"prov_code","muni_code","censo","votantes","validos","blancos","nulos","siglas","votos"
29,"29056",1177,807,794,3,13,"ACIMA",0
29,"29067",420165,273593,271376,3342,2217,"ACIMA",348
29,"29065",207,151,149,1,2,"ACIMA",0
29,"29004",343,281,281,0,0,"ACIMA",1
29,"29072",3258,2484,2447,30,37,"ACIMA",0
29,"29054",39904,27540,27307,240,233,"ACIMA",27
29,"29005",4307,2967,2951,18,16,"ACIMA",0
29,"29902",2577,1689,1665,20,24,"ACIMA",2
29,"29093",2299,1767,1732,7,35,"ACIMA",0
29,"29028",1253,887,876,8,11,"ACIMA",8
29,"29008",14069,9934,9859,118,75,"ACIMA",4
29,"29088",2784,2019,1975,14,44,"ACIMA",0
29,"29075",12666,8284,8218,62,66,"ACIMA",2
29,"29062",647,573,571,1,2,"ACIMA",0
29,"29037",227,170,170,0,0,"ACIMA",0
29,"29019",908,720,714,0,6,"ACIMA",0
29,"29090",1805,1265,1260,5,5,"ACIMA",4
29,"29052",245,151,151,0,0,"ACIMA",0
29,"29032",6673,5204,5140,43,64,"ACIMA",4
29,"29073",1520,1032,1021,10,11,"ACIMA",10
29,"29092",596,457,454,10,3,"ACIMA",2
29,"29031",1652,1123,1118,11,5,"ACIMA",0
29,"29053",1715,1239,1221,7,18,"ACIMA",1
29,"29059",2551,1986,1964,11,22,"ACIMA",1
29,"29100",2442,1834,1824,14,10,"ACIMA",1
29,"29023",1661,1080,1074,15,6,"ACIMA",2
29,"29017",6766,5162,5114,48,48,"ACIMA",3
29,"29039",2822,2091,2074,8,17,"ACIMA",0
29,"29085",156,116,113,0,3,"ACIMA",1
29,"29006",721,516,508,5,8,"ACIMA",0
29,"29025",34637,22545,22354,268,191,"ACIMA",21
29,"29086",814,538,536,9,2,"ACIMA",1
29,"29095",3431,2660,2607,23,53,"ACIMA",2
29,"29079",2500,2016,2000,23,16,"ACIMA",1
29,"29044",866,631,627,3,4,"ACIMA",0
29,"29033",1385,878,868,4,10,"ACIMA",0
29,"29076",2022,1384,1374,14,10,"ACIMA",134
29,"29046",2777,2032,2013,10,19,"ACIMA",1
29,"29011",3013,1893,1876,7,17,"ACIMA",0
29,"29077",225,157,157,1,0,"ACIMA",0
29,"29030",839,669,668,5,1,"ACIMA",0
29,"29081",290,226,226,3,0,"ACIMA",0
29,"29083",2212,1679,1652,15,27,"ACIMA",1
29,"29041",2796,1950,1921,24,29,"ACIMA",2
29,"29091",8777,6226,6126,64,100,"ACIMA",1
29,"29020",3188,2448,2424,30,24,"ACIMA",3
29,"29024",414,271,261,6,10,"ACIMA",0
29,"29018",2088,1565,1540,9,25,"ACIMA",3
29,"29070",35228,23374,23146,258,228,"ACIMA",28
29,"29068",6209,4025,3983,41,42,"ACIMA",7
29,"29097",4076,3060,3018,40,42,"ACIMA",1
29,"29057",413,311,308,2,3,"ACIMA",0
29,"29050",483,341,340,1,1,"ACIMA",1
29,"29014",250,152,150,0,2,"ACIMA",6
29,"29074",818,631,630,3,1,"ACIMA",0
29,"29049",3137,2365,2352,19,13,"ACIMA",1
29,"29058",1560,1103,1096,5,7,"ACIMA",0
29,"29089",3343,2514,2489,14,25,"ACIMA",0
29,"29027",2416,1907,1893,15,14,"ACIMA",0
29,"29099",958,739,730,5,9,"ACIMA",0
29,"29003",1133,902,900,5,2,"ACIMA",0
29,"29035",1717,1280,1270,14,10,"ACIMA",0
29,"29012",9817,7063,6991,51,72,"ACIMA",2
29,"29040",1934,1344,1332,12,12,"ACIMA",32
29,"29009",1525,1126,1109,9,17,"ACIMA",0
29,"29036",670,504,499,4,5,"ACIMA",0
29,"29055",1837,1478,1454,12,24,"ACIMA",2
29,"29045",1750,1246,1239,6,7,"ACIMA",0
29,"29002",1246,896,893,11,3,"ACIMA",1
29,"29061",1045,861,855,7,6,"ACIMA",2
29,"29048",1508,1254,1245,6,9,"ACIMA",0
29,"29015",31805,22566,22347,272,219,"ACIMA",5
29,"29043",2596,1670,1647,24,23,"ACIMA",1
29,"29022",202,142,141,2,1,"ACIMA",0
29,"29010",1703,1411,1377,7,34,"ACIMA",0
29,"29063",358,272,271,2,1,"ACIMA",0
29,"29001",4176,3339,3303,23,36,"ACIMA",0
29,"29080",6598,4703,4663,31,40,"ACIMA",5
29,"29021",153,113,113,0,0,"ACIMA",0
29,"29034",462,360,357,0,3,"ACIMA",2
29,"29094",54317,36540,36174,410,366,"ACIMA",17
29,"29098",1312,1043,1036,22,7,"ACIMA",0
29,"29096",2880,2012,1971,28,41,"ACIMA",1
29,"29060",775,573,572,1,1,"ACIMA",0
29,"29066",363,263,260,1,3,"ACIMA",0
29,"29087",409,306,305,3,1,"ACIMA",0
29,"29026",1130,815,799,7,16,"ACIMA",3
29,"29051",37991,24498,24095,381,403,"ACIMA",25
29,"29047",1165,973,969,0,4,"ACIMA",1
29,"29064",584,428,422,4,6,"ACIMA",0
29,"29016",272,180,179,5,1,"ACIMA",0
29,"29029",452,339,336,0,3,"ACIMA",3
29,"29069",80337,50235,49723,690,512,"ACIMA",49
29,"29042",14047,9845,9735,118,110,"ACIMA",58
29,"29082",29311,20220,20051,223,169,"ACIMA",27
29,"29007",25572,17726,17564,227,162,"ACIMA",15
29,"29901",41445,27372,27158,295,214,"ACIMA",27
29,"29084",28386,19450,19202,296,248,"ACIMA",16
29,"29071",915,601,598,4,3,"ACIMA",1
29,"29013",1718,1302,1283,4,19,"ACIMA",3
29,"29038",16309,10579,10494,152,85,"ACIMA",15
38,"38014",1446,1018,1007,8,11,"ANC",6
35,"35017",22331,13463,13144,217,319,"ANC",23
35,"35012",9662,5511,5446,45,65,"ANC",10
35,"35011",23140,15550,15320,199,230,"ANC",34
35,"35019",30279,17607,17380,158,227,"ANC",33
38,"38036",6477,4514,4422,40,92,"ANC",11
35,"35020",6142,4227,4192,24,35,"ANC",8
38,"38010",4054,2642,2599,17,43,"ANC",10
38,"38025",6649,4858,4778,52,80,"ANC",17
38,"38047",1819,1269,1239,12,30,"ANC",1
35,"35010",3565,2178,2135,26,43,"ANC",2
38,"38901",1389,917,907,16,10,"ANC",0
35,"35029",3981,2341,2315,43,26,"ANC",5
35,"35031",6968,4927,4862,71,65,"ANC",14
35,"35007",569,392,391,2,1,"ANC",0
38,"38005",5327,3316,3270,38,46,"ANC",30
38,"38017",24438,13769,13576,176,193,"ANC",94
38,"38049",2794,1721,1694,12,27,"ANC",1
38,"38053",3752,2459,2397,28,62,"ANC",3
35,"35026",78933,49860,48955,780,905,"ANC",100
38,"38043",18628,12966,12763,134,203,"ANC",57
35,"35006",29515,20731,20286,362,445,"ANC",32
38,"38020",14520,9396,9202,121,194,"ANC",22
35,"35014",9943,5438,5316,95,122,"ANC",7
35,"35009",19678,13799,13442,155,357,"ANC",21
38,"38050",2516,1765,1734,9,31,"ANC",6
38,"38033",3987,2696,2656,23,40,"ANC",2
38,"38031",28391,21797,21431,234,366,"ANC",85
38,"38030",1875,1320,1301,11,19,"ANC",2
38,"38018",4397,3216,3163,27,53,"ANC",10
35,"35001",4663,3639,3569,39,70,"ANC",10
38,"38052",1344,886,872,5,14,"ANC",3
38,"38038",161890,99555,97980,1101,1575,"ANC",598
35,"35024",12420,6978,6819,131,159,"ANC",16
38,"38048",3884,2615,2587,34,28,"ANC",6
35,"35033",6415,4394,4302,51,92,"ANC",8
35,"35016",291589,181013,177964,2856,3049,"ANC",372
38,"38024",14851,9589,9399,93,190,"ANC",14
38,"38008",5430,3844,3772,46,72,"ANC",0
35,"35028",8810,4687,4603,71,84,"ANC",9
38,"38042",3876,2850,2809,24,41,"ANC",9
35,"35013",6779,5059,4961,105,98,"ANC",8
38,"38011",19299,12565,12313,152,252,"ANC",67
38,"38016",1250,664,646,3,18,"ANC",0
35,"35027",10510,7523,7375,88,148,"ANC",26
35,"35018",11652,6488,6367,107,121,"ANC",18
38,"38027",5392,3530,3459,41,71,"ANC",14
38,"38035",8172,4990,4919,62,71,"ANC",30
38,"38002",991,716,708,1,8,"ANC",0
38,"38029",1456,732,715,4,17,"ANC",2
38,"38013",2823,1856,1843,18,13,"ANC",3
38,"38026",32174,24822,24431,283,391,"ANC",129
38,"38012",2535,1735,1716,11,19,"ANC",42
38,"38009",3910,2687,2633,31,54,"ANC",2
38,"38040",4697,3007,2962,31,45,"ANC",5
38,"38015",4326,3132,3099,21,33,"ANC",21
35,"35030",8295,5433,5315,54,118,"ANC",4
38,"38034",4092,3034,2983,30,51,"ANC",6
35,"35004",35462,18498,18196,325,302,"ANC",49
35,"35002",21673,14480,14253,172,227,"ANC",38
35,"35034",6372,2951,2921,33,30,"ANC",26
38,"38004",4522,3034,2975,33,59,"ANC",11
38,"38001",17632,9601,9475,121,126,"ANC",35
38,"38046",8848,6410,6301,75,109,"ANC",24
38,"38021",1792,1184,1160,6,24,"ANC",4
38,"38007",1844,1209,1188,5,21,"ANC",1
35,"35005",1170,864,853,7,11,"ANC",2
38,"38051",7081,5298,5229,64,69,"ANC",17
35,"35008",6151,4514,4419,59,95,"ANC",13
38,"38032",13032,8487,8357,101,130,"ANC",25
38,"38023",118865,76393,75039,928,1354,"ANC",466
35,"35022",43892,27289,26876,326,413,"ANC",46
38,"38044",2325,1550,1532,7,18,"ANC",1
38,"38045",4181,2176,2140,13,36,"ANC",3
38,"38022",18671,13075,12890,111,185,"ANC",36
38,"38037",13166,8509,8332,65,177,"ANC",12
35,"35003",4764,2733,2680,34,53,"ANC",4
35,"35021",14982,9948,9749,138,199,"ANC",19
38,"38019",12624,8174,8099,65,75,"ANC",17
35,"35025",1941,1345,1328,12,17,"ANC",2
38,"38006",35862,18726,18500,209,226,"ANC",118
38,"38039",10198,7548,7429,78,119,"ANC",24
38,"38003",1446,1053,1044,4,9,"ANC",4
35,"35032",3432,2605,2548,37,57,"ANC",6
38,"38028",22003,14876,14589,158,287,"ANC",67
38,"38041",6780,4905,4813,57,92,"ANC",15
35,"35015",9065,4859,4770,64,89,"ANC",5
35,"35023",11640,8412,8178,97,234,"ANC",14
31,"31242",235,157,157,2,0,"AMAIUR",31
31,"31221",1182,774,767,12,7,"AMAIUR",238
31,"31016",7377,5149,5072,101,77,"AMAIUR",1004
31,"31001",88,58,58,1,0,"AMAIUR",13
31,"31229",46,38,37,0,1,"AMAIUR",8
48,"48048",547,423,423,5,0,"AMAIUR",187
48,"48903",1909,1455,1430,4,25,"AMAIUR",226
48,"48018",905,591,587,8,4,"AMAIUR",325
20,"20013",5331,3662,3637,33,25,"AMAIUR",1732
48,"48066",350,277,277,0,0,"AMAIUR",91
31,"31139",172,97,97,1,0,"AMAIUR",10
48,"48026",1093,881,875,3,6,"AMAIUR",484
1,"1042",915,678,661,1,17,"AMAIUR",275
31,"31196",40,35,35,1,0,"AMAIUR",13
1,"1016",461,241,237,2,4,"AMAIUR",57
20,"20073",4689,3196,3176,28,20,"AMAIUR",1872
31,"31249",1926,1376,1361,30,15,"AMAIUR",22
1,"1013",711,477,474,1,3,"AMAIUR",183
31,"31059",204,140,139,3,1,"AMAIUR",42
31,"31210",219,169,167,3,2,"AMAIUR",37
20,"20012",149,97,97,0,0,"AMAIUR",59
31,"31119",49,28,28,0,0,"AMAIUR",2
1,"1032",536,412,400,0,12,"AMAIUR",49
31,"31129",405,285,281,1,4,"AMAIUR",165
48,"48071",6097,4307,4224,61,83,"AMAIUR",839
48,"48052",1526,1213,1205,7,8,"AMAIUR",627
31,"31015",1989,1404,1380,29,24,"AMAIUR",71
31,"31028",217,129,128,1,1,"AMAIUR",50
48,"48005",93,65,64,0,1,"AMAIUR",24
48,"48084",23491,15322,15084,213,238,"AMAIUR",1950
31,"31011",688,437,432,17,5,"AMAIUR",59
20,"20065",3176,2156,2137,19,19,"AMAIUR",865
20,"20025",1174,814,803,4,11,"AMAIUR",471
48,"48906",796,625,622,5,3,"AMAIUR",287
31,"31012",839,577,570,10,7,"AMAIUR",50
31,"31102",162,80,78,0,2,"AMAIUR",37
48,"48003",14142,10268,10167,84,101,"AMAIUR",3108
48,"48073",7090,4865,4802,37,63,"AMAIUR",2678
31,"31159",1158,864,846,17,18,"AMAIUR",191
20,"20061",4011,2666,2653,23,13,"AMAIUR",1129
31,"31109",1365,946,934,11,12,"AMAIUR",178
1,"1002",8057,5854,5757,48,97,"AMAIUR",1689
31,"31140",117,91,89,3,2,"AMAIUR",15
48,"48097",1359,936,915,9,21,"AMAIUR",257
20,"20010",1392,949,941,8,8,"AMAIUR",520
48,"48032",5864,4257,4223,32,34,"AMAIUR",1795
31,"31225",40,32,32,0,0,"AMAIUR",1
1,"1030",170,123,120,1,3,"AMAIUR",13
31,"31180",240,174,170,5,4,"AMAIUR",17
31,"31167",859,600,593,11,7,"AMAIUR",92
48,"48056",849,610,608,3,2,"AMAIUR",204
31,"31259",503,341,336,6,5,"AMAIUR",145
31,"31907",9914,7394,7282,198,112,"AMAIUR",1048
1,"1022",826,615,602,6,13,"AMAIUR",54
1,"1047",942,674,655,4,19,"AMAIUR",44
48,"48007",354,254,253,1,1,"AMAIUR",132
48,"48095",2367,1593,1577,20,16,"AMAIUR",513
31,"31010",5788,3716,3637,48,79,"AMAIUR",1045
20,"20001",249,167,167,4,0,"AMAIUR",99
1,"1018",1395,952,943,7,9,"AMAIUR",329
31,"31147",103,81,80,3,1,"AMAIUR",5
31,"31115",171,112,109,2,3,"AMAIUR",35
31,"31024",116,56,56,2,0,"AMAIUR",41
31,"31055",264,194,193,0,1,"AMAIUR",88
20,"20008",757,499,499,8,0,"AMAIUR",351
48,"48089",2878,2120,2089,19,31,"AMAIUR",618
31,"31041",1397,938,913,26,25,"AMAIUR",133
48,"48059",397,289,286,0,3,"AMAIUR",139
31,"31192",148,107,104,1,3,"AMAIUR",23
20,"20067",31173,20218,20017,270,201,"AMAIUR",6419
48,"48009",767,585,580,4,5,"AMAIUR",250
31,"31231",127,93,91,1,2,"AMAIUR",2
20,"20066",467,316,316,0,0,"AMAIUR",244
31,"31132",160,124,124,6,0,"AMAIUR",40
31,"31086",11499,8520,8389,214,131,"AMAIUR",1143
31,"31239",302,229,224,7,5,"AMAIUR",52
31,"31066",915,660,647,19,13,"AMAIUR",21
31,"31106",676,534,518,10,16,"AMAIUR",11
1,"1053",590,341,333,4,8,"AMAIUR",129
31,"31082",634,402,398,10,4,"AMAIUR",210
31,"31224",980,691,681,9,10,"AMAIUR",24
31,"31091",365,227,224,3,3,"AMAIUR",127
31,"31051",270,182,181,8,1,"AMAIUR",22
31,"31169",2285,1621,1590,43,31,"AMAIUR",19
1,"1008",781,566,546,7,20,"AMAIUR",119
20,"20076",6978,4823,4762,38,61,"AMAIUR",1949
20,"20902",14148,9874,9798,120,76,"AMAIUR",2446
31,"31007",137,96,90,2,6,"AMAIUR",11
48,"48025",882,652,644,2,8,"AMAIUR",274
31,"31098",1762,1285,1262,34,23,"AMAIUR",255
48,"48080",10161,6901,6815,95,86,"AMAIUR",1084
1,"1027",430,283,276,4,7,"AMAIUR",78
1,"1054",959,680,675,8,5,"AMAIUR",285
31,"31152",1406,1003,975,23,28,"AMAIUR",60
20,"20045",46542,30907,30536,425,371,"AMAIUR",5145
48,"48023",601,499,492,4,7,"AMAIUR",220
1,"1010",2276,1649,1618,27,31,"AMAIUR",526
31,"31256",113,64,64,0,0,"AMAIUR",30
48,"48063",355,287,287,6,0,"AMAIUR",143
48,"48053",856,683,680,8,3,"AMAIUR",132
48,"48081",1938,1449,1435,14,14,"AMAIUR",414
48,"48082",38551,25768,25482,316,286,"AMAIUR",3715
48,"48060",3689,2477,2466,12,11,"AMAIUR",1164
31,"31137",215,108,106,1,2,"AMAIUR",39
20,"20049",4081,2741,2723,30,18,"AMAIUR",1313
20,"20077",5382,3766,3741,42,25,"AMAIUR",1275
20,"20040",15103,9781,9686,148,95,"AMAIUR",4747
48,"48038",1087,826,821,7,5,"AMAIUR",308
20,"20036",12731,8519,8431,131,88,"AMAIUR",2394
20,"20079",17229,12010,11927,143,83,"AMAIUR",4475
31,"31071",17,15,15,0,0,"AMAIUR",0
1,"1059",183468,127839,125801,1422,2038,"AMAIUR",20836
1,"1902",776,532,526,6,6,"AMAIUR",67
20,"20033",884,650,641,4,9,"AMAIUR",377
20,"20028",2204,1400,1379,11,21,"AMAIUR",728
31,"31092",676,447,446,6,1,"AMAIUR",115
48,"48051",225,157,156,0,1,"AMAIUR",18
31,"31113",147,87,85,2,2,"AMAIUR",12
20,"20004",254,153,153,5,0,"AMAIUR",72
48,"48077",3398,2490,2477,33,13,"AMAIUR",610
31,"31020",488,247,246,0,1,"AMAIUR",177
31,"31183",667,516,508,8,8,"AMAIUR",66
48,"48072",1009,796,787,3,9,"AMAIUR",433
31,"31193",1312,969,948,33,21,"AMAIUR",211
48,"48036",23973,16491,16344,179,147,"AMAIUR",3621
31,"31052",89,62,58,1,4,"AMAIUR",4
31,"31245",87,59,58,5,1,"AMAIUR",9
48,"48085",9893,6960,6885,93,75,"AMAIUR",2006
31,"31184",66,60,59,0,1,"AMAIUR",18
31,"31002",421,292,284,5,8,"AMAIUR",41
31,"31213",114,58,58,0,0,"AMAIUR",26
20,"20034",3192,2035,2030,11,5,"AMAIUR",855
31,"31228",540,376,364,13,12,"AMAIUR",26
31,"31078",2502,1880,1852,33,28,"AMAIUR",58
31,"31080",544,428,426,7,2,"AMAIUR",71
20,"20002",347,237,237,8,0,"AMAIUR",170
31,"31141",132,100,98,1,2,"AMAIUR",7
31,"31026",154,125,122,1,3,"AMAIUR",8
20,"20055",17856,11885,11791,91,94,"AMAIUR",4805
48,"48911",373,300,296,1,4,"AMAIUR",197
20,"20019",10105,6640,6555,73,85,"AMAIUR",2179
31,"31053",595,430,418,6,12,"AMAIUR",55
20,"20047",494,321,319,2,2,"AMAIUR",194
31,"31200",763,527,514,17,13,"AMAIUR",135
31,"31031",234,144,143,1,1,"AMAIUR",84
48,"48006",285,246,243,3,3,"AMAIUR",115
31,"31143",105,62,58,2,4,"AMAIUR",2
20,"20052",1154,849,847,14,2,"AMAIUR",417
20,"20039",2003,1517,1512,9,5,"AMAIUR",794
31,"31101",1305,892,874,15,18,"AMAIUR",192
48,"48039",263,217,216,4,1,"AMAIUR",88
20,"20015",1307,980,979,13,1,"AMAIUR",658
31,"31254",1956,1495,1476,16,19,"AMAIUR",79
48,"48091",1170,860,851,3,9,"AMAIUR",399
20,"20020",143,104,104,1,0,"AMAIUR",59
1,"1046",629,428,421,5,7,"AMAIUR",80
20,"20056",3975,2692,2669,17,23,"AMAIUR",1364
31,"31157",3567,2435,2393,32,42,"AMAIUR",142
31,"31027",824,611,609,2,2,"AMAIUR",394
20,"20064",12380,7568,7464,112,104,"AMAIUR",2701
31,"31241",164,117,116,4,1,"AMAIUR",19
31,"31156",268,202,201,5,1,"AMAIUR",56
31,"31008",97,64,63,1,1,"AMAIUR",6
48,"48022",2396,1524,1504,12,20,"AMAIUR",287
20,"20018",11027,7428,7387,53,41,"AMAIUR",4012
31,"31252",91,60,58,0,2,"AMAIUR",24
20,"20070",1109,817,815,4,2,"AMAIUR",540
31,"31116",71,48,48,2,0,"AMAIUR",1
31,"31207",280,198,195,7,3,"AMAIUR",70
31,"31025",751,501,495,12,6,"AMAIUR",154
31,"31247",171,121,121,1,0,"AMAIUR",44
48,"48075",1915,1362,1325,15,37,"AMAIUR",416
31,"31061",67,47,47,2,0,"AMAIUR",2
31,"31056",183,123,122,4,1,"AMAIUR",25
31,"31174",115,72,70,1,2,"AMAIUR",11
31,"31029",987,693,680,16,13,"AMAIUR",40
31,"31178",540,395,392,4,3,"AMAIUR",10
31,"31036",957,631,616,22,15,"AMAIUR",74
48,"48064",599,490,490,1,0,"AMAIUR",245
31,"31901",15574,11165,10974,201,191,"AMAIUR",1560
31,"31226",597,339,335,2,4,"AMAIUR",160
31,"31215",4618,3384,3315,54,69,"AMAIUR",34
31,"31144",840,509,508,7,1,"AMAIUR",239
20,"20009",11794,7805,7725,103,80,"AMAIUR",2545
31,"31004",36,21,20,0,1,"AMAIUR",1
31,"31076",2314,1843,1823,39,20,"AMAIUR",167
1,"1063",1803,1290,1284,18,6,"AMAIUR",350
31,"31108",1969,1474,1452,23,22,"AMAIUR",26
48,"48010",427,303,300,2,3,"AMAIUR",114
48,"48058",977,706,700,2,6,"AMAIUR",324
20,"20024",400,238,235,0,3,"AMAIUR",156
31,"31057",1863,1450,1409,32,41,"AMAIUR",11
31,"31212",173,117,117,3,0,"AMAIUR",3
48,"48094",3299,2398,2377,15,21,"AMAIUR",1036
31,"31251",3147,2274,2225,39,49,"AMAIUR",144
48,"48069",12381,8760,8672,66,88,"AMAIUR",2017
31,"31189",1229,745,740,5,5,"AMAIUR",286
31,"31120",408,267,265,8,2,"AMAIUR",60
48,"48040",1274,936,921,10,15,"AMAIUR",315
31,"31244",153,97,97,3,0,"AMAIUR",32
31,"31237",198,137,136,7,1,"AMAIUR",8
1,"1034",177,140,137,1,3,"AMAIUR",37
31,"31065",1927,1391,1362,39,29,"AMAIUR",77
20,"20901",1468,951,947,13,4,"AMAIUR",379
31,"31235",189,111,110,0,1,"AMAIUR",29
1,"1058",1342,877,872,8,5,"AMAIUR",400
48,"48015",34932,24209,23966,296,243,"AMAIUR",3359
1,"1020",317,222,220,0,2,"AMAIUR",80
31,"31222",67,46,44,3,2,"AMAIUR",10
31,"31018",422,303,299,8,4,"AMAIUR",39
31,"31068",3004,2258,2207,43,51,"AMAIUR",98
20,"20904",98,67,66,0,1,"AMAIUR",57
20,"20062",995,687,667,5,20,"AMAIUR",358
31,"31181",168,121,119,3,2,"AMAIUR",38
48,"48001",5842,4040,4020,23,20,"AMAIUR",1431
31,"31154",229,133,133,4,0,"AMAIUR",48
31,"31130",319,213,209,1,4,"AMAIUR",78
20,"20026",214,172,172,0,0,"AMAIUR",97
31,"31236",1333,887,874,15,13,"AMAIUR",216
1,"1033",679,537,532,2,5,"AMAIUR",50
31,"31205",465,335,325,9,10,"AMAIUR",20
31,"31073",332,228,226,1,2,"AMAIUR",103
48,"48079",470,391,391,2,0,"AMAIUR",165
31,"31262",219,158,157,4,1,"AMAIUR",30
48,"48914",324,278,276,0,2,"AMAIUR",127
31,"31111",100,75,75,1,0,"AMAIUR",22
1,"1056",256,183,181,1,2,"AMAIUR",23
31,"31081",335,249,243,8,6,"AMAIUR",102
48,"48905",2600,1903,1869,14,34,"AMAIUR",490
31,"31202",4247,3014,2957,69,57,"AMAIUR",94
20,"20003",547,361,359,3,2,"AMAIUR",260
31,"31182",45,28,28,2,0,"AMAIUR",6
20,"20048",175,102,102,1,0,"AMAIUR",72
20,"20032",8949,6189,6117,55,72,"AMAIUR",2022
20,"20069",146828,101992,101225,1287,767,"AMAIUR",24435
31,"31075",96,61,61,0,0,"AMAIUR",17
20,"20068",199,132,129,2,3,"AMAIUR",87
48,"48065",3311,2340,2323,23,17,"AMAIUR",689
31,"31122",4506,3333,3281,76,52,"AMAIUR",647
1,"1060",223,181,178,1,3,"AMAIUR",10
31,"31166",274,183,182,2,1,"AMAIUR",17
31,"31165",2868,2094,2046,43,48,"AMAIUR",44
48,"48910",3063,2122,2104,14,18,"AMAIUR",612
31,"31112",106,79,78,0,1,"AMAIUR",13
31,"31058",240,184,179,0,5,"AMAIUR",31
1,"1014",385,281,274,6,7,"AMAIUR",31
1,"1023",290,236,235,1,1,"AMAIUR",35
20,"20041",279,153,151,5,2,"AMAIUR",85
31,"31248",318,190,187,2,3,"AMAIUR",43
48,"48074",3384,2441,2397,20,44,"AMAIUR",817
31,"31103",51,40,40,3,0,"AMAIUR",6
48,"48004",329,240,239,2,1,"AMAIUR",115
31,"31134",195,134,132,3,2,"AMAIUR",29
48,"48030",626,487,483,0,4,"AMAIUR",245
31,"31083",50,37,37,0,0,"AMAIUR",13
31,"31009",717,510,497,14,13,"AMAIUR",97
31,"31204",45,35,34,0,1,"AMAIUR",4
20,"20042",3354,2131,2117,18,14,"AMAIUR",1080
31,"31177",264,162,158,3,4,"AMAIUR",18
1,"1004",1427,1021,996,15,25,"AMAIUR",261
31,"31117",670,471,467,3,4,"AMAIUR",400
48,"48083",7021,4722,4656,74,66,"AMAIUR",756
31,"31121",79,53,52,2,1,"AMAIUR",7
31,"31107",1706,1321,1311,17,10,"AMAIUR",11
48,"48035",379,304,301,0,3,"AMAIUR",108
31,"31172",375,295,288,11,7,"AMAIUR",30
31,"31138",939,648,646,14,2,"AMAIUR",329
48,"48024",1026,845,841,3,4,"AMAIUR",376
20,"20907",136,94,94,0,0,"AMAIUR",69
31,"31054",498,310,308,1,2,"AMAIUR",153
31,"31124",209,139,138,1,1,"AMAIUR",19
31,"31003",131,101,101,1,0,"AMAIUR",33
31,"31234",148,107,105,6,2,"AMAIUR",8
31,"31037",94,68,68,0,0,"AMAIUR",38
31,"31017",358,220,219,12,1,"AMAIUR",64
31,"31261",271,202,201,4,1,"AMAIUR",18
48,"48047",161,126,126,1,0,"AMAIUR",91
31,"31044",276,224,223,0,1,"AMAIUR",119
31,"31085",451,334,327,3,7,"AMAIUR",137
48,"48054",23712,16643,16439,215,204,"AMAIUR",2411
48,"48045",5060,3912,3849,31,63,"AMAIUR",942
31,"31005",312,209,206,4,3,"AMAIUR",26
20,"20081",7346,4957,4925,35,32,"AMAIUR",1981
31,"31176",2777,1999,1955,57,44,"AMAIUR",43
1,"1031",1229,916,899,13,17,"AMAIUR",111
31,"31069",860,660,647,2,13,"AMAIUR",87
31,"31035",60,47,47,0,0,"AMAIUR",2
31,"31096",127,112,110,2,2,"AMAIUR",22
31,"31149",2381,1626,1607,7,19,"AMAIUR",1047
48,"48044",63869,47453,47085,511,368,"AMAIUR",7085
48,"48067",1204,895,892,4,3,"AMAIUR",422
31,"31219",93,75,73,1,2,"AMAIUR",2
1,"1049",147,115,115,1,0,"AMAIUR",30
31,"31142",1443,906,899,16,7,"AMAIUR",136
1,"1021",473,332,324,3,8,"AMAIUR",45
20,"20058",770,549,547,3,2,"AMAIUR",193
31,"31100",298,193,193,2,0,"AMAIUR",31
31,"31110",97,53,53,3,0,"AMAIUR",4
48,"48057",5934,4407,4385,27,22,"AMAIUR",2419
31,"31023",5338,3986,3920,120,66,"AMAIUR",366
31,"31194",308,212,210,6,2,"AMAIUR",60
31,"31063",96,77,75,0,2,"AMAIUR",15
20,"20054",476,350,348,1,2,"AMAIUR",282
20,"20071",14488,9499,9419,93,80,"AMAIUR",4052
48,"48028",767,623,621,1,2,"AMAIUR",331
20,"20006",277,177,175,6,2,"AMAIUR",112
48,"48043",4256,3066,3040,33,26,"AMAIUR",790
1,"1019",155,124,124,0,0,"AMAIUR",15
20,"20007",300,203,202,2,1,"AMAIUR",146
48,"48002",7971,5377,5290,65,87,"AMAIUR",1018
31,"31199",161,103,103,1,0,"AMAIUR",30
31,"31047",283,208,204,3,4,"AMAIUR",32
48,"48014",1211,838,834,4,4,"AMAIUR",234
48,"48017",13554,9303,9234,64,69,"AMAIUR",3436
48,"48021",1460,1024,1012,13,12,"AMAIUR",373
31,"31227",8257,5987,5884,125,103,"AMAIUR",1358
31,"31257",827,598,585,16,13,"AMAIUR",75
31,"31220",771,584,572,9,12,"AMAIUR",18
31,"31903",6058,3985,3919,67,66,"AMAIUR",843
31,"31170",46,40,39,3,1,"AMAIUR",6
1,"1006",181,133,127,2,6,"AMAIUR",18
48,"48034",13160,9290,9189,82,101,"AMAIUR",1148
31,"31088",5358,3655,3592,97,63,"AMAIUR",395
31,"31203",30,25,25,0,0,"AMAIUR",0
31,"31014",280,197,196,2,1,"AMAIUR",40
31,"31265",81,52,50,0,2,"AMAIUR",11
48,"48037",727,528,519,2,9,"AMAIUR",153
31,"31099",68,50,50,0,0,"AMAIUR",3
31,"31072",5098,3764,3698,75,66,"AMAIUR",75
1,"1037",625,403,398,6,5,"AMAIUR",103
31,"31038",1372,982,968,17,14,"AMAIUR",65
31,"31232",24440,17810,17436,420,374,"AMAIUR",622
48,"48046",12635,9231,9161,61,70,"AMAIUR",3632
20,"20017",8670,5923,5890,27,33,"AMAIUR",2660
20,"20072",4643,2967,2948,46,19,"AMAIUR",901
48,"48041",721,588,585,9,3,"AMAIUR",197
20,"20005",1341,890,885,4,5,"AMAIUR",552
31,"31246",148,101,100,3,1,"AMAIUR",9
48,"48907",351,290,290,1,0,"AMAIUR",116
31,"31188",185,139,137,2,2,"AMAIUR",37
31,"31208",2574,2003,1966,32,37,"AMAIUR",21
20,"20046",1157,734,729,6,5,"AMAIUR",399
31,"31039",94,65,61,0,4,"AMAIUR",7
31,"31908",997,692,683,9,9,"AMAIUR",223
31,"31905",2707,1913,1881,32,32,"AMAIUR",122
31,"31145",173,129,127,2,2,"AMAIUR",1
31,"31209",155,105,104,1,1,"AMAIUR",24
31,"31153",2246,1504,1487,13,17,"AMAIUR",716
1,"1017",910,629,621,17,8,"AMAIUR",174
31,"31206",2079,1517,1475,33,42,"AMAIUR",287
31,"31094",123,100,97,3,3,"AMAIUR",10
20,"20016",1526,937,932,4,5,"AMAIUR",473
1,"1041",159,116,113,1,3,"AMAIUR",9
48,"48076",294,226,226,0,0,"AMAIUR",69
31,"31179",558,384,384,3,0,"AMAIUR",21
1,"1052",240,191,191,1,0,"AMAIUR",38
31,"31148",99,69,66,2,3,"AMAIUR",5
31,"31095",83,70,70,1,0,"AMAIUR",25
1,"1043",2322,1623,1595,12,28,"AMAIUR",229
48,"48087",463,371,370,4,1,"AMAIUR",57
31,"31128",406,261,261,4,0,"AMAIUR",68
31,"31032",1785,1330,1305,24,25,"AMAIUR",24
31,"31046",58,41,41,3,0,"AMAIUR",2
20,"20014",1101,660,654,8,6,"AMAIUR",426
48,"48909",194,163,163,0,0,"AMAIUR",101
31,"31238",125,99,98,3,1,"AMAIUR",24
31,"31255",100,78,78,1,0,"AMAIUR",7
48,"48096",6607,5007,4900,54,107,"AMAIUR",867
31,"31258",7679,5561,5475,92,86,"AMAIUR",1349
48,"48902",19232,12809,12633,182,176,"AMAIUR",2123
31,"31190",48,34,34,1,0,"AMAIUR",6
20,"20075",4447,2823,2798,32,25,"AMAIUR",1421
20,"20074",11660,8003,7951,31,52,"AMAIUR",3956
48,"48012",2036,1630,1616,9,14,"AMAIUR",531
31,"31162",53,35,34,1,1,"AMAIUR",7
20,"20027",2809,1929,1918,25,11,"AMAIUR",1135
31,"31240",553,360,359,3,1,"AMAIUR",182
31,"31160",111,93,93,7,0,"AMAIUR",9
48,"48020",276378,191777,190141,2335,1636,"AMAIUR",26191
48,"48027",21610,15409,15274,145,135,"AMAIUR",4204
31,"31090",156,77,77,0,0,"AMAIUR",26
20,"20038",382,281,280,1,1,"AMAIUR",184
31,"31164",604,462,448,9,14,"AMAIUR",10
48,"48049",564,446,446,2,0,"AMAIUR",192
31,"31216",3911,2699,2653,82,46,"AMAIUR",283
31,"31211",25,14,14,2,0,"AMAIUR",1
1,"1039",211,164,158,1,6,"AMAIUR",10
31,"31904",1590,1054,1031,19,23,"AMAIUR",285
31,"31175",78,55,54,0,1,"AMAIUR",2
31,"31187",122,68,68,2,0,"AMAIUR",29
20,"20060",92,83,82,0,1,"AMAIUR",80
31,"31033",55,34,34,0,0,"AMAIUR",11
31,"31013",668,382,375,12,7,"AMAIUR",87
31,"31087",163,122,121,3,1,"AMAIUR",45
31,"31135",116,87,86,9,1,"AMAIUR",1
31,"31125",269,172,169,6,3,"AMAIUR",28
31,"31064",1500,1137,1120,12,17,"AMAIUR",37
31,"31034",43,29,29,0,0,"AMAIUR",9
20,"20031",179,114,113,1,1,"AMAIUR",73
31,"31074",430,304,303,10,1,"AMAIUR",98
1,"1055",906,632,623,7,9,"AMAIUR",109
48,"48070",559,413,407,1,6,"AMAIUR",270
1,"1901",2254,1561,1528,24,33,"AMAIUR",215
31,"31161",321,251,246,5,5,"AMAIUR",67
31,"31146",46,34,34,1,0,"AMAIUR",4
31,"31045",501,384,377,16,7,"AMAIUR",43
48,"48055",2620,1954,1934,22,20,"AMAIUR",783
1,"1061",155,122,122,2,0,"AMAIUR",46
31,"31048",154,118,117,0,1,"AMAIUR",1
1,"1036",15236,10511,10372,141,139,"AMAIUR",2815
31,"31093",305,207,203,2,4,"AMAIUR",53
1,"1003",1199,863,848,2,15,"AMAIUR",578
31,"31089",246,198,195,4,3,"AMAIUR",8
20,"20078",1146,885,884,6,1,"AMAIUR",641
31,"31201",144714,104019,102644,2027,1375,"AMAIUR",14503
31,"31253",123,102,97,0,5,"AMAIUR",50
48,"48061",773,585,582,6,3,"AMAIUR",177
1,"1028",1106,773,760,8,13,"AMAIUR",136
20,"20906",117,89,89,0,0,"AMAIUR",55
31,"31171",738,521,495,7,26,"AMAIUR",57
31,"31214",95,64,64,1,0,"AMAIUR",16
20,"20030",22191,15262,15148,164,114,"AMAIUR",4087
31,"31127",145,89,89,2,0,"AMAIUR",26
31,"31118",182,114,114,6,0,"AMAIUR",13
31,"31043",42,30,30,1,0,"AMAIUR",0
48,"48062",317,263,262,1,1,"AMAIUR",111
31,"31151",77,49,49,2,0,"AMAIUR",7
20,"20905",142,105,103,1,2,"AMAIUR",70
31,"31133",48,34,34,3,0,"AMAIUR",14
48,"48068",1577,1224,1213,4,11,"AMAIUR",418
20,"20044",368,258,257,1,1,"AMAIUR",149
31,"31906",2493,1796,1770,57,26,"AMAIUR",251
48,"48904",3510,2682,2665,26,17,"AMAIUR",472
1,"1011",245,189,185,7,4,"AMAIUR",8
31,"31114",384,320,318,37,2,"AMAIUR",39
48,"48042",1401,1116,1099,15,17,"AMAIUR",150
31,"31042",2719,2100,2057,27,43,"AMAIUR",15
48,"48901",4370,3156,3124,46,32,"AMAIUR",477
31,"31123",652,379,373,8,6,"AMAIUR",123
31,"31105",1619,1306,1284,30,22,"AMAIUR",21
20,"20051",7033,4843,4779,57,64,"AMAIUR",1829
31,"31233",103,87,82,2,5,"AMAIUR",6
48,"48092",792,603,600,5,3,"AMAIUR",151
31,"31198",38,33,33,0,0,"AMAIUR",14
31,"31097",10461,7152,7029,129,123,"AMAIUR",1134
31,"31195",186,127,126,1,1,"AMAIUR",55
48,"48019",3741,2613,2595,24,18,"AMAIUR",826
48,"48008",600,432,428,3,4,"AMAIUR",92
31,"31022",544,378,369,1,9,"AMAIUR",238
20,"20050",293,213,211,3,2,"AMAIUR",151
48,"48088",148,110,109,0,1,"AMAIUR",66
48,"48913",1231,936,922,10,14,"AMAIUR",230
31,"31186",299,205,200,3,5,"AMAIUR",76
20,"20037",100,65,64,2,1,"AMAIUR",35
1,"1062",333,236,232,5,4,"AMAIUR",23
48,"48011",9742,6697,6628,82,69,"AMAIUR",1469
31,"31030",155,113,112,3,1,"AMAIUR",37
48,"48013",81335,54452,53803,771,649,"AMAIUR",6681
31,"31191",2930,2194,2148,43,46,"AMAIUR",131
48,"48031",370,296,296,1,0,"AMAIUR",129
20,"20022",832,527,521,9,6,"AMAIUR",326
31,"31019",1858,1288,1266,25,22,"AMAIUR",471
31,"31126",372,247,244,6,3,"AMAIUR",113
48,"48086",2087,1432,1420,11,12,"AMAIUR",437
20,"20023",451,260,259,2,1,"AMAIUR",176
48,"48078",39866,27311,26995,311,316,"AMAIUR",3453
20,"20029",4283,3014,2998,26,16,"AMAIUR",1494
31,"31136",438,283,283,10,0,"AMAIUR",91
31,"31163",2008,1458,1434,22,24,"AMAIUR",59
1,"1057",266,212,212,2,0,"AMAIUR",60
31,"31243",313,227,223,5,4,"AMAIUR",47
31,"31264",173,110,108,1,2,"AMAIUR",39
31,"31104",1990,1374,1355,20,19,"AMAIUR",103
20,"20903",3625,2282,2267,52,15,"AMAIUR",1089
1,"1044",242,174,173,1,1,"AMAIUR",43
31,"31067",1982,1400,1363,28,37,"AMAIUR",54
20,"20053",4830,2895,2868,36,27,"AMAIUR",1452
1,"1001",2010,1362,1336,26,26,"AMAIUR",321
48,"48029",8022,5488,5409,83,79,"AMAIUR",638
1,"1009",1296,876,863,9,13,"AMAIUR",369
20,"20021",216,122,122,0,0,"AMAIUR",85
31,"31173",881,754,733,12,21,"AMAIUR",8
31,"31197",69,58,57,1,1,"AMAIUR",3
48,"48908",242,194,194,1,0,"AMAIUR",83
31,"31250",2887,1827,1802,20,25,"AMAIUR",707
48,"48915",362,273,271,2,2,"AMAIUR",147
20,"20057",194,122,122,0,0,"AMAIUR",86
31,"31217",382,256,244,5,12,"AMAIUR",34
31,"31021",75,52,52,0,0,"AMAIUR",16
31,"31155",264,187,183,7,4,"AMAIUR",9
48,"48090",6153,4682,4571,40,111,"AMAIUR",718
31,"31230",118,88,85,1,3,"AMAIUR",8
20,"20059",8816,6335,6293,32,42,"AMAIUR",3320
31,"31060",12916,8830,8687,158,143,"AMAIUR",1513
31,"31158",264,174,173,1,1,"AMAIUR",52
48,"48093",893,707,695,1,12,"AMAIUR",276
31,"31062",1103,849,832,7,17,"AMAIUR",15
31,"31150",234,163,162,5,1,"AMAIUR",56
48,"48033",223,171,171,1,0,"AMAIUR",75
31,"31006",1988,1434,1395,22,39,"AMAIUR",27
31,"31079",99,64,63,0,1,"AMAIUR",5
20,"20080",8104,5497,5454,52,43,"AMAIUR",1412
20,"20011",1700,1265,1258,11,7,"AMAIUR",698
31,"31263",241,135,132,0,3,"AMAIUR",82
31,"31084",1949,1369,1361,11,8,"AMAIUR",837
31,"31260",1263,788,780,11,8,"AMAIUR",165
31,"31902",3722,2670,2632,77,38,"AMAIUR",353
1,"1051",3662,2242,2210,26,32,"AMAIUR",794
20,"20035",497,346,344,1,2,"AMAIUR",217
20,"20043",1782,1220,1214,13,6,"AMAIUR",662
48,"48050",216,173,172,0,1,"AMAIUR",102
31,"31168",247,165,163,0,2,"AMAIUR",28
31,"31040",197,137,135,2,2,"AMAIUR",40
31,"31185",541,377,374,2,3,"AMAIUR",103
31,"31223",1043,783,771,14,12,"AMAIUR",115
31,"31050",6253,4045,3987,74,58,"AMAIUR",1356
48,"48912",2340,1794,1776,22,18,"AMAIUR",439
31,"31131",841,610,594,12,16,"AMAIUR",80
48,"48016",5214,3782,3736,46,46,"AMAIUR",862
31,"31077",5349,4025,3917,103,108,"AMAIUR",79
31,"31049",733,479,479,4,0,"AMAIUR",289
31,"31070",2706,1949,1912,34,37,"AMAIUR",94
20,"20063",7889,5381,5340,48,41,"AMAIUR",3463
33,"33044",180964,129466,128346,1888,1120,"ANDECHA",214
33,"33059",5049,3480,3447,37,33,"ANDECHA",3
33,"33043",710,529,528,1,1,"ANDECHA",0
33,"33028",1466,812,806,5,6,"ANDECHA",0
33,"33008",1934,1474,1459,11,15,"ANDECHA",1
33,"33010",1922,1284,1277,14,7,"ANDECHA",0
33,"33061",446,260,259,1,1,"ANDECHA",0
33,"33027",929,617,613,5,4,"ANDECHA",0
33,"33058",1863,1307,1286,11,21,"ANDECHA",2
33,"33048",169,120,120,1,0,"ANDECHA",0
33,"33073",9341,5825,5773,69,52,"ANDECHA",3
33,"33046",546,429,421,3,8,"ANDECHA",0
33,"33020",13542,9300,9173,135,127,"ANDECHA",18
33,"33009",951,673,663,7,10,"ANDECHA",5
33,"33035",11413,8105,8035,104,70,"ANDECHA",14
33,"33002",10837,7667,7588,77,79,"ANDECHA",10
33,"33066",42885,29326,29013,460,313,"ANDECHA",82
33,"33006",1674,1130,1120,10,10,"ANDECHA",6
33,"33018",2971,2139,2121,32,18,"ANDECHA",2
33,"33023",3410,2501,2485,40,16,"ANDECHA",0
33,"33017",3289,2378,2350,35,28,"ANDECHA",1
33,"33057",1635,1150,1132,16,18,"ANDECHA",2
33,"33072",1737,1171,1159,11,12,"ANDECHA",3
33,"33069",3611,2615,2597,25,18,"ANDECHA",0
33,"33013",466,349,345,4,4,"ANDECHA",0
33,"33003",737,475,471,6,4,"ANDECHA",0
33,"33016",19516,14345,14210,198,135,"ANDECHA",21
33,"33039",1719,1325,1319,14,6,"ANDECHA",3
33,"33062",452,282,281,3,1,"ANDECHA",0
33,"33068",1224,704,703,5,1,"ANDECHA",1
33,"33012",5341,3816,3777,43,39,"ANDECHA",1
33,"33047",1178,939,931,2,8,"ANDECHA",1
33,"33026",9144,6019,5959,87,60,"ANDECHA",6
33,"33011",12085,7186,7116,89,70,"ANDECHA",5
33,"33067",802,650,639,12,11,"ANDECHA",3
33,"33024",229816,164603,163179,2100,1424,"ANDECHA",275
33,"33064",237,175,173,1,2,"ANDECHA",0
33,"33031",38090,25034,24730,380,304,"ANDECHA",47
33,"33001",1772,984,971,14,13,"ANDECHA",0
33,"33021",4932,3544,3502,45,42,"ANDECHA",9
33,"33022",992,709,696,12,13,"ANDECHA",0
33,"33032",12060,8627,8491,107,136,"ANDECHA",15
33,"33055",1589,1212,1192,16,20,"ANDECHA",0
33,"33042",4434,3172,3135,43,37,"ANDECHA",25
33,"33037",37135,25522,25262,291,260,"ANDECHA",48
33,"33071",671,528,523,4,5,"ANDECHA",0
33,"33051",7576,5379,5335,65,44,"ANDECHA",2
33,"33049",6806,4629,4581,70,48,"ANDECHA",6
33,"33019",3262,2283,2244,12,39,"ANDECHA",4
33,"33054",1780,1272,1263,8,9,"ANDECHA",5
33,"33004",69056,49228,48730,726,498,"ANDECHA",92
33,"33077",1351,938,931,7,7,"ANDECHA",0
33,"33075",305,191,190,0,1,"ANDECHA",0
33,"33036",11674,8695,8605,104,90,"ANDECHA",10
33,"33038",2442,1757,1725,14,32,"ANDECHA",6
33,"33050",653,406,402,0,4,"ANDECHA",0
33,"33005",1600,1084,1080,6,4,"ANDECHA",0
33,"33070",3481,2557,2521,33,36,"ANDECHA",1
33,"33052",758,526,518,2,8,"ANDECHA",0
33,"33025",9455,6331,6277,84,54,"ANDECHA",6
33,"33063",467,367,363,4,4,"ANDECHA",1
33,"33029",420,243,241,3,2,"ANDECHA",0
33,"33007",1680,1186,1179,10,7,"ANDECHA",1
33,"33074",3699,2643,2611,30,32,"ANDECHA",0
33,"33030",921,682,668,4,14,"ANDECHA",0
33,"33014",9318,6380,6320,66,60,"ANDECHA",14
33,"33078",159,108,106,1,2,"ANDECHA",0
33,"33076",12662,8733,8670,120,63,"ANDECHA",23
33,"33040",4702,3285,3236,44,49,"ANDECHA",9
33,"33033",10609,7179,7107,91,72,"ANDECHA",13
33,"33053",1206,817,811,6,6,"ANDECHA",0
33,"33056",5278,3576,3540,41,36,"ANDECHA",6
33,"33065",1150,791,784,16,7,"ANDECHA",1
33,"33034",11390,7583,7501,85,82,"ANDECHA",2
33,"33015",1695,1177,1161,12,16,"ANDECHA",0
33,"33060",15694,11036,10883,112,153,"ANDECHA",36
33,"33045",4692,3347,3297,42,50,"ANDECHA",7
33,"33041",7488,5356,5309,65,47,"ANDECHA",5
11,"11018",1528,1194,1178,9,16,"ANTICAPITALISTAS",0
19,"19108",117,97,95,0,2,"ANTICAPITALISTAS",0
9,"9065",152,137,137,1,0,"ANTICAPITALISTAS",0
39,"39014",943,706,700,9,6,"ANTICAPITALISTAS",1
49,"49243",117,85,85,0,0,"ANTICAPITALISTAS",1
28,"28172",7648,6130,6076,65,54,"ANTICAPITALISTAS",4
9,"9447",36,33,33,0,0,"ANTICAPITALISTAS",0
18,"18049",632,476,474,5,2,"ANTICAPITALISTAS",0
28,"28071",77,57,55,0,2,"ANTICAPITALISTAS",0
19,"19006",873,634,620,1,14,"ANTICAPITALISTAS",0
49,"49194",380,250,247,4,3,"ANTICAPITALISTAS",0
28,"28014",31360,23434,23133,203,301,"ANTICAPITALISTAS",12
9,"9077",38,26,25,0,1,"ANTICAPITALISTAS",0
39,"39092",1030,753,747,1,6,"ANTICAPITALISTAS",1
41,"41090",3488,2792,2751,22,41,"ANTICAPITALISTAS",2
18,"18177",463,285,281,4,4,"ANTICAPITALISTAS",0
49,"49136",347,249,247,6,2,"ANTICAPITALISTAS",0
39,"39005",1319,1048,1026,3,22,"ANTICAPITALISTAS",0
39,"39097",732,476,470,4,6,"ANTICAPITALISTAS",0
49,"49034",467,363,359,3,4,"ANTICAPITALISTAS",0
28,"28131",12664,9454,9342,100,112,"ANTICAPITALISTAS",19
39,"39023",6048,4795,4747,43,48,"ANTICAPITALISTAS",15
28,"28120",1259,946,931,11,15,"ANTICAPITALISTAS",2
28,"28150",2985,2363,2345,21,18,"ANTICAPITALISTAS",2
19,"19279",66,56,56,0,0,"ANTICAPITALISTAS",0
28,"28179",1385,1039,1027,10,12,"ANTICAPITALISTAS",1
28,"28181",20003,16133,15952,159,181,"ANTICAPITALISTAS",20
41,"41027",4061,2783,2752,28,31,"ANTICAPITALISTAS",0
18,"18132",3461,2797,2772,19,25,"ANTICAPITALISTAS",1
9,"9072",272,210,209,4,1,"ANTICAPITALISTAS",1
49,"49117",505,376,369,5,7,"ANTICAPITALISTAS",0
49,"49088",90,67,66,3,1,"ANTICAPITALISTAS",1
49,"49162",217,157,155,2,2,"ANTICAPITALISTAS",0
28,"28009",13466,10392,10286,102,106,"ANTICAPITALISTAS",7
19,"19160",944,600,593,6,7,"ANTICAPITALISTAS",3
39,"39075",140941,103308,102362,1364,946,"ANTICAPITALISTAS",113
9,"9241",198,159,158,5,1,"ANTICAPITALISTAS",0
9,"9410",3181,2079,2049,48,30,"ANTICAPITALISTAS",10
19,"19044",319,248,245,0,3,"ANTICAPITALISTAS",2
49,"49109",657,534,529,12,5,"ANTICAPITALISTAS",0
9,"9176",60,47,45,2,2,"ANTICAPITALISTAS",0
19,"19092",437,331,326,4,5,"ANTICAPITALISTAS",0
9,"9086",629,467,461,5,6,"ANTICAPITALISTAS",1
41,"41021",20767,14040,13822,240,218,"ANTICAPITALISTAS",14
19,"19219",18,12,12,0,0,"ANTICAPITALISTAS",0
9,"9382",33,30,30,0,0,"ANTICAPITALISTAS",0
9,"9311",70,51,51,0,0,"ANTICAPITALISTAS",0
19,"19152",674,505,498,2,7,"ANTICAPITALISTAS",0
41,"41082",3448,2827,2796,15,31,"ANTICAPITALISTAS",1
18,"18147",3742,2419,2386,20,33,"ANTICAPITALISTAS",2
49,"49205",429,313,309,10,4,"ANTICAPITALISTAS",0
49,"49207",279,206,204,2,2,"ANTICAPITALISTAS",0
49,"49174",131,97,97,1,0,"ANTICAPITALISTAS",0
9,"9480",106,87,87,0,0,"ANTICAPITALISTAS",0
28,"28110",1912,1492,1475,8,17,"ANTICAPITALISTAS",1
28,"28076",417,325,321,1,4,"ANTICAPITALISTAS",1
19,"19119",93,80,79,2,1,"ANTICAPITALISTAS",1
11,"11034",2381,1807,1784,19,23,"ANTICAPITALISTAS",0
49,"49018",341,281,279,5,2,"ANTICAPITALISTAS",0
18,"18141",484,326,325,1,1,"ANTICAPITALISTAS",0
9,"9298",90,74,74,1,0,"ANTICAPITALISTAS",0
49,"49220",161,122,118,5,4,"ANTICAPITALISTAS",0
41,"41083",1176,915,908,8,7,"ANTICAPITALISTAS",1
19,"19046",20318,15118,14892,219,226,"ANTICAPITALISTAS",30
49,"49084",306,234,234,8,0,"ANTICAPITALISTAS",0
9,"9407",31,27,27,0,0,"ANTICAPITALISTAS",0
41,"41009",1272,914,899,8,15,"ANTICAPITALISTAS",0
39,"39055",1130,881,869,10,12,"ANTICAPITALISTAS",0
4,"4080",194,169,168,1,1,"ANTICAPITALISTAS",0
9,"9362",219,185,184,2,1,"ANTICAPITALISTAS",0
28,"28134",55921,42676,42221,505,455,"ANTICAPITALISTAS",66
19,"19250",25,23,22,0,1,"ANTICAPITALISTAS",0
49,"49021",14682,10495,10296,194,199,"ANTICAPITALISTAS",10
19,"19050",21,19,19,0,0,"ANTICAPITALISTAS",0
19,"19197",29,19,19,0,0,"ANTICAPITALISTAS",0
9,"9035",336,255,251,3,4,"ANTICAPITALISTAS",0
49,"49224",161,114,112,2,2,"ANTICAPITALISTAS",0
18,"18185",608,484,479,2,5,"ANTICAPITALISTAS",0
49,"49273",217,144,144,0,0,"ANTICAPITALISTAS",0
39,"39008",13716,10396,10274,129,122,"ANTICAPITALISTAS",8
19,"19058",6455,5028,4933,63,95,"ANTICAPITALISTAS",7
19,"19216",143,112,105,2,7,"ANTICAPITALISTAS",0
49,"49165",72,63,63,0,0,"ANTICAPITALISTAS",1
49,"49031",150,128,127,2,1,"ANTICAPITALISTAS",0
9,"9236",41,38,37,0,1,"ANTICAPITALISTAS",0
9,"9209",4617,3269,3234,44,35,"ANTICAPITALISTAS",5
18,"18903",960,761,753,1,8,"ANTICAPITALISTAS",0
11,"11042",1232,933,922,4,11,"ANTICAPITALISTAS",0
28,"28011",437,318,315,2,3,"ANTICAPITALISTAS",0
4,"4047",2290,1956,1937,9,19,"ANTICAPITALISTAS",0
41,"41015",5263,3820,3752,34,68,"ANTICAPITALISTAS",3
11,"11008",16655,11309,11189,184,120,"ANTICAPITALISTAS",5
9,"9312",113,94,91,0,3,"ANTICAPITALISTAS",1
19,"19038",48,33,33,0,0,"ANTICAPITALISTAS",0
18,"18068",1456,1105,1088,13,17,"ANTICAPITALISTAS",0
18,"18087",187449,138136,136783,1548,1353,"ANTICAPITALISTAS",185
9,"9221",446,343,340,7,3,"ANTICAPITALISTAS",2
49,"49046",283,240,235,2,5,"ANTICAPITALISTAS",0
49,"49170",111,87,85,1,2,"ANTICAPITALISTAS",0
49,"49118",215,174,173,2,1,"ANTICAPITALISTAS",0
49,"49119",245,194,191,2,3,"ANTICAPITALISTAS",0
41,"41036",4053,2930,2899,29,31,"ANTICAPITALISTAS",3
19,"19291",1271,925,902,3,23,"ANTICAPITALISTAS",1
39,"39029",642,521,517,6,4,"ANTICAPITALISTAS",1
39,"39049",339,244,242,5,2,"ANTICAPITALISTAS",1
19,"19168",324,233,231,6,2,"ANTICAPITALISTAS",1
18,"18015",465,381,379,1,2,"ANTICAPITALISTAS",0
4,"4058",402,324,322,5,2,"ANTICAPITALISTAS",0
49,"49238",289,233,231,3,2,"ANTICAPITALISTAS",0
49,"49027",178,134,127,1,7,"ANTICAPITALISTAS",0
9,"9255",90,68,68,0,0,"ANTICAPITALISTAS",1
49,"49095",318,232,232,5,0,"ANTICAPITALISTAS",0
9,"9102",44,36,36,0,0,"ANTICAPITALISTAS",0
41,"41023",7901,6050,5972,45,78,"ANTICAPITALISTAS",0
18,"18029",1892,1355,1347,6,8,"ANTICAPITALISTAS",0
9,"9074",735,558,547,7,11,"ANTICAPITALISTAS",1
39,"39071",463,358,358,2,0,"ANTICAPITALISTAS",0
39,"39056",2387,1857,1835,22,22,"ANTICAPITALISTAS",2
18,"18082",912,691,683,8,8,"ANTICAPITALISTAS",0
18,"18148",874,714,706,6,8,"ANTICAPITALISTAS",0
9,"9143",24,14,14,1,0,"ANTICAPITALISTAS",1
9,"9088",77,40,40,0,0,"ANTICAPITALISTAS",1
9,"9013",48,41,41,1,0,"ANTICAPITALISTAS",0
4,"4057",1454,1081,1071,1,10,"ANTICAPITALISTAS",0
28,"28050",3576,2706,2663,21,43,"ANTICAPITALISTAS",0
4,"4036",246,205,204,1,1,"ANTICAPITALISTAS",0
28,"28125",2808,2077,2055,19,22,"ANTICAPITALISTAS",2
28,"28022",30019,24469,24279,292,190,"ANTICAPITALISTAS",21
39,"39059",8476,6365,6284,73,81,"ANTICAPITALISTAS",4
9,"9166",97,87,87,1,0,"ANTICAPITALISTAS",0
28,"28140",2665,2167,2141,26,26,"ANTICAPITALISTAS",0
18,"18042",425,344,342,2,2,"ANTICAPITALISTAS",1
4,"4086",1903,1376,1371,11,5,"ANTICAPITALISTAS",0
18,"18192",1581,1331,1318,6,13,"ANTICAPITALISTAS",0
9,"9337",126,88,87,1,1,"ANTICAPITALISTAS",0
49,"49226",279,235,233,1,2,"ANTICAPITALISTAS",0
49,"49166",1294,1003,988,29,15,"ANTICAPITALISTAS",3
11,"11027",67042,43386,43065,557,321,"ANTICAPITALISTAS",47
9,"9173",135,116,116,1,0,"ANTICAPITALISTAS",0
19,"19322",35,28,27,1,1,"ANTICAPITALISTAS",0
18,"18056",3695,2961,2940,25,21,"ANTICAPITALISTAS",2
49,"49057",125,98,94,1,4,"ANTICAPITALISTAS",1
49,"49189",228,151,150,3,1,"ANTICAPITALISTAS",0
41,"41078",2587,1979,1970,15,9,"ANTICAPITALISTAS",1
19,"19153",25,17,17,0,0,"ANTICAPITALISTAS",1
9,"9317",17,15,15,0,0,"ANTICAPITALISTAS",0
18,"18153",8348,6170,6118,88,52,"ANTICAPITALISTAS",8
28,"28019",1195,901,888,5,13,"ANTICAPITALISTAS",1
9,"9131",412,332,321,6,11,"ANTICAPITALISTAS",0
49,"49014",134,104,102,1,2,"ANTICAPITALISTAS",0
49,"49094",276,180,180,2,0,"ANTICAPITALISTAS",2
19,"19156",1032,782,762,4,20,"ANTICAPITALISTAS",0
28,"28080",45696,36832,36529,402,303,"ANTICAPITALISTAS",38
4,"4083",1933,1511,1497,16,14,"ANTICAPITALISTAS",0
9,"9213",370,260,260,5,0,"ANTICAPITALISTAS",0
19,"19130",58473,45114,44362,688,752,"ANTICAPITALISTAS",72
19,"19175",39,31,31,0,0,"ANTICAPITALISTAS",0
4,"4027",260,186,186,0,0,"ANTICAPITALISTAS",0
28,"28061",19624,15082,14905,162,177,"ANTICAPITALISTAS",15
18,"18016",339,254,253,2,1,"ANTICAPITALISTAS",2
39,"39051",73,62,62,2,0,"ANTICAPITALISTAS",0
18,"18039",3733,2901,2878,18,23,"ANTICAPITALISTAS",0
39,"39060",6723,5453,5360,56,93,"ANTICAPITALISTAS",3
9,"9390",645,522,518,9,4,"ANTICAPITALISTAS",0
9,"9169",96,80,80,1,0,"ANTICAPITALISTAS",0
19,"19307",30,27,27,0,0,"ANTICAPITALISTAS",0
49,"49122",701,542,534,7,8,"ANTICAPITALISTAS",1
49,"49229",134,99,99,2,0,"ANTICAPITALISTAS",0
11,"11020",163674,106898,106082,1655,816,"ANTICAPITALISTAS",117
19,"19215",206,170,166,0,4,"ANTICAPITALISTAS",0
49,"49272",102,87,86,0,1,"ANTICAPITALISTAS",0
9,"9226",74,57,57,0,0,"ANTICAPITALISTAS",0
39,"39054",4265,3338,3276,57,62,"ANTICAPITALISTAS",0
28,"28157",605,452,446,2,6,"ANTICAPITALISTAS",2
28,"28169",1244,971,962,8,9,"ANTICAPITALISTAS",1
19,"19116",16,10,10,0,0,"ANTICAPITALISTAS",0
19,"19020",52,39,39,3,0,"ANTICAPITALISTAS",0
4,"4002",1146,891,884,1,7,"ANTICAPITALISTAS",0
41,"41038",96442,66696,65945,1021,751,"ANTICAPITALISTAS",77
18,"18174",470,368,363,1,5,"ANTICAPITALISTAS",0
11,"11039",9943,6634,6582,104,52,"ANTICAPITALISTAS",11
18,"18150",6452,4666,4625,56,41,"ANTICAPITALISTAS",2
18,"18061",1109,882,869,1,13,"ANTICAPITALISTAS",0
9,"9225",95,61,61,3,0,"ANTICAPITALISTAS",0
41,"41086",15877,10246,10150,146,96,"ANTICAPITALISTAS",19
19,"19334",50,37,37,0,0,"ANTICAPITALISTAS",0
28,"28138",78,48,46,0,2,"ANTICAPITALISTAS",0
49,"49127",2227,1617,1587,48,30,"ANTICAPITALISTAS",4
9,"9289",1540,1127,1117,16,10,"ANTICAPITALISTAS",1
41,"41024",22383,15333,15160,213,173,"ANTICAPITALISTAS",12
9,"9217",389,273,270,8,3,"ANTICAPITALISTAS",0
49,"49050",558,382,375,3,7,"ANTICAPITALISTAS",0
49,"49155",105,85,85,0,0,"ANTICAPITALISTAS",0
18,"18048",2277,1705,1688,19,17,"ANTICAPITALISTAS",1
28,"28013",38226,27886,27547,246,339,"ANTICAPITALISTAS",21
49,"49030",96,78,77,2,1,"ANTICAPITALISTAS",0
4,"4050",818,611,602,5,9,"ANTICAPITALISTAS",2
9,"9064",353,277,277,6,0,"ANTICAPITALISTAS",1
39,"39057",2298,1735,1719,17,16,"ANTICAPITALISTAS",0
19,"19311",87,60,60,0,0,"ANTICAPITALISTAS",0
41,"41055",15121,11082,10997,98,85,"ANTICAPITALISTAS",3
18,"18154",1062,770,769,0,1,"ANTICAPITALISTAS",0
28,"28183",935,663,649,7,14,"ANTICAPITALISTAS",2
9,"9266",87,72,72,0,0,"ANTICAPITALISTAS",0
49,"49160",54,35,34,3,1,"ANTICAPITALISTAS",0
9,"9108",399,287,283,5,4,"ANTICAPITALISTAS",1
49,"49247",507,340,332,6,8,"ANTICAPITALISTAS",0
19,"19229",83,71,68,0,3,"ANTICAPITALISTAS",0
19,"19330",93,81,81,2,0,"ANTICAPITALISTAS",0
9,"9408",45,36,36,0,0,"ANTICAPITALISTAS",0
19,"19121",277,219,217,0,2,"ANTICAPITALISTAS",0
49,"49190",81,65,64,2,1,"ANTICAPITALISTAS",1
49,"49029",675,553,542,6,11,"ANTICAPITALISTAS",1
41,"41094",6089,4757,4680,47,77,"ANTICAPITALISTAS",2
9,"9392",51,42,42,1,0,"ANTICAPITALISTAS",0
39,"39020",23947,15404,15122,267,282,"ANTICAPITALISTAS",33
41,"41093",17665,13712,13526,179,186,"ANTICAPITALISTAS",28
9,"9478",53,41,41,1,0,"ANTICAPITALISTAS",0
9,"9119",51,38,38,0,0,"ANTICAPITALISTAS",0
9,"9113",503,397,390,7,7,"ANTICAPITALISTAS",1
41,"41901",2626,2190,2167,24,23,"ANTICAPITALISTAS",1
19,"19036",279,238,236,1,2,"ANTICAPITALISTAS",0
28,"28045",30286,23148,22879,226,269,"ANTICAPITALISTAS",37
49,"49192",166,139,139,2,0,"ANTICAPITALISTAS",0
9,"9378",42,26,26,0,0,"ANTICAPITALISTAS",0
9,"9244",53,44,44,0,0,"ANTICAPITALISTAS",0
28,"28118",72,49,47,1,2,"ANTICAPITALISTAS",3
19,"19196",99,80,74,2,6,"ANTICAPITALISTAS",0
39,"39081",440,372,369,3,3,"ANTICAPITALISTAS",0
28,"28171",4148,2972,2929,21,43,"ANTICAPITALISTAS",3
18,"18027",2575,1913,1899,15,14,"ANTICAPITALISTAS",1
4,"4013",137455,94867,94142,1203,725,"ANTICAPITALISTAS",101
19,"19032",202,11,11,0,0,"ANTICAPITALISTAS",0
39,"39042",5928,4680,4634,44,46,"ANTICAPITALISTAS",3
19,"19047",87,71,70,2,1,"ANTICAPITALISTAS",0
28,"28008",1734,1244,1221,11,23,"ANTICAPITALISTAS",1
28,"28035",1314,1058,1046,3,12,"ANTICAPITALISTAS",0
49,"49199",266,214,211,1,3,"ANTICAPITALISTAS",1
18,"18094",2398,1882,1868,16,14,"ANTICAPITALISTAS",3
4,"4097",299,229,227,0,2,"ANTICAPITALISTAS",0
19,"19002",99,77,76,0,1,"ANTICAPITALISTAS",2
18,"18909",668,536,534,2,2,"ANTICAPITALISTAS",0
18,"18108",892,674,673,2,1,"ANTICAPITALISTAS",0
19,"19244",95,82,82,6,0,"ANTICAPITALISTAS",0
9,"9389",77,66,66,0,0,"ANTICAPITALISTAS",0
28,"28034",356,278,276,1,2,"ANTICAPITALISTAS",1
19,"19138",298,223,219,3,4,"ANTICAPITALISTAS",0
28,"28040",15089,9976,9852,116,124,"ANTICAPITALISTAS",16
19,"19125",54,42,42,2,0,"ANTICAPITALISTAS",0
4,"4901",576,427,426,5,1,"ANTICAPITALISTAS",0
28,"28007",122891,95200,94139,990,1061,"ANTICAPITALISTAS",111
9,"9906",1199,912,903,12,9,"ANTICAPITALISTAS",3
49,"49062",142,104,104,1,0,"ANTICAPITALISTAS",0
41,"41031",1319,879,875,6,4,"ANTICAPITALISTAS",1
19,"19326",1125,800,786,10,14,"ANTICAPITALISTAS",0
19,"19329",62,52,50,0,2,"ANTICAPITALISTAS",0
39,"39040",4350,3413,3373,30,40,"ANTICAPITALISTAS",1
28,"28115",57612,46786,46458,458,328,"ANTICAPITALISTAS",56
9,"9398",92,68,68,2,0,"ANTICAPITALISTAS",0
49,"49041",443,337,334,7,3,"ANTICAPITALISTAS",0
19,"19021",1129,818,800,10,18,"ANTICAPITALISTAS",0
28,"28111",618,486,479,2,7,"ANTICAPITALISTAS",1
18,"18170",377,238,237,0,1,"ANTICAPITALISTAS",1
9,"9438",547,440,433,9,7,"ANTICAPITALISTAS",1
9,"9483",226,173,171,4,2,"ANTICAPITALISTAS",0
9,"9060",171,142,142,0,0,"ANTICAPITALISTAS",0
49,"49258",127,107,104,0,3,"ANTICAPITALISTAS",0
9,"9396",152,113,113,0,0,"ANTICAPITALISTAS",0
28,"28173",507,397,390,2,7,"ANTICAPITALISTAS",0
28,"28145",2125,1643,1620,15,23,"ANTICAPITALISTAS",1
9,"9904",548,412,407,7,5,"ANTICAPITALISTAS",0
19,"19022",673,501,496,4,5,"ANTICAPITALISTAS",1
41,"41057",299,191,189,0,2,"ANTICAPITALISTAS",0
39,"39025",8985,7048,6955,70,93,"ANTICAPITALISTAS",8
19,"19095",14,9,8,0,1,"ANTICAPITALISTAS",0
19,"19151",1126,849,830,3,19,"ANTICAPITALISTAS",2
9,"9249",54,44,42,1,2,"ANTICAPITALISTAS",0
11,"11033",19983,12960,12807,199,153,"ANTICAPITALISTAS",15
18,"18128",361,284,283,5,1,"ANTICAPITALISTAS",0
19,"19001",64,56,56,1,0,"ANTICAPITALISTAS",0
9,"9463",261,205,205,1,0,"ANTICAPITALISTAS",0
19,"19203",35,27,27,0,0,"ANTICAPITALISTAS",0
9,"9369",460,339,336,4,3,"ANTICAPITALISTAS",4
49,"49266",83,69,69,1,0,"ANTICAPITALISTAS",0
4,"4019",269,210,209,3,1,"ANTICAPITALISTAS",2
41,"41064",5629,4041,4006,28,35,"ANTICAPITALISTAS",0
9,"9123",31,27,27,0,0,"ANTICAPITALISTAS",0
9,"9051",181,136,133,2,3,"ANTICAPITALISTAS",0
18,"18182",1982,1405,1397,6,8,"ANTICAPITALISTAS",0
18,"18063",1189,795,789,7,6,"ANTICAPITALISTAS",0
41,"41012",3115,2314,2271,29,43,"ANTICAPITALISTAS",0
4,"4049",4981,3652,3630,34,22,"ANTICAPITALISTAS",6
19,"19041",166,127,127,3,0,"ANTICAPITALISTAS",0
9,"9206",65,56,55,2,1,"ANTICAPITALISTAS",0
18,"18168",864,613,605,4,8,"ANTICAPITALISTAS",0
39,"39024",2065,1616,1601,8,15,"ANTICAPITALISTAS",1
41,"41079",9349,7095,7001,71,94,"ANTICAPITALISTAS",2
41,"41035",1171,898,889,12,9,"ANTICAPITALISTAS",0
49,"49005",156,102,101,2,1,"ANTICAPITALISTAS",0
9,"9242",93,82,82,2,0,"ANTICAPITALISTAS",0
11,"11015",59476,38207,37898,501,309,"ANTICAPITALISTAS",43
28,"28170",2503,1744,1727,20,17,"ANTICAPITALISTAS",2
9,"9269",39,33,33,0,0,"ANTICAPITALISTAS",0
49,"49158",229,174,172,0,2,"ANTICAPITALISTAS",0
39,"39066",895,710,703,6,7,"ANTICAPITALISTAS",1
28,"28178",1017,799,791,11,8,"ANTICAPITALISTAS",0
9,"9400",340,253,249,4,4,"ANTICAPITALISTAS",0
19,"19259",37,32,32,0,0,"ANTICAPITALISTAS",0
18,"18004",818,601,594,2,7,"ANTICAPITALISTAS",0
11,"11001",4389,3110,3072,13,38,"ANTICAPITALISTAS",5
49,"49200",1011,789,771,6,18,"ANTICAPITALISTAS",1
9,"9041",27,27,27,0,0,"ANTICAPITALISTAS",0
9,"9183",58,47,46,1,1,"ANTICAPITALISTAS",0
18,"18011",4246,3195,3172,23,23,"ANTICAPITALISTAS",3
49,"49112",131,93,93,2,0,"ANTICAPITALISTAS",0
19,"19267",22,15,15,0,0,"ANTICAPITALISTAS",0
11,"11014",16318,11093,11031,144,62,"ANTICAPITALISTAS",18
9,"9253",108,95,94,4,1,"ANTICAPITALISTAS",0
49,"49239",723,506,495,12,11,"ANTICAPITALISTAS",0
49,"49271",221,178,176,2,2,"ANTICAPITALISTAS",1
19,"19299",94,75,75,0,0,"ANTICAPITALISTAS",0
9,"9120",46,35,34,1,1,"ANTICAPITALISTAS",0
19,"19017",87,70,70,0,0,"ANTICAPITALISTAS",0
49,"49121",382,270,270,1,0,"ANTICAPITALISTAS",0
19,"19247",171,125,118,6,7,"ANTICAPITALISTAS",0
18,"18099",1551,1217,1205,11,12,"ANTICAPITALISTAS",2
28,"28030",1591,1268,1230,12,38,"ANTICAPITALISTAS",2
18,"18144",779,592,590,3,2,"ANTICAPITALISTAS",2
28,"28174",1745,1233,1224,11,9,"ANTICAPITALISTAS",0
41,"41049",8898,6881,6812,95,69,"ANTICAPITALISTAS",2
9,"9323",71,44,44,2,0,"ANTICAPITALISTAS",1
49,"49007",387,289,289,4,0,"ANTICAPITALISTAS",0
19,"19233",108,93,90,2,3,"ANTICAPITALISTAS",1
49,"49206",948,706,692,15,14,"ANTICAPITALISTAS",0
19,"19199",24,21,21,0,0,"ANTICAPITALISTAS",0
39,"39083",1214,785,775,7,10,"ANTICAPITALISTAS",1
18,"18010",576,464,458,4,6,"ANTICAPITALISTAS",1
49,"49156",265,217,214,6,3,"ANTICAPITALISTAS",0
19,"19193",30,29,29,1,0,"ANTICAPITALISTAS",0
49,"49010",338,271,265,4,6,"ANTICAPITALISTAS",1
9,"9100",56,46,44,0,2,"ANTICAPITALISTAS",0
41,"41001",1642,1314,1302,10,12,"ANTICAPITALISTAS",0
19,"19230",438,317,309,4,8,"ANTICAPITALISTAS",1
49,"49141",397,289,286,7,3,"ANTICAPITALISTAS",4
9,"9366",99,67,65,1,2,"ANTICAPITALISTAS",1
28,"28066",7033,5439,5383,45,56,"ANTICAPITALISTAS",3
9,"9144",61,51,50,0,1,"ANTICAPITALISTAS",0
9,"9095",88,75,73,2,2,"ANTICAPITALISTAS",0
28,"28037",1598,1263,1250,10,13,"ANTICAPITALISTAS",0
19,"19170",214,139,138,0,1,"ANTICAPITALISTAS",1
9,"9437",298,249,247,5,2,"ANTICAPITALISTAS",0
4,"4085",453,384,383,0,1,"ANTICAPITALISTAS",0
39,"39084",873,647,642,4,5,"ANTICAPITALISTAS",0
9,"9423",34,28,28,1,0,"ANTICAPITALISTAS",0
9,"9020",276,222,222,6,0,"ANTICAPITALISTAS",0
49,"49006",168,124,122,2,2,"ANTICAPITALISTAS",0
41,"41074",3079,2406,2386,14,20,"ANTICAPITALISTAS",0
28,"28112",168,138,137,0,1,"ANTICAPITALISTAS",0
9,"9148",95,75,75,2,0,"ANTICAPITALISTAS",4
28,"28135",928,665,659,6,6,"ANTICAPITALISTAS",2
41,"41903",6653,5134,5070,61,64,"ANTICAPITALISTAS",3
9,"9229",213,163,163,1,0,"ANTICAPITALISTAS",0
28,"28092",148714,112174,110838,1215,1336,"ANTICAPITALISTAS",121
49,"49012",73,43,43,0,0,"ANTICAPITALISTAS",0
18,"18045",1211,892,885,4,7,"ANTICAPITALISTAS",1
9,"9232",182,146,146,1,0,"ANTICAPITALISTAS",0
49,"49102",217,178,176,3,2,"ANTICAPITALISTAS",1
18,"18079",3497,2729,2706,15,23,"ANTICAPITALISTAS",0
9,"9358",261,200,199,3,1,"ANTICAPITALISTAS",0
49,"49103",435,354,350,6,4,"ANTICAPITALISTAS",0
49,"49237",157,110,110,0,0,"ANTICAPITALISTAS",0
9,"9415",290,192,192,4,0,"ANTICAPITALISTAS",2
9,"9152",273,207,207,1,0,"ANTICAPITALISTAS",0
18,"18101",8990,6659,6556,96,103,"ANTICAPITALISTAS",8
18,"18066",2072,1558,1552,8,6,"ANTICAPITALISTAS",0
49,"49252",370,310,305,6,5,"ANTICAPITALISTAS",0
4,"4102",12940,9247,9152,90,95,"ANTICAPITALISTAS",13
9,"9104",56,49,49,0,0,"ANTICAPITALISTAS",0
19,"19323",50,41,39,0,2,"ANTICAPITALISTAS",0
18,"18046",1960,1327,1312,5,15,"ANTICAPITALISTAS",1
11,"11024",6811,5241,5202,58,39,"ANTICAPITALISTAS",4
19,"19106",95,68,66,0,2,"ANTICAPITALISTAS",0
49,"49068",523,356,353,5,3,"ANTICAPITALISTAS",0
19,"19064",97,84,83,1,1,"ANTICAPITALISTAS",0
11,"11901",5576,4433,4398,69,35,"ANTICAPITALISTAS",1
19,"19023",121,95,94,5,1,"ANTICAPITALISTAS",0
18,"18053",1836,1345,1340,11,5,"ANTICAPITALISTAS",1
19,"19174",126,88,86,0,2,"ANTICAPITALISTAS",0
19,"19257",3595,2593,2543,48,50,"ANTICAPITALISTAS",0
9,"9138",92,77,74,0,3,"ANTICAPITALISTAS",0
9,"9055",55,46,44,0,2,"ANTICAPITALISTAS",0
19,"19202",16,14,14,0,0,"ANTICAPITALISTAS",0
4,"4048",1459,1110,1100,11,10,"ANTICAPITALISTAS",1
19,"19302",64,60,60,2,0,"ANTICAPITALISTAS",0
19,"19280",3415,2521,2490,27,31,"ANTICAPITALISTAS",5
9,"9059",137122,103909,102353,2008,1556,"ANTICAPITALISTAS",226
9,"9196",161,111,110,0,1,"ANTICAPITALISTAS",0
9,"9316",108,87,84,0,3,"ANTICAPITALISTAS",1
9,"9063",223,191,189,1,2,"ANTICAPITALISTAS",0
49,"49263",69,54,54,2,0,"ANTICAPITALISTAS",0
39,"39099",2987,2416,2391,28,25,"ANTICAPITALISTAS",0
19,"19901",43,34,34,0,0,"ANTICAPITALISTAS",0
41,"41081",28121,20027,19785,275,242,"ANTICAPITALISTAS",29
49,"49061",141,106,105,1,1,"ANTICAPITALISTAS",0
9,"9076",24,15,15,0,0,"ANTICAPITALISTAS",0
9,"9446",13,9,9,0,0,"ANTICAPITALISTAS",0
49,"49151",680,494,491,6,3,"ANTICAPITALISTAS",1
49,"49004",137,105,105,3,0,"ANTICAPITALISTAS",0
19,"19288",22,21,21,0,0,"ANTICAPITALISTAS",0
39,"39074",6785,5287,5233,50,54,"ANTICAPITALISTAS",5
19,"19251",41,35,34,0,1,"ANTICAPITALISTAS",0
28,"28006",74554,57439,56890,586,549,"ANTICAPITALISTAS",69
4,"4032",5476,3666,3643,34,23,"ANTICAPITALISTAS",3
9,"9332",137,88,85,1,3,"ANTICAPITALISTAS",0
28,"28095",1358,1092,1077,8,15,"ANTICAPITALISTAS",1
4,"4054",384,328,325,0,3,"ANTICAPITALISTAS",0
49,"49210",493,358,356,6,2,"ANTICAPITALISTAS",0
19,"19109",53,40,40,1,0,"ANTICAPITALISTAS",0
19,"19256",48,44,43,0,1,"ANTICAPITALISTAS",0
39,"39101",328,251,247,5,4,"ANTICAPITALISTAS",1
9,"9050",77,52,52,0,0,"ANTICAPITALISTAS",1
11,"11031",76347,49071,48616,681,455,"ANTICAPITALISTAS",102
9,"9109",1181,664,631,16,33,"ANTICAPITALISTAS",7
4,"4063",1199,871,862,6,9,"ANTICAPITALISTAS",2
9,"9374",96,85,81,3,4,"ANTICAPITALISTAS",0
49,"49168",96,78,78,1,0,"ANTICAPITALISTAS",0
19,"19314",46,41,41,0,0,"ANTICAPITALISTAS",0
49,"49169",42,34,33,1,1,"ANTICAPITALISTAS",0
9,"9318",63,38,38,0,0,"ANTICAPITALISTAS",0
11,"11010",6452,4534,4510,61,24,"ANTICAPITALISTAS",0
19,"19034",23,23,23,1,0,"ANTICAPITALISTAS",0
19,"19019",23,18,18,0,0,"ANTICAPITALISTAS",0
41,"41017",13878,10053,9926,130,127,"ANTICAPITALISTAS",15
4,"4004",458,367,364,6,3,"ANTICAPITALISTAS",1
19,"19225",879,625,618,9,7,"ANTICAPITALISTAS",1
9,"9172",129,110,109,2,1,"ANTICAPITALISTAS",0
9,"9288",98,80,80,1,0,"ANTICAPITALISTAS",1
19,"19007",460,351,345,5,6,"ANTICAPITALISTAS",0
18,"18152",1037,822,818,9,4,"ANTICAPITALISTAS",0
9,"9467",65,49,49,0,0,"ANTICAPITALISTAS",0
18,"18051",1196,857,852,4,5,"ANTICAPITALISTAS",0
19,"19258",103,81,81,0,0,"ANTICAPITALISTAS",0
19,"19086",1655,1310,1295,10,15,"ANTICAPITALISTAS",0
9,"9258",190,159,159,5,0,"ANTICAPITALISTAS",0
41,"41006",2743,1972,1957,13,15,"ANTICAPITALISTAS",2
4,"4053",12062,9283,9180,119,103,"ANTICAPITALISTAS",7
28,"28097",127,94,92,0,2,"ANTICAPITALISTAS",0
49,"49201",330,280,278,9,2,"ANTICAPITALISTAS",0
9,"9273",55,47,47,0,0,"ANTICAPITALISTAS",0
4,"4072",339,272,271,0,1,"ANTICAPITALISTAS",0
19,"19005",92,80,79,0,1,"ANTICAPITALISTAS",1
19,"19145",64,49,48,2,1,"ANTICAPITALISTAS",0
9,"9368",26,18,18,0,0,"ANTICAPITALISTAS",0
41,"41053",20729,16178,15971,142,207,"ANTICAPITALISTAS",12
18,"18135",4752,3252,3212,34,40,"ANTICAPITALISTAS",17
39,"39052",17031,13198,13034,187,164,"ANTICAPITALISTAS",10
9,"9386",61,45,45,0,0,"ANTICAPITALISTAS",0
28,"28074",136617,106248,105095,1101,1153,"ANTICAPITALISTAS",199
18,"18088",1576,1258,1253,2,5,"ANTICAPITALISTAS",2
49,"49227",295,238,237,5,1,"ANTICAPITALISTAS",1
41,"41051",2103,1705,1686,7,19,"ANTICAPITALISTAS",0
19,"19248",64,53,53,0,0,"ANTICAPITALISTAS",0
49,"49260",814,653,644,6,9,"ANTICAPITALISTAS",0
28,"28106",72603,53231,52524,681,707,"ANTICAPITALISTAS",47
9,"9228",168,143,143,3,0,"ANTICAPITALISTAS",1
28,"28102",913,700,693,9,7,"ANTICAPITALISTAS",1
11,"11007",17997,10781,10676,184,105,"ANTICAPITALISTAS",13
18,"18095",1916,1428,1306,21,122,"ANTICAPITALISTAS",0
9,"9021",62,33,33,1,0,"ANTICAPITALISTAS",0
9,"9365",38,27,27,0,0,"ANTICAPITALISTAS",0
18,"18902",950,769,762,6,7,"ANTICAPITALISTAS",0
39,"39096",719,521,518,4,3,"ANTICAPITALISTAS",0
49,"49011",236,195,194,5,1,"ANTICAPITALISTAS",0
41,"41034",22561,16014,15840,270,174,"ANTICAPITALISTAS",9
4,"4045",1877,1512,1497,23,15,"ANTICAPITALISTAS",1
4,"4031",2495,1942,1931,13,11,"ANTICAPITALISTAS",0
9,"9191",45,34,33,1,1,"ANTICAPITALISTAS",0
49,"49056",324,251,247,3,4,"ANTICAPITALISTAS",0
49,"49069",414,276,270,1,6,"ANTICAPITALISTAS",0
19,"19163",73,59,59,0,0,"ANTICAPITALISTAS",0
49,"49025",187,143,142,3,1,"ANTICAPITALISTAS",0
41,"41026",4273,3577,3538,15,39,"ANTICAPITALISTAS",5
9,"9388",32,25,24,2,1,"ANTICAPITALISTAS",0
49,"49026",236,189,184,3,5,"ANTICAPITALISTAS",0
9,"9164",179,130,130,1,0,"ANTICAPITALISTAS",0
9,"9429",64,44,44,2,0,"ANTICAPITALISTAS",0
9,"9208",252,192,192,6,0,"ANTICAPITALISTAS",1
9,"9907",1385,1053,1041,31,12,"ANTICAPITALISTAS",3
19,"19285",26,20,20,2,0,"ANTICAPITALISTAS",0
19,"19037",153,128,128,0,0,"ANTICAPITALISTAS",0
28,"28055",932,713,707,5,6,"ANTICAPITALISTAS",0
9,"9279",195,140,140,4,0,"ANTICAPITALISTAS",0
39,"39100",922,718,712,8,6,"ANTICAPITALISTAS",0
19,"19298",75,53,52,2,1,"ANTICAPITALISTAS",0
28,"28012",830,654,651,6,3,"ANTICAPITALISTAS",0
19,"19051",94,83,83,1,0,"ANTICAPITALISTAS",0
19,"19308",67,61,61,0,0,"ANTICAPITALISTAS",0
49,"49132",338,245,238,0,7,"ANTICAPITALISTAS",0
9,"9201",33,22,22,2,0,"ANTICAPITALISTAS",0
49,"49100",322,236,233,1,3,"ANTICAPITALISTAS",0
19,"19220",2225,1482,1456,7,26,"ANTICAPITALISTAS",2
28,"28177",9470,7524,7466,87,58,"ANTICAPITALISTAS",7
49,"49105",158,135,133,2,2,"ANTICAPITALISTAS",0
9,"9448",225,188,186,1,2,"ANTICAPITALISTAS",0
28,"28159",629,482,478,2,4,"ANTICAPITALISTAS",3
28,"28107",443,338,333,7,5,"ANTICAPITALISTAS",0
18,"18083",296,242,242,1,0,"ANTICAPITALISTAS",0
49,"49077",210,146,144,1,2,"ANTICAPITALISTAS",0
19,"19076",36,29,29,0,0,"ANTICAPITALISTAS",0
4,"4011",2814,2283,2263,25,20,"ANTICAPITALISTAS",2
19,"19155",61,52,50,1,2,"ANTICAPITALISTAS",0
18,"18070",287,240,239,2,1,"ANTICAPITALISTAS",0
19,"19277",22,17,17,0,0,"ANTICAPITALISTAS",0
19,"19042",41,32,32,0,0,"ANTICAPITALISTAS",0
49,"49257",277,180,179,0,1,"ANTICAPITALISTAS",0
28,"28126",59,37,37,0,0,"ANTICAPITALISTAS",0
41,"41054",671,556,550,0,6,"ANTICAPITALISTAS",2
19,"19243",53,39,39,0,0,"ANTICAPITALISTAS",0
4,"4082",309,216,214,3,2,"ANTICAPITALISTAS",0
4,"4012",230,195,195,2,0,"ANTICAPITALISTAS",0
4,"4034",152,106,105,1,1,"ANTICAPITALISTAS",0
19,"19118",17,13,13,0,0,"ANTICAPITALISTAS",0
49,"49079",110,93,92,2,1,"ANTICAPITALISTAS",0
11,"11036",725,484,482,10,2,"ANTICAPITALISTAS",0
18,"18194",2258,1656,1652,11,4,"ANTICAPITALISTAS",2
18,"18162",947,726,721,8,5,"ANTICAPITALISTAS",0
9,"9303",92,64,64,0,0,"ANTICAPITALISTAS",0
4,"4020",361,265,263,1,2,"ANTICAPITALISTAS",1
19,"19043",92,82,82,1,0,"ANTICAPITALISTAS",0
28,"28104",11704,9455,9361,119,94,"ANTICAPITALISTAS",15
49,"49022",319,266,261,3,5,"ANTICAPITALISTAS",0
49,"49235",486,344,340,6,4,"ANTICAPITALISTAS",2
19,"19213",72,60,60,1,0,"ANTICAPITALISTAS",1
18,"18119",1778,1401,1391,14,10,"ANTICAPITALISTAS",2
19,"19045",180,145,145,1,0,"ANTICAPITALISTAS",0
49,"49180",169,113,107,2,6,"ANTICAPITALISTAS",0
28,"28062",311,233,226,0,7,"ANTICAPITALISTAS",3
28,"28901",765,579,567,2,12,"ANTICAPITALISTAS",0
4,"4014",162,136,136,0,0,"ANTICAPITALISTAS",0
49,"49124",279,203,202,2,1,"ANTICAPITALISTAS",2
9,"9256",369,254,252,2,2,"ANTICAPITALISTAS",0
28,"28063",268,209,203,4,6,"ANTICAPITALISTAS",3
9,"9149",37,25,25,0,0,"ANTICAPITALISTAS",0
28,"28158",632,505,495,4,10,"ANTICAPITALISTAS",1
19,"19264",45,39,39,0,0,"ANTICAPITALISTAS",0
19,"19214",94,78,78,2,0,"ANTICAPITALISTAS",0
18,"18032",248,166,166,2,0,"ANTICAPITALISTAS",2
49,"49216",175,144,142,3,2,"ANTICAPITALISTAS",0
28,"28044",5403,4245,4188,27,57,"ANTICAPITALISTAS",4
28,"28151",3025,2237,2185,9,52,"ANTICAPITALISTAS",1
19,"19098",22,18,18,0,0,"ANTICAPITALISTAS",0
49,"49246",248,212,210,1,2,"ANTICAPITALISTAS",0
4,"4052",11567,8189,8124,158,65,"ANTICAPITALISTAS",13
9,"9902",491,363,357,4,6,"ANTICAPITALISTAS",2
18,"18001",288,212,212,1,0,"ANTICAPITALISTAS",0
49,"49125",1344,956,939,21,17,"ANTICAPITALISTAS",0
18,"18165",3942,2819,2776,27,43,"ANTICAPITALISTAS",2
19,"19303",56,48,47,1,1,"ANTICAPITALISTAS",0
28,"28152",14903,11954,11865,125,89,"ANTICAPITALISTAS",22
4,"4015",149,115,115,0,0,"ANTICAPITALISTAS",0
19,"19008",34,25,25,1,0,"ANTICAPITALISTAS",0
28,"28002",2650,2018,1993,24,25,"ANTICAPITALISTAS",2
19,"19073",24,20,19,0,1,"ANTICAPITALISTAS",0
41,"41058",16497,12415,12248,181,167,"ANTICAPITALISTAS",11
49,"49066",531,392,386,2,6,"ANTICAPITALISTAS",0
9,"9413",500,335,331,1,4,"ANTICAPITALISTAS",2
49,"49099",127,96,96,1,0,"ANTICAPITALISTAS",0
4,"4024",3049,2396,2361,19,35,"ANTICAPITALISTAS",5
19,"19150",128,112,108,0,4,"ANTICAPITALISTAS",0
4,"4065",387,320,318,1,2,"ANTICAPITALISTAS",1
18,"18057",5045,3755,3721,44,34,"ANTICAPITALISTAS",1
19,"19241",45,37,37,2,0,"ANTICAPITALISTAS",0
19,"19161",243,171,166,2,5,"ANTICAPITALISTAS",0
9,"9259",239,178,177,2,1,"ANTICAPITALISTAS",0
9,"9044",54,45,45,1,0,"ANTICAPITALISTAS",0
18,"18167",1927,1397,1380,13,17,"ANTICAPITALISTAS",0
28,"28060",1471,1205,1192,8,13,"ANTICAPITALISTAS",1
49,"49171",704,568,561,6,7,"ANTICAPITALISTAS",2
28,"28146",1672,1220,1205,4,15,"ANTICAPITALISTAS",0
19,"19294",27,26,26,1,0,"ANTICAPITALISTAS",0
19,"19123",40,34,34,0,0,"ANTICAPITALISTAS",0
9,"9395",164,134,133,1,1,"ANTICAPITALISTAS",1
39,"39015",898,692,688,7,4,"ANTICAPITALISTAS",1
39,"39021",536,448,444,1,4,"ANTICAPITALISTAS",0
11,"11019",1871,1449,1425,9,24,"ANTICAPITALISTAS",3
19,"19173",52,42,42,3,0,"ANTICAPITALISTAS",0
49,"49129",903,671,661,16,10,"ANTICAPITALISTAS",0
49,"49145",251,154,153,0,1,"ANTICAPITALISTAS",0
19,"19249",38,32,32,0,0,"ANTICAPITALISTAS",0
9,"9454",46,31,30,1,1,"ANTICAPITALISTAS",0
9,"9387",121,92,91,3,1,"ANTICAPITALISTAS",0
41,"41092",7649,5816,5738,39,78,"ANTICAPITALISTAS",3
9,"9085",486,348,339,8,9,"ANTICAPITALISTAS",0
18,"18034",510,377,375,2,2,"ANTICAPITALISTAS",0
28,"28033",3581,2712,2691,14,21,"ANTICAPITALISTAS",1
4,"4056",144,118,118,0,0,"ANTICAPITALISTAS",0
18,"18093",2580,1837,1820,8,17,"ANTICAPITALISTAS",0
19,"19240",64,47,46,1,1,"ANTICAPITALISTAS",0
18,"18035",1254,991,982,7,9,"ANTICAPITALISTAS",0
18,"18136",1973,1679,1668,5,11,"ANTICAPITALISTAS",0
4,"4067",657,526,524,1,2,"ANTICAPITALISTAS",0
9,"9163",642,526,518,3,8,"ANTICAPITALISTAS",1
19,"19061",76,57,55,3,2,"ANTICAPITALISTAS",0
9,"9373",485,332,331,5,1,"ANTICAPITALISTAS",2
39,"39063",1018,769,762,6,7,"ANTICAPITALISTAS",0
18,"18906",955,736,731,5,5,"ANTICAPITALISTAS",0
39,"39028",3513,2760,2718,23,42,"ANTICAPITALISTAS",1
9,"9132",174,129,127,3,2,"ANTICAPITALISTAS",0
9,"9430",18,15,15,0,0,"ANTICAPITALISTAS",0
39,"39011",1646,1295,1294,5,1,"ANTICAPITALISTAS",0
49,"49193",503,365,357,4,8,"ANTICAPITALISTAS",0
9,"9129",112,93,93,0,0,"ANTICAPITALISTAS",1
9,"9908",509,328,321,5,7,"ANTICAPITALISTAS",1
4,"4091",380,322,318,3,4,"ANTICAPITALISTAS",0
9,"9048",1565,1166,1148,20,18,"ANTICAPITALISTAS",1
19,"19115",41,26,26,1,0,"ANTICAPITALISTAS",0
49,"49131",312,227,225,7,2,"ANTICAPITALISTAS",0
49,"49104",383,281,276,2,5,"ANTICAPITALISTAS",0
9,"9010",35,27,27,1,0,"ANTICAPITALISTAS",0
9,"9078",41,37,35,0,2,"ANTICAPITALISTAS",0
18,"18037",488,408,404,0,4,"ANTICAPITALISTAS",0
11,"11006",24221,16564,16470,197,94,"ANTICAPITALISTAS",9
9,"9194",2033,1557,1535,28,22,"ANTICAPITALISTAS",3
49,"49096",188,149,146,2,3,"ANTICAPITALISTAS",0
18,"18149",5096,3949,3900,36,49,"ANTICAPITALISTAS",1
41,"41019",4528,3194,3168,41,26,"ANTICAPITALISTAS",1
4,"4081",367,312,309,0,3,"ANTICAPITALISTAS",0
49,"49148",213,144,143,0,1,"ANTICAPITALISTAS",2
18,"18161",220,180,178,0,2,"ANTICAPITALISTAS",0
28,"28070",139,98,97,0,1,"ANTICAPITALISTAS",1
18,"18193",13680,9874,9764,130,110,"ANTICAPITALISTAS",5
39,"39022",985,735,734,5,1,"ANTICAPITALISTAS",1
11,"11026",4834,3736,3691,27,45,"ANTICAPITALISTAS",2
28,"28087",3150,2475,2453,26,22,"ANTICAPITALISTAS",3
39,"39013",561,413,412,2,1,"ANTICAPITALISTAS",0
19,"19107",349,289,288,1,1,"ANTICAPITALISTAS",0
49,"49134",203,142,142,4,0,"ANTICAPITALISTAS",0
41,"41002",1510,1161,1140,4,21,"ANTICAPITALISTAS",0
11,"11017",3219,2403,2388,18,15,"ANTICAPITALISTAS",0
9,"9432",212,161,158,1,3,"ANTICAPITALISTAS",0
19,"19300",746,595,585,3,10,"ANTICAPITALISTAS",0
9,"9433",67,46,45,2,1,"ANTICAPITALISTAS",0
9,"9135",41,29,29,1,0,"ANTICAPITALISTAS",0
9,"9409",138,105,102,0,3,"ANTICAPITALISTAS",0
9,"9091",746,556,550,8,6,"ANTICAPITALISTAS",0
49,"49135",687,485,475,3,10,"ANTICAPITALISTAS",0
19,"19067",91,59,59,0,0,"ANTICAPITALISTAS",2
19,"19033",79,55,55,0,0,"ANTICAPITALISTAS",0
28,"28903",29222,23945,23689,296,256,"ANTICAPITALISTAS",29
28,"28064",143,112,110,1,2,"ANTICAPITALISTAS",0
18,"18076",880,676,676,3,0,"ANTICAPITALISTAS",0
28,"28047",38404,28739,28436,312,303,"ANTICAPITALISTAS",43
49,"49023",1033,736,728,10,8,"ANTICAPITALISTAS",0
19,"19134",22,14,14,0,0,"ANTICAPITALISTAS",0
28,"28088",251,174,173,5,1,"ANTICAPITALISTAS",0
18,"18020",1473,1111,1106,7,5,"ANTICAPITALISTAS",1
28,"28072",5232,4065,4007,35,58,"ANTICAPITALISTAS",5
9,"9215",426,290,287,1,3,"ANTICAPITALISTAS",0
19,"19169",51,35,35,0,0,"ANTICAPITALISTAS",0
41,"41041",9646,7901,7791,58,110,"ANTICAPITALISTAS",8
19,"19057",79,56,56,0,0,"ANTICAPITALISTAS",1
28,"28058",137542,103880,102686,1155,1194,"ANTICAPITALISTAS",98
9,"9227",131,100,100,1,0,"ANTICAPITALISTAS",0
9,"9133",39,33,33,1,0,"ANTICAPITALISTAS",0
49,"49275",53766,37940,37379,774,561,"ANTICAPITALISTAS",87
19,"19246",48,38,38,1,0,"ANTICAPITALISTAS",0
41,"41013",4762,3359,3327,9,32,"ANTICAPITALISTAS",0
9,"9272",319,225,225,5,0,"ANTICAPITALISTAS",0
49,"49181",386,308,307,2,1,"ANTICAPITALISTAS",0
49,"49111",144,117,116,10,1,"ANTICAPITALISTAS",0
28,"28073",11899,8877,8769,112,108,"ANTICAPITALISTAS",9
28,"28089",3531,2786,2753,25,33,"ANTICAPITALISTAS",3
9,"9199",97,75,74,0,1,"ANTICAPITALISTAS",1
9,"9243",87,66,64,2,2,"ANTICAPITALISTAS",0
49,"49048",162,119,119,2,0,"ANTICAPITALISTAS",0
19,"19181",69,54,54,5,0,"ANTICAPITALISTAS",0
19,"19071",7346,5380,5294,76,86,"ANTICAPITALISTAS",4
18,"18109",607,461,456,1,5,"ANTICAPITALISTAS",2
9,"9449",94,80,80,2,0,"ANTICAPITALISTAS",0
49,"49232",95,78,78,1,0,"ANTICAPITALISTAS",0
9,"9412",846,568,563,4,5,"ANTICAPITALISTAS",1
9,"9043",215,151,151,1,0,"ANTICAPITALISTAS",0
39,"39086",386,282,280,1,2,"ANTICAPITALISTAS",0
11,"11011",1685,1231,1216,8,15,"ANTICAPITALISTAS",10
49,"49098",242,177,175,4,2,"ANTICAPITALISTAS",0
18,"18033",282,227,226,0,1,"ANTICAPITALISTAS",0
19,"19087",22,16,16,0,0,"ANTICAPITALISTAS",0
49,"49184",190,135,133,1,2,"ANTICAPITALISTAS",0
49,"49008",535,395,394,7,1,"ANTICAPITALISTAS",0
18,"18043",140,89,87,1,2,"ANTICAPITALISTAS",0
19,"19186",93,77,77,0,0,"ANTICAPITALISTAS",0
19,"19278",30,28,28,0,0,"ANTICAPITALISTAS",0
28,"28005",132097,100509,99506,1069,1003,"ANTICAPITALISTAS",98
9,"9192",74,55,53,0,2,"ANTICAPITALISTAS",3
9,"9230",41,33,33,0,0,"ANTICAPITALISTAS",0
19,"19183",108,87,86,1,1,"ANTICAPITALISTAS",1
28,"28182",219,179,178,2,1,"ANTICAPITALISTAS",2
28,"28024",156,132,132,5,0,"ANTICAPITALISTAS",0
49,"49009",430,309,309,0,0,"ANTICAPITALISTAS",1
9,"9177",1154,823,815,12,8,"ANTICAPITALISTAS",1
9,"9190",97,73,72,0,1,"ANTICAPITALISTAS",0
9,"9058",357,278,276,4,2,"ANTICAPITALISTAS",0
49,"49157",177,140,140,0,0,"ANTICAPITALISTAS",0
11,"11038",13815,10849,10756,126,93,"ANTICAPITALISTAS",11
9,"9403",98,75,75,0,0,"ANTICAPITALISTAS",0
28,"28130",27391,21367,21111,235,256,"ANTICAPITALISTAS",18
9,"9007",66,50,50,0,0,"ANTICAPITALISTAS",0
28,"28004",5761,4098,4044,38,54,"ANTICAPITALISTAS",3
39,"39045",410,324,323,5,1,"ANTICAPITALISTAS",0
28,"28025",426,336,332,2,4,"ANTICAPITALISTAS",0
49,"49087",581,358,356,3,2,"ANTICAPITALISTAS",0
19,"19321",46,29,29,0,0,"ANTICAPITALISTAS",0
9,"9414",197,159,159,2,0,"ANTICAPITALISTAS",0
49,"49116",401,308,305,4,3,"ANTICAPITALISTAS",0
28,"28168",1144,821,810,15,11,"ANTICAPITALISTAS",0
49,"49204",85,64,64,0,0,"ANTICAPITALISTAS",0
9,"9405",143,106,105,2,1,"ANTICAPITALISTAS",2
18,"18179",583,417,409,7,8,"ANTICAPITALISTAS",0
9,"9276",420,275,245,5,30,"ANTICAPITALISTAS",2
19,"19284",11,11,11,0,0,"ANTICAPITALISTAS",0
19,"19124",420,293,291,3,2,"ANTICAPITALISTAS",1
18,"18114",678,508,508,6,0,"ANTICAPITALISTAS",1
19,"19185",40,21,19,0,2,"ANTICAPITALISTAS",0
9,"9343",94,77,76,0,1,"ANTICAPITALISTAS",0
19,"19114",40,34,34,0,0,"ANTICAPITALISTAS",0
49,"49146",330,268,265,6,3,"ANTICAPITALISTAS",0
41,"41102",14343,11050,10837,206,213,"ANTICAPITALISTAS",4
9,"9009",167,129,128,8,1,"ANTICAPITALISTAS",1
18,"18005",366,279,277,3,2,"ANTICAPITALISTAS",1
4,"4902",42901,28927,28711,338,216,"ANTICAPITALISTAS",50
9,"9114",88,75,73,0,2,"ANTICAPITALISTAS",0
49,"49234",439,336,332,5,4,"ANTICAPITALISTAS",0
19,"19102",122,101,100,0,1,"ANTICAPITALISTAS",0
39,"39072",375,234,234,4,0,"ANTICAPITALISTAS",1
9,"9103",247,201,200,2,1,"ANTICAPITALISTAS",0
49,"49225",172,130,129,0,1,"ANTICAPITALISTAS",1
19,"19040",73,42,42,1,0,"ANTICAPITALISTAS",0
39,"39037",2061,1609,1586,10,23,"ANTICAPITALISTAS",2
19,"19055",54,41,37,1,4,"ANTICAPITALISTAS",0
4,"4084",370,290,285,6,5,"ANTICAPITALISTAS",0
41,"41018",9457,6940,6867,66,73,"ANTICAPITALISTAS",3
41,"41071",5603,3999,3932,28,67,"ANTICAPITALISTAS",3
41,"41088",542,414,408,1,6,"ANTICAPITALISTAS",0
9,"9375",42,30,30,1,0,"ANTICAPITALISTAS",0
49,"49133",344,247,243,3,4,"ANTICAPITALISTAS",0
18,"18116",2972,2237,2213,19,24,"ANTICAPITALISTAS",2
49,"49149",422,305,303,6,2,"ANTICAPITALISTAS",0
39,"39030",1971,1397,1379,20,18,"ANTICAPITALISTAS",4
49,"49015",259,213,208,2,5,"ANTICAPITALISTAS",0
19,"19127",97,66,66,1,0,"ANTICAPITALISTAS",0
9,"9330",1562,1212,1176,10,36,"ANTICAPITALISTAS",2
9,"9105",111,85,81,2,4,"ANTICAPITALISTAS",0
9,"9377",658,509,505,11,4,"ANTICAPITALISTAS",0
41,"41020",12710,8954,8882,91,72,"ANTICAPITALISTAS",1
18,"18047",5603,3833,3805,67,28,"ANTICAPITALISTAS",6
19,"19252",90,80,78,0,2,"ANTICAPITALISTAS",0
4,"4103",1555,1159,1157,8,2,"ANTICAPITALISTAS",0
4,"4070",1649,1267,1255,9,12,"ANTICAPITALISTAS",1
28,"28164",2807,2194,2173,10,21,"ANTICAPITALISTAS",3
9,"9024",159,124,123,2,1,"ANTICAPITALISTAS",0
9,"9181",334,271,271,14,0,"ANTICAPITALISTAS",0
39,"39048",1616,1326,1308,8,18,"ANTICAPITALISTAS",0
4,"4071",452,364,363,1,1,"ANTICAPITALISTAS",0
9,"9283",63,36,36,0,0,"ANTICAPITALISTAS",0
19,"19081",43,33,33,0,0,"ANTICAPITALISTAS",0
19,"19189",136,99,97,0,2,"ANTICAPITALISTAS",0
9,"9197",160,129,128,3,1,"ANTICAPITALISTAS",0
9,"9214",724,477,467,4,10,"ANTICAPITALISTAS",1
11,"11002",4291,3388,3374,19,14,"ANTICAPITALISTAS",0
28,"28148",79726,60405,59651,724,754,"ANTICAPITALISTAS",83
18,"18159",1051,873,869,4,4,"ANTICAPITALISTAS",0
4,"4009",165,124,122,2,2,"ANTICAPITALISTAS",0
49,"49052",200,149,144,1,5,"ANTICAPITALISTAS",2
9,"9292",98,73,71,3,2,"ANTICAPITALISTAS",0
4,"4061",668,541,536,7,5,"ANTICAPITALISTAS",0
49,"49152",572,401,395,6,6,"ANTICAPITALISTAS",0
19,"19289",33,28,28,1,0,"ANTICAPITALISTAS",0
41,"41076",2227,1507,1492,5,15,"ANTICAPITALISTAS",0
9,"9068",25,19,19,2,0,"ANTICAPITALISTAS",0
4,"4051",476,406,400,3,6,"ANTICAPITALISTAS",0
18,"18040",246,147,146,0,1,"ANTICAPITALISTAS",1
9,"9154",150,107,107,3,0,"ANTICAPITALISTAS",0
39,"39006",1732,1381,1373,23,8,"ANTICAPITALISTAS",0
19,"19147",58,45,40,0,5,"ANTICAPITALISTAS",0
49,"49261",1579,1161,1145,36,16,"ANTICAPITALISTAS",1
4,"4003",17244,11933,11840,94,93,"ANTICAPITALISTAS",16
41,"41005",8792,6642,6585,71,57,"ANTICAPITALISTAS",3
9,"9216",390,278,272,2,6,"ANTICAPITALISTAS",0
49,"49033",761,563,556,9,7,"ANTICAPITALISTAS",0
18,"18050",1657,1209,1196,5,13,"ANTICAPITALISTAS",1
39,"39102",2330,1748,1731,13,17,"ANTICAPITALISTAS",1
49,"49065",1212,939,926,3,13,"ANTICAPITALISTAS",1
19,"19191",19,15,15,0,0,"ANTICAPITALISTAS",0
9,"9128",82,65,63,0,2,"ANTICAPITALISTAS",0
28,"28166",325,269,268,8,1,"ANTICAPITALISTAS",0
41,"41022",4281,3087,3066,15,21,"ANTICAPITALISTAS",3
19,"19192",1743,1370,1359,10,11,"ANTICAPITALISTAS",3
19,"19099",337,211,210,6,1,"ANTICAPITALISTAS",0
49,"49233",119,78,78,2,0,"ANTICAPITALISTAS",0
39,"39068",663,488,485,4,3,"ANTICAPITALISTAS",1
39,"39085",6722,5198,5134,60,64,"ANTICAPITALISTAS",4
28,"28059",4061,3169,3130,38,39,"ANTICAPITALISTAS",7
18,"18134",5528,3751,3679,57,72,"ANTICAPITALISTAS",4
4,"4064",2585,1817,1803,18,14,"ANTICAPITALISTAS",0
18,"18012",2693,1841,1831,11,10,"ANTICAPITALISTAS",0
9,"9022",83,58,58,2,0,"ANTICAPITALISTAS",0
9,"9445",46,31,31,1,0,"ANTICAPITALISTAS",0
19,"19178",45,34,34,0,0,"ANTICAPITALISTAS",0
49,"49114",51,34,33,1,1,"ANTICAPITALISTAS",0
9,"9345",134,102,102,1,0,"ANTICAPITALISTAS",0
39,"39002",3400,2554,2514,35,40,"ANTICAPITALISTAS",5
28,"28038",4999,3659,3590,32,69,"ANTICAPITALISTAS",6
19,"19048",18,12,11,1,1,"ANTICAPITALISTAS",0
4,"4006",7156,5175,5106,51,69,"ANTICAPITALISTAS",0
19,"19272",86,67,65,1,2,"ANTICAPITALISTAS",0
49,"49040",118,102,98,1,4,"ANTICAPITALISTAS",0
19,"19162",71,52,51,0,1,"ANTICAPITALISTAS",0
49,"49203",345,294,292,4,2,"ANTICAPITALISTAS",0
39,"39026",1825,1383,1371,12,12,"ANTICAPITALISTAS",2
49,"49249",78,63,63,0,0,"ANTICAPITALISTAS",0
28,"28116",666,507,498,5,9,"ANTICAPITALISTAS",0
4,"4055",418,368,367,5,1,"ANTICAPITALISTAS",0
11,"11041",9805,7136,7067,87,69,"ANTICAPITALISTAS",3
39,"39087",43561,33709,33242,404,467,"ANTICAPITALISTAS",38
49,"49265",143,105,105,1,0,"ANTICAPITALISTAS",0
18,"18089",15803,10794,10712,95,82,"ANTICAPITALISTAS",3
19,"19136",22,15,15,0,0,"ANTICAPITALISTAS",0
41,"41016",6950,5194,5120,45,74,"ANTICAPITALISTAS",5
18,"18024",882,696,688,12,8,"ANTICAPITALISTAS",0
41,"41025",1999,1502,1476,13,26,"ANTICAPITALISTAS",1
49,"49130",218,159,156,3,3,"ANTICAPITALISTAS",0
39,"39036",1023,802,790,5,12,"ANTICAPITALISTAS",0
9,"9220",82,60,60,2,0,"ANTICAPITALISTAS",0
4,"4089",805,607,597,1,10,"ANTICAPITALISTAS",0
28,"28100",3970,2903,2865,32,38,"ANTICAPITALISTAS",4
19,"19090",107,87,86,0,1,"ANTICAPITALISTAS",0
49,"49159",289,225,225,2,0,"ANTICAPITALISTAS",1
9,"9047",62,48,45,0,3,"ANTICAPITALISTAS",0
18,"18158",10328,7336,7254,69,82,"ANTICAPITALISTAS",5
49,"49251",191,157,154,7,3,"ANTICAPITALISTAS",0
11,"11023",9209,6979,6929,81,50,"ANTICAPITALISTAS",1
19,"19013",143,110,108,1,2,"ANTICAPITALISTAS",0
19,"19333",142,86,84,0,2,"ANTICAPITALISTAS",0
18,"18124",387,270,267,0,3,"ANTICAPITALISTAS",0
28,"28054",10459,7798,7698,65,100,"ANTICAPITALISTAS",9
19,"19143",1610,1287,1268,9,19,"ANTICAPITALISTAS",2
9,"9018",24688,17880,17508,345,372,"ANTICAPITALISTAS",46
28,"28067",3893,2996,2950,26,46,"ANTICAPITALISTAS",3
49,"49267",101,77,77,1,0,"ANTICAPITALISTAS",0
39,"39043",1321,1082,1072,8,10,"ANTICAPITALISTAS",0
28,"28122",504,367,366,2,1,"ANTICAPITALISTAS",0
28,"28132",10987,8066,7943,90,123,"ANTICAPITALISTAS",9
9,"9328",81,56,56,2,0,"ANTICAPITALISTAS",0
49,"49268",480,365,362,8,3,"ANTICAPITALISTAS",0
28,"28143",81,71,67,1,4,"ANTICAPITALISTAS",0
18,"18151",276,191,188,0,3,"ANTICAPITALISTAS",0
9,"9170",218,158,157,0,1,"ANTICAPITALISTAS",0
49,"49147",301,243,239,4,4,"ANTICAPITALISTAS",0
4,"4092",2897,2351,2325,13,26,"ANTICAPITALISTAS",6
39,"39047",1987,1495,1482,9,13,"ANTICAPITALISTAS",0
9,"9167",60,49,49,2,0,"ANTICAPITALISTAS",0
19,"19221",56,41,41,2,0,"ANTICAPITALISTAS",0
19,"19154",79,68,67,0,1,"ANTICAPITALISTAS",0
18,"18907",1997,1627,1612,5,15,"ANTICAPITALISTAS",0
9,"9023",993,771,765,22,6,"ANTICAPITALISTAS",2
41,"41095",40097,27969,27731,354,238,"ANTICAPITALISTAS",21
28,"28021",418,334,328,4,6,"ANTICAPITALISTAS",1
11,"11035",13266,8794,8668,115,126,"ANTICAPITALISTAS",13
19,"19126",1552,1140,1119,16,21,"ANTICAPITALISTAS",4
49,"49078",209,173,172,1,1,"ANTICAPITALISTAS",0
39,"39004",1593,1321,1305,9,16,"ANTICAPITALISTAS",0
19,"19167",136,112,109,4,3,"ANTICAPITALISTAS",0
41,"41028",1880,1479,1458,28,21,"ANTICAPITALISTAS",3
9,"9419",82,61,61,0,0,"ANTICAPITALISTAS",1
9,"9361",134,99,98,0,1,"ANTICAPITALISTAS",0
49,"49003",896,650,647,11,3,"ANTICAPITALISTAS",0
39,"39039",648,496,493,0,3,"ANTICAPITALISTAS",0
19,"19232",89,68,67,0,1,"ANTICAPITALISTAS",0
41,"41072",4083,3073,3046,12,27,"ANTICAPITALISTAS",0
9,"9347",136,113,109,5,4,"ANTICAPITALISTAS",0
19,"19054",184,156,151,2,5,"ANTICAPITALISTAS",0
19,"19265",157,102,101,0,1,"ANTICAPITALISTAS",0
39,"39031",1227,965,956,4,9,"ANTICAPITALISTAS",4
18,"18096",348,289,287,1,2,"ANTICAPITALISTAS",0
9,"9348",150,122,122,2,0,"ANTICAPITALISTAS",1
4,"4016",2184,1699,1677,15,22,"ANTICAPITALISTAS",1
19,"19209",50,40,39,0,1,"ANTICAPITALISTAS",0
19,"19024",7736,5738,5646,82,92,"ANTICAPITALISTAS",8
49,"49242",503,421,410,5,11,"ANTICAPITALISTAS",0
18,"18137",1057,875,868,8,7,"ANTICAPITALISTAS",0
18,"18036",3553,2762,2741,20,21,"ANTICAPITALISTAS",3
19,"19172",76,65,64,1,1,"ANTICAPITALISTAS",0
18,"18145",10083,7592,7499,78,93,"ANTICAPITALISTAS",7
28,"28057",1419,1084,1074,12,10,"ANTICAPITALISTAS",2
9,"9354",33,29,29,2,0,"ANTICAPITALISTAS",0
9,"9218",384,285,279,8,6,"ANTICAPITALISTAS",0
9,"9901",407,319,308,8,11,"ANTICAPITALISTAS",0
9,"9304",197,168,165,1,3,"ANTICAPITALISTAS",0
9,"9039",58,50,49,0,1,"ANTICAPITALISTAS",0
28,"28082",5144,3967,3905,46,62,"ANTICAPITALISTAS",7
19,"19097",28,27,27,0,0,"ANTICAPITALISTAS",0
28,"28127",60108,48418,48039,568,379,"ANTICAPITALISTAS",53
4,"4096",293,220,219,1,1,"ANTICAPITALISTAS",0
9,"9257",93,73,72,2,1,"ANTICAPITALISTAS",0
9,"9054",107,80,80,1,0,"ANTICAPITALISTAS",1
11,"11028",32224,20706,20482,359,224,"ANTICAPITALISTAS",41
9,"9182",104,81,81,1,0,"ANTICAPITALISTAS",0
28,"28036",2301,1809,1784,13,25,"ANTICAPITALISTAS",1
9,"9306",127,94,94,0,0,"ANTICAPITALISTAS",0
9,"9155",27,17,17,0,0,"ANTICAPITALISTAS",0
19,"19201",70,52,52,2,0,"ANTICAPITALISTAS",0
18,"18164",1881,1351,1342,16,9,"ANTICAPITALISTAS",1
28,"28128",366,280,275,2,5,"ANTICAPITALISTAS",0
9,"9056",4957,3607,3557,70,50,"ANTICAPITALISTAS",12
18,"18064",419,347,345,3,2,"ANTICAPITALISTAS",0
49,"49262",401,317,313,1,4,"ANTICAPITALISTAS",0
49,"49219",7742,5643,5562,87,81,"ANTICAPITALISTAS",6
19,"19111",180,147,146,0,1,"ANTICAPITALISTAS",0
19,"19133",103,89,88,2,1,"ANTICAPITALISTAS",0
28,"28136",618,527,516,2,11,"ANTICAPITALISTAS",0
9,"9017",96,76,74,0,2,"ANTICAPITALISTAS",0
18,"18912",1576,1193,1185,7,8,"ANTICAPITALISTAS",0
39,"39077",256,196,196,1,0,"ANTICAPITALISTAS",0
41,"41087",9827,7300,7150,51,150,"ANTICAPITALISTAS",4
4,"4001",1139,890,884,6,6,"ANTICAPITALISTAS",1
49,"49017",264,189,187,1,2,"ANTICAPITALISTAS",1
9,"9200",54,35,35,2,0,"ANTICAPITALISTAS",0
39,"39078",1407,1041,1033,10,8,"ANTICAPITALISTAS",0
49,"49248",224,183,180,4,3,"ANTICAPITALISTAS",0
9,"9223",46,40,40,0,0,"ANTICAPITALISTAS",1
19,"19091",30,22,22,2,0,"ANTICAPITALISTAS",0
49,"49185",171,140,140,3,0,"ANTICAPITALISTAS",0
39,"39098",1522,1256,1244,8,12,"ANTICAPITALISTAS",0
28,"28162",2263,1802,1786,32,16,"ANTICAPITALISTAS",0
18,"18102",8556,6358,6272,42,86,"ANTICAPITALISTAS",4
9,"9308",70,51,51,0,0,"ANTICAPITALISTAS",0
9,"9019",153,104,104,1,0,"ANTICAPITALISTAS",1
4,"4099",5086,4023,3980,26,43,"ANTICAPITALISTAS",4
9,"9231",77,42,42,0,0,"ANTICAPITALISTAS",0
28,"28099",1670,1258,1246,9,12,"ANTICAPITALISTAS",5
41,"41068",13809,10171,10072,100,99,"ANTICAPITALISTAS",5
18,"18044",208,132,132,4,0,"ANTICAPITALISTAS",0
41,"41100",1097,894,878,8,16,"ANTICAPITALISTAS",0
9,"9130",87,72,71,0,1,"ANTICAPITALISTAS",0
9,"9261",486,342,338,7,4,"ANTICAPITALISTAS",2
49,"49101",186,134,129,0,5,"ANTICAPITALISTAS",0
28,"28046",4208,3297,3272,31,25,"ANTICAPITALISTAS",2
49,"49223",770,606,601,8,5,"ANTICAPITALISTAS",2
18,"18078",768,638,637,1,1,"ANTICAPITALISTAS",0
9,"9248",63,52,52,0,0,"ANTICAPITALISTAS",1
11,"11032",53183,32205,31982,441,223,"ANTICAPITALISTAS",43
18,"18157",1062,793,783,9,10,"ANTICAPITALISTAS",0
9,"9117",82,59,59,1,0,"ANTICAPITALISTAS",0
19,"19270",17,16,16,0,0,"ANTICAPITALISTAS",0
9,"9442",385,295,289,4,6,"ANTICAPITALISTAS",1
49,"49039",333,243,240,6,3,"ANTICAPITALISTAS",0
9,"9428",124,107,107,1,0,"ANTICAPITALISTAS",0
41,"41101",5752,4663,4629,25,34,"ANTICAPITALISTAS",2
28,"28124",83,55,53,0,2,"ANTICAPITALISTAS",2
28,"28101",222,158,158,4,0,"ANTICAPITALISTAS",0
19,"19039",73,57,57,0,0,"ANTICAPITALISTAS",0
28,"28155",529,427,416,2,11,"ANTICAPITALISTAS",0
4,"4090",435,338,335,3,3,"ANTICAPITALISTAS",1
4,"4094",206,152,152,0,0,"ANTICAPITALISTAS",0
19,"19318",36,19,19,1,0,"ANTICAPITALISTAS",0
18,"18022",12448,8777,8659,111,118,"ANTICAPITALISTAS",11
9,"9061",187,146,144,1,2,"ANTICAPITALISTAS",0
28,"28117",116,90,90,1,0,"ANTICAPITALISTAS",0
39,"39034",289,209,209,3,0,"ANTICAPITALISTAS",0
11,"11021",6838,5102,5049,67,53,"ANTICAPITALISTAS",0
41,"41061",2205,1798,1770,2,28,"ANTICAPITALISTAS",0
9,"9353",62,51,51,2,0,"ANTICAPITALISTAS",0
19,"19282",210,157,157,0,0,"ANTICAPITALISTAS",0
28,"28165",1689,1310,1295,5,15,"ANTICAPITALISTAS",0
49,"49123",557,421,415,5,6,"ANTICAPITALISTAS",0
9,"9350",502,384,376,7,8,"ANTICAPITALISTAS",0
49,"49191",305,248,246,2,2,"ANTICAPITALISTAS",0
49,"49028",119,103,103,1,0,"ANTICAPITALISTAS",0
19,"19242",112,93,92,1,1,"ANTICAPITALISTAS",0
49,"49240",237,190,186,1,4,"ANTICAPITALISTAS",0
39,"39090",731,577,572,3,5,"ANTICAPITALISTAS",1
9,"9280",34,23,23,0,0,"ANTICAPITALISTAS",0
19,"19231",16,14,14,0,0,"ANTICAPITALISTAS",0
28,"28079",2290453,1721837,1705310,17342,16527,"ANTICAPITALISTAS",2291
19,"19079",7,7,7,0,0,"ANTICAPITALISTAS",0
4,"4022",375,296,295,0,1,"ANTICAPITALISTAS",0
19,"19176",280,216,216,0,0,"ANTICAPITALISTAS",0
49,"49270",156,112,112,6,0,"ANTICAPITALISTAS",0
19,"19066",78,63,62,0,1,"ANTICAPITALISTAS",0
19,"19142",259,191,190,0,1,"ANTICAPITALISTAS",0
19,"19065",126,100,100,3,0,"ANTICAPITALISTAS",1
19,"19335",77,61,61,1,0,"ANTICAPITALISTAS",0
18,"18017",17990,12070,11962,80,108,"ANTICAPITALISTAS",5
28,"28902",453,338,329,3,9,"ANTICAPITALISTAS",1
41,"41046",3055,2456,2418,23,38,"ANTICAPITALISTAS",2
18,"18107",988,769,760,3,9,"ANTICAPITALISTAS",0
41,"41080",1289,1010,997,13,13,"ANTICAPITALISTAS",1
49,"49179",401,285,284,2,1,"ANTICAPITALISTAS",3
18,"18105",5222,3866,3839,32,27,"ANTICAPITALISTAS",0
4,"4060",486,373,372,0,1,"ANTICAPITALISTAS",0
18,"18173",8858,6238,6187,64,51,"ANTICAPITALISTAS",7
41,"41902",4682,3136,3101,34,35,"ANTICAPITALISTAS",5
28,"28090",7899,6216,6131,60,85,"ANTICAPITALISTAS",5
28,"28069",51,35,33,1,2,"ANTICAPITALISTAS",0
28,"28048",489,398,389,3,9,"ANTICAPITALISTAS",1
9,"9315",362,267,265,9,2,"ANTICAPITALISTAS",2
49,"49126",232,175,173,3,2,"ANTICAPITALISTAS",1
9,"9159",57,49,48,0,1,"ANTICAPITALISTAS",0
28,"28093",1911,1537,1518,19,19,"ANTICAPITALISTAS",0
9,"9250",295,234,230,5,4,"ANTICAPITALISTAS",0
19,"19293",1860,1407,1373,16,34,"ANTICAPITALISTAS",0
18,"18189",723,547,541,6,6,"ANTICAPITALISTAS",1
19,"19139",32,23,23,0,0,"ANTICAPITALISTAS",0
28,"28091",5202,3714,3671,34,43,"ANTICAPITALISTAS",2
19,"19204",168,129,126,2,3,"ANTICAPITALISTAS",0
28,"28160",7496,5680,5613,46,67,"ANTICAPITALISTAS",4
41,"41030",527,436,429,6,7,"ANTICAPITALISTAS",0
28,"28114",148,110,110,0,0,"ANTICAPITALISTAS",0
49,"49137",179,149,147,2,2,"ANTICAPITALISTAS",0
28,"28113",31318,23779,23436,271,343,"ANTICAPITALISTAS",40
4,"4062",4604,3711,3654,22,57,"ANTICAPITALISTAS",6
9,"9351",63,46,44,0,2,"ANTICAPITALISTAS",0
49,"49138",269,190,189,0,1,"ANTICAPITALISTAS",0
49,"49153",183,141,139,1,2,"ANTICAPITALISTAS",0
49,"49082",400,331,324,2,7,"ANTICAPITALISTAS",0
28,"28121",185,153,152,0,1,"ANTICAPITALISTAS",1
19,"19224",119,95,94,0,1,"ANTICAPITALISTAS",0
9,"9381",38,30,30,0,0,"ANTICAPITALISTAS",0
9,"9335",62,52,51,1,1,"ANTICAPITALISTAS",0
19,"19120",107,95,95,1,0,"ANTICAPITALISTAS",1
4,"4038",3140,2258,2231,44,27,"ANTICAPITALISTAS",3
49,"49183",111,87,87,2,0,"ANTICAPITALISTAS",0
41,"41098",4650,3665,3603,43,62,"ANTICAPITALISTAS",2
28,"28001",61,46,45,1,1,"ANTICAPITALISTAS",0
39,"39094",927,702,691,0,11,"ANTICAPITALISTAS",0
41,"41014",2484,1956,1936,13,20,"ANTICAPITALISTAS",1
9,"9127",54,39,39,0,0,"ANTICAPITALISTAS",1
49,"49083",67,48,48,1,0,"ANTICAPITALISTAS",0
49,"49038",114,81,80,0,1,"ANTICAPITALISTAS",2
19,"19281",25,24,22,3,2,"ANTICAPITALISTAS",0
18,"18074",297,245,245,5,0,"ANTICAPITALISTAS",0
41,"41040",9567,7305,7210,93,95,"ANTICAPITALISTAS",6
9,"9416",61,44,44,0,0,"ANTICAPITALISTAS",1
19,"19255",95,68,68,0,0,"ANTICAPITALISTAS",0
9,"9038",123,92,92,0,0,"ANTICAPITALISTAS",0
19,"19304",235,169,166,1,3,"ANTICAPITALISTAS",1
9,"9356",57,38,37,1,1,"ANTICAPITALISTAS",0
9,"9265",44,36,35,2,1,"ANTICAPITALISTAS",0
9,"9384",310,223,218,3,5,"ANTICAPITALISTAS",0
4,"4098",1616,1255,1249,7,6,"ANTICAPITALISTAS",1
9,"9178",61,48,48,0,0,"ANTICAPITALISTAS",0
49,"49036",592,410,403,5,7,"ANTICAPITALISTAS",0
39,"39017",588,424,419,2,5,"ANTICAPITALISTAS",0
9,"9443",197,160,154,5,6,"ANTICAPITALISTAS",0
49,"49197",187,126,126,3,0,"ANTICAPITALISTAS",0
41,"41047",9810,7427,7321,99,106,"ANTICAPITALISTAS",9
19,"19227",95,64,63,1,1,"ANTICAPITALISTAS",0
18,"18187",587,432,432,0,0,"ANTICAPITALISTAS",0
19,"19010",15,13,13,1,0,"ANTICAPITALISTAS",0
9,"9339",139,105,104,1,1,"ANTICAPITALISTAS",0
49,"49172",594,389,383,0,6,"ANTICAPITALISTAS",0
18,"18146",1059,791,776,2,15,"ANTICAPITALISTAS",1
28,"28068",10502,7857,7778,68,79,"ANTICAPITALISTAS",8
9,"9115",96,71,70,4,1,"ANTICAPITALISTAS",0
49,"49250",1330,998,985,19,13,"ANTICAPITALISTAS",1
4,"4100",7918,5465,5425,52,40,"ANTICAPITALISTAS",4
9,"9162",122,94,93,1,1,"ANTICAPITALISTAS",2
49,"49187",1317,967,954,31,13,"ANTICAPITALISTAS",2
19,"19049",19,11,11,0,0,"ANTICAPITALISTAS",0
28,"28109",1621,1121,1104,9,17,"ANTICAPITALISTAS",1
41,"41060",15176,10797,10693,114,104,"ANTICAPITALISTAS",3
9,"9441",70,59,59,2,0,"ANTICAPITALISTAS",0
18,"18067",704,526,521,1,5,"ANTICAPITALISTAS",0
49,"49071",822,558,557,5,1,"ANTICAPITALISTAS",0
49,"49188",142,101,100,3,1,"ANTICAPITALISTAS",0
49,"49055",115,96,95,1,1,"ANTICAPITALISTAS",0
28,"28154",5232,3910,3860,40,50,"ANTICAPITALISTAS",4
18,"18018",658,520,514,4,6,"ANTICAPITALISTAS",0
28,"28147",910,705,698,5,7,"ANTICAPITALISTAS",0
4,"4008",530,423,418,4,5,"ANTICAPITALISTAS",0
41,"41043",647,457,454,5,3,"ANTICAPITALISTAS",0
19,"19222",120,90,89,3,1,"ANTICAPITALISTAS",0
9,"9352",134,107,106,0,1,"ANTICAPITALISTAS",0
9,"9184",4,4,4,0,0,"ANTICAPITALISTAS",0
28,"28026",5852,4506,4449,40,57,"ANTICAPITALISTAS",5
18,"18084",3954,3039,3015,50,24,"ANTICAPITALISTAS",1
9,"9321",1760,1338,1327,20,11,"ANTICAPITALISTAS",2
9,"9297",326,270,266,7,4,"ANTICAPITALISTAS",0
18,"18126",1461,1129,1121,15,8,"ANTICAPITALISTAS",1
9,"9425",561,431,418,3,13,"ANTICAPITALISTAS",2
19,"19165",51,43,42,0,1,"ANTICAPITALISTAS",0
49,"49090",207,168,168,4,0,"ANTICAPITALISTAS",0
28,"28031",1981,1524,1500,9,24,"ANTICAPITALISTAS",0
9,"9246",662,469,457,3,12,"ANTICAPITALISTAS",0
41,"41067",7055,5368,5295,64,73,"ANTICAPITALISTAS",7
18,"18901",583,374,368,3,6,"ANTICAPITALISTAS",0
28,"28180",5179,4033,3975,18,58,"ANTICAPITALISTAS",5
4,"4033",161,120,119,1,1,"ANTICAPITALISTAS",0
49,"49058",341,262,259,4,3,"ANTICAPITALISTAS",2
19,"19166",179,123,121,4,2,"ANTICAPITALISTAS",0
9,"9238",1026,612,601,6,11,"ANTICAPITALISTAS",0
19,"19210",34,29,29,1,0,"ANTICAPITALISTAS",0
9,"9179",45,37,37,0,0,"ANTICAPITALISTAS",0
19,"19187",64,54,54,0,0,"ANTICAPITALISTAS",0
19,"19198",22,19,19,0,0,"ANTICAPITALISTAS",0
19,"19015",104,88,87,0,1,"ANTICAPITALISTAS",0
49,"49163",235,167,167,0,0,"ANTICAPITALISTAS",0
49,"49107",160,113,111,2,2,"ANTICAPITALISTAS",0
49,"49241",275,225,221,2,4,"ANTICAPITALISTAS",0
19,"19188",72,48,48,1,0,"ANTICAPITALISTAS",0
41,"41045",5505,3946,3889,68,57,"ANTICAPITALISTAS",2
19,"19004",67,56,56,0,0,"ANTICAPITALISTAS",0
28,"28027",1232,937,919,9,18,"ANTICAPITALISTAS",2
28,"28094",774,557,551,5,6,"ANTICAPITALISTAS",11
4,"4093",1869,1341,1334,10,7,"ANTICAPITALISTAS",1
28,"28141",5568,4097,4051,31,46,"ANTICAPITALISTAS",3
18,"18117",535,444,440,2,4,"ANTICAPITALISTAS",0
19,"19011",286,219,218,3,1,"ANTICAPITALISTAS",0
49,"49108",512,387,381,9,6,"ANTICAPITALISTAS",0
9,"9421",269,189,189,5,0,"ANTICAPITALISTAS",2
19,"19317",150,122,121,2,1,"ANTICAPITALISTAS",0
19,"19261",42,31,31,1,0,"ANTICAPITALISTAS",0
4,"4079",45851,31893,31644,430,249,"ANTICAPITALISTAS",32
4,"4023",144,116,116,2,0,"ANTICAPITALISTAS",0
18,"18111",2647,1957,1941,24,16,"ANTICAPITALISTAS",0
41,"41044",6838,5064,5005,67,59,"ANTICAPITALISTAS",3
9,"9307",119,89,88,1,1,"ANTICAPITALISTAS",0
9,"9338",220,173,168,5,5,"ANTICAPITALISTAS",0
19,"19105",2235,1709,1686,23,23,"ANTICAPITALISTAS",2
41,"41085",3918,3173,3128,42,45,"ANTICAPITALISTAS",3
9,"9098",553,416,410,11,6,"ANTICAPITALISTAS",1
11,"11005",4617,3287,3214,26,73,"ANTICAPITALISTAS",2
18,"18115",2380,1843,1823,14,20,"ANTICAPITALISTAS",0
49,"49080",736,571,560,5,11,"ANTICAPITALISTAS",0
19,"19226",40,31,30,0,1,"ANTICAPITALISTAS",0
28,"28003",196,154,151,2,3,"ANTICAPITALISTAS",0
9,"9110",95,68,68,1,0,"ANTICAPITALISTAS",0
9,"9380",85,71,71,1,0,"ANTICAPITALISTAS",0
9,"9422",24,18,16,0,2,"ANTICAPITALISTAS",0
9,"9394",805,594,588,13,6,"ANTICAPITALISTAS",2
19,"19070",100,74,74,0,0,"ANTICAPITALISTAS",0
19,"19327",551,459,449,3,10,"ANTICAPITALISTAS",0
28,"28015",14491,11562,11417,155,145,"ANTICAPITALISTAS",12
9,"9434",1167,916,902,24,14,"ANTICAPITALISTAS",2
19,"19235",121,92,87,0,5,"ANTICAPITALISTAS",1
19,"19132",105,79,79,0,0,"ANTICAPITALISTAS",0
18,"18098",6440,4743,4679,44,64,"ANTICAPITALISTAS",2
49,"49081",1457,1166,1141,17,25,"ANTICAPITALISTAS",1
4,"4074",2731,1959,1936,26,23,"ANTICAPITALISTAS",3
11,"11029",5360,3445,3423,27,22,"ANTICAPITALISTAS",0
9,"9066",62,44,42,0,2,"ANTICAPITALISTAS",0
9,"9424",42,35,34,1,1,"ANTICAPITALISTAS",0
39,"39007",479,348,347,3,1,"ANTICAPITALISTAS",0
9,"9067",460,335,328,5,7,"ANTICAPITALISTAS",0
9,"9029",186,138,137,4,1,"ANTICAPITALISTAS",0
39,"39016",24213,18549,18362,265,187,"ANTICAPITALISTAS",8
41,"41089",6394,4593,4526,57,67,"ANTICAPITALISTAS",6
9,"9075",126,102,101,1,1,"ANTICAPITALISTAS",0
41,"41066",1417,1121,1113,9,8,"ANTICAPITALISTAS",1
9,"9139",104,84,80,3,4,"ANTICAPITALISTAS",0
9,"9476",67,52,52,0,0,"ANTICAPITALISTAS",0
41,"41096",6079,4673,4595,47,78,"ANTICAPITALISTAS",8
19,"19096",99,79,78,1,1,"ANTICAPITALISTAS",0
4,"4028",239,212,207,0,5,"ANTICAPITALISTAS",3
19,"19129",48,33,31,0,2,"ANTICAPITALISTAS",0
19,"19053",2172,1602,1587,14,15,"ANTICAPITALISTAS",2
28,"28176",10977,8790,8718,68,72,"ANTICAPITALISTAS",6
4,"4043",520,439,435,3,4,"ANTICAPITALISTAS",1
9,"9455",48,39,39,0,0,"ANTICAPITALISTAS",0
39,"39089",163,126,126,0,0,"ANTICAPITALISTAS",0
4,"4005",631,531,524,6,7,"ANTICAPITALISTAS",0
9,"9189",146,101,99,2,2,"ANTICAPITALISTAS",0
9,"9083",27,21,21,0,0,"ANTICAPITALISTAS",0
18,"18910",832,601,594,6,7,"ANTICAPITALISTAS",0
19,"19190",2499,1829,1785,32,44,"ANTICAPITALISTAS",2
18,"18112",132,90,90,1,0,"ANTICAPITALISTAS",0
9,"9325",217,151,148,1,3,"ANTICAPITALISTAS",0
9,"9275",202,140,139,5,1,"ANTICAPITALISTAS",1
11,"11022",48624,26656,26430,345,226,"ANTICAPITALISTAS",22
28,"28039",139,103,103,1,0,"ANTICAPITALISTAS",0
19,"19103",303,247,244,3,3,"ANTICAPITALISTAS",0
41,"41059",31676,23199,22889,330,310,"ANTICAPITALISTAS",26
39,"39070",152,118,118,0,0,"ANTICAPITALISTAS",0
28,"28075",5127,3976,3916,42,60,"ANTICAPITALISTAS",2
39,"39019",2009,1556,1536,10,20,"ANTICAPITALISTAS",5
39,"39027",3213,2506,2473,21,33,"ANTICAPITALISTAS",3
9,"9355",117,88,87,1,1,"ANTICAPITALISTAS",0
18,"18178",834,685,683,3,2,"ANTICAPITALISTAS",0
28,"28032",4469,3412,3369,32,43,"ANTICAPITALISTAS",2
9,"9247",28,21,20,0,1,"ANTICAPITALISTAS",0
9,"9046",41,30,30,0,0,"ANTICAPITALISTAS",0
9,"9262",158,139,137,7,2,"ANTICAPITALISTAS",0
19,"19195",41,30,30,1,0,"ANTICAPITALISTAS",0
19,"19228",39,30,29,0,1,"ANTICAPITALISTAS",0
9,"9001",29,25,25,0,0,"ANTICAPITALISTAS",0
9,"9151",509,389,383,5,6,"ANTICAPITALISTAS",0
18,"18071",5589,4268,4205,44,63,"ANTICAPITALISTAS",6
41,"41052",2967,2305,2288,7,17,"ANTICAPITALISTAS",0
41,"41003",2196,1803,1782,21,21,"ANTICAPITALISTAS",1
18,"18911",6796,4923,4867,74,56,"ANTICAPITALISTAS",8
39,"39095",2292,1824,1801,24,23,"ANTICAPITALISTAS",4
39,"39001",2146,1669,1645,20,24,"ANTICAPITALISTAS",1
28,"28023",4350,3425,3392,32,33,"ANTICAPITALISTAS",3
4,"4075",4783,3731,3700,33,31,"ANTICAPITALISTAS",1
9,"9406",242,193,193,2,0,"ANTICAPITALISTAS",1
28,"28086",4603,3286,3248,29,38,"ANTICAPITALISTAS",4
39,"39035",10031,7685,7601,74,84,"ANTICAPITALISTAS",12
28,"28010",9309,7304,7229,71,75,"ANTICAPITALISTAS",7
9,"9034",301,250,250,3,0,"ANTICAPITALISTAS",0
9,"9073",889,672,663,12,9,"ANTICAPITALISTAS",1
49,"49175",263,215,215,4,0,"ANTICAPITALISTAS",0
41,"41091",545464,388043,383816,5325,4227,"ANTICAPITALISTAS",635
11,"11040",411,317,309,0,8,"ANTICAPITALISTAS",0
49,"49167",223,173,171,5,2,"ANTICAPITALISTAS",0
18,"18138",2460,1751,1741,1,10,"ANTICAPITALISTAS",0
18,"18069",506,375,371,4,4,"ANTICAPITALISTAS",1
49,"49255",455,372,367,1,5,"ANTICAPITALISTAS",0
9,"9418",79,60,58,0,2,"ANTICAPITALISTAS",0
39,"39073",9275,6984,6903,83,81,"ANTICAPITALISTAS",4
49,"49164",158,120,114,2,6,"ANTICAPITALISTAS",0
49,"49256",289,229,224,3,5,"ANTICAPITALISTAS",0
39,"39012",6666,5148,5061,43,87,"ANTICAPITALISTAS",3
9,"9360",37,29,29,0,0,"ANTICAPITALISTAS",0
39,"39003",321,265,261,0,4,"ANTICAPITALISTAS",0
9,"9090",61,50,50,0,0,"ANTICAPITALISTAS",0
28,"28056",782,604,586,6,18,"ANTICAPITALISTAS",1
39,"39082",1688,1280,1266,9,14,"ANTICAPITALISTAS",0
9,"9037",122,91,90,2,1,"ANTICAPITALISTAS",0
9,"9391",383,290,284,7,6,"ANTICAPITALISTAS",0
19,"19052",37,32,31,1,1,"ANTICAPITALISTAS",0
49,"49059",111,83,82,2,1,"ANTICAPITALISTAS",0
41,"41037",3228,2510,2483,27,27,"ANTICAPITALISTAS",0
28,"28084",15408,11489,11355,122,134,"ANTICAPITALISTAS",12
9,"9340",72,41,41,0,0,"ANTICAPITALISTAS",0
41,"41063",2678,1869,1853,22,16,"ANTICAPITALISTAS",0
9,"9268",108,78,78,0,0,"ANTICAPITALISTAS",0
39,"39080",3627,2743,2693,19,50,"ANTICAPITALISTAS",3
39,"39053",251,179,179,1,0,"ANTICAPITALISTAS",0
28,"28042",1091,814,808,5,6,"ANTICAPITALISTAS",1
9,"9052",40,31,31,1,0,"ANTICAPITALISTAS",0
41,"41029",13231,9756,9610,128,146,"ANTICAPITALISTAS",8
9,"9239",52,42,42,1,0,"ANTICAPITALISTAS",0
9,"9277",130,101,101,1,0,"ANTICAPITALISTAS",0
19,"19182",38,24,22,0,2,"ANTICAPITALISTAS",0
19,"19262",184,137,136,0,1,"ANTICAPITALISTAS",0
18,"18121",135,109,109,0,0,"ANTICAPITALISTAS",0
49,"49221",266,148,147,6,1,"ANTICAPITALISTAS",1
19,"19268",34,26,25,0,1,"ANTICAPITALISTAS",0
39,"39069",1957,1595,1570,18,25,"ANTICAPITALISTAS",4
18,"18085",818,538,532,4,6,"ANTICAPITALISTAS",0
9,"9309",343,252,246,7,6,"ANTICAPITALISTAS",0
19,"19266",278,234,231,4,3,"ANTICAPITALISTAS",0
49,"49214",720,560,558,6,2,"ANTICAPITALISTAS",0
18,"18062",9418,6916,6835,62,81,"ANTICAPITALISTAS",5
41,"41004",55127,37662,37179,622,483,"ANTICAPITALISTAS",54
19,"19159",108,91,88,1,3,"ANTICAPITALISTAS",0
39,"39067",901,628,623,1,5,"ANTICAPITALISTAS",0
49,"49047",120,91,90,1,1,"ANTICAPITALISTAS",0
49,"49019",256,206,205,5,1,"ANTICAPITALISTAS",1
9,"9287",201,159,158,4,1,"ANTICAPITALISTAS",0
28,"28051",1469,1147,1129,7,18,"ANTICAPITALISTAS",2
39,"39018",4077,3212,3160,44,52,"ANTICAPITALISTAS",4
19,"19075",81,53,50,4,3,"ANTICAPITALISTAS",0
18,"18120",274,238,237,2,1,"ANTICAPITALISTAS",0
28,"28096",16844,12441,12308,117,133,"ANTICAPITALISTAS",10
18,"18021",16026,11376,11219,186,157,"ANTICAPITALISTAS",7
49,"49020",323,275,272,1,3,"ANTICAPITALISTAS",0
49,"49097",97,55,55,1,0,"ANTICAPITALISTAS",0
19,"19171",4352,3299,3221,35,78,"ANTICAPITALISTAS",3
39,"39033",604,480,473,3,7,"ANTICAPITALISTAS",0
19,"19254",57,50,50,0,0,"ANTICAPITALISTAS",0
9,"9112",115,80,80,4,0,"ANTICAPITALISTAS",0
19,"19211",450,340,334,0,6,"ANTICAPITALISTAS",0
41,"41011",15274,11359,11207,145,152,"ANTICAPITALISTAS",4
19,"19325",127,105,102,4,3,"ANTICAPITALISTAS",0
49,"49178",679,469,461,9,8,"ANTICAPITALISTAS",32
18,"18025",326,242,238,0,4,"ANTICAPITALISTAS",0
49,"49139",195,146,146,0,0,"ANTICAPITALISTAS",0
9,"9460",187,144,142,2,2,"ANTICAPITALISTAS",0
9,"9168",329,254,254,2,0,"ANTICAPITALISTAS",2
49,"49209",568,374,372,1,2,"ANTICAPITALISTAS",0
49,"49043",304,256,256,6,0,"ANTICAPITALISTAS",0
18,"18180",655,450,447,1,3,"ANTICAPITALISTAS",1
41,"41075",9987,7904,7809,71,95,"ANTICAPITALISTAS",6
11,"11030",22528,14741,14557,195,184,"ANTICAPITALISTAS",9
49,"49075",153,128,122,0,6,"ANTICAPITALISTAS",0
4,"4046",826,645,634,4,11,"ANTICAPITALISTAS",0
19,"19237",53,40,39,2,1,"ANTICAPITALISTAS",0
19,"19148",56,41,38,1,3,"ANTICAPITALISTAS",0
9,"9439",909,720,697,16,23,"ANTICAPITALISTAS",3
19,"19301",47,38,38,0,0,"ANTICAPITALISTAS",0
9,"9160",104,75,74,0,1,"ANTICAPITALISTAS",0
18,"18122",16253,12271,12109,132,162,"ANTICAPITALISTAS",9
28,"28053",6035,4854,4783,61,71,"ANTICAPITALISTAS",2
18,"18023",16072,11594,11488,131,106,"ANTICAPITALISTAS",25
9,"9101",79,66,66,2,0,"ANTICAPITALISTAS",0
49,"49143",243,161,157,0,4,"ANTICAPITALISTAS",0
19,"19305",166,130,130,0,0,"ANTICAPITALISTAS",0
49,"49115",191,151,149,3,2,"ANTICAPITALISTAS",0
49,"49222",404,297,294,4,3,"ANTICAPITALISTAS",1
49,"49024",736,551,544,16,7,"ANTICAPITALISTAS",1
19,"19016",74,50,49,0,1,"ANTICAPITALISTAS",0
19,"19031",18,11,11,0,0,"ANTICAPITALISTAS",0
4,"4044",1517,1232,1224,8,8,"ANTICAPITALISTAS",0
11,"11013",2284,1691,1670,15,21,"ANTICAPITALISTAS",1
39,"39088",70,61,61,1,0,"ANTICAPITALISTAS",0
19,"19260",44,41,41,1,0,"ANTICAPITALISTAS",0
9,"9033",104,82,80,1,2,"ANTICAPITALISTAS",0
19,"19104",16,12,12,1,0,"ANTICAPITALISTAS",0
19,"19271",53,45,45,1,0,"ANTICAPITALISTAS",0
4,"4078",1069,837,832,6,5,"ANTICAPITALISTAS",0
18,"18003",13486,10245,10100,145,145,"ANTICAPITALISTAS",14
28,"28119",1911,1527,1514,13,13,"ANTICAPITALISTAS",0
9,"9281",159,134,132,5,2,"ANTICAPITALISTAS",1
49,"49044",80,63,63,3,0,"ANTICAPITALISTAS",0
9,"9180",132,97,95,8,2,"ANTICAPITALISTAS",0
9,"9025",150,112,110,0,2,"ANTICAPITALISTAS",1
9,"9363",1047,798,792,9,6,"ANTICAPITALISTAS",2
19,"19212",795,644,632,2,12,"ANTICAPITALISTAS",0
18,"18007",808,602,591,5,11,"ANTICAPITALISTAS",0
4,"4035",8213,6218,6171,51,47,"ANTICAPITALISTAS",4
4,"4101",3927,2827,2804,34,23,"ANTICAPITALISTAS",5
39,"39046",1442,1071,1050,13,21,"ANTICAPITALISTAS",0
19,"19297",34,29,29,0,0,"ANTICAPITALISTAS",0
41,"41084",2875,2362,2335,9,27,"ANTICAPITALISTAS",0
18,"18002",625,505,504,2,1,"ANTICAPITALISTAS",0
49,"49113",188,166,161,2,5,"ANTICAPITALISTAS",1
9,"9030",135,97,97,2,0,"ANTICAPITALISTAS",0
41,"41050",5102,4224,4183,39,41,"ANTICAPITALISTAS",1
18,"18183",685,502,500,3,2,"ANTICAPITALISTAS",0
9,"9224",172,125,125,3,0,"ANTICAPITALISTAS",0
19,"19286",743,566,554,8,12,"ANTICAPITALISTAS",2
9,"9062",52,33,32,1,1,"ANTICAPITALISTAS",0
11,"11025",4371,3260,3226,34,34,"ANTICAPITALISTAS",1
9,"9329",117,80,79,1,1,"ANTICAPITALISTAS",0
18,"18171",2093,1719,1704,10,15,"ANTICAPITALISTAS",1
39,"39064",1339,1072,1066,7,6,"ANTICAPITALISTAS",0
18,"18028",992,826,821,4,5,"ANTICAPITALISTAS",0
9,"9482",33,31,30,1,1,"ANTICAPITALISTAS",0
18,"18133",2256,1783,1773,12,10,"ANTICAPITALISTAS",1
19,"19089",33,22,22,1,0,"ANTICAPITALISTAS",0
9,"9195",64,40,40,1,0,"ANTICAPITALISTAS",0
49,"49093",308,248,245,5,3,"ANTICAPITALISTAS",0
9,"9134",237,164,159,7,5,"ANTICAPITALISTAS",3
9,"9011",86,56,56,1,0,"ANTICAPITALISTAS",1
49,"49016",272,216,211,1,5,"ANTICAPITALISTAS",0
19,"19274",881,652,644,8,8,"ANTICAPITALISTAS",3
9,"9302",116,87,87,3,0,"ANTICAPITALISTAS",0
19,"19218",60,35,35,0,0,"ANTICAPITALISTAS",0
39,"39079",9035,6959,6897,55,62,"ANTICAPITALISTAS",6
9,"9079",49,44,44,1,0,"ANTICAPITALISTAS",1
41,"41077",8817,6520,6375,53,145,"ANTICAPITALISTAS",1
18,"18140",42971,28391,28126,335,265,"ANTICAPITALISTAS",16
19,"19177",82,67,66,0,1,"ANTICAPITALISTAS",0
19,"19287",153,114,113,2,1,"ANTICAPITALISTAS",0
9,"9174",859,645,639,11,6,"ANTICAPITALISTAS",0
9,"9274",1160,924,914,14,10,"ANTICAPITALISTAS",5
28,"28065",118796,93292,92186,919,1106,"ANTICAPITALISTAS",91
39,"39091",2026,1636,1628,14,8,"ANTICAPITALISTAS",1
18,"18038",1097,906,900,3,6,"ANTICAPITALISTAS",0
18,"18908",827,669,660,7,9,"ANTICAPITALISTAS",4
39,"39065",272,199,197,2,2,"ANTICAPITALISTAS",0
9,"9003",205,156,154,4,2,"ANTICAPITALISTAS",1
4,"4068",187,137,137,1,0,"ANTICAPITALISTAS",0
9,"9327",34,34,34,0,0,"ANTICAPITALISTAS",0
28,"28016",86,68,67,3,1,"ANTICAPITALISTAS",0
9,"9903",3299,2373,2349,45,24,"ANTICAPITALISTAS",4
28,"28017",1120,905,888,8,17,"ANTICAPITALISTAS",0
18,"18123",307,239,238,1,1,"ANTICAPITALISTAS",0
18,"18188",1659,1329,1308,9,21,"ANTICAPITALISTAS",0
41,"41039",31429,23337,23138,294,199,"ANTICAPITALISTAS",12
19,"19146",51,40,38,0,2,"ANTICAPITALISTAS",0
39,"39041",1775,1432,1414,15,18,"ANTICAPITALISTAS",0
19,"19234",63,48,48,0,0,"ANTICAPITALISTAS",0
49,"49110",382,236,233,1,3,"ANTICAPITALISTAS",0
49,"49245",296,218,218,2,0,"ANTICAPITALISTAS",0
19,"19157",66,56,56,4,0,"ANTICAPITALISTAS",0
9,"9198",115,85,85,1,0,"ANTICAPITALISTAS",0
49,"49037",201,171,171,2,0,"ANTICAPITALISTAS",0
41,"41010",4338,2990,2958,48,32,"ANTICAPITALISTAS",1
9,"9905",432,313,309,1,4,"ANTICAPITALISTAS",1
19,"19310",13,9,8,0,1,"ANTICAPITALISTAS",0
9,"9093",154,127,125,1,2,"ANTICAPITALISTAS",0
49,"49154",147,104,102,1,2,"ANTICAPITALISTAS",0
39,"39076",3388,2673,2641,22,32,"ANTICAPITALISTAS",2
18,"18086",397,321,321,3,0,"ANTICAPITALISTAS",0
18,"18176",265,183,181,0,2,"ANTICAPITALISTAS",0
49,"49064",566,372,368,8,4,"ANTICAPITALISTAS",0
9,"9027",54,48,43,0,5,"ANTICAPITALISTAS",0
28,"28085",3794,2980,2933,18,47,"ANTICAPITALISTAS",3
19,"19110",73,59,57,4,2,"ANTICAPITALISTAS",0
19,"19306",42,31,31,1,0,"ANTICAPITALISTAS",0
19,"19117",1526,1155,1132,26,23,"ANTICAPITALISTAS",0
9,"9471",171,127,125,1,2,"ANTICAPITALISTAS",0
4,"4087",198,162,159,2,3,"ANTICAPITALISTAS",1
28,"28133",5868,4236,4144,23,92,"ANTICAPITALISTAS",0
19,"19074",81,69,69,0,0,"ANTICAPITALISTAS",0
4,"4029",10682,7542,7474,63,68,"ANTICAPITALISTAS",7
18,"18913",827,653,646,2,7,"ANTICAPITALISTAS",0
49,"49228",64,56,56,0,0,"ANTICAPITALISTAS",0
39,"39061",3458,2673,2644,42,29,"ANTICAPITALISTAS",4
19,"19078",58,49,48,0,1,"ANTICAPITALISTAS",0
19,"19009",253,187,184,0,3,"ANTICAPITALISTAS",0
28,"28167",7818,6016,5942,82,74,"ANTICAPITALISTAS",4
49,"49013",300,230,228,6,2,"ANTICAPITALISTAS",0
28,"28052",3799,2753,2719,17,34,"ANTICAPITALISTAS",3
4,"4073",389,289,286,4,3,"ANTICAPITALISTAS",0
9,"9346",95,83,83,1,0,"ANTICAPITALISTAS",1
19,"19059",84,60,60,0,0,"ANTICAPITALISTAS",0
28,"28049",59507,46919,46379,488,540,"ANTICAPITALISTAS",49
9,"9427",1561,1090,1078,18,12,"ANTICAPITALISTAS",1
9,"9084",200,147,147,4,0,"ANTICAPITALISTAS",1
18,"18013",4392,3268,3223,23,45,"ANTICAPITALISTAS",4
19,"19296",43,31,30,1,1,"ANTICAPITALISTAS",1
4,"4018",293,250,245,2,5,"ANTICAPITALISTAS",0
9,"9451",244,208,202,1,6,"ANTICAPITALISTAS",1
19,"19060",165,127,121,3,6,"ANTICAPITALISTAS",0
9,"9202",26,24,24,1,0,"ANTICAPITALISTAS",0
49,"49176",757,502,501,5,1,"ANTICAPITALISTAS",0
9,"9219",28514,20244,19951,326,293,"ANTICAPITALISTAS",52
49,"49086",127,108,107,1,1,"ANTICAPITALISTAS",0
9,"9326",156,119,114,2,5,"ANTICAPITALISTAS",0
9,"9082",49,41,41,0,0,"ANTICAPITALISTAS",0
41,"41056",3697,3041,3008,25,33,"ANTICAPITALISTAS",4
39,"39032",1576,1215,1209,10,6,"ANTICAPITALISTAS",1
49,"49173",430,272,272,5,0,"ANTICAPITALISTAS",0
49,"49150",169,129,126,0,3,"ANTICAPITALISTAS",0
39,"39062",1759,1397,1387,9,10,"ANTICAPITALISTAS",0
18,"18905",12975,9260,9209,155,51,"ANTICAPITALISTAS",9
19,"19208",55,41,41,1,0,"ANTICAPITALISTAS",0
19,"19332",106,76,72,4,4,"ANTICAPITALISTAS",0
19,"19290",872,622,613,7,9,"ANTICAPITALISTAS",0
19,"19082",91,68,67,1,1,"ANTICAPITALISTAS",0
4,"4041",334,247,245,0,2,"ANTICAPITALISTAS",3
41,"41032",4059,3122,3062,22,60,"ANTICAPITALISTAS",1
49,"49236",86,64,64,0,0,"ANTICAPITALISTAS",0
28,"28161",44185,33371,32966,353,405,"ANTICAPITALISTAS",24
19,"19080",90,64,64,0,0,"ANTICAPITALISTAS",0
19,"19324",199,151,151,2,0,"ANTICAPITALISTAS",0
11,"11016",14611,9848,9774,114,74,"ANTICAPITALISTAS",5
18,"18006",4116,2862,2831,25,31,"ANTICAPITALISTAS",3
19,"19309",37,32,31,0,1,"ANTICAPITALISTAS",1
9,"9456",142,110,110,3,0,"ANTICAPITALISTAS",0
41,"41069",28331,21065,20877,252,188,"ANTICAPITALISTAS",10
49,"49035",260,231,229,4,2,"ANTICAPITALISTAS",0
9,"9310",14,10,9,2,1,"ANTICAPITALISTAS",0
41,"41042",5902,4572,4509,37,63,"ANTICAPITALISTAS",2
28,"28149",5276,4132,4063,43,69,"ANTICAPITALISTAS",3
28,"28129",7219,5536,5461,71,75,"ANTICAPITALISTAS",5
28,"28083",8037,6078,6025,66,53,"ANTICAPITALISTAS",7
41,"41073",1789,1292,1272,5,20,"ANTICAPITALISTAS",1
49,"49002",77,59,59,1,0,"ANTICAPITALISTAS",0
49,"49120",79,58,58,1,0,"ANTICAPITALISTAS",0
11,"11902",3578,2400,2376,21,24,"ANTICAPITALISTAS",1
4,"4010",602,492,491,10,1,"ANTICAPITALISTAS",0
9,"9458",422,325,316,5,9,"ANTICAPITALISTAS",1
18,"18059",4055,3232,3191,37,41,"ANTICAPITALISTAS",2
9,"9136",203,153,146,3,7,"ANTICAPITALISTAS",0
39,"39010",688,533,524,6,9,"ANTICAPITALISTAS",1
4,"4903",4331,3183,3164,31,19,"ANTICAPITALISTAS",0
19,"19263",34,27,27,0,0,"ANTICAPITALISTAS",0
9,"9012",105,77,74,3,3,"ANTICAPITALISTAS",0
9,"9211",1489,1137,1121,28,16,"ANTICAPITALISTAS",3
9,"9472",58,46,46,0,0,"ANTICAPITALISTAS",0
28,"28144",5663,4456,4410,47,46,"ANTICAPITALISTAS",6
9,"9026",384,296,295,8,1,"ANTICAPITALISTAS",0
41,"41048",2296,1749,1726,21,23,"ANTICAPITALISTAS",0
9,"9444",81,54,52,1,2,"ANTICAPITALISTAS",0
49,"49231",360,256,254,4,2,"ANTICAPITALISTAS",0
41,"41008",1073,884,875,0,9,"ANTICAPITALISTAS",0
9,"9235",179,148,142,1,6,"ANTICAPITALISTAS",0
18,"18014",5667,4132,4085,43,47,"ANTICAPITALISTAS",8
49,"49091",278,197,197,4,0,"ANTICAPITALISTAS",0
28,"28043",5944,4199,4147,56,52,"ANTICAPITALISTAS",3
18,"18054",879,646,644,4,2,"ANTICAPITALISTAS",0
49,"49067",416,300,300,2,0,"ANTICAPITALISTAS",2
9,"9294",123,96,93,1,3,"ANTICAPITALISTAS",0
18,"18184",2140,1663,1645,18,18,"ANTICAPITALISTAS",0
9,"9466",151,111,110,1,1,"ANTICAPITALISTAS",0
4,"4037",1393,1090,1079,8,11,"ANTICAPITALISTAS",0
18,"18175",11534,8772,8698,68,74,"ANTICAPITALISTAS",4
18,"18103",803,653,647,5,6,"ANTICAPITALISTAS",0
41,"41099",4141,2818,2799,37,19,"ANTICAPITALISTAS",6
9,"9440",105,80,80,0,0,"ANTICAPITALISTAS",1
9,"9372",207,169,165,1,4,"ANTICAPITALISTAS",0
9,"9334",52,40,39,1,1,"ANTICAPITALISTAS",0
28,"28018",3572,2837,2795,20,42,"ANTICAPITALISTAS",1
19,"19331",2497,1898,1847,19,51,"ANTICAPITALISTAS",4
9,"9071",48,32,32,0,0,"ANTICAPITALISTAS",0
11,"11004",87610,53062,52639,828,423,"ANTICAPITALISTAS",45
28,"28028",1615,1204,1173,11,31,"ANTICAPITALISTAS",13
19,"19194",113,80,76,1,4,"ANTICAPITALISTAS",0
39,"39050",305,207,205,1,2,"ANTICAPITALISTAS",0
9,"9295",78,54,53,0,1,"ANTICAPITALISTAS",0
9,"9450",31,26,26,1,0,"ANTICAPITALISTAS",0
4,"4095",777,547,541,8,6,"ANTICAPITALISTAS",1
4,"4021",188,157,157,2,0,"ANTICAPITALISTAS",0
9,"9122",93,71,71,4,0,"ANTICAPITALISTAS",0
19,"19239",99,74,73,1,1,"ANTICAPITALISTAS",0
49,"49063",371,291,290,3,1,"ANTICAPITALISTAS",0
19,"19003",50,36,35,1,1,"ANTICAPITALISTAS",0
9,"9431",124,102,100,2,2,"ANTICAPITALISTAS",0
9,"9314",113,89,88,4,1,"ANTICAPITALISTAS",0
49,"49092",160,123,123,2,0,"ANTICAPITALISTAS",0
9,"9473",94,81,81,2,0,"ANTICAPITALISTAS",0
19,"19088",98,67,66,0,1,"ANTICAPITALISTAS",0
9,"9070",38,27,27,3,0,"ANTICAPITALISTAS",0
9,"9267",135,118,118,3,0,"ANTICAPITALISTAS",0
28,"28175",780,641,630,8,11,"ANTICAPITALISTAS",0
9,"9411",174,104,103,1,1,"ANTICAPITALISTAS",0
18,"18143",949,722,704,2,18,"ANTICAPITALISTAS",2
19,"19245",1222,954,943,10,11,"ANTICAPITALISTAS",0
4,"4088",2516,1849,1832,7,17,"ANTICAPITALISTAS",0
19,"19113",519,396,395,4,1,"ANTICAPITALISTAS",0
9,"9014",190,113,113,3,0,"ANTICAPITALISTAS",0
49,"49208",428,266,261,1,5,"ANTICAPITALISTAS",1
49,"49032",369,295,291,0,4,"ANTICAPITALISTAS",0
9,"9032",118,68,68,0,0,"ANTICAPITALISTAS",0
39,"39009",3200,2427,2402,24,25,"ANTICAPITALISTAS",1
4,"4069",4729,3740,3706,52,34,"ANTICAPITALISTAS",10
9,"9417",43,38,38,0,0,"ANTICAPITALISTAS",0
19,"19135",120,102,100,2,2,"ANTICAPITALISTAS",0
19,"19112",68,50,50,0,0,"ANTICAPITALISTAS",0
19,"19217",85,57,54,2,3,"ANTICAPITALISTAS",0
28,"28163",395,305,301,7,4,"ANTICAPITALISTAS",0
41,"41070",5598,4101,4039,79,62,"ANTICAPITALISTAS",8
18,"18072",710,507,499,2,8,"ANTICAPITALISTAS",0
19,"19283",40,33,33,0,0,"ANTICAPITALISTAS",0
49,"49054",929,690,687,12,3,"ANTICAPITALISTAS",2
4,"4007",791,599,599,5,0,"ANTICAPITALISTAS",1
19,"19018",189,145,138,2,7,"ANTICAPITALISTAS",0
4,"4059",1231,837,830,8,7,"ANTICAPITALISTAS",0
49,"49269",241,171,170,5,1,"ANTICAPITALISTAS",0
28,"28156",958,742,733,12,9,"ANTICAPITALISTAS",0
19,"19179",109,77,75,3,2,"ANTICAPITALISTAS",0
28,"28123",48429,38681,38187,429,494,"ANTICAPITALISTAS",96
49,"49053",978,809,796,10,13,"ANTICAPITALISTAS",0
49,"49259",121,88,87,1,1,"ANTICAPITALISTAS",0
19,"19027",185,140,138,1,2,"ANTICAPITALISTAS",1
41,"41033",5237,3915,3878,20,37,"ANTICAPITALISTAS",2
9,"9006",68,40,39,1,1,"ANTICAPITALISTAS",0
4,"4077",343,313,313,1,0,"ANTICAPITALISTAS",0
28,"28078",39,23,23,1,0,"ANTICAPITALISTAS",0
39,"39038",1465,1065,1047,8,18,"ANTICAPITALISTAS",1
4,"4017",1337,965,960,7,5,"ANTICAPITALISTAS",0
41,"41097",3096,2489,2451,21,38,"ANTICAPITALISTAS",1
9,"9485",62,56,56,0,0,"ANTICAPITALISTAS",1
18,"18127",15897,11597,11483,133,114,"ANTICAPITALISTAS",11
9,"9036",32,27,27,2,0,"ANTICAPITALISTAS",0
19,"19200",150,105,105,1,0,"ANTICAPITALISTAS",0
9,"9124",1598,1151,1129,19,22,"ANTICAPITALISTAS",3
49,"49244",48,30,30,1,0,"ANTICAPITALISTAS",0
9,"9270",180,147,143,2,4,"ANTICAPITALISTAS",0
28,"28029",538,416,414,4,2,"ANTICAPITALISTAS",0
4,"4066",13570,9018,8963,97,55,"ANTICAPITALISTAS",5
49,"49177",298,199,196,6,3,"ANTICAPITALISTAS",1
18,"18100",7304,5807,5737,62,70,"ANTICAPITALISTAS",2
9,"9140",136,110,110,1,0,"ANTICAPITALISTAS",0
18,"18181",253,183,182,0,1,"ANTICAPITALISTAS",0
28,"28137",1626,1231,1222,9,9,"ANTICAPITALISTAS",2
11,"11003",1290,952,940,8,12,"ANTICAPITALISTAS",0
11,"11012",103946,68124,67375,856,749,"ANTICAPITALISTAS",266
49,"49076",333,260,257,10,3,"ANTICAPITALISTAS",0
28,"28108",3002,2254,2228,31,26,"ANTICAPITALISTAS",0
19,"19269",103,84,83,0,1,"ANTICAPITALISTAS",0
49,"49142",264,180,179,2,1,"ANTICAPITALISTAS",0
9,"9464",44,28,28,0,0,"ANTICAPITALISTAS",0
19,"19238",42,32,31,1,1,"ANTICAPITALISTAS",0
9,"9251",417,292,288,3,4,"ANTICAPITALISTAS",0
41,"41007",12177,8150,8016,126,134,"ANTICAPITALISTAS",7
11,"11037",5640,4337,4285,32,52,"ANTICAPITALISTAS",4
11,"11009",636,430,424,2,6,"ANTICAPITALISTAS",0
28,"28041",4006,3190,3154,45,36,"ANTICAPITALISTAS",0
9,"9301",625,510,504,11,6,"ANTICAPITALISTAS",2
19,"19223",129,94,90,1,4,"ANTICAPITALISTAS",1
39,"39044",3864,2940,2905,44,35,"ANTICAPITALISTAS",3
9,"9175",143,99,98,0,1,"ANTICAPITALISTAS",0
18,"18904",858,620,612,3,8,"ANTICAPITALISTAS",0
19,"19319",4203,3139,3104,28,35,"ANTICAPITALISTAS",5
9,"9016",87,55,54,1,1,"ANTICAPITALISTAS",0
49,"49085",1173,912,908,16,4,"ANTICAPITALISTAS",0
19,"19184",88,63,62,1,1,"ANTICAPITALISTAS",0
39,"39093",351,260,253,2,7,"ANTICAPITALISTAS",0
28,"28020",145,102,100,0,2,"ANTICAPITALISTAS",0
49,"49042",271,216,216,1,0,"ANTICAPITALISTAS",0
9,"9094",49,39,39,0,0,"ANTICAPITALISTAS",0
19,"19122",96,65,65,0,0,"ANTICAPITALISTAS",0
49,"49264",652,439,435,2,4,"ANTICAPITALISTAS",0
4,"4026",75,58,58,0,0,"ANTICAPITALISTAS",0
4,"4030",1222,930,924,5,6,"ANTICAPITALISTAS",0
9,"9141",607,503,481,10,22,"ANTICAPITALISTAS",2
9,"9045",283,196,196,4,0,"ANTICAPITALISTAS",0
41,"41062",2252,1719,1698,12,21,"ANTICAPITALISTAS",0
49,"49202",221,158,157,2,1,"ANTICAPITALISTAS",0
9,"9125",648,463,460,5,3,"ANTICAPITALISTAS",1
49,"49230",122,98,95,1,3,"ANTICAPITALISTAS",0
9,"9137",177,134,134,6,0,"ANTICAPITALISTAS",0
49,"49128",617,480,474,10,6,"ANTICAPITALISTAS",0
4,"4076",1325,1050,1041,7,9,"ANTICAPITALISTAS",0
49,"49186",273,205,204,1,1,"ANTICAPITALISTAS",0
18,"18163",327,246,238,0,8,"ANTICAPITALISTAS",0
18,"18097",1022,758,752,4,6,"ANTICAPITALISTAS",1
41,"41065",23028,15133,14958,191,175,"ANTICAPITALISTAS",9
9,"9057",155,125,124,0,1,"ANTICAPITALISTAS",0
39,"39058",862,586,584,6,2,"ANTICAPITALISTAS",2
18,"18030",612,457,456,0,1,"ANTICAPITALISTAS",0
28,"28153",608,422,406,1,16,"ANTICAPITALISTAS",1
43,"43146",45,33,30,1,3,"ANTICAPITALISTES",0
17,"17092",3520,2273,2228,42,45,"ANTICAPITALISTES",7
8,"8228",303,230,227,5,3,"ANTICAPITALISTES",14
43,"43091",142,106,98,5,8,"ANTICAPITALISTES",0
25,"25035",428,289,284,5,5,"ANTICAPITALISTES",0
25,"25145",88,67,67,2,0,"ANTICAPITALISTES",0
43,"43156",4120,2811,2741,66,70,"ANTICAPITALISTES",11
25,"25208",294,174,170,3,4,"ANTICAPITALISTES",1
25,"25913",100,78,78,0,0,"ANTICAPITALISTES",0
8,"8033",12476,8513,8378,180,135,"ANTICAPITALISTES",36
43,"43113",454,321,316,10,5,"ANTICAPITALISTES",0
25,"25005",291,194,190,7,4,"ANTICAPITALISTES",1
17,"17154",93,54,49,1,5,"ANTICAPITALISTES",1
43,"43074",1697,1150,1120,25,30,"ANTICAPITALISTES",6
17,"17142",2440,1713,1681,39,32,"ANTICAPITALISTES",13
25,"25155",714,490,485,8,5,"ANTICAPITALISTES",2
8,"8012",1694,1155,1136,32,19,"ANTICAPITALISTES",8
43,"43023",244,179,177,8,2,"ANTICAPITALISTES",1
17,"17126",309,231,229,9,2,"ANTICAPITALISTES",3
17,"17023",26941,17098,16799,344,299,"ANTICAPITALISTES",105
43,"43012",3392,2346,2295,48,51,"ANTICAPITALISTES",4
25,"25904",149,107,104,1,3,"ANTICAPITALISTES",0
25,"25029",1766,1145,1118,38,27,"ANTICAPITALISTES",2
8,"8114",17629,11781,11579,189,202,"ANTICAPITALISTES",37
25,"25043",830,483,467,17,16,"ANTICAPITALISTES",0
43,"43001",706,481,473,12,8,"ANTICAPITALISTES",2
17,"17196",209,139,138,6,1,"ANTICAPITALISTES",0
8,"8090",120,86,86,2,0,"ANTICAPITALISTES",0
8,"8227",2372,1591,1549,38,42,"ANTICAPITALISTES",7
8,"8124",36292,24541,24210,471,331,"ANTICAPITALISTES",100
8,"8192",5450,3688,3634,79,54,"ANTICAPITALISTES",17
8,"8134",776,528,513,15,15,"ANTICAPITALISTES",6
17,"17069",395,276,267,2,9,"ANTICAPITALISTES",0
25,"25082",265,156,155,8,1,"ANTICAPITALISTES",0
25,"25096",988,633,613,12,20,"ANTICAPITALISTES",0
17,"17003",101,67,64,2,3,"ANTICAPITALISTES",0
8,"8231",19810,12359,12196,244,163,"ANTICAPITALISTES",50
43,"43140",2393,1612,1583,23,29,"ANTICAPITALISTES",1
17,"17216",158,100,97,1,3,"ANTICAPITALISTES",5
25,"25104",128,88,86,11,2,"ANTICAPITALISTES",0
8,"8043",3067,2044,2023,29,21,"ANTICAPITALISTES",3
8,"8224",771,538,528,26,10,"ANTICAPITALISTES",4
8,"8288",1735,985,957,13,28,"ANTICAPITALISTES",3
17,"17152",10378,6239,6156,100,83,"ANTICAPITALISTES",15
25,"25227",674,375,372,2,3,"ANTICAPITALISTES",3
43,"43159",89,51,51,2,0,"ANTICAPITALISTES",0
25,"25086",569,379,370,4,9,"ANTICAPITALISTES",1
25,"25907",506,297,292,6,5,"ANTICAPITALISTES",0
43,"43903",2368,1504,1492,22,12,"ANTICAPITALISTES",0
25,"25239",627,310,310,7,0,"ANTICAPITALISTES",3
17,"17057",1010,640,634,19,6,"ANTICAPITALISTES",1
25,"25056",289,168,163,3,5,"ANTICAPITALISTES",0
43,"43086",5269,3275,3196,92,79,"ANTICAPITALISTES",6
43,"43078",841,557,547,7,10,"ANTICAPITALISTES",2
43,"43169",477,377,364,8,13,"ANTICAPITALISTES",2
17,"17123",365,274,266,8,8,"ANTICAPITALISTES",1
8,"8194",24757,15009,14799,245,210,"ANTICAPITALISTES",54
25,"25141",171,111,107,2,4,"ANTICAPITALISTES",5
17,"17041",237,153,153,1,0,"ANTICAPITALISTES",1
25,"25110",2662,1649,1602,44,47,"ANTICAPITALISTES",5
8,"8145",2597,1823,1784,23,39,"ANTICAPITALISTES",3
8,"8271",74,45,44,3,1,"ANTICAPITALISTES",0
8,"8003",6983,5061,4993,53,68,"ANTICAPITALISTES",23
25,"25254",782,533,531,9,2,"ANTICAPITALISTES",0
17,"17178",1075,683,679,15,4,"ANTICAPITALISTES",2
8,"8158",2996,2012,1986,19,26,"ANTICAPITALISTES",5
8,"8168",418,268,266,0,2,"ANTICAPITALISTES",0
8,"8023",6546,4261,4194,86,67,"ANTICAPITALISTES",17
8,"8081",332,232,225,2,7,"ANTICAPITALISTES",2
8,"8258",845,577,555,23,22,"ANTICAPITALISTES",5
43,"43050",2407,1528,1504,20,24,"ANTICAPITALISTES",1
25,"25902",581,411,395,15,16,"ANTICAPITALISTES",0
43,"43148",89309,59260,58346,1202,914,"ANTICAPITALISTES",190
17,"17116",369,230,227,3,3,"ANTICAPITALISTES",4
25,"25231",515,402,395,4,7,"ANTICAPITALISTES",0
25,"25192",799,543,527,19,16,"ANTICAPITALISTES",3
25,"25046",438,299,286,6,13,"ANTICAPITALISTES",0
43,"43164",298,233,231,4,2,"ANTICAPITALISTES",0
25,"25009",690,479,471,9,8,"ANTICAPITALISTES",0
43,"43136",10163,6312,6197,121,115,"ANTICAPITALISTES",4
17,"17087",230,170,161,6,9,"ANTICAPITALISTES",0
8,"8148",2240,1246,1223,22,23,"ANTICAPITALISTES",4
17,"17038",343,261,256,2,5,"ANTICAPITALISTES",1
25,"25197",158,102,101,2,1,"ANTICAPITALISTES",0
43,"43028",2654,1620,1588,27,32,"ANTICAPITALISTES",5
8,"8176",166,111,109,0,2,"ANTICAPITALISTES",1
43,"43106",878,600,592,17,8,"ANTICAPITALISTES",4
43,"43066",165,113,112,2,1,"ANTICAPITALISTES",0
17,"17100",201,140,135,1,5,"ANTICAPITALISTES",0
43,"43128",927,636,625,11,11,"ANTICAPITALISTES",0
8,"8078",224,154,151,2,3,"ANTICAPITALISTES",4
8,"8240",9104,6355,6262,101,93,"ANTICAPITALISTES",25
17,"17198",404,264,259,9,5,"ANTICAPITALISTES",2
43,"43096",103,81,77,3,4,"ANTICAPITALISTES",2
43,"43085",229,178,171,0,7,"ANTICAPITALISTES",2
17,"17073",1753,1320,1298,18,22,"ANTICAPITALISTES",5
8,"8903",217,178,176,10,2,"ANTICAPITALISTES",0
17,"17016",725,491,481,8,10,"ANTICAPITALISTES",3
8,"8242",243,174,172,5,2,"ANTICAPITALISTES",3
43,"43069",194,131,127,3,4,"ANTICAPITALISTES",0
25,"25248",926,615,601,17,14,"ANTICAPITALISTES",3
8,"8202",12206,8265,8129,183,136,"ANTICAPITALISTES",36
8,"8055",476,312,304,11,8,"ANTICAPITALISTES",1
17,"17078",346,231,226,3,5,"ANTICAPITALISTES",1
25,"25064",122,91,88,7,3,"ANTICAPITALISTES",2
8,"8013",1234,834,820,23,14,"ANTICAPITALISTES",4
25,"25051",1710,1060,1044,23,16,"ANTICAPITALISTES",2
8,"8137",255,190,190,3,0,"ANTICAPITALISTES",2
8,"8020",4542,3352,3298,77,54,"ANTICAPITALISTES",17
17,"17220",780,550,545,13,5,"ANTICAPITALISTES",2
17,"17065",316,211,205,6,6,"ANTICAPITALISTES",1
25,"25055",187,115,115,3,0,"ANTICAPITALISTES",3
25,"25216",250,175,173,5,2,"ANTICAPITALISTES",0
8,"8097",985,676,657,3,19,"ANTICAPITALISTES",4
8,"8077",33925,23896,23548,381,348,"ANTICAPITALISTES",87
17,"17094",1161,694,683,11,11,"ANTICAPITALISTES",1
8,"8104",713,454,441,9,13,"ANTICAPITALISTES",1
8,"8048",622,461,454,9,7,"ANTICAPITALISTES",0
43,"43906",2050,1332,1298,28,34,"ANTICAPITALISTES",3
25,"25194",440,292,283,11,9,"ANTICAPITALISTES",0
43,"43103",897,586,575,21,11,"ANTICAPITALISTES",1
43,"43137",1873,1241,1212,27,29,"ANTICAPITALISTES",3
43,"43044",3990,2768,2715,72,53,"ANTICAPITALISTES",0
17,"17170",192,135,134,1,1,"ANTICAPITALISTES",0
17,"17199",6630,4242,4162,80,80,"ANTICAPITALISTES",9
17,"17902",1330,898,874,11,24,"ANTICAPITALISTES",3
25,"25118",378,232,226,4,6,"ANTICAPITALISTES",1
8,"8084",1134,789,760,14,29,"ANTICAPITALISTES",3
17,"17030",624,414,409,8,5,"ANTICAPITALISTES",0
25,"25133",748,499,483,7,16,"ANTICAPITALISTES",0
25,"25001",146,76,76,1,0,"ANTICAPITALISTES",0
8,"8099",808,533,519,11,14,"ANTICAPITALISTES",5
43,"43120",454,287,283,1,4,"ANTICAPITALISTES",2
17,"17224",355,246,241,10,5,"ANTICAPITALISTES",0
8,"8182",2802,1871,1852,35,19,"ANTICAPITALISTES",5
25,"25171",2305,1496,1469,37,27,"ANTICAPITALISTES",2
25,"25027",1042,691,665,11,26,"ANTICAPITALISTES",1
17,"17005",404,258,254,12,4,"ANTICAPITALISTES",0
17,"17101",567,349,339,4,10,"ANTICAPITALISTES",1
8,"8147",17023,11177,10961,184,216,"ANTICAPITALISTES",35
43,"43042",2071,1504,1485,28,19,"ANTICAPITALISTES",3
17,"17112",215,141,138,4,3,"ANTICAPITALISTES",0
8,"8146",1321,876,862,18,14,"ANTICAPITALISTES",0
17,"17076",126,77,76,5,1,"ANTICAPITALISTES",1
25,"25014",264,170,164,11,6,"ANTICAPITALISTES",1
8,"8210",4176,2661,2579,54,82,"ANTICAPITALISTES",9
43,"43905",13621,8120,8011,131,109,"ANTICAPITALISTES",15
8,"8234",3143,2040,2008,45,32,"ANTICAPITALISTES",14
8,"8187",149633,104021,102629,1794,1392,"ANTICAPITALISTES",598
25,"25253",175,132,129,1,3,"ANTICAPITALISTES",0
25,"25169",201,134,134,6,0,"ANTICAPITALISTES",0
8,"8057",61,41,40,1,1,"ANTICAPITALISTES",0
17,"17226",852,539,535,0,4,"ANTICAPITALISTES",1
8,"8088",11250,8019,7861,144,158,"ANTICAPITALISTES",33
17,"17077",580,374,372,5,2,"ANTICAPITALISTES",0
17,"17012",1093,689,679,11,10,"ANTICAPITALISTES",7
8,"8155",6573,4411,4334,85,77,"ANTICAPITALISTES",18
17,"17210",527,358,349,9,9,"ANTICAPITALISTES",5
17,"17121",230,159,158,7,1,"ANTICAPITALISTES",0
17,"17026",542,404,398,3,6,"ANTICAPITALISTES",1
17,"17158",404,266,264,3,2,"ANTICAPITALISTES",0
25,"25222",69,55,54,0,1,"ANTICAPITALISTES",0
43,"43047",4064,2412,2352,50,60,"ANTICAPITALISTES",4
25,"25031",57,34,34,1,0,"ANTICAPITALISTES",0
8,"8091",5106,3379,3312,59,67,"ANTICAPITALISTES",11
43,"43065",443,278,270,8,8,"ANTICAPITALISTES",0
8,"8178",450,311,304,3,7,"ANTICAPITALISTES",2
8,"8166",1138,726,706,10,20,"ANTICAPITALISTES",1
8,"8162",1955,1306,1271,28,35,"ANTICAPITALISTES",3
43,"43114",383,238,234,6,4,"ANTICAPITALISTES",2
8,"8025",1460,990,963,14,27,"ANTICAPITALISTES",9
25,"25207",6253,3938,3872,91,66,"ANTICAPITALISTES",14
43,"43049",805,555,536,6,19,"ANTICAPITALISTES",6
17,"17027",2865,1955,1892,34,63,"ANTICAPITALISTES",9
8,"8203",2442,1526,1498,34,28,"ANTICAPITALISTES",4
17,"17140",684,476,470,10,6,"ANTICAPITALISTES",1
25,"25124",161,110,109,4,1,"ANTICAPITALISTES",0
17,"17202",3799,2398,2366,44,32,"ANTICAPITALISTES",4
17,"17068",252,156,156,4,0,"ANTICAPITALISTES",0
8,"8056",39345,26705,26396,449,309,"ANTICAPITALISTES",75
8,"8220",2277,1641,1604,44,37,"ANTICAPITALISTES",4
17,"17103",4988,2788,2724,51,64,"ANTICAPITALISTES",9
43,"43142",1155,730,714,20,16,"ANTICAPITALISTES",3
17,"17144",217,145,143,4,2,"ANTICAPITALISTES",0
25,"25243",3408,2280,2252,49,28,"ANTICAPITALISTES",6
25,"25240",1398,976,958,17,18,"ANTICAPITALISTES",3
8,"8161",10991,6841,6709,114,132,"ANTICAPITALISTES",24
8,"8278",4668,3033,2949,67,84,"ANTICAPITALISTES",8
8,"8301",47343,32098,31664,672,434,"ANTICAPITALISTES",92
43,"43126",1170,802,783,19,19,"ANTICAPITALISTES",7
8,"8036",172,124,124,4,0,"ANTICAPITALISTES",0
17,"17055",158,121,121,4,0,"ANTICAPITALISTES",0
17,"17218",568,361,350,11,11,"ANTICAPITALISTES",2
43,"43007",635,448,441,7,7,"ANTICAPITALISTES",0
25,"25164",404,270,264,5,6,"ANTICAPITALISTES",0
17,"17129",126,91,90,3,1,"ANTICAPITALISTES",0
43,"43130",196,132,131,7,1,"ANTICAPITALISTES",0
8,"8152",129,94,93,0,1,"ANTICAPITALISTES",2
43,"43032",587,418,413,9,5,"ANTICAPITALISTES",0
25,"25191",353,234,227,5,7,"ANTICAPITALISTES",1
43,"43111",2096,1305,1281,19,24,"ANTICAPITALISTES",1
8,"8298",25338,16982,16690,353,292,"ANTICAPITALISTES",42
43,"43016",3437,2323,2266,40,57,"ANTICAPITALISTES",11
25,"25085",153,103,100,2,3,"ANTICAPITALISTES",1
25,"25200",353,225,217,4,8,"ANTICAPITALISTES",1
8,"8001",8538,5929,5838,120,91,"ANTICAPITALISTES",21
8,"8175",3477,2303,2270,39,33,"ANTICAPITALISTES",8
43,"43166",1521,1002,977,17,25,"ANTICAPITALISTES",2
17,"17137",3331,2163,2110,39,53,"ANTICAPITALISTES",10
25,"25010",206,119,118,7,1,"ANTICAPITALISTES",1
8,"8126",8299,5599,5508,103,91,"ANTICAPITALISTES",25
17,"17024",301,207,204,4,3,"ANTICAPITALISTES",0
17,"17232",159,107,104,0,3,"ANTICAPITALISTES",1
25,"25212",233,185,185,8,0,"ANTICAPITALISTES",0
8,"8164",873,606,584,13,22,"ANTICAPITALISTES",4
43,"43022",1559,1097,1074,22,23,"ANTICAPITALISTES",0
8,"8212",508,366,363,1,3,"ANTICAPITALISTES",0
17,"17051",201,146,142,4,4,"ANTICAPITALISTES",0
25,"25123",206,140,136,4,4,"ANTICAPITALISTES",0
25,"25037",396,275,273,9,2,"ANTICAPITALISTES",1
8,"8171",2158,1385,1359,27,26,"ANTICAPITALISTES",2
8,"8237",1692,1155,1127,22,28,"ANTICAPITALISTES",1
25,"25157",183,128,128,4,0,"ANTICAPITALISTES",0
25,"25175",221,151,150,0,1,"ANTICAPITALISTES",1
17,"17214",695,470,461,10,9,"ANTICAPITALISTES",2
8,"8073",60247,41448,40843,770,605,"ANTICAPITALISTES",298
43,"43020",2119,1463,1427,26,36,"ANTICAPITALISTES",4
17,"17120",779,501,485,9,16,"ANTICAPITALISTES",1
8,"8190",281,201,197,3,4,"ANTICAPITALISTES",0
17,"17119",89,65,64,3,1,"ANTICAPITALISTES",0
25,"25215",399,229,226,4,3,"ANTICAPITALISTES",3
8,"8211",32035,23059,22687,453,372,"ANTICAPITALISTES",112
25,"25218",94,75,73,1,2,"ANTICAPITALISTES",0
25,"25154",126,77,77,2,0,"ANTICAPITALISTES",0
8,"8248",5239,3513,3443,71,70,"ANTICAPITALISTES",6
43,"43072",97,73,70,0,3,"ANTICAPITALISTES",0
17,"17093",859,561,552,16,9,"ANTICAPITALISTES",0
8,"8198",4112,2766,2661,49,105,"ANTICAPITALISTES",8
8,"8105",9642,6571,6483,110,88,"ANTICAPITALISTES",37
25,"25102",733,478,464,15,14,"ANTICAPITALISTES",0
17,"17148",1546,980,957,24,23,"ANTICAPITALISTES",7
17,"17149",366,254,251,4,3,"ANTICAPITALISTES",2
25,"25099",1185,720,709,9,11,"ANTICAPITALISTES",3
8,"8129",444,278,271,2,7,"ANTICAPITALISTES",1
8,"8022",12437,7598,7445,169,153,"ANTICAPITALISTES",8
8,"8052",148,103,98,1,5,"ANTICAPITALISTES",0
25,"25209",1558,1041,1009,22,32,"ANTICAPITALISTES",5
8,"8297",138,99,99,2,0,"ANTICAPITALISTES",1
8,"8236",1507,1027,1002,18,25,"ANTICAPITALISTES",3
43,"43068",573,388,378,5,10,"ANTICAPITALISTES",1
8,"8130",95,63,62,3,1,"ANTICAPITALISTES",1
25,"25100",207,125,115,2,10,"ANTICAPITALISTES",0
8,"8156",10672,7359,7225,121,134,"ANTICAPITALISTES",7
25,"25156",761,535,529,15,6,"ANTICAPITALISTES",0
25,"25045",51,33,33,2,0,"ANTICAPITALISTES",0
25,"25181",189,128,123,3,5,"ANTICAPITALISTES",0
43,"43057",45,27,27,2,0,"ANTICAPITALISTES",0
8,"8274",4887,3326,3279,36,47,"ANTICAPITALISTES",6
8,"8308",145,116,115,1,1,"ANTICAPITALISTES",0
43,"43147",528,393,380,7,13,"ANTICAPITALISTES",0
43,"43094",2209,1558,1524,31,34,"ANTICAPITALISTES",4
8,"8046",12603,8826,8663,190,163,"ANTICAPITALISTES",54
25,"25126",286,192,189,7,3,"ANTICAPITALISTES",3
25,"25007",1363,902,885,36,17,"ANTICAPITALISTES",4
8,"8154",677,499,488,2,11,"ANTICAPITALISTES",1
25,"25148",232,144,144,5,0,"ANTICAPITALISTES",0
8,"8141",4666,3124,3066,57,58,"ANTICAPITALISTES",8
8,"8268",1110,768,755,17,13,"ANTICAPITALISTES",1
25,"25205",563,373,362,12,11,"ANTICAPITALISTES",0
8,"8093",32,21,20,0,1,"ANTICAPITALISTES",0
25,"25177",379,240,236,2,4,"ANTICAPITALISTES",4
43,"43080",254,175,173,7,2,"ANTICAPITALISTES",0
8,"8087",158,133,132,6,1,"ANTICAPITALISTES",1
8,"8180",26210,17504,17214,366,290,"ANTICAPITALISTES",126
8,"8179",591,415,405,6,10,"ANTICAPITALISTES",2
17,"17046",738,510,498,15,12,"ANTICAPITALISTES",0
8,"8139",184,130,128,1,2,"ANTICAPITALISTES",3
25,"25076",165,84,83,3,1,"ANTICAPITALISTES",0
25,"25047",1048,760,748,24,12,"ANTICAPITALISTES",1
17,"17096",182,96,94,2,2,"ANTICAPITALISTES",1
17,"17039",1850,1299,1275,31,24,"ANTICAPITALISTES",8
43,"43127",778,530,524,6,6,"ANTICAPITALISTES",0
43,"43004",6411,4089,4001,92,88,"ANTICAPITALISTES",1
43,"43163",24903,15475,15241,263,234,"ANTICAPITALISTES",37
25,"25909",141,82,78,0,4,"ANTICAPITALISTES",0
8,"8045",70,42,42,2,0,"ANTICAPITALISTES",1
8,"8038",1406,911,895,24,16,"ANTICAPITALISTES",3
8,"8075",3906,2442,2414,31,28,"ANTICAPITALISTES",7
17,"17054",395,250,247,3,3,"ANTICAPITALISTES",0
8,"8206",717,557,547,7,10,"ANTICAPITALISTES",0
8,"8123",18751,13394,13154,238,240,"ANTICAPITALISTES",76
8,"8150",245,181,178,11,3,"ANTICAPITALISTES",1
8,"8170",458,300,288,13,12,"ANTICAPITALISTES",1
25,"25068",576,376,364,6,12,"ANTICAPITALISTES",1
43,"43104",1821,1209,1178,34,31,"ANTICAPITALISTES",4
43,"43161",17199,10765,10547,197,218,"ANTICAPITALISTES",31
43,"43172",378,268,266,8,2,"ANTICAPITALISTES",1
43,"43088",1810,1199,1177,29,22,"ANTICAPITALISTES",1
17,"17044",6619,4293,4187,69,106,"ANTICAPITALISTES",10
17,"17160",14852,9257,9128,145,129,"ANTICAPITALISTES",21
8,"8049",1340,839,816,10,23,"ANTICAPITALISTES",1
8,"8067",5657,3772,3671,75,101,"ANTICAPITALISTES",4
25,"25912",899,643,640,6,3,"ANTICAPITALISTES",2
8,"8107",10955,7236,7130,151,106,"ANTICAPITALISTES",21
17,"17082",443,285,280,1,5,"ANTICAPITALISTES",1
8,"8144",769,494,481,16,13,"ANTICAPITALISTES",2
8,"8221",11348,8413,8306,109,107,"ANTICAPITALISTES",52
8,"8277",134,90,90,4,0,"ANTICAPITALISTES",1
17,"17176",141,96,95,3,1,"ANTICAPITALISTES",0
8,"8111",220,188,188,4,0,"ANTICAPITALISTES",0
8,"8117",2424,1685,1661,45,24,"ANTICAPITALISTES",10
17,"17230",456,326,320,10,6,"ANTICAPITALISTES",2
25,"25172",1838,1267,1230,35,37,"ANTICAPITALISTES",2
25,"25058",4390,2696,2650,57,46,"ANTICAPITALISTES",8
25,"25152",160,92,90,4,2,"ANTICAPITALISTES",0
8,"8285",10168,6582,6423,152,159,"ANTICAPITALISTES",22
8,"8071",248,172,167,2,5,"ANTICAPITALISTES",0
8,"8255",132,83,82,1,1,"ANTICAPITALISTES",0
25,"25092",135,100,97,2,3,"ANTICAPITALISTES",1
8,"8293",246,145,145,4,0,"ANTICAPITALISTES",1
25,"25203",8995,5418,5309,116,109,"ANTICAPITALISTES",13
8,"8262",6835,4086,3993,94,93,"ANTICAPITALISTES",9
17,"17197",144,103,102,3,1,"ANTICAPITALISTES",1
43,"43073",90,57,57,1,0,"ANTICAPITALISTES",0
25,"25114",102,82,78,4,4,"ANTICAPITALISTES",0
25,"25050",3249,2056,1988,40,68,"ANTICAPITALISTES",7
43,"43013",4369,2795,2747,54,48,"ANTICAPITALISTES",2
8,"8296",1683,1227,1203,29,24,"ANTICAPITALISTES",5
25,"25176",341,243,240,7,3,"ANTICAPITALISTES",3
8,"8270",17464,11828,11677,212,151,"ANTICAPITALISTES",43
25,"25220",1076,711,702,10,9,"ANTICAPITALISTES",3
43,"43081",574,415,404,13,11,"ANTICAPITALISTES",3
25,"25134",657,421,416,4,5,"ANTICAPITALISTES",2
8,"8287",1053,738,730,26,8,"ANTICAPITALISTES",2
8,"8113",52352,33606,33123,590,483,"ANTICAPITALISTES",124
17,"17211",864,628,612,12,16,"ANTICAPITALISTES",0
43,"43160",1278,840,812,9,28,"ANTICAPITALISTES",2
17,"17172",426,286,283,3,3,"ANTICAPITALISTES",5
25,"25247",142,80,78,3,2,"ANTICAPITALISTES",0
25,"25042",211,131,127,0,4,"ANTICAPITALISTES",1
8,"8032",1955,1330,1294,18,36,"ANTICAPITALISTES",10
8,"8247",903,627,608,10,19,"ANTICAPITALISTES",3
17,"17186",3593,2358,2317,33,41,"ANTICAPITALISTES",14
25,"25185",690,409,404,8,5,"ANTICAPITALISTES",4
43,"43076",467,308,300,7,8,"ANTICAPITALISTES",0
43,"43011",1013,745,729,21,16,"ANTICAPITALISTES",4
17,"17019",1783,1264,1234,42,30,"ANTICAPITALISTES",2
25,"25101",583,391,382,8,9,"ANTICAPITALISTES",0
25,"25002",481,306,302,6,4,"ANTICAPITALISTES",0
25,"25135",1077,739,722,18,17,"ANTICAPITALISTES",0
8,"8050",149,112,108,4,4,"ANTICAPITALISTES",0
43,"43045",156,110,109,1,1,"ANTICAPITALISTES",0
8,"8241",80,61,61,1,0,"ANTICAPITALISTES",0
17,"17184",1281,803,787,21,16,"ANTICAPITALISTES",3
17,"17212",129,100,98,4,2,"ANTICAPITALISTES",0
17,"17222",108,86,86,1,0,"ANTICAPITALISTES",0
43,"43067",626,445,431,21,14,"ANTICAPITALISTES",1
25,"25127",226,134,130,2,4,"ANTICAPITALISTES",1
8,"8289",4123,2802,2768,54,34,"ANTICAPITALISTES",24
25,"25225",603,395,387,7,8,"ANTICAPITALISTES",0
43,"43154",136,97,96,6,1,"ANTICAPITALISTES",0
17,"17099",74,52,50,1,2,"ANTICAPITALISTES",0
17,"17128",309,232,224,5,8,"ANTICAPITALISTES",0
8,"8292",1083,775,764,21,11,"ANTICAPITALISTES",2
17,"17118",12541,7817,7681,130,136,"ANTICAPITALISTES",26
8,"8218",7968,5014,4932,129,82,"ANTICAPITALISTES",17
8,"8011",1754,1116,1085,29,31,"ANTICAPITALISTES",4
8,"8229",561,404,398,12,6,"ANTICAPITALISTES",2
8,"8143",2679,1772,1756,35,16,"ANTICAPITALISTES",6
8,"8082",1143,733,723,17,10,"ANTICAPITALISTES",2
8,"8243",160,112,110,3,2,"ANTICAPITALISTES",1
8,"8300",5621,4021,3933,94,88,"ANTICAPITALISTES",17
8,"8035",12099,7838,7735,123,103,"ANTICAPITALISTES",26
8,"8096",40650,28247,27784,527,463,"ANTICAPITALISTES",60
8,"8015",155673,101652,100264,1628,1388,"ANTICAPITALISTES",358
8,"8199",712,507,499,15,8,"ANTICAPITALISTES",4
17,"17022",6771,4247,4169,76,78,"ANTICAPITALISTES",12
17,"17043",159,101,100,2,1,"ANTICAPITALISTES",1
25,"25196",127,87,86,3,1,"ANTICAPITALISTES",7
25,"25016",2203,1375,1357,20,18,"ANTICAPITALISTES",12
8,"8189",141,113,111,4,2,"ANTICAPITALISTES",1
25,"25120",90759,58761,57778,1325,983,"ANTICAPITALISTES",152
17,"17011",625,472,467,5,5,"ANTICAPITALISTES",3
25,"25190",271,180,176,12,4,"ANTICAPITALISTES",0
25,"25081",332,212,206,6,6,"ANTICAPITALISTES",0
25,"25011",5241,3127,3080,48,47,"ANTICAPITALISTES",2
17,"17173",174,121,119,1,2,"ANTICAPITALISTES",1
43,"43009",1421,913,897,18,16,"ANTICAPITALISTES",2
43,"43058",106,76,76,5,0,"ANTICAPITALISTES",0
17,"17060",378,240,233,1,7,"ANTICAPITALISTES",1
25,"25039",299,189,186,7,3,"ANTICAPITALISTES",1
25,"25021",2693,1632,1605,40,27,"ANTICAPITALISTES",6
17,"17190",811,548,532,7,16,"ANTICAPITALISTES",2
25,"25149",1401,1031,1010,17,21,"ANTICAPITALISTES",3
8,"8037",1830,1247,1209,40,38,"ANTICAPITALISTES",3
17,"17139",1346,899,869,21,30,"ANTICAPITALISTES",0
17,"17015",12254,7759,7553,143,206,"ANTICAPITALISTES",25
8,"8232",1793,1239,1220,20,19,"ANTICAPITALISTES",2
8,"8159",13482,9173,9040,239,133,"ANTICAPITALISTES",30
25,"25232",1480,968,959,38,9,"ANTICAPITALISTES",1
17,"17903",893,565,556,14,9,"ANTICAPITALISTES",1
25,"25206",289,187,184,3,3,"ANTICAPITALISTES",0
17,"17010",327,216,214,6,2,"ANTICAPITALISTES",4
25,"25238",231,158,156,1,2,"ANTICAPITALISTES",0
17,"17200",616,406,393,12,13,"ANTICAPITALISTES",2
17,"17125",132,90,89,1,1,"ANTICAPITALISTES",0
43,"43119",739,500,496,5,4,"ANTICAPITALISTES",1
17,"17033",5157,3142,3095,44,47,"ANTICAPITALISTES",6
25,"25242",787,501,490,11,11,"ANTICAPITALISTES",1
8,"8266",42860,30047,29521,536,526,"ANTICAPITALISTES",229
17,"17227",107,82,82,1,0,"ANTICAPITALISTES",0
43,"43062",298,227,223,7,4,"ANTICAPITALISTES",0
8,"8294",1870,1205,1171,22,34,"ANTICAPITALISTES",5
17,"17188",167,124,122,9,2,"ANTICAPITALISTES",0
8,"8263",20729,13742,13563,232,179,"ANTICAPITALISTES",55
25,"25161",361,222,218,1,4,"ANTICAPITALISTES",0
17,"17008",3745,2262,2195,34,67,"ANTICAPITALISTES",3
8,"8008",193,119,114,5,5,"ANTICAPITALISTES",0
25,"25255",468,318,309,9,9,"ANTICAPITALISTES",2
25,"25140",785,472,460,5,12,"ANTICAPITALISTES",1
17,"17018",478,337,332,8,5,"ANTICAPITALISTES",0
8,"8230",7452,5349,5286,94,63,"ANTICAPITALISTES",15
25,"25020",328,216,209,4,7,"ANTICAPITALISTES",0
43,"43150",1337,994,977,12,17,"ANTICAPITALISTES",2
17,"17164",4092,2409,2346,60,63,"ANTICAPITALISTES",5
17,"17195",324,220,214,6,6,"ANTICAPITALISTES",1
43,"43039",117,85,83,3,2,"ANTICAPITALISTES",0
25,"25078",1014,730,719,17,11,"ANTICAPITALISTES",1
17,"17192",145,107,105,4,2,"ANTICAPITALISTES",0
25,"25165",301,202,198,6,4,"ANTICAPITALISTES",0
17,"17097",185,136,136,4,0,"ANTICAPITALISTES",1
25,"25129",175,105,105,3,0,"ANTICAPITALISTES",0
8,"8305",26208,17810,17506,296,304,"ANTICAPITALISTES",65
8,"8040",10538,6916,6804,99,112,"ANTICAPITALISTES",18
17,"17151",174,131,131,6,0,"ANTICAPITALISTES",1
8,"8101",169663,112624,111107,1841,1517,"ANTICAPITALISTES",375
25,"25069",471,291,289,9,2,"ANTICAPITALISTES",2
17,"17171",148,111,109,5,2,"ANTICAPITALISTES",0
8,"8122",1755,1063,1034,17,29,"ANTICAPITALISTES",7
17,"17070",116,78,78,3,0,"ANTICAPITALISTES",0
8,"8225",92,68,68,2,0,"ANTICAPITALISTES",0
17,"17056",1704,1171,1158,21,13,"ANTICAPITALISTES",6
8,"8222",1827,1343,1317,21,26,"ANTICAPITALISTES",5
43,"43005",3559,2191,2147,47,44,"ANTICAPITALISTES",2
43,"43021",381,218,213,3,5,"ANTICAPITALISTES",2
8,"8068",6554,4323,4255,87,68,"ANTICAPITALISTES",23
25,"25070",888,594,582,18,12,"ANTICAPITALISTES",2
8,"8306",509,330,324,6,6,"ANTICAPITALISTES",1
43,"43090",1142,644,636,7,8,"ANTICAPITALISTES",0
8,"8116",600,401,393,9,8,"ANTICAPITALISTES",2
8,"8072",9910,6326,6235,140,91,"ANTICAPITALISTES",36
43,"43902",2761,1836,1811,25,25,"ANTICAPITALISTES",1
25,"25217",10570,6660,6500,191,160,"ANTICAPITALISTES",22
25,"25125",450,297,289,10,8,"ANTICAPITALISTES",0
25,"25013",2274,1344,1321,25,23,"ANTICAPITALISTES",2
8,"8163",17986,11683,11548,159,135,"ANTICAPITALISTES",26
8,"8256",669,498,496,16,2,"ANTICAPITALISTES",3
25,"25250",358,237,234,4,3,"ANTICAPITALISTES",5
25,"25249",207,151,150,4,1,"ANTICAPITALISTES",0
25,"25093",657,465,455,8,10,"ANTICAPITALISTES",0
25,"25226",257,162,158,5,4,"ANTICAPITALISTES",1
43,"43099",330,240,236,4,4,"ANTICAPITALISTES",0
17,"17233",2192,1470,1434,33,36,"ANTICAPITALISTES",4
17,"17163",2478,1729,1681,41,48,"ANTICAPITALISTES",10
17,"17034",6723,4131,4064,77,67,"ANTICAPITALISTES",10
17,"17029",198,136,133,1,3,"ANTICAPITALISTES",1
43,"43082",383,282,270,8,12,"ANTICAPITALISTES",0
8,"8207",1718,1296,1256,28,40,"ANTICAPITALISTES",7
8,"8244",5746,4044,3940,102,104,"ANTICAPITALISTES",56
8,"8295",10579,6896,6769,137,127,"ANTICAPITALISTES",57
17,"17189",1536,1061,1025,7,36,"ANTICAPITALISTES",0
17,"17079",62633,40844,40101,670,743,"ANTICAPITALISTES",188
43,"43167",390,284,280,12,4,"ANTICAPITALISTES",0
43,"43116",494,328,325,5,3,"ANTICAPITALISTES",0
8,"8034",741,542,529,4,13,"ANTICAPITALISTES",2
17,"17135",380,273,269,9,4,"ANTICAPITALISTES",1
17,"17234",183,131,128,2,3,"ANTICAPITALISTES",0
8,"8177",52,31,31,1,0,"ANTICAPITALISTES",0
43,"43010",302,227,223,7,4,"ANTICAPITALISTES",2
25,"25167",253,176,172,0,4,"ANTICAPITALISTES",0
8,"8021",76,49,47,1,2,"ANTICAPITALISTES",0
8,"8031",2289,1619,1599,34,20,"ANTICAPITALISTES",9
43,"43024",1459,958,937,17,21,"ANTICAPITALISTES",1
8,"8307",47176,31341,30846,536,495,"ANTICAPITALISTES",129
17,"17132",1296,913,900,15,13,"ANTICAPITALISTES",4
25,"25119",2297,1554,1513,46,41,"ANTICAPITALISTES",5
43,"43117",150,118,115,1,3,"ANTICAPITALISTES",0
8,"8239",471,338,333,6,5,"ANTICAPITALISTES",0
8,"8195",88,64,64,2,0,"ANTICAPITALISTES",1
17,"17064",341,253,250,4,3,"ANTICAPITALISTES",0
17,"17155",14284,8528,8391,143,137,"ANTICAPITALISTES",27
43,"43093",3924,2507,2445,62,62,"ANTICAPITALISTES",1
8,"8065",1224,796,778,13,18,"ANTICAPITALISTES",5
17,"17115",281,209,207,5,2,"ANTICAPITALISTES",0
8,"8260",17869,11898,11686,215,212,"ANTICAPITALISTES",36
25,"25230",1665,1164,1140,36,24,"ANTICAPITALISTES",1
17,"17075",304,216,210,5,6,"ANTICAPITALISTES",3
8,"8005",5884,4114,4041,68,73,"ANTICAPITALISTES",14
17,"17205",198,146,138,3,8,"ANTICAPITALISTES",1
8,"8157",8256,5729,5624,119,105,"ANTICAPITALISTES",21
25,"25036",190,138,134,5,4,"ANTICAPITALISTES",2
8,"8026",180,144,143,0,1,"ANTICAPITALISTES",0
43,"43158",109,63,61,5,2,"ANTICAPITALISTES",0
8,"8094",1500,1102,1071,21,31,"ANTICAPITALISTES",0
25,"25061",75,45,45,0,0,"ANTICAPITALISTES",0
8,"8131",696,483,469,7,14,"ANTICAPITALISTES",0
25,"25910",118,77,76,3,1,"ANTICAPITALISTES",0
17,"17062",5994,3686,3614,69,72,"ANTICAPITALISTES",14
43,"43107",378,255,248,18,7,"ANTICAPITALISTES",0
17,"17109",759,428,414,10,14,"ANTICAPITALISTES",8
43,"43121",636,385,371,6,14,"ANTICAPITALISTES",1
8,"8080",42,33,33,2,0,"ANTICAPITALISTES",0
17,"17147",8385,5401,5325,105,76,"ANTICAPITALISTES",19
25,"25211",701,378,368,5,10,"ANTICAPITALISTES",1
8,"8006",10984,7255,7092,104,163,"ANTICAPITALISTES",16
8,"8118",17077,11817,11598,203,219,"ANTICAPITALISTES",51
17,"17035",548,385,379,7,6,"ANTICAPITALISTES",0
25,"25017",248,160,159,1,1,"ANTICAPITALISTES",2
17,"17159",639,408,397,3,11,"ANTICAPITALISTES",4
25,"25087",65,41,39,0,2,"ANTICAPITALISTES",0
43,"43037",16656,9986,9812,163,174,"ANTICAPITALISTES",53
43,"43135",327,243,238,2,5,"ANTICAPITALISTES",0
25,"25158",1647,1154,1135,27,19,"ANTICAPITALISTES",1
17,"17901",964,628,621,16,7,"ANTICAPITALISTES",5
43,"43168",106,70,69,2,1,"ANTICAPITALISTES",0
25,"25019",4626,2971,2932,54,39,"ANTICAPITALISTES",5
8,"8027",673,527,515,9,12,"ANTICAPITALISTES",2
8,"8007",6338,4165,4050,89,115,"ANTICAPITALISTES",18
17,"17084",269,177,175,4,2,"ANTICAPITALISTES",0
25,"25131",439,319,314,6,5,"ANTICAPITALISTES",0
8,"8028",1049,667,657,15,10,"ANTICAPITALISTES",0
43,"43095",2434,1658,1624,27,34,"ANTICAPITALISTES",3
25,"25139",549,358,357,5,1,"ANTICAPITALISTES",1
8,"8160",313,227,222,8,5,"ANTICAPITALISTES",0
43,"43054",2850,1815,1771,37,44,"ANTICAPITALISTES",8
8,"8018",2664,1707,1669,29,38,"ANTICAPITALISTES",6
17,"17217",347,267,251,5,16,"ANTICAPITALISTES",3
43,"43144",1187,787,772,12,15,"ANTICAPITALISTES",4
17,"17048",6176,3818,3773,52,45,"ANTICAPITALISTES",10
8,"8019",1143222,778246,767530,12386,10716,"ANTICAPITALISTES",3719
8,"8233",1867,1179,1169,29,10,"ANTICAPITALISTES",2
17,"17130",333,236,233,5,3,"ANTICAPITALISTES",2
43,"43036",836,503,494,4,9,"ANTICAPITALISTES",0
17,"17166",503,361,342,10,19,"ANTICAPITALISTES",3
25,"25034",2471,1622,1592,25,30,"ANTICAPITALISTES",3
17,"17071",1064,719,698,33,21,"ANTICAPITALISTES",4
25,"25112",286,202,199,11,3,"ANTICAPITALISTES",0
17,"17058",177,115,114,2,1,"ANTICAPITALISTES",1
17,"17063",169,113,111,5,2,"ANTICAPITALISTES",0
25,"25151",641,451,444,20,7,"ANTICAPITALISTES",2
43,"43077",486,335,328,4,7,"ANTICAPITALISTES",0
8,"8183",4497,2914,2865,43,49,"ANTICAPITALISTES",8
43,"43089",272,193,185,1,8,"ANTICAPITALISTES",0
25,"25003",3853,2367,2340,68,27,"ANTICAPITALISTES",3
8,"8060",167,102,101,0,1,"ANTICAPITALISTES",0
25,"25163",237,147,142,2,5,"ANTICAPITALISTES",0
25,"25234",4572,2707,2648,57,59,"ANTICAPITALISTES",5
43,"43048",830,547,530,16,17,"ANTICAPITALISTES",0
43,"43105",175,119,116,14,3,"ANTICAPITALISTES",2
43,"43031",1509,1016,992,20,24,"ANTICAPITALISTES",4
17,"17133",1336,889,866,14,23,"ANTICAPITALISTES",1
25,"25038",1606,1104,1093,19,11,"ANTICAPITALISTES",1
25,"25079",307,242,240,7,2,"ANTICAPITALISTES",0
8,"8215",2594,1763,1728,51,35,"ANTICAPITALISTES",4
25,"25182",1075,749,731,30,18,"ANTICAPITALISTES",2
17,"17080",165,115,114,1,1,"ANTICAPITALISTES",0
43,"43171",13906,8978,8855,167,123,"ANTICAPITALISTES",24
17,"17182",257,177,175,2,2,"ANTICAPITALISTES",0
8,"8286",2865,1843,1796,30,47,"ANTICAPITALISTES",10
8,"8062",863,595,583,8,12,"ANTICAPITALISTES",7
17,"17061",175,123,123,4,0,"ANTICAPITALISTES",0
8,"8041",10032,6880,6761,112,119,"ANTICAPITALISTES",24
8,"8102",27850,18716,18470,373,246,"ANTICAPITALISTES",46
25,"25103",125,82,80,4,2,"ANTICAPITALISTES",0
17,"17153",172,127,123,1,4,"ANTICAPITALISTES",1
17,"17031",172,94,93,1,1,"ANTICAPITALISTES",1
43,"43123",70216,45627,44828,906,799,"ANTICAPITALISTES",131
8,"8185",189,131,126,1,5,"ANTICAPITALISTES",0
43,"43098",362,251,247,1,4,"ANTICAPITALISTES",1
17,"17201",131,89,89,2,0,"ANTICAPITALISTES",0
17,"17183",261,178,176,2,2,"ANTICAPITALISTES",2
17,"17002",567,413,401,4,12,"ANTICAPITALISTES",1
8,"8083",1626,1199,1178,23,21,"ANTICAPITALISTES",5
43,"43904",2918,1779,1732,49,47,"ANTICAPITALISTES",4
43,"43015",104,69,68,2,1,"ANTICAPITALISTES",0
8,"8002",202,143,140,4,3,"ANTICAPITALISTES",1
25,"25071",56,37,35,2,2,"ANTICAPITALISTES",0
17,"17009",4089,2573,2490,59,83,"ANTICAPITALISTES",14
17,"17150",1428,1018,996,24,22,"ANTICAPITALISTES",2
8,"8213",6188,4031,3970,113,61,"ANTICAPITALISTES",15
8,"8281",4735,3239,3193,57,46,"ANTICAPITALISTES",14
25,"25094",154,110,107,1,3,"ANTICAPITALISTES",3
25,"25052",1611,1094,1062,21,32,"ANTICAPITALISTES",1
25,"25251",670,476,473,1,3,"ANTICAPITALISTES",0
17,"17124",1670,1087,1056,18,31,"ANTICAPITALISTES",4
25,"25024",370,221,217,8,4,"ANTICAPITALISTES",1
17,"17203",171,97,94,3,3,"ANTICAPITALISTES",1
25,"25166",177,127,125,3,2,"ANTICAPITALISTES",0
8,"8074",10224,6571,6479,116,92,"ANTICAPITALISTES",19
25,"25073",662,382,379,11,3,"ANTICAPITALISTES",0
17,"17136",173,124,120,0,4,"ANTICAPITALISTES",0
25,"25142",387,265,264,5,1,"ANTICAPITALISTES",1
43,"43157",388,282,270,10,12,"ANTICAPITALISTES",1
43,"43109",2040,1332,1316,28,16,"ANTICAPITALISTES",5
25,"25128",151,83,81,1,2,"ANTICAPITALISTES",0
43,"43125",1008,706,701,10,5,"ANTICAPITALISTES",0
25,"25252",536,361,352,13,9,"ANTICAPITALISTES",0
17,"17032",1613,933,918,11,15,"ANTICAPITALISTES",2
17,"17013",2774,1884,1859,21,25,"ANTICAPITALISTES",4
25,"25053",1085,733,727,10,6,"ANTICAPITALISTES",1
8,"8290",1446,1075,1056,12,19,"ANTICAPITALISTES",4
25,"25905",386,264,258,12,6,"ANTICAPITALISTES",0
43,"43101",146,94,93,3,1,"ANTICAPITALISTES",0
8,"8902",3600,2518,2496,57,22,"ANTICAPITALISTES",4
8,"8106",6858,4675,4559,113,116,"ANTICAPITALISTES",16
8,"8250",7083,4485,4426,72,59,"ANTICAPITALISTES",15
43,"43134",279,208,206,14,2,"ANTICAPITALISTES",0
43,"43110",307,216,214,5,2,"ANTICAPITALISTES",0
25,"25074",178,137,132,3,5,"ANTICAPITALISTES",0
17,"17225",208,138,134,1,4,"ANTICAPITALISTES",2
17,"17085",295,212,208,12,4,"ANTICAPITALISTES",0
17,"17167",2818,1886,1858,52,28,"ANTICAPITALISTES",6
43,"43118",439,318,313,7,5,"ANTICAPITALISTES",0
17,"17028",327,220,217,4,3,"ANTICAPITALISTES",0
8,"8267",6215,4100,4011,82,89,"ANTICAPITALISTES",19
8,"8254",1721,1189,1174,26,15,"ANTICAPITALISTES",4
8,"8193",928,565,554,15,11,"ANTICAPITALISTES",1
8,"8053",2850,1788,1772,21,16,"ANTICAPITALISTES",8
43,"43017",141,98,98,2,0,"ANTICAPITALISTES",1
43,"43055",2002,1404,1374,36,30,"ANTICAPITALISTES",2
17,"17141",5689,3485,3428,50,57,"ANTICAPITALISTES",4
43,"43053",190,149,149,2,0,"ANTICAPITALISTES",1
17,"17117",14022,8705,8595,129,110,"ANTICAPITALISTES",13
17,"17138",1010,677,662,3,15,"ANTICAPITALISTES",1
43,"43102",517,377,366,2,11,"ANTICAPITALISTES",1
25,"25244",350,270,268,9,2,"ANTICAPITALISTES",0
17,"17006",1203,759,754,17,5,"ANTICAPITALISTES",1
17,"17067",732,483,470,16,13,"ANTICAPITALISTES",2
17,"17207",2357,1636,1584,40,52,"ANTICAPITALISTES",8
8,"8098",2374,1552,1535,28,17,"ANTICAPITALISTES",6
25,"25067",768,498,494,14,4,"ANTICAPITALISTES",0
25,"25130",208,117,112,4,5,"ANTICAPITALISTES",0
8,"8128",557,377,374,16,3,"ANTICAPITALISTES",2
8,"8191",5520,3601,3536,64,65,"ANTICAPITALISTES",21
8,"8252",24033,16704,16402,368,302,"ANTICAPITALISTES",106
43,"43143",62,51,50,1,1,"ANTICAPITALISTES",0
8,"8030",4849,3466,3422,50,44,"ANTICAPITALISTES",18
8,"8253",134,91,91,2,0,"ANTICAPITALISTES",0
43,"43152",472,355,351,9,4,"ANTICAPITALISTES",0
8,"8109",200,155,153,1,2,"ANTICAPITALISTES",0
17,"17036",2822,1844,1806,36,38,"ANTICAPITALISTES",4
25,"25122",1956,1281,1256,33,25,"ANTICAPITALISTES",4
8,"8140",4665,3160,3103,55,57,"ANTICAPITALISTES",10
25,"25245",445,312,306,4,6,"ANTICAPITALISTES",2
43,"43006",712,484,475,10,9,"ANTICAPITALISTES",2
8,"8069",3028,2071,2029,36,42,"ANTICAPITALISTES",9
8,"8110",13366,8493,8329,144,164,"ANTICAPITALISTES",13
43,"43014",14146,9153,8915,204,238,"ANTICAPITALISTES",23
17,"17169",2460,1690,1651,34,39,"ANTICAPITALISTES",8
8,"8273",2287,1594,1547,18,47,"ANTICAPITALISTES",8
25,"25204",1313,888,881,21,7,"ANTICAPITALISTES",1
17,"17088",551,374,363,4,11,"ANTICAPITALISTES",1
25,"25113",1227,869,856,28,13,"ANTICAPITALISTES",3
25,"25143",86,58,58,1,0,"ANTICAPITALISTES",0
43,"43079",387,259,255,26,4,"ANTICAPITALISTES",0
25,"25089",107,66,64,0,2,"ANTICAPITALISTES",2
8,"8120",6342,4801,4746,63,55,"ANTICAPITALISTES",11
25,"25132",128,87,85,3,2,"ANTICAPITALISTES",0
25,"25901",315,196,189,3,7,"ANTICAPITALISTES",0
8,"8039",365,264,260,5,4,"ANTICAPITALISTES",1
17,"17209",605,469,463,21,6,"ANTICAPITALISTES",1
43,"43056",931,537,515,18,22,"ANTICAPITALISTES",2
25,"25049",166,105,102,1,3,"ANTICAPITALISTES",2
17,"17089",5486,3328,3288,43,40,"ANTICAPITALISTES",3
43,"43153",10307,6572,6450,94,122,"ANTICAPITALISTES",25
43,"43124",532,366,358,3,8,"ANTICAPITALISTES",1
8,"8010",4124,2674,2611,44,63,"ANTICAPITALISTES",13
8,"8172",19889,13537,13333,267,204,"ANTICAPITALISTES",107
43,"43178",1262,891,870,24,21,"ANTICAPITALISTES",4
25,"25012",2204,1432,1406,29,26,"ANTICAPITALISTES",3
25,"25173",1784,1177,1139,20,38,"ANTICAPITALISTES",2
8,"8184",52133,33696,33220,656,476,"ANTICAPITALISTES",157
25,"25004",553,405,400,13,5,"ANTICAPITALISTES",0
17,"17162",137,80,78,2,2,"ANTICAPITALISTES",1
43,"43040",350,251,246,18,5,"ANTICAPITALISTES",0
43,"43034",494,355,344,8,11,"ANTICAPITALISTES",1
43,"43083",141,97,97,2,0,"ANTICAPITALISTES",0
43,"43019",1356,868,837,13,31,"ANTICAPITALISTES",1
43,"43901",8849,5651,5540,179,111,"ANTICAPITALISTES",3
8,"8042",2172,1459,1448,30,11,"ANTICAPITALISTES",7
43,"43155",22951,14114,13856,326,258,"ANTICAPITALISTES",21
8,"8246",1714,1175,1153,27,22,"ANTICAPITALISTES",8
17,"17175",569,375,369,6,6,"ANTICAPITALISTES",0
17,"17001",557,370,365,7,5,"ANTICAPITALISTES",2
17,"17040",506,320,316,7,4,"ANTICAPITALISTES",3
8,"8133",157,100,97,2,3,"ANTICAPITALISTES",0
43,"43139",2166,1319,1270,37,49,"ANTICAPITALISTES",1
17,"17143",134,89,87,2,2,"ANTICAPITALISTES",1
43,"43115",171,112,110,3,2,"ANTICAPITALISTES",0
17,"17091",433,288,277,16,11,"ANTICAPITALISTES",0
8,"8216",21,14,14,0,0,"ANTICAPITALISTES",0
25,"25115",878,542,542,17,0,"ANTICAPITALISTES",2
8,"8291",4516,2895,2855,56,40,"ANTICAPITALISTES",10
25,"25153",215,165,161,0,4,"ANTICAPITALISTES",0
25,"25233",270,207,201,3,6,"ANTICAPITALISTES",0
43,"43041",237,177,176,4,1,"ANTICAPITALISTES",0
17,"17208",1012,642,622,12,20,"ANTICAPITALISTES",3
8,"8223",1855,1178,1155,19,23,"ANTICAPITALISTES",7
17,"17037",105,66,66,2,0,"ANTICAPITALISTES",0
8,"8029",3389,2542,2514,45,28,"ANTICAPITALISTES",6
25,"25224",144,93,91,6,2,"ANTICAPITALISTES",0
8,"8904",10608,6654,6561,140,93,"ANTICAPITALISTES",136
8,"8302",9271,5981,5892,82,89,"ANTICAPITALISTES",16
8,"8217",24130,17554,17319,383,235,"ANTICAPITALISTES",97
17,"17174",183,120,117,5,3,"ANTICAPITALISTES",1
25,"25138",605,440,428,13,12,"ANTICAPITALISTES",1
25,"25072",5921,3743,3637,81,106,"ANTICAPITALISTES",21
8,"8165",1689,1091,1070,18,21,"ANTICAPITALISTES",1
43,"43132",365,217,214,8,3,"ANTICAPITALISTES",0
25,"25228",2907,2043,2021,43,22,"ANTICAPITALISTES",3
17,"17042",415,297,292,2,5,"ANTICAPITALISTES",0
25,"25015",394,264,264,14,0,"ANTICAPITALISTES",0
8,"8299",444,277,267,5,10,"ANTICAPITALISTES",2
43,"43003",307,187,184,10,3,"ANTICAPITALISTES",0
8,"8136",11117,7602,7478,174,124,"ANTICAPITALISTES",16
17,"17168",393,285,281,8,4,"ANTICAPITALISTES",2
8,"8235",3627,2506,2467,35,39,"ANTICAPITALISTES",6
8,"8272",148,97,96,6,1,"ANTICAPITALISTES",0
25,"25006",362,231,228,2,3,"ANTICAPITALISTES",0
17,"17146",2952,1895,1864,49,31,"ANTICAPITALISTES",4
25,"25088",100,74,74,0,0,"ANTICAPITALISTES",0
43,"43165",624,471,459,6,12,"ANTICAPITALISTES",1
17,"17106",140,105,104,0,1,"ANTICAPITALISTES",0
25,"25109",279,183,183,2,0,"ANTICAPITALISTES",0
25,"25201",119,78,76,3,2,"ANTICAPITALISTES",1
43,"43133",5697,3470,3388,76,82,"ANTICAPITALISTES",4
8,"8086",13267,8791,8669,200,122,"ANTICAPITALISTES",17
8,"8066",1315,985,965,16,20,"ANTICAPITALISTES",4
43,"43052",1001,669,636,12,33,"ANTICAPITALISTES",2
8,"8200",61189,40677,40069,736,608,"ANTICAPITALISTES",138
8,"8280",116,74,72,3,2,"ANTICAPITALISTES",1
43,"43030",454,321,307,5,14,"ANTICAPITALISTES",2
17,"17014",64,39,37,0,2,"ANTICAPITALISTES",1
8,"8063",434,336,333,8,3,"ANTICAPITALISTES",2
25,"25183",485,336,327,6,9,"ANTICAPITALISTES",1
8,"8201",458,305,298,12,7,"ANTICAPITALISTES",5
17,"17095",19245,11212,11067,160,145,"ANTICAPITALISTES",17
43,"43177",338,242,236,6,6,"ANTICAPITALISTES",0
43,"43071",975,677,664,14,13,"ANTICAPITALISTES",3
8,"8121",85069,58372,57620,923,752,"ANTICAPITALISTES",240
43,"43162",4143,2892,2833,59,59,"ANTICAPITALISTES",2
17,"17161",978,693,687,21,6,"ANTICAPITALISTES",2
17,"17086",1687,1148,1129,14,19,"ANTICAPITALISTES",7
8,"8047",4141,2610,2580,49,30,"ANTICAPITALISTES",13
8,"8127",2274,1371,1338,23,33,"ANTICAPITALISTES",3
17,"17105",257,152,146,4,6,"ANTICAPITALISTES",4
8,"8169",47505,31997,31566,555,431,"ANTICAPITALISTES",138
8,"8108",4879,3475,3437,64,38,"ANTICAPITALISTES",7
43,"43008",333,206,197,3,9,"ANTICAPITALISTES",0
8,"8149",985,683,671,11,12,"ANTICAPITALISTES",0
17,"17110",1359,930,917,12,13,"ANTICAPITALISTES",2
8,"8132",381,247,241,6,6,"ANTICAPITALISTES",0
25,"25008",1187,834,818,15,16,"ANTICAPITALISTES",0
25,"25121",623,406,400,6,6,"ANTICAPITALISTES",1
17,"17020",3446,2322,2268,45,54,"ANTICAPITALISTES",1
25,"25025",1307,874,859,32,15,"ANTICAPITALISTES",4
8,"8209",6596,4415,4351,69,64,"ANTICAPITALISTES",13
25,"25180",245,167,165,3,2,"ANTICAPITALISTES",0
25,"25150",185,119,113,4,6,"ANTICAPITALISTES",0
25,"25041",625,432,420,20,12,"ANTICAPITALISTES",2
8,"8303",279,202,201,11,1,"ANTICAPITALISTES",1
25,"25032",71,44,42,1,2,"ANTICAPITALISTES",1
8,"8142",127,83,83,4,0,"ANTICAPITALISTES",0
8,"8283",5862,3712,3618,72,94,"ANTICAPITALISTES",7
8,"8103",636,453,446,16,7,"ANTICAPITALISTES",0
43,"43176",832,575,572,16,3,"ANTICAPITALISTES",3
17,"17107",301,203,200,8,3,"ANTICAPITALISTES",1
43,"43112",294,184,181,2,3,"ANTICAPITALISTES",2
43,"43063",588,358,350,13,8,"ANTICAPITALISTES",0
8,"8304",822,587,578,16,9,"ANTICAPITALISTES",1
43,"43907",4122,2759,2712,52,47,"ANTICAPITALISTES",10
17,"17021",108,86,79,0,7,"ANTICAPITALISTES",0
43,"43038",20710,12999,12771,224,228,"ANTICAPITALISTES",32
8,"8153",502,357,350,7,7,"ANTICAPITALISTES",2
17,"17090",548,412,404,7,8,"ANTICAPITALISTES",1
43,"43174",152,104,101,1,3,"ANTICAPITALISTES",1
17,"17049",3056,1986,1944,43,42,"ANTICAPITALISTES",19
43,"43108",1808,1183,1157,28,26,"ANTICAPITALISTES",2
43,"43170",880,601,592,9,9,"ANTICAPITALISTES",1
17,"17180",8076,4868,4767,81,101,"ANTICAPITALISTES",26
8,"8009",8932,6188,6088,103,100,"ANTICAPITALISTES",32
8,"8151",504,345,338,6,7,"ANTICAPITALISTES",0
8,"8016",1984,1319,1289,26,30,"ANTICAPITALISTES",3
25,"25048",1684,1120,1095,29,25,"ANTICAPITALISTES",21
25,"25221",125,76,76,0,0,"ANTICAPITALISTES",0
8,"8901",249,180,180,2,0,"ANTICAPITALISTES",0
17,"17181",3228,2116,2081,19,35,"ANTICAPITALISTES",3
17,"17083",2886,1825,1801,39,24,"ANTICAPITALISTES",5
17,"17074",490,345,342,5,3,"ANTICAPITALISTES",0
25,"25063",97,65,64,2,1,"ANTICAPITALISTES",1
8,"8014",1906,1338,1313,37,25,"ANTICAPITALISTES",4
8,"8085",1033,731,720,10,11,"ANTICAPITALISTES",1
8,"8174",409,294,292,10,2,"ANTICAPITALISTES",0
8,"8276",249,188,187,9,1,"ANTICAPITALISTES",1
25,"25146",227,150,149,0,1,"ANTICAPITALISTES",0
8,"8051",17397,12178,12002,240,176,"ANTICAPITALISTES",61
8,"8279",149233,101676,100363,1965,1313,"ANTICAPITALISTES",325
25,"25189",2085,1348,1327,38,21,"ANTICAPITALISTES",9
43,"43043",3065,1952,1919,39,33,"ANTICAPITALISTES",8
17,"17204",539,349,347,10,2,"ANTICAPITALISTES",2
25,"25223",951,562,546,14,16,"ANTICAPITALISTES",2
17,"17007",1778,1137,1113,16,24,"ANTICAPITALISTES",1
17,"17145",1593,1090,1068,10,22,"ANTICAPITALISTES",8
43,"43059",264,185,185,4,0,"ANTICAPITALISTES",0
8,"8259",6362,4482,4420,97,62,"ANTICAPITALISTES",22
43,"43033",772,547,533,4,14,"ANTICAPITALISTES",2
17,"17050",645,438,425,15,13,"ANTICAPITALISTES",1
25,"25033",1125,738,718,17,20,"ANTICAPITALISTES",1
43,"43025",660,453,446,13,7,"ANTICAPITALISTES",0
17,"17221",4135,2789,2723,49,66,"ANTICAPITALISTES",5
8,"8257",116,84,81,0,3,"ANTICAPITALISTES",0
8,"8264",3983,2773,2744,30,29,"ANTICAPITALISTES",7
25,"25022",119,83,83,0,0,"ANTICAPITALISTES",0
25,"25174",438,289,283,4,6,"ANTICAPITALISTES",1
25,"25908",250,169,168,4,1,"ANTICAPITALISTES",3
25,"25057",198,140,136,2,4,"ANTICAPITALISTES",2
43,"43070",265,198,196,3,2,"ANTICAPITALISTES",0
8,"8905",2268,1692,1657,28,35,"ANTICAPITALISTES",10
43,"43097",379,283,278,6,5,"ANTICAPITALISTES",0
8,"8070",275,192,191,5,1,"ANTICAPITALISTES",2
43,"43129",4525,3032,2956,62,76,"ANTICAPITALISTES",6
25,"25193",771,509,501,8,8,"ANTICAPITALISTES",4
8,"8219",14647,10347,10169,193,178,"ANTICAPITALISTES",40
43,"43175",590,419,411,8,8,"ANTICAPITALISTES",2
17,"17052",134,84,83,2,1,"ANTICAPITALISTES",1
17,"17025",1127,775,760,11,15,"ANTICAPITALISTES",4
8,"8251",4771,3214,3140,57,74,"ANTICAPITALISTES",15
17,"17165",608,414,400,9,14,"ANTICAPITALISTES",0
17,"17187",574,414,402,1,12,"ANTICAPITALISTES",1
43,"43029",330,202,194,6,8,"ANTICAPITALISTES",2
8,"8058",1699,1089,1061,25,28,"ANTICAPITALISTES",4
8,"8119",6039,3991,3884,74,107,"ANTICAPITALISTES",11
8,"8095",75,56,55,1,1,"ANTICAPITALISTES",0
17,"17213",5282,3097,3041,42,56,"ANTICAPITALISTES",5
8,"8205",54870,41064,40491,682,573,"ANTICAPITALISTES",213
25,"25906",235,160,154,3,6,"ANTICAPITALISTES",1
8,"8044",4247,2763,2712,50,51,"ANTICAPITALISTES",12
25,"25210",1164,799,789,13,10,"ANTICAPITALISTES",0
17,"17047",4803,2866,2803,30,63,"ANTICAPITALISTES",7
43,"43141",131,71,70,3,1,"ANTICAPITALISTES",0
25,"25105",146,90,89,1,1,"ANTICAPITALISTES",1
8,"8089",33316,22369,22107,437,262,"ANTICAPITALISTES",62
8,"8059",323,189,186,9,3,"ANTICAPITALISTES",0
8,"8282",6092,4478,4405,79,73,"ANTICAPITALISTES",29
43,"43064",2063,1420,1391,37,29,"ANTICAPITALISTES",1
25,"25137",8404,5264,5167,112,97,"ANTICAPITALISTES",16
25,"25097",102,70,69,3,1,"ANTICAPITALISTES",3
17,"17185",2273,1416,1379,32,37,"ANTICAPITALISTES",4
8,"8100",1934,1437,1401,40,36,"ANTICAPITALISTES",1
17,"17004",504,340,337,6,3,"ANTICAPITALISTES",1
17,"17177",563,398,388,7,10,"ANTICAPITALISTES",0
17,"17134",235,149,148,3,1,"ANTICAPITALISTES",1
25,"25060",92,53,52,1,1,"ANTICAPITALISTES",0
8,"8061",1467,960,952,10,8,"ANTICAPITALISTES",4
25,"25111",116,70,70,0,0,"ANTICAPITALISTES",0
43,"43151",119,91,89,0,2,"ANTICAPITALISTES",0
25,"25030",147,101,95,3,6,"ANTICAPITALISTES",0
43,"43138",2719,1775,1730,45,45,"ANTICAPITALISTES",5
8,"8115",3870,2693,2644,60,49,"ANTICAPITALISTES",7
25,"25040",10654,6905,6768,144,137,"ANTICAPITALISTES",13
17,"17228",280,172,170,4,2,"ANTICAPITALISTES",0
43,"43027",177,129,128,6,1,"ANTICAPITALISTES",0
8,"8092",3928,2511,2473,33,38,"ANTICAPITALISTES",2
25,"25911",472,306,296,2,10,"ANTICAPITALISTES",0
8,"8135",6647,4753,4678,79,75,"ANTICAPITALISTES",29
8,"8238",13892,10237,10094,206,143,"ANTICAPITALISTES",35
17,"17081",236,165,162,2,3,"ANTICAPITALISTES",1
43,"43092",7051,4294,4220,45,74,"ANTICAPITALISTES",5
8,"8208",5471,3859,3792,82,67,"ANTICAPITALISTES",12
8,"8275",242,188,186,4,2,"ANTICAPITALISTES",1
43,"43046",114,80,79,5,1,"ANTICAPITALISTES",0
43,"43018",430,350,337,7,13,"ANTICAPITALISTES",0
17,"17191",153,116,114,0,2,"ANTICAPITALISTES",0
8,"8112",12946,8533,8390,227,143,"ANTICAPITALISTES",17
25,"25077",474,281,277,5,4,"ANTICAPITALISTES",1
43,"43060",3049,2030,1980,62,50,"ANTICAPITALISTES",2
25,"25023",4446,3079,3020,70,59,"ANTICAPITALISTES",4
8,"8079",335,255,243,14,12,"ANTICAPITALISTES",3
17,"17111",789,584,574,15,10,"ANTICAPITALISTES",3
8,"8196",18989,12658,12490,253,168,"ANTICAPITALISTES",29
43,"43100",3062,2058,2021,52,37,"ANTICAPITALISTES",7
43,"43149",711,529,516,13,13,"ANTICAPITALISTES",0
8,"8181",7722,5280,5188,112,92,"ANTICAPITALISTES",13
25,"25136",106,79,79,1,0,"ANTICAPITALISTES",1
43,"43061",55,31,31,1,0,"ANTICAPITALISTES",0
25,"25903",261,176,170,9,6,"ANTICAPITALISTES",0
25,"25044",195,136,134,1,2,"ANTICAPITALISTES",0
43,"43145",3968,2781,2742,52,39,"ANTICAPITALISTES",4
8,"8214",6754,4659,4555,83,104,"ANTICAPITALISTES",21
8,"8054",8733,6215,6077,123,138,"ANTICAPITALISTES",19
43,"43075",102,63,63,1,0,"ANTICAPITALISTES",0
25,"25062",806,515,497,11,18,"ANTICAPITALISTES",0
25,"25075",122,85,83,0,2,"ANTICAPITALISTES",1
43,"43035",280,202,198,0,4,"ANTICAPITALISTES",0
8,"8249",273,218,214,4,4,"ANTICAPITALISTES",0
8,"8024",409,266,260,4,6,"ANTICAPITALISTES",3
17,"17102",571,354,350,7,4,"ANTICAPITALISTES",1
25,"25186",231,168,168,3,0,"ANTICAPITALISTES",0
25,"25170",271,197,196,4,1,"ANTICAPITALISTES",1
17,"17223",787,523,514,8,9,"ANTICAPITALISTES",5
8,"8125",24559,16065,15798,293,267,"ANTICAPITALISTES",64
43,"43131",4495,2842,2814,51,28,"ANTICAPITALISTES",4
8,"8226",886,667,656,13,11,"ANTICAPITALISTES",0
8,"8076",15925,10435,10242,179,193,"ANTICAPITALISTES",33
8,"8167",5703,3896,3831,82,65,"ANTICAPITALISTES",2
8,"8188",106,87,86,4,1,"ANTICAPITALISTES",0
43,"43084",573,383,378,6,5,"ANTICAPITALISTES",1
8,"8261",2273,1547,1525,30,22,"ANTICAPITALISTES",2
8,"8269",2613,1840,1814,32,26,"ANTICAPITALISTES",3
8,"8204",2991,2076,2040,45,36,"ANTICAPITALISTES",4
25,"25179",198,141,136,1,5,"ANTICAPITALISTES",0
17,"17194",93,55,55,1,0,"ANTICAPITALISTES",1
17,"17098",311,208,202,4,6,"ANTICAPITALISTES",0
43,"43122",92,65,61,0,4,"ANTICAPITALISTES",0
8,"8284",11920,7059,6942,139,117,"ANTICAPITALISTES",39
8,"8004",228,176,172,2,4,"ANTICAPITALISTES",0
43,"43002",1790,1252,1226,17,26,"ANTICAPITALISTES",1
8,"8245",78826,51185,50445,962,740,"ANTICAPITALISTES",172
43,"43051",8749,5494,5411,78,83,"ANTICAPITALISTES",15
25,"25059",796,580,575,9,5,"ANTICAPITALISTES",0
25,"25202",110,62,59,3,3,"ANTICAPITALISTES",1
17,"17215",1918,1350,1321,40,29,"ANTICAPITALISTES",5
8,"8197",7316,4983,4926,69,57,"ANTICAPITALISTES",15
17,"17206",167,108,107,2,1,"ANTICAPITALISTES",2
17,"17157",127,99,98,3,1,"ANTICAPITALISTES",3
25,"25168",510,385,378,19,7,"ANTICAPITALISTES",0
8,"8064",1847,1277,1246,14,31,"ANTICAPITALISTES",2
17,"17114",22610,14079,13811,263,268,"ANTICAPITALISTES",44
8,"8138",4014,2735,2679,46,56,"ANTICAPITALISTES",20
25,"25098",266,177,177,0,0,"ANTICAPITALISTES",0
8,"8017",2740,1800,1768,38,32,"ANTICAPITALISTES",5
17,"17193",3978,2365,2305,38,60,"ANTICAPITALISTES",6
8,"8265",1575,1065,1026,38,39,"ANTICAPITALISTES",2
43,"43026",800,531,522,15,9,"ANTICAPITALISTES",0
43,"43173",114,65,64,0,1,"ANTICAPITALISTES",1
17,"17066",25667,15429,15157,244,272,"ANTICAPITALISTES",50
25,"25219",144,90,86,0,4,"ANTICAPITALISTES",0
39,"39050",305,207,205,1,2,"BASTA YA",0
39,"39031",1227,965,956,4,9,"BASTA YA",2
39,"39006",1732,1381,1373,23,8,"BASTA YA",1
39,"39030",1971,1397,1379,20,18,"BASTA YA",3
39,"39089",163,126,126,0,0,"BASTA YA",0
39,"39058",862,586,584,6,2,"BASTA YA",1
39,"39066",895,710,703,6,7,"BASTA YA",3
39,"39085",6722,5198,5134,60,64,"BASTA YA",19
39,"39083",1214,785,775,7,10,"BASTA YA",1
39,"39003",321,265,261,0,4,"BASTA YA",0
39,"39075",140941,103308,102362,1364,946,"BASTA YA",93
39,"39017",588,424,419,2,5,"BASTA YA",0
39,"39099",2987,2416,2391,28,25,"BASTA YA",0
39,"39038",1465,1065,1047,8,18,"BASTA YA",1
39,"39095",2292,1824,1801,24,23,"BASTA YA",0
39,"39020",23947,15404,15122,267,282,"BASTA YA",37
39,"39052",17031,13198,13034,187,164,"BASTA YA",16
39,"39036",1023,802,790,5,12,"BASTA YA",0
39,"39102",2330,1748,1731,13,17,"BASTA YA",3
39,"39023",6048,4795,4747,43,48,"BASTA YA",6
39,"39076",3388,2673,2641,22,32,"BASTA YA",4
39,"39088",70,61,61,1,0,"BASTA YA",0
39,"39044",3864,2940,2905,44,35,"BASTA YA",0
39,"39047",1987,1495,1482,9,13,"BASTA YA",1
39,"39049",339,244,242,5,2,"BASTA YA",0
39,"39077",256,196,196,1,0,"BASTA YA",0
39,"39032",1576,1215,1209,10,6,"BASTA YA",0
39,"39069",1957,1595,1570,18,25,"BASTA YA",2
39,"39037",2061,1609,1586,10,23,"BASTA YA",0
39,"39072",375,234,234,4,0,"BASTA YA",0
39,"39041",1775,1432,1414,15,18,"BASTA YA",2
39,"39054",4265,3338,3276,57,62,"BASTA YA",6
39,"39016",24213,18549,18362,265,187,"BASTA YA",22
39,"39033",604,480,473,3,7,"BASTA YA",0
39,"39093",351,260,253,2,7,"BASTA YA",0
39,"39057",2298,1735,1719,17,16,"BASTA YA",3
39,"39048",1616,1326,1308,8,18,"BASTA YA",0
39,"39042",5928,4680,4634,44,46,"BASTA YA",4
39,"39094",927,702,691,0,11,"BASTA YA",0
39,"39018",4077,3212,3160,44,52,"BASTA YA",4
39,"39043",1321,1082,1072,8,10,"BASTA YA",0
39,"39040",4350,3413,3373,30,40,"BASTA YA",2
39,"39067",901,628,623,1,5,"BASTA YA",1
39,"39034",289,209,209,3,0,"BASTA YA",0
39,"39024",2065,1616,1601,8,15,"BASTA YA",2
39,"39001",2146,1669,1645,20,24,"BASTA YA",2
39,"39009",3200,2427,2402,24,25,"BASTA YA",0
39,"39027",3213,2506,2473,21,33,"BASTA YA",3
39,"39029",642,521,517,6,4,"BASTA YA",1
39,"39068",663,488,485,4,3,"BASTA YA",0
39,"39008",13716,10396,10274,129,122,"BASTA YA",13
39,"39086",386,282,280,1,2,"BASTA YA",0
39,"39059",8476,6365,6284,73,81,"BASTA YA",4
39,"39056",2387,1857,1835,22,22,"BASTA YA",2
39,"39064",1339,1072,1066,7,6,"BASTA YA",3
39,"39055",1130,881,869,10,12,"BASTA YA",0
39,"39014",943,706,700,9,6,"BASTA YA",1
39,"39035",10031,7685,7601,74,84,"BASTA YA",8
39,"39060",6723,5453,5360,56,93,"BASTA YA",7
39,"39071",463,358,358,2,0,"BASTA YA",0
39,"39087",43561,33709,33242,404,467,"BASTA YA",39
39,"39081",440,372,369,3,3,"BASTA YA",1
39,"39063",1018,769,762,6,7,"BASTA YA",0
39,"39022",985,735,734,5,1,"BASTA YA",0
39,"39065",272,199,197,2,2,"BASTA YA",0
39,"39100",922,718,712,8,6,"BASTA YA",1
39,"39090",731,577,572,3,5,"BASTA YA",0
39,"39101",328,251,247,5,4,"BASTA YA",0
39,"39078",1407,1041,1033,10,8,"BASTA YA",0
39,"39026",1825,1383,1371,12,12,"BASTA YA",1
39,"39098",1522,1256,1244,8,12,"BASTA YA",1
39,"39084",873,647,642,4,5,"BASTA YA",0
39,"39015",898,692,688,7,4,"BASTA YA",0
39,"39079",9035,6959,6897,55,62,"BASTA YA",3
39,"39062",1759,1397,1387,9,10,"BASTA YA",1
39,"39045",410,324,323,5,1,"BASTA YA",0
39,"39053",251,179,179,1,0,"BASTA YA",0
39,"39010",688,533,524,6,9,"BASTA YA",0
39,"39091",2026,1636,1628,14,8,"BASTA YA",0
39,"39051",73,62,62,2,0,"BASTA YA",0
39,"39019",2009,1556,1536,10,20,"BASTA YA",2
39,"39070",152,118,118,0,0,"BASTA YA",0
39,"39092",1030,753,747,1,6,"BASTA YA",0
39,"39046",1442,1071,1050,13,21,"BASTA YA",2
39,"39080",3627,2743,2693,19,50,"BASTA YA",1
39,"39074",6785,5287,5233,50,54,"BASTA YA",3
39,"39061",3458,2673,2644,42,29,"BASTA YA",0
39,"39097",732,476,470,4,6,"BASTA YA",0
39,"39025",8985,7048,6955,70,93,"BASTA YA",5
39,"39005",1319,1048,1026,3,22,"BASTA YA",0
39,"39011",1646,1295,1294,5,1,"BASTA YA",1
39,"39096",719,521,518,4,3,"BASTA YA",0
39,"39039",648,496,493,0,3,"BASTA YA",1
39,"39028",3513,2760,2718,23,42,"BASTA YA",3
39,"39013",561,413,412,2,1,"BASTA YA",1
39,"39021",536,448,444,1,4,"BASTA YA",0
39,"39002",3400,2554,2514,35,40,"BASTA YA",2
39,"39073",9275,6984,6903,83,81,"BASTA YA",16
39,"39007",479,348,347,3,1,"BASTA YA",0
39,"39082",1688,1280,1266,9,14,"BASTA YA",2
39,"39012",6666,5148,5061,43,87,"BASTA YA",5
39,"39004",1593,1321,1305,9,16,"BASTA YA",0
1,"1014",385,281,274,6,7,"PUM+J",1
1,"1006",181,133,127,2,6,"PUM+J",0
48,"48057",5934,4407,4385,27,22,"PUM+J",1
1,"1032",536,412,400,0,12,"PUM+J",2
1,"1049",147,115,115,1,0,"PUM+J",0
48,"48079",470,391,391,2,0,"PUM+J",0
48,"48912",2340,1794,1776,22,18,"PUM+J",0
48,"48087",463,371,370,4,1,"PUM+J",0
48,"48043",4256,3066,3040,33,26,"PUM+J",7
1,"1037",625,403,398,6,5,"PUM+J",1
48,"48013",81335,54452,53803,771,649,"PUM+J",157
1,"1039",211,164,158,1,6,"PUM+J",0
48,"48910",3063,2122,2104,14,18,"PUM+J",8
1,"1020",317,222,220,0,2,"PUM+J",0
48,"48010",427,303,300,2,3,"PUM+J",0
48,"48001",5842,4040,4020,23,20,"PUM+J",9
48,"48031",370,296,296,1,0,"PUM+J",0
48,"48016",5214,3782,3736,46,46,"PUM+J",8
48,"48052",1526,1213,1205,7,8,"PUM+J",0
48,"48903",1909,1455,1430,4,25,"PUM+J",0
48,"48034",13160,9290,9189,82,101,"PUM+J",30
48,"48024",1026,845,841,3,4,"PUM+J",1
1,"1033",679,537,532,2,5,"PUM+J",1
1,"1034",177,140,137,1,3,"PUM+J",0
48,"48069",12381,8760,8672,66,88,"PUM+J",14
1,"1011",245,189,185,7,4,"PUM+J",0
1,"1009",1296,876,863,9,13,"PUM+J",1
48,"48097",1359,936,915,9,21,"PUM+J",0
48,"48056",849,610,608,3,2,"PUM+J",0
48,"48053",856,683,680,8,3,"PUM+J",0
1,"1901",2254,1561,1528,24,33,"PUM+J",3
48,"48094",3299,2398,2377,15,21,"PUM+J",1
1,"1044",242,174,173,1,1,"PUM+J",2
48,"48002",7971,5377,5290,65,87,"PUM+J",13
48,"48036",23973,16491,16344,179,147,"PUM+J",45
48,"48906",796,625,622,5,3,"PUM+J",1
1,"1054",959,680,675,8,5,"PUM+J",2
48,"48021",1460,1024,1012,13,12,"PUM+J",2
48,"48086",2087,1432,1420,11,12,"PUM+J",2
48,"48072",1009,796,787,3,9,"PUM+J",0
48,"48078",39866,27311,26995,311,316,"PUM+J",79
48,"48012",2036,1630,1616,9,14,"PUM+J",4
48,"48050",216,173,172,0,1,"PUM+J",0
48,"48068",1577,1224,1213,4,11,"PUM+J",0
48,"48077",3398,2490,2477,33,13,"PUM+J",6
48,"48040",1274,936,921,10,15,"PUM+J",2
1,"1051",3662,2242,2210,26,32,"PUM+J",9
48,"48032",5864,4257,4223,32,34,"PUM+J",12
48,"48027",21610,15409,15274,145,135,"PUM+J",24
48,"48075",1915,1362,1325,15,37,"PUM+J",2
48,"48076",294,226,226,0,0,"PUM+J",0
1,"1059",183468,127839,125801,1422,2038,"PUM+J",659
1,"1062",333,236,232,5,4,"PUM+J",0
48,"48090",6153,4682,4571,40,111,"PUM+J",12
48,"48029",8022,5488,5409,83,79,"PUM+J",16
1,"1043",2322,1623,1595,12,28,"PUM+J",5
48,"48039",263,217,216,4,1,"PUM+J",1
1,"1017",910,629,621,17,8,"PUM+J",2
48,"48054",23712,16643,16439,215,204,"PUM+J",78
48,"48065",3311,2340,2323,23,17,"PUM+J",7
48,"48915",362,273,271,2,2,"PUM+J",0
48,"48046",12635,9231,9161,61,70,"PUM+J",10
48,"48003",14142,10268,10167,84,101,"PUM+J",16
48,"48914",324,278,276,0,2,"PUM+J",0
48,"48089",2878,2120,2089,19,31,"PUM+J",4
1,"1031",1229,916,899,13,17,"PUM+J",0
48,"48045",5060,3912,3849,31,63,"PUM+J",8
48,"48060",3689,2477,2466,12,11,"PUM+J",1
48,"48061",773,585,582,6,3,"PUM+J",0
48,"48008",600,432,428,3,4,"PUM+J",0
48,"48904",3510,2682,2665,26,17,"PUM+J",1
1,"1018",1395,952,943,7,9,"PUM+J",3
1,"1063",1803,1290,1284,18,6,"PUM+J",5
1,"1023",290,236,235,1,1,"PUM+J",0
48,"48023",601,499,492,4,7,"PUM+J",0
48,"48908",242,194,194,1,0,"PUM+J",0
48,"48082",38551,25768,25482,316,286,"PUM+J",66
48,"48071",6097,4307,4224,61,83,"PUM+J",11
48,"48080",10161,6901,6815,95,86,"PUM+J",14
48,"48030",626,487,483,0,4,"PUM+J",0
48,"48019",3741,2613,2595,24,18,"PUM+J",5
1,"1055",906,632,623,7,9,"PUM+J",1
48,"48074",3384,2441,2397,20,44,"PUM+J",4
48,"48083",7021,4722,4656,74,66,"PUM+J",15
48,"48905",2600,1903,1869,14,34,"PUM+J",4
48,"48049",564,446,446,2,0,"PUM+J",0
48,"48093",893,707,695,1,12,"PUM+J",0
48,"48091",1170,860,851,3,9,"PUM+J",4
1,"1052",240,191,191,1,0,"PUM+J",1
48,"48014",1211,838,834,4,4,"PUM+J",0
1,"1016",461,241,237,2,4,"PUM+J",2
48,"48063",355,287,287,6,0,"PUM+J",1
48,"48041",721,588,585,9,3,"PUM+J",0
48,"48064",599,490,490,1,0,"PUM+J",0
48,"48092",792,603,600,5,3,"PUM+J",0
48,"48017",13554,9303,9234,64,69,"PUM+J",10
1,"1027",430,283,276,4,7,"PUM+J",0
48,"48911",373,300,296,1,4,"PUM+J",1
48,"48085",9893,6960,6885,93,75,"PUM+J",16
1,"1019",155,124,124,0,0,"PUM+J",0
48,"48009",767,585,580,4,5,"PUM+J",0
48,"48047",161,126,126,1,0,"PUM+J",0
1,"1004",1427,1021,996,15,25,"PUM+J",3
48,"48042",1401,1116,1099,15,17,"PUM+J",2
48,"48005",93,65,64,0,1,"PUM+J",0
48,"48048",547,423,423,5,0,"PUM+J",0
1,"1010",2276,1649,1618,27,31,"PUM+J",5
1,"1058",1342,877,872,8,5,"PUM+J",1
48,"48058",977,706,700,2,6,"PUM+J",0
48,"48096",6607,5007,4900,54,107,"PUM+J",12
48,"48028",767,623,621,1,2,"PUM+J",0
48,"48033",223,171,171,1,0,"PUM+J",1
48,"48020",276378,191777,190141,2335,1636,"PUM+J",651
1,"1042",915,678,661,1,17,"PUM+J",2
48,"48907",351,290,290,1,0,"PUM+J",0
48,"48025",882,652,644,2,8,"PUM+J",0
48,"48006",285,246,243,3,3,"PUM+J",0
1,"1001",2010,1362,1336,26,26,"PUM+J",4
1,"1021",473,332,324,3,8,"PUM+J",0
1,"1002",8057,5854,5757,48,97,"PUM+J",23
1,"1902",776,532,526,6,6,"PUM+J",1
1,"1036",15236,10511,10372,141,139,"PUM+J",22
1,"1053",590,341,333,4,8,"PUM+J",2
48,"48062",317,263,262,1,1,"PUM+J",0
48,"48909",194,163,163,0,0,"PUM+J",0
48,"48037",727,528,519,2,9,"PUM+J",1
1,"1046",629,428,421,5,7,"PUM+J",0
1,"1061",155,122,122,2,0,"PUM+J",4
48,"48059",397,289,286,0,3,"PUM+J",0
48,"48004",329,240,239,2,1,"PUM+J",0
48,"48081",1938,1449,1435,14,14,"PUM+J",3
48,"48035",379,304,301,0,3,"PUM+J",0
1,"1003",1199,863,848,2,15,"PUM+J",0
48,"48901",4370,3156,3124,46,32,"PUM+J",9
48,"48067",1204,895,892,4,3,"PUM+J",2
1,"1057",266,212,212,2,0,"PUM+J",0
48,"48066",350,277,277,0,0,"PUM+J",0
48,"48007",354,254,253,1,1,"PUM+J",0
48,"48018",905,591,587,8,4,"PUM+J",1
1,"1013",711,477,474,1,3,"PUM+J",3
48,"48022",2396,1524,1504,12,20,"PUM+J",2
48,"48015",34932,24209,23966,296,243,"PUM+J",49
48,"48026",1093,881,875,3,6,"PUM+J",1
48,"48055",2620,1954,1934,22,20,"PUM+J",7
48,"48902",19232,12809,12633,182,176,"PUM+J",25
48,"48038",1087,826,821,7,5,"PUM+J",0
1,"1041",159,116,113,1,3,"PUM+J",0
48,"48051",225,157,156,0,1,"PUM+J",0
48,"48088",148,110,109,0,1,"PUM+J",0
48,"48011",9742,6697,6628,82,69,"PUM+J",16
1,"1008",781,566,546,7,20,"PUM+J",0
48,"48084",23491,15322,15084,213,238,"PUM+J",29
48,"48070",559,413,407,1,6,"PUM+J",0
1,"1056",256,183,181,1,2,"PUM+J",1
1,"1047",942,674,655,4,19,"PUM+J",0
48,"48095",2367,1593,1577,20,16,"PUM+J",5
1,"1060",223,181,178,1,3,"PUM+J",0
1,"1030",170,123,120,1,3,"PUM+J",0
48,"48073",7090,4865,4802,37,63,"PUM+J",1
48,"48044",63869,47453,47085,511,368,"PUM+J",110
1,"1028",1106,773,760,8,13,"PUM+J",1
48,"48913",1231,936,922,10,14,"PUM+J",1
1,"1022",826,615,602,6,13,"PUM+J",1
20,"20008",757,499,499,8,0,"PU M+J",0
20,"20012",149,97,97,0,0,"PU M+J",0
20,"20068",199,132,129,2,3,"PU M+J",0
20,"20045",46542,30907,30536,425,371,"PU M+J",122
20,"20032",8949,6189,6117,55,72,"PU M+J",13
20,"20035",497,346,344,1,2,"PU M+J",1
20,"20037",100,65,64,2,1,"PU M+J",0
20,"20063",7889,5381,5340,48,41,"PU M+J",8
20,"20905",142,105,103,1,2,"PU M+J",0
20,"20003",547,361,359,3,2,"PU M+J",1
20,"20016",1526,937,932,4,5,"PU M+J",0
20,"20031",179,114,113,1,1,"PU M+J",1
20,"20057",194,122,122,0,0,"PU M+J",0
20,"20040",15103,9781,9686,148,95,"PU M+J",25
20,"20075",4447,2823,2798,32,25,"PU M+J",3
20,"20071",14488,9499,9419,93,80,"PU M+J",23
20,"20055",17856,11885,11791,91,94,"PU M+J",16
20,"20030",22191,15262,15148,164,114,"PU M+J",27
20,"20064",12380,7568,7464,112,104,"PU M+J",31
20,"20066",467,316,316,0,0,"PU M+J",0
20,"20021",216,122,122,0,0,"PU M+J",0
20,"20050",293,213,211,3,2,"PU M+J",0
20,"20001",249,167,167,4,0,"PU M+J",1
20,"20019",10105,6640,6555,73,85,"PU M+J",14
20,"20053",4830,2895,2868,36,27,"PU M+J",7
20,"20039",2003,1517,1512,9,5,"PU M+J",1
20,"20051",7033,4843,4779,57,64,"PU M+J",6
20,"20907",136,94,94,0,0,"PU M+J",0
20,"20017",8670,5923,5890,27,33,"PU M+J",11
20,"20002",347,237,237,8,0,"PU M+J",0
20,"20078",1146,885,884,6,1,"PU M+J",2
20,"20033",884,650,641,4,9,"PU M+J",0
20,"20049",4081,2741,2723,30,18,"PU M+J",3
20,"20034",3192,2035,2030,11,5,"PU M+J",3
20,"20902",14148,9874,9798,120,76,"PU M+J",43
20,"20067",31173,20218,20017,270,201,"PU M+J",90
20,"20052",1154,849,847,14,2,"PU M+J",0
20,"20006",277,177,175,6,2,"PU M+J",0
20,"20029",4283,3014,2998,26,16,"PU M+J",11
20,"20004",254,153,153,5,0,"PU M+J",0
20,"20065",3176,2156,2137,19,19,"PU M+J",3
20,"20014",1101,660,654,8,6,"PU M+J",0
20,"20005",1341,890,885,4,5,"PU M+J",1
20,"20079",17229,12010,11927,143,83,"PU M+J",25
20,"20022",832,527,521,9,6,"PU M+J",3
20,"20038",382,281,280,1,1,"PU M+J",0
20,"20059",8816,6335,6293,32,42,"PU M+J",2
20,"20011",1700,1265,1258,11,7,"PU M+J",1
20,"20077",5382,3766,3741,42,25,"PU M+J",13
20,"20046",1157,734,729,6,5,"PU M+J",0
20,"20013",5331,3662,3637,33,25,"PU M+J",15
20,"20073",4689,3196,3176,28,20,"PU M+J",4
20,"20027",2809,1929,1918,25,11,"PU M+J",1
20,"20901",1468,951,947,13,4,"PU M+J",1
20,"20058",770,549,547,3,2,"PU M+J",0
20,"20023",451,260,259,2,1,"PU M+J",1
20,"20042",3354,2131,2117,18,14,"PU M+J",2
20,"20026",214,172,172,0,0,"PU M+J",0
20,"20028",2204,1400,1379,11,21,"PU M+J",3
20,"20020",143,104,104,1,0,"PU M+J",0
20,"20018",11027,7428,7387,53,41,"PU M+J",7
20,"20081",7346,4957,4925,35,32,"PU M+J",9
20,"20007",300,203,202,2,1,"PU M+J",1
20,"20903",3625,2282,2267,52,15,"PU M+J",5
20,"20015",1307,980,979,13,1,"PU M+J",0
20,"20070",1109,817,815,4,2,"PU M+J",0
20,"20024",400,238,235,0,3,"PU M+J",0
20,"20906",117,89,89,0,0,"PU M+J",0
20,"20069",146828,101992,101225,1287,767,"PU M+J",369
20,"20010",1392,949,941,8,8,"PU M+J",5
20,"20080",8104,5497,5454,52,43,"PU M+J",8
20,"20044",368,258,257,1,1,"PU M+J",1
20,"20047",494,321,319,2,2,"PU M+J",2
20,"20043",1782,1220,1214,13,6,"PU M+J",0
20,"20072",4643,2967,2948,46,19,"PU M+J",12
20,"20904",98,67,66,0,1,"PU M+J",0
20,"20062",995,687,667,5,20,"PU M+J",2
20,"20048",175,102,102,1,0,"PU M+J",0
20,"20054",476,350,348,1,2,"PU M+J",0
20,"20041",279,153,151,5,2,"PU M+J",0
20,"20076",6978,4823,4762,38,61,"PU M+J",10
20,"20060",92,83,82,0,1,"PU M+J",0
20,"20009",11794,7805,7725,103,80,"PU M+J",14
20,"20061",4011,2666,2653,23,13,"PU M+J",5
20,"20036",12731,8519,8431,131,88,"PU M+J",22
20,"20025",1174,814,803,4,11,"PU M+J",1
20,"20074",11660,8003,7951,31,52,"PU M+J",13
20,"20056",3975,2692,2669,17,23,"PU M+J",6
12,"12036",668,529,514,6,15,"COMPROMÍS-Q",7
12,"12020",131,109,107,1,2,"COMPROMÍS-Q",0
46,"46150",1898,1555,1541,8,14,"COMPROMÍS-Q",55
3,"3010",330,269,266,3,3,"COMPROMÍS-Q",17
3,"3021",5594,4630,4517,46,113,"COMPROMÍS-Q",285
3,"3122",40476,29591,29265,341,326,"COMPROMÍS-Q",752
46,"46207",6453,5086,5031,52,55,"COMPROMÍS-Q",345
3,"3054",371,321,315,2,6,"COMPROMÍS-Q",10
3,"3135",228,185,181,0,4,"COMPROMÍS-Q",9
46,"46162",1230,1045,1027,6,18,"COMPROMÍS-Q",34
3,"3065",164772,124457,123236,1556,1221,"COMPROMÍS-Q",2476
12,"12077",4683,3476,3414,41,62,"COMPROMÍS-Q",101
3,"3111",5244,4184,4146,39,38,"COMPROMÍS-Q",36
46,"46240",226,188,185,3,3,"COMPROMÍS-Q",8
46,"46212",1598,1233,1218,5,15,"COMPROMÍS-Q",91
46,"46045",1288,1065,1044,2,21,"COMPROMÍS-Q",70
12,"12089",4277,3009,2946,32,63,"COMPROMÍS-Q",102
46,"46144",699,547,536,2,11,"COMPROMÍS-Q",9
12,"12142",158,122,121,1,1,"COMPROMÍS-Q",1
46,"46215",1451,1185,1169,8,16,"COMPROMÍS-Q",122
12,"12135",35189,25691,25345,380,346,"COMPROMÍS-Q",1405
46,"46131",49087,37846,37477,422,369,"COMPROMÍS-Q",2409
12,"12084",17219,12059,11911,165,148,"COMPROMÍS-Q",351
3,"3020",108,87,86,1,1,"COMPROMÍS-Q",4
3,"3088",5381,4056,3988,47,68,"COMPROMÍS-Q",41
46,"46199",5661,4328,4280,38,48,"COMPROMÍS-Q",163
12,"12005",8066,5835,5441,116,394,"COMPROMÍS-Q",199
46,"46155",1072,861,849,4,12,"COMPROMÍS-Q",47
12,"12112",104,90,90,0,0,"COMPROMÍS-Q",0
46,"46142",870,682,673,7,9,"COMPROMÍS-Q",8
46,"46021",23273,17264,17091,163,173,"COMPROMÍS-Q",671
46,"46219",143,127,126,1,1,"COMPROMÍS-Q",4
46,"46235",21966,16641,16465,167,176,"COMPROMÍS-Q",2908
12,"12018",326,274,265,1,9,"COMPROMÍS-Q",3
12,"12061",431,324,316,6,8,"COMPROMÍS-Q",10
46,"46158",1037,829,822,9,7,"COMPROMÍS-Q",16
46,"46191",1952,1554,1528,9,26,"COMPROMÍS-Q",48
3,"3024",3908,3324,3271,34,53,"COMPROMÍS-Q",23
12,"12008",236,203,199,4,4,"COMPROMÍS-Q",5
46,"46255",3135,2530,2508,11,22,"COMPROMÍS-Q",169
12,"12009",17124,12273,12098,150,175,"COMPROMÍS-Q",564
3,"3032",112,90,88,0,2,"COMPROMÍS-Q",9
46,"46261",1706,1388,1366,13,22,"COMPROMÍS-Q",34
3,"3085",275,218,215,2,3,"COMPROMÍS-Q",15
46,"46132",2124,1845,1817,14,28,"COMPROMÍS-Q",100
3,"3051",356,314,311,2,3,"COMPROMÍS-Q",10
3,"3079",18028,14580,14317,189,263,"COMPROMÍS-Q",347
3,"3106",642,542,535,3,7,"COMPROMÍS-Q",31
46,"46185",422,360,359,7,1,"COMPROMÍS-Q",82
3,"3016",91,67,66,1,1,"COMPROMÍS-Q",1
3,"3075",160,139,136,2,3,"COMPROMÍS-Q",10
46,"46091",126,108,108,0,0,"COMPROMÍS-Q",7
3,"3110",294,239,238,0,1,"COMPROMÍS-Q",43
3,"3013",1144,941,926,5,15,"COMPROMÍS-Q",8
12,"12071",1355,1069,1050,3,19,"COMPROMÍS-Q",18
3,"3099",41561,32556,32248,288,308,"COMPROMÍS-Q",330
46,"46220",48981,34657,34242,450,415,"COMPROMÍS-Q",1657
3,"3125",340,276,275,2,1,"COMPROMÍS-Q",50
46,"46067",1798,1487,1472,10,15,"COMPROMÍS-Q",62
3,"3005",7482,6191,6146,49,45,"COMPROMÍS-Q",63
3,"3031",39966,27099,26802,291,297,"COMPROMÍS-Q",482
46,"46063",1764,1441,1423,15,18,"COMPROMÍS-Q",99
46,"46081",10254,8188,8101,52,87,"COMPROMÍS-Q",400
46,"46047",551,479,469,10,10,"COMPROMÍS-Q",26
3,"3128",3944,2847,2812,16,35,"COMPROMÍS-Q",147
46,"46194",15267,11622,11491,110,131,"COMPROMÍS-Q",570
12,"12092",143,98,98,0,0,"COMPROMÍS-Q",2
12,"12002",135,101,100,1,1,"COMPROMÍS-Q",13
46,"46245",478,357,354,1,3,"COMPROMÍS-Q",33
3,"3018",11899,8855,8720,119,135,"COMPROMÍS-Q",487
46,"46164",11634,8843,8724,90,119,"COMPROMÍS-Q",363
46,"46236",996,853,844,7,9,"COMPROMÍS-Q",52
46,"46182",1190,864,855,11,9,"COMPROMÍS-Q",75
12,"12070",576,473,463,5,10,"COMPROMÍS-Q",30
3,"3029",260,191,186,0,5,"COMPROMÍS-Q",20
12,"12048",293,208,205,2,3,"COMPROMÍS-Q",5
46,"46190",48324,34747,34424,431,323,"COMPROMÍS-Q",1814
3,"3117",381,321,317,4,4,"COMPROMÍS-Q",31
46,"46154",836,684,678,7,6,"COMPROMÍS-Q",24
46,"46016",1097,927,917,12,10,"COMPROMÍS-Q",80
12,"12136",2663,2325,2284,33,41,"COMPROMÍS-Q",44
46,"46059",1310,1076,1058,2,18,"COMPROMÍS-Q",84
46,"46022",15090,10922,10840,99,82,"COMPROMÍS-Q",407
12,"12053",2121,1745,1719,11,26,"COMPROMÍS-Q",33
3,"3076",8373,6319,6222,68,97,"COMPROMÍS-Q",62
3,"3119",15887,12128,11988,122,140,"COMPROMÍS-Q",462
3,"3120",2329,1810,1785,16,25,"COMPROMÍS-Q",12
46,"46001",863,647,641,5,6,"COMPROMÍS-Q",15
12,"12058",99,74,74,0,0,"COMPROMÍS-Q",1
3,"3028",1049,903,895,6,8,"COMPROMÍS-Q",112
46,"46229",1065,840,831,8,9,"COMPROMÍS-Q",71
12,"12056",304,259,254,7,5,"COMPROMÍS-Q",7
46,"46057",483,357,349,9,8,"COMPROMÍS-Q",21
3,"3115",267,242,242,2,0,"COMPROMÍS-Q",21
3,"3043",2933,2494,2447,27,47,"COMPROMÍS-Q",119
46,"46077",7637,5979,5845,64,134,"COMPROMÍS-Q",139
46,"46026",1217,1043,1035,2,8,"COMPROMÍS-Q",89
46,"46028",424,352,347,5,5,"COMPROMÍS-Q",12
46,"46209",1984,1606,1594,11,12,"COMPROMÍS-Q",111
12,"12042",664,549,530,5,19,"COMPROMÍS-Q",10
3,"3040",260,224,220,0,4,"COMPROMÍS-Q",32
3,"3057",232,179,178,0,1,"COMPROMÍS-Q",7
12,"12111",423,375,363,6,12,"COMPROMÍS-Q",12
46,"46205",14277,10882,10764,115,118,"COMPROMÍS-Q",461
3,"3096",5863,4550,4457,57,93,"COMPROMÍS-Q",256
46,"46169",31753,24041,23802,270,239,"COMPROMÍS-Q",977
12,"12123",70,50,48,2,2,"COMPROMÍS-Q",3
46,"46090",1668,1488,1452,9,36,"COMPROMÍS-Q",61
46,"46099",987,764,754,2,10,"COMPROMÍS-Q",4
46,"46083",15427,12079,11941,109,138,"COMPROMÍS-Q",1258
12,"12043",620,499,487,2,12,"COMPROMÍS-Q",19
46,"46089",2116,1653,1627,9,26,"COMPROMÍS-Q",92
46,"46127",2790,2298,2267,23,31,"COMPROMÍS-Q",183
46,"46180",715,585,581,4,4,"COMPROMÍS-Q",26
12,"12068",57,45,44,0,1,"COMPROMÍS-Q",0
46,"46107",1998,1650,1623,8,27,"COMPROMÍS-Q",33
46,"46044",4301,3284,3169,50,115,"COMPROMÍS-Q",51
46,"46208",1141,990,978,6,12,"COMPROMÍS-Q",91
46,"46096",320,267,267,0,0,"COMPROMÍS-Q",12
46,"46242",361,288,280,4,8,"COMPROMÍS-Q",3
46,"46149",398,307,305,1,2,"COMPROMÍS-Q",3
46,"46038",368,264,260,1,4,"COMPROMÍS-Q",9
46,"46119",856,702,693,0,9,"COMPROMÍS-Q",50
46,"46136",2476,1890,1865,16,25,"COMPROMÍS-Q",43
46,"46002",1166,942,915,7,27,"COMPROMÍS-Q",118
46,"46904",782,659,650,6,9,"COMPROMÍS-Q",44
46,"46065",1606,1250,1234,15,16,"COMPROMÍS-Q",101
46,"46073",1119,931,915,14,16,"COMPROMÍS-Q",29
12,"12032",23406,16895,16721,227,174,"COMPROMÍS-Q",557
46,"46121",116,103,101,0,2,"COMPROMÍS-Q",1
46,"46015",7042,5644,5581,53,63,"COMPROMÍS-Q",307
46,"46253",118,105,102,7,3,"COMPROMÍS-Q",3
46,"46239",457,331,323,2,8,"COMPROMÍS-Q",6
12,"12015",96,83,82,3,1,"COMPROMÍS-Q",1
3,"3134",159,129,126,0,3,"COMPROMÍS-Q",8
3,"3107",2288,1670,1647,15,23,"COMPROMÍS-Q",102
46,"46130",934,745,734,6,11,"COMPROMÍS-Q",96
46,"46101",868,720,716,8,4,"COMPROMÍS-Q",30
3,"3014",234288,168004,166418,1795,1586,"COMPROMÍS-Q",4211
46,"46250",574266,435877,431619,4626,4258,"COMPROMÍS-Q",25407
46,"46243",149,120,117,0,3,"COMPROMÍS-Q",7
46,"46233",3911,3025,2988,10,37,"COMPROMÍS-Q",209
12,"12106",1207,992,969,7,23,"COMPROMÍS-Q",7
3,"3131",181,161,157,1,4,"COMPROMÍS-Q",9
3,"3061",1052,842,836,6,6,"COMPROMÍS-Q",6
46,"46017",32928,24879,24672,267,207,"COMPROMÍS-Q",1919
12,"12098",665,552,539,9,13,"COMPROMÍS-Q",41
46,"46179",2186,1849,1804,17,45,"COMPROMÍS-Q",40
3,"3130",43,30,29,0,1,"COMPROMÍS-Q",2
12,"12122",835,674,658,14,16,"COMPROMÍS-Q",16
46,"46201",83,50,49,0,1,"COMPROMÍS-Q",2
46,"46263",333,243,241,2,2,"COMPROMÍS-Q",1
46,"46036",675,440,431,11,9,"COMPROMÍS-Q",7
3,"3048",4747,3878,3817,16,61,"COMPROMÍS-Q",333
12,"12001",1098,821,817,8,4,"COMPROMÍS-Q",43
46,"46113",2338,1804,1797,14,7,"COMPROMÍS-Q",163
3,"3069",2830,2009,1979,22,30,"COMPROMÍS-Q",43
12,"12046",236,177,176,4,1,"COMPROMÍS-Q",3
12,"12055",112,79,78,3,1,"COMPROMÍS-Q",9
12,"12039",870,743,736,4,7,"COMPROMÍS-Q",11
3,"3105",5322,4218,4124,34,94,"COMPROMÍS-Q",77
3,"3137",719,536,530,3,6,"COMPROMÍS-Q",48
3,"3103",288,248,243,2,5,"COMPROMÍS-Q",15
46,"46007",11576,8929,8848,71,81,"COMPROMÍS-Q",329
3,"3017",380,331,324,7,7,"COMPROMÍS-Q",18
46,"46109",6143,4731,4637,40,94,"COMPROMÍS-Q",119
12,"12022",367,282,279,4,3,"COMPROMÍS-Q",5
46,"46237",7261,5405,5350,54,55,"COMPROMÍS-Q",279
46,"46092",304,206,201,1,5,"COMPROMÍS-Q",7
12,"12096",854,663,653,17,10,"COMPROMÍS-Q",22
46,"46037",1146,1007,1003,5,4,"COMPROMÍS-Q",104
46,"46225",360,319,310,5,9,"COMPROMÍS-Q",10
46,"46262",228,161,158,0,3,"COMPROMÍS-Q",3
12,"12027",16914,11657,11452,188,205,"COMPROMÍS-Q",546
46,"46066",1264,1060,1050,5,10,"COMPROMÍS-Q",84
12,"12067",563,458,439,8,19,"COMPROMÍS-Q",4
46,"46098",2556,2072,2057,12,15,"COMPROMÍS-Q",411
46,"46228",2434,1881,1859,30,22,"COMPROMÍS-Q",98
12,"12109",700,564,555,7,9,"COMPROMÍS-Q",19
3,"3083",5708,4267,4196,66,71,"COMPROMÍS-Q",117
46,"46008",2727,2249,2233,17,16,"COMPROMÍS-Q",206
46,"46115",515,364,354,1,10,"COMPROMÍS-Q",2
46,"46039",2200,1849,1820,12,29,"COMPROMÍS-Q",70
46,"46258",2792,2196,2164,14,32,"COMPROMÍS-Q",35
12,"12102",547,474,466,2,8,"COMPROMÍS-Q",13
12,"12081",654,519,515,2,4,"COMPROMÍS-Q",12
46,"46128",1649,1322,1292,14,30,"COMPROMÍS-Q",87
3,"3094",8442,6105,6053,70,52,"COMPROMÍS-Q",158
46,"46126",5471,4454,4392,53,62,"COMPROMÍS-Q",377
3,"3072",331,284,277,2,7,"COMPROMÍS-Q",30
46,"46147",16527,11836,11716,105,120,"COMPROMÍS-Q",820
46,"46135",9634,7671,7586,64,85,"COMPROMÍS-Q",587
12,"12094",807,612,604,14,8,"COMPROMÍS-Q",33
3,"3095",4498,3558,3517,29,41,"COMPROMÍS-Q",317
3,"3904",1416,1104,1096,11,8,"COMPROMÍS-Q",29
12,"12129",1936,1372,1326,29,46,"COMPROMÍS-Q",70
12,"12118",83,63,62,0,1,"COMPROMÍS-Q",0
46,"46170",3464,2944,2908,24,36,"COMPROMÍS-Q",86
46,"46034",1791,1477,1468,8,9,"COMPROMÍS-Q",199
46,"46061",331,276,273,3,3,"COMPROMÍS-Q",15
3,"3091",256,220,219,1,1,"COMPROMÍS-Q",13
12,"12049",471,366,344,10,22,"COMPROMÍS-Q",24
12,"12104",6981,5464,5357,54,107,"COMPROMÍS-Q",106
46,"46012",930,698,684,9,14,"COMPROMÍS-Q",13
12,"12139",344,219,216,0,3,"COMPROMÍS-Q",16
3,"3082",11741,8208,8102,80,106,"COMPROMÍS-Q",572
12,"12113",100,72,72,0,0,"COMPROMÍS-Q",0
46,"46009",3140,2521,2498,15,23,"COMPROMÍS-Q",214
3,"3102",7346,5827,5751,39,76,"COMPROMÍS-Q",574
12,"12115",234,184,183,2,1,"COMPROMÍS-Q",0
46,"46138",338,297,296,1,1,"COMPROMÍS-Q",26
46,"46140",379,314,313,0,1,"COMPROMÍS-Q",66
46,"46120",1133,889,870,2,19,"COMPROMÍS-Q",45
46,"46031",10580,7900,7809,87,91,"COMPROMÍS-Q",555
12,"12024",146,129,128,1,1,"COMPROMÍS-Q",2
12,"12045",388,301,286,2,15,"COMPROMÍS-Q",13
46,"46244",57805,41885,41595,415,290,"COMPROMÍS-Q",1792
3,"3073",219,199,199,0,0,"COMPROMÍS-Q",1
12,"12003",1058,830,813,15,17,"COMPROMÍS-Q",34
46,"46032",5583,4342,4287,39,55,"COMPROMÍS-Q",251
3,"3127",399,336,322,3,14,"COMPROMÍS-Q",12
3,"3035",672,560,550,0,10,"COMPROMÍS-Q",43
3,"3002",3559,2747,2707,16,40,"COMPROMÍS-Q",178
3,"3046",1530,1136,1121,11,15,"COMPROMÍS-Q",29
46,"46218",1082,964,936,5,28,"COMPROMÍS-Q",136
12,"12031",3748,2751,2687,35,64,"COMPROMÍS-Q",158
46,"46133",686,572,565,1,7,"COMPROMÍS-Q",9
46,"46069",166,149,148,1,1,"COMPROMÍS-Q",10
46,"46112",582,475,463,4,12,"COMPROMÍS-Q",11
46,"46171",16753,12565,12399,122,166,"COMPROMÍS-Q",718
46,"46188",660,579,576,4,3,"COMPROMÍS-Q",80
46,"46106",1616,1196,1188,6,8,"COMPROMÍS-Q",18
3,"3086",145,119,118,1,1,"COMPROMÍS-Q",19
12,"12040",116573,84142,83078,1257,1064,"COMPROMÍS-Q",3793
46,"46139",4594,3794,3734,28,60,"COMPROMÍS-Q",300
12,"12075",139,106,102,0,4,"COMPROMÍS-Q",4
46,"46058",1787,1460,1441,10,19,"COMPROMÍS-Q",43
46,"46204",6906,5426,5357,62,69,"COMPROMÍS-Q",315
46,"46082",4661,3447,3401,46,46,"COMPROMÍS-Q",159
46,"46196",159,145,144,1,1,"COMPROMÍS-Q",1
3,"3098",526,410,400,6,10,"COMPROMÍS-Q",20
46,"46103",1244,998,972,12,26,"COMPROMÍS-Q",74
12,"12050",1418,1183,1156,8,27,"COMPROMÍS-Q",30
46,"46060",9510,7506,7408,52,98,"COMPROMÍS-Q",481
46,"46902",425,333,332,3,1,"COMPROMÍS-Q",12
46,"46129",553,430,423,4,7,"COMPROMÍS-Q",2
12,"12080",2051,1692,1650,23,42,"COMPROMÍS-Q",53
46,"46163",1811,1487,1463,12,24,"COMPROMÍS-Q",117
46,"46122",2737,2154,2131,18,23,"COMPROMÍS-Q",90
46,"46145",21751,16601,16397,155,204,"COMPROMÍS-Q",998
3,"3009",47547,35945,35298,603,647,"COMPROMÍS-Q",2045
46,"46226",34,34,33,0,1,"COMPROMÍS-Q",2
46,"46018",689,597,592,12,5,"COMPROMÍS-Q",12
12,"12074",783,679,676,3,3,"COMPROMÍS-Q",4
46,"46030",800,677,662,6,15,"COMPROMÍS-Q",25
46,"46206",595,497,495,3,2,"COMPROMÍS-Q",8
12,"12119",153,87,87,0,0,"COMPROMÍS-Q",0
12,"12099",583,485,465,3,20,"COMPROMÍS-Q",6
46,"46234",388,308,307,3,1,"COMPROMÍS-Q",17
46,"46217",912,758,751,4,7,"COMPROMÍS-Q",63
46,"46184",26507,20314,20010,263,304,"COMPROMÍS-Q",1629
46,"46048",3484,2915,2875,26,40,"COMPROMÍS-Q",292
46,"46042",3376,2873,2819,17,54,"COMPROMÍS-Q",129
46,"46193",8494,6662,6580,73,82,"COMPROMÍS-Q",509
46,"46046",922,699,694,2,5,"COMPROMÍS-Q",55
46,"46006",4643,3847,3785,32,62,"COMPROMÍS-Q",397
46,"46053",584,484,461,2,23,"COMPROMÍS-Q",35
3,"3042",1337,1028,1019,8,9,"COMPROMÍS-Q",103
12,"12108",495,394,389,4,5,"COMPROMÍS-Q",8
3,"3118",2368,1746,1718,16,28,"COMPROMÍS-Q",15
12,"12087",22,20,20,0,0,"COMPROMÍS-Q",1
46,"46049",292,249,245,0,4,"COMPROMÍS-Q",19
46,"46010",927,706,699,3,7,"COMPROMÍS-Q",28
46,"46111",10589,7823,7710,94,113,"COMPROMÍS-Q",298
12,"12088",55,51,51,2,0,"COMPROMÍS-Q",0
46,"46210",346,300,295,4,5,"COMPROMÍS-Q",18
46,"46104",2012,1691,1676,9,15,"COMPROMÍS-Q",240
46,"46174",1003,854,847,6,7,"COMPROMÍS-Q",61
46,"46134",2326,1691,1664,20,27,"COMPROMÍS-Q",61
46,"46222",378,321,310,1,11,"COMPROMÍS-Q",35
3,"3039",92,70,66,1,4,"COMPROMÍS-Q",3
12,"12029",760,619,601,7,18,"COMPROMÍS-Q",13
12,"12131",92,78,78,1,0,"COMPROMÍS-Q",0
3,"3084",593,518,513,2,5,"COMPROMÍS-Q",16
46,"46173",1393,1156,1137,10,19,"COMPROMÍS-Q",116
46,"46192",755,564,554,9,10,"COMPROMÍS-Q",29
3,"3138",3218,2403,2388,22,15,"COMPROMÍS-Q",128
46,"46080",1090,860,849,2,11,"COMPROMÍS-Q",7
46,"46211",1716,1459,1447,9,12,"COMPROMÍS-Q",74
46,"46118",3883,3141,3105,28,36,"COMPROMÍS-Q",88
3,"3112",684,566,561,4,5,"COMPROMÍS-Q",18
46,"46213",15621,11361,11164,214,197,"COMPROMÍS-Q",184
46,"46085",11344,8526,8426,87,100,"COMPROMÍS-Q",632
3,"3067",94,81,79,1,2,"COMPROMÍS-Q",8
12,"12132",524,407,401,4,6,"COMPROMÍS-Q",25
3,"3007",160,131,127,0,4,"COMPROMÍS-Q",11
46,"46252",142,108,107,1,1,"COMPROMÍS-Q",0
12,"12133",64,47,47,0,0,"COMPROMÍS-Q",0
46,"46157",3068,2523,2491,17,32,"COMPROMÍS-Q",141
46,"46254",1085,847,834,12,13,"COMPROMÍS-Q",13
46,"46079",381,304,299,3,5,"COMPROMÍS-Q",2
3,"3080",1288,1116,1103,6,13,"COMPROMÍS-Q",4
3,"3034",1343,1140,1126,5,14,"COMPROMÍS-Q",16
46,"46055",1286,1083,1067,11,16,"COMPROMÍS-Q",152
46,"46003",988,864,847,13,17,"COMPROMÍS-Q",54
3,"3038",338,294,291,2,3,"COMPROMÍS-Q",7
3,"3068",48,45,45,1,0,"COMPROMÍS-Q",1
3,"3071",3993,3180,3128,40,52,"COMPROMÍS-Q",326
12,"12091",203,153,140,2,13,"COMPROMÍS-Q",1
46,"46050",161,126,123,1,3,"COMPROMÍS-Q",2
3,"3053",7082,5754,5664,60,90,"COMPROMÍS-Q",299
46,"46161",1454,1192,1179,8,13,"COMPROMÍS-Q",78
3,"3049",12150,10039,9892,88,147,"COMPROMÍS-Q",90
3,"3139",21796,15501,15320,160,181,"COMPROMÍS-Q",446
46,"46152",96,70,70,0,0,"COMPROMÍS-Q",3
3,"3036",84,72,72,0,0,"COMPROMÍS-Q",10
46,"46020",3793,3084,3046,21,38,"COMPROMÍS-Q",196
12,"12011",4663,3578,3525,28,53,"COMPROMÍS-Q",171
46,"46117",476,377,373,6,4,"COMPROMÍS-Q",15
46,"46175",469,406,401,5,5,"COMPROMÍS-Q",22
46,"46247",1059,829,823,6,6,"COMPROMÍS-Q",6
12,"12034",1509,1125,1097,10,28,"COMPROMÍS-Q",60
12,"12117",3674,2846,2794,25,52,"COMPROMÍS-Q",156
12,"12063",59,42,41,0,1,"COMPROMÍS-Q",2
3,"3030",522,464,453,6,11,"COMPROMÍS-Q",39
3,"3050",17818,12860,12706,160,154,"COMPROMÍS-Q",509
46,"46216",4806,3857,3825,39,32,"COMPROMÍS-Q",251
3,"3059",20261,15951,15825,82,126,"COMPROMÍS-Q",1489
46,"46054",11422,8666,8566,82,100,"COMPROMÍS-Q",386
46,"46072",3711,3006,2932,38,74,"COMPROMÍS-Q",302
46,"46088",196,146,140,0,6,"COMPROMÍS-Q",4
46,"46186",18444,14173,14029,135,144,"COMPROMÍS-Q",817
46,"46177",4594,3576,3523,29,53,"COMPROMÍS-Q",310
46,"46203",3669,3002,2964,36,38,"COMPROMÍS-Q",164
46,"46023",318,275,267,2,8,"COMPROMÍS-Q",18
46,"46123",1808,1440,1410,7,30,"COMPROMÍS-Q",240
46,"46187",1339,1096,1083,13,13,"COMPROMÍS-Q",66
3,"3006",479,380,369,2,11,"COMPROMÍS-Q",29
46,"46074",2656,2071,2053,22,18,"COMPROMÍS-Q",185
12,"12095",1027,790,775,15,15,"COMPROMÍS-Q",10
46,"46241",440,336,314,4,22,"COMPROMÍS-Q",12
12,"12125",235,203,201,1,2,"COMPROMÍS-Q",1
12,"12073",168,135,135,1,0,"COMPROMÍS-Q",2
3,"3064",4976,4098,4058,26,40,"COMPROMÍS-Q",24
3,"3045",233,204,203,2,1,"COMPROMÍS-Q",12
12,"12101",385,309,296,3,13,"COMPROMÍS-Q",6
46,"46166",8260,6422,6324,60,98,"COMPROMÍS-Q",568
12,"12069",53,48,47,0,1,"COMPROMÍS-Q",3
12,"12127",92,64,61,0,3,"COMPROMÍS-Q",3
3,"3025",1252,1054,1044,4,10,"COMPROMÍS-Q",6
46,"46165",6962,5390,5322,53,68,"COMPROMÍS-Q",292
46,"46238",13401,10371,10283,96,88,"COMPROMÍS-Q",1410
46,"46141",424,338,336,2,2,"COMPROMÍS-Q",6
46,"46004",1933,1563,1541,8,22,"COMPROMÍS-Q",231
12,"12083",106,89,88,0,1,"COMPROMÍS-Q",0
12,"12105",866,679,673,6,6,"COMPROMÍS-Q",12
3,"3081",1409,1102,1087,14,15,"COMPROMÍS-Q",160
46,"46064",547,463,458,2,5,"COMPROMÍS-Q",30
46,"46153",445,374,366,7,8,"COMPROMÍS-Q",49
46,"46052",532,471,463,2,8,"COMPROMÍS-Q",16
12,"12128",1448,1114,1092,16,22,"COMPROMÍS-Q",39
12,"12121",1197,1050,1020,4,30,"COMPROMÍS-Q",15
3,"3902",9578,7085,7007,65,78,"COMPROMÍS-Q",43
46,"46093",2082,1722,1716,9,6,"COMPROMÍS-Q",104
12,"12026",946,728,702,16,26,"COMPROMÍS-Q",23
46,"46224",179,131,128,0,3,"COMPROMÍS-Q",10
46,"46259",537,426,424,9,2,"COMPROMÍS-Q",13
12,"12004",4354,3145,3083,50,62,"COMPROMÍS-Q",133
46,"46176",1965,1423,1405,12,18,"COMPROMÍS-Q",57
3,"3078",528,424,423,2,1,"COMPROMÍS-Q",4
3,"3011",7341,5277,5218,72,59,"COMPROMÍS-Q",123
3,"3133",40056,25746,25554,231,192,"COMPROMÍS-Q",219
46,"46076",651,541,528,2,13,"COMPROMÍS-Q",4
46,"46231",2496,1831,1817,16,14,"COMPROMÍS-Q",170
12,"12012",2747,2196,2135,24,61,"COMPROMÍS-Q",22
46,"46227",923,787,771,4,16,"COMPROMÍS-Q",97
46,"46200",1915,1625,1595,15,30,"COMPROMÍS-Q",85
46,"46257",5579,4546,4512,32,34,"COMPROMÍS-Q",403
12,"12134",147,107,107,3,0,"COMPROMÍS-Q",3
46,"46062",4589,3794,3752,46,42,"COMPROMÍS-Q",256
12,"12057",650,530,515,6,15,"COMPROMÍS-Q",21
12,"12014",191,139,137,4,2,"COMPROMÍS-Q",8
46,"46256",6734,4902,4858,33,44,"COMPROMÍS-Q",255
12,"12051",520,382,376,1,6,"COMPROMÍS-Q",8
46,"46041",369,255,255,1,0,"COMPROMÍS-Q",14
12,"12006",185,160,153,0,7,"COMPROMÍS-Q",4
12,"12064",118,91,89,1,2,"COMPROMÍS-Q",4
46,"46198",815,660,654,4,6,"COMPROMÍS-Q",115
12,"12052",627,510,491,9,19,"COMPROMÍS-Q",16
46,"46100",307,264,255,0,9,"COMPROMÍS-Q",25
46,"46087",137,105,105,1,0,"COMPROMÍS-Q",1
3,"3063",25410,18205,17989,208,216,"COMPROMÍS-Q",1199
46,"46035",6470,5115,5047,38,68,"COMPROMÍS-Q",504
3,"3101",4648,3694,3607,29,87,"COMPROMÍS-Q",487
12,"12124",1902,1532,1499,15,33,"COMPROMÍS-Q",27
46,"46249",9650,7288,7191,125,97,"COMPROMÍS-Q",76
12,"12114",228,178,173,2,5,"COMPROMÍS-Q",4
12,"12085",4941,3183,3125,32,58,"COMPROMÍS-Q",103
3,"3060",124,100,98,0,2,"COMPROMÍS-Q",8
46,"46114",565,501,495,3,6,"COMPROMÍS-Q",3
46,"46260",2576,2140,2106,24,34,"COMPROMÍS-Q",153
3,"3129",1188,936,918,10,18,"COMPROMÍS-Q",28
12,"12138",18762,12489,12231,243,258,"COMPROMÍS-Q",496
12,"12110",253,199,195,3,4,"COMPROMÍS-Q",7
46,"46084",1587,1363,1332,7,31,"COMPROMÍS-Q",72
46,"46148",1400,1131,1114,13,17,"COMPROMÍS-Q",32
3,"3090",16226,12224,12116,139,108,"COMPROMÍS-Q",369
12,"12021",4433,3368,3292,42,76,"COMPROMÍS-Q",200
3,"3114",1620,1320,1305,10,15,"COMPROMÍS-Q",12
46,"46202",15578,11811,11676,110,135,"COMPROMÍS-Q",675
12,"12065",181,155,155,0,0,"COMPROMÍS-Q",0
12,"12100",1380,1124,1109,11,15,"COMPROMÍS-Q",26
3,"3092",6780,5364,5269,96,95,"COMPROMÍS-Q",480
46,"46223",7685,6040,5996,62,44,"COMPROMÍS-Q",293
3,"3070",1962,1582,1552,8,30,"COMPROMÍS-Q",7
12,"12141",116,97,97,0,0,"COMPROMÍS-Q",2
3,"3140",26223,19998,19552,338,446,"COMPROMÍS-Q",721
46,"46086",80,71,71,3,0,"COMPROMÍS-Q",6
12,"12079",450,360,353,3,7,"COMPROMÍS-Q",1
3,"3121",20518,14464,14315,137,149,"COMPROMÍS-Q",426
46,"46181",17153,13332,13184,108,148,"COMPROMÍS-Q",1557
46,"46246",1081,917,904,5,13,"COMPROMÍS-Q",15
3,"3047",8867,6219,6113,76,106,"COMPROMÍS-Q",224
3,"3012",1021,870,862,3,8,"COMPROMÍS-Q",17
46,"46189",490,400,396,3,4,"COMPROMÍS-Q",58
46,"46214",15129,11609,11500,116,109,"COMPROMÍS-Q",561
12,"12041",115,98,98,2,0,"COMPROMÍS-Q",2
46,"46068",326,292,285,3,7,"COMPROMÍS-Q",24
3,"3104",26809,20511,20193,317,318,"COMPROMÍS-Q",613
3,"3093",19646,15399,15159,173,240,"COMPROMÍS-Q",286
3,"3116",1167,912,904,12,8,"COMPROMÍS-Q",77
46,"46156",2065,1746,1721,14,25,"COMPROMÍS-Q",94
3,"3041",5811,4325,4269,33,56,"COMPROMÍS-Q",374
3,"3124",482,420,415,7,5,"COMPROMÍS-Q",47
46,"46095",632,505,495,1,10,"COMPROMÍS-Q",12
12,"12007",747,674,660,9,14,"COMPROMÍS-Q",72
46,"46108",550,446,444,3,2,"COMPROMÍS-Q",3
46,"46025",2495,1962,1941,24,21,"COMPROMÍS-Q",147
46,"46125",858,724,710,6,14,"COMPROMÍS-Q",38
3,"3003",460,382,370,1,12,"COMPROMÍS-Q",49
3,"3109",2745,2332,2302,18,30,"COMPROMÍS-Q",17
46,"46903",5210,4037,4000,40,37,"COMPROMÍS-Q",206
12,"12013",180,131,130,0,1,"COMPROMÍS-Q",8
46,"46178",4406,3235,3201,22,34,"COMPROMÍS-Q",182
3,"3004",624,497,486,7,11,"COMPROMÍS-Q",13
46,"46102",19880,15358,15179,122,179,"COMPROMÍS-Q",621
46,"46071",488,418,402,10,16,"COMPROMÍS-Q",8
46,"46160",1976,1591,1570,21,21,"COMPROMÍS-Q",161
46,"46056",203,164,160,2,4,"COMPROMÍS-Q",13
12,"12060",467,367,353,2,14,"COMPROMÍS-Q",14
46,"46011",7727,5874,5777,75,97,"COMPROMÍS-Q",308
12,"12107",358,314,311,4,3,"COMPROMÍS-Q",6
46,"46195",1975,1631,1631,33,0,"COMPROMÍS-Q",110
46,"46033",220,183,181,0,2,"COMPROMÍS-Q",17
3,"3058",4798,4126,4103,26,23,"COMPROMÍS-Q",32
12,"12017",183,143,141,6,2,"COMPROMÍS-Q",3
12,"12028",12115,9084,8992,137,92,"COMPROMÍS-Q",391
12,"12116",56,45,45,0,0,"COMPROMÍS-Q",0
46,"46078",28197,20643,20415,205,228,"COMPROMÍS-Q",1012
12,"12078",365,273,267,5,6,"COMPROMÍS-Q",5
46,"46116",12587,9821,9724,120,97,"COMPROMÍS-Q",528
46,"46248",4847,3655,3597,25,58,"COMPROMÍS-Q",130
46,"46167",411,312,309,0,3,"COMPROMÍS-Q",5
46,"46094",20341,15367,15222,152,145,"COMPROMÍS-Q",907
12,"12120",218,180,177,0,3,"COMPROMÍS-Q",6
3,"3077",1411,1146,1130,14,16,"COMPROMÍS-Q",23
3,"3027",150,131,130,1,1,"COMPROMÍS-Q",4
12,"12076",105,79,79,0,0,"COMPROMÍS-Q",0
46,"46183",5946,4718,4656,35,62,"COMPROMÍS-Q",348
12,"12126",24420,18431,18136,231,295,"COMPROMÍS-Q",490
3,"3033",127,102,97,2,5,"COMPROMÍS-Q",3
46,"46040",1227,1028,1021,13,7,"COMPROMÍS-Q",79
12,"12090",127,109,107,2,2,"COMPROMÍS-Q",3
3,"3052",984,837,820,10,17,"COMPROMÍS-Q",35
46,"46043",149,139,139,0,0,"COMPROMÍS-Q",9
46,"46146",1718,1395,1374,10,21,"COMPROMÍS-Q",239
46,"46230",14204,10650,10515,112,135,"COMPROMÍS-Q",578
12,"12016",1589,1309,1293,15,16,"COMPROMÍS-Q",38
3,"3066",42697,31279,30833,566,446,"COMPROMÍS-Q",580
46,"46137",273,232,229,1,3,"COMPROMÍS-Q",12
12,"12072",1191,1007,977,17,30,"COMPROMÍS-Q",34
12,"12093",254,190,187,0,3,"COMPROMÍS-Q",15
3,"3037",354,293,289,1,4,"COMPROMÍS-Q",22
46,"46027",997,869,855,4,14,"COMPROMÍS-Q",32
46,"46197",1902,1559,1554,15,5,"COMPROMÍS-Q",92
46,"46251",2599,2215,2179,21,36,"COMPROMÍS-Q",126
3,"3019",14914,12087,11927,137,160,"COMPROMÍS-Q",121
12,"12901",3383,2664,2632,34,32,"COMPROMÍS-Q",121
12,"12097",78,59,59,4,0,"COMPROMÍS-Q",1
3,"3044",4459,3798,3753,21,45,"COMPROMÍS-Q",24
12,"12103",85,65,65,4,0,"COMPROMÍS-Q",4
3,"3113",4154,3295,3251,24,44,"COMPROMÍS-Q",28
3,"3100",540,448,443,2,5,"COMPROMÍS-Q",24
46,"46105",16708,12164,12040,100,124,"COMPROMÍS-Q",569
3,"3026",1210,1004,989,11,15,"COMPROMÍS-Q",75
46,"46005",22815,17016,16838,185,178,"COMPROMÍS-Q",756
3,"3056",8929,6927,6776,74,151,"COMPROMÍS-Q",380
46,"46159",23111,17258,17086,141,172,"COMPROMÍS-Q",698
46,"46014",3092,2449,2420,26,29,"COMPROMÍS-Q",172
12,"12038",195,135,134,8,1,"COMPROMÍS-Q",1
46,"46151",717,596,589,3,7,"COMPROMÍS-Q",38
3,"3901",1070,826,818,14,8,"COMPROMÍS-Q",63
12,"12082",9741,7555,7408,84,147,"COMPROMÍS-Q",254
46,"46019",8671,7195,7109,70,86,"COMPROMÍS-Q",459
3,"3062",206,175,175,0,0,"COMPROMÍS-Q",4
46,"46070",15946,11979,11874,113,105,"COMPROMÍS-Q",790
46,"46143",4278,3309,3266,46,43,"COMPROMÍS-Q",329
3,"3022",160,133,131,1,2,"COMPROMÍS-Q",14
3,"3123",7435,5860,5744,63,116,"COMPROMÍS-Q",99
12,"12010",280,232,229,3,3,"COMPROMÍS-Q",14
3,"3074",1752,1479,1466,5,13,"COMPROMÍS-Q",7
46,"46221",350,319,317,3,2,"COMPROMÍS-Q",18
46,"46168",1828,1461,1449,7,12,"COMPROMÍS-Q",101
12,"12902",2056,1454,1411,14,43,"COMPROMÍS-Q",33
46,"46075",166,148,145,3,3,"COMPROMÍS-Q",11
3,"3132",571,464,461,8,3,"COMPROMÍS-Q",36
3,"3136",484,393,386,1,7,"COMPROMÍS-Q",38
3,"3055",5128,4121,4076,43,45,"COMPROMÍS-Q",40
46,"46051",8122,6432,6378,57,54,"COMPROMÍS-Q",227
12,"12140",1204,975,954,9,21,"COMPROMÍS-Q",22
46,"46013",16111,12469,12328,145,141,"COMPROMÍS-Q",955
3,"3089",9696,7447,7302,83,145,"COMPROMÍS-Q",205
3,"3008",176,142,140,1,2,"COMPROMÍS-Q",3
12,"12037",20,15,14,1,1,"COMPROMÍS-Q",1
3,"3023",1425,1259,1233,11,26,"COMPROMÍS-Q",53
12,"12130",425,348,344,2,4,"COMPROMÍS-Q",2
3,"3015",12241,9734,9636,88,98,"COMPROMÍS-Q",58
12,"12025",146,106,105,0,1,"COMPROMÍS-Q",3
46,"46110",21420,15810,15671,134,139,"COMPROMÍS-Q",588
3,"3097",973,791,779,6,12,"COMPROMÍS-Q",97
12,"12137",47,36,35,0,1,"COMPROMÍS-Q",1
12,"12033",1970,1547,1509,8,38,"COMPROMÍS-Q",72
3,"3903",2431,1991,1960,18,31,"COMPROMÍS-Q",16
46,"46172",4838,3492,3445,24,47,"COMPROMÍS-Q",213
46,"46124",768,641,632,10,9,"COMPROMÍS-Q",20
46,"46232",920,730,722,6,8,"COMPROMÍS-Q",14
3,"3001",359,296,292,2,4,"COMPROMÍS-Q",23
12,"12044",527,472,463,4,9,"COMPROMÍS-Q",4
12,"12059",276,227,227,1,0,"COMPROMÍS-Q",1
46,"46097",890,674,662,2,12,"COMPROMÍS-Q",13
46,"46024",448,365,358,1,7,"COMPROMÍS-Q",8
46,"46029",20887,16124,15988,144,136,"COMPROMÍS-Q",1004
36,"36044",2595,1862,1834,23,28,"B.N.G.",275
15,"15040",2891,2160,2129,18,31,"B.N.G.",238
36,"36056",5087,3883,3830,37,53,"B.N.G.",390
36,"36036",2616,1981,1948,24,33,"B.N.G.",170
15,"15041",9718,7514,7425,102,89,"B.N.G.",775
15,"15083",1198,874,855,8,19,"B.N.G.",59
36,"36043",5188,3435,3390,35,45,"B.N.G.",371
15,"15003",1936,1400,1382,19,18,"B.N.G.",89
15,"15028",1485,1130,1118,14,12,"B.N.G.",238
36,"36009",5138,3147,3108,24,39,"B.N.G.",180
15,"15050",1971,1110,1097,27,13,"B.N.G.",140
15,"15089",4354,3255,3216,55,39,"B.N.G.",343
15,"15006",5539,3940,3866,53,74,"B.N.G.",619
15,"15092",6869,4965,4907,53,58,"B.N.G.",911
36,"36034",3684,2686,2651,32,35,"B.N.G.",363
15,"15042",3249,2341,2303,25,38,"B.N.G.",232
36,"36011",1939,1189,1172,15,17,"B.N.G.",71
36,"36053",5677,4204,4157,51,47,"B.N.G.",729
15,"15024",4726,3634,3555,51,79,"B.N.G.",338
36,"36002",3154,2381,2358,35,23,"B.N.G.",266
15,"15034",3116,2146,2114,20,32,"B.N.G.",169
36,"36014",2145,1568,1548,9,20,"B.N.G.",98
36,"36005",8231,5985,5873,84,112,"B.N.G.",578
15,"15062",6304,4418,4356,44,62,"B.N.G.",537
36,"36003",9876,7155,7007,100,148,"B.N.G.",752
36,"36023",8522,6206,6062,64,144,"B.N.G.",807
15,"15072",9868,7077,6951,79,126,"B.N.G.",1401
36,"36017",18554,13573,13378,200,195,"B.N.G.",1511
15,"15081",1139,869,853,9,16,"B.N.G.",41
36,"36046",4093,3175,3120,31,55,"B.N.G.",324
36,"36058",5021,3589,3516,54,73,"B.N.G.",655
36,"36057",236900,168990,166060,2833,2930,"B.N.G.",17461
15,"15065",7570,5710,5628,71,82,"B.N.G.",729
15,"15036",60838,40345,39667,915,678,"B.N.G.",3673
36,"36040",2627,1938,1907,24,31,"B.N.G.",246
36,"36029",16178,11902,11636,148,266,"B.N.G.",2248
15,"15059",10658,7889,7728,125,161,"B.N.G.",968
15,"15061",6105,4391,4307,64,84,"B.N.G.",324
15,"15093",4562,3314,3270,37,44,"B.N.G.",606
15,"15031",22951,16018,15696,382,322,"B.N.G.",1807
15,"15051",4780,3333,3289,61,44,"B.N.G.",474
36,"36024",17164,12723,12500,163,223,"B.N.G.",1082
36,"36022",9203,6423,6226,100,197,"B.N.G.",794
15,"15088",3769,2626,2599,21,27,"B.N.G.",441
15,"15054",32172,20472,20154,519,318,"B.N.G.",2379
15,"15027",1537,1263,1242,22,21,"B.N.G.",93
36,"36032",3666,2789,2755,25,34,"B.N.G.",352
36,"36035",14551,10675,10469,160,206,"B.N.G.",840
36,"36047",2723,1875,1853,27,22,"B.N.G.",159
36,"36051",14288,10228,10079,124,149,"B.N.G.",1014
36,"36010",2987,2312,2282,30,30,"B.N.G.",316
36,"36007",1778,1258,1238,2,20,"B.N.G.",95
15,"15080",1913,1407,1389,15,18,"B.N.G.",142
36,"36028",4207,3294,3254,21,40,"B.N.G.",342
15,"15011",15507,10935,10751,123,184,"B.N.G.",1506
15,"15017",18860,12975,12737,325,238,"B.N.G.",1179
36,"36039",14581,11007,10782,167,225,"B.N.G.",1319
15,"15022",6102,4207,4164,52,43,"B.N.G.",519
15,"15060",5599,4139,4069,82,70,"B.N.G.",383
15,"15008",5657,4224,4157,62,67,"B.N.G.",475
15,"15049",1211,851,843,7,8,"B.N.G.",139
36,"36054",10862,8201,8087,87,114,"B.N.G.",1351
36,"36025",2442,1531,1516,10,15,"B.N.G.",123
36,"36045",24724,17794,17459,237,335,"B.N.G.",2099
36,"36061",8729,6747,6640,68,107,"B.N.G.",562
15,"15045",4178,2743,2727,22,16,"B.N.G.",361
36,"36901",4085,3285,3235,21,50,"B.N.G.",327
15,"15021",5114,3527,3475,77,52,"B.N.G.",328
15,"15052",4567,3539,3493,22,46,"B.N.G.",238
15,"15073",21991,14686,14456,216,230,"B.N.G.",1724
15,"15069",7019,5036,4938,85,98,"B.N.G.",721
15,"15018",1211,821,805,11,16,"B.N.G.",126
15,"15068",5404,3780,3725,53,55,"B.N.G.",374
15,"15013",6160,4229,4165,70,64,"B.N.G.",475
15,"15026",2025,1426,1413,17,13,"B.N.G.",154
36,"36055",13678,10508,10288,155,220,"B.N.G.",1150
15,"15070",9684,6627,6464,141,163,"B.N.G.",1214
15,"15005",23875,15132,14895,356,237,"B.N.G.",1767
15,"15075",12042,8639,8486,147,153,"B.N.G.",910
15,"15039",1374,1027,998,27,29,"B.N.G.",82
36,"36020",2581,1947,1922,27,25,"B.N.G.",139
15,"15044",1436,1083,1068,10,15,"B.N.G.",89
15,"15032",3639,2642,2586,35,56,"B.N.G.",266
15,"15055",4780,3247,3181,70,66,"B.N.G.",420
15,"15053",8164,5679,5592,60,87,"B.N.G.",793
15,"15071",8233,5751,5668,93,83,"B.N.G.",728
15,"15090",1267,959,953,4,6,"B.N.G.",185
15,"15077",8677,6349,6269,82,80,"B.N.G.",483
15,"15035",11969,8239,8120,192,119,"B.N.G.",1574
36,"36033",12323,9328,9150,97,178,"B.N.G.",1107
36,"36042",17897,12635,12437,157,198,"B.N.G.",1649
15,"15033",2581,2094,2079,15,15,"B.N.G.",341
15,"15056",5873,4205,4150,63,55,"B.N.G.",399
15,"15074",4254,3246,3219,35,27,"B.N.G.",421
15,"15025",1173,780,777,10,3,"B.N.G.",69
15,"15015",2840,2006,1964,43,42,"B.N.G.",224
36,"36048",5416,4045,3971,55,74,"B.N.G.",518
36,"36012",3839,2884,2825,14,59,"B.N.G.",241
36,"36006",11387,8911,8727,72,184,"B.N.G.",1309
36,"36018",3492,2516,2494,25,22,"B.N.G.",255
15,"15078",78092,56506,55597,1110,909,"B.N.G.",7110
15,"15014",4239,3151,3104,39,47,"B.N.G.",323
15,"15058",26931,19505,19196,471,309,"B.N.G.",1832
36,"36050",7602,5424,5339,50,85,"B.N.G.",842
15,"15002",21528,15479,15218,314,261,"B.N.G.",2015
36,"36021",11798,8742,8574,136,168,"B.N.G.",1051
15,"15016",5135,3816,3771,22,45,"B.N.G.",220
15,"15063",2849,2022,2001,28,21,"B.N.G.",170
36,"36037",2727,1923,1896,18,27,"B.N.G.",252
15,"15048",4769,3470,3415,57,55,"B.N.G.",247
15,"15046",6949,4641,4539,56,102,"B.N.G.",570
15,"15085",3576,2656,2612,29,44,"B.N.G.",254
15,"15012",3767,2973,2926,51,47,"B.N.G.",255
36,"36060",30264,21398,21051,344,347,"B.N.G.",2180
36,"36013",2690,1801,1778,11,23,"B.N.G.",169
36,"36059",5438,3874,3805,47,69,"B.N.G.",347
15,"15043",5491,4033,3971,45,62,"B.N.G.",430
36,"36008",21702,15366,15037,261,329,"B.N.G.",2544
36,"36049",6608,5189,5097,56,92,"B.N.G.",862
15,"15009",11109,8179,8014,129,165,"B.N.G.",880
15,"15086",3110,2281,2259,30,22,"B.N.G.",162
15,"15023",6629,4879,4795,52,84,"B.N.G.",566
15,"15064",2356,1859,1824,35,35,"B.N.G.",120
15,"15030",201751,141022,138934,2981,2088,"B.N.G.",13531
15,"15084",3681,2676,2656,34,20,"B.N.G.",205
36,"36031",572,484,479,5,5,"B.N.G.",89
15,"15047",2606,1789,1761,33,28,"B.N.G.",206
15,"15038",2363,1643,1610,29,33,"B.N.G.",262
15,"15067",8142,6054,5978,73,76,"B.N.G.",1188
15,"15082",15075,11217,11046,187,171,"B.N.G.",1836
15,"15037",4181,2839,2804,25,35,"B.N.G.",359
36,"36016",1373,865,853,7,12,"B.N.G.",67
15,"15079",1709,1268,1253,14,15,"B.N.G.",155
36,"36027",4478,3376,3339,29,37,"B.N.G.",273
15,"15029",6266,4668,4618,49,50,"B.N.G.",525
36,"36001",3138,2060,2049,13,11,"B.N.G.",329
36,"36019",1681,1204,1188,14,16,"B.N.G.",118
15,"15076",2766,1971,1936,18,35,"B.N.G.",567
15,"15007",3702,2670,2642,19,28,"B.N.G.",228
15,"15901",3855,2463,2419,48,44,"B.N.G.",341
15,"15087",6054,4004,3956,79,48,"B.N.G.",374
15,"15020",4187,2802,2781,18,21,"B.N.G.",545
15,"15066",4180,3098,3062,38,36,"B.N.G.",280
36,"36041",13141,9405,9238,114,167,"B.N.G.",1306
15,"15001",4985,3560,3506,63,54,"B.N.G.",363
36,"36015",4379,3151,3101,38,50,"B.N.G.",425
36,"36026",20494,14048,13798,232,250,"B.N.G.",1479
15,"15019",26096,18466,18187,350,279,"B.N.G.",3220
15,"15004",4891,3595,3545,61,50,"B.N.G.",477
36,"36052",7517,5563,5461,54,102,"B.N.G.",676
36,"36038",65661,47940,47214,836,726,"B.N.G.",7276
15,"15010",2009,1468,1441,24,27,"B.N.G.",158
36,"36030",4387,3206,3177,35,29,"B.N.G.",484
15,"15091",1171,839,829,9,10,"B.N.G.",71
36,"36004",10264,7383,7263,80,120,"B.N.G.",1589
15,"15057",12467,8936,8744,102,192,"B.N.G.",1146
27,"27055",1494,1120,1107,8,13,"BNG",59
27,"27001",2582,1687,1669,31,18,"BNG",128
32,"32068",1631,1187,1174,4,13,"BNG",104
27,"27052",966,726,718,9,8,"BNG",22
32,"32063",2127,1469,1444,22,25,"BNG",116
32,"32033",843,595,583,7,12,"BNG",40
27,"27037",1205,857,845,13,12,"BNG",29
32,"32004",2071,1145,1142,7,3,"BNG",31
32,"32069",4573,3624,3580,35,44,"BNG",375
27,"27053",606,429,426,4,3,"BNG",19
32,"32077",1234,999,993,23,6,"BNG",71
32,"32064",561,439,437,5,2,"BNG",8
27,"27038",1035,817,809,9,8,"BNG",40
32,"32089",1480,1063,1045,7,18,"BNG",75
27,"27057",11297,8174,8005,162,169,"BNG",665
27,"27032",3466,2565,2530,40,35,"BNG",182
32,"32012",912,763,756,8,7,"BNG",87
32,"32072",3949,2881,2841,32,40,"BNG",227
27,"27013",3950,3156,3090,39,66,"BNG",281
32,"32008",7618,5529,5433,83,96,"BNG",631
27,"27017",1138,789,787,6,2,"BNG",50
27,"27016",7521,5439,5338,83,101,"BNG",695
32,"32040",1587,1226,1219,7,7,"BNG",106
32,"32085",10730,7588,7475,100,113,"BNG",716
32,"32076",2358,1835,1823,18,12,"BNG",155
32,"32017",1333,906,895,10,11,"BNG",37
32,"32025",1218,954,941,12,13,"BNG",69
27,"27024",1759,1346,1324,17,22,"BNG",99
27,"27020",3807,3204,3161,33,43,"BNG",200
32,"32048",1004,687,671,48,16,"BNG",76
32,"32028",1805,1369,1354,16,15,"BNG",92
32,"32051",1574,1296,1290,7,6,"BNG",83
27,"27015",4587,3465,3409,55,56,"BNG",280
27,"27042",1888,1427,1407,12,20,"BNG",58
32,"32037",828,660,654,10,6,"BNG",57
27,"27044",3089,2167,2125,31,42,"BNG",315
27,"27048",2404,1939,1909,36,30,"BNG",141
27,"27021",1936,1295,1271,19,24,"BNG",137
32,"32035",1632,1100,1088,8,12,"BNG",59
32,"32026",2775,2096,2064,37,32,"BNG",156
27,"27039",4363,3410,3346,63,64,"BNG",327
27,"27045",1149,817,812,7,5,"BNG",23
27,"27051",8224,6048,5953,108,95,"BNG",896
32,"32011",1026,660,650,4,10,"BNG",19
32,"32032",8284,6295,6198,84,97,"BNG",947
27,"27025",3005,2414,2377,25,37,"BNG",343
27,"27026",2605,1785,1751,19,34,"BNG",157
32,"32044",939,774,764,8,10,"BNG",139
32,"32052",2126,1690,1673,28,17,"BNG",82
27,"27043",1422,988,962,10,26,"BNG",58
32,"32053",1500,1206,1199,19,7,"BNG",73
27,"27031",16169,11446,11214,194,232,"BNG",1441
27,"27901",2559,1847,1831,27,16,"BNG",145
27,"27056",1388,1043,1026,16,17,"BNG",65
32,"32057",608,475,473,4,2,"BNG",19
32,"32031",1079,837,828,5,9,"BNG",44
32,"32036",1528,1217,1202,13,15,"BNG",92
32,"32023",1360,1030,1011,6,19,"BNG",53
27,"27005",2792,2101,2076,21,25,"BNG",276
32,"32003",950,736,727,3,9,"BNG",63
32,"32016",1021,781,776,2,5,"BNG",41
32,"32015",995,697,694,9,3,"BNG",40
27,"27054",1332,1063,1054,12,9,"BNG",228
32,"32020",2958,2300,2283,19,17,"BNG",354
32,"32090",834,662,657,4,5,"BNG",396
32,"32013",2464,1695,1671,10,24,"BNG",124
27,"27007",3015,2426,2374,42,52,"BNG",124
32,"32067",1487,1004,995,10,9,"BNG",202
27,"27009",2354,1812,1782,19,30,"BNG",103
32,"32002",2060,1566,1551,13,15,"BNG",80
27,"27027",2111,1652,1605,21,47,"BNG",182
32,"32083",960,675,672,0,3,"BNG",32
32,"32092",596,367,364,2,3,"BNG",49
27,"27041",2644,1946,1915,29,31,"BNG",168
32,"32007",1674,1263,1243,4,20,"BNG",198
32,"32088",1749,1232,1217,10,15,"BNG",59
32,"32078",1366,1026,1018,3,8,"BNG",59
32,"32081",2240,1698,1682,13,16,"BNG",119
32,"32022",1591,1219,1207,9,12,"BNG",263
32,"32038",497,360,358,2,2,"BNG",17
32,"32045",2640,1999,1980,23,19,"BNG",94
27,"27040",3421,2718,2693,27,25,"BNG",132
32,"32084",1084,818,805,0,13,"BNG",104
27,"27035",194,119,119,0,0,"BNG",4
32,"32018",1351,1100,1092,9,8,"BNG",50
27,"27046",1626,1177,1153,17,24,"BNG",128
27,"27047",1851,1293,1273,16,20,"BNG",208
27,"27902",7198,5074,4976,106,98,"BNG",501
32,"32039",1424,1084,1069,10,15,"BNG",133
32,"32019",11469,8297,8180,134,117,"BNG",676
32,"32062",963,735,729,10,6,"BNG",162
32,"32041",884,576,568,2,8,"BNG",63
27,"27033",723,536,529,10,7,"BNG",46
32,"32059",1983,1526,1510,27,16,"BNG",71
27,"27002",1835,1455,1437,16,18,"BNG",149
32,"32087",1935,1609,1591,11,18,"BNG",119
32,"32005",957,760,753,8,7,"BNG",60
27,"27006",2789,1949,1911,22,38,"BNG",128
32,"32073",1415,1111,1100,8,11,"BNG",73
32,"32056",1861,1378,1369,8,9,"BNG",39
27,"27065",13035,9432,9254,168,178,"BNG",802
27,"27062",681,535,532,7,3,"BNG",14
27,"27023",2770,2196,2178,30,18,"BNG",92
32,"32014",1271,939,925,9,14,"BNG",283
27,"27010",4725,3427,3368,55,59,"BNG",304
27,"27029",1525,1243,1221,18,22,"BNG",90
27,"27011",2663,1822,1785,23,37,"BNG",164
32,"32006",1814,1344,1330,20,14,"BNG",91
32,"32079",1448,1103,1094,14,9,"BNG",99
32,"32047",2003,1595,1575,10,20,"BNG",195
32,"32070",660,457,452,1,5,"BNG",37
32,"32021",1043,793,788,7,5,"BNG",64
27,"27050",3236,2475,2438,11,37,"BNG",161
32,"32055",1412,1056,1037,5,19,"BNG",50
27,"27058",3908,2946,2915,28,31,"BNG",203
27,"27059",2320,1783,1763,25,20,"BNG",140
27,"27061",1170,917,906,8,11,"BNG",75
32,"32074",1180,892,876,11,16,"BNG",51
32,"32001",4938,3715,3667,50,48,"BNG",1432
27,"27019",8247,6146,6022,101,124,"BNG",670
27,"27022",5093,3535,3486,74,49,"BNG",327
27,"27060",2938,2063,2028,26,35,"BNG",155
32,"32027",1156,850,836,15,14,"BNG",51
32,"32080",394,311,309,3,2,"BNG",11
27,"27030",3744,2587,2525,32,62,"BNG",370
32,"32075",3839,2957,2910,51,47,"BNG",166
27,"27012",1519,886,880,6,6,"BNG",49
32,"32061",1196,976,973,4,3,"BNG",62
32,"32046",1375,976,962,3,14,"BNG",90
32,"32091",1971,1472,1466,12,6,"BNG",80
27,"27034",1297,871,867,3,4,"BNG",44
32,"32010",457,362,356,0,6,"BNG",23
32,"32066",634,492,488,0,4,"BNG",12
27,"27008",1458,1130,1115,18,15,"BNG",108
27,"27066",12908,9554,9329,171,225,"BNG",1238
32,"32050",2663,1991,1974,17,17,"BNG",139
32,"32058",5253,3872,3821,57,51,"BNG",218
32,"32060",885,650,641,10,9,"BNG",40
27,"27028",78862,57097,55890,1246,1207,"BNG",4386
32,"32086",2874,2026,2003,18,23,"BNG",242
32,"32065",720,550,539,3,11,"BNG",28
27,"27049",1554,1073,1062,6,11,"BNG",92
32,"32029",557,426,424,1,2,"BNG",14
32,"32049",863,566,563,7,3,"BNG",36
27,"27014",3511,2470,2437,45,33,"BNG",382
32,"32071",1614,1121,1112,4,9,"BNG",72
32,"32030",1120,857,846,9,11,"BNG",30
32,"32054",87289,63027,61875,1263,1152,"BNG",5242
32,"32009",10752,7778,7684,120,94,"BNG",475
27,"27003",2064,1531,1516,19,15,"BNG",121
27,"27018",3871,2523,2489,32,34,"BNG",202
32,"32024",5054,3668,3609,40,59,"BNG",415
32,"32043",2679,2006,1985,14,21,"BNG",377
27,"27004",1379,981,966,4,15,"BNG",36
27,"27064",1706,1233,1214,14,19,"BNG",112
32,"32042",1784,1292,1282,13,10,"BNG",83
32,"32082",1403,1055,1047,9,8,"BNG",59
32,"32034",1228,995,990,5,5,"BNG",75
27,"27063",1916,1469,1440,14,29,"BNG",135
35,"35013",6779,5059,4961,105,98,"IUC-CxI",131
35,"35007",569,392,391,2,1,"IUC-CxI",9
35,"35002",21673,14480,14253,172,227,"IUC-CxI",633
35,"35005",1170,864,853,7,11,"IUC-CxI",12
35,"35011",23140,15550,15320,199,230,"IUC-CxI",575
35,"35010",3565,2178,2135,26,43,"IUC-CxI",113
35,"35022",43892,27289,26876,326,413,"IUC-CxI",873
35,"35003",4764,2733,2680,34,53,"IUC-CxI",107
35,"35015",9065,4859,4770,64,89,"IUC-CxI",145
35,"35020",6142,4227,4192,24,35,"IUC-CxI",54
35,"35009",19678,13799,13442,155,357,"IUC-CxI",516
35,"35027",10510,7523,7375,88,148,"IUC-CxI",235
35,"35016",291589,181013,177964,2856,3049,"IUC-CxI",8829
35,"35024",12420,6978,6819,131,159,"IUC-CxI",338
35,"35026",78933,49860,48955,780,905,"IUC-CxI",1919
35,"35006",29515,20731,20286,362,445,"IUC-CxI",1001
35,"35004",35462,18498,18196,325,302,"IUC-CxI",680
35,"35028",8810,4687,4603,71,84,"IUC-CxI",155
35,"35034",6372,2951,2921,33,30,"IUC-CxI",129
35,"35008",6151,4514,4419,59,95,"IUC-CxI",163
35,"35012",9662,5511,5446,45,65,"IUC-CxI",112
35,"35018",11652,6488,6367,107,121,"IUC-CxI",292
35,"35001",4663,3639,3569,39,70,"IUC-CxI",138
35,"35032",3432,2605,2548,37,57,"IUC-CxI",92
35,"35025",1941,1345,1328,12,17,"IUC-CxI",28
35,"35023",11640,8412,8178,97,234,"IUC-CxI",270
35,"35019",30279,17607,17380,158,227,"IUC-CxI",523
35,"35030",8295,5433,5315,54,118,"IUC-CxI",126
35,"35014",9943,5438,5316,95,122,"IUC-CxI",241
35,"35021",14982,9948,9749,138,199,"IUC-CxI",557
35,"35031",6968,4927,4862,71,65,"IUC-CxI",255
35,"35017",22331,13463,13144,217,319,"IUC-CxI",456
35,"35033",6415,4394,4302,51,92,"IUC-CxI",147
35,"35029",3981,2341,2315,43,26,"IUC-CxI",89
46,"46200",1915,1625,1595,15,30,"C.D.L.",1
46,"46101",868,720,716,8,4,"C.D.L.",2
16,"16905",1017,811,806,14,5,"C.D.L.",0
46,"46262",228,161,158,0,3,"C.D.L.",0
16,"16247",87,65,62,1,3,"C.D.L.",0
46,"46119",856,702,693,0,9,"C.D.L.",0
16,"16099",232,180,178,5,2,"C.D.L.",0
46,"46087",137,105,105,1,0,"C.D.L.",0
16,"16142",118,93,93,1,0,"C.D.L.",0
16,"16906",104,83,82,0,1,"C.D.L.",0
46,"46111",10589,7823,7710,94,113,"C.D.L.",3
16,"16112",1562,1159,1140,12,19,"C.D.L.",0
16,"16071",25,23,23,0,0,"C.D.L.",0
16,"16043",105,86,86,1,0,"C.D.L.",0
46,"46255",3135,2530,2508,11,22,"C.D.L.",2
30,"30006",823,719,711,5,8,"C.D.L.",1
46,"46160",1976,1591,1570,21,21,"C.D.L.",0
16,"16238",560,484,479,3,5,"C.D.L.",0
16,"16903",1097,855,828,9,27,"C.D.L.",0
46,"46014",3092,2449,2420,26,29,"C.D.L.",3
46,"46168",1828,1461,1449,7,12,"C.D.L.",0
46,"46904",782,659,650,6,9,"C.D.L.",1
16,"16101",160,142,142,0,0,"C.D.L.",0
46,"46192",755,564,554,9,10,"C.D.L.",1
16,"16204",306,235,235,5,0,"C.D.L.",3
16,"16272",273,215,215,2,0,"C.D.L.",0
16,"16254",213,166,165,2,1,"C.D.L.",2
16,"16103",310,263,259,4,4,"C.D.L.",0
46,"46258",2792,2196,2164,14,32,"C.D.L.",3
16,"16205",126,94,93,0,1,"C.D.L.",0
16,"16030",28,24,24,0,0,"C.D.L.",0
46,"46172",4838,3492,3445,24,47,"C.D.L.",0
30,"30010",6804,5691,5647,36,44,"C.D.L.",6
46,"46221",350,319,317,3,2,"C.D.L.",0
30,"30902",7463,5291,5228,38,63,"C.D.L.",5
16,"16157",229,187,182,2,5,"C.D.L.",0
16,"16032",304,253,244,2,9,"C.D.L.",0
46,"46186",18444,14173,14029,135,144,"C.D.L.",38
30,"30038",15057,11640,11555,82,85,"C.D.L.",16
46,"46188",660,579,576,4,3,"C.D.L.",0
16,"16189",263,213,211,2,2,"C.D.L.",0
46,"46046",922,699,694,2,5,"C.D.L.",0
46,"46134",2326,1691,1664,20,27,"C.D.L.",2
16,"16197",73,50,50,1,0,"C.D.L.",0
30,"30013",7369,5780,5731,53,49,"C.D.L.",2
30,"30020",5989,4533,4487,14,46,"C.D.L.",3
16,"16017",406,337,334,1,3,"C.D.L.",0
16,"16173",249,189,188,0,1,"C.D.L.",1
30,"30043",24501,19738,19416,230,322,"C.D.L.",15
46,"46007",11576,8929,8848,71,81,"C.D.L.",6
30,"30009",11961,9992,9880,92,112,"C.D.L.",9
46,"46065",1606,1250,1234,15,16,"C.D.L.",0
46,"46024",448,365,358,1,7,"C.D.L.",0
16,"16124",1909,1573,1555,14,18,"C.D.L.",0
46,"46216",4806,3857,3825,39,32,"C.D.L.",3
46,"46093",2082,1722,1716,9,6,"C.D.L.",1
46,"46104",2012,1691,1676,9,15,"C.D.L.",4
46,"46128",1649,1322,1292,14,30,"C.D.L.",0
16,"16186",521,434,429,2,5,"C.D.L.",2
46,"46077",7637,5979,5845,64,134,"C.D.L.",2
16,"16145",508,421,417,6,4,"C.D.L.",0
16,"16203",9839,7520,7342,101,178,"C.D.L.",7
46,"46166",8260,6422,6324,60,98,"C.D.L.",7
16,"16115",60,45,45,0,0,"C.D.L.",0
46,"46062",4589,3794,3752,46,42,"C.D.L.",0
16,"16056",495,377,374,11,3,"C.D.L.",0
46,"46089",2116,1653,1627,9,26,"C.D.L.",0
16,"16015",407,311,311,4,0,"C.D.L.",1
16,"16216",358,300,296,2,4,"C.D.L.",2
16,"16239",158,114,112,2,2,"C.D.L.",0
46,"46004",1933,1563,1541,8,22,"C.D.L.",0
16,"16066",2402,2064,1997,32,67,"C.D.L.",3
16,"16007",1272,1056,1051,7,5,"C.D.L.",0
16,"16263",936,730,719,8,11,"C.D.L.",0
46,"46075",166,148,145,3,3,"C.D.L.",0
46,"46061",331,276,273,3,3,"C.D.L.",0
16,"16117",1130,871,857,8,14,"C.D.L.",0
46,"46162",1230,1045,1027,6,18,"C.D.L.",0
46,"46016",1097,927,917,12,10,"C.D.L.",0
16,"16027",779,619,612,5,7,"C.D.L.",2
46,"46203",3669,3002,2964,36,38,"C.D.L.",3
46,"46142",870,682,673,7,9,"C.D.L.",0
46,"46156",2065,1746,1721,14,25,"C.D.L.",1
46,"46023",318,275,267,2,8,"C.D.L.",0
46,"46144",699,547,536,2,11,"C.D.L.",0
16,"16058",120,103,102,1,1,"C.D.L.",0
46,"46150",1898,1555,1541,8,14,"C.D.L.",2
16,"16191",1001,867,864,13,3,"C.D.L.",0
46,"46039",2200,1849,1820,12,29,"C.D.L.",0
46,"46196",159,145,144,1,1,"C.D.L.",0
46,"46026",1217,1043,1035,2,8,"C.D.L.",3
46,"46038",368,264,260,1,4,"C.D.L.",0
16,"16135",192,127,125,0,2,"C.D.L.",0
16,"16153",1006,856,843,8,13,"C.D.L.",0
46,"46091",126,108,108,0,0,"C.D.L.",0
46,"46235",21966,16641,16465,167,176,"C.D.L.",6
46,"46083",15427,12079,11941,109,138,"C.D.L.",10
46,"46124",768,641,632,10,9,"C.D.L.",0
30,"30021",8550,6423,6349,44,74,"C.D.L.",2
46,"46069",166,149,148,1,1,"C.D.L.",0
46,"46903",5210,4037,4000,40,37,"C.D.L.",5
16,"16244",735,615,606,3,9,"C.D.L.",0
16,"16068",143,117,116,6,1,"C.D.L.",0
46,"46067",1798,1487,1472,10,15,"C.D.L.",3
46,"46135",9634,7671,7586,64,85,"C.D.L.",8
46,"46213",15621,11361,11164,214,197,"C.D.L.",7
16,"16147",78,63,62,1,1,"C.D.L.",0
30,"30017",11683,9332,9233,95,99,"C.D.L.",10
46,"46008",2727,2249,2233,17,16,"C.D.L.",0
16,"16240",134,100,98,0,2,"C.D.L.",0
46,"46011",7727,5874,5777,75,97,"C.D.L.",5
46,"46165",6962,5390,5322,53,68,"C.D.L.",0
16,"16086",935,814,802,14,12,"C.D.L.",1
46,"46015",7042,5644,5581,53,63,"C.D.L.",40
46,"46058",1787,1460,1441,10,19,"C.D.L.",1
16,"16053",414,334,326,2,8,"C.D.L.",0
46,"46095",632,505,495,1,10,"C.D.L.",0
16,"16174",209,170,167,0,3,"C.D.L.",0
46,"46031",10580,7900,7809,87,91,"C.D.L.",2
46,"46140",379,314,313,0,1,"C.D.L.",0
46,"46193",8494,6662,6580,73,82,"C.D.L.",4
46,"46147",16527,11836,11716,105,120,"C.D.L.",6
16,"16079",33,21,21,0,0,"C.D.L.",0
46,"46223",7685,6040,5996,62,44,"C.D.L.",5
30,"30029",11533,8854,8768,73,86,"C.D.L.",47
16,"16038",50,40,40,0,0,"C.D.L.",0
46,"46113",2338,1804,1797,14,7,"C.D.L.",1
46,"46148",1400,1131,1114,13,17,"C.D.L.",0
46,"46220",48981,34657,34242,450,415,"C.D.L.",54
16,"16064",699,588,580,4,8,"C.D.L.",0
30,"30041",12957,9360,9288,89,72,"C.D.L.",9
46,"46180",715,585,581,4,4,"C.D.L.",0
16,"16217",113,95,92,0,3,"C.D.L.",0
16,"16107",161,101,98,1,3,"C.D.L.",0
16,"16094",142,112,111,1,1,"C.D.L.",0
16,"16149",179,140,138,2,2,"C.D.L.",0
46,"46013",16111,12469,12328,145,141,"C.D.L.",11
46,"46902",425,333,332,3,1,"C.D.L.",0
46,"46177",4594,3576,3523,29,53,"C.D.L.",2
46,"46012",930,698,684,9,14,"C.D.L.",0
16,"16040",97,76,75,1,1,"C.D.L.",0
16,"16018",417,350,342,3,8,"C.D.L.",0
16,"16073",214,170,170,2,0,"C.D.L.",0
46,"46070",15946,11979,11874,113,105,"C.D.L.",15
16,"16187",78,61,60,3,1,"C.D.L.",0
46,"46055",1286,1083,1067,11,16,"C.D.L.",1
30,"30004",1164,958,952,1,6,"C.D.L.",0
46,"46154",836,684,678,7,6,"C.D.L.",1
16,"16003",147,122,121,0,1,"C.D.L.",0
46,"46019",8671,7195,7109,70,86,"C.D.L.",1
16,"16259",30,26,26,1,0,"C.D.L.",0
16,"16055",698,485,481,8,4,"C.D.L.",0
16,"16131",154,116,115,0,1,"C.D.L.",2
46,"46169",31753,24041,23802,270,239,"C.D.L.",16
46,"46204",6906,5426,5357,62,69,"C.D.L.",5
16,"16140",34,27,27,0,0,"C.D.L.",0
16,"16224",96,69,69,0,0,"C.D.L.",0
46,"46132",2124,1845,1817,14,28,"C.D.L.",1
46,"46236",996,853,844,7,9,"C.D.L.",3
46,"46047",551,479,469,10,10,"C.D.L.",4
46,"46217",912,758,751,4,7,"C.D.L.",0
16,"16270",192,156,155,0,1,"C.D.L.",0
16,"16156",122,91,91,0,0,"C.D.L.",0
16,"16067",135,97,97,2,0,"C.D.L.",0
16,"16237",116,98,98,3,0,"C.D.L.",0
46,"46263",333,243,241,2,2,"C.D.L.",0
16,"16155",549,430,426,2,4,"C.D.L.",1
46,"46143",4278,3309,3266,46,43,"C.D.L.",0
16,"16199",27,20,19,0,1,"C.D.L.",0
16,"16050",298,245,238,0,7,"C.D.L.",0
16,"16070",35,29,29,0,0,"C.D.L.",0
46,"46167",411,312,309,0,3,"C.D.L.",0
46,"46099",987,764,754,2,10,"C.D.L.",0
46,"46237",7261,5405,5350,54,55,"C.D.L.",4
46,"46229",1065,840,831,8,9,"C.D.L.",0
16,"16280",205,177,175,1,2,"C.D.L.",0
46,"46107",1998,1650,1623,8,27,"C.D.L.",1
46,"46159",23111,17258,17086,141,172,"C.D.L.",15
46,"46194",15267,11622,11491,110,131,"C.D.L.",13
46,"46096",320,267,267,0,0,"C.D.L.",0
46,"46042",3376,2873,2819,17,54,"C.D.L.",0
46,"46109",6143,4731,4637,40,94,"C.D.L.",0
16,"16024",134,92,91,1,1,"C.D.L.",0
46,"46028",424,352,347,5,5,"C.D.L.",0
30,"30019",25722,18740,18553,164,187,"C.D.L.",24
46,"46232",920,730,722,6,8,"C.D.L.",0
30,"30036",13978,10244,10141,94,103,"C.D.L.",9
46,"46057",483,357,349,9,8,"C.D.L.",0
46,"46184",26507,20314,20010,263,304,"C.D.L.",39
46,"46214",15129,11609,11500,116,109,"C.D.L.",6
46,"46105",16708,12164,12040,100,124,"C.D.L.",8
16,"16102",1320,1016,1007,15,9,"C.D.L.",0
16,"16150",120,90,90,0,0,"C.D.L.",0
46,"46228",2434,1881,1859,30,22,"C.D.L.",2
46,"46051",8122,6432,6378,57,54,"C.D.L.",2
16,"16022",102,76,76,2,0,"C.D.L.",0
16,"16096",279,231,229,7,2,"C.D.L.",0
46,"46182",1190,864,855,11,9,"C.D.L.",1
46,"46084",1587,1363,1332,7,31,"C.D.L.",0
16,"16255",159,123,122,3,1,"C.D.L.",0
16,"16161",84,73,72,4,1,"C.D.L.",0
46,"46120",1133,889,870,2,19,"C.D.L.",0
16,"16231",47,43,43,0,0,"C.D.L.",0
46,"46034",1791,1477,1468,8,9,"C.D.L.",2
16,"16019",252,210,207,2,3,"C.D.L.",1
16,"16126",811,701,692,13,9,"C.D.L.",0
16,"16119",181,130,130,0,0,"C.D.L.",0
16,"16234",52,38,36,0,2,"C.D.L.",0
16,"16253",340,256,256,4,0,"C.D.L.",2
46,"46018",689,597,592,12,5,"C.D.L.",0
16,"16194",298,238,238,1,0,"C.D.L.",0
16,"16167",357,318,315,5,3,"C.D.L.",0
16,"16033",1792,1485,1454,10,31,"C.D.L.",1
30,"30001",4763,3992,3956,26,36,"C.D.L.",3
46,"46078",28197,20643,20415,205,228,"C.D.L.",108
46,"46002",1166,942,915,7,27,"C.D.L.",0
46,"46090",1668,1488,1452,9,36,"C.D.L.",0
16,"16029",114,80,80,0,0,"C.D.L.",0
46,"46102",19880,15358,15179,122,179,"C.D.L.",11
46,"46043",149,139,139,0,0,"C.D.L.",0
16,"16169",75,44,44,0,0,"C.D.L.",0
46,"46175",469,406,401,5,5,"C.D.L.",3
16,"16277",128,100,100,3,0,"C.D.L.",0
46,"46130",934,745,734,6,11,"C.D.L.",0
16,"16039",466,330,326,1,4,"C.D.L.",0
46,"46227",923,787,771,4,16,"C.D.L.",3
46,"46246",1081,917,904,5,13,"C.D.L.",0
16,"16215",285,192,186,2,6,"C.D.L.",1
46,"46151",717,596,589,3,7,"C.D.L.",0
46,"46009",3140,2521,2498,15,23,"C.D.L.",2
46,"46252",142,108,107,1,1,"C.D.L.",0
16,"16185",63,45,44,0,1,"C.D.L.",0
16,"16148",634,553,547,5,6,"C.D.L.",1
30,"30028",6810,5333,5251,44,82,"C.D.L.",6
46,"46201",83,50,49,0,1,"C.D.L.",0
46,"46163",1811,1487,1463,12,24,"C.D.L.",0
46,"46085",11344,8526,8426,87,100,"C.D.L.",2
16,"16097",196,167,166,2,1,"C.D.L.",0
46,"46174",1003,854,847,6,7,"C.D.L.",0
16,"16110",98,81,81,3,0,"C.D.L.",0
16,"16084",49,36,35,0,1,"C.D.L.",0
16,"16243",451,395,388,3,7,"C.D.L.",0
30,"30024",57868,41894,41513,393,381,"C.D.L.",56
46,"46158",1037,829,822,9,7,"C.D.L.",0
30,"30005",29081,22312,22142,184,170,"C.D.L.",198
46,"46253",118,105,102,7,3,"C.D.L.",0
16,"16162",51,36,36,0,0,"C.D.L.",0
16,"16248",887,733,710,20,23,"C.D.L.",0
16,"16141",161,132,131,1,1,"C.D.L.",0
46,"46240",226,188,185,3,3,"C.D.L.",39
16,"16176",61,45,43,0,2,"C.D.L.",0
16,"16158",550,427,423,2,4,"C.D.L.",6
46,"46005",22815,17016,16838,185,178,"C.D.L.",14
16,"16265",27,26,26,0,0,"C.D.L.",0
16,"16154",4946,3975,3914,58,61,"C.D.L.",2
16,"16085",151,123,122,2,1,"C.D.L.",0
46,"46116",12587,9821,9724,120,97,"C.D.L.",5
46,"46245",478,357,354,1,3,"C.D.L.",0
30,"30007",6115,4651,4603,29,48,"C.D.L.",4
16,"16193",77,68,67,0,1,"C.D.L.",0
16,"16074",53,42,42,1,0,"C.D.L.",0
16,"16910",104,69,69,1,0,"C.D.L.",0
46,"46076",651,541,528,2,13,"C.D.L.",3
46,"46108",550,446,444,3,2,"C.D.L.",0
46,"46211",1716,1459,1447,9,12,"C.D.L.",1
16,"16209",153,129,129,0,0,"C.D.L.",0
16,"16276",32,23,22,1,1,"C.D.L.",0
30,"30008",13289,9992,9849,86,143,"C.D.L.",17
16,"16078",40954,30382,29933,568,449,"C.D.L.",24
16,"16166",277,210,202,0,8,"C.D.L.",0
16,"16062",30,27,27,0,0,"C.D.L.",0
16,"16042",1286,1101,1089,8,12,"C.D.L.",2
16,"16219",106,83,82,0,1,"C.D.L.",0
16,"16143",20,14,13,1,1,"C.D.L.",0
46,"46022",15090,10922,10840,99,82,"C.D.L.",30
46,"46071",488,418,402,10,16,"C.D.L.",1
46,"46112",582,475,463,4,12,"C.D.L.",0
16,"16134",4283,3398,3361,59,37,"C.D.L.",5
16,"16106",2839,2351,2331,10,20,"C.D.L.",0
46,"46231",2496,1831,1817,16,14,"C.D.L.",0
30,"30032",2839,2361,2337,21,24,"C.D.L.",3
46,"46155",1072,861,849,4,12,"C.D.L.",0
30,"30023",3572,2859,2811,22,48,"C.D.L.",1
46,"46199",5661,4328,4280,38,48,"C.D.L.",3
46,"46161",1454,1192,1179,8,13,"C.D.L.",0
30,"30015",18792,14453,14336,120,117,"C.D.L.",7
46,"46059",1310,1076,1058,2,18,"C.D.L.",0
46,"46010",927,706,699,3,7,"C.D.L.",1
46,"46021",23273,17264,17091,163,173,"C.D.L.",28
46,"46115",515,364,354,1,10,"C.D.L.",0
46,"46086",80,71,71,3,0,"C.D.L.",0
46,"46056",203,164,160,2,4,"C.D.L.",0
46,"46110",21420,15810,15671,134,139,"C.D.L.",16
16,"16081",64,46,45,1,1,"C.D.L.",1
46,"46210",346,300,295,4,5,"C.D.L.",1
30,"30018",7493,6003,5922,52,81,"C.D.L.",5
16,"16909",737,590,585,9,5,"C.D.L.",0
16,"16083",58,30,30,1,0,"C.D.L.",0
16,"16052",596,469,464,2,5,"C.D.L.",0
46,"46208",1141,990,978,6,12,"C.D.L.",0
16,"16225",89,69,68,1,1,"C.D.L.",0
46,"46138",338,297,296,1,1,"C.D.L.",2
46,"46224",179,131,128,0,3,"C.D.L.",0
16,"16249",2076,1728,1700,11,28,"C.D.L.",0
46,"46060",9510,7506,7408,52,98,"C.D.L.",4
46,"46206",595,497,495,3,2,"C.D.L.",0
46,"46044",4301,3284,3169,50,115,"C.D.L.",1
16,"16013",24,23,23,0,0,"C.D.L.",0
16,"16139",346,279,277,2,2,"C.D.L.",0
46,"46212",1598,1233,1218,5,15,"C.D.L.",0
46,"46179",2186,1849,1804,17,45,"C.D.L.",1
16,"16002",195,175,172,0,3,"C.D.L.",0
46,"46114",565,501,495,3,6,"C.D.L.",0
46,"46001",863,647,641,5,6,"C.D.L.",0
30,"30014",1686,1400,1387,10,13,"C.D.L.",4
46,"46050",161,126,123,1,3,"C.D.L.",0
16,"16049",158,129,129,1,0,"C.D.L.",0
16,"16026",104,79,79,1,0,"C.D.L.",9
16,"16250",94,71,71,0,0,"C.D.L.",0
16,"16035",287,216,213,2,3,"C.D.L.",0
46,"46082",4661,3447,3401,46,46,"C.D.L.",6
16,"16023",468,332,327,3,5,"C.D.L.",0
16,"16228",202,146,144,2,2,"C.D.L.",0
16,"16109",46,34,34,2,0,"C.D.L.",0
16,"16009",79,63,62,0,1,"C.D.L.",0
46,"46248",4847,3655,3597,25,58,"C.D.L.",0
46,"46094",20341,15367,15222,152,145,"C.D.L.",20
16,"16904",508,413,407,10,6,"C.D.L.",0
16,"16063",97,81,81,0,0,"C.D.L.",0
46,"46183",5946,4718,4656,35,62,"C.D.L.",2
46,"46202",15578,11811,11676,110,135,"C.D.L.",10
46,"46218",1082,964,936,5,28,"C.D.L.",0
30,"30027",45194,35272,34973,366,299,"C.D.L.",23
46,"46072",3711,3006,2932,38,74,"C.D.L.",1
16,"16111",171,130,128,0,2,"C.D.L.",0
16,"16278",91,69,69,2,0,"C.D.L.",0
16,"16093",80,57,57,0,0,"C.D.L.",0
16,"16092",158,132,132,0,0,"C.D.L.",0
30,"30042",1841,1531,1519,10,12,"C.D.L.",3
16,"16091",86,66,66,1,0,"C.D.L.",0
16,"16160",76,54,53,1,1,"C.D.L.",0
46,"46257",5579,4546,4512,32,34,"C.D.L.",1
16,"16034",207,174,173,0,1,"C.D.L.",0
46,"46073",1119,931,915,14,16,"C.D.L.",1
46,"46260",2576,2140,2106,24,34,"C.D.L.",2
16,"16196",658,578,568,6,10,"C.D.L.",0
46,"46198",815,660,654,4,6,"C.D.L.",2
46,"46098",2556,2072,2057,12,15,"C.D.L.",0
30,"30012",9037,7242,7142,62,100,"C.D.L.",10
16,"16192",54,37,37,1,0,"C.D.L.",0
16,"16048",432,339,337,8,2,"C.D.L.",0
16,"16129",112,79,74,0,5,"C.D.L.",0
16,"16016",258,178,178,1,0,"C.D.L.",0
46,"46239",457,331,323,2,8,"C.D.L.",1
30,"30034",1182,956,943,3,13,"C.D.L.",0
46,"46036",675,440,431,11,9,"C.D.L.",0
16,"16258",288,215,213,1,2,"C.D.L.",0
16,"16175",5058,4363,4295,70,68,"C.D.L.",3
46,"46139",4594,3794,3734,28,60,"C.D.L.",1
16,"16133",4466,3522,3453,51,69,"C.D.L.",6
16,"16010",184,135,133,1,2,"C.D.L.",0
16,"16152",42,38,37,3,1,"C.D.L.",0
16,"16012",102,81,80,0,1,"C.D.L.",0
16,"16266",402,334,325,4,9,"C.D.L.",0
46,"46250",574266,435877,431619,4626,4258,"C.D.L.",372
46,"46164",11634,8843,8724,90,119,"C.D.L.",8
46,"46029",20887,16124,15988,144,136,"C.D.L.",15
16,"16172",413,330,318,1,12,"C.D.L.",0
16,"16279",251,175,172,1,3,"C.D.L.",1
46,"46129",553,430,423,4,7,"C.D.L.",0
46,"46261",1706,1388,1366,13,22,"C.D.L.",1
46,"46226",34,34,33,0,1,"C.D.L.",0
46,"46064",547,463,458,2,5,"C.D.L.",0
16,"16165",84,70,70,0,0,"C.D.L.",0
16,"16190",5151,4229,4144,52,85,"C.D.L.",4
46,"46092",304,206,201,1,5,"C.D.L.",0
16,"16151",66,56,56,0,0,"C.D.L.",0
16,"16020",20,15,15,0,0,"C.D.L.",0
16,"16122",259,195,190,2,5,"C.D.L.",0
46,"46243",149,120,117,0,3,"C.D.L.",1
46,"46157",3068,2523,2491,17,32,"C.D.L.",0
16,"16108",68,56,55,0,1,"C.D.L.",0
16,"16123",110,74,73,1,1,"C.D.L.",0
16,"16118",1454,1221,1211,19,10,"C.D.L.",2
46,"46238",13401,10371,10283,96,88,"C.D.L.",2
16,"16001",79,66,66,1,0,"C.D.L.",0
16,"16060",841,714,704,11,10,"C.D.L.",0
46,"46125",858,724,710,6,14,"C.D.L.",0
46,"46234",388,308,307,3,1,"C.D.L.",0
46,"46131",49087,37846,37477,422,369,"C.D.L.",28
46,"46247",1059,829,823,6,6,"C.D.L.",0
30,"30031",560,471,469,3,2,"C.D.L.",3
16,"16128",70,64,64,2,0,"C.D.L.",0
30,"30011",4687,3776,3726,20,50,"C.D.L.",26
16,"16031",62,34,32,4,2,"C.D.L.",0
46,"46074",2656,2071,2053,22,18,"C.D.L.",0
46,"46066",1264,1060,1050,5,10,"C.D.L.",0
46,"46017",32928,24879,24672,267,207,"C.D.L.",54
16,"16057",109,82,82,1,0,"C.D.L.",0
16,"16181",73,62,62,1,0,"C.D.L.",0
30,"30025",4780,3901,3874,18,27,"C.D.L.",17
46,"46244",57805,41885,41595,415,290,"C.D.L.",34
30,"30039",18615,14213,14068,134,145,"C.D.L.",46
30,"30022",16489,12207,12042,152,165,"C.D.L.",8
16,"16198",1451,1126,1105,21,21,"C.D.L.",32
46,"46126",5471,4454,4392,53,62,"C.D.L.",2
46,"46053",584,484,461,2,23,"C.D.L.",4
30,"30026",15165,10524,10369,80,155,"C.D.L.",9
46,"46191",1952,1554,1528,9,26,"C.D.L.",0
16,"16041",395,289,287,6,2,"C.D.L.",1
46,"46048",3484,2915,2875,26,40,"C.D.L.",0
30,"30035",17849,12871,12744,133,127,"C.D.L.",28
46,"46079",381,304,299,3,5,"C.D.L.",0
46,"46037",1146,1007,1003,5,4,"C.D.L.",2
46,"46241",440,336,314,4,22,"C.D.L.",0
16,"16264",505,440,438,6,2,"C.D.L.",0
46,"46003",988,864,847,13,17,"C.D.L.",0
16,"16246",520,417,407,1,10,"C.D.L.",0
16,"16212",286,229,226,3,3,"C.D.L.",0
46,"46178",4406,3235,3201,22,34,"C.D.L.",3
16,"16227",128,95,94,0,1,"C.D.L.",0
46,"46049",292,249,245,0,4,"C.D.L.",0
46,"46146",1718,1395,1374,10,21,"C.D.L.",0
46,"46251",2599,2215,2179,21,36,"C.D.L.",1
16,"16047",249,192,191,5,1,"C.D.L.",0
46,"46137",273,232,229,1,3,"C.D.L.",0
46,"46170",3464,2944,2908,24,36,"C.D.L.",4
16,"16146",96,74,70,0,4,"C.D.L.",0
16,"16213",39,32,32,1,0,"C.D.L.",0
16,"16045",226,177,176,2,1,"C.D.L.",0
16,"16005",275,215,215,2,0,"C.D.L.",0
46,"46152",96,70,70,0,0,"C.D.L.",0
16,"16036",143,117,115,1,2,"C.D.L.",0
46,"46123",1808,1440,1410,7,30,"C.D.L.",2
46,"46020",3793,3084,3046,21,38,"C.D.L.",2
46,"46117",476,377,373,6,4,"C.D.L.",0
16,"16236",964,762,758,10,4,"C.D.L.",0
46,"46176",1965,1423,1405,12,18,"C.D.L.",0
16,"16901",793,590,582,2,8,"C.D.L.",0
46,"46041",369,255,255,1,0,"C.D.L.",0
46,"46219",143,127,126,1,1,"C.D.L.",0
46,"46171",16753,12565,12399,122,166,"C.D.L.",9
16,"16121",270,211,207,1,4,"C.D.L.",0
16,"16211",462,317,313,2,4,"C.D.L.",0
16,"16089",386,310,308,10,2,"C.D.L.",0
46,"46032",5583,4342,4287,39,55,"C.D.L.",2
46,"46121",116,103,101,0,2,"C.D.L.",0
16,"16014",659,534,528,8,6,"C.D.L.",0
16,"16170",733,552,543,3,9,"C.D.L.",3
16,"16271",659,568,566,4,2,"C.D.L.",0
46,"46145",21751,16601,16397,155,204,"C.D.L.",17
16,"16098",586,480,474,10,6,"C.D.L.",0
16,"16163",75,57,57,0,0,"C.D.L.",0
30,"30002",9802,7628,7553,48,75,"C.D.L.",9
46,"46209",1984,1606,1594,11,12,"C.D.L.",0
46,"46225",360,319,310,5,9,"C.D.L.",0
30,"30037",17942,13830,13734,90,96,"C.D.L.",6
46,"46081",10254,8188,8101,52,87,"C.D.L.",1
46,"46068",326,292,285,3,7,"C.D.L.",0
16,"16269",494,412,407,5,5,"C.D.L.",0
46,"46122",2737,2154,2131,18,23,"C.D.L.",0
46,"46040",1227,1028,1021,13,7,"C.D.L.",3
46,"46181",17153,13332,13184,108,148,"C.D.L.",4
16,"16065",454,380,374,4,6,"C.D.L.",0
46,"46189",490,400,396,3,4,"C.D.L.",0
16,"16116",104,67,66,1,1,"C.D.L.",0
16,"16095",98,68,68,0,0,"C.D.L.",0
30,"30040",733,640,635,2,5,"C.D.L.",1
30,"30901",10113,8265,8194,70,71,"C.D.L.",7
16,"16125",1734,1367,1350,12,17,"C.D.L.",2
16,"16188",106,76,76,0,0,"C.D.L.",0
46,"46190",48324,34747,34424,431,323,"C.D.L.",92
16,"16008",131,89,88,2,1,"C.D.L.",0
16,"16202",908,753,744,10,9,"C.D.L.",0
16,"16159",299,204,202,5,2,"C.D.L.",0
46,"46054",11422,8666,8566,82,100,"C.D.L.",94
46,"46080",1090,860,849,2,11,"C.D.L.",0
16,"16275",15,12,12,0,0,"C.D.L.",0
46,"46052",532,471,463,2,8,"C.D.L.",0
46,"46197",1902,1559,1554,15,5,"C.D.L.",0
16,"16082",318,226,226,1,0,"C.D.L.",0
16,"16104",65,52,52,1,0,"C.D.L.",0
16,"16245",430,338,329,2,9,"C.D.L.",1
46,"46118",3883,3141,3105,28,36,"C.D.L.",1
46,"46045",1288,1065,1044,2,21,"C.D.L.",0
46,"46215",1451,1185,1169,8,16,"C.D.L.",0
46,"46207",6453,5086,5031,52,55,"C.D.L.",4
16,"16044",51,35,35,0,0,"C.D.L.",0
46,"46088",196,146,140,0,6,"C.D.L.",0
16,"16206",250,188,188,2,0,"C.D.L.",0
46,"46259",537,426,424,9,2,"C.D.L.",0
16,"16046",262,191,191,1,0,"C.D.L.",0
16,"16251",1903,1510,1493,18,17,"C.D.L.",2
16,"16242",367,315,313,4,2,"C.D.L.",0
46,"46173",1393,1156,1137,10,19,"C.D.L.",0
46,"46133",686,572,565,1,7,"C.D.L.",0
16,"16088",125,103,103,1,0,"C.D.L.",0
46,"46149",398,307,305,1,2,"C.D.L.",0
30,"30030",305669,236235,234391,2112,1844,"C.D.L.",304
46,"46025",2495,1962,1941,24,21,"C.D.L.",3
46,"46153",445,374,366,7,8,"C.D.L.",0
46,"46195",1975,1631,1631,33,0,"C.D.L.",1
46,"46106",1616,1196,1188,6,8,"C.D.L.",1
46,"46100",307,264,255,0,9,"C.D.L.",0
46,"46256",6734,4902,4858,33,44,"C.D.L.",2
16,"16072",161,126,123,0,3,"C.D.L.",1
46,"46027",997,869,855,4,14,"C.D.L.",1
16,"16004",325,247,246,0,1,"C.D.L.",0
46,"46185",422,360,359,7,1,"C.D.L.",0
16,"16274",147,125,125,1,0,"C.D.L.",0
16,"16273",328,277,275,2,2,"C.D.L.",0
16,"16177",86,68,68,0,0,"C.D.L.",0
16,"16113",3075,2363,2338,36,25,"C.D.L.",0
46,"46136",2476,1890,1865,16,25,"C.D.L.",0
16,"16908",227,181,179,1,2,"C.D.L.",0
16,"16006",133,117,116,2,1,"C.D.L.",0
16,"16130",633,504,492,5,12,"C.D.L.",0
46,"46249",9650,7288,7191,125,97,"C.D.L.",2
46,"46006",4643,3847,3785,32,62,"C.D.L.",2
46,"46242",361,288,280,4,8,"C.D.L.",0
30,"30033",9940,7794,7700,79,94,"C.D.L.",8
46,"46230",14204,10650,10515,112,135,"C.D.L.",10
46,"46222",378,321,310,1,11,"C.D.L.",1
30,"30003",23570,16482,16354,169,128,"C.D.L.",19
46,"46233",3911,3025,2988,10,37,"C.D.L.",7
16,"16100",764,660,655,3,5,"C.D.L.",35
16,"16195",545,436,433,6,3,"C.D.L.",1
16,"16132",36,31,31,0,0,"C.D.L.",0
16,"16061",1035,861,848,15,13,"C.D.L.",1
16,"16025",31,23,23,0,0,"C.D.L.",0
16,"16171",1930,1616,1584,25,32,"C.D.L.",1
16,"16011",39,30,30,0,0,"C.D.L.",0
16,"16218",207,170,169,4,1,"C.D.L.",0
46,"46127",2790,2298,2267,23,31,"C.D.L.",6
46,"46254",1085,847,834,12,13,"C.D.L.",1
46,"46063",1764,1441,1423,15,18,"C.D.L.",0
46,"46141",424,338,336,2,2,"C.D.L.",0
46,"46187",1339,1096,1083,13,13,"C.D.L.",2
16,"16087",229,193,187,4,6,"C.D.L.",0
46,"46103",1244,998,972,12,26,"C.D.L.",0
46,"46030",800,677,662,6,15,"C.D.L.",0
30,"30016",149046,103847,102890,1031,957,"C.D.L.",132
16,"16902",165,128,126,1,2,"C.D.L.",0
46,"46033",220,183,181,0,2,"C.D.L.",0
46,"46097",890,674,662,2,12,"C.D.L.",1
46,"46205",14277,10882,10764,115,118,"C.D.L.",8
16,"16051",166,140,140,1,0,"C.D.L.",0
46,"46035",6470,5115,5047,38,68,"C.D.L.",5
16,"16137",64,41,40,0,1,"C.D.L.",0
50,"50240",1127,799,783,25,16,"CHA-IU",55
50,"50249",333,280,272,2,8,"CHA-IU",12
50,"50082",108,73,72,0,1,"CHA-IU",3
50,"50251",8379,6225,6116,110,109,"CHA-IU",719
50,"50058",80,65,64,0,1,"CHA-IU",8
50,"50083",96,72,72,1,0,"CHA-IU",10
50,"50270",39,30,29,1,1,"CHA-IU",5
50,"50255",219,150,148,1,2,"CHA-IU",10
50,"50087",31,25,25,0,0,"CHA-IU",6
50,"50275",103,76,76,0,0,"CHA-IU",2
50,"50102",918,722,713,12,9,"CHA-IU",26
50,"50062",1750,1298,1275,22,23,"CHA-IU",133
50,"50206",499,386,384,10,2,"CHA-IU",28
50,"50202",182,125,122,2,3,"CHA-IU",0
50,"50192",240,188,184,9,4,"CHA-IU",15
50,"50059",790,593,586,12,7,"CHA-IU",32
50,"50256",90,59,59,1,0,"CHA-IU",5
50,"50105",343,263,259,2,4,"CHA-IU",13
50,"50222",1695,1117,1091,16,26,"CHA-IU",81
50,"50086",193,109,109,0,0,"CHA-IU",9
50,"50252",5345,3860,3792,79,68,"CHA-IU",245
50,"50248",552,421,407,5,14,"CHA-IU",28
50,"50115",3280,2234,2205,32,29,"CHA-IU",140
50,"50190",751,576,565,7,11,"CHA-IU",26
50,"50032",330,233,228,3,5,"CHA-IU",28
50,"50084",84,64,64,1,0,"CHA-IU",3
50,"50066",2357,1677,1659,42,18,"CHA-IU",141
50,"50104",379,306,303,4,3,"CHA-IU",17
50,"50281",76,63,63,2,0,"CHA-IU",8
50,"50273",36,22,22,0,0,"CHA-IU",2
50,"50243",346,277,272,2,5,"CHA-IU",4
50,"50259",89,53,53,1,0,"CHA-IU",0
50,"50063",76,67,67,0,0,"CHA-IU",0
50,"50108",50,31,31,0,0,"CHA-IU",4
50,"50167",235,191,184,1,7,"CHA-IU",14
50,"50291",112,75,73,0,2,"CHA-IU",3
50,"50209",2559,1685,1661,34,24,"CHA-IU",155
50,"50181",1053,787,760,9,27,"CHA-IU",90
50,"50026",459,360,354,5,6,"CHA-IU",20
50,"50179",269,230,229,2,1,"CHA-IU",9
50,"50018",973,761,755,12,6,"CHA-IU",23
50,"50271",283,209,207,4,2,"CHA-IU",11
50,"50250",58,43,43,4,0,"CHA-IU",6
50,"50144",36,32,32,0,0,"CHA-IU",6
50,"50244",215,155,155,6,0,"CHA-IU",6
50,"50072",181,128,127,1,1,"CHA-IU",6
50,"50099",3136,2333,2297,27,36,"CHA-IU",156
50,"50056",450,329,328,4,1,"CHA-IU",26
50,"50178",325,228,225,4,3,"CHA-IU",14
50,"50119",997,740,720,13,20,"CHA-IU",44
50,"50182",3704,2551,2515,44,36,"CHA-IU",273
50,"50064",469,377,373,5,4,"CHA-IU",23
50,"50174",107,92,90,0,2,"CHA-IU",2
50,"50006",978,758,749,16,9,"CHA-IU",70
50,"50292",138,117,115,4,2,"CHA-IU",7
50,"50284",176,131,130,1,1,"CHA-IU",6
50,"50147",845,637,627,12,10,"CHA-IU",61
50,"50150",716,430,427,10,3,"CHA-IU",30
50,"50010",77,65,64,5,1,"CHA-IU",1
50,"50231",285,231,224,7,7,"CHA-IU",23
50,"50267",648,450,441,8,9,"CHA-IU",50
50,"50061",228,191,183,3,8,"CHA-IU",3
50,"50223",956,751,745,14,6,"CHA-IU",33
50,"50020",868,646,629,5,17,"CHA-IU",89
50,"50173",175,104,104,2,0,"CHA-IU",8
50,"50241",634,462,455,2,7,"CHA-IU",27
50,"50117",131,101,100,1,1,"CHA-IU",7
50,"50186",44,30,29,0,1,"CHA-IU",5
50,"50065",59,37,37,2,0,"CHA-IU",6
50,"50253",461,381,375,3,6,"CHA-IU",13
50,"50002",166,130,130,2,0,"CHA-IU",4
50,"50005",245,199,195,1,4,"CHA-IU",8
50,"50293",492,339,338,6,1,"CHA-IU",31
50,"50208",1831,1321,1305,24,16,"CHA-IU",153
50,"50238",114,82,80,0,2,"CHA-IU",12
50,"50036",103,81,80,2,1,"CHA-IU",8
50,"50232",176,123,120,5,3,"CHA-IU",14
50,"50260",42,35,35,1,0,"CHA-IU",3
50,"50154",129,98,97,1,1,"CHA-IU",6
50,"50124",474,375,367,11,8,"CHA-IU",14
50,"50184",132,106,106,1,0,"CHA-IU",2
50,"50268",59,46,46,3,0,"CHA-IU",0
50,"50157",313,253,250,7,3,"CHA-IU",11
50,"50074",6516,4378,4222,77,156,"CHA-IU",423
50,"50235",2371,1723,1701,36,22,"CHA-IU",149
50,"50211",277,193,193,1,0,"CHA-IU",14
50,"50183",369,277,274,5,3,"CHA-IU",11
50,"50242",102,82,82,2,0,"CHA-IU",19
50,"50288",3252,2412,2380,50,32,"CHA-IU",203
50,"50153",1002,757,748,12,9,"CHA-IU",61
50,"50166",282,216,210,1,6,"CHA-IU",31
50,"50185",150,109,109,2,0,"CHA-IU",14
50,"50149",48,35,35,0,0,"CHA-IU",0
50,"50007",61,45,45,0,0,"CHA-IU",3
50,"50156",234,186,183,2,3,"CHA-IU",19
50,"50081",562,410,400,7,10,"CHA-IU",19
50,"50008",5110,3458,3406,56,52,"CHA-IU",522
50,"50067",14124,10049,9870,203,179,"CHA-IU",673
50,"50176",237,161,160,4,1,"CHA-IU",9
50,"50068",2082,1514,1481,18,33,"CHA-IU",89
50,"50096",49,35,35,0,0,"CHA-IU",1
50,"50237",103,76,75,0,1,"CHA-IU",4
50,"50227",105,79,79,2,0,"CHA-IU",8
50,"50290",436,334,331,4,3,"CHA-IU",14
50,"50205",98,72,71,2,1,"CHA-IU",6
50,"50234",251,201,191,13,10,"CHA-IU",9
50,"50093",113,84,84,2,0,"CHA-IU",4
50,"50118",2312,1737,1718,22,19,"CHA-IU",223
50,"50264",184,140,134,0,6,"CHA-IU",11
50,"50148",365,256,251,2,5,"CHA-IU",17
50,"50021",42,34,33,1,1,"CHA-IU",2
50,"50272",12481,8744,8642,176,102,"CHA-IU",1149
50,"50159",728,554,544,4,10,"CHA-IU",18
50,"50069",68,32,32,0,0,"CHA-IU",1
50,"50129",258,164,164,0,0,"CHA-IU",10
50,"50040",98,77,76,2,1,"CHA-IU",4
50,"50175",1088,742,732,10,10,"CHA-IU",67
50,"50037",140,110,103,3,7,"CHA-IU",6
50,"50088",337,273,264,4,9,"CHA-IU",11
50,"50085",205,143,143,3,0,"CHA-IU",10
50,"50030",232,164,160,1,4,"CHA-IU",22
50,"50003",141,108,108,3,0,"CHA-IU",7
50,"50116",220,154,153,0,1,"CHA-IU",9
50,"50172",187,140,138,4,2,"CHA-IU",5
50,"50160",2397,1905,1865,19,40,"CHA-IU",98
50,"50012",105,93,90,0,3,"CHA-IU",6
50,"50263",235,160,160,1,0,"CHA-IU",8
50,"50194",102,67,67,2,0,"CHA-IU",1
50,"50245",121,80,80,1,0,"CHA-IU",7
50,"50130",415,288,288,7,0,"CHA-IU",23
50,"50213",117,83,82,0,1,"CHA-IU",2
50,"50028",120,86,85,2,1,"CHA-IU",9
50,"50207",126,97,95,1,2,"CHA-IU",7
50,"50254",179,136,136,0,0,"CHA-IU",8
50,"50236",124,103,103,2,0,"CHA-IU",1
50,"50070",70,42,41,0,1,"CHA-IU",1
50,"50246",48,33,33,1,0,"CHA-IU",0
50,"50100",355,273,266,3,7,"CHA-IU",17
50,"50126",2473,1747,1724,41,23,"CHA-IU",109
50,"50089",6673,4936,4877,120,59,"CHA-IU",448
50,"50289",71,59,59,0,0,"CHA-IU",7
50,"50230",1295,914,903,13,11,"CHA-IU",44
50,"50180",111,91,89,3,2,"CHA-IU",14
50,"50189",776,588,576,9,12,"CHA-IU",34
50,"50274",78,45,45,1,0,"CHA-IU",2
50,"50262",1216,916,904,20,12,"CHA-IU",147
50,"50121",297,250,245,6,5,"CHA-IU",14
50,"50033",81,64,64,0,0,"CHA-IU",6
50,"50151",713,536,531,5,5,"CHA-IU",27
50,"50024",652,541,531,8,10,"CHA-IU",33
50,"50014",169,108,108,1,0,"CHA-IU",18
50,"50247",794,572,567,7,5,"CHA-IU",42
50,"50218",113,92,92,0,0,"CHA-IU",10
50,"50090",165,117,117,1,0,"CHA-IU",4
50,"50266",139,95,94,1,1,"CHA-IU",5
50,"50101",922,648,637,8,11,"CHA-IU",58
50,"50132",697,544,536,11,8,"CHA-IU",38
50,"50091",56,39,39,1,0,"CHA-IU",1
50,"50152",1569,1151,1135,31,16,"CHA-IU",37
50,"50043",258,170,166,2,4,"CHA-IU",11
50,"50155",119,91,91,1,0,"CHA-IU",1
50,"50057",1468,1022,1004,17,18,"CHA-IU",80
50,"50187",72,45,45,1,0,"CHA-IU",5
50,"50215",21,20,19,0,1,"CHA-IU",4
50,"50203",1083,814,798,28,16,"CHA-IU",91
50,"50257",195,154,154,0,0,"CHA-IU",21
50,"50122",68,47,45,2,2,"CHA-IU",2
50,"50013",244,195,195,1,0,"CHA-IU",13
50,"50239",65,44,44,0,0,"CHA-IU",0
50,"50163",3427,2448,2413,62,35,"CHA-IU",323
50,"50219",3704,2672,2625,39,47,"CHA-IU",301
50,"50133",126,101,100,1,1,"CHA-IU",5
50,"50216",267,201,194,8,7,"CHA-IU",8
50,"50092",329,273,272,0,1,"CHA-IU",7
50,"50210",39,28,24,0,4,"CHA-IU",2
50,"50035",78,61,56,2,5,"CHA-IU",27
50,"50077",254,189,188,4,1,"CHA-IU",9
50,"50161",124,86,86,1,0,"CHA-IU",2
50,"50123",428,335,332,9,3,"CHA-IU",28
50,"50110",424,315,314,6,1,"CHA-IU",11
50,"50204",2519,1823,1804,24,19,"CHA-IU",145
50,"50017",1734,1232,1212,41,20,"CHA-IU",162
50,"50045",1289,1011,992,14,19,"CHA-IU",55
50,"50164",407,271,268,4,3,"CHA-IU",29
50,"50220",59,43,43,1,0,"CHA-IU",2
50,"50277",82,63,63,0,0,"CHA-IU",13
50,"50287",298,214,211,10,3,"CHA-IU",23
50,"50027",260,209,202,2,7,"CHA-IU",25
50,"50296",417,313,310,6,3,"CHA-IU",25
50,"50278",207,152,149,4,3,"CHA-IU",3
50,"50135",100,76,75,2,1,"CHA-IU",9
50,"50165",1880,1339,1274,49,65,"CHA-IU",103
50,"50193",635,483,465,3,18,"CHA-IU",62
50,"50221",38,20,20,0,0,"CHA-IU",1
50,"50046",201,155,153,2,2,"CHA-IU",9
50,"50075",89,74,74,1,0,"CHA-IU",0
50,"50269",316,186,185,1,1,"CHA-IU",0
50,"50015",109,73,73,0,0,"CHA-IU",2
50,"50276",148,116,114,3,2,"CHA-IU",11
50,"50094",1744,1220,1193,25,27,"CHA-IU",81
50,"50294",77,58,57,0,1,"CHA-IU",4
50,"50279",111,79,79,1,0,"CHA-IU",6
50,"50009",122,93,93,0,0,"CHA-IU",7
50,"50095",12558,9029,8910,179,119,"CHA-IU",930
50,"50136",617,469,462,4,7,"CHA-IU",13
50,"50019",79,57,55,1,2,"CHA-IU",2
50,"50076",113,89,89,0,0,"CHA-IU",5
50,"50047",60,34,34,2,0,"CHA-IU",5
50,"50106",137,107,106,0,1,"CHA-IU",4
50,"50233",120,89,88,2,1,"CHA-IU",3
50,"50261",246,199,199,4,0,"CHA-IU",17
50,"50038",1583,1194,1174,29,20,"CHA-IU",100
50,"50137",1119,842,834,12,8,"CHA-IU",37
50,"50001",130,96,96,0,0,"CHA-IU",2
50,"50048",43,33,33,1,0,"CHA-IU",2
50,"50280",370,296,291,5,5,"CHA-IU",39
50,"50265",63,46,46,1,0,"CHA-IU",6
50,"50039",580,450,446,3,4,"CHA-IU",47
50,"50107",953,785,780,13,5,"CHA-IU",65
50,"50029",676,527,517,6,10,"CHA-IU",26
50,"50177",355,268,265,4,3,"CHA-IU",12
50,"50195",48,38,38,1,0,"CHA-IU",2
50,"50214",31,22,21,1,1,"CHA-IU",1
50,"50011",131,113,113,8,0,"CHA-IU",8
50,"50138",49,43,43,2,0,"CHA-IU",5
50,"50050",109,73,73,1,0,"CHA-IU",6
50,"50098",215,150,146,2,4,"CHA-IU",14
50,"50078",278,210,208,2,2,"CHA-IU",13
50,"50297",495260,360632,355561,7046,5071,"CHA-IU",45062
50,"50224",70,52,49,2,3,"CHA-IU",8
50,"50196",110,87,86,4,1,"CHA-IU",4
50,"50060",187,138,136,1,2,"CHA-IU",13
50,"50168",34,26,26,1,0,"CHA-IU",3
50,"50031",167,105,103,0,2,"CHA-IU",9
50,"50125",421,284,280,1,4,"CHA-IU",17
50,"50212",52,48,48,0,0,"CHA-IU",0
50,"50079",281,213,210,2,3,"CHA-IU",11
50,"50146",211,168,167,4,1,"CHA-IU",5
50,"50139",372,280,278,3,2,"CHA-IU",17
50,"50225",1638,1079,1062,7,17,"CHA-IU",87
50,"50188",34,28,27,0,1,"CHA-IU",0
50,"50298",5319,4023,3955,72,68,"CHA-IU",258
50,"50022",548,430,416,10,14,"CHA-IU",18
50,"50282",88,66,63,3,3,"CHA-IU",2
50,"50197",89,65,65,3,0,"CHA-IU",1
50,"50041",21,13,13,0,0,"CHA-IU",0
50,"50169",371,275,274,5,1,"CHA-IU",19
50,"50051",886,677,671,9,6,"CHA-IU",24
50,"50080",41,31,31,1,0,"CHA-IU",8
50,"50140",172,108,108,1,0,"CHA-IU",12
50,"50004",613,445,441,6,4,"CHA-IU",57
50,"50052",100,82,82,0,0,"CHA-IU",1
50,"50131",243,185,183,6,2,"CHA-IU",7
50,"50128",36,30,29,0,1,"CHA-IU",5
50,"50198",46,36,36,2,0,"CHA-IU",4
50,"50283",73,55,55,1,0,"CHA-IU",0
50,"50023",240,180,180,4,0,"CHA-IU",4
50,"50901",170,122,121,1,1,"CHA-IU",17
50,"50170",411,316,313,2,3,"CHA-IU",26
50,"50042",16,14,14,0,0,"CHA-IU",1
50,"50217",496,380,379,0,1,"CHA-IU",8
50,"50071",134,97,96,0,1,"CHA-IU",2
50,"50141",116,98,98,1,0,"CHA-IU",6
50,"50053",756,570,563,14,7,"CHA-IU",24
50,"50111",191,141,138,2,3,"CHA-IU",6
50,"50902",97,85,85,1,0,"CHA-IU",7
50,"50162",160,108,108,2,0,"CHA-IU",5
50,"50228",295,238,236,10,2,"CHA-IU",7
50,"50199",380,263,254,2,9,"CHA-IU",28
50,"50171",126,90,89,4,1,"CHA-IU",1
50,"50903",2234,1622,1597,35,25,"CHA-IU",219
50,"50034",923,634,617,10,17,"CHA-IU",32
50,"50113",653,528,526,9,2,"CHA-IU",66
50,"50229",62,47,46,2,1,"CHA-IU",3
50,"50109",101,79,79,2,0,"CHA-IU",9
50,"50191",505,395,390,4,5,"CHA-IU",31
50,"50142",45,25,24,0,1,"CHA-IU",11
50,"50054",63,46,46,0,0,"CHA-IU",8
50,"50295",54,42,41,0,1,"CHA-IU",2
50,"50025",4569,3319,3271,68,48,"CHA-IU",294
50,"50285",635,452,445,8,7,"CHA-IU",37
50,"50200",534,436,432,9,4,"CHA-IU",38
50,"50055",3592,2520,2473,59,47,"CHA-IU",224
50,"50073",2265,1773,1756,20,17,"CHA-IU",155
50,"50016",51,30,30,1,0,"CHA-IU",5
50,"50044",259,175,175,0,0,"CHA-IU",28
50,"50201",466,366,363,7,3,"CHA-IU",11
50,"50120",53,41,41,0,0,"CHA-IU",2
50,"50286",90,73,73,2,0,"CHA-IU",7
50,"50114",157,120,120,1,0,"CHA-IU",10
50,"50134",134,102,101,3,1,"CHA-IU",3
50,"50143",608,427,424,5,3,"CHA-IU",93
50,"50258",54,37,37,0,0,"CHA-IU",2
22,"22110",822,602,588,3,14,"CHA-IU",66
44,"44157",62,45,44,0,1,"CHA-IU",2
22,"22167",515,417,399,16,18,"CHA-IU",21
22,"22141",129,103,102,3,1,"CHA-IU",6
44,"44056",577,436,434,7,2,"CHA-IU",25
44,"44168",194,154,152,4,2,"CHA-IU",6
44,"44062",38,34,34,0,0,"CHA-IU",0
44,"44225",129,100,98,5,2,"CHA-IU",4
44,"44189",69,57,57,0,0,"CHA-IU",3
44,"44230",154,127,127,3,0,"CHA-IU",10
22,"22111",180,126,125,3,1,"CHA-IU",5
44,"44243",38,27,26,3,1,"CHA-IU",1
44,"44268",30,25,25,0,0,"CHA-IU",1
44,"44037",483,349,344,10,5,"CHA-IU",24
44,"44084",63,51,50,0,1,"CHA-IU",1
44,"44102",30,29,28,0,1,"CHA-IU",3
44,"44238",2475,1718,1692,50,26,"CHA-IU",81
44,"44198",205,160,160,5,0,"CHA-IU",7
22,"22182",271,160,150,4,10,"CHA-IU",21
22,"22173",247,150,150,3,0,"CHA-IU",12
44,"44137",215,165,163,5,2,"CHA-IU",11
44,"44265",203,169,158,6,11,"CHA-IU",2
44,"44210",754,573,567,3,6,"CHA-IU",46
44,"44014",2603,1965,1912,25,53,"CHA-IU",244
22,"22076",331,241,235,3,6,"CHA-IU",22
22,"22067",82,54,49,3,5,"CHA-IU",6
22,"22057",377,283,278,3,5,"CHA-IU",27
44,"44053",111,77,76,2,1,"CHA-IU",4
22,"22003",148,117,116,2,1,"CHA-IU",14
44,"44262",141,114,113,2,1,"CHA-IU",6
22,"22086",207,149,147,1,2,"CHA-IU",22
44,"44005",59,43,43,1,0,"CHA-IU",0
22,"22127",483,357,353,9,4,"CHA-IU",37
44,"44145",1078,723,714,26,9,"CHA-IU",40
22,"22103",697,532,523,10,9,"CHA-IU",48
22,"22083",522,437,428,4,9,"CHA-IU",36
44,"44121",63,48,48,1,0,"CHA-IU",2
44,"44052",96,60,59,2,1,"CHA-IU",1
44,"44217",37,28,27,0,1,"CHA-IU",3
44,"44031",124,72,72,0,0,"CHA-IU",1
22,"22206",218,169,167,3,2,"CHA-IU",9
22,"22126",100,81,80,2,1,"CHA-IU",0
44,"44163",119,91,91,0,0,"CHA-IU",5
44,"44181",82,63,63,3,0,"CHA-IU",4
22,"22199",7259,4980,4861,128,119,"CHA-IU",520
44,"44002",62,47,47,1,0,"CHA-IU",4
44,"44244",93,56,56,5,0,"CHA-IU",4
44,"44126",344,250,236,1,14,"CHA-IU",17
22,"22081",268,197,196,4,1,"CHA-IU",14
22,"22087",85,56,55,4,1,"CHA-IU",0
22,"22079",126,97,97,4,0,"CHA-IU",4
44,"44063",82,55,55,2,0,"CHA-IU",7
44,"44086",485,380,371,5,9,"CHA-IU",21
44,"44115",121,100,100,0,0,"CHA-IU",7
22,"22002",107,85,84,3,1,"CHA-IU",4
22,"22062",189,126,125,2,1,"CHA-IU",11
22,"22909",349,259,252,3,7,"CHA-IU",8
22,"22164",46,32,32,0,0,"CHA-IU",1
44,"44021",114,81,77,1,4,"CHA-IU",6
22,"22106",25,17,17,0,0,"CHA-IU",1
44,"44246",1591,1030,997,15,33,"CHA-IU",108
44,"44205",757,541,527,12,14,"CHA-IU",22
44,"44038",112,94,92,3,2,"CHA-IU",8
22,"22163",431,353,344,5,9,"CHA-IU",23
22,"22072",209,130,128,2,2,"CHA-IU",16
44,"44257",184,132,131,6,1,"CHA-IU",3
22,"22176",173,154,149,2,5,"CHA-IU",8
44,"44061",89,55,55,1,0,"CHA-IU",1
44,"44156",57,40,38,1,2,"CHA-IU",5
22,"22155",89,67,67,2,0,"CHA-IU",3
22,"22253",71,54,54,1,0,"CHA-IU",4
22,"22107",131,81,77,1,4,"CHA-IU",18
44,"44252",78,63,60,0,3,"CHA-IU",0
22,"22133",123,87,85,2,2,"CHA-IU",5
22,"22232",98,78,75,0,3,"CHA-IU",9
22,"22017",917,677,661,8,16,"CHA-IU",45
22,"22142",114,91,91,2,0,"CHA-IU",9
44,"44094",116,105,103,4,2,"CHA-IU",1
44,"44043",126,94,94,7,0,"CHA-IU",10
22,"22149",321,244,241,5,3,"CHA-IU",19
44,"44195",103,71,70,0,1,"CHA-IU",3
22,"22109",243,178,178,2,0,"CHA-IU",15
44,"44208",32,23,23,1,0,"CHA-IU",0
22,"22016",654,476,464,10,12,"CHA-IU",24
22,"22113",512,357,353,8,4,"CHA-IU",27
44,"44023",13,11,11,0,0,"CHA-IU",1
22,"22200",271,198,191,3,7,"CHA-IU",11
22,"22189",199,140,138,5,2,"CHA-IU",17
44,"44067",132,89,89,0,0,"CHA-IU",16
22,"22028",424,311,310,3,1,"CHA-IU",23
22,"22904",908,660,653,14,7,"CHA-IU",50
22,"22095",87,61,61,1,0,"CHA-IU",3
44,"44132",64,57,56,0,1,"CHA-IU",1
44,"44108",352,228,225,8,3,"CHA-IU",12
44,"44007",194,152,145,3,7,"CHA-IU",2
44,"44263",332,249,243,10,6,"CHA-IU",21
22,"22078",468,302,301,8,1,"CHA-IU",46
44,"44183",78,49,46,0,3,"CHA-IU",2
44,"44128",84,56,56,3,0,"CHA-IU",3
44,"44082",90,67,66,1,1,"CHA-IU",2
22,"22195",231,193,189,6,4,"CHA-IU",19
22,"22008",194,168,167,11,1,"CHA-IU",12
22,"22203",92,79,79,0,0,"CHA-IU",2
44,"44174",435,310,309,3,1,"CHA-IU",12
22,"22027",351,251,250,8,1,"CHA-IU",9
44,"44228",121,97,96,2,1,"CHA-IU",0
22,"22011",102,78,78,3,0,"CHA-IU",1
22,"22049",88,70,69,5,1,"CHA-IU",2
44,"44048",77,59,59,0,0,"CHA-IU",1
22,"22177",101,79,75,1,4,"CHA-IU",6
44,"44184",34,21,21,2,0,"CHA-IU",0
44,"44085",61,38,38,0,0,"CHA-IU",1
44,"44133",21,16,16,0,0,"CHA-IU",0
22,"22227",225,172,168,3,4,"CHA-IU",7
22,"22236",266,213,213,3,0,"CHA-IU",9
22,"22029",130,99,98,6,1,"CHA-IU",1
44,"44207",187,147,146,5,1,"CHA-IU",5
44,"44047",267,162,160,4,2,"CHA-IU",21
22,"22168",22,16,16,0,0,"CHA-IU",0
44,"44080",294,216,211,3,5,"CHA-IU",10
44,"44247",335,251,243,10,8,"CHA-IU",16
44,"44150",30,30,30,0,0,"CHA-IU",1
44,"44123",117,79,78,2,1,"CHA-IU",3
44,"44141",147,99,95,0,4,"CHA-IU",1
22,"22903",672,555,547,6,8,"CHA-IU",29
22,"22064",184,139,137,3,2,"CHA-IU",6
44,"44016",541,384,379,5,5,"CHA-IU",17
22,"22218",49,33,33,1,0,"CHA-IU",3
44,"44100",200,147,146,0,1,"CHA-IU",16
22,"22024",222,144,139,3,5,"CHA-IU",12
44,"44167",41,31,31,1,0,"CHA-IU",2
22,"22105",132,104,102,2,2,"CHA-IU",6
22,"22175",211,158,158,9,0,"CHA-IU",12
44,"44131",26,20,20,0,0,"CHA-IU",3
44,"44197",60,37,37,1,0,"CHA-IU",4
22,"22022",582,448,438,12,10,"CHA-IU",31
22,"22170",622,439,430,13,9,"CHA-IU",42
44,"44075",329,250,240,4,10,"CHA-IU",10
22,"22226",823,640,627,11,13,"CHA-IU",49
22,"22193",318,266,264,7,2,"CHA-IU",18
22,"22209",161,115,115,4,0,"CHA-IU",12
22,"22197",504,395,390,7,5,"CHA-IU",30
22,"22901",792,515,508,13,7,"CHA-IU",70
44,"44175",138,111,111,4,0,"CHA-IU",9
22,"22165",515,409,403,9,6,"CHA-IU",17
44,"44112",473,353,350,4,3,"CHA-IU",28
44,"44109",123,86,84,2,2,"CHA-IU",1
22,"22116",1571,1127,1114,37,13,"CHA-IU",61
44,"44171",186,127,124,3,3,"CHA-IU",27
22,"22023",474,382,380,4,2,"CHA-IU",11
22,"22907",1444,1034,1018,12,16,"CHA-IU",129
22,"22019",190,141,138,4,3,"CHA-IU",10
22,"22202",146,120,120,1,0,"CHA-IU",4
22,"22012",93,74,74,5,0,"CHA-IU",5
44,"44159",47,43,43,0,0,"CHA-IU",3
22,"22217",406,314,309,4,5,"CHA-IU",9
22,"22124",229,171,170,2,1,"CHA-IU",7
22,"22228",501,382,369,15,13,"CHA-IU",26
44,"44199",52,40,39,0,1,"CHA-IU",3
22,"22249",110,83,81,0,2,"CHA-IU",10
44,"44212",45,35,35,0,0,"CHA-IU",3
22,"22037",115,87,79,0,8,"CHA-IU",14
44,"44040",206,167,166,5,1,"CHA-IU",13
44,"44204",24,21,21,0,0,"CHA-IU",3
44,"44194",128,92,89,1,3,"CHA-IU",4
44,"44142",39,28,28,1,0,"CHA-IU",4
22,"22129",193,124,123,4,1,"CHA-IU",4
22,"22102",194,152,149,4,3,"CHA-IU",10
22,"22144",258,203,203,5,0,"CHA-IU",18
44,"44260",160,117,115,5,2,"CHA-IU",8
44,"44046",58,44,44,1,0,"CHA-IU",1
44,"44042",139,87,87,0,0,"CHA-IU",5
22,"22114",137,94,94,4,0,"CHA-IU",3
44,"44169",403,285,278,0,7,"CHA-IU",9
44,"44200",41,30,30,0,0,"CHA-IU",2
44,"44227",81,59,59,0,0,"CHA-IU",0
44,"44147",439,320,314,14,6,"CHA-IU",15
22,"22143",244,166,161,2,5,"CHA-IU",4
44,"44218",37,26,26,2,0,"CHA-IU",0
44,"44012",389,297,293,5,4,"CHA-IU",12
22,"22052",997,776,769,15,7,"CHA-IU",36
22,"22099",532,411,408,6,3,"CHA-IU",20
22,"22074",311,227,219,5,8,"CHA-IU",21
44,"44125",78,57,57,1,0,"CHA-IU",3
44,"44258",75,56,55,0,1,"CHA-IU",1
44,"44176",167,131,130,5,1,"CHA-IU",7
44,"44138",158,109,106,0,3,"CHA-IU",7
22,"22201",287,203,198,2,5,"CHA-IU",12
22,"22244",61,46,44,1,2,"CHA-IU",0
22,"22139",86,66,63,2,3,"CHA-IU",5
44,"44251",271,218,218,5,0,"CHA-IU",1
44,"44161",487,363,358,9,5,"CHA-IU",22
44,"44036",27,17,17,0,0,"CHA-IU",1
44,"44149",106,79,78,2,1,"CHA-IU",10
22,"22001",242,177,173,2,4,"CHA-IU",8
44,"44120",217,126,121,5,5,"CHA-IU",15
44,"44001",69,48,47,0,1,"CHA-IU",5
44,"44101",60,47,47,1,0,"CHA-IU",5
22,"22233",94,69,69,0,0,"CHA-IU",0
44,"44130",38,27,27,0,0,"CHA-IU",2
44,"44110",57,45,45,0,0,"CHA-IU",5
22,"22047",228,200,200,5,0,"CHA-IU",15
44,"44261",777,600,594,8,6,"CHA-IU",37
22,"22051",108,86,84,2,2,"CHA-IU",6
44,"44096",173,139,133,4,6,"CHA-IU",13
22,"22080",288,217,217,4,0,"CHA-IU",4
22,"22063",184,142,140,2,2,"CHA-IU",36
44,"44049",886,652,627,6,25,"CHA-IU",31
44,"44144",326,233,227,7,6,"CHA-IU",4
22,"22157",251,176,175,9,1,"CHA-IU",15
44,"44215",156,100,100,2,0,"CHA-IU",7
44,"44240",168,135,132,2,3,"CHA-IU",6
44,"44093",86,64,64,3,0,"CHA-IU",16
44,"44092",89,68,68,0,0,"CHA-IU",5
22,"22151",97,71,71,0,0,"CHA-IU",2
44,"44060",42,34,34,0,0,"CHA-IU",4
22,"22036",101,82,82,1,0,"CHA-IU",6
44,"44068",690,544,528,6,16,"CHA-IU",27
22,"22009",704,488,473,15,15,"CHA-IU",48
22,"22053",867,567,554,13,13,"CHA-IU",44
22,"22048",12485,9146,9028,237,118,"CHA-IU",644
22,"22014",265,192,191,1,1,"CHA-IU",8
44,"44216",25877,18461,18057,467,404,"CHA-IU",1559
22,"22137",1164,850,839,14,11,"CHA-IU",54
44,"44203",8,8,8,0,0,"CHA-IU",0
22,"22215",137,90,90,1,0,"CHA-IU",10
22,"22158",11978,8404,8279,149,125,"CHA-IU",818
44,"44071",657,453,448,9,5,"CHA-IU",20
22,"22248",119,94,92,3,2,"CHA-IU",3
44,"44013",11286,7797,7584,242,213,"CHA-IU",629
44,"44211",39,32,32,2,0,"CHA-IU",1
44,"44221",377,305,297,6,8,"CHA-IU",13
22,"22184",203,172,167,2,5,"CHA-IU",9
44,"44180",71,52,52,1,0,"CHA-IU",1
44,"44089",57,50,49,0,1,"CHA-IU",3
22,"22045",104,83,80,2,3,"CHA-IU",4
44,"44241",575,442,427,4,15,"CHA-IU",23
44,"44190",81,52,52,0,0,"CHA-IU",5
22,"22075",150,103,101,7,2,"CHA-IU",3
22,"22186",217,173,173,3,0,"CHA-IU",9
44,"44027",168,140,140,2,0,"CHA-IU",6
22,"22050",100,84,83,0,1,"CHA-IU",2
22,"22094",109,76,74,5,2,"CHA-IU",5
22,"22223",92,65,64,3,1,"CHA-IU",4
44,"44234",76,63,63,0,0,"CHA-IU",3
44,"44191",806,602,594,6,8,"CHA-IU",119
22,"22060",1180,909,891,13,18,"CHA-IU",50
22,"22039",920,721,710,12,11,"CHA-IU",81
44,"44164",32,25,25,0,0,"CHA-IU",2
44,"44064",93,63,62,0,1,"CHA-IU",3
44,"44119",119,84,84,2,0,"CHA-IU",10
44,"44003",19,19,19,0,0,"CHA-IU",1
22,"22908",231,167,162,2,5,"CHA-IU",26
44,"44222",136,99,99,2,0,"CHA-IU",5
22,"22243",45,27,27,1,0,"CHA-IU",0
44,"44182",216,173,173,4,0,"CHA-IU",4
22,"22251",391,288,278,4,10,"CHA-IU",12
44,"44099",724,519,511,4,8,"CHA-IU",87
22,"22230",302,234,231,11,3,"CHA-IU",24
22,"22085",119,97,94,0,3,"CHA-IU",11
44,"44219",207,159,157,1,2,"CHA-IU",4
44,"44235",103,71,68,0,3,"CHA-IU",8
44,"44160",473,315,312,8,3,"CHA-IU",13
44,"44076",2338,1839,1797,36,42,"CHA-IU",82
22,"22090",115,82,82,5,0,"CHA-IU",7
44,"44165",182,140,140,1,0,"CHA-IU",13
44,"44113",79,57,55,0,2,"CHA-IU",16
22,"22018",357,272,271,4,1,"CHA-IU",20
44,"44070",62,47,47,1,0,"CHA-IU",0
44,"44237",450,352,343,5,9,"CHA-IU",10
22,"22112",9618,6642,6533,205,109,"CHA-IU",338
22,"22172",613,463,452,6,11,"CHA-IU",81
22,"22222",510,367,365,6,2,"CHA-IU",29
22,"22068",79,51,51,2,0,"CHA-IU",5
22,"22902",240,169,169,3,0,"CHA-IU",16
44,"44105",82,63,63,2,0,"CHA-IU",6
44,"44035",122,99,98,3,1,"CHA-IU",4
44,"44041",67,56,51,1,5,"CHA-IU",9
22,"22160",219,166,166,5,0,"CHA-IU",13
22,"22046",784,618,599,15,19,"CHA-IU",35
22,"22117",2585,1880,1848,57,32,"CHA-IU",122
22,"22135",200,152,147,5,5,"CHA-IU",10
44,"44158",1159,904,873,15,31,"CHA-IU",71
44,"44135",149,110,109,1,1,"CHA-IU",1
44,"44044",103,79,78,0,1,"CHA-IU",5
22,"22088",171,133,128,5,5,"CHA-IU",17
22,"22174",520,401,394,11,7,"CHA-IU",10
44,"44019",75,38,37,0,1,"CHA-IU",0
22,"22220",192,138,136,5,2,"CHA-IU",4
44,"44250",20,11,11,1,0,"CHA-IU",0
44,"44224",26,15,15,0,0,"CHA-IU",0
44,"44020",23,15,15,0,0,"CHA-IU",0
22,"22225",2784,1839,1805,42,34,"CHA-IU",123
44,"44213",60,48,48,0,0,"CHA-IU",1
22,"22021",2080,1524,1505,31,19,"CHA-IU",113
22,"22136",908,671,662,11,9,"CHA-IU",35
22,"22254",1175,868,856,14,12,"CHA-IU",15
44,"44236",77,48,47,0,1,"CHA-IU",2
44,"44029",637,495,490,6,5,"CHA-IU",48
22,"22181",91,57,55,0,2,"CHA-IU",9
44,"44179",369,245,243,6,2,"CHA-IU",25
22,"22905",312,249,247,4,2,"CHA-IU",9
22,"22246",93,63,62,0,1,"CHA-IU",12
44,"44232",408,301,295,5,6,"CHA-IU",16
44,"44008",1695,1280,1257,11,23,"CHA-IU",91
22,"22122",62,57,57,3,0,"CHA-IU",5
44,"44172",345,257,251,3,6,"CHA-IU",8
22,"22252",130,98,96,5,2,"CHA-IU",11
44,"44152",62,50,50,3,0,"CHA-IU",3
44,"44148",98,77,77,3,0,"CHA-IU",7
44,"44004",450,334,332,2,2,"CHA-IU",19
44,"44051",2783,2144,2089,38,55,"CHA-IU",89
22,"22015",336,237,235,11,2,"CHA-IU",17
22,"22162",135,107,107,3,0,"CHA-IU",6
22,"22212",93,79,79,0,0,"CHA-IU",27
44,"44022",550,387,380,6,7,"CHA-IU",31
44,"44239",29,25,25,1,0,"CHA-IU",0
44,"44033",307,222,221,5,1,"CHA-IU",9
44,"44245",274,189,184,1,5,"CHA-IU",1
44,"44177",120,85,85,1,0,"CHA-IU",14
22,"22213",3152,2265,2230,62,35,"CHA-IU",183
44,"44229",150,108,107,5,1,"CHA-IU",13
22,"22178",107,92,92,1,0,"CHA-IU",1
44,"44066",121,88,86,0,2,"CHA-IU",3
22,"22059",1149,792,764,23,28,"CHA-IU",65
22,"22054",1602,1040,982,42,58,"CHA-IU",116
22,"22204",1122,773,756,19,17,"CHA-IU",71
44,"44196",152,116,114,2,2,"CHA-IU",4
22,"22020",110,81,79,3,2,"CHA-IU",3
22,"22229",127,93,89,4,4,"CHA-IU",7
44,"44025",6168,4326,4150,68,176,"CHA-IU",726
22,"22188",100,68,66,3,2,"CHA-IU",4
44,"44034",150,117,117,1,0,"CHA-IU",5
22,"22214",131,101,100,2,1,"CHA-IU",1
22,"22119",1433,994,981,14,13,"CHA-IU",59
44,"44116",96,68,65,3,3,"CHA-IU",6
22,"22234",818,609,605,12,4,"CHA-IU",7
22,"22150",491,342,336,9,6,"CHA-IU",22
44,"44231",54,38,36,2,2,"CHA-IU",7
22,"22906",190,152,147,3,5,"CHA-IU",32
44,"44026",89,69,69,0,0,"CHA-IU",3
44,"44206",156,119,117,3,2,"CHA-IU",8
22,"22006",319,203,197,5,6,"CHA-IU",34
22,"22156",256,209,203,5,6,"CHA-IU",18
22,"22125",38140,26924,26463,676,461,"CHA-IU",2573
22,"22235",101,88,87,1,1,"CHA-IU",1
44,"44039",255,189,189,5,0,"CHA-IU",4
22,"22082",320,231,229,1,2,"CHA-IU",9
44,"44117",357,278,275,0,3,"CHA-IU",22
44,"44103",128,95,95,0,0,"CHA-IU",2
22,"22131",96,79,77,2,2,"CHA-IU",7
44,"44193",99,71,67,0,4,"CHA-IU",8
44,"44122",1441,1009,990,21,19,"CHA-IU",55
44,"44024",24,19,19,0,0,"CHA-IU",1
22,"22128",203,164,161,7,3,"CHA-IU",4
22,"22004",146,97,97,2,0,"CHA-IU",7
22,"22077",421,327,323,14,4,"CHA-IU",10
44,"44111",101,68,68,4,0,"CHA-IU",10
22,"22208",168,136,133,2,3,"CHA-IU",34
44,"44087",98,87,87,2,0,"CHA-IU",4
22,"22007",863,636,621,8,15,"CHA-IU",26
44,"44114",254,194,188,4,6,"CHA-IU",14
44,"44153",1882,1273,1246,10,27,"CHA-IU",120
44,"44074",435,344,337,5,7,"CHA-IU",9
22,"22245",329,261,257,3,4,"CHA-IU",5
22,"22040",155,129,127,3,2,"CHA-IU",4
44,"44065",60,40,40,0,0,"CHA-IU",2
44,"44151",215,143,140,1,3,"CHA-IU",8
44,"44264",249,196,193,1,3,"CHA-IU",13
22,"22096",301,239,237,8,2,"CHA-IU",18
22,"22035",261,179,176,3,3,"CHA-IU",15
22,"22066",699,479,464,8,15,"CHA-IU",65
44,"44018",27,23,23,0,0,"CHA-IU",0
22,"22084",524,362,354,11,8,"CHA-IU",33
44,"44028",202,159,156,2,3,"CHA-IU",2
44,"44127",79,62,61,0,1,"CHA-IU",0
22,"22242",75,53,52,0,1,"CHA-IU",1
44,"44155",1162,819,801,24,18,"CHA-IU",87
44,"44223",80,55,55,0,0,"CHA-IU",10
44,"44266",134,107,105,2,2,"CHA-IU",4
44,"44220",137,97,96,1,1,"CHA-IU",2
44,"44178",69,45,44,0,1,"CHA-IU",2
22,"22130",9983,6691,6573,148,118,"CHA-IU",704
22,"22247",31,21,20,1,1,"CHA-IU",2
44,"44097",158,97,95,1,2,"CHA-IU",1
44,"44226",163,112,112,3,0,"CHA-IU",9
22,"22044",278,195,191,7,4,"CHA-IU",17
44,"44201",526,449,443,9,6,"CHA-IU",44
44,"44088",32,31,31,1,0,"CHA-IU",0
44,"44129",44,34,33,0,1,"CHA-IU",0
44,"44055",85,63,62,2,1,"CHA-IU",2
22,"22250",368,261,255,12,6,"CHA-IU",27
22,"22032",120,78,73,5,5,"CHA-IU",7
44,"44154",271,196,195,7,1,"CHA-IU",15
22,"22061",6611,4789,4698,110,91,"CHA-IU",323
22,"22025",1104,790,767,27,23,"CHA-IU",24
44,"44009",805,608,595,18,13,"CHA-IU",37
44,"44010",189,138,138,2,0,"CHA-IU",7
22,"22041",175,138,138,1,0,"CHA-IU",1
44,"44077",80,62,62,1,0,"CHA-IU",1
44,"44054",125,97,97,2,0,"CHA-IU",9
44,"44173",107,87,77,5,10,"CHA-IU",4
44,"44090",84,71,71,0,0,"CHA-IU",2
22,"22239",90,76,76,2,0,"CHA-IU",3
22,"22058",194,138,137,5,1,"CHA-IU",11
44,"44249",58,40,40,1,0,"CHA-IU",2
44,"44032",18,12,12,0,0,"CHA-IU",0
44,"44045",373,303,301,4,2,"CHA-IU",32
44,"44143",382,292,292,5,0,"CHA-IU",9
22,"22043",112,72,71,2,1,"CHA-IU",3
44,"44146",185,160,159,8,1,"CHA-IU",10
22,"22205",472,369,363,5,6,"CHA-IU",10
44,"44192",401,324,322,5,2,"CHA-IU",19
44,"44256",37,35,35,9,0,"CHA-IU",1
44,"44059",571,446,434,10,12,"CHA-IU",26
22,"22013",304,239,236,3,3,"CHA-IU",16
44,"44187",224,170,163,2,7,"CHA-IU",6
22,"22115",415,307,304,2,3,"CHA-IU",22
44,"44017",316,232,229,1,3,"CHA-IU",19
44,"44267",79,63,61,2,2,"CHA-IU",0
44,"44050",3183,2208,2154,78,54,"CHA-IU",155
22,"22187",295,222,222,3,0,"CHA-IU",25
44,"44209",892,666,649,6,17,"CHA-IU",35
22,"22207",135,86,79,4,7,"CHA-IU",8
44,"44185",117,91,90,0,1,"CHA-IU",6
22,"22221",108,70,69,5,1,"CHA-IU",8
22,"22089",329,246,237,8,9,"CHA-IU",6
44,"44106",173,132,131,8,1,"CHA-IU",16
22,"22055",347,291,289,5,2,"CHA-IU",19
44,"44136",51,39,39,0,0,"CHA-IU",1
44,"44006",293,220,212,3,8,"CHA-IU",5
22,"22042",115,93,91,1,2,"CHA-IU",9
22,"22069",436,317,315,5,2,"CHA-IU",30
44,"44107",233,161,154,3,7,"CHA-IU",6
22,"22190",120,76,73,4,3,"CHA-IU",9
44,"44118",183,129,127,2,2,"CHA-IU",8
44,"44124",88,63,61,3,2,"CHA-IU",7
44,"44011",67,47,47,0,0,"CHA-IU",4
47,"47018",33,30,28,2,2,"CCD",0
47,"47207",325,265,263,4,2,"CCD",0
9,"9058",357,278,276,4,2,"CCD",0
47,"47142",172,132,131,2,1,"CCD",0
9,"9136",203,153,146,3,7,"CCD",0
19,"19048",18,12,11,1,1,"CCD",0
9,"9369",460,339,336,4,3,"CCD",0
9,"9289",1540,1127,1117,16,10,"CCD",0
19,"19293",1860,1407,1373,16,34,"CCD",0
9,"9439",909,720,697,16,23,"CCD",1
19,"19220",2225,1482,1456,7,26,"CCD",1
9,"9430",18,15,15,0,0,"CCD",0
19,"19157",66,56,56,4,0,"CCD",0
13,"13049",838,654,648,0,6,"CCD",0
19,"19024",7736,5738,5646,82,92,"CCD",4
19,"19092",437,331,326,4,5,"CCD",1
47,"47035",956,778,768,5,10,"CCD",1
47,"47129",954,744,731,4,13,"CCD",0
9,"9327",34,34,34,0,0,"CCD",0
13,"13091",570,484,478,0,6,"CCD",0
19,"19259",37,32,32,0,0,"CCD",0
9,"9192",74,55,53,0,2,"CCD",0
47,"47041",166,135,133,2,2,"CCD",0
9,"9088",77,40,40,0,0,"CCD",0
19,"19307",30,27,27,0,0,"CCD",0
19,"19123",40,34,34,0,0,"CCD",0
19,"19235",121,92,87,0,5,"CCD",0
47,"47134",186,155,149,2,6,"CCD",0
9,"9444",81,54,52,1,2,"CCD",0
47,"47104",2917,2391,2357,31,34,"CCD",0
19,"19008",34,25,25,1,0,"CCD",0
9,"9317",17,15,15,0,0,"CCD",0
47,"47015",229,172,170,1,2,"CCD",0
9,"9265",44,36,35,2,1,"CCD",0
47,"47135",93,77,76,0,1,"CCD",0
47,"47221",115,102,102,0,0,"CCD",0
9,"9230",41,33,33,0,0,"CCD",0
19,"19027",185,140,138,1,2,"CCD",0
9,"9077",38,26,25,0,1,"CCD",0
47,"47155",3043,2246,2225,35,21,"CCD",1
47,"47161",3886,3133,3105,45,28,"CCD",2
9,"9047",62,48,45,0,3,"CCD",0
19,"19115",41,26,26,1,0,"CCD",0
9,"9035",336,255,251,3,4,"CCD",0
9,"9148",95,75,75,2,0,"CCD",0
9,"9019",153,104,104,1,0,"CCD",0
19,"19245",1222,954,943,10,11,"CCD",0
9,"9281",159,134,132,5,2,"CCD",0
19,"19251",41,35,34,0,1,"CCD",0
19,"19197",29,19,19,0,0,"CCD",0
9,"9120",46,35,34,1,1,"CCD",0
9,"9009",167,129,128,8,1,"CCD",0
19,"19174",126,88,86,0,2,"CCD",0
9,"9269",39,33,33,0,0,"CCD",0
19,"19004",67,56,56,0,0,"CCD",0
19,"19080",90,64,64,0,0,"CCD",0
13,"13083",2529,1837,1795,26,42,"CCD",1
13,"13034",56981,42819,42306,742,513,"CCD",120
9,"9094",49,39,39,0,0,"CCD",0
9,"9228",168,143,143,3,0,"CCD",0
19,"19109",53,40,40,1,0,"CCD",0
13,"13022",403,314,314,2,0,"CCD",0
47,"47222",92,77,77,4,0,"CCD",0
9,"9176",60,47,45,2,2,"CCD",0
47,"47197",932,739,730,15,9,"CCD",0
47,"47097",345,291,289,7,2,"CCD",0
19,"19248",64,53,53,0,0,"CCD",0
47,"47063",107,87,87,2,0,"CCD",0
9,"9223",46,40,40,0,0,"CCD",0
9,"9907",1385,1053,1041,31,12,"CCD",0
19,"19284",11,11,11,0,0,"CCD",0
9,"9251",417,292,288,3,4,"CCD",0
9,"9302",116,87,87,3,0,"CCD",0
13,"13008",473,362,360,4,2,"CCD",0
9,"9433",67,46,45,2,1,"CCD",0
9,"9195",64,40,40,1,0,"CCD",0
47,"47077",291,232,232,1,0,"CCD",0
19,"19308",67,61,61,0,0,"CCD",0
9,"9065",152,137,137,1,0,"CCD",0
9,"9160",104,75,74,0,1,"CCD",0
19,"19298",75,53,52,2,1,"CCD",0
19,"19256",48,44,43,0,1,"CCD",0
19,"19306",42,31,31,1,0,"CCD",0
9,"9166",97,87,87,1,0,"CCD",0
9,"9010",35,27,27,1,0,"CCD",0
9,"9109",1181,664,631,16,33,"CCD",15
9,"9303",92,64,64,0,0,"CCD",0
19,"19187",64,54,54,0,0,"CCD",0
47,"47012",134,105,105,0,0,"CCD",0
19,"19061",76,57,55,3,2,"CCD",0
47,"47006",196,151,146,1,5,"CCD",1
47,"47091",97,82,80,3,2,"CCD",0
9,"9064",353,277,277,6,0,"CCD",0
47,"47037",194,160,159,1,1,"CCD",1
9,"9108",399,287,283,5,4,"CCD",0
9,"9063",223,191,189,1,2,"CCD",0
19,"19287",153,114,113,2,1,"CCD",0
9,"9183",58,47,46,1,1,"CCD",0
19,"19173",52,42,42,3,0,"CCD",0
19,"19060",165,127,121,3,6,"CCD",0
19,"19098",22,18,18,0,0,"CCD",0
9,"9411",174,104,103,1,1,"CCD",0
19,"19230",438,317,309,4,8,"CCD",1
19,"19148",56,41,38,1,3,"CCD",0
13,"13066",2444,2094,2065,15,29,"CCD",0
19,"19111",180,147,146,0,1,"CCD",0
47,"47126",49,43,42,1,1,"CCD",0
47,"47210",396,324,321,5,3,"CCD",0
47,"47003",263,224,222,1,2,"CCD",0
13,"13032",1218,926,922,9,4,"CCD",0
9,"9213",370,260,260,5,0,"CCD",0
13,"13063",3839,2801,2771,31,30,"CCD",2
9,"9276",420,275,245,5,30,"CCD",0
47,"47008",26,17,17,0,0,"CCD",0
9,"9310",14,10,9,2,1,"CCD",0
19,"19133",103,89,88,2,1,"CCD",0
13,"13050",533,427,421,3,6,"CCD",0
9,"9244",53,44,44,0,0,"CCD",0
19,"19161",243,171,166,2,5,"CCD",0
19,"19001",64,56,56,1,0,"CCD",0
19,"19005",92,80,79,0,1,"CCD",0
47,"47067",198,159,156,5,3,"CCD",0
19,"19300",746,595,585,3,10,"CCD",0
9,"9375",42,30,30,1,0,"CCD",0
47,"47219",46,36,36,1,0,"CCD",0
9,"9334",52,40,39,1,1,"CCD",0
13,"13087",22953,16674,16376,298,298,"CCD",17
9,"9054",107,80,80,1,0,"CCD",0
19,"19186",93,77,77,0,0,"CCD",0
47,"47133",2382,1861,1841,30,20,"CCD",3
19,"19015",104,88,87,0,1,"CCD",0
9,"9068",25,19,19,2,0,"CCD",0
9,"9353",62,51,51,2,0,"CCD",0
47,"47156",182,155,148,0,7,"CCD",0
9,"9408",45,36,36,0,0,"CCD",0
9,"9464",44,28,28,0,0,"CCD",0
9,"9100",56,46,44,0,2,"CCD",0
19,"19331",2497,1898,1847,19,51,"CCD",0
19,"19103",303,247,244,3,3,"CCD",0
9,"9365",38,27,27,0,0,"CCD",0
47,"47111",1005,804,794,5,10,"CCD",0
9,"9055",55,46,44,0,2,"CCD",0
47,"47029",61,54,53,0,1,"CCD",0
47,"47178",190,162,161,1,1,"CCD",0
19,"19183",108,87,86,1,1,"CCD",0
9,"9221",446,343,340,7,3,"CCD",0
19,"19277",22,17,17,0,0,"CCD",0
47,"47050",3557,2688,2651,50,37,"CCD",2
9,"9358",261,200,199,3,1,"CCD",0
19,"19152",674,505,498,2,7,"CCD",1
19,"19254",57,50,50,0,0,"CCD",0
47,"47169",70,57,57,0,0,"CCD",0
19,"19222",120,90,89,3,1,"CCD",0
47,"47011",600,493,489,4,4,"CCD",0
9,"9196",161,111,110,0,1,"CCD",1
19,"19075",81,53,50,4,3,"CCD",0
9,"9308",70,51,51,0,0,"CCD",0
9,"9483",226,173,171,4,2,"CCD",0
47,"47025",127,103,103,0,0,"CCD",0
9,"9229",213,163,163,1,0,"CCD",0
9,"9419",82,61,61,0,0,"CCD",0
9,"9391",383,290,284,7,6,"CCD",0
47,"47023",2863,2278,2258,38,20,"CCD",1
47,"47064",30,21,21,1,0,"CCD",0
19,"19179",109,77,75,3,2,"CCD",0
19,"19054",184,156,151,2,5,"CCD",0
19,"19297",34,29,29,0,0,"CCD",0
9,"9236",41,38,37,0,1,"CCD",0
19,"19326",1125,800,786,10,14,"CCD",0
19,"19243",53,39,39,0,0,"CCD",0
9,"9266",87,72,72,0,0,"CCD",0
9,"9345",134,102,102,1,0,"CCD",0
47,"47131",189,145,145,4,0,"CCD",0
19,"19305",166,130,130,0,0,"CCD",0
9,"9458",422,325,316,5,9,"CCD",2
9,"9363",1047,798,792,9,6,"CCD",0
19,"19169",51,35,35,0,0,"CCD",0
9,"9901",407,319,308,8,11,"CCD",2
19,"19327",551,459,449,3,10,"CCD",0
9,"9309",343,252,246,7,6,"CCD",0
9,"9449",94,80,80,2,0,"CCD",0
9,"9272",319,225,225,5,0,"CCD",0
47,"47162",80,62,62,1,0,"CCD",0
19,"19303",56,48,47,1,1,"CCD",0
47,"47002",30,27,27,1,0,"CCD",0
9,"9149",37,25,25,0,0,"CCD",0
47,"47114",4107,2877,2834,37,43,"CCD",2
47,"47087",376,320,315,7,5,"CCD",0
13,"13037",901,752,745,2,7,"CCD",0
47,"47146",236,196,195,4,1,"CCD",0
47,"47034",90,65,63,0,2,"CCD",0
13,"13075",212,161,159,1,2,"CCD",0
19,"19219",18,12,12,0,0,"CCD",0
19,"19185",40,21,19,0,2,"CCD",0
13,"13001",1372,1087,1067,8,20,"CCD",2
47,"47154",168,144,144,7,0,"CCD",0
9,"9155",27,17,17,0,0,"CCD",0
9,"9384",310,223,218,3,5,"CCD",0
19,"19073",24,20,19,0,1,"CCD",0
47,"47005",578,467,455,5,12,"CCD",0
9,"9128",82,65,63,0,2,"CCD",0
9,"9200",54,35,35,2,0,"CCD",0
9,"9001",29,25,25,0,0,"CCD",0
19,"19044",319,248,245,0,3,"CCD",0
19,"19223",129,94,90,1,4,"CCD",0
9,"9119",51,38,38,0,0,"CCD",0
13,"13042",953,704,693,5,11,"CCD",1
9,"9026",384,296,295,8,1,"CCD",0
19,"19153",25,17,17,0,0,"CCD",0
13,"13053",14718,10958,10766,159,192,"CCD",9
9,"9410",3181,2079,2049,48,30,"CCD",4
9,"9231",77,42,42,0,0,"CCD",0
19,"19064",97,84,83,1,1,"CCD",0
19,"19334",50,37,37,0,0,"CCD",0
19,"19190",2499,1829,1785,32,44,"CCD",1
19,"19088",98,67,66,0,1,"CCD",0
9,"9274",1160,924,914,14,10,"CCD",0
13,"13003",503,390,387,2,3,"CCD",1
9,"9440",105,80,80,0,0,"CCD",0
47,"47083",80,61,59,3,2,"CCD",0
9,"9007",66,50,50,0,0,"CCD",0
19,"19270",17,16,16,0,0,"CCD",0
19,"19302",64,60,60,2,0,"CCD",0
13,"13011",5166,3555,3500,31,55,"CCD",3
9,"9454",46,31,30,1,1,"CCD",0
47,"47068",41,28,28,0,0,"CCD",0
9,"9377",658,509,505,11,4,"CCD",0
9,"9460",187,144,142,2,2,"CCD",0
9,"9075",126,102,101,1,1,"CCD",1
9,"9267",135,118,118,3,0,"CCD",0
19,"19324",199,151,151,2,0,"CCD",1
19,"19114",40,34,34,0,0,"CCD",0
47,"47045",839,636,632,3,4,"CCD",0
19,"19167",136,112,109,4,3,"CCD",0
47,"47195",449,350,346,5,4,"CCD",3
47,"47076",16922,13030,12899,212,131,"CCD",20
47,"47231",4272,3268,3243,64,25,"CCD",0
9,"9191",45,34,33,1,1,"CCD",0
9,"9177",1154,823,815,12,8,"CCD",0
47,"47160",466,368,364,5,4,"CCD",0
47,"47014",55,47,47,0,0,"CCD",0
9,"9030",135,97,97,2,0,"CCD",0
19,"19051",94,83,83,1,0,"CCD",0
9,"9338",220,173,168,5,5,"CCD",0
47,"47038",128,91,91,0,0,"CCD",0
19,"19006",873,634,620,1,14,"CCD",2
19,"19165",51,43,42,0,1,"CCD",0
19,"19091",30,22,22,2,0,"CCD",0
13,"13031",2384,1908,1874,23,34,"CCD",1
47,"47188",125,112,109,3,3,"CCD",0
47,"47116",426,363,358,0,5,"CCD",0
19,"19125",54,42,42,2,0,"CCD",0
47,"47182",1371,991,982,12,9,"CCD",0
19,"19112",68,50,50,0,0,"CCD",0
19,"19038",48,33,33,0,0,"CCD",0
19,"19262",184,137,136,0,1,"CCD",0
47,"47224",92,77,77,0,0,"CCD",0
19,"19041",166,127,127,3,0,"CCD",0
19,"19263",34,27,27,0,0,"CCD",0
19,"19238",42,32,31,1,1,"CCD",0
19,"19317",150,122,121,2,1,"CCD",0
19,"19214",94,78,78,2,0,"CCD",0
19,"19267",22,15,15,0,0,"CCD",0
47,"47211",45,38,38,1,0,"CCD",0
9,"9216",390,278,272,2,6,"CCD",0
19,"19151",1126,849,830,3,19,"CCD",0
9,"9079",49,44,44,1,0,"CCD",0
19,"19260",44,41,41,1,0,"CCD",0
13,"13078",9291,7062,6993,92,69,"CCD",8
9,"9387",121,92,91,3,1,"CCD",0
13,"13093",4333,3281,3229,43,52,"CCD",2
19,"19299",94,75,75,0,0,"CCD",0
9,"9416",61,44,44,0,0,"CCD",0
19,"19321",46,29,29,0,0,"CCD",0
47,"47180",96,82,81,0,1,"CCD",0
13,"13059",232,186,184,0,2,"CCD",0
47,"47198",71,56,56,2,0,"CCD",1
9,"9105",111,85,81,2,4,"CCD",0
19,"19901",43,34,34,0,0,"CCD",0
9,"9283",63,36,36,0,0,"CCD",0
19,"19258",103,81,81,0,0,"CCD",0
19,"19216",143,112,105,2,7,"CCD",0
19,"19118",17,13,13,0,0,"CCD",0
19,"19013",143,110,108,1,2,"CCD",0
9,"9255",90,68,68,0,0,"CCD",0
9,"9389",77,66,66,0,0,"CCD",0
9,"9169",96,80,80,1,0,"CCD",0
47,"47118",159,122,122,2,0,"CCD",0
13,"13039",14349,10928,10776,149,152,"CCD",10
47,"47073",141,118,116,1,2,"CCD",0
13,"13054",5032,3901,3824,70,77,"CCD",35
19,"19325",127,105,102,4,3,"CCD",0
47,"47085",16967,12618,12472,208,146,"CCD",7
19,"19126",1552,1140,1119,16,21,"CCD",0
47,"47079",67,56,56,1,0,"CCD",0
13,"13076",514,436,428,0,8,"CCD",0
19,"19082",91,68,67,1,1,"CCD",0
13,"13065",3011,2105,2088,24,17,"CCD",4
47,"47228",481,385,383,3,2,"CCD",0
9,"9170",218,158,157,0,1,"CCD",0
13,"13025",321,257,254,1,3,"CCD",0
9,"9261",486,342,338,7,4,"CCD",0
9,"9137",177,134,134,6,0,"CCD",0
19,"19314",46,41,41,0,0,"CCD",0
9,"9257",93,73,72,2,1,"CCD",0
9,"9437",298,249,247,5,2,"CCD",0
9,"9415",290,192,192,4,0,"CCD",0
9,"9239",52,42,42,1,0,"CCD",0
19,"19022",673,501,496,4,5,"CCD",9
9,"9051",181,136,133,2,3,"CCD",0
13,"13096",7716,5759,5659,70,100,"CCD",5
19,"19120",107,95,95,1,0,"CCD",0
19,"19211",450,340,334,0,6,"CCD",0
19,"19177",82,67,66,0,1,"CCD",0
19,"19124",420,293,291,3,2,"CCD",0
47,"47172",149,125,124,3,1,"CCD",0
19,"19046",20318,15118,14892,219,226,"CCD",13
47,"47175",6562,5041,4957,62,84,"CCD",4
47,"47031",203,149,149,0,0,"CCD",0
19,"19020",52,39,39,3,0,"CCD",0
9,"9321",1760,1338,1327,20,11,"CCD",2
9,"9098",553,416,410,11,6,"CCD",0
19,"19225",879,625,618,9,7,"CCD",0
9,"9057",155,125,124,0,1,"CCD",0
9,"9044",54,45,45,1,0,"CCD",0
47,"47138",259,198,195,3,3,"CCD",0
47,"47167",258,230,229,3,1,"CCD",0
47,"47193",1538,1229,1211,23,18,"CCD",0
19,"19265",157,102,101,0,1,"CCD",0
19,"19210",34,29,29,1,0,"CCD",0
19,"19323",50,41,39,0,2,"CCD",0
9,"9298",90,74,74,1,0,"CCD",0
9,"9086",629,467,461,5,6,"CCD",0
9,"9093",154,127,125,1,2,"CCD",0
9,"9014",190,113,113,3,0,"CCD",0
9,"9386",61,45,45,0,0,"CCD",0
9,"9218",384,285,279,8,6,"CCD",2
9,"9472",58,46,46,0,0,"CCD",0
9,"9140",136,110,110,1,0,"CCD",0
9,"9339",139,105,104,1,1,"CCD",0
19,"19110",73,59,57,4,2,"CCD",0
19,"19280",3415,2521,2490,27,31,"CCD",3
13,"13048",538,441,433,5,8,"CCD",0
13,"13055",738,585,578,8,7,"CCD",0
13,"13088",649,531,526,3,5,"CCD",1
47,"47030",1075,822,801,13,21,"CCD",0
13,"13077",3654,2535,2480,31,55,"CCD",1
9,"9304",197,168,165,1,3,"CCD",0
19,"19052",37,32,31,1,1,"CCD",0
9,"9198",115,85,85,1,0,"CCD",1
19,"19049",19,11,11,0,0,"CCD",0
19,"19194",113,80,76,1,4,"CCD",0
19,"19039",73,57,57,0,0,"CCD",0
19,"19076",36,29,29,0,0,"CCD",0
19,"19155",61,52,50,1,2,"CCD",0
9,"9143",24,14,14,1,0,"CCD",0
19,"19163",73,59,59,0,0,"CCD",0
9,"9326",156,119,114,2,5,"CCD",0
47,"47124",435,364,358,5,6,"CCD",0
9,"9343",94,77,76,0,1,"CCD",0
19,"19271",53,45,45,1,0,"CCD",0
9,"9405",143,106,105,2,1,"CCD",1
47,"47143",146,108,107,0,1,"CCD",0
13,"13082",25643,17973,17798,257,175,"CCD",6
9,"9478",53,41,41,1,0,"CCD",0
9,"9159",57,49,48,0,1,"CCD",0
13,"13038",1770,1397,1380,8,17,"CCD",1
19,"19078",58,49,48,0,1,"CCD",0
19,"19285",26,20,20,2,0,"CCD",0
47,"47046",124,105,103,0,2,"CCD",0
9,"9091",746,556,550,8,6,"CCD",0
9,"9181",334,271,271,14,0,"CCD",2
19,"19178",45,34,34,0,0,"CCD",0
47,"47204",275,221,219,3,2,"CCD",0
47,"47176",229,157,157,0,0,"CCD",0
19,"19209",50,40,39,0,1,"CCD",0
47,"47043",330,267,264,1,3,"CCD",0
47,"47070",33,30,30,1,0,"CCD",0
13,"13006",641,529,519,4,10,"CCD",0
9,"9133",39,33,33,1,0,"CCD",0
9,"9427",1561,1090,1078,18,12,"CCD",1
13,"13069",704,605,590,2,15,"CCD",0
47,"47139",1080,845,833,11,12,"CCD",1
19,"19204",168,129,126,2,3,"CCD",0
9,"9182",104,81,81,1,0,"CCD",0
13,"13044",2747,1996,1950,20,46,"CCD",4
9,"9020",276,222,222,6,0,"CCD",0
9,"9248",63,52,52,0,0,"CCD",0
9,"9287",201,159,158,4,1,"CCD",0
19,"19283",40,33,33,0,0,"CCD",0
19,"19198",22,19,19,0,0,"CCD",0
13,"13040",933,755,744,4,11,"CCD",0
9,"9407",31,27,27,0,0,"CCD",0
47,"47010",11275,8800,8701,163,99,"CCD",4
9,"9059",137122,103909,102353,2008,1556,"CCD",83
13,"13085",2455,2146,2118,21,28,"CCD",2
19,"19042",41,32,32,0,0,"CCD",0
9,"9392",51,42,42,1,0,"CCD",0
19,"19129",48,33,31,0,2,"CCD",0
9,"9382",33,30,30,0,0,"CCD",0
19,"19168",324,233,231,6,2,"CCD",0
9,"9463",261,205,205,1,0,"CCD",0
9,"9151",509,389,383,5,6,"CCD",0
19,"19199",24,21,21,0,0,"CCD",0
47,"47181",170,128,128,1,0,"CCD",0
13,"13097",2309,1843,1825,20,18,"CCD",2
47,"47099",174,153,153,4,0,"CCD",0
9,"9124",1598,1151,1129,19,22,"CCD",0
19,"19096",99,79,78,1,1,"CCD",0
9,"9249",54,44,42,1,2,"CCD",0
47,"47026",59,46,46,1,0,"CCD",0
13,"13072",803,638,633,13,5,"CCD",0
19,"19193",30,29,29,1,0,"CCD",0
47,"47144",85,65,65,2,0,"CCD",0
9,"9406",242,193,193,2,0,"CCD",1
19,"19017",87,70,70,0,0,"CCD",0
19,"19130",58473,45114,44362,688,752,"CCD",41
19,"19200",150,105,105,1,0,"CCD",0
13,"13043",251,208,206,1,2,"CCD",0
9,"9448",225,188,186,1,2,"CCD",0
47,"47227",62,52,52,1,0,"CCD",0
19,"19224",119,95,94,0,1,"CCD",0
47,"47024",283,211,210,1,1,"CCD",1
9,"9110",95,68,68,1,0,"CCD",0
13,"13015",5755,4334,4293,40,41,"CCD",2
9,"9445",46,31,31,1,0,"CCD",0
19,"19045",180,145,145,1,0,"CCD",0
47,"47065",898,762,752,9,10,"CCD",1
19,"19208",55,41,41,1,0,"CCD",0
13,"13051",358,291,289,5,2,"CCD",0
9,"9041",27,27,27,0,0,"CCD",0
19,"19257",3595,2593,2543,48,50,"CCD",1
9,"9335",62,52,51,1,1,"CCD",0
47,"47203",69,57,56,0,1,"CCD",0
13,"13030",153,123,123,1,0,"CCD",0
9,"9217",389,273,270,8,3,"CCD",0
19,"19171",4352,3299,3221,35,78,"CCD",1
47,"47048",204,168,167,2,1,"CCD",2
9,"9127",54,39,39,0,0,"CCD",0
47,"47215",60,52,52,2,0,"CCD",0
9,"9184",4,4,4,0,0,"CCD",0
13,"13089",1906,1610,1553,12,57,"CCD",1
47,"47192",99,84,84,0,0,"CCD",0
19,"19246",48,38,38,1,0,"CCD",0
13,"13902",497,396,394,3,2,"CCD",0
13,"13090",1202,994,972,4,22,"CCD",0
13,"13012",475,322,318,1,4,"CCD",0
13,"13046",786,654,644,2,10,"CCD",0
9,"9139",104,84,80,3,4,"CCD",0
19,"19033",79,55,55,0,0,"CCD",0
47,"47190",103,87,87,7,0,"CCD",0
9,"9241",198,159,158,5,1,"CCD",0
47,"47105",210,181,179,1,2,"CCD",0
19,"19119",93,80,79,2,1,"CCD",0
9,"9316",108,87,84,0,3,"CCD",0
9,"9259",239,178,177,2,1,"CCD",0
19,"19269",103,84,83,0,1,"CCD",0
9,"9201",33,22,22,2,0,"CCD",0
47,"47150",338,273,271,2,2,"CCD",0
9,"9070",38,27,27,3,0,"CCD",0
47,"47123",456,356,353,10,3,"CCD",1
47,"47213",122,99,99,1,0,"CCD",0
9,"9318",63,38,38,0,0,"CCD",0
9,"9175",143,99,98,0,1,"CCD",0
19,"19034",23,23,23,1,0,"CCD",0
19,"19070",100,74,74,0,0,"CCD",0
19,"19279",66,56,56,0,0,"CCD",0
47,"47033",209,170,168,3,2,"CCD",0
19,"19201",70,52,52,2,0,"CCD",0
9,"9078",41,37,35,0,2,"CCD",0
19,"19010",15,13,13,1,0,"CCD",0
47,"47168",32,29,28,1,1,"CCD",0
47,"47151",32,29,29,0,0,"CCD",0
9,"9262",158,139,137,7,2,"CCD",0
19,"19249",38,32,32,0,0,"CCD",0
13,"13092",1924,1655,1635,4,20,"CCD",0
19,"19104",16,12,12,1,0,"CCD",0
13,"13016",708,555,553,2,2,"CCD",0
9,"9072",272,210,209,4,1,"CCD",0
19,"19232",89,68,67,0,1,"CCD",0
9,"9442",385,295,289,4,6,"CCD",0
19,"19296",43,31,30,1,1,"CCD",0
9,"9295",78,54,53,0,1,"CCD",0
9,"9164",179,130,130,1,0,"CCD",0
13,"13060",291,235,229,0,6,"CCD",0
19,"19090",107,87,86,0,1,"CCD",0
9,"9208",252,192,192,6,0,"CCD",0
9,"9297",326,270,266,7,4,"CCD",0
47,"47017",205,177,176,1,1,"CCD",0
19,"19333",142,86,84,0,2,"CCD",0
9,"9048",1565,1166,1148,20,18,"CCD",0
19,"19002",99,77,76,0,1,"CCD",0
9,"9197",160,129,128,3,1,"CCD",0
19,"19172",76,65,64,1,1,"CCD",0
13,"13080",418,310,309,1,1,"CCD",0
47,"47170",40,30,30,0,0,"CCD",1
9,"9374",96,85,81,3,4,"CCD",0
9,"9061",187,146,144,1,2,"CCD",0
13,"13064",1465,1127,1110,21,17,"CCD",0
19,"19116",16,10,10,0,0,"CCD",0
13,"13095",94,70,70,1,0,"CCD",0
19,"19286",743,566,554,8,12,"CCD",1
9,"9083",27,21,21,0,0,"CCD",0
9,"9224",172,125,125,3,0,"CCD",0
9,"9006",68,40,39,1,1,"CCD",1
9,"9130",87,72,71,0,1,"CCD",0
47,"47137",27,22,22,2,0,"CCD",0
19,"19309",37,32,31,0,1,"CCD",0
47,"47007",3453,2616,2580,42,36,"CCD",4
19,"19162",71,52,51,0,1,"CCD",0
13,"13074",1000,886,878,15,8,"CCD",0
9,"9011",86,56,56,1,0,"CCD",0
47,"47080",45,39,39,1,0,"CCD",0
47,"47062",185,153,153,5,0,"CCD",0
9,"9024",159,124,123,2,1,"CCD",0
9,"9330",1562,1212,1176,10,36,"CCD",0
47,"47225",89,67,66,0,1,"CCD",0
19,"19031",18,11,11,0,0,"CCD",0
9,"9122",93,71,71,4,0,"CCD",0
19,"19086",1655,1310,1295,10,15,"CCD",0
9,"9306",127,94,94,0,0,"CCD",0
9,"9482",33,31,30,1,1,"CCD",0
47,"47110",471,386,378,6,8,"CCD",0
19,"19081",43,33,33,0,0,"CCD",0
47,"47028",31,21,20,0,1,"CCD",0
9,"9052",40,31,31,1,0,"CCD",0
47,"47209",43,33,33,0,0,"CCD",0
19,"19067",91,59,59,0,0,"CCD",0
47,"47199",84,61,60,1,1,"CCD",0
9,"9226",74,57,57,0,0,"CCD",0
9,"9038",123,92,92,0,0,"CCD",1
9,"9422",24,18,16,0,2,"CCD",0
9,"9312",113,94,91,0,3,"CCD",0
47,"47061",266,227,223,0,4,"CCD",0
9,"9178",61,48,48,0,0,"CCD",0
19,"19278",30,28,28,0,0,"CCD",0
19,"19213",72,60,60,1,0,"CCD",0
9,"9214",724,477,467,4,10,"CCD",0
19,"19304",235,169,166,1,3,"CCD",0
47,"47082",816,664,661,10,3,"CCD",1
9,"9256",369,254,252,2,2,"CCD",0
9,"9215",426,290,287,1,3,"CCD",0
47,"47200",91,73,73,0,0,"CCD",0
47,"47056",90,69,69,2,0,"CCD",0
19,"19071",7346,5380,5294,76,86,"CCD",3
9,"9066",62,44,42,0,2,"CCD",0
13,"13021",459,358,355,5,3,"CCD",0
19,"19057",79,56,56,0,0,"CCD",0
19,"19065",126,100,100,3,0,"CCD",0
9,"9395",164,134,133,1,1,"CCD",0
9,"9154",150,107,107,3,0,"CCD",0
9,"9125",648,463,460,5,3,"CCD",0
19,"19132",105,79,79,0,0,"CCD",0
9,"9466",151,111,110,1,1,"CCD",0
13,"13056",10945,8173,8070,111,103,"CCD",11
9,"9173",135,116,116,1,0,"CCD",2
9,"9396",152,113,113,0,0,"CCD",0
19,"19291",1271,925,902,3,23,"CCD",1
9,"9467",65,49,49,0,0,"CCD",0
47,"47214",1517,1215,1191,34,24,"CCD",1
19,"19218",60,35,35,0,0,"CCD",0
47,"47149",44,22,20,0,2,"CCD",0
47,"47093",865,658,642,11,16,"CCD",1
47,"47057",237,198,198,3,0,"CCD",0
19,"19036",279,238,236,1,2,"CCD",0
9,"9095",88,75,73,2,2,"CCD",1
47,"47140",132,109,108,1,1,"CCD",0
19,"19058",6455,5028,4933,63,95,"CCD",1
13,"13903",564,461,454,2,7,"CCD",1
9,"9337",126,88,87,1,1,"CCD",0
47,"47113",166,136,135,1,1,"CCD",0
13,"13058",4155,3320,3285,24,35,"CCD",1
47,"47055",212,169,168,3,1,"CCD",0
19,"19310",13,9,8,0,1,"CCD",0
19,"19037",153,128,128,0,0,"CCD",0
19,"19150",128,112,108,0,4,"CCD",0
9,"9451",244,208,202,1,6,"CCD",0
9,"9189",146,101,99,2,2,"CCD",0
19,"19009",253,187,184,0,3,"CCD",0
9,"9904",548,412,407,7,5,"CCD",0
19,"19122",96,65,65,0,0,"CCD",0
19,"19059",84,60,60,0,0,"CCD",0
47,"47153",135,94,93,1,1,"CCD",0
9,"9219",28514,20244,19951,326,293,"CCD",19
19,"19074",81,69,69,0,0,"CCD",0
19,"19227",95,64,63,1,1,"CCD",0
9,"9441",70,59,59,2,0,"CCD",0
9,"9242",93,82,82,2,0,"CCD",0
47,"47060",262,220,218,1,2,"CCD",1
13,"13014",565,457,452,3,5,"CCD",0
19,"19250",25,23,22,0,1,"CCD",0
47,"47086",4062,3162,3120,37,42,"CCD",0
9,"9247",28,21,20,0,1,"CCD",0
19,"19319",4203,3139,3104,28,35,"CCD",1
19,"19095",14,9,8,0,1,"CCD",0
13,"13073",565,459,456,2,3,"CCD",0
19,"19229",83,71,68,0,3,"CCD",0
13,"13004",1130,937,923,6,14,"CCD",0
47,"47115",306,248,248,2,0,"CCD",0
9,"9067",460,335,328,5,7,"CCD",0
47,"47130",105,86,85,2,1,"CCD",0
9,"9388",32,25,24,2,1,"CCD",0
19,"19240",64,47,46,1,1,"CCD",0
47,"47078",178,159,154,7,5,"CCD",1
9,"9361",134,99,98,0,1,"CCD",0
19,"19040",73,42,42,1,0,"CCD",0
13,"13027",3582,2770,2715,25,55,"CCD",1
47,"47069",128,108,108,0,0,"CCD",0
9,"9443",197,160,154,5,6,"CCD",1
47,"47196",43,29,29,0,0,"CCD",0
47,"47009",117,88,88,1,0,"CCD",0
9,"9373",485,332,331,5,1,"CCD",0
9,"9132",174,129,127,3,2,"CCD",1
13,"13094",338,276,275,2,1,"CCD",0
47,"47088",121,100,100,0,0,"CCD",0
13,"13061",5898,4442,4373,56,69,"CCD",4
13,"13028",10536,8503,8331,140,172,"CCD",4
9,"9417",43,38,38,0,0,"CCD",0
9,"9003",205,156,154,4,2,"CCD",0
9,"9039",58,50,49,0,1,"CCD",0
19,"19289",33,28,28,1,0,"CCD",0
9,"9152",273,207,207,1,0,"CCD",0
19,"19055",54,41,37,1,4,"CCD",0
19,"19274",881,652,644,8,8,"CCD",0
9,"9328",81,56,56,2,0,"CCD",0
9,"9179",45,37,37,0,0,"CCD",0
19,"19107",349,289,288,1,1,"CCD",0
19,"19242",112,93,92,1,1,"CCD",0
9,"9227",131,100,100,1,0,"CCD",0
19,"19154",79,68,67,0,1,"CCD",1
9,"9134",237,164,159,7,5,"CCD",0
19,"19106",95,68,66,0,2,"CCD",0
19,"19117",1526,1155,1132,26,23,"CCD",0
13,"13007",1319,1069,1051,18,18,"CCD",0
9,"9381",38,30,30,0,0,"CCD",1
13,"13901",945,734,719,6,15,"CCD",0
47,"47036",257,212,212,1,0,"CCD",0
13,"13041",298,225,225,1,0,"CCD",0
19,"19053",2172,1602,1587,14,15,"CCD",1
47,"47016",94,77,77,1,0,"CCD",0
9,"9476",67,52,52,0,0,"CCD",0
19,"19121",277,219,217,0,2,"CCD",0
47,"47075",4999,4020,3957,39,63,"CCD",3
47,"47019",93,69,68,0,1,"CCD",0
9,"9056",4957,3607,3557,70,50,"CCD",2
9,"9253",108,95,94,4,1,"CCD",0
9,"9347",136,113,109,5,4,"CCD",0
47,"47090",2511,1907,1880,23,27,"CCD",0
47,"47173",862,683,675,5,8,"CCD",1
13,"13020",4805,3475,3434,40,41,"CCD",40
19,"19156",1032,782,762,4,20,"CCD",0
19,"19288",22,21,21,0,0,"CCD",0
13,"13009",1573,1265,1255,6,10,"CCD",0
9,"9421",269,189,189,5,0,"CCD",0
9,"9025",150,112,110,0,2,"CCD",0
9,"9114",88,75,73,0,2,"CCD",0
19,"19255",95,68,68,0,0,"CCD",0
13,"13002",1576,1143,1134,4,9,"CCD",0
13,"13068",1058,801,793,4,8,"CCD",0
47,"47194",322,244,233,1,11,"CCD",0
9,"9450",31,26,26,1,0,"CCD",1
19,"19097",28,27,27,0,0,"CCD",0
9,"9394",805,594,588,13,6,"CCD",0
19,"19018",189,145,138,2,7,"CCD",0
47,"47174",302,236,234,3,2,"CCD",0
19,"19146",51,40,38,0,2,"CCD",0
9,"9270",180,147,143,2,4,"CCD",0
47,"47059",108,77,76,1,1,"CCD",0
19,"19239",99,74,73,1,1,"CCD",0
47,"47132",45,40,40,0,0,"CCD",0
19,"19089",33,22,22,1,0,"CCD",0
19,"19019",23,18,18,0,0,"CCD",0
19,"19266",278,234,231,4,3,"CCD",0
13,"13010",910,729,726,8,3,"CCD",14
9,"9023",993,771,765,22,6,"CCD",0
9,"9280",34,23,23,0,0,"CCD",0
47,"47148",475,389,384,2,5,"CCD",2
19,"19192",1743,1370,1359,10,11,"CCD",1
47,"47212",386,327,325,1,2,"CCD",0
19,"19252",90,80,78,0,2,"CCD",0
47,"47184",575,447,443,6,4,"CCD",0
19,"19228",39,30,29,0,1,"CCD",0
13,"13081",684,553,527,1,26,"CCD",0
19,"19099",337,211,210,6,1,"CCD",0
19,"19261",42,31,31,1,0,"CCD",0
9,"9273",55,47,47,0,0,"CCD",0
47,"47066",1114,891,888,10,3,"CCD",0
47,"47220",194,143,142,4,1,"CCD",0
47,"47206",111,99,99,0,0,"CCD",0
47,"47158",906,716,710,10,6,"CCD",0
19,"19237",53,40,39,2,1,"CCD",0
19,"19247",171,125,118,6,7,"CCD",0
13,"13024",938,703,699,3,4,"CCD",0
9,"9018",24688,17880,17508,345,372,"CCD",25
19,"19105",2235,1709,1686,23,23,"CCD",3
9,"9455",48,39,39,0,0,"CCD",0
9,"9425",561,431,418,3,13,"CCD",0
19,"19203",35,27,27,0,0,"CCD",0
9,"9471",171,127,125,1,2,"CCD",0
47,"47058",199,157,157,3,0,"CCD",0
19,"19301",47,38,38,0,0,"CCD",0
9,"9348",150,122,122,2,0,"CCD",0
9,"9174",859,645,639,11,6,"CCD",0
9,"9279",195,140,140,4,0,"CCD",0
47,"47103",277,218,214,1,4,"CCD",0
9,"9354",33,29,29,2,0,"CCD",0
9,"9045",283,196,196,4,0,"CCD",0
13,"13084",973,800,793,6,7,"CCD",1
47,"47098",607,496,492,9,4,"CCD",0
9,"9090",61,50,50,0,0,"CCD",0
19,"19176",280,216,216,0,0,"CCD",0
47,"47042",63,50,49,3,1,"CCD",0
47,"47205",414,307,298,5,9,"CCD",0
13,"13026",482,387,384,1,3,"CCD",0
13,"13036",837,671,666,3,5,"CCD",2
9,"9350",502,384,376,7,8,"CCD",0
13,"13029",102,90,89,0,1,"CCD",1
9,"9071",48,32,32,0,0,"CCD",0
9,"9046",41,30,30,0,0,"CCD",0
9,"9112",115,80,80,4,0,"CCD",1
9,"9084",200,147,147,4,0,"CCD",0
9,"9029",186,138,137,4,1,"CCD",0
9,"9438",547,440,433,9,7,"CCD",0
47,"47152",94,65,65,0,0,"CCD",0
13,"13086",209,167,166,0,1,"CCD",0
19,"19108",117,97,95,0,2,"CCD",0
13,"13071",41043,28435,28183,370,252,"CCD",87
9,"9429",64,44,44,2,0,"CCD",0
9,"9168",329,254,254,2,0,"CCD",0
47,"47232",107,77,75,1,2,"CCD",0
13,"13005",23052,18002,17700,255,302,"CCD",12
13,"13017",307,230,226,0,4,"CCD",0
19,"19241",45,37,37,2,0,"CCD",0
9,"9144",61,51,50,0,1,"CCD",0
47,"47128",57,52,48,1,4,"CCD",0
19,"19311",87,60,60,0,0,"CCD",0
9,"9022",83,58,58,2,0,"CCD",0
19,"19272",86,67,65,1,2,"CCD",0
9,"9368",26,18,18,0,0,"CCD",0
19,"19217",85,57,54,2,3,"CCD",0
13,"13057",1214,1018,998,9,20,"CCD",2
19,"19330",93,81,81,2,0,"CCD",0
19,"19102",122,101,100,0,1,"CCD",0
19,"19160",944,600,593,6,7,"CCD",0
19,"19166",179,123,121,4,2,"CCD",0
47,"47044",325,257,252,1,5,"CCD",0
19,"19142",259,191,190,0,1,"CCD",0
13,"13098",2265,1805,1759,19,46,"CCD",0
13,"13904",556,448,441,14,7,"CCD",0
47,"47165",7036,5328,5258,67,70,"CCD",5
13,"13047",5822,4735,4650,52,85,"CCD",8
9,"9329",117,80,79,1,1,"CCD",1
13,"13062",595,490,480,4,10,"CCD",0
9,"9211",1489,1137,1121,28,16,"CCD",0
9,"9037",122,91,90,2,1,"CCD",0
19,"19016",74,50,49,0,1,"CCD",0
9,"9199",97,75,74,0,1,"CCD",0
47,"47071",406,333,329,6,4,"CCD",0
19,"19003",50,36,35,1,1,"CCD",0
19,"19136",22,15,15,0,0,"CCD",0
9,"9167",60,49,49,2,0,"CCD",0
9,"9356",57,38,37,1,1,"CCD",0
9,"9905",432,313,309,1,4,"CCD",0
13,"13023",8731,6818,6732,94,86,"CCD",13
9,"9138",92,77,74,0,3,"CCD",1
47,"47013",118,97,97,2,0,"CCD",0
19,"19032",202,11,11,0,0,"CCD",0
19,"19143",1610,1287,1268,9,19,"CCD",1
47,"47096",139,109,107,0,2,"CCD",0
9,"9409",138,105,102,0,3,"CCD",0
9,"9076",24,15,15,0,0,"CCD",0
9,"9123",31,27,27,0,0,"CCD",0
47,"47100",169,146,144,1,2,"CCD",0
19,"19145",64,49,48,2,1,"CCD",0
13,"13079",12220,9665,9502,177,163,"CCD",4
47,"47032",161,130,129,3,1,"CCD",0
9,"9246",662,469,457,3,12,"CCD",0
13,"13013",7141,5682,5564,60,118,"CCD",6
47,"47054",673,545,541,8,4,"CCD",0
19,"19021",1129,818,800,10,18,"CCD",0
9,"9292",98,73,71,3,2,"CCD",0
47,"47185",97,76,75,1,1,"CCD",0
47,"47040",67,51,50,0,1,"CCD",0
47,"47122",2078,1697,1665,21,32,"CCD",3
9,"9380",85,71,71,1,0,"CCD",0
47,"47021",84,61,61,2,0,"CCD",0
47,"47119",101,78,77,0,1,"CCD",1
9,"9908",509,328,321,5,7,"CCD",1
9,"9314",113,89,88,4,1,"CCD",0
47,"47159",862,704,695,20,9,"CCD",0
47,"47027",2680,2059,2024,23,35,"CCD",0
9,"9190",97,73,72,0,1,"CCD",1
9,"9351",63,46,44,0,2,"CCD",0
19,"19113",519,396,395,4,1,"CCD",3
19,"19294",27,26,26,1,0,"CCD",0
9,"9325",217,151,148,1,3,"CCD",0
19,"19264",45,39,39,0,0,"CCD",0
9,"9288",98,80,80,1,0,"CCD",0
13,"13033",1719,1436,1419,6,17,"CCD",0
47,"47117",306,231,228,4,3,"CCD",2
9,"9424",42,35,34,1,1,"CCD",0
47,"47229",235,161,161,1,0,"CCD",0
9,"9258",190,159,159,5,0,"CCD",0
9,"9906",1199,912,903,12,9,"CCD",0
13,"13070",769,653,640,1,13,"CCD",0
47,"47183",150,125,122,0,3,"CCD",0
19,"19182",38,24,22,0,2,"CCD",0
9,"9412",846,568,563,4,5,"CCD",0
9,"9012",105,77,74,3,3,"CCD",0
19,"19050",21,19,19,0,0,"CCD",0
19,"19318",36,19,19,1,0,"CCD",0
19,"19268",34,26,25,0,1,"CCD",0
19,"19282",210,157,157,0,0,"CCD",0
47,"47141",148,121,119,1,2,"CCD",0
47,"47052",6207,4812,4761,79,51,"CCD",3
9,"9085",486,348,339,8,9,"CCD",0
19,"19138",298,223,219,3,4,"CCD",0
19,"19134",22,14,14,0,0,"CCD",0
19,"19079",7,7,7,0,0,"CCD",0
9,"9082",49,41,41,0,0,"CCD",0
19,"19226",40,31,30,0,1,"CCD",0
47,"47102",302,250,248,3,2,"CCD",0
9,"9418",79,60,58,0,2,"CCD",0
13,"13035",1043,794,770,10,24,"CCD",0
9,"9113",503,397,390,7,7,"CCD",0
47,"47020",283,237,232,5,5,"CCD",0
47,"47053",125,100,99,1,1,"CCD",0
9,"9434",1167,916,902,24,14,"CCD",0
47,"47074",155,125,124,0,1,"CCD",0
47,"47001",51,44,42,2,2,"CCD",0
19,"19135",120,102,100,2,2,"CCD",0
19,"19191",19,15,15,0,0,"CCD",0
9,"9372",207,169,165,1,4,"CCD",0
47,"47171",453,371,368,10,3,"CCD",1
19,"19231",16,14,14,0,0,"CCD",0
19,"19170",214,139,138,0,1,"CCD",0
9,"9346",95,83,83,1,0,"CCD",1
19,"19335",77,61,61,1,0,"CCD",2
47,"47089",184,139,138,1,1,"CCD",0
47,"47039",196,163,163,1,0,"CCD",0
47,"47051",351,269,256,5,13,"CCD",0
9,"9033",104,82,80,1,2,"CCD",0
9,"9206",65,56,55,2,1,"CCD",0
19,"19159",108,91,88,1,3,"CCD",0
9,"9311",70,51,51,0,0,"CCD",0
19,"19023",121,95,94,5,1,"CCD",0
47,"47163",315,253,250,2,3,"CCD",1
19,"19196",99,80,74,2,6,"CCD",0
19,"19047",87,71,70,2,1,"CCD",0
9,"9180",132,97,95,8,2,"CCD",0
9,"9277",130,101,101,1,0,"CCD",0
19,"19175",39,31,31,0,0,"CCD",0
9,"9103",247,201,200,2,1,"CCD",1
9,"9060",171,142,142,0,0,"CCD",0
19,"19189",136,99,97,0,2,"CCD",0
47,"47226",180,152,148,1,4,"CCD",0
47,"47094",154,129,127,0,2,"CCD",0
9,"9194",2033,1557,1535,28,22,"CCD",0
9,"9428",124,107,107,1,0,"CCD",0
19,"19127",97,66,66,1,0,"CCD",0
47,"47230",318,266,259,2,7,"CCD",0
9,"9101",79,66,66,2,0,"CCD",0
9,"9414",197,159,159,2,0,"CCD",0
9,"9115",96,71,70,4,1,"CCD",1
9,"9423",34,28,28,1,0,"CCD",0
19,"19007",460,351,345,5,6,"CCD",0
19,"19234",63,48,48,0,0,"CCD",0
9,"9301",625,510,504,11,6,"CCD",0
47,"47047",217,171,170,5,1,"CCD",0
9,"9400",340,253,249,4,4,"CCD",0
9,"9340",72,41,41,0,0,"CCD",0
19,"19332",106,76,72,4,4,"CCD",0
19,"19202",16,14,14,0,0,"CCD",0
47,"47095",41,36,36,3,0,"CCD",0
9,"9225",95,61,61,3,0,"CCD",0
47,"47109",183,151,151,4,0,"CCD",0
9,"9135",41,29,29,1,0,"CCD",0
13,"13019",5254,4038,3978,62,60,"CCD",0
9,"9446",13,9,9,0,0,"CCD",0
47,"47208",56,45,43,1,2,"CCD",0
9,"9013",48,41,41,1,0,"CCD",0
9,"9366",99,67,65,1,2,"CCD",0
9,"9172",129,110,109,2,1,"CCD",0
19,"19322",35,28,27,1,1,"CCD",0
9,"9129",112,93,93,0,0,"CCD",0
9,"9050",77,52,52,0,0,"CCD",0
47,"47022",62,54,54,0,0,"CCD",0
47,"47049",94,71,71,1,0,"CCD",0
9,"9062",52,33,32,1,1,"CCD",0
47,"47127",150,110,108,0,2,"CCD",0
9,"9390",645,522,518,9,4,"CCD",0
9,"9480",106,87,87,0,0,"CCD",0
47,"47218",983,776,767,7,9,"CCD",2
9,"9250",295,234,230,5,4,"CCD",0
9,"9413",500,335,331,1,4,"CCD",0
9,"9323",71,44,44,2,0,"CCD",0
9,"9432",212,161,158,1,3,"CCD",0
9,"9447",36,33,33,0,0,"CCD",0
9,"9043",215,151,151,1,0,"CCD",0
9,"9294",123,96,93,1,3,"CCD",0
9,"9104",56,49,49,0,0,"CCD",0
13,"13045",744,615,608,6,7,"CCD",0
47,"47157",544,462,458,9,4,"CCD",0
47,"47189",164,134,134,1,0,"CCD",0
9,"9021",62,33,33,1,0,"CCD",0
9,"9238",1026,612,601,6,11,"CCD",1
47,"47112",2671,2231,2198,28,33,"CCD",4
47,"47092",123,100,99,2,1,"CCD",0
47,"47187",101,82,81,1,1,"CCD",0
47,"47186",251279,193705,191693,2746,2012,"CCD",198
13,"13067",380,314,312,3,2,"CCD",0
19,"19043",92,82,82,1,0,"CCD",0
19,"19181",69,54,54,5,0,"CCD",0
9,"9017",96,76,74,0,2,"CCD",0
19,"19184",88,63,62,1,1,"CCD",0
9,"9275",202,140,139,5,1,"CCD",0
9,"9473",94,81,81,2,0,"CCD",0
9,"9162",122,94,93,1,1,"CCD",0
9,"9352",134,107,106,0,1,"CCD",0
9,"9036",32,27,27,2,0,"CCD",0
9,"9903",3299,2373,2349,45,24,"CCD",6
47,"47147",129,96,96,0,0,"CCD",0
19,"19233",108,93,90,2,3,"CCD",0
9,"9485",62,56,56,0,0,"CCD",0
9,"9355",117,88,87,1,1,"CCD",0
9,"9360",37,29,29,0,0,"CCD",0
13,"13018",860,740,727,2,13,"CCD",10
19,"19215",206,170,166,0,4,"CCD",0
19,"19147",58,45,40,0,5,"CCD",0
9,"9902",491,363,357,4,6,"CCD",0
47,"47084",1230,981,968,19,13,"CCD",0
47,"47145",658,482,473,7,9,"CCD",0
9,"9073",889,672,663,12,9,"CCD",2
47,"47223",172,147,147,6,0,"CCD",1
9,"9362",219,185,184,2,1,"CCD",1
9,"9378",42,26,26,0,0,"CCD",0
9,"9016",87,55,54,1,1,"CCD",0
19,"19281",25,24,22,3,2,"CCD",0
19,"19011",286,219,218,3,1,"CCD",0
9,"9220",82,60,60,2,0,"CCD",0
9,"9032",118,68,68,0,0,"CCD",0
19,"19188",72,48,48,1,0,"CCD",0
19,"19139",32,23,23,0,0,"CCD",0
9,"9202",26,24,24,1,0,"CCD",0
47,"47217",1812,1395,1377,20,18,"CCD",0
9,"9074",735,558,547,7,11,"CCD",0
9,"9209",4617,3269,3234,44,35,"CCD",1
9,"9034",301,250,250,3,0,"CCD",1
9,"9232",182,146,146,1,0,"CCD",0
19,"19290",872,622,613,7,9,"CCD",0
47,"47191",113,81,80,1,1,"CCD",0
47,"47164",391,326,320,3,6,"CCD",1
47,"47166",276,226,223,0,3,"CCD",1
19,"19329",62,52,50,0,2,"CCD",0
9,"9431",124,102,100,2,2,"CCD",0
47,"47101",1740,1458,1444,12,14,"CCD",0
9,"9307",119,89,88,1,1,"CCD",0
19,"19221",56,41,41,2,0,"CCD",0
47,"47081",57,44,44,1,0,"CCD",0
13,"13052",6580,4869,4786,76,83,"CCD",5
47,"47004",1261,1047,1031,11,16,"CCD",0
9,"9102",44,36,36,0,0,"CCD",0
19,"19087",22,16,16,0,0,"CCD",0
9,"9456",142,110,110,3,0,"CCD",0
47,"47106",63,52,52,0,0,"CCD",0
9,"9131",412,332,321,6,11,"CCD",1
9,"9027",54,48,43,0,5,"CCD",0
9,"9403",98,75,75,0,0,"CCD",0
47,"47177",112,83,79,1,4,"CCD",0
19,"19244",95,82,82,6,0,"CCD",0
47,"47216",124,99,98,2,1,"CCD",0
9,"9141",607,503,481,10,22,"CCD",0
9,"9117",82,59,59,1,0,"CCD",0
47,"47179",408,315,306,6,9,"CCD",0
9,"9315",362,267,265,9,2,"CCD",0
19,"19066",78,63,62,0,1,"CCD",0
47,"47125",55,46,46,0,0,"CCD",0
19,"19212",795,644,632,2,12,"CCD",0
9,"9398",92,68,68,2,0,"CCD",0
9,"9243",87,66,64,2,2,"CCD",0
9,"9163",642,526,518,3,8,"CCD",0
9,"9268",108,78,78,0,0,"CCD",0
9,"9235",179,148,142,1,6,"CCD",0
9,"9332",137,88,85,1,3,"CCD",0
47,"47121",590,495,490,4,5,"CCD",0
19,"19195",41,30,30,1,0,"CCD",0
51,"51001",58533,32223,31745,498,478,"Caballas",1712
38,"38901",1389,917,907,16,10,"CC-NC-PNC",316
35,"35020",6142,4227,4192,24,35,"CC-NC-PNC",1273
38,"38003",1446,1053,1044,4,9,"CC-NC-PNC",100
35,"35010",3565,2178,2135,26,43,"CC-NC-PNC",591
35,"35012",9662,5511,5446,45,65,"CC-NC-PNC",447
35,"35033",6415,4394,4302,51,92,"CC-NC-PNC",405
38,"38038",161890,99555,97980,1101,1575,"CC-NC-PNC",15957
35,"35014",9943,5438,5316,95,122,"CC-NC-PNC",948
38,"38049",2794,1721,1694,12,27,"CC-NC-PNC",215
35,"35002",21673,14480,14253,172,227,"CC-NC-PNC",2025
38,"38017",24438,13769,13576,176,193,"CC-NC-PNC",2560
38,"38005",5327,3316,3270,38,46,"CC-NC-PNC",893
38,"38011",19299,12565,12313,152,252,"CC-NC-PNC",2060
38,"38021",1792,1184,1160,6,24,"CC-NC-PNC",254
38,"38022",18671,13075,12890,111,185,"CC-NC-PNC",2707
38,"38052",1344,886,872,5,14,"CC-NC-PNC",170
35,"35011",23140,15550,15320,199,230,"CC-NC-PNC",1607
38,"38006",35862,18726,18500,209,226,"CC-NC-PNC",3617
35,"35025",1941,1345,1328,12,17,"CC-NC-PNC",124
38,"38008",5430,3844,3772,46,72,"CC-NC-PNC",938
35,"35013",6779,5059,4961,105,98,"CC-NC-PNC",415
35,"35019",30279,17607,17380,158,227,"CC-NC-PNC",2168
38,"38028",22003,14876,14589,158,287,"CC-NC-PNC",1702
38,"38018",4397,3216,3163,27,53,"CC-NC-PNC",992
38,"38001",17632,9601,9475,121,126,"CC-NC-PNC",1586
35,"35006",29515,20731,20286,362,445,"CC-NC-PNC",2371
35,"35001",4663,3639,3569,39,70,"CC-NC-PNC",217
38,"38030",1875,1320,1301,11,19,"CC-NC-PNC",394
38,"38029",1456,732,715,4,17,"CC-NC-PNC",126
38,"38050",2516,1765,1734,9,31,"CC-NC-PNC",154
38,"38039",10198,7548,7429,78,119,"CC-NC-PNC",1385
38,"38041",6780,4905,4813,57,92,"CC-NC-PNC",1746
35,"35005",1170,864,853,7,11,"CC-NC-PNC",143
35,"35022",43892,27289,26876,326,413,"CC-NC-PNC",5296
38,"38025",6649,4858,4778,52,80,"CC-NC-PNC",804
38,"38043",18628,12966,12763,134,203,"CC-NC-PNC",2830
35,"35024",12420,6978,6819,131,159,"CC-NC-PNC",1404
38,"38051",7081,5298,5229,64,69,"CC-NC-PNC",972
35,"35026",78933,49860,48955,780,905,"CC-NC-PNC",5724
38,"38016",1250,664,646,3,18,"CC-NC-PNC",87
38,"38040",4697,3007,2962,31,45,"CC-NC-PNC",632
38,"38002",991,716,708,1,8,"CC-NC-PNC",131
35,"35007",569,392,391,2,1,"CC-NC-PNC",178
38,"38044",2325,1550,1532,7,18,"CC-NC-PNC",555
38,"38014",1446,1018,1007,8,11,"CC-NC-PNC",300
38,"38023",118865,76393,75039,928,1354,"CC-NC-PNC",16100
35,"35027",10510,7523,7375,88,148,"CC-NC-PNC",482
38,"38009",3910,2687,2633,31,54,"CC-NC-PNC",598
38,"38042",3876,2850,2809,24,41,"CC-NC-PNC",484
35,"35003",4764,2733,2680,34,53,"CC-NC-PNC",435
38,"38015",4326,3132,3099,21,33,"CC-NC-PNC",1014
35,"35029",3981,2341,2315,43,26,"CC-NC-PNC",741
38,"38031",28391,21797,21431,234,366,"CC-NC-PNC",3573
38,"38053",3752,2459,2397,28,62,"CC-NC-PNC",573
38,"38035",8172,4990,4919,62,71,"CC-NC-PNC",1057
35,"35016",291589,181013,177964,2856,3049,"CC-NC-PNC",11014
38,"38046",8848,6410,6301,75,109,"CC-NC-PNC",1404
35,"35017",22331,13463,13144,217,319,"CC-NC-PNC",2871
38,"38004",4522,3034,2975,33,59,"CC-NC-PNC",410
38,"38020",14520,9396,9202,121,194,"CC-NC-PNC",2186
38,"38019",12624,8174,8099,65,75,"CC-NC-PNC",1929
35,"35018",11652,6488,6367,107,121,"CC-NC-PNC",928
38,"38027",5392,3530,3459,41,71,"CC-NC-PNC",781
38,"38007",1844,1209,1188,5,21,"CC-NC-PNC",233
38,"38047",1819,1269,1239,12,30,"CC-NC-PNC",331
38,"38013",2823,1856,1843,18,13,"CC-NC-PNC",515
35,"35004",35462,18498,18196,325,302,"CC-NC-PNC",3102
35,"35030",8295,5433,5315,54,118,"CC-NC-PNC",1463
38,"38045",4181,2176,2140,13,36,"CC-NC-PNC",593
38,"38024",14851,9589,9399,93,190,"CC-NC-PNC",2252
35,"35034",6372,2951,2921,33,30,"CC-NC-PNC",393
35,"35023",11640,8412,8178,97,234,"CC-NC-PNC",1424
35,"35015",9065,4859,4770,64,89,"CC-NC-PNC",1005
38,"38033",3987,2696,2656,23,40,"CC-NC-PNC",494
35,"35008",6151,4514,4419,59,95,"CC-NC-PNC",574
38,"38026",32174,24822,24431,283,391,"CC-NC-PNC",6708
38,"38048",3884,2615,2587,34,28,"CC-NC-PNC",680
38,"38012",2535,1735,1716,11,19,"CC-NC-PNC",342
35,"35009",19678,13799,13442,155,357,"CC-NC-PNC",1607
38,"38034",4092,3034,2983,30,51,"CC-NC-PNC",688
38,"38032",13032,8487,8357,101,130,"CC-NC-PNC",1028
35,"35028",8810,4687,4603,71,84,"CC-NC-PNC",516
38,"38010",4054,2642,2599,17,43,"CC-NC-PNC",364
35,"35021",14982,9948,9749,138,199,"CC-NC-PNC",524
35,"35032",3432,2605,2548,37,57,"CC-NC-PNC",158
38,"38036",6477,4514,4422,40,92,"CC-NC-PNC",628
35,"35031",6968,4927,4862,71,65,"CC-NC-PNC",619
38,"38037",13166,8509,8332,65,177,"CC-NC-PNC",1251
17,"17164",4092,2409,2346,60,63,"CiU",1114
17,"17216",158,100,97,1,3,"CiU",53
17,"17159",639,408,397,3,11,"CiU",193
17,"17029",198,136,133,1,3,"CiU",52
17,"17041",237,153,153,1,0,"CiU",48
17,"17160",14852,9257,9128,145,129,"CiU",3041
17,"17007",1778,1137,1113,16,24,"CiU",547
17,"17076",126,77,76,5,1,"CiU",28
17,"17068",252,156,156,4,0,"CiU",87
17,"17151",174,131,131,6,0,"CiU",59
17,"17036",2822,1844,1806,36,38,"CiU",728
17,"17207",2357,1636,1584,40,52,"CiU",904
17,"17085",295,212,208,12,4,"CiU",91
17,"17209",605,469,463,21,6,"CiU",177
17,"17112",215,141,138,4,3,"CiU",71
17,"17056",1704,1171,1158,21,13,"CiU",600
17,"17071",1064,719,698,33,21,"CiU",338
17,"17129",126,91,90,3,1,"CiU",35
17,"17225",208,138,134,1,4,"CiU",52
17,"17009",4089,2573,2490,59,83,"CiU",1143
17,"17147",8385,5401,5325,105,76,"CiU",2194
17,"17099",74,52,50,1,2,"CiU",26
17,"17158",404,266,264,3,2,"CiU",133
17,"17006",1203,759,754,17,5,"CiU",357
17,"17050",645,438,425,15,13,"CiU",204
17,"17168",393,285,281,8,4,"CiU",129
17,"17902",1330,898,874,11,24,"CiU",473
17,"17154",93,54,49,1,5,"CiU",10
17,"17174",183,120,117,5,3,"CiU",62
17,"17116",369,230,227,3,3,"CiU",124
17,"17215",1918,1350,1321,40,29,"CiU",588
17,"17184",1281,803,787,21,16,"CiU",424
17,"17088",551,374,363,4,11,"CiU",167
17,"17135",380,273,269,9,4,"CiU",85
17,"17140",684,476,470,10,6,"CiU",245
17,"17087",230,170,161,6,9,"CiU",74
17,"17199",6630,4242,4162,80,80,"CiU",1704
17,"17139",1346,899,869,21,30,"CiU",462
17,"17054",395,250,247,3,3,"CiU",98
17,"17230",456,326,320,10,6,"CiU",145
17,"17193",3978,2365,2305,38,60,"CiU",786
17,"17097",185,136,136,4,0,"CiU",66
17,"17180",8076,4868,4767,81,101,"CiU",2044
17,"17211",864,628,612,12,16,"CiU",322
17,"17008",3745,2262,2195,34,67,"CiU",1014
17,"17089",5486,3328,3288,43,40,"CiU",1456
17,"17028",327,220,217,4,3,"CiU",125
17,"17217",347,267,251,5,16,"CiU",120
17,"17044",6619,4293,4187,69,106,"CiU",1937
17,"17077",580,374,372,5,2,"CiU",187
17,"17062",5994,3686,3614,69,72,"CiU",1329
17,"17101",567,349,339,4,10,"CiU",126
17,"17107",301,203,200,8,3,"CiU",114
17,"17176",141,96,95,3,1,"CiU",38
17,"17205",198,146,138,3,8,"CiU",76
17,"17002",567,413,401,4,12,"CiU",196
17,"17130",333,236,233,5,3,"CiU",122
17,"17070",116,78,78,3,0,"CiU",50
17,"17025",1127,775,760,11,15,"CiU",360
17,"17145",1593,1090,1068,10,22,"CiU",557
17,"17195",324,220,214,6,6,"CiU",89
17,"17091",433,288,277,16,11,"CiU",161
17,"17011",625,472,467,5,5,"CiU",225
17,"17067",732,483,470,16,13,"CiU",227
17,"17032",1613,933,918,11,15,"CiU",402
17,"17149",366,254,251,4,3,"CiU",131
17,"17134",235,149,148,3,1,"CiU",69
17,"17106",140,105,104,0,1,"CiU",64
17,"17152",10378,6239,6156,100,83,"CiU",1958
17,"17181",3228,2116,2081,19,35,"CiU",883
17,"17221",4135,2789,2723,49,66,"CiU",870
17,"17210",527,358,349,9,9,"CiU",166
17,"17043",159,101,100,2,1,"CiU",61
17,"17117",14022,8705,8595,129,110,"CiU",3152
17,"17226",852,539,535,0,4,"CiU",194
17,"17055",158,121,121,4,0,"CiU",44
17,"17143",134,89,87,2,2,"CiU",38
17,"17096",182,96,94,2,2,"CiU",41
17,"17903",893,565,556,14,9,"CiU",249
17,"17142",2440,1713,1681,39,32,"CiU",678
17,"17022",6771,4247,4169,76,78,"CiU",1473
17,"17078",346,231,226,3,5,"CiU",139
17,"17189",1536,1061,1025,7,36,"CiU",488
17,"17052",134,84,83,2,1,"CiU",37
17,"17188",167,124,122,9,2,"CiU",61
17,"17191",153,116,114,0,2,"CiU",81
17,"17126",309,231,229,9,2,"CiU",119
17,"17037",105,66,66,2,0,"CiU",44
17,"17196",209,139,138,6,1,"CiU",48
17,"17185",2273,1416,1379,32,37,"CiU",765
17,"17094",1161,694,683,11,11,"CiU",370
17,"17144",217,145,143,4,2,"CiU",69
17,"17010",327,216,214,6,2,"CiU",83
17,"17086",1687,1148,1129,14,19,"CiU",310
17,"17073",1753,1320,1298,18,22,"CiU",732
17,"17049",3056,1986,1944,43,42,"CiU",696
17,"17155",14284,8528,8391,143,137,"CiU",2743
17,"17092",3520,2273,2228,42,45,"CiU",827
17,"17169",2460,1690,1651,34,39,"CiU",623
17,"17069",395,276,267,2,9,"CiU",136
17,"17150",1428,1018,996,24,22,"CiU",511
17,"17103",4988,2788,2724,51,64,"CiU",800
17,"17031",172,94,93,1,1,"CiU",57
17,"17015",12254,7759,7553,143,206,"CiU",3591
17,"17046",738,510,498,15,12,"CiU",242
17,"17066",25667,15429,15157,244,272,"CiU",5165
17,"17074",490,345,342,5,3,"CiU",119
17,"17114",22610,14079,13811,263,268,"CiU",6253
17,"17192",145,107,105,4,2,"CiU",63
17,"17026",542,404,398,3,6,"CiU",249
17,"17038",343,261,256,2,5,"CiU",171
17,"17080",165,115,114,1,1,"CiU",50
17,"17058",177,115,114,2,1,"CiU",49
17,"17208",1012,642,622,12,20,"CiU",326
17,"17197",144,103,102,3,1,"CiU",51
17,"17177",563,398,388,7,10,"CiU",213
17,"17233",2192,1470,1434,33,36,"CiU",687
17,"17218",568,361,350,11,11,"CiU",177
17,"17035",548,385,379,7,6,"CiU",206
17,"17111",789,584,574,15,10,"CiU",284
17,"17167",2818,1886,1858,52,28,"CiU",804
17,"17023",26941,17098,16799,344,299,"CiU",4259
17,"17224",355,246,241,10,5,"CiU",117
17,"17057",1010,640,634,19,6,"CiU",245
17,"17123",365,274,266,8,8,"CiU",160
17,"17120",779,501,485,9,16,"CiU",251
17,"17148",1546,980,957,24,23,"CiU",354
17,"17119",89,65,64,3,1,"CiU",29
17,"17021",108,86,79,0,7,"CiU",30
17,"17187",574,414,402,1,12,"CiU",162
17,"17095",19245,11212,11067,160,145,"CiU",3066
17,"17051",201,146,142,4,4,"CiU",65
17,"17901",964,628,621,16,7,"CiU",262
17,"17024",301,207,204,4,3,"CiU",117
17,"17165",608,414,400,9,14,"CiU",200
17,"17173",174,121,119,1,2,"CiU",47
17,"17012",1093,689,679,11,10,"CiU",249
17,"17153",172,127,123,1,4,"CiU",48
17,"17048",6176,3818,3773,52,45,"CiU",1517
17,"17186",3593,2358,2317,33,41,"CiU",789
17,"17190",811,548,532,7,16,"CiU",276
17,"17138",1010,677,662,3,15,"CiU",211
17,"17200",616,406,393,12,13,"CiU",139
17,"17202",3799,2398,2366,44,32,"CiU",888
17,"17081",236,165,162,2,3,"CiU",87
17,"17014",64,39,37,0,2,"CiU",11
17,"17201",131,89,89,2,0,"CiU",50
17,"17040",506,320,316,7,4,"CiU",158
17,"17198",404,264,259,9,5,"CiU",105
17,"17083",2886,1825,1801,39,24,"CiU",626
17,"17110",1359,930,917,12,13,"CiU",371
17,"17222",108,86,86,1,0,"CiU",51
17,"17060",378,240,233,1,7,"CiU",98
17,"17157",127,99,98,3,1,"CiU",64
17,"17161",978,693,687,21,6,"CiU",343
17,"17098",311,208,202,4,6,"CiU",69
17,"17079",62633,40844,40101,670,743,"CiU",14331
17,"17084",269,177,175,4,2,"CiU",102
17,"17064",341,253,250,4,3,"CiU",118
17,"17137",3331,2163,2110,39,53,"CiU",1047
17,"17232",159,107,104,0,3,"CiU",45
17,"17163",2478,1729,1681,41,48,"CiU",870
17,"17047",4803,2866,2803,30,63,"CiU",1002
17,"17100",201,140,135,1,5,"CiU",89
17,"17128",309,232,224,5,8,"CiU",109
17,"17172",426,286,283,3,3,"CiU",163
17,"17171",148,111,109,5,2,"CiU",64
17,"17170",192,135,134,1,1,"CiU",70
17,"17132",1296,913,900,15,13,"CiU",451
17,"17162",137,80,78,2,2,"CiU",34
17,"17004",504,340,337,6,3,"CiU",150
17,"17175",569,375,369,6,6,"CiU",78
17,"17013",2774,1884,1859,21,25,"CiU",719
17,"17183",261,178,176,2,2,"CiU",101
17,"17166",503,361,342,10,19,"CiU",168
17,"17124",1670,1087,1056,18,31,"CiU",511
17,"17003",101,67,64,2,3,"CiU",27
17,"17027",2865,1955,1892,34,63,"CiU",757
17,"17206",167,108,107,2,1,"CiU",76
17,"17105",257,152,146,4,6,"CiU",62
17,"17228",280,172,170,4,2,"CiU",82
17,"17214",695,470,461,10,9,"CiU",237
17,"17065",316,211,205,6,6,"CiU",97
17,"17141",5689,3485,3428,50,57,"CiU",1406
17,"17118",12541,7817,7681,130,136,"CiU",2770
17,"17146",2952,1895,1864,49,31,"CiU",590
17,"17033",5157,3142,3095,44,47,"CiU",1046
17,"17194",93,55,55,1,0,"CiU",16
17,"17178",1075,683,679,15,4,"CiU",316
17,"17234",183,131,128,2,3,"CiU",51
17,"17203",171,97,94,3,3,"CiU",50
17,"17020",3446,2322,2268,45,54,"CiU",1184
17,"17019",1783,1264,1234,42,30,"CiU",621
17,"17005",404,258,254,12,4,"CiU",113
17,"17109",759,428,414,10,14,"CiU",210
17,"17075",304,216,210,5,6,"CiU",108
17,"17133",1336,889,866,14,23,"CiU",504
17,"17001",557,370,365,7,5,"CiU",163
17,"17220",780,550,545,13,5,"CiU",311
17,"17227",107,82,82,1,0,"CiU",46
17,"17115",281,209,207,5,2,"CiU",107
17,"17063",169,113,111,5,2,"CiU",64
17,"17018",478,337,332,8,5,"CiU",158
17,"17039",1850,1299,1275,31,24,"CiU",553
17,"17212",129,100,98,4,2,"CiU",61
17,"17182",257,177,175,2,2,"CiU",53
17,"17030",624,414,409,8,5,"CiU",175
17,"17082",443,285,280,1,5,"CiU",158
17,"17016",725,491,481,8,10,"CiU",245
17,"17093",859,561,552,16,9,"CiU",247
17,"17034",6723,4131,4064,77,67,"CiU",1553
17,"17061",175,123,123,4,0,"CiU",76
17,"17090",548,412,404,7,8,"CiU",227
17,"17102",571,354,350,7,4,"CiU",191
17,"17213",5282,3097,3041,42,56,"CiU",1156
17,"17136",173,124,120,0,4,"CiU",50
17,"17121",230,159,158,7,1,"CiU",89
17,"17223",787,523,514,8,9,"CiU",182
17,"17204",539,349,347,10,2,"CiU",140
17,"17125",132,90,89,1,1,"CiU",42
17,"17042",415,297,292,2,5,"CiU",164
8,"8228",303,230,227,5,3,"CiU",99
25,"25904",149,107,104,1,3,"CiU",48
8,"8104",713,454,441,9,13,"CiU",209
25,"25070",888,594,582,18,12,"CiU",284
43,"43050",2407,1528,1504,20,24,"CiU",410
43,"43099",330,240,236,4,4,"CiU",144
25,"25152",160,92,90,4,2,"CiU",48
8,"8308",145,116,115,1,1,"CiU",94
8,"8298",25338,16982,16690,353,292,"CiU",7722
8,"8248",5239,3513,3443,71,70,"CiU",1268
43,"43001",706,481,473,12,8,"CiU",148
43,"43137",1873,1241,1212,27,29,"CiU",372
43,"43033",772,547,533,4,14,"CiU",204
43,"43108",1808,1183,1157,28,26,"CiU",467
8,"8288",1735,985,957,13,28,"CiU",272
25,"25043",830,483,467,17,16,"CiU",209
43,"43130",196,132,131,7,1,"CiU",63
8,"8077",33925,23896,23548,381,348,"CiU",4532
43,"43143",62,51,50,1,1,"CiU",32
8,"8063",434,336,333,8,3,"CiU",184
8,"8238",13892,10237,10094,206,143,"CiU",3783
25,"25196",127,87,86,3,1,"CiU",50
8,"8046",12603,8826,8663,190,163,"CiU",3038
25,"25231",515,402,395,4,7,"CiU",212
43,"43121",636,385,371,6,14,"CiU",103
8,"8064",1847,1277,1246,14,31,"CiU",613
25,"25253",175,132,129,1,3,"CiU",78
8,"8007",6338,4165,4050,89,115,"CiU",1705
25,"25040",10654,6905,6768,144,137,"CiU",2746
25,"25250",358,237,234,4,3,"CiU",118
8,"8083",1626,1199,1178,23,21,"CiU",653
25,"25219",144,90,86,0,4,"CiU",33
8,"8134",776,528,513,15,15,"CiU",229
43,"43119",739,500,496,5,4,"CiU",157
8,"8202",12206,8265,8129,183,136,"CiU",3144
43,"43100",3062,2058,2021,52,37,"CiU",507
25,"25179",198,141,136,1,5,"CiU",87
25,"25092",135,100,97,2,3,"CiU",50
8,"8302",9271,5981,5892,82,89,"CiU",1189
8,"8258",845,577,555,23,22,"CiU",256
8,"8155",6573,4411,4334,85,77,"CiU",1169
43,"43012",3392,2346,2295,48,51,"CiU",668
43,"43134",279,208,206,14,2,"CiU",63
43,"43172",378,268,266,8,2,"CiU",126
8,"8012",1694,1155,1136,32,19,"CiU",625
25,"25185",690,409,404,8,5,"CiU",219
25,"25014",264,170,164,11,6,"CiU",71
25,"25138",605,440,428,13,12,"CiU",184
8,"8232",1793,1239,1220,20,19,"CiU",594
43,"43047",4064,2412,2352,50,60,"CiU",455
43,"43061",55,31,31,1,0,"CiU",17
8,"8148",2240,1246,1223,22,23,"CiU",348
25,"25216",250,175,173,5,2,"CiU",100
8,"8132",381,247,241,6,6,"CiU",164
8,"8222",1827,1343,1317,21,26,"CiU",457
25,"25208",294,174,170,3,4,"CiU",70
8,"8026",180,144,143,0,1,"CiU",93
8,"8002",202,143,140,4,3,"CiU",88
8,"8016",1984,1319,1289,26,30,"CiU",597
8,"8905",2268,1692,1657,28,35,"CiU",646
8,"8159",13482,9173,9040,239,133,"CiU",2212
8,"8233",1867,1179,1169,29,10,"CiU",592
8,"8274",4887,3326,3279,36,47,"CiU",1116
25,"25048",1684,1120,1095,29,25,"CiU",525
43,"43072",97,73,70,0,3,"CiU",30
43,"43159",89,51,51,2,0,"CiU",33
8,"8053",2850,1788,1772,21,16,"CiU",607
8,"8158",2996,2012,1986,19,26,"CiU",608
43,"43901",8849,5651,5540,179,111,"CiU",1231
8,"8084",1134,789,760,14,29,"CiU",304
25,"25038",1606,1104,1093,19,11,"CiU",520
43,"43054",2850,1815,1771,37,44,"CiU",796
25,"25245",445,312,306,4,6,"CiU",88
25,"25013",2274,1344,1321,25,23,"CiU",470
43,"43069",194,131,127,3,4,"CiU",42
8,"8043",3067,2044,2023,29,21,"CiU",616
8,"8227",2372,1591,1549,38,42,"CiU",733
8,"8265",1575,1065,1026,38,39,"CiU",485
43,"43034",494,355,344,8,11,"CiU",153
25,"25164",404,270,264,5,6,"CiU",151
25,"25251",670,476,473,1,3,"CiU",271
8,"8293",246,145,145,4,0,"CiU",77
25,"25109",279,183,183,2,0,"CiU",112
25,"25057",198,140,136,2,4,"CiU",32
25,"25158",1647,1154,1135,27,19,"CiU",631
25,"25157",183,128,128,4,0,"CiU",57
8,"8078",224,154,151,2,3,"CiU",84
43,"43103",897,586,575,21,11,"CiU",188
8,"8018",2664,1707,1669,29,38,"CiU",577
25,"25909",141,82,78,0,4,"CiU",36
43,"43064",2063,1420,1391,37,29,"CiU",608
25,"25175",221,151,150,0,1,"CiU",80
8,"8006",10984,7255,7092,104,163,"CiU",2735
25,"25203",8995,5418,5309,116,109,"CiU",2054
43,"43020",2119,1463,1427,26,36,"CiU",420
8,"8170",458,300,288,13,12,"CiU",137
25,"25086",569,379,370,4,9,"CiU",183
8,"8029",3389,2542,2514,45,28,"CiU",1283
43,"43078",841,557,547,7,10,"CiU",286
43,"43144",1187,787,772,12,15,"CiU",262
43,"43169",477,377,364,8,13,"CiU",151
25,"25150",185,119,113,4,6,"CiU",67
8,"8090",120,86,86,2,0,"CiU",52
25,"25120",90759,58761,57778,1325,983,"CiU",18906
8,"8242",243,174,172,5,2,"CiU",77
8,"8027",673,527,515,9,12,"CiU",204
43,"43042",2071,1504,1485,28,19,"CiU",669
8,"8162",1955,1306,1271,28,35,"CiU",403
25,"25154",126,77,77,2,0,"CiU",36
8,"8017",2740,1800,1768,38,32,"CiU",751
8,"8094",1500,1102,1071,21,31,"CiU",454
8,"8085",1033,731,720,10,11,"CiU",429
25,"25104",128,88,86,11,2,"CiU",43
8,"8210",4176,2661,2579,54,82,"CiU",998
43,"43162",4143,2892,2833,59,59,"CiU",883
43,"43110",307,216,214,5,2,"CiU",117
8,"8301",47343,32098,31664,672,434,"CiU",4872
25,"25211",701,378,368,5,10,"CiU",166
43,"43028",2654,1620,1588,27,32,"CiU",458
8,"8183",4497,2914,2865,43,49,"CiU",1340
8,"8087",158,133,132,6,1,"CiU",67
43,"43086",5269,3275,3196,92,79,"CiU",1181
43,"43164",298,233,231,4,2,"CiU",48
43,"43152",472,355,351,9,4,"CiU",165
8,"8179",591,415,405,6,10,"CiU",161
25,"25222",69,55,54,0,1,"CiU",30
8,"8169",47505,31997,31566,555,431,"CiU",4675
8,"8021",76,49,47,1,2,"CiU",24
8,"8098",2374,1552,1535,28,17,"CiU",585
25,"25223",951,562,546,14,16,"CiU",281
43,"43156",4120,2811,2741,66,70,"CiU",884
43,"43154",136,97,96,6,1,"CiU",50
8,"8127",2274,1371,1338,23,33,"CiU",477
8,"8275",242,188,186,4,2,"CiU",107
8,"8207",1718,1296,1256,28,40,"CiU",659
8,"8194",24757,15009,14799,245,210,"CiU",2348
8,"8304",822,587,578,16,9,"CiU",258
43,"43056",931,537,515,18,22,"CiU",148
25,"25009",690,479,471,9,8,"CiU",217
43,"43022",1559,1097,1074,22,23,"CiU",310
8,"8089",33316,22369,22107,437,262,"CiU",4595
25,"25068",576,376,364,6,12,"CiU",235
8,"8110",13366,8493,8329,144,164,"CiU",2411
8,"8244",5746,4044,3940,102,104,"CiU",1107
43,"43116",494,328,325,5,3,"CiU",129
25,"25210",1164,799,789,13,10,"CiU",386
25,"25075",122,85,83,0,2,"CiU",49
8,"8145",2597,1823,1784,23,39,"CiU",740
8,"8036",172,124,124,4,0,"CiU",73
25,"25016",2203,1375,1357,20,18,"CiU",628
8,"8300",5621,4021,3933,94,88,"CiU",1122
8,"8154",677,499,488,2,11,"CiU",246
8,"8271",74,45,44,3,1,"CiU",19
25,"25143",86,58,58,1,0,"CiU",25
25,"25913",100,78,78,0,0,"CiU",44
25,"25193",771,509,501,8,8,"CiU",273
25,"25205",563,373,362,12,11,"CiU",169
25,"25910",118,77,76,3,1,"CiU",30
43,"43167",390,284,280,12,4,"CiU",130
8,"8033",12476,8513,8378,180,135,"CiU",2861
25,"25169",201,134,134,6,0,"CiU",50
25,"25901",315,196,189,3,7,"CiU",97
43,"43105",175,119,116,14,3,"CiU",39
25,"25115",878,542,542,17,0,"CiU",329
8,"8071",248,172,167,2,5,"CiU",72
43,"43013",4369,2795,2747,54,48,"CiU",945
8,"8262",6835,4086,3993,94,93,"CiU",1254
25,"25067",768,498,494,14,4,"CiU",197
8,"8252",24033,16704,16402,368,302,"CiU",2515
8,"8272",148,97,96,6,1,"CiU",59
25,"25177",379,240,236,2,4,"CiU",109
25,"25031",57,34,34,1,0,"CiU",12
25,"25221",125,76,76,0,0,"CiU",25
25,"25029",1766,1145,1118,38,27,"CiU",410
8,"8251",4771,3214,3140,57,74,"CiU",833
8,"8176",166,111,109,0,2,"CiU",68
25,"25087",65,41,39,0,2,"CiU",13
25,"25174",438,289,283,4,6,"CiU",140
43,"43145",3968,2781,2742,52,39,"CiU",1089
43,"43174",152,104,101,1,3,"CiU",46
8,"8086",13267,8791,8669,200,122,"CiU",2751
8,"8015",155673,101652,100264,1628,1388,"CiU",18759
8,"8230",7452,5349,5286,94,63,"CiU",2012
25,"25227",674,375,372,2,3,"CiU",184
25,"25247",142,80,78,3,2,"CiU",23
43,"43146",45,33,30,1,3,"CiU",10
8,"8123",18751,13394,13154,238,240,"CiU",4185
43,"43151",119,91,89,0,2,"CiU",22
25,"25121",623,406,400,6,6,"CiU",106
8,"8005",5884,4114,4041,68,73,"CiU",1799
43,"43093",3924,2507,2445,62,62,"CiU",935
43,"43076",467,308,300,7,8,"CiU",99
8,"8268",1110,768,755,17,13,"CiU",282
8,"8107",10955,7236,7130,151,106,"CiU",1670
25,"25064",122,91,88,7,3,"CiU",49
8,"8165",1689,1091,1070,18,21,"CiU",447
43,"43107",378,255,248,18,7,"CiU",78
43,"43097",379,283,278,6,5,"CiU",127
43,"43077",486,335,328,4,7,"CiU",45
25,"25130",208,117,112,4,5,"CiU",62
25,"25148",232,144,144,5,0,"CiU",96
8,"8055",476,312,304,11,8,"CiU",120
8,"8200",61189,40677,40069,736,608,"CiU",6580
8,"8152",129,94,93,0,1,"CiU",54
25,"25019",4626,2971,2932,54,39,"CiU",1210
25,"25012",2204,1432,1406,29,26,"CiU",520
8,"8041",10032,6880,6761,112,119,"CiU",1413
25,"25133",748,499,483,7,16,"CiU",280
8,"8048",622,461,454,9,7,"CiU",198
8,"8139",184,130,128,1,2,"CiU",52
8,"8129",444,278,271,2,7,"CiU",123
43,"43153",10307,6572,6450,94,122,"CiU",1950
8,"8229",561,404,398,12,6,"CiU",248
8,"8172",19889,13537,13333,267,204,"CiU",3962
25,"25145",88,67,67,2,0,"CiU",39
43,"43133",5697,3470,3388,76,82,"CiU",871
8,"8096",40650,28247,27784,527,463,"CiU",8845
25,"25051",1710,1060,1044,23,16,"CiU",539
25,"25123",206,140,136,4,4,"CiU",65
8,"8069",3028,2071,2029,36,42,"CiU",718
25,"25010",206,119,118,7,1,"CiU",46
8,"8263",20729,13742,13563,232,179,"CiU",2649
8,"8171",2158,1385,1359,27,26,"CiU",733
25,"25100",207,125,115,2,10,"CiU",67
8,"8220",2277,1641,1604,44,37,"CiU",893
8,"8070",275,192,191,5,1,"CiU",89
8,"8285",10168,6582,6423,152,159,"CiU",2929
43,"43142",1155,730,714,20,16,"CiU",332
25,"25061",75,45,45,0,0,"CiU",29
25,"25071",56,37,35,2,2,"CiU",19
25,"25005",291,194,190,7,4,"CiU",109
8,"8106",6858,4675,4559,113,116,"CiU",1526
8,"8023",6546,4261,4194,86,67,"CiU",1443
8,"8121",85069,58372,57620,923,752,"CiU",15874
8,"8261",2273,1547,1525,30,22,"CiU",543
8,"8050",149,112,108,4,4,"CiU",60
25,"25197",158,102,101,2,1,"CiU",53
43,"43015",104,69,68,2,1,"CiU",32
8,"8214",6754,4659,4555,83,104,"CiU",1885
8,"8168",418,268,266,0,2,"CiU",99
25,"25017",248,160,159,1,1,"CiU",93
25,"25094",154,110,107,1,3,"CiU",54
8,"8003",6983,5061,4993,53,68,"CiU",2247
43,"43007",635,448,441,7,7,"CiU",194
25,"25124",161,110,109,4,1,"CiU",56
43,"43058",106,76,76,5,0,"CiU",35
43,"43132",365,217,214,8,3,"CiU",102
8,"8225",92,68,68,2,0,"CiU",45
43,"43114",383,238,234,6,4,"CiU",64
8,"8904",10608,6654,6561,140,93,"CiU",528
43,"43095",2434,1658,1624,27,34,"CiU",557
8,"8088",11250,8019,7861,144,158,"CiU",3271
8,"8067",5657,3772,3671,75,101,"CiU",1603
43,"43127",778,530,524,6,6,"CiU",281
8,"8025",1460,990,963,14,27,"CiU",317
8,"8082",1143,733,723,17,10,"CiU",177
8,"8143",2679,1772,1756,35,16,"CiU",659
43,"43019",1356,868,837,13,31,"CiU",301
25,"25209",1558,1041,1009,22,32,"CiU",474
8,"8236",1507,1027,1002,18,25,"CiU",333
43,"43017",141,98,98,2,0,"CiU",49
25,"25050",3249,2056,1988,40,68,"CiU",988
43,"43104",1821,1209,1178,34,31,"CiU",423
25,"25168",510,385,378,19,7,"CiU",190
43,"43025",660,453,446,13,7,"CiU",116
25,"25004",553,405,400,13,5,"CiU",188
25,"25060",92,53,52,1,1,"CiU",32
8,"8217",24130,17554,17319,383,235,"CiU",3365
25,"25027",1042,691,665,11,26,"CiU",338
43,"43085",229,178,171,0,7,"CiU",58
8,"8281",4735,3239,3193,57,46,"CiU",1448
25,"25912",899,643,640,6,3,"CiU",235
43,"43148",89309,59260,58346,1202,914,"CiU",14105
43,"43082",383,282,270,8,12,"CiU",107
25,"25011",5241,3127,3080,48,47,"CiU",1286
8,"8073",60247,41448,40843,770,605,"CiU",4690
25,"25132",128,87,85,3,2,"CiU",49
8,"8254",1721,1189,1174,26,15,"CiU",625
8,"8193",928,565,554,15,11,"CiU",222
8,"8020",4542,3352,3298,77,54,"CiU",1187
8,"8030",4849,3466,3422,50,44,"CiU",1714
25,"25244",350,270,268,9,2,"CiU",129
43,"43094",2209,1558,1524,31,34,"CiU",624
25,"25254",782,533,531,9,2,"CiU",210
8,"8108",4879,3475,3437,64,38,"CiU",1051
43,"43111",2096,1305,1281,19,24,"CiU",321
43,"43160",1278,840,812,9,28,"CiU",250
25,"25047",1048,760,748,24,12,"CiU",375
8,"8303",279,202,201,11,1,"CiU",79
8,"8068",6554,4323,4255,87,68,"CiU",1416
8,"8191",5520,3601,3536,64,65,"CiU",1261
8,"8128",557,377,374,16,3,"CiU",181
8,"8113",52352,33606,33123,590,483,"CiU",13166
25,"25242",787,501,490,11,11,"CiU",215
25,"25079",307,242,240,7,2,"CiU",121
25,"25044",195,136,134,1,2,"CiU",60
25,"25053",1085,733,727,10,6,"CiU",344
43,"43139",2166,1319,1270,37,49,"CiU",665
8,"8161",10991,6841,6709,114,132,"CiU",1907
8,"8239",471,338,333,6,5,"CiU",156
25,"25097",102,70,69,3,1,"CiU",18
43,"43027",177,129,128,6,1,"CiU",85
8,"8076",15925,10435,10242,179,193,"CiU",2634
43,"43014",14146,9153,8915,204,238,"CiU",3179
8,"8140",4665,3160,3103,55,57,"CiU",1270
8,"8203",2442,1526,1498,34,28,"CiU",552
8,"8056",39345,26705,26396,449,309,"CiU",6074
25,"25129",175,105,105,3,0,"CiU",60
8,"8234",3143,2040,2008,45,32,"CiU",705
25,"25204",1313,888,881,21,7,"CiU",375
8,"8291",4516,2895,2855,56,40,"CiU",718
8,"8903",217,178,176,10,2,"CiU",99
8,"8117",2424,1685,1661,45,24,"CiU",775
8,"8278",4668,3033,2949,67,84,"CiU",1657
8,"8060",167,102,101,0,1,"CiU",64
8,"8131",696,483,469,7,14,"CiU",223
8,"8295",10579,6896,6769,137,127,"CiU",1927
43,"43161",17199,10765,10547,197,218,"CiU",4205
8,"8009",8932,6188,6088,103,100,"CiU",2450
43,"43118",439,318,313,7,5,"CiU",103
25,"25141",171,111,107,2,4,"CiU",47
25,"25049",166,105,102,1,3,"CiU",58
8,"8101",169663,112624,111107,1841,1517,"CiU",15708
8,"8204",2991,2076,2040,45,36,"CiU",693
8,"8224",771,538,528,26,10,"CiU",216
8,"8255",132,83,82,1,1,"CiU",55
43,"43032",587,418,413,9,5,"CiU",155
8,"8122",1755,1063,1034,17,29,"CiU",273
8,"8118",17077,11817,11598,203,219,"CiU",4443
43,"43005",3559,2191,2147,47,44,"CiU",729
25,"25911",472,306,296,2,10,"CiU",189
8,"8902",3600,2518,2496,57,22,"CiU",959
43,"43065",443,278,270,8,8,"CiU",101
43,"43109",2040,1332,1316,28,16,"CiU",375
8,"8297",138,99,99,2,0,"CiU",66
8,"8052",148,103,98,1,5,"CiU",68
43,"43141",131,71,70,3,1,"CiU",32
8,"8266",42860,30047,29521,536,526,"CiU",6050
25,"25002",481,306,302,6,4,"CiU",146
8,"8130",95,63,62,3,1,"CiU",33
25,"25212",233,185,185,8,0,"CiU",115
8,"8099",808,533,519,11,14,"CiU",258
25,"25042",211,131,127,0,4,"CiU",80
25,"25161",361,222,218,1,4,"CiU",106
8,"8277",134,90,90,4,0,"CiU",49
43,"43147",528,393,380,7,13,"CiU",178
43,"43177",338,242,236,6,6,"CiU",85
25,"25183",485,336,327,6,9,"CiU",180
25,"25218",94,75,73,1,2,"CiU",44
43,"43066",165,113,112,2,1,"CiU",54
8,"8247",903,627,608,10,19,"CiU",352
8,"8187",149633,104021,102629,1794,1392,"CiU",26134
8,"8093",32,21,20,0,1,"CiU",9
25,"25239",627,310,310,7,0,"CiU",148
8,"8175",3477,2303,2270,39,33,"CiU",1077
25,"25207",6253,3938,3872,91,66,"CiU",1641
43,"43071",975,677,664,14,13,"CiU",312
8,"8213",6188,4031,3970,113,61,"CiU",1694
43,"43023",244,179,177,8,2,"CiU",52
8,"8201",458,305,298,12,7,"CiU",154
8,"8114",17629,11781,11579,189,202,"CiU",3084
8,"8241",80,61,61,1,0,"CiU",37
43,"43173",114,65,64,0,1,"CiU",25
43,"43083",141,97,97,2,0,"CiU",45
25,"25135",1077,739,722,18,17,"CiU",360
43,"43010",302,227,223,7,4,"CiU",101
8,"8166",1138,726,706,10,20,"CiU",329
25,"25194",440,292,283,11,9,"CiU",165
8,"8296",1683,1227,1203,29,24,"CiU",563
25,"25191",353,234,227,5,7,"CiU",114
8,"8211",32035,23059,22687,453,372,"CiU",5034
8,"8011",1754,1116,1085,29,31,"CiU",547
8,"8180",26210,17504,17214,366,290,"CiU",2936
8,"8156",10672,7359,7225,121,134,"CiU",2342
8,"8177",52,31,31,1,0,"CiU",12
8,"8174",409,294,292,10,2,"CiU",138
43,"43166",1521,1002,977,17,25,"CiU",280
43,"43008",333,206,197,3,9,"CiU",34
8,"8072",9910,6326,6235,140,91,"CiU",2159
8,"8153",502,357,350,7,7,"CiU",166
8,"8307",47176,31341,30846,536,495,"CiU",8720
8,"8189",141,113,111,4,2,"CiU",81
25,"25074",178,137,132,3,5,"CiU",70
43,"43158",109,63,61,5,2,"CiU",34
25,"25007",1363,902,885,36,17,"CiU",374
25,"25033",1125,738,718,17,20,"CiU",378
43,"43126",1170,802,783,19,19,"CiU",382
25,"25907",506,297,292,6,5,"CiU",130
25,"25243",3408,2280,2252,49,28,"CiU",721
43,"43084",573,383,378,6,5,"CiU",113
43,"43011",1013,745,729,21,16,"CiU",326
8,"8237",1692,1155,1127,22,28,"CiU",601
8,"8137",255,190,190,3,0,"CiU",104
43,"43115",171,112,110,3,2,"CiU",52
8,"8040",10538,6916,6804,99,112,"CiU",2338
43,"43176",832,575,572,16,3,"CiU",245
25,"25234",4572,2707,2648,57,59,"CiU",1128
8,"8151",504,345,338,6,7,"CiU",197
25,"25151",641,451,444,20,7,"CiU",239
43,"43039",117,85,83,3,2,"CiU",43
8,"8047",4141,2610,2580,49,30,"CiU",952
25,"25902",581,411,395,15,16,"CiU",160
43,"43175",590,419,411,8,8,"CiU",177
25,"25008",1187,834,818,15,16,"CiU",434
25,"25170",271,197,196,4,1,"CiU",105
25,"25139",549,358,357,5,1,"CiU",180
43,"43062",298,227,223,7,4,"CiU",89
25,"25908",250,169,168,4,1,"CiU",74
8,"8294",1870,1205,1171,22,34,"CiU",527
25,"25225",603,395,387,7,8,"CiU",185
43,"43024",1459,958,937,17,21,"CiU",273
25,"25119",2297,1554,1513,46,41,"CiU",773
25,"25125",450,297,289,10,8,"CiU",142
8,"8181",7722,5280,5188,112,92,"CiU",1902
25,"25131",439,319,314,6,5,"CiU",150
8,"8044",4247,2763,2712,50,51,"CiU",937
43,"43041",237,177,176,4,1,"CiU",68
8,"8270",17464,11828,11677,212,151,"CiU",4046
8,"8095",75,56,55,1,1,"CiU",30
8,"8004",228,176,172,2,4,"CiU",114
8,"8209",6596,4415,4351,69,64,"CiU",1257
43,"43079",387,259,255,26,4,"CiU",109
43,"43030",454,321,307,5,14,"CiU",133
8,"8283",5862,3712,3618,72,94,"CiU",1814
8,"8038",1406,911,895,24,16,"CiU",390
43,"43088",1810,1199,1177,29,22,"CiU",472
25,"25077",474,281,277,5,4,"CiU",176
8,"8150",245,181,178,11,3,"CiU",90
8,"8120",6342,4801,4746,63,55,"CiU",2832
25,"25020",328,216,209,4,7,"CiU",103
43,"43009",1421,913,897,18,16,"CiU",368
43,"43036",836,503,494,4,9,"CiU",148
25,"25171",2305,1496,1469,37,27,"CiU",604
8,"8100",1934,1437,1401,40,36,"CiU",876
8,"8081",332,232,225,2,7,"CiU",134
8,"8235",3627,2506,2467,35,39,"CiU",1161
8,"8141",4666,3124,3066,57,58,"CiU",1327
25,"25039",299,189,186,7,3,"CiU",69
43,"43004",6411,4089,4001,92,88,"CiU",1041
25,"25248",926,615,601,17,14,"CiU",339
8,"8240",9104,6355,6262,101,93,"CiU",2218
8,"8111",220,188,188,4,0,"CiU",103
25,"25202",110,62,59,3,3,"CiU",16
8,"8198",4112,2766,2661,49,105,"CiU",1087
8,"8091",5106,3379,3312,59,67,"CiU",991
25,"25102",733,478,464,15,14,"CiU",225
8,"8253",134,91,91,2,0,"CiU",58
8,"8184",52133,33696,33220,656,476,"CiU",6215
8,"8075",3906,2442,2414,31,28,"CiU",798
8,"8138",4014,2735,2679,46,56,"CiU",1123
43,"43138",2719,1775,1730,45,45,"CiU",769
43,"43149",711,529,516,13,13,"CiU",156
8,"8195",88,64,64,2,0,"CiU",40
8,"8306",509,330,324,6,6,"CiU",146
8,"8010",4124,2674,2611,44,63,"CiU",1066
25,"25252",536,361,352,13,9,"CiU",172
43,"43055",2002,1404,1374,36,30,"CiU",508
8,"8039",365,264,260,5,4,"CiU",119
43,"43136",10163,6312,6197,121,115,"CiU",2000
25,"25903",261,176,170,9,6,"CiU",82
8,"8144",769,494,481,16,13,"CiU",206
25,"25249",207,151,150,4,1,"CiU",76
25,"25226",257,162,158,5,4,"CiU",69
43,"43902",2761,1836,1811,25,25,"CiU",463
25,"25134",657,421,416,4,5,"CiU",168
8,"8133",157,100,97,2,3,"CiU",60
25,"25023",4446,3079,3020,70,59,"CiU",1361
8,"8164",873,606,584,13,22,"CiU",258
25,"25081",332,212,206,6,6,"CiU",104
43,"43003",307,187,184,10,3,"CiU",55
25,"25024",370,221,217,8,4,"CiU",84
43,"43073",90,57,57,1,0,"CiU",34
25,"25052",1611,1094,1062,21,32,"CiU",547
43,"43157",388,282,270,10,12,"CiU",112
8,"8289",4123,2802,2768,54,34,"CiU",949
43,"43021",381,218,213,3,5,"CiU",59
8,"8223",1855,1178,1155,19,23,"CiU",503
43,"43031",1509,1016,992,20,24,"CiU",497
8,"8305",26208,17810,17506,296,304,"CiU",6219
43,"43053",190,149,149,2,0,"CiU",74
43,"43080",254,175,173,7,2,"CiU",71
8,"8190",281,201,197,3,4,"CiU",98
43,"43178",1262,891,870,24,21,"CiU",401
25,"25046",438,299,286,6,13,"CiU",118
43,"43067",626,445,431,21,14,"CiU",140
8,"8163",17986,11683,11548,159,135,"CiU",3080
43,"43123",70216,45627,44828,906,799,"CiU",13770
8,"8126",8299,5599,5508,103,91,"CiU",1524
25,"25036",190,138,134,5,4,"CiU",44
8,"8051",17397,12178,12002,240,176,"CiU",3883
43,"43040",350,251,246,18,5,"CiU",77
8,"8216",21,14,14,0,0,"CiU",4
25,"25200",353,225,217,4,8,"CiU",103
8,"8045",70,42,42,2,0,"CiU",23
25,"25167",253,176,172,0,4,"CiU",96
8,"8001",8538,5929,5838,120,91,"CiU",1111
8,"8276",249,188,187,9,1,"CiU",70
25,"25041",625,432,420,20,12,"CiU",171
8,"8080",42,33,33,2,0,"CiU",11
43,"43112",294,184,181,2,3,"CiU",72
25,"25112",286,202,199,11,3,"CiU",101
8,"8028",1049,667,657,15,10,"CiU",127
8,"8136",11117,7602,7478,174,124,"CiU",1296
8,"8167",5703,3896,3831,82,65,"CiU",906
25,"25201",119,78,76,3,2,"CiU",43
8,"8147",17023,11177,10961,184,216,"CiU",2869
25,"25055",187,115,115,3,0,"CiU",72
43,"43052",1001,669,636,12,33,"CiU",219
8,"8019",1143222,778246,767530,12386,10716,"CiU",212399
43,"43140",2393,1612,1583,23,29,"CiU",357
8,"8231",19810,12359,12196,244,163,"CiU",3159
43,"43906",2050,1332,1298,28,34,"CiU",554
8,"8292",1083,775,764,21,11,"CiU",232
8,"8243",160,112,110,3,2,"CiU",77
43,"43048",830,547,530,16,17,"CiU",128
43,"43006",712,484,475,10,9,"CiU",98
25,"25078",1014,730,719,17,11,"CiU",371
43,"43129",4525,3032,2956,62,76,"CiU",1497
25,"25089",107,66,64,0,2,"CiU",29
25,"25101",583,391,382,8,9,"CiU",166
25,"25172",1838,1267,1230,35,37,"CiU",559
8,"8057",61,41,40,1,1,"CiU",26
43,"43029",330,202,194,6,8,"CiU",58
43,"43125",1008,706,701,10,5,"CiU",263
43,"43068",573,388,378,5,10,"CiU",95
25,"25220",1076,711,702,10,9,"CiU",306
8,"8199",712,507,499,15,8,"CiU",237
43,"43038",20710,12999,12771,224,228,"CiU",3951
43,"43903",2368,1504,1492,22,12,"CiU",516
25,"25021",2693,1632,1605,40,27,"CiU",717
8,"8219",14647,10347,10169,193,178,"CiU",4209
25,"25114",102,82,78,4,4,"CiU",46
8,"8215",2594,1763,1728,51,35,"CiU",828
8,"8109",200,155,153,1,2,"CiU",66
25,"25146",227,150,149,0,1,"CiU",73
43,"43117",150,118,115,1,3,"CiU",59
25,"25063",97,65,64,2,1,"CiU",14
8,"8267",6215,4100,4011,82,89,"CiU",1169
25,"25022",119,83,83,0,0,"CiU",54
25,"25142",387,265,264,5,1,"CiU",119
8,"8245",78826,51185,50445,962,740,"CiU",5487
25,"25180",245,167,165,3,2,"CiU",97
8,"8257",116,84,81,0,3,"CiU",44
8,"8160",313,227,222,8,5,"CiU",123
25,"25255",468,318,309,9,9,"CiU",125
8,"8022",12437,7598,7445,169,153,"CiU",3273
8,"8264",3983,2773,2744,30,29,"CiU",1241
25,"25233",270,207,201,3,6,"CiU",89
43,"43091",142,106,98,5,8,"CiU",35
25,"25037",396,275,273,9,2,"CiU",129
25,"25186",231,168,168,3,0,"CiU",79
25,"25127",226,134,130,2,4,"CiU",74
25,"25001",146,76,76,1,0,"CiU",41
8,"8226",886,667,656,13,11,"CiU",347
8,"8024",409,266,260,4,6,"CiU",101
8,"8037",1830,1247,1209,40,38,"CiU",655
43,"43096",103,81,77,3,4,"CiU",47
43,"43170",880,601,592,9,9,"CiU",252
25,"25224",144,93,91,6,2,"CiU",50
25,"25058",4390,2696,2650,57,46,"CiU",1291
8,"8097",985,676,657,3,19,"CiU",289
25,"25032",71,44,42,1,2,"CiU",13
25,"25238",231,158,156,1,2,"CiU",72
8,"8192",5450,3688,3634,79,54,"CiU",1634
43,"43128",927,636,625,11,11,"CiU",252
25,"25128",151,83,81,1,2,"CiU",51
43,"43124",532,366,358,3,8,"CiU",161
8,"8196",18989,12658,12490,253,168,"CiU",2062
25,"25153",215,165,161,0,4,"CiU",50
8,"8146",1321,876,862,18,14,"CiU",227
8,"8031",2289,1619,1599,34,20,"CiU",681
25,"25228",2907,2043,2021,43,22,"CiU",922
25,"25155",714,490,485,8,5,"CiU",247
25,"25182",1075,749,731,30,18,"CiU",206
8,"8092",3928,2511,2473,33,38,"CiU",1030
43,"43044",3990,2768,2715,72,53,"CiU",631
43,"43907",4122,2759,2712,52,47,"CiU",521
8,"8066",1315,985,965,16,20,"CiU",287
25,"25110",2662,1649,1602,44,47,"CiU",672
8,"8032",1955,1330,1294,18,36,"CiU",582
8,"8074",10224,6571,6479,116,92,"CiU",1578
25,"25111",116,70,70,0,0,"CiU",38
8,"8280",116,74,72,3,2,"CiU",41
43,"43131",4495,2842,2814,51,28,"CiU",757
25,"25126",286,192,189,7,3,"CiU",83
8,"8178",450,311,304,3,7,"CiU",143
25,"25093",657,465,455,8,10,"CiU",237
8,"8206",717,557,547,7,10,"CiU",240
25,"25085",153,103,100,2,3,"CiU",44
25,"25006",362,231,228,2,3,"CiU",86
25,"25098",266,177,177,0,0,"CiU",112
8,"8042",2172,1459,1448,30,11,"CiU",433
8,"8269",2613,1840,1814,32,26,"CiU",1000
43,"43904",2918,1779,1732,49,47,"CiU",594
8,"8014",1906,1338,1313,37,25,"CiU",632
25,"25173",1784,1177,1139,20,38,"CiU",410
25,"25192",799,543,527,19,16,"CiU",259
43,"43089",272,193,185,1,8,"CiU",57
25,"25181",189,128,123,3,5,"CiU",65
25,"25059",796,580,575,9,5,"CiU",129
8,"8182",2802,1871,1852,35,19,"CiU",390
43,"43150",1337,994,977,12,17,"CiU",395
43,"43063",588,358,350,13,8,"CiU",127
8,"8287",1053,738,730,26,8,"CiU",363
25,"25073",662,382,379,11,3,"CiU",205
8,"8290",1446,1075,1056,12,19,"CiU",430
25,"25076",165,84,83,3,1,"CiU",29
43,"43037",16656,9986,9812,163,174,"CiU",2653
43,"43070",265,198,196,3,2,"CiU",57
8,"8282",6092,4478,4405,79,73,"CiU",1745
43,"43090",1142,644,636,7,8,"CiU",101
43,"43163",24903,15475,15241,263,234,"CiU",3808
25,"25103",125,82,80,4,2,"CiU",39
8,"8116",600,401,393,9,8,"CiU",228
25,"25206",289,187,184,3,3,"CiU",100
43,"43168",106,70,69,2,1,"CiU",30
8,"8062",863,595,583,8,12,"CiU",227
8,"8221",11348,8413,8306,109,107,"CiU",3006
25,"25025",1307,874,859,32,15,"CiU",327
25,"25215",399,229,226,4,3,"CiU",85
8,"8049",1340,839,816,10,23,"CiU",434
8,"8124",36292,24541,24210,471,331,"CiU",4831
25,"25230",1665,1164,1140,36,24,"CiU",487
43,"43035",280,202,198,0,4,"CiU",124
25,"25163",237,147,142,2,5,"CiU",85
25,"25189",2085,1348,1327,38,21,"CiU",534
8,"8185",189,131,126,1,5,"CiU",71
8,"8284",11920,7059,6942,139,117,"CiU",2498
25,"25056",289,168,163,3,5,"CiU",97
43,"43122",92,65,61,0,4,"CiU",33
8,"8035",12099,7838,7735,123,103,"CiU",2931
25,"25088",100,74,74,0,0,"CiU",65
8,"8105",9642,6571,6483,110,88,"CiU",903
25,"25232",1480,968,959,38,9,"CiU",369
25,"25240",1398,976,958,17,18,"CiU",407
8,"8197",7316,4983,4926,69,57,"CiU",2073
25,"25069",471,291,289,9,2,"CiU",134
25,"25136",106,79,79,1,0,"CiU",47
8,"8115",3870,2693,2644,60,49,"CiU",731
25,"25003",3853,2367,2340,68,27,"CiU",990
25,"25015",394,264,264,14,0,"CiU",122
8,"8246",1714,1175,1153,27,22,"CiU",659
25,"25190",271,180,176,12,4,"CiU",74
8,"8061",1467,960,952,10,8,"CiU",315
43,"43059",264,185,185,4,0,"CiU",101
8,"8249",273,218,214,4,4,"CiU",115
25,"25166",177,127,125,3,2,"CiU",55
25,"25217",10570,6660,6500,191,160,"CiU",2776
43,"43081",574,415,404,13,11,"CiU",203
8,"8054",8733,6215,6077,123,138,"CiU",1621
8,"8256",669,498,496,16,2,"CiU",183
25,"25045",51,33,33,2,0,"CiU",14
43,"43098",362,251,247,1,4,"CiU",120
8,"8157",8256,5729,5624,119,105,"CiU",1503
8,"8142",127,83,83,4,0,"CiU",47
25,"25035",428,289,284,5,5,"CiU",121
43,"43171",13906,8978,8855,167,123,"CiU",2407
8,"8250",7083,4485,4426,72,59,"CiU",888
8,"8125",24559,16065,15798,293,267,"CiU",2909
43,"43155",22951,14114,13856,326,258,"CiU",4450
43,"43905",13621,8120,8011,131,109,"CiU",1784
25,"25099",1185,720,709,9,11,"CiU",392
25,"25165",301,202,198,6,4,"CiU",116
8,"8259",6362,4482,4420,97,62,"CiU",1694
8,"8149",985,683,671,11,12,"CiU",336
43,"43092",7051,4294,4220,45,74,"CiU",1166
25,"25034",2471,1622,1592,25,30,"CiU",766
8,"8205",54870,41064,40491,682,573,"CiU",16228
25,"25105",146,90,89,1,1,"CiU",44
25,"25113",1227,869,856,28,13,"CiU",376
43,"43046",114,80,79,5,1,"CiU",36
8,"8286",2865,1843,1796,30,47,"CiU",558
25,"25140",785,472,460,5,12,"CiU",236
43,"43135",327,243,238,2,5,"CiU",150
8,"8058",1699,1089,1061,25,28,"CiU",299
43,"43060",3049,2030,1980,62,50,"CiU",516
8,"8299",444,277,267,5,10,"CiU",133
25,"25122",1956,1281,1256,33,25,"CiU",538
43,"43016",3437,2323,2266,40,57,"CiU",607
8,"8013",1234,834,820,23,14,"CiU",335
43,"43049",805,555,536,6,19,"CiU",270
43,"43101",146,94,93,3,1,"CiU",40
43,"43113",454,321,316,10,5,"CiU",149
43,"43165",624,471,459,6,12,"CiU",250
43,"43102",517,377,366,2,11,"CiU",164
43,"43074",1697,1150,1120,25,30,"CiU",464
8,"8273",2287,1594,1547,18,47,"CiU",761
8,"8119",6039,3991,3884,74,107,"CiU",1057
8,"8008",193,119,114,5,5,"CiU",43
25,"25156",761,535,529,15,6,"CiU",265
43,"43051",8749,5494,5411,78,83,"CiU",1100
43,"43057",45,27,27,2,0,"CiU",12
25,"25906",235,160,154,3,6,"CiU",58
8,"8212",508,366,363,1,3,"CiU",214
8,"8065",1224,796,778,13,18,"CiU",411
8,"8103",636,453,446,16,7,"CiU",208
25,"25062",806,515,497,11,18,"CiU",232
25,"25030",147,101,95,3,6,"CiU",55
43,"43106",878,600,592,17,8,"CiU",183
25,"25072",5921,3743,3637,81,106,"CiU",1490
8,"8059",323,189,186,9,3,"CiU",92
8,"8034",741,542,529,4,13,"CiU",265
8,"8135",6647,4753,4678,79,75,"CiU",842
8,"8260",17869,11898,11686,215,212,"CiU",2337
8,"8208",5471,3859,3792,82,67,"CiU",987
43,"43075",102,63,63,1,0,"CiU",43
43,"43120",454,287,283,1,4,"CiU",76
25,"25149",1401,1031,1010,17,21,"CiU",582
8,"8112",12946,8533,8390,227,143,"CiU",3377
8,"8102",27850,18716,18470,373,246,"CiU",7858
25,"25905",386,264,258,12,6,"CiU",140
8,"8188",106,87,86,4,1,"CiU",41
8,"8079",335,255,243,14,12,"CiU",108
25,"25137",8404,5264,5167,112,97,"CiU",2439
25,"25176",341,243,240,7,3,"CiU",115
43,"43018",430,350,337,7,13,"CiU",187
8,"8901",249,180,180,2,0,"CiU",118
43,"43002",1790,1252,1226,17,26,"CiU",396
43,"43043",3065,1952,1919,39,33,"CiU",539
8,"8279",149233,101676,100363,1965,1313,"CiU",25816
25,"25118",378,232,226,4,6,"CiU",138
43,"43045",156,110,109,1,1,"CiU",56
43,"43026",800,531,522,15,9,"CiU",181
25,"25096",988,633,613,12,20,"CiU",252
8,"8218",7968,5014,4932,129,82,"CiU",1666
25,"25082",265,156,155,8,1,"CiU",76
10,"10109",1834,1307,1287,18,20,"CEx",5
10,"10040",455,344,334,8,10,"CEx",0
10,"10203",4770,3397,3327,40,70,"CEx",4
10,"10122",253,197,191,2,6,"CEx",0
6,"6094",1508,1130,1119,6,11,"CEx",2
6,"6153",20332,15398,15216,239,182,"CEx",57
6,"6127",2922,2306,2279,27,27,"CEx",1
10,"10149",434,323,319,1,4,"CEx",0
6,"6124",1750,1418,1378,17,40,"CEx",1
10,"10013",305,242,237,1,5,"CEx",0
6,"6159",2341,1522,1510,8,12,"CEx",0
10,"10086",342,259,250,5,9,"CEx",1
10,"10044",1520,1120,1103,10,17,"CEx",0
10,"10176",384,300,293,5,7,"CEx",0
10,"10054",551,435,428,6,7,"CEx",2
10,"10157",289,218,212,1,6,"CEx",1
6,"6067",2030,1583,1572,16,11,"CEx",2
6,"6062",638,493,492,3,1,"CEx",0
10,"10185",587,457,450,1,7,"CEx",0
6,"6108",2355,1773,1746,24,27,"CEx",3
10,"10017",884,681,673,6,8,"CEx",0
10,"10166",351,246,238,2,8,"CEx",0
6,"6063",3079,2467,2454,16,13,"CEx",2
6,"6025",5083,3898,3851,51,47,"CEx",6
6,"6016",3013,2363,2306,31,57,"CEx",1
10,"10902",727,608,599,5,9,"CEx",0
6,"6078",548,457,453,2,4,"CEx",0
6,"6128",4466,3310,3264,50,46,"CEx",5
10,"10217",535,423,422,3,1,"CEx",0
6,"6017",292,250,250,0,0,"CEx",0
10,"10009",285,223,221,0,2,"CEx",0
6,"6055",2105,1623,1599,13,24,"CEx",1
10,"10126",1660,1221,1201,9,20,"CEx",3
10,"10194",557,449,440,0,9,"CEx",1
6,"6137",1035,848,842,2,6,"CEx",2
10,"10113",2440,1891,1859,11,32,"CEx",10
10,"10148",32554,23348,22955,365,393,"CEx",63
10,"10180",5446,3957,3917,28,40,"CEx",4
10,"10162",616,505,496,1,9,"CEx",1
10,"10058",994,751,738,13,13,"CEx",2
6,"6148",991,826,818,9,8,"CEx",1
10,"10034",376,283,278,5,5,"CEx",0
10,"10095",346,290,283,3,7,"CEx",0
6,"6032",76,59,59,1,0,"CEx",0
10,"10081",183,143,142,0,1,"CEx",0
6,"6112",411,330,326,0,4,"CEx",0
6,"6037",1789,1258,1252,6,6,"CEx",1
10,"10047",978,795,780,9,15,"CEx",1
6,"6046",1288,1050,1042,11,8,"CEx",0
6,"6138",1070,838,829,13,9,"CEx",0
6,"6123",4699,3509,3448,54,61,"CEx",10
10,"10193",1410,1179,1158,16,21,"CEx",4
10,"10167",322,265,264,1,1,"CEx",0
6,"6162",2964,2415,2390,19,25,"CEx",2
6,"6006",4664,3435,3367,50,68,"CEx",6
6,"6086",1270,956,949,2,7,"CEx",2
10,"10039",448,352,350,0,2,"CEx",1
10,"10082",1947,1601,1572,10,29,"CEx",1
6,"6099",1127,815,805,6,10,"CEx",1
6,"6107",1610,1131,1128,6,3,"CEx",1
6,"6098",537,436,435,6,1,"CEx",0
10,"10154",194,150,145,0,5,"CEx",0
6,"6028",4366,3881,3809,35,72,"CEx",1
10,"10027",88,78,78,0,0,"CEx",0
10,"10202",665,533,523,7,10,"CEx",0
10,"10901",1148,844,839,18,5,"CEx",2
6,"6158",13094,9945,9753,131,192,"CEx",20
6,"6093",4599,3658,3612,22,46,"CEx",4
10,"10215",437,338,333,3,5,"CEx",0
10,"10147",1263,1003,965,5,38,"CEx",0
10,"10076",825,619,610,7,9,"CEx",0
6,"6015",116077,82756,81836,989,920,"CEx",146
6,"6082",373,315,311,3,4,"CEx",27
10,"10035",1941,1517,1492,15,25,"CEx",12
6,"6106",447,335,333,7,2,"CEx",0
10,"10003",616,463,458,3,5,"CEx",0
10,"10207",499,394,392,1,2,"CEx",0
6,"6001",730,546,538,4,8,"CEx",0
10,"10066",182,136,133,1,3,"CEx",0
10,"10216",1549,1247,1235,15,12,"CEx",1
10,"10088",244,168,168,0,0,"CEx",1
10,"10209",297,217,213,3,4,"CEx",0
10,"10053",303,253,246,5,7,"CEx",0
10,"10121",8063,6048,5988,51,60,"CEx",14
6,"6076",854,639,631,9,8,"CEx",0
10,"10107",1062,832,821,7,11,"CEx",0
6,"6092",592,468,456,5,12,"CEx",2
6,"6133",1744,1343,1328,22,15,"CEx",0
6,"6052",3965,3176,3134,33,42,"CEx",1
6,"6143",3308,2625,2595,24,30,"CEx",0
6,"6047",878,686,680,5,6,"CEx",0
6,"6113",2750,2143,2105,26,38,"CEx",1
6,"6109",4006,3435,3372,21,63,"CEx",2
6,"6010",1144,903,898,6,5,"CEx",0
6,"6030",171,132,131,0,1,"CEx",0
10,"10116",3762,2781,2705,36,76,"CEx",5
6,"6156",1190,989,978,9,11,"CEx",1
10,"10016",321,266,262,2,4,"CEx",2
10,"10171",376,287,282,0,5,"CEx",0
6,"6902",1688,1325,1313,21,12,"CEx",0
10,"10099",633,458,450,4,8,"CEx",0
10,"10153",331,266,263,1,3,"CEx",0
10,"10085",334,244,243,1,1,"CEx",0
10,"10139",117,98,97,1,1,"CEx",0
10,"10067",10392,7979,7804,111,175,"CEx",13
10,"10108",231,152,152,0,0,"CEx",1
10,"10212",1688,1276,1242,16,34,"CEx",2
6,"6114",152,122,122,0,0,"CEx",0
10,"10190",569,438,435,6,3,"CEx",0
10,"10090",552,404,396,3,8,"CEx",3
10,"10026",598,458,447,5,11,"CEx",6
10,"10002",396,317,314,5,3,"CEx",0
10,"10038",98,84,83,0,1,"CEx",0
6,"6144",588,476,464,2,12,"CEx",1
10,"10004",733,576,565,6,11,"CEx",0
6,"6021",971,761,747,6,14,"CEx",0
6,"6142",284,240,235,4,5,"CEx",0
10,"10179",340,262,257,3,5,"CEx",0
10,"10189",2728,2108,2063,24,45,"CEx",5
10,"10114",926,670,652,8,18,"CEx",0
6,"6040",1032,807,807,11,0,"CEx",0
10,"10128",5805,4456,4336,50,120,"CEx",10
10,"10160",235,183,183,1,0,"CEx",0
10,"10142",822,635,625,4,10,"CEx",0
10,"10012",615,525,520,4,5,"CEx",0
10,"10049",3952,3348,3259,36,89,"CEx",7
10,"10006",1306,1081,1070,7,11,"CEx",1
10,"10211",461,341,334,3,7,"CEx",0
10,"10165",274,231,229,0,2,"CEx",0
10,"10170",269,217,215,4,2,"CEx",0
6,"6117",1471,1155,1130,8,25,"CEx",1
6,"6160",3190,2343,2314,12,29,"CEx",0
6,"6146",1188,951,936,8,15,"CEx",0
6,"6077",373,307,304,4,3,"CEx",0
6,"6054",5468,4305,4185,35,120,"CEx",3
10,"10135",1366,1004,998,3,6,"CEx",0
6,"6031",490,387,385,8,2,"CEx",0
10,"10060",1037,758,742,9,16,"CEx",0
10,"10080",385,294,287,0,7,"CEx",0
6,"6058",2048,1595,1574,22,21,"CEx",4
6,"6057",575,481,474,2,7,"CEx",1
6,"6087",2258,1855,1832,24,23,"CEx",0
10,"10077",719,551,543,3,8,"CEx",0
10,"10057",166,133,133,0,0,"CEx",0
10,"10043",866,636,622,1,14,"CEx",0
10,"10089",1399,1043,1032,15,11,"CEx",4
10,"10903",813,620,615,3,5,"CEx",1
10,"10103",480,385,380,3,5,"CEx",0
10,"10032",1768,1438,1415,9,23,"CEx",0
6,"6008",636,561,552,6,9,"CEx",0
10,"10094",247,212,211,0,1,"CEx",0
10,"10052",186,138,138,0,0,"CEx",1
10,"10206",237,177,174,0,3,"CEx",0
6,"6091",3854,2961,2906,33,55,"CEx",3
6,"6011",24301,17977,17819,268,158,"CEx",41
10,"10065",188,123,123,1,0,"CEx",0
10,"10102",534,447,440,4,7,"CEx",1
10,"10087",1754,1283,1262,4,21,"CEx",0
10,"10059",414,352,349,4,3,"CEx",0
10,"10115",3622,2872,2800,52,72,"CEx",3
6,"6005",1699,1332,1320,19,12,"CEx",0
6,"6026",865,671,665,4,6,"CEx",0
6,"6147",390,321,319,3,2,"CEx",1
10,"10093",413,339,332,2,7,"CEx",0
6,"6045",513,418,412,8,6,"CEx",0
10,"10175",1509,1149,1127,4,22,"CEx",2
10,"10062",421,332,325,3,7,"CEx",12
10,"10134",585,420,412,1,8,"CEx",1
10,"10158",367,307,306,3,1,"CEx",0
10,"10112",1582,1299,1284,5,15,"CEx",0
6,"6901",2113,1729,1706,26,23,"CEx",5
6,"6102",1045,851,840,7,11,"CEx",0
10,"10030",502,364,362,5,2,"CEx",0
10,"10123",601,502,492,0,10,"CEx",0
6,"6084",1105,932,917,5,15,"CEx",0
10,"10168",318,240,238,1,2,"CEx",0
6,"6115",1261,893,885,7,8,"CEx",0
10,"10073",759,589,583,3,6,"CEx",0
6,"6131",1037,871,865,8,6,"CEx",0
6,"6061",1116,1000,989,8,11,"CEx",0
10,"10131",12797,9017,8922,131,95,"CEx",18
10,"10025",408,355,337,4,18,"CEx",0
6,"6007",1557,1200,1189,4,11,"CEx",0
6,"6049",1088,847,829,3,18,"CEx",1
6,"6066",1798,1348,1340,7,8,"CEx",0
6,"6088",12879,9362,9222,153,140,"CEx",21
10,"10111",1453,1052,1046,13,6,"CEx",2
6,"6080",1942,1519,1507,9,12,"CEx",2
6,"6152",1327,983,967,8,16,"CEx",2
10,"10161",76,59,59,1,0,"CEx",0
10,"10033",440,340,336,4,4,"CEx",0
6,"6072",2370,1907,1885,9,22,"CEx",2
10,"10048",299,232,231,0,1,"CEx",1
10,"10125",925,705,689,3,16,"CEx",0
10,"10184",771,609,597,7,12,"CEx",2
6,"6022",2719,2274,2245,14,29,"CEx",1
10,"10169",587,460,450,2,10,"CEx",0
10,"10072",892,663,655,3,8,"CEx",1
10,"10151",245,204,202,2,2,"CEx",0
6,"6081",1114,870,865,10,5,"CEx",1
10,"10192",910,679,670,3,9,"CEx",1
10,"10018",1761,1321,1296,17,25,"CEx",2
10,"10005",551,439,424,4,15,"CEx",2
6,"6145",929,746,743,5,3,"CEx",1
6,"6121",3436,2700,2662,35,38,"CEx",6
6,"6136",1621,1300,1283,11,17,"CEx",1
10,"10130",1745,1360,1341,10,19,"CEx",1
6,"6060",5865,4657,4592,67,65,"CEx",2
6,"6103",4777,3702,3671,31,31,"CEx",5
10,"10104",5233,3904,3824,30,80,"CEx",5
10,"10029",447,362,355,1,7,"CEx",0
10,"10007",680,537,519,5,18,"CEx",0
10,"10181",739,607,598,6,9,"CEx",1
10,"10031",189,158,158,1,0,"CEx",1
10,"10143",169,135,131,1,4,"CEx",0
10,"10196",309,244,244,1,0,"CEx",1
10,"10219",1408,984,971,11,13,"CEx",0
6,"6023",4572,3301,3261,34,40,"CEx",1
6,"6122",6620,4904,4797,44,107,"CEx",8
10,"10064",1549,1229,1209,6,20,"CEx",2
10,"10199",181,142,140,1,2,"CEx",1
6,"6157",497,350,343,0,7,"CEx",0
10,"10210",599,453,452,3,1,"CEx",0
10,"10024",663,490,480,3,10,"CEx",2
10,"10117",264,174,174,2,0,"CEx",1
10,"10097",109,97,96,0,1,"CEx",0
6,"6126",2199,1706,1686,14,20,"CEx",1
6,"6051",1606,1314,1302,10,12,"CEx",0
10,"10172",728,531,522,3,9,"CEx",0
10,"10068",780,624,595,5,29,"CEx",1
10,"10011",611,527,519,5,8,"CEx",0
10,"10208",141,118,118,1,0,"CEx",0
10,"10174",177,145,145,2,0,"CEx",0
6,"6085",3437,2566,2530,32,36,"CEx",2
10,"10022",442,377,370,1,7,"CEx",0
10,"10021",5421,4189,4099,47,90,"CEx",6
6,"6042",1017,824,820,5,4,"CEx",0
6,"6050",4277,3500,3457,36,43,"CEx",3
10,"10098",412,317,313,5,4,"CEx",0
6,"6097",2475,1934,1902,27,32,"CEx",1
6,"6038",816,621,620,6,1,"CEx",0
10,"10070",765,614,613,5,1,"CEx",0
6,"6132",876,656,648,2,8,"CEx",0
10,"10127",4663,3554,3498,38,56,"CEx",8
6,"6161",335,261,259,2,2,"CEx",1
10,"10129",374,279,276,2,3,"CEx",0
6,"6043",661,542,532,3,10,"CEx",2
10,"10124",873,707,707,16,0,"CEx",2
10,"10201",202,173,171,3,2,"CEx",0
10,"10138",551,451,443,7,8,"CEx",0
6,"6036",5228,4075,4028,22,47,"CEx",3
10,"10042",79,63,62,2,1,"CEx",0
10,"10197",143,96,94,1,2,"CEx",0
10,"10177",1692,1351,1318,15,33,"CEx",2
6,"6111",502,389,387,8,2,"CEx",0
6,"6083",45013,31929,31491,527,438,"CEx",43
10,"10183",1022,818,805,5,13,"CEx",6
6,"6053",642,466,454,4,12,"CEx",0
10,"10079",891,711,706,6,5,"CEx",2
6,"6151",1109,850,846,6,4,"CEx",2
6,"6018",808,608,598,5,10,"CEx",0
6,"6027",732,655,645,8,10,"CEx",0
10,"10205",2081,1486,1457,19,29,"CEx",0
6,"6118",228,181,181,1,0,"CEx",3
6,"6096",254,202,201,0,1,"CEx",0
10,"10191",527,421,414,3,7,"CEx",1
10,"10055",709,523,508,13,15,"CEx",0
10,"10063",175,142,142,1,0,"CEx",0
10,"10120",168,122,119,1,3,"CEx",0
6,"6129",631,493,490,2,3,"CEx",1
10,"10178",797,604,597,5,7,"CEx",3
10,"10214",226,178,176,2,2,"CEx",0
10,"10045",1119,884,859,5,25,"CEx",1
6,"6013",283,245,244,1,1,"CEx",0
10,"10213",605,478,477,1,1,"CEx",1
10,"10008",1393,1105,1086,10,19,"CEx",2
10,"10152",499,424,418,4,6,"CEx",0
6,"6056",487,411,411,1,0,"CEx",1
10,"10084",1416,994,972,12,22,"CEx",0
6,"6004",1607,1317,1309,10,8,"CEx",1
6,"6075",517,433,429,3,4,"CEx",0
10,"10071",179,133,133,1,0,"CEx",0
10,"10056",605,484,476,5,8,"CEx",0
6,"6069",3116,2316,2288,46,28,"CEx",4
6,"6150",860,722,710,2,12,"CEx",0
10,"10075",276,189,189,1,0,"CEx",0
6,"6068",481,383,378,3,5,"CEx",0
10,"10188",553,473,468,2,5,"CEx",0
10,"10141",289,209,209,0,0,"CEx",0
6,"6020",1852,1476,1462,5,14,"CEx",2
10,"10164",770,557,547,2,10,"CEx",0
10,"10106",144,123,123,4,0,"CEx",0
10,"10050",1208,1003,983,8,20,"CEx",1
6,"6140",654,533,523,7,10,"CEx",0
6,"6064",900,715,706,2,9,"CEx",2
10,"10091",391,327,324,3,3,"CEx",0
6,"6035",1048,879,871,5,8,"CEx",0
6,"6071",257,236,230,1,6,"CEx",1
6,"6024",1215,1015,1006,4,9,"CEx",0
6,"6101",489,397,395,5,2,"CEx",0
10,"10105",2599,1869,1835,25,34,"CEx",4
10,"10118",306,262,261,2,1,"CEx",1
10,"10144",999,782,773,7,9,"CEx",2
6,"6125",1852,1419,1399,11,20,"CEx",0
6,"6073",787,563,552,9,11,"CEx",0
10,"10119",714,489,482,3,7,"CEx",1
6,"6044",28321,21143,20931,232,212,"CEx",28
10,"10146",1439,991,975,11,16,"CEx",1
6,"6002",4321,3272,3195,32,77,"CEx",4
6,"6059",1959,1476,1466,8,10,"CEx",3
10,"10019",1414,1054,1037,10,17,"CEx",1
10,"10051",489,373,373,2,0,"CEx",1
10,"10159",341,278,277,1,1,"CEx",0
6,"6039",1848,1564,1546,13,18,"CEx",0
10,"10182",146,112,108,0,4,"CEx",0
6,"6141",1803,1419,1397,23,22,"CEx",0
6,"6104",701,588,584,12,4,"CEx",0
6,"6029",1230,884,880,5,4,"CEx",0
10,"10132",420,293,287,1,6,"CEx",0
10,"10200",499,368,368,0,0,"CEx",0
10,"10010",2358,1597,1576,18,21,"CEx",0
10,"10061",1765,1305,1290,13,15,"CEx",5
6,"6041",459,406,404,4,2,"CEx",0
6,"6009",214,178,178,2,0,"CEx",0
6,"6119",680,539,534,3,5,"CEx",0
10,"10187",486,349,345,2,4,"CEx",1
10,"10037",74974,56844,55950,898,894,"CEx",161
6,"6033",1387,1075,1068,6,7,"CEx",0
6,"6139",600,489,481,5,8,"CEx",0
10,"10101",172,134,129,1,5,"CEx",0
10,"10163",374,310,308,0,2,"CEx",0
6,"6135",1094,898,890,14,8,"CEx",0
10,"10136",289,229,228,0,1,"CEx",1
6,"6154",2830,2108,2080,38,28,"CEx",0
10,"10218",1184,896,893,0,3,"CEx",0
10,"10198",1213,1068,1054,12,14,"CEx",0
10,"10140",1143,941,927,9,14,"CEx",0
6,"6116",1680,1331,1317,15,14,"CEx",0
10,"10046",216,185,184,1,1,"CEx",0
6,"6130",216,182,180,0,2,"CEx",0
6,"6105",655,450,448,1,2,"CEx",0
6,"6014",6843,4894,4839,30,55,"CEx",3
10,"10137",428,373,371,1,2,"CEx",0
10,"10014",1907,1507,1488,14,19,"CEx",3
10,"10195",7917,6143,6054,36,89,"CEx",6
10,"10096",3384,2581,2533,32,48,"CEx",6
6,"6149",10390,8354,8215,111,139,"CEx",3
10,"10133",1247,1045,1028,7,17,"CEx",0
10,"10078",451,349,341,3,8,"CEx",0
10,"10015",688,539,523,5,16,"CEx",1
6,"6134",561,399,398,5,1,"CEx",0
6,"6090",904,724,710,10,14,"CEx",1
10,"10036",345,262,251,2,11,"CEx",1
6,"6012",3263,2498,2476,31,22,"CEx",0
6,"6089",607,530,529,2,1,"CEx",0
10,"10156",116,91,91,0,0,"CEx",0
6,"6100",1000,828,821,3,7,"CEx",0
6,"6074",4777,3730,3659,41,71,"CEx",13
10,"10110",2326,1751,1703,11,48,"CEx",1
10,"10186",1031,906,896,8,10,"CEx",0
6,"6155",1911,1384,1363,18,21,"CEx",1
10,"10100",792,554,538,1,16,"CEx",0
10,"10020",1671,1386,1374,14,12,"CEx",2
10,"10155",1156,829,819,4,10,"CEx",5
6,"6048",879,758,740,4,18,"CEx",1
6,"6110",176,130,124,0,6,"CEx",0
10,"10083",105,74,74,0,0,"CEx",0
10,"10204",489,364,351,3,13,"CEx",1
6,"6019",2111,1621,1596,24,25,"CEx",0
6,"6095",9330,6974,6873,129,101,"CEx",3
6,"6070",7805,6083,6001,76,82,"CEx",9
10,"10173",557,436,431,6,5,"CEx",2
10,"10069",858,680,673,2,7,"CEx",2
10,"10028",125,88,88,0,0,"CEx",0
6,"6120",3508,2772,2741,31,31,"CEx",3
10,"10041",1070,850,846,8,4,"CEx",0
6,"6003",875,705,691,4,14,"CEx",0
10,"10092",316,263,262,1,1,"CEx",0
10,"10023",854,688,682,9,6,"CEx",2
6,"6079",623,525,522,6,3,"CEx",1
10,"10145",132,112,111,0,1,"CEx",0
6,"6034",190,134,129,3,5,"CEx",0
10,"10001",270,231,229,2,2,"CEx",0
6,"6065",327,262,259,2,3,"CEx",0
10,"10150",374,331,328,2,3,"CEx",1
15,"15059",10658,7889,7728,125,161,"C.XXI",17
36,"36055",13678,10508,10288,155,220,"C.XXI",95
15,"15004",4891,3595,3545,61,50,"C.XXI",3
15,"15022",6102,4207,4164,52,43,"C.XXI",1
15,"15031",22951,16018,15696,382,322,"C.XXI",8
27,"27054",1332,1063,1054,12,9,"C.XXI",1
27,"27013",3950,3156,3090,39,66,"C.XXI",3
15,"15025",1173,780,777,10,3,"C.XXI",0
27,"27023",2770,2196,2178,30,18,"C.XXI",1
36,"36044",2595,1862,1834,23,28,"C.XXI",1
36,"36049",6608,5189,5097,56,92,"C.XXI",6
27,"27052",966,726,718,9,8,"C.XXI",0
15,"15033",2581,2094,2079,15,15,"C.XXI",20
15,"15005",23875,15132,14895,356,237,"C.XXI",6
36,"36020",2581,1947,1922,27,25,"C.XXI",0
15,"15092",6869,4965,4907,53,58,"C.XXI",0
27,"27058",3908,2946,2915,28,31,"C.XXI",1
15,"15075",12042,8639,8486,147,153,"C.XXI",0
15,"15009",11109,8179,8014,129,165,"C.XXI",2
15,"15056",5873,4205,4150,63,55,"C.XXI",4
27,"27008",1458,1130,1115,18,15,"C.XXI",0
15,"15081",1139,869,853,9,16,"C.XXI",0
15,"15026",2025,1426,1413,17,13,"C.XXI",0
27,"27038",1035,817,809,9,8,"C.XXI",0
15,"15006",5539,3940,3866,53,74,"C.XXI",2
27,"27037",1205,857,845,13,12,"C.XXI",0
36,"36058",5021,3589,3516,54,73,"C.XXI",0
15,"15050",1971,1110,1097,27,13,"C.XXI",0
15,"15079",1709,1268,1253,14,15,"C.XXI",0
27,"27059",2320,1783,1763,25,20,"C.XXI",0
27,"27012",1519,886,880,6,6,"C.XXI",0
15,"15060",5599,4139,4069,82,70,"C.XXI",3
36,"36017",18554,13573,13378,200,195,"C.XXI",21
27,"27007",3015,2426,2374,42,52,"C.XXI",0
27,"27005",2792,2101,2076,21,25,"C.XXI",1
27,"27011",2663,1822,1785,23,37,"C.XXI",1
15,"15093",4562,3314,3270,37,44,"C.XXI",2
36,"36051",14288,10228,10079,124,149,"C.XXI",4
15,"15088",3769,2626,2599,21,27,"C.XXI",0
36,"36053",5677,4204,4157,51,47,"C.XXI",3
27,"27027",2111,1652,1605,21,47,"C.XXI",1
27,"27003",2064,1531,1516,19,15,"C.XXI",0
27,"27047",1851,1293,1273,16,20,"C.XXI",0
15,"15083",1198,874,855,8,19,"C.XXI",3
27,"27001",2582,1687,1669,31,18,"C.XXI",0
15,"15085",3576,2656,2612,29,44,"C.XXI",2
36,"36002",3154,2381,2358,35,23,"C.XXI",0
27,"27043",1422,988,962,10,26,"C.XXI",0
27,"27048",2404,1939,1909,36,30,"C.XXI",3
15,"15027",1537,1263,1242,22,21,"C.XXI",1
27,"27020",3807,3204,3161,33,43,"C.XXI",2
15,"15074",4254,3246,3219,35,27,"C.XXI",2
36,"36007",1778,1258,1238,2,20,"C.XXI",0
36,"36009",5138,3147,3108,24,39,"C.XXI",2
15,"15064",2356,1859,1824,35,35,"C.XXI",1
27,"27044",3089,2167,2125,31,42,"C.XXI",2
15,"15076",2766,1971,1936,18,35,"C.XXI",2
27,"27062",681,535,532,7,3,"C.XXI",0
15,"15058",26931,19505,19196,471,309,"C.XXI",6
27,"27064",1706,1233,1214,14,19,"C.XXI",1
36,"36050",7602,5424,5339,50,85,"C.XXI",6
15,"15053",8164,5679,5592,60,87,"C.XXI",0
15,"15011",15507,10935,10751,123,184,"C.XXI",3
36,"36031",572,484,479,5,5,"C.XXI",0
36,"36022",9203,6423,6226,100,197,"C.XXI",1
15,"15049",1211,851,843,7,8,"C.XXI",1
36,"36018",3492,2516,2494,25,22,"C.XXI",1
15,"15012",3767,2973,2926,51,47,"C.XXI",0
15,"15069",7019,5036,4938,85,98,"C.XXI",2
15,"15015",2840,2006,1964,43,42,"C.XXI",2
15,"15065",7570,5710,5628,71,82,"C.XXI",6
36,"36023",8522,6206,6062,64,144,"C.XXI",2
36,"36024",17164,12723,12500,163,223,"C.XXI",10
27,"27039",4363,3410,3346,63,64,"C.XXI",1
15,"15067",8142,6054,5978,73,76,"C.XXI",0
15,"15032",3639,2642,2586,35,56,"C.XXI",1
15,"15018",1211,821,805,11,16,"C.XXI",0
36,"36028",4207,3294,3254,21,40,"C.XXI",1
27,"27066",12908,9554,9329,171,225,"C.XXI",51
15,"15029",6266,4668,4618,49,50,"C.XXI",2
15,"15036",60838,40345,39667,915,678,"C.XXI",13
36,"36010",2987,2312,2282,30,30,"C.XXI",0
27,"27046",1626,1177,1153,17,24,"C.XXI",5
36,"36016",1373,865,853,7,12,"C.XXI",0
15,"15008",5657,4224,4157,62,67,"C.XXI",0
36,"36039",14581,11007,10782,167,225,"C.XXI",2
15,"15089",4354,3255,3216,55,39,"C.XXI",1
15,"15044",1436,1083,1068,10,15,"C.XXI",2
36,"36901",4085,3285,3235,21,50,"C.XXI",0
36,"36034",3684,2686,2651,32,35,"C.XXI",1
36,"36048",5416,4045,3971,55,74,"C.XXI",1
27,"27063",1916,1469,1440,14,29,"C.XXI",2
15,"15087",6054,4004,3956,79,48,"C.XXI",2
15,"15078",78092,56506,55597,1110,909,"C.XXI",86
36,"36005",8231,5985,5873,84,112,"C.XXI",6
36,"36054",10862,8201,8087,87,114,"C.XXI",6
27,"27053",606,429,426,4,3,"C.XXI",0
15,"15068",5404,3780,3725,53,55,"C.XXI",1
15,"15003",1936,1400,1382,19,18,"C.XXI",0
36,"36033",12323,9328,9150,97,178,"C.XXI",6
36,"36029",16178,11902,11636,148,266,"C.XXI",4
36,"36059",5438,3874,3805,47,69,"C.XXI",9
27,"27021",1936,1295,1271,19,24,"C.XXI",4
27,"27024",1759,1346,1324,17,22,"C.XXI",0
27,"27045",1149,817,812,7,5,"C.XXI",0
15,"15051",4780,3333,3289,61,44,"C.XXI",1
36,"36006",11387,8911,8727,72,184,"C.XXI",5
15,"15071",8233,5751,5668,93,83,"C.XXI",1
36,"36011",1939,1189,1172,15,17,"C.XXI",1
36,"36025",2442,1531,1516,10,15,"C.XXI",2
36,"36035",14551,10675,10469,160,206,"C.XXI",11
15,"15073",21991,14686,14456,216,230,"C.XXI",12
36,"36043",5188,3435,3390,35,45,"C.XXI",1
15,"15017",18860,12975,12737,325,238,"C.XXI",6
15,"15055",4780,3247,3181,70,66,"C.XXI",1
15,"15070",9684,6627,6464,141,163,"C.XXI",6
27,"27016",7521,5439,5338,83,101,"C.XXI",4
15,"15062",6304,4418,4356,44,62,"C.XXI",0
27,"27057",11297,8174,8005,162,169,"C.XXI",19
36,"36014",2145,1568,1548,9,20,"C.XXI",1
27,"27040",3421,2718,2693,27,25,"C.XXI",1
27,"27006",2789,1949,1911,22,38,"C.XXI",3
36,"36003",9876,7155,7007,100,148,"C.XXI",2
15,"15014",4239,3151,3104,39,47,"C.XXI",0
36,"36061",8729,6747,6640,68,107,"C.XXI",6
15,"15045",4178,2743,2727,22,16,"C.XXI",9
15,"15010",2009,1468,1441,24,27,"C.XXI",1
15,"15037",4181,2839,2804,25,35,"C.XXI",1
15,"15084",3681,2676,2656,34,20,"C.XXI",1
15,"15039",1374,1027,998,27,29,"C.XXI",0
36,"36001",3138,2060,2049,13,11,"C.XXI",2
36,"36015",4379,3151,3101,38,50,"C.XXI",3
15,"15063",2849,2022,2001,28,21,"C.XXI",1
15,"15090",1267,959,953,4,6,"C.XXI",1
15,"15019",26096,18466,18187,350,279,"C.XXI",7
36,"36036",2616,1981,1948,24,33,"C.XXI",3
15,"15021",5114,3527,3475,77,52,"C.XXI",21
27,"27026",2605,1785,1751,19,34,"C.XXI",1
36,"36030",4387,3206,3177,35,29,"C.XXI",2
27,"27065",13035,9432,9254,168,178,"C.XXI",9
15,"15020",4187,2802,2781,18,21,"C.XXI",0
15,"15066",4180,3098,3062,38,36,"C.XXI",2
36,"36040",2627,1938,1907,24,31,"C.XXI",0
15,"15086",3110,2281,2259,30,22,"C.XXI",3
36,"36013",2690,1801,1778,11,23,"C.XXI",21
36,"36012",3839,2884,2825,14,59,"C.XXI",3
27,"27056",1388,1043,1026,16,17,"C.XXI",0
27,"27009",2354,1812,1782,19,30,"C.XXI",1
36,"36004",10264,7383,7263,80,120,"C.XXI",6
15,"15047",2606,1789,1761,33,28,"C.XXI",3
15,"15028",1485,1130,1118,14,12,"C.XXI",3
15,"15024",4726,3634,3555,51,79,"C.XXI",3
27,"27033",723,536,529,10,7,"C.XXI",0
27,"27051",8224,6048,5953,108,95,"C.XXI",2
15,"15901",3855,2463,2419,48,44,"C.XXI",4
36,"36042",17897,12635,12437,157,198,"C.XXI",4
27,"27025",3005,2414,2377,25,37,"C.XXI",1
15,"15002",21528,15479,15218,314,261,"C.XXI",16
15,"15077",8677,6349,6269,82,80,"C.XXI",4
36,"36021",11798,8742,8574,136,168,"C.XXI",4
36,"36047",2723,1875,1853,27,22,"C.XXI",2
36,"36045",24724,17794,17459,237,335,"C.XXI",15
36,"36032",3666,2789,2755,25,34,"C.XXI",1
15,"15052",4567,3539,3493,22,46,"C.XXI",0
27,"27032",3466,2565,2530,40,35,"C.XXI",3
27,"27042",1888,1427,1407,12,20,"C.XXI",0
27,"27018",3871,2523,2489,32,34,"C.XXI",0
27,"27029",1525,1243,1221,18,22,"C.XXI",1
27,"27050",3236,2475,2438,11,37,"C.XXI",3
27,"27902",7198,5074,4976,106,98,"C.XXI",3
27,"27041",2644,1946,1915,29,31,"C.XXI",0
27,"27014",3511,2470,2437,45,33,"C.XXI",0
15,"15054",32172,20472,20154,519,318,"C.XXI",13
27,"27010",4725,3427,3368,55,59,"C.XXI",4
15,"15061",6105,4391,4307,64,84,"C.XXI",0
15,"15057",12467,8936,8744,102,192,"C.XXI",2
36,"36056",5087,3883,3830,37,53,"C.XXI",1
15,"15080",1913,1407,1389,15,18,"C.XXI",1
15,"15043",5491,4033,3971,45,62,"C.XXI",1
15,"15038",2363,1643,1610,29,33,"C.XXI",0
15,"15040",2891,2160,2129,18,31,"C.XXI",1
15,"15007",3702,2670,2642,19,28,"C.XXI",0
27,"27004",1379,981,966,4,15,"C.XXI",1
27,"27022",5093,3535,3486,74,49,"C.XXI",3
27,"27901",2559,1847,1831,27,16,"C.XXI",1
15,"15034",3116,2146,2114,20,32,"C.XXI",2
15,"15030",201751,141022,138934,2981,2088,"C.XXI",122
36,"36057",236900,168990,166060,2833,2930,"C.XXI",129
15,"15001",4985,3560,3506,63,54,"C.XXI",3
27,"27002",1835,1455,1437,16,18,"C.XXI",0
36,"36038",65661,47940,47214,836,726,"C.XXI",37
27,"27019",8247,6146,6022,101,124,"C.XXI",6
27,"27055",1494,1120,1107,8,13,"C.XXI",2
27,"27015",4587,3465,3409,55,56,"C.XXI",2
15,"15023",6629,4879,4795,52,84,"C.XXI",0
27,"27060",2938,2063,2028,26,35,"C.XXI",2
27,"27034",1297,871,867,3,4,"C.XXI",0
36,"36026",20494,14048,13798,232,250,"C.XXI",9
27,"27030",3744,2587,2525,32,62,"C.XXI",1
15,"15035",11969,8239,8120,192,119,"C.XXI",5
36,"36027",4478,3376,3339,29,37,"C.XXI",2
36,"36019",1681,1204,1188,14,16,"C.XXI",0
27,"27028",78862,57097,55890,1246,1207,"C.XXI",79
27,"27031",16169,11446,11214,194,232,"C.XXI",11
15,"15042",3249,2341,2303,25,38,"C.XXI",0
15,"15013",6160,4229,4165,70,64,"C.XXI",2
15,"15048",4769,3470,3415,57,55,"C.XXI",2
15,"15072",9868,7077,6951,79,126,"C.XXI",4
36,"36060",30264,21398,21051,344,347,"C.XXI",7
15,"15046",6949,4641,4539,56,102,"C.XXI",3
36,"36052",7517,5563,5461,54,102,"C.XXI",6
15,"15091",1171,839,829,9,10,"C.XXI",0
27,"27049",1554,1073,1062,6,11,"C.XXI",0
36,"36046",4093,3175,3120,31,55,"C.XXI",2
15,"15082",15075,11217,11046,187,171,"C.XXI",6
15,"15016",5135,3816,3771,22,45,"C.XXI",0
27,"27017",1138,789,787,6,2,"C.XXI",0
27,"27035",194,119,119,0,0,"C.XXI",0
36,"36041",13141,9405,9238,114,167,"C.XXI",8
36,"36037",2727,1923,1896,18,27,"C.XXI",0
36,"36008",21702,15366,15037,261,329,"C.XXI",20
15,"15041",9718,7514,7425,102,89,"C.XXI",3
27,"27061",1170,917,906,8,11,"C.XXI",0
32,"32069",4573,3624,3580,35,44,"CXXI",1
32,"32016",1021,781,776,2,5,"CXXI",0
32,"32056",1861,1378,1369,8,9,"CXXI",0
32,"32007",1674,1263,1243,4,20,"CXXI",0
32,"32020",2958,2300,2283,19,17,"CXXI",3
32,"32060",885,650,641,10,9,"CXXI",0
32,"32041",884,576,568,2,8,"CXXI",1
32,"32053",1500,1206,1199,19,7,"CXXI",1
32,"32081",2240,1698,1682,13,16,"CXXI",5
32,"32028",1805,1369,1354,16,15,"CXXI",2
32,"32052",2126,1690,1673,28,17,"CXXI",1
32,"32021",1043,793,788,7,5,"CXXI",0
32,"32035",1632,1100,1088,8,12,"CXXI",7
32,"32064",561,439,437,5,2,"CXXI",0
32,"32074",1180,892,876,11,16,"CXXI",1
32,"32005",957,760,753,8,7,"CXXI",0
32,"32049",863,566,563,7,3,"CXXI",0
32,"32092",596,367,364,2,3,"CXXI",0
32,"32085",10730,7588,7475,100,113,"CXXI",4
32,"32008",7618,5529,5433,83,96,"CXXI",6
32,"32032",8284,6295,6198,84,97,"CXXI",18
32,"32076",2358,1835,1823,18,12,"CXXI",0
32,"32078",1366,1026,1018,3,8,"CXXI",0
32,"32082",1403,1055,1047,9,8,"CXXI",0
32,"32023",1360,1030,1011,6,19,"CXXI",0
32,"32026",2775,2096,2064,37,32,"CXXI",2
32,"32015",995,697,694,9,3,"CXXI",0
32,"32080",394,311,309,3,2,"CXXI",0
32,"32055",1412,1056,1037,5,19,"CXXI",0
32,"32065",720,550,539,3,11,"CXXI",0
32,"32062",963,735,729,10,6,"CXXI",1
32,"32013",2464,1695,1671,10,24,"CXXI",0
32,"32025",1218,954,941,12,13,"CXXI",0
32,"32048",1004,687,671,48,16,"CXXI",0
32,"32024",5054,3668,3609,40,59,"CXXI",1
32,"32079",1448,1103,1094,14,9,"CXXI",3
32,"32083",960,675,672,0,3,"CXXI",1
32,"32090",834,662,657,4,5,"CXXI",0
32,"32084",1084,818,805,0,13,"CXXI",2
32,"32033",843,595,583,7,12,"CXXI",0
32,"32050",2663,1991,1974,17,17,"CXXI",1
32,"32051",1574,1296,1290,7,6,"CXXI",0
32,"32009",10752,7778,7684,120,94,"CXXI",4
32,"32091",1971,1472,1466,12,6,"CXXI",0
32,"32012",912,763,756,8,7,"CXXI",1
32,"32044",939,774,764,8,10,"CXXI",0
32,"32054",87289,63027,61875,1263,1152,"CXXI",74
32,"32017",1333,906,895,10,11,"CXXI",0
32,"32004",2071,1145,1142,7,3,"CXXI",1
32,"32040",1587,1226,1219,7,7,"CXXI",3
32,"32059",1983,1526,1510,27,16,"CXXI",1
32,"32047",2003,1595,1575,10,20,"CXXI",3
32,"32058",5253,3872,3821,57,51,"CXXI",4
32,"32019",11469,8297,8180,134,117,"CXXI",3
32,"32018",1351,1100,1092,9,8,"CXXI",1
32,"32088",1749,1232,1217,10,15,"CXXI",2
32,"32037",828,660,654,10,6,"CXXI",0
32,"32029",557,426,424,1,2,"CXXI",0
32,"32057",608,475,473,4,2,"CXXI",1
32,"32089",1480,1063,1045,7,18,"CXXI",0
32,"32077",1234,999,993,23,6,"CXXI",0
32,"32039",1424,1084,1069,10,15,"CXXI",0
32,"32002",2060,1566,1551,13,15,"CXXI",2
32,"32071",1614,1121,1112,4,9,"CXXI",0
32,"32063",2127,1469,1444,22,25,"CXXI",0
32,"32011",1026,660,650,4,10,"CXXI",0
32,"32045",2640,1999,1980,23,19,"CXXI",0
32,"32086",2874,2026,2003,18,23,"CXXI",1
32,"32006",1814,1344,1330,20,14,"CXXI",0
32,"32046",1375,976,962,3,14,"CXXI",1
32,"32003",950,736,727,3,9,"CXXI",1
32,"32061",1196,976,973,4,3,"CXXI",0
32,"32038",497,360,358,2,2,"CXXI",0
32,"32087",1935,1609,1591,11,18,"CXXI",2
32,"32075",3839,2957,2910,51,47,"CXXI",2
32,"32067",1487,1004,995,10,9,"CXXI",2
32,"32030",1120,857,846,9,11,"CXXI",0
32,"32073",1415,1111,1100,8,11,"CXXI",0
32,"32072",3949,2881,2841,32,40,"CXXI",3
32,"32070",660,457,452,1,5,"CXXI",0
32,"32036",1528,1217,1202,13,15,"CXXI",0
32,"32027",1156,850,836,15,14,"CXXI",0
32,"32010",457,362,356,0,6,"CXXI",0
32,"32022",1591,1219,1207,9,12,"CXXI",8
32,"32042",1784,1292,1282,13,10,"CXXI",0
32,"32034",1228,995,990,5,5,"CXXI",0
32,"32066",634,492,488,0,4,"CXXI",0
32,"32014",1271,939,925,9,14,"CXXI",0
32,"32068",1631,1187,1174,4,13,"CXXI",0
32,"32043",2679,2006,1985,14,21,"CXXI",0
32,"32001",4938,3715,3667,50,48,"CXXI",1
32,"32031",1079,837,828,5,9,"CXXI",1
47,"47020",283,237,232,5,5,"D.N.",0
47,"47003",263,224,222,1,2,"D.N.",0
4,"4083",1933,1511,1497,16,14,"D.N.",1
42,"42177",78,64,62,4,2,"D.N.",0
42,"42108",13,10,10,1,0,"D.N.",0
19,"19179",109,77,75,3,2,"D.N.",0
47,"47164",391,326,320,3,6,"D.N.",0
42,"42044",62,47,46,0,1,"D.N.",0
42,"42038",42,32,31,3,1,"D.N.",0
21,"21060",11685,8026,7932,135,94,"D.N.",8
47,"47218",983,776,767,7,9,"D.N.",2
42,"42075",91,71,70,1,1,"D.N.",0
4,"4002",1146,891,884,1,7,"D.N.",1
42,"42058",129,103,101,1,2,"D.N.",0
47,"47099",174,153,153,4,0,"D.N.",1
4,"4072",339,272,271,0,1,"D.N.",0
19,"19230",438,317,309,4,8,"D.N.",2
4,"4024",3049,2396,2361,19,35,"D.N.",14
47,"47073",141,118,116,1,2,"D.N.",0
47,"47227",62,52,52,1,0,"D.N.",0
42,"42068",99,74,74,5,0,"D.N.",0
47,"47044",325,257,252,1,5,"D.N.",1
42,"42086",40,25,25,1,0,"D.N.",0
47,"47207",325,265,263,4,2,"D.N.",0
47,"47210",396,324,321,5,3,"D.N.",1
47,"47082",816,664,661,10,3,"D.N.",0
19,"19226",40,31,30,0,1,"D.N.",0
47,"47061",266,227,223,0,4,"D.N.",0
47,"47199",84,61,60,1,1,"D.N.",0
21,"21072",10233,7829,7666,124,163,"D.N.",5
4,"4004",458,367,364,6,3,"D.N.",0
19,"19200",150,105,105,1,0,"D.N.",0
47,"47134",186,155,149,2,6,"D.N.",0
19,"19197",29,19,19,0,0,"D.N.",0
4,"4047",2290,1956,1937,9,19,"D.N.",0
42,"42036",52,40,39,2,1,"D.N.",0
42,"42165",424,291,280,6,11,"D.N.",0
47,"47064",30,21,21,1,0,"D.N.",0
47,"47029",61,54,53,0,1,"D.N.",0
19,"19138",298,223,219,3,4,"D.N.",0
19,"19286",743,566,554,8,12,"D.N.",0
19,"19064",97,84,83,1,1,"D.N.",0
4,"4061",668,541,536,7,5,"D.N.",0
47,"47034",90,65,63,0,2,"D.N.",0
4,"4091",380,322,318,3,4,"D.N.",0
42,"42141",124,90,87,1,3,"D.N.",0
4,"4902",42901,28927,28711,338,216,"D.N.",57
19,"19013",143,110,108,1,2,"D.N.",0
19,"19209",50,40,39,0,1,"D.N.",0
19,"19023",121,95,94,5,1,"D.N.",0
19,"19105",2235,1709,1686,23,23,"D.N.",6
47,"47165",7036,5328,5258,67,70,"D.N.",1
47,"47038",128,91,91,0,0,"D.N.",0
42,"42174",188,142,138,5,4,"D.N.",0
19,"19109",53,40,40,1,0,"D.N.",0
47,"47229",235,161,161,1,0,"D.N.",0
4,"4036",246,205,204,1,1,"D.N.",0
47,"47175",6562,5041,4957,62,84,"D.N.",6
47,"47022",62,54,54,0,0,"D.N.",0
47,"47173",862,683,675,5,8,"D.N.",1
4,"4058",402,324,322,5,2,"D.N.",0
42,"42215",821,561,545,19,16,"D.N.",1
47,"47135",93,77,76,0,1,"D.N.",0
19,"19048",18,12,11,1,1,"D.N.",0
19,"19033",79,55,55,0,0,"D.N.",0
42,"42211",92,69,68,0,1,"D.N.",1
19,"19255",95,68,68,0,0,"D.N.",0
42,"42145",140,111,111,2,0,"D.N.",1
19,"19213",72,60,60,1,0,"D.N.",0
21,"21025",3969,2731,2686,33,45,"D.N.",2
19,"19244",95,82,82,6,0,"D.N.",0
21,"21077",1690,1335,1321,8,14,"D.N.",0
19,"19202",16,14,14,0,0,"D.N.",0
19,"19099",337,211,210,6,1,"D.N.",0
47,"47035",956,778,768,5,10,"D.N.",0
19,"19058",6455,5028,4933,63,95,"D.N.",9
47,"47192",99,84,84,0,0,"D.N.",0
42,"42015",34,24,24,5,0,"D.N.",0
4,"4013",137455,94867,94142,1203,725,"D.N.",204
42,"42029",164,114,113,1,1,"D.N.",0
21,"21009",916,622,608,6,14,"D.N.",0
4,"4012",230,195,195,2,0,"D.N.",1
42,"42144",464,343,331,3,12,"D.N.",1
21,"21042",15246,8640,8572,154,68,"D.N.",9
19,"19040",73,42,42,1,0,"D.N.",0
42,"42090",96,75,74,3,1,"D.N.",0
47,"47153",135,94,93,1,1,"D.N.",0
4,"4019",269,210,209,3,1,"D.N.",0
42,"42116",63,50,48,3,2,"D.N.",0
19,"19175",39,31,31,0,0,"D.N.",0
21,"21022",173,123,123,1,0,"D.N.",0
4,"4094",206,152,152,0,0,"D.N.",0
42,"42049",141,83,81,1,2,"D.N.",0
19,"19301",47,38,38,0,0,"D.N.",1
47,"47138",259,198,195,3,3,"D.N.",0
19,"19225",879,625,618,9,7,"D.N.",8
42,"42089",54,44,44,3,0,"D.N.",0
4,"4001",1139,890,884,6,6,"D.N.",2
19,"19240",64,47,46,1,1,"D.N.",0
19,"19174",126,88,86,0,2,"D.N.",0
19,"19311",87,60,60,0,0,"D.N.",0
19,"19046",20318,15118,14892,219,226,"D.N.",120
19,"19152",674,505,498,2,7,"D.N.",0
19,"19220",2225,1482,1456,7,26,"D.N.",6
42,"42070",45,29,28,0,1,"D.N.",0
42,"42198",24,17,17,0,0,"D.N.",0
19,"19261",42,31,31,1,0,"D.N.",0
19,"19165",51,43,42,0,1,"D.N.",0
47,"47119",101,78,77,0,1,"D.N.",0
19,"19291",1271,925,902,3,23,"D.N.",9
42,"42188",64,51,51,0,0,"D.N.",0
19,"19223",129,94,90,1,4,"D.N.",0
42,"42121",77,56,56,1,0,"D.N.",0
19,"19159",108,91,88,1,3,"D.N.",0
19,"19106",95,68,66,0,2,"D.N.",0
21,"21026",255,181,169,2,12,"D.N.",0
21,"21035",9657,6943,6871,64,72,"D.N.",5
42,"42100",31,31,31,0,0,"D.N.",0
42,"42054",20,14,14,0,0,"D.N.",0
47,"47113",166,136,135,1,1,"D.N.",0
4,"4080",194,169,168,1,1,"D.N.",0
21,"21063",2624,2109,2097,13,12,"D.N.",1
19,"19216",143,112,105,2,7,"D.N.",0
47,"47226",180,152,148,1,4,"D.N.",0
19,"19329",62,52,50,0,2,"D.N.",0
4,"4097",299,229,227,0,2,"D.N.",0
19,"19118",17,13,13,0,0,"D.N.",0
42,"42115",72,48,48,0,0,"D.N.",0
19,"19271",53,45,45,1,0,"D.N.",0
42,"42082",9,9,9,0,0,"D.N.",0
4,"4029",10682,7542,7474,63,68,"D.N.",7
47,"47140",132,109,108,1,1,"D.N.",0
19,"19195",41,30,30,1,0,"D.N.",0
19,"19268",34,26,25,0,1,"D.N.",0
4,"4050",818,611,602,5,9,"D.N.",1
47,"47093",865,658,642,11,16,"D.N.",0
19,"19264",45,39,39,0,0,"D.N.",0
42,"42028",62,45,43,2,2,"D.N.",0
47,"47110",471,386,378,6,8,"D.N.",0
42,"42037",38,23,20,3,3,"D.N.",0
47,"47224",92,77,77,0,0,"D.N.",0
19,"19196",99,80,74,2,6,"D.N.",0
42,"42031",31,19,19,0,0,"D.N.",0
19,"19087",22,16,16,0,0,"D.N.",0
47,"47162",80,62,62,1,0,"D.N.",0
47,"47050",3557,2688,2651,50,37,"D.N.",5
47,"47105",210,181,179,1,2,"D.N.",0
47,"47188",125,112,109,3,3,"D.N.",0
42,"42073",84,53,53,0,0,"D.N.",0
47,"47152",94,65,65,0,0,"D.N.",0
19,"19047",87,71,70,2,1,"D.N.",0
4,"4901",576,427,426,5,1,"D.N.",1
42,"42043",3905,2931,2875,48,56,"D.N.",4
42,"42052",17,10,10,0,0,"D.N.",0
42,"42156",30,21,21,0,0,"D.N.",0
42,"42053",27,26,25,1,1,"D.N.",0
19,"19186",93,77,77,0,0,"D.N.",0
47,"47115",306,248,248,2,0,"D.N.",0
19,"19121",277,219,217,0,2,"D.N.",0
19,"19303",56,48,47,1,1,"D.N.",1
21,"21075",375,294,291,12,3,"D.N.",0
19,"19126",1552,1140,1119,16,21,"D.N.",10
42,"42098",14,8,8,0,0,"D.N.",0
19,"19278",30,28,28,0,0,"D.N.",0
21,"21039",313,233,232,2,1,"D.N.",0
19,"19335",77,61,61,1,0,"D.N.",0
47,"47070",33,30,30,1,0,"D.N.",0
47,"47018",33,30,28,2,2,"D.N.",0
21,"21051",272,202,201,5,1,"D.N.",0
47,"47060",262,220,218,1,2,"D.N.",0
47,"47046",124,105,103,0,2,"D.N.",0
47,"47017",205,177,176,1,1,"D.N.",0
4,"4102",12940,9247,9152,90,95,"D.N.",19
4,"4006",7156,5175,5106,51,69,"D.N.",2
47,"47032",161,130,129,3,1,"D.N.",0
4,"4028",239,212,207,0,5,"D.N.",0
19,"19095",14,9,8,0,1,"D.N.",0
47,"47154",168,144,144,7,0,"D.N.",0
4,"4064",2585,1817,1803,18,14,"D.N.",0
19,"19053",2172,1602,1587,14,15,"D.N.",4
21,"21041",114169,74740,73814,1129,926,"D.N.",141
47,"47126",49,43,42,1,1,"D.N.",0
19,"19251",41,35,34,0,1,"D.N.",0
19,"19257",3595,2593,2543,48,50,"D.N.",5
4,"4085",453,384,383,0,1,"D.N.",1
19,"19181",69,54,54,5,0,"D.N.",0
4,"4008",530,423,418,4,5,"D.N.",1
42,"42117",146,115,111,1,4,"D.N.",0
47,"47196",43,29,29,0,0,"D.N.",0
21,"21029",1633,1276,1259,15,17,"D.N.",1
19,"19017",87,70,70,0,0,"D.N.",0
19,"19299",94,75,75,0,0,"D.N.",0
47,"47055",212,169,168,3,1,"D.N.",0
47,"47179",408,315,306,6,9,"D.N.",0
4,"4015",149,115,115,0,0,"D.N.",0
19,"19061",76,57,55,3,2,"D.N.",0
19,"19298",75,53,52,2,1,"D.N.",0
42,"42009",97,69,67,2,2,"D.N.",1
47,"47008",26,17,17,0,0,"D.N.",0
47,"47185",97,76,75,1,1,"D.N.",0
19,"19057",79,56,56,0,0,"D.N.",0
4,"4032",5476,3666,3643,34,23,"D.N.",5
19,"19016",74,50,49,0,1,"D.N.",0
19,"19008",34,25,25,1,0,"D.N.",0
19,"19037",153,128,128,0,0,"D.N.",1
47,"47039",196,163,163,1,0,"D.N.",0
47,"47141",148,121,119,1,2,"D.N.",1
19,"19153",25,17,17,0,0,"D.N.",0
19,"19334",50,37,37,0,0,"D.N.",0
47,"47048",204,168,167,2,1,"D.N.",0
4,"4017",1337,965,960,7,5,"D.N.",2
21,"21016",1076,823,790,11,33,"D.N.",0
47,"47056",90,69,69,2,0,"D.N.",0
47,"47097",345,291,289,7,2,"D.N.",1
19,"19323",50,41,39,0,2,"D.N.",0
19,"19297",34,29,29,0,0,"D.N.",0
47,"47212",386,327,325,1,2,"D.N.",4
19,"19031",18,11,11,0,0,"D.N.",0
4,"4079",45851,31893,31644,430,249,"D.N.",55
47,"47181",170,128,128,1,0,"D.N.",0
19,"19219",18,12,12,0,0,"D.N.",0
42,"42171",158,99,94,3,5,"D.N.",0
42,"42125",73,65,64,4,1,"D.N.",0
19,"19019",23,18,18,0,0,"D.N.",0
4,"4063",1199,871,862,6,9,"D.N.",0
19,"19129",48,33,31,0,2,"D.N.",0
47,"47063",107,87,87,2,0,"D.N.",0
47,"47143",146,108,107,0,1,"D.N.",0
19,"19183",108,87,86,1,1,"D.N.",0
47,"47216",124,99,98,2,1,"D.N.",0
4,"4031",2495,1942,1931,13,11,"D.N.",2
47,"47005",578,467,455,5,12,"D.N.",1
42,"42041",36,25,25,4,0,"D.N.",0
42,"42209",155,114,110,2,4,"D.N.",0
47,"47002",30,27,27,1,0,"D.N.",0
21,"21066",522,440,431,4,9,"D.N.",0
19,"19036",279,238,236,1,2,"D.N.",0
19,"19325",127,105,102,4,3,"D.N.",0
21,"21076",2108,1647,1628,22,19,"D.N.",0
19,"19262",184,137,136,0,1,"D.N.",0
47,"47067",198,159,156,5,3,"D.N.",0
19,"19148",56,41,38,1,3,"D.N.",0
47,"47021",84,61,61,2,0,"D.N.",0
47,"47187",101,82,81,1,1,"D.N.",0
42,"42120",148,91,91,4,0,"D.N.",0
42,"42193",17,10,10,0,0,"D.N.",0
47,"47019",93,69,68,0,1,"D.N.",0
19,"19043",92,82,82,1,0,"D.N.",0
47,"47083",80,61,59,3,2,"D.N.",0
47,"47161",3886,3133,3105,45,28,"D.N.",4
19,"19078",58,49,48,0,1,"D.N.",0
19,"19246",48,38,38,1,0,"D.N.",0
19,"19170",214,139,138,0,1,"D.N.",0
42,"42181",453,357,347,7,10,"D.N.",2
42,"42110",82,58,58,2,0,"D.N.",3
47,"47155",3043,2246,2225,35,21,"D.N.",3
19,"19193",30,29,29,1,0,"D.N.",1
42,"42167",305,223,222,3,1,"D.N.",0
21,"21048",327,226,226,5,0,"D.N.",0
42,"42197",90,71,71,0,0,"D.N.",1
19,"19156",1032,782,762,4,20,"D.N.",0
19,"19215",206,170,166,0,4,"D.N.",0
42,"42003",76,54,51,0,3,"D.N.",0
42,"42093",56,39,38,0,1,"D.N.",0
21,"21011",3531,2672,2639,15,33,"D.N.",1
42,"42182",62,53,53,2,0,"D.N.",0
47,"47158",906,716,710,10,6,"D.N.",0
47,"47186",251279,193705,191693,2746,2012,"D.N.",259
19,"19002",99,77,76,0,1,"D.N.",0
4,"4100",7918,5465,5425,52,40,"D.N.",6
47,"47189",164,134,134,1,0,"D.N.",0
21,"21008",2717,1994,1978,11,16,"D.N.",0
19,"19290",872,622,613,7,9,"D.N.",3
42,"42013",45,35,34,1,1,"D.N.",0
42,"42158",112,79,79,6,0,"D.N.",0
42,"42219",45,33,33,1,0,"D.N.",0
4,"4067",657,526,524,1,2,"D.N.",0
47,"47088",121,100,100,0,0,"D.N.",0
21,"21073",1840,1249,1236,13,13,"D.N.",1
4,"4054",384,328,325,0,3,"D.N.",0
47,"47043",330,267,264,1,3,"D.N.",0
19,"19090",107,87,86,0,1,"D.N.",0
19,"19020",52,39,39,3,0,"D.N.",0
19,"19168",324,233,231,6,2,"D.N.",1
19,"19289",33,28,28,1,0,"D.N.",0
19,"19192",1743,1370,1359,10,11,"D.N.",0
19,"19272",86,67,65,1,2,"D.N.",0
42,"42213",31,24,24,2,0,"D.N.",0
47,"47163",315,253,250,2,3,"D.N.",1
19,"19222",120,90,89,3,1,"D.N.",1
4,"4092",2897,2351,2325,13,26,"D.N.",5
19,"19280",3415,2521,2490,27,31,"D.N.",20
19,"19267",22,15,15,0,0,"D.N.",0
47,"47183",150,125,122,0,3,"D.N.",0
42,"42081",158,131,131,3,0,"D.N.",0
19,"19150",128,112,108,0,4,"D.N.",0
19,"19241",45,37,37,2,0,"D.N.",0
4,"4003",17244,11933,11840,94,93,"D.N.",11
4,"4052",11567,8189,8124,158,65,"D.N.",20
19,"19185",40,21,19,0,2,"D.N.",0
4,"4020",361,265,263,1,2,"D.N.",0
19,"19147",58,45,40,0,5,"D.N.",1
4,"4070",1649,1267,1255,9,12,"D.N.",1
19,"19211",450,340,334,0,6,"D.N.",0
19,"19163",73,59,59,0,0,"D.N.",0
42,"42218",86,59,59,0,0,"D.N.",0
19,"19001",64,56,56,1,0,"D.N.",0
47,"47128",57,52,48,1,4,"D.N.",0
47,"47069",128,108,108,0,0,"D.N.",1
42,"42045",345,238,234,2,4,"D.N.",0
4,"4086",1903,1376,1371,11,5,"D.N.",1
19,"19073",24,20,19,0,1,"D.N.",0
21,"21014",4063,3424,3408,27,16,"D.N.",3
4,"4038",3140,2258,2231,44,27,"D.N.",1
19,"19080",90,64,64,0,0,"D.N.",0
42,"42175",28,19,19,0,0,"D.N.",0
47,"47193",1538,1229,1211,23,18,"D.N.",0
47,"47085",16967,12618,12472,208,146,"D.N.",17
19,"19250",25,23,22,0,1,"D.N.",0
4,"4068",187,137,137,1,0,"D.N.",1
19,"19248",64,53,53,0,0,"D.N.",0
19,"19038",48,33,33,0,0,"D.N.",0
47,"47124",435,364,358,5,6,"D.N.",0
47,"47091",97,82,80,3,2,"D.N.",0
19,"19331",2497,1898,1847,19,51,"D.N.",3
19,"19187",64,54,54,0,0,"D.N.",0
19,"19096",99,79,78,1,1,"D.N.",0
19,"19145",64,49,48,2,1,"D.N.",0
19,"19111",180,147,146,0,1,"D.N.",0
19,"19042",41,32,32,0,0,"D.N.",0
47,"47220",194,143,142,4,1,"D.N.",0
47,"47225",89,67,66,0,1,"D.N.",0
4,"4062",4604,3711,3654,22,57,"D.N.",0
19,"19034",23,23,23,1,0,"D.N.",0
19,"19314",46,41,41,0,0,"D.N.",0
19,"19139",32,23,23,0,0,"D.N.",0
42,"42155",188,121,120,0,1,"D.N.",0
19,"19184",88,63,62,1,1,"D.N.",0
42,"42119",192,124,123,0,1,"D.N.",0
47,"47071",406,333,329,6,4,"D.N.",1
47,"47045",839,636,632,3,4,"D.N.",1
19,"19116",16,10,10,0,0,"D.N.",0
47,"47075",4999,4020,3957,39,63,"D.N.",7
47,"47203",69,57,56,0,1,"D.N.",0
47,"47089",184,139,138,1,1,"D.N.",0
42,"42176",30,22,22,0,0,"D.N.",1
4,"4049",4981,3652,3630,34,22,"D.N.",5
19,"19235",121,92,87,0,5,"D.N.",0
47,"47095",41,36,36,3,0,"D.N.",0
21,"21001",628,434,428,5,6,"D.N.",1
47,"47232",107,77,75,1,2,"D.N.",0
47,"47178",190,162,161,1,1,"D.N.",0
19,"19199",24,21,21,0,0,"D.N.",0
47,"47076",16922,13030,12899,212,131,"D.N.",14
47,"47098",607,496,492,9,4,"D.N.",3
4,"4009",165,124,122,2,2,"D.N.",0
4,"4090",435,338,335,3,3,"D.N.",0
21,"21046",1715,1354,1343,15,11,"D.N.",3
21,"21043",1898,1382,1350,9,32,"D.N.",0
42,"42096",316,218,215,9,3,"D.N.",0
42,"42173",28809,20268,19748,632,520,"D.N.",110
42,"42103",626,487,481,3,6,"D.N.",0
19,"19233",108,93,90,2,3,"D.N.",0
4,"4087",198,162,159,2,3,"D.N.",0
21,"21036",213,172,167,1,5,"D.N.",0
21,"21023",2106,1471,1456,7,15,"D.N.",1
21,"21057",1054,699,697,9,2,"D.N.",0
47,"47057",237,198,198,3,0,"D.N.",1
19,"19065",126,100,100,3,0,"D.N.",0
21,"21037",491,386,378,1,8,"D.N.",0
42,"42123",172,128,128,3,0,"D.N.",1
47,"47030",1075,822,801,13,21,"D.N.",1
42,"42105",54,45,45,0,0,"D.N.",1
19,"19110",73,59,57,4,2,"D.N.",0
42,"42195",112,74,72,1,2,"D.N.",0
42,"42129",706,523,509,14,14,"D.N.",1
42,"42060",33,22,22,0,0,"D.N.",0
42,"42113",553,412,404,7,8,"D.N.",0
47,"47081",57,44,44,1,0,"D.N.",0
21,"21010",14308,8960,8861,154,99,"D.N.",9
4,"4074",2731,1959,1936,26,23,"D.N.",2
47,"47065",898,762,752,9,10,"D.N.",0
4,"4011",2814,2283,2263,25,20,"D.N.",0
19,"19114",40,34,34,0,0,"D.N.",0
42,"42032",186,143,141,2,2,"D.N.",0
21,"21052",4741,2897,2839,21,58,"D.N.",2
4,"4027",260,186,186,0,0,"D.N.",0
19,"19124",420,293,291,3,2,"D.N.",2
42,"42014",83,55,55,1,0,"D.N.",0
19,"19229",83,71,68,0,3,"D.N.",0
19,"19054",184,156,151,2,5,"D.N.",0
42,"42127",47,35,35,0,0,"D.N.",0
47,"47131",189,145,145,4,0,"D.N.",0
19,"19024",7736,5738,5646,82,92,"D.N.",22
42,"42172",31,28,28,3,0,"D.N.",0
21,"21069",1778,1245,1242,11,3,"D.N.",0
19,"19067",91,59,59,0,0,"D.N.",0
19,"19277",22,17,17,0,0,"D.N.",0
47,"47079",67,56,56,1,0,"D.N.",0
42,"42140",17,10,10,0,0,"D.N.",0
47,"47150",338,273,271,2,2,"D.N.",0
4,"4005",631,531,524,6,7,"D.N.",0
42,"42153",19,16,16,0,0,"D.N.",0
47,"47125",55,46,46,0,0,"D.N.",0
42,"42194",200,165,163,4,2,"D.N.",0
19,"19070",100,74,74,0,0,"D.N.",0
47,"47012",134,105,105,0,0,"D.N.",0
42,"42217",38,32,32,0,0,"D.N.",0
21,"21074",2752,1981,1968,15,13,"D.N.",2
21,"21033",508,385,382,7,3,"D.N.",0
47,"47151",32,29,29,0,0,"D.N.",0
19,"19252",90,80,78,0,2,"D.N.",0
19,"19071",7346,5380,5294,76,86,"D.N.",18
21,"21068",1009,726,721,10,5,"D.N.",0
19,"19201",70,52,52,2,0,"D.N.",0
4,"4084",370,290,285,6,5,"D.N.",0
42,"42008",69,50,50,0,0,"D.N.",0
47,"47168",32,29,28,1,1,"D.N.",0
4,"4073",389,289,286,4,3,"D.N.",0
47,"47033",209,170,168,3,2,"D.N.",0
42,"42022",253,177,171,2,6,"D.N.",0
19,"19076",36,29,29,0,0,"D.N.",0
47,"47166",276,226,223,0,3,"D.N.",0
42,"42056",26,23,22,1,1,"D.N.",0
42,"42084",27,21,21,0,0,"D.N.",0
4,"4056",144,118,118,0,0,"D.N.",0
42,"42139",22,18,17,0,1,"D.N.",0
21,"21018",1821,1283,1273,19,10,"D.N.",5
47,"47025",127,103,103,0,0,"D.N.",0
19,"19321",46,29,29,0,0,"D.N.",0
21,"21031",1309,903,871,9,32,"D.N.",2
42,"42048",78,63,62,3,1,"D.N.",0
47,"47195",449,350,346,5,4,"D.N.",0
19,"19178",45,34,34,0,0,"D.N.",0
4,"4023",144,116,116,2,0,"D.N.",0
42,"42152",96,71,69,1,2,"D.N.",0
47,"47049",94,71,71,1,0,"D.N.",0
19,"19122",96,65,65,0,0,"D.N.",0
47,"47031",203,149,149,0,0,"D.N.",0
47,"47204",275,221,219,3,2,"D.N.",0
47,"47052",6207,4812,4761,79,51,"D.N.",7
42,"42069",1591,1122,1114,33,8,"D.N.",1
47,"47176",229,157,157,0,0,"D.N.",0
42,"42183",131,95,94,7,1,"D.N.",0
19,"19247",171,125,118,6,7,"D.N.",0
47,"47006",196,151,146,1,5,"D.N.",1
21,"21002",14281,10297,10173,141,124,"D.N.",12
21,"21027",67,52,52,0,0,"D.N.",0
47,"47106",63,52,52,0,0,"D.N.",0
19,"19154",79,68,67,0,1,"D.N.",0
19,"19210",34,29,29,1,0,"D.N.",0
4,"4096",293,220,219,1,1,"D.N.",0
19,"19242",112,93,92,1,1,"D.N.",0
42,"42059",23,19,19,1,0,"D.N.",0
47,"47004",1261,1047,1031,11,16,"D.N.",0
47,"47130",105,86,85,2,1,"D.N.",0
47,"47180",96,82,81,0,1,"D.N.",0
19,"19015",104,88,87,0,1,"D.N.",0
42,"42135",89,59,59,1,0,"D.N.",0
47,"47062",185,153,153,5,0,"D.N.",0
42,"42027",87,61,61,4,0,"D.N.",0
21,"21038",1146,786,767,9,19,"D.N.",0
47,"47172",149,125,124,3,1,"D.N.",0
47,"47013",118,97,97,2,0,"D.N.",0
42,"42071",186,104,103,3,1,"D.N.",0
42,"42124",71,50,50,0,0,"D.N.",0
19,"19188",72,48,48,1,0,"D.N.",0
47,"47157",544,462,458,9,4,"D.N.",0
19,"19143",1610,1287,1268,9,19,"D.N.",4
4,"4045",1877,1512,1497,23,15,"D.N.",0
19,"19011",286,219,218,3,1,"D.N.",0
42,"42057",197,133,133,6,0,"D.N.",0
19,"19081",43,33,33,0,0,"D.N.",0
42,"42004",2383,1776,1740,30,36,"D.N.",3
19,"19021",1129,818,800,10,18,"D.N.",4
47,"47104",2917,2391,2357,31,34,"D.N.",3
42,"42065",28,24,24,0,0,"D.N.",0
19,"19104",16,12,12,1,0,"D.N.",0
47,"47026",59,46,46,1,0,"D.N.",0
19,"19091",30,22,22,2,0,"D.N.",0
19,"19258",103,81,81,0,0,"D.N.",0
19,"19259",37,32,32,0,0,"D.N.",0
19,"19125",54,42,42,2,0,"D.N.",0
19,"19238",42,32,31,1,1,"D.N.",3
42,"42095",1575,1136,1106,40,30,"D.N.",4
42,"42190",102,71,71,3,0,"D.N.",0
19,"19326",1125,800,786,10,14,"D.N.",9
47,"47080",45,39,39,1,0,"D.N.",0
19,"19161",243,171,166,2,5,"D.N.",1
47,"47074",155,125,124,0,1,"D.N.",0
4,"4014",162,136,136,0,0,"D.N.",0
42,"42191",187,143,141,5,2,"D.N.",0
19,"19245",1222,954,943,10,11,"D.N.",2
42,"42207",49,37,34,0,3,"D.N.",0
42,"42106",15,14,14,0,0,"D.N.",0
47,"47111",1005,804,794,5,10,"D.N.",1
42,"42111",310,228,222,2,6,"D.N.",2
19,"19132",105,79,79,0,0,"D.N.",0
19,"19234",63,48,48,0,0,"D.N.",0
19,"19075",81,53,50,4,3,"D.N.",0
47,"47086",4062,3162,3120,37,42,"D.N.",3
19,"19098",22,18,18,0,0,"D.N.",0
19,"19086",1655,1310,1295,10,15,"D.N.",3
47,"47117",306,231,228,4,3,"D.N.",0
21,"21071",216,169,169,5,0,"D.N.",0
42,"42151",38,32,29,0,3,"D.N.",0
21,"21062",1444,1003,991,7,12,"D.N.",0
42,"42051",23,12,11,0,1,"D.N.",0
19,"19281",25,24,22,3,2,"D.N.",0
19,"19300",746,595,585,3,10,"D.N.",3
47,"47146",236,196,195,4,1,"D.N.",1
47,"47042",63,50,49,3,1,"D.N.",0
47,"47054",673,545,541,8,4,"D.N.",0
19,"19265",157,102,101,0,1,"D.N.",0
19,"19284",11,11,11,0,0,"D.N.",0
47,"47090",2511,1907,1880,23,27,"D.N.",2
19,"19066",78,63,62,0,1,"D.N.",0
4,"4035",8213,6218,6171,51,47,"D.N.",3
47,"47170",40,30,30,0,0,"D.N.",0
19,"19317",150,122,121,2,1,"D.N.",0
42,"42011",22,14,14,1,0,"D.N.",0
19,"19115",41,26,26,1,0,"D.N.",0
47,"47058",199,157,157,3,0,"D.N.",0
19,"19051",94,83,83,1,0,"D.N.",0
47,"47221",115,102,102,0,0,"D.N.",0
19,"19119",93,80,79,2,1,"D.N.",1
47,"47102",302,250,248,3,2,"D.N.",1
42,"42076",237,185,179,6,6,"D.N.",0
47,"47144",85,65,65,2,0,"D.N.",1
19,"19010",15,13,13,1,0,"D.N.",0
47,"47177",112,83,79,1,4,"D.N.",0
21,"21044",17018,11390,11290,132,100,"D.N.",19
19,"19103",303,247,244,3,3,"D.N.",0
19,"19097",28,27,27,0,0,"D.N.",0
4,"4037",1393,1090,1079,8,11,"D.N.",1
19,"19256",48,44,43,0,1,"D.N.",0
21,"21065",295,212,211,0,1,"D.N.",0
21,"21034",1253,875,861,7,14,"D.N.",0
47,"47222",92,77,77,4,0,"D.N.",0
4,"4081",367,312,309,0,3,"D.N.",0
42,"42055",183,128,127,4,1,"D.N.",1
47,"47231",4272,3268,3243,64,25,"D.N.",4
4,"4044",1517,1232,1224,8,8,"D.N.",4
19,"19120",107,95,95,1,0,"D.N.",1
47,"47160",466,368,364,5,4,"D.N.",0
47,"47016",94,77,77,1,0,"D.N.",0
19,"19050",21,19,19,0,0,"D.N.",0
42,"42160",288,222,221,2,1,"D.N.",0
4,"4078",1069,837,832,6,5,"D.N.",0
19,"19333",142,86,84,0,2,"D.N.",0
19,"19208",55,41,41,1,0,"D.N.",0
21,"21079",749,556,553,6,3,"D.N.",0
47,"47209",43,33,33,0,0,"D.N.",0
47,"47118",159,122,122,2,0,"D.N.",0
42,"42161",158,119,119,0,0,"D.N.",0
42,"42094",520,376,362,14,14,"D.N.",1
42,"42046",55,35,35,0,0,"D.N.",0
19,"19182",38,24,22,0,2,"D.N.",0
47,"47028",31,21,20,0,1,"D.N.",0
47,"47215",60,52,52,2,0,"D.N.",0
47,"47023",2863,2278,2258,38,20,"D.N.",6
19,"19269",103,84,83,0,1,"D.N.",0
21,"21056",2992,2172,2096,29,76,"D.N.",1
47,"47014",55,47,47,0,0,"D.N.",0
19,"19307",30,27,27,0,0,"D.N.",0
42,"42184",76,50,49,0,1,"D.N.",5
42,"42080",168,115,114,0,1,"D.N.",0
4,"4098",1616,1255,1249,7,6,"D.N.",1
47,"47123",456,356,353,10,3,"D.N.",0
21,"21020",398,282,282,3,0,"D.N.",0
47,"47145",658,482,473,7,9,"D.N.",0
19,"19079",7,7,7,0,0,"D.N.",0
4,"4103",1555,1159,1157,8,2,"D.N.",0
19,"19041",166,127,127,3,0,"D.N.",0
47,"47053",125,100,99,1,1,"D.N.",0
21,"21067",418,318,312,5,6,"D.N.",0
19,"19324",199,151,151,2,0,"D.N.",0
47,"47127",150,110,108,0,2,"D.N.",0
19,"19221",56,41,41,2,0,"D.N.",0
19,"19045",180,145,145,1,0,"D.N.",0
19,"19218",60,35,35,0,0,"D.N.",0
47,"47001",51,44,42,2,2,"D.N.",0
42,"42192",43,36,36,2,0,"D.N.",0
47,"47198",71,56,56,2,0,"D.N.",1
19,"19167",136,112,109,4,3,"D.N.",0
4,"4048",1459,1110,1100,11,10,"D.N.",0
19,"19176",280,216,216,0,0,"D.N.",0
47,"47149",44,22,20,0,2,"D.N.",0
42,"42079",32,25,25,0,0,"D.N.",0
19,"19155",61,52,50,1,2,"D.N.",0
47,"47137",27,22,22,2,0,"D.N.",0
21,"21058",2609,1867,1857,15,10,"D.N.",2
4,"4071",452,364,363,1,1,"D.N.",0
47,"47037",194,160,159,1,1,"D.N.",0
47,"47112",2671,2231,2198,28,33,"D.N.",3
21,"21015",728,453,447,6,6,"D.N.",1
47,"47011",600,493,489,4,4,"D.N.",0
19,"19189",136,99,97,0,2,"D.N.",0
19,"19212",795,644,632,2,12,"D.N.",2
19,"19032",202,11,11,0,0,"D.N.",0
42,"42085",219,167,167,2,0,"D.N.",0
42,"42189",75,58,58,2,0,"D.N.",0
47,"47167",258,230,229,3,1,"D.N.",0
21,"21005",15205,11006,10909,108,97,"D.N.",4
47,"47066",1114,891,888,10,3,"D.N.",1
21,"21053",3278,2363,2325,20,38,"D.N.",0
21,"21032",1790,1362,1347,14,15,"D.N.",1
19,"19044",319,248,245,0,3,"D.N.",0
19,"19190",2499,1829,1785,32,44,"D.N.",1
42,"42168",128,82,81,4,1,"D.N.",0
42,"42128",43,38,38,2,0,"D.N.",0
47,"47047",217,171,170,5,1,"D.N.",0
19,"19214",94,78,78,2,0,"D.N.",0
42,"42212",75,45,45,2,0,"D.N.",0
21,"21040",3096,2370,2351,28,19,"D.N.",0
42,"42092",89,60,60,0,0,"D.N.",0
19,"19007",460,351,345,5,6,"D.N.",0
47,"47211",45,38,38,1,0,"D.N.",0
42,"42163",53,41,41,0,0,"D.N.",0
19,"19249",38,32,32,0,0,"D.N.",0
47,"47010",11275,8800,8701,163,99,"D.N.",17
4,"4007",791,599,599,5,0,"D.N.",1
47,"47101",1740,1458,1444,12,14,"D.N.",0
19,"19294",27,26,26,1,0,"D.N.",0
42,"42061",297,190,188,4,2,"D.N.",0
19,"19191",19,15,15,0,0,"D.N.",0
21,"21021",11825,7657,7574,108,83,"D.N.",3
19,"19239",99,74,73,1,1,"D.N.",0
47,"47206",111,99,99,0,0,"D.N.",0
19,"19133",103,89,88,2,1,"D.N.",0
21,"21045",261,200,200,5,0,"D.N.",0
19,"19306",42,31,31,1,0,"D.N.",0
47,"47096",139,109,107,0,2,"D.N.",0
4,"4082",309,216,214,3,2,"D.N.",0
21,"21059",203,166,162,1,4,"D.N.",0
47,"47190",103,87,87,7,0,"D.N.",0
42,"42042",46,35,33,1,2,"D.N.",1
47,"47109",183,151,151,4,0,"D.N.",0
19,"19310",13,9,8,0,1,"D.N.",0
19,"19005",92,80,79,0,1,"D.N.",0
47,"47087",376,320,315,7,5,"D.N.",1
19,"19285",26,20,20,2,0,"D.N.",0
4,"4057",1454,1081,1071,1,10,"D.N.",1
19,"19160",944,600,593,6,7,"D.N.",3
42,"42024",95,80,73,1,7,"D.N.",0
42,"42062",36,23,22,0,1,"D.N.",0
42,"42006",166,110,107,3,3,"D.N.",0
19,"19112",68,50,50,0,0,"D.N.",0
4,"4016",2184,1699,1677,15,22,"D.N.",1
47,"47182",1371,991,982,12,9,"D.N.",1
19,"19194",113,80,76,1,4,"D.N.",0
19,"19217",85,57,54,2,3,"D.N.",0
47,"47194",322,244,233,1,11,"D.N.",0
42,"42185",29,23,23,1,0,"D.N.",0
19,"19173",52,42,42,3,0,"D.N.",0
47,"47078",178,159,154,7,5,"D.N.",0
47,"47103",277,218,214,1,4,"D.N.",0
4,"4018",293,250,245,2,5,"D.N.",0
19,"19039",73,57,57,0,0,"D.N.",0
21,"21017",3581,2416,2389,27,27,"D.N.",0
4,"4051",476,406,400,3,6,"D.N.",1
19,"19231",16,14,14,0,0,"D.N.",0
47,"47114",4107,2877,2834,37,43,"D.N.",11
42,"42107",86,60,59,2,1,"D.N.",0
47,"47007",3453,2616,2580,42,36,"D.N.",4
21,"21004",1530,1059,1042,9,17,"D.N.",2
47,"47051",351,269,256,5,13,"D.N.",0
47,"47121",590,495,490,4,5,"D.N.",0
42,"42164",1699,1244,1209,13,35,"D.N.",6
42,"42187",65,51,51,0,0,"D.N.",0
47,"47084",1230,981,968,19,13,"D.N.",0
42,"42017",154,134,130,2,4,"D.N.",0
42,"42204",64,49,44,4,5,"D.N.",0
47,"47040",67,51,50,0,1,"D.N.",0
19,"19232",89,68,67,0,1,"D.N.",0
4,"4060",486,373,372,0,1,"D.N.",0
47,"47217",1812,1395,1377,20,18,"D.N.",2
42,"42088",69,56,56,1,0,"D.N.",1
19,"19266",278,234,231,4,3,"D.N.",3
19,"19243",53,39,39,0,0,"D.N.",0
19,"19108",117,97,95,0,2,"D.N.",0
4,"4093",1869,1341,1334,10,7,"D.N.",1
42,"42166",68,49,48,1,1,"D.N.",0
19,"19322",35,28,27,1,1,"D.N.",0
19,"19304",235,169,166,1,3,"D.N.",0
4,"4033",161,120,119,1,1,"D.N.",0
19,"19302",64,60,60,2,0,"D.N.",0
47,"47122",2078,1697,1665,21,32,"D.N.",0
19,"19237",53,40,39,2,1,"D.N.",0
42,"42162",2482,1871,1850,23,21,"D.N.",4
19,"19006",873,634,620,1,14,"D.N.",1
19,"19107",349,289,288,1,1,"D.N.",0
47,"47171",453,371,368,10,3,"D.N.",1
42,"42205",99,70,70,0,0,"D.N.",0
21,"21078",2865,2085,2066,21,19,"D.N.",0
19,"19117",1526,1155,1132,26,23,"D.N.",4
47,"47197",932,739,730,15,9,"D.N.",0
4,"4034",152,106,105,1,1,"D.N.",0
21,"21055",6320,4819,4760,46,59,"D.N.",4
42,"42131",53,38,37,0,1,"D.N.",0
19,"19049",19,11,11,0,0,"D.N.",0
19,"19162",71,52,51,0,1,"D.N.",0
47,"47036",257,212,212,1,0,"D.N.",0
21,"21013",10601,7384,7231,110,153,"D.N.",5
19,"19282",210,157,157,0,0,"D.N.",0
19,"19254",57,50,50,0,0,"D.N.",0
42,"42142",55,41,38,2,3,"D.N.",1
42,"42023",78,58,58,1,0,"D.N.",0
4,"4089",805,607,597,1,10,"D.N.",0
42,"42196",14,11,11,0,0,"D.N.",0
19,"19228",39,30,29,0,1,"D.N.",0
4,"4046",826,645,634,4,11,"D.N.",0
47,"47191",113,81,80,1,1,"D.N.",1
47,"47184",575,447,443,6,4,"D.N.",3
42,"42208",23,15,15,1,0,"D.N.",0
21,"21028",419,320,315,3,5,"D.N.",0
42,"42019",562,392,383,9,9,"D.N.",0
19,"19004",67,56,56,0,0,"D.N.",1
42,"42200",98,70,67,1,3,"D.N.",0
19,"19169",51,35,35,0,0,"D.N.",0
42,"42078",1110,829,817,15,12,"D.N.",2
42,"42001",308,242,237,4,5,"D.N.",0
42,"42157",18,16,15,0,1,"D.N.",0
42,"42130",70,55,54,2,1,"D.N.",0
4,"4903",4331,3183,3164,31,19,"D.N.",2
21,"21024",502,363,358,10,5,"D.N.",1
19,"19172",76,65,64,1,1,"D.N.",0
19,"19102",122,101,100,0,1,"D.N.",0
42,"42020",4385,3055,2957,74,98,"D.N.",6
19,"19151",1126,849,830,3,19,"D.N.",3
21,"21012",331,254,246,2,8,"D.N.",0
47,"47214",1517,1215,1191,34,24,"D.N.",0
42,"42018",178,129,124,0,5,"D.N.",0
47,"47174",302,236,234,3,2,"D.N.",0
47,"47228",481,385,383,3,2,"D.N.",0
21,"21050",12322,8772,8679,99,93,"D.N.",12
47,"47200",91,73,73,0,0,"D.N.",1
47,"47092",123,100,99,2,1,"D.N.",0
4,"4053",12062,9283,9180,119,103,"D.N.",4
42,"42216",27,22,22,0,0,"D.N.",0
42,"42159",40,31,31,1,0,"D.N.",0
19,"19263",34,27,27,0,0,"D.N.",0
19,"19288",22,21,21,0,0,"D.N.",0
47,"47208",56,45,43,1,2,"D.N.",0
21,"21019",645,464,458,2,6,"D.N.",1
42,"42016",25,13,13,0,0,"D.N.",0
47,"47015",229,172,170,1,2,"D.N.",0
42,"42064",92,76,76,0,0,"D.N.",0
19,"19327",551,459,449,3,10,"D.N.",0
47,"47133",2382,1861,1841,30,20,"D.N.",3
47,"47169",70,57,57,0,0,"D.N.",0
19,"19060",165,127,121,3,6,"D.N.",0
19,"19270",17,16,16,0,0,"D.N.",0
19,"19003",50,36,35,1,1,"D.N.",0
47,"47230",318,266,259,2,7,"D.N.",0
19,"19009",253,187,184,0,3,"D.N.",1
4,"4041",334,247,245,0,2,"D.N.",0
47,"47223",172,147,147,6,0,"D.N.",0
19,"19901",43,34,34,0,0,"D.N.",0
19,"19296",43,31,30,1,1,"D.N.",0
42,"42202",33,15,14,1,1,"D.N.",0
42,"42063",69,53,53,4,0,"D.N.",0
4,"4101",3927,2827,2804,34,23,"D.N.",10
47,"47077",291,232,232,1,0,"D.N.",0
47,"47068",41,28,28,0,0,"D.N.",0
19,"19027",185,140,138,1,2,"D.N.",0
42,"42010",19,15,15,1,0,"D.N.",0
47,"47147",129,96,96,0,0,"D.N.",0
42,"42134",2626,1945,1896,36,49,"D.N.",6
19,"19052",37,32,31,1,1,"D.N.",0
42,"42033",54,48,48,0,0,"D.N.",0
47,"47129",954,744,731,4,13,"D.N.",0
4,"4075",4783,3731,3700,33,31,"D.N.",0
21,"21070",6278,4489,4445,42,44,"D.N.",4
4,"4030",1222,930,924,5,6,"D.N.",0
42,"42035",847,600,592,4,8,"D.N.",1
19,"19136",22,15,15,0,0,"D.N.",0
19,"19142",259,191,190,0,1,"D.N.",1
42,"42083",28,25,25,0,0,"D.N.",0
42,"42206",10,9,9,1,0,"D.N.",0
19,"19157",66,56,56,4,0,"D.N.",0
19,"19171",4352,3299,3221,35,78,"D.N.",11
19,"19166",179,123,121,4,2,"D.N.",0
42,"42201",27,24,24,2,0,"D.N.",0
19,"19309",37,32,31,0,1,"D.N.",0
4,"4066",13570,9018,8963,97,55,"D.N.",12
21,"21007",6088,4174,4123,57,51,"D.N.",3
47,"47009",117,88,88,1,0,"D.N.",0
4,"4077",343,313,313,1,0,"D.N.",0
4,"4021",188,157,157,2,0,"D.N.",1
4,"4026",75,58,58,0,0,"D.N.",0
47,"47219",46,36,36,1,0,"D.N.",0
42,"42149",404,292,286,12,6,"D.N.",2
21,"21030",1757,1448,1426,14,22,"D.N.",0
42,"42007",143,110,110,2,0,"D.N.",0
47,"47027",2680,2059,2024,23,35,"D.N.",3
42,"42148",14,14,14,0,0,"D.N.",0
19,"19127",97,66,66,1,0,"D.N.",0
19,"19203",35,27,27,0,0,"D.N.",0
4,"4010",602,492,491,10,1,"D.N.",1
19,"19274",881,652,644,8,8,"D.N.",4
21,"21006",3565,2477,2441,29,36,"D.N.",2
21,"21064",6331,4390,4352,46,38,"D.N.",10
21,"21003",691,540,536,7,4,"D.N.",1
19,"19318",36,19,19,1,0,"D.N.",0
47,"47142",172,132,131,2,1,"D.N.",0
47,"47159",862,704,695,20,9,"D.N.",4
19,"19319",4203,3139,3104,28,35,"D.N.",23
42,"42026",25,16,16,0,0,"D.N.",0
19,"19224",119,95,94,0,1,"D.N.",0
19,"19204",168,129,126,2,3,"D.N.",0
19,"19260",44,41,41,1,0,"D.N.",0
19,"19134",22,14,14,0,0,"D.N.",0
19,"19227",95,64,63,1,1,"D.N.",0
42,"42087",48,38,37,1,1,"D.N.",1
42,"42030",115,88,86,2,2,"D.N.",0
19,"19089",33,22,22,1,0,"D.N.",0
19,"19279",66,56,56,0,0,"D.N.",0
47,"47100",169,146,144,1,2,"D.N.",0
42,"42012",43,29,29,1,0,"D.N.",2
42,"42097",19,16,16,0,0,"D.N.",0
4,"4095",777,547,541,8,6,"D.N.",0
47,"47139",1080,845,833,11,12,"D.N.",0
19,"19059",84,60,60,0,0,"D.N.",0
4,"4099",5086,4023,3980,26,43,"D.N.",7
42,"42039",270,172,169,2,3,"D.N.",0
19,"19332",106,76,72,4,4,"D.N.",0
19,"19055",54,41,37,1,4,"D.N.",0
4,"4059",1231,837,830,8,7,"D.N.",1
19,"19018",189,145,138,2,7,"D.N.",0
21,"21049",3468,2327,2283,18,44,"D.N.",1
4,"4076",1325,1050,1041,7,9,"D.N.",0
47,"47094",154,129,127,0,2,"D.N.",0
4,"4069",4729,3740,3706,52,34,"D.N.",3
42,"42021",101,70,70,1,0,"D.N.",0
19,"19146",51,40,38,0,2,"D.N.",0
47,"47024",283,211,210,1,1,"D.N.",0
19,"19092",437,331,326,4,5,"D.N.",0
19,"19305",166,130,130,0,0,"D.N.",0
42,"42034",40,29,29,0,0,"D.N.",0
47,"47148",475,389,384,2,5,"D.N.",0
19,"19074",81,69,69,0,0,"D.N.",0
19,"19177",82,67,66,0,1,"D.N.",0
42,"42050",29,20,20,1,0,"D.N.",0
19,"19287",153,114,113,2,1,"D.N.",0
19,"19022",673,501,496,4,5,"D.N.",2
47,"47156",182,155,148,0,7,"D.N.",0
21,"21061",5089,3657,3635,33,22,"D.N.",2
47,"47205",414,307,298,5,9,"D.N.",0
19,"19130",58473,45114,44362,688,752,"D.N.",119
4,"4055",418,368,367,5,1,"D.N.",0
42,"42025",1305,964,945,15,19,"D.N.",2
19,"19330",93,81,81,2,0,"D.N.",0
42,"42132",159,132,127,4,5,"D.N.",0
42,"42118",26,20,20,0,0,"D.N.",0
42,"42178",144,105,104,3,1,"D.N.",0
47,"47213",122,99,99,1,0,"D.N.",0
47,"47132",45,40,40,0,0,"D.N.",0
47,"47116",426,363,358,0,5,"D.N.",0
19,"19308",67,61,61,0,0,"D.N.",0
21,"21047",1965,1355,1325,17,30,"D.N.",0
19,"19088",98,67,66,0,1,"D.N.",0
4,"4022",375,296,295,0,1,"D.N.",0
19,"19283",40,33,33,0,0,"D.N.",0
21,"21054",8024,6159,6072,67,87,"D.N.",3
42,"42154",95,73,73,0,0,"D.N.",0
4,"4043",520,439,435,3,4,"D.N.",1
19,"19198",22,19,19,0,0,"D.N.",0
19,"19135",120,102,100,2,2,"D.N.",0
47,"47041",166,135,133,2,2,"D.N.",0
19,"19082",91,68,67,1,1,"D.N.",0
47,"47059",108,77,76,1,1,"D.N.",0
19,"19123",40,34,34,0,0,"D.N.",0
19,"19293",1860,1407,1373,16,34,"D.N.",3
4,"4088",2516,1849,1832,7,17,"D.N.",0
4,"4065",387,320,318,1,2,"D.N.",0
19,"19113",519,396,395,4,1,"D.N.",3
50,"50027",260,209,202,2,7,"DeC",0
50,"50155",119,91,91,1,0,"DeC",0
50,"50037",140,110,103,3,7,"DeC",0
50,"50115",3280,2234,2205,32,29,"DeC",2
4,"4001",1139,890,884,6,6,"DeC",0
50,"50277",82,63,63,0,0,"DeC",0
50,"50287",298,214,211,10,3,"DeC",0
50,"50125",421,284,280,1,4,"DeC",0
50,"50046",201,155,153,2,2,"DeC",0
50,"50105",343,263,259,2,4,"DeC",0
50,"50252",5345,3860,3792,79,68,"DeC",0
50,"50902",97,85,85,1,0,"DeC",0
50,"50241",634,462,455,2,7,"DeC",0
4,"4041",334,247,245,0,2,"DeC",0
50,"50211",277,193,193,1,0,"DeC",0
50,"50202",182,125,122,2,3,"DeC",0
4,"4078",1069,837,832,6,5,"DeC",0
4,"4094",206,152,152,0,0,"DeC",0
50,"50014",169,108,108,1,0,"DeC",0
4,"4072",339,272,271,0,1,"DeC",0
50,"50243",346,277,272,2,5,"DeC",0
4,"4002",1146,891,884,1,7,"DeC",0
4,"4061",668,541,536,7,5,"DeC",0
50,"50199",380,263,254,2,9,"DeC",2
50,"50193",635,483,465,3,18,"DeC",2
50,"50134",134,102,101,3,1,"DeC",0
4,"4902",42901,28927,28711,338,216,"DeC",34
4,"4090",435,338,335,3,3,"DeC",0
4,"4056",144,118,118,0,0,"DeC",0
50,"50256",90,59,59,1,0,"DeC",0
50,"50110",424,315,314,6,1,"DeC",0
50,"50048",43,33,33,1,0,"DeC",0
50,"50255",219,150,148,1,2,"DeC",0
50,"50065",59,37,37,2,0,"DeC",0
4,"4020",361,265,263,1,2,"DeC",0
4,"4080",194,169,168,1,1,"DeC",0
50,"50036",103,81,80,2,1,"DeC",0
50,"50072",181,128,127,1,1,"DeC",0
4,"4008",530,423,418,4,5,"DeC",0
50,"50135",100,76,75,2,1,"DeC",0
50,"50198",46,36,36,2,0,"DeC",0
50,"50114",157,120,120,1,0,"DeC",0
50,"50174",107,92,90,0,2,"DeC",1
50,"50284",176,131,130,1,1,"DeC",0
50,"50052",100,82,82,0,0,"DeC",0
50,"50186",44,30,29,0,1,"DeC",0
50,"50038",1583,1194,1174,29,20,"DeC",2
50,"50271",283,209,207,4,2,"DeC",0
50,"50278",207,152,149,4,3,"DeC",0
4,"4097",299,229,227,0,2,"DeC",0
50,"50120",53,41,41,0,0,"DeC",0
50,"50096",49,35,35,0,0,"DeC",0
50,"50020",868,646,629,5,17,"DeC",0
50,"50024",652,541,531,8,10,"DeC",0
4,"4083",1933,1511,1497,16,14,"DeC",0
50,"50017",1734,1232,1212,41,20,"DeC",2
4,"4035",8213,6218,6171,51,47,"DeC",3
50,"50124",474,375,367,11,8,"DeC",0
50,"50101",922,648,637,8,11,"DeC",0
50,"50180",111,91,89,3,2,"DeC",0
50,"50274",78,45,45,1,0,"DeC",0
50,"50100",355,273,266,3,7,"DeC",0
50,"50190",751,576,565,7,11,"DeC",1
50,"50064",469,377,373,5,4,"DeC",0
50,"50247",794,572,567,7,5,"DeC",0
50,"50231",285,231,224,7,7,"DeC",0
50,"50164",407,271,268,4,3,"DeC",0
50,"50071",134,97,96,0,1,"DeC",0
50,"50066",2357,1677,1659,42,18,"DeC",3
50,"50296",417,313,310,6,3,"DeC",0
50,"50151",713,536,531,5,5,"DeC",0
4,"4021",188,157,157,2,0,"DeC",0
4,"4045",1877,1512,1497,23,15,"DeC",4
50,"50218",113,92,92,0,0,"DeC",0
50,"50223",956,751,745,14,6,"DeC",0
4,"4052",11567,8189,8124,158,65,"DeC",12
50,"50227",105,79,79,2,0,"DeC",1
50,"50208",1831,1321,1305,24,16,"DeC",2
4,"4068",187,137,137,1,0,"DeC",0
50,"50246",48,33,33,1,0,"DeC",0
50,"50177",355,268,265,4,3,"DeC",0
50,"50159",728,554,544,4,10,"DeC",0
50,"50183",369,277,274,5,3,"DeC",0
50,"50131",243,185,183,6,2,"DeC",1
50,"50192",240,188,184,9,4,"DeC",0
50,"50010",77,65,64,5,1,"DeC",0
50,"50170",411,316,313,2,3,"DeC",1
50,"50062",1750,1298,1275,22,23,"DeC",0
50,"50032",330,233,228,3,5,"DeC",0
50,"50214",31,22,21,1,1,"DeC",0
50,"50162",160,108,108,2,0,"DeC",0
50,"50077",254,189,188,4,1,"DeC",0
4,"4058",402,324,322,5,2,"DeC",1
50,"50093",113,84,84,2,0,"DeC",0
50,"50042",16,14,14,0,0,"DeC",0
4,"4075",4783,3731,3700,33,31,"DeC",1
50,"50039",580,450,446,3,4,"DeC",0
50,"50043",258,170,166,2,4,"DeC",1
50,"50055",3592,2520,2473,59,47,"DeC",1
50,"50161",124,86,86,1,0,"DeC",0
50,"50230",1295,914,903,13,11,"DeC",1
50,"50023",240,180,180,4,0,"DeC",0
50,"50157",313,253,250,7,3,"DeC",0
50,"50275",103,76,76,0,0,"DeC",0
50,"50041",21,13,13,0,0,"DeC",0
50,"50171",126,90,89,4,1,"DeC",0
50,"50021",42,34,33,1,1,"DeC",0
50,"50084",84,64,64,1,0,"DeC",0
50,"50189",776,588,576,9,12,"DeC",0
50,"50075",89,74,74,1,0,"DeC",0
50,"50059",790,593,586,12,7,"DeC",0
50,"50234",251,201,191,13,10,"DeC",2
50,"50026",459,360,354,5,6,"DeC",0
50,"50261",246,199,199,4,0,"DeC",0
50,"50283",73,55,55,1,0,"DeC",0
4,"4086",1903,1376,1371,11,5,"DeC",2
50,"50045",1289,1011,992,14,19,"DeC",0
50,"50209",2559,1685,1661,34,24,"DeC",1
4,"4048",1459,1110,1100,11,10,"DeC",0
50,"50013",244,195,195,1,0,"DeC",0
50,"50148",365,256,251,2,5,"DeC",0
50,"50088",337,273,264,4,9,"DeC",0
4,"4023",144,116,116,2,0,"DeC",0
50,"50240",1127,799,783,25,16,"DeC",0
50,"50141",116,98,98,1,0,"DeC",0
50,"50237",103,76,75,0,1,"DeC",0
50,"50143",608,427,424,5,3,"DeC",0
50,"50249",333,280,272,2,8,"DeC",0
4,"4053",12062,9283,9180,119,103,"DeC",4
50,"50111",191,141,138,2,3,"DeC",0
4,"4067",657,526,524,1,2,"DeC",0
50,"50053",756,570,563,14,7,"DeC",2
50,"50228",295,238,236,10,2,"DeC",0
50,"50149",48,35,35,0,0,"DeC",0
50,"50220",59,43,43,1,0,"DeC",0
50,"50268",59,46,46,3,0,"DeC",0
50,"50290",436,334,331,4,3,"DeC",0
50,"50259",89,53,53,1,0,"DeC",0
4,"4071",452,364,363,1,1,"DeC",0
4,"4087",198,162,159,2,3,"DeC",0
50,"50016",51,30,30,1,0,"DeC",0
50,"50178",325,228,225,4,3,"DeC",0
50,"50217",496,380,379,0,1,"DeC",0
4,"4079",45851,31893,31644,430,249,"DeC",23
50,"50004",613,445,441,6,4,"DeC",0
50,"50154",129,98,97,1,1,"DeC",0
50,"50173",175,104,104,2,0,"DeC",0
50,"50087",31,25,25,0,0,"DeC",0
50,"50297",495260,360632,355561,7046,5071,"DeC",362
4,"4060",486,373,372,0,1,"DeC",0
50,"50086",193,109,109,0,0,"DeC",1
50,"50269",316,186,185,1,1,"DeC",1
50,"50156",234,186,183,2,3,"DeC",0
50,"50250",58,43,43,4,0,"DeC",0
50,"50137",1119,842,834,12,8,"DeC",0
50,"50233",120,89,88,2,1,"DeC",0
4,"4004",458,367,364,6,3,"DeC",0
50,"50121",297,250,245,6,5,"DeC",0
50,"50144",36,32,32,0,0,"DeC",0
50,"50090",165,117,117,1,0,"DeC",0
50,"50267",648,450,441,8,9,"DeC",0
4,"4093",1869,1341,1334,10,7,"DeC",0
50,"50215",21,20,19,0,1,"DeC",0
50,"50286",90,73,73,2,0,"DeC",0
50,"50185",150,109,109,2,0,"DeC",0
50,"50196",110,87,86,4,1,"DeC",0
4,"4038",3140,2258,2231,44,27,"DeC",0
50,"50078",278,210,208,2,2,"DeC",0
50,"50205",98,72,71,2,1,"DeC",0
50,"50001",130,96,96,0,0,"DeC",0
4,"4012",230,195,195,2,0,"DeC",0
50,"50140",172,108,108,1,0,"DeC",0
50,"50054",63,46,46,0,0,"DeC",0
4,"4009",165,124,122,2,2,"DeC",0
50,"50068",2082,1514,1481,18,33,"DeC",1
50,"50035",78,61,56,2,5,"DeC",0
50,"50203",1083,814,798,28,16,"DeC",1
50,"50168",34,26,26,1,0,"DeC",0
50,"50128",36,30,29,0,1,"DeC",0
50,"50011",131,113,113,8,0,"DeC",0
50,"50150",716,430,427,10,3,"DeC",1
4,"4024",3049,2396,2361,19,35,"DeC",1
50,"50107",953,785,780,13,5,"DeC",2
4,"4057",1454,1081,1071,1,10,"DeC",0
4,"4064",2585,1817,1803,18,14,"DeC",0
50,"50132",697,544,536,11,8,"DeC",1
50,"50257",195,154,154,0,0,"DeC",0
50,"50007",61,45,45,0,0,"DeC",0
4,"4006",7156,5175,5106,51,69,"DeC",3
50,"50253",461,381,375,3,6,"DeC",0
4,"4074",2731,1959,1936,26,23,"DeC",3
50,"50069",68,32,32,0,0,"DeC",0
50,"50270",39,30,29,1,1,"DeC",0
4,"4016",2184,1699,1677,15,22,"DeC",2
50,"50095",12558,9029,8910,179,119,"DeC",5
50,"50074",6516,4378,4222,77,156,"DeC",6
4,"4101",3927,2827,2804,34,23,"DeC",2
4,"4027",260,186,186,0,0,"DeC",0
4,"4059",1231,837,830,8,7,"DeC",0
50,"50098",215,150,146,2,4,"DeC",0
50,"50187",72,45,45,1,0,"DeC",0
50,"50005",245,199,195,1,4,"DeC",0
50,"50244",215,155,155,6,0,"DeC",0
50,"50019",79,57,55,1,2,"DeC",0
50,"50280",370,296,291,5,5,"DeC",0
50,"50279",111,79,79,1,0,"DeC",0
50,"50242",102,82,82,2,0,"DeC",0
50,"50239",65,44,44,0,0,"DeC",0
4,"4049",4981,3652,3630,34,22,"DeC",2
4,"4032",5476,3666,3643,34,23,"DeC",3
50,"50081",562,410,400,7,10,"DeC",0
50,"50015",109,73,73,0,0,"DeC",0
50,"50167",235,191,184,1,7,"DeC",0
4,"4102",12940,9247,9152,90,95,"DeC",5
50,"50029",676,527,517,6,10,"DeC",0
4,"4098",1616,1255,1249,7,6,"DeC",1
50,"50033",81,64,64,0,0,"DeC",1
50,"50222",1695,1117,1091,16,26,"DeC",3
4,"4095",777,547,541,8,6,"DeC",0
50,"50118",2312,1737,1718,22,19,"DeC",0
50,"50060",187,138,136,1,2,"DeC",0
50,"50258",54,37,37,0,0,"DeC",0
4,"4019",269,210,209,3,1,"DeC",0
4,"4046",826,645,634,4,11,"DeC",0
50,"50294",77,58,57,0,1,"DeC",0
50,"50030",232,164,160,1,4,"DeC",0
50,"50117",131,101,100,1,1,"DeC",0
50,"50047",60,34,34,2,0,"DeC",0
50,"50195",48,38,38,1,0,"DeC",0
50,"50106",137,107,106,0,1,"DeC",0
4,"4085",453,384,383,0,1,"DeC",0
50,"50067",14124,10049,9870,203,179,"DeC",18
50,"50126",2473,1747,1724,41,23,"DeC",1
50,"50213",117,83,82,0,1,"DeC",0
50,"50176",237,161,160,4,1,"DeC",0
4,"4015",149,115,115,0,0,"DeC",0
50,"50080",41,31,31,1,0,"DeC",0
50,"50201",466,366,363,7,3,"DeC",1
50,"50082",108,73,72,0,1,"DeC",0
4,"4030",1222,930,924,5,6,"DeC",0
50,"50034",923,634,617,10,17,"DeC",2
50,"50044",259,175,175,0,0,"DeC",0
50,"50028",120,86,85,2,1,"DeC",0
50,"50063",76,67,67,0,0,"DeC",0
50,"50102",918,722,713,12,9,"DeC",0
4,"4100",7918,5465,5425,52,40,"DeC",6
4,"4005",631,531,524,6,7,"DeC",7
50,"50089",6673,4936,4877,120,59,"DeC",9
50,"50104",379,306,303,4,3,"DeC",1
50,"50262",1216,916,904,20,12,"DeC",0
50,"50204",2519,1823,1804,24,19,"DeC",3
50,"50293",492,339,338,6,1,"DeC",0
50,"50092",329,273,272,0,1,"DeC",0
50,"50901",170,122,121,1,1,"DeC",0
4,"4063",1199,871,862,6,9,"DeC",1
4,"4062",4604,3711,3654,22,57,"DeC",0
50,"50295",54,42,41,0,1,"DeC",0
4,"4034",152,106,105,1,1,"DeC",0
50,"50138",49,43,43,2,0,"DeC",0
4,"4031",2495,1942,1931,13,11,"DeC",2
50,"50002",166,130,130,2,0,"DeC",0
50,"50273",36,22,22,0,0,"DeC",0
50,"50083",96,72,72,1,0,"DeC",0
50,"50265",63,46,46,1,0,"DeC",0
4,"4022",375,296,295,0,1,"DeC",1
50,"50235",2371,1723,1701,36,22,"DeC",1
50,"50091",56,39,39,1,0,"DeC",0
50,"50130",415,288,288,7,0,"DeC",0
50,"50288",3252,2412,2380,50,32,"DeC",2
50,"50122",68,47,45,2,2,"DeC",0
4,"4037",1393,1090,1079,8,11,"DeC",0
50,"50061",228,191,183,3,8,"DeC",0
50,"50136",617,469,462,4,7,"DeC",1
4,"4044",1517,1232,1224,8,8,"DeC",0
4,"4082",309,216,214,3,2,"DeC",2
50,"50210",39,28,24,0,4,"DeC",0
4,"4076",1325,1050,1041,7,9,"DeC",0
50,"50182",3704,2551,2515,44,36,"DeC",3
4,"4089",805,607,597,1,10,"DeC",0
50,"50229",62,47,46,2,1,"DeC",1
4,"4043",520,439,435,3,4,"DeC",0
50,"50263",235,160,160,1,0,"DeC",0
50,"50146",211,168,167,4,1,"DeC",0
50,"50289",71,59,59,0,0,"DeC",0
4,"4051",476,406,400,3,6,"DeC",0
50,"50094",1744,1220,1193,25,27,"DeC",2
4,"4036",246,205,204,1,1,"DeC",0
50,"50153",1002,757,748,12,9,"DeC",0
50,"50264",184,140,134,0,6,"DeC",0
4,"4011",2814,2283,2263,25,20,"DeC",1
50,"50129",258,164,164,0,0,"DeC",0
50,"50073",2265,1773,1756,20,17,"DeC",0
4,"4901",576,427,426,5,1,"DeC",0
50,"50292",138,117,115,4,2,"DeC",2
50,"50206",499,386,384,10,2,"DeC",0
50,"50058",80,65,64,0,1,"DeC",0
50,"50200",534,436,432,9,4,"DeC",0
50,"50188",34,28,27,0,1,"DeC",0
50,"50179",269,230,229,2,1,"DeC",0
4,"4028",239,212,207,0,5,"DeC",0
50,"50008",5110,3458,3406,56,52,"DeC",1
50,"50163",3427,2448,2413,62,35,"DeC",1
50,"50245",121,80,80,1,0,"DeC",0
50,"50254",179,136,136,0,0,"DeC",0
50,"50003",141,108,108,3,0,"DeC",0
50,"50272",12481,8744,8642,176,102,"DeC",21
50,"50160",2397,1905,1865,19,40,"DeC",0
4,"4014",162,136,136,0,0,"DeC",1
50,"50113",653,528,526,9,2,"DeC",0
50,"50903",2234,1622,1597,35,25,"DeC",0
50,"50109",101,79,79,2,0,"DeC",0
50,"50236",124,103,103,2,0,"DeC",0
50,"50133",126,101,100,1,1,"DeC",0
50,"50099",3136,2333,2297,27,36,"DeC",3
50,"50012",105,93,90,0,3,"DeC",0
4,"4017",1337,965,960,7,5,"DeC",1
50,"50070",70,42,41,0,1,"DeC",0
50,"50031",167,105,103,0,2,"DeC",0
50,"50298",5319,4023,3955,72,68,"DeC",0
50,"50276",148,116,114,3,2,"DeC",0
4,"4029",10682,7542,7474,63,68,"DeC",6
4,"4065",387,320,318,1,2,"DeC",0
4,"4026",75,58,58,0,0,"DeC",0
50,"50191",505,395,390,4,5,"DeC",0
50,"50108",50,31,31,0,0,"DeC",0
4,"4003",17244,11933,11840,94,93,"DeC",5
50,"50285",635,452,445,8,7,"DeC",1
50,"50232",176,123,120,5,3,"DeC",2
50,"50282",88,66,63,3,3,"DeC",0
50,"50025",4569,3319,3271,68,48,"DeC",2
50,"50225",1638,1079,1062,7,17,"DeC",0
50,"50142",45,25,24,0,1,"DeC",0
4,"4054",384,328,325,0,3,"DeC",0
50,"50076",113,89,89,0,0,"DeC",0
4,"4047",2290,1956,1937,9,19,"DeC",4
50,"50175",1088,742,732,10,10,"DeC",1
4,"4081",367,312,309,0,3,"DeC",0
50,"50219",3704,2672,2625,39,47,"DeC",3
4,"4007",791,599,599,5,0,"DeC",0
50,"50238",114,82,80,0,2,"DeC",0
4,"4096",293,220,219,1,1,"DeC",1
50,"50079",281,213,210,2,3,"DeC",0
50,"50022",548,430,416,10,14,"DeC",0
4,"4066",13570,9018,8963,97,55,"DeC",8
50,"50119",997,740,720,13,20,"DeC",1
4,"4088",2516,1849,1832,7,17,"DeC",1
4,"4077",343,313,313,1,0,"DeC",0
50,"50216",267,201,194,8,7,"DeC",0
50,"50172",187,140,138,4,2,"DeC",0
4,"4018",293,250,245,2,5,"DeC",0
50,"50212",52,48,48,0,0,"DeC",0
4,"4055",418,368,367,5,1,"DeC",0
50,"50197",89,65,65,3,0,"DeC",0
50,"50057",1468,1022,1004,17,18,"DeC",0
50,"50184",132,106,106,1,0,"DeC",0
4,"4103",1555,1159,1157,8,2,"DeC",0
50,"50116",220,154,153,0,1,"DeC",0
50,"50040",98,77,76,2,1,"DeC",0
50,"50207",126,97,95,1,2,"DeC",0
50,"50050",109,73,73,1,0,"DeC",1
50,"50123",428,335,332,9,3,"DeC",1
4,"4084",370,290,285,6,5,"DeC",0
50,"50266",139,95,94,1,1,"DeC",0
4,"4073",389,289,286,4,3,"DeC",0
4,"4033",161,120,119,1,1,"DeC",0
50,"50051",886,677,671,9,6,"DeC",1
4,"4092",2897,2351,2325,13,26,"DeC",0
50,"50085",205,143,143,3,0,"DeC",0
50,"50169",371,275,274,5,1,"DeC",0
4,"4099",5086,4023,3980,26,43,"DeC",6
50,"50056",450,329,328,4,1,"DeC",0
4,"4091",380,322,318,3,4,"DeC",0
50,"50147",845,637,627,12,10,"DeC",0
4,"4903",4331,3183,3164,31,19,"DeC",2
50,"50166",282,216,210,1,6,"DeC",0
50,"50018",973,761,755,12,6,"DeC",1
50,"50165",1880,1339,1274,49,65,"DeC",1
50,"50248",552,421,407,5,14,"DeC",0
50,"50152",1569,1151,1135,31,16,"DeC",3
4,"4010",602,492,491,10,1,"DeC",0
50,"50006",978,758,749,16,9,"DeC",2
50,"50139",372,280,278,3,2,"DeC",0
50,"50181",1053,787,760,9,27,"DeC",0
50,"50291",112,75,73,0,2,"DeC",0
4,"4070",1649,1267,1255,9,12,"DeC",0
4,"4013",137455,94867,94142,1203,725,"DeC",98
50,"50221",38,20,20,0,0,"DeC",0
50,"50224",70,52,49,2,3,"DeC",0
50,"50194",102,67,67,2,0,"DeC",0
50,"50281",76,63,63,2,0,"DeC",0
4,"4050",818,611,602,5,9,"DeC",0
4,"4069",4729,3740,3706,52,34,"DeC",3
50,"50260",42,35,35,1,0,"DeC",0
50,"50251",8379,6225,6116,110,109,"DeC",2
50,"50009",122,93,93,0,0,"DeC",0
31,"31904",1590,1054,1031,19,23,"DNE",0
31,"31106",676,534,518,10,16,"DNE",0
31,"31033",55,34,34,0,0,"DNE",0
31,"31101",1305,892,874,15,18,"DNE",0
31,"31229",46,38,37,0,1,"DNE",0
31,"31046",58,41,41,3,0,"DNE",0
31,"31061",67,47,47,2,0,"DNE",0
31,"31010",5788,3716,3637,48,79,"DNE",0
31,"31259",503,341,336,6,5,"DNE",0
31,"31198",38,33,33,0,0,"DNE",0
31,"31901",15574,11165,10974,201,191,"DNE",0
31,"31264",173,110,108,1,2,"DNE",0
31,"31191",2930,2194,2148,43,46,"DNE",0
31,"31117",670,471,467,3,4,"DNE",0
31,"31133",48,34,34,3,0,"DNE",0
31,"31079",99,64,63,0,1,"DNE",0
31,"31099",68,50,50,0,0,"DNE",0
31,"31018",422,303,299,8,4,"DNE",0
31,"31137",215,108,106,1,2,"DNE",0
31,"31200",763,527,514,17,13,"DNE",0
31,"31239",302,229,224,7,5,"DNE",0
31,"31188",185,139,137,2,2,"DNE",0
31,"31073",332,228,226,1,2,"DNE",0
31,"31120",408,267,265,8,2,"DNE",0
31,"31063",96,77,75,0,2,"DNE",0
31,"31074",430,304,303,10,1,"DNE",0
31,"31131",841,610,594,12,16,"DNE",0
31,"31144",840,509,508,7,1,"DNE",0
31,"31240",553,360,359,3,1,"DNE",0
31,"31008",97,64,63,1,1,"DNE",0
31,"31089",246,198,195,4,3,"DNE",0
31,"31058",240,184,179,0,5,"DNE",0
31,"31905",2707,1913,1881,32,32,"DNE",0
31,"31066",915,660,647,19,13,"DNE",0
31,"31127",145,89,89,2,0,"DNE",0
31,"31143",105,62,58,2,4,"DNE",0
31,"31050",6253,4045,3987,74,58,"DNE",0
31,"31182",45,28,28,2,0,"DNE",0
31,"31026",154,125,122,1,3,"DNE",0
31,"31153",2246,1504,1487,13,17,"DNE",0
31,"31051",270,182,181,8,1,"DNE",0
31,"31038",1372,982,968,17,14,"DNE",0
31,"31083",50,37,37,0,0,"DNE",0
31,"31015",1989,1404,1380,29,24,"DNE",0
31,"31006",1988,1434,1395,22,39,"DNE",0
31,"31003",131,101,101,1,0,"DNE",0
31,"31222",67,46,44,3,2,"DNE",0
31,"31069",860,660,647,2,13,"DNE",0
31,"31177",264,162,158,3,4,"DNE",0
31,"31093",305,207,203,2,4,"DNE",0
31,"31201",144714,104019,102644,2027,1375,"DNE",0
31,"31080",544,428,426,7,2,"DNE",0
31,"31185",541,377,374,2,3,"DNE",0
31,"31113",147,87,85,2,2,"DNE",0
31,"31167",859,600,593,11,7,"DNE",0
31,"31160",111,93,93,7,0,"DNE",0
31,"31183",667,516,508,8,8,"DNE",0
31,"31262",219,158,157,4,1,"DNE",0
31,"31242",235,157,157,2,0,"DNE",0
31,"31226",597,339,335,2,4,"DNE",0
31,"31086",11499,8520,8389,214,131,"DNE",0
31,"31022",544,378,369,1,9,"DNE",0
31,"31233",103,87,82,2,5,"DNE",0
31,"31141",132,100,98,1,2,"DNE",0
31,"31249",1926,1376,1361,30,15,"DNE",0
31,"31002",421,292,284,5,8,"DNE",0
31,"31165",2868,2094,2046,43,48,"DNE",0
31,"31085",451,334,327,3,7,"DNE",0
31,"31107",1706,1321,1311,17,10,"DNE",0
31,"31147",103,81,80,3,1,"DNE",0
31,"31060",12916,8830,8687,158,143,"DNE",0
31,"31043",42,30,30,1,0,"DNE",0
31,"31158",264,174,173,1,1,"DNE",0
31,"31036",957,631,616,22,15,"DNE",0
31,"31123",652,379,373,8,6,"DNE",0
31,"31202",4247,3014,2957,69,57,"DNE",0
31,"31157",3567,2435,2393,32,42,"DNE",0
31,"31243",313,227,223,5,4,"DNE",0
31,"31257",827,598,585,16,13,"DNE",0
31,"31219",93,75,73,1,2,"DNE",0
31,"31260",1263,788,780,11,8,"DNE",0
31,"31094",123,100,97,3,3,"DNE",0
31,"31013",668,382,375,12,7,"DNE",0
31,"31152",1406,1003,975,23,28,"DNE",0
31,"31102",162,80,78,0,2,"DNE",0
31,"31184",66,60,59,0,1,"DNE",0
31,"31072",5098,3764,3698,75,66,"DNE",0
31,"31119",49,28,28,0,0,"DNE",0
31,"31095",83,70,70,1,0,"DNE",0
31,"31114",384,320,318,37,2,"DNE",0
31,"31126",372,247,244,6,3,"DNE",0
31,"31110",97,53,53,3,0,"DNE",0
31,"31019",1858,1288,1266,25,22,"DNE",0
31,"31135",116,87,86,9,1,"DNE",0
31,"31081",335,249,243,8,6,"DNE",0
31,"31109",1365,946,934,11,12,"DNE",0
31,"31012",839,577,570,10,7,"DNE",0
31,"31034",43,29,29,0,0,"DNE",0
31,"31130",319,213,209,1,4,"DNE",0
31,"31029",987,693,680,16,13,"DNE",0
31,"31124",209,139,138,1,1,"DNE",0
31,"31116",71,48,48,2,0,"DNE",0
31,"31032",1785,1330,1305,24,25,"DNE",0
31,"31172",375,295,288,11,7,"DNE",0
31,"31030",155,113,112,3,1,"DNE",0
31,"31163",2008,1458,1434,22,24,"DNE",0
31,"31090",156,77,77,0,0,"DNE",0
31,"31100",298,193,193,2,0,"DNE",0
31,"31225",40,32,32,0,0,"DNE",0
31,"31173",881,754,733,12,21,"DNE",0
31,"31055",264,194,193,0,1,"DNE",0
31,"31121",79,53,52,2,1,"DNE",0
31,"31145",173,129,127,2,2,"DNE",0
31,"31254",1956,1495,1476,16,19,"DNE",0
31,"31244",153,97,97,3,0,"DNE",0
31,"31178",540,395,392,4,3,"DNE",0
31,"31238",125,99,98,3,1,"DNE",0
31,"31170",46,40,39,3,1,"DNE",0
31,"31020",488,247,246,0,1,"DNE",0
31,"31134",195,134,132,3,2,"DNE",0
31,"31215",4618,3384,3315,54,69,"DNE",0
31,"31154",229,133,133,4,0,"DNE",0
31,"31056",183,123,122,4,1,"DNE",0
31,"31166",274,183,182,2,1,"DNE",0
31,"31129",405,285,281,1,4,"DNE",0
31,"31231",127,93,91,1,2,"DNE",0
31,"31078",2502,1880,1852,33,28,"DNE",0
31,"31139",172,97,97,1,0,"DNE",0
31,"31045",501,384,377,16,7,"DNE",0
31,"31175",78,55,54,0,1,"DNE",0
31,"31084",1949,1369,1361,11,8,"DNE",0
31,"31042",2719,2100,2057,27,43,"DNE",0
31,"31103",51,40,40,3,0,"DNE",0
31,"31092",676,447,446,6,1,"DNE",0
31,"31193",1312,969,948,33,21,"DNE",0
31,"31220",771,584,572,9,12,"DNE",0
31,"31214",95,64,64,1,0,"DNE",0
31,"31162",53,35,34,1,1,"DNE",0
31,"31155",264,187,183,7,4,"DNE",0
31,"31027",824,611,609,2,2,"DNE",0
31,"31059",204,140,139,3,1,"DNE",0
31,"31230",118,88,85,1,3,"DNE",0
31,"31105",1619,1306,1284,30,22,"DNE",0
31,"31062",1103,849,832,7,17,"DNE",0
31,"31195",186,127,126,1,1,"DNE",0
31,"31111",100,75,75,1,0,"DNE",0
31,"31164",604,462,448,9,14,"DNE",0
31,"31025",751,501,495,12,6,"DNE",0
31,"31132",160,124,124,6,0,"DNE",0
31,"31161",321,251,246,5,5,"DNE",0
31,"31041",1397,938,913,26,25,"DNE",0
31,"31234",148,107,105,6,2,"DNE",0
31,"31048",154,118,117,0,1,"DNE",0
31,"31077",5349,4025,3917,103,108,"DNE",0
31,"31017",358,220,219,12,1,"DNE",0
31,"31208",2574,2003,1966,32,37,"DNE",0
31,"31023",5338,3986,3920,120,66,"DNE",0
31,"31197",69,58,57,1,1,"DNE",0
31,"31248",318,190,187,2,3,"DNE",0
31,"31205",465,335,325,9,10,"DNE",0
31,"31097",10461,7152,7029,129,123,"DNE",0
31,"31052",89,62,58,1,4,"DNE",0
31,"31176",2777,1999,1955,57,44,"DNE",0
31,"31005",312,209,206,4,3,"DNE",0
31,"31091",365,227,224,3,3,"DNE",0
31,"31047",283,208,204,3,4,"DNE",0
31,"31159",1158,864,846,17,18,"DNE",0
31,"31142",1443,906,899,16,7,"DNE",0
31,"31190",48,34,34,1,0,"DNE",0
31,"31068",3004,2258,2207,43,51,"DNE",0
31,"31181",168,121,119,3,2,"DNE",0
31,"31192",148,107,104,1,3,"DNE",0
31,"31096",127,112,110,2,2,"DNE",0
31,"31031",234,144,143,1,1,"DNE",0
31,"31171",738,521,495,7,26,"DNE",0
31,"31212",173,117,117,3,0,"DNE",0
31,"31028",217,129,128,1,1,"DNE",0
31,"31024",116,56,56,2,0,"DNE",0
31,"31075",96,61,61,0,0,"DNE",0
31,"31057",1863,1450,1409,32,41,"DNE",0
31,"31216",3911,2699,2653,82,46,"DNE",0
31,"31256",113,64,64,0,0,"DNE",0
31,"31039",94,65,61,0,4,"DNE",0
31,"31146",46,34,34,1,0,"DNE",0
31,"31235",189,111,110,0,1,"DNE",0
31,"31104",1990,1374,1355,20,19,"DNE",0
31,"31223",1043,783,771,14,12,"DNE",0
31,"31115",171,112,109,2,3,"DNE",0
31,"31265",81,52,50,0,2,"DNE",0
31,"31263",241,135,132,0,3,"DNE",0
31,"31194",308,212,210,6,2,"DNE",0
31,"31065",1927,1391,1362,39,29,"DNE",0
31,"31108",1969,1474,1452,23,22,"DNE",0
31,"31250",2887,1827,1802,20,25,"DNE",0
31,"31209",155,105,104,1,1,"DNE",0
31,"31224",980,691,681,9,10,"DNE",0
31,"31908",997,692,683,9,9,"DNE",0
31,"31053",595,430,418,6,12,"DNE",0
31,"31174",115,72,70,1,2,"DNE",0
31,"31156",268,202,201,5,1,"DNE",0
31,"31140",117,91,89,3,2,"DNE",0
31,"31149",2381,1626,1607,7,19,"DNE",0
31,"31207",280,198,195,7,3,"DNE",0
31,"31245",87,59,58,5,1,"DNE",0
31,"31261",271,202,201,4,1,"DNE",0
31,"31054",498,310,308,1,2,"DNE",0
31,"31128",406,261,261,4,0,"DNE",0
31,"31228",540,376,364,13,12,"DNE",0
31,"31001",88,58,58,1,0,"DNE",0
31,"31255",100,78,78,1,0,"DNE",0
31,"31246",148,101,100,3,1,"DNE",0
31,"31070",2706,1949,1912,34,37,"DNE",0
31,"31187",122,68,68,2,0,"DNE",0
31,"31186",299,205,200,3,5,"DNE",0
31,"31112",106,79,78,0,1,"DNE",0
31,"31252",91,60,58,0,2,"DNE",0
31,"31221",1182,774,767,12,7,"DNE",0
31,"31217",382,256,244,5,12,"DNE",0
31,"31241",164,117,116,4,1,"DNE",0
31,"31021",75,52,52,0,0,"DNE",0
31,"31016",7377,5149,5072,101,77,"DNE",0
31,"31150",234,163,162,5,1,"DNE",0
31,"31040",197,137,135,2,2,"DNE",0
31,"31211",25,14,14,2,0,"DNE",0
31,"31204",45,35,34,0,1,"DNE",0
31,"31151",77,49,49,2,0,"DNE",0
31,"31082",634,402,398,10,4,"DNE",0
31,"31125",269,172,169,6,3,"DNE",0
31,"31064",1500,1137,1120,12,17,"DNE",0
31,"31196",40,35,35,1,0,"DNE",0
31,"31210",219,169,167,3,2,"DNE",0
31,"31203",30,25,25,0,0,"DNE",0
31,"31044",276,224,223,0,1,"DNE",0
31,"31067",1982,1400,1363,28,37,"DNE",0
31,"31906",2493,1796,1770,57,26,"DNE",0
31,"31247",171,121,121,1,0,"DNE",0
31,"31011",688,437,432,17,5,"DNE",0
31,"31236",1333,887,874,15,13,"DNE",0
31,"31035",60,47,47,0,0,"DNE",0
31,"31049",733,479,479,4,0,"DNE",0
31,"31179",558,384,384,3,0,"DNE",0
31,"31903",6058,3985,3919,67,66,"DNE",0
31,"31122",4506,3333,3281,76,52,"DNE",0
31,"31007",137,96,90,2,6,"DNE",0
31,"31907",9914,7394,7282,198,112,"DNE",0
31,"31258",7679,5561,5475,92,86,"DNE",0
31,"31169",2285,1621,1590,43,31,"DNE",0
31,"31118",182,114,114,6,0,"DNE",0
31,"31180",240,174,170,5,4,"DNE",0
31,"31189",1229,745,740,5,5,"DNE",0
31,"31004",36,21,20,0,1,"DNE",0
31,"31253",123,102,97,0,5,"DNE",0
31,"31037",94,68,68,0,0,"DNE",0
31,"31088",5358,3655,3592,97,63,"DNE",0
31,"31009",717,510,497,14,13,"DNE",0
31,"31213",114,58,58,0,0,"DNE",0
31,"31076",2314,1843,1823,39,20,"DNE",0
31,"31902",3722,2670,2632,77,38,"DNE",0
31,"31237",198,137,136,7,1,"DNE",0
31,"31199",161,103,103,1,0,"DNE",0
31,"31071",17,15,15,0,0,"DNE",0
31,"31148",99,69,66,2,3,"DNE",0
31,"31206",2079,1517,1475,33,42,"DNE",0
31,"31168",247,165,163,0,2,"DNE",0
31,"31232",24440,17810,17436,420,374,"DNE",0
31,"31136",438,283,283,10,0,"DNE",0
31,"31014",280,197,196,2,1,"DNE",0
31,"31227",8257,5987,5884,125,103,"DNE",0
31,"31251",3147,2274,2225,39,49,"DNE",0
31,"31138",939,648,646,14,2,"DNE",0
31,"31087",163,122,121,3,1,"DNE",0
31,"31098",1762,1285,1262,34,23,"DNE",0
32,"32002",2060,1566,1551,13,15,"eQuo",4
32,"32016",1021,781,776,2,5,"eQuo",1
32,"32044",939,774,764,8,10,"eQuo",2
32,"32027",1156,850,836,15,14,"eQuo",0
32,"32001",4938,3715,3667,50,48,"eQuo",31
32,"32052",2126,1690,1673,28,17,"eQuo",6
32,"32068",1631,1187,1174,4,13,"eQuo",3
32,"32088",1749,1232,1217,10,15,"eQuo",5
32,"32024",5054,3668,3609,40,59,"eQuo",15
32,"32008",7618,5529,5433,83,96,"eQuo",45
32,"32072",3949,2881,2841,32,40,"eQuo",9
32,"32089",1480,1063,1045,7,18,"eQuo",1
32,"32065",720,550,539,3,11,"eQuo",0
32,"32059",1983,1526,1510,27,16,"eQuo",7
32,"32053",1500,1206,1199,19,7,"eQuo",1
32,"32009",10752,7778,7684,120,94,"eQuo",35
32,"32022",1591,1219,1207,9,12,"eQuo",6
32,"32063",2127,1469,1444,22,25,"eQuo",6
32,"32074",1180,892,876,11,16,"eQuo",4
32,"32080",394,311,309,3,2,"eQuo",0
32,"32029",557,426,424,1,2,"eQuo",0
32,"32090",834,662,657,4,5,"eQuo",1
32,"32048",1004,687,671,48,16,"eQuo",1
32,"32020",2958,2300,2283,19,17,"eQuo",0
32,"32032",8284,6295,6198,84,97,"eQuo",24
32,"32012",912,763,756,8,7,"eQuo",0
32,"32057",608,475,473,4,2,"eQuo",3
32,"32011",1026,660,650,4,10,"eQuo",1
32,"32046",1375,976,962,3,14,"eQuo",4
32,"32035",1632,1100,1088,8,12,"eQuo",2
32,"32055",1412,1056,1037,5,19,"eQuo",9
32,"32056",1861,1378,1369,8,9,"eQuo",2
32,"32086",2874,2026,2003,18,23,"eQuo",7
32,"32050",2663,1991,1974,17,17,"eQuo",1
32,"32038",497,360,358,2,2,"eQuo",0
32,"32045",2640,1999,1980,23,19,"eQuo",8
32,"32041",884,576,568,2,8,"eQuo",3
32,"32017",1333,906,895,10,11,"eQuo",2
32,"32003",950,736,727,3,9,"eQuo",6
32,"32091",1971,1472,1466,12,6,"eQuo",1
32,"32026",2775,2096,2064,37,32,"eQuo",8
32,"32084",1084,818,805,0,13,"eQuo",0
32,"32006",1814,1344,1330,20,14,"eQuo",3
32,"32060",885,650,641,10,9,"eQuo",2
32,"32043",2679,2006,1985,14,21,"eQuo",8
32,"32092",596,367,364,2,3,"eQuo",1
32,"32004",2071,1145,1142,7,3,"eQuo",4
32,"32036",1528,1217,1202,13,15,"eQuo",2
32,"32077",1234,999,993,23,6,"eQuo",1
32,"32021",1043,793,788,7,5,"eQuo",0
32,"32071",1614,1121,1112,4,9,"eQuo",3
32,"32033",843,595,583,7,12,"eQuo",1
32,"32015",995,697,694,9,3,"eQuo",0
32,"32075",3839,2957,2910,51,47,"eQuo",13
32,"32054",87289,63027,61875,1263,1152,"eQuo",610
32,"32023",1360,1030,1011,6,19,"eQuo",1
32,"32034",1228,995,990,5,5,"eQuo",0
32,"32076",2358,1835,1823,18,12,"eQuo",1
32,"32066",634,492,488,0,4,"eQuo",1
32,"32069",4573,3624,3580,35,44,"eQuo",15
32,"32025",1218,954,941,12,13,"eQuo",2
32,"32013",2464,1695,1671,10,24,"eQuo",7
32,"32081",2240,1698,1682,13,16,"eQuo",11
32,"32064",561,439,437,5,2,"eQuo",1
32,"32014",1271,939,925,9,14,"eQuo",0
32,"32083",960,675,672,0,3,"eQuo",2
32,"32079",1448,1103,1094,14,9,"eQuo",4
32,"32067",1487,1004,995,10,9,"eQuo",1
32,"32058",5253,3872,3821,57,51,"eQuo",31
32,"32047",2003,1595,1575,10,20,"eQuo",5
32,"32070",660,457,452,1,5,"eQuo",0
32,"32051",1574,1296,1290,7,6,"eQuo",1
32,"32030",1120,857,846,9,11,"eQuo",6
32,"32085",10730,7588,7475,100,113,"eQuo",30
32,"32007",1674,1263,1243,4,20,"eQuo",3
32,"32005",957,760,753,8,7,"eQuo",1
32,"32078",1366,1026,1018,3,8,"eQuo",3
32,"32028",1805,1369,1354,16,15,"eQuo",2
32,"32031",1079,837,828,5,9,"eQuo",4
32,"32018",1351,1100,1092,9,8,"eQuo",1
32,"32042",1784,1292,1282,13,10,"eQuo",0
32,"32039",1424,1084,1069,10,15,"eQuo",1
32,"32049",863,566,563,7,3,"eQuo",3
32,"32062",963,735,729,10,6,"eQuo",1
32,"32061",1196,976,973,4,3,"eQuo",3
32,"32019",11469,8297,8180,134,117,"eQuo",48
32,"32082",1403,1055,1047,9,8,"eQuo",3
32,"32087",1935,1609,1591,11,18,"eQuo",6
32,"32010",457,362,356,0,6,"eQuo",3
32,"32040",1587,1226,1219,7,7,"eQuo",2
32,"32073",1415,1111,1100,8,11,"eQuo",1
32,"32037",828,660,654,10,6,"eQuo",0
16,"16219",106,83,82,0,1,"EQUO",1
1,"1902",776,532,526,6,6,"EQUO",12
31,"31038",1372,982,968,17,14,"EQUO",5
1,"1003",1199,863,848,2,15,"EQUO",12
29,"29027",2416,1907,1893,15,14,"EQUO",1
37,"37287",341,247,246,1,1,"EQUO",5
15,"15074",4254,3246,3219,35,27,"EQUO",11
41,"41903",6653,5134,5070,61,64,"EQUO",15
37,"37221",465,360,353,0,7,"EQUO",0
1,"1013",711,477,474,1,3,"EQUO",19
47,"47133",2382,1861,1841,30,20,"EQUO",36
50,"50262",1216,916,904,20,12,"EQUO",4
18,"18141",484,326,325,1,1,"EQUO",1
4,"4080",194,169,168,1,1,"EQUO",1
2,"2012",1834,1632,1622,12,10,"EQUO",2
18,"18107",988,769,760,3,9,"EQUO",0
18,"18162",947,726,721,8,5,"EQUO",2
21,"21035",9657,6943,6871,64,72,"EQUO",37
16,"16091",86,66,66,1,0,"EQUO",0
13,"13037",901,752,745,2,7,"EQUO",0
31,"31190",48,34,34,1,0,"EQUO",0
10,"10152",499,424,418,4,6,"EQUO",0
47,"47155",3043,2246,2225,35,21,"EQUO",12
41,"41001",1642,1314,1302,10,12,"EQUO",2
48,"48009",767,585,580,4,5,"EQUO",1
10,"10170",269,217,215,4,2,"EQUO",1
24,"24067",700,453,447,4,6,"EQUO",1
23,"23019",1590,1355,1339,7,16,"EQUO",5
2,"2073",4924,3923,3847,76,76,"EQUO",9
6,"6002",4321,3272,3195,32,77,"EQUO",5
28,"28183",935,663,649,7,14,"EQUO",52
50,"50050",109,73,73,1,0,"EQUO",0
24,"24145",656,420,420,11,0,"EQUO",1
26,"26143",187,154,151,4,3,"EQUO",4
37,"37260",175,122,122,1,0,"EQUO",2
50,"50096",49,35,35,0,0,"EQUO",0
50,"50178",325,228,225,4,3,"EQUO",0
10,"10016",321,266,262,2,4,"EQUO",1
2,"2013",158,123,121,1,2,"EQUO",1
2,"2020",519,433,430,0,3,"EQUO",1
30,"30008",13289,9992,9849,86,143,"EQUO",77
18,"18123",307,239,238,1,1,"EQUO",6
42,"42201",27,24,24,2,0,"EQUO",0
19,"19171",4352,3299,3221,35,78,"EQUO",33
15,"15058",26931,19505,19196,471,309,"EQUO",289
42,"42070",45,29,28,0,1,"EQUO",0
37,"37109",191,142,141,1,1,"EQUO",0
23,"23020",1623,1414,1400,16,14,"EQUO",8
24,"24143",515,376,373,6,3,"EQUO",2
19,"19121",277,219,217,0,2,"EQUO",0
1,"1059",183468,127839,125801,1422,2038,"EQUO",2950
2,"2028",139,115,115,1,0,"EQUO",0
50,"50193",635,483,465,3,18,"EQUO",2
21,"21047",1965,1355,1325,17,30,"EQUO",4
20,"20028",2204,1400,1379,11,21,"EQUO",7
41,"41049",8898,6881,6812,95,69,"EQUO",99
22,"22042",115,93,91,1,2,"EQUO",1
37,"37223",127,102,101,1,1,"EQUO",0
5,"5029",132,102,102,0,0,"EQUO",0
29,"29016",272,180,179,5,1,"EQUO",1
18,"18150",6452,4666,4625,56,41,"EQUO",14
37,"37375",764,636,627,19,9,"EQUO",1
50,"50216",267,201,194,8,7,"EQUO",0
24,"24114",3441,2322,2304,42,18,"EQUO",4
41,"41071",5603,3999,3932,28,67,"EQUO",8
15,"15042",3249,2341,2303,25,38,"EQUO",6
26,"26128",116,94,93,0,1,"EQUO",0
9,"9093",154,127,125,1,2,"EQUO",0
1,"1054",959,680,675,8,5,"EQUO",23
31,"31152",1406,1003,975,23,28,"EQUO",5
29,"29055",1837,1478,1454,12,24,"EQUO",7
28,"28164",2807,2194,2173,10,21,"EQUO",15
28,"28112",168,138,137,0,1,"EQUO",0
18,"18089",15803,10794,10712,95,82,"EQUO",45
16,"16277",128,100,100,3,0,"EQUO",0
18,"18133",2256,1783,1773,12,10,"EQUO",4
22,"22003",148,117,116,2,1,"EQUO",5
9,"9391",383,290,284,7,6,"EQUO",2
2,"2010",1877,1557,1519,15,38,"EQUO",2
35,"35025",1941,1345,1328,12,17,"EQUO",10
39,"39033",604,480,473,3,7,"EQUO",2
21,"21045",261,200,200,5,0,"EQUO",6
2,"2082",121,107,107,1,0,"EQUO",1
39,"39087",43561,33709,33242,404,467,"EQUO",212
18,"18088",1576,1258,1253,2,5,"EQUO",0
1,"1016",461,241,237,2,4,"EQUO",0
41,"41053",20729,16178,15971,142,207,"EQUO",83
37,"37215",156,106,106,1,0,"EQUO",0
1,"1043",2322,1623,1595,12,28,"EQUO",15
37,"37013",133,93,85,5,8,"EQUO",0
6,"6109",4006,3435,3372,21,63,"EQUO",5
28,"28902",453,338,329,3,9,"EQUO",14
18,"18124",387,270,267,0,3,"EQUO",0
9,"9208",252,192,192,6,0,"EQUO",0
24,"24163",3706,2760,2714,57,46,"EQUO",39
5,"5078",128,112,111,2,1,"EQUO",1
42,"42023",78,58,58,1,0,"EQUO",1
19,"19115",41,26,26,1,0,"EQUO",0
16,"16115",60,45,45,0,0,"EQUO",0
22,"22176",173,154,149,2,5,"EQUO",0
19,"19286",743,566,554,8,12,"EQUO",7
24,"24199",432,280,278,2,2,"EQUO",3
29,"29011",3013,1893,1876,7,17,"EQUO",3
28,"28159",629,482,478,2,4,"EQUO",6
23,"23086",11411,8918,8798,129,120,"EQUO",52
10,"10162",616,505,496,1,9,"EQUO",1
4,"4007",791,599,599,5,0,"EQUO",0
22,"22052",997,776,769,15,7,"EQUO",6
50,"50069",68,32,32,0,0,"EQUO",0
31,"31042",2719,2100,2057,27,43,"EQUO",4
41,"41027",4061,2783,2752,28,31,"EQUO",14
22,"22054",1602,1040,982,42,58,"EQUO",29
40,"40111",72,57,55,0,2,"EQUO",0
37,"37192",362,229,221,3,8,"EQUO",0
18,"18153",8348,6170,6118,88,52,"EQUO",35
5,"5060",127,108,105,1,3,"EQUO",0
41,"41076",2227,1507,1492,5,15,"EQUO",1
26,"26088",48,41,41,0,0,"EQUO",0
40,"40903",102,75,75,0,0,"EQUO",0
4,"4082",309,216,214,3,2,"EQUO",3
26,"26174",154,122,122,2,0,"EQUO",4
50,"50249",333,280,272,2,8,"EQUO",2
9,"9196",161,111,110,0,1,"EQUO",1
24,"24216",782,582,574,3,8,"EQUO",2
6,"6096",254,202,201,0,1,"EQUO",0
31,"31078",2502,1880,1852,33,28,"EQUO",9
19,"19199",24,21,21,0,0,"EQUO",0
48,"48059",397,289,286,0,3,"EQUO",2
5,"5083",155,120,113,1,7,"EQUO",0
11,"11006",24221,16564,16470,197,94,"EQUO",116
39,"39059",8476,6365,6284,73,81,"EQUO",30
19,"19213",72,60,60,1,0,"EQUO",0
50,"50188",34,28,27,0,1,"EQUO",0
35,"35019",30279,17607,17380,158,227,"EQUO",116
40,"40123",168,130,126,3,4,"EQUO",2
6,"6017",292,250,250,0,0,"EQUO",0
41,"41082",3448,2827,2796,15,31,"EQUO",5
42,"42029",164,114,113,1,1,"EQUO",0
6,"6093",4599,3658,3612,22,46,"EQUO",10
9,"9328",81,56,56,2,0,"EQUO",2
22,"22048",12485,9146,9028,237,118,"EQUO",90
37,"37052",274,213,212,1,1,"EQUO",0
31,"31047",283,208,204,3,4,"EQUO",1
29,"29054",39904,27540,27307,240,233,"EQUO",223
24,"24038",3206,2439,2399,37,40,"EQUO",11
2,"2040",631,569,566,3,3,"EQUO",1
19,"19188",72,48,48,1,0,"EQUO",0
47,"47039",196,163,163,1,0,"EQUO",0
40,"40188",120,82,81,0,1,"EQUO",0
37,"37229",144,108,108,0,0,"EQUO",0
9,"9200",54,35,35,2,0,"EQUO",0
40,"40203",814,643,631,14,12,"EQUO",23
18,"18165",3942,2819,2776,27,43,"EQUO",14
19,"19232",89,68,67,0,1,"EQUO",0
37,"37300",586,430,421,6,9,"EQUO",2
41,"41061",2205,1798,1770,2,28,"EQUO",2
24,"24080",228,165,164,0,1,"EQUO",0
23,"23093",3313,2706,2673,13,33,"EQUO",3
41,"41024",22383,15333,15160,213,173,"EQUO",92
21,"21042",15246,8640,8572,154,68,"EQUO",62
19,"19156",1032,782,762,4,20,"EQUO",1
24,"24073",521,385,382,4,3,"EQUO",0
37,"37072",184,157,155,5,2,"EQUO",0
47,"47058",199,157,157,3,0,"EQUO",0
31,"31012",839,577,570,10,7,"EQUO",8
47,"47159",862,704,695,20,9,"EQUO",1
24,"24167",813,509,509,8,0,"EQUO",1
18,"18034",510,377,375,2,2,"EQUO",2
50,"50136",617,469,462,4,7,"EQUO",0
2,"2055",1267,900,884,6,16,"EQUO",4
19,"19233",108,93,90,2,3,"EQUO",0
36,"36026",20494,14048,13798,232,250,"EQUO",88
37,"37147",201,153,151,1,2,"EQUO",3
5,"5141",99,90,89,0,1,"EQUO",0
18,"18913",827,653,646,2,7,"EQUO",1
31,"31170",46,40,39,3,1,"EQUO",7
5,"5040",77,59,59,1,0,"EQUO",1
33,"33065",1150,791,784,16,7,"EQUO",0
50,"50280",370,296,291,5,5,"EQUO",0
11,"11029",5360,3445,3423,27,22,"EQUO",2
19,"19111",180,147,146,0,1,"EQUO",0
21,"21031",1309,903,871,9,32,"EQUO",1
4,"4063",1199,871,862,6,9,"EQUO",2
47,"47114",4107,2877,2834,37,43,"EQUO",23
22,"22089",329,246,237,8,9,"EQUO",0
45,"45149",638,542,533,2,9,"EQUO",0
9,"9155",27,17,17,0,0,"EQUO",0
50,"50179",269,230,229,2,1,"EQUO",0
26,"26152",38,31,31,0,0,"EQUO",0
18,"18136",1973,1679,1668,5,11,"EQUO",0
19,"19296",43,31,30,1,1,"EQUO",2
41,"41078",2587,1979,1970,15,9,"EQUO",6
29,"29052",245,151,151,0,0,"EQUO",0
37,"37121",557,458,451,8,7,"EQUO",1
2,"2045",3763,3086,3035,42,51,"EQUO",8
40,"40902",137,118,118,3,0,"EQUO",1
19,"19235",121,92,87,0,5,"EQUO",0
18,"18068",1456,1105,1088,13,17,"EQUO",16
31,"31066",915,660,647,19,13,"EQUO",1
31,"31167",859,600,593,11,7,"EQUO",7
26,"26066",277,229,228,9,1,"EQUO",1
6,"6108",2355,1773,1746,24,27,"EQUO",5
10,"10131",12797,9017,8922,131,95,"EQUO",54
23,"23091",790,668,664,3,4,"EQUO",0
16,"16107",161,101,98,1,3,"EQUO",1
36,"36018",3492,2516,2494,25,22,"EQUO",9
29,"29044",866,631,627,3,4,"EQUO",1
5,"5046",44,39,38,1,1,"EQUO",0
37,"37123",206,166,165,1,1,"EQUO",0
47,"47197",932,739,730,15,9,"EQUO",5
24,"24214",716,518,509,4,9,"EQUO",2
35,"35031",6968,4927,4862,71,65,"EQUO",51
37,"37193",432,310,309,5,1,"EQUO",0
22,"22020",110,81,79,3,2,"EQUO",1
28,"28053",6035,4854,4783,61,71,"EQUO",62
28,"28146",1672,1220,1205,4,15,"EQUO",1
19,"19280",3415,2521,2490,27,31,"EQUO",15
50,"50185",150,109,109,2,0,"EQUO",13
18,"18109",607,461,456,1,5,"EQUO",0
2,"2076",371,292,287,3,5,"EQUO",0
41,"41083",1176,915,908,8,7,"EQUO",3
37,"37157",94,65,65,0,0,"EQUO",0
24,"24119",742,524,510,15,14,"EQUO",4
50,"50230",1295,914,903,13,11,"EQUO",0
50,"50016",51,30,30,1,0,"EQUO",0
9,"9067",460,335,328,5,7,"EQUO",2
14,"14005",6334,4262,4206,61,56,"EQUO",17
37,"37149",78,69,69,0,0,"EQUO",3
9,"9239",52,42,42,1,0,"EQUO",0
37,"37186",109,88,88,2,0,"EQUO",0
18,"18084",3954,3039,3015,50,24,"EQUO",30
5,"5254",212,186,185,2,1,"EQUO",0
23,"23077",668,523,518,2,5,"EQUO",2
45,"45015",624,485,480,2,5,"EQUO",4
35,"35007",569,392,391,2,1,"EQUO",2
5,"5038",131,88,84,0,4,"EQUO",0
24,"24059",956,592,585,9,7,"EQUO",4
37,"37103",483,354,351,1,3,"EQUO",0
19,"19237",53,40,39,2,1,"EQUO",0
28,"28150",2985,2363,2345,21,18,"EQUO",17
20,"20014",1101,660,654,8,6,"EQUO",3
18,"18163",327,246,238,0,8,"EQUO",2
9,"9283",63,36,36,0,0,"EQUO",0
31,"31150",234,163,162,5,1,"EQUO",7
16,"16068",143,117,116,6,1,"EQUO",0
50,"50056",450,329,328,4,1,"EQUO",1
45,"45163",8239,6203,6073,103,130,"EQUO",34
9,"9078",41,37,35,0,2,"EQUO",0
16,"16003",147,122,121,0,1,"EQUO",3
15,"15021",5114,3527,3475,77,52,"EQUO",15
28,"28082",5144,3967,3905,46,62,"EQUO",167
31,"31070",2706,1949,1912,34,37,"EQUO",6
6,"6154",2830,2108,2080,38,28,"EQUO",6
18,"18003",13486,10245,10100,145,145,"EQUO",68
47,"47162",80,62,62,1,0,"EQUO",1
5,"5043",86,68,68,0,0,"EQUO",1
5,"5076",477,397,385,4,12,"EQUO",9
18,"18063",1189,795,789,7,6,"EQUO",1
45,"45152",653,503,497,2,6,"EQUO",2
31,"31098",1762,1285,1262,34,23,"EQUO",20
28,"28027",1232,937,919,9,18,"EQUO",10
16,"16012",102,81,80,0,1,"EQUO",0
50,"50095",12558,9029,8910,179,119,"EQUO",34
16,"16906",104,83,82,0,1,"EQUO",2
13,"13022",403,314,314,2,0,"EQUO",1
37,"37148",451,344,343,3,1,"EQUO",1
9,"9307",119,89,88,1,1,"EQUO",1
23,"23067",2523,2004,1974,16,30,"EQUO",3
40,"40061",66,53,52,1,1,"EQUO",0
13,"13902",497,396,394,3,2,"EQUO",1
24,"24178",83,67,67,2,0,"EQUO",0
41,"41066",1417,1121,1113,9,8,"EQUO",4
24,"24098",1251,837,819,19,18,"EQUO",8
37,"37278",736,538,529,7,9,"EQUO",8
31,"31235",189,111,110,0,1,"EQUO",0
24,"24174",525,393,387,6,6,"EQUO",0
14,"14033",1289,974,958,18,16,"EQUO",4
29,"29025",34637,22545,22354,268,191,"EQUO",191
31,"31228",540,376,364,13,12,"EQUO",6
4,"4028",239,212,207,0,5,"EQUO",0
37,"37243",123,89,88,1,1,"EQUO",0
9,"9160",104,75,74,0,1,"EQUO",4
28,"28002",2650,2018,1993,24,25,"EQUO",22
15,"15071",8233,5751,5668,93,83,"EQUO",18
37,"37059",132,110,110,2,0,"EQUO",1
18,"18100",7304,5807,5737,62,70,"EQUO",20
42,"42007",143,110,110,2,0,"EQUO",2
24,"24021",1791,1251,1228,14,23,"EQUO",8
45,"45131",327,262,258,1,4,"EQUO",1
50,"50060",187,138,136,1,2,"EQUO",7
23,"23028",6428,4855,4802,26,53,"EQUO",51
37,"37074",172,136,135,1,1,"EQUO",0
50,"50041",21,13,13,0,0,"EQUO",0
50,"50142",45,25,24,0,1,"EQUO",0
24,"24224",665,490,484,8,6,"EQUO",5
45,"45197",1972,1570,1538,8,32,"EQUO",1
10,"10132",420,293,287,1,6,"EQUO",0
9,"9216",390,278,272,2,6,"EQUO",1
1,"1056",256,183,181,1,2,"EQUO",1
16,"16004",325,247,246,0,1,"EQUO",0
37,"37290",143,111,110,1,1,"EQUO",1
5,"5051",194,165,154,0,11,"EQUO",0
9,"9326",156,119,114,2,5,"EQUO",1
19,"19271",53,45,45,1,0,"EQUO",0
33,"33075",305,191,190,0,1,"EQUO",1
37,"37152",474,357,351,2,6,"EQUO",0
13,"13060",291,235,229,0,6,"EQUO",0
37,"37049",163,119,119,0,0,"EQUO",1
19,"19050",21,19,19,0,0,"EQUO",0
5,"5034",17,13,13,0,0,"EQUO",0
24,"24144",781,551,541,13,10,"EQUO",8
13,"13093",4333,3281,3229,43,52,"EQUO",18
50,"50061",228,191,183,3,8,"EQUO",1
10,"10011",611,527,519,5,8,"EQUO",4
50,"50237",103,76,75,0,1,"EQUO",0
47,"47195",449,350,346,5,4,"EQUO",1
21,"21052",4741,2897,2839,21,58,"EQUO",14
1,"1058",1342,877,872,8,5,"EQUO",19
24,"24007",798,582,566,2,16,"EQUO",4
23,"23090",1371,1188,1177,6,11,"EQUO",1
23,"23046",2441,2049,2027,13,22,"EQUO",1
50,"50062",1750,1298,1275,22,23,"EQUO",10
1,"1032",536,412,400,0,12,"EQUO",4
50,"50228",295,238,236,10,2,"EQUO",0
31,"31239",302,229,224,7,5,"EQUO",0
18,"18082",912,691,683,8,8,"EQUO",0
36,"36029",16178,11902,11636,148,266,"EQUO",90
50,"50238",114,82,80,0,2,"EQUO",0
16,"16248",887,733,710,20,23,"EQUO",1
45,"45171",1359,1114,1093,13,21,"EQUO",3
19,"19334",50,37,37,0,0,"EQUO",0
47,"47170",40,30,30,0,0,"EQUO",0
42,"42158",112,79,79,6,0,"EQUO",5
15,"15034",3116,2146,2114,20,32,"EQUO",5
31,"31188",185,139,137,2,2,"EQUO",0
5,"5194",147,131,130,4,1,"EQUO",1
41,"41088",542,414,408,1,6,"EQUO",0
37,"37131",200,150,148,1,2,"EQUO",2
28,"28158",632,505,495,4,10,"EQUO",16
19,"19086",1655,1310,1295,10,15,"EQUO",5
18,"18168",864,613,605,4,8,"EQUO",7
24,"24181",1652,1303,1288,12,15,"EQUO",1
24,"24173",1023,757,747,4,10,"EQUO",6
45,"45173",9133,7147,7035,78,112,"EQUO",44
19,"19221",56,41,41,2,0,"EQUO",0
10,"10164",770,557,547,2,10,"EQUO",2
37,"37198",212,176,173,2,3,"EQUO",10
6,"6156",1190,989,978,9,11,"EQUO",3
2,"2048",1320,1076,1061,11,15,"EQUO",4
39,"39030",1971,1397,1379,20,18,"EQUO",15
31,"31149",2381,1626,1607,7,19,"EQUO",6
24,"24202",8677,5486,5377,103,109,"EQUO",82
33,"33017",3289,2378,2350,35,28,"EQUO",5
6,"6035",1048,879,871,5,8,"EQUO",0
37,"37212",123,95,92,1,3,"EQUO",1
9,"9281",159,134,132,5,2,"EQUO",3
29,"29018",2088,1565,1540,9,25,"EQUO",7
16,"16166",277,210,202,0,8,"EQUO",4
13,"13006",641,529,519,4,10,"EQUO",0
50,"50202",182,125,122,2,3,"EQUO",1
42,"42090",96,75,74,3,1,"EQUO",0
37,"37176",136,103,100,1,3,"EQUO",0
41,"41012",3115,2314,2271,29,43,"EQUO",15
26,"26057",52,42,42,0,0,"EQUO",0
40,"40089",248,183,177,3,6,"EQUO",1
20,"20026",214,172,172,0,0,"EQUO",1
18,"18049",632,476,474,5,2,"EQUO",3
19,"19223",129,94,90,1,4,"EQUO",0
9,"9197",160,129,128,3,1,"EQUO",1
37,"37264",78,52,52,0,0,"EQUO",2
13,"13032",1218,926,922,9,4,"EQUO",4
37,"37340",155,121,121,0,0,"EQUO",1
13,"13010",910,729,726,8,3,"EQUO",0
21,"21037",491,386,378,1,8,"EQUO",0
6,"6114",152,122,122,0,0,"EQUO",0
42,"42087",48,38,37,1,1,"EQUO",2
18,"18086",397,321,321,3,0,"EQUO",0
2,"2051",1729,1318,1303,10,15,"EQUO",2
41,"41013",4762,3359,3327,9,32,"EQUO",1
19,"19147",58,45,40,0,5,"EQUO",0
9,"9195",64,40,40,1,0,"EQUO",0
6,"6079",623,525,522,6,3,"EQUO",0
42,"42212",75,45,45,2,0,"EQUO",0
28,"28001",61,46,45,1,1,"EQUO",2
9,"9467",65,49,49,0,0,"EQUO",0
40,"40125",99,72,71,3,1,"EQUO",0
28,"28114",148,110,110,0,0,"EQUO",2
19,"19291",1271,925,902,3,23,"EQUO",2
41,"41075",9987,7904,7809,71,95,"EQUO",19
24,"24044",176,138,136,2,2,"EQUO",0
47,"47065",898,762,752,9,10,"EQUO",1
50,"50243",346,277,272,2,5,"EQUO",0
31,"31102",162,80,78,0,2,"EQUO",0
42,"42165",424,291,280,6,11,"EQUO",1
24,"24222",13915,9939,9751,304,188,"EQUO",91
31,"31099",68,50,50,0,0,"EQUO",1
50,"50002",166,130,130,2,0,"EQUO",0
21,"21029",1633,1276,1259,15,17,"EQUO",0
18,"18111",2647,1957,1941,24,16,"EQUO",25
9,"9068",25,19,19,2,0,"EQUO",1
37,"37217",60,49,48,1,1,"EQUO",0
4,"4043",520,439,435,3,4,"EQUO",1
50,"50215",21,20,19,0,1,"EQUO",1
19,"19150",128,112,108,0,4,"EQUO",1
2,"2017",895,685,682,4,3,"EQUO",0
21,"21043",1898,1382,1350,9,32,"EQUO",7
13,"13035",1043,794,770,10,24,"EQUO",6
31,"31194",308,212,210,6,2,"EQUO",3
50,"50012",105,93,90,0,3,"EQUO",1
30,"30038",15057,11640,11555,82,85,"EQUO",54
19,"19038",48,33,33,0,0,"EQUO",0
9,"9162",122,94,93,1,1,"EQUO",1
4,"4088",2516,1849,1832,7,17,"EQUO",8
37,"37181",301,232,230,2,2,"EQUO",1
37,"37293",131,108,106,5,2,"EQUO",0
50,"50130",415,288,288,7,0,"EQUO",0
18,"18157",1062,793,783,9,10,"EQUO",4
11,"11003",1290,952,940,8,12,"EQUO",1
37,"37101",185,143,141,1,2,"EQUO",0
2,"2003",129078,98135,97009,1430,1126,"EQUO",1412
45,"45177",2295,1898,1857,15,41,"EQUO",6
9,"9220",82,60,60,2,0,"EQUO",0
28,"28085",3794,2980,2933,18,47,"EQUO",55
22,"22204",1122,773,756,19,17,"EQUO",12
19,"19321",46,29,29,0,0,"EQUO",0
37,"37120",107,88,87,0,1,"EQUO",2
18,"18905",12975,9260,9209,155,51,"EQUO",55
41,"41043",647,457,454,5,3,"EQUO",0
15,"15035",11969,8239,8120,192,119,"EQUO",61
15,"15045",4178,2743,2727,22,16,"EQUO",4
9,"9072",272,210,209,4,1,"EQUO",1
47,"47232",107,77,75,1,2,"EQUO",0
10,"10024",663,490,480,3,10,"EQUO",4
50,"50071",134,97,96,0,1,"EQUO",0
36,"36050",7602,5424,5339,50,85,"EQUO",22
42,"42068",99,74,74,5,0,"EQUO",0
5,"5199",48,39,39,0,0,"EQUO",0
9,"9398",92,68,68,2,0,"EQUO",0
19,"19229",83,71,68,0,3,"EQUO",1
13,"13005",23052,18002,17700,255,302,"EQUO",116
6,"6046",1288,1050,1042,11,8,"EQUO",1
50,"50162",160,108,108,2,0,"EQUO",0
28,"28132",10987,8066,7943,90,123,"EQUO",59
1,"1049",147,115,115,1,0,"EQUO",4
28,"28177",9470,7524,7466,87,58,"EQUO",119
19,"19220",2225,1482,1456,7,26,"EQUO",16
23,"23060",19107,14365,14264,130,101,"EQUO",46
31,"31106",676,534,518,10,16,"EQUO",6
18,"18027",2575,1913,1899,15,14,"EQUO",4
48,"48001",5842,4040,4020,23,20,"EQUO",35
24,"24117",493,376,369,2,7,"EQUO",1
16,"16176",61,45,43,0,2,"EQUO",0
47,"47018",33,30,28,2,2,"EQUO",0
50,"50163",3427,2448,2413,62,35,"EQUO",24
10,"10190",569,438,435,6,3,"EQUO",4
37,"37373",793,591,589,4,2,"EQUO",3
18,"18907",1997,1627,1612,5,15,"EQUO",2
19,"19332",106,76,72,4,4,"EQUO",0
22,"22032",120,78,73,5,5,"EQUO",1
35,"35003",4764,2733,2680,34,53,"EQUO",38
18,"18116",2972,2237,2213,19,24,"EQUO",15
41,"41045",5505,3946,3889,68,57,"EQUO",38
45,"45186",3217,2573,2527,24,46,"EQUO",15
50,"50073",2265,1773,1756,20,17,"EQUO",2
6,"6125",1852,1419,1399,11,20,"EQUO",5
19,"19127",97,66,66,1,0,"EQUO",0
41,"41054",671,556,550,0,6,"EQUO",2
41,"41046",3055,2456,2418,23,38,"EQUO",4
13,"13096",7716,5759,5659,70,100,"EQUO",18
23,"23049",1942,1514,1486,16,28,"EQUO",2
29,"29072",3258,2484,2447,30,37,"EQUO",13
5,"5210",105,83,82,2,1,"EQUO",0
19,"19053",2172,1602,1587,14,15,"EQUO",8
50,"50164",407,271,268,4,3,"EQUO",0
36,"36053",5677,4204,4157,51,47,"EQUO",20
47,"47193",1538,1229,1211,23,18,"EQUO",16
23,"23063",3960,3073,3037,21,36,"EQUO",4
5,"5104",35,29,29,0,0,"EQUO",0
24,"24107",316,208,206,1,2,"EQUO",0
45,"45200",4633,3768,3672,37,96,"EQUO",12
28,"28157",605,452,446,2,6,"EQUO",1
4,"4072",339,272,271,0,1,"EQUO",1
4,"4024",3049,2396,2361,19,35,"EQUO",8
21,"21049",3468,2327,2283,18,44,"EQUO",16
19,"19054",184,156,151,2,5,"EQUO",0
4,"4013",137455,94867,94142,1203,725,"EQUO",1460
37,"37150",43,36,34,0,2,"EQUO",0
28,"28143",81,71,67,1,4,"EQUO",0
28,"28120",1259,946,931,11,15,"EQUO",11
50,"50222",1695,1117,1091,16,26,"EQUO",4
24,"24069",53,44,44,0,0,"EQUO",0
24,"24189",5410,3630,3572,83,58,"EQUO",27
40,"40139",302,243,238,5,5,"EQUO",0
22,"22197",504,395,390,7,5,"EQUO",4
19,"19201",70,52,52,2,0,"EQUO",0
18,"18143",949,722,704,2,18,"EQUO",7
13,"13033",1719,1436,1419,6,17,"EQUO",1
1,"1006",181,133,127,2,6,"EQUO",2
5,"5109",438,359,351,5,8,"EQUO",5
23,"23066",4348,3687,3654,21,33,"EQUO",3
35,"35026",78933,49860,48955,780,905,"EQUO",490
2,"2039",1050,862,848,16,14,"EQUO",13
5,"5001",210,180,176,2,4,"EQUO",1
9,"9199",97,75,74,0,1,"EQUO",0
5,"5084",81,70,69,0,1,"EQUO",0
50,"50047",60,34,34,2,0,"EQUO",0
5,"5181",39,26,26,0,0,"EQUO",6
37,"37342",252,216,211,3,5,"EQUO",2
47,"47075",4999,4020,3957,39,63,"EQUO",18
23,"23098",923,808,807,6,1,"EQUO",0
41,"41098",4650,3665,3603,43,62,"EQUO",32
37,"37190",235,195,193,1,2,"EQUO",0
28,"28107",443,338,333,7,5,"EQUO",4
15,"15079",1709,1268,1253,14,15,"EQUO",1
2,"2077",51,46,45,0,1,"EQUO",0
18,"18061",1109,882,869,1,13,"EQUO",1
39,"39043",1321,1082,1072,8,10,"EQUO",5
45,"45166",1734,1460,1429,8,31,"EQUO",4
29,"29059",2551,1986,1964,11,22,"EQUO",5
45,"45154",1459,1148,1140,12,8,"EQUO",13
29,"29012",9817,7063,6991,51,72,"EQUO",14
16,"16006",133,117,116,2,1,"EQUO",0
2,"2041",399,311,304,1,7,"EQUO",1
2,"2066",258,219,217,2,2,"EQUO",0
22,"22036",101,82,82,1,0,"EQUO",0
41,"41067",7055,5368,5295,64,73,"EQUO",24
16,"16060",841,714,704,11,10,"EQUO",0
42,"42034",40,29,29,0,0,"EQUO",0
24,"24210",532,329,328,2,1,"EQUO",0
26,"26150",129,104,104,0,0,"EQUO",1
41,"41100",1097,894,878,8,16,"EQUO",1
31,"31002",421,292,284,5,8,"EQUO",1
26,"26121",33,28,28,0,0,"EQUO",0
9,"9006",68,40,39,1,1,"EQUO",0
9,"9219",28514,20244,19951,326,293,"EQUO",178
6,"6058",2048,1595,1574,22,21,"EQUO",6
37,"37232",412,374,373,1,1,"EQUO",0
13,"13047",5822,4735,4650,52,85,"EQUO",16
28,"28151",3025,2237,2185,9,52,"EQUO",27
16,"16019",252,210,207,2,3,"EQUO",0
16,"16047",249,192,191,5,1,"EQUO",0
22,"22021",2080,1524,1505,31,19,"EQUO",8
42,"42008",69,50,50,0,0,"EQUO",0
6,"6029",1230,884,880,5,4,"EQUO",1
28,"28032",4469,3412,3369,32,43,"EQUO",23
37,"37269",475,383,382,2,1,"EQUO",1
4,"4100",7918,5465,5425,52,40,"EQUO",52
39,"39028",3513,2760,2718,23,42,"EQUO",11
31,"31014",280,197,196,2,1,"EQUO",3
16,"16022",102,76,76,2,0,"EQUO",0
24,"24090",366,225,224,2,1,"EQUO",3
21,"21055",6320,4819,4760,46,59,"EQUO",20
48,"48077",3398,2490,2477,33,13,"EQUO",32
18,"18035",1254,991,982,7,9,"EQUO",3
19,"19209",50,40,39,0,1,"EQUO",0
37,"37195",48,32,32,0,0,"EQUO",2
5,"5056",94,78,73,1,5,"EQUO",0
36,"36028",4207,3294,3254,21,40,"EQUO",5
5,"5132",1040,770,753,2,17,"EQUO",3
28,"28176",10977,8790,8718,68,72,"EQUO",146
23,"23074",3039,2491,2451,29,40,"EQUO",12
45,"45122",4828,3816,3746,48,70,"EQUO",30
47,"47134",186,155,149,2,6,"EQUO",0
47,"47079",67,56,56,1,0,"EQUO",0
18,"18046",1960,1327,1312,5,15,"EQUO",4
37,"37171",437,362,358,4,4,"EQUO",0
29,"29007",25572,17726,17564,227,162,"EQUO",227
47,"47052",6207,4812,4761,79,51,"EQUO",31
26,"26111",266,203,200,4,3,"EQUO",1
22,"22206",218,169,167,3,2,"EQUO",4
10,"10082",1947,1601,1572,10,29,"EQUO",2
9,"9223",46,40,40,0,0,"EQUO",0
42,"42039",270,172,169,2,3,"EQUO",2
23,"23075",3404,2800,2782,24,18,"EQUO",4
42,"42141",124,90,87,1,3,"EQUO",0
14,"14044",1585,1279,1265,12,14,"EQUO",0
2,"2047",109,94,94,0,0,"EQUO",0
24,"24012",291,196,194,2,2,"EQUO",0
37,"37021",86,70,68,2,2,"EQUO",0
36,"36008",21702,15366,15037,261,329,"EQUO",148
19,"19080",90,64,64,0,0,"EQUO",0
4,"4048",1459,1110,1100,11,10,"EQUO",5
10,"10068",780,624,595,5,29,"EQUO",13
13,"13018",860,740,727,2,13,"EQUO",0
5,"5090",72,64,63,1,1,"EQUO",0
45,"45198",1950,1661,1641,9,20,"EQUO",1
37,"37237",330,250,242,1,8,"EQUO",1
10,"10124",873,707,707,16,0,"EQUO",2
6,"6095",9330,6974,6873,129,101,"EQUO",28
15,"15019",26096,18466,18187,350,279,"EQUO",54
9,"9075",126,102,101,1,1,"EQUO",2
13,"13008",473,362,360,4,2,"EQUO",1
18,"18038",1097,906,900,3,6,"EQUO",1
37,"37125",243,184,180,3,4,"EQUO",6
37,"37350",452,368,364,5,4,"EQUO",2
19,"19278",30,28,28,0,0,"EQUO",0
19,"19067",91,59,59,0,0,"EQUO",0
16,"16153",1006,856,843,8,13,"EQUO",2
6,"6020",1852,1476,1462,5,14,"EQUO",1
31,"31028",217,129,128,1,1,"EQUO",0
6,"6067",2030,1583,1572,16,11,"EQUO",2
26,"26129",1010,794,780,7,14,"EQUO",5
24,"24175",1760,1324,1303,29,21,"EQUO",14
4,"4902",42901,28927,28711,338,216,"EQUO",229
39,"39066",895,710,703,6,7,"EQUO",4
37,"37239",235,208,201,2,7,"EQUO",3
4,"4094",206,152,152,0,0,"EQUO",0
45,"45090",396,335,333,0,2,"EQUO",0
23,"23080",1832,1425,1414,3,11,"EQUO",2
24,"24096",145,96,93,0,3,"EQUO",2
18,"18020",1473,1111,1106,7,5,"EQUO",2
26,"26018",10396,8186,8041,161,145,"EQUO",64
11,"11037",5640,4337,4285,32,52,"EQUO",10
19,"19169",51,35,35,0,0,"EQUO",0
24,"24017",630,476,468,11,8,"EQUO",0
18,"18040",246,147,146,0,1,"EQUO",0
9,"9125",648,463,460,5,3,"EQUO",1
16,"16099",232,180,178,5,2,"EQUO",1
31,"31201",144714,104019,102644,2027,1375,"EQUO",1424
20,"20051",7033,4843,4779,57,64,"EQUO",28
42,"42093",56,39,38,0,1,"EQUO",0
5,"5224",104,90,90,0,0,"EQUO",0
6,"6023",4572,3301,3261,34,40,"EQUO",11
28,"28058",137542,103880,102686,1155,1194,"EQUO",1168
24,"24084",182,133,132,1,1,"EQUO",1
5,"5061",264,222,214,5,8,"EQUO",3
19,"19036",279,238,236,1,2,"EQUO",2
50,"50176",237,161,160,4,1,"EQUO",1
37,"37202",938,742,726,25,16,"EQUO",16
2,"2016",600,471,468,5,3,"EQUO",2
24,"24006",521,384,378,4,6,"EQUO",3
22,"22018",357,272,271,4,1,"EQUO",1
24,"24019",367,293,287,5,6,"EQUO",1
5,"5095",301,253,250,2,3,"EQUO",0
36,"36002",3154,2381,2358,35,23,"EQUO",10
41,"41040",9567,7305,7210,93,95,"EQUO",139
18,"18134",5528,3751,3679,57,72,"EQUO",57
40,"40016",63,45,45,0,0,"EQUO",1
37,"37154",156,130,125,1,5,"EQUO",0
19,"19021",1129,818,800,10,18,"EQUO",4
16,"16032",304,253,244,2,9,"EQUO",1
50,"50030",232,164,160,1,4,"EQUO",1
33,"33036",11674,8695,8605,104,90,"EQUO",58
1,"1042",915,678,661,1,17,"EQUO",6
13,"13090",1202,994,972,4,22,"EQUO",0
31,"31093",305,207,203,2,4,"EQUO",1
40,"40143",97,72,72,0,0,"EQUO",2
24,"24223",2793,2121,2113,63,8,"EQUO",9
41,"41015",5263,3820,3752,34,68,"EQUO",19
45,"45167",1552,1296,1278,14,18,"EQUO",8
47,"47006",196,151,146,1,5,"EQUO",2
37,"37032",530,410,409,4,1,"EQUO",8
23,"23101",413,324,321,3,3,"EQUO",0
37,"37060",229,179,173,2,6,"EQUO",1
4,"4099",5086,4023,3980,26,43,"EQUO",21
28,"28116",666,507,498,5,9,"EQUO",9
26,"26036",16873,12341,12167,190,174,"EQUO",78
50,"50003",141,108,108,3,0,"EQUO",0
16,"16074",53,42,42,1,0,"EQUO",0
21,"21064",6331,4390,4352,46,38,"EQUO",15
37,"37009",225,189,185,2,4,"EQUO",0
5,"5184",288,225,224,0,1,"EQUO",1
28,"28161",44185,33371,32966,353,405,"EQUO",438
50,"50110",424,315,314,6,1,"EQUO",2
37,"37345",179,156,156,2,0,"EQUO",1
50,"50080",41,31,31,1,0,"EQUO",2
47,"47223",172,147,147,6,0,"EQUO",0
9,"9084",200,147,147,4,0,"EQUO",1
22,"22250",368,261,255,12,6,"EQUO",5
24,"24212",1105,856,846,14,10,"EQUO",3
31,"31095",83,70,70,1,0,"EQUO",0
37,"37132",398,317,311,3,6,"EQUO",1
22,"22066",699,479,464,8,15,"EQUO",8
26,"26038",93,71,69,1,2,"EQUO",1
31,"31125",269,172,169,6,3,"EQUO",2
37,"37170",1571,1122,1107,22,15,"EQUO",2
24,"24023",272,196,193,6,3,"EQUO",1
41,"41069",28331,21065,20877,252,188,"EQUO",65
6,"6061",1116,1000,989,8,11,"EQUO",1
19,"19272",86,67,65,1,2,"EQUO",0
19,"19251",41,35,34,0,1,"EQUO",0
24,"24226",223,154,153,1,1,"EQUO",0
5,"5100",307,245,245,2,0,"EQUO",2
16,"16079",33,21,21,0,0,"EQUO",0
26,"26039",44,38,36,1,2,"EQUO",0
11,"11901",5576,4433,4398,69,35,"EQUO",4
19,"19308",67,61,61,0,0,"EQUO",0
26,"26153",12,9,8,0,1,"EQUO",0
13,"13028",10536,8503,8331,140,172,"EQUO",19
31,"31219",93,75,73,1,2,"EQUO",1
18,"18016",339,254,253,2,1,"EQUO",0
40,"40084",65,53,53,2,0,"EQUO",1
4,"4069",4729,3740,3706,52,34,"EQUO",25
9,"9194",2033,1557,1535,28,22,"EQUO",9
16,"16122",259,195,190,2,5,"EQUO",1
6,"6078",548,457,453,2,4,"EQUO",0
19,"19187",64,54,54,0,0,"EQUO",0
50,"50152",1569,1151,1135,31,16,"EQUO",2
45,"45172",757,597,594,7,3,"EQUO",1
29,"29045",1750,1246,1239,6,7,"EQUO",5
28,"28149",5276,4132,4063,43,69,"EQUO",46
41,"41002",1510,1161,1140,4,21,"EQUO",2
24,"24053",503,338,332,3,6,"EQUO",0
42,"42013",45,35,34,1,1,"EQUO",0
47,"47145",658,482,473,7,9,"EQUO",2
31,"31128",406,261,261,4,0,"EQUO",1
19,"19155",61,52,50,1,2,"EQUO",0
5,"5198",80,65,65,1,0,"EQUO",0
45,"45137",1610,1057,1047,11,10,"EQUO",2
10,"10042",79,63,62,2,1,"EQUO",0
33,"33032",12060,8627,8491,107,136,"EQUO",35
41,"41020",12710,8954,8882,91,72,"EQUO",9
50,"50173",175,104,104,2,0,"EQUO",0
39,"39048",1616,1326,1308,8,18,"EQUO",6
2,"2061",715,570,565,4,5,"EQUO",0
21,"21069",1778,1245,1242,11,3,"EQUO",2
37,"37250",405,277,274,1,3,"EQUO",5
19,"19005",92,80,79,0,1,"EQUO",1
19,"19081",43,33,33,0,0,"EQUO",0
6,"6081",1114,870,865,10,5,"EQUO",4
48,"48026",1093,881,875,3,6,"EQUO",3
6,"6112",411,330,326,0,4,"EQUO",0
10,"10139",117,98,97,1,1,"EQUO",1
5,"5014",5559,4197,4101,53,96,"EQUO",52
2,"2062",456,348,344,2,4,"EQUO",0
40,"40138",2195,1758,1725,18,33,"EQUO",17
20,"20062",995,687,667,5,20,"EQUO",1
39,"39049",339,244,242,5,2,"EQUO",3
1,"1004",1427,1021,996,15,25,"EQUO",10
28,"28165",1689,1310,1295,5,15,"EQUO",4
26,"26044",60,48,46,1,2,"EQUO",0
40,"40215",109,94,91,0,3,"EQUO",1
18,"18085",818,538,532,4,6,"EQUO",0
45,"45066",7334,5602,5536,52,66,"EQUO",24
16,"16085",151,123,122,2,1,"EQUO",0
4,"4095",777,547,541,8,6,"EQUO",0
26,"26161",9,8,8,0,0,"EQUO",0
9,"9227",131,100,100,1,0,"EQUO",1
5,"5190",61,48,48,3,0,"EQUO",0
18,"18184",2140,1663,1645,18,18,"EQUO",6
24,"24030",4397,3272,3229,54,43,"EQUO",16
50,"50270",39,30,29,1,1,"EQUO",0
42,"42164",1699,1244,1209,13,35,"EQUO",6
6,"6039",1848,1564,1546,13,18,"EQUO",1
41,"41048",2296,1749,1726,21,23,"EQUO",1
45,"45104",457,375,370,2,5,"EQUO",2
10,"10060",1037,758,742,9,16,"EQUO",1
24,"24031",220,180,176,3,4,"EQUO",0
29,"29030",839,669,668,5,1,"EQUO",0
37,"37330",338,272,270,3,2,"EQUO",1
14,"14029",4380,3344,3308,35,36,"EQUO",12
50,"50271",283,209,207,4,2,"EQUO",1
26,"26176",69,55,54,0,1,"EQUO",2
42,"42018",178,129,124,0,5,"EQUO",0
22,"22127",483,357,353,9,4,"EQUO",0
2,"2064",413,350,348,7,2,"EQUO",0
37,"37044",461,363,360,1,3,"EQUO",0
31,"31031",234,144,143,1,1,"EQUO",0
47,"47166",276,226,223,0,3,"EQUO",1
24,"24099",199,164,162,0,2,"EQUO",0
19,"19258",103,81,81,0,0,"EQUO",0
37,"37331",234,161,161,3,0,"EQUO",0
18,"18053",1836,1345,1340,11,5,"EQUO",6
26,"26134",102,82,80,2,2,"EQUO",2
36,"36047",2723,1875,1853,27,22,"EQUO",3
15,"15014",4239,3151,3104,39,47,"EQUO",12
28,"28137",1626,1231,1222,9,9,"EQUO",6
37,"37179",230,194,191,3,3,"EQUO",0
45,"45106",7666,6045,5945,92,100,"EQUO",28
39,"39052",17031,13198,13034,187,164,"EQUO",136
22,"22079",126,97,97,4,0,"EQUO",2
16,"16046",262,191,191,1,0,"EQUO",0
50,"50254",179,136,136,0,0,"EQUO",0
9,"9275",202,140,139,5,1,"EQUO",0
50,"50098",215,150,146,2,4,"EQUO",0
2,"2067",1197,938,924,6,14,"EQUO",6
9,"9202",26,24,24,1,0,"EQUO",0
37,"37143",410,342,338,3,4,"EQUO",0
47,"47176",229,157,157,0,0,"EQUO",0
4,"4044",1517,1232,1224,8,8,"EQUO",10
42,"42168",128,82,81,4,1,"EQUO",1
45,"45107",3006,2344,2299,32,45,"EQUO",20
50,"50013",244,195,195,1,0,"EQUO",4
31,"31247",171,121,121,1,0,"EQUO",0
50,"50207",126,97,95,1,2,"EQUO",0
6,"6120",3508,2772,2741,31,31,"EQUO",7
21,"21044",17018,11390,11290,132,100,"EQUO",47
35,"35012",9662,5511,5446,45,65,"EQUO",28
42,"42009",97,69,67,2,2,"EQUO",0
23,"23088",6177,4955,4872,94,83,"EQUO",18
9,"9248",63,52,52,0,0,"EQUO",0
11,"11004",87610,53062,52639,828,423,"EQUO",332
14,"14032",434,377,375,1,2,"EQUO",2
50,"50189",776,588,576,9,12,"EQUO",3
22,"22131",96,79,77,2,2,"EQUO",0
23,"23014",2529,2058,2039,13,19,"EQUO",10
50,"50100",355,273,266,3,7,"EQUO",0
26,"26052",181,146,146,0,0,"EQUO",0
5,"5165",386,292,280,7,12,"EQUO",2
4,"4101",3927,2827,2804,34,23,"EQUO",10
24,"24198",644,423,417,7,6,"EQUO",3
23,"23903",3537,2892,2877,12,15,"EQUO",3
22,"22235",101,88,87,1,1,"EQUO",1
15,"15073",21991,14686,14456,216,230,"EQUO",40
23,"23016",442,355,354,5,1,"EQUO",0
40,"40148",259,213,212,3,1,"EQUO",5
36,"36006",11387,8911,8727,72,184,"EQUO",40
42,"42103",626,487,481,3,6,"EQUO",1
9,"9166",97,87,87,1,0,"EQUO",0
50,"50015",109,73,73,0,0,"EQUO",0
40,"40194",40248,30946,30365,525,581,"EQUO",372
5,"5144",92,66,66,4,0,"EQUO",0
16,"16094",142,112,111,1,1,"EQUO",2
19,"19196",99,80,74,2,6,"EQUO",1
24,"24159",1901,1492,1477,11,15,"EQUO",4
31,"31137",215,108,106,1,2,"EQUO",0
40,"40054",145,103,102,1,1,"EQUO",1
33,"33047",1178,939,931,2,8,"EQUO",0
30,"30007",6115,4651,4603,29,48,"EQUO",16
9,"9407",31,27,27,0,0,"EQUO",0
5,"5123",90,69,69,3,0,"EQUO",0
9,"9120",46,35,34,1,1,"EQUO",2
18,"18047",5603,3833,3805,67,28,"EQUO",64
18,"18028",992,826,821,4,5,"EQUO",0
31,"31261",271,202,201,4,1,"EQUO",2
20,"20072",4643,2967,2948,46,19,"EQUO",28
40,"40196",44,34,34,3,0,"EQUO",0
45,"45075",205,162,159,4,3,"EQUO",2
48,"48003",14142,10268,10167,84,101,"EQUO",122
16,"16236",964,762,758,10,4,"EQUO",2
37,"37325",102,77,77,0,0,"EQUO",0
42,"42175",28,19,19,0,0,"EQUO",0
39,"39022",985,735,734,5,1,"EQUO",5
22,"22085",119,97,94,0,3,"EQUO",0
31,"31139",172,97,97,1,0,"EQUO",1
37,"37299",237,167,165,2,2,"EQUO",1
42,"42028",62,45,43,2,2,"EQUO",5
50,"50277",82,63,63,0,0,"EQUO",0
36,"36020",2581,1947,1922,27,25,"EQUO",6
22,"22086",207,149,147,1,2,"EQUO",3
28,"28080",45696,36832,36529,402,303,"EQUO",717
6,"6066",1798,1348,1340,7,8,"EQUO",0
29,"29028",1253,887,876,8,11,"EQUO",1
2,"2049",937,717,708,2,9,"EQUO",1
22,"22107",131,81,77,1,4,"EQUO",0
19,"19200",150,105,105,1,0,"EQUO",1
5,"5049",440,335,330,8,5,"EQUO",0
24,"24041",602,403,396,3,7,"EQUO",3
20,"20074",11660,8003,7951,31,52,"EQUO",62
31,"31232",24440,17810,17436,420,374,"EQUO",183
9,"9039",58,50,49,0,1,"EQUO",1
1,"1020",317,222,220,0,2,"EQUO",3
10,"10140",1143,941,927,9,14,"EQUO",4
23,"23021",541,464,453,0,11,"EQUO",0
39,"39058",862,586,584,6,2,"EQUO",7
37,"37070",538,428,427,12,1,"EQUO",1
9,"9170",218,158,157,0,1,"EQUO",1
24,"24043",144,77,77,0,0,"EQUO",0
22,"22046",784,618,599,15,19,"EQUO",0
2,"2063",1537,1252,1242,11,10,"EQUO",2
4,"4051",476,406,400,3,6,"EQUO",0
9,"9041",27,27,27,0,0,"EQUO",0
36,"36022",9203,6423,6226,100,197,"EQUO",36
18,"18098",6440,4743,4679,44,64,"EQUO",13
37,"37189",139,90,90,1,0,"EQUO",1
13,"13044",2747,1996,1950,20,46,"EQUO",4
19,"19098",22,18,18,0,0,"EQUO",0
50,"50019",79,57,55,1,2,"EQUO",0
1,"1021",473,332,324,3,8,"EQUO",12
14,"14039",2705,2204,2189,12,15,"EQUO",9
22,"22246",93,63,62,0,1,"EQUO",4
41,"41057",299,191,189,0,2,"EQUO",0
22,"22143",244,166,161,2,5,"EQUO",1
18,"18001",288,212,212,1,0,"EQUO",0
19,"19268",34,26,25,0,1,"EQUO",0
9,"9173",135,116,116,1,0,"EQUO",0
14,"14009",2864,2021,2003,8,18,"EQUO",1
35,"35001",4663,3639,3569,39,70,"EQUO",29
9,"9258",190,159,159,5,0,"EQUO",0
39,"39025",8985,7048,6955,70,93,"EQUO",23
20,"20077",5382,3766,3741,42,25,"EQUO",36
39,"39034",289,209,209,3,0,"EQUO",0
10,"10076",825,619,610,7,9,"EQUO",0
16,"16101",160,142,142,0,0,"EQUO",0
42,"42131",53,38,37,0,1,"EQUO",0
18,"18002",625,505,504,2,1,"EQUO",0
50,"50138",49,43,43,2,0,"EQUO",1
16,"16172",413,330,318,1,12,"EQUO",0
5,"5086",96,81,81,2,0,"EQUO",1
39,"39061",3458,2673,2644,42,29,"EQUO",19
2,"2005",602,490,488,2,2,"EQUO",2
18,"18167",1927,1397,1380,13,17,"EQUO",6
42,"42184",76,50,49,0,1,"EQUO",0
4,"4029",10682,7542,7474,63,68,"EQUO",20
42,"42063",69,53,53,4,0,"EQUO",0
37,"37381",153,114,109,3,5,"EQUO",0
2,"2079",2936,2305,2235,29,70,"EQUO",14
31,"31053",595,430,418,6,12,"EQUO",1
16,"16244",735,615,606,3,9,"EQUO",0
2,"2043",1335,1120,1108,10,12,"EQUO",0
4,"4055",418,368,367,5,1,"EQUO",0
41,"41059",31676,23199,22889,330,310,"EQUO",574
50,"50197",89,65,65,3,0,"EQUO",0
50,"50022",548,430,416,10,14,"EQUO",1
14,"14062",1114,889,882,9,7,"EQUO",2
5,"5019",44095,34409,33934,505,475,"EQUO",299
10,"10200",499,368,368,0,0,"EQUO",0
6,"6105",655,450,448,1,2,"EQUO",1
30,"30013",7369,5780,5731,53,49,"EQUO",12
29,"29088",2784,2019,1975,14,44,"EQUO",2
1,"1061",155,122,122,2,0,"EQUO",1
9,"9441",70,59,59,2,0,"EQUO",0
36,"36027",4478,3376,3339,29,37,"EQUO",12
37,"37158",262,181,179,0,2,"EQUO",3
28,"28040",15089,9976,9852,116,124,"EQUO",119
48,"48913",1231,936,922,10,14,"EQUO",4
5,"5251",80,58,58,0,0,"EQUO",0
13,"13016",708,555,553,2,2,"EQUO",0
41,"41086",15877,10246,10150,146,96,"EQUO",100
18,"18170",377,238,237,0,1,"EQUO",1
28,"28155",529,427,416,2,11,"EQUO",1
20,"20081",7346,4957,4925,35,32,"EQUO",33
24,"24130",468,343,337,6,6,"EQUO",2
9,"9221",446,343,340,7,3,"EQUO",7
9,"9356",57,38,37,1,1,"EQUO",0
20,"20046",1157,734,729,6,5,"EQUO",5
42,"42189",75,58,58,2,0,"EQUO",0
42,"42037",38,23,20,3,3,"EQUO",0
29,"29015",31805,22566,22347,272,219,"EQUO",108
47,"47105",210,181,179,1,2,"EQUO",0
9,"9177",1154,823,815,12,8,"EQUO",11
28,"28086",4603,3286,3248,29,38,"EQUO",33
23,"23032",598,518,515,0,3,"EQUO",1
15,"15027",1537,1263,1242,22,21,"EQUO",5
13,"13017",307,230,226,0,4,"EQUO",1
4,"4091",380,322,318,3,4,"EQUO",1
45,"45123",2961,2081,2049,30,32,"EQUO",36
2,"2083",246,215,215,0,0,"EQUO",0
19,"19106",95,68,66,0,2,"EQUO",0
37,"37197",101,72,70,1,2,"EQUO",2
9,"9178",61,48,48,0,0,"EQUO",0
2,"2071",1053,899,895,5,4,"EQUO",4
50,"50113",653,528,526,9,2,"EQUO",0
5,"5145",57,41,41,0,0,"EQUO",0
37,"37161",157,118,116,1,2,"EQUO",0
16,"16249",2076,1728,1700,11,28,"EQUO",1
23,"23033",1382,1166,1152,7,14,"EQUO",2
1,"1033",679,537,532,2,5,"EQUO",3
31,"31057",1863,1450,1409,32,41,"EQUO",2
5,"5024",268,205,201,2,4,"EQUO",0
9,"9012",105,77,74,3,3,"EQUO",1
29,"29008",14069,9934,9859,118,75,"EQUO",24
9,"9179",45,37,37,0,0,"EQUO",0
37,"37262",81,66,64,2,2,"EQUO",0
40,"40212",29,22,20,0,2,"EQUO",0
24,"24054",492,359,351,1,8,"EQUO",0
13,"13085",2455,2146,2118,21,28,"EQUO",3
16,"16110",98,81,81,3,0,"EQUO",0
20,"20012",149,97,97,0,0,"EQUO",0
37,"37199",157,115,113,0,2,"EQUO",2
18,"18909",668,536,534,2,2,"EQUO",1
30,"30017",11683,9332,9233,95,99,"EQUO",25
24,"24095",293,211,208,1,3,"EQUO",1
19,"19212",795,644,632,2,12,"EQUO",8
26,"26003",446,388,387,8,1,"EQUO",2
31,"31069",860,660,647,2,13,"EQUO",1
5,"5256",119,101,100,0,1,"EQUO",1
39,"39040",4350,3413,3373,30,40,"EQUO",12
50,"50084",84,64,64,1,0,"EQUO",0
28,"28088",251,174,173,5,1,"EQUO",5
30,"30018",7493,6003,5922,52,81,"EQUO",25
19,"19070",100,74,74,0,0,"EQUO",0
37,"37004",31,23,23,0,0,"EQUO",0
37,"37151",150,125,121,1,4,"EQUO",0
18,"18910",832,601,594,6,7,"EQUO",0
10,"10004",733,576,565,6,11,"EQUO",1
18,"18175",11534,8772,8698,68,74,"EQUO",36
41,"41065",23028,15133,14958,191,175,"EQUO",103
13,"13054",5032,3901,3824,70,77,"EQUO",10
19,"19110",73,59,57,4,2,"EQUO",0
40,"40014",60,39,39,1,0,"EQUO",0
18,"18072",710,507,499,2,8,"EQUO",0
9,"9182",104,81,81,1,0,"EQUO",0
2,"2901",2223,1678,1667,19,11,"EQUO",3
36,"36033",12323,9328,9150,97,178,"EQUO",44
5,"5160",339,290,286,2,4,"EQUO",1
15,"15088",3769,2626,2599,21,27,"EQUO",4
15,"15004",4891,3595,3545,61,50,"EQUO",18
50,"50233",120,89,88,2,1,"EQUO",0
16,"16202",908,753,744,10,9,"EQUO",0
29,"29048",1508,1254,1245,6,9,"EQUO",1
48,"48051",225,157,156,0,1,"EQUO",1
21,"21001",628,434,428,5,6,"EQUO",14
14,"14019",6486,5288,5243,65,45,"EQUO",22
6,"6162",2964,2415,2390,19,25,"EQUO",13
18,"18042",425,344,342,2,2,"EQUO",4
19,"19073",24,20,19,0,1,"EQUO",0
30,"30019",25722,18740,18553,164,187,"EQUO",80
39,"39068",663,488,485,4,3,"EQUO",3
5,"5062",213,188,184,3,4,"EQUO",1
47,"47184",575,447,443,6,4,"EQUO",3
18,"18012",2693,1841,1831,11,10,"EQUO",2
22,"22165",515,409,403,9,6,"EQUO",1
31,"31032",1785,1330,1305,24,25,"EQUO",3
19,"19182",38,24,22,0,2,"EQUO",0
50,"50118",2312,1737,1718,22,19,"EQUO",4
37,"37088",208,173,172,4,1,"EQUO",1
18,"18076",880,676,676,3,0,"EQUO",1
5,"5063",48,39,39,2,0,"EQUO",0
18,"18043",140,89,87,1,2,"EQUO",8
18,"18177",463,285,281,4,4,"EQUO",3
37,"37318",225,167,165,0,2,"EQUO",0
2,"2054",421,346,343,2,3,"EQUO",0
19,"19112",68,50,50,0,0,"EQUO",0
5,"5054",1282,979,965,5,14,"EQUO",18
19,"19102",122,101,100,0,1,"EQUO",0
9,"9189",146,101,99,2,2,"EQUO",0
47,"47167",258,230,229,3,1,"EQUO",0
21,"21033",508,385,382,7,3,"EQUO",5
18,"18146",1059,791,776,2,15,"EQUO",3
29,"29051",37991,24498,24095,381,403,"EQUO",230
24,"24061",1713,1223,1210,34,13,"EQUO",14
50,"50119",997,740,720,13,20,"EQUO",0
18,"18014",5667,4132,4085,43,47,"EQUO",33
39,"39018",4077,3212,3160,44,52,"EQUO",18
42,"42202",33,15,14,1,1,"EQUO",0
37,"37169",196,137,136,1,1,"EQUO",0
10,"10173",557,436,431,6,5,"EQUO",2
31,"31215",4618,3384,3315,54,69,"EQUO",20
19,"19001",64,56,56,1,0,"EQUO",0
37,"37010",963,705,690,5,15,"EQUO",9
37,"37078",888,728,714,9,14,"EQUO",3
47,"47059",108,77,76,1,1,"EQUO",0
50,"50264",184,140,134,0,6,"EQUO",1
42,"42052",17,10,10,0,0,"EQUO",0
4,"4031",2495,1942,1931,13,11,"EQUO",4
19,"19114",40,34,34,0,0,"EQUO",0
21,"21004",1530,1059,1042,9,17,"EQUO",14
1,"1046",629,428,421,5,7,"EQUO",2
24,"24182",448,339,333,9,6,"EQUO",0
19,"19322",35,28,27,1,1,"EQUO",0
40,"40082",131,111,110,5,1,"EQUO",0
37,"37247",216,176,173,1,3,"EQUO",0
9,"9192",74,55,53,0,2,"EQUO",0
19,"19186",93,77,77,0,0,"EQUO",0
2,"2057",2138,1736,1712,30,24,"EQUO",3
15,"15092",6869,4965,4907,53,58,"EQUO",9
42,"42053",27,26,25,1,1,"EQUO",0
40,"40132",75,50,50,1,0,"EQUO",0
26,"26169",83,73,72,0,1,"EQUO",0
42,"42157",18,16,15,0,1,"EQUO",0
42,"42011",22,14,14,1,0,"EQUO",0
42,"42054",20,14,14,0,0,"EQUO",0
50,"50209",2559,1685,1661,34,24,"EQUO",9
22,"22023",474,382,380,4,2,"EQUO",0
29,"29053",1715,1239,1221,7,18,"EQUO",9
42,"42206",10,9,9,1,0,"EQUO",0
24,"24146",284,223,221,0,2,"EQUO",3
31,"31249",1926,1376,1361,30,15,"EQUO",2
36,"36040",2627,1938,1907,24,31,"EQUO",13
41,"41070",5598,4101,4039,79,62,"EQUO",98
6,"6124",1750,1418,1378,17,40,"EQUO",3
18,"18103",803,653,647,5,6,"EQUO",0
16,"16269",494,412,407,5,5,"EQUO",1
5,"5058",81,61,59,0,2,"EQUO",0
1,"1051",3662,2242,2210,26,32,"EQUO",30
37,"37211",223,169,169,1,0,"EQUO",0
18,"18083",296,242,242,1,0,"EQUO",1
50,"50210",39,28,24,0,4,"EQUO",0
40,"40182",207,155,155,6,0,"EQUO",0
37,"37286",231,166,160,2,6,"EQUO",7
40,"40087",112,85,83,0,2,"EQUO",0
40,"40072",170,134,132,1,2,"EQUO",3
42,"42160",288,222,221,2,1,"EQUO",4
15,"15066",4180,3098,3062,38,36,"EQUO",16
16,"16213",39,32,32,1,0,"EQUO",0
5,"5070",41,33,33,0,0,"EQUO",0
4,"4071",452,364,363,1,1,"EQUO",4
15,"15901",3855,2463,2419,48,44,"EQUO",12
37,"37174",1150,942,922,3,20,"EQUO",1
21,"21008",2717,1994,1978,11,16,"EQUO",1
30,"30025",4780,3901,3874,18,27,"EQUO",5
5,"5265",87,68,66,2,2,"EQUO",0
1,"1053",590,341,333,4,8,"EQUO",11
37,"37054",273,230,229,2,1,"EQUO",0
37,"37275",136,98,98,0,0,"EQUO",0
18,"18010",576,464,458,4,6,"EQUO",1
39,"39023",6048,4795,4747,43,48,"EQUO",24
42,"42015",34,24,24,5,0,"EQUO",0
47,"47119",101,78,77,0,1,"EQUO",0
24,"24068",500,357,349,3,8,"EQUO",6
19,"19119",93,80,79,2,1,"EQUO",0
13,"13065",3011,2105,2088,24,17,"EQUO",9
42,"42058",129,103,101,1,2,"EQUO",0
42,"42211",92,69,68,0,1,"EQUO",2
50,"50212",52,48,48,0,0,"EQUO",0
48,"48060",3689,2477,2466,12,11,"EQUO",16
36,"36044",2595,1862,1834,23,28,"EQUO",12
2,"2026",845,723,716,5,7,"EQUO",1
18,"18108",892,674,673,2,1,"EQUO",0
5,"5200",56,43,42,0,1,"EQUO",1
23,"23096",2678,2298,2276,18,22,"EQUO",1
18,"18120",274,238,237,2,1,"EQUO",2
37,"37214",134,94,94,4,0,"EQUO",1
42,"42059",23,19,19,1,0,"EQUO",0
6,"6130",216,182,180,0,2,"EQUO",0
39,"39076",3388,2673,2641,22,32,"EQUO",10
36,"36045",24724,17794,17459,237,335,"EQUO",167
22,"22178",107,92,92,1,0,"EQUO",1
10,"10101",172,134,129,1,5,"EQUO",0
37,"37329",40,36,36,2,0,"EQUO",0
4,"4038",3140,2258,2231,44,27,"EQUO",15
20,"20064",12380,7568,7464,112,104,"EQUO",88
37,"37102",430,323,322,1,1,"EQUO",2
40,"40234",441,363,355,3,8,"EQUO",2
39,"39077",256,196,196,1,0,"EQUO",0
16,"16274",147,125,125,1,0,"EQUO",0
24,"24071",1060,808,797,6,11,"EQUO",6
37,"37058",68,44,44,0,0,"EQUO",0
40,"40218",111,81,80,1,1,"EQUO",6
16,"16044",51,35,35,0,0,"EQUO",0
28,"28122",504,367,366,2,1,"EQUO",8
5,"5140",112,100,99,1,1,"EQUO",0
47,"47175",6562,5041,4957,62,84,"EQUO",30
28,"28052",3799,2753,2719,17,34,"EQUO",29
45,"45031",2773,2011,1975,25,36,"EQUO",13
9,"9384",310,223,218,3,5,"EQUO",1
50,"50159",728,554,544,4,10,"EQUO",2
36,"36014",2145,1568,1548,9,20,"EQUO",4
11,"11002",4291,3388,3374,19,14,"EQUO",1
5,"5075",100,76,76,1,0,"EQUO",0
31,"31073",332,228,226,1,2,"EQUO",2
18,"18187",587,432,432,0,0,"EQUO",1
14,"14061",841,700,693,3,7,"EQUO",0
16,"16033",1792,1485,1454,10,31,"EQUO",6
42,"42021",101,70,70,1,0,"EQUO",0
19,"19259",37,32,32,0,0,"EQUO",3
23,"23901",1194,1048,1045,8,3,"EQUO",1
9,"9032",118,68,68,0,0,"EQUO",0
50,"50040",98,77,76,2,1,"EQUO",0
9,"9472",58,46,46,0,0,"EQUO",0
42,"42217",38,32,32,0,0,"EQUO",0
31,"31257",827,598,585,16,13,"EQUO",9
19,"19123",40,34,34,0,0,"EQUO",0
45,"45144",839,701,691,11,10,"EQUO",5
42,"42218",86,59,59,0,0,"EQUO",2
47,"47177",112,83,79,1,4,"EQUO",0
45,"45108",564,461,456,2,5,"EQUO",0
22,"22130",9983,6691,6573,148,118,"EQUO",85
42,"42171",158,99,94,3,5,"EQUO",0
36,"36037",2727,1923,1896,18,27,"EQUO",4
40,"40005",34,32,31,1,1,"EQUO",1
39,"39079",9035,6959,6897,55,62,"EQUO",27
37,"37258",206,151,149,2,2,"EQUO",0
16,"16278",91,69,69,2,0,"EQUO",0
47,"47124",435,364,358,5,6,"EQUO",2
50,"50131",243,185,183,6,2,"EQUO",0
6,"6136",1621,1300,1283,11,17,"EQUO",3
40,"40905",143,103,103,1,0,"EQUO",0
45,"45145",2430,1866,1821,13,45,"EQUO",9
40,"40193",231,188,185,6,3,"EQUO",6
39,"39054",4265,3338,3276,57,62,"EQUO",22
47,"47152",94,65,65,0,0,"EQUO",2
37,"37183",425,321,316,3,5,"EQUO",0
50,"50275",103,76,76,0,0,"EQUO",0
23,"23059",5974,4910,4852,37,58,"EQUO",13
9,"9478",53,41,41,1,0,"EQUO",0
21,"21015",728,453,447,6,6,"EQUO",0
42,"42024",95,80,73,1,7,"EQUO",1
18,"18192",1581,1331,1318,6,13,"EQUO",0
19,"19091",30,22,22,2,0,"EQUO",0
6,"6001",730,546,538,4,8,"EQUO",1
6,"6138",1070,838,829,13,9,"EQUO",2
39,"39003",321,265,261,0,4,"EQUO",2
36,"36051",14288,10228,10079,124,149,"EQUO",51
19,"19015",104,88,87,0,1,"EQUO",0
29,"29063",358,272,271,2,1,"EQUO",1
31,"31076",2314,1843,1823,39,20,"EQUO",27
41,"41079",9349,7095,7001,71,94,"EQUO",53
14,"14004",2016,1560,1543,8,17,"EQUO",4
5,"5177",164,134,133,0,1,"EQUO",1
50,"50248",552,421,407,5,14,"EQUO",3
6,"6140",654,533,523,7,10,"EQUO",1
18,"18193",13680,9874,9764,130,110,"EQUO",112
10,"10109",1834,1307,1287,18,20,"EQUO",7
1,"1017",910,629,621,17,8,"EQUO",7
33,"33024",229816,164603,163179,2100,1424,"EQUO",1222
47,"47208",56,45,43,1,2,"EQUO",2
23,"23061",7309,5637,5584,60,53,"EQUO",17
2,"2072",1598,1220,1198,5,22,"EQUO",6
19,"19335",77,61,61,1,0,"EQUO",0
39,"39082",1688,1280,1266,9,14,"EQUO",2
19,"19299",94,75,75,0,0,"EQUO",0
19,"19016",74,50,49,0,1,"EQUO",0
37,"37224",216,190,186,5,4,"EQUO",0
41,"41080",1289,1010,997,13,13,"EQUO",6
9,"9347",136,113,109,5,4,"EQUO",1
23,"23062",1476,1274,1264,2,10,"EQUO",0
19,"19017",87,70,70,0,0,"EQUO",0
19,"19901",43,34,34,0,0,"EQUO",0
37,"37112",162,124,124,3,0,"EQUO",0
37,"37113",439,365,365,7,0,"EQUO",0
5,"5081",44,36,36,0,0,"EQUO",0
37,"37069",952,737,723,12,14,"EQUO",6
19,"19326",1125,800,786,10,14,"EQUO",16
5,"5232",106,84,80,1,4,"EQUO",0
19,"19168",324,233,231,6,2,"EQUO",0
2,"2074",6093,4630,4548,57,82,"EQUO",28
13,"13009",1573,1265,1255,6,10,"EQUO",0
18,"18132",3461,2797,2772,19,25,"EQUO",4
4,"4083",1933,1511,1497,16,14,"EQUO",6
50,"50135",100,76,75,2,1,"EQUO",1
19,"19130",58473,45114,44362,688,752,"EQUO",448
13,"13076",514,436,428,0,8,"EQUO",0
9,"9169",96,80,80,1,0,"EQUO",0
16,"16904",508,413,407,10,6,"EQUO",5
26,"26102",6158,4794,4716,60,78,"EQUO",23
2,"2002",479,411,407,3,4,"EQUO",1
36,"36055",13678,10508,10288,155,220,"EQUO",65
41,"41004",55127,37662,37179,622,483,"EQUO",337
47,"47074",155,125,124,0,1,"EQUO",1
9,"9350",502,384,376,7,8,"EQUO",0
22,"22199",7259,4980,4861,128,119,"EQUO",69
24,"24206",1831,1362,1341,13,21,"EQUO",5
28,"28106",72603,53231,52524,681,707,"EQUO",583
50,"50251",8379,6225,6116,110,109,"EQUO",39
31,"31264",173,110,108,1,2,"EQUO",1
20,"20076",6978,4823,4762,38,61,"EQUO",44
21,"21020",398,282,282,3,0,"EQUO",1
41,"41005",8792,6642,6585,71,57,"EQUO",48
4,"4085",453,384,383,0,1,"EQUO",0
6,"6009",214,178,178,2,0,"EQUO",3
39,"39007",479,348,347,3,1,"EQUO",0
45,"45153",1704,1376,1353,9,23,"EQUO",4
9,"9351",63,46,44,0,2,"EQUO",0
28,"28173",507,397,390,2,7,"EQUO",2
50,"50020",868,646,629,5,17,"EQUO",1
18,"18903",960,761,753,1,8,"EQUO",7
19,"19303",56,48,47,1,1,"EQUO",0
40,"40202",79,59,58,0,1,"EQUO",0
22,"22004",146,97,97,2,0,"EQUO",1
40,"40110",391,303,302,6,1,"EQUO",0
22,"22201",287,203,198,2,5,"EQUO",1
22,"22049",88,70,69,5,1,"EQUO",0
45,"45043",827,679,670,3,9,"EQUO",2
9,"9353",62,51,51,2,0,"EQUO",0
21,"21022",173,123,123,1,0,"EQUO",1
24,"24209",3016,2006,1984,20,22,"EQUO",11
41,"41058",16497,12415,12248,181,167,"EQUO",81
37,"37191",127,86,85,1,1,"EQUO",0
39,"39086",386,282,280,1,2,"EQUO",0
37,"37231",285,227,225,6,2,"EQUO",2
24,"24008",9789,7277,7179,110,98,"EQUO",50
40,"40204",187,139,134,4,5,"EQUO",0
18,"18135",4752,3252,3212,34,40,"EQUO",4
50,"50298",5319,4023,3955,72,68,"EQUO",23
22,"22050",100,84,83,0,1,"EQUO",0
9,"9354",33,29,29,2,0,"EQUO",0
23,"23070",4142,2877,2846,20,31,"EQUO",9
33,"33006",1674,1130,1120,10,10,"EQUO",12
31,"31902",3722,2670,2632,77,38,"EQUO",40
40,"40063",7290,5366,5171,68,195,"EQUO",31
23,"23071",1811,1444,1431,13,13,"EQUO",12
16,"16910",104,69,69,1,0,"EQUO",0
22,"22203",92,79,79,0,0,"EQUO",1
19,"19136",22,15,15,0,0,"EQUO",0
2,"2006",612,540,534,1,6,"EQUO",0
31,"31145",173,129,127,2,2,"EQUO",0
13,"13015",5755,4334,4293,40,41,"EQUO",9
50,"50140",172,108,108,1,0,"EQUO",0
26,"26108",324,245,243,4,2,"EQUO",0
19,"19239",99,74,73,1,1,"EQUO",1
41,"41008",1073,884,875,0,9,"EQUO",1
21,"21024",502,363,358,10,5,"EQUO",2
24,"24169",3205,2317,2282,33,35,"EQUO",10
50,"50283",73,55,55,1,0,"EQUO",0
31,"31176",2777,1999,1955,57,44,"EQUO",19
47,"47051",351,269,256,5,13,"EQUO",4
39,"39010",688,533,524,6,9,"EQUO",3
9,"9906",1199,912,903,12,9,"EQUO",1
40,"40069",87,76,75,0,1,"EQUO",0
5,"5088",34,26,26,0,0,"EQUO",0
9,"9085",486,348,339,8,9,"EQUO",2
39,"39011",1646,1295,1294,5,1,"EQUO",6
33,"33053",1206,817,811,6,6,"EQUO",7
31,"31116",71,48,48,2,0,"EQUO",0
50,"50024",652,541,531,8,10,"EQUO",4
36,"36061",8729,6747,6640,68,107,"EQUO",39
19,"19138",298,223,219,3,4,"EQUO",1
45,"45159",100,84,84,1,0,"EQUO",0
9,"9907",1385,1053,1041,31,12,"EQUO",23
36,"36901",4085,3285,3235,21,50,"EQUO",10
48,"48078",39866,27311,26995,311,316,"EQUO",266
42,"42086",40,25,25,1,0,"EQUO",0
31,"31056",183,123,122,4,1,"EQUO",1
9,"9048",1565,1166,1148,20,18,"EQUO",7
41,"41036",4053,2930,2899,29,31,"EQUO",14
24,"24092",883,707,702,6,5,"EQUO",2
37,"37236",163,123,119,4,4,"EQUO",0
37,"37122",210,175,174,3,1,"EQUO",0
47,"47216",124,99,98,2,1,"EQUO",0
9,"9088",77,40,40,0,0,"EQUO",0
9,"9360",37,29,29,0,0,"EQUO",1
11,"11016",14611,9848,9774,114,74,"EQUO",31
37,"37349",136,105,104,2,1,"EQUO",0
9,"9314",113,89,88,4,1,"EQUO",0
36,"36030",4387,3206,3177,35,29,"EQUO",13
19,"19242",112,93,92,1,1,"EQUO",1
15,"15028",1485,1130,1118,14,12,"EQUO",8
37,"37081",1000,807,800,5,7,"EQUO",0
30,"30016",149046,103847,102890,1031,957,"EQUO",620
41,"41011",15274,11359,11207,145,152,"EQUO",28
31,"31179",558,384,384,3,0,"EQUO",0
30,"30042",1841,1531,1519,10,12,"EQUO",3
13,"13052",6580,4869,4786,76,83,"EQUO",11
41,"41089",6394,4593,4526,57,67,"EQUO",20
10,"10002",396,317,314,5,3,"EQUO",0
45,"45161",11339,7989,7869,95,120,"EQUO",53
42,"42089",54,44,44,3,0,"EQUO",0
40,"40213",99,75,74,1,1,"EQUO",2
47,"47137",27,22,22,2,0,"EQUO",0
37,"37351",305,261,258,2,3,"EQUO",0
9,"9225",95,61,61,3,0,"EQUO",0
24,"24134",3682,2636,2588,44,48,"EQUO",9
13,"13020",4805,3475,3434,40,41,"EQUO",13
19,"19108",117,97,95,0,2,"EQUO",0
47,"47138",259,198,195,3,3,"EQUO",1
18,"18039",3733,2901,2878,18,23,"EQUO",11
47,"47190",103,87,87,7,0,"EQUO",0
42,"42043",3905,2931,2875,48,56,"EQUO",15
37,"37126",36,26,26,0,0,"EQUO",0
10,"10126",1660,1221,1201,9,20,"EQUO",7
10,"10003",616,463,458,3,5,"EQUO",4
37,"37352",199,150,142,0,8,"EQUO",1
16,"16154",4946,3975,3914,58,61,"EQUO",10
6,"6022",2719,2274,2245,14,29,"EQUO",13
23,"23037",513,430,424,3,6,"EQUO",0
6,"6113",2750,2143,2105,26,38,"EQUO",8
31,"31211",25,14,14,2,0,"EQUO",0
9,"9054",107,80,80,1,0,"EQUO",0
47,"47139",1080,845,833,11,12,"EQUO",2
28,"28113",31318,23779,23436,271,343,"EQUO",440
23,"23081",1643,1245,1234,12,11,"EQUO",13
31,"31182",45,28,28,2,0,"EQUO",0
10,"10005",551,439,424,4,15,"EQUO",0
50,"50146",211,168,167,4,1,"EQUO",0
19,"19246",48,38,38,1,0,"EQUO",0
26,"26073",100,85,84,1,1,"EQUO",2
18,"18911",6796,4923,4867,74,56,"EQUO",24
23,"23039",2239,1799,1764,9,35,"EQUO",3
4,"4096",293,220,219,1,1,"EQUO",2
26,"26118",64,58,56,0,2,"EQUO",0
14,"14018",3795,3004,2970,24,34,"EQUO",4
5,"5258",123,105,104,1,1,"EQUO",1
24,"24058",224,166,163,1,3,"EQUO",0
19,"19317",150,122,121,2,1,"EQUO",1
13,"13089",1906,1610,1553,12,57,"EQUO",3
6,"6025",5083,3898,3851,51,47,"EQUO",8
41,"41014",2484,1956,1936,13,20,"EQUO",1
23,"23084",1046,817,812,4,5,"EQUO",3
37,"37129",247,198,198,4,0,"EQUO",0
19,"19037",153,128,128,0,0,"EQUO",2
50,"50148",365,256,251,2,5,"EQUO",3
37,"37203",174,148,148,0,0,"EQUO",4
19,"19247",171,125,118,6,7,"EQUO",2
5,"5192",96,78,77,1,1,"EQUO",0
28,"28160",7496,5680,5613,46,67,"EQUO",134
35,"35010",3565,2178,2135,26,43,"EQUO",31
4,"4065",387,320,318,1,2,"EQUO",0
31,"31062",1103,849,832,7,17,"EQUO",3
10,"10008",1393,1105,1086,10,19,"EQUO",0
18,"18145",10083,7592,7499,78,93,"EQUO",83
29,"29067",420165,273593,271376,3342,2217,"EQUO",2349
5,"5163",1762,1400,1380,5,20,"EQUO",12
13,"13025",321,257,254,1,3,"EQUO",0
22,"22217",406,314,309,4,5,"EQUO",3
24,"24100",760,563,553,14,10,"EQUO",8
37,"37244",132,97,95,5,2,"EQUO",0
20,"20019",10105,6640,6555,73,85,"EQUO",89
33,"33014",9318,6380,6320,66,60,"EQUO",40
5,"5097",525,378,373,4,5,"EQUO",2
9,"9100",56,46,44,0,2,"EQUO",0
29,"29068",6209,4025,3983,41,42,"EQUO",14
10,"10009",285,223,221,0,2,"EQUO",0
19,"19218",60,35,35,0,0,"EQUO",0
24,"24062",151,107,107,0,0,"EQUO",0
31,"31064",1500,1137,1120,12,17,"EQUO",5
45,"45132",1916,1487,1473,9,14,"EQUO",8
18,"18044",208,132,132,4,0,"EQUO",0
48,"48054",23712,16643,16439,215,204,"EQUO",255
9,"9101",79,66,66,2,0,"EQUO",0
29,"29069",80337,50235,49723,690,512,"EQUO",377
26,"26122",109,94,92,2,2,"EQUO",0
23,"23087",11474,9197,9123,90,74,"EQUO",26
2,"2056",1816,1518,1506,15,12,"EQUO",3
26,"26123",129,113,113,1,0,"EQUO",0
37,"37133",108,79,77,0,2,"EQUO",0
18,"18045",1211,892,885,4,7,"EQUO",2
42,"42100",31,31,31,0,0,"EQUO",1
19,"19250",25,23,22,0,1,"EQUO",2
18,"18147",3742,2419,2386,20,33,"EQUO",37
24,"24063",453,323,322,2,1,"EQUO",1
39,"39019",2009,1556,1536,10,20,"EQUO",12
9,"9060",171,142,142,0,0,"EQUO",0
19,"19040",73,42,42,1,0,"EQUO",0
22,"22067",82,54,49,3,5,"EQUO",2
21,"21036",213,172,167,1,5,"EQUO",0
9,"9374",96,85,81,3,4,"EQUO",0
26,"26124",860,705,694,3,11,"EQUO",2
16,"16036",143,117,115,1,2,"EQUO",0
18,"18115",2380,1843,1823,14,20,"EQUO",5
9,"9103",247,201,200,2,1,"EQUO",0
10,"10013",305,242,237,1,5,"EQUO",0
6,"6032",76,59,59,1,0,"EQUO",0
37,"37012",155,124,120,1,4,"EQUO",0
41,"41018",9457,6940,6867,66,73,"EQUO",34
22,"22173",247,150,150,3,0,"EQUO",7
24,"24104",291,198,196,3,2,"EQUO",0
22,"22068",79,51,51,2,0,"EQUO",1
15,"15037",4181,2839,2804,25,35,"EQUO",2
14,"14024",1926,1557,1527,14,30,"EQUO",5
2,"2022",431,346,343,1,3,"EQUO",0
19,"19252",90,80,78,0,2,"EQUO",0
4,"4103",1555,1159,1157,8,2,"EQUO",7
35,"35014",9943,5438,5316,95,122,"EQUO",72
50,"50239",65,44,44,0,0,"EQUO",1
21,"21007",6088,4174,4123,57,51,"EQUO",62
47,"47062",185,153,153,5,0,"EQUO",1
10,"10014",1907,1507,1488,14,19,"EQUO",3
31,"31158",264,174,173,1,1,"EQUO",2
21,"21038",1146,786,767,9,19,"EQUO",15
6,"6126",2199,1706,1686,14,20,"EQUO",6
10,"10218",1184,896,893,0,3,"EQUO",0
19,"19118",17,13,13,0,0,"EQUO",0
16,"16270",192,156,155,0,1,"EQUO",0
16,"16040",97,76,75,1,1,"EQUO",1
18,"18048",2277,1705,1688,19,17,"EQUO",3
22,"22225",2784,1839,1805,42,34,"EQUO",10
37,"37137",114,87,87,3,0,"EQUO",1
37,"37362",4333,3276,3238,65,38,"EQUO",37
13,"13031",2384,1908,1874,23,34,"EQUO",4
45,"45174",343,289,288,0,1,"EQUO",0
6,"6036",5228,4075,4028,22,47,"EQUO",11
31,"31008",97,64,63,1,1,"EQUO",0
37,"37251",137,98,93,3,5,"EQUO",0
28,"28050",3576,2706,2663,21,43,"EQUO",26
4,"4036",246,205,204,1,1,"EQUO",0
16,"16001",79,66,66,1,0,"EQUO",0
22,"22074",311,227,219,5,8,"EQUO",3
37,"37138",212,174,169,5,5,"EQUO",1
39,"39101",328,251,247,5,4,"EQUO",3
35,"35016",291589,181013,177964,2856,3049,"EQUO",2468
23,"23051",2805,2312,2290,8,22,"EQUO",7
24,"24108",421,316,314,6,2,"EQUO",0
9,"9241",198,159,158,5,1,"EQUO",9
19,"19157",66,56,56,4,0,"EQUO",0
24,"24901",994,698,686,8,12,"EQUO",0
15,"15040",2891,2160,2129,18,31,"EQUO",7
31,"31191",2930,2194,2148,43,46,"EQUO",15
47,"47148",475,389,384,2,5,"EQUO",1
4,"4037",1393,1090,1079,8,11,"EQUO",18
20,"20063",7889,5381,5340,48,41,"EQUO",50
31,"31040",197,137,135,2,2,"EQUO",0
37,"37253",137,115,115,1,0,"EQUO",0
47,"47228",481,385,383,3,2,"EQUO",0
10,"10019",1414,1054,1037,10,17,"EQUO",2
5,"5105",349,275,272,12,3,"EQUO",3
15,"15041",9718,7514,7425,102,89,"EQUO",24
35,"35017",22331,13463,13144,217,319,"EQUO",138
24,"24070",4434,3199,3136,34,63,"EQUO",9
10,"10142",822,635,625,4,10,"EQUO",5
42,"42213",31,24,24,2,0,"EQUO",0
24,"24190",183,134,131,1,3,"EQUO",1
10,"10020",1671,1386,1374,14,12,"EQUO",3
47,"47229",235,161,161,1,0,"EQUO",0
33,"33020",13542,9300,9173,135,127,"EQUO",39
4,"4004",458,367,364,6,3,"EQUO",0
5,"5204",654,521,516,7,5,"EQUO",1
48,"48095",2367,1593,1577,20,16,"EQUO",11
20,"20065",3176,2156,2137,19,19,"EQUO",11
28,"28167",7818,6016,5942,82,74,"EQUO",86
41,"41023",7901,6050,5972,45,78,"EQUO",12
10,"10143",169,135,131,1,4,"EQUO",0
37,"37216",300,270,266,2,4,"EQUO",0
31,"31011",688,437,432,17,5,"EQUO",4
6,"6041",459,406,404,4,2,"EQUO",1
5,"5902",319,262,262,0,0,"EQUO",0
21,"21012",331,254,246,2,8,"EQUO",3
23,"23055",48167,33913,33612,400,301,"EQUO",181
47,"47150",338,273,271,2,2,"EQUO",2
23,"23099",4649,3638,3594,39,44,"EQUO",14
11,"11030",22528,14741,14557,195,184,"EQUO",74
16,"16171",1930,1616,1584,25,32,"EQUO",13
10,"10022",442,377,370,1,7,"EQUO",0
40,"40190",50,41,40,1,1,"EQUO",0
9,"9114",88,75,73,0,2,"EQUO",0
16,"16276",32,23,22,1,1,"EQUO",0
33,"33044",180964,129466,128346,1888,1120,"EQUO",1050
37,"37369",143,103,103,0,0,"EQUO",0
26,"26050",114,84,81,1,3,"EQUO",0
6,"6043",661,542,532,3,10,"EQUO",3
45,"45181",2276,1788,1764,10,24,"EQUO",1
10,"10023",854,688,682,9,6,"EQUO",1
22,"22233",94,69,69,0,0,"EQUO",0
5,"5206",29,23,21,2,2,"EQUO",0
50,"50160",2397,1905,1865,19,40,"EQUO",3
9,"9115",96,71,70,4,1,"EQUO",0
10,"10105",2599,1869,1835,25,34,"EQUO",23
2,"2031",626,507,502,3,5,"EQUO",2
19,"19162",71,52,51,0,1,"EQUO",0
23,"23902",2495,2081,2067,4,14,"EQUO",5
37,"37144",398,302,301,3,1,"EQUO",0
22,"22081",268,197,196,4,1,"EQUO",5
40,"40192",179,151,150,1,1,"EQUO",1
29,"29079",2500,2016,2000,23,16,"EQUO",5
26,"26011",7455,5452,5353,93,99,"EQUO",29
18,"18056",3695,2961,2940,25,21,"EQUO",6
16,"16174",209,170,167,0,3,"EQUO",0
26,"26138",4646,3468,3398,46,70,"EQUO",16
6,"6045",513,418,412,8,6,"EQUO",1
24,"24197",784,570,564,7,6,"EQUO",0
28,"28124",83,55,53,0,2,"EQUO",0
37,"37296",385,311,308,3,3,"EQUO",1
26,"26095",126,102,102,0,0,"EQUO",2
37,"37335",432,347,346,0,1,"EQUO",2
2,"2033",1955,1565,1536,15,29,"EQUO",10
26,"26140",268,213,207,2,6,"EQUO",0
29,"29006",721,516,508,5,8,"EQUO",3
5,"5079",68,52,50,1,2,"EQUO",0
16,"16175",5058,4363,4295,70,68,"EQUO",7
30,"30032",2839,2361,2337,21,24,"EQUO",2
47,"47069",128,108,108,0,0,"EQUO",0
28,"28012",830,654,651,6,3,"EQUO",1
2,"2034",1419,1153,1146,18,7,"EQUO",1
22,"22083",522,437,428,4,9,"EQUO",2
29,"29081",290,226,226,3,0,"EQUO",0
40,"40007",86,70,69,0,1,"EQUO",0
15,"15046",6949,4641,4539,56,102,"EQUO",14
23,"23905",1884,1447,1438,4,9,"EQUO",3
19,"19166",179,123,121,4,2,"EQUO",3
14,"14034",367,301,292,1,9,"EQUO",2
45,"45185",7912,6321,6180,68,141,"EQUO",16
19,"19231",16,14,14,0,0,"EQUO",0
24,"24201",1123,790,777,14,13,"EQUO",2
5,"5012",156,134,132,1,2,"EQUO",0
13,"13007",1319,1069,1051,18,18,"EQUO",2
24,"24039",2157,1738,1727,30,11,"EQUO",6
16,"16051",166,140,140,1,0,"EQUO",0
48,"48002",7971,5377,5290,65,87,"EQUO",50
6,"6049",1088,847,829,3,18,"EQUO",4
15,"15047",2606,1789,1761,33,28,"EQUO",6
28,"28126",59,37,37,0,0,"EQUO",0
20,"20036",12731,8519,8431,131,88,"EQUO",120
40,"40151",52,42,42,0,0,"EQUO",0
6,"6050",4277,3500,3457,36,43,"EQUO",8
5,"5013",890,746,739,4,7,"EQUO",5
48,"48905",2600,1903,1869,14,34,"EQUO",13
41,"41095",40097,27969,27731,354,238,"EQUO",113
2,"2036",104,78,78,0,0,"EQUO",0
48,"48906",796,625,622,5,3,"EQUO",2
26,"26016",32,27,27,0,0,"EQUO",0
5,"5115",590,458,450,1,8,"EQUO",2
5,"5211",484,406,405,3,1,"EQUO",0
37,"37263",361,277,275,1,2,"EQUO",2
9,"9168",329,254,254,2,0,"EQUO",0
2,"2037",22380,15942,15724,203,218,"EQUO",86
37,"37226",167,129,127,1,2,"EQUO",1
37,"37376",2373,1720,1700,23,20,"EQUO",7
26,"26144",196,163,162,2,1,"EQUO",0
29,"29083",2212,1679,1652,15,27,"EQUO",2
31,"31018",422,303,299,8,4,"EQUO",1
10,"10030",502,364,362,5,2,"EQUO",3
31,"31110",97,53,53,3,0,"EQUO",0
47,"47129",954,744,731,4,13,"EQUO",1
18,"18097",1022,758,752,4,6,"EQUO",4
50,"50165",1880,1339,1274,49,65,"EQUO",5
6,"6052",3965,3176,3134,33,42,"EQUO",18
41,"41030",527,436,429,6,7,"EQUO",1
18,"18030",612,457,456,0,1,"EQUO",2
37,"37302",337,230,229,5,1,"EQUO",0
50,"50076",113,89,89,0,0,"EQUO",0
22,"22245",329,261,257,3,4,"EQUO",1
2,"2038",296,254,254,1,0,"EQUO",0
10,"10032",1768,1438,1415,9,23,"EQUO",7
39,"39006",1732,1381,1373,23,8,"EQUO",4
14,"14038",31501,23683,23394,336,289,"EQUO",122
19,"19234",63,48,48,0,0,"EQUO",0
31,"31020",488,247,246,0,1,"EQUO",2
24,"24122",1424,1001,992,9,9,"EQUO",1
28,"28128",366,280,275,2,5,"EQUO",1
19,"19170",214,139,138,0,1,"EQUO",3
6,"6055",2105,1623,1599,13,24,"EQUO",3
18,"18164",1881,1351,1342,16,9,"EQUO",2
26,"26147",34,29,29,2,0,"EQUO",0
5,"5016",6231,4831,4763,56,68,"EQUO",17
21,"21051",272,202,201,5,1,"EQUO",2
9,"9127",54,39,39,0,0,"EQUO",0
6,"6146",1188,951,936,8,15,"EQUO",2
4,"4086",1903,1376,1371,11,5,"EQUO",3
11,"11011",1685,1231,1216,8,15,"EQUO",10
37,"37031",399,308,307,5,1,"EQUO",1
47,"47076",16922,13030,12899,212,131,"EQUO",93
9,"9001",29,25,25,0,0,"EQUO",0
26,"26148",189,151,150,0,1,"EQUO",1
18,"18064",419,347,345,3,2,"EQUO",0
50,"50078",278,210,208,2,2,"EQUO",0
15,"15052",4567,3539,3493,22,46,"EQUO",1
5,"5119",41,31,31,0,0,"EQUO",0
47,"47212",386,327,325,1,2,"EQUO",2
48,"48910",3063,2122,2104,14,18,"EQUO",17
13,"13080",418,310,309,1,1,"EQUO",0
45,"45155",481,382,375,3,7,"EQUO",3
24,"24087",670,513,513,12,0,"EQUO",4
45,"45192",2549,2178,2155,39,23,"EQUO",8
10,"10158",367,307,306,3,1,"EQUO",0
24,"24125",545,374,373,5,1,"EQUO",0
9,"9003",205,156,154,4,2,"EQUO",1
19,"19172",76,65,64,1,1,"EQUO",0
50,"50169",371,275,274,5,1,"EQUO",0
45,"45082",1333,1143,1123,14,20,"EQUO",1
19,"19270",17,16,16,0,0,"EQUO",1
37,"37033",86,64,63,1,1,"EQUO",0
9,"9129",112,93,93,0,0,"EQUO",0
18,"18066",2072,1558,1552,8,6,"EQUO",0
6,"6059",1959,1476,1466,8,10,"EQUO",5
26,"26151",455,384,382,1,2,"EQUO",3
2,"2007",1139,923,916,0,7,"EQUO",3
19,"19173",52,42,42,3,0,"EQUO",0
39,"39036",1023,802,790,5,12,"EQUO",12
13,"13048",538,441,433,5,8,"EQUO",0
40,"40161",38,28,28,0,0,"EQUO",0
9,"9130",87,72,71,0,1,"EQUO",0
45,"45194",57,41,41,0,0,"EQUO",0
39,"39088",70,61,61,1,0,"EQUO",0
19,"19023",121,95,94,5,1,"EQUO",1
10,"10160",235,183,183,1,0,"EQUO",0
24,"24129",125,88,86,5,2,"EQUO",0
18,"18067",704,526,521,1,5,"EQUO",1
5,"5217",69,54,54,0,0,"EQUO",1
47,"47214",1517,1215,1191,34,24,"EQUO",0
47,"47187",101,82,81,1,1,"EQUO",0
31,"31207",280,198,195,7,3,"EQUO",1
13,"13049",838,654,648,0,6,"EQUO",1
45,"45195",2229,1806,1784,11,22,"EQUO",2
5,"5185",109,89,89,1,0,"EQUO",0
5,"5022",1649,1335,1328,7,7,"EQUO",6
9,"9086",629,467,461,5,6,"EQUO",2
22,"22099",532,411,408,6,3,"EQUO",2
50,"50171",126,90,89,4,1,"EQUO",0
10,"10039",448,352,350,0,2,"EQUO",3
50,"50256",90,59,59,1,0,"EQUO",0
5,"5218",148,123,117,1,6,"EQUO",1
37,"37272",162,121,120,1,1,"EQUO",0
31,"31025",751,501,495,12,6,"EQUO",6
10,"10122",253,197,191,2,6,"EQUO",0
40,"40119",182,149,145,2,4,"EQUO",0
30,"30015",18792,14453,14336,120,117,"EQUO",57
15,"15055",4780,3247,3181,70,66,"EQUO",9
31,"31117",670,471,467,3,4,"EQUO",0
40,"40022",210,154,151,2,3,"EQUO",0
19,"19176",280,216,216,0,0,"EQUO",0
6,"6063",3079,2467,2454,16,13,"EQUO",2
26,"26155",173,134,134,1,0,"EQUO",0
5,"5023",177,160,158,1,2,"EQUO",0
18,"18069",506,375,371,4,4,"EQUO",2
9,"9267",135,118,118,3,0,"EQUO",0
16,"16025",31,23,23,0,0,"EQUO",0
10,"10041",1070,850,846,8,4,"EQUO",2
21,"21058",2609,1867,1857,15,10,"EQUO",9
41,"41010",4338,2990,2958,48,32,"EQUO",44
15,"15029",6266,4668,4618,49,50,"EQUO",3
16,"16196",658,578,568,6,10,"EQUO",4
24,"24014",7677,5352,5289,75,63,"EQUO",27
40,"40025",158,124,124,0,0,"EQUO",0
37,"37038",808,671,664,6,7,"EQUO",1
19,"19066",78,63,62,0,1,"EQUO",1
5,"5124",134,111,109,1,2,"EQUO",0
37,"37162",232,184,182,4,2,"EQUO",2
9,"9408",45,36,36,0,0,"EQUO",0
31,"31907",9914,7394,7282,198,112,"EQUO",147
18,"18174",470,368,363,1,5,"EQUO",1
9,"9135",41,29,29,1,0,"EQUO",0
45,"45199",2712,1817,1796,17,21,"EQUO",15
50,"50231",285,231,224,7,7,"EQUO",1
28,"28021",418,334,328,4,6,"EQUO",10
6,"6021",971,761,747,6,14,"EQUO",1
24,"24016",544,323,322,4,1,"EQUO",0
47,"47164",391,326,320,3,6,"EQUO",1
5,"5025",108,86,86,2,0,"EQUO",0
41,"41090",3488,2792,2751,22,41,"EQUO",4
40,"40028",106,89,88,1,1,"EQUO",0
22,"22902",240,169,169,3,0,"EQUO",1
16,"16067",135,97,97,2,0,"EQUO",0
31,"31120",408,267,265,8,2,"EQUO",4
42,"42044",62,47,46,0,1,"EQUO",1
24,"24136",596,465,463,12,2,"EQUO",1
39,"39015",898,692,688,7,4,"EQUO",3
6,"6159",2341,1522,1510,8,12,"EQUO",2
37,"37276",188,136,135,0,1,"EQUO",1
35,"35008",6151,4514,4419,59,95,"EQUO",46
28,"28022",30019,24469,24279,292,190,"EQUO",413
15,"15059",10658,7889,7728,125,161,"EQUO",32
29,"29020",3188,2448,2424,30,24,"EQUO",8
9,"9016",87,55,54,1,1,"EQUO",0
6,"6069",3116,2316,2288,46,28,"EQUO",9
21,"21061",5089,3657,3635,33,22,"EQUO",5
39,"39041",1775,1432,1414,15,18,"EQUO",7
10,"10045",1119,884,859,5,25,"EQUO",4
48,"48083",7021,4722,4656,74,66,"EQUO",40
9,"9272",319,225,225,5,0,"EQUO",1
6,"6024",1215,1015,1006,4,9,"EQUO",2
31,"31030",155,113,112,3,1,"EQUO",0
5,"5027",290,233,230,2,3,"EQUO",1
13,"13023",8731,6818,6732,94,86,"EQUO",12
6,"6116",1680,1331,1317,15,14,"EQUO",2
16,"16031",62,34,32,4,2,"EQUO",0
2,"2015",1508,1230,1211,7,19,"EQUO",1
2,"2052",493,417,412,9,5,"EQUO",0
39,"39042",5928,4680,4634,44,46,"EQUO",15
36,"36001",3138,2060,2049,13,11,"EQUO",5
6,"6071",257,236,230,1,6,"EQUO",1
31,"31213",114,58,58,0,0,"EQUO",0
45,"45093",168,133,133,0,0,"EQUO",0
40,"40173",148,121,120,3,1,"EQUO",2
10,"10007",680,537,519,5,18,"EQUO",1
24,"24141",101,83,80,6,3,"EQUO",0
2,"2053",3053,2550,2517,33,33,"EQUO",17
20,"20054",476,350,348,1,2,"EQUO",1
21,"21063",2624,2109,2097,13,12,"EQUO",12
37,"37130",177,153,153,2,0,"EQUO",1
13,"13024",938,703,699,3,4,"EQUO",1
45,"45094",441,358,353,6,5,"EQUO",3
22,"22112",9618,6642,6533,205,109,"EQUO",39
36,"36003",9876,7155,7007,100,148,"EQUO",54
37,"37045",27,21,21,0,0,"EQUO",0
45,"45204",621,500,497,1,3,"EQUO",2
24,"24142",24843,17695,17371,409,324,"EQUO",111
26,"26165",350,297,294,1,3,"EQUO",5
22,"22113",512,357,353,8,4,"EQUO",9
22,"22063",184,142,140,2,2,"EQUO",0
31,"31033",55,34,34,0,0,"EQUO",0
18,"18078",768,638,637,1,1,"EQUO",2
42,"42154",95,73,73,0,0,"EQUO",0
37,"37046",11929,8847,8683,146,164,"EQUO",54
19,"19184",88,63,62,1,1,"EQUO",0
24,"24101",465,274,266,5,8,"EQUO",0
16,"16263",936,730,719,8,11,"EQUO",7
40,"40129",203,166,162,1,4,"EQUO",1
20,"20056",3975,2692,2669,17,23,"EQUO",38
45,"45022",427,317,314,8,3,"EQUO",1
47,"47142",172,132,131,2,1,"EQUO",2
24,"24022",364,231,230,2,1,"EQUO",1
15,"15063",2849,2022,2001,28,21,"EQUO",8
22,"22114",137,94,94,4,0,"EQUO",0
26,"26167",66,51,51,2,0,"EQUO",0
16,"16264",505,440,438,6,2,"EQUO",0
19,"19185",40,21,19,0,2,"EQUO",0
28,"28138",78,48,46,0,2,"EQUO",2
39,"39045",410,324,323,5,1,"EQUO",0
22,"22115",415,307,304,2,3,"EQUO",4
9,"9277",130,101,101,1,0,"EQUO",0
47,"47008",26,17,17,0,0,"EQUO",0
5,"5262",378,308,307,2,1,"EQUO",2
40,"40083",88,72,72,1,0,"EQUO",1
24,"24102",701,536,530,3,6,"EQUO",2
37,"37283",130,104,104,1,0,"EQUO",0
4,"4032",5476,3666,3643,34,23,"EQUO",32
45,"45097",1094,934,925,9,9,"EQUO",5
42,"42010",19,15,15,1,0,"EQUO",0
28,"28140",2665,2167,2141,26,26,"EQUO",18
39,"39046",1442,1071,1050,13,21,"EQUO",2
2,"2021",1114,872,860,7,12,"EQUO",2
5,"5035",105,87,87,2,0,"EQUO",0
6,"6077",373,307,304,4,3,"EQUO",0
15,"15065",7570,5710,5628,71,82,"EQUO",29
16,"16266",402,334,325,4,9,"EQUO",1
45,"45098",2273,1799,1756,11,43,"EQUO",5
4,"4102",12940,9247,9152,90,95,"EQUO",40
20,"20059",8816,6335,6293,32,42,"EQUO",21
16,"16081",64,46,45,1,1,"EQUO",0
9,"9148",95,75,75,2,0,"EQUO",2
22,"22117",2585,1880,1848,57,32,"EQUO",31
50,"50182",3704,2551,2515,44,36,"EQUO",9
37,"37173",1643,1298,1285,26,13,"EQUO",4
26,"26171",212,171,170,6,1,"EQUO",0
1,"1001",2010,1362,1336,26,26,"EQUO",45
14,"14055",18619,13802,13607,192,195,"EQUO",82
29,"29100",2442,1834,1824,14,10,"EQUO",7
9,"9280",34,23,23,0,0,"EQUO",0
5,"5231",172,142,141,0,1,"EQUO",0
9,"9105",111,85,81,2,4,"EQUO",2
9,"9419",82,61,61,0,0,"EQUO",0
29,"29901",41445,27372,27158,295,214,"EQUO",205
26,"26042",852,660,651,11,9,"EQUO",4
1,"1002",8057,5854,5757,48,97,"EQUO",64
4,"4901",576,427,426,5,1,"EQUO",2
10,"10056",605,484,476,5,8,"EQUO",0
47,"47090",2511,1907,1880,23,27,"EQUO",12
9,"9024",159,124,123,2,1,"EQUO",0
31,"31129",405,285,281,1,4,"EQUO",0
24,"24150",262,182,182,3,0,"EQUO",0
4,"4035",8213,6218,6171,51,47,"EQUO",33
26,"26172",35,29,29,0,0,"EQUO",1
50,"50183",369,277,274,5,3,"EQUO",0
10,"10179",340,262,257,3,5,"EQUO",8
26,"26173",10,10,10,1,0,"EQUO",0
29,"29902",2577,1689,1665,20,24,"EQUO",4
37,"37175",408,319,311,6,8,"EQUO",3
23,"23095",8882,6668,6628,31,40,"EQUO",18
14,"14057",6115,5040,4975,71,65,"EQUO",19
50,"50269",316,186,185,1,1,"EQUO",0
21,"21070",6278,4489,4445,42,44,"EQUO",16
33,"33041",7488,5356,5309,65,47,"EQUO",31
41,"41047",9810,7427,7321,99,106,"EQUO",120
10,"10058",994,751,738,13,13,"EQUO",1
40,"40044",160,117,114,4,3,"EQUO",0
10,"10180",5446,3957,3917,28,40,"EQUO",11
9,"9422",24,18,16,0,2,"EQUO",0
42,"42016",25,13,13,0,0,"EQUO",0
5,"5136",110,75,75,3,0,"EQUO",0
24,"24029",840,590,579,11,11,"EQUO",4
16,"16042",1286,1101,1089,8,12,"EQUO",3
18,"18050",1657,1209,1196,5,13,"EQUO",10
45,"45176",3570,2619,2583,45,36,"EQUO",20
41,"41022",4281,3087,3066,15,21,"EQUO",2
9,"9288",98,80,80,1,0,"EQUO",0
42,"42163",53,41,41,0,0,"EQUO",8
6,"6084",1105,932,917,5,15,"EQUO",1
21,"21071",216,169,169,5,0,"EQUO",1
28,"28144",5663,4456,4410,47,46,"EQUO",118
19,"19191",19,15,15,0,0,"EQUO",0
33,"33042",4434,3172,3135,43,37,"EQUO",25
5,"5138",326,278,275,2,3,"EQUO",2
40,"40046",99,81,78,2,3,"EQUO",3
24,"24153",253,201,199,4,2,"EQUO",0
47,"47174",302,236,234,3,2,"EQUO",2
19,"19087",22,16,16,0,0,"EQUO",0
48,"48029",8022,5488,5409,83,79,"EQUO",82
19,"19192",1743,1370,1359,10,11,"EQUO",3
39,"39051",73,62,62,2,0,"EQUO",2
5,"5235",136,120,119,2,1,"EQUO",0
35,"35018",11652,6488,6367,107,121,"EQUO",100
21,"21072",10233,7829,7666,124,163,"EQUO",61
50,"50011",131,113,113,8,0,"EQUO",0
6,"6086",1270,956,949,2,7,"EQUO",0
19,"19047",87,71,70,2,1,"EQUO",0
2,"2065",517,450,449,4,1,"EQUO",2
19,"19193",30,29,29,1,0,"EQUO",0
40,"40002",38,31,31,1,0,"EQUO",0
19,"19160",944,600,593,6,7,"EQUO",3
5,"5107",74,54,53,0,1,"EQUO",0
16,"16224",96,69,69,0,0,"EQUO",1
13,"13068",1058,801,793,4,8,"EQUO",1
16,"16089",386,310,308,10,2,"EQUO",1
20,"20066",467,316,316,0,0,"EQUO",2
5,"5236",147,101,101,0,0,"EQUO",0
6,"6042",1017,824,820,5,4,"EQUO",0
6,"6088",12879,9362,9222,153,140,"EQUO",48
2,"2030",3180,2499,2456,13,43,"EQUO",12
26,"26135",181,139,137,1,2,"EQUO",0
26,"26049",189,141,137,1,4,"EQUO",1
37,"37218",81,51,51,1,0,"EQUO",0
21,"21074",2752,1981,1968,15,13,"EQUO",6
48,"48031",370,296,296,1,0,"EQUO",0
50,"50273",36,22,22,0,0,"EQUO",0
23,"23012",4250,3235,3216,19,19,"EQUO",18
30,"30004",1164,958,952,1,6,"EQUO",0
6,"6089",607,530,529,2,1,"EQUO",1
6,"6044",28321,21143,20931,232,212,"EQUO",84
20,"20068",199,132,129,2,3,"EQUO",1
37,"37294",11233,8282,8167,139,115,"EQUO",82
29,"29033",1385,878,868,4,10,"EQUO",3
15,"15072",9868,7077,6951,79,126,"EQUO",28
37,"37061",254,187,185,0,2,"EQUO",1
50,"50042",16,14,14,0,0,"EQUO",0
5,"5044",301,217,217,3,0,"EQUO",0
19,"19090",107,87,86,0,1,"EQUO",1
4,"4045",1877,1512,1497,23,15,"EQUO",1
37,"37062",92,73,73,1,0,"EQUO",0
9,"9295",78,54,53,0,1,"EQUO",0
47,"47016",94,77,77,1,0,"EQUO",0
2,"2069",11624,9091,8907,119,184,"EQUO",47
50,"50014",169,108,108,1,0,"EQUO",2
19,"19261",42,31,31,1,0,"EQUO",0
26,"26183",65,54,54,0,0,"EQUO",1
21,"21046",1715,1354,1343,15,11,"EQUO",0
29,"29034",462,360,357,0,3,"EQUO",1
28,"28033",3581,2712,2691,14,21,"EQUO",13
6,"6092",592,468,456,5,12,"EQUO",0
37,"37372",145,109,109,0,0,"EQUO",0
5,"5045",104,82,82,0,0,"EQUO",0
50,"50190",751,576,565,7,11,"EQUO",1
18,"18094",2398,1882,1868,16,14,"EQUO",4
20,"20070",1109,817,815,4,2,"EQUO",3
10,"10067",10392,7979,7804,111,175,"EQUO",24
47,"47179",408,315,306,6,9,"EQUO",1
20,"20071",14488,9499,9419,93,80,"EQUO",100
19,"19126",1552,1140,1119,16,21,"EQUO",14
9,"9430",18,15,15,0,0,"EQUO",1
42,"42069",1591,1122,1114,33,8,"EQUO",5
23,"23017",1668,1392,1377,10,15,"EQUO",5
31,"31046",58,41,41,3,0,"EQUO",0
4,"4047",2290,1956,1937,9,19,"EQUO",9
16,"16177",86,68,68,0,0,"EQUO",1
31,"31016",7377,5149,5072,101,77,"EQUO",60
37,"37185",602,452,448,8,4,"EQUO",7
42,"42174",188,142,138,5,4,"EQUO",4
50,"50044",259,175,175,0,0,"EQUO",0
31,"31138",939,648,646,14,2,"EQUO",9
50,"50191",505,395,390,4,5,"EQUO",0
22,"22136",908,671,662,11,9,"EQUO",3
37,"37067",2938,2306,2267,47,39,"EQUO",32
19,"19095",14,9,8,0,1,"EQUO",0
19,"19198",22,19,19,0,0,"EQUO",0
10,"10069",858,680,673,2,7,"EQUO",1
47,"47180",96,82,81,0,1,"EQUO",0
15,"15075",12042,8639,8486,147,153,"EQUO",83
45,"45112",2022,1470,1423,12,47,"EQUO",3
48,"48036",23973,16491,16344,179,147,"EQUO",150
9,"9037",122,91,90,2,1,"EQUO",1
24,"24162",1631,1214,1195,33,19,"EQUO",17
24,"24040",494,369,366,6,3,"EQUO",6
39,"39057",2298,1735,1719,17,16,"EQUO",5
37,"37187",567,449,448,3,1,"EQUO",0
9,"9302",116,87,87,3,0,"EQUO",0
20,"20001",249,167,167,4,0,"EQUO",0
37,"37225",119,101,95,3,6,"EQUO",0
4,"4050",818,611,602,5,9,"EQUO",1
29,"29065",207,151,149,1,2,"EQUO",0
16,"16098",586,480,474,10,6,"EQUO",1
40,"40058",368,306,304,1,2,"EQUO",0
50,"50018",973,761,755,12,6,"EQUO",0
36,"36021",11798,8742,8574,136,168,"EQUO",75
5,"5148",34,27,27,0,0,"EQUO",0
22,"22001",242,177,173,2,4,"EQUO",1
31,"31049",733,479,479,4,0,"EQUO",3
41,"41056",3697,3041,3008,25,33,"EQUO",4
29,"29038",16309,10579,10494,152,85,"EQUO",55
19,"19301",47,38,38,0,0,"EQUO",0
2,"2075",1689,1386,1372,10,14,"EQUO",2
28,"28036",2301,1809,1784,13,25,"EQUO",22
24,"24205",995,719,712,9,7,"EQUO",1
50,"50106",137,107,106,0,1,"EQUO",0
15,"15077",8677,6349,6269,82,80,"EQUO",25
42,"42030",115,88,86,2,2,"EQUO",0
6,"6099",1127,815,805,6,10,"EQUO",1
30,"30010",6804,5691,5647,36,44,"EQUO",19
22,"22047",228,200,200,5,0,"EQUO",7
45,"45189",655,510,502,3,8,"EQUO",3
18,"18902",950,769,762,6,7,"EQUO",1
22,"22002",107,85,84,3,1,"EQUO",0
31,"31050",6253,4045,3987,74,58,"EQUO",20
9,"9172",129,110,109,2,1,"EQUO",0
6,"6100",1000,828,821,3,7,"EQUO",0
47,"47183",150,125,122,0,3,"EQUO",0
45,"45116",682,576,565,0,11,"EQUO",0
9,"9438",547,440,433,9,7,"EQUO",4
28,"28152",14903,11954,11865,125,89,"EQUO",323
10,"10196",309,244,244,1,0,"EQUO",1
50,"50252",5345,3860,3792,79,68,"EQUO",11
6,"6101",489,397,395,5,2,"EQUO",0
5,"5245",344,285,284,5,1,"EQUO",2
19,"19099",337,211,210,6,1,"EQUO",2
50,"50195",48,38,38,1,0,"EQUO",0
24,"24046",1002,704,696,20,8,"EQUO",1
19,"19304",235,169,166,1,3,"EQUO",1
5,"5052",102,91,91,0,0,"EQUO",0
45,"45007",747,641,632,1,9,"EQUO",1
28,"28038",4999,3659,3590,32,69,"EQUO",92
19,"19203",35,27,27,0,0,"EQUO",0
4,"4016",2184,1699,1677,15,22,"EQUO",7
36,"36025",2442,1531,1516,10,15,"EQUO",9
16,"16909",737,590,585,9,5,"EQUO",2
24,"24047",856,623,612,5,11,"EQUO",3
13,"13046",786,654,644,2,10,"EQUO",0
6,"6103",4777,3702,3671,31,31,"EQUO",8
47,"47185",97,76,75,1,1,"EQUO",0
37,"37305",206,153,152,4,1,"EQUO",1
2,"2078",967,770,756,9,14,"EQUO",0
45,"45119",3274,2279,2236,37,43,"EQUO",13
5,"5153",112,89,89,5,0,"EQUO",2
37,"37306",316,194,192,1,2,"EQUO",0
47,"47024",283,211,210,1,1,"EQUO",2
40,"40205",292,221,220,2,1,"EQUO",3
16,"16103",310,263,259,4,4,"EQUO",2
5,"5247",267,164,164,0,0,"EQUO",1
20,"20080",8104,5497,5454,52,43,"EQUO",55
45,"45009",588,430,422,2,8,"EQUO",1
24,"24009",362,188,184,0,4,"EQUO",0
31,"31054",498,310,308,1,2,"EQUO",0
23,"23029",924,730,727,2,3,"EQUO",3
16,"16245",430,338,329,2,9,"EQUO",3
40,"40065",520,401,393,6,8,"EQUO",0
45,"45120",159,125,122,0,3,"EQUO",0
47,"47186",251279,193705,191693,2746,2012,"EQUO",1398
29,"29042",14047,9845,9735,118,110,"EQUO",67
39,"39062",1759,1397,1387,9,10,"EQUO",5
40,"40207",724,551,540,9,11,"EQUO",18
22,"22008",194,168,167,11,1,"EQUO",5
5,"5055",649,525,518,3,7,"EQUO",3
28,"28154",5232,3910,3860,40,50,"EQUO",29
2,"2081",18319,14324,14096,225,228,"EQUO",76
40,"40115",126,98,95,2,3,"EQUO",1
9,"9311",70,51,51,0,0,"EQUO",1
39,"39063",1018,769,762,6,7,"EQUO",1
16,"16106",2839,2351,2331,10,20,"EQUO",8
9,"9265",44,36,35,2,1,"EQUO",0
50,"50284",176,131,130,1,1,"EQUO",3
6,"6107",1610,1131,1128,6,3,"EQUO",0
50,"50111",191,141,138,2,3,"EQUO",0
15,"15083",1198,874,855,8,19,"EQUO",0
31,"31238",125,99,98,3,1,"EQUO",1
50,"50199",380,263,254,2,9,"EQUO",0
24,"24052",178,113,111,0,2,"EQUO",0
5,"5156",260,188,185,0,3,"EQUO",4
24,"24171",417,231,231,2,0,"EQUO",0
9,"9312",113,94,91,0,3,"EQUO",0
37,"37310",154,115,115,1,0,"EQUO",0
50,"50172",187,140,138,4,2,"EQUO",0
10,"10203",4770,3397,3327,40,70,"EQUO",7
47,"47188",125,112,109,3,3,"EQUO",0
22,"22012",93,74,74,5,0,"EQUO",0
28,"28156",958,742,733,12,9,"EQUO",5
19,"19210",34,29,29,1,0,"EQUO",0
47,"47027",2680,2059,2024,23,35,"EQUO",13
31,"31240",553,360,359,3,1,"EQUO",3
40,"40211",72,65,65,1,0,"EQUO",4
24,"24172",491,234,232,2,2,"EQUO",2
37,"37273",115,83,83,1,0,"EQUO",0
45,"45013",1870,1504,1486,5,18,"EQUO",2
41,"41062",2252,1719,1698,12,21,"EQUO",2
39,"39064",1339,1072,1066,7,6,"EQUO",7
4,"4022",375,296,295,0,1,"EQUO",5
2,"2084",362,276,270,2,6,"EQUO",1
9,"9445",46,31,31,1,0,"EQUO",0
10,"10083",105,74,74,0,0,"EQUO",0
6,"6110",176,130,124,0,6,"EQUO",0
36,"36031",572,484,479,5,5,"EQUO",3
10,"10084",1416,994,972,12,22,"EQUO",3
18,"18105",5222,3866,3839,32,27,"EQUO",14
1,"1034",177,140,137,1,3,"EQUO",1
47,"47109",183,151,151,4,0,"EQUO",1
50,"50201",466,366,363,7,3,"EQUO",5
18,"18007",808,602,591,5,11,"EQUO",3
9,"9052",40,31,31,1,0,"EQUO",0
41,"41063",2678,1869,1853,22,16,"EQUO",9
22,"22058",194,138,137,5,1,"EQUO",3
40,"40168",36,27,27,0,0,"EQUO",0
28,"28042",1091,814,808,5,6,"EQUO",13
5,"5059",112,91,88,1,3,"EQUO",0
24,"24055",747,557,549,11,8,"EQUO",3
45,"45089",1615,1238,1221,16,17,"EQUO",0
5,"5159",287,216,216,0,0,"EQUO",0
13,"13087",22953,16674,16376,298,298,"EQUO",133
24,"24056",3200,2368,2332,53,36,"EQUO",9
50,"50203",1083,814,798,28,16,"EQUO",4
22,"22212",93,79,79,0,0,"EQUO",0
1,"1037",625,403,398,6,5,"EQUO",6
31,"31059",204,140,139,3,1,"EQUO",0
40,"40074",271,221,218,3,3,"EQUO",1
9,"9447",36,33,33,0,0,"EQUO",0
6,"6068",481,383,378,3,5,"EQUO",1
10,"10208",141,118,118,1,0,"EQUO",0
15,"15087",6054,4004,3956,79,48,"EQUO",10
9,"9055",55,46,44,0,2,"EQUO",0
9,"9317",17,15,15,0,0,"EQUO",0
50,"50028",120,86,85,2,1,"EQUO",0
39,"39067",901,628,623,1,5,"EQUO",2
37,"37201",263,196,196,5,0,"EQUO",2
16,"16112",1562,1159,1140,12,19,"EQUO",5
40,"40076",6641,4958,4862,67,96,"EQUO",73
16,"16254",213,166,165,2,1,"EQUO",0
47,"47004",1261,1047,1031,11,16,"EQUO",0
6,"6115",1261,893,885,7,8,"EQUO",1
22,"22017",917,677,661,8,16,"EQUO",0
9,"9183",58,47,46,1,1,"EQUO",0
19,"19215",206,170,166,0,4,"EQUO",0
9,"9095",88,75,73,2,2,"EQUO",0
5,"5225",423,346,342,8,4,"EQUO",0
16,"16255",159,123,122,3,1,"EQUO",0
47,"47192",99,84,84,0,0,"EQUO",5
31,"31061",67,47,47,2,0,"EQUO",2
42,"42046",55,35,35,0,0,"EQUO",2
22,"22164",46,32,32,0,0,"EQUO",0
40,"40078",180,143,143,1,0,"EQUO",2
10,"10210",599,453,452,3,1,"EQUO",2
6,"6117",1471,1155,1130,8,25,"EQUO",1
24,"24020",480,326,324,9,2,"EQUO",1
18,"18912",1576,1193,1185,7,8,"EQUO",6
48,"48052",1526,1213,1205,7,8,"EQUO",8
42,"42048",78,63,62,3,1,"EQUO",1
42,"42049",141,83,81,1,2,"EQUO",0
9,"9057",155,125,124,0,1,"EQUO",2
14,"14050",2418,1983,1966,23,17,"EQUO",6
26,"26076",144,124,123,3,1,"EQUO",0
40,"40220",71,57,52,0,5,"EQUO",0
33,"33059",5049,3480,3447,37,33,"EQUO",13
6,"6118",228,181,181,1,0,"EQUO",1
10,"10090",552,404,396,3,8,"EQUO",1
9,"9451",244,208,202,1,6,"EQUO",1
24,"24060",660,382,382,0,0,"EQUO",1
5,"5064",117,94,93,4,1,"EQUO",0
50,"50263",235,160,160,1,0,"EQUO",0
50,"50031",167,105,103,0,2,"EQUO",0
42,"42200",98,70,67,1,3,"EQUO",0
10,"10091",391,327,324,3,3,"EQUO",2
15,"15090",1267,959,953,4,6,"EQUO",2
37,"37319",138,94,94,1,0,"EQUO",0
28,"28046",4208,3297,3272,31,25,"EQUO",127
6,"6028",4366,3881,3809,35,72,"EQUO",5
40,"40034",85,73,73,1,0,"EQUO",0
50,"50032",330,233,228,3,5,"EQUO",0
16,"16034",207,174,173,0,1,"EQUO",0
9,"9454",46,31,30,1,1,"EQUO",2
39,"39096",719,521,518,4,3,"EQUO",2
5,"5099",555,472,466,4,6,"EQUO",1
30,"30022",16489,12207,12042,152,165,"EQUO",72
37,"37206",100,81,80,1,1,"EQUO",0
24,"24225",1089,798,784,15,14,"EQUO",6
6,"6121",3436,2700,2662,35,38,"EQUO",7
15,"15091",1171,839,829,9,10,"EQUO",3
47,"47034",90,65,63,0,2,"EQUO",0
39,"39071",463,358,358,2,0,"EQUO",1
31,"31248",318,190,187,2,3,"EQUO",0
22,"22170",622,439,430,13,9,"EQUO",3
37,"37092",1403,1034,1022,12,12,"EQUO",2
6,"6122",6620,4904,4797,44,107,"EQUO",27
24,"24024",717,501,498,10,3,"EQUO",4
37,"37207",287,211,208,2,3,"EQUO",1
5,"5066",480,397,392,5,5,"EQUO",8
45,"45134",1606,1260,1242,10,18,"EQUO",4
19,"19153",25,17,17,0,0,"EQUO",0
19,"19219",18,12,12,0,0,"EQUO",0
10,"10094",247,212,211,0,1,"EQUO",0
31,"31035",60,47,47,0,0,"EQUO",0
5,"5067",85,68,68,0,0,"EQUO",0
9,"9061",187,146,144,1,2,"EQUO",0
30,"30023",3572,2859,2811,22,48,"EQUO",21
33,"33061",446,260,259,1,1,"EQUO",4
37,"37208",92,59,58,0,1,"EQUO",0
16,"16121",270,211,207,1,4,"EQUO",0
9,"9458",422,325,316,5,9,"EQUO",8
28,"28048",489,398,389,3,9,"EQUO",3
15,"15093",4562,3314,3270,37,44,"EQUO",3
10,"10217",535,423,422,3,1,"EQUO",2
23,"23047",1658,1342,1339,6,3,"EQUO",10
15,"15009",11109,8179,8014,129,165,"EQUO",58
37,"37097",47,39,39,1,0,"EQUO",0
40,"40225",1152,931,918,10,13,"EQUO",2
45,"45025",1237,919,907,11,12,"EQUO",3
4,"4070",1649,1267,1255,9,12,"EQUO",5
5,"5069",91,79,78,1,1,"EQUO",0
9,"9460",187,144,142,2,2,"EQUO",0
24,"24026",1304,1015,1001,17,14,"EQUO",5
31,"31067",1982,1400,1363,28,37,"EQUO",8
28,"28049",59507,46919,46379,488,540,"EQUO",679
22,"22025",1104,790,767,27,23,"EQUO",4
31,"31251",3147,2274,2225,39,49,"EQUO",12
23,"23004",478,416,415,1,1,"EQUO",0
10,"10097",109,97,96,0,1,"EQUO",0
47,"47036",257,212,212,1,0,"EQUO",0
42,"42056",26,23,22,1,1,"EQUO",0
48,"48058",977,706,700,2,6,"EQUO",11
18,"18117",535,444,440,2,4,"EQUO",1
39,"39074",6785,5287,5233,50,54,"EQUO",24
36,"36042",17897,12635,12437,157,198,"EQUO",60
22,"22175",211,158,158,9,0,"EQUO",0
50,"50036",103,81,80,2,1,"EQUO",0
50,"50211",277,193,193,1,0,"EQUO",1
22,"22027",351,251,250,8,1,"EQUO",1
10,"10098",412,317,313,5,4,"EQUO",4
40,"40183",148,127,127,0,0,"EQUO",0
15,"15011",15507,10935,10751,123,184,"EQUO",40
47,"47199",84,61,60,1,1,"EQUO",1
45,"45028",3696,3059,3024,40,35,"EQUO",7
26,"26086",18,17,17,0,0,"EQUO",0
37,"37213",97,77,76,0,1,"EQUO",1
39,"39075",140941,103308,102362,1364,946,"EQUO",754
16,"16002",195,175,172,0,3,"EQUO",1
18,"18119",1778,1401,1391,14,10,"EQUO",12
13,"13098",2265,1805,1759,19,46,"EQUO",1
6,"6128",4466,3310,3264,50,46,"EQUO",5
45,"45139",231,198,194,0,4,"EQUO",1
9,"9065",152,137,137,1,0,"EQUO",4
23,"23007",3116,2483,2458,15,25,"EQUO",3
31,"31223",1043,783,771,14,12,"EQUO",1
37,"37289",265,211,209,0,2,"EQUO",3
48,"48027",21610,15409,15274,145,135,"EQUO",192
19,"19007",460,351,345,5,6,"EQUO",0
1,"1055",906,632,623,7,9,"EQUO",9
40,"40233",457,350,348,1,2,"EQUO",1
5,"5267",102,78,77,1,1,"EQUO",2
13,"13901",945,734,719,6,15,"EQUO",2
23,"23052",1186,1012,997,1,15,"EQUO",0
16,"16273",328,277,275,2,2,"EQUO",0
42,"42060",33,22,22,0,0,"EQUO",0
15,"15013",6160,4229,4165,70,64,"EQUO",40
45,"45030",486,378,374,4,4,"EQUO",3
47,"47200",91,73,73,0,0,"EQUO",0
28,"28051",1469,1147,1129,7,18,"EQUO",24
10,"10102",534,447,440,4,7,"EQUO",0
28,"28097",127,94,92,0,2,"EQUO",0
40,"40093",88,77,72,0,5,"EQUO",1
50,"50214",31,22,21,1,1,"EQUO",0
37,"37178",107,88,87,0,1,"EQUO",0
16,"16005",275,215,215,2,0,"EQUO",3
42,"42215",821,561,545,19,16,"EQUO",1
42,"42062",36,23,22,0,1,"EQUO",0
47,"47014",55,47,47,0,0,"EQUO",0
13,"13903",564,461,454,2,7,"EQUO",0
47,"47122",2078,1697,1665,21,32,"EQUO",7
16,"16130",633,504,492,5,12,"EQUO",0
22,"22182",271,160,150,4,10,"EQUO",3
31,"31072",5098,3764,3698,75,66,"EQUO",26
45,"45142",7974,6294,6178,89,116,"EQUO",21
48,"48063",355,287,287,6,0,"EQUO",0
47,"47204",275,221,219,3,2,"EQUO",0
6,"6133",1744,1343,1328,22,15,"EQUO",1
37,"37180",69,46,46,0,0,"EQUO",0
23,"23056",3182,2539,2523,20,16,"EQUO",4
10,"10063",175,142,142,1,0,"EQUO",0
10,"10104",5233,3904,3824,30,80,"EQUO",17
26,"26179",49,39,36,0,3,"EQUO",0
19,"19010",15,13,13,1,0,"EQUO",0
16,"16007",1272,1056,1051,7,5,"EQUO",2
13,"13904",556,448,441,14,7,"EQUO",1
28,"28099",1670,1258,1246,9,12,"EQUO",16
33,"33067",802,650,639,12,11,"EQUO",4
24,"24196",2183,1573,1543,11,30,"EQUO",7
22,"22039",920,721,710,12,11,"EQUO",14
1,"1011",245,189,185,7,4,"EQUO",0
1,"1060",223,181,178,1,3,"EQUO",0
9,"9071",48,32,32,0,0,"EQUO",1
21,"21075",375,294,291,12,3,"EQUO",3
5,"5077",205,164,160,2,4,"EQUO",0
37,"37333",247,160,154,2,6,"EQUO",1
35,"35021",14982,9948,9749,138,199,"EQUO",211
4,"4078",1069,837,832,6,5,"EQUO",4
19,"19228",39,30,29,0,1,"EQUO",0
24,"24076",1210,917,907,26,10,"EQUO",6
10,"10106",144,123,123,4,0,"EQUO",0
37,"37107",11407,8234,8116,123,118,"EQUO",16
9,"9206",65,56,55,2,1,"EQUO",0
47,"47206",111,99,99,0,0,"EQUO",0
24,"24037",429,282,277,4,5,"EQUO",0
42,"42172",31,28,28,3,0,"EQUO",0
5,"5110",710,584,581,1,3,"EQUO",4
6,"6091",3854,2961,2906,33,55,"EQUO",7
47,"47125",55,46,46,0,0,"EQUO",0
40,"40100",303,241,231,5,10,"EQUO",3
45,"45035",307,236,236,3,0,"EQUO",5
39,"39080",3627,2743,2693,19,50,"EQUO",9
14,"14003",1289,1046,1026,12,20,"EQUO",2
21,"21016",1076,823,790,11,33,"EQUO",0
10,"10108",231,152,152,0,0,"EQUO",2
37,"37222",124,92,92,2,0,"EQUO",0
1,"1062",333,236,232,5,4,"EQUO",2
15,"15018",1211,821,805,11,16,"EQUO",0
16,"16280",205,177,175,1,2,"EQUO",1
20,"20034",3192,2035,2030,11,5,"EQUO",14
48,"48067",1204,895,892,4,3,"EQUO",5
19,"19051",94,83,83,1,0,"EQUO",0
16,"16050",298,245,238,0,7,"EQUO",1
30,"30033",9940,7794,7700,79,94,"EQUO",23
9,"9209",4617,3269,3234,44,35,"EQUO",27
21,"21077",1690,1335,1321,8,14,"EQUO",5
37,"37065",346,269,267,0,2,"EQUO",0
5,"5080",75,53,53,1,0,"EQUO",0
18,"18127",15897,11597,11483,133,114,"EQUO",78
19,"19197",29,19,19,0,0,"EQUO",0
31,"31077",5349,4025,3917,103,108,"EQUO",24
4,"4081",367,312,309,0,3,"EQUO",0
42,"42071",186,104,103,3,1,"EQUO",0
50,"50219",3704,2672,2625,39,47,"EQUO",16
33,"33002",10837,7667,7588,77,79,"EQUO",16
28,"28056",782,604,586,6,18,"EQUO",34
16,"16902",165,128,126,1,2,"EQUO",1
1,"1901",2254,1561,1528,24,33,"EQUO",34
6,"6141",1803,1419,1397,23,22,"EQUO",0
48,"48069",12381,8760,8672,66,88,"EQUO",93
26,"26099",1281,1050,1025,19,25,"EQUO",6
33,"33070",3481,2557,2521,33,36,"EQUO",16
40,"40105",60,51,51,1,0,"EQUO",0
29,"29064",584,428,422,4,6,"EQUO",0
6,"6142",284,240,235,4,5,"EQUO",1
41,"41081",28121,20027,19785,275,242,"EQUO",125
21,"21018",1821,1283,1273,19,10,"EQUO",1
31,"31048",154,118,117,0,1,"EQUO",2
5,"5048",131,112,111,0,1,"EQUO",0
5,"5147",174,141,135,4,6,"EQUO",0
6,"6097",2475,1934,1902,27,32,"EQUO",1
22,"22195",231,193,189,6,4,"EQUO",3
42,"42075",91,71,70,1,1,"EQUO",0
2,"2001",731,601,584,6,17,"EQUO",2
48,"48071",6097,4307,4224,61,83,"EQUO",32
10,"10112",1582,1299,1284,5,15,"EQUO",0
16,"16014",659,534,528,8,6,"EQUO",0
6,"6007",1557,1200,1189,4,11,"EQUO",1
6,"6143",3308,2625,2595,24,30,"EQUO",1
19,"19018",189,145,138,2,7,"EQUO",0
33,"33072",1737,1171,1159,11,12,"EQUO",6
10,"10113",2440,1891,1859,11,32,"EQUO",5
45,"45151",631,474,470,1,4,"EQUO",2
19,"19097",28,27,27,0,0,"EQUO",0
9,"9077",38,26,25,0,1,"EQUO",0
20,"20002",347,237,237,8,0,"EQUO",1
11,"11009",636,430,424,2,6,"EQUO",4
6,"6144",588,476,464,2,12,"EQUO",3
39,"39084",873,647,642,4,5,"EQUO",4
40,"40059",124,104,104,2,0,"EQUO",4
19,"19132",105,79,79,0,0,"EQUO",1
11,"11010",6452,4534,4510,61,24,"EQUO",12
33,"33004",69056,49228,48730,726,498,"EQUO",364
6,"6145",929,746,743,5,3,"EQUO",0
9,"9902",491,363,357,4,6,"EQUO",0
16,"16016",258,178,178,1,0,"EQUO",0
47,"47211",45,38,38,1,0,"EQUO",0
10,"10115",3622,2872,2800,52,72,"EQUO",17
50,"50137",1119,842,834,12,8,"EQUO",6
20,"20004",254,153,153,5,0,"EQUO",2
19,"19020",52,39,39,3,0,"EQUO",0
16,"16100",764,660,655,3,5,"EQUO",1
19,"19133",103,89,88,2,1,"EQUO",0
9,"9217",389,273,270,8,3,"EQUO",9
2,"2004",654,554,544,7,10,"EQUO",2
10,"10116",3762,2781,2705,36,76,"EQUO",15
41,"41084",2875,2362,2335,9,27,"EQUO",6
37,"37230",221,173,171,0,2,"EQUO",1
20,"20005",1341,890,885,4,5,"EQUO",2
37,"37117",1320,948,937,16,11,"EQUO",12
24,"24086",323,245,243,1,2,"EQUO",0
28,"28174",1745,1233,1224,11,9,"EQUO",5
50,"50108",50,31,31,0,0,"EQUO",0
9,"9082",49,41,41,0,0,"EQUO",0
5,"5183",165,142,140,0,2,"EQUO",0
42,"42081",158,131,131,3,0,"EQUO",1
31,"31143",105,62,58,2,4,"EQUO",0
36,"36058",5021,3589,3516,54,73,"EQUO",12
21,"21023",2106,1471,1456,7,15,"EQUO",5
9,"9083",27,21,21,0,0,"EQUO",0
31,"31174",115,72,70,1,2,"EQUO",2
6,"6012",3263,2498,2476,31,22,"EQUO",4
15,"15024",4726,3634,3555,51,79,"EQUO",6
6,"6149",10390,8354,8215,111,139,"EQUO",33
37,"37344",259,212,211,5,1,"EQUO",0
19,"19135",120,102,100,2,2,"EQUO",0
35,"35002",21673,14480,14253,172,227,"EQUO",119
45,"45156",3528,2985,2924,19,61,"EQUO",9
47,"47050",3557,2688,2651,50,37,"EQUO",16
6,"6150",860,722,710,2,12,"EQUO",2
13,"13014",565,457,452,3,5,"EQUO",0
31,"31084",1949,1369,1361,11,8,"EQUO",4
15,"15025",1173,780,777,10,3,"EQUO",1
10,"10119",714,489,482,3,7,"EQUO",1
50,"50051",886,677,671,9,6,"EQUO",2
50,"50901",170,122,121,1,1,"EQUO",0
9,"9355",117,88,87,1,1,"EQUO",0
6,"6151",1109,850,846,6,4,"EQUO",1
40,"40113",438,330,322,4,8,"EQUO",9
6,"6014",6843,4894,4839,30,55,"EQUO",14
4,"4089",805,607,597,1,10,"EQUO",2
37,"37382",202,172,171,3,1,"EQUO",1
24,"24089",106265,77385,76124,1666,1261,"EQUO",762
2,"2008",1332,985,966,12,19,"EQUO",11
50,"50198",46,36,36,2,0,"EQUO",0
6,"6152",1327,983,967,8,16,"EQUO",3
11,"11014",16318,11093,11031,144,62,"EQUO",78
33,"33076",12662,8733,8670,120,63,"EQUO",62
18,"18005",366,279,277,3,2,"EQUO",0
19,"19024",7736,5738,5646,82,92,"EQUO",54
22,"22053",867,567,554,13,13,"EQUO",6
39,"39089",163,126,126,0,0,"EQUO",0
21,"21025",3969,2731,2686,33,45,"EQUO",25
47,"47215",60,52,52,2,0,"EQUO",0
5,"5089",500,390,375,3,15,"EQUO",1
18,"18137",1057,875,868,8,7,"EQUO",0
21,"21026",255,181,169,2,12,"EQUO",4
6,"6153",20332,15398,15216,239,182,"EQUO",56
11,"11015",59476,38207,37898,501,309,"EQUO",380
5,"5057",2593,2172,2152,16,20,"EQUO",5
35,"35005",1170,864,853,7,11,"EQUO",2
20,"20010",1392,949,941,8,8,"EQUO",6
16,"16150",120,90,90,0,0,"EQUO",0
28,"28062",311,233,226,0,7,"EQUO",5
45,"45050",508,385,378,0,7,"EQUO",1
47,"47053",125,100,99,1,1,"EQUO",1
9,"9908",509,328,321,5,7,"EQUO",6
10,"10123",601,502,492,0,10,"EQUO",0
22,"22207",135,86,79,4,7,"EQUO",3
31,"31148",99,69,66,2,3,"EQUO",0
39,"39090",731,577,572,3,5,"EQUO",6
19,"19031",18,11,11,0,0,"EQUO",0
33,"33009",951,673,663,7,10,"EQUO",3
19,"19211",450,340,334,0,6,"EQUO",3
31,"31906",2493,1796,1770,57,26,"EQUO",28
6,"6019",2111,1621,1596,24,25,"EQUO",8
39,"39013",561,413,412,2,1,"EQUO",4
18,"18140",42971,28391,28126,335,265,"EQUO",155
22,"22057",377,283,278,3,5,"EQUO",4
26,"26113",35,31,31,1,0,"EQUO",0
37,"37238",102,77,76,0,1,"EQUO",0
19,"19243",53,39,39,0,0,"EQUO",1
4,"4093",1869,1341,1334,10,7,"EQUO",5
35,"35006",29515,20731,20286,362,445,"EQUO",203
6,"6157",497,350,343,0,7,"EQUO",0
40,"40122",551,417,414,9,3,"EQUO",4
22,"22209",161,115,115,4,0,"EQUO",4
50,"50174",107,92,90,0,2,"EQUO",0
19,"19143",1610,1287,1268,9,19,"EQUO",7
47,"47218",983,776,767,7,9,"EQUO",3
9,"9091",746,556,550,8,6,"EQUO",1
26,"26114",87,74,72,0,2,"EQUO",0
4,"4061",668,541,536,7,5,"EQUO",0
31,"31089",246,198,195,4,3,"EQUO",1
28,"28179",1385,1039,1027,10,12,"EQUO",17
5,"5189",478,361,360,3,1,"EQUO",2
45,"45053",8208,6763,6663,103,100,"EQUO",13
50,"50144",36,32,32,0,0,"EQUO",0
13,"13021",459,358,355,5,3,"EQUO",1
31,"31090",156,77,77,0,0,"EQUO",1
28,"28065",118796,93292,92186,919,1106,"EQUO",1543
50,"50232",176,123,120,5,3,"EQUO",1
19,"19245",1222,954,943,10,11,"EQUO",2
37,"37127",229,183,182,3,1,"EQUO",0
9,"9363",1047,798,792,9,6,"EQUO",4
22,"22059",1149,792,764,23,28,"EQUO",9
22,"22060",1180,909,891,13,18,"EQUO",2
16,"16029",114,80,80,0,0,"EQUO",0
47,"47056",90,69,69,2,0,"EQUO",0
5,"5094",158,124,124,3,0,"EQUO",0
37,"37241",172,135,134,1,1,"EQUO",1
16,"16070",35,29,29,0,0,"EQUO",0
24,"24057",1459,1121,1092,16,29,"EQUO",9
6,"6160",3190,2343,2314,12,29,"EQUO",5
6,"6161",335,261,259,2,2,"EQUO",0
24,"24097",244,161,156,4,5,"EQUO",2
50,"50147",845,637,627,12,10,"EQUO",2
16,"16113",3075,2363,2338,36,25,"EQUO",1
29,"29049",3137,2365,2352,19,13,"EQUO",4
45,"45056",2246,1523,1502,16,21,"EQUO",7
47,"47220",194,143,142,4,1,"EQUO",0
18,"18144",779,592,590,3,2,"EQUO",13
42,"42094",520,376,362,14,14,"EQUO",11
16,"16156",122,91,91,0,0,"EQUO",0
48,"48084",23491,15322,15084,213,238,"EQUO",136
28,"28181",20003,16133,15952,159,181,"EQUO",243
31,"31092",676,447,446,6,1,"EQUO",6
15,"15032",3639,2642,2586,35,56,"EQUO",10
39,"39016",24213,18549,18362,265,187,"EQUO",108
9,"9098",553,416,410,11,6,"EQUO",0
26,"26120",1515,1215,1198,20,17,"EQUO",4
10,"10130",1745,1360,1341,10,19,"EQUO",9
23,"23085",2350,1963,1956,8,7,"EQUO",0
47,"47032",161,130,129,3,1,"EQUO",1
50,"50059",790,593,586,12,7,"EQUO",4
42,"42095",1575,1136,1106,40,30,"EQUO",14
31,"31184",66,60,59,0,1,"EQUO",0
2,"2018",922,759,754,7,5,"EQUO",0
6,"6027",732,655,645,8,10,"EQUO",0
50,"50149",48,35,35,0,0,"EQUO",0
42,"42096",316,218,215,9,3,"EQUO",1
48,"48086",2087,1432,1420,11,12,"EQUO",13
40,"40128",144,116,116,5,0,"EQUO",4
10,"10172",728,531,522,3,9,"EQUO",1
45,"45058",409,334,332,2,2,"EQUO",0
19,"19249",38,32,32,0,0,"EQUO",0
19,"19151",1126,849,830,3,19,"EQUO",2
16,"16159",299,204,202,5,2,"EQUO",0
37,"37205",235,199,195,5,4,"EQUO",3
39,"39070",152,118,118,0,0,"EQUO",1
10,"10010",2358,1597,1576,18,21,"EQUO",3
37,"37281",36,34,33,0,1,"EQUO",0
31,"31094",123,100,97,3,3,"EQUO",0
4,"4030",1222,930,924,5,6,"EQUO",0
48,"48021",1460,1024,1012,13,12,"EQUO",6
31,"31186",299,205,200,3,5,"EQUO",7
37,"37245",357,273,272,2,1,"EQUO",0
13,"13059",232,186,184,0,2,"EQUO",0
33,"33037",37135,25522,25262,291,260,"EQUO",90
40,"40130",139,106,106,4,0,"EQUO",0
16,"16160",76,54,53,1,1,"EQUO",0
13,"13027",3582,2770,2715,25,55,"EQUO",7
39,"39097",732,476,470,4,6,"EQUO",0
40,"40131",48,41,41,0,0,"EQUO",0
10,"10134",585,420,412,1,8,"EQUO",0
45,"45170",257,186,183,0,3,"EQUO",0
10,"10215",437,338,333,3,5,"EQUO",2
37,"37358",163,143,139,0,4,"EQUO",0
15,"15036",60838,40345,39667,915,678,"EQUO",310
10,"10052",186,138,138,0,0,"EQUO",1
47,"47169",70,57,57,0,0,"EQUO",0
31,"31005",312,209,206,4,3,"EQUO",1
28,"28005",132097,100509,99506,1069,1003,"EQUO",1430
20,"20022",832,527,521,9,6,"EQUO",0
37,"37011",131,87,86,2,1,"EQUO",0
35,"35013",6779,5059,4961,105,98,"EQUO",24
5,"5101",297,224,222,4,2,"EQUO",3
5,"5196",69,54,54,2,0,"EQUO",0
31,"31096",127,112,110,2,2,"EQUO",0
28,"28901",765,579,567,2,12,"EQUO",11
33,"33016",19516,14345,14210,198,135,"EQUO",98
22,"22222",510,367,365,6,2,"EQUO",14
39,"39020",23947,15404,15122,267,282,"EQUO",375
16,"16038",50,40,40,0,0,"EQUO",0
24,"24227",1664,1159,1148,16,11,"EQUO",4
26,"26126",32,31,31,1,0,"EQUO",0
24,"24228",732,543,529,4,14,"EQUO",0
28,"28118",72,49,47,1,2,"EQUO",1
6,"6033",1387,1075,1068,6,7,"EQUO",3
50,"50153",1002,757,748,12,9,"EQUO",2
39,"39099",2987,2416,2391,28,25,"EQUO",15
13,"13029",102,90,89,0,1,"EQUO",1
28,"28006",74554,57439,56890,586,549,"EQUO",940
45,"45063",504,378,372,3,6,"EQUO",3
16,"16039",466,330,326,1,4,"EQUO",4
47,"47225",89,67,66,0,1,"EQUO",0
2,"2023",636,534,533,6,1,"EQUO",1
19,"19222",120,90,89,3,1,"EQUO",3
2,"2024",3424,2765,2726,32,39,"EQUO",17
28,"28119",1911,1527,1514,13,13,"EQUO",30
35,"35015",9065,4859,4770,64,89,"EQUO",42
37,"37136",702,494,485,4,9,"EQUO",2
16,"16165",84,70,70,0,0,"EQUO",2
50,"50154",129,98,97,1,1,"EQUO",0
48,"48092",792,603,600,5,3,"EQUO",1
15,"15039",1374,1027,998,27,29,"EQUO",2
5,"5103",84,68,68,3,0,"EQUO",1
40,"40136",130,106,106,1,0,"EQUO",1
23,"23094",3917,3200,3166,32,34,"EQUO",8
24,"24230",450,333,327,4,6,"EQUO",0
9,"9463",261,205,205,1,0,"EQUO",4
16,"16041",395,289,287,6,2,"EQUO",1
29,"29073",1520,1032,1021,10,11,"EQUO",13
47,"47227",62,52,52,1,0,"EQUO",0
28,"28903",29222,23945,23689,296,256,"EQUO",865
28,"28007",122891,95200,94139,990,1061,"EQUO",1540
50,"50155",119,91,91,1,0,"EQUO",0
10,"10017",884,681,673,6,8,"EQUO",1
19,"19256",48,44,43,0,1,"EQUO",1
22,"22227",225,172,168,3,4,"EQUO",0
45,"45175",698,587,579,5,8,"EQUO",1
37,"37364",893,653,644,10,9,"EQUO",5
19,"19044",319,248,245,0,3,"EQUO",0
10,"10100",792,554,538,1,16,"EQUO",6
26,"26130",229,181,177,0,4,"EQUO",3
4,"4903",4331,3183,3164,31,19,"EQUO",9
28,"28008",1734,1244,1221,11,23,"EQUO",16
9,"9242",93,82,82,2,0,"EQUO",0
37,"37139",199,167,163,1,4,"EQUO",6
10,"10141",289,209,209,0,0,"EQUO",0
9,"9243",87,66,64,2,2,"EQUO",0
50,"50067",14124,10049,9870,203,179,"EQUO",43
5,"5106",39,26,26,0,0,"EQUO",0
14,"14028",333,279,277,1,2,"EQUO",0
50,"50242",102,82,82,2,0,"EQUO",1
39,"39024",2065,1616,1601,8,15,"EQUO",12
37,"37018",128,89,87,0,2,"EQUO",0
2,"2027",347,301,301,2,0,"EQUO",0
37,"37366",46,35,34,0,1,"EQUO",0
40,"40141",881,658,647,9,11,"EQUO",2
9,"9112",115,80,80,4,0,"EQUO",0
21,"21041",114169,74740,73814,1129,926,"EQUO",821
9,"9244",53,44,44,0,0,"EQUO",0
37,"37141",158,140,139,1,1,"EQUO",0
13,"13034",56981,42819,42306,742,513,"EQUO",456
40,"40001",713,575,562,10,13,"EQUO",2
31,"31193",1312,969,948,33,21,"EQUO",22
45,"45179",608,476,471,3,5,"EQUO",0
28,"28009",13466,10392,10286,102,106,"EQUO",116
37,"37019",157,114,113,0,1,"EQUO",0
20,"20029",4283,3014,2998,26,16,"EQUO",19
10,"10103",480,385,380,3,5,"EQUO",1
26,"26008",1909,1544,1527,19,17,"EQUO",6
9,"9246",662,469,457,3,12,"EQUO",10
33,"33021",4932,3544,3502,45,42,"EQUO",9
42,"42116",63,50,48,3,2,"EQUO",1
37,"37255",58,47,47,3,0,"EQUO",0
28,"28074",136617,106248,105095,1101,1153,"EQUO",1604
15,"15043",5491,4033,3971,45,62,"EQUO",9
20,"20030",22191,15262,15148,164,114,"EQUO",162
40,"40003",144,123,120,1,3,"EQUO",0
13,"13036",837,671,666,3,5,"EQUO",0
5,"5108",64,41,41,0,0,"EQUO",0
5,"5005",199,170,169,1,1,"EQUO",0
24,"24113",404,318,310,3,8,"EQUO",1
50,"50245",121,80,80,1,0,"EQUO",2
9,"9247",28,21,20,0,1,"EQUO",0
18,"18054",879,646,644,4,2,"EQUO",3
16,"16173",249,189,188,0,1,"EQUO",0
10,"10146",1439,991,975,11,16,"EQUO",9
31,"31104",1990,1374,1355,20,19,"EQUO",16
14,"14031",634,516,514,1,2,"EQUO",0
37,"37257",52,43,43,0,0,"EQUO",3
31,"31195",186,127,126,1,1,"EQUO",2
45,"45182",1077,873,856,11,17,"EQUO",2
16,"16048",432,339,337,8,2,"EQUO",0
19,"19049",19,11,11,0,0,"EQUO",0
5,"5007",126,104,102,0,2,"EQUO",0
9,"9117",82,59,59,1,0,"EQUO",0
26,"26010",98,82,79,1,3,"EQUO",0
33,"33022",992,709,696,12,13,"EQUO",2
41,"41025",1999,1502,1476,13,26,"EQUO",2
50,"50246",48,33,33,1,0,"EQUO",0
10,"10147",1263,1003,965,5,38,"EQUO",3
9,"9476",67,52,52,0,0,"EQUO",0
16,"16133",4466,3522,3453,51,69,"EQUO",20
33,"33046",546,429,421,3,8,"EQUO",1
5,"5207",743,595,591,1,4,"EQUO",3
40,"40006",23,20,20,0,0,"EQUO",0
1,"1014",385,281,274,6,7,"EQUO",3
31,"31045",501,384,377,16,7,"EQUO",6
5,"5112",125,88,87,0,1,"EQUO",5
23,"23904",3070,2047,2033,19,14,"EQUO",7
9,"9249",54,44,42,1,2,"EQUO",1
5,"5010",173,141,134,2,7,"EQUO",0
31,"31015",1989,1404,1380,29,24,"EQUO",8
9,"9119",51,38,38,0,0,"EQUO",2
13,"13039",14349,10928,10776,149,152,"EQUO",95
41,"41094",6089,4757,4680,47,77,"EQUO",57
42,"42025",1305,964,945,15,19,"EQUO",2
37,"37024",101,80,80,0,0,"EQUO",0
39,"39029",642,521,517,6,4,"EQUO",2
28,"28125",2808,2077,2055,19,22,"EQUO",27
9,"9250",295,234,230,5,4,"EQUO",0
10,"10027",88,78,78,0,0,"EQUO",1
40,"40008",44,37,36,0,1,"EQUO",0
40,"40103",157,121,120,0,1,"EQUO",1
18,"18161",220,180,178,0,2,"EQUO",3
22,"22084",524,362,354,11,8,"EQUO",15
45,"45037",1730,1325,1304,15,21,"EQUO",10
10,"10028",125,88,88,0,0,"EQUO",0
19,"19263",34,27,27,0,0,"EQUO",0
26,"26014",472,358,353,6,5,"EQUO",3
2,"2035",1988,1601,1586,19,15,"EQUO",9
19,"19167",136,112,109,4,3,"EQUO",1
28,"28013",38226,27886,27547,246,339,"EQUO",361
13,"13041",298,225,225,1,0,"EQUO",2
9,"9122",93,71,71,4,0,"EQUO",1
40,"40009",49,41,41,0,0,"EQUO",0
21,"21048",327,226,226,5,0,"EQUO",0
22,"22242",75,53,52,0,1,"EQUO",0
16,"16052",596,469,464,2,5,"EQUO",1
10,"10151",245,204,202,2,2,"EQUO",1
35,"35023",11640,8412,8178,97,234,"EQUO",83
18,"18194",2258,1656,1652,11,4,"EQUO",1
24,"24002",271,213,213,2,0,"EQUO",0
9,"9123",31,27,27,0,0,"EQUO",0
9,"9253",108,95,94,4,1,"EQUO",0
19,"19129",48,33,31,0,2,"EQUO",0
45,"45039",236,197,190,2,7,"EQUO",0
22,"22045",104,83,80,2,3,"EQUO",0
28,"28014",31360,23434,23133,203,301,"EQUO",230
35,"35024",12420,6978,6819,131,159,"EQUO",105
20,"20037",100,65,64,2,1,"EQUO",0
24,"24120",379,258,256,3,2,"EQUO",0
41,"41096",6079,4673,4595,47,78,"EQUO",104
16,"16186",521,434,429,2,5,"EQUO",1
41,"41097",3096,2489,2451,21,38,"EQUO",2
24,"24003",725,528,520,8,8,"EQUO",0
9,"9256",369,254,252,2,2,"EQUO",1
13,"13043",251,208,206,1,2,"EQUO",0
24,"24004",535,391,390,0,1,"EQUO",1
40,"40013",67,56,54,1,2,"EQUO",0
31,"31080",544,428,426,7,2,"EQUO",4
22,"22088",171,133,128,5,5,"EQUO",2
21,"21050",12322,8772,8679,99,93,"EQUO",37
10,"10154",194,150,145,0,5,"EQUO",0
29,"29084",28386,19450,19202,296,248,"EQUO",131
26,"26146",141,98,96,0,2,"EQUO",1
10,"10114",926,670,652,8,18,"EQUO",3
24,"24005",437,308,305,3,3,"EQUO",0
48,"48006",285,246,243,3,3,"EQUO",0
19,"19267",22,15,15,0,0,"EQUO",0
19,"19055",54,41,37,1,4,"EQUO",0
37,"37030",90,71,70,4,1,"EQUO",0
16,"16056",495,377,374,11,3,"EQUO",2
50,"50077",254,189,188,4,1,"EQUO",1
24,"24123",835,559,555,6,4,"EQUO",0
40,"40156",361,268,264,5,4,"EQUO",1
9,"9396",152,113,113,0,0,"EQUO",0
33,"33027",929,617,613,5,4,"EQUO",1
10,"10156",116,91,91,0,0,"EQUO",1
26,"26020",506,372,364,10,8,"EQUO",0
10,"10034",376,283,278,5,5,"EQUO",1
50,"50167",235,191,184,1,7,"EQUO",1
31,"31021",75,52,52,0,0,"EQUO",0
6,"6056",487,411,411,1,0,"EQUO",0
40,"40157",74,51,50,2,1,"EQUO",3
28,"28129",7219,5536,5461,71,75,"EQUO",81
5,"5118",91,66,66,0,0,"EQUO",1
33,"33028",1466,812,806,5,6,"EQUO",2
16,"16189",263,213,211,2,2,"EQUO",0
26,"26149",67,50,49,1,1,"EQUO",0
40,"40017",103,89,88,2,1,"EQUO",0
40,"40158",24,18,17,0,1,"EQUO",0
10,"10117",264,174,174,2,0,"EQUO",0
29,"29087",409,306,305,3,1,"EQUO",0
35,"35028",8810,4687,4603,71,84,"EQUO",63
41,"41032",4059,3122,3062,22,60,"EQUO",10
9,"9440",105,80,80,0,0,"EQUO",0
20,"20042",3354,2131,2117,18,14,"EQUO",20
9,"9400",340,253,249,4,4,"EQUO",4
39,"39035",10031,7685,7601,74,84,"EQUO",40
5,"5018",27,24,24,0,0,"EQUO",0
37,"37156",4319,3280,3233,28,47,"EQUO",14
31,"31114",384,320,318,37,2,"EQUO",5
14,"14041",3215,2492,2439,45,53,"EQUO",6
28,"28017",1120,905,888,8,17,"EQUO",23
40,"40018",102,88,87,2,1,"EQUO",0
19,"19060",165,127,121,3,6,"EQUO",15
24,"24127",327,258,255,1,3,"EQUO",0
40,"40019",43,35,35,0,0,"EQUO",1
31,"31205",465,335,325,9,10,"EQUO",3
42,"42135",89,59,59,1,0,"EQUO",0
16,"16061",1035,861,848,15,13,"EQUO",3
22,"22096",301,239,237,8,2,"EQUO",5
2,"2044",1207,908,893,5,15,"EQUO",5
15,"15054",32172,20472,20154,519,318,"EQUO",122
33,"33030",921,682,668,4,14,"EQUO",1
50,"50023",240,180,180,4,0,"EQUO",0
4,"4019",269,210,209,3,1,"EQUO",0
10,"10038",98,84,83,0,1,"EQUO",0
15,"15026",2025,1426,1413,17,13,"EQUO",4
41,"41034",22561,16014,15840,270,174,"EQUO",69
16,"16062",30,27,27,0,0,"EQUO",0
40,"40020",200,155,149,2,6,"EQUO",2
31,"31115",171,112,109,2,3,"EQUO",2
9,"9047",62,48,45,0,3,"EQUO",1
40,"40021",33,32,32,0,0,"EQUO",0
24,"24011",244,131,129,0,2,"EQUO",0
9,"9132",174,129,127,3,2,"EQUO",0
41,"41102",14343,11050,10837,206,213,"EQUO",26
16,"16063",97,81,81,0,0,"EQUO",0
16,"16194",298,238,238,1,0,"EQUO",1
37,"37271",393,324,318,5,6,"EQUO",0
14,"14043",7664,5935,5874,53,61,"EQUO",13
2,"2046",1165,954,941,16,13,"EQUO",5
26,"26154",12,12,12,3,0,"EQUO",0
37,"37235",226,194,192,0,2,"EQUO",0
41,"41901",2626,2190,2167,24,23,"EQUO",2
48,"48012",2036,1630,1616,9,14,"EQUO",21
21,"21057",1054,699,697,9,2,"EQUO",0
40,"40164",188,145,142,0,3,"EQUO",0
22,"22103",697,532,523,10,9,"EQUO",4
5,"5219",45,33,33,0,0,"EQUO",0
9,"9011",86,56,56,1,0,"EQUO",0
10,"10163",374,310,308,0,2,"EQUO",0
19,"19274",881,652,644,8,8,"EQUO",8
11,"11902",3578,2400,2376,21,24,"EQUO",1
19,"19065",126,100,100,3,0,"EQUO",1
48,"48079",470,391,391,2,0,"EQUO",6
40,"40024",920,712,704,7,8,"EQUO",2
31,"31087",163,122,121,3,1,"EQUO",2
19,"19177",82,67,66,0,1,"EQUO",0
6,"6064",900,715,706,2,9,"EQUO",0
18,"18173",8858,6238,6187,64,51,"EQUO",27
29,"29017",6766,5162,5114,48,48,"EQUO",14
31,"31027",824,611,609,2,2,"EQUO",2
9,"9268",108,78,78,0,0,"EQUO",0
37,"37274",123032,90819,89629,1506,1190,"EQUO",916
9,"9134",237,164,159,7,5,"EQUO",1
47,"47163",315,253,250,2,3,"EQUO",1
26,"26158",296,238,237,7,1,"EQUO",0
21,"21059",203,166,162,1,4,"EQUO",4
5,"5125",60,52,52,0,0,"EQUO",0
48,"48015",34932,24209,23966,296,243,"EQUO",225
48,"48081",1938,1449,1435,14,14,"EQUO",11
9,"9269",39,33,33,0,0,"EQUO",0
18,"18071",5589,4268,4205,44,63,"EQUO",43
37,"37039",325,241,236,0,5,"EQUO",0
9,"9013",48,41,41,1,0,"EQUO",0
47,"47003",263,224,222,1,2,"EQUO",0
26,"26160",684,538,528,5,10,"EQUO",7
37,"37040",431,362,362,4,0,"EQUO",1
31,"31029",987,693,680,16,13,"EQUO",4
9,"9409",138,105,102,0,3,"EQUO",2
42,"42145",140,111,111,2,0,"EQUO",1
28,"28134",55921,42676,42221,505,455,"EQUO",752
9,"9136",203,153,146,3,7,"EQUO",1
35,"35033",6415,4394,4302,51,92,"EQUO",55
50,"50260",42,35,35,1,0,"EQUO",0
42,"42148",14,14,14,0,0,"EQUO",0
40,"40029",50,43,42,0,1,"EQUO",0
5,"5026",229,193,192,2,1,"EQUO",0
48,"48016",5214,3782,3736,46,46,"EQUO",56
45,"45201",3439,2353,2317,31,36,"EQUO",10
47,"47165",7036,5328,5258,67,70,"EQUO",22
31,"31121",79,53,52,2,1,"EQUO",1
29,"29094",54317,36540,36174,410,366,"EQUO",211
37,"37165",27,20,20,1,0,"EQUO",0
37,"37086",105,75,72,3,3,"EQUO",0
22,"22016",654,476,464,10,12,"EQUO",6
19,"19181",69,54,54,5,0,"EQUO",0
20,"20052",1154,849,847,14,2,"EQUO",3
24,"24018",180,150,149,1,1,"EQUO",3
9,"9411",174,104,103,1,1,"EQUO",1
26,"26162",116,94,93,2,1,"EQUO",1
22,"22061",6611,4789,4698,110,91,"EQUO",31
21,"21062",1444,1003,991,7,12,"EQUO",1
29,"29021",153,113,113,0,0,"EQUO",0
10,"10169",587,460,450,2,10,"EQUO",1
22,"22111",180,126,125,3,1,"EQUO",1
45,"45203",2535,1883,1829,21,54,"EQUO",9
47,"47005",578,467,455,5,12,"EQUO",2
9,"9138",92,77,74,0,3,"EQUO",0
20,"20053",4830,2895,2868,36,27,"EQUO",27
9,"9139",104,84,80,3,4,"EQUO",0
22,"22906",190,152,147,3,5,"EQUO",3
9,"9017",96,76,74,0,2,"EQUO",0
42,"42006",166,110,107,3,3,"EQUO",2
6,"6072",2370,1907,1885,9,22,"EQUO",2
37,"37279",780,580,571,6,9,"EQUO",2
5,"5096",74,56,56,0,0,"EQUO",1
41,"41041",9646,7901,7791,58,110,"EQUO",14
19,"19183",108,87,86,1,1,"EQUO",0
10,"10049",3952,3348,3259,36,89,"EQUO",4
5,"5129",153,98,95,0,3,"EQUO",0
9,"9140",136,110,110,1,0,"EQUO",0
50,"50088",337,273,264,4,9,"EQUO",1
13,"13058",4155,3320,3285,24,35,"EQUO",1
47,"47085",16967,12618,12472,208,146,"EQUO",52
5,"5227",409,307,305,2,2,"EQUO",2
48,"48020",276378,191777,190141,2335,1636,"EQUO",2908
31,"31154",229,133,133,4,0,"EQUO",0
5,"5033",184,159,155,3,4,"EQUO",0
37,"37168",470,357,353,1,4,"EQUO",0
41,"41042",5902,4572,4509,37,63,"EQUO",17
15,"15062",6304,4418,4356,44,62,"EQUO",6
48,"48087",463,371,370,4,1,"EQUO",3
22,"22218",49,33,33,1,0,"EQUO",0
9,"9141",607,503,481,10,22,"EQUO",5
5,"5065",498,424,422,7,2,"EQUO",0
5,"5261",48,32,31,0,1,"EQUO",0
22,"22168",22,16,16,0,0,"EQUO",1
28,"28003",196,154,151,2,3,"EQUO",5
45,"45096",1021,800,778,5,22,"EQUO",0
29,"29098",1312,1043,1036,22,7,"EQUO",3
47,"47033",209,170,168,3,2,"EQUO",0
16,"16118",1454,1221,1211,19,10,"EQUO",3
16,"16078",40954,30382,29933,568,449,"EQUO",436
36,"36005",8231,5985,5873,84,112,"EQUO",17
29,"29024",414,271,261,6,10,"EQUO",8
42,"42156",30,21,21,0,0,"EQUO",0
9,"9416",61,44,44,0,0,"EQUO",3
6,"6076",854,639,631,9,8,"EQUO",2
5,"5229",90,79,77,2,2,"EQUO",0
6,"6031",490,387,385,8,2,"EQUO",0
10,"10175",1509,1149,1127,4,22,"EQUO",2
21,"21066",522,440,431,4,9,"EQUO",0
40,"40223",241,190,190,2,0,"EQUO",4
45,"45133",2803,2241,2199,18,42,"EQUO",7
23,"23001",1058,922,920,6,2,"EQUO",1
37,"37050",71,48,48,1,0,"EQUO",1
14,"14053",6040,4455,4376,78,79,"EQUO",28
9,"9279",195,140,140,4,0,"EQUO",0
31,"31126",372,247,244,6,3,"EQUO",3
13,"13061",5898,4442,4373,56,69,"EQUO",24
2,"2058",390,290,285,0,5,"EQUO",1
31,"31036",957,631,616,22,15,"EQUO",7
10,"10053",303,253,246,5,7,"EQUO",0
19,"19078",58,49,48,0,1,"EQUO",4
50,"50266",139,95,94,1,1,"EQUO",1
9,"9022",83,58,58,2,0,"EQUO",0
10,"10054",551,435,428,6,7,"EQUO",4
37,"37172",857,584,580,5,4,"EQUO",7
24,"24148",1759,1362,1348,29,14,"EQUO",12
42,"42012",43,29,29,1,0,"EQUO",1
50,"50181",1053,787,760,9,27,"EQUO",9
50,"50267",648,450,441,8,9,"EQUO",1
13,"13062",595,490,480,4,10,"EQUO",1
4,"4034",152,106,105,1,1,"EQUO",0
10,"10055",709,523,508,13,15,"EQUO",4
48,"48024",1026,845,841,3,4,"EQUO",4
18,"18181",253,183,182,0,1,"EQUO",2
5,"5037",296,213,212,0,1,"EQUO",0
39,"39047",1987,1495,1482,9,13,"EQUO",7
21,"21068",1009,726,721,10,5,"EQUO",3
10,"10178",797,604,597,5,7,"EQUO",3
48,"48025",882,652,644,2,8,"EQUO",3
45,"45100",205,169,169,0,0,"EQUO",0
28,"28141",5568,4097,4051,31,46,"EQUO",71
14,"14056",23507,17245,17071,259,174,"EQUO",68
2,"2060",1232,974,964,10,10,"EQUO",0
15,"15067",8142,6054,5978,73,76,"EQUO",26
36,"36009",5138,3147,3108,24,39,"EQUO",12
42,"42014",83,55,55,1,0,"EQUO",1
50,"50268",59,46,46,3,0,"EQUO",1
9,"9064",353,277,277,6,0,"EQUO",1
16,"16215",285,192,186,2,6,"EQUO",2
5,"5135",440,363,360,0,3,"EQUO",1
9,"9151",509,389,383,5,6,"EQUO",4
6,"6082",373,315,311,3,4,"EQUO",0
9,"9152",273,207,207,1,0,"EQUO",0
50,"50008",5110,3458,3406,56,52,"EQUO",15
16,"16216",358,300,296,2,4,"EQUO",0
22,"22124",229,171,170,2,1,"EQUO",7
50,"50094",1744,1220,1193,25,27,"EQUO",9
18,"18183",685,502,500,3,2,"EQUO",1
5,"5039",58,48,48,0,0,"EQUO",0
24,"24151",514,391,387,6,4,"EQUO",2
36,"36011",1939,1189,1172,15,17,"EQUO",4
47,"47012",134,105,105,0,0,"EQUO",1
31,"31130",319,213,209,1,4,"EQUO",0
47,"47173",862,683,675,5,8,"EQUO",7
24,"24152",481,326,322,5,4,"EQUO",2
37,"37056",56,47,47,0,0,"EQUO",0
26,"26045",13,13,13,0,0,"EQUO",0
47,"47092",123,100,99,2,1,"EQUO",0
39,"39050",305,207,205,1,2,"EQUO",1
40,"40185",977,725,712,13,13,"EQUO",2
16,"16086",935,814,802,14,12,"EQUO",0
36,"36012",3839,2884,2825,14,59,"EQUO",14
22,"22126",100,81,80,2,1,"EQUO",0
37,"37177",310,242,241,1,1,"EQUO",0
31,"31131",841,610,594,12,16,"EQUO",6
26,"26046",1617,1237,1219,14,18,"EQUO",3
37,"37057",223,190,190,0,0,"EQUO",0
19,"19290",872,622,613,7,9,"EQUO",7
10,"10182",146,112,108,0,4,"EQUO",0
40,"40186",50,33,33,0,0,"EQUO",0
50,"50186",44,30,29,0,1,"EQUO",0
5,"5139",74,62,59,2,3,"EQUO",0
10,"10061",1765,1305,1290,13,15,"EQUO",2
47,"47093",865,658,642,11,16,"EQUO",6
31,"31224",980,691,681,9,10,"EQUO",2
10,"10183",1022,818,805,5,13,"EQUO",4
18,"18185",608,484,479,2,5,"EQUO",3
9,"9425",561,431,418,3,13,"EQUO",5
36,"36013",2690,1801,1778,11,23,"EQUO",9
23,"23010",14447,10777,10704,109,73,"EQUO",37
19,"19293",1860,1407,1373,16,34,"EQUO",39
29,"29003",1133,902,900,5,2,"EQUO",1
40,"40048",40,30,30,0,0,"EQUO",0
24,"24032",134,102,101,1,1,"EQUO",1
14,"14060",4843,3857,3787,47,70,"EQUO",12
9,"9159",57,49,48,0,1,"EQUO",0
24,"24033",214,157,152,3,5,"EQUO",2
5,"5042",156,126,126,0,0,"EQUO",0
31,"31133",48,34,34,3,0,"EQUO",0
24,"24155",524,428,420,6,8,"EQUO",3
31,"31226",597,339,335,2,4,"EQUO",3
28,"28031",1981,1524,1500,9,24,"EQUO",11
19,"19294",27,26,26,1,0,"EQUO",0
42,"42167",305,223,222,3,1,"EQUO",0
9,"9294",123,96,93,1,3,"EQUO",1
19,"19089",33,22,22,1,0,"EQUO",0
1,"1010",2276,1649,1618,27,31,"EQUO",18
31,"31134",195,134,132,3,2,"EQUO",0
22,"22129",193,124,123,4,1,"EQUO",0
41,"41091",545464,388043,383816,5325,4227,"EQUO",6173
47,"47015",229,172,170,1,2,"EQUO",0
42,"42022",253,177,171,2,6,"EQUO",0
24,"24156",264,187,186,6,1,"EQUO",0
9,"9033",104,82,80,1,2,"EQUO",0
5,"5142",113,97,96,0,1,"EQUO",0
36,"36015",4379,3151,3101,38,50,"EQUO",10
9,"9428",124,107,107,1,0,"EQUO",0
41,"41051",2103,1705,1686,7,19,"EQUO",4
33,"33045",4692,3347,3297,42,50,"EQUO",17
6,"6090",904,724,710,10,14,"EQUO",2
39,"39053",251,179,179,1,0,"EQUO",0
37,"37182",92,72,72,2,0,"EQUO",0
45,"45109",3030,2507,2417,30,90,"EQUO",7
9,"9034",301,250,250,3,0,"EQUO",1
16,"16228",202,146,144,2,2,"EQUO",0
14,"14063",1121,875,866,9,9,"EQUO",2
37,"37371",285,190,190,2,0,"EQUO",0
41,"41052",2967,2305,2288,7,17,"EQUO",2
10,"10188",553,473,468,2,5,"EQUO",3
22,"22041",175,138,138,1,0,"EQUO",2
28,"28169",1244,971,962,8,9,"EQUO",22
23,"23015",1476,1189,1179,10,10,"EQUO",2
5,"5239",215,171,170,2,1,"EQUO",2
37,"37297",441,376,369,1,7,"EQUO",0
22,"22133",123,87,85,2,2,"EQUO",0
48,"48034",13160,9290,9189,82,101,"EQUO",91
39,"39055",1130,881,869,10,12,"EQUO",2
10,"10189",2728,2108,2063,24,45,"EQUO",6
14,"14064",352,265,261,3,4,"EQUO",1
28,"28170",2503,1744,1727,20,17,"EQUO",4
47,"47043",330,267,264,1,3,"EQUO",1
9,"9345",134,102,102,1,0,"EQUO",0
42,"42121",77,56,56,1,0,"EQUO",0
5,"5240",3351,2472,2428,22,44,"EQUO",11
29,"29035",1717,1280,1270,14,10,"EQUO",2
16,"16234",52,38,36,0,2,"EQUO",0
5,"5209",104,78,78,0,0,"EQUO",0
19,"19298",75,53,52,2,1,"EQUO",0
9,"9036",32,27,27,2,0,"EQUO",2
31,"31230",118,88,85,1,3,"EQUO",0
13,"13073",565,459,456,2,3,"EQUO",0
50,"50102",918,722,713,12,9,"EQUO",3
10,"10191",527,421,414,3,7,"EQUO",2
6,"6094",1508,1130,1119,6,11,"EQUO",3
18,"18095",1916,1428,1306,21,122,"EQUO",3
21,"21078",2865,2085,2066,21,19,"EQUO",4
39,"39056",2387,1857,1835,22,22,"EQUO",7
47,"47019",93,69,68,0,1,"EQUO",0
29,"29036",670,504,499,4,5,"EQUO",0
24,"24161",307,231,228,1,3,"EQUO",1
5,"5114",1418,1195,1182,9,13,"EQUO",3
26,"26056",440,345,339,4,6,"EQUO",0
42,"42027",87,61,61,4,0,"EQUO",0
45,"45113",2094,1589,1555,6,34,"EQUO",2
10,"10111",1453,1052,1046,13,6,"EQUO",5
40,"40057",1522,1272,1260,19,12,"EQUO",9
18,"18096",348,289,287,1,2,"EQUO",1
1,"1018",1395,952,943,7,9,"EQUO",32
22,"22137",1164,850,839,14,11,"EQUO",4
16,"16097",196,167,166,2,1,"EQUO",0
31,"31109",1365,946,934,11,12,"EQUO",16
10,"10193",1410,1179,1158,16,21,"EQUO",4
19,"19096",99,79,78,1,1,"EQUO",0
30,"30009",11961,9992,9880,92,112,"EQUO",21
13,"13075",212,161,159,1,2,"EQUO",1
45,"45003",607,515,511,3,4,"EQUO",2
50,"50278",207,152,149,4,3,"EQUO",0
22,"22139",86,66,63,2,3,"EQUO",1
45,"45004",603,497,494,6,3,"EQUO",3
37,"37301",78,58,58,0,0,"EQUO",0
42,"42178",144,105,104,3,1,"EQUO",1
10,"10072",892,663,655,3,8,"EQUO",7
47,"47021",84,61,61,2,0,"EQUO",0
45,"45115",2600,2140,2105,14,35,"EQUO",1
40,"40200",47,41,39,0,2,"EQUO",1
50,"50194",102,67,67,2,0,"EQUO",0
45,"45005",267,223,218,4,5,"EQUO",0
31,"31233",103,87,82,2,5,"EQUO",0
22,"22141",129,103,102,3,1,"EQUO",0
10,"10195",7917,6143,6054,36,89,"EQUO",28
26,"26059",1137,887,869,9,18,"EQUO",3
48,"48039",263,217,216,4,1,"EQUO",1
16,"16240",134,100,98,0,2,"EQUO",0
40,"40201",48,48,48,2,0,"EQUO",0
10,"10073",759,589,583,3,6,"EQUO",5
13,"13077",3654,2535,2480,31,55,"EQUO",9
9,"9306",127,94,94,0,0,"EQUO",1
37,"37303",207,158,152,3,6,"EQUO",0
29,"29039",2822,2091,2074,8,17,"EQUO",17
9,"9043",215,151,151,1,0,"EQUO",0
36,"36023",8522,6206,6062,64,144,"EQUO",32
47,"47101",1740,1458,1444,12,14,"EQUO",2
26,"26060",100,71,71,3,0,"EQUO",1
45,"45006",1524,1128,1110,13,18,"EQUO",1
42,"42032",186,143,141,2,2,"EQUO",4
16,"16242",367,315,313,4,2,"EQUO",0
31,"31234",148,107,105,6,2,"EQUO",2
39,"39060",6723,5453,5360,56,93,"EQUO",38
31,"31051",270,182,181,8,1,"EQUO",0
37,"37304",190,144,142,1,2,"EQUO",1
40,"40062",54,44,44,0,0,"EQUO",0
24,"24166",1521,1137,1112,27,25,"EQUO",6
29,"29040",1934,1344,1332,12,12,"EQUO",9
6,"6102",1045,851,840,7,11,"EQUO",1
22,"22006",319,203,197,5,6,"EQUO",2
33,"33051",7576,5379,5335,65,44,"EQUO",9
31,"31052",89,62,58,1,4,"EQUO",0
14,"14071",1025,739,733,8,6,"EQUO",1
26,"26062",94,78,77,1,1,"EQUO",1
4,"4054",384,328,325,0,3,"EQUO",0
50,"50224",70,52,49,2,3,"EQUO",0
30,"30012",9037,7242,7142,62,100,"EQUO",39
13,"13013",7141,5682,5564,60,118,"EQUO",23
9,"9174",859,645,639,11,6,"EQUO",2
10,"10199",181,142,140,1,2,"EQUO",4
1,"1027",430,283,276,4,7,"EQUO",7
18,"18904",858,620,612,3,8,"EQUO",9
22,"22149",321,244,241,5,3,"EQUO",1
24,"24049",1528,1144,1124,22,20,"EQUO",6
28,"28153",608,422,406,1,16,"EQUO",15
22,"22007",863,636,621,8,15,"EQUO",4
9,"9309",343,252,246,7,6,"EQUO",0
14,"14072",1169,925,922,5,3,"EQUO",4
10,"10078",451,349,341,3,8,"EQUO",0
9,"9175",143,99,98,0,1,"EQUO",0
31,"31237",198,137,136,7,1,"EQUO",1
26,"26064",2341,1770,1749,26,21,"EQUO",7
5,"5249",101,73,71,1,2,"EQUO",7
37,"37307",177,132,130,0,2,"EQUO",0
9,"9310",14,10,9,2,1,"EQUO",0
9,"9046",41,30,30,0,0,"EQUO",1
42,"42084",27,21,21,0,0,"EQUO",0
16,"16246",520,417,407,1,10,"EQUO",0
48,"48044",63869,47453,47085,511,368,"EQUO",722
22,"22009",704,488,473,15,15,"EQUO",2
6,"6106",447,335,333,7,2,"EQUO",0
10,"10080",385,294,287,0,7,"EQUO",0
24,"24051",484,375,368,2,7,"EQUO",2
9,"9442",385,295,289,4,6,"EQUO",1
22,"22205",472,369,363,5,6,"EQUO",2
37,"37079",77,64,63,1,1,"EQUO",1
31,"31146",46,34,34,1,0,"EQUO",0
37,"37309",42,26,25,3,1,"EQUO",0
10,"10202",665,533,523,7,10,"EQUO",3
22,"22011",102,78,78,3,0,"EQUO",2
20,"20901",1468,951,947,13,4,"EQUO",19
4,"4057",1454,1081,1071,1,10,"EQUO",10
40,"40208",828,650,638,7,12,"EQUO",6
19,"19105",2235,1709,1686,23,23,"EQUO",16
14,"14074",2387,2002,1995,26,7,"EQUO",3
40,"40070",137,91,91,0,0,"EQUO",3
31,"31177",264,162,158,3,4,"EQUO",2
26,"26067",22,19,19,1,0,"EQUO",0
37,"37311",251,210,209,8,1,"EQUO",0
22,"22156",256,209,203,5,6,"EQUO",4
45,"45012",683,572,566,10,6,"EQUO",0
48,"48046",12635,9231,9161,61,70,"EQUO",40
20,"20902",14148,9874,9798,120,76,"EQUO",113
50,"50200",534,436,432,9,4,"EQUO",1
47,"47106",63,52,52,0,0,"EQUO",0
16,"16108",68,56,55,0,1,"EQUO",0
42,"42191",187,143,141,5,2,"EQUO",3
28,"28020",145,102,100,0,2,"EQUO",9
13,"13084",973,800,793,6,7,"EQUO",3
22,"22157",251,176,175,9,1,"EQUO",1
48,"48047",161,126,126,1,0,"EQUO",0
45,"45124",2183,1868,1823,20,45,"EQUO",1
15,"15085",3576,2656,2612,29,44,"EQUO",8
33,"33055",1589,1212,1192,16,20,"EQUO",7
45,"45014",4087,2851,2816,36,35,"EQUO",7
42,"42041",36,25,25,4,0,"EQUO",0
6,"6111",502,389,387,8,2,"EQUO",0
5,"5158",410,333,331,2,2,"EQUO",2
39,"39065",272,199,197,2,2,"EQUO",0
22,"22013",304,239,236,3,3,"EQUO",1
50,"50114",157,120,120,1,0,"EQUO",0
2,"2085",345,288,284,2,4,"EQUO",2
47,"47189",164,134,134,1,0,"EQUO",0
10,"10206",237,177,174,0,3,"EQUO",1
33,"33056",5278,3576,3540,41,36,"EQUO",10
22,"22014",265,192,191,1,1,"EQUO",1
1,"1036",15236,10511,10372,141,139,"EQUO",83
29,"29046",2777,2032,2013,10,19,"EQUO",16
26,"26071",8475,6088,5964,92,124,"EQUO",73
39,"39014",943,706,700,9,6,"EQUO",7
16,"16251",1903,1510,1493,18,17,"EQUO",10
45,"45126",278,188,187,0,1,"EQUO",4
50,"50027",260,209,202,2,7,"EQUO",0
47,"47110",471,386,378,6,8,"EQUO",0
10,"10086",342,259,250,5,9,"EQUO",1
22,"22015",336,237,235,11,2,"EQUO",2
50,"50288",3252,2412,2380,50,32,"EQUO",25
19,"19109",53,40,40,1,0,"EQUO",0
47,"47191",113,81,80,1,1,"EQUO",0
23,"23038",3273,2658,2638,29,20,"EQUO",23
31,"31243",313,227,223,5,4,"EQUO",3
28,"28043",5944,4199,4147,56,52,"EQUO",21
10,"10087",1754,1283,1262,4,21,"EQUO",6
18,"18011",4246,3195,3172,23,23,"EQUO",49
19,"19214",94,78,78,2,0,"EQUO",0
50,"50116",220,154,153,0,1,"EQUO",1
28,"28044",5403,4245,4188,27,57,"EQUO",119
45,"45055",1052,886,870,10,16,"EQUO",0
40,"40124",261,190,183,9,7,"EQUO",0
31,"31151",77,49,49,2,0,"EQUO",1
9,"9318",63,38,38,0,0,"EQUO",0
42,"42045",345,238,234,2,4,"EQUO",0
33,"33057",1635,1150,1132,16,18,"EQUO",8
48,"48050",216,173,172,0,1,"EQUO",0
36,"36034",3684,2686,2651,32,35,"EQUO",9
1,"1041",159,116,113,1,3,"EQUO",2
47,"47112",2671,2231,2198,28,33,"EQUO",2
40,"40216",753,621,611,15,10,"EQUO",5
40,"40077",713,526,519,12,7,"EQUO",13
9,"9321",1760,1338,1327,20,11,"EQUO",2
5,"5161",638,525,522,0,3,"EQUO",5
9,"9449",94,80,80,2,0,"EQUO",0
37,"37087",779,590,586,18,4,"EQUO",15
9,"9056",4957,3607,3557,70,50,"EQUO",27
28,"28045",30286,23148,22879,226,269,"EQUO",511
19,"19216",143,112,105,2,7,"EQUO",0
50,"50205",98,72,71,2,1,"EQUO",0
15,"15005",23875,15132,14895,356,237,"EQUO",65
26,"26075",377,297,289,4,8,"EQUO",0
45,"45130",354,287,283,2,4,"EQUO",0
14,"14020",415,323,319,3,4,"EQUO",2
28,"28090",7899,6216,6131,60,85,"EQUO",133
29,"29050",483,341,340,1,1,"EQUO",4
22,"22019",190,141,138,4,3,"EQUO",2
30,"30020",5989,4533,4487,14,46,"EQUO",9
9,"9323",71,44,44,2,0,"EQUO",0
18,"18013",4392,3268,3223,23,45,"EQUO",11
22,"22167",515,417,399,16,18,"EQUO",2
40,"40079",236,174,171,0,3,"EQUO",3
10,"10212",1688,1276,1242,16,34,"EQUO",65
50,"50206",499,386,384,10,2,"EQUO",4
20,"20018",11027,7428,7387,53,41,"EQUO",14
50,"50291",112,75,73,0,2,"EQUO",0
13,"13091",570,484,478,0,6,"EQUO",0
42,"42050",29,20,20,1,0,"EQUO",0
4,"4066",13570,9018,8963,97,55,"EQUO",54
9,"9058",357,278,276,4,2,"EQUO",5
19,"19217",85,57,54,2,3,"EQUO",0
5,"5164",34,24,24,0,0,"EQUO",0
19,"19039",73,57,57,0,0,"EQUO",0
14,"14021",259993,183200,181402,2936,1798,"EQUO",2589
2,"2019",2455,2107,2077,16,30,"EQUO",4
23,"23043",554,411,407,6,4,"EQUO",7
13,"13026",482,387,384,1,3,"EQUO",0
28,"28092",148714,112174,110838,1215,1336,"EQUO",1469
9,"9372",207,169,165,1,4,"EQUO",2
45,"45059",1758,1465,1437,10,28,"EQUO",8
50,"50293",492,339,338,6,1,"EQUO",0
10,"10214",226,178,176,2,2,"EQUO",2
9,"9059",137122,103909,102353,2008,1556,"EQUO",965
33,"33060",15694,11036,10883,112,153,"EQUO",27
50,"50120",53,41,41,0,0,"EQUO",0
50,"50208",1831,1321,1305,24,16,"EQUO",9
9,"9191",45,34,33,1,1,"EQUO",0
45,"45023",1936,1476,1456,18,20,"EQUO",14
23,"23045",2180,1671,1667,3,4,"EQUO",1
31,"31156",268,202,201,5,1,"EQUO",2
20,"20020",143,104,104,1,0,"EQUO",2
40,"40036",531,440,424,10,16,"EQUO",2
9,"9235",179,148,142,1,6,"EQUO",0
39,"39072",375,234,234,4,0,"EQUO",0
4,"4068",187,137,137,1,0,"EQUO",1
48,"48056",849,610,608,3,2,"EQUO",7
19,"19323",50,41,39,0,2,"EQUO",0
13,"13094",338,276,275,2,1,"EQUO",0
6,"6123",4699,3509,3448,54,61,"EQUO",16
9,"9456",142,110,110,3,0,"EQUO",0
19,"19003",50,36,35,1,1,"EQUO",1
16,"16265",27,26,26,0,0,"EQUO",0
47,"47061",266,227,223,0,4,"EQUO",3
24,"24184",206,111,111,0,0,"EQUO",1
10,"10216",1549,1247,1235,15,12,"EQUO",5
30,"30024",57868,41894,41513,393,381,"EQUO",113
39,"39073",9275,6984,6903,83,81,"EQUO",68
28,"28163",395,305,301,7,4,"EQUO",24
24,"24065",2104,1512,1488,27,24,"EQUO",7
19,"19116",16,10,10,0,0,"EQUO",0
37,"37209",376,258,253,4,5,"EQUO",0
50,"50034",923,634,617,10,17,"EQUO",1
33,"33062",452,282,281,3,1,"EQUO",1
40,"40228",539,446,437,2,9,"EQUO",0
50,"50035",78,61,56,2,5,"EQUO",5
37,"37324",415,338,334,2,4,"EQUO",0
23,"23048",884,691,679,6,12,"EQUO",2
24,"24066",561,440,437,5,3,"EQUO",0
18,"18017",17990,12070,11962,80,108,"EQUO",64
26,"26082",121,95,95,0,0,"EQUO",0
9,"9330",1562,1212,1176,10,36,"EQUO",19
16,"16124",1909,1573,1555,14,18,"EQUO",2
45,"45026",269,200,198,2,2,"EQUO",1
26,"26083",303,234,234,1,0,"EQUO",0
10,"10219",1408,984,971,11,13,"EQUO",4
40,"40229",45,37,37,0,0,"EQUO",0
15,"15010",2009,1468,1441,24,27,"EQUO",0
37,"37099",104,64,62,1,2,"EQUO",1
20,"20025",1174,814,803,4,11,"EQUO",2
40,"40088",303,242,238,0,4,"EQUO",1
13,"13097",2309,1843,1825,20,18,"EQUO",0
42,"42057",197,133,133,6,0,"EQUO",0
5,"5072",91,72,72,1,0,"EQUO",0
5,"5169",241,218,218,0,0,"EQUO",0
30,"30026",15165,10524,10369,80,155,"EQUO",46
24,"24188",3830,2987,2928,51,59,"EQUO",15
9,"9332",137,88,85,1,3,"EQUO",0
22,"22177",101,79,75,1,4,"EQUO",2
36,"36043",5188,3435,3390,35,45,"EQUO",15
29,"29056",1177,807,794,3,13,"EQUO",4
5,"5266",112,92,89,0,3,"EQUO",1
33,"33064",237,175,173,1,2,"EQUO",1
19,"19006",873,634,620,1,14,"EQUO",5
31,"31161",321,251,246,5,5,"EQUO",1
14,"14027",7948,5944,5871,92,73,"EQUO",28
41,"41073",1789,1292,1272,5,20,"EQUO",18
4,"4073",389,289,286,4,3,"EQUO",1
6,"6129",631,493,490,2,3,"EQUO",1
48,"48061",773,585,582,6,3,"EQUO",12
22,"22029",130,99,98,6,1,"EQUO",1
9,"9198",115,85,85,1,0,"EQUO",1
19,"19120",107,95,95,1,0,"EQUO",1
41,"41074",3079,2406,2386,14,20,"EQUO",4
5,"5170",63,50,50,0,0,"EQUO",0
9,"9066",62,44,42,0,2,"EQUO",0
9,"9335",62,52,51,1,1,"EQUO",2
50,"50213",117,83,82,0,1,"EQUO",0
5,"5073",319,258,254,7,4,"EQUO",0
5,"5171",84,74,73,0,1,"EQUO",1
40,"40092",132,100,100,0,0,"EQUO",0
21,"21011",3531,2672,2639,15,33,"EQUO",14
5,"5074",755,639,638,5,1,"EQUO",2
13,"13001",1372,1087,1067,8,20,"EQUO",5
19,"19008",34,25,25,1,0,"EQUO",0
22,"22035",261,179,176,3,3,"EQUO",8
36,"36046",4093,3175,3120,31,55,"EQUO",11
19,"19330",93,81,81,2,0,"EQUO",2
28,"28166",325,269,268,8,1,"EQUO",0
5,"5172",147,122,122,0,0,"EQUO",0
31,"31163",2008,1458,1434,22,24,"EQUO",8
6,"6132",876,656,648,2,8,"EQUO",0
18,"18121",135,109,109,0,0,"EQUO",1
2,"2029",3210,2512,2481,37,31,"EQUO",16
26,"26091",165,139,139,0,0,"EQUO",1
10,"10184",771,609,597,7,12,"EQUO",11
9,"9471",171,127,125,1,2,"EQUO",4
40,"40094",375,286,284,4,2,"EQUO",1
5,"5173",62,55,55,1,0,"EQUO",0
39,"39078",1407,1041,1033,10,8,"EQUO",3
31,"31164",604,462,448,9,14,"EQUO",0
5,"5903",171,118,118,0,0,"EQUO",1
37,"37104",32,24,23,0,1,"EQUO",0
19,"19331",2497,1898,1847,19,51,"EQUO",11
9,"9339",139,105,104,1,1,"EQUO",0
22,"22037",115,87,79,0,8,"EQUO",4
4,"4077",343,313,313,1,0,"EQUO",1
48,"48064",599,490,490,1,0,"EQUO",4
15,"15015",2840,2006,1964,43,42,"EQUO",18
29,"29060",775,573,572,1,1,"EQUO",1
28,"28010",9309,7304,7229,71,75,"EQUO",176
4,"4006",7156,5175,5106,51,69,"EQUO",26
45,"45033",407,302,295,3,7,"EQUO",5
37,"37106",289,199,196,2,3,"EQUO",0
47,"47205",414,307,298,5,9,"EQUO",0
41,"41077",8817,6520,6375,53,145,"EQUO",20
5,"5174",81,71,71,1,0,"EQUO",0
15,"15016",5135,3816,3771,22,45,"EQUO",3
26,"26093",60,41,41,0,0,"EQUO",0
36,"36049",6608,5189,5097,56,92,"EQUO",26
31,"31074",430,304,303,10,1,"EQUO",4
23,"23058",8497,6642,6591,44,51,"EQUO",30
42,"42065",28,24,24,0,0,"EQUO",3
14,"14002",10991,8444,8358,106,86,"EQUO",22
50,"50217",496,380,379,0,1,"EQUO",1
28,"28054",10459,7798,7698,65,100,"EQUO",246
37,"37334",86,50,49,0,1,"EQUO",0
31,"31166",274,183,182,2,1,"EQUO",2
28,"28147",910,705,698,5,7,"EQUO",3
16,"16009",79,63,62,0,1,"EQUO",2
19,"19013",143,110,108,1,2,"EQUO",0
18,"18093",2580,1837,1820,8,17,"EQUO",9
19,"19297",34,29,29,0,0,"EQUO",0
16,"16279",251,175,172,1,3,"EQUO",4
22,"22188",100,68,66,3,2,"EQUO",0
28,"28101",222,158,158,4,0,"EQUO",5
47,"47207",325,265,263,4,2,"EQUO",0
5,"5176",237,193,190,4,3,"EQUO",0
45,"45036",704,559,537,4,22,"EQUO",0
18,"18126",1461,1129,1121,15,8,"EQUO",6
24,"24078",426,323,316,0,7,"EQUO",2
24,"24116",451,297,294,5,3,"EQUO",1
10,"10149",434,323,319,1,4,"EQUO",1
19,"19230",438,317,309,4,8,"EQUO",11
16,"16049",158,129,129,1,0,"EQUO",0
22,"22239",90,76,76,2,0,"EQUO",1
6,"6139",600,489,481,5,8,"EQUO",1
16,"16135",192,127,125,0,2,"EQUO",0
37,"37110",112,89,88,1,1,"EQUO",1
36,"36052",7517,5563,5461,54,102,"EQUO",17
26,"26098",99,74,73,2,1,"EQUO",1
16,"16137",64,41,40,0,1,"EQUO",0
22,"22043",112,72,71,2,1,"EQUO",0
47,"47127",150,110,108,0,2,"EQUO",0
10,"10110",2326,1751,1703,11,48,"EQUO",14
40,"40104",261,179,178,1,1,"EQUO",5
39,"39004",1593,1321,1305,9,16,"EQUO",0
28,"28171",4148,2972,2929,21,43,"EQUO",25
26,"26142",804,661,648,1,13,"EQUO",9
37,"37337",140,122,121,0,1,"EQUO",0
9,"9432",212,161,158,1,3,"EQUO",0
22,"22193",318,266,264,7,2,"EQUO",3
50,"50134",134,102,101,3,1,"EQUO",0
30,"30034",1182,956,943,3,13,"EQUO",1
14,"14066",5911,4515,4473,54,42,"EQUO",16
33,"33071",671,528,523,4,5,"EQUO",6
6,"6005",1699,1332,1320,19,12,"EQUO",0
22,"22044",278,195,191,7,4,"EQUO",3
26,"26100",59,51,51,1,0,"EQUO",0
5,"5082",569,467,462,1,5,"EQUO",1
9,"9038",123,92,92,0,0,"EQUO",0
39,"39083",1214,785,775,7,10,"EQUO",3
28,"28104",11704,9455,9361,119,94,"EQUO",163
9,"9076",24,15,15,0,0,"EQUO",0
24,"24082",877,698,690,13,8,"EQUO",2
30,"30035",17849,12871,12744,133,127,"EQUO",81
21,"21019",645,464,458,2,6,"EQUO",2
31,"31079",99,64,63,0,1,"EQUO",0
9,"9485",62,56,56,0,0,"EQUO",1
28,"28057",1419,1084,1074,12,10,"EQUO",14
31,"31019",1858,1288,1266,25,22,"EQUO",8
5,"5180",109,92,91,1,1,"EQUO",0
16,"16141",161,132,131,1,1,"EQUO",0
37,"37228",388,339,336,2,3,"EQUO",1
9,"9901",407,319,308,8,11,"EQUO",0
45,"45041",3617,2672,2635,21,37,"EQUO",24
47,"47047",217,171,170,5,1,"EQUO",0
40,"40108",120,83,82,1,1,"EQUO",0
48,"48072",1009,796,787,3,9,"EQUO",0
19,"19019",23,18,18,0,0,"EQUO",0
42,"42078",1110,829,817,15,12,"EQUO",3
37,"37341",52,32,32,0,0,"EQUO",2
36,"36056",5087,3883,3830,37,53,"EQUO",20
16,"16905",1017,811,806,14,5,"EQUO",11
22,"22200",271,198,191,3,7,"EQUO",8
33,"33073",9341,5825,5773,69,52,"EQUO",7
14,"14008",2905,2226,2200,18,26,"EQUO",4
31,"31081",335,249,243,8,6,"EQUO",1
48,"48073",7090,4865,4802,37,63,"EQUO",10
9,"9079",49,44,44,1,0,"EQUO",0
16,"16143",20,14,13,1,1,"EQUO",0
28,"28059",4061,3169,3130,38,39,"EQUO",33
6,"6010",1144,903,898,6,5,"EQUO",0
37,"37116",75,55,55,1,0,"EQUO",0
6,"6147",390,321,319,3,2,"EQUO",1
42,"42080",168,115,114,0,1,"EQUO",0
15,"15023",6629,4879,4795,52,84,"EQUO",15
48,"48074",3384,2441,2397,20,44,"EQUO",18
41,"41006",2743,1972,1957,13,15,"EQUO",1
26,"26105",2181,1712,1690,24,22,"EQUO",10
37,"37343",56,42,40,0,2,"EQUO",0
5,"5085",35,34,34,0,0,"EQUO",0
23,"23069",5489,4656,4586,36,70,"EQUO",23
47,"47131",189,145,145,4,0,"EQUO",0
11,"11012",103946,68124,67375,856,749,"EQUO",684
31,"31901",15574,11165,10974,201,191,"EQUO",163
6,"6148",991,826,818,9,8,"EQUO",2
48,"48911",373,300,296,1,4,"EQUO",3
4,"4087",198,162,159,2,3,"EQUO",1
10,"10077",719,551,543,3,8,"EQUO",2
37,"37118",141,115,114,3,1,"EQUO",0
16,"16146",96,74,70,0,4,"EQUO",0
41,"41085",3918,3173,3128,42,45,"EQUO",42
47,"47213",122,99,99,1,0,"EQUO",0
19,"19022",673,501,496,4,5,"EQUO",1
10,"10118",306,262,261,2,1,"EQUO",1
28,"28108",3002,2254,2228,31,26,"EQUO",52
24,"24088",1103,903,885,4,18,"EQUO",2
6,"6013",283,245,244,1,1,"EQUO",0
11,"11013",2284,1691,1670,15,21,"EQUO",4
37,"37233",59,46,45,1,1,"EQUO",0
22,"22051",108,86,84,2,2,"EQUO",0
37,"37119",115,98,98,0,0,"EQUO",1
30,"30039",18615,14213,14068,134,145,"EQUO",52
33,"33007",1680,1186,1179,10,7,"EQUO",2
37,"37346",264,211,210,1,1,"EQUO",1
16,"16147",78,63,62,1,1,"EQUO",0
20,"20008",757,499,499,8,0,"EQUO",2
48,"48010",427,303,300,2,3,"EQUO",2
35,"35029",3981,2341,2315,43,26,"EQUO",25
50,"50227",105,79,79,2,0,"EQUO",0
14,"14012",6305,4749,4690,44,59,"EQUO",20
19,"19240",64,47,46,1,1,"EQUO",0
31,"31903",6058,3985,3919,67,66,"EQUO",43
36,"36060",30264,21398,21051,344,347,"EQUO",176
45,"45048",388,310,308,2,2,"EQUO",0
24,"24010",8550,6242,6111,100,131,"EQUO",46
28,"28110",1912,1492,1475,8,17,"EQUO",10
42,"42085",219,167,167,2,0,"EQUO",0
37,"37347",481,374,371,6,3,"EQUO",6
31,"31904",1590,1054,1031,19,23,"EQUO",7
4,"4090",435,338,335,3,3,"EQUO",0
16,"16023",468,332,327,3,5,"EQUO",11
18,"18036",3553,2762,2741,20,21,"EQUO",40
26,"26110",178,149,147,3,2,"EQUO",1
45,"45158",2577,1948,1909,18,39,"EQUO",5
16,"16149",179,140,138,2,2,"EQUO",4
19,"19139",32,23,23,0,0,"EQUO",0
37,"37160",644,474,464,4,10,"EQUO",1
50,"50902",97,85,85,1,0,"EQUO",0
9,"9133",39,33,33,1,0,"EQUO",0
19,"19241",45,37,37,2,0,"EQUO",0
30,"30041",12957,9360,9288,89,72,"EQUO",30
20,"20047",494,321,319,2,2,"EQUO",2
50,"50257",195,154,154,0,0,"EQUO",0
18,"18138",2460,1751,1741,1,10,"EQUO",5
50,"50903",2234,1622,1597,35,25,"EQUO",14
31,"31905",2707,1913,1881,32,32,"EQUO",22
28,"28111",618,486,479,2,7,"EQUO",3
19,"19309",37,32,31,0,1,"EQUO",0
18,"18037",488,408,404,0,4,"EQUO",3
14,"14014",2610,2160,2125,19,35,"EQUO",8
50,"50054",63,46,46,0,0,"EQUO",0
6,"6155",1911,1384,1363,18,21,"EQUO",3
16,"16151",66,56,56,0,0,"EQUO",0
39,"39091",2026,1636,1628,14,8,"EQUO",3
45,"45051",1658,1305,1293,20,12,"EQUO",2
24,"24093",388,262,258,1,4,"EQUO",0
13,"13019",5254,4038,3978,62,60,"EQUO",15
11,"11017",3219,2403,2388,18,15,"EQUO",2
28,"28178",1017,799,791,11,8,"EQUO",11
14,"14015",2198,1776,1755,16,21,"EQUO",5
5,"5188",55,47,47,0,0,"EQUO",0
37,"37124",227,181,179,3,2,"EQUO",0
50,"50143",608,427,424,5,3,"EQUO",1
5,"5092",172,142,139,0,3,"EQUO",0
47,"47217",1812,1395,1377,20,18,"EQUO",9
9,"9362",219,185,184,2,1,"EQUO",0
19,"19032",202,11,11,0,0,"EQUO",0
33,"33010",1922,1284,1277,14,7,"EQUO",4
39,"39092",1030,753,747,1,6,"EQUO",3
26,"26030",12,12,12,0,0,"EQUO",0
19,"19145",64,49,48,2,1,"EQUO",0
37,"37003",134,103,102,0,1,"EQUO",0
19,"19033",79,55,55,0,0,"EQUO",0
11,"11018",1528,1194,1178,9,16,"EQUO",1
50,"50287",298,214,211,10,3,"EQUO",1
26,"26031",120,100,100,0,0,"EQUO",0
26,"26115",20,20,20,4,0,"EQUO",0
45,"45054",4285,3321,3274,32,47,"EQUO",6
41,"41038",96442,66696,65945,1021,751,"EQUO",723
19,"19146",51,40,38,0,2,"EQUO",1
50,"50057",1468,1022,1004,17,18,"EQUO",4
37,"37240",781,552,540,10,12,"EQUO",3
33,"33011",12085,7186,7116,89,70,"EQUO",17
2,"2014",390,333,326,5,7,"EQUO",0
22,"22213",3152,2265,2230,62,35,"EQUO",12
37,"37353",142,119,119,2,0,"EQUO",0
45,"45164",191,160,158,0,2,"EQUO",4
33,"33034",11390,7583,7501,85,82,"EQUO",25
31,"31060",12916,8830,8687,158,143,"EQUO",103
9,"9270",180,147,143,2,4,"EQUO",2
15,"15031",22951,16018,15696,382,322,"EQUO",173
5,"5191",124,98,98,2,0,"EQUO",0
35,"35009",19678,13799,13442,155,357,"EQUO",131
9,"9365",38,27,27,0,0,"EQUO",0
31,"31091",365,227,224,3,3,"EQUO",1
16,"16155",549,430,426,2,4,"EQUO",0
6,"6070",7805,6083,6001,76,82,"EQUO",15
45,"45165",62818,47242,46629,549,613,"EQUO",357
28,"28066",7033,5439,5383,45,56,"EQUO",52
20,"20016",1526,937,932,4,5,"EQUO",11
23,"23082",1985,1464,1451,9,13,"EQUO",11
26,"26119",223,186,185,2,1,"EQUO",2
4,"4097",299,229,227,0,2,"EQUO",1
9,"9366",99,67,65,1,2,"EQUO",0
47,"47057",237,198,198,3,0,"EQUO",0
50,"50058",80,65,64,0,1,"EQUO",0
22,"22215",137,90,90,1,0,"EQUO",0
22,"22062",189,126,125,2,1,"EQUO",3
37,"37355",187,142,140,2,2,"EQUO",5
11,"11021",6838,5102,5049,67,53,"EQUO",31
42,"42152",96,71,69,1,2,"EQUO",0
16,"16157",229,187,182,2,5,"EQUO",0
40,"40127",45,33,33,0,0,"EQUO",0
31,"31001",88,58,58,1,0,"EQUO",4
45,"45057",222,197,189,0,8,"EQUO",0
37,"37007",467,368,363,6,5,"EQUO",0
15,"15033",2581,2094,2079,15,15,"EQUO",3
28,"28182",219,179,178,2,1,"EQUO",7
50,"50235",2371,1723,1701,36,22,"EQUO",12
6,"6902",1688,1325,1313,21,12,"EQUO",3
28,"28115",57612,46786,46458,458,328,"EQUO",759
9,"9019",153,104,104,1,0,"EQUO",0
45,"45095",742,606,585,2,21,"EQUO",0
11,"11022",48624,26656,26430,345,226,"EQUO",114
9,"9231",77,42,42,0,0,"EQUO",0
35,"35011",23140,15550,15320,199,230,"EQUO",124
45,"45168",61519,47265,46528,736,737,"EQUO",555
41,"41016",6950,5194,5120,45,74,"EQUO",45
36,"36004",10264,7383,7263,80,120,"EQUO",21
19,"19075",81,53,50,4,3,"EQUO",1
40,"40081",151,109,107,2,2,"EQUO",4
37,"37357",283,216,214,0,2,"EQUO",0
22,"22908",231,167,162,2,5,"EQUO",0
50,"50236",124,103,103,2,0,"EQUO",0
40,"40035",146,114,112,3,2,"EQUO",6
31,"31216",3911,2699,2653,82,46,"EQUO",15
37,"37047",178,111,111,0,0,"EQUO",0
31,"31004",36,21,20,0,1,"EQUO",0
41,"41017",13878,10053,9926,130,127,"EQUO",127
28,"28068",10502,7857,7778,68,79,"EQUO",141
5,"5195",241,168,164,0,4,"EQUO",0
28,"28117",116,90,90,1,0,"EQUO",6
37,"37246",5430,4363,4315,63,48,"EQUO",17
28,"28004",5761,4098,4044,38,54,"EQUO",35
47,"47060",262,220,218,1,2,"EQUO",2
50,"50005",245,199,195,1,4,"EQUO",0
22,"22022",582,448,438,12,10,"EQUO",1
33,"33038",2442,1757,1725,14,32,"EQUO",3
39,"39098",1522,1256,1244,8,12,"EQUO",3
20,"20021",216,122,122,0,0,"EQUO",1
24,"24103",330,180,177,0,3,"EQUO",1
37,"37134",250,192,189,1,3,"EQUO",2
16,"16161",84,73,72,4,1,"EQUO",0
28,"28069",51,35,33,1,2,"EQUO",0
19,"19041",166,127,127,3,0,"EQUO",0
18,"18148",874,714,706,6,8,"EQUO",1
16,"16162",51,36,36,0,0,"EQUO",0
47,"47009",117,88,88,1,0,"EQUO",0
31,"31187",122,68,68,2,0,"EQUO",0
31,"31097",10461,7152,7029,129,123,"EQUO",71
9,"9375",42,30,30,1,0,"EQUO",0
5,"5197",114,98,98,1,0,"EQUO",1
48,"48090",6153,4682,4571,40,111,"EQUO",23
37,"37248",160,130,130,1,0,"EQUO",0
31,"31006",1988,1434,1395,22,39,"EQUO",5
29,"29071",915,601,598,4,3,"EQUO",1
22,"22223",92,65,64,3,1,"EQUO",0
24,"24105",1460,1095,1075,27,20,"EQUO",4
16,"16163",75,57,57,0,0,"EQUO",0
10,"10137",428,373,371,1,2,"EQUO",1
23,"23092",27970,20921,20651,284,270,"EQUO",185
14,"14025",3061,2547,2517,13,30,"EQUO",6
18,"18149",5096,3949,3900,36,49,"EQUO",39
31,"31007",137,96,90,2,6,"EQUO",1
39,"39021",536,448,444,1,4,"EQUO",1
47,"47226",180,152,148,1,4,"EQUO",0
42,"42107",86,60,59,2,1,"EQUO",1
45,"45064",3801,2987,2953,38,34,"EQUO",20
50,"50240",1127,799,783,25,16,"EQUO",0
40,"40041",1035,819,799,14,20,"EQUO",6
10,"10138",551,451,443,7,8,"EQUO",2
47,"47172",149,125,124,3,1,"EQUO",2
24,"24106",340,229,228,6,1,"EQUO",1
20,"20061",4011,2666,2653,23,13,"EQUO",13
42,"42161",158,119,119,0,0,"EQUO",0
37,"37015",248,169,168,0,1,"EQUO",0
39,"39100",922,718,712,8,6,"EQUO",3
42,"42108",13,10,10,1,0,"EQUO",0
14,"14026",2043,1434,1421,10,13,"EQUO",2
9,"9025",150,112,110,0,2,"EQUO",0
42,"42162",2482,1871,1850,23,21,"EQUO",14
37,"37055",132,112,107,2,5,"EQUO",3
11,"11027",67042,43386,43065,557,321,"EQUO",404
50,"50241",634,462,455,2,7,"EQUO",0
6,"6037",1789,1258,1252,6,6,"EQUO",9
26,"26004",82,64,64,1,0,"EQUO",0
19,"19255",95,68,68,0,0,"EQUO",1
18,"18151",276,191,188,0,3,"EQUO",2
9,"9109",1181,664,631,16,33,"EQUO",31
23,"23006",4644,3913,3871,36,42,"EQUO",7
45,"45102",3539,2581,2533,23,48,"EQUO",5
37,"37252",127,92,92,0,0,"EQUO",0
31,"31009",717,510,497,14,13,"EQUO",4
4,"4003",17244,11933,11840,94,93,"EQUO",59
22,"22228",501,382,369,15,13,"EQUO",5
19,"19045",180,145,145,1,0,"EQUO",0
22,"22076",331,241,235,3,6,"EQUO",4
31,"31101",1305,892,874,15,18,"EQUO",11
37,"37017",249,200,199,0,1,"EQUO",1
24,"24902",375,292,289,1,3,"EQUO",0
16,"16169",75,44,44,0,0,"EQUO",0
24,"24109",1098,672,663,12,9,"EQUO",3
22,"22077",421,327,323,14,4,"EQUO",0
28,"28121",185,153,152,0,1,"EQUO",1
50,"50156",234,186,183,2,3,"EQUO",1
42,"42113",553,412,404,7,8,"EQUO",2
26,"26132",130,98,96,2,2,"EQUO",0
37,"37140",731,490,475,0,15,"EQUO",4
16,"16170",733,552,543,3,9,"EQUO",3
24,"24110",1291,914,904,16,10,"EQUO",5
16,"16087",229,193,187,4,6,"EQUO",1
37,"37254",189,168,164,1,4,"EQUO",0
42,"42115",72,48,48,0,0,"EQUO",0
22,"22230",302,234,231,11,3,"EQUO",2
50,"50068",2082,1514,1481,18,33,"EQUO",3
26,"26007",551,434,422,3,12,"EQUO",3
45,"45069",1791,1409,1389,8,20,"EQUO",5
40,"40047",47,37,36,0,1,"EQUO",0
48,"48096",6607,5007,4900,54,107,"EQUO",32
30,"30029",11533,8854,8768,73,86,"EQUO",16
31,"31103",51,40,40,3,0,"EQUO",0
37,"37368",18,15,15,1,0,"EQUO",0
19,"19161",243,171,166,2,5,"EQUO",4
5,"5205",78,59,58,0,1,"EQUO",0
37,"37142",613,436,434,7,2,"EQUO",4
16,"16045",226,177,176,2,1,"EQUO",0
45,"45180",2714,2018,1980,19,38,"EQUO",10
37,"37020",449,371,365,7,6,"EQUO",5
42,"42117",146,115,111,1,4,"EQUO",3
48,"48097",1359,936,915,9,21,"EQUO",2
45,"45070",1415,1175,1162,11,13,"EQUO",2
29,"29077",225,157,157,1,0,"EQUO",0
20,"20031",179,114,113,1,1,"EQUO",0
31,"31013",668,382,375,12,7,"EQUO",5
47,"47041",166,135,133,2,2,"EQUO",1
9,"9386",61,45,45,0,0,"EQUO",0
28,"28075",5127,3976,3916,42,60,"EQUO",62
48,"48901",4370,3156,3124,46,32,"EQUO",22
40,"40191",265,191,190,1,1,"EQUO",1
40,"40004",534,428,420,3,8,"EQUO",3
28,"28123",48429,38681,38187,429,494,"EQUO",1033
40,"40145",1152,933,920,3,13,"EQUO",1
35,"35020",6142,4227,4192,24,35,"EQUO",10
19,"19260",44,41,41,1,0,"EQUO",0
20,"20032",8949,6189,6117,55,72,"EQUO",42
48,"48902",19232,12809,12633,182,176,"EQUO",135
50,"50099",3136,2333,2297,27,36,"EQUO",2
47,"47068",41,28,28,0,0,"EQUO",0
29,"29005",4307,2967,2951,18,16,"EQUO",1
40,"40146",270,222,222,0,0,"EQUO",1
45,"45072",690,535,532,7,3,"EQUO",2
26,"26139",68,55,55,4,0,"EQUO",0
6,"6137",1035,848,842,2,6,"EQUO",0
41,"41093",17665,13712,13526,179,186,"EQUO",274
18,"18158",10328,7336,7254,69,82,"EQUO",11
24,"24077",237,205,199,2,6,"EQUO",0
39,"39002",3400,2554,2514,35,40,"EQUO",12
48,"48033",223,171,171,1,0,"EQUO",1
45,"45183",2189,1537,1514,10,23,"EQUO",12
37,"37023",1040,819,811,11,8,"EQUO",11
48,"48903",1909,1455,1430,4,25,"EQUO",15
4,"4009",165,124,122,2,2,"EQUO",1
50,"50247",794,572,567,7,5,"EQUO",3
47,"47153",135,94,93,1,1,"EQUO",4
45,"45074",428,349,343,3,6,"EQUO",1
28,"28148",79726,60405,59651,724,754,"EQUO",758
37,"37184",381,295,289,5,6,"EQUO",0
45,"45184",219,150,148,3,2,"EQUO",2
50,"50132",697,544,536,11,8,"EQUO",4
26,"26013",350,267,264,5,3,"EQUO",3
11,"11034",2381,1807,1784,19,23,"EQUO",0
48,"48904",3510,2682,2665,26,17,"EQUO",25
19,"19052",37,32,31,1,1,"EQUO",0
31,"31229",46,38,37,0,1,"EQUO",0
40,"40195",946,722,707,13,15,"EQUO",3
4,"4010",602,492,491,10,1,"EQUO",3
6,"6048",879,758,740,4,18,"EQUO",0
29,"29082",29311,20220,20051,223,169,"EQUO",235
28,"28078",39,23,23,1,0,"EQUO",0
13,"13040",933,755,744,4,11,"EQUO",1
31,"31199",161,103,103,1,0,"EQUO",0
11,"11035",13266,8794,8668,115,126,"EQUO",64
47,"47154",168,144,144,7,0,"EQUO",0
31,"31017",358,220,219,12,1,"EQUO",2
9,"9167",60,49,49,2,0,"EQUO",0
14,"14035",6153,4715,4656,51,59,"EQUO",13
24,"24001",241,148,147,3,1,"EQUO",0
10,"10029",447,362,355,1,7,"EQUO",0
37,"37026",201,176,176,3,0,"EQUO",0
50,"50017",1734,1232,1212,41,20,"EQUO",12
42,"42073",84,53,53,0,0,"EQUO",0
37,"37338",82,69,67,0,2,"EQUO",0
13,"13042",953,704,693,5,11,"EQUO",0
19,"19265",157,102,101,0,1,"EQUO",1
10,"10192",910,679,670,3,9,"EQUO",0
40,"40012",280,215,213,2,2,"EQUO",0
24,"24081",143,111,110,1,1,"EQUO",0
14,"14036",3774,2928,2909,51,19,"EQUO",7
42,"42127",47,35,35,0,0,"EQUO",0
26,"26017",380,277,276,3,1,"EQUO",2
9,"9255",90,68,68,0,0,"EQUO",0
45,"45077",554,430,423,7,7,"EQUO",2
40,"40154",23,21,21,1,0,"EQUO",0
41,"41029",13231,9756,9610,128,146,"EQUO",111
39,"39031",1227,965,956,4,9,"EQUO",6
22,"22087",85,56,55,4,1,"EQUO",0
18,"18062",9418,6916,6835,62,81,"EQUO",41
10,"10071",179,133,133,1,0,"EQUO",0
50,"50250",58,43,43,4,0,"EQUO",2
45,"45078",1451,1243,1228,7,15,"EQUO",0
6,"6053",642,466,454,4,12,"EQUO",2
15,"15049",1211,851,843,7,8,"EQUO",2
4,"4014",162,136,136,0,0,"EQUO",1
16,"16187",78,61,60,3,1,"EQUO",3
19,"19266",278,234,231,4,3,"EQUO",2
5,"5212",274,202,197,0,5,"EQUO",0
16,"16239",158,114,112,2,2,"EQUO",1
5,"5117",213,183,180,0,3,"EQUO",2
37,"37029",226,181,178,4,3,"EQUO",0
37,"37377",268,209,208,1,1,"EQUO",0
10,"10155",1156,829,819,4,10,"EQUO",1
37,"37265",224,192,191,1,1,"EQUO",1
42,"42129",706,523,509,14,14,"EQUO",1
6,"6054",5468,4305,4185,35,120,"EQUO",14
20,"20040",15103,9781,9686,148,95,"EQUO",109
16,"16057",109,82,82,1,0,"EQUO",0
40,"40015",33,30,30,1,0,"EQUO",0
15,"15051",4780,3333,3289,61,44,"EQUO",16
48,"48909",194,163,163,0,0,"EQUO",0
45,"45190",502,425,414,6,11,"EQUO",1
48,"48007",354,254,253,1,1,"EQUO",2
11,"11039",9943,6634,6582,104,52,"EQUO",48
20,"20041",279,153,151,5,2,"EQUO",5
22,"22247",31,21,20,1,1,"EQUO",0
13,"13045",744,615,608,6,7,"EQUO",0
37,"37266",83,54,54,1,0,"EQUO",0
24,"24124",419,286,282,0,4,"EQUO",0
5,"5017",87,69,68,1,1,"EQUO",1
5,"5215",186,138,136,1,2,"EQUO",2
22,"22090",115,82,82,5,0,"EQUO",0
35,"35027",10510,7523,7375,88,148,"EQUO",87
10,"10035",1941,1517,1492,15,25,"EQUO",7
50,"50168",34,26,26,1,0,"EQUO",0
22,"22094",109,76,74,5,2,"EQUO",0
10,"10157",289,218,212,1,6,"EQUO",2
42,"42132",159,132,127,4,5,"EQUO",0
28,"28083",8037,6078,6025,66,53,"EQUO",49
16,"16018",417,350,342,3,8,"EQUO",1
14,"14010",4087,3144,3121,15,23,"EQUO",5
40,"40159",150,111,110,0,1,"EQUO",1
31,"31204",45,35,34,0,1,"EQUO",0
33,"33029",420,243,241,3,2,"EQUO",0
4,"4017",1337,965,960,7,5,"EQUO",2
22,"22095",87,61,61,1,0,"EQUO",1
5,"5216",237,195,192,0,3,"EQUO",0
10,"10159",341,278,277,1,1,"EQUO",0
20,"20043",1782,1220,1214,13,6,"EQUO",4
31,"31023",5338,3986,3920,120,66,"EQUO",61
41,"41033",5237,3915,3878,20,37,"EQUO",10
42,"42134",2626,1945,1896,36,49,"EQUO",35
45,"45083",421,353,345,0,8,"EQUO",2
40,"40160",120,94,92,2,2,"EQUO",0
50,"50079",281,213,210,2,3,"EQUO",0
5,"5120",38,28,28,1,0,"EQUO",0
19,"19103",303,247,244,3,3,"EQUO",0
6,"6060",5865,4657,4592,67,65,"EQUO",6
19,"19208",55,41,41,1,0,"EQUO",1
23,"23030",1270,1052,1045,3,7,"EQUO",0
29,"29014",250,152,150,0,2,"EQUO",2
9,"9007",66,50,50,0,0,"EQUO",0
20,"20045",46542,30907,30536,425,371,"EQUO",494
37,"37035",220,176,173,1,3,"EQUO",1
50,"50170",411,316,313,2,3,"EQUO",0
22,"22251",391,288,278,4,10,"EQUO",0
35,"35030",8295,5433,5315,54,118,"EQUO",34
30,"30040",733,640,635,2,5,"EQUO",1
45,"45085",1511,1111,1100,10,11,"EQUO",3
9,"9009",167,129,128,8,1,"EQUO",2
4,"4020",361,265,263,1,2,"EQUO",1
26,"26026",1344,1108,1096,14,12,"EQUO",3
28,"28131",12664,9454,9342,100,112,"EQUO",292
45,"45196",1363,1092,1076,3,16,"EQUO",1
41,"41035",1171,898,889,12,9,"EQUO",6
37,"37036",74,54,52,0,2,"EQUO",3
33,"33031",38090,25034,24730,380,304,"EQUO",96
9,"9266",87,72,72,0,0,"EQUO",0
41,"41087",9827,7300,7150,51,150,"EQUO",77
10,"10081",183,143,142,0,1,"EQUO",0
22,"22253",71,54,54,1,0,"EQUO",0
22,"22102",194,152,149,4,3,"EQUO",2
40,"40210",110,71,67,1,4,"EQUO",0
42,"42190",102,71,71,3,0,"EQUO",0
33,"33054",1780,1272,1263,8,9,"EQUO",5
4,"4021",188,157,157,2,0,"EQUO",1
45,"45087",8428,6434,6292,74,142,"EQUO",17
18,"18006",4116,2862,2831,25,31,"EQUO",6
28,"28063",268,209,203,4,6,"EQUO",9
16,"16024",134,92,91,1,1,"EQUO",0
28,"28133",5868,4236,4144,23,92,"EQUO",41
13,"13051",358,291,289,5,2,"EQUO",0
47,"47001",51,44,42,2,2,"EQUO",0
14,"14045",3093,2662,2642,14,20,"EQUO",2
22,"22254",1175,868,856,14,12,"EQUO",1
31,"31118",182,114,114,6,0,"EQUO",1
16,"16065",454,380,374,4,6,"EQUO",0
5,"5220",386,316,312,0,4,"EQUO",2
40,"40166",275,247,246,2,1,"EQUO",0
6,"6065",327,262,259,2,3,"EQUO",0
22,"22105",132,104,102,2,2,"EQUO",0
42,"42144",464,343,331,3,12,"EQUO",2
29,"29092",596,457,454,10,3,"EQUO",1
47,"47081",57,44,44,1,0,"EQUO",0
20,"20049",4081,2741,2723,30,18,"EQUO",18
33,"33033",10609,7179,7107,91,72,"EQUO",34
22,"22901",792,515,508,13,7,"EQUO",8
10,"10166",351,246,238,2,8,"EQUO",0
40,"40026",114,98,97,2,1,"EQUO",2
37,"37163",44,36,36,0,0,"EQUO",1
19,"19311",87,60,60,0,0,"EQUO",1
6,"6158",13094,9945,9753,131,192,"EQUO",85
31,"31210",219,169,167,3,2,"EQUO",0
20,"20050",293,213,211,3,2,"EQUO",0
16,"16198",1451,1126,1105,21,21,"EQUO",4
16,"16197",73,50,50,1,0,"EQUO",0
13,"13086",209,167,166,0,1,"EQUO",0
29,"29019",908,720,714,0,6,"EQUO",1
10,"10044",1520,1120,1103,10,17,"EQUO",5
2,"2086",2856,2019,2005,9,14,"EQUO",8
5,"5126",78,70,70,0,0,"EQUO",0
2,"2050",121,95,95,1,0,"EQUO",3
29,"29047",1165,973,969,0,4,"EQUO",1
5,"5222",155,132,132,1,0,"EQUO",0
22,"22109",243,178,178,2,0,"EQUO",1
35,"35034",6372,2951,2921,33,30,"EQUO",46
47,"47083",80,61,59,3,2,"EQUO",0
9,"9137",177,134,134,6,0,"EQUO",1
1,"1039",211,164,158,1,6,"EQUO",1
42,"42092",89,60,60,0,0,"EQUO",0
19,"19314",46,41,41,0,0,"EQUO",0
42,"42149",404,292,286,12,6,"EQUO",2
48,"48017",13554,9303,9234,64,69,"EQUO",33
13,"13055",738,585,578,8,7,"EQUO",0
37,"37042",45,35,35,1,0,"EQUO",0
5,"5127",715,601,596,4,5,"EQUO",5
10,"10046",216,185,184,1,1,"EQUO",0
20,"20015",1307,980,979,13,1,"EQUO",2
40,"40031",515,410,404,7,6,"EQUO",4
45,"45092",252,223,221,0,2,"EQUO",0
29,"29095",3431,2660,2607,23,53,"EQUO",1
18,"18074",297,245,245,5,0,"EQUO",0
18,"18176",265,183,181,0,2,"EQUO",0
22,"22905",312,249,247,4,2,"EQUO",4
24,"24139",2320,1687,1654,16,33,"EQUO",6
26,"26034",678,526,510,3,16,"EQUO",0
14,"14049",16358,12577,12478,137,99,"EQUO",56
9,"9413",500,335,331,1,4,"EQUO",2
5,"5128",361,288,280,3,8,"EQUO",1
9,"9273",55,47,47,0,0,"EQUO",0
50,"50177",355,268,265,4,3,"EQUO",0
40,"40219",635,519,505,7,14,"EQUO",3
37,"37167",164,140,132,6,8,"EQUO",0
15,"15061",6105,4391,4307,64,84,"EQUO",9
9,"9274",1160,924,914,14,10,"EQUO",5
19,"19282",210,157,157,0,0,"EQUO",0
48,"48019",3741,2613,2595,24,18,"EQUO",19
40,"40032",394,293,288,6,5,"EQUO",0
31,"31214",95,64,64,1,0,"EQUO",0
5,"5226",92,67,67,0,0,"EQUO",0
42,"42153",19,16,16,0,0,"EQUO",0
6,"6073",787,563,552,9,11,"EQUO",3
36,"36036",2616,1981,1948,24,33,"EQUO",6
16,"16259",30,26,26,1,0,"EQUO",0
37,"37280",84,64,64,0,0,"EQUO",0
29,"29097",4076,3060,3018,40,42,"EQUO",8
29,"29023",1661,1080,1074,15,6,"EQUO",10
40,"40176",418,344,341,8,3,"EQUO",0
39,"39044",3864,2940,2905,44,35,"EQUO",18
45,"45901",811,595,591,2,4,"EQUO",4
40,"40221",50,41,41,0,0,"EQUO",0
18,"18112",132,90,90,1,0,"EQUO",1
9,"9369",460,339,336,4,3,"EQUO",4
5,"5130",95,76,76,0,0,"EQUO",0
50,"50150",716,430,427,10,3,"EQUO",1
48,"48032",5864,4257,4223,32,34,"EQUO",29
45,"45169",239,183,183,1,0,"EQUO",1
36,"36038",65661,47940,47214,836,726,"EQUO",384
31,"31155",264,187,183,7,4,"EQUO",2
47,"47087",376,320,315,7,5,"EQUO",1
16,"16206",250,188,188,2,0,"EQUO",0
9,"9415",290,192,192,4,0,"EQUO",2
5,"5228",193,146,145,1,1,"EQUO",0
37,"37321",169,144,144,1,0,"EQUO",0
28,"28026",5852,4506,4449,40,57,"EQUO",75
48,"48022",2396,1524,1504,12,20,"EQUO",9
20,"20057",194,122,122,0,0,"EQUO",0
18,"18079",3497,2729,2706,15,23,"EQUO",7
1,"1047",942,674,655,4,19,"EQUO",10
15,"15064",2356,1859,1824,35,35,"EQUO",10
9,"9143",24,14,14,1,0,"EQUO",0
26,"26168",5055,3534,3484,47,50,"EQUO",36
29,"29070",35228,23374,23146,258,228,"EQUO",260
16,"16211",462,317,313,2,4,"EQUO",1
40,"40179",634,545,538,4,7,"EQUO",2
19,"19285",26,20,20,2,0,"EQUO",0
47,"47196",43,29,29,0,0,"EQUO",0
29,"29099",958,739,730,5,9,"EQUO",5
26,"26040",67,63,62,2,1,"EQUO",0
33,"33039",1719,1325,1319,14,6,"EQUO",9
9,"9236",41,38,37,0,1,"EQUO",0
14,"14054",13632,10857,10652,194,205,"EQUO",72
26,"26170",471,353,348,4,5,"EQUO",1
48,"48023",601,499,492,4,7,"EQUO",5
9,"9418",79,60,58,0,2,"EQUO",0
50,"50006",978,758,749,16,9,"EQUO",1
24,"24025",331,237,237,5,0,"EQUO",0
16,"16082",318,226,226,1,0,"EQUO",0
19,"19079",7,7,7,0,0,"EQUO",0
42,"42159",40,31,31,1,0,"EQUO",0
47,"47171",453,371,368,10,3,"EQUO",0
50,"50092",329,273,272,0,1,"EQUO",1
29,"29026",1130,815,799,7,16,"EQUO",1
40,"40181",4413,3439,3361,43,78,"EQUO",62
9,"9023",993,771,765,22,6,"EQUO",8
47,"47010",11275,8800,8701,163,99,"EQUO",70
31,"31220",771,584,572,9,12,"EQUO",1
22,"22119",1433,994,981,14,13,"EQUO",4
19,"19117",1526,1155,1132,26,23,"EQUO",11
31,"31037",94,68,68,0,0,"EQUO",0
24,"24149",149,120,118,3,2,"EQUO",1
13,"13063",3839,2801,2771,31,30,"EQUO",17
5,"5168",3682,2846,2801,43,45,"EQUO",14
18,"18182",1982,1405,1397,6,8,"EQUO",3
9,"9063",223,191,189,1,2,"EQUO",1
23,"23005",30698,23126,22916,310,210,"EQUO",85
26,"26002",805,617,605,6,12,"EQUO",2
50,"50124",474,375,367,11,8,"EQUO",2
31,"31159",1158,864,846,17,18,"EQUO",6
40,"40230",117,92,90,1,2,"EQUO",0
31,"31252",91,60,58,0,2,"EQUO",0
28,"28028",1615,1204,1173,11,31,"EQUO",51
23,"23050",91354,68649,67925,990,724,"EQUO",825
16,"16271",659,568,566,4,2,"EQUO",1
19,"19189",136,99,97,0,2,"EQUO",5
24,"24028",426,350,331,3,19,"EQUO",2
31,"31222",67,46,44,3,2,"EQUO",0
28,"28095",1358,1092,1077,8,15,"EQUO",16
47,"47091",97,82,80,3,2,"EQUO",0
37,"37288",252,194,194,3,0,"EQUO",6
40,"40043",1842,1494,1469,28,25,"EQUO",5
50,"50184",132,106,106,1,0,"EQUO",0
16,"16272",273,215,215,2,0,"EQUO",0
48,"48093",893,707,695,1,12,"EQUO",2
10,"10181",739,607,598,6,9,"EQUO",1
19,"19082",91,68,67,1,1,"EQUO",2
22,"22125",38140,26924,26463,676,461,"EQUO",543
10,"10059",414,352,349,4,3,"EQUO",0
30,"30001",4763,3992,3956,26,36,"EQUO",5
40,"40045",123,102,102,0,0,"EQUO",2
9,"9287",201,159,158,4,1,"EQUO",0
16,"16217",113,95,92,0,3,"EQUO",0
45,"45103",457,400,394,0,6,"EQUO",0
16,"16218",207,170,169,4,1,"EQUO",3
42,"42017",154,134,130,2,4,"EQUO",1
50,"50126",2473,1747,1724,41,23,"EQUO",3
29,"29029",452,339,336,0,3,"EQUO",1
30,"30002",9802,7628,7553,48,75,"EQUO",18
5,"5234",58,49,49,0,0,"EQUO",0
23,"23008",1552,1280,1266,9,14,"EQUO",1
26,"26047",2076,1702,1682,17,20,"EQUO",6
13,"13067",380,314,312,3,2,"EQUO",0
9,"9029",186,138,137,4,1,"EQUO",7
24,"24191",112,88,88,1,0,"EQUO",0
15,"15070",9684,6627,6464,141,163,"EQUO",38
14,"14059",713,572,567,5,5,"EQUO",1
18,"18022",12448,8777,8659,111,118,"EQUO",36
26,"26177",322,276,274,2,2,"EQUO",4
33,"33043",710,529,528,1,1,"EQUO",3
31,"31041",1397,938,913,26,25,"EQUO",12
28,"28145",2125,1643,1620,15,23,"EQUO",27
31,"31255",100,78,78,1,0,"EQUO",0
42,"42020",4385,3055,2957,74,98,"EQUO",14
50,"50157",313,253,250,7,3,"EQUO",3
37,"37292",101,84,84,2,0,"EQUO",0
40,"40189",560,455,438,6,17,"EQUO",0
6,"6087",2258,1855,1832,24,23,"EQUO",8
26,"26178",88,74,73,1,1,"EQUO",0
21,"21073",1840,1249,1236,13,13,"EQUO",5
9,"9030",135,97,97,2,0,"EQUO",2
9,"9427",1561,1090,1078,18,12,"EQUO",4
50,"50187",72,45,45,1,0,"EQUO",2
23,"23011",2227,1644,1620,25,24,"EQUO",2
20,"20067",31173,20218,20017,270,201,"EQUO",197
19,"19194",113,80,76,1,4,"EQUO",2
16,"16225",89,69,68,1,1,"EQUO",0
40,"40049",52,39,39,1,0,"EQUO",0
13,"13069",704,605,590,2,15,"EQUO",4
19,"19048",18,12,11,1,1,"EQUO",0
30,"30030",305669,236235,234391,2112,1844,"EQUO",2127
26,"26136",111,90,90,3,0,"EQUO",2
22,"22080",288,217,217,4,0,"EQUO",3
13,"13003",503,390,387,2,3,"EQUO",1
6,"6135",1094,898,890,14,8,"EQUO",2
18,"18188",1659,1329,1308,9,21,"EQUO",5
10,"10186",1031,906,896,8,10,"EQUO",2
19,"19306",42,31,31,1,0,"EQUO",0
10,"10064",1549,1229,1209,6,20,"EQUO",0
5,"5238",815,649,641,6,8,"EQUO",2
47,"47095",41,36,36,3,0,"EQUO",0
33,"33068",1224,704,703,5,1,"EQUO",4
9,"9429",64,44,44,2,0,"EQUO",0
26,"26051",271,219,214,4,5,"EQUO",1
10,"10065",188,123,123,1,0,"EQUO",1
30,"30005",29081,22312,22142,184,170,"EQUO",80
9,"9343",94,77,76,0,1,"EQUO",0
9,"9163",642,526,518,3,8,"EQUO",2
26,"26181",14,12,12,0,0,"EQUO",0
31,"31258",7679,5561,5475,92,86,"EQUO",73
20,"20033",884,650,641,4,9,"EQUO",4
36,"36017",18554,13573,13378,200,195,"EQUO",69
29,"29062",647,573,571,1,2,"EQUO",1
10,"10066",182,136,133,1,3,"EQUO",0
9,"9164",179,130,130,1,0,"EQUO",0
42,"42173",28809,20268,19748,632,520,"EQUO",308
26,"26053",221,177,173,5,4,"EQUO",2
50,"50101",922,648,637,8,11,"EQUO",0
9,"9298",90,74,74,1,0,"EQUO",0
2,"2070",439,372,366,4,6,"EQUO",1
26,"26096",244,204,201,2,3,"EQUO",1
28,"28055",932,713,707,5,6,"EQUO",0
11,"11005",4617,3287,3214,26,73,"EQUO",7
10,"10040",455,344,334,8,10,"EQUO",1
18,"18159",1051,873,869,4,4,"EQUO",0
6,"6047",878,686,680,5,6,"EQUO",2
26,"26054",381,298,292,2,6,"EQUO",2
45,"45147",598,484,478,9,6,"EQUO",2
9,"9346",95,83,83,1,0,"EQUO",1
24,"24079",1045,721,710,15,11,"EQUO",1
36,"36019",1681,1204,1188,14,16,"EQUO",4
22,"22135",200,152,147,5,5,"EQUO",0
14,"14065",1846,1509,1492,14,17,"EQUO",2
50,"50276",148,116,114,3,2,"EQUO",1
24,"24160",741,545,539,17,6,"EQUO",0
16,"16095",98,68,68,0,0,"EQUO",0
26,"26055",38,32,30,0,2,"EQUO",0
47,"47098",607,496,492,9,4,"EQUO",3
45,"45001",1901,1468,1431,14,37,"EQUO",7
19,"19264",45,39,39,0,0,"EQUO",0
23,"23018",2415,1791,1781,9,10,"EQUO",3
16,"16096",279,231,229,7,2,"EQUO",0
41,"41028",1880,1479,1458,28,21,"EQUO",27
40,"40056",41,34,34,0,0,"EQUO",0
42,"42124",71,50,50,0,0,"EQUO",0
26,"26015",205,167,165,1,2,"EQUO",0
13,"13074",1000,886,878,15,8,"EQUO",0
50,"50104",379,306,303,4,3,"EQUO",0
19,"19300",746,595,585,3,10,"EQUO",14
9,"9483",226,173,171,4,2,"EQUO",0
9,"9433",67,46,45,2,1,"EQUO",1
47,"47099",174,153,153,4,0,"EQUO",0
21,"21079",749,556,553,6,3,"EQUO",2
40,"40199",110,88,86,3,2,"EQUO",3
1,"1019",155,124,124,0,0,"EQUO",2
47,"47181",170,128,128,1,0,"EQUO",0
14,"14006",1326,1170,1148,12,22,"EQUO",4
41,"41003",2196,1803,1782,21,21,"EQUO",8
36,"36054",10862,8201,8087,87,114,"EQUO",27
47,"47020",283,237,232,5,5,"EQUO",0
5,"5243",101,69,68,0,1,"EQUO",0
26,"26058",151,114,109,1,5,"EQUO",0
47,"47210",396,324,321,5,3,"EQUO",0
16,"16238",560,484,479,3,5,"EQUO",2
48,"48038",1087,826,821,7,5,"EQUO",4
10,"10194",557,449,440,0,9,"EQUO",0
37,"37114",92,75,74,1,1,"EQUO",0
20,"20075",4447,2823,2798,32,25,"EQUO",14
14,"14068",581,460,457,7,3,"EQUO",4
9,"9437",298,249,247,5,2,"EQUO",2
42,"42181",453,357,347,7,10,"EQUO",1
30,"30036",13978,10244,10141,94,103,"EQUO",60
15,"15078",78092,56506,55597,1110,909,"EQUO",636
23,"23024",12634,9916,9673,116,243,"EQUO",53
24,"24164",397,215,213,2,2,"EQUO",3
20,"20003",547,361,359,3,2,"EQUO",1
20,"20039",2003,1517,1512,9,5,"EQUO",5
31,"31141",132,100,98,1,2,"EQUO",1
37,"37071",90,80,80,1,0,"EQUO",0
42,"42031",31,19,19,0,0,"EQUO",0
1,"1022",826,615,602,6,13,"EQUO",8
19,"19202",16,14,14,0,0,"EQUO",0
50,"50107",953,785,780,13,5,"EQUO",3
31,"31172",375,295,288,11,7,"EQUO",3
13,"13078",9291,7062,6993,92,69,"EQUO",32
23,"23025",2845,2292,2271,17,21,"EQUO",5
14,"14069",7733,5910,5824,68,86,"EQUO",16
48,"48040",1274,936,921,10,15,"EQUO",7
30,"30011",4687,3776,3726,20,50,"EQUO",13
31,"31142",1443,906,899,16,7,"EQUO",1
36,"36024",17164,12723,12500,163,223,"EQUO",56
9,"9439",909,720,697,16,23,"EQUO",10
13,"13079",12220,9665,9502,177,163,"EQUO",27
47,"47023",2863,2278,2258,38,20,"EQUO",28
5,"5246",68,57,56,1,1,"EQUO",0
14,"14070",1385,1131,1111,4,20,"EQUO",2
16,"16243",451,395,388,3,7,"EQUO",3
23,"23027",763,619,616,1,3,"EQUO",0
20,"20078",1146,885,884,6,1,"EQUO",1
50,"50196",110,87,86,4,1,"EQUO",1
10,"10198",1213,1068,1054,12,14,"EQUO",1
9,"9218",384,285,279,8,6,"EQUO",1
9,"9128",82,65,63,0,2,"EQUO",1
47,"47049",94,71,71,1,0,"EQUO",0
33,"33074",3699,2643,2611,30,32,"EQUO",9
9,"9045",283,196,196,4,0,"EQUO",0
19,"19204",168,129,126,2,3,"EQUO",0
29,"29041",2796,1950,1921,24,29,"EQUO",5
28,"28084",15408,11489,11355,122,134,"EQUO",87
50,"50109",101,79,79,2,0,"EQUO",0
45,"45008",158,129,127,0,2,"EQUO",0
6,"6104",701,588,584,12,4,"EQUO",0
19,"19305",166,130,130,0,0,"EQUO",0
15,"15081",1139,869,853,9,16,"EQUO",3
28,"28039",139,103,103,1,0,"EQUO",1
22,"22150",491,342,336,9,6,"EQUO",13
28,"28109",1621,1121,1104,9,17,"EQUO",7
20,"20007",300,203,202,2,1,"EQUO",4
6,"6074",4777,3730,3659,41,71,"EQUO",8
9,"9176",60,47,45,2,2,"EQUO",1
28,"28061",19624,15082,14905,162,177,"EQUO",338
47,"47025",127,103,103,0,0,"EQUO",0
37,"37270",201,159,158,0,1,"EQUO",0
5,"5087",144,87,87,0,0,"EQUO",0
18,"18101",8990,6659,6556,96,103,"EQUO",84
4,"4056",144,118,118,0,0,"EQUO",0
14,"14073",3009,2246,2224,32,22,"EQUO",2
19,"19104",16,12,12,1,0,"EQUO",0
19,"19307",30,27,27,0,0,"EQUO",0
10,"10201",202,173,171,3,2,"EQUO",0
1,"1030",170,123,120,1,3,"EQUO",2
50,"50255",219,150,148,1,2,"EQUO",0
10,"10161",76,59,59,1,0,"EQUO",0
24,"24170",2006,1410,1394,14,16,"EQUO",5
23,"23031",771,649,646,6,3,"EQUO",4
45,"45121",6553,4720,4653,43,67,"EQUO",15
18,"18906",955,736,731,5,5,"EQUO",3
31,"31055",264,194,193,0,1,"EQUO",0
13,"13083",2529,1837,1795,26,42,"EQUO",3
18,"18102",8556,6358,6272,42,86,"EQUO",16
42,"42038",42,32,31,3,1,"EQUO",1
31,"31147",103,81,80,3,1,"EQUO",3
16,"16064",699,588,580,4,8,"EQUO",0
19,"19064",97,84,83,1,1,"EQUO",0
36,"36007",1778,1258,1238,2,20,"EQUO",2
9,"9443",197,160,154,5,6,"EQUO",1
4,"4058",402,324,322,5,2,"EQUO",0
26,"26027",169,126,126,1,0,"EQUO",0
24,"24131",813,583,580,9,3,"EQUO",1
37,"37080",242,187,185,1,2,"EQUO",2
40,"40071",52,45,45,4,0,"EQUO",0
50,"50082",108,73,72,0,1,"EQUO",0
40,"40120",173,145,144,1,1,"EQUO",2
9,"9050",77,52,52,0,0,"EQUO",0
47,"47080",45,39,39,1,0,"EQUO",1
50,"50229",62,47,46,2,1,"EQUO",1
20,"20903",3625,2282,2267,52,15,"EQUO",23
28,"28087",3150,2475,2453,26,22,"EQUO",60
14,"14075",624,508,500,8,8,"EQUO",2
50,"50286",90,73,73,2,0,"EQUO",0
9,"9224",172,125,125,3,0,"EQUO",0
50,"50026",459,360,354,5,6,"EQUO",2
16,"16109",46,34,34,2,0,"EQUO",0
19,"19310",13,9,8,0,1,"EQUO",0
15,"15001",4985,3560,3506,63,54,"EQUO",21
10,"10205",2081,1486,1457,19,29,"EQUO",7
23,"23034",2591,2146,2124,13,22,"EQUO",1
19,"19107",349,289,288,1,1,"EQUO",1
26,"26070",203,179,177,3,2,"EQUO",0
20,"20904",98,67,66,0,1,"EQUO",0
9,"9446",13,9,9,0,0,"EQUO",0
45,"45125",2407,1977,1949,22,28,"EQUO",8
42,"42193",17,10,10,0,0,"EQUO",0
41,"41064",5629,4041,4006,28,35,"EQUO",12
20,"20905",142,105,103,1,2,"EQUO",0
45,"45162",773,599,594,3,5,"EQUO",0
10,"10043",866,636,622,1,14,"EQUO",0
15,"15086",3110,2281,2259,30,22,"EQUO",6
48,"48048",547,423,423,5,0,"EQUO",4
37,"37083",190,165,165,3,0,"EQUO",0
16,"16027",779,619,612,5,7,"EQUO",4
31,"31242",235,157,157,2,0,"EQUO",0
45,"45016",3804,2926,2876,52,50,"EQUO",30
37,"37200",192,142,142,0,0,"EQUO",0
29,"29093",2299,1767,1732,7,35,"EQUO",2
42,"42194",200,165,163,4,2,"EQUO",1
48,"48049",564,446,446,2,0,"EQUO",1
24,"24218",476,344,340,11,4,"EQUO",3
5,"5257",153,105,104,0,1,"EQUO",0
47,"47030",1075,822,801,13,21,"EQUO",2
24,"24176",336,267,261,3,6,"EQUO",0
13,"13088",649,531,526,3,5,"EQUO",0
45,"45017",268,215,212,1,3,"EQUO",0
11,"11019",1871,1449,1425,9,24,"EQUO",10
31,"31212",173,117,117,3,0,"EQUO",3
4,"4062",4604,3711,3654,22,57,"EQUO",8
26,"26072",310,270,264,4,6,"EQUO",1
31,"31244",153,97,97,3,0,"EQUO",0
45,"45128",2558,1831,1806,20,25,"EQUO",5
16,"16030",28,24,24,0,0,"EQUO",0
37,"37316",792,565,559,7,6,"EQUO",0
20,"20907",136,94,94,0,0,"EQUO",0
42,"42151",38,32,29,0,3,"EQUO",0
24,"24177",477,325,319,3,6,"EQUO",1
10,"10209",297,217,213,3,4,"EQUO",1
42,"42197",90,71,71,0,0,"EQUO",0
23,"23040",1538,1319,1311,3,8,"EQUO",2
10,"10129",374,279,276,2,3,"EQUO",0
10,"10088",244,168,168,0,0,"EQUO",0
37,"37317",323,281,278,3,3,"EQUO",0
36,"36035",14551,10675,10469,160,206,"EQUO",95
45,"45129",145,121,120,0,1,"EQUO",1
45,"45019",7033,5207,5110,89,97,"EQUO",47
50,"50290",436,334,331,4,3,"EQUO",1
39,"39069",1957,1595,1570,18,25,"EQUO",4
5,"5259",132,115,114,1,1,"EQUO",0
19,"19148",56,41,38,1,3,"EQUO",0
47,"47141",148,121,119,1,2,"EQUO",0
9,"9450",31,26,26,1,0,"EQUO",0
39,"39017",588,424,419,2,5,"EQUO",1
47,"47113",166,136,135,1,1,"EQUO",0
6,"6026",865,671,665,4,6,"EQUO",0
23,"23041",519,455,448,2,7,"EQUO",0
16,"16116",104,67,66,1,1,"EQUO",1
23,"23042",359,278,277,0,1,"EQUO",0
37,"37204",286,216,214,0,2,"EQUO",0
31,"31153",2246,1504,1487,13,17,"EQUO",10
9,"9230",41,33,33,0,0,"EQUO",0
28,"28067",3893,2996,2950,26,46,"EQUO",49
19,"19113",519,396,395,4,1,"EQUO",0
26,"26077",15,15,15,1,0,"EQUO",0
21,"21003",691,540,536,7,4,"EQUO",0
1,"1044",242,174,173,1,1,"EQUO",3
10,"10213",605,478,477,1,1,"EQUO",0
37,"37090",59,54,50,0,4,"EQUO",0
47,"47222",92,77,77,4,0,"EQUO",0
42,"42097",19,16,16,0,0,"EQUO",0
26,"26166",152,139,136,1,3,"EQUO",1
9,"9190",97,73,72,0,1,"EQUO",2
47,"47231",4272,3268,3243,64,25,"EQUO",39
40,"40097",114,96,94,2,2,"EQUO",0
19,"19011",286,219,218,3,1,"EQUO",2
21,"21034",1253,875,861,7,14,"EQUO",12
50,"50004",613,445,441,6,4,"EQUO",0
40,"40222",190,157,156,1,1,"EQUO",0
21,"21065",295,212,211,0,1,"EQUO",1
6,"6075",517,433,429,3,4,"EQUO",0
23,"23044",4897,3943,3893,13,50,"EQUO",16
6,"6030",171,132,131,0,1,"EQUO",0
26,"26079",690,568,562,5,6,"EQUO",1
28,"28162",2263,1802,1786,32,16,"EQUO",24
42,"42204",64,49,44,4,5,"EQUO",0
18,"18114",678,508,508,6,0,"EQUO",0
18,"18179",583,417,409,7,8,"EQUO",2
9,"9327",34,34,34,0,0,"EQUO",0
18,"18015",465,381,379,1,2,"EQUO",0
10,"10174",177,145,145,2,0,"EQUO",0
50,"50180",111,91,89,3,2,"EQUO",0
36,"36039",14581,11007,10782,167,225,"EQUO",45
50,"50294",77,58,57,0,1,"EQUO",0
24,"24064",1532,1128,1107,17,21,"EQUO",5
26,"26125",2720,2121,2084,26,37,"EQUO",8
37,"37322",2501,1692,1676,32,16,"EQUO",12
21,"21006",3565,2477,2441,29,36,"EQUO",7
42,"42205",99,70,70,0,0,"EQUO",2
19,"19262",184,137,136,0,1,"EQUO",3
47,"47144",85,65,65,2,0,"EQUO",0
45,"45135",4437,3621,3550,44,71,"EQUO",13
31,"31127",145,89,89,2,0,"EQUO",1
45,"45062",1161,959,928,8,31,"EQUO",0
10,"10095",346,290,283,3,7,"EQUO",1
5,"5036",136,107,106,0,1,"EQUO",0
48,"48057",5934,4407,4385,27,22,"EQUO",6
9,"9329",117,80,79,1,1,"EQUO",1
9,"9062",52,33,32,1,1,"EQUO",0
22,"22024",222,144,139,3,5,"EQUO",4
5,"5167",274,230,224,6,6,"EQUO",1
24,"24185",512,414,402,3,12,"EQUO",8
50,"50123",428,335,332,9,3,"EQUO",1
1,"1052",240,191,191,1,0,"EQUO",3
42,"42055",183,128,127,4,1,"EQUO",1
42,"42207",49,37,34,0,3,"EQUO",0
47,"47117",306,231,228,4,3,"EQUO",0
11,"11026",4834,3736,3691,27,45,"EQUO",14
37,"37098",355,267,265,1,2,"EQUO",3
28,"28094",774,557,551,5,6,"EQUO",10
47,"47118",159,122,122,2,0,"EQUO",1
19,"19043",92,82,82,1,0,"EQUO",0
16,"16083",58,30,30,1,0,"EQUO",0
5,"5134",47,37,37,0,0,"EQUO",0
31,"31068",3004,2258,2207,43,51,"EQUO",10
22,"22122",62,57,57,3,0,"EQUO",1
24,"24027",1184,853,837,7,16,"EQUO",8
33,"33040",4702,3285,3236,44,49,"EQUO",23
22,"22226",823,640,627,11,13,"EQUO",3
9,"9108",399,287,283,5,4,"EQUO",4
42,"42209",155,114,110,2,4,"EQUO",2
2,"2025",7496,6153,5985,69,168,"EQUO",56
41,"41072",4083,3073,3046,12,27,"EQUO",4
9,"9464",44,28,28,0,0,"EQUO",1
45,"45138",1185,998,973,5,25,"EQUO",3
36,"36010",2987,2312,2282,30,30,"EQUO",16
37,"37100",89,77,76,4,1,"EQUO",0
21,"21009",916,622,608,6,14,"EQUO",1
37,"37327",191,148,148,9,0,"EQUO",1
47,"47038",128,91,91,0,0,"EQUO",1
16,"16167",357,318,315,5,3,"EQUO",0
10,"10902",727,608,599,5,9,"EQUO",2
28,"28072",5232,4065,4007,35,58,"EQUO",120
42,"42110",82,58,58,2,0,"EQUO",0
22,"22075",150,103,101,7,2,"EQUO",0
37,"37328",218,155,149,2,6,"EQUO",0
28,"28096",16844,12441,12308,117,133,"EQUO",146
45,"45029",233,207,202,4,5,"EQUO",1
15,"15012",3767,2973,2926,51,47,"EQUO",15
47,"47121",590,495,490,4,5,"EQUO",0
16,"16128",70,64,64,2,0,"EQUO",0
31,"31254",1956,1495,1476,16,19,"EQUO",15
15,"15069",7019,5036,4938,85,98,"EQUO",52
18,"18152",1037,822,818,9,4,"EQUO",3
19,"19329",62,52,50,0,2,"EQUO",0
45,"45140",1087,885,867,6,18,"EQUO",3
5,"5901",289,197,196,4,1,"EQUO",1
31,"31071",17,15,15,0,0,"EQUO",0
23,"23053",9431,7160,7128,42,32,"EQUO",24
22,"22229",127,93,89,4,4,"EQUO",3
18,"18051",1196,857,852,4,5,"EQUO",2
11,"11001",4389,3110,3072,13,38,"EQUO",12
1,"1057",266,212,212,2,0,"EQUO",1
6,"6040",1032,807,807,11,0,"EQUO",2
23,"23054",393,288,286,1,2,"EQUO",1
45,"45141",981,815,790,6,25,"EQUO",3
19,"19122",96,65,65,0,0,"EQUO",0
50,"50039",580,450,446,3,4,"EQUO",2
9,"9113",503,397,390,7,7,"EQUO",4
29,"29076",2022,1384,1374,14,10,"EQUO",7
24,"24154",1068,803,795,6,8,"EQUO",3
5,"5041",1051,840,827,13,13,"EQUO",3
40,"40142",53,43,41,1,2,"EQUO",1
16,"16275",15,12,12,0,0,"EQUO",0
31,"31256",113,64,64,0,0,"EQUO",0
18,"18023",16072,11594,11488,131,106,"EQUO",45
19,"19226",40,31,30,0,1,"EQUO",1
41,"41050",5102,4224,4183,39,41,"EQUO",15
45,"45032",471,340,333,2,7,"EQUO",1
26,"26092",112,89,88,2,1,"EQUO",0
18,"18122",16253,12271,12109,132,162,"EQUO",50
40,"40095",507,437,425,2,12,"EQUO",1
24,"24074",107,87,87,0,0,"EQUO",0
21,"21013",10601,7384,7231,110,153,"EQUO",147
24,"24194",327,237,236,5,1,"EQUO",0
50,"50129",258,164,164,0,0,"EQUO",1
28,"28175",780,641,630,8,11,"EQUO",13
31,"31175",78,55,54,0,1,"EQUO",0
21,"21054",8024,6159,6072,67,87,"EQUO",24
29,"29004",343,281,281,0,0,"EQUO",1
11,"11031",76347,49071,48616,681,455,"EQUO",342
15,"15044",1436,1083,1068,10,15,"EQUO",9
47,"47077",291,232,232,1,0,"EQUO",0
39,"39009",3200,2427,2402,24,25,"EQUO",16
16,"16008",131,89,88,2,1,"EQUO",2
11,"11032",53183,32205,31982,441,223,"EQUO",147
42,"42219",45,33,33,1,0,"EQUO",0
39,"39001",2146,1669,1645,20,24,"EQUO",9
31,"31075",96,61,61,0,0,"EQUO",2
30,"30031",560,471,469,3,2,"EQUO",2
2,"2032",323,261,259,1,2,"EQUO",1
39,"39027",3213,2506,2473,21,33,"EQUO",13
18,"18025",326,242,238,0,4,"EQUO",0
5,"5008",244,200,196,1,4,"EQUO",0
28,"28011",437,318,315,2,3,"EQUO",5
10,"10107",1062,832,821,7,11,"EQUO",17
47,"47017",205,177,176,1,1,"EQUO",2
19,"19333",142,86,84,0,2,"EQUO",0
48,"48066",350,277,277,0,0,"EQUO",2
50,"50218",113,92,92,0,0,"EQUO",0
4,"4079",45851,31893,31644,430,249,"EQUO",305
37,"37108",108,95,95,1,0,"EQUO",0
40,"40101",770,584,577,16,7,"EQUO",6
40,"40906",1793,1428,1405,32,23,"EQUO",27
37,"37146",135,117,117,1,0,"EQUO",0
50,"50072",181,128,127,1,1,"EQUO",1
5,"5186",1670,1306,1287,9,19,"EQUO",11
6,"6062",638,493,492,3,1,"EQUO",0
47,"47161",3886,3133,3105,45,28,"EQUO",30
5,"5208",55,45,45,0,0,"EQUO",1
16,"16011",39,30,30,0,0,"EQUO",0
18,"18057",5045,3755,3721,44,34,"EQUO",18
31,"31107",1706,1321,1311,17,10,"EQUO",4
37,"37336",54,49,47,0,2,"EQUO",0
21,"21017",3581,2416,2389,27,27,"EQUO",3
6,"6003",875,705,691,4,14,"EQUO",1
42,"42123",172,128,128,3,0,"EQUO",0
28,"28102",913,700,693,9,7,"EQUO",1
31,"31168",247,165,163,0,2,"EQUO",3
11,"11007",17997,10781,10676,184,105,"EQUO",55
1,"1063",1803,1290,1284,18,6,"EQUO",46
45,"45038",3125,2401,2374,33,27,"EQUO",17
9,"9211",1489,1137,1121,28,16,"EQUO",4
15,"15056",5873,4205,4150,63,55,"EQUO",15
37,"37261",255,191,191,2,0,"EQUO",3
31,"31178",540,395,392,4,3,"EQUO",1
37,"37374",1204,1018,1004,9,14,"EQUO",3
16,"16181",73,62,62,1,0,"EQUO",0
31,"31231",127,93,91,1,2,"EQUO",0
4,"4011",2814,2283,2263,25,20,"EQUO",14
6,"6004",1607,1317,1309,10,8,"EQUO",1
47,"47045",839,636,632,3,4,"EQUO",0
47,"47209",43,33,33,0,0,"EQUO",1
40,"40010",140,117,117,0,0,"EQUO",1
33,"33003",737,475,471,6,4,"EQUO",1
24,"24203",109,73,73,0,0,"EQUO",0
47,"47128",57,52,48,1,4,"EQUO",0
11,"11008",16655,11309,11189,184,120,"EQUO",62
31,"31169",2285,1621,1590,43,31,"EQUO",3
16,"16140",34,27,27,0,0,"EQUO",0
50,"50074",6516,4378,4222,77,156,"EQUO",26
45,"45040",1504,1058,1046,5,12,"EQUO",1
10,"10153",331,266,263,1,3,"EQUO",0
6,"6006",4664,3435,3367,50,68,"EQUO",13
31,"31263",241,135,132,0,3,"EQUO",0
47,"47046",124,105,103,0,2,"EQUO",0
37,"37028",175,130,125,1,5,"EQUO",1
24,"24121",645,511,502,10,9,"EQUO",1
31,"31171",738,521,495,7,26,"EQUO",4
50,"50221",38,20,20,0,0,"EQUO",0
5,"5015",100,78,78,0,0,"EQUO",0
23,"23065",1701,1238,1226,10,12,"EQUO",6
9,"9215",426,290,287,1,3,"EQUO",2
5,"5116",131,114,109,0,5,"EQUO",0
4,"4084",370,290,285,6,5,"EQUO",0
33,"33026",9144,6019,5959,87,60,"EQUO",31
37,"37115",135,107,101,2,6,"EQUO",0
14,"14007",15871,11609,11477,121,132,"EQUO",35
15,"15050",1971,1110,1097,27,13,"EQUO",4
50,"50166",282,216,210,1,6,"EQUO",0
9,"9257",93,73,72,2,1,"EQUO",1
5,"5213",117,94,88,0,6,"EQUO",0
47,"47048",204,168,167,2,1,"EQUO",1
13,"13011",5166,3555,3500,31,55,"EQUO",11
26,"26103",796,616,611,11,5,"EQUO",4
16,"16142",118,93,93,1,0,"EQUO",0
26,"26019",365,296,295,6,1,"EQUO",2
4,"4052",11567,8189,8124,158,65,"EQUO",96
26,"26104",18,16,16,0,0,"EQUO",0
21,"21021",11825,7657,7574,108,83,"EQUO",53
33,"33005",1600,1084,1080,6,4,"EQUO",6
39,"39085",6722,5198,5134,60,64,"EQUO",27
31,"31265",81,52,50,0,2,"EQUO",0
16,"16017",406,337,334,1,3,"EQUO",3
50,"50223",956,751,745,14,6,"EQUO",4
31,"31173",881,754,733,12,21,"EQUO",1
9,"9352",134,107,106,0,1,"EQUO",0
19,"19134",22,14,14,0,0,"EQUO",0
9,"9903",3299,2373,2349,45,24,"EQUO",39
31,"31082",634,402,398,10,4,"EQUO",4
50,"50048",43,33,33,1,0,"EQUO",0
19,"19269",103,84,83,0,1,"EQUO",0
6,"6011",24301,17977,17819,268,158,"EQUO",89
18,"18033",282,227,226,0,1,"EQUO",1
16,"16145",508,421,417,6,4,"EQUO",3
6,"6057",575,481,474,2,7,"EQUO",0
31,"31113",147,87,85,2,2,"EQUO",2
31,"31083",50,37,37,0,0,"EQUO",8
19,"19238",42,32,31,1,1,"EQUO",0
50,"50139",372,280,278,3,2,"EQUO",0
42,"42082",9,9,9,0,0,"EQUO",0
41,"41007",12177,8150,8016,126,134,"EQUO",84
50,"50225",1638,1079,1062,7,17,"EQUO",4
48,"48075",1915,1362,1325,15,37,"EQUO",6
22,"22064",184,139,137,3,2,"EQUO",5
31,"31185",541,377,374,2,3,"EQUO",0
9,"9414",197,159,159,2,0,"EQUO",1
9,"9905",432,313,309,1,4,"EQUO",5
26,"26107",97,79,79,1,0,"EQUO",0
48,"48912",2340,1794,1776,22,18,"EQUO",3
5,"5237",198,157,155,3,2,"EQUO",0
22,"22234",818,609,605,12,4,"EQUO",1
26,"26023",505,386,380,6,6,"EQUO",2
37,"37022",287,237,232,0,5,"EQUO",1
15,"15007",3702,2670,2642,19,28,"EQUO",4
9,"9262",158,139,137,7,2,"EQUO",0
37,"37034",91,72,72,0,0,"EQUO",0
26,"26024",273,220,219,2,1,"EQUO",2
31,"31085",451,334,327,3,7,"EQUO",7
45,"45157",2097,1519,1499,15,20,"EQUO",12
23,"23072",2063,1661,1643,16,18,"EQUO",7
6,"6015",116077,82756,81836,989,920,"EQUO",585
19,"19061",76,57,55,3,2,"EQUO",1
42,"42139",22,18,17,0,1,"EQUO",0
47,"47160",466,368,364,5,4,"EQUO",0
50,"50141",116,98,98,1,0,"EQUO",3
41,"41009",1272,914,899,8,15,"EQUO",4
33,"33008",1934,1474,1459,11,15,"EQUO",5
31,"31086",11499,8520,8389,214,131,"EQUO",200
10,"10121",8063,6048,5988,51,60,"EQUO",19
2,"2009",19661,14804,14570,259,234,"EQUO",121
35,"35004",35462,18498,18196,325,302,"EQUO",200
24,"24091",704,502,496,8,6,"EQUO",2
19,"19027",185,140,138,1,2,"EQUO",1
48,"48045",5060,3912,3849,31,63,"EQUO",28
50,"50063",76,67,67,0,0,"EQUO",0
26,"26080",529,427,425,2,2,"EQUO",1
23,"23002",17740,14007,13858,171,149,"EQUO",64
50,"50053",756,570,563,14,7,"EQUO",2
20,"20058",770,549,547,3,2,"EQUO",3
15,"15084",3681,2676,2656,34,20,"EQUO",6
9,"9010",35,27,27,1,0,"EQUO",0
37,"37348",114,91,90,1,1,"EQUO",2
50,"50285",635,452,445,8,7,"EQUO",4
39,"39038",1465,1065,1047,8,18,"EQUO",16
18,"18171",2093,1719,1704,10,15,"EQUO",4
26,"26068",83,65,64,0,1,"EQUO",1
9,"9104",56,49,49,0,0,"EQUO",0
39,"39012",6666,5148,5061,43,87,"EQUO",32
23,"23076",831,681,671,5,10,"EQUO",1
4,"4092",2897,2351,2325,13,26,"EQUO",13
37,"37001",224,182,181,0,1,"EQUO",0
48,"48091",1170,860,851,3,9,"EQUO",5
20,"20011",1700,1265,1258,11,7,"EQUO",14
47,"47089",184,139,138,1,1,"EQUO",0
52,"52001",51028,26966,26659,496,307,"EQUO",427
22,"22208",168,136,133,2,3,"EQUO",1
2,"2011",730,612,610,3,2,"EQUO",2
16,"16026",104,79,79,1,0,"EQUO",0
21,"21028",419,320,315,3,5,"EQUO",0
33,"33078",159,108,106,1,2,"EQUO",0
31,"31088",5358,3655,3592,97,63,"EQUO",45
16,"16152",42,38,37,3,1,"EQUO",0
31,"31180",240,174,170,5,4,"EQUO",0
45,"45052",2793,2247,2212,38,35,"EQUO",28
28,"28064",143,112,110,1,2,"EQUO",3
23,"23079",3750,3084,3063,19,21,"EQUO",5
50,"50259",89,53,53,1,0,"EQUO",0
15,"15002",21528,15479,15218,314,261,"EQUO",186
24,"24217",144,108,107,2,1,"EQUO",0
19,"19244",95,82,82,6,0,"EQUO",0
14,"14047",1566,1154,1143,19,11,"EQUO",6
16,"16084",49,36,35,0,1,"EQUO",0
15,"15020",4187,2802,2781,18,21,"EQUO",7
37,"37016",539,424,420,8,4,"EQUO",5
21,"21060",11685,8026,7932,135,94,"EQUO",60
16,"16111",171,130,128,0,2,"EQUO",0
50,"50085",205,143,143,3,0,"EQUO",1
37,"37164",280,217,213,9,4,"EQUO",1
10,"10167",322,265,264,1,1,"EQUO",0
31,"31908",997,692,683,9,9,"EQUO",5
19,"19034",23,23,23,1,0,"EQUO",0
31,"31181",168,121,119,3,2,"EQUO",0
30,"30901",10113,8265,8194,70,71,"EQUO",85
9,"9094",49,39,39,0,0,"EQUO",0
42,"42001",308,242,237,4,5,"EQUO",2
9,"9448",225,188,186,1,2,"EQUO",1
26,"26032",58,52,52,1,0,"EQUO",0
47,"47111",1005,804,794,5,10,"EQUO",2
24,"24137",1226,920,904,16,16,"EQUO",4
28,"28180",5179,4033,3975,18,58,"EQUO",13
24,"24219",580,435,431,10,4,"EQUO",0
30,"30902",7463,5291,5228,38,63,"EQUO",39
37,"37005",92,65,65,0,0,"EQUO",0
50,"50029",676,527,517,6,10,"EQUO",1
19,"19071",7346,5380,5294,76,86,"EQUO",68
11,"11020",163674,106898,106082,1655,816,"EQUO",719
37,"37128",261,211,210,2,1,"EQUO",0
33,"33012",5341,3816,3777,43,39,"EQUO",38
19,"19281",25,24,22,3,2,"EQUO",0
37,"37006",157,108,107,0,1,"EQUO",2
40,"40126",96,80,78,0,2,"EQUO",1
31,"31183",667,516,508,8,8,"EQUO",4
37,"37354",4828,3589,3522,76,67,"EQUO",33
50,"50289",71,59,59,0,0,"EQUO",0
47,"47084",1230,981,968,19,13,"EQUO",0
21,"21032",1790,1362,1347,14,15,"EQUO",1
9,"9412",846,568,563,4,5,"EQUO",13
13,"13057",1214,1018,998,9,20,"EQUO",0
26,"26164",70,42,42,1,0,"EQUO",0
9,"9229",213,163,163,1,0,"EQUO",0
16,"16072",161,126,123,0,3,"EQUO",0
47,"47221",115,102,102,0,0,"EQUO",0
9,"9018",24688,17880,17508,345,372,"EQUO",157
28,"28024",156,132,132,5,0,"EQUO",3
48,"48085",9893,6960,6885,93,75,"EQUO",161
33,"33013",466,349,345,4,4,"EQUO",2
4,"4098",1616,1255,1249,7,6,"EQUO",4
5,"5193",224,197,197,2,0,"EQUO",0
16,"16158",550,427,423,2,4,"EQUO",2
6,"6901",2113,1729,1706,26,23,"EQUO",2
16,"16073",214,170,170,2,0,"EQUO",1
47,"47168",32,29,28,1,1,"EQUO",0
37,"37008",4316,3518,3457,31,61,"EQUO",17
40,"40144",19,17,17,1,0,"EQUO",0
16,"16191",1001,867,864,13,3,"EQUO",2
10,"10036",345,262,251,2,11,"EQUO",1
28,"28025",426,336,332,2,4,"EQUO",0
10,"10050",1208,1003,983,8,20,"EQUO",0
9,"9325",217,151,148,1,3,"EQUO",0
10,"10145",132,112,111,0,1,"EQUO",1
16,"16020",20,15,15,0,0,"EQUO",0
24,"24211",291,226,224,3,2,"EQUO",5
41,"41092",7649,5816,5738,39,78,"EQUO",16
42,"42187",65,51,51,0,0,"EQUO",1
9,"9387",121,92,91,3,1,"EQUO",1
47,"47007",3453,2616,2580,42,36,"EQUO",17
10,"10093",413,339,332,2,7,"EQUO",1
37,"37282",238,169,168,3,1,"EQUO",0
47,"47143",146,108,107,0,1,"EQUO",0
47,"47115",306,248,248,2,0,"EQUO",0
9,"9232",182,146,146,1,0,"EQUO",1
45,"45060",204,151,148,1,3,"EQUO",1
33,"33015",1695,1177,1161,12,16,"EQUO",6
37,"37359",194,155,152,1,3,"EQUO",0
28,"28047",38404,28739,28436,312,303,"EQUO",551
50,"50090",165,117,117,1,0,"EQUO",1
5,"5131",118,86,86,3,0,"EQUO",0
48,"48055",2620,1954,1934,22,20,"EQUO",13
9,"9455",48,39,39,0,0,"EQUO",0
22,"22221",108,70,69,5,1,"EQUO",1
45,"45061",2523,1839,1813,20,26,"EQUO",10
47,"47088",121,100,100,0,0,"EQUO",0
10,"10135",1366,1004,998,3,6,"EQUO",4
9,"9144",61,51,50,0,1,"EQUO",0
4,"4046",826,645,634,4,11,"EQUO",4
29,"29090",1805,1265,1260,5,5,"EQUO",3
5,"5230",79,73,73,1,0,"EQUO",1
37,"37284",334,256,254,1,2,"EQUO",12
42,"42140",17,10,10,0,0,"EQUO",0
10,"10176",384,300,293,5,7,"EQUO",1
22,"22116",1571,1127,1114,37,13,"EQUO",3
22,"22189",199,140,138,5,2,"EQUO",1
39,"39081",440,372,369,3,3,"EQUO",0
26,"26081",23,17,17,0,0,"EQUO",0
37,"37135",1234,972,961,8,11,"EQUO",3
19,"19154",79,68,67,0,1,"EQUO",0
37,"37025",264,217,216,1,1,"EQUO",0
42,"42106",15,14,14,0,0,"EQUO",0
40,"40135",298,247,242,4,5,"EQUO",0
11,"11025",4371,3260,3226,34,34,"EQUO",3
50,"50064",469,377,373,5,4,"EQUO",0
9,"9301",625,510,504,11,6,"EQUO",2
13,"13030",153,123,123,1,0,"EQUO",0
45,"45002",2500,1771,1756,26,15,"EQUO",1
37,"37014",1198,862,852,8,10,"EQUO",2
10,"10015",688,539,523,5,16,"EQUO",7
15,"15038",2363,1643,1610,29,33,"EQUO",3
19,"19287",153,114,113,2,1,"EQUO",0
16,"16123",110,74,73,1,1,"EQUO",0
9,"9238",1026,612,601,6,11,"EQUO",4
19,"19288",22,21,21,0,0,"EQUO",0
50,"50007",61,45,45,0,0,"EQUO",0
20,"20024",400,238,235,0,3,"EQUO",1
16,"16237",116,98,98,3,0,"EQUO",1
26,"26043",397,313,306,6,7,"EQUO",3
42,"42208",23,15,15,1,0,"EQUO",0
47,"47146",236,196,195,4,1,"EQUO",3
47,"47198",71,56,56,2,0,"EQUO",0
6,"6127",2922,2306,2279,27,27,"EQUO",5
50,"50296",417,313,310,6,3,"EQUO",0
9,"9421",269,189,189,5,0,"EQUO",2
16,"16903",1097,855,828,9,27,"EQUO",3
10,"10057",166,133,133,0,0,"EQUO",2
23,"23064",1680,1483,1478,8,5,"EQUO",0
9,"9380",85,71,71,1,0,"EQUO",0
50,"50066",2357,1677,1659,42,18,"EQUO",13
47,"47147",129,96,96,0,0,"EQUO",0
40,"40231",128,102,100,3,2,"EQUO",0
47,"47064",30,21,21,1,0,"EQUO",2
45,"45065",317,261,258,0,3,"EQUO",0
9,"9154",150,107,107,3,0,"EQUO",1
19,"19190",2499,1829,1785,32,44,"EQUO",19
21,"21040",3096,2370,2351,28,19,"EQUO",10
9,"9110",95,68,68,1,0,"EQUO",0
33,"33019",3262,2283,2244,12,39,"EQUO",10
20,"20027",2809,1929,1918,25,11,"EQUO",10
40,"40140",100,74,73,1,1,"EQUO",0
9,"9334",52,40,39,1,1,"EQUO",1
11,"11028",32224,20706,20482,359,224,"EQUO",355
45,"45067",2385,1923,1878,19,45,"EQUO",3
50,"50010",77,65,64,5,1,"EQUO",0
19,"19159",108,91,88,1,3,"EQUO",0
16,"16043",105,86,86,1,0,"EQUO",0
23,"23097",6510,4687,4639,36,48,"EQUO",12
31,"31010",5788,3716,3637,48,79,"EQUO",17
29,"29002",1246,896,893,11,3,"EQUO",9
19,"19257",3595,2593,2543,48,50,"EQUO",21
31,"31162",53,35,34,1,1,"EQUO",0
9,"9424",42,35,34,1,1,"EQUO",0
23,"23009",12876,10335,10231,109,104,"EQUO",34
29,"29075",12666,8284,8218,62,66,"EQUO",78
6,"6131",1037,871,865,8,6,"EQUO",0
4,"4075",4783,3731,3700,33,31,"EQUO",10
37,"37291",261,215,214,1,1,"EQUO",0
42,"42061",297,190,188,4,2,"EQUO",6
42,"42019",562,392,383,9,9,"EQUO",11
31,"31132",160,124,124,6,0,"EQUO",1
18,"18087",187449,138136,136783,1548,1353,"EQUO",1753
5,"5002",1996,1497,1476,15,21,"EQUO",19
37,"37367",218,182,176,0,6,"EQUO",0
9,"9292",98,73,71,3,2,"EQUO",1
10,"10021",5421,4189,4099,47,90,"EQUO",13
24,"24112",323,230,228,0,2,"EQUO",0
30,"30003",23570,16482,16354,169,128,"EQUO",55
10,"10144",999,782,773,7,9,"EQUO",3
47,"47123",456,356,353,10,3,"EQUO",1
22,"22128",203,164,161,7,3,"EQUO",1
39,"39026",1825,1383,1371,12,12,"EQUO",5
22,"22232",98,78,75,0,3,"EQUO",0
47,"47067",198,159,156,5,3,"EQUO",0
47,"47230",318,266,259,2,7,"EQUO",1
37,"37256",245,191,190,2,1,"EQUO",1
50,"50244",215,155,155,6,0,"EQUO",0
2,"2042",897,712,709,6,3,"EQUO",2
16,"16205",126,94,93,0,1,"EQUO",2
40,"40033",61,48,47,3,1,"EQUO",2
30,"30021",8550,6423,6349,44,74,"EQUO",21
50,"50070",70,42,41,0,1,"EQUO",0
10,"10037",74974,56844,55950,898,894,"EQUO",685
1,"1028",1106,773,760,8,13,"EQUO",6
36,"36059",5438,3874,3805,47,69,"EQUO",18
45,"45071",1896,1592,1575,21,17,"EQUO",4
48,"48076",294,226,226,0,0,"EQUO",0
29,"29061",1045,861,855,7,6,"EQUO",2
42,"42064",92,76,76,0,0,"EQUO",2
24,"24036",321,190,188,0,2,"EQUO",2
2,"2068",379,290,284,3,6,"EQUO",0
40,"40052",95,69,69,0,0,"EQUO",1
37,"37145",276,217,214,0,3,"EQUO",0
19,"19163",73,59,59,0,0,"EQUO",0
10,"10187",486,349,345,2,4,"EQUO",3
42,"42119",192,124,123,0,1,"EQUO",0
24,"24115",54654,38629,38010,716,619,"EQUO",329
50,"50161",124,86,86,1,0,"EQUO",0
31,"31105",1619,1306,1284,30,22,"EQUO",6
33,"33023",3410,2501,2485,40,16,"EQUO",7
5,"5905",253,200,198,1,2,"EQUO",1
24,"24158",333,223,223,6,0,"EQUO",0
47,"47178",190,162,161,1,1,"EQUO",1
37,"37063",94,77,76,3,1,"EQUO",1
10,"10026",598,458,447,5,11,"EQUO",1
19,"19165",51,43,42,0,1,"EQUO",1
28,"28076",417,325,321,1,4,"EQUO",8
37,"37259",44,32,32,3,0,"EQUO",0
40,"40053",116,92,90,1,2,"EQUO",3
9,"9358",261,200,199,3,1,"EQUO",0
41,"41044",6838,5064,5005,67,59,"EQUO",88
24,"24213",162,134,133,1,1,"EQUO",1
40,"40163",62,51,51,5,0,"EQUO",0
47,"47224",92,77,77,0,0,"EQUO",0
40,"40149",563,446,434,9,12,"EQUO",4
31,"31198",38,33,33,0,0,"EQUO",1
28,"28041",4006,3190,3154,45,36,"EQUO",41
5,"5252",70,52,51,0,1,"EQUO",0
47,"47097",345,291,289,7,2,"EQUO",1
5,"5241",3145,2303,2273,27,30,"EQUO",7
45,"45111",65,47,44,1,3,"EQUO",1
48,"48915",362,273,271,2,2,"EQUO",0
20,"20035",497,346,344,1,2,"EQUO",3
47,"47070",33,30,30,1,0,"EQUO",0
10,"10150",374,331,328,2,3,"EQUO",0
24,"24118",132,96,96,2,0,"EQUO",1
48,"48013",81335,54452,53803,771,649,"EQUO",503
5,"5253",95,75,74,0,1,"EQUO",0
29,"29091",8777,6226,6126,64,100,"EQUO",22
40,"40165",95,72,71,1,1,"EQUO",0
45,"45088",2038,1379,1356,14,23,"EQUO",5
31,"31108",1969,1474,1452,23,22,"EQUO",2
45,"45076",603,420,419,3,1,"EQUO",1
26,"26157",306,268,263,1,5,"EQUO",1
50,"50083",96,72,72,1,0,"EQUO",1
9,"9482",33,31,30,1,1,"EQUO",0
40,"40152",750,615,595,4,20,"EQUO",5
41,"41055",15121,11082,10997,98,85,"EQUO",25
35,"35032",3432,2605,2548,37,57,"EQUO",21
16,"16185",63,45,44,0,1,"EQUO",0
37,"37027",242,196,192,2,4,"EQUO",0
15,"15048",4769,3470,3415,57,55,"EQUO",17
45,"45187",4187,3581,3512,25,69,"EQUO",12
29,"29009",1525,1126,1109,9,17,"EQUO",0
48,"48037",727,528,519,2,9,"EQUO",2
42,"42177",78,64,62,4,2,"EQUO",0
50,"50115",3280,2234,2205,32,29,"EQUO",5
42,"42125",73,65,64,4,1,"EQUO",1
48,"48004",329,240,239,2,1,"EQUO",2
28,"28127",60108,48418,48039,568,379,"EQUO",901
47,"47182",1371,991,982,12,9,"EQUO",5
50,"50105",343,263,259,2,4,"EQUO",0
47,"47156",182,155,148,0,7,"EQUO",0
20,"20038",382,281,280,1,1,"EQUO",0
37,"37188",198,164,160,7,4,"EQUO",2
16,"16055",698,485,481,8,4,"EQUO",1
40,"40155",3083,2333,2280,73,53,"EQUO",39
28,"28015",14491,11562,11417,155,145,"EQUO",160
50,"50175",1088,742,732,10,10,"EQUO",19
10,"10168",318,240,238,1,2,"EQUO",1
9,"9304",197,168,165,1,3,"EQUO",0
11,"11038",13815,10849,10756,126,93,"EQUO",58
6,"6008",636,561,552,6,9,"EQUO",3
5,"5244",66,45,45,0,0,"EQUO",0
9,"9395",164,134,133,1,1,"EQUO",4
48,"48908",242,194,194,1,0,"EQUO",1
31,"31202",4247,3014,2957,69,57,"EQUO",17
31,"31111",100,75,75,1,0,"EQUO",0
50,"50279",111,79,79,1,0,"EQUO",1
29,"29085",156,116,113,0,3,"EQUO",0
40,"40060",86,65,64,3,1,"EQUO",0
19,"19302",64,60,60,2,0,"EQUO",1
47,"47157",544,462,458,9,4,"EQUO",1
45,"45080",3,3,3,0,0,"EQUO",0
37,"37378",118,85,85,3,0,"EQUO",0
41,"41031",1319,879,875,6,4,"EQUO",2
45,"45191",601,506,498,1,8,"EQUO",0
31,"31112",106,79,78,0,1,"EQUO",0
29,"29086",814,538,536,9,2,"EQUO",0
10,"10075",276,189,189,1,0,"EQUO",2
13,"13012",475,322,318,1,4,"EQUO",0
37,"37267",210,169,165,0,4,"EQUO",0
41,"41099",4141,2818,2799,37,19,"EQUO",2
37,"37379",167,128,125,4,3,"EQUO",0
31,"31203",30,25,25,0,0,"EQUO",0
5,"5053",94,73,71,0,2,"EQUO",1
37,"37155",81,57,57,0,0,"EQUO",0
21,"21053",3278,2363,2325,20,38,"EQUO",5
11,"11040",411,317,309,0,8,"EQUO",0
16,"16058",120,103,102,1,1,"EQUO",1
50,"50253",461,381,375,3,6,"EQUO",0
9,"9308",70,51,51,0,0,"EQUO",0
50,"50297",495260,360632,355561,7046,5071,"EQUO",3063
22,"22248",119,94,92,3,2,"EQUO",0
47,"47103",277,218,214,1,4,"EQUO",1
45,"45193",661,557,548,1,9,"EQUO",0
9,"9261",486,342,338,7,4,"EQUO",0
29,"29013",1718,1302,1283,4,19,"EQUO",11
22,"22907",1444,1034,1018,12,16,"EQUO",19
9,"9070",38,27,27,3,0,"EQUO",0
19,"19059",84,60,60,0,0,"EQUO",0
33,"33052",758,526,518,2,8,"EQUO",1
11,"11041",9805,7136,7067,87,69,"EQUO",18
6,"6119",680,539,534,3,5,"EQUO",3
18,"18178",834,685,683,3,2,"EQUO",1
15,"15053",8164,5679,5592,60,87,"EQUO",19
22,"22249",110,83,81,0,2,"EQUO",1
31,"31144",840,509,508,7,1,"EQUO",4
31,"31250",2887,1827,1802,20,25,"EQUO",19
42,"42083",28,25,25,0,0,"EQUO",1
24,"24157",2580,2046,2000,39,46,"EQUO",17
16,"16104",65,52,52,1,0,"EQUO",0
22,"22151",97,71,71,0,0,"EQUO",0
5,"5154",46,35,35,0,0,"EQUO",1
5,"5021",2044,1592,1557,37,35,"EQUO",19
9,"9131",412,332,321,6,11,"EQUO",2
19,"19174",126,88,86,0,2,"EQUO",1
41,"41101",5752,4663,4629,25,34,"EQUO",7
47,"47104",2917,2391,2357,31,34,"EQUO",5
13,"13082",25643,17973,17798,257,175,"EQUO",45
16,"16192",54,37,37,1,0,"EQUO",0
5,"5121",250,181,178,1,3,"EQUO",1
16,"16247",87,65,62,1,3,"EQUO",0
37,"37159",100,77,75,0,2,"EQUO",0
39,"39037",2061,1609,1586,10,23,"EQUO",6
22,"22252",130,98,96,5,2,"EQUO",1
21,"21056",2992,2172,2096,29,76,"EQUO",2
19,"19175",39,31,31,0,0,"EQUO",0
45,"45086",491,406,399,3,7,"EQUO",0
40,"40224",34,25,25,0,0,"EQUO",1
31,"31259",503,341,336,6,5,"EQUO",0
19,"19002",99,77,76,0,1,"EQUO",0
37,"37360",252,194,194,1,0,"EQUO",1
28,"28019",1195,901,888,5,13,"EQUO",10
22,"22172",613,463,452,6,11,"EQUO",1
40,"40180",319,259,255,3,4,"EQUO",3
26,"26141",132,101,101,2,0,"EQUO",0
22,"22236",266,213,213,3,0,"EQUO",1
37,"37196",93,74,70,1,4,"EQUO",0
9,"9444",81,54,52,1,2,"EQUO",0
4,"4033",161,120,119,1,1,"EQUO",5
16,"16212",286,229,226,3,3,"EQUO",0
5,"5133",62,49,49,0,0,"EQUO",0
33,"33077",1351,938,931,7,7,"EQUO",1
37,"37037",130,100,99,0,1,"EQUO",0
24,"24132",683,440,435,5,5,"EQUO",7
9,"9149",37,25,25,0,0,"EQUO",0
45,"45091",419,311,309,5,2,"EQUO",0
6,"6080",1942,1519,1507,9,12,"EQUO",3
20,"20060",92,83,82,0,1,"EQUO",0
45,"45136",5891,4414,4368,55,46,"EQUO",4
18,"18070",287,240,239,2,1,"EQUO",9
20,"20048",175,102,102,1,0,"EQUO",1
22,"22072",209,130,128,2,2,"EQUO",2
24,"24229",473,348,344,8,4,"EQUO",0
15,"15057",12467,8936,8744,102,192,"EQUO",43
47,"47002",30,27,27,1,0,"EQUO",0
19,"19178",45,34,34,0,0,"EQUO",0
50,"50093",113,84,84,2,0,"EQUO",6
41,"41037",3228,2510,2483,27,27,"EQUO",7
13,"13053",14718,10958,10766,159,192,"EQUO",75
31,"31119",49,28,28,0,0,"EQUO",0
9,"9316",108,87,84,0,3,"EQUO",0
24,"24094",1466,1023,1006,24,17,"EQUO",4
9,"9226",74,57,57,0,0,"EQUO",0
5,"5093",431,330,329,1,1,"EQUO",5
26,"26084",5999,4440,4399,56,41,"EQUO",48
20,"20013",5331,3662,3637,33,25,"EQUO",30
22,"22243",45,27,27,1,0,"EQUO",0
10,"10099",633,458,450,4,8,"EQUO",1
37,"37314",79,61,61,3,0,"EQUO",0
40,"40170",1383,1091,1072,11,19,"EQUO",16
36,"36032",3666,2789,2755,25,34,"EQUO",7
10,"10207",499,394,392,1,2,"EQUO",1
47,"47082",816,664,661,10,3,"EQUO",2
42,"42195",112,74,72,1,2,"EQUO",1
40,"40214",243,204,199,0,5,"EQUO",0
19,"19179",109,77,75,3,2,"EQUO",0
15,"15068",5404,3780,3725,53,55,"EQUO",13
14,"14058",8116,6274,6215,76,59,"EQUO",32
45,"45127",739,550,538,5,12,"EQUO",4
40,"40171",32,25,25,0,0,"EQUO",0
16,"16253",340,256,256,4,0,"EQUO",0
10,"10903",813,620,615,3,5,"EQUO",1
26,"26175",57,46,45,1,1,"EQUO",0
28,"28135",928,665,659,6,6,"EQUO",32
37,"37277",58,39,38,1,1,"EQUO",0
31,"31246",148,101,100,3,1,"EQUO",1
41,"41039",31429,23337,23138,294,199,"EQUO",131
10,"10006",1306,1081,1070,7,11,"EQUO",1
10,"10128",5805,4456,4336,50,120,"EQUO",12
26,"26163",143,118,116,2,2,"EQUO",3
45,"45202",3876,3037,2984,13,53,"EQUO",6
10,"10047",978,795,780,9,15,"EQUO",0
26,"26074",128,102,101,0,1,"EQUO",1
15,"15060",5599,4139,4069,82,70,"EQUO",23
37,"37166",206,172,171,3,1,"EQUO",0
50,"50086",193,109,109,0,0,"EQUO",0
33,"33035",11413,8105,8035,104,70,"EQUO",41
48,"48018",905,591,587,8,4,"EQUO",0
9,"9184",4,4,4,0,0,"EQUO",0
4,"4064",2585,1817,1803,18,14,"EQUO",19
10,"10211",461,341,334,3,7,"EQUO",0
15,"15089",4354,3255,3216,55,39,"EQUO",20
26,"26035",22,14,14,0,0,"EQUO",0
9,"9368",26,18,18,0,0,"EQUO",0
16,"16204",306,235,235,5,0,"EQUO",0
19,"19318",36,19,19,1,0,"EQUO",0
10,"10171",376,287,282,0,5,"EQUO",1
31,"31123",652,379,373,8,6,"EQUO",1
21,"21002",14281,10297,10173,141,124,"EQUO",146
37,"37356",90,66,66,1,0,"EQUO",0
45,"45020",1396,1165,1151,15,14,"EQUO",2
10,"10062",421,332,325,3,7,"EQUO",0
16,"16117",1130,871,857,8,14,"EQUO",1
40,"40080",68,53,52,0,1,"EQUO",0
19,"19088",98,67,66,0,1,"EQUO",2
26,"26063",131,104,102,2,2,"EQUO",1
41,"41068",13809,10171,10072,100,99,"EQUO",31
45,"45021",2399,1834,1804,23,30,"EQUO",6
31,"31124",209,139,138,1,1,"EQUO",0
42,"42035",847,600,592,4,8,"EQUO",5
37,"37077",293,262,258,3,4,"EQUO",0
45,"45205",6333,4544,4451,58,93,"EQUO",28
4,"4018",293,250,245,2,5,"EQUO",1
5,"5047",4267,3345,3275,34,70,"EQUO",20
45,"45148",340,256,256,1,0,"EQUO",2
47,"47151",32,29,29,0,0,"EQUO",0
42,"42118",26,20,20,0,0,"EQUO",0
10,"10092",316,263,262,1,1,"EQUO",1
14,"14052",9720,6444,6384,58,60,"EQUO",24
42,"42051",23,12,11,0,1,"EQUO",0
10,"10051",489,373,373,2,0,"EQUO",1
19,"19284",11,11,11,0,0,"EQUO",0
4,"4067",657,526,524,1,2,"EQUO",1
42,"42098",14,8,8,0,0,"EQUO",0
19,"19076",36,29,29,0,0,"EQUO",0
11,"11023",9209,6979,6929,81,50,"EQUO",24
14,"14022",4077,3147,3102,20,45,"EQUO",6
37,"37091",181,127,119,0,8,"EQUO",0
22,"22909",349,259,252,3,7,"EQUO",4
40,"40178",104,80,79,1,1,"EQUO",0
31,"31136",438,283,283,10,0,"EQUO",10
11,"11024",6811,5241,5202,58,39,"EQUO",15
9,"9417",43,38,38,0,0,"EQUO",0
24,"24183",900,571,567,10,4,"EQUO",2
31,"31157",3567,2435,2393,32,42,"EQUO",9
33,"33001",1772,984,971,14,13,"EQUO",3
50,"50151",713,536,531,5,5,"EQUO",2
35,"35022",43892,27289,26876,326,413,"EQUO",194
37,"37096",235,199,197,3,2,"EQUO",0
50,"50121",297,250,245,6,5,"EQUO",0
31,"31208",2574,2003,1966,32,37,"EQUO",14
9,"9389",77,66,66,0,0,"EQUO",0
40,"40037",47,35,35,0,0,"EQUO",0
6,"6098",537,436,435,6,1,"EQUO",2
50,"50046",201,155,153,2,2,"EQUO",0
33,"33069",3611,2615,2597,25,18,"EQUO",8
9,"9480",106,87,87,0,0,"EQUO",0
22,"22190",120,76,73,4,3,"EQUO",1
40,"40055",41,32,31,0,1,"EQUO",0
21,"21067",418,318,312,5,6,"EQUO",1
23,"23003",8778,6945,6877,51,68,"EQUO",16
2,"2059",336,262,258,3,4,"EQUO",0
22,"22163",431,353,344,5,9,"EQUO",9
9,"9381",38,30,30,0,0,"EQUO",0
21,"21027",67,52,52,0,0,"EQUO",0
18,"18059",4055,3232,3191,37,41,"EQUO",4
5,"5157",256,187,183,0,4,"EQUO",0
19,"19325",127,105,102,4,3,"EQUO",1
37,"37249",48,36,36,0,0,"EQUO",0
47,"47071",406,333,329,6,4,"EQUO",3
26,"26069",276,211,208,5,3,"EQUO",0
40,"40073",425,371,367,3,4,"EQUO",0
24,"24187",881,664,659,14,5,"EQUO",1
47,"47011",600,493,489,4,4,"EQUO",0
9,"9090",61,50,50,0,0,"EQUO",0
22,"22158",11978,8404,8279,149,125,"EQUO",51
33,"33048",169,120,120,1,0,"EQUO",0
45,"45101",3761,3212,3181,19,31,"EQUO",2
10,"10901",1148,844,839,18,5,"EQUO",5
37,"37363",121,100,99,0,1,"EQUO",0
21,"21039",313,233,232,2,1,"EQUO",0
18,"18018",658,520,514,4,6,"EQUO",1
9,"9392",51,42,42,1,0,"EQUO",0
45,"45027",433,352,349,1,3,"EQUO",1
6,"6051",1606,1314,1302,10,12,"EQUO",2
4,"4012",230,195,195,2,0,"EQUO",0
31,"31160",111,93,93,7,0,"EQUO",1
22,"22028",424,311,310,3,1,"EQUO",8
50,"50037",140,110,103,3,7,"EQUO",0
4,"4002",1146,891,884,1,7,"EQUO",1
24,"24042",79,68,68,0,0,"EQUO",0
40,"40107",113,93,90,3,3,"EQUO",0
24,"24083",1165,831,819,17,12,"EQUO",4
31,"31043",42,30,30,1,0,"EQUO",0
24,"24168",493,397,391,7,6,"EQUO",0
39,"39093",351,260,253,2,7,"EQUO",3
5,"5233",246,212,212,2,0,"EQUO",0
9,"9027",54,48,43,0,5,"EQUO",0
26,"26087",222,180,178,5,2,"EQUO",1
4,"4026",75,58,58,0,0,"EQUO",0
29,"29010",1703,1411,1377,7,34,"EQUO",1
13,"13066",2444,2094,2065,15,29,"EQUO",2
50,"50282",88,66,63,3,3,"EQUO",0
5,"5187",1833,1385,1361,16,24,"EQUO",10
47,"47013",118,97,97,2,0,"EQUO",0
48,"48028",767,623,621,1,2,"EQUO",1
19,"19046",20318,15118,14892,219,226,"EQUO",159
6,"6085",3437,2566,2530,32,36,"EQUO",16
29,"29058",1560,1103,1096,5,7,"EQUO",1
26,"26006",1853,1456,1430,15,26,"EQUO",8
9,"9382",33,30,30,0,0,"EQUO",0
19,"19225",879,625,618,9,7,"EQUO",7
1,"1008",781,566,546,7,20,"EQUO",11
40,"40109",84,70,67,0,3,"EQUO",0
30,"30037",17942,13830,13734,90,96,"EQUO",43
22,"22181",91,57,55,0,2,"EQUO",0
50,"50128",36,30,29,0,1,"EQUO",0
47,"47203",69,57,56,0,1,"EQUO",0
26,"26089",108356,81446,80090,1450,1356,"EQUO",1005
28,"28073",11899,8877,8769,112,108,"EQUO",73
4,"4053",12062,9283,9180,119,103,"EQUO",37
29,"29031",1652,1123,1118,11,5,"EQUO",4
16,"16088",125,103,103,1,0,"EQUO",1
31,"31225",40,32,32,0,0,"EQUO",0
1,"1009",1296,876,863,9,13,"EQUO",7
4,"4005",631,531,524,6,7,"EQUO",2
24,"24193",371,254,252,3,2,"EQUO",0
48,"48008",600,432,428,3,4,"EQUO",2
33,"33066",42885,29326,29013,460,313,"EQUO",227
47,"47094",154,129,127,0,2,"EQUO",0
9,"9904",548,412,407,7,5,"EQUO",1
45,"45045",1313,992,979,12,13,"EQUO",9
29,"29032",6673,5204,5140,43,64,"EQUO",20
47,"47116",426,363,358,0,5,"EQUO",2
10,"10127",4663,3554,3498,38,56,"EQUO",8
47,"47194",322,244,233,1,11,"EQUO",5
42,"42216",27,22,22,0,0,"EQUO",0
22,"22202",146,120,120,1,0,"EQUO",0
14,"14051",1392,1148,1130,11,18,"EQUO",1
19,"19319",4203,3139,3104,28,35,"EQUO",27
31,"31003",131,101,101,1,0,"EQUO",0
37,"37298",206,144,140,1,4,"EQUO",0
28,"28034",356,278,276,1,2,"EQUO",5
16,"16126",811,701,692,13,9,"EQUO",2
50,"50025",4569,3319,3271,68,48,"EQUO",17
6,"6034",190,134,129,3,5,"EQUO",0
48,"48080",10161,6901,6815,95,86,"EQUO",35
23,"23057",823,717,711,4,6,"EQUO",1
19,"19124",420,293,291,3,2,"EQUO",1
22,"22040",155,129,127,3,2,"EQUO",0
16,"16092",158,132,132,0,0,"EQUO",0
18,"18189",723,547,541,6,6,"EQUO",9
40,"40099",61,52,52,2,0,"EQUO",0
13,"13004",1130,937,923,6,14,"EQUO",1
13,"13038",1770,1397,1380,8,17,"EQUO",2
37,"37370",345,261,260,1,1,"EQUO",1
31,"31024",116,56,56,2,0,"EQUO",1
29,"29080",6598,4703,4663,31,40,"EQUO",15
15,"15017",18860,12975,12737,325,238,"EQUO",150
22,"22082",320,231,229,1,2,"EQUO",0
5,"5175",190,149,149,2,0,"EQUO",3
22,"22155",89,67,67,2,0,"EQUO",2
5,"5143",81,61,61,0,0,"EQUO",0
16,"16093",80,57,57,0,0,"EQUO",0
21,"21076",2108,1647,1628,22,19,"EQUO",7
13,"13072",803,638,633,13,5,"EQUO",0
14,"14013",17006,13114,12958,166,156,"EQUO",111
11,"11033",19983,12960,12807,199,153,"EQUO",83
21,"21005",15205,11006,10909,108,97,"EQUO",32
50,"50265",63,46,46,1,0,"EQUO",0
28,"28093",1911,1537,1518,19,19,"EQUO",20
18,"18180",655,450,447,1,3,"EQUO",1
9,"9406",242,193,193,2,0,"EQUO",6
21,"21030",1757,1448,1426,14,22,"EQUO",5
42,"42185",29,23,23,1,0,"EQUO",0
28,"28089",3531,2786,2753,25,33,"EQUO",10
13,"13050",533,427,421,3,6,"EQUO",0
37,"37315",99,77,75,3,2,"EQUO",0
29,"29066",363,263,260,1,3,"EQUO",0
10,"10096",3384,2581,2533,32,48,"EQUO",41
42,"42026",25,16,16,0,0,"EQUO",0
9,"9466",151,111,110,1,1,"EQUO",0
31,"31253",123,102,97,0,5,"EQUO",1
20,"20055",17856,11885,11791,91,94,"EQUO",87
45,"45079",368,278,273,1,5,"EQUO",4
24,"24165",400,284,279,4,5,"EQUO",2
9,"9228",168,143,143,3,0,"EQUO",3
36,"36041",13141,9405,9238,114,167,"EQUO",61
6,"6018",808,608,598,5,10,"EQUO",1
9,"9251",417,292,288,3,4,"EQUO",0
9,"9180",132,97,95,8,2,"EQUO",0
9,"9377",658,509,505,11,4,"EQUO",1
50,"50055",3592,2520,2473,59,47,"EQUO",12
16,"16250",94,71,71,0,0,"EQUO",1
9,"9361",134,99,98,0,1,"EQUO",4
10,"10165",274,231,229,0,2,"EQUO",0
37,"37313",581,440,435,7,5,"EQUO",1
15,"15076",2766,1971,1936,18,35,"EQUO",3
4,"4049",4981,3652,3630,34,22,"EQUO",17
5,"5242",692,556,553,18,3,"EQUO",0
50,"50192",240,188,184,9,4,"EQUO",0
39,"39005",1319,1048,1026,3,22,"EQUO",4
11,"11036",725,484,482,10,2,"EQUO",0
20,"20073",4689,3196,3176,28,20,"EQUO",29
48,"48070",559,413,407,1,6,"EQUO",0
33,"33049",6806,4629,4581,70,48,"EQUO",26
26,"26101",46,35,34,0,1,"EQUO",0
9,"9124",1598,1151,1129,19,22,"EQUO",6
9,"9434",1167,916,902,24,14,"EQUO",6
9,"9181",334,271,271,14,0,"EQUO",2
40,"40075",182,149,146,4,3,"EQUO",4
48,"48042",1401,1116,1099,15,17,"EQUO",16
10,"10031",189,158,158,1,0,"EQUO",1
6,"6134",561,399,398,5,1,"EQUO",0
28,"28029",538,416,414,4,2,"EQUO",17
45,"45046",2455,1884,1862,11,22,"EQUO",9
48,"48053",856,683,680,8,3,"EQUO",2
5,"5149",128,97,97,1,0,"EQUO",0
29,"29074",818,631,630,3,1,"EQUO",0
28,"28130",27391,21367,21111,235,256,"EQUO",267
42,"42105",54,45,45,0,0,"EQUO",0
10,"10204",489,364,351,3,13,"EQUO",10
37,"37323",549,427,418,6,9,"EQUO",0
19,"19004",67,56,56,0,0,"EQUO",0
22,"22142",114,91,91,2,0,"EQUO",1
42,"42196",14,11,11,0,0,"EQUO",0
47,"47022",62,54,54,0,0,"EQUO",0
37,"37242",99,73,72,0,1,"EQUO",0
33,"33050",653,406,402,0,4,"EQUO",2
42,"42182",62,53,53,2,0,"EQUO",0
47,"47031",203,149,149,0,0,"EQUO",0
50,"50204",2519,1823,1804,24,19,"EQUO",12
36,"36057",236900,168990,166060,2833,2930,"EQUO",1767
5,"5182",862,673,668,2,5,"EQUO",6
16,"16188",106,76,76,0,0,"EQUO",1
18,"18099",1551,1217,1205,11,12,"EQUO",20
23,"23026",3872,3051,2994,23,57,"EQUO",2
16,"16129",112,79,74,0,5,"EQUO",0
50,"50281",76,63,63,2,0,"EQUO",0
1,"1023",290,236,235,1,1,"EQUO",2
37,"37073",583,458,455,7,3,"EQUO",0
5,"5152",737,618,609,5,9,"EQUO",1
16,"16102",1320,1016,1007,15,9,"EQUO",1
15,"15080",1913,1407,1389,15,18,"EQUO",0
24,"24179",331,219,214,4,5,"EQUO",1
42,"42198",24,17,17,0,0,"EQUO",0
5,"5162",107,71,71,0,0,"EQUO",2
19,"19248",64,53,53,0,0,"EQUO",1
9,"9201",33,22,22,2,0,"EQUO",0
14,"14023",2084,1809,1787,13,22,"EQUO",2
37,"37332",78,52,49,0,3,"EQUO",0
48,"48907",351,290,290,1,0,"EQUO",2
22,"22184",203,172,167,2,5,"EQUO",6
14,"14017",10755,8220,8149,101,71,"EQUO",26
21,"21010",14308,8960,8861,154,99,"EQUO",74
14,"14011",595,498,497,4,1,"EQUO",0
31,"31063",96,77,75,0,2,"EQUO",1
19,"19324",199,151,151,2,0,"EQUO",2
50,"50009",122,93,93,0,0,"EQUO",1
19,"19327",551,459,449,3,10,"EQUO",1
10,"10018",1761,1321,1296,17,25,"EQUO",6
41,"41021",20767,14040,13822,240,218,"EQUO",131
6,"6083",45013,31929,31491,527,438,"EQUO",292
40,"40086",738,628,619,12,9,"EQUO",3
47,"47042",63,50,49,3,1,"EQUO",0
26,"26037",150,129,128,1,1,"EQUO",0
45,"45047",2404,1685,1662,7,23,"EQUO",13
28,"28018",3572,2837,2795,20,42,"EQUO",63
2,"2080",580,450,443,4,7,"EQUO",1
41,"41060",15176,10797,10693,114,104,"EQUO",58
37,"37194",271,206,204,0,2,"EQUO",0
5,"5155",60,44,44,1,0,"EQUO",1
29,"29089",3343,2514,2489,14,25,"EQUO",2
16,"16119",181,130,130,0,0,"EQUO",3
47,"47078",178,159,154,7,5,"EQUO",0
9,"9388",32,25,24,2,1,"EQUO",0
40,"40118",59,44,43,1,1,"EQUO",1
45,"45011",316,271,268,1,3,"EQUO",0
13,"13071",41043,28435,28183,370,252,"EQUO",150
47,"47026",59,46,46,1,0,"EQUO",0
6,"6016",3013,2363,2306,31,57,"EQUO",3
16,"16193",77,68,67,0,1,"EQUO",0
45,"45049",394,315,315,6,0,"EQUO",3
48,"48089",2878,2120,2089,19,31,"EQUO",25
5,"5263",175,133,131,0,2,"EQUO",0
30,"30006",823,719,711,5,8,"EQUO",3
9,"9035",336,255,251,3,4,"EQUO",3
5,"5166",235,181,178,1,3,"EQUO",0
50,"50033",81,64,64,0,0,"EQUO",1
48,"48005",93,65,64,0,1,"EQUO",0
9,"9303",92,64,64,0,0,"EQUO",0
19,"19227",95,64,63,1,1,"EQUO",0
16,"16015",407,311,311,4,0,"EQUO",0
40,"40112",2346,1848,1798,35,50,"EQUO",24
19,"19283",40,33,33,0,0,"EQUO",0
26,"26117",2152,1682,1655,20,27,"EQUO",11
48,"48035",379,304,301,0,3,"EQUO",6
15,"15022",6102,4207,4164,52,43,"EQUO",13
37,"37089",74,54,54,2,0,"EQUO",1
50,"50133",126,101,100,1,1,"EQUO",0
22,"22174",520,401,394,11,7,"EQUO",0
31,"31260",1263,788,780,11,8,"EQUO",6
48,"48068",1577,1224,1213,4,11,"EQUO",9
18,"18021",16026,11376,11219,186,157,"EQUO",89
26,"26028",135,108,106,2,2,"EQUO",0
10,"10177",1692,1351,1318,15,33,"EQUO",7
47,"47028",31,21,20,0,1,"EQUO",0
5,"5264",68,48,48,1,0,"EQUO",0
42,"42142",55,41,38,2,3,"EQUO",2
26,"26001",211,174,168,3,6,"EQUO",0
40,"40121",325,266,262,3,4,"EQUO",2
31,"31241",164,117,116,4,1,"EQUO",0
31,"31189",1229,745,740,5,5,"EQUO",5
22,"22106",25,17,17,0,0,"EQUO",0
30,"30043",24501,19738,19416,230,322,"EQUO",104
31,"31058",240,184,179,0,5,"EQUO",1
23,"23035",1066,919,912,3,7,"EQUO",3
16,"16066",2402,2064,1997,32,67,"EQUO",3
10,"10085",334,244,243,1,1,"EQUO",0
22,"22160",219,166,166,5,0,"EQUO",2
14,"14016",1406,1123,1115,9,8,"EQUO",6
28,"28035",1314,1058,1046,3,12,"EQUO",18
33,"33025",9455,6331,6277,84,54,"EQUO",22
50,"50045",1289,1011,992,14,19,"EQUO",5
13,"13064",1465,1127,1110,21,17,"EQUO",8
33,"33018",2971,2139,2121,32,18,"EQUO",5
50,"50075",89,74,74,1,0,"EQUO",0
47,"47029",61,54,53,0,1,"EQUO",0
22,"22244",61,46,44,1,2,"EQUO",1
28,"28060",1471,1205,1192,8,13,"EQUO",5
16,"16258",288,215,213,1,2,"EQUO",1
26,"26145",251,201,199,3,2,"EQUO",2
26,"26106",78,70,69,0,1,"EQUO",1
45,"45114",608,476,468,3,8,"EQUO",0
42,"42128",43,38,38,2,0,"EQUO",0
31,"31236",1333,887,874,15,13,"EQUO",1
20,"20906",117,89,89,0,0,"EQUO",2
37,"37268",113,78,77,1,1,"EQUO",0
47,"47126",49,43,42,1,1,"EQUO",0
9,"9423",34,28,28,1,0,"EQUO",0
40,"40091",140,111,109,1,2,"EQUO",3
26,"26005",2251,1602,1580,18,22,"EQUO",7
31,"31100",298,193,193,2,0,"EQUO",1
19,"19042",41,32,32,0,0,"EQUO",2
14,"14048",1244,975,970,5,5,"EQUO",0
45,"45042",184,154,151,3,3,"EQUO",3
50,"50038",1583,1194,1174,29,20,"EQUO",10
40,"40172",34,27,26,0,1,"EQUO",0
30,"30028",6810,5333,5251,44,82,"EQUO",13
39,"39094",927,702,691,0,11,"EQUO",4
4,"4027",260,186,186,0,0,"EQUO",0
42,"42079",32,25,25,0,0,"EQUO",0
42,"42130",70,55,54,2,1,"EQUO",0
31,"31245",87,59,58,5,1,"EQUO",0
42,"42004",2383,1776,1740,30,36,"EQUO",3
22,"22110",822,602,588,3,14,"EQUO",3
16,"16203",9839,7520,7342,101,178,"EQUO",36
10,"10089",1399,1043,1032,15,11,"EQUO",1
45,"45081",16099,12232,12079,154,153,"EQUO",85
16,"16908",227,181,179,1,2,"EQUO",0
47,"47066",1114,891,888,10,3,"EQUO",10
47,"47149",44,22,20,0,2,"EQUO",0
39,"39095",2292,1824,1801,24,23,"EQUO",7
20,"20017",8670,5923,5890,27,33,"EQUO",18
50,"50234",251,201,191,13,10,"EQUO",1
18,"18154",1062,770,769,0,1,"EQUO",1
22,"22144",258,203,203,5,0,"EQUO",1
29,"29022",202,142,141,2,1,"EQUO",1
50,"50087",31,25,25,0,0,"EQUO",0
15,"15008",5657,4224,4157,62,67,"EQUO",36
47,"47035",956,778,768,5,10,"EQUO",1
20,"20006",277,177,175,6,2,"EQUO",3
45,"45143",1302,916,901,6,15,"EQUO",4
13,"13002",1576,1143,1134,4,9,"EQUO",1
16,"16199",27,20,19,0,1,"EQUO",0
28,"28091",5202,3714,3671,34,43,"EQUO",31
19,"19224",119,95,94,0,1,"EQUO",0
22,"22903",672,555,547,6,8,"EQUO",1
40,"40134",769,628,620,19,8,"EQUO",2
10,"10136",289,229,228,0,1,"EQUO",1
47,"47044",325,257,252,1,5,"EQUO",0
22,"22055",347,291,289,5,2,"EQUO",1
31,"31026",154,125,122,1,3,"EQUO",1
4,"4059",1231,837,830,8,7,"EQUO",2
50,"50295",54,42,41,0,1,"EQUO",0
24,"24034",3434,2524,2481,37,43,"EQUO",20
13,"13092",1924,1655,1635,4,20,"EQUO",1
9,"9276",420,275,245,5,30,"EQUO",15
9,"9020",276,222,222,6,0,"EQUO",1
47,"47086",4062,3162,3120,37,42,"EQUO",8
10,"10133",1247,1045,1028,7,17,"EQUO",1
26,"26078",85,69,69,0,0,"EQUO",1
31,"31065",1927,1391,1362,39,29,"EQUO",9
40,"40206",179,136,134,0,2,"EQUO",2
9,"9021",62,33,33,1,0,"EQUO",0
16,"16035",287,216,213,2,3,"EQUO",0
31,"31217",382,256,244,5,12,"EQUO",0
16,"16209",153,129,129,0,0,"EQUO",3
20,"20009",11794,7805,7725,103,80,"EQUO",80
9,"9297",326,270,266,7,4,"EQUO",2
16,"16134",4283,3398,3361,59,37,"EQUO",31
26,"26012",17,15,15,1,0,"EQUO",0
16,"16010",184,135,133,1,2,"EQUO",0
45,"45146",117,99,98,0,1,"EQUO",0
10,"10148",32554,23348,22955,365,393,"EQUO",239
45,"45110",1918,1585,1570,10,15,"EQUO",1
10,"10012",615,525,520,4,5,"EQUO",0
50,"50043",258,170,166,2,4,"EQUO",0
16,"16125",1734,1367,1350,12,17,"EQUO",4
9,"9214",724,477,467,4,10,"EQUO",5
45,"45188",2883,2180,2151,30,29,"EQUO",11
39,"39008",13716,10396,10274,129,122,"EQUO",60
47,"47100",169,146,144,1,2,"EQUO",0
9,"9410",3181,2079,2049,48,30,"EQUO",27
26,"26009",426,318,313,4,5,"EQUO",5
29,"29057",413,311,308,2,3,"EQUO",5
24,"24180",1196,868,862,22,6,"EQUO",3
5,"5260",114,101,101,1,0,"EQUO",0
42,"42111",310,228,222,2,6,"EQUO",6
37,"37041",80,53,53,1,0,"EQUO",0
6,"6038",816,621,620,6,1,"EQUO",4
9,"9026",384,296,295,8,1,"EQUO",2
22,"22069",436,317,315,5,2,"EQUO",3
40,"40150",76,62,62,1,0,"EQUO",3
31,"31192",148,107,104,1,3,"EQUO",6
24,"24215",169,121,120,1,1,"EQUO",0
26,"26127",236,206,204,1,2,"EQUO",0
39,"39039",648,496,493,0,3,"EQUO",0
19,"19254",57,50,50,0,0,"EQUO",0
48,"48062",317,263,262,1,1,"EQUO",2
18,"18908",827,669,660,7,9,"EQUO",2
31,"31221",1182,774,767,12,7,"EQUO",10
42,"42192",43,36,36,2,0,"EQUO",0
37,"37312",278,232,229,1,3,"EQUO",0
31,"31262",219,158,157,4,1,"EQUO",3
45,"45150",471,388,382,1,6,"EQUO",0
50,"50065",59,37,37,2,0,"EQUO",0
47,"47063",107,87,87,2,0,"EQUO",0
47,"47037",194,160,159,1,1,"EQUO",0
9,"9378",42,26,26,0,0,"EQUO",0
37,"37082",869,663,650,3,13,"EQUO",0
28,"28079",2290453,1721837,1705310,17342,16527,"EQUO",38442
9,"9213",370,260,260,5,0,"EQUO",2
31,"31200",763,527,514,17,13,"EQUO",1
28,"28172",7648,6130,6076,65,54,"EQUO",92
50,"50125",421,284,280,1,4,"EQUO",1
28,"28071",77,57,55,0,2,"EQUO",1
45,"45024",1105,870,856,16,14,"EQUO",2
31,"31197",69,58,57,1,1,"EQUO",0
41,"41026",4273,3577,3538,15,39,"EQUO",10
9,"9394",805,594,588,13,6,"EQUO",9
28,"28030",1591,1268,1230,12,38,"EQUO",41
31,"31140",117,91,89,3,2,"EQUO",0
39,"39032",1576,1215,1209,10,6,"EQUO",4
15,"15006",5539,3940,3866,53,74,"EQUO",5
47,"47219",46,36,36,1,0,"EQUO",0
9,"9014",190,113,113,3,0,"EQUO",0
19,"19009",253,187,184,0,3,"EQUO",0
15,"15003",1936,1400,1382,19,18,"EQUO",2
9,"9431",124,102,100,2,2,"EQUO",1
45,"45099",3449,2451,2405,22,46,"EQUO",18
19,"19092",437,331,326,4,5,"EQUO",2
28,"28070",139,98,97,0,1,"EQUO",6
13,"13095",94,70,70,1,0,"EQUO",0
40,"40901",379,292,288,11,4,"EQUO",4
28,"28037",1598,1263,1250,10,13,"EQUO",0
5,"5201",557,444,437,2,7,"EQUO",1
4,"4074",2731,1959,1936,26,23,"EQUO",22
28,"28168",1144,821,810,15,11,"EQUO",11
45,"45068",164,135,133,1,2,"EQUO",1
22,"22904",908,660,653,14,7,"EQUO",5
13,"13056",10945,8173,8070,111,103,"EQUO",64
4,"4015",149,115,115,0,0,"EQUO",0
19,"19057",79,56,56,0,0,"EQUO",3
10,"10033",440,340,336,4,4,"EQUO",0
9,"9337",126,88,87,1,1,"EQUO",1
47,"47040",67,51,50,0,1,"EQUO",0
50,"50272",12481,8744,8642,176,102,"EQUO",58
10,"10197",143,96,94,1,2,"EQUO",1
26,"26021",2758,2190,2163,21,27,"EQUO",10
26,"26061",1552,1119,1099,31,20,"EQUO",11
26,"26048",29,27,26,1,1,"EQUO",0
22,"22078",468,302,301,8,1,"EQUO",2
42,"42166",68,49,48,1,1,"EQUO",0
50,"50021",42,34,33,1,1,"EQUO",0
40,"40174",402,292,290,5,2,"EQUO",3
19,"19074",81,69,69,0,0,"EQUO",3
29,"29037",227,170,170,0,0,"EQUO",1
18,"18901",583,374,368,3,6,"EQUO",10
9,"9348",150,122,122,2,0,"EQUO",1
37,"37051",90,72,72,0,0,"EQUO",0
19,"19142",259,191,190,0,1,"EQUO",0
45,"45034",1375,1108,1079,18,29,"EQUO",0
16,"16190",5151,4229,4144,52,85,"EQUO",18
22,"22162",135,107,107,3,0,"EQUO",0
10,"10185",587,457,450,1,7,"EQUO",0
31,"31022",544,378,369,1,9,"EQUO",0
29,"29001",4176,3339,3303,23,36,"EQUO",2
19,"19279",66,56,56,0,0,"EQUO",0
30,"30027",45194,35272,34973,366,299,"EQUO",256
48,"48082",38551,25768,25482,316,286,"EQUO",205
40,"40184",269,227,224,4,3,"EQUO",2
9,"9390",645,522,518,9,4,"EQUO",3
10,"10025",408,355,337,4,18,"EQUO",2
26,"26065",57,43,43,0,0,"EQUO",1
40,"40106",232,173,173,3,0,"EQUO",1
16,"16227",128,95,94,0,1,"EQUO",0
13,"13070",769,653,640,1,13,"EQUO",5
10,"10001",270,231,229,2,2,"EQUO",0
40,"40904",332,271,268,5,3,"EQUO",5
4,"4008",530,423,418,4,5,"EQUO",3
31,"31135",116,87,86,9,1,"EQUO",2
26,"26094",97,86,85,0,1,"EQUO",1
19,"19152",674,505,498,2,7,"EQUO",1
14,"14042",18991,14726,14495,290,231,"EQUO",107
48,"48088",148,110,109,0,1,"EQUO",0
9,"9289",1540,1127,1117,16,10,"EQUO",6
5,"5113",90,74,74,0,0,"EQUO",0
37,"37365",172,152,149,2,3,"EQUO",1
16,"16148",634,553,547,5,6,"EQUO",0
23,"23073",4671,3778,3735,19,43,"EQUO",21
40,"40162",420,320,314,1,6,"EQUO",0
37,"37234",376,275,272,2,3,"EQUO",1
42,"42120",148,91,91,4,0,"EQUO",0
20,"20069",146828,101992,101225,1287,767,"EQUO",1759
45,"45073",351,265,261,3,4,"EQUO",0
9,"9073",889,672,663,12,9,"EQUO",8
9,"9044",54,45,45,1,0,"EQUO",0
47,"47096",139,109,107,0,2,"EQUO",0
26,"26041",152,106,104,0,2,"EQUO",0
41,"41902",4682,3136,3101,34,35,"EQUO",7
50,"50220",59,43,43,1,0,"EQUO",0
47,"47135",93,77,76,0,1,"EQUO",0
14,"14037",3500,2662,2616,29,46,"EQUO",7
26,"26022",232,191,190,1,1,"EQUO",0
42,"42076",237,185,179,6,6,"EQUO",1
48,"48094",3299,2398,2377,15,21,"EQUO",4
16,"16131",154,116,115,0,1,"EQUO",0
47,"47055",212,169,168,3,1,"EQUO",1
31,"31039",94,65,61,0,4,"EQUO",2
15,"15030",201751,141022,138934,2981,2088,"EQUO",1479
9,"9315",362,267,265,9,2,"EQUO",1
10,"10125",925,705,689,3,16,"EQUO",2
28,"28136",618,527,516,2,11,"EQUO",3
20,"20023",451,260,259,2,1,"EQUO",0
24,"24015",2391,1812,1782,20,30,"EQUO",16
31,"31209",155,105,104,1,1,"EQUO",3
26,"26131",44,36,36,0,0,"EQUO",0
9,"9340",72,41,41,0,0,"EQUO",0
31,"31122",4506,3333,3281,76,52,"EQUO",49
24,"24207",320,274,272,5,2,"EQUO",3
37,"37002",152,90,89,1,1,"EQUO",0
45,"45117",800,679,668,7,11,"EQUO",0
22,"22214",131,101,100,2,1,"EQUO",0
19,"19125",54,42,42,2,0,"EQUO",0
10,"10048",299,232,231,0,1,"EQUO",0
42,"42183",131,95,94,7,1,"EQUO",0
33,"33058",1863,1307,1286,11,21,"EQUO",4
16,"16195",545,436,433,6,3,"EQUO",0
16,"16139",346,279,277,2,2,"EQUO",0
16,"16053",414,334,326,2,8,"EQUO",5
4,"4001",1139,890,884,6,6,"EQUO",3
5,"5214",46,23,23,1,0,"EQUO",0
9,"9259",239,178,177,2,1,"EQUO",0
37,"37380",57,45,44,1,1,"EQUO",0
5,"5178",392,310,304,2,6,"EQUO",0
5,"5179",231,206,204,2,2,"EQUO",0
48,"48011",9742,6697,6628,82,69,"EQUO",103
47,"47140",132,109,108,1,1,"EQUO",0
15,"15082",15075,11217,11046,187,171,"EQUO",114
9,"9373",485,332,331,5,1,"EQUO",0
50,"50117",131,101,100,1,1,"EQUO",2
50,"50091",56,39,39,1,0,"EQUO",0
14,"14067",3821,3105,3082,38,23,"EQUO",13
4,"4076",1325,1050,1041,7,9,"EQUO",6
9,"9338",220,173,168,5,5,"EQUO",4
47,"47132",45,40,40,0,0,"EQUO",0
37,"37085",4334,3254,3201,69,53,"EQUO",25
19,"19289",33,28,28,1,0,"EQUO",0
45,"45105",426,326,322,2,4,"EQUO",4
28,"28016",86,68,67,3,1,"EQUO",2
47,"47102",302,250,248,3,2,"EQUO",1
47,"47130",105,86,85,2,1,"EQUO",2
40,"40177",171,145,145,2,0,"EQUO",0
50,"50261",246,199,199,4,0,"EQUO",0
39,"39102",2330,1748,1731,13,17,"EQUO",15
28,"28100",3970,2903,2865,32,38,"EQUO",44
42,"42033",54,48,48,0,0,"EQUO",0
18,"18004",818,601,594,2,7,"EQUO",2
20,"20044",368,258,257,1,1,"EQUO",0
48,"48914",324,278,276,0,2,"EQUO",0
10,"10120",168,122,119,1,3,"EQUO",0
42,"42042",46,35,33,1,2,"EQUO",1
24,"24221",850,635,619,6,16,"EQUO",3
50,"50089",6673,4936,4877,120,59,"EQUO",35
45,"45118",1980,1412,1390,13,22,"EQUO",5
16,"16071",25,23,23,0,0,"EQUO",2
9,"9074",735,558,547,7,11,"EQUO",10
33,"33063",467,367,363,4,4,"EQUO",2
14,"14040",3821,2986,2949,40,37,"EQUO",8
26,"26112",270,201,200,0,1,"EQUO",2
36,"36016",1373,865,853,7,12,"EQUO",1
16,"16231",47,43,43,0,0,"EQUO",0
37,"37320",96,70,70,0,0,"EQUO",0
26,"26025",78,69,69,1,0,"EQUO",0
14,"14030",8519,6832,6753,64,79,"EQUO",28
48,"48030",626,487,483,0,4,"EQUO",0
42,"42188",64,51,51,0,0,"EQUO",2
22,"22220",192,138,136,5,2,"EQUO",4
45,"45084",2395,1879,1842,21,37,"EQUO",3
40,"40040",2677,1990,1966,24,24,"EQUO",6
5,"5102",1850,1487,1475,11,12,"EQUO",12
5,"5221",398,298,297,10,1,"EQUO",1
50,"50081",562,410,400,7,10,"EQUO",3
20,"20079",17229,12010,11927,143,83,"EQUO",117
19,"19058",6455,5028,4933,63,95,"EQUO",77
11,"11042",1232,933,922,4,11,"EQUO",4
40,"40030",520,432,425,9,7,"EQUO",2
31,"31196",40,35,35,1,0,"EQUO",0
50,"50274",78,45,45,1,0,"EQUO",0
48,"48041",721,588,585,9,3,"EQUO",8
31,"31044",276,224,223,0,1,"EQUO",2
24,"24133",379,279,279,0,0,"EQUO",0
22,"22186",217,173,173,3,0,"EQUO",1
37,"37068",386,291,287,6,4,"EQUO",1
45,"45160",1104,911,896,12,15,"EQUO",1
40,"40039",257,188,184,2,4,"EQUO",1
16,"16013",24,23,23,0,0,"EQUO",0
5,"5151",100,86,82,1,4,"EQUO",0
29,"29096",2880,2012,1971,28,41,"EQUO",12
29,"29043",2596,1670,1647,24,23,"EQUO",5
5,"5030",43,39,39,0,0,"EQUO",2
26,"26109",105,87,84,0,3,"EQUO",0
31,"31165",2868,2094,2046,43,48,"EQUO",11
50,"50052",100,82,82,0,0,"EQUO",0
31,"31034",43,29,29,0,0,"EQUO",0
37,"37285",457,349,347,2,2,"EQUO",1
41,"41019",4528,3194,3168,41,26,"EQUO",21
47,"47054",673,545,541,8,4,"EQUO",0
40,"40198",30,21,20,0,1,"EQUO",0
42,"42176",30,22,22,0,0,"EQUO",0
47,"47073",141,118,116,1,2,"EQUO",0
5,"5122",156,124,124,0,0,"EQUO",0
37,"37339",345,280,279,3,1,"EQUO",0
42,"42155",188,121,120,0,1,"EQUO",1
22,"22187",295,222,222,3,0,"EQUO",1
4,"4041",334,247,245,0,2,"EQUO",0
1,"1031",1229,916,899,13,17,"EQUO",7
50,"50001",130,96,96,0,0,"EQUO",0
10,"10070",765,614,613,5,1,"EQUO",0
4,"4023",144,116,116,2,0,"EQUO",0
48,"48043",4256,3066,3040,33,26,"EQUO",48
16,"16901",793,590,582,2,8,"EQUO",3
37,"37361",91,67,62,0,5,"EQUO",0
9,"9051",181,136,133,2,3,"EQUO",1
19,"19277",22,17,17,0,0,"EQUO",0
18,"18128",361,284,283,5,1,"EQUO",0
47,"47158",906,716,710,10,6,"EQUO",3
30,"30014",1686,1400,1387,10,13,"EQUO",2
50,"50122",68,47,45,2,2,"EQUO",0
13,"13081",684,553,527,1,26,"EQUO",0
31,"31227",8257,5987,5884,125,103,"EQUO",49
45,"45018",445,332,322,4,10,"EQUO",0
9,"9473",94,81,81,2,0,"EQUO",1
4,"4060",486,373,372,0,1,"EQUO",9
48,"48014",1211,838,834,4,4,"EQUO",21
50,"50258",54,37,37,0,0,"EQUO",1
26,"26029",33,25,24,1,1,"EQUO",0
28,"28023",4350,3425,3392,32,33,"EQUO",90
24,"24050",113,91,90,0,1,"EQUO",3
14,"14046",4587,3671,3641,35,30,"EQUO",9
42,"42003",76,54,51,0,3,"EQUO",0
48,"48065",3311,2340,2323,23,17,"EQUO",15
5,"5904",149,99,97,0,2,"EQUO",4
9,"9403",98,75,75,0,0,"EQUO",0
45,"45010",471,374,372,2,2,"EQUO",0
36,"36048",5416,4045,3971,55,74,"EQUO",28
18,"18029",1892,1355,1347,6,8,"EQUO",6
9,"9405",143,106,105,2,1,"EQUO",1
26,"26180",243,185,181,4,4,"EQUO",2
10,"10079",891,711,706,6,5,"EQUO",5
42,"42088",69,56,56,1,0,"EQUO",0
40,"40068",39,32,32,0,0,"EQUO",0
9,"9102",44,36,36,0,0,"EQUO",0
16,"16132",36,31,31,0,0,"EQUO",0
19,"19195",41,30,30,1,0,"EQUO",0
18,"18032",248,166,166,2,0,"EQUO",1
21,"21014",4063,3424,3408,27,16,"EQUO",6
18,"18024",882,696,688,12,8,"EQUO",1
42,"42036",52,40,39,2,1,"EQUO",0
37,"37219",197,121,120,0,1,"EQUO",0
14,"14001",3633,3095,3064,25,31,"EQUO",4
40,"40051",54,41,40,0,1,"EQUO",2
50,"50292",138,117,115,4,2,"EQUO",0
26,"26033",183,157,156,2,1,"EQUO",2
31,"31206",2079,1517,1475,33,42,"EQUO",15
30,"30901",10113,8265,8194,70,71,"Eb",16
44,"44176",167,131,130,5,1,"Eb",0
28,"28165",1689,1310,1295,5,15,"Eb",0
49,"49166",1294,1003,988,29,15,"Eb",1
19,"19265",157,102,101,0,1,"Eb",0
19,"19190",2499,1829,1785,32,44,"Eb",9
18,"18119",1778,1401,1391,14,10,"Eb",3
37,"37263",361,277,275,1,2,"Eb",0
41,"41012",3115,2314,2271,29,43,"Eb",7
33,"33064",237,175,173,1,2,"Eb",1
44,"44190",81,52,52,0,0,"Eb",0
28,"28069",51,35,33,1,2,"Eb",0
28,"28007",122891,95200,94139,990,1061,"Eb",371
37,"37376",2373,1720,1700,23,20,"Eb",3
49,"49109",657,534,529,12,5,"Eb",1
49,"49194",380,250,247,4,3,"Eb",1
50,"50155",119,91,91,1,0,"Eb",0
50,"50241",634,462,455,2,7,"Eb",2
13,"13075",212,161,159,1,2,"Eb",0
44,"44047",267,162,160,4,2,"Eb",2
18,"18049",632,476,474,5,2,"Eb",0
28,"28095",1358,1092,1077,8,15,"Eb",2
50,"50071",134,97,96,0,1,"Eb",0
37,"37195",48,32,32,0,0,"Eb",0
49,"49083",67,48,48,1,0,"Eb",0
41,"41021",20767,14040,13822,240,218,"Eb",36
19,"19099",337,211,210,6,1,"Eb",1
19,"19209",50,40,39,0,1,"Eb",0
11,"11901",5576,4433,4398,69,35,"Eb",4
18,"18097",1022,758,752,4,6,"Eb",0
28,"28072",5232,4065,4007,35,58,"Eb",14
28,"28061",19624,15082,14905,162,177,"Eb",62
50,"50062",1750,1298,1275,22,23,"Eb",10
50,"50072",181,128,127,1,1,"Eb",0
49,"49244",48,30,30,1,0,"Eb",0
50,"50297",495260,360632,355561,7046,5071,"Eb",2032
50,"50225",1638,1079,1062,7,17,"Eb",1
19,"19156",1032,782,762,4,20,"Eb",1
37,"37159",100,77,75,0,2,"Eb",0
28,"28158",632,505,495,4,10,"Eb",1
30,"30037",17942,13830,13734,90,96,"Eb",28
19,"19148",56,41,38,1,3,"Eb",0
29,"29080",6598,4703,4663,31,40,"Eb",15
30,"30040",733,640,635,2,5,"Eb",2
48,"48030",626,487,483,0,4,"Eb",0
37,"37035",220,176,173,1,3,"Eb",0
49,"49224",161,114,112,2,2,"Eb",0
44,"44169",403,285,278,0,7,"Eb",0
18,"18147",3742,2419,2386,20,33,"Eb",5
28,"28076",417,325,321,1,4,"Eb",1
14,"14036",3774,2928,2909,51,19,"Eb",6
18,"18144",779,592,590,3,2,"Eb",1
14,"14029",4380,3344,3308,35,36,"Eb",3
44,"44193",99,71,67,0,4,"Eb",0
19,"19152",674,505,498,2,7,"Eb",0
44,"44137",215,165,163,5,2,"Eb",0
49,"49056",324,251,247,3,4,"Eb",1
37,"37182",92,72,72,2,0,"Eb",0
41,"41046",3055,2456,2418,23,38,"Eb",2
11,"11034",2381,1807,1784,19,23,"Eb",2
28,"28055",932,713,707,5,6,"Eb",1
44,"44145",1078,723,714,26,9,"Eb",0
50,"50205",98,72,71,2,1,"Eb",0
21,"21046",1715,1354,1343,15,11,"Eb",0
11,"11018",1528,1194,1178,9,16,"Eb",0
14,"14016",1406,1123,1115,9,8,"Eb",0
37,"37023",1040,819,811,11,8,"Eb",2
19,"19138",298,223,219,3,4,"Eb",0
37,"37290",143,111,110,1,1,"Eb",0
29,"29902",2577,1689,1665,20,24,"Eb",1
49,"49121",382,270,270,1,0,"Eb",0
37,"37031",399,308,307,5,1,"Eb",0
37,"37149",78,69,69,0,0,"Eb",0
18,"18114",678,508,508,6,0,"Eb",1
21,"21035",9657,6943,6871,64,72,"Eb",23
29,"29035",1717,1280,1270,14,10,"Eb",2
2,"2029",3210,2512,2481,37,31,"Eb",11
37,"37150",43,36,34,0,2,"Eb",0
41,"41056",3697,3041,3008,25,33,"Eb",1
18,"18085",818,538,532,4,6,"Eb",1
49,"49098",242,177,175,4,2,"Eb",0
41,"41026",4273,3577,3538,15,39,"Eb",6
14,"14019",6486,5288,5243,65,45,"Eb",6
49,"49155",105,85,85,0,0,"Eb",1
37,"37371",285,190,190,2,0,"Eb",0
50,"50234",251,201,191,13,10,"Eb",0
19,"19166",179,123,121,4,2,"Eb",0
48,"48093",893,707,695,1,12,"Eb",2
50,"50231",285,231,224,7,7,"Eb",2
50,"50207",126,97,95,1,2,"Eb",0
18,"18912",1576,1193,1185,7,8,"Eb",0
19,"19054",184,156,151,2,5,"Eb",0
33,"33005",1600,1084,1080,6,4,"Eb",2
14,"14057",6115,5040,4975,71,65,"Eb",16
50,"50221",38,20,20,0,0,"Eb",0
37,"37113",439,365,365,7,0,"Eb",0
19,"19233",108,93,90,2,3,"Eb",1
18,"18141",484,326,325,1,1,"Eb",0
2,"2015",1508,1230,1211,7,19,"Eb",3
18,"18153",8348,6170,6118,88,52,"Eb",17
48,"48082",38551,25768,25482,316,286,"Eb",85
50,"50219",3704,2672,2625,39,47,"Eb",18
33,"33074",3699,2643,2611,30,32,"Eb",4
50,"50052",100,82,82,0,0,"Eb",0
41,"41069",28331,21065,20877,252,188,"Eb",50
29,"29076",2022,1384,1374,14,10,"Eb",0
44,"44004",450,334,332,2,2,"Eb",4
21,"21065",295,212,211,0,1,"Eb",1
41,"41096",6079,4673,4595,47,78,"Eb",19
19,"19033",79,55,55,0,0,"Eb",0
49,"49230",122,98,95,1,3,"Eb",0
19,"19198",22,19,19,0,0,"Eb",0
49,"49200",1011,789,771,6,18,"Eb",2
18,"18015",465,381,379,1,2,"Eb",0
19,"19240",64,47,46,1,1,"Eb",0
28,"28901",765,579,567,2,12,"Eb",2
19,"19255",95,68,68,0,0,"Eb",0
13,"13060",291,235,229,0,6,"Eb",0
28,"28179",1385,1039,1027,10,12,"Eb",2
37,"37235",226,194,192,0,2,"Eb",0
44,"44093",86,64,64,3,0,"Eb",0
28,"28159",629,482,478,2,4,"Eb",1
28,"28162",2263,1802,1786,32,16,"Eb",5
49,"49159",289,225,225,2,0,"Eb",3
13,"13094",338,276,275,2,1,"Eb",0
50,"50218",113,92,92,0,0,"Eb",0
37,"37178",107,88,87,0,1,"Eb",0
37,"37192",362,229,221,3,8,"Eb",2
44,"44198",205,160,160,5,0,"Eb",1
19,"19178",45,34,34,0,0,"Eb",0
2,"2045",3763,3086,3035,42,51,"Eb",11
37,"37309",42,26,25,3,1,"Eb",0
28,"28016",86,68,67,3,1,"Eb",0
28,"28004",5761,4098,4044,38,54,"Eb",12
41,"41018",9457,6940,6867,66,73,"Eb",14
41,"41090",3488,2792,2751,22,41,"Eb",9
49,"49018",341,281,279,5,2,"Eb",0
49,"49223",770,606,601,8,5,"Eb",3
13,"13034",56981,42819,42306,742,513,"Eb",277
37,"37176",136,103,100,1,3,"Eb",0
44,"44219",207,159,157,1,2,"Eb",1
50,"50269",316,186,185,1,1,"Eb",0
44,"44175",138,111,111,4,0,"Eb",2
19,"19134",22,14,14,0,0,"Eb",0
19,"19108",117,97,95,0,2,"Eb",0
13,"13016",708,555,553,2,2,"Eb",0
14,"14026",2043,1434,1421,10,13,"Eb",0
48,"48084",23491,15322,15084,213,238,"Eb",106
49,"49183",111,87,87,2,0,"Eb",0
2,"2028",139,115,115,1,0,"Eb",0
37,"37327",191,148,148,9,0,"Eb",0
28,"28050",3576,2706,2663,21,43,"Eb",10
37,"37107",11407,8234,8116,123,118,"Eb",18
28,"28153",608,422,406,1,16,"Eb",2
50,"50048",43,33,33,1,0,"Eb",0
37,"37255",58,47,47,3,0,"Eb",0
19,"19165",51,43,42,0,1,"Eb",0
19,"19297",34,29,29,0,0,"Eb",0
37,"37230",221,173,171,0,2,"Eb",0
44,"44223",80,55,55,0,0,"Eb",0
49,"49103",435,354,350,6,4,"Eb",1
37,"37300",586,430,421,6,9,"Eb",2
37,"37322",2501,1692,1676,32,16,"Eb",6
41,"41049",8898,6881,6812,95,69,"Eb",15
44,"44021",114,81,77,1,4,"Eb",0
13,"13098",2265,1805,1759,19,46,"Eb",11
28,"28169",1244,971,962,8,9,"Eb",3
37,"37298",206,144,140,1,4,"Eb",1
49,"49010",338,271,265,4,6,"Eb",3
48,"48001",5842,4040,4020,23,20,"Eb",12
18,"18187",587,432,432,0,0,"Eb",0
21,"21076",2108,1647,1628,22,19,"Eb",2
37,"37027",242,196,192,2,4,"Eb",2
21,"21032",1790,1362,1347,14,15,"Eb",2
50,"50157",313,253,250,7,3,"Eb",0
18,"18902",950,769,762,6,7,"Eb",1
37,"37134",250,192,189,1,3,"Eb",0
50,"50181",1053,787,760,9,27,"Eb",1
37,"37219",197,121,120,0,1,"Eb",0
11,"11006",24221,16564,16470,197,94,"Eb",197
44,"44266",134,107,105,2,2,"Eb",0
19,"19261",42,31,31,1,0,"Eb",0
13,"13012",475,322,318,1,4,"Eb",2
48,"48074",3384,2441,2397,20,44,"Eb",8
18,"18044",208,132,132,4,0,"Eb",1
13,"13017",307,230,226,0,4,"Eb",0
21,"21039",313,233,232,2,1,"Eb",1
37,"37130",177,153,153,2,0,"Eb",1
50,"50293",492,339,338,6,1,"Eb",0
49,"49188",142,101,100,3,1,"Eb",0
33,"33010",1922,1284,1277,14,7,"Eb",1
37,"37373",793,591,589,4,2,"Eb",0
44,"44208",32,23,23,1,0,"Eb",0
37,"37254",189,168,164,1,4,"Eb",0
33,"33018",2971,2139,2121,32,18,"Eb",5
44,"44189",69,57,57,0,0,"Eb",0
44,"44084",63,51,50,0,1,"Eb",0
49,"49021",14682,10495,10296,194,199,"Eb",65
49,"49236",86,64,64,0,0,"Eb",0
37,"37141",158,140,139,1,1,"Eb",0
37,"37375",764,636,627,19,9,"Eb",0
50,"50077",254,189,188,4,1,"Eb",0
28,"28170",2503,1744,1727,20,17,"Eb",1
50,"50211",277,193,193,1,0,"Eb",0
48,"48906",796,625,622,5,3,"Eb",0
21,"21049",3468,2327,2283,18,44,"Eb",6
29,"29077",225,157,157,1,0,"Eb",1
33,"33047",1178,939,931,2,8,"Eb",4
49,"49220",161,122,118,5,4,"Eb",1
49,"49247",507,340,332,6,8,"Eb",0
28,"28073",11899,8877,8769,112,108,"Eb",41
28,"28040",15089,9976,9852,116,124,"Eb",32
14,"14052",9720,6444,6384,58,60,"Eb",16
30,"30010",6804,5691,5647,36,44,"Eb",8
41,"41029",13231,9756,9610,128,146,"Eb",29
49,"49126",232,175,173,3,2,"Eb",1
37,"37364",893,653,644,10,9,"Eb",0
49,"49162",217,157,155,2,2,"Eb",3
19,"19015",104,88,87,0,1,"Eb",0
37,"37367",218,182,176,0,6,"Eb",0
19,"19047",87,71,70,2,1,"Eb",0
2,"2079",2936,2305,2235,29,70,"Eb",3
37,"37260",175,122,122,1,0,"Eb",0
13,"13082",25643,17973,17798,257,175,"Eb",83
37,"37025",264,217,216,1,1,"Eb",0
13,"13028",10536,8503,8331,140,172,"Eb",32
2,"2033",1955,1565,1536,15,29,"Eb",3
50,"50107",953,785,780,13,5,"Eb",3
19,"19326",1125,800,786,10,14,"Eb",1
48,"48007",354,254,253,1,1,"Eb",0
19,"19058",6455,5028,4933,63,95,"Eb",30
29,"29086",814,538,536,9,2,"Eb",0
37,"37342",252,216,211,3,5,"Eb",2
19,"19303",56,48,47,1,1,"Eb",0
44,"44099",724,519,511,4,8,"Eb",1
18,"18042",425,344,342,2,2,"Eb",4
29,"29087",409,306,305,3,1,"Eb",0
2,"2016",600,471,468,5,3,"Eb",0
18,"18051",1196,857,852,4,5,"Eb",0
19,"19042",41,32,32,0,0,"Eb",0
50,"50256",90,59,59,1,0,"Eb",0
49,"49205",429,313,309,10,4,"Eb",0
48,"48004",329,240,239,2,1,"Eb",0
50,"50294",77,58,57,0,1,"Eb",0
49,"49095",318,232,232,5,0,"Eb",0
41,"41015",5263,3820,3752,34,68,"Eb",9
49,"49041",443,337,334,7,3,"Eb",1
41,"41009",1272,914,899,8,15,"Eb",0
37,"37234",376,275,272,2,3,"Eb",0
49,"49097",97,55,55,1,0,"Eb",0
29,"29046",2777,2032,2013,10,19,"Eb",6
44,"44035",122,99,98,3,1,"Eb",0
37,"37301",78,58,58,0,0,"Eb",0
49,"49146",330,268,265,6,3,"Eb",1
29,"29015",31805,22566,22347,272,219,"Eb",42
37,"37170",1571,1122,1107,22,15,"Eb",3
48,"48077",3398,2490,2477,33,13,"Eb",6
48,"48913",1231,936,922,10,14,"Eb",2
44,"44116",96,68,65,3,3,"Eb",0
37,"37242",99,73,72,0,1,"Eb",0
37,"37003",134,103,102,0,1,"Eb",0
28,"28140",2665,2167,2141,26,26,"Eb",7
13,"13009",1573,1265,1255,6,10,"Eb",5
18,"18057",5045,3755,3721,44,34,"Eb",6
48,"48075",1915,1362,1325,15,37,"Eb",5
49,"49264",652,439,435,2,4,"Eb",0
50,"50055",3592,2520,2473,59,47,"Eb",10
41,"41093",17665,13712,13526,179,186,"Eb",39
29,"29009",1525,1126,1109,9,17,"Eb",0
2,"2021",1114,872,860,7,12,"Eb",5
28,"28104",11704,9455,9361,119,94,"Eb",29
19,"19230",438,317,309,4,8,"Eb",2
29,"29089",3343,2514,2489,14,25,"Eb",0
19,"19098",22,18,18,0,0,"Eb",0
18,"18021",16026,11376,11219,186,157,"Eb",46
49,"49197",187,126,126,3,0,"Eb",0
50,"50106",137,107,106,0,1,"Eb",0
49,"49034",467,363,359,3,4,"Eb",1
48,"48050",216,173,172,0,1,"Eb",0
49,"49044",80,63,63,3,0,"Eb",0
18,"18162",947,726,721,8,5,"Eb",0
28,"28126",59,37,37,0,0,"Eb",0
19,"19232",89,68,67,0,1,"Eb",0
18,"18059",4055,3232,3191,37,41,"Eb",1
44,"44212",45,35,35,0,0,"Eb",1
19,"19199",24,21,21,0,0,"Eb",0
18,"18029",1892,1355,1347,6,8,"Eb",2
44,"44082",90,67,66,1,1,"Eb",1
28,"28181",20003,16133,15952,159,181,"Eb",56
37,"37316",792,565,559,7,6,"Eb",0
50,"50137",1119,842,834,12,8,"Eb",5
11,"11021",6838,5102,5049,67,53,"Eb",10
2,"2052",493,417,412,9,5,"Eb",1
37,"37163",44,36,36,0,0,"Eb",1
29,"29025",34637,22545,22354,268,191,"Eb",70
44,"44203",8,8,8,0,0,"Eb",0
18,"18082",912,691,683,8,8,"Eb",0
44,"44060",42,34,34,0,0,"Eb",0
44,"44216",25877,18461,18057,467,404,"Eb",132
11,"11040",411,317,309,0,8,"Eb",0
13,"13023",8731,6818,6732,94,86,"Eb",14
44,"44085",61,38,38,0,0,"Eb",0
18,"18043",140,89,87,1,2,"Eb",0
18,"18126",1461,1129,1121,15,8,"Eb",2
50,"50030",232,164,160,1,4,"Eb",1
37,"37026",201,176,176,3,0,"Eb",1
11,"11020",163674,106898,106082,1655,816,"Eb",402
37,"37241",172,135,134,1,1,"Eb",0
37,"37128",261,211,210,2,1,"Eb",0
37,"37188",198,164,160,7,4,"Eb",1
18,"18074",297,245,245,5,0,"Eb",0
18,"18098",6440,4743,4679,44,64,"Eb",4
18,"18027",2575,1913,1899,15,14,"Eb",3
13,"13055",738,585,578,8,7,"Eb",1
44,"44024",24,19,19,0,0,"Eb",0
44,"44037",483,349,344,10,5,"Eb",1
33,"33027",929,617,613,5,4,"Eb",0
18,"18045",1211,892,885,4,7,"Eb",2
13,"13090",1202,994,972,4,22,"Eb",2
18,"18039",3733,2901,2878,18,23,"Eb",5
19,"19293",1860,1407,1373,16,34,"Eb",4
37,"37167",164,140,132,6,8,"Eb",0
44,"44184",34,21,21,2,0,"Eb",0
28,"28114",148,110,110,0,0,"Eb",0
2,"2056",1816,1518,1506,15,12,"Eb",4
44,"44087",98,87,87,2,0,"Eb",4
19,"19250",25,23,22,0,1,"Eb",0
29,"29069",80337,50235,49723,690,512,"Eb",113
50,"50208",1831,1321,1305,24,16,"Eb",5
37,"37046",11929,8847,8683,146,164,"Eb",28
50,"50147",845,637,627,12,10,"Eb",2
11,"11014",16318,11093,11031,144,62,"Eb",28
18,"18189",723,547,541,6,6,"Eb",0
2,"2013",158,123,121,1,2,"Eb",3
37,"37091",181,127,119,0,8,"Eb",0
50,"50006",978,758,749,16,9,"Eb",1
19,"19322",35,28,27,1,1,"Eb",0
41,"41064",5629,4041,4006,28,35,"Eb",14
44,"44089",57,50,49,0,1,"Eb",0
19,"19197",29,19,19,0,0,"Eb",0
28,"28137",1626,1231,1222,9,9,"Eb",5
49,"49142",264,180,179,2,1,"Eb",1
48,"48078",39866,27311,26995,311,316,"Eb",98
13,"13050",533,427,421,3,6,"Eb",0
37,"37050",71,48,48,1,0,"Eb",0
28,"28117",116,90,90,1,0,"Eb",2
30,"30031",560,471,469,3,2,"Eb",0
49,"49104",383,281,276,2,5,"Eb",0
50,"50237",103,76,75,0,1,"Eb",1
37,"37126",36,26,26,0,0,"Eb",0
50,"50133",126,101,100,1,1,"Eb",0
33,"33070",3481,2557,2521,33,36,"Eb",12
18,"18079",3497,2729,2706,15,23,"Eb",2
50,"50116",220,154,153,0,1,"Eb",0
44,"44128",84,56,56,3,0,"Eb",0
19,"19167",136,112,109,4,3,"Eb",0
44,"44215",156,100,100,2,0,"Eb",0
18,"18136",1973,1679,1668,5,11,"Eb",0
50,"50074",6516,4378,4222,77,156,"Eb",25
28,"28177",9470,7524,7466,87,58,"Eb",23
18,"18038",1097,906,900,3,6,"Eb",0
50,"50174",107,92,90,0,2,"Eb",0
50,"50204",2519,1823,1804,24,19,"Eb",3
49,"49093",308,248,245,5,3,"Eb",0
11,"11017",3219,2403,2388,18,15,"Eb",2
14,"14056",23507,17245,17071,259,174,"Eb",40
44,"44160",473,315,312,8,3,"Eb",2
44,"44008",1695,1280,1257,11,23,"Eb",2
33,"33041",7488,5356,5309,65,47,"Eb",31
37,"37054",273,230,229,2,1,"Eb",0
41,"41020",12710,8954,8882,91,72,"Eb",12
28,"28071",77,57,55,0,2,"Eb",0
19,"19901",43,34,34,0,0,"Eb",0
50,"50065",59,37,37,2,0,"Eb",0
19,"19243",53,39,39,0,0,"Eb",0
28,"28064",143,112,110,1,2,"Eb",0
19,"19041",166,127,127,3,0,"Eb",1
2,"2070",439,372,366,4,6,"Eb",0
44,"44260",160,117,115,5,2,"Eb",0
49,"49005",156,102,101,2,1,"Eb",0
19,"19210",34,29,29,1,0,"Eb",0
37,"37244",132,97,95,5,2,"Eb",0
49,"49091",278,197,197,4,0,"Eb",0
33,"33017",3289,2378,2350,35,28,"Eb",6
29,"29073",1520,1032,1021,10,11,"Eb",2
41,"41019",4528,3194,3168,41,26,"Eb",4
41,"41073",1789,1292,1272,5,20,"Eb",1
33,"33039",1719,1325,1319,14,6,"Eb",1
50,"50252",5345,3860,3792,79,68,"Eb",15
50,"50195",48,38,38,1,0,"Eb",0
19,"19202",16,14,14,0,0,"Eb",0
44,"44177",120,85,85,1,0,"Eb",0
49,"49145",251,154,153,0,1,"Eb",0
30,"30007",6115,4651,4603,29,48,"Eb",3
18,"18011",4246,3195,3172,23,23,"Eb",4
19,"19046",20318,15118,14892,219,226,"Eb",72
13,"13902",497,396,394,3,2,"Eb",0
44,"44011",67,47,47,0,0,"Eb",0
29,"29058",1560,1103,1096,5,7,"Eb",2
48,"48062",317,263,262,1,1,"Eb",1
19,"19246",48,38,38,1,0,"Eb",0
33,"33020",13542,9300,9173,135,127,"Eb",35
19,"19258",103,81,81,0,0,"Eb",0
49,"49112",131,93,93,2,0,"Eb",2
19,"19192",1743,1370,1359,10,11,"Eb",2
37,"37330",338,272,270,3,2,"Eb",1
11,"11029",5360,3445,3423,27,22,"Eb",3
50,"50243",346,277,272,2,5,"Eb",1
30,"30011",4687,3776,3726,20,50,"Eb",6
19,"19216",143,112,105,2,7,"Eb",0
28,"28045",30286,23148,22879,226,269,"Eb",93
49,"49141",397,289,286,7,3,"Eb",2
14,"14030",8519,6832,6753,64,79,"Eb",24
44,"44050",3183,2208,2154,78,54,"Eb",12
44,"44258",75,56,55,0,1,"Eb",0
41,"41047",9810,7427,7321,99,106,"Eb",21
37,"37055",132,112,107,2,5,"Eb",0
41,"41050",5102,4224,4183,39,41,"Eb",6
44,"44234",76,63,63,0,0,"Eb",0
13,"13069",704,605,590,2,15,"Eb",0
37,"37331",234,161,161,3,0,"Eb",1
37,"37184",381,295,289,5,6,"Eb",0
50,"50139",372,280,278,3,2,"Eb",2
13,"13019",5254,4038,3978,62,60,"Eb",7
44,"44200",41,30,30,0,0,"Eb",0
19,"19252",90,80,78,0,2,"Eb",0
18,"18145",10083,7592,7499,78,93,"Eb",39
37,"37354",4828,3589,3522,76,67,"Eb",15
50,"50289",71,59,59,0,0,"Eb",0
28,"28102",913,700,693,9,7,"Eb",0
2,"2071",1053,899,895,5,4,"Eb",1
44,"44192",401,324,322,5,2,"Eb",2
13,"13022",403,314,314,2,0,"Eb",0
50,"50150",716,430,427,10,3,"Eb",1
37,"37047",178,111,111,0,0,"Eb",0
37,"37158",262,181,179,0,2,"Eb",1
29,"29024",414,271,261,6,10,"Eb",0
50,"50236",124,103,103,2,0,"Eb",0
28,"28176",10977,8790,8718,68,72,"Eb",33
41,"41086",15877,10246,10150,146,96,"Eb",32
49,"49025",187,143,142,3,1,"Eb",0
49,"49251",191,157,154,7,3,"Eb",0
37,"37022",287,237,232,0,5,"Eb",0
49,"49026",236,189,184,3,5,"Eb",0
50,"50042",16,14,14,0,0,"Eb",1
49,"49117",505,376,369,5,7,"Eb",1
33,"33023",3410,2501,2485,40,16,"Eb",10
41,"41078",2587,1979,1970,15,9,"Eb",1
41,"41052",2967,2305,2288,7,17,"Eb",3
49,"49147",301,243,239,4,4,"Eb",0
49,"49252",370,310,305,6,5,"Eb",0
44,"44103",128,95,95,0,0,"Eb",0
37,"37171",437,362,358,4,4,"Eb",0
48,"48056",849,610,608,3,2,"Eb",0
41,"41079",9349,7095,7001,71,94,"Eb",10
44,"44221",377,305,297,6,8,"Eb",0
50,"50152",1569,1151,1135,31,16,"Eb",1
19,"19126",1552,1140,1119,16,21,"Eb",5
37,"37310",154,115,115,1,0,"Eb",0
18,"18016",339,254,253,2,1,"Eb",0
37,"37217",60,49,48,1,1,"Eb",0
50,"50069",68,32,32,0,0,"Eb",1
50,"50015",109,73,73,0,0,"Eb",0
21,"21047",1965,1355,1325,17,30,"Eb",0
2,"2034",1419,1153,1146,18,7,"Eb",2
49,"49241",275,225,221,2,4,"Eb",0
30,"30033",9940,7794,7700,79,94,"Eb",10
11,"11025",4371,3260,3226,34,34,"Eb",4
30,"30902",7463,5291,5228,38,63,"Eb",19
44,"44036",27,17,17,0,0,"Eb",0
19,"19110",73,59,57,4,2,"Eb",0
37,"37211",223,169,169,1,0,"Eb",0
41,"41054",671,556,550,0,6,"Eb",0
29,"29026",1130,815,799,7,16,"Eb",1
19,"19127",97,66,66,1,0,"Eb",0
50,"50102",918,722,713,12,9,"Eb",1
49,"49242",503,421,410,5,11,"Eb",0
13,"13030",153,123,123,1,0,"Eb",0
44,"44107",233,161,154,3,7,"Eb",1
37,"37262",81,66,64,2,2,"Eb",0
50,"50192",240,188,184,9,4,"Eb",1
44,"44227",81,59,59,0,0,"Eb",0
18,"18048",2277,1705,1688,19,17,"Eb",3
37,"37251",137,98,93,3,5,"Eb",0
49,"49079",110,93,92,2,1,"Eb",0
44,"44061",89,55,55,1,0,"Eb",0
29,"29008",14069,9934,9859,118,75,"Eb",17
21,"21018",1821,1283,1273,19,10,"Eb",4
48,"48070",559,413,407,1,6,"Eb",0
11,"11036",725,484,482,10,2,"Eb",0
37,"37225",119,101,95,3,6,"Eb",1
33,"33048",169,120,120,1,0,"Eb",1
29,"29083",2212,1679,1652,15,27,"Eb",1
14,"14006",1326,1170,1148,12,22,"Eb",2
30,"30009",11961,9992,9880,92,112,"Eb",13
49,"49206",948,706,692,15,14,"Eb",1
19,"19096",99,79,78,1,1,"Eb",0
49,"49080",736,571,560,5,11,"Eb",1
18,"18183",685,502,500,3,2,"Eb",0
19,"19279",66,56,56,0,0,"Eb",0
49,"49076",333,260,257,10,3,"Eb",0
37,"37024",101,80,80,0,0,"Eb",0
21,"21033",508,385,382,7,3,"Eb",0
37,"37143",410,342,338,3,4,"Eb",0
41,"41025",1999,1502,1476,13,26,"Eb",2
49,"49105",158,135,133,2,2,"Eb",0
49,"49228",64,56,56,0,0,"Eb",0
19,"19154",79,68,67,0,1,"Eb",0
44,"44044",103,79,78,0,1,"Eb",1
48,"48091",1170,860,851,3,9,"Eb",1
37,"37261",255,191,191,2,0,"Eb",0
50,"50213",117,83,82,0,1,"Eb",0
21,"21021",11825,7657,7574,108,83,"Eb",35
44,"44178",69,45,44,0,1,"Eb",0
29,"29002",1246,896,893,11,3,"Eb",2
37,"37303",207,158,152,3,6,"Eb",0
19,"19170",214,139,138,0,1,"Eb",0
13,"13077",3654,2535,2480,31,55,"Eb",6
50,"50076",113,89,89,0,0,"Eb",1
2,"2040",631,569,566,3,3,"Eb",1
14,"14069",7733,5910,5824,68,86,"Eb",7
41,"41031",1319,879,875,6,4,"Eb",0
29,"29011",3013,1893,1876,7,17,"Eb",0
18,"18032",248,166,166,2,0,"Eb",1
37,"37378",118,85,85,3,0,"Eb",0
28,"28152",14903,11954,11865,125,89,"Eb",52
18,"18903",960,761,753,1,8,"Eb",1
44,"44025",6168,4326,4150,68,176,"Eb",18
19,"19121",277,219,217,0,2,"Eb",1
18,"18177",463,285,281,4,4,"Eb",0
29,"29096",2880,2012,1971,28,41,"Eb",1
19,"19037",153,128,128,0,0,"Eb",1
49,"49234",439,336,332,5,4,"Eb",0
28,"28167",7818,6016,5942,82,74,"Eb",30
50,"50159",728,554,544,4,10,"Eb",0
2,"2074",6093,4630,4548,57,82,"Eb",12
29,"29032",6673,5204,5140,43,64,"Eb",4
18,"18088",1576,1258,1253,2,5,"Eb",0
14,"14021",259993,183200,181402,2936,1798,"Eb",1061
50,"50282",88,66,63,3,3,"Eb",0
18,"18904",858,620,612,3,8,"Eb",1
29,"29007",25572,17726,17564,227,162,"Eb",58
49,"49269",241,171,170,5,1,"Eb",0
2,"2011",730,612,610,3,2,"Eb",2
18,"18149",5096,3949,3900,36,49,"Eb",6
28,"28156",958,742,733,12,9,"Eb",2
44,"44090",84,71,71,0,0,"Eb",0
49,"49232",95,78,78,1,0,"Eb",0
2,"2076",371,292,287,3,5,"Eb",0
49,"49169",42,34,33,1,1,"Eb",0
37,"37323",549,427,418,6,9,"Eb",0
33,"33015",1695,1177,1161,12,16,"Eb",3
28,"28138",78,48,46,0,2,"Eb",0
37,"37132",398,317,311,3,6,"Eb",1
13,"13059",232,186,184,0,2,"Eb",1
28,"28161",44185,33371,32966,353,405,"Eb",119
50,"50120",53,41,41,0,0,"Eb",0
44,"44155",1162,819,801,24,18,"Eb",6
48,"48022",2396,1524,1504,12,20,"Eb",1
18,"18035",1254,991,982,7,9,"Eb",1
41,"41101",5752,4663,4629,25,34,"Eb",4
41,"41060",15176,10797,10693,114,104,"Eb",20
2,"2044",1207,908,893,5,15,"Eb",0
49,"49267",101,77,77,1,0,"Eb",0
19,"19174",126,88,86,0,2,"Eb",0
49,"49088",90,67,66,3,1,"Eb",0
44,"44070",62,47,47,1,0,"Eb",0
41,"41035",1171,898,889,12,9,"Eb",0
50,"50162",160,108,108,2,0,"Eb",1
50,"50228",295,238,236,10,2,"Eb",0
19,"19307",30,27,27,0,0,"Eb",0
50,"50081",562,410,400,7,10,"Eb",0
21,"21056",2992,2172,2096,29,76,"Eb",9
18,"18046",1960,1327,1312,5,15,"Eb",7
2,"2009",19661,14804,14570,259,234,"Eb",112
49,"49118",215,174,173,2,1,"Eb",1
19,"19003",50,36,35,1,1,"Eb",0
14,"14054",13632,10857,10652,194,205,"Eb",30
28,"28101",222,158,158,4,0,"Eb",0
48,"48012",2036,1630,1616,9,14,"Eb",1
28,"28038",4999,3659,3590,32,69,"Eb",8
28,"28084",15408,11489,11355,122,134,"Eb",34
48,"48911",373,300,296,1,4,"Eb",0
44,"44199",52,40,39,0,1,"Eb",0
18,"18138",2460,1751,1741,1,10,"Eb",6
41,"41071",5603,3999,3932,28,67,"Eb",3
33,"33077",1351,938,931,7,7,"Eb",3
11,"11016",14611,9848,9774,114,74,"Eb",20
37,"37249",48,36,36,0,0,"Eb",0
44,"44205",757,541,527,12,14,"Eb",1
11,"11007",17997,10781,10676,184,105,"Eb",48
49,"49092",160,123,123,2,0,"Eb",0
37,"37110",112,89,88,1,1,"Eb",0
48,"48058",977,706,700,2,6,"Eb",2
37,"37136",702,494,485,4,9,"Eb",0
37,"37273",115,83,83,1,0,"Eb",0
49,"49135",687,485,475,3,10,"Eb",3
50,"50064",469,377,373,5,4,"Eb",0
14,"14046",4587,3671,3641,35,30,"Eb",2
50,"50173",175,104,104,2,0,"Eb",0
30,"30008",13289,9992,9849,86,143,"Eb",33
37,"37068",386,291,287,6,4,"Eb",0
28,"28021",418,334,328,4,6,"Eb",6
50,"50202",182,125,122,2,3,"Eb",1
18,"18007",808,602,591,5,11,"Eb",3
28,"28042",1091,814,808,5,6,"Eb",4
50,"50114",157,120,120,1,0,"Eb",1
33,"33056",5278,3576,3540,41,36,"Eb",3
50,"50056",450,329,328,4,1,"Eb",0
13,"13020",4805,3475,3434,40,41,"Eb",8
50,"50144",36,32,32,0,0,"Eb",0
37,"37352",199,150,142,0,8,"Eb",0
37,"37239",235,208,201,2,7,"Eb",0
19,"19244",95,82,82,6,0,"Eb",0
37,"37004",31,23,23,0,0,"Eb",0
50,"50066",2357,1677,1659,42,18,"Eb",7
49,"49180",169,113,107,2,6,"Eb",0
44,"44118",183,129,127,2,2,"Eb",1
19,"19091",30,22,22,2,0,"Eb",0
49,"49255",455,372,367,1,5,"Eb",0
13,"13014",565,457,452,3,5,"Eb",0
19,"19194",113,80,76,1,4,"Eb",0
49,"49115",191,151,149,3,2,"Eb",1
33,"33009",951,673,663,7,10,"Eb",1
19,"19235",121,92,87,0,5,"Eb",0
50,"50233",120,89,88,2,1,"Eb",1
49,"49208",428,266,261,1,5,"Eb",1
19,"19036",279,238,236,1,2,"Eb",0
28,"28180",5179,4033,3975,18,58,"Eb",6
41,"41005",8792,6642,6585,71,57,"Eb",11
37,"37265",224,192,191,1,1,"Eb",1
13,"13088",649,531,526,3,5,"Eb",0
30,"30018",7493,6003,5922,52,81,"Eb",15
50,"50261",246,199,199,4,0,"Eb",1
13,"13089",1906,1610,1553,12,57,"Eb",4
37,"37278",736,538,529,7,9,"Eb",4
28,"28090",7899,6216,6131,60,85,"Eb",19
19,"19111",180,147,146,0,1,"Eb",0
50,"50086",193,109,109,0,0,"Eb",0
49,"49233",119,78,78,2,0,"Eb",0
37,"37129",247,198,198,4,0,"Eb",0
50,"50177",355,268,265,4,3,"Eb",1
37,"37006",157,108,107,0,1,"Eb",0
18,"18099",1551,1217,1205,11,12,"Eb",3
37,"37343",56,42,40,0,2,"Eb",1
44,"44206",156,119,117,3,2,"Eb",2
37,"37279",780,580,571,6,9,"Eb",1
21,"21002",14281,10297,10173,141,124,"Eb",49
37,"37088",208,173,172,4,1,"Eb",0
19,"19038",48,33,33,0,0,"Eb",0
44,"44100",200,147,146,0,1,"Eb",0
50,"50187",72,45,45,1,0,"Eb",0
21,"21073",1840,1249,1236,13,13,"Eb",6
19,"19048",18,12,11,1,1,"Eb",0
13,"13025",321,257,254,1,3,"Eb",0
2,"2017",895,685,682,4,3,"Eb",1
13,"13024",938,703,699,3,4,"Eb",4
41,"41067",7055,5368,5295,64,73,"Eb",16
29,"29097",4076,3060,3018,40,42,"Eb",9
19,"19051",94,83,83,1,0,"Eb",0
37,"37185",602,452,448,8,4,"Eb",0
18,"18095",1916,1428,1306,21,122,"Eb",3
50,"50149",48,35,35,0,0,"Eb",0
49,"49240",237,190,186,1,4,"Eb",0
18,"18116",2972,2237,2213,19,24,"Eb",5
19,"19215",206,170,166,0,4,"Eb",0
14,"14022",4077,3147,3102,20,45,"Eb",7
11,"11023",9209,6979,6929,81,50,"Eb",8
49,"49012",73,43,43,0,0,"Eb",0
21,"21044",17018,11390,11290,132,100,"Eb",90
44,"44196",152,116,114,2,2,"Eb",0
37,"37119",115,98,98,0,0,"Eb",0
50,"50227",105,79,79,2,0,"Eb",2
14,"14051",1392,1148,1130,11,18,"Eb",1
33,"33076",12662,8733,8670,120,63,"Eb",33
2,"2068",379,290,284,3,6,"Eb",2
44,"44249",58,40,40,1,0,"Eb",0
37,"37246",5430,4363,4315,63,48,"Eb",14
41,"41017",13878,10053,9926,130,127,"Eb",34
37,"37358",163,143,139,0,4,"Eb",0
33,"33060",15694,11036,10883,112,153,"Eb",40
48,"48021",1460,1024,1012,13,12,"Eb",0
29,"29098",1312,1043,1036,22,7,"Eb",0
37,"37011",131,87,86,2,1,"Eb",0
48,"48088",148,110,109,0,1,"Eb",0
14,"14013",17006,13114,12958,166,156,"Eb",31
19,"19153",25,17,17,0,0,"Eb",0
14,"14023",2084,1809,1787,13,22,"Eb",2
2,"2057",2138,1736,1712,30,24,"Eb",3
50,"50121",297,250,245,6,5,"Eb",0
18,"18170",377,238,237,0,1,"Eb",0
49,"49239",723,506,495,12,11,"Eb",0
50,"50209",2559,1685,1661,34,24,"Eb",10
33,"33069",3611,2615,2597,25,18,"Eb",14
44,"44056",577,436,434,7,2,"Eb",1
49,"49090",207,168,168,4,0,"Eb",0
18,"18148",874,714,706,6,8,"Eb",2
21,"21005",15205,11006,10909,108,97,"Eb",39
41,"41001",1642,1314,1302,10,12,"Eb",0
44,"44001",69,48,47,0,1,"Eb",0
2,"2014",390,333,326,5,7,"Eb",2
44,"44195",103,71,70,0,1,"Eb",1
48,"48079",470,391,391,2,0,"Eb",0
18,"18089",15803,10794,10712,95,82,"Eb",15
2,"2003",129078,98135,97009,1430,1126,"Eb",665
50,"50285",635,452,445,8,7,"Eb",1
29,"29044",866,631,627,3,4,"Eb",0
48,"48080",10161,6901,6815,95,86,"Eb",26
37,"37361",91,67,62,0,5,"Eb",0
13,"13029",102,90,89,0,1,"Eb",0
18,"18161",220,180,178,0,2,"Eb",0
49,"49120",79,58,58,1,0,"Eb",0
50,"50153",1002,757,748,12,9,"Eb",3
30,"30025",4780,3901,3874,18,27,"Eb",5
49,"49059",111,83,82,2,1,"Eb",0
50,"50201",466,366,363,7,3,"Eb",0
49,"49078",209,173,172,1,1,"Eb",0
44,"44174",435,310,309,3,1,"Eb",1
49,"49134",203,142,142,4,0,"Eb",0
21,"21058",2609,1867,1857,15,10,"Eb",6
44,"44132",64,57,56,0,1,"Eb",1
19,"19325",127,105,102,4,3,"Eb",0
21,"21038",1146,786,767,9,19,"Eb",3
37,"37099",104,64,62,1,2,"Eb",0
49,"49061",141,106,105,1,1,"Eb",1
33,"33063",467,367,363,4,4,"Eb",0
50,"50093",113,84,84,2,0,"Eb",0
19,"19044",319,248,245,0,3,"Eb",1
50,"50154",129,98,97,1,1,"Eb",0
19,"19223",129,94,90,1,4,"Eb",0
49,"49193",503,365,357,4,8,"Eb",2
49,"49062",142,104,104,1,0,"Eb",1
19,"19288",22,21,21,0,0,"Eb",0
44,"44009",805,608,595,18,13,"Eb",2
29,"29056",1177,807,794,3,13,"Eb",0
50,"50288",3252,2412,2380,50,32,"Eb",2
19,"19311",87,60,60,0,0,"Eb",0
37,"37340",155,121,121,0,0,"Eb",0
49,"49191",305,248,246,2,2,"Eb",0
37,"37008",4316,3518,3457,31,61,"Eb",1
2,"2083",246,215,215,0,0,"Eb",1
21,"21061",5089,3657,3635,33,22,"Eb",3
50,"50122",68,47,45,2,2,"Eb",0
18,"18037",488,408,404,0,4,"Eb",0
29,"29094",54317,36540,36174,410,366,"Eb",74
13,"13044",2747,1996,1950,20,46,"Eb",2
37,"37341",52,32,32,0,0,"Eb",0
49,"49261",1579,1161,1145,36,16,"Eb",6
44,"44123",117,79,78,2,1,"Eb",0
18,"18175",11534,8772,8698,68,74,"Eb",9
41,"41074",3079,2406,2386,14,20,"Eb",3
49,"49065",1212,939,926,3,13,"Eb",1
28,"28051",1469,1147,1129,7,18,"Eb",2
30,"30028",6810,5333,5251,44,82,"Eb",7
49,"49111",144,117,116,10,1,"Eb",0
48,"48095",2367,1593,1577,20,16,"Eb",7
37,"37018",128,89,87,0,2,"Eb",0
41,"41023",7901,6050,5972,45,78,"Eb",5
2,"2065",517,450,449,4,1,"Eb",1
50,"50186",44,30,29,0,1,"Eb",0
19,"19257",3595,2593,2543,48,50,"Eb",10
44,"44262",141,114,113,2,1,"Eb",1
44,"44012",389,297,293,5,4,"Eb",0
29,"29059",2551,1986,1964,11,22,"Eb",5
41,"41075",9987,7904,7809,71,95,"Eb",15
44,"44165",182,140,140,1,0,"Eb",0
18,"18022",12448,8777,8659,111,118,"Eb",24
50,"50002",166,130,130,2,0,"Eb",0
29,"29067",420165,273593,271376,3342,2217,"Eb",967
37,"37142",613,436,434,7,2,"Eb",2
49,"49067",416,300,300,2,0,"Eb",2
41,"41099",4141,2818,2799,37,19,"Eb",6
28,"28129",7219,5536,5461,71,75,"Eb",24
44,"44264",249,196,193,1,3,"Eb",0
18,"18122",16253,12271,12109,132,162,"Eb",14
37,"37020",449,371,365,7,6,"Eb",2
44,"44263",332,249,243,10,6,"Eb",2
2,"2030",3180,2499,2456,13,43,"Eb",4
44,"44181",82,63,63,3,0,"Eb",0
19,"19176",280,216,216,0,0,"Eb",1
37,"37041",80,53,53,1,0,"Eb",0
44,"44101",60,47,47,1,0,"Eb",0
28,"28010",9309,7304,7229,71,75,"Eb",30
44,"44168",194,154,152,4,2,"Eb",0
48,"48086",2087,1432,1420,11,12,"Eb",1
48,"48912",2340,1794,1776,22,18,"Eb",7
50,"50255",219,150,148,1,2,"Eb",1
49,"49129",903,671,661,16,10,"Eb",3
49,"49237",157,110,110,0,0,"Eb",0
28,"28018",3572,2837,2795,20,42,"Eb",9
49,"49101",186,134,129,0,5,"Eb",1
44,"44209",892,666,649,6,17,"Eb",2
21,"21034",1253,875,861,7,14,"Eb",7
44,"44115",121,100,100,0,0,"Eb",0
28,"28092",148714,112174,110838,1215,1336,"Eb",410
48,"48011",9742,6697,6628,82,69,"Eb",38
18,"18124",387,270,267,0,3,"Eb",0
19,"19011",286,219,218,3,1,"Eb",0
44,"44054",125,97,97,2,0,"Eb",0
11,"11004",87610,53062,52639,828,423,"Eb",137
48,"48066",350,277,277,0,0,"Eb",1
28,"28124",83,55,53,0,2,"Eb",0
37,"37183",425,321,316,3,5,"Eb",0
37,"37370",345,261,260,1,1,"Eb",2
50,"50246",48,33,33,1,0,"Eb",0
19,"19013",143,110,108,1,2,"Eb",0
44,"44224",26,15,15,0,0,"Eb",0
37,"37259",44,32,32,3,0,"Eb",0
37,"37335",432,347,346,0,1,"Eb",0
37,"37146",135,117,117,1,0,"Eb",0
44,"44211",39,32,32,2,0,"Eb",0
50,"50247",794,572,567,7,5,"Eb",1
19,"19262",184,137,136,0,1,"Eb",0
29,"29099",958,739,730,5,9,"Eb",1
21,"21036",213,172,167,1,5,"Eb",0
28,"28093",1911,1537,1518,19,19,"Eb",3
28,"28012",830,654,651,6,3,"Eb",1
44,"44144",326,233,227,7,6,"Eb",0
49,"49028",119,103,103,1,0,"Eb",0
21,"21043",1898,1382,1350,9,32,"Eb",2
48,"48064",599,490,490,1,0,"Eb",1
48,"48904",3510,2682,2665,26,17,"Eb",5
41,"41027",4061,2783,2752,28,31,"Eb",5
19,"19027",185,140,138,1,2,"Eb",0
37,"37135",1234,972,961,8,11,"Eb",0
2,"2022",431,346,343,1,3,"Eb",0
21,"21007",6088,4174,4123,57,51,"Eb",20
18,"18017",17990,12070,11962,80,108,"Eb",16
37,"37337",140,122,121,0,1,"Eb",0
29,"29064",584,428,422,4,6,"Eb",1
19,"19324",199,151,151,2,0,"Eb",1
14,"14025",3061,2547,2517,13,30,"Eb",1
48,"48905",2600,1903,1869,14,34,"Eb",6
18,"18061",1109,882,869,1,13,"Eb",1
44,"44239",29,25,25,1,0,"Eb",0
2,"2024",3424,2765,2726,32,39,"Eb",12
2,"2023",636,534,533,6,1,"Eb",1
33,"33025",9455,6331,6277,84,54,"Eb",16
14,"14066",5911,4515,4473,54,42,"Eb",5
19,"19155",61,52,50,1,2,"Eb",0
44,"44187",224,170,163,2,7,"Eb",0
44,"44020",23,15,15,0,0,"Eb",0
19,"19053",2172,1602,1587,14,15,"Eb",3
49,"49209",568,374,372,1,2,"Eb",0
18,"18128",361,284,283,5,1,"Eb",0
50,"50220",59,43,43,1,0,"Eb",0
29,"29065",207,151,149,1,2,"Eb",0
19,"19168",324,233,231,6,2,"Eb",0
13,"13042",953,704,693,5,11,"Eb",1
11,"11008",16655,11309,11189,184,120,"Eb",35
2,"2037",22380,15942,15724,203,218,"Eb",65
37,"37226",167,129,127,1,2,"Eb",0
33,"33003",737,475,471,6,4,"Eb",0
37,"37069",952,737,723,12,14,"Eb",2
19,"19018",189,145,138,2,7,"Eb",1
37,"37213",97,77,76,0,1,"Eb",0
49,"49151",680,494,491,6,3,"Eb",0
44,"44133",21,16,16,0,0,"Eb",0
44,"44243",38,27,26,3,1,"Eb",0
18,"18159",1051,873,869,4,4,"Eb",1
28,"28125",2808,2077,2055,19,22,"Eb",10
19,"19201",70,52,52,2,0,"Eb",0
11,"11019",1871,1449,1425,9,24,"Eb",3
28,"28128",366,280,275,2,5,"Eb",0
50,"50166",282,216,210,1,6,"Eb",6
50,"50136",617,469,462,4,7,"Eb",0
11,"11028",32224,20706,20482,359,224,"Eb",105
19,"19290",872,622,613,7,9,"Eb",4
29,"29074",818,631,630,3,1,"Eb",0
37,"37253",137,115,115,1,0,"Eb",0
11,"11010",6452,4534,4510,61,24,"Eb",10
33,"33050",653,406,402,0,4,"Eb",0
49,"49168",96,78,78,1,0,"Eb",1
41,"41057",299,191,189,0,2,"Eb",0
49,"49033",761,563,556,9,7,"Eb",0
50,"50223",956,751,745,14,6,"Eb",0
37,"37152",474,357,351,2,6,"Eb",1
33,"33073",9341,5825,5773,69,52,"Eb",11
41,"41098",4650,3665,3603,43,62,"Eb",8
28,"28107",443,338,333,7,5,"Eb",0
14,"14039",2705,2204,2189,12,15,"Eb",4
11,"11011",1685,1231,1216,8,15,"Eb",2
49,"49219",7742,5643,5562,87,81,"Eb",28
48,"48073",7090,4865,4802,37,63,"Eb",3
14,"14009",2864,2021,2003,8,18,"Eb",1
50,"50068",2082,1514,1481,18,33,"Eb",3
37,"37117",1320,948,937,16,11,"Eb",6
19,"19226",40,31,30,0,1,"Eb",0
44,"44065",60,40,40,0,0,"Eb",0
37,"37355",187,142,140,2,2,"Eb",1
19,"19248",64,53,53,0,0,"Eb",1
28,"28067",3893,2996,2950,26,46,"Eb",8
48,"48096",6607,5007,4900,54,107,"Eb",10
29,"29003",1133,902,900,5,2,"Eb",3
37,"37380",57,45,44,1,1,"Eb",0
50,"50196",110,87,86,4,1,"Eb",2
50,"50298",5319,4023,3955,72,68,"Eb",18
49,"49127",2227,1617,1587,48,30,"Eb",20
37,"37344",259,212,211,5,1,"Eb",1
49,"49085",1173,912,908,16,4,"Eb",4
37,"37074",172,136,135,1,1,"Eb",0
18,"18034",510,377,375,2,2,"Eb",0
2,"2006",612,540,534,1,6,"Eb",0
19,"19294",27,26,26,1,0,"Eb",0
18,"18157",1062,793,783,9,10,"Eb",1
28,"28146",1672,1220,1205,4,15,"Eb",0
2,"2043",1335,1120,1108,10,12,"Eb",3
44,"44235",103,71,68,0,3,"Eb",0
21,"21055",6320,4819,4760,46,59,"Eb",7
41,"41092",7649,5816,5738,39,78,"Eb",6
50,"50061",228,191,183,3,8,"Eb",0
28,"28175",780,641,630,8,11,"Eb",1
13,"13048",538,441,433,5,8,"Eb",0
37,"37009",225,189,185,2,4,"Eb",0
21,"21024",502,363,358,10,5,"Eb",4
49,"49011",236,195,194,5,1,"Eb",1
50,"50283",73,55,55,1,0,"Eb",0
44,"44236",77,48,47,0,1,"Eb",0
50,"50901",170,122,121,1,1,"Eb",0
44,"44068",690,544,528,6,16,"Eb",4
19,"19104",16,12,12,1,0,"Eb",0
48,"48044",63869,47453,47085,511,368,"Eb",233
37,"37194",271,206,204,0,2,"Eb",0
18,"18905",12975,9260,9209,155,51,"Eb",35
29,"29043",2596,1670,1647,24,23,"Eb",3
2,"2008",1332,985,966,12,19,"Eb",10
41,"41102",14343,11050,10837,206,213,"Eb",29
49,"49174",131,97,97,1,0,"Eb",1
37,"37346",264,211,210,1,1,"Eb",0
19,"19105",2235,1709,1686,23,23,"Eb",17
41,"41087",9827,7300,7150,51,150,"Eb",17
11,"11015",59476,38207,37898,501,309,"Eb",150
33,"33008",1934,1474,1459,11,15,"Eb",2
28,"28148",79726,60405,59651,724,754,"Eb",232
11,"11033",19983,12960,12807,199,153,"Eb",25
50,"50132",697,544,536,11,8,"Eb",1
37,"37160",644,474,464,4,10,"Eb",1
37,"37080",242,187,185,1,2,"Eb",0
33,"33054",1780,1272,1263,8,9,"Eb",7
14,"14044",1585,1279,1265,12,14,"Eb",2
2,"2047",109,94,94,0,0,"Eb",0
48,"48046",12635,9231,9161,61,70,"Eb",16
19,"19065",126,100,100,3,0,"Eb",0
48,"48002",7971,5377,5290,65,87,"Eb",18
49,"49227",295,238,237,5,1,"Eb",1
50,"50200",534,436,432,9,4,"Eb",2
50,"50229",62,47,46,2,1,"Eb",0
44,"44226",163,112,112,3,0,"Eb",0
13,"13018",860,740,727,2,13,"Eb",0
50,"50143",608,427,424,5,3,"Eb",0
49,"49256",289,229,224,3,5,"Eb",0
18,"18193",13680,9874,9764,130,110,"Eb",38
19,"19221",56,41,41,2,0,"Eb",0
28,"28119",1911,1527,1514,13,13,"Eb",6
50,"50240",1127,799,783,25,16,"Eb",1
41,"41095",40097,27969,27731,354,238,"Eb",85
49,"49043",304,256,256,6,0,"Eb",1
49,"49003",896,650,647,11,3,"Eb",2
2,"2048",1320,1076,1061,11,15,"Eb",1
37,"37186",109,88,88,2,0,"Eb",0
48,"48081",1938,1449,1435,14,14,"Eb",3
44,"44075",329,250,240,4,10,"Eb",2
37,"37125",243,184,180,3,4,"Eb",1
13,"13086",209,167,166,0,1,"Eb",1
48,"48048",547,423,423,5,0,"Eb",0
50,"50287",298,214,211,10,3,"Eb",0
50,"50115",3280,2234,2205,32,29,"Eb",5
37,"37275",136,98,98,0,0,"Eb",0
41,"41903",6653,5134,5070,61,64,"Eb",14
19,"19067",91,59,59,0,0,"Eb",0
21,"21029",1633,1276,1259,15,17,"Eb",4
50,"50259",89,53,53,1,0,"Eb",0
37,"37039",325,241,236,0,5,"Eb",0
19,"19179",109,77,75,3,2,"Eb",0
29,"29019",908,720,714,0,6,"Eb",0
50,"50203",1083,814,798,28,16,"Eb",1
18,"18010",576,464,458,4,6,"Eb",0
37,"37040",431,362,362,4,0,"Eb",0
49,"49272",102,87,86,0,1,"Eb",0
13,"13010",910,729,726,8,3,"Eb",0
18,"18072",710,507,499,2,8,"Eb",1
44,"44094",116,105,103,4,2,"Eb",1
18,"18143",949,722,704,2,18,"Eb",1
44,"44150",30,30,30,0,0,"Eb",0
50,"50175",1088,742,732,10,10,"Eb",3
41,"41013",4762,3359,3327,9,32,"Eb",2
37,"37377",268,209,208,1,1,"Eb",0
19,"19191",19,15,15,0,0,"Eb",0
44,"44230",154,127,127,3,0,"Eb",6
19,"19132",105,79,79,0,0,"Eb",0
19,"19267",22,15,15,0,0,"Eb",0
37,"37086",105,75,72,3,3,"Eb",0
33,"33034",11390,7583,7501,85,82,"Eb",19
18,"18108",892,674,673,2,1,"Eb",3
28,"28089",3531,2786,2753,25,33,"Eb",5
44,"44097",158,97,95,1,2,"Eb",0
13,"13056",10945,8173,8070,111,103,"Eb",36
18,"18911",6796,4923,4867,74,56,"Eb",18
50,"50058",80,65,64,0,1,"Eb",0
19,"19317",150,122,121,2,1,"Eb",1
48,"48051",225,157,156,0,1,"Eb",0
29,"29021",153,113,113,0,0,"Eb",0
41,"41066",1417,1121,1113,9,8,"Eb",3
18,"18109",607,461,456,1,5,"Eb",1
41,"41040",9567,7305,7210,93,95,"Eb",36
48,"48052",1526,1213,1205,7,8,"Eb",1
44,"44232",408,301,295,5,6,"Eb",1
44,"44246",1591,1030,997,15,33,"Eb",11
37,"37203",174,148,148,0,0,"Eb",0
50,"50059",790,593,586,12,7,"Eb",1
50,"50262",1216,916,904,20,12,"Eb",2
19,"19009",253,187,184,0,3,"Eb",0
28,"28074",136617,106248,105095,1101,1153,"Eb",356
21,"21022",173,123,123,1,0,"Eb",0
50,"50050",109,73,73,1,0,"Eb",2
11,"11022",48624,26656,26430,345,226,"Eb",65
28,"28115",57612,46786,46458,458,328,"Eb",154
37,"37318",225,167,165,0,2,"Eb",0
37,"37168",470,357,353,1,4,"Eb",0
48,"48019",3741,2613,2595,24,18,"Eb",14
18,"18076",880,676,676,3,0,"Eb",0
49,"49099",127,96,96,1,0,"Eb",3
28,"28182",219,179,178,2,1,"Eb",1
37,"37131",200,150,148,1,2,"Eb",0
50,"50235",2371,1723,1701,36,22,"Eb",12
28,"28108",3002,2254,2228,31,26,"Eb",11
50,"50206",499,386,384,10,2,"Eb",3
50,"50188",34,28,27,0,1,"Eb",0
50,"50022",548,430,416,10,14,"Eb",1
48,"48043",4256,3066,3040,33,26,"Eb",17
37,"37120",107,88,87,0,1,"Eb",0
50,"50160",2397,1905,1865,19,40,"Eb",2
49,"49055",115,96,95,1,1,"Eb",1
37,"37169",196,137,136,1,1,"Eb",0
49,"49086",127,108,107,1,1,"Eb",1
18,"18913",827,653,646,2,7,"Eb",1
49,"49204",85,64,64,0,0,"Eb",1
37,"37281",36,34,33,0,1,"Eb",0
44,"44016",541,384,379,5,5,"Eb",1
44,"44003",19,19,19,0,0,"Eb",1
41,"41043",647,457,454,5,3,"Eb",0
37,"37282",238,169,168,3,1,"Eb",0
50,"50264",184,140,134,0,6,"Eb",1
44,"44041",67,56,51,1,5,"Eb",1
37,"37090",59,54,50,0,4,"Eb",0
49,"49116",401,308,305,4,3,"Eb",1
49,"49102",217,178,176,3,2,"Eb",2
19,"19040",73,42,42,1,0,"Eb",0
44,"44210",754,573,567,3,6,"Eb",0
50,"50151",713,536,531,5,5,"Eb",0
19,"19251",41,35,34,0,1,"Eb",0
37,"37247",216,176,173,1,3,"Eb",0
33,"33038",2442,1757,1725,14,32,"Eb",7
49,"49013",300,230,228,6,2,"Eb",0
37,"37360",252,194,194,1,0,"Eb",1
28,"28005",132097,100509,99506,1069,1003,"Eb",352
37,"37196",93,74,70,1,4,"Eb",0
50,"50033",81,64,64,0,0,"Eb",0
49,"49057",125,98,94,1,4,"Eb",0
41,"41094",6089,4757,4680,47,77,"Eb",6
37,"37096",235,199,197,3,2,"Eb",0
44,"44172",345,257,251,3,6,"Eb",0
29,"29054",39904,27540,27307,240,233,"Eb",79
28,"28163",395,305,301,7,4,"Eb",1
49,"49042",271,216,216,1,0,"Eb",0
19,"19117",1526,1155,1132,26,23,"Eb",6
50,"50266",139,95,94,1,1,"Eb",0
44,"44005",59,43,43,1,0,"Eb",0
37,"37123",206,166,165,1,1,"Eb",0
21,"21037",491,386,378,1,8,"Eb",0
37,"37051",90,72,72,0,0,"Eb",0
37,"37173",1643,1298,1285,26,13,"Eb",1
37,"37013",133,93,85,5,8,"Eb",0
14,"14034",367,301,292,1,9,"Eb",0
49,"49164",158,120,114,2,6,"Eb",0
48,"48036",23973,16491,16344,179,147,"Eb",76
21,"21028",419,320,315,3,5,"Eb",0
44,"44092",89,68,68,0,0,"Eb",0
44,"44213",60,48,48,0,0,"Eb",0
28,"28141",5568,4097,4051,31,46,"Eb",15
44,"44119",119,84,84,2,0,"Eb",0
2,"2061",715,570,565,4,5,"Eb",1
29,"29072",3258,2484,2447,30,37,"Eb",5
37,"37137",114,87,87,3,0,"Eb",0
19,"19080",90,64,64,0,0,"Eb",0
50,"50036",103,81,80,2,1,"Eb",0
49,"49150",169,129,126,0,3,"Eb",2
18,"18084",3954,3039,3015,50,24,"Eb",10
48,"48059",397,289,286,0,3,"Eb",0
18,"18182",1982,1405,1397,6,8,"Eb",1
37,"37287",341,247,246,1,1,"Eb",1
37,"37015",248,169,168,0,1,"Eb",0
2,"2025",7496,6153,5985,69,168,"Eb",25
37,"37175",408,319,311,6,8,"Eb",1
28,"28903",29222,23945,23689,296,256,"Eb",117
30,"30026",15165,10524,10369,80,155,"Eb",20
19,"19189",136,99,97,0,2,"Eb",0
28,"28036",2301,1809,1784,13,25,"Eb",8
50,"50184",132,106,106,1,0,"Eb",0
48,"48027",21610,15409,15274,145,135,"Eb",66
50,"50222",1695,1117,1091,16,26,"Eb",3
50,"50194",102,67,67,2,0,"Eb",0
48,"48907",351,290,290,1,0,"Eb",0
29,"29066",363,263,260,1,3,"Eb",0
18,"18040",246,147,146,0,1,"Eb",0
49,"49110",382,236,233,1,3,"Eb",0
37,"37240",781,552,540,10,12,"Eb",1
37,"37116",75,55,55,1,0,"Eb",0
48,"48061",773,585,582,6,3,"Eb",0
21,"21031",1309,903,871,9,32,"Eb",1
28,"28044",5403,4245,4188,27,57,"Eb",10
19,"19225",879,625,618,9,7,"Eb",1
18,"18152",1037,822,818,9,4,"Eb",0
50,"50126",2473,1747,1724,41,23,"Eb",2
19,"19159",108,91,88,1,3,"Eb",0
37,"37189",139,90,90,1,0,"Eb",0
30,"30002",9802,7628,7553,48,75,"Eb",11
50,"50095",12558,9029,8910,179,119,"Eb",34
18,"18087",187449,138136,136783,1548,1353,"Eb",423
19,"19291",1271,925,902,3,23,"Eb",1
18,"18121",135,109,109,0,0,"Eb",2
37,"37215",156,106,106,1,0,"Eb",1
49,"49154",147,104,102,1,2,"Eb",0
33,"33043",710,529,528,1,1,"Eb",0
37,"37019",157,114,113,0,1,"Eb",0
28,"28166",325,269,268,8,1,"Eb",0
13,"13001",1372,1087,1067,8,20,"Eb",1
19,"19008",34,25,25,1,0,"Eb",0
50,"50281",76,63,63,2,0,"Eb",0
44,"44138",158,109,106,0,3,"Eb",0
28,"28009",13466,10392,10286,102,106,"Eb",42
48,"48085",9893,6960,6885,93,75,"Eb",45
30,"30020",5989,4533,4487,14,46,"Eb",6
37,"37204",286,216,214,0,2,"Eb",2
44,"44207",187,147,146,5,1,"Eb",0
37,"37059",132,110,110,2,0,"Eb",0
49,"49113",188,166,161,2,5,"Eb",1
44,"44013",11286,7797,7584,242,213,"Eb",74
11,"11002",4291,3388,3374,19,14,"Eb",2
50,"50039",580,450,446,3,4,"Eb",3
49,"49248",224,183,180,4,3,"Eb",0
19,"19123",40,34,34,0,0,"Eb",0
14,"14031",634,516,514,1,2,"Eb",1
37,"37369",143,103,103,0,0,"Eb",0
37,"37181",301,232,230,2,2,"Eb",1
49,"49100",322,236,233,1,3,"Eb",0
44,"44141",147,99,95,0,4,"Eb",2
44,"44154",271,196,195,7,1,"Eb",3
49,"49024",736,551,544,16,7,"Eb",2
19,"19173",52,42,42,3,0,"Eb",0
13,"13037",901,752,745,2,7,"Eb",1
21,"21054",8024,6159,6072,67,87,"Eb",21
44,"44014",2603,1965,1912,25,53,"Eb",15
19,"19260",44,41,41,1,0,"Eb",0
2,"2055",1267,900,884,6,16,"Eb",5
37,"37345",179,156,156,2,0,"Eb",1
18,"18004",818,601,594,2,7,"Eb",0
14,"14002",10991,8444,8358,106,86,"Eb",15
37,"37193",432,310,309,5,1,"Eb",0
37,"37145",276,217,214,0,3,"Eb",0
37,"37144",398,302,301,3,1,"Eb",1
49,"49250",1330,998,985,19,13,"Eb",2
33,"33068",1224,704,703,5,1,"Eb",0
21,"21075",375,294,291,12,3,"Eb",0
14,"14063",1121,875,866,9,9,"Eb",1
33,"33053",1206,817,811,6,6,"Eb",2
28,"28011",437,318,315,2,3,"Eb",0
14,"14033",1289,974,958,18,16,"Eb",5
50,"50014",169,108,108,1,0,"Eb",2
37,"37062",92,73,73,1,0,"Eb",0
48,"48903",1909,1455,1430,4,25,"Eb",2
13,"13006",641,529,519,4,10,"Eb",0
49,"49027",178,134,127,1,7,"Eb",5
30,"30006",823,719,711,5,8,"Eb",0
28,"28033",3581,2712,2691,14,21,"Eb",7
2,"2069",11624,9091,8907,119,184,"Eb",22
18,"18115",2380,1843,1823,14,20,"Eb",1
48,"48034",13160,9290,9189,82,101,"Eb",51
37,"37297",441,376,369,1,7,"Eb",0
19,"19139",32,23,23,0,0,"Eb",0
37,"37222",124,92,92,2,0,"Eb",1
44,"44268",30,25,25,0,0,"Eb",0
29,"29081",290,226,226,3,0,"Eb",0
41,"41088",542,414,408,1,6,"Eb",0
50,"50082",108,73,72,0,1,"Eb",0
48,"48035",379,304,301,0,3,"Eb",2
41,"41053",20729,16178,15971,142,207,"Eb",26
37,"37147",201,153,151,1,2,"Eb",0
14,"14024",1926,1557,1527,14,30,"Eb",60
18,"18028",992,826,821,4,5,"Eb",0
13,"13041",298,225,225,1,0,"Eb",0
19,"19299",94,75,75,0,0,"Eb",0
2,"2072",1598,1220,1198,5,22,"Eb",0
50,"50092",329,273,272,0,1,"Eb",1
28,"28094",774,557,551,5,6,"Eb",1
49,"49149",422,305,303,6,2,"Eb",0
2,"2060",1232,974,964,10,10,"Eb",5
37,"37112",162,124,124,3,0,"Eb",3
21,"21048",327,226,226,5,0,"Eb",0
37,"37299",237,167,165,2,2,"Eb",1
2,"2036",104,78,78,0,0,"Eb",1
28,"28171",4148,2972,2929,21,43,"Eb",15
50,"50134",134,102,101,3,1,"Eb",0
14,"14005",6334,4262,4206,61,56,"Eb",29
50,"50277",82,63,63,0,0,"Eb",1
44,"44148",98,77,77,3,0,"Eb",0
44,"44108",352,228,225,8,3,"Eb",4
49,"49165",72,63,63,0,0,"Eb",2
18,"18194",2258,1656,1652,11,4,"Eb",1
41,"41055",15121,11082,10997,98,85,"Eb",16
19,"19300",746,595,585,3,10,"Eb",4
29,"29037",227,170,170,0,0,"Eb",0
41,"41081",28121,20027,19785,275,242,"Eb",54
44,"44228",121,97,96,2,1,"Eb",1
50,"50193",635,483,465,3,18,"Eb",0
48,"48049",564,446,446,2,0,"Eb",2
14,"14067",3821,3105,3082,38,23,"Eb",10
49,"49004",137,105,105,3,0,"Eb",0
18,"18132",3461,2797,2772,19,25,"Eb",2
11,"11009",636,430,424,2,6,"Eb",1
50,"50084",84,64,64,1,0,"Eb",0
33,"33049",6806,4629,4581,70,48,"Eb",14
48,"48094",3299,2398,2377,15,21,"Eb",4
19,"19289",33,28,28,1,0,"Eb",1
44,"44110",57,45,45,0,0,"Eb",2
19,"19070",100,74,74,0,0,"Eb",1
14,"14068",581,460,457,7,3,"Eb",1
48,"48039",263,217,216,4,1,"Eb",0
18,"18184",2140,1663,1645,18,18,"Eb",2
11,"11038",13815,10849,10756,126,93,"Eb",36
13,"13066",2444,2094,2065,15,29,"Eb",1
50,"50242",102,82,82,2,0,"Eb",4
13,"13011",5166,3555,3500,31,55,"Eb",7
49,"49124",279,203,202,2,1,"Eb",2
33,"33004",69056,49228,48730,726,498,"Eb",191
37,"37190",235,195,193,1,2,"Eb",0
19,"19302",64,60,60,2,0,"Eb",0
21,"21051",272,202,201,5,1,"Eb",0
49,"49082",400,331,324,2,7,"Eb",1
49,"49262",401,317,313,1,4,"Eb",3
13,"13078",9291,7062,6993,92,69,"Eb",12
18,"18063",1189,795,789,7,6,"Eb",1
41,"41083",1176,915,908,8,7,"Eb",4
49,"49125",1344,956,939,21,17,"Eb",5
33,"33028",1466,812,806,5,6,"Eb",1
44,"44151",215,143,140,1,3,"Eb",0
29,"29039",2822,2091,2074,8,17,"Eb",6
37,"37191",127,86,85,1,1,"Eb",0
19,"19112",68,50,50,0,0,"Eb",0
28,"28083",8037,6078,6025,66,53,"Eb",14
2,"2078",967,770,756,9,14,"Eb",4
33,"33021",4932,3544,3502,45,42,"Eb",4
13,"13035",1043,794,770,10,24,"Eb",2
41,"41076",2227,1507,1492,5,15,"Eb",0
33,"33066",42885,29326,29013,460,313,"Eb",118
41,"41032",4059,3122,3062,22,60,"Eb",9
11,"11012",103946,68124,67375,856,749,"Eb",362
19,"19304",235,169,166,1,3,"Eb",0
49,"49170",111,87,85,1,2,"Eb",1
19,"19021",1129,818,800,10,18,"Eb",1
50,"50003",141,108,108,3,0,"Eb",0
37,"37231",285,227,225,6,2,"Eb",0
37,"37232",412,374,373,1,1,"Eb",0
30,"30039",18615,14213,14068,134,145,"Eb",34
48,"48009",767,585,580,4,5,"Eb",3
44,"44265",203,169,158,6,11,"Eb",1
18,"18100",7304,5807,5737,62,70,"Eb",5
50,"50070",70,42,41,0,1,"Eb",1
37,"37269",475,383,382,2,1,"Eb",0
29,"29061",1045,861,855,7,6,"Eb",2
19,"19270",17,16,16,0,0,"Eb",0
50,"50170",411,316,313,2,3,"Eb",0
19,"19136",22,15,15,0,0,"Eb",0
50,"50089",6673,4936,4877,120,59,"Eb",27
28,"28116",666,507,498,5,9,"Eb",3
19,"19239",99,74,73,1,1,"Eb",1
19,"19283",40,33,33,0,0,"Eb",0
50,"50080",41,31,31,1,0,"Eb",0
41,"41034",22561,16014,15840,270,174,"Eb",49
37,"37078",888,728,714,9,14,"Eb",0
33,"33030",921,682,668,4,14,"Eb",1
18,"18168",864,613,605,4,8,"Eb",5
13,"13027",3582,2770,2715,25,55,"Eb",3
44,"44197",60,37,37,1,0,"Eb",0
49,"49087",581,358,356,3,2,"Eb",0
37,"37359",194,155,152,1,3,"Eb",0
50,"50171",126,90,89,4,1,"Eb",1
50,"50111",191,141,138,2,3,"Eb",0
37,"37347",481,374,371,6,3,"Eb",1
19,"19061",76,57,55,3,2,"Eb",0
49,"49225",172,130,129,0,1,"Eb",0
28,"28110",1912,1492,1475,8,17,"Eb",1
44,"44071",657,453,448,9,5,"Eb",0
37,"37063",94,77,76,3,1,"Eb",0
19,"19024",7736,5738,5646,82,92,"Eb",19
50,"50199",380,263,254,2,9,"Eb",1
18,"18192",1581,1331,1318,6,13,"Eb",1
28,"28041",4006,3190,3154,45,36,"Eb",12
37,"37272",162,121,120,1,1,"Eb",0
18,"18068",1456,1105,1088,13,17,"Eb",6
49,"49190",81,65,64,2,1,"Eb",0
19,"19323",50,41,39,0,2,"Eb",0
41,"41036",4053,2930,2899,29,31,"Eb",1
49,"49176",757,502,501,5,1,"Eb",0
21,"21027",67,52,52,0,0,"Eb",0
21,"21057",1054,699,697,9,2,"Eb",2
50,"50257",195,154,154,0,0,"Eb",1
18,"18103",803,653,647,5,6,"Eb",0
19,"19242",112,93,92,1,1,"Eb",0
19,"19052",37,32,31,1,1,"Eb",0
14,"14004",2016,1560,1543,8,17,"Eb",6
14,"14035",6153,4715,4656,51,59,"Eb",3
29,"29036",670,504,499,4,5,"Eb",2
19,"19277",22,17,17,0,0,"Eb",0
18,"18069",506,375,371,4,4,"Eb",0
37,"37081",1000,807,800,5,7,"Eb",0
2,"2084",362,276,270,2,6,"Eb",0
37,"37198",212,176,173,2,3,"Eb",0
44,"44120",217,126,121,5,5,"Eb",0
50,"50083",96,72,72,1,0,"Eb",0
37,"37238",102,77,76,0,1,"Eb",1
37,"37124",227,181,179,3,2,"Eb",0
18,"18909",668,536,534,2,2,"Eb",0
33,"33078",159,108,106,1,2,"Eb",0
19,"19310",13,9,8,0,1,"Eb",0
44,"44076",2338,1839,1797,36,42,"Eb",4
30,"30043",24501,19738,19416,230,322,"Eb",38
2,"2012",1834,1632,1622,12,10,"Eb",5
29,"29093",2299,1767,1732,7,35,"Eb",0
37,"37200",192,142,142,0,0,"Eb",0
19,"19213",72,60,60,1,0,"Eb",1
30,"30035",17849,12871,12744,133,127,"Eb",36
37,"37083",190,165,165,3,0,"Eb",1
18,"18174",470,368,363,1,5,"Eb",0
2,"2086",2856,2019,2005,9,14,"Eb",3
49,"49046",283,240,235,2,5,"Eb",1
37,"37085",4334,3254,3201,69,53,"Eb",19
48,"48005",93,65,64,0,1,"Eb",0
48,"48071",6097,4307,4224,61,83,"Eb",11
19,"19200",150,105,105,1,0,"Eb",0
19,"19301",47,38,38,0,0,"Eb",0
28,"28001",61,46,45,1,1,"Eb",1
49,"49137",179,149,147,2,2,"Eb",0
49,"49260",814,653,644,6,9,"Eb",0
49,"49138",269,190,189,0,1,"Eb",0
21,"21020",398,282,282,3,0,"Eb",2
41,"41030",527,436,429,6,7,"Eb",1
33,"33035",11413,8105,8035,104,70,"Eb",39
50,"50232",176,123,120,5,3,"Eb",1
37,"37201",263,196,196,5,0,"Eb",0
37,"37315",99,77,75,3,2,"Eb",0
28,"28037",1598,1263,1250,10,13,"Eb",0
14,"14059",713,572,567,5,5,"Eb",0
37,"37102",430,323,322,1,1,"Eb",0
33,"33012",5341,3816,3777,43,39,"Eb",9
29,"29095",3431,2660,2607,23,53,"Eb",0
41,"41014",2484,1956,1936,13,20,"Eb",0
37,"37042",45,35,35,1,0,"Eb",0
21,"21001",628,434,428,5,6,"Eb",1
14,"14049",16358,12577,12478,137,99,"Eb",14
21,"21062",1444,1003,991,7,12,"Eb",3
37,"37317",323,281,278,3,3,"Eb",1
33,"33058",1863,1307,1286,11,21,"Eb",1
29,"29050",483,341,340,1,1,"Eb",0
21,"21011",3531,2672,2639,15,33,"Eb",2
28,"28023",4350,3425,3392,32,33,"Eb",18
37,"37087",779,590,586,18,4,"Eb",3
49,"49066",531,392,386,2,6,"Eb",0
50,"50011",131,113,113,8,0,"Eb",0
19,"19247",171,125,118,6,7,"Eb",0
44,"44113",79,57,55,0,2,"Eb",2
28,"28002",2650,2018,1993,24,25,"Eb",5
37,"37356",90,66,66,1,0,"Eb",0
37,"37243",123,89,88,1,1,"Eb",0
37,"37007",467,368,363,6,5,"Eb",0
50,"50178",325,228,225,4,3,"Eb",0
29,"29022",202,142,141,2,1,"Eb",5
18,"18023",16072,11594,11488,131,106,"Eb",19
19,"19074",81,69,69,0,0,"Eb",0
19,"19282",210,157,157,0,0,"Eb",0
44,"44167",41,31,31,1,0,"Eb",0
48,"48087",463,371,370,4,1,"Eb",0
21,"21003",691,540,536,7,4,"Eb",0
41,"41059",31676,23199,22889,330,310,"Eb",103
44,"44086",485,380,371,5,9,"Eb",0
18,"18167",1927,1397,1380,13,17,"Eb",1
37,"37010",963,705,690,5,15,"Eb",1
28,"28003",196,154,151,2,3,"Eb",1
50,"50032",330,233,228,3,5,"Eb",0
37,"37382",202,172,171,3,1,"Eb",1
37,"37157",94,65,65,0,0,"Eb",0
33,"33037",37135,25522,25262,291,260,"Eb",231
37,"37294",11233,8282,8167,139,115,"Eb",32
21,"21045",261,200,200,5,0,"Eb",0
19,"19218",60,35,35,0,0,"Eb",0
13,"13093",4333,3281,3229,43,52,"Eb",10
19,"19321",46,29,29,0,0,"Eb",0
30,"30022",16489,12207,12042,152,165,"Eb",14
19,"19001",64,56,56,1,0,"Eb",0
13,"13038",1770,1397,1380,8,17,"Eb",0
13,"13071",41043,28435,28183,370,252,"Eb",107
19,"19185",40,21,19,0,2,"Eb",0
18,"18056",3695,2961,2940,25,21,"Eb",1
14,"14053",6040,4455,4376,78,79,"Eb",11
21,"21066",522,440,431,4,9,"Eb",0
41,"41044",6838,5064,5005,67,59,"Eb",19
19,"19186",93,77,77,0,0,"Eb",0
37,"37321",169,144,144,1,0,"Eb",0
33,"33061",446,260,259,1,1,"Eb",2
37,"37283",130,104,104,1,0,"Eb",0
28,"28026",5852,4506,4449,40,57,"Eb",13
19,"19002",99,77,76,0,1,"Eb",0
50,"50043",258,170,166,2,4,"Eb",0
44,"44117",357,278,275,0,3,"Eb",0
19,"19196",99,80,74,2,6,"Eb",0
44,"44105",82,63,63,2,0,"Eb",0
13,"13061",5898,4442,4373,56,69,"Eb",8
48,"48915",362,273,271,2,2,"Eb",0
29,"29090",1805,1265,1260,5,5,"Eb",2
33,"33062",452,282,281,3,1,"Eb",1
2,"2058",390,290,285,0,5,"Eb",0
21,"21006",3565,2477,2441,29,36,"Eb",5
37,"37209",376,258,253,4,5,"Eb",0
49,"49058",341,262,259,4,3,"Eb",0
50,"50210",39,28,24,0,4,"Eb",0
44,"44173",107,87,77,5,10,"Eb",0
28,"28006",74554,57439,56890,586,549,"Eb",213
49,"49015",259,213,208,2,5,"Eb",0
14,"14065",1846,1509,1492,14,17,"Eb",6
33,"33032",12060,8627,8491,107,136,"Eb",23
28,"28133",5868,4236,4144,23,92,"Eb",13
29,"29055",1837,1478,1454,12,24,"Eb",4
44,"44045",373,303,301,4,2,"Eb",2
21,"21068",1009,726,721,10,5,"Eb",5
11,"11026",4834,3736,3691,27,45,"Eb",4
50,"50123",428,335,332,9,3,"Eb",0
37,"37250",405,277,274,1,3,"Eb",0
37,"37286",231,166,160,2,6,"Eb",1
50,"50183",369,277,274,5,3,"Eb",1
19,"19118",17,13,13,0,0,"Eb",0
13,"13031",2384,1908,1874,23,34,"Eb",2
37,"37098",355,267,265,1,2,"Eb",0
19,"19043",92,82,82,1,0,"Eb",0
33,"33040",4702,3285,3236,44,49,"Eb",14
48,"48026",1093,881,875,3,6,"Eb",0
50,"50008",5110,3458,3406,56,52,"Eb",20
28,"28028",1615,1204,1173,11,31,"Eb",5
49,"49243",117,85,85,0,0,"Eb",0
18,"18018",658,520,514,4,6,"Eb",1
28,"28134",55921,42676,42221,505,455,"Eb",170
13,"13064",1465,1127,1110,21,17,"Eb",9
49,"49210",493,358,356,6,2,"Eb",1
28,"28080",45696,36832,36529,402,303,"Eb",146
49,"49214",720,560,558,6,2,"Eb",0
13,"13065",3011,2105,2088,24,17,"Eb",3
41,"41038",96442,66696,65945,1021,751,"Eb",267
50,"50085",205,143,143,3,0,"Eb",1
13,"13032",1218,926,922,9,4,"Eb",4
33,"33026",9144,6019,5959,87,60,"Eb",7
28,"28135",928,665,659,6,6,"Eb",0
28,"28120",1259,946,931,11,15,"Eb",0
50,"50185",150,109,109,2,0,"Eb",0
49,"49273",217,144,144,0,0,"Eb",0
50,"50038",1583,1194,1174,29,20,"Eb",2
37,"37139",199,167,163,1,4,"Eb",0
37,"37127",229,183,182,3,1,"Eb",0
44,"44010",189,138,138,2,0,"Eb",1
33,"33019",3262,2283,2244,12,39,"Eb",2
18,"18120",274,238,237,2,1,"Eb",0
28,"28008",1734,1244,1221,11,23,"Eb",4
50,"50028",120,86,85,2,1,"Eb",1
49,"49246",248,212,210,1,2,"Eb",1
44,"44049",886,652,627,6,25,"Eb",5
49,"49020",323,275,272,1,3,"Eb",1
37,"37329",40,36,36,2,0,"Eb",0
28,"28121",185,153,152,0,1,"Eb",0
37,"37366",46,35,34,0,1,"Eb",0
21,"21041",114169,74740,73814,1129,926,"Eb",309
28,"28030",1591,1268,1230,12,38,"Eb",3
2,"2064",413,350,348,7,2,"Eb",0
19,"19330",93,81,81,2,0,"Eb",0
37,"37072",184,157,155,5,2,"Eb",0
44,"44038",112,94,92,3,2,"Eb",0
37,"37044",461,363,360,1,3,"Eb",1
2,"2077",51,46,45,0,1,"Eb",0
11,"11001",4389,3110,3072,13,38,"Eb",13
48,"48910",3063,2122,2104,14,18,"Eb",8
2,"2041",399,311,304,1,7,"Eb",0
49,"49202",221,158,157,2,1,"Eb",1
33,"33013",466,349,345,4,4,"Eb",0
28,"28122",504,367,366,2,1,"Eb",0
19,"19160",944,600,593,6,7,"Eb",2
50,"50272",12481,8744,8642,176,102,"Eb",42
50,"50129",258,164,164,0,0,"Eb",5
28,"28145",2125,1643,1620,15,23,"Eb",6
30,"30003",23570,16482,16354,169,128,"Eb",23
37,"37073",583,458,455,7,3,"Eb",1
19,"19227",95,64,63,1,1,"Eb",0
37,"37218",81,51,51,1,0,"Eb",0
33,"33067",802,650,639,12,11,"Eb",1
19,"19161",243,171,166,2,5,"Eb",0
50,"50273",36,22,22,0,0,"Eb",0
37,"37332",78,52,49,0,3,"Eb",0
28,"28053",6035,4854,4783,61,71,"Eb",25
18,"18123",307,239,238,1,1,"Eb",0
49,"49157",177,140,140,0,0,"Eb",2
28,"28123",48429,38681,38187,429,494,"Eb",173
48,"48901",4370,3156,3124,46,32,"Eb",10
18,"18024",882,696,688,12,8,"Eb",1
14,"14032",434,377,375,1,2,"Eb",0
49,"49054",929,690,687,12,3,"Eb",3
28,"28046",4208,3297,3272,31,25,"Eb",13
44,"44183",78,49,46,0,3,"Eb",0
19,"19075",81,53,50,4,3,"Eb",0
44,"44067",132,89,89,0,0,"Eb",0
44,"44143",382,292,292,5,0,"Eb",0
13,"13070",769,653,640,1,13,"Eb",1
19,"19296",43,31,30,1,1,"Eb",0
37,"37061",254,187,185,0,2,"Eb",1
19,"19050",21,19,19,0,0,"Eb",0
44,"44029",637,495,490,6,5,"Eb",2
49,"49130",218,159,156,3,3,"Eb",1
50,"50023",240,180,180,4,0,"Eb",1
37,"37307",177,132,130,0,2,"Eb",0
44,"44267",79,63,61,2,2,"Eb",0
44,"44055",85,63,62,2,1,"Eb",0
49,"49075",153,128,122,0,6,"Eb",0
49,"49071",822,558,557,5,1,"Eb",2
29,"29006",721,516,508,5,8,"Eb",3
48,"48067",1204,895,892,4,3,"Eb",0
21,"21015",728,453,447,6,6,"Eb",0
11,"11005",4617,3287,3214,26,73,"Eb",3
37,"37336",54,49,47,0,2,"Eb",0
49,"49175",263,215,215,4,0,"Eb",0
37,"37372",145,109,109,0,0,"Eb",0
44,"44238",2475,1718,1692,50,26,"Eb",19
50,"50284",176,131,130,1,1,"Eb",0
37,"37109",191,142,141,1,1,"Eb",0
44,"44043",126,94,94,7,0,"Eb",0
37,"37208",92,59,58,0,1,"Eb",0
50,"50903",2234,1622,1597,35,25,"Eb",18
21,"21026",255,181,169,2,12,"Eb",1
28,"28132",10987,8066,7943,90,123,"Eb",45
48,"48068",1577,1224,1213,4,11,"Eb",4
19,"19231",16,14,14,0,0,"Eb",0
41,"41002",1510,1161,1140,4,21,"Eb",2
13,"13007",1319,1069,1051,18,18,"Eb",1
44,"44059",571,446,434,10,12,"Eb",8
49,"49077",210,146,144,1,2,"Eb",0
49,"49002",77,59,59,1,0,"Eb",1
50,"50267",648,450,441,8,9,"Eb",1
44,"44256",37,35,35,9,0,"Eb",0
28,"28013",38226,27886,27547,246,339,"Eb",80
50,"50073",2265,1773,1756,20,17,"Eb",10
50,"50164",407,271,268,4,3,"Eb",0
48,"48069",12381,8760,8672,66,88,"Eb",43
19,"19129",48,33,31,0,2,"Eb",0
49,"49030",96,78,77,2,1,"Eb",0
28,"28079",2290453,1721837,1705310,17342,16527,"Eb",6707
37,"37338",82,69,67,0,2,"Eb",0
50,"50044",259,175,175,0,0,"Eb",1
41,"41003",2196,1803,1782,21,21,"Eb",0
21,"21079",749,556,553,6,3,"Eb",1
33,"33002",10837,7667,7588,77,79,"Eb",18
28,"28150",2985,2363,2345,21,18,"Eb",1
37,"37187",567,449,448,3,1,"Eb",0
50,"50017",1734,1232,1212,41,20,"Eb",13
48,"48037",727,528,519,2,9,"Eb",2
33,"33071",671,528,523,4,5,"Eb",3
11,"11027",67042,43386,43065,557,321,"Eb",176
19,"19145",64,49,48,2,1,"Eb",0
37,"37313",581,440,435,7,5,"Eb",0
18,"18107",988,769,760,3,9,"Eb",0
30,"30038",15057,11640,11555,82,85,"Eb",23
19,"19234",63,48,48,0,0,"Eb",0
2,"2002",479,411,407,3,4,"Eb",0
50,"50279",111,79,79,1,0,"Eb",0
18,"18163",327,246,238,0,8,"Eb",0
50,"50009",122,93,93,0,0,"Eb",1
21,"21040",3096,2370,2351,28,19,"Eb",5
18,"18062",9418,6916,6835,62,81,"Eb",20
28,"28172",7648,6130,6076,65,54,"Eb",27
19,"19169",51,35,35,0,0,"Eb",0
48,"48072",1009,796,787,3,9,"Eb",0
37,"37151",150,125,121,1,4,"Eb",0
44,"44217",37,28,27,0,1,"Eb",0
49,"49216",175,144,142,3,2,"Eb",0
48,"48006",285,246,243,3,3,"Eb",0
30,"30036",13978,10244,10141,94,103,"Eb",29
28,"28173",507,397,390,2,7,"Eb",0
37,"37101",185,143,141,1,2,"Eb",0
49,"49081",1457,1166,1141,17,25,"Eb",4
21,"21010",14308,8960,8861,154,99,"Eb",33
44,"44023",13,11,11,0,0,"Eb",0
19,"19057",79,56,56,0,0,"Eb",1
14,"14008",2905,2226,2200,18,26,"Eb",4
19,"19133",103,89,88,2,1,"Eb",0
37,"37266",83,54,54,1,0,"Eb",0
28,"28058",137542,103880,102686,1155,1194,"Eb",407
37,"37071",90,80,80,1,0,"Eb",1
50,"50176",237,161,160,4,1,"Eb",0
50,"50020",868,646,629,5,17,"Eb",2
18,"18176",265,183,181,0,2,"Eb",0
49,"49008",535,395,394,7,1,"Eb",0
28,"28059",4061,3169,3130,38,39,"Eb",13
19,"19281",25,24,22,3,2,"Eb",0
13,"13068",1058,801,793,4,8,"Eb",1
41,"41084",2875,2362,2335,9,27,"Eb",3
19,"19259",37,32,32,0,0,"Eb",0
37,"37156",4319,3280,3233,28,47,"Eb",5
19,"19269",103,84,83,0,1,"Eb",0
37,"37268",113,78,77,1,1,"Eb",0
50,"50101",922,648,637,8,11,"Eb",3
14,"14010",4087,3144,3121,15,23,"Eb",6
33,"33006",1674,1130,1120,10,10,"Eb",1
19,"19122",96,65,65,0,0,"Eb",0
50,"50031",167,105,103,0,2,"Eb",0
37,"37305",206,153,152,4,1,"Eb",0
48,"48042",1401,1116,1099,15,17,"Eb",6
41,"41100",1097,894,878,8,16,"Eb",0
41,"41007",12177,8150,8016,126,134,"Eb",21
21,"21023",2106,1471,1456,7,15,"Eb",1
19,"19204",168,129,126,2,3,"Eb",0
49,"49172",594,389,383,0,6,"Eb",0
37,"37306",316,194,192,1,2,"Eb",0
19,"19103",303,247,244,3,3,"Eb",0
50,"50021",42,34,33,1,1,"Eb",0
44,"44027",168,140,140,2,0,"Eb",2
37,"37034",91,72,72,0,0,"Eb",0
48,"48010",427,303,300,2,3,"Eb",1
28,"28154",5232,3910,3860,40,50,"Eb",16
18,"18003",13486,10245,10100,145,145,"Eb",20
18,"18093",2580,1837,1820,8,17,"Eb",2
19,"19163",73,59,59,0,0,"Eb",0
11,"11042",1232,933,922,4,11,"Eb",0
2,"2080",580,450,443,4,7,"Eb",0
14,"14012",6305,4749,4690,44,59,"Eb",2
13,"13015",5755,4334,4293,40,41,"Eb",9
50,"50198",46,36,36,2,0,"Eb",0
48,"48054",23712,16643,16439,215,204,"Eb",86
28,"28025",426,336,332,2,4,"Eb",0
19,"19125",54,42,42,2,0,"Eb",0
19,"19124",420,293,291,3,2,"Eb",0
2,"2020",519,433,430,0,3,"Eb",1
49,"49189",228,151,150,3,1,"Eb",0
28,"28131",12664,9454,9342,100,112,"Eb",48
33,"33031",38090,25034,24730,380,304,"Eb",92
37,"37271",393,324,318,5,6,"Eb",0
19,"19272",86,67,65,1,2,"Eb",0
19,"19064",97,84,83,1,1,"Eb",0
50,"50141",116,98,98,1,0,"Eb",0
18,"18137",1057,875,868,8,7,"Eb",0
44,"44241",575,442,427,4,15,"Eb",4
19,"19334",50,37,37,0,0,"Eb",0
14,"14074",2387,2002,1995,26,7,"Eb",1
50,"50024",652,541,531,8,10,"Eb",1
44,"44225",129,100,98,5,2,"Eb",0
49,"49132",338,245,238,0,7,"Eb",0
13,"13095",94,70,70,1,0,"Eb",0
28,"28048",489,398,389,3,9,"Eb",1
37,"37285",457,349,347,2,2,"Eb",0
19,"19308",67,61,61,0,0,"Eb",0
41,"41062",2252,1719,1698,12,21,"Eb",2
19,"19106",95,68,66,0,2,"Eb",0
37,"37348",114,91,90,1,1,"Eb",1
50,"50238",114,82,80,0,2,"Eb",1
37,"37349",136,105,104,2,1,"Eb",1
44,"44019",75,38,37,0,1,"Eb",1
2,"2035",1988,1601,1586,19,15,"Eb",3
29,"29063",358,272,271,2,1,"Eb",1
19,"19177",82,67,66,0,1,"Eb",0
30,"30042",1841,1531,1519,10,12,"Eb",6
19,"19309",37,32,31,0,1,"Eb",0
41,"41089",6394,4593,4526,57,67,"Eb",6
49,"49229",134,99,99,2,0,"Eb",0
28,"28087",3150,2475,2453,26,22,"Eb",10
37,"37350",452,368,364,5,4,"Eb",0
29,"29092",596,457,454,10,3,"Eb",1
41,"41902",4682,3136,3101,34,35,"Eb",2
37,"37199",157,115,113,0,2,"Eb",0
44,"44034",150,117,117,1,0,"Eb",1
37,"37312",278,232,229,1,3,"Eb",0
48,"48015",34932,24209,23966,296,243,"Eb",96
29,"29018",2088,1565,1540,9,25,"Eb",3
19,"19032",202,11,11,0,0,"Eb",0
28,"28112",168,138,137,0,1,"Eb",1
37,"37339",345,280,279,3,1,"Eb",0
50,"50148",365,256,251,2,5,"Eb",1
19,"19073",24,20,19,0,1,"Eb",0
44,"44125",78,57,57,1,0,"Eb",0
44,"44161",487,363,358,9,5,"Eb",0
28,"28088",251,174,173,5,1,"Eb",0
19,"19109",53,40,40,1,0,"Eb",0
50,"50146",211,168,167,4,1,"Eb",0
29,"29038",16309,10579,10494,152,85,"Eb",20
14,"14017",10755,8220,8149,101,71,"Eb",16
49,"49006",168,124,122,2,2,"Eb",0
33,"33011",12085,7186,7116,89,70,"Eb",11
44,"44204",24,21,21,0,0,"Eb",0
19,"19181",69,54,54,5,0,"Eb",0
50,"50047",60,34,34,2,0,"Eb",0
30,"30019",25722,18740,18553,164,187,"Eb",45
49,"49096",188,149,146,2,3,"Eb",1
29,"29020",3188,2448,2424,30,24,"Eb",3
14,"14018",3795,3004,2970,24,34,"Eb",8
28,"28151",3025,2237,2185,9,52,"Eb",5
50,"50156",234,186,183,2,3,"Eb",0
19,"19329",62,52,50,0,2,"Eb",0
44,"44136",51,39,39,0,0,"Eb",0
28,"28066",7033,5439,5383,45,56,"Eb",18
19,"19071",7346,5380,5294,76,86,"Eb",23
50,"50029",676,527,517,6,10,"Eb",1
21,"21072",10233,7829,7666,124,163,"Eb",19
49,"49048",162,119,119,2,0,"Eb",1
18,"18012",2693,1841,1831,11,10,"Eb",2
37,"37058",68,44,44,0,0,"Eb",0
49,"49050",558,382,375,3,7,"Eb",0
21,"21014",4063,3424,3408,27,16,"Eb",4
50,"50290",436,334,331,4,3,"Eb",0
2,"2053",3053,2550,2517,33,33,"Eb",13
48,"48040",1274,936,921,10,15,"Eb",1
37,"37216",300,270,266,2,4,"Eb",0
11,"11030",22528,14741,14557,195,184,"Eb",93
49,"49201",330,280,278,9,2,"Eb",0
48,"48023",601,499,492,4,7,"Eb",2
41,"41070",5598,4101,4039,79,62,"Eb",34
18,"18036",3553,2762,2741,20,21,"Eb",8
49,"49009",430,309,309,0,0,"Eb",1
28,"28091",5202,3714,3671,34,43,"Eb",9
49,"49036",592,410,403,5,7,"Eb",1
19,"19193",30,29,29,1,0,"Eb",0
33,"33036",11674,8695,8605,104,90,"Eb",18
48,"48053",856,683,680,8,3,"Eb",3
37,"37089",74,54,54,2,0,"Eb",0
37,"37280",84,64,64,0,0,"Eb",0
41,"41042",5902,4572,4509,37,63,"Eb",2
2,"2018",922,759,754,7,5,"Eb",3
29,"29068",6209,4025,3983,41,42,"Eb",10
18,"18146",1059,791,776,2,15,"Eb",2
49,"49187",1317,967,954,31,13,"Eb",3
37,"37245",357,273,272,2,1,"Eb",0
28,"28068",10502,7857,7778,68,79,"Eb",24
37,"37320",96,70,70,0,0,"Eb",0
2,"2019",2455,2107,2077,16,30,"Eb",0
41,"41016",6950,5194,5120,45,74,"Eb",7
50,"50004",613,445,441,6,4,"Eb",0
41,"41008",1073,884,875,0,9,"Eb",1
19,"19284",11,11,11,0,0,"Eb",0
18,"18158",10328,7336,7254,69,82,"Eb",7
19,"19333",142,86,84,0,2,"Eb",0
21,"21004",1530,1059,1042,9,17,"Eb",2
28,"28047",38404,28739,28436,312,303,"Eb",98
19,"19332",106,76,72,4,4,"Eb",0
19,"19228",39,30,29,0,1,"Eb",0
29,"29042",14047,9845,9735,118,110,"Eb",30
28,"28902",453,338,329,3,9,"Eb",1
50,"50124",474,375,367,11,8,"Eb",1
50,"50131",243,185,183,6,2,"Eb",1
44,"44251",271,218,218,5,0,"Eb",2
19,"19285",26,20,20,2,0,"Eb",0
19,"19220",2225,1482,1456,7,26,"Eb",7
48,"48089",2878,2120,2089,19,31,"Eb",6
44,"44088",32,31,31,1,0,"Eb",0
49,"49094",276,180,180,2,0,"Eb",0
44,"44179",369,245,243,6,2,"Eb",4
21,"21042",15246,8640,8572,154,68,"Eb",39
14,"14003",1289,1046,1026,12,20,"Eb",1
44,"44157",62,45,44,0,1,"Eb",0
28,"28155",529,427,416,2,11,"Eb",0
33,"33046",546,429,421,3,8,"Eb",0
48,"48045",5060,3912,3849,31,63,"Eb",14
13,"13039",14349,10928,10776,149,152,"Eb",33
2,"2046",1165,954,941,16,13,"Eb",2
37,"37122",210,175,174,3,1,"Eb",2
37,"37311",251,210,209,8,1,"Eb",2
28,"28070",139,98,97,0,1,"Eb",1
48,"48090",6153,4682,4571,40,111,"Eb",5
29,"29071",915,601,598,4,3,"Eb",0
50,"50239",65,44,44,0,0,"Eb",0
37,"37065",346,269,267,0,2,"Eb",0
18,"18083",296,242,242,1,0,"Eb",0
41,"41010",4338,2990,2958,48,32,"Eb",7
33,"33001",1772,984,971,14,13,"Eb",1
19,"19143",1610,1287,1268,9,19,"Eb",1
50,"50295",54,42,41,0,1,"Eb",2
41,"41045",5505,3946,3889,68,57,"Eb",7
18,"18181",253,183,182,0,1,"Eb",0
28,"28027",1232,937,919,9,18,"Eb",7
50,"50182",3704,2551,2515,44,36,"Eb",16
29,"29100",2442,1834,1824,14,10,"Eb",0
37,"37174",1150,942,922,3,20,"Eb",0
21,"21069",1778,1245,1242,11,3,"Eb",3
29,"29027",2416,1907,1893,15,14,"Eb",1
44,"44007",194,152,145,3,7,"Eb",0
21,"21008",2717,1994,1978,11,16,"Eb",0
50,"50271",283,209,207,4,2,"Eb",2
50,"50258",54,37,37,0,0,"Eb",0
44,"44046",58,44,44,1,0,"Eb",0
37,"37212",123,95,92,1,3,"Eb",1
13,"13097",2309,1843,1825,20,18,"Eb",4
19,"19005",92,80,79,0,1,"Eb",0
50,"50045",1289,1011,992,14,19,"Eb",2
21,"21059",203,166,162,1,4,"Eb",0
18,"18134",5528,3751,3679,57,72,"Eb",12
14,"14064",352,265,261,3,4,"Eb",1
13,"13072",803,638,633,13,5,"Eb",0
37,"37103",483,354,351,1,3,"Eb",0
28,"28014",31360,23434,23133,203,301,"Eb",75
37,"37228",388,339,336,2,3,"Eb",0
28,"28143",81,71,67,1,4,"Eb",0
49,"49152",572,401,395,6,6,"Eb",4
48,"48060",3689,2477,2466,12,11,"Eb",3
19,"19119",93,80,79,2,1,"Eb",0
28,"28029",538,416,414,4,2,"Eb",0
19,"19256",48,44,43,0,1,"Eb",0
18,"18050",1657,1209,1196,5,13,"Eb",2
37,"37252",127,92,92,0,0,"Eb",0
19,"19327",551,459,449,3,10,"Eb",0
37,"37328",218,155,149,2,6,"Eb",2
19,"19086",1655,1310,1295,10,15,"Eb",3
33,"33065",1150,791,784,16,7,"Eb",5
49,"49199",266,214,211,1,3,"Eb",0
50,"50067",14124,10049,9870,203,179,"Eb",40
41,"41065",23028,15133,14958,191,175,"Eb",19
19,"19280",3415,2521,2490,27,31,"Eb",6
29,"29048",1508,1254,1245,6,9,"Eb",0
44,"44218",37,26,26,2,0,"Eb",0
13,"13067",380,314,312,3,2,"Eb",0
29,"29075",12666,8284,8218,62,66,"Eb",19
37,"37140",731,490,475,0,15,"Eb",1
29,"29030",839,669,668,5,1,"Eb",0
50,"50167",235,191,184,1,7,"Eb",0
44,"44064",93,63,62,0,1,"Eb",0
48,"48029",8022,5488,5409,83,79,"Eb",36
41,"41051",2103,1705,1686,7,19,"Eb",1
48,"48909",194,163,163,0,0,"Eb",0
28,"28160",7496,5680,5613,46,67,"Eb",17
48,"48018",905,591,587,8,4,"Eb",0
49,"49184",190,135,133,1,2,"Eb",0
50,"50118",2312,1737,1718,22,19,"Eb",2
37,"37304",190,144,142,1,2,"Eb",0
37,"37379",167,128,125,4,3,"Eb",0
37,"37108",108,95,95,1,0,"Eb",0
37,"37138",212,174,169,5,5,"Eb",0
13,"13013",7141,5682,5564,60,118,"Eb",11
33,"33016",19516,14345,14210,198,135,"Eb",58
19,"19088",98,67,66,0,1,"Eb",0
37,"37179",230,194,191,3,3,"Eb",0
14,"14020",415,323,319,3,4,"Eb",0
44,"44026",89,69,69,0,0,"Eb",2
13,"13903",564,461,454,2,7,"Eb",3
44,"44180",71,52,52,1,0,"Eb",0
37,"37292",101,84,84,2,0,"Eb",0
21,"21013",10601,7384,7231,110,153,"Eb",19
50,"50216",267,201,194,8,7,"Eb",0
30,"30004",1164,958,952,1,6,"Eb",0
37,"37256",245,191,190,2,1,"Eb",0
49,"49114",51,34,33,1,1,"Eb",0
48,"48065",3311,2340,2323,23,17,"Eb",8
49,"49203",345,294,292,4,2,"Eb",0
49,"49249",78,63,63,0,0,"Eb",0
19,"19162",71,52,51,0,1,"Eb",0
28,"28100",3970,2903,2865,32,38,"Eb",16
37,"37257",52,43,43,0,0,"Eb",0
33,"33045",4692,3347,3297,42,50,"Eb",14
50,"50179",269,230,229,2,1,"Eb",0
50,"50161",124,86,86,1,0,"Eb",0
2,"2032",323,261,259,1,2,"Eb",1
44,"44028",202,159,156,2,3,"Eb",3
37,"37221",465,360,353,0,7,"Eb",1
44,"44053",111,77,76,2,1,"Eb",0
50,"50217",496,380,379,0,1,"Eb",2
49,"49039",333,243,240,6,3,"Eb",0
14,"14073",3009,2246,2224,32,22,"Eb",16
50,"50249",333,280,272,2,8,"Eb",0
14,"14062",1114,889,882,9,7,"Eb",0
41,"41037",3228,2510,2483,27,27,"Eb",7
30,"30005",29081,22312,22142,184,170,"Eb",66
18,"18025",326,242,238,0,4,"Eb",0
37,"37334",86,50,49,0,1,"Eb",0
19,"19229",83,71,68,0,3,"Eb",0
28,"28035",1314,1058,1046,3,12,"Eb",0
18,"18185",608,484,479,2,5,"Eb",0
37,"37121",557,458,451,8,7,"Eb",2
28,"28174",1745,1233,1224,11,9,"Eb",4
49,"49040",118,102,98,1,4,"Eb",0
18,"18094",2398,1882,1868,16,14,"Eb",2
49,"49268",480,365,362,8,3,"Eb",2
13,"13083",2529,1837,1795,26,42,"Eb",4
44,"44156",57,40,38,1,2,"Eb",0
49,"49160",54,35,34,3,1,"Eb",0
49,"49148",213,144,143,0,1,"Eb",1
28,"28118",72,49,47,1,2,"Eb",0
50,"50113",653,528,526,9,2,"Eb",0
19,"19298",75,53,52,2,1,"Eb",1
13,"13040",933,755,744,4,11,"Eb",3
28,"28149",5276,4132,4063,43,69,"Eb",17
41,"41901",2626,2190,2167,24,23,"Eb",2
48,"48003",14142,10268,10167,84,101,"Eb",33
37,"37067",2938,2306,2267,47,39,"Eb",20
19,"19031",18,11,11,0,0,"Eb",0
28,"28049",59507,46919,46379,488,540,"Eb",215
41,"41011",15274,11359,11207,145,152,"Eb",23
37,"37237",330,250,242,1,8,"Eb",0
18,"18173",8858,6238,6187,64,51,"Eb",5
41,"41028",1880,1479,1458,28,21,"Eb",10
37,"37374",1204,1018,1004,9,14,"Eb",3
11,"11035",13266,8794,8668,115,126,"Eb",36
41,"41080",1289,1010,997,13,13,"Eb",0
13,"13008",473,362,360,4,2,"Eb",0
30,"30034",1182,956,943,3,13,"Eb",2
21,"21078",2865,2085,2066,21,19,"Eb",7
44,"44231",54,38,36,2,2,"Eb",0
28,"28178",1017,799,791,11,8,"Eb",1
18,"18070",287,240,239,2,1,"Eb",1
50,"50104",379,306,303,4,3,"Eb",1
49,"49258",127,107,104,0,3,"Eb",0
2,"2073",4924,3923,3847,76,76,"Eb",11
33,"33033",10609,7179,7107,91,72,"Eb",30
19,"19087",22,16,16,0,0,"Eb",0
44,"44237",450,352,343,5,9,"Eb",2
44,"44240",168,135,132,2,3,"Eb",0
48,"48914",324,278,276,0,2,"Eb",0
44,"44194",128,92,89,1,3,"Eb",0
37,"37032",530,410,409,4,1,"Eb",0
37,"37314",79,61,61,3,0,"Eb",0
2,"2001",731,601,584,6,17,"Eb",0
44,"44191",806,602,594,6,8,"Eb",1
37,"37070",538,428,427,12,1,"Eb",0
50,"50250",58,43,43,4,0,"Eb",0
50,"50018",973,761,755,12,6,"Eb",2
48,"48038",1087,826,821,7,5,"Eb",3
48,"48908",242,194,194,1,0,"Eb",0
44,"44149",106,79,78,2,1,"Eb",1
21,"21050",12322,8772,8679,99,93,"Eb",28
50,"50251",8379,6225,6116,110,109,"Eb",23
18,"18164",1881,1351,1342,16,9,"Eb",0
19,"19055",54,41,37,1,4,"Eb",0
44,"44063",82,55,55,2,0,"Eb",2
37,"37115",135,107,101,2,6,"Eb",0
50,"50010",77,65,64,5,1,"Eb",0
13,"13901",945,734,719,6,15,"Eb",3
41,"41022",4281,3087,3066,15,21,"Eb",3
29,"29001",4176,3339,3303,23,36,"Eb",9
49,"49153",183,141,139,1,2,"Eb",0
28,"28144",5663,4456,4410,47,46,"Eb",9
37,"37030",90,71,70,4,1,"Eb",0
44,"44111",101,68,68,4,0,"Eb",0
49,"49007",387,289,289,4,0,"Eb",1
28,"28097",127,94,92,0,2,"Eb",1
50,"50130",415,288,288,7,0,"Eb",1
28,"28085",3794,2980,2933,18,47,"Eb",11
19,"19208",55,41,41,1,0,"Eb",0
50,"50035",78,61,56,2,5,"Eb",0
50,"50214",31,22,21,1,1,"Eb",0
37,"37133",108,79,77,0,2,"Eb",0
19,"19182",38,24,22,0,2,"Eb",0
13,"13045",744,615,608,6,7,"Eb",1
37,"37079",77,64,63,1,1,"Eb",0
37,"37351",305,261,258,2,3,"Eb",0
13,"13079",12220,9665,9502,177,163,"Eb",74
48,"48097",1359,936,915,9,21,"Eb",5
44,"44018",27,23,23,0,0,"Eb",0
48,"48055",2620,1954,1934,22,20,"Eb",7
48,"48041",721,588,585,9,3,"Eb",2
37,"37291",261,215,214,1,1,"Eb",1
14,"14060",4843,3857,3787,47,70,"Eb",2
28,"28024",156,132,132,5,0,"Eb",0
44,"44066",121,88,86,0,2,"Eb",1
30,"30012",9037,7242,7142,62,100,"Eb",10
19,"19238",42,32,31,1,1,"Eb",0
37,"37118",141,115,114,3,1,"Eb",0
49,"49128",617,480,474,10,6,"Eb",1
13,"13081",684,553,527,1,26,"Eb",2
33,"33052",758,526,518,2,8,"Eb",0
14,"14011",595,498,497,4,1,"Eb",0
33,"33075",305,191,190,0,1,"Eb",0
49,"49266",83,69,69,1,0,"Eb",1
2,"2007",1139,923,916,0,7,"Eb",2
37,"37233",59,46,45,1,1,"Eb",0
44,"44182",216,173,173,4,0,"Eb",1
19,"19306",42,31,31,1,0,"Eb",0
29,"29023",1661,1080,1074,15,6,"Eb",4
48,"48033",223,171,171,1,0,"Eb",1
19,"19023",121,95,94,5,1,"Eb",0
37,"37270",201,159,158,0,1,"Eb",1
29,"29014",250,152,150,0,2,"Eb",0
29,"29052",245,151,151,0,0,"Eb",1
44,"44201",526,449,443,9,6,"Eb",1
19,"19222",120,90,89,3,1,"Eb",1
49,"49192",166,139,139,2,0,"Eb",0
49,"49271",221,178,176,2,2,"Eb",0
44,"44159",47,43,43,0,0,"Eb",0
19,"19278",30,28,28,0,0,"Eb",0
30,"30014",1686,1400,1387,10,13,"Eb",1
18,"18067",704,526,521,1,5,"Eb",1
29,"29901",41445,27372,27158,295,214,"Eb",72
21,"21052",4741,2897,2839,21,58,"Eb",7
44,"44171",186,127,124,3,3,"Eb",5
19,"19078",58,49,48,0,1,"Eb",0
44,"44124",88,63,61,3,2,"Eb",1
50,"50087",31,25,25,0,0,"Eb",1
19,"19175",39,31,31,0,0,"Eb",0
19,"19241",45,37,37,2,0,"Eb",0
49,"49131",312,227,225,7,2,"Eb",0
41,"41061",2205,1798,1770,2,28,"Eb",2
2,"2081",18319,14324,14096,225,228,"Eb",61
18,"18906",955,736,731,5,5,"Eb",2
19,"19146",51,40,38,0,2,"Eb",0
28,"28019",1195,901,888,5,13,"Eb",0
48,"48057",5934,4407,4385,27,22,"Eb",4
50,"50172",187,140,138,4,2,"Eb",1
50,"50142",45,25,24,0,1,"Eb",0
28,"28063",268,209,203,4,6,"Eb",0
44,"44130",38,27,27,0,0,"Eb",0
2,"2059",336,262,258,3,4,"Eb",1
30,"30024",57868,41894,41513,393,381,"Eb",78
19,"19335",77,61,61,1,0,"Eb",0
33,"33024",229816,164603,163179,2100,1424,"Eb",744
37,"37274",123032,90819,89629,1506,1190,"Eb",371
37,"37161",157,118,116,1,2,"Eb",0
19,"19287",153,114,113,2,1,"Eb",1
18,"18171",2093,1719,1704,10,15,"Eb",2
44,"44033",307,222,221,5,1,"Eb",1
48,"48047",161,126,126,1,0,"Eb",0
19,"19211",450,340,334,0,6,"Eb",0
37,"37001",224,182,181,0,1,"Eb",0
18,"18105",5222,3866,3839,32,27,"Eb",3
2,"2004",654,554,544,7,10,"Eb",0
19,"19020",52,39,39,3,0,"Eb",0
50,"50041",21,13,13,0,0,"Eb",0
14,"14001",3633,3095,3064,25,31,"Eb",3
37,"37325",102,77,77,0,0,"Eb",0
29,"29049",3137,2365,2352,19,13,"Eb",4
13,"13053",14718,10958,10766,159,192,"Eb",114
37,"37082",869,663,650,3,13,"Eb",3
44,"44245",274,189,184,1,5,"Eb",0
11,"11024",6811,5241,5202,58,39,"Eb",7
37,"37014",1198,862,852,8,10,"Eb",1
49,"49179",401,285,284,2,1,"Eb",0
44,"44042",139,87,87,0,0,"Eb",0
21,"21025",3969,2731,2686,33,45,"Eb",6
18,"18111",2647,1957,1941,24,16,"Eb",8
49,"49052",200,149,144,1,5,"Eb",0
21,"21019",645,464,458,2,6,"Eb",2
29,"29028",1253,887,876,8,11,"Eb",0
28,"28022",30019,24469,24279,292,190,"Eb",77
44,"44121",63,48,48,1,0,"Eb",0
49,"49235",486,344,340,6,4,"Eb",3
41,"41039",31429,23337,23138,294,199,"Eb",36
21,"21030",1757,1448,1426,14,22,"Eb",1
37,"37277",58,39,38,1,1,"Eb",0
14,"14048",1244,975,970,5,5,"Eb",2
44,"44077",80,62,62,1,0,"Eb",0
19,"19034",23,23,23,1,0,"Eb",0
37,"37353",142,119,119,2,0,"Eb",0
44,"44244",93,56,56,5,0,"Eb",0
37,"37005",92,65,65,0,0,"Eb",0
50,"50019",79,57,55,1,2,"Eb",0
37,"37202",938,742,726,25,16,"Eb",6
2,"2901",2223,1678,1667,19,11,"Eb",7
44,"44048",77,59,59,0,0,"Eb",0
49,"49064",566,372,368,8,4,"Eb",1
18,"18086",397,321,321,3,0,"Eb",0
48,"48017",13554,9303,9234,64,69,"Eb",17
19,"19147",58,45,40,0,5,"Eb",0
37,"37229",144,108,108,0,0,"Eb",0
19,"19268",34,26,25,0,1,"Eb",0
19,"19090",107,87,86,0,1,"Eb",0
14,"14042",18991,14726,14495,290,231,"Eb",105
50,"50230",1295,914,903,13,11,"Eb",0
19,"19017",87,70,70,0,0,"Eb",0
50,"50007",61,45,45,0,0,"Eb",0
49,"49107",160,113,111,2,2,"Eb",1
19,"19081",43,33,33,0,0,"Eb",0
28,"28136",618,527,516,2,11,"Eb",3
37,"37207",287,211,208,2,3,"Eb",0
44,"44147",439,320,314,14,6,"Eb",2
50,"50117",131,101,100,1,1,"Eb",0
18,"18001",288,212,212,1,0,"Eb",1
37,"37155",81,57,57,0,0,"Eb",0
50,"50244",215,155,155,6,0,"Eb",1
13,"13005",23052,18002,17700,255,302,"Eb",86
50,"50275",103,76,76,0,0,"Eb",0
19,"19172",76,65,64,1,1,"Eb",4
44,"44152",62,50,50,3,0,"Eb",0
37,"37267",210,169,165,0,4,"Eb",1
14,"14050",2418,1983,1966,23,17,"Eb",7
18,"18151",276,191,188,0,3,"Eb",3
49,"49186",273,205,204,1,1,"Eb",2
19,"19217",85,57,54,2,3,"Eb",0
19,"19150",128,112,108,0,4,"Eb",0
50,"50263",235,160,160,1,0,"Eb",0
18,"18112",132,90,90,1,0,"Eb",0
50,"50119",997,740,720,13,20,"Eb",0
37,"37357",283,216,214,0,2,"Eb",0
18,"18014",5667,4132,4085,43,47,"Eb",18
28,"28183",935,663,649,7,14,"Eb",5
13,"13026",482,387,384,1,3,"Eb",0
50,"50292",138,117,115,4,2,"Eb",0
44,"44127",79,62,61,0,1,"Eb",0
49,"49173",430,272,272,5,0,"Eb",1
19,"19195",41,30,30,1,0,"Eb",0
18,"18188",1659,1329,1308,9,21,"Eb",0
18,"18054",879,646,644,4,2,"Eb",2
11,"11032",53183,32205,31982,441,223,"Eb",98
44,"44250",20,11,11,1,0,"Eb",0
19,"19114",40,34,34,0,0,"Eb",0
18,"18117",535,444,440,2,4,"Eb",4
19,"19264",45,39,39,0,0,"Eb",0
41,"41077",8817,6520,6375,53,145,"Eb",5
50,"50110",424,315,314,6,1,"Eb",0
29,"29033",1385,878,868,4,10,"Eb",0
14,"14015",2198,1776,1755,16,21,"Eb",7
50,"50268",59,46,46,3,0,"Eb",0
50,"50180",111,91,89,3,2,"Eb",0
49,"49108",512,387,381,9,6,"Eb",1
44,"44164",32,25,25,0,0,"Eb",0
18,"18179",583,417,409,7,8,"Eb",0
37,"37296",385,311,308,3,3,"Eb",0
19,"19076",36,29,29,0,0,"Eb",0
30,"30032",2839,2361,2337,21,24,"Eb",3
2,"2066",258,219,217,2,2,"Eb",0
50,"50098",215,150,146,2,4,"Eb",0
29,"29034",462,360,357,0,3,"Eb",1
29,"29062",647,573,571,1,2,"Eb",2
18,"18102",8556,6358,6272,42,86,"Eb",6
19,"19203",35,27,27,0,0,"Eb",1
21,"21070",6278,4489,4445,42,44,"Eb",11
37,"37288",252,194,194,3,0,"Eb",0
2,"2010",1877,1557,1519,15,38,"Eb",0
37,"37172",857,584,580,5,4,"Eb",2
19,"19079",7,7,7,0,0,"Eb",0
37,"37097",47,39,39,1,0,"Eb",0
50,"50163",3427,2448,2413,62,35,"Eb",17
19,"19016",74,50,49,0,1,"Eb",1
44,"44146",185,160,159,8,1,"Eb",1
49,"49207",279,206,204,2,2,"Eb",0
19,"19142",259,191,190,0,1,"Eb",9
44,"44074",435,344,337,5,7,"Eb",1
13,"13051",358,291,289,5,2,"Eb",0
37,"37038",808,671,664,6,7,"Eb",5
14,"14055",18619,13802,13607,192,195,"Eb",30
28,"28056",782,604,586,6,18,"Eb",3
13,"13062",595,490,480,4,10,"Eb",0
19,"19254",57,50,50,0,0,"Eb",0
28,"28164",2807,2194,2173,10,21,"Eb",10
2,"2039",1050,862,848,16,14,"Eb",2
18,"18101",8990,6659,6556,96,103,"Eb",25
13,"13085",2455,2146,2118,21,28,"Eb",0
13,"13063",3839,2801,2771,31,30,"Eb",8
19,"19066",78,63,62,0,1,"Eb",0
18,"18127",15897,11597,11483,133,114,"Eb",35
13,"13096",7716,5759,5659,70,100,"Eb",19
18,"18150",6452,4666,4625,56,41,"Eb",15
28,"28054",10459,7798,7698,65,100,"Eb",27
44,"44257",184,132,131,6,1,"Eb",0
48,"48092",792,603,600,5,3,"Eb",1
49,"49139",195,146,146,0,0,"Eb",0
50,"50128",36,30,29,0,1,"Eb",0
29,"29070",35228,23374,23146,258,228,"Eb",87
44,"44129",44,34,33,0,1,"Eb",0
18,"18005",366,279,277,3,2,"Eb",0
19,"19183",108,87,86,1,1,"Eb",0
41,"41082",3448,2827,2796,15,31,"Eb",2
49,"49063",371,291,290,3,1,"Eb",0
29,"29010",1703,1411,1377,7,34,"Eb",0
13,"13904",556,448,441,14,7,"Eb",13
30,"30029",11533,8854,8768,73,86,"Eb",12
50,"50278",207,152,149,4,3,"Eb",0
50,"50270",39,30,29,1,1,"Eb",1
21,"21071",216,169,169,5,0,"Eb",0
2,"2027",347,301,301,2,0,"Eb",0
13,"13033",1719,1436,1419,6,17,"Eb",1
14,"14058",8116,6274,6215,76,59,"Eb",15
14,"14028",333,279,277,1,2,"Eb",0
49,"49275",53766,37940,37379,774,561,"Eb",338
19,"19007",460,351,345,5,6,"Eb",0
2,"2063",1537,1252,1242,11,10,"Eb",5
33,"33057",1635,1150,1132,16,18,"Eb",5
37,"37017",249,200,199,0,1,"Eb",0
19,"19120",107,95,95,1,0,"Eb",0
44,"44261",777,600,594,8,6,"Eb",0
48,"48028",767,623,621,1,2,"Eb",2
37,"37166",206,172,171,3,1,"Eb",0
50,"50274",78,45,45,1,0,"Eb",0
19,"19107",349,289,288,1,1,"Eb",1
37,"37206",100,81,80,1,1,"Eb",0
50,"50100",355,273,266,3,7,"Eb",1
44,"44142",39,28,28,1,0,"Eb",0
48,"48025",882,652,644,2,8,"Eb",0
37,"37002",152,90,89,1,1,"Eb",1
18,"18908",827,669,660,7,9,"Eb",1
33,"33055",1589,1212,1192,16,20,"Eb",3
49,"49031",150,128,127,2,1,"Eb",2
37,"37162",232,184,182,4,2,"Eb",0
50,"50001",130,96,96,0,0,"Eb",0
50,"50902",97,85,85,1,0,"Eb",0
14,"14043",7664,5935,5874,53,61,"Eb",4
49,"49084",306,234,234,8,0,"Eb",1
14,"14040",3821,2986,2949,40,37,"Eb",7
50,"50168",34,26,26,1,0,"Eb",0
2,"2005",602,490,488,2,2,"Eb",1
29,"29012",9817,7063,6991,51,72,"Eb",7
14,"14070",1385,1131,1111,4,20,"Eb",1
50,"50096",49,35,35,0,0,"Eb",0
50,"50046",201,155,153,2,2,"Eb",1
19,"19097",28,27,27,0,0,"Eb",0
37,"37180",69,46,46,0,0,"Eb",0
29,"29060",775,573,572,1,1,"Eb",0
50,"50040",98,77,76,2,1,"Eb",0
28,"28032",4469,3412,3369,32,43,"Eb",4
21,"21074",2752,1981,1968,15,13,"Eb",0
48,"48031",370,296,296,1,0,"Eb",0
19,"19089",33,22,22,1,0,"Eb",0
28,"28168",1144,821,810,15,11,"Eb",0
49,"49158",229,174,172,0,2,"Eb",1
19,"19049",19,11,11,0,0,"Eb",0
29,"29079",2500,2016,2000,23,16,"Eb",0
13,"13092",1924,1655,1635,4,20,"Eb",2
19,"19022",673,501,496,4,5,"Eb",2
50,"50140",172,108,108,1,0,"Eb",0
50,"50013",244,195,195,1,0,"Eb",0
14,"14072",1169,925,922,5,3,"Eb",0
13,"13004",1130,937,923,6,14,"Eb",0
37,"37148",451,344,343,3,1,"Eb",1
48,"48902",19232,12809,12633,182,176,"Eb",71
37,"37052",274,213,212,1,1,"Eb",0
44,"44131",26,20,20,0,0,"Eb",0
50,"50276",148,116,114,3,2,"Eb",1
50,"50189",776,588,576,9,12,"Eb",1
41,"41072",4083,3073,3046,12,27,"Eb",2
19,"19188",72,48,48,1,0,"Eb",0
2,"2085",345,288,284,2,4,"Eb",0
49,"49238",289,233,231,3,2,"Eb",1
2,"2049",937,717,708,2,9,"Eb",2
18,"18096",348,289,287,1,2,"Eb",3
30,"30017",11683,9332,9233,95,99,"Eb",14
50,"50090",165,117,117,1,0,"Eb",1
30,"30023",3572,2859,2811,22,48,"Eb",4
50,"50190",751,576,565,7,11,"Eb",1
19,"19115",41,26,26,1,0,"Eb",0
37,"37092",1403,1034,1022,12,12,"Eb",5
2,"2082",121,107,107,1,0,"Eb",0
44,"44031",124,72,72,0,0,"Eb",0
18,"18154",1062,770,769,0,1,"Eb",2
19,"19102",122,101,100,0,1,"Eb",0
49,"49185",171,140,140,3,0,"Eb",2
50,"50135",100,76,75,2,1,"Eb",0
50,"50034",923,634,617,10,17,"Eb",0
50,"50053",756,570,563,14,7,"Eb",0
37,"37223",127,102,101,1,1,"Eb",0
49,"49163",235,167,167,0,0,"Eb",1
29,"29016",272,180,179,5,1,"Eb",0
30,"30015",18792,14453,14336,120,117,"Eb",21
37,"37236",163,123,119,4,4,"Eb",0
50,"50091",56,39,39,1,0,"Eb",0
44,"44106",173,132,131,8,1,"Eb",5
19,"19092",437,331,326,4,5,"Eb",0
21,"21016",1076,823,790,11,33,"Eb",1
49,"49177",298,199,196,6,3,"Eb",0
44,"44158",1159,904,873,15,31,"Eb",3
49,"49270",156,112,112,6,0,"Eb",0
13,"13074",1000,886,878,15,8,"Eb",3
19,"19095",14,9,8,0,1,"Eb",0
19,"19271",53,45,45,1,0,"Eb",0
29,"29082",29311,20220,20051,223,169,"Eb",68
28,"28109",1621,1121,1104,9,17,"Eb",2
2,"2031",626,507,502,3,5,"Eb",1
49,"49038",114,81,80,0,1,"Eb",0
13,"13084",973,800,793,6,7,"Eb",1
44,"44102",30,29,28,0,1,"Eb",0
49,"49016",272,216,211,1,5,"Eb",1
48,"48013",81335,54452,53803,771,649,"Eb",274
37,"37362",4333,3276,3238,65,38,"Eb",14
28,"28060",1471,1205,1192,8,13,"Eb",5
49,"49017",264,189,187,1,2,"Eb",2
50,"50286",90,73,73,2,0,"Eb",0
37,"37363",121,100,99,0,1,"Eb",1
18,"18064",419,347,345,3,2,"Eb",0
13,"13002",1576,1143,1134,4,9,"Eb",1
21,"21012",331,254,246,2,8,"Eb",1
49,"49156",265,217,214,6,3,"Eb",1
19,"19318",36,19,19,1,0,"Eb",0
41,"41041",9646,7901,7791,58,110,"Eb",16
37,"37114",92,75,74,1,1,"Eb",0
14,"14007",15871,11609,11477,121,132,"Eb",20
18,"18910",832,601,594,6,7,"Eb",2
2,"2051",1729,1318,1303,10,15,"Eb",0
13,"13076",514,436,428,0,8,"Eb",1
14,"14037",3500,2662,2616,29,46,"Eb",8
28,"28082",5144,3967,3905,46,62,"Eb",22
2,"2075",1689,1386,1372,10,14,"Eb",4
14,"14038",31501,23683,23394,336,289,"Eb",61
18,"18133",2256,1783,1773,12,10,"Eb",1
41,"41097",3096,2489,2451,21,38,"Eb",1
49,"49019",256,206,205,5,1,"Eb",0
2,"2038",296,254,254,1,0,"Eb",0
50,"50125",421,284,280,1,4,"Eb",0
33,"33042",4434,3172,3135,43,37,"Eb",14
19,"19004",67,56,56,0,0,"Eb",0
28,"28096",16844,12441,12308,117,133,"Eb",44
37,"37177",310,242,241,1,1,"Eb",0
44,"44222",136,99,99,2,0,"Eb",0
18,"18140",42971,28391,28126,335,265,"Eb",61
29,"29017",6766,5162,5114,48,48,"Eb",6
14,"14075",624,508,500,8,8,"Eb",0
37,"37224",216,190,186,5,4,"Eb",0
50,"50016",51,30,30,1,0,"Eb",0
49,"49069",414,276,270,1,6,"Eb",0
49,"49029",675,553,542,6,11,"Eb",8
28,"28078",39,23,23,1,0,"Eb",0
13,"13046",786,654,644,2,10,"Eb",0
41,"41058",16497,12415,12248,181,167,"Eb",39
50,"50212",52,48,48,0,0,"Eb",0
37,"37045",27,21,21,0,0,"Eb",0
48,"48014",1211,838,834,4,4,"Eb",4
50,"50296",417,313,310,6,3,"Eb",2
50,"50005",245,199,195,1,4,"Eb",3
19,"19219",18,12,12,0,0,"Eb",0
29,"29053",1715,1239,1221,7,18,"Eb",2
19,"19171",4352,3299,3221,35,78,"Eb",15
21,"21063",2624,2109,2097,13,12,"Eb",4
48,"48008",600,432,428,3,4,"Eb",0
18,"18033",282,227,226,0,1,"Eb",0
33,"33029",420,243,241,3,2,"Eb",1
13,"13036",837,671,666,3,5,"Eb",0
19,"19039",73,57,57,0,0,"Eb",0
28,"28075",5127,3976,3916,42,60,"Eb",15
19,"19135",120,102,100,2,2,"Eb",0
13,"13047",5822,4735,4650,52,85,"Eb",21
50,"50169",371,275,274,5,1,"Eb",3
50,"50109",101,79,79,2,0,"Eb",1
28,"28017",1120,905,888,8,17,"Eb",4
30,"30013",7369,5780,5731,53,49,"Eb",3
28,"28039",139,103,103,1,0,"Eb",0
11,"11041",9805,7136,7067,87,69,"Eb",8
19,"19060",165,127,121,3,6,"Eb",0
28,"28020",145,102,100,0,2,"Eb",1
50,"50224",70,52,49,2,3,"Eb",1
50,"50215",21,20,19,0,1,"Eb",0
50,"50108",50,31,31,0,0,"Eb",0
44,"44002",62,47,47,1,0,"Eb",0
11,"11902",3578,2400,2376,21,24,"Eb",10
37,"37258",206,151,149,2,2,"Eb",2
2,"2042",897,712,709,6,3,"Eb",2
29,"29005",4307,2967,2951,18,16,"Eb",6
37,"37077",293,262,258,3,4,"Eb",0
29,"29045",1750,1246,1239,6,7,"Eb",1
37,"37333",247,160,154,2,6,"Eb",0
19,"19237",53,40,39,2,1,"Eb",0
44,"44185",117,91,90,0,1,"Eb",0
37,"37100",89,77,76,4,1,"Eb",0
19,"19263",34,27,27,0,0,"Eb",0
28,"28113",31318,23779,23436,271,343,"Eb",92
19,"19006",873,634,620,1,14,"Eb",3
49,"49178",679,469,461,9,8,"Eb",5
50,"50265",63,46,46,1,0,"Eb",0
28,"28157",605,452,446,2,6,"Eb",0
50,"50138",49,43,43,2,0,"Eb",0
29,"29031",1652,1123,1118,11,5,"Eb",3
49,"49221",266,148,147,6,1,"Eb",0
44,"44220",137,97,96,1,1,"Eb",0
49,"49119",245,194,191,2,3,"Eb",0
18,"18006",4116,2862,2831,25,31,"Eb",8
49,"49023",1033,736,728,10,8,"Eb",5
41,"41024",22383,15333,15160,213,173,"Eb",37
37,"37324",415,338,334,2,4,"Eb",2
50,"50025",4569,3319,3271,68,48,"Eb",10
48,"48024",1026,845,841,3,4,"Eb",2
18,"18907",1997,1627,1612,5,15,"Eb",2
28,"28086",4603,3286,3248,29,38,"Eb",9
18,"18047",5603,3833,3805,67,28,"Eb",19
37,"37012",155,124,120,1,4,"Eb",0
44,"44252",78,63,60,0,3,"Eb",0
28,"28034",356,278,276,1,2,"Eb",0
49,"49257",277,180,179,0,1,"Eb",2
19,"19019",23,18,18,0,0,"Eb",0
50,"50037",140,110,103,3,7,"Eb",0
19,"19249",38,32,32,0,0,"Eb",0
37,"37028",175,130,125,1,5,"Eb",1
50,"50088",337,273,264,4,9,"Eb",1
37,"37037",130,100,99,0,1,"Eb",0
49,"49133",344,247,243,3,4,"Eb",0
33,"33007",1680,1186,1179,10,7,"Eb",4
19,"19184",88,63,62,1,1,"Eb",0
19,"19274",881,652,644,8,8,"Eb",3
50,"50026",459,360,354,5,6,"Eb",0
44,"44017",316,232,229,1,3,"Eb",2
18,"18053",1836,1345,1340,11,5,"Eb",1
28,"28147",910,705,698,5,7,"Eb",1
19,"19151",1126,849,830,3,19,"Eb",0
37,"37368",18,15,15,1,0,"Eb",0
44,"44163",119,91,91,0,0,"Eb",0
44,"44096",173,139,133,4,6,"Eb",1
13,"13057",1214,1018,998,9,20,"Eb",1
44,"44122",1441,1009,990,21,19,"Eb",5
41,"41063",2678,1869,1853,22,16,"Eb",1
13,"13021",459,358,355,5,3,"Eb",1
13,"13049",838,654,648,0,6,"Eb",1
37,"37049",163,119,119,0,0,"Eb",0
49,"49022",319,266,261,3,5,"Eb",1
19,"19314",46,41,41,0,0,"Eb",0
49,"49263",69,54,54,2,0,"Eb",0
28,"28111",618,486,479,2,7,"Eb",0
33,"33014",9318,6380,6320,66,60,"Eb",31
50,"50078",278,210,208,2,2,"Eb",1
37,"37154",156,130,125,1,5,"Eb",1
37,"37057",223,190,190,0,0,"Eb",0
49,"49181",386,308,307,2,1,"Eb",0
49,"49231",360,256,254,4,2,"Eb",1
33,"33022",992,709,696,12,13,"Eb",3
44,"44080",294,216,211,3,5,"Eb",0
37,"37164",280,217,213,9,4,"Eb",0
37,"37165",27,20,20,1,0,"Eb",0
29,"29091",8777,6226,6126,64,100,"Eb",7
41,"41068",13809,10171,10072,100,99,"Eb",8
19,"19082",91,68,67,1,1,"Eb",0
37,"37197",101,72,70,1,2,"Eb",1
50,"50191",505,395,390,4,5,"Eb",0
48,"48076",294,226,226,0,0,"Eb",0
13,"13043",251,208,206,1,2,"Eb",0
18,"18030",612,457,456,0,1,"Eb",2
13,"13052",6580,4869,4786,76,83,"Eb",3
19,"19212",795,644,632,2,12,"Eb",1
21,"21053",3278,2363,2325,20,38,"Eb",3
18,"18078",768,638,637,1,1,"Eb",1
48,"48032",5864,4257,4223,32,34,"Eb",10
30,"30021",8550,6423,6349,44,74,"Eb",8
21,"21077",1690,1335,1321,8,14,"Eb",0
11,"11003",1290,952,940,8,12,"Eb",0
44,"44135",149,110,109,1,1,"Eb",0
44,"44051",2783,2144,2089,38,55,"Eb",10
11,"11039",9943,6634,6582,104,52,"Eb",14
37,"37021",86,70,68,2,2,"Eb",0
50,"50051",886,677,671,9,6,"Eb",1
44,"44039",255,189,189,5,0,"Eb",0
49,"49053",978,809,796,10,13,"Eb",2
37,"37205",235,199,195,5,4,"Eb",0
44,"44247",335,251,243,10,8,"Eb",1
2,"2054",421,346,343,2,3,"Eb",2
49,"49037",201,171,171,2,0,"Eb",0
41,"41048",2296,1749,1726,21,23,"Eb",1
50,"50054",63,46,46,0,0,"Eb",1
49,"49068",523,356,353,5,3,"Eb",1
50,"50248",552,421,407,5,14,"Eb",0
44,"44229",150,108,107,5,1,"Eb",3
50,"50280",370,296,291,5,5,"Eb",0
18,"18165",3942,2819,2776,27,43,"Eb",9
18,"18178",834,685,683,3,2,"Eb",0
37,"37289",265,211,209,0,2,"Eb",0
37,"37319",138,94,94,1,0,"Eb",0
18,"18066",2072,1558,1552,8,6,"Eb",0
14,"14071",1025,739,733,8,6,"Eb",2
13,"13073",565,459,456,2,3,"Eb",0
13,"13080",418,310,309,1,1,"Eb",0
50,"50057",1468,1022,1004,17,18,"Eb",2
30,"30041",12957,9360,9288,89,72,"Eb",17
37,"37365",172,152,149,2,3,"Eb",0
49,"49047",120,91,90,1,1,"Eb",1
50,"50099",3136,2333,2297,27,36,"Eb",11
19,"19045",180,145,145,1,0,"Eb",0
19,"19130",58473,45114,44362,688,752,"Eb",192
50,"50075",89,74,74,1,0,"Eb",0
49,"49226",279,235,233,1,2,"Eb",1
21,"21067",418,318,312,5,6,"Eb",0
37,"37248",160,130,130,1,0,"Eb",0
44,"44114",254,194,188,4,6,"Eb",1
2,"2067",1197,938,924,6,14,"Eb",8
13,"13058",4155,3320,3285,24,35,"Eb",4
49,"49122",701,542,534,7,8,"Eb",1
50,"50012",105,93,90,0,3,"Eb",0
37,"37106",289,199,196,2,3,"Eb",1
33,"33051",7576,5379,5335,65,44,"Eb",24
49,"49035",260,231,229,4,2,"Eb",0
30,"30016",149046,103847,102890,1031,957,"Eb",328
14,"14045",3093,2662,2642,14,20,"Eb",5
37,"37060",229,179,173,2,6,"Eb",0
50,"50079",281,213,210,2,3,"Eb",1
50,"50197",89,65,65,3,0,"Eb",0
49,"49245",296,218,218,2,0,"Eb",4
50,"50063",76,67,67,0,0,"Eb",0
49,"49171",704,568,561,6,7,"Eb",2
18,"18013",4392,3268,3223,23,45,"Eb",5
14,"14014",2610,2160,2125,19,35,"Eb",3
44,"44032",18,12,12,0,0,"Eb",0
13,"13003",503,390,387,2,3,"Eb",0
2,"2026",845,723,716,5,7,"Eb",3
29,"29040",1934,1344,1332,12,12,"Eb",1
41,"41006",2743,1972,1957,13,15,"Eb",0
2,"2062",456,348,344,2,4,"Eb",0
49,"49123",557,421,415,5,6,"Eb",1
37,"37016",539,424,420,8,4,"Eb",3
37,"37293",131,108,106,5,2,"Eb",0
28,"28106",72603,53231,52524,681,707,"Eb",252
29,"29041",2796,1950,1921,24,29,"Eb",3
33,"33044",180964,129466,128346,1888,1120,"Eb",494
44,"44109",123,86,84,2,2,"Eb",0
37,"37264",78,52,52,0,0,"Eb",0
50,"50245",121,80,80,1,0,"Eb",1
37,"37056",56,47,47,0,0,"Eb",0
48,"48020",276378,191777,190141,2335,1636,"Eb",1084
18,"18020",1473,1111,1106,7,5,"Eb",0
49,"49143",243,161,157,0,4,"Eb",0
21,"21017",3581,2416,2389,27,27,"Eb",5
28,"28043",5944,4199,4147,56,52,"Eb",5
18,"18071",5589,4268,4205,44,63,"Eb",9
14,"14041",3215,2492,2439,45,53,"Eb",0
19,"19010",15,13,13,1,0,"Eb",0
11,"11037",5640,4337,4285,32,52,"Eb",4
19,"19059",84,60,60,0,0,"Eb",0
49,"49222",404,297,294,4,3,"Eb",1
37,"37284",334,256,254,1,2,"Eb",0
29,"29085",156,116,113,0,3,"Eb",0
28,"28052",3799,2753,2719,17,34,"Eb",4
50,"50253",461,381,375,3,6,"Eb",2
44,"44112",473,353,350,4,3,"Eb",1
29,"29088",2784,2019,1975,14,44,"Eb",1
19,"19331",2497,1898,1847,19,51,"Eb",2
50,"50291",112,75,73,0,2,"Eb",0
14,"14027",7948,5944,5871,92,73,"Eb",11
21,"21009",916,622,608,6,14,"Eb",0
50,"50094",1744,1220,1193,25,27,"Eb",2
50,"50165",1880,1339,1274,49,65,"Eb",16
44,"44022",550,387,380,6,7,"Eb",4
33,"33072",1737,1171,1159,11,12,"Eb",1
28,"28015",14491,11562,11417,155,145,"Eb",40
11,"11013",2284,1691,1670,15,21,"Eb",0
18,"18135",4752,3252,3212,34,40,"Eb",5
41,"41033",5237,3915,3878,20,37,"Eb",2
44,"44052",96,60,59,2,1,"Eb",0
29,"29004",343,281,281,0,0,"Eb",0
37,"37033",86,64,63,1,1,"Eb",1
37,"37029",226,181,178,4,3,"Eb",0
13,"13087",22953,16674,16376,298,298,"Eb",95
19,"19157",66,56,56,4,0,"Eb",0
50,"50105",343,263,259,2,4,"Eb",0
50,"50254",179,136,136,0,0,"Eb",0
49,"49265",143,105,105,1,0,"Eb",0
41,"41085",3918,3173,3128,42,45,"Eb",13
48,"48063",355,287,287,6,0,"Eb",0
19,"19224",119,95,94,0,1,"Eb",0
29,"29051",37991,24498,24095,381,403,"Eb",50
11,"11031",76347,49071,48616,681,455,"Eb",199
30,"30030",305669,236235,234391,2112,1844,"Eb",617
48,"48016",5214,3782,3736,46,46,"Eb",11
28,"28130",27391,21367,21111,235,256,"Eb",80
14,"14061",841,700,693,3,7,"Eb",0
13,"13054",5032,3901,3824,70,77,"Eb",33
19,"19245",1222,954,943,10,11,"Eb",1
19,"19116",16,10,10,0,0,"Eb",0
19,"19187",64,54,54,0,0,"Eb",1
29,"29013",1718,1302,1283,4,19,"Eb",3
44,"44062",38,34,34,0,0,"Eb",0
50,"50060",187,138,136,1,2,"Eb",1
37,"37302",337,230,229,5,1,"Eb",1
33,"33059",5049,3480,3447,37,33,"Eb",11
41,"41091",545464,388043,383816,5325,4227,"Eb",1261
28,"28031",1981,1524,1500,9,24,"Eb",0
41,"41004",55127,37662,37179,622,483,"Eb",155
29,"29084",28386,19450,19202,296,248,"Eb",53
13,"13091",570,484,478,0,6,"Eb",0
48,"48083",7021,4722,4656,74,66,"Eb",18
28,"28057",1419,1084,1074,12,10,"Eb",7
28,"28065",118796,93292,92186,919,1106,"Eb",320
19,"19305",166,130,130,0,0,"Eb",0
29,"29057",413,311,308,2,3,"Eb",0
44,"44126",344,250,236,1,14,"Eb",2
37,"37214",134,94,94,4,0,"Eb",0
30,"30027",45194,35272,34973,366,299,"Eb",106
19,"19266",278,234,231,4,3,"Eb",1
44,"44040",206,167,166,5,1,"Eb",0
49,"49259",121,88,87,1,1,"Eb",0
19,"19286",743,566,554,8,12,"Eb",1
49,"49032",369,295,291,0,4,"Eb",0
50,"50260",42,35,35,1,0,"Eb",0
44,"44153",1882,1273,1246,10,27,"Eb",4
37,"37276",188,136,135,0,1,"Eb",0
44,"44006",293,220,212,3,8,"Eb",2
19,"19214",94,78,78,2,0,"Eb",0
19,"19113",519,396,395,4,1,"Eb",0
37,"37381",153,114,109,3,5,"Eb",0
21,"21060",11685,8026,7932,135,94,"Eb",20
29,"29047",1165,973,969,0,4,"Eb",2
2,"2050",121,95,95,1,0,"Eb",0
28,"28099",1670,1258,1246,9,12,"Eb",1
18,"18180",655,450,447,1,3,"Eb",1
37,"37104",32,24,23,0,1,"Eb",0
21,"21064",6331,4390,4352,46,38,"Eb",19
28,"28062",311,233,226,0,7,"Eb",0
18,"18002",625,505,504,2,1,"Eb",0
30,"30001",4763,3992,3956,26,36,"Eb",3
50,"50027",260,209,202,2,7,"Eb",0
37,"37036",74,54,52,0,2,"Eb",0
14,"14047",1566,1154,1143,19,11,"Eb",7
19,"19319",4203,3139,3104,28,35,"Eb",6
28,"28127",60108,48418,48039,568,379,"Eb",169
29,"29029",452,339,336,0,3,"Eb",1
49,"49014",134,104,102,1,2,"Eb",0
49,"49167",223,173,171,5,2,"Eb",1
18,"18901",583,374,368,3,6,"Eb",0
49,"49136",347,249,247,6,2,"Eb",0
46,"46200",1915,1625,1595,15,30,"EB",9
46,"46180",715,585,581,4,4,"EB",0
46,"46130",934,745,734,6,11,"EB",0
46,"46127",2790,2298,2267,23,31,"EB",10
46,"46026",1217,1043,1035,2,8,"EB",4
46,"46184",26507,20314,20010,263,304,"EB",59
46,"46046",922,699,694,2,5,"EB",0
46,"46119",856,702,693,0,9,"EB",0
46,"46095",632,505,495,1,10,"EB",1
46,"46122",2737,2154,2131,18,23,"EB",3
46,"46192",755,564,554,9,10,"EB",1
46,"46075",166,148,145,3,3,"EB",0
46,"46102",19880,15358,15179,122,179,"EB",34
46,"46176",1965,1423,1405,12,18,"EB",1
46,"46064",547,463,458,2,5,"EB",0
46,"46067",1798,1487,1472,10,15,"EB",3
46,"46169",31753,24041,23802,270,239,"EB",73
46,"46107",1998,1650,1623,8,27,"EB",0
46,"46263",333,243,241,2,2,"EB",0
46,"46154",836,684,678,7,6,"EB",3
46,"46188",660,579,576,4,3,"EB",0
46,"46143",4278,3309,3266,46,43,"EB",2
46,"46007",11576,8929,8848,71,81,"EB",18
46,"46148",1400,1131,1114,13,17,"EB",1
46,"46022",15090,10922,10840,99,82,"EB",25
46,"46257",5579,4546,4512,32,34,"EB",4
46,"46227",923,787,771,4,16,"EB",2
46,"46162",1230,1045,1027,6,18,"EB",0
46,"46010",927,706,699,3,7,"EB",2
46,"46134",2326,1691,1664,20,27,"EB",8
46,"46004",1933,1563,1541,8,22,"EB",4
46,"46049",292,249,245,0,4,"EB",0
46,"46170",3464,2944,2908,24,36,"EB",3
46,"46018",689,597,592,12,5,"EB",1
46,"46203",3669,3002,2964,36,38,"EB",3
46,"46142",870,682,673,7,9,"EB",3
46,"46166",8260,6422,6324,60,98,"EB",25
46,"46052",532,471,463,2,8,"EB",1
46,"46110",21420,15810,15671,134,139,"EB",34
46,"46113",2338,1804,1797,14,7,"EB",4
46,"46204",6906,5426,5357,62,69,"EB",15
46,"46100",307,264,255,0,9,"EB",0
46,"46054",11422,8666,8566,82,100,"EB",13
46,"46002",1166,942,915,7,27,"EB",3
46,"46121",116,103,101,0,2,"EB",1
46,"46174",1003,854,847,6,7,"EB",0
46,"46245",478,357,354,1,3,"EB",0
46,"46083",15427,12079,11941,109,138,"EB",26
46,"46222",378,321,310,1,11,"EB",0
46,"46231",2496,1831,1817,16,14,"EB",5
46,"46061",331,276,273,3,3,"EB",3
46,"46202",15578,11811,11676,110,135,"EB",25
46,"46118",3883,3141,3105,28,36,"EB",9
46,"46224",179,131,128,0,3,"EB",2
46,"46111",10589,7823,7710,94,113,"EB",11
46,"46077",7637,5979,5845,64,134,"EB",9
46,"46138",338,297,296,1,1,"EB",0
46,"46038",368,264,260,1,4,"EB",0
46,"46195",1975,1631,1631,33,0,"EB",1
46,"46150",1898,1555,1541,8,14,"EB",0
46,"46091",126,108,108,0,0,"EB",0
46,"46240",226,188,185,3,3,"EB",0
46,"46086",80,71,71,3,0,"EB",1
46,"46039",2200,1849,1820,12,29,"EB",3
46,"46058",1787,1460,1441,10,19,"EB",3
46,"46062",4589,3794,3752,46,42,"EB",11
46,"46126",5471,4454,4392,53,62,"EB",13
46,"46115",515,364,354,1,10,"EB",0
46,"46216",4806,3857,3825,39,32,"EB",13
46,"46085",11344,8526,8426,87,100,"EB",6
46,"46096",320,267,267,0,0,"EB",2
46,"46252",142,108,107,1,1,"EB",0
46,"46218",1082,964,936,5,28,"EB",1
46,"46103",1244,998,972,12,26,"EB",4
46,"46235",21966,16641,16465,167,176,"EB",44
46,"46219",143,127,126,1,1,"EB",0
46,"46183",5946,4718,4656,35,62,"EB",16
46,"46210",346,300,295,4,5,"EB",0
46,"46112",582,475,463,4,12,"EB",3
46,"46105",16708,12164,12040,100,124,"EB",20
46,"46232",920,730,722,6,8,"EB",0
46,"46229",1065,840,831,8,9,"EB",0
46,"46129",553,430,423,4,7,"EB",0
46,"46168",1828,1461,1449,7,12,"EB",6
46,"46132",2124,1845,1817,14,28,"EB",2
46,"46173",1393,1156,1137,10,19,"EB",1
46,"46201",83,50,49,0,1,"EB",0
46,"46255",3135,2530,2508,11,22,"EB",17
46,"46228",2434,1881,1859,30,22,"EB",6
46,"46258",2792,2196,2164,14,32,"EB",6
46,"46236",996,853,844,7,9,"EB",3
46,"46208",1141,990,978,6,12,"EB",5
46,"46196",159,145,144,1,1,"EB",0
46,"46161",1454,1192,1179,8,13,"EB",5
46,"46035",6470,5115,5047,38,68,"EB",15
46,"46089",2116,1653,1627,9,26,"EB",1
46,"46031",10580,7900,7809,87,91,"EB",9
46,"46057",483,357,349,9,8,"EB",0
46,"46193",8494,6662,6580,73,82,"EB",25
46,"46051",8122,6432,6378,57,54,"EB",6
46,"46221",350,319,317,3,2,"EB",0
46,"46078",28197,20643,20415,205,228,"EB",58
46,"46024",448,365,358,1,7,"EB",0
46,"46005",22815,17016,16838,185,178,"EB",71
46,"46021",23273,17264,17091,163,173,"EB",35
46,"46097",890,674,662,2,12,"EB",2
46,"46008",2727,2249,2233,17,16,"EB",7
46,"46194",15267,11622,11491,110,131,"EB",28
46,"46212",1598,1233,1218,5,15,"EB",2
46,"46072",3711,3006,2932,38,74,"EB",8
46,"46146",1718,1395,1374,10,21,"EB",8
46,"46903",5210,4037,4000,40,37,"EB",19
46,"46019",8671,7195,7109,70,86,"EB",11
46,"46011",7727,5874,5777,75,97,"EB",16
46,"46104",2012,1691,1676,9,15,"EB",3
46,"46066",1264,1060,1050,5,10,"EB",2
46,"46016",1097,927,917,12,10,"EB",0
46,"46175",469,406,401,5,5,"EB",1
46,"46251",2599,2215,2179,21,36,"EB",4
46,"46237",7261,5405,5350,54,55,"EB",25
46,"46259",537,426,424,9,2,"EB",2
46,"46117",476,377,373,6,4,"EB",1
46,"46247",1059,829,823,6,6,"EB",4
46,"46012",930,698,684,9,14,"EB",2
46,"46069",166,149,148,1,1,"EB",0
46,"46099",987,764,754,2,10,"EB",1
46,"46151",717,596,589,3,7,"EB",2
46,"46178",4406,3235,3201,22,34,"EB",13
46,"46042",3376,2873,2819,17,54,"EB",3
46,"46070",15946,11979,11874,113,105,"EB",36
46,"46023",318,275,267,2,8,"EB",0
46,"46135",9634,7671,7586,64,85,"EB",33
46,"46036",675,440,431,11,9,"EB",4
46,"46199",5661,4328,4280,38,48,"EB",12
46,"46167",411,312,309,0,3,"EB",0
46,"46056",203,164,160,2,4,"EB",1
46,"46059",1310,1076,1058,2,18,"EB",6
46,"46159",23111,17258,17086,141,172,"EB",57
46,"46254",1085,847,834,12,13,"EB",4
46,"46048",3484,2915,2875,26,40,"EB",3
46,"46147",16527,11836,11716,105,120,"EB",24
46,"46124",768,641,632,10,9,"EB",2
46,"46250",574266,435877,431619,4626,4258,"EB",1484
46,"46223",7685,6040,5996,62,44,"EB",9
46,"46020",3793,3084,3046,21,38,"EB",9
46,"46207",6453,5086,5031,52,55,"EB",12
46,"46047",551,479,469,10,10,"EB",0
46,"46211",1716,1459,1447,9,12,"EB",8
46,"46108",550,446,444,3,2,"EB",0
46,"46014",3092,2449,2420,26,29,"EB",4
46,"46006",4643,3847,3785,32,62,"EB",6
46,"46139",4594,3794,3734,28,60,"EB",1
46,"46074",2656,2071,2053,22,18,"EB",8
46,"46032",5583,4342,4287,39,55,"EB",13
46,"46123",1808,1440,1410,7,30,"EB",2
46,"46197",1902,1559,1554,15,5,"EB",3
46,"46043",149,139,139,0,0,"EB",2
46,"46088",196,146,140,0,6,"EB",1
46,"46076",651,541,528,2,13,"EB",0
46,"46234",388,308,307,3,1,"EB",0
46,"46071",488,418,402,10,16,"EB",1
46,"46220",48981,34657,34242,450,415,"EB",97
46,"46185",422,360,359,7,1,"EB",2
46,"46093",2082,1722,1716,9,6,"EB",3
46,"46248",4847,3655,3597,25,58,"EB",6
46,"46029",20887,16124,15988,144,136,"EB",48
46,"46094",20341,15367,15222,152,145,"EB",32
46,"46082",4661,3447,3401,46,46,"EB",4
46,"46045",1288,1065,1044,2,21,"EB",1
46,"46182",1190,864,855,11,9,"EB",3
46,"46136",2476,1890,1865,16,25,"EB",1
46,"46098",2556,2072,2057,12,15,"EB",6
46,"46145",21751,16601,16397,155,204,"EB",31
46,"46226",34,34,33,0,1,"EB",0
46,"46156",2065,1746,1721,14,25,"EB",2
46,"46073",1119,931,915,14,16,"EB",0
46,"46033",220,183,181,0,2,"EB",0
46,"46060",9510,7506,7408,52,98,"EB",14
46,"46013",16111,12469,12328,145,141,"EB",36
46,"46186",18444,14173,14029,135,144,"EB",32
46,"46205",14277,10882,10764,115,118,"EB",33
46,"46160",1976,1591,1570,21,21,"EB",3
46,"46034",1791,1477,1468,8,9,"EB",5
46,"46053",584,484,461,2,23,"EB",2
46,"46179",2186,1849,1804,17,45,"EB",0
46,"46238",13401,10371,10283,96,88,"EB",14
46,"46081",10254,8188,8101,52,87,"EB",13
46,"46243",149,120,117,0,3,"EB",0
46,"46028",424,352,347,5,5,"EB",1
46,"46109",6143,4731,4637,40,94,"EB",8
46,"46015",7042,5644,5581,53,63,"EB",10
46,"46087",137,105,105,1,0,"EB",0
46,"46244",57805,41885,41595,415,290,"EB",92
46,"46092",304,206,201,1,5,"EB",1
46,"46158",1037,829,822,9,7,"EB",0
46,"46120",1133,889,870,2,19,"EB",5
46,"46209",1984,1606,1594,11,12,"EB",3
46,"46233",3911,3025,2988,10,37,"EB",4
46,"46155",1072,861,849,4,12,"EB",0
46,"46253",118,105,102,7,3,"EB",0
46,"46133",686,572,565,1,7,"EB",0
46,"46904",782,659,650,6,9,"EB",1
46,"46256",6734,4902,4858,33,44,"EB",17
46,"46149",398,307,305,1,2,"EB",0
46,"46116",12587,9821,9724,120,97,"EB",39
46,"46214",15129,11609,11500,116,109,"EB",37
46,"46050",161,126,123,1,3,"EB",1
46,"46025",2495,1962,1941,24,21,"EB",5
46,"46215",1451,1185,1169,8,16,"EB",4
46,"46172",4838,3492,3445,24,47,"EB",4
46,"46261",1706,1388,1366,13,22,"EB",1
46,"46165",6962,5390,5322,53,68,"EB",14
46,"46230",14204,10650,10515,112,135,"EB",30
46,"46177",4594,3576,3523,29,53,"EB",12
46,"46262",228,161,158,0,3,"EB",0
46,"46068",326,292,285,3,7,"EB",0
46,"46009",3140,2521,2498,15,23,"EB",7
46,"46239",457,331,323,2,8,"EB",0
46,"46171",16753,12565,12399,122,166,"EB",26
46,"46217",912,758,751,4,7,"EB",0
46,"46190",48324,34747,34424,431,323,"EB",126
46,"46246",1081,917,904,5,13,"EB",2
46,"46055",1286,1083,1067,11,16,"EB",3
46,"46141",424,338,336,2,2,"EB",1
46,"46164",11634,8843,8724,90,119,"EB",20
46,"46101",868,720,716,8,4,"EB",0
46,"46225",360,319,310,5,9,"EB",0
46,"46249",9650,7288,7191,125,97,"EB",5
46,"46187",1339,1096,1083,13,13,"EB",5
46,"46030",800,677,662,6,15,"EB",0
46,"46040",1227,1028,1021,13,7,"EB",2
46,"46137",273,232,229,1,3,"EB",0
46,"46144",699,547,536,2,11,"EB",0
46,"46106",1616,1196,1188,6,8,"EB",3
46,"46041",369,255,255,1,0,"EB",0
46,"46181",17153,13332,13184,108,148,"EB",52
46,"46191",1952,1554,1528,9,26,"EB",4
46,"46189",490,400,396,3,4,"EB",1
46,"46027",997,869,855,4,14,"EB",1
46,"46001",863,647,641,5,6,"EB",2
46,"46152",96,70,70,0,0,"EB",0
46,"46153",445,374,366,7,8,"EB",2
46,"46198",815,660,654,4,6,"EB",3
46,"46065",1606,1250,1234,15,16,"EB",1
46,"46090",1668,1488,1452,9,36,"EB",1
46,"46084",1587,1363,1332,7,31,"EB",1
46,"46128",1649,1322,1292,14,30,"EB",3
46,"46114",565,501,495,3,6,"EB",2
46,"46131",49087,37846,37477,422,369,"EB",102
46,"46140",379,314,313,0,1,"EB",0
46,"46063",1764,1441,1423,15,18,"EB",1
46,"46902",425,333,332,3,1,"EB",0
46,"46206",595,497,495,3,2,"EB",0
46,"46242",361,288,280,4,8,"EB",1
46,"46163",1811,1487,1463,12,24,"EB",10
46,"46125",858,724,710,6,14,"EB",2
46,"46213",15621,11361,11164,214,197,"EB",31
46,"46080",1090,860,849,2,11,"EB",0
46,"46003",988,864,847,13,17,"EB",7
46,"46037",1146,1007,1003,5,4,"EB",0
46,"46017",32928,24879,24672,267,207,"EB",64
46,"46241",440,336,314,4,22,"EB",2
46,"46044",4301,3284,3169,50,115,"EB",6
46,"46157",3068,2523,2491,17,32,"EB",2
46,"46260",2576,2140,2106,24,34,"EB",2
46,"46079",381,304,299,3,5,"EB",1
8,"8308",145,116,115,1,1,"Eb",0
17,"17184",1281,803,787,21,16,"Eb",13
25,"25096",988,633,613,12,20,"Eb",8
25,"25061",75,45,45,0,0,"Eb",0
25,"25202",110,62,59,3,3,"Eb",0
25,"25244",350,270,268,9,2,"Eb",3
25,"25208",294,174,170,3,4,"Eb",1
25,"25218",94,75,73,1,2,"Eb",0
7,"7007",454,304,300,4,4,"Eb",2
7,"7015",20783,12244,12016,381,228,"Eb",169
8,"8138",4014,2735,2679,46,56,"Eb",84
8,"8056",39345,26705,26396,449,309,"Eb",398
7,"7026",30036,16912,16661,294,251,"Eb",103
8,"8217",24130,17554,17319,383,235,"Eb",251
25,"25145",88,67,67,2,0,"Eb",0
8,"8277",134,90,90,4,0,"Eb",2
8,"8093",32,21,20,0,1,"Eb",2
25,"25071",56,37,35,2,2,"Eb",0
25,"25161",361,222,218,1,4,"Eb",8
17,"17066",25667,15429,15157,244,272,"Eb",190
25,"25052",1611,1094,1062,21,32,"Eb",13
8,"8137",255,190,190,3,0,"Eb",1
8,"8200",61189,40677,40069,736,608,"Eb",489
17,"17196",209,139,138,6,1,"Eb",1
17,"17014",64,39,37,0,2,"Eb",0
17,"17018",478,337,332,8,5,"Eb",4
43,"43108",1808,1183,1157,28,26,"Eb",5
43,"43173",114,65,64,0,1,"Eb",0
8,"8124",36292,24541,24210,471,331,"Eb",306
17,"17076",126,77,76,5,1,"Eb",1
17,"17015",12254,7759,7553,143,206,"Eb",187
25,"25055",187,115,115,3,0,"Eb",2
7,"7014",6697,3818,3757,38,61,"Eb",20
17,"17124",1670,1087,1056,18,31,"Eb",9
25,"25150",185,119,113,4,6,"Eb",0
17,"17169",2460,1690,1651,34,39,"Eb",37
8,"8117",2424,1685,1661,45,24,"Eb",37
43,"43079",387,259,255,26,4,"Eb",1
25,"25167",253,176,172,0,4,"Eb",6
8,"8026",180,144,143,0,1,"Eb",2
17,"17087",230,170,161,6,9,"Eb",5
17,"17023",26941,17098,16799,344,299,"Eb",194
43,"43018",430,350,337,7,13,"Eb",1
43,"43172",378,268,266,8,2,"Eb",0
7,"7048",15296,8559,8439,176,120,"Eb",64
8,"8179",591,415,405,6,10,"Eb",7
25,"25072",5921,3743,3637,81,106,"Eb",31
25,"25051",1710,1060,1044,23,16,"Eb",17
8,"8231",19810,12359,12196,244,163,"Eb",191
25,"25219",144,90,86,0,4,"Eb",2
8,"8032",1955,1330,1294,18,36,"Eb",20
25,"25017",248,160,159,1,1,"Eb",3
17,"17148",1546,980,957,24,23,"Eb",27
25,"25014",264,170,164,11,6,"Eb",4
17,"17041",237,153,153,1,0,"Eb",1
25,"25251",670,476,473,1,3,"Eb",7
17,"17203",171,97,94,3,3,"Eb",5
25,"25086",569,379,370,4,9,"Eb",2
25,"25132",128,87,85,3,2,"Eb",2
43,"43071",975,677,664,14,13,"Eb",9
43,"43142",1155,730,714,20,16,"Eb",1
7,"7010",4668,3229,3174,58,55,"Eb",45
8,"8005",5884,4114,4041,68,73,"Eb",52
17,"17212",129,100,98,4,2,"Eb",5
7,"7021",255,197,193,1,4,"Eb",2
17,"17105",257,152,146,4,6,"Eb",6
8,"8901",249,180,180,2,0,"Eb",1
43,"43167",390,284,280,12,4,"Eb",1
8,"8210",4176,2661,2579,54,82,"Eb",54
17,"17147",8385,5401,5325,105,76,"Eb",68
25,"25135",1077,739,722,18,17,"Eb",3
43,"43082",383,282,270,8,12,"Eb",2
43,"43061",55,31,31,1,0,"Eb",0
8,"8168",418,268,266,0,2,"Eb",5
8,"8227",2372,1591,1549,38,42,"Eb",12
17,"17164",4092,2409,2346,60,63,"Eb",48
17,"17140",684,476,470,10,6,"Eb",9
8,"8104",713,454,441,9,13,"Eb",4
25,"25127",226,134,130,2,4,"Eb",1
7,"7051",4925,2993,2947,66,46,"Eb",43
17,"17216",158,100,97,1,3,"Eb",1
8,"8097",985,676,657,3,19,"Eb",10
8,"8087",158,133,132,6,1,"Eb",2
25,"25185",690,409,404,8,5,"Eb",4
8,"8248",5239,3513,3443,71,70,"Eb",32
25,"25057",198,140,136,2,4,"Eb",3
17,"17198",404,264,259,9,5,"Eb",1
25,"25139",549,358,357,5,1,"Eb",2
17,"17178",1075,683,679,15,4,"Eb",11
25,"25104",128,88,86,11,2,"Eb",1
25,"25122",1956,1281,1256,33,25,"Eb",10
17,"17022",6771,4247,4169,76,78,"Eb",105
17,"17154",93,54,49,1,5,"Eb",1
25,"25165",301,202,198,6,4,"Eb",0
25,"25121",623,406,400,6,6,"Eb",4
8,"8074",10224,6571,6479,116,92,"Eb",78
17,"17034",6723,4131,4064,77,67,"Eb",51
8,"8181",7722,5280,5188,112,92,"Eb",53
43,"43134",279,208,206,14,2,"Eb",3
8,"8268",1110,768,755,17,13,"Eb",7
8,"8096",40650,28247,27784,527,463,"Eb",357
25,"25209",1558,1041,1009,22,32,"Eb",12
43,"43169",477,377,364,8,13,"Eb",8
17,"17199",6630,4242,4162,80,80,"Eb",65
25,"25040",10654,6905,6768,144,137,"Eb",43
8,"8193",928,565,554,15,11,"Eb",6
8,"8287",1053,738,730,26,8,"Eb",9
25,"25910",118,77,76,3,1,"Eb",0
17,"17205",198,146,138,3,8,"Eb",2
8,"8064",1847,1277,1246,14,31,"Eb",22
8,"8116",600,401,393,9,8,"Eb",6
8,"8048",622,461,454,9,7,"Eb",5
25,"25243",3408,2280,2252,49,28,"Eb",18
25,"25138",605,440,428,13,12,"Eb",2
17,"17095",19245,11212,11067,160,145,"Eb",90
8,"8022",12437,7598,7445,169,153,"Eb",114
8,"8236",1507,1027,1002,18,25,"Eb",11
25,"25227",674,375,372,2,3,"Eb",3
43,"43107",378,255,248,18,7,"Eb",1
8,"8238",13892,10237,10094,206,143,"Eb",177
8,"8010",4124,2674,2611,44,63,"Eb",59
43,"43175",590,419,411,8,8,"Eb",1
8,"8120",6342,4801,4746,63,55,"Eb",44
43,"43039",117,85,83,3,2,"Eb",0
25,"25025",1307,874,859,32,15,"Eb",8
17,"17067",732,483,470,16,13,"Eb",11
25,"25232",1480,968,959,38,9,"Eb",6
8,"8283",5862,3712,3618,72,94,"Eb",89
43,"43110",307,216,214,5,2,"Eb",1
8,"8083",1626,1199,1178,23,21,"Eb",25
17,"17118",12541,7817,7681,130,136,"Eb",113
8,"8165",1689,1091,1070,18,21,"Eb",10
8,"8160",313,227,222,8,5,"Eb",6
8,"8157",8256,5729,5624,119,105,"Eb",68
43,"43170",880,601,592,9,9,"Eb",6
25,"25221",125,76,76,0,0,"Eb",1
17,"17234",183,131,128,2,3,"Eb",0
17,"17186",3593,2358,2317,33,41,"Eb",52
25,"25247",142,80,78,3,2,"Eb",0
8,"8213",6188,4031,3970,113,61,"Eb",44
8,"8304",822,587,578,16,9,"Eb",7
8,"8143",2679,1772,1756,35,16,"Eb",17
8,"8178",450,311,304,3,7,"Eb",2
43,"43058",106,76,76,5,0,"Eb",0
7,"7057",7102,4702,4611,85,91,"Eb",33
8,"8111",220,188,188,4,0,"Eb",6
8,"8204",2991,2076,2040,45,36,"Eb",32
8,"8185",189,131,126,1,5,"Eb",0
17,"17103",4988,2788,2724,51,64,"Eb",45
43,"43003",307,187,184,10,3,"Eb",0
17,"17084",269,177,175,4,2,"Eb",2
8,"8190",281,201,197,3,4,"Eb",2
17,"17101",567,349,339,4,10,"Eb",5
17,"17144",217,145,143,4,2,"Eb",0
43,"43091",142,106,98,5,8,"Eb",2
17,"17051",201,146,142,4,4,"Eb",7
7,"7006",4964,3234,3157,51,77,"Eb",31
7,"7062",7206,4073,4035,72,38,"Eb",29
8,"8161",10991,6841,6709,114,132,"Eb",69
25,"25154",126,77,77,2,0,"Eb",1
17,"17092",3520,2273,2228,42,45,"Eb",37
17,"17211",864,628,612,12,16,"Eb",13
43,"43028",2654,1620,1588,27,32,"Eb",21
17,"17116",369,230,227,3,3,"Eb",3
8,"8149",985,683,671,11,12,"Eb",16
43,"43086",5269,3275,3196,92,79,"Eb",33
8,"8192",5450,3688,3634,79,54,"Eb",56
25,"25203",8995,5418,5309,116,109,"Eb",53
43,"43135",327,243,238,2,5,"Eb",1
7,"7029",4090,2921,2866,44,55,"Eb",25
8,"8262",6835,4086,3993,94,93,"Eb",37
25,"25021",2693,1632,1605,40,27,"Eb",21
17,"17091",433,288,277,16,11,"Eb",5
43,"43074",1697,1150,1120,25,30,"Eb",9
25,"25006",362,231,228,2,3,"Eb",0
8,"8221",11348,8413,8306,109,107,"Eb",140
7,"7018",389,275,271,0,4,"Eb",5
43,"43150",1337,994,977,12,17,"Eb",7
8,"8209",6596,4415,4351,69,64,"Eb",59
43,"43019",1356,868,837,13,31,"Eb",4
43,"43163",24903,15475,15241,263,234,"Eb",131
25,"25016",2203,1375,1357,20,18,"Eb",17
8,"8038",1406,911,895,24,16,"Eb",20
8,"8253",134,91,91,2,0,"Eb",1
43,"43030",454,321,307,5,14,"Eb",4
8,"8164",873,606,584,13,22,"Eb",7
17,"17123",365,274,266,8,8,"Eb",3
25,"25036",190,138,134,5,4,"Eb",0
25,"25073",662,382,379,11,3,"Eb",1
8,"8188",106,87,86,4,1,"Eb",1
25,"25112",286,202,199,11,3,"Eb",1
17,"17160",14852,9257,9128,145,129,"Eb",110
43,"43094",2209,1558,1524,31,34,"Eb",20
8,"8301",47343,32098,31664,672,434,"Eb",366
17,"17044",6619,4293,4187,69,106,"Eb",74
17,"17065",316,211,205,6,6,"Eb",6
8,"8023",6546,4261,4194,86,67,"Eb",60
8,"8175",3477,2303,2270,39,33,"Eb",28
43,"43044",3990,2768,2715,72,53,"Eb",8
43,"43151",119,91,89,0,2,"Eb",1
17,"17180",8076,4868,4767,81,101,"Eb",76
8,"8100",1934,1437,1401,40,36,"Eb",33
17,"17200",616,406,393,12,13,"Eb",12
25,"25092",135,100,97,2,3,"Eb",2
17,"17016",725,491,481,8,10,"Eb",13
43,"43103",897,586,575,21,11,"Eb",10
7,"7020",3455,2491,2453,46,38,"Eb",25
43,"43160",1278,840,812,9,28,"Eb",8
25,"25047",1048,760,748,24,12,"Eb",9
43,"43906",2050,1332,1298,28,34,"Eb",7
43,"43174",152,104,101,1,3,"Eb",0
8,"8121",85069,58372,57620,923,752,"Eb",669
25,"25068",576,376,364,6,12,"Eb",4
8,"8101",169663,112624,111107,1841,1517,"Eb",1481
7,"7055",7000,4471,4379,67,92,"Eb",25
43,"43035",280,202,198,0,4,"Eb",3
17,"17115",281,209,207,5,2,"Eb",2
43,"43065",443,278,270,8,8,"Eb",1
25,"25239",627,310,310,7,0,"Eb",8
8,"8280",116,74,72,3,2,"Eb",2
8,"8029",3389,2542,2514,45,28,"Eb",41
43,"43041",237,177,176,4,1,"Eb",1
8,"8133",157,100,97,2,3,"Eb",2
17,"17152",10378,6239,6156,100,83,"Eb",52
25,"25151",641,451,444,20,7,"Eb",8
8,"8214",6754,4659,4555,83,104,"Eb",81
7,"7050",3099,2008,1979,45,29,"Eb",12
25,"25114",102,82,78,4,4,"Eb",2
7,"7058",2803,2100,2046,38,54,"Eb",31
43,"43131",4495,2842,2814,51,28,"Eb",14
8,"8196",18989,12658,12490,253,168,"Eb",135
17,"17225",208,138,134,1,4,"Eb",2
17,"17112",215,141,138,4,3,"Eb",0
8,"8298",25338,16982,16690,353,292,"Eb",364
25,"25155",714,490,485,8,5,"Eb",4
8,"8271",74,45,44,3,1,"Eb",3
8,"8154",677,499,488,2,11,"Eb",4
8,"8016",1984,1319,1289,26,30,"Eb",10
8,"8203",2442,1526,1498,34,28,"Eb",26
7,"7047",2161,1447,1407,31,40,"Eb",23
25,"25903",261,176,170,9,6,"Eb",0
17,"17153",172,127,123,1,4,"Eb",15
25,"25904",149,107,104,1,3,"Eb",3
25,"25136",106,79,79,1,0,"Eb",1
43,"43026",800,531,522,15,9,"Eb",5
8,"8222",1827,1343,1317,21,26,"Eb",26
7,"7004",3669,2511,2453,51,58,"Eb",25
43,"43069",194,131,127,3,4,"Eb",1
25,"25222",69,55,54,0,1,"Eb",0
25,"25099",1185,720,709,9,11,"Eb",8
8,"8068",6554,4323,4255,87,68,"Eb",56
8,"8278",4668,3033,2949,67,84,"Eb",68
8,"8197",7316,4983,4926,69,57,"Eb",56
8,"8134",776,528,513,15,15,"Eb",13
8,"8902",3600,2518,2496,57,22,"Eb",20
7,"7001",3450,2544,2470,36,74,"Eb",19
43,"43125",1008,706,701,10,5,"Eb",3
8,"8249",273,218,214,4,4,"Eb",4
17,"17901",964,628,621,16,7,"Eb",19
17,"17221",4135,2789,2723,49,66,"Eb",29
8,"8001",8538,5929,5838,120,91,"Eb",83
25,"25119",2297,1554,1513,46,41,"Eb",13
43,"43093",3924,2507,2445,62,62,"Eb",27
43,"43068",573,388,378,5,10,"Eb",0
25,"25912",899,643,640,6,3,"Eb",11
43,"43123",70216,45627,44828,906,799,"Eb",427
25,"25015",394,264,264,14,0,"Eb",4
8,"8036",172,124,124,4,0,"Eb",1
25,"25008",1187,834,818,15,16,"Eb",5
17,"17902",1330,898,874,11,24,"Eb",17
25,"25075",122,85,83,0,2,"Eb",4
43,"43126",1170,802,783,19,19,"Eb",9
8,"8220",2277,1641,1604,44,37,"Eb",48
25,"25177",379,240,236,2,4,"Eb",2
8,"8288",1735,985,957,13,28,"Eb",6
43,"43077",486,335,328,4,7,"Eb",1
17,"17190",811,548,532,7,16,"Eb",10
8,"8076",15925,10435,10242,179,193,"Eb",143
25,"25045",51,33,33,2,0,"Eb",1
25,"25158",1647,1154,1135,27,19,"Eb",10
8,"8169",47505,31997,31566,555,431,"Eb",304
8,"8077",33925,23896,23548,381,348,"Eb",360
25,"25046",438,299,286,6,13,"Eb",2
8,"8027",673,527,515,9,12,"Eb",6
8,"8201",458,305,298,12,7,"Eb",3
7,"7031",23371,14443,14213,285,230,"Eb",110
17,"17128",309,232,224,5,8,"Eb",3
17,"17096",182,96,94,2,2,"Eb",4
25,"25102",733,478,464,15,14,"Eb",3
43,"43005",3559,2191,2147,47,44,"Eb",8
43,"43157",388,282,270,10,12,"Eb",2
43,"43085",229,178,171,0,7,"Eb",1
17,"17192",145,107,105,4,2,"Eb",0
8,"8198",4112,2766,2661,49,105,"Eb",59
8,"8297",138,99,99,2,0,"Eb",3
43,"43027",177,129,128,6,1,"Eb",0
8,"8266",42860,30047,29521,536,526,"Eb",426
17,"17185",2273,1416,1379,32,37,"Eb",15
17,"17136",173,124,120,0,4,"Eb",2
25,"25010",206,119,118,7,1,"Eb",1
8,"8109",200,155,153,1,2,"Eb",2
25,"25088",100,74,74,0,0,"Eb",0
25,"25131",439,319,314,6,5,"Eb",5
43,"43128",927,636,625,11,11,"Eb",3
17,"17068",252,156,156,4,0,"Eb",6
43,"43136",10163,6312,6197,121,115,"Eb",36
25,"25039",299,189,186,7,3,"Eb",5
8,"8171",2158,1385,1359,27,26,"Eb",16
8,"8264",3983,2773,2744,30,29,"Eb",33
8,"8294",1870,1205,1171,22,34,"Eb",23
43,"43102",517,377,366,2,11,"Eb",1
43,"43115",171,112,110,3,2,"Eb",1
7,"7036",25502,17151,16914,294,237,"Eb",174
8,"8006",10984,7255,7092,104,163,"Eb",91
25,"25902",581,411,395,15,16,"Eb",6
25,"25166",177,127,125,3,2,"Eb",0
25,"25003",3853,2367,2340,68,27,"Eb",28
17,"17028",327,220,217,4,3,"Eb",4
7,"7044",8326,6044,5846,99,198,"Eb",36
17,"17132",1296,913,900,15,13,"Eb",15
8,"8050",149,112,108,4,4,"Eb",4
25,"25078",1014,730,719,17,11,"Eb",9
25,"25058",4390,2696,2650,57,46,"Eb",43
17,"17226",852,539,535,0,4,"Eb",1
43,"43095",2434,1658,1624,27,34,"Eb",11
43,"43141",131,71,70,3,1,"Eb",0
25,"25067",768,498,494,14,4,"Eb",6
17,"17158",404,266,264,3,2,"Eb",1
8,"8108",4879,3475,3437,64,38,"Eb",47
17,"17086",1687,1148,1129,14,19,"Eb",18
8,"8065",1224,796,778,13,18,"Eb",7
7,"7027",20045,12873,12678,204,195,"Eb",122
25,"25142",387,265,264,5,1,"Eb",2
25,"25255",468,318,309,9,9,"Eb",4
25,"25252",536,361,352,13,9,"Eb",1
8,"8075",3906,2442,2414,31,28,"Eb",31
17,"17075",304,216,210,5,6,"Eb",1
25,"25089",107,66,64,0,2,"Eb",0
8,"8246",1714,1175,1153,27,22,"Eb",34
7,"7035",1542,1190,1161,19,29,"Eb",4
43,"43139",2166,1319,1270,37,49,"Eb",15
25,"25081",332,212,206,6,6,"Eb",11
8,"8082",1143,733,723,17,10,"Eb",5
8,"8042",2172,1459,1448,30,11,"Eb",18
8,"8256",669,498,496,16,2,"Eb",10
8,"8216",21,14,14,0,0,"Eb",1
25,"25217",10570,6660,6500,191,160,"Eb",98
25,"25153",215,165,161,0,4,"Eb",1
25,"25183",485,336,327,6,9,"Eb",0
25,"25196",127,87,86,3,1,"Eb",1
43,"43902",2761,1836,1811,25,25,"Eb",7
17,"17005",404,258,254,12,4,"Eb",3
43,"43159",89,51,51,2,0,"Eb",0
8,"8144",769,494,481,16,13,"Eb",12
43,"43140",2393,1612,1583,23,29,"Eb",5
43,"43060",3049,2030,1980,62,50,"Eb",13
7,"7003",10671,6262,6149,79,113,"Eb",50
8,"8073",60247,41448,40843,770,605,"Eb",471
25,"25231",515,402,395,4,7,"Eb",7
25,"25169",201,134,134,6,0,"Eb",3
8,"8067",5657,3772,3671,75,101,"Eb",94
17,"17032",1613,933,918,11,15,"Eb",16
8,"8176",166,111,109,0,2,"Eb",2
8,"8282",6092,4478,4405,79,73,"Eb",73
17,"17093",859,561,552,16,9,"Eb",12
43,"43070",265,198,196,3,2,"Eb",5
43,"43045",156,110,109,1,1,"Eb",0
8,"8225",92,68,68,2,0,"Eb",2
8,"8132",381,247,241,6,6,"Eb",3
8,"8139",184,130,128,1,2,"Eb",5
25,"25022",119,83,83,0,0,"Eb",2
17,"17159",639,408,397,3,11,"Eb",14
25,"25063",97,65,64,2,1,"Eb",0
8,"8215",2594,1763,1728,51,35,"Eb",46
25,"25004",553,405,400,13,5,"Eb",8
8,"8174",409,294,292,10,2,"Eb",2
25,"25007",1363,902,885,36,17,"Eb",19
8,"8276",249,188,187,9,1,"Eb",3
8,"8208",5471,3859,3792,82,67,"Eb",63
25,"25189",2085,1348,1327,38,21,"Eb",18
8,"8126",8299,5599,5508,103,91,"Eb",82
17,"17064",341,253,250,4,3,"Eb",5
8,"8189",141,113,111,4,2,"Eb",3
8,"8270",17464,11828,11677,212,151,"Eb",190
25,"25053",1085,733,727,10,6,"Eb",7
17,"17025",1127,775,760,11,15,"Eb",11
17,"17137",3331,2163,2110,39,53,"Eb",39
25,"25201",119,78,76,3,2,"Eb",0
43,"43076",467,308,300,7,8,"Eb",1
8,"8903",217,178,176,10,2,"Eb",2
8,"8066",1315,985,965,16,20,"Eb",14
8,"8291",4516,2895,2855,56,40,"Eb",42
25,"25082",265,156,155,8,1,"Eb",6
8,"8240",9104,6355,6262,101,93,"Eb",74
25,"25064",122,91,88,7,3,"Eb",2
8,"8020",4542,3352,3298,77,54,"Eb",86
8,"8261",2273,1547,1525,30,22,"Eb",26
25,"25048",1684,1120,1095,29,25,"Eb",13
43,"43113",454,321,316,10,5,"Eb",0
17,"17029",198,136,133,1,3,"Eb",3
7,"7011",26954,16786,16595,299,191,"Eb",112
17,"17138",1010,677,662,3,15,"Eb",1
25,"25211",701,378,368,5,10,"Eb",7
25,"25002",481,306,302,6,4,"Eb",6
8,"8191",5520,3601,3536,64,65,"Eb",38
43,"43092",7051,4294,4220,45,74,"Eb",29
17,"17120",779,501,485,9,16,"Eb",4
43,"43165",624,471,459,6,12,"Eb",3
25,"25087",65,41,39,0,2,"Eb",0
8,"8272",148,97,96,6,1,"Eb",0
8,"8078",224,154,151,2,3,"Eb",1
17,"17099",74,52,50,1,2,"Eb",0
8,"8252",24033,16704,16402,368,302,"Eb",206
17,"17013",2774,1884,1859,21,25,"Eb",19
25,"25146",227,150,149,0,1,"Eb",0
8,"8229",561,404,398,12,6,"Eb",6
25,"25111",116,70,70,0,0,"Eb",1
17,"17204",539,349,347,10,2,"Eb",4
8,"8202",12206,8265,8129,183,136,"Eb",92
25,"25215",399,229,226,4,3,"Eb",6
43,"43022",1559,1097,1074,22,23,"Eb",3
8,"8243",160,112,110,3,2,"Eb",6
43,"43177",338,242,236,6,6,"Eb",0
17,"17007",1778,1137,1113,16,24,"Eb",14
8,"8103",636,453,446,16,7,"Eb",6
17,"17149",366,254,251,4,3,"Eb",7
25,"25077",474,281,277,5,4,"Eb",3
43,"43055",2002,1404,1374,36,30,"Eb",22
43,"43153",10307,6572,6450,94,122,"Eb",41
25,"25901",315,196,189,3,7,"Eb",1
7,"7043",3522,2384,2345,35,39,"Eb",38
7,"7032",19658,12168,11959,238,209,"Eb",203
17,"17166",503,361,342,10,19,"Eb",16
8,"8094",1500,1102,1071,21,31,"Eb",13
43,"43124",532,366,358,3,8,"Eb",3
43,"43148",89309,59260,58346,1202,914,"Eb",717
17,"17019",1783,1264,1234,42,30,"Eb",13
8,"8012",1694,1155,1136,32,19,"Eb",17
17,"17073",1753,1320,1298,18,22,"Eb",35
25,"25123",206,140,136,4,4,"Eb",3
7,"7040",266127,162699,160491,2698,2208,"Eb",1564
25,"25182",1075,749,731,30,18,"Eb",3
25,"25216",250,175,173,5,2,"Eb",4
43,"43050",2407,1528,1504,20,24,"Eb",8
8,"8245",78826,51185,50445,962,740,"Eb",659
7,"7041",2077,1583,1549,27,34,"Eb",18
8,"8177",52,31,31,1,0,"Eb",1
17,"17027",2865,1955,1892,34,63,"Eb",35
7,"7023",3541,2414,2365,88,49,"Eb",32
43,"43130",196,132,131,7,1,"Eb",2
8,"8292",1083,775,764,21,11,"Eb",12
43,"43152",472,355,351,9,4,"Eb",1
43,"43016",3437,2323,2266,40,57,"Eb",12
8,"8007",6338,4165,4050,89,115,"Eb",71
43,"43054",2850,1815,1771,37,44,"Eb",12
8,"8018",2664,1707,1669,29,38,"Eb",17
17,"17020",3446,2322,2268,45,54,"Eb",44
17,"17036",2822,1844,1806,36,38,"Eb",34
8,"8195",88,64,64,2,0,"Eb",1
17,"17232",159,107,104,0,3,"Eb",1
8,"8206",717,557,547,7,10,"Eb",1
8,"8226",886,667,656,13,11,"Eb",11
17,"17224",355,246,241,10,5,"Eb",4
17,"17201",131,89,89,2,0,"Eb",3
17,"17081",236,165,162,2,3,"Eb",4
25,"25126",286,192,189,7,3,"Eb",3
8,"8257",116,84,81,0,3,"Eb",2
7,"7046",13748,8294,8183,183,111,"Eb",54
25,"25174",438,289,283,4,6,"Eb",2
43,"43009",1421,913,897,18,16,"Eb",10
8,"8114",17629,11781,11579,189,202,"Eb",131
25,"25210",1164,799,789,13,10,"Eb",9
8,"8086",13267,8791,8669,200,122,"Eb",121
8,"8107",10955,7236,7130,151,106,"Eb",82
17,"17100",201,140,135,1,5,"Eb",4
25,"25109",279,183,183,2,0,"Eb",2
43,"43047",4064,2412,2352,50,60,"Eb",11
43,"43001",706,481,473,12,8,"Eb",8
8,"8254",1721,1189,1174,26,15,"Eb",23
7,"7052",4578,2671,2651,46,20,"Eb",50
8,"8281",4735,3239,3193,57,46,"Eb",89
8,"8017",2740,1800,1768,38,32,"Eb",35
17,"17187",574,414,402,1,12,"Eb",10
17,"17135",380,273,269,9,4,"Eb",8
25,"25019",4626,2971,2932,54,39,"Eb",28
25,"25194",440,292,283,11,9,"Eb",0
25,"25024",370,221,217,8,4,"Eb",1
17,"17063",169,113,111,5,2,"Eb",4
25,"25056",289,168,163,3,5,"Eb",0
8,"8113",52352,33606,33123,590,483,"Eb",410
25,"25038",1606,1104,1093,19,11,"Eb",3
17,"17191",153,116,114,0,2,"Eb",2
43,"43114",383,238,234,6,4,"Eb",1
17,"17220",780,550,545,13,5,"Eb",9
17,"17146",2952,1895,1864,49,31,"Eb",33
25,"25200",353,225,217,4,8,"Eb",2
17,"17125",132,90,89,1,1,"Eb",2
25,"25097",102,70,69,3,1,"Eb",1
8,"8219",14647,10347,10169,193,178,"Eb",224
8,"8136",11117,7602,7478,174,124,"Eb",88
25,"25085",153,103,100,2,3,"Eb",1
7,"7039",4920,3488,3377,54,111,"Eb",18
43,"43046",114,80,79,5,1,"Eb",3
25,"25242",787,501,490,11,11,"Eb",11
25,"25230",1665,1164,1140,36,24,"Eb",4
8,"8167",5703,3896,3831,82,65,"Eb",41
17,"17043",159,101,100,2,1,"Eb",4
25,"25907",506,297,292,6,5,"Eb",4
43,"43118",439,318,313,7,5,"Eb",1
8,"8015",155673,101652,100264,1628,1388,"Eb",1596
17,"17214",695,470,461,10,9,"Eb",6
8,"8187",149633,104021,102629,1794,1392,"Eb",1269
25,"25913",100,78,78,0,0,"Eb",2
25,"25175",221,151,150,0,1,"Eb",3
17,"17126",309,231,229,9,2,"Eb",4
25,"25113",1227,869,856,28,13,"Eb",9
8,"8258",845,577,555,23,22,"Eb",6
8,"8141",4666,3124,3066,57,58,"Eb",49
43,"43178",1262,891,870,24,21,"Eb",9
17,"17048",6176,3818,3773,52,45,"Eb",57
43,"43007",635,448,441,7,7,"Eb",3
17,"17181",3228,2116,2081,19,35,"Eb",25
43,"43080",254,175,173,7,2,"Eb",0
8,"8211",32035,23059,22687,453,372,"Eb",300
17,"17082",443,285,280,1,5,"Eb",5
8,"8155",6573,4411,4334,85,77,"Eb",48
17,"17188",167,124,122,9,2,"Eb",7
43,"43176",832,575,572,16,3,"Eb",7
17,"17903",893,565,556,14,9,"Eb",7
17,"17206",167,108,107,2,1,"Eb",2
7,"7002",6305,4188,4073,80,115,"Eb",54
43,"43011",1013,745,729,21,16,"Eb",16
43,"43002",1790,1252,1226,17,26,"Eb",5
8,"8218",7968,5014,4932,129,82,"Eb",66
25,"25192",799,543,527,19,16,"Eb",6
8,"8129",444,278,271,2,7,"Eb",7
8,"8028",1049,667,657,15,10,"Eb",7
25,"25180",245,167,165,3,2,"Eb",1
8,"8049",1340,839,816,10,23,"Eb",15
8,"8293",246,145,145,4,0,"Eb",2
25,"25100",207,125,115,2,10,"Eb",1
8,"8089",33316,22369,22107,437,262,"Eb",303
17,"17050",645,438,425,15,13,"Eb",12
43,"43171",13906,8978,8855,167,123,"Eb",60
17,"17107",301,203,200,8,3,"Eb",5
43,"43088",1810,1199,1177,29,22,"Eb",16
8,"8110",13366,8493,8329,144,164,"Eb",98
17,"17189",1536,1061,1025,7,36,"Eb",15
25,"25909",141,82,78,0,4,"Eb",0
17,"17058",177,115,114,2,1,"Eb",5
17,"17218",568,361,350,11,11,"Eb",7
43,"43036",836,503,494,4,9,"Eb",2
43,"43109",2040,1332,1316,28,16,"Eb",10
43,"43904",2918,1779,1732,49,47,"Eb",24
17,"17098",311,208,202,4,6,"Eb",6
25,"25250",358,237,234,4,3,"Eb",0
25,"25031",57,34,34,1,0,"Eb",1
25,"25143",86,58,58,1,0,"Eb",1
17,"17002",567,413,401,4,12,"Eb",13
17,"17157",127,99,98,3,1,"Eb",2
17,"17176",141,96,95,3,1,"Eb",0
17,"17167",2818,1886,1858,52,28,"Eb",39
43,"43034",494,355,344,8,11,"Eb",2
25,"25234",4572,2707,2648,57,59,"Eb",27
25,"25149",1401,1031,1010,17,21,"Eb",4
43,"43021",381,218,213,3,5,"Eb",2
8,"8172",19889,13537,13333,267,204,"Eb",241
43,"43106",878,600,592,17,8,"Eb",3
25,"25079",307,242,240,7,2,"Eb",0
43,"43032",587,418,413,9,5,"Eb",1
17,"17168",393,285,281,8,4,"Eb",8
43,"43078",841,557,547,7,10,"Eb",4
7,"7034",971,724,708,10,16,"Eb",14
8,"8159",13482,9173,9040,239,133,"Eb",112
8,"8152",129,94,93,0,1,"Eb",4
17,"17070",116,78,78,3,0,"Eb",0
8,"8052",148,103,98,1,5,"Eb",1
25,"25206",289,187,184,3,3,"Eb",2
17,"17172",426,286,283,3,3,"Eb",4
17,"17001",557,370,365,7,5,"Eb",7
25,"25249",207,151,150,4,1,"Eb",2
8,"8062",863,595,583,8,12,"Eb",10
43,"43133",5697,3470,3388,76,82,"Eb",36
7,"7028",876,607,595,6,12,"Eb",5
43,"43033",772,547,533,4,14,"Eb",9
25,"25042",211,131,127,0,4,"Eb",1
25,"25093",657,465,455,8,10,"Eb",5
43,"43017",141,98,98,2,0,"Eb",2
25,"25226",257,162,158,5,4,"Eb",0
8,"8123",18751,13394,13154,238,240,"Eb",229
17,"17134",235,149,148,3,1,"Eb",5
43,"43156",4120,2811,2741,66,70,"Eb",19
8,"8237",1692,1155,1127,22,28,"Eb",18
43,"43099",330,240,236,4,4,"Eb",1
8,"8033",12476,8513,8378,180,135,"Eb",93
8,"8060",167,102,101,0,1,"Eb",5
17,"17193",3978,2365,2305,38,60,"Eb",45
17,"17097",185,136,136,4,0,"Eb",8
43,"43121",636,385,371,6,14,"Eb",9
8,"8224",771,538,528,26,10,"Eb",10
8,"8194",24757,15009,14799,245,210,"Eb",189
8,"8295",10579,6896,6769,137,127,"Eb",79
7,"7008",5422,3782,3705,61,77,"Eb",46
25,"25179",198,141,136,1,5,"Eb",2
25,"25191",353,234,227,5,7,"Eb",3
25,"25041",625,432,420,20,12,"Eb",6
43,"43010",302,227,223,7,4,"Eb",3
25,"25905",386,264,258,12,6,"Eb",2
17,"17194",93,55,55,1,0,"Eb",1
43,"43042",2071,1504,1485,28,19,"Eb",10
8,"8021",76,49,47,1,2,"Eb",0
43,"43090",1142,644,636,7,8,"Eb",6
25,"25176",341,243,240,7,3,"Eb",7
17,"17111",789,584,574,15,10,"Eb",10
17,"17155",14284,8528,8391,143,137,"Eb",142
25,"25105",146,90,89,1,1,"Eb",3
8,"8146",1321,876,862,18,14,"Eb",5
7,"7038",1962,1504,1480,20,24,"Eb",13
7,"7049",1482,1046,1037,14,9,"Eb",12
8,"8025",1460,990,963,14,27,"Eb",16
8,"8035",12099,7838,7735,123,103,"Eb",70
8,"8156",10672,7359,7225,121,134,"Eb",111
17,"17207",2357,1636,1584,40,52,"Eb",36
25,"25212",233,185,185,8,0,"Eb",3
25,"25906",235,160,154,3,6,"Eb",3
25,"25156",761,535,529,15,6,"Eb",1
8,"8106",6858,4675,4559,113,116,"Eb",80
25,"25129",175,105,105,3,0,"Eb",0
25,"25253",175,132,129,1,3,"Eb",2
17,"17175",569,375,369,6,6,"Eb",7
25,"25168",510,385,378,19,7,"Eb",1
25,"25120",90759,58761,57778,1325,983,"Eb",921
43,"43089",272,193,185,1,8,"Eb",0
8,"8300",5621,4021,3933,94,88,"Eb",52
25,"25141",171,111,107,2,4,"Eb",3
25,"25207",6253,3938,3872,91,66,"Eb",83
43,"43162",4143,2892,2833,59,59,"Eb",16
25,"25034",2471,1622,1592,25,30,"Eb",17
8,"8247",903,627,608,10,19,"Eb",23
7,"7901",642,483,470,5,13,"Eb",5
43,"43105",175,119,116,14,3,"Eb",8
25,"25101",583,391,382,8,9,"Eb",6
25,"25152",160,92,90,4,2,"Eb",0
25,"25059",796,580,575,9,5,"Eb",5
8,"8244",5746,4044,3940,102,104,"Eb",66
7,"7059",3011,2077,2012,22,65,"Eb",29
43,"43020",2119,1463,1427,26,36,"Eb",22
17,"17077",580,374,372,5,2,"Eb",4
7,"7030",1576,1150,1135,26,15,"Eb",15
17,"17006",1203,759,754,17,5,"Eb",10
43,"43111",2096,1305,1281,19,24,"Eb",6
43,"43012",3392,2346,2295,48,51,"Eb",33
17,"17026",542,404,398,3,6,"Eb",9
25,"25044",195,136,134,1,2,"Eb",3
43,"43143",62,51,50,1,1,"Eb",5
43,"43053",190,149,149,2,0,"Eb",1
17,"17057",1010,640,634,19,6,"Eb",16
8,"8099",808,533,519,11,14,"Eb",6
43,"43038",20710,12999,12771,224,228,"Eb",115
8,"8079",335,255,243,14,12,"Eb",6
43,"43120",454,287,283,1,4,"Eb",2
43,"43907",4122,2759,2712,52,47,"Eb",11
43,"43901",8849,5651,5540,179,111,"Eb",31
25,"25103",125,82,80,4,2,"Eb",0
25,"25013",2274,1344,1321,25,23,"Eb",16
43,"43057",45,27,27,2,0,"Eb",0
25,"25134",657,421,416,4,5,"Eb",0
25,"25140",785,472,460,5,12,"Eb",2
8,"8170",458,300,288,13,12,"Eb",7
17,"17119",89,65,64,3,1,"Eb",4
17,"17217",347,267,251,5,16,"Eb",3
43,"43063",588,358,350,13,8,"Eb",4
17,"17163",2478,1729,1681,41,48,"Eb",61
25,"25172",1838,1267,1230,35,37,"Eb",11
8,"8002",202,143,140,4,3,"Eb",0
17,"17069",395,276,267,2,9,"Eb",3
25,"25094",154,110,107,1,3,"Eb",1
25,"25171",2305,1496,1469,37,27,"Eb",20
43,"43096",103,81,77,3,4,"Eb",0
17,"17173",174,121,119,1,2,"Eb",1
17,"17141",5689,3485,3428,50,57,"Eb",44
8,"8008",193,119,114,5,5,"Eb",3
25,"25130",208,117,112,4,5,"Eb",4
43,"43132",365,217,214,8,3,"Eb",2
17,"17139",1346,899,869,21,30,"Eb",15
8,"8904",10608,6654,6561,140,93,"Eb",64
17,"17151",174,131,131,6,0,"Eb",3
25,"25124",161,110,109,4,1,"Eb",3
25,"25012",2204,1432,1406,29,26,"Eb",20
43,"43048",830,547,530,16,17,"Eb",1
17,"17060",378,240,233,1,7,"Eb",1
8,"8162",1955,1306,1271,28,35,"Eb",16
8,"8051",17397,12178,12002,240,176,"Eb",192
17,"17133",1336,889,866,14,23,"Eb",13
17,"17061",175,123,123,4,0,"Eb",8
43,"43098",362,251,247,1,4,"Eb",5
8,"8184",52133,33696,33220,656,476,"Eb",455
17,"17162",137,80,78,2,2,"Eb",2
17,"17090",548,412,404,7,8,"Eb",10
8,"8041",10032,6880,6761,112,119,"Eb",44
8,"8011",1754,1116,1085,29,31,"Eb",31
43,"43081",574,415,404,13,11,"Eb",7
25,"25137",8404,5264,5167,112,97,"Eb",73
7,"7005",6331,4128,4058,76,70,"Eb",20
25,"25220",1076,711,702,10,9,"Eb",10
17,"17094",1161,694,683,11,11,"Eb",11
25,"25074",178,137,132,3,5,"Eb",0
8,"8072",9910,6326,6235,140,91,"Eb",105
8,"8307",47176,31341,30846,536,495,"Eb",407
25,"25033",1125,738,718,17,20,"Eb",16
43,"43025",660,453,446,13,7,"Eb",1
7,"7013",6525,4528,4409,78,119,"Eb",45
8,"8230",7452,5349,5286,94,63,"Eb",84
25,"25005",291,194,190,7,4,"Eb",3
17,"17037",105,66,66,2,0,"Eb",3
8,"8063",434,336,333,8,3,"Eb",10
25,"25181",189,128,123,3,5,"Eb",0
25,"25197",158,102,101,2,1,"Eb",2
17,"17031",172,94,93,1,1,"Eb",0
8,"8009",8932,6188,6088,103,100,"Eb",93
8,"8151",504,345,338,6,7,"Eb",4
43,"43104",1821,1209,1178,34,31,"Eb",11
17,"17079",62633,40844,40101,670,743,"Eb",959
43,"43004",6411,4089,4001,92,88,"Eb",18
8,"8182",2802,1871,1852,35,19,"Eb",14
8,"8148",2240,1246,1223,22,23,"Eb",8
43,"43066",165,113,112,2,1,"Eb",2
8,"8084",1134,789,760,14,29,"Eb",16
25,"25118",378,232,226,4,6,"Eb",0
43,"43083",141,97,97,2,0,"Eb",0
17,"17003",101,67,64,2,3,"Eb",1
8,"8299",444,277,267,5,10,"Eb",7
43,"43905",13621,8120,8011,131,109,"Eb",60
17,"17074",490,345,342,5,3,"Eb",4
17,"17165",608,414,400,9,14,"Eb",10
8,"8115",3870,2693,2644,60,49,"Eb",12
17,"17114",22610,14079,13811,263,268,"Eb",194
43,"43051",8749,5494,5411,78,83,"Eb",28
8,"8055",476,312,304,11,8,"Eb",6
43,"43067",626,445,431,21,14,"Eb",2
17,"17223",787,523,514,8,9,"Eb",6
7,"7009",744,593,576,11,17,"Eb",4
43,"43062",298,227,223,7,4,"Eb",1
17,"17197",144,103,102,3,1,"Eb",2
17,"17062",5994,3686,3614,69,72,"Eb",49
7,"7024",6070,3232,3170,60,62,"Eb",29
8,"8290",1446,1075,1056,12,19,"Eb",13
43,"43084",573,383,378,6,5,"Eb",5
8,"8199",712,507,499,15,8,"Eb",8
8,"8046",12603,8826,8663,190,163,"Eb",159
25,"25148",232,144,144,5,0,"Eb",0
17,"17088",551,374,363,4,11,"Eb",10
43,"43137",1873,1241,1212,27,29,"Eb",12
7,"7025",457,355,346,3,9,"Eb",4
17,"17130",333,236,233,5,3,"Eb",15
17,"17183",261,178,176,2,2,"Eb",6
8,"8039",365,264,260,5,4,"Eb",6
43,"43097",379,283,278,6,5,"Eb",1
8,"8043",3067,2044,2023,29,21,"Eb",24
17,"17143",134,89,87,2,2,"Eb",2
8,"8090",120,86,86,2,0,"Eb",1
17,"17208",1012,642,622,12,20,"Eb",12
25,"25193",771,509,501,8,8,"Eb",10
8,"8241",80,61,61,1,0,"Eb",0
43,"43072",97,73,70,0,3,"Eb",0
8,"8047",4141,2610,2580,49,30,"Eb",38
25,"25009",690,479,471,9,8,"Eb",4
7,"7019",230,165,164,1,1,"Eb",0
17,"17056",1704,1171,1158,21,13,"Eb",42
8,"8905",2268,1692,1657,28,35,"Eb",33
43,"43029",330,202,194,6,8,"Eb",0
25,"25911",472,306,296,2,10,"Eb",4
43,"43037",16656,9986,9812,163,174,"Eb",71
8,"8031",2289,1619,1599,34,20,"Eb",17
25,"25050",3249,2056,1988,40,68,"Eb",58
43,"43040",350,251,246,18,5,"Eb",1
17,"17210",527,358,349,9,9,"Eb",3
8,"8088",11250,8019,7861,144,158,"Eb",105
8,"8242",243,174,172,5,2,"Eb",4
17,"17227",107,82,82,1,0,"Eb",3
25,"25223",951,562,546,14,16,"Eb",17
8,"8102",27850,18716,18470,373,246,"Eb",236
43,"43122",92,65,61,0,4,"Eb",0
17,"17024",301,207,204,4,3,"Eb",1
17,"17042",415,297,292,2,5,"Eb",3
8,"8259",6362,4482,4420,97,62,"Eb",100
8,"8260",17869,11898,11686,215,212,"Eb",155
17,"17121",230,159,158,7,1,"Eb",3
17,"17202",3799,2398,2366,44,32,"Eb",17
25,"25020",328,216,209,4,7,"Eb",3
43,"43161",17199,10765,10547,197,218,"Eb",93
43,"43147",528,393,380,7,13,"Eb",2
17,"17011",625,472,467,5,5,"Eb",4
17,"17008",3745,2262,2195,34,67,"Eb",21
8,"8053",2850,1788,1772,21,16,"Eb",21
8,"8059",323,189,186,9,3,"Eb",2
17,"17071",1064,719,698,33,21,"Eb",15
8,"8267",6215,4100,4011,82,89,"Eb",49
17,"17109",759,428,414,10,14,"Eb",12
43,"43023",244,179,177,8,2,"Eb",3
8,"8130",95,63,62,3,1,"Eb",1
17,"17078",346,231,226,3,5,"Eb",2
8,"8251",4771,3214,3140,57,74,"Eb",31
25,"25224",144,93,91,6,2,"Eb",2
17,"17055",158,121,121,4,0,"Eb",3
43,"43145",3968,2781,2742,52,39,"Eb",26
17,"17010",327,216,214,6,2,"Eb",11
43,"43056",931,537,515,18,22,"Eb",6
17,"17049",3056,1986,1944,43,42,"Eb",48
8,"8286",2865,1843,1796,30,47,"Eb",10
17,"17161",978,693,687,21,6,"Eb",7
43,"43903",2368,1504,1492,22,12,"Eb",4
8,"8296",1683,1227,1203,29,24,"Eb",10
8,"8054",8733,6215,6077,123,138,"Eb",99
7,"7037",3269,1737,1700,37,37,"Eb",21
7,"7016",2726,1848,1809,34,39,"Eb",12
25,"25128",151,83,81,1,2,"Eb",4
7,"7045",1189,843,823,23,20,"Eb",19
17,"17142",2440,1713,1681,39,32,"Eb",35
43,"43008",333,206,197,3,9,"Eb",3
43,"43155",22951,14114,13856,326,258,"Eb",123
8,"8239",471,338,333,6,5,"Eb",5
43,"43166",1521,1002,977,17,25,"Eb",7
8,"8058",1699,1089,1061,25,28,"Eb",15
17,"17046",738,510,498,15,12,"Eb",5
17,"17106",140,105,104,0,1,"Eb",0
7,"7042",10393,6536,6421,96,115,"Eb",50
8,"8223",1855,1178,1155,19,23,"Eb",27
8,"8045",70,42,42,2,0,"Eb",0
17,"17021",108,86,79,0,7,"Eb",2
8,"8092",3928,2511,2473,33,38,"Eb",145
17,"17085",295,212,208,12,4,"Eb",7
8,"8233",1867,1179,1169,29,10,"Eb",21
8,"8140",4665,3160,3103,55,57,"Eb",25
8,"8234",3143,2040,2008,45,32,"Eb",24
43,"43164",298,233,231,4,2,"Eb",0
8,"8284",11920,7059,6942,139,117,"Eb",103
8,"8080",42,33,33,2,0,"Eb",0
17,"17233",2192,1470,1434,33,36,"Eb",35
8,"8274",4887,3326,3279,36,47,"Eb",22
8,"8040",10538,6916,6804,99,112,"Eb",119
8,"8305",26208,17810,17506,296,304,"Eb",229
43,"43006",712,484,475,10,9,"Eb",6
43,"43031",1509,1016,992,20,24,"Eb",5
25,"25037",396,275,273,9,2,"Eb",3
43,"43119",739,500,496,5,4,"Eb",5
25,"25240",1398,976,958,17,18,"Eb",12
8,"8289",4123,2802,2768,54,34,"Eb",50
17,"17145",1593,1090,1068,10,22,"Eb",20
8,"8207",1718,1296,1256,28,40,"Eb",18
17,"17052",134,84,83,2,1,"Eb",2
25,"25170",271,197,196,4,1,"Eb",4
8,"8091",5106,3379,3312,59,67,"Eb",66
25,"25245",445,312,306,4,6,"Eb",6
25,"25173",1784,1177,1139,20,38,"Eb",20
25,"25125",450,297,289,10,8,"Eb",3
8,"8122",1755,1063,1034,17,29,"Eb",14
8,"8044",4247,2763,2712,50,51,"Eb",32
8,"8228",303,230,227,5,3,"Eb",5
8,"8135",6647,4753,4678,79,75,"Eb",47
25,"25001",146,76,76,1,0,"Eb",0
17,"17129",126,91,90,3,1,"Eb",1
8,"8069",3028,2071,2029,36,42,"Eb",39
8,"8163",17986,11683,11548,159,135,"Eb",95
25,"25029",1766,1145,1118,38,27,"Eb",9
43,"43144",1187,787,772,12,15,"Eb",12
25,"25115",878,542,542,17,0,"Eb",5
17,"17004",504,340,337,6,3,"Eb",10
7,"7054",19930,11186,11028,196,158,"Eb",106
17,"17195",324,220,214,6,6,"Eb",4
7,"7017",800,556,539,14,17,"Eb",5
43,"43014",14146,9153,8915,204,238,"Eb",64
7,"7061",9429,5937,5800,125,137,"Eb",67
25,"25027",1042,691,665,11,26,"Eb",8
8,"8250",7083,4485,4426,72,59,"Eb",36
17,"17035",548,385,379,7,6,"Eb",7
17,"17040",506,320,316,7,4,"Eb",5
8,"8019",1143222,778246,767530,12386,10716,"Eb",14182
25,"25228",2907,2043,2021,43,22,"Eb",44
43,"43127",778,530,524,6,6,"Eb",3
8,"8095",75,56,55,1,1,"Eb",2
25,"25011",5241,3127,3080,48,47,"Eb",44
25,"25069",471,291,289,9,2,"Eb",5
8,"8070",275,192,191,5,1,"Eb",3
8,"8158",2996,2012,1986,19,26,"Eb",28
8,"8302",9271,5981,5892,82,89,"Eb",51
8,"8127",2274,1371,1338,23,33,"Eb",24
25,"25076",165,84,83,3,1,"Eb",3
17,"17182",257,177,175,2,2,"Eb",0
43,"43013",4369,2795,2747,54,48,"Eb",24
17,"17080",165,115,114,1,1,"Eb",4
25,"25023",4446,3079,3020,70,59,"Eb",41
8,"8098",2374,1552,1535,28,17,"Eb",10
8,"8131",696,483,469,7,14,"Eb",10
8,"8166",1138,726,706,10,20,"Eb",7
43,"43059",264,185,185,4,0,"Eb",0
43,"43024",1459,958,937,17,21,"Eb",13
8,"8183",4497,2914,2865,43,49,"Eb",59
7,"7053",1133,863,839,16,24,"Eb",14
25,"25070",888,594,582,18,12,"Eb",4
7,"7056",4701,3164,3090,55,74,"Eb",42
25,"25190",271,180,176,12,4,"Eb",4
8,"8269",2613,1840,1814,32,26,"Eb",35
8,"8212",508,366,363,1,3,"Eb",4
17,"17222",108,86,86,1,0,"Eb",2
8,"8275",242,188,186,4,2,"Eb",4
8,"8255",132,83,82,1,1,"Eb",1
17,"17228",280,172,170,4,2,"Eb",4
8,"8153",502,357,350,7,7,"Eb",13
7,"7064",5286,3340,3279,53,61,"Eb",58
25,"25060",92,53,52,1,1,"Eb",0
7,"7065",2061,1376,1345,29,31,"Eb",7
25,"25098",266,177,177,0,0,"Eb",2
25,"25133",748,499,483,7,16,"Eb",4
7,"7033",25954,14975,14738,328,237,"Eb",143
43,"43064",2063,1420,1391,37,29,"Eb",5
43,"43112",294,184,181,2,3,"Eb",1
17,"17177",563,398,388,7,10,"Eb",4
8,"8013",1234,834,820,23,14,"Eb",12
8,"8071",248,172,167,2,5,"Eb",1
8,"8205",54870,41064,40491,682,573,"Eb",773
17,"17209",605,469,463,21,6,"Eb",10
17,"17170",192,135,134,1,1,"Eb",0
8,"8030",4849,3466,3422,50,44,"Eb",46
8,"8037",1830,1247,1209,40,38,"Eb",20
17,"17230",456,326,320,10,6,"Eb",1
8,"8004",228,176,172,2,4,"Eb",8
8,"8180",26210,17504,17214,366,290,"Eb",185
8,"8119",6039,3991,3884,74,107,"Eb",39
43,"43015",104,69,68,2,1,"Eb",3
43,"43168",106,70,69,2,1,"Eb",0
25,"25163",237,147,142,2,5,"Eb",0
8,"8024",409,266,260,4,6,"Eb",8
17,"17012",1093,689,679,11,10,"Eb",17
8,"8061",1467,960,952,10,8,"Eb",11
17,"17039",1850,1299,1275,31,24,"Eb",8
7,"7060",2534,1724,1697,30,27,"Eb",15
8,"8085",1033,731,720,10,11,"Eb",5
25,"25164",404,270,264,5,6,"Eb",2
25,"25157",183,128,128,4,0,"Eb",0
8,"8118",17077,11817,11598,203,219,"Eb",233
8,"8003",6983,5061,4993,53,68,"Eb",96
8,"8273",2287,1594,1547,18,47,"Eb",22
25,"25254",782,533,531,9,2,"Eb",7
8,"8128",557,377,374,16,3,"Eb",9
25,"25205",563,373,362,12,11,"Eb",3
8,"8232",1793,1239,1220,20,19,"Eb",15
25,"25204",1313,888,881,21,7,"Eb",5
43,"43158",109,63,61,5,2,"Eb",0
43,"43049",805,555,536,6,19,"Eb",6
8,"8147",17023,11177,10961,184,216,"Eb",176
43,"43052",1001,669,636,12,33,"Eb",4
17,"17102",571,354,350,7,4,"Eb",2
8,"8303",279,202,201,11,1,"Eb",6
8,"8306",509,330,324,6,6,"Eb",8
8,"8105",9642,6571,6483,110,88,"Eb",41
17,"17033",5157,3142,3095,44,47,"Eb",55
25,"25186",231,168,168,3,0,"Eb",4
43,"43146",45,33,30,1,3,"Eb",0
17,"17215",1918,1350,1321,40,29,"Eb",21
43,"43116",494,328,325,5,3,"Eb",3
25,"25030",147,101,95,3,6,"Eb",2
17,"17047",4803,2866,2803,30,63,"Eb",40
8,"8142",127,83,83,4,0,"Eb",2
43,"43129",4525,3032,2956,62,76,"Eb",21
8,"8150",245,181,178,11,3,"Eb",8
17,"17150",1428,1018,996,24,22,"Eb",23
43,"43073",90,57,57,1,0,"Eb",0
17,"17030",624,414,409,8,5,"Eb",10
25,"25248",926,615,601,17,14,"Eb",10
17,"17083",2886,1825,1801,39,24,"Eb",25
25,"25062",806,515,497,11,18,"Eb",7
25,"25049",166,105,102,1,3,"Eb",1
17,"17117",14022,8705,8595,129,110,"Eb",108
43,"43043",3065,1952,1919,39,33,"Eb",20
7,"7012",1880,1437,1405,20,32,"Eb",8
43,"43101",146,94,93,3,1,"Eb",0
8,"8235",3627,2506,2467,35,39,"Eb",39
17,"17054",395,250,247,3,3,"Eb",2
17,"17009",4089,2573,2490,59,83,"Eb",44
43,"43149",711,529,516,13,13,"Eb",4
8,"8057",61,41,40,1,1,"Eb",0
8,"8279",149233,101676,100363,1965,1313,"Eb",1460
8,"8263",20729,13742,13563,232,179,"Eb",127
7,"7902",1071,734,712,22,22,"Eb",9
8,"8081",332,232,225,2,7,"Eb",5
17,"17213",5282,3097,3041,42,56,"Eb",66
17,"17171",148,111,109,5,2,"Eb",3
43,"43100",3062,2058,2021,52,37,"Eb",30
25,"25233",270,207,201,3,6,"Eb",3
43,"43154",136,97,96,6,1,"Eb",0
17,"17089",5486,3328,3288,43,40,"Eb",69
25,"25238",231,158,156,1,2,"Eb",7
8,"8014",1906,1338,1313,37,25,"Eb",18
17,"17174",183,120,117,5,3,"Eb",4
25,"25032",71,44,42,1,2,"Eb",0
8,"8034",741,542,529,4,13,"Eb",10
25,"25043",830,483,467,17,16,"Eb",6
43,"43117",150,118,115,1,3,"Eb",1
17,"17038",343,261,256,2,5,"Eb",2
25,"25110",2662,1649,1602,44,47,"Eb",27
43,"43138",2719,1775,1730,45,45,"Eb",12
8,"8285",10168,6582,6423,152,159,"Eb",131
25,"25035",428,289,284,5,5,"Eb",0
25,"25225",603,395,387,7,8,"Eb",8
25,"25908",250,169,168,4,1,"Eb",1
43,"43075",102,63,63,1,0,"Eb",0
17,"17110",1359,930,917,12,13,"Eb",14
8,"8145",2597,1823,1784,23,39,"Eb",20
7,"7022",11700,7512,7371,128,141,"Eb",74
8,"8112",12946,8533,8390,227,143,"Eb",137
7,"7063",1414,1050,1030,25,20,"Eb",9
8,"8265",1575,1065,1026,38,39,"Eb",23
8,"8125",24559,16065,15798,293,267,"Eb",230
46,"46083",15427,12079,11941,109,138,"ESPAÑA 2000",75
46,"46134",2326,1691,1664,20,27,"ESPAÑA 2000",4
46,"46221",350,319,317,3,2,"ESPAÑA 2000",3
46,"46075",166,148,145,3,3,"ESPAÑA 2000",0
12,"12130",425,348,344,2,4,"ESPAÑA 2000",0
46,"46245",478,357,354,1,3,"ESPAÑA 2000",1
12,"12094",807,612,604,14,8,"ESPAÑA 2000",9
46,"46002",1166,942,915,7,27,"ESPAÑA 2000",1
12,"12078",365,273,267,5,6,"ESPAÑA 2000",0
46,"46256",6734,4902,4858,33,44,"ESPAÑA 2000",19
46,"46145",21751,16601,16397,155,204,"ESPAÑA 2000",46
12,"12068",57,45,44,0,1,"ESPAÑA 2000",0
12,"12012",2747,2196,2135,24,61,"ESPAÑA 2000",14
46,"46904",782,659,650,6,9,"ESPAÑA 2000",4
46,"46111",10589,7823,7710,94,113,"ESPAÑA 2000",20
46,"46059",1310,1076,1058,2,18,"ESPAÑA 2000",0
12,"12099",583,485,465,3,20,"ESPAÑA 2000",1
46,"46172",4838,3492,3445,24,47,"ESPAÑA 2000",17
46,"46167",411,312,309,0,3,"ESPAÑA 2000",0
46,"46080",1090,860,849,2,11,"ESPAÑA 2000",1
12,"12136",2663,2325,2284,33,41,"ESPAÑA 2000",14
12,"12140",1204,975,954,9,21,"ESPAÑA 2000",4
12,"12011",4663,3578,3525,28,53,"ESPAÑA 2000",9
46,"46094",20341,15367,15222,152,145,"ESPAÑA 2000",165
46,"46204",6906,5426,5357,62,69,"ESPAÑA 2000",15
46,"46118",3883,3141,3105,28,36,"ESPAÑA 2000",4
12,"12020",131,109,107,1,2,"ESPAÑA 2000",1
46,"46208",1141,990,978,6,12,"ESPAÑA 2000",7
12,"12056",304,259,254,7,5,"ESPAÑA 2000",1
12,"12028",12115,9084,8992,137,92,"ESPAÑA 2000",53
46,"46218",1082,964,936,5,28,"ESPAÑA 2000",4
46,"46005",22815,17016,16838,185,178,"ESPAÑA 2000",58
46,"46048",3484,2915,2875,26,40,"ESPAÑA 2000",15
12,"12044",527,472,463,4,9,"ESPAÑA 2000",1
12,"12112",104,90,90,0,0,"ESPAÑA 2000",1
46,"46150",1898,1555,1541,8,14,"ESPAÑA 2000",3
12,"12058",99,74,74,0,0,"ESPAÑA 2000",2
12,"12124",1902,1532,1499,15,33,"ESPAÑA 2000",5
46,"46126",5471,4454,4392,53,62,"ESPAÑA 2000",17
46,"46062",4589,3794,3752,46,42,"ESPAÑA 2000",25
46,"46115",515,364,354,1,10,"ESPAÑA 2000",6
12,"12015",96,83,82,3,1,"ESPAÑA 2000",2
46,"46148",1400,1131,1114,13,17,"ESPAÑA 2000",5
46,"46156",2065,1746,1721,14,25,"ESPAÑA 2000",3
12,"12089",4277,3009,2946,32,63,"ESPAÑA 2000",46
46,"46213",15621,11361,11164,214,197,"ESPAÑA 2000",28
46,"46066",1264,1060,1050,5,10,"ESPAÑA 2000",3
46,"46056",203,164,160,2,4,"ESPAÑA 2000",0
46,"46046",922,699,694,2,5,"ESPAÑA 2000",2
46,"46262",228,161,158,0,3,"ESPAÑA 2000",0
12,"12048",293,208,205,2,3,"ESPAÑA 2000",1
46,"46110",21420,15810,15671,134,139,"ESPAÑA 2000",115
12,"12139",344,219,216,0,3,"ESPAÑA 2000",1
12,"12137",47,36,35,0,1,"ESPAÑA 2000",0
46,"46010",927,706,699,3,7,"ESPAÑA 2000",0
46,"46107",1998,1650,1623,8,27,"ESPAÑA 2000",2
46,"46013",16111,12469,12328,145,141,"ESPAÑA 2000",26
12,"12106",1207,992,969,7,23,"ESPAÑA 2000",1
46,"46182",1190,864,855,11,9,"ESPAÑA 2000",0
12,"12901",3383,2664,2632,34,32,"ESPAÑA 2000",45
46,"46011",7727,5874,5777,75,97,"ESPAÑA 2000",25
46,"46198",815,660,654,4,6,"ESPAÑA 2000",3
46,"46133",686,572,565,1,7,"ESPAÑA 2000",3
46,"46038",368,264,260,1,4,"ESPAÑA 2000",0
12,"12060",467,367,353,2,14,"ESPAÑA 2000",1
46,"46078",28197,20643,20415,205,228,"ESPAÑA 2000",77
46,"46021",23273,17264,17091,163,173,"ESPAÑA 2000",60
46,"46195",1975,1631,1631,33,0,"ESPAÑA 2000",8
46,"46130",934,745,734,6,11,"ESPAÑA 2000",4
12,"12122",835,674,658,14,16,"ESPAÑA 2000",1
46,"46180",715,585,581,4,4,"ESPAÑA 2000",1
46,"46072",3711,3006,2932,38,74,"ESPAÑA 2000",4
12,"12039",870,743,736,4,7,"ESPAÑA 2000",2
12,"12070",576,473,463,5,10,"ESPAÑA 2000",0
12,"12055",112,79,78,3,1,"ESPAÑA 2000",0
12,"12077",4683,3476,3414,41,62,"ESPAÑA 2000",34
12,"12109",700,564,555,7,9,"ESPAÑA 2000",5
46,"46140",379,314,313,0,1,"ESPAÑA 2000",0
46,"46090",1668,1488,1452,9,36,"ESPAÑA 2000",4
46,"46097",890,674,662,2,12,"ESPAÑA 2000",3
46,"46188",660,579,576,4,3,"ESPAÑA 2000",5
12,"12135",35189,25691,25345,380,346,"ESPAÑA 2000",406
12,"12013",180,131,130,0,1,"ESPAÑA 2000",1
46,"46045",1288,1065,1044,2,21,"ESPAÑA 2000",12
46,"46061",331,276,273,3,3,"ESPAÑA 2000",3
46,"46102",19880,15358,15179,122,179,"ESPAÑA 2000",60
46,"46096",320,267,267,0,0,"ESPAÑA 2000",0
46,"46261",1706,1388,1366,13,22,"ESPAÑA 2000",1
12,"12037",20,15,14,1,1,"ESPAÑA 2000",0
12,"12072",1191,1007,977,17,30,"ESPAÑA 2000",5
46,"46119",856,702,693,0,9,"ESPAÑA 2000",5
12,"12002",135,101,100,1,1,"ESPAÑA 2000",0
46,"46159",23111,17258,17086,141,172,"ESPAÑA 2000",78
12,"12113",100,72,72,0,0,"ESPAÑA 2000",0
12,"12076",105,79,79,0,0,"ESPAÑA 2000",0
46,"46194",15267,11622,11491,110,131,"ESPAÑA 2000",56
12,"12016",1589,1309,1293,15,16,"ESPAÑA 2000",6
46,"46057",483,357,349,9,8,"ESPAÑA 2000",1
46,"46203",3669,3002,2964,36,38,"ESPAÑA 2000",11
12,"12111",423,375,363,6,12,"ESPAÑA 2000",0
46,"46206",595,497,495,3,2,"ESPAÑA 2000",0
12,"12007",747,674,660,9,14,"ESPAÑA 2000",5
12,"12022",367,282,279,4,3,"ESPAÑA 2000",0
46,"46184",26507,20314,20010,263,304,"ESPAÑA 2000",43
46,"46030",800,677,662,6,15,"ESPAÑA 2000",2
46,"46047",551,479,469,10,10,"ESPAÑA 2000",1
12,"12041",115,98,98,2,0,"ESPAÑA 2000",0
46,"46217",912,758,751,4,7,"ESPAÑA 2000",1
12,"12115",234,184,183,2,1,"ESPAÑA 2000",2
46,"46004",1933,1563,1541,8,22,"ESPAÑA 2000",9
46,"46085",11344,8526,8426,87,100,"ESPAÑA 2000",33
12,"12119",153,87,87,0,0,"ESPAÑA 2000",2
46,"46109",6143,4731,4637,40,94,"ESPAÑA 2000",13
46,"46252",142,108,107,1,1,"ESPAÑA 2000",0
46,"46174",1003,854,847,6,7,"ESPAÑA 2000",1
12,"12046",236,177,176,4,1,"ESPAÑA 2000",2
46,"46215",1451,1185,1169,8,16,"ESPAÑA 2000",1
12,"12098",665,552,539,9,13,"ESPAÑA 2000",7
46,"46091",126,108,108,0,0,"ESPAÑA 2000",1
46,"46042",3376,2873,2819,17,54,"ESPAÑA 2000",4
12,"12075",139,106,102,0,4,"ESPAÑA 2000",0
46,"46164",11634,8843,8724,90,119,"ESPAÑA 2000",32
46,"46053",584,484,461,2,23,"ESPAÑA 2000",2
46,"46137",273,232,229,1,3,"ESPAÑA 2000",1
46,"46034",1791,1477,1468,8,9,"ESPAÑA 2000",15
46,"46191",1952,1554,1528,9,26,"ESPAÑA 2000",0
12,"12120",218,180,177,0,3,"ESPAÑA 2000",0
46,"46186",18444,14173,14029,135,144,"ESPAÑA 2000",77
12,"12003",1058,830,813,15,17,"ESPAÑA 2000",3
12,"12133",64,47,47,0,0,"ESPAÑA 2000",0
46,"46216",4806,3857,3825,39,32,"ESPAÑA 2000",7
46,"46232",920,730,722,6,8,"ESPAÑA 2000",0
12,"12082",9741,7555,7408,84,147,"ESPAÑA 2000",76
12,"12107",358,314,311,4,3,"ESPAÑA 2000",0
46,"46122",2737,2154,2131,18,23,"ESPAÑA 2000",7
46,"46098",2556,2072,2057,12,15,"ESPAÑA 2000",9
46,"46141",424,338,336,2,2,"ESPAÑA 2000",1
46,"46205",14277,10882,10764,115,118,"ESPAÑA 2000",23
46,"46243",149,120,117,0,3,"ESPAÑA 2000",0
12,"12090",127,109,107,2,2,"ESPAÑA 2000",1
46,"46125",858,724,710,6,14,"ESPAÑA 2000",1
12,"12091",203,153,140,2,13,"ESPAÑA 2000",5
46,"46070",15946,11979,11874,113,105,"ESPAÑA 2000",26
46,"46033",220,183,181,0,2,"ESPAÑA 2000",1
46,"46187",1339,1096,1083,13,13,"ESPAÑA 2000",7
12,"12031",3748,2751,2687,35,64,"ESPAÑA 2000",31
46,"46192",755,564,554,9,10,"ESPAÑA 2000",2
12,"12073",168,135,135,1,0,"ESPAÑA 2000",0
12,"12024",146,129,128,1,1,"ESPAÑA 2000",0
46,"46069",166,149,148,1,1,"ESPAÑA 2000",0
12,"12027",16914,11657,11452,188,205,"ESPAÑA 2000",120
12,"12005",8066,5835,5441,116,394,"ESPAÑA 2000",66
46,"46104",2012,1691,1676,9,15,"ESPAÑA 2000",1
46,"46058",1787,1460,1441,10,19,"ESPAÑA 2000",5
46,"46067",1798,1487,1472,10,15,"ESPAÑA 2000",4
12,"12067",563,458,439,8,19,"ESPAÑA 2000",1
46,"46175",469,406,401,5,5,"ESPAÑA 2000",1
46,"46229",1065,840,831,8,9,"ESPAÑA 2000",4
46,"46199",5661,4328,4280,38,48,"ESPAÑA 2000",12
46,"46018",689,597,592,12,5,"ESPAÑA 2000",1
46,"46037",1146,1007,1003,5,4,"ESPAÑA 2000",6
46,"46129",553,430,423,4,7,"ESPAÑA 2000",0
12,"12123",70,50,48,2,2,"ESPAÑA 2000",1
12,"12085",4941,3183,3125,32,58,"ESPAÑA 2000",57
12,"12040",116573,84142,83078,1257,1064,"ESPAÑA 2000",1095
46,"46169",31753,24041,23802,270,239,"ESPAÑA 2000",98
46,"46223",7685,6040,5996,62,44,"ESPAÑA 2000",27
46,"46207",6453,5086,5031,52,55,"ESPAÑA 2000",21
46,"46022",15090,10922,10840,99,82,"ESPAÑA 2000",47
46,"46135",9634,7671,7586,64,85,"ESPAÑA 2000",15
46,"46200",1915,1625,1595,15,30,"ESPAÑA 2000",2
46,"46170",3464,2944,2908,24,36,"ESPAÑA 2000",4
12,"12052",627,510,491,9,19,"ESPAÑA 2000",3
46,"46081",10254,8188,8101,52,87,"ESPAÑA 2000",31
46,"46049",292,249,245,0,4,"ESPAÑA 2000",3
12,"12104",6981,5464,5357,54,107,"ESPAÑA 2000",15
46,"46149",398,307,305,1,2,"ESPAÑA 2000",2
46,"46027",997,869,855,4,14,"ESPAÑA 2000",1
12,"12080",2051,1692,1650,23,42,"ESPAÑA 2000",4
46,"46116",12587,9821,9724,120,97,"ESPAÑA 2000",15
12,"12045",388,301,286,2,15,"ESPAÑA 2000",2
46,"46108",550,446,444,3,2,"ESPAÑA 2000",0
46,"46193",8494,6662,6580,73,82,"ESPAÑA 2000",24
46,"46139",4594,3794,3734,28,60,"ESPAÑA 2000",17
12,"12083",106,89,88,0,1,"ESPAÑA 2000",0
46,"46087",137,105,105,1,0,"ESPAÑA 2000",0
46,"46028",424,352,347,5,5,"ESPAÑA 2000",2
12,"12050",1418,1183,1156,8,27,"ESPAÑA 2000",6
46,"46155",1072,861,849,4,12,"ESPAÑA 2000",5
46,"46258",2792,2196,2164,14,32,"ESPAÑA 2000",1
12,"12088",55,51,51,2,0,"ESPAÑA 2000",0
46,"46101",868,720,716,8,4,"ESPAÑA 2000",2
12,"12108",495,394,389,4,5,"ESPAÑA 2000",2
46,"46074",2656,2071,2053,22,18,"ESPAÑA 2000",9
46,"46029",20887,16124,15988,144,136,"ESPAÑA 2000",82
46,"46237",7261,5405,5350,54,55,"ESPAÑA 2000",19
12,"12025",146,106,105,0,1,"ESPAÑA 2000",3
46,"46121",116,103,101,0,2,"ESPAÑA 2000",0
46,"46902",425,333,332,3,1,"ESPAÑA 2000",0
46,"46177",4594,3576,3523,29,53,"ESPAÑA 2000",10
12,"12059",276,227,227,1,0,"ESPAÑA 2000",0
46,"46040",1227,1028,1021,13,7,"ESPAÑA 2000",2
12,"12092",143,98,98,0,0,"ESPAÑA 2000",0
46,"46086",80,71,71,3,0,"ESPAÑA 2000",0
12,"12042",664,549,530,5,19,"ESPAÑA 2000",4
46,"46211",1716,1459,1447,9,12,"ESPAÑA 2000",16
46,"46240",226,188,185,3,3,"ESPAÑA 2000",3
46,"46024",448,365,358,1,7,"ESPAÑA 2000",0
12,"12093",254,190,187,0,3,"ESPAÑA 2000",0
12,"12127",92,64,61,0,3,"ESPAÑA 2000",0
12,"12069",53,48,47,0,1,"ESPAÑA 2000",2
46,"46084",1587,1363,1332,7,31,"ESPAÑA 2000",7
46,"46219",143,127,126,1,1,"ESPAÑA 2000",1
46,"46073",1119,931,915,14,16,"ESPAÑA 2000",0
46,"46054",11422,8666,8566,82,100,"ESPAÑA 2000",33
12,"12079",450,360,353,3,7,"ESPAÑA 2000",1
46,"46120",1133,889,870,2,19,"ESPAÑA 2000",3
46,"46052",532,471,463,2,8,"ESPAÑA 2000",2
46,"46255",3135,2530,2508,11,22,"ESPAÑA 2000",16
46,"46017",32928,24879,24672,267,207,"ESPAÑA 2000",256
46,"46260",2576,2140,2106,24,34,"ESPAÑA 2000",16
46,"46212",1598,1233,1218,5,15,"ESPAÑA 2000",5
46,"46012",930,698,684,9,14,"ESPAÑA 2000",1
46,"46095",632,505,495,1,10,"ESPAÑA 2000",4
46,"46082",4661,3447,3401,46,46,"ESPAÑA 2000",4
46,"46158",1037,829,822,9,7,"ESPAÑA 2000",1
46,"46117",476,377,373,6,4,"ESPAÑA 2000",0
46,"46036",675,440,431,11,9,"ESPAÑA 2000",0
46,"46015",7042,5644,5581,53,63,"ESPAÑA 2000",34
46,"46231",2496,1831,1817,16,14,"ESPAÑA 2000",4
12,"12129",1936,1372,1326,29,46,"ESPAÑA 2000",2
12,"12074",783,679,676,3,3,"ESPAÑA 2000",7
46,"46026",1217,1043,1035,2,8,"ESPAÑA 2000",0
46,"46142",870,682,673,7,9,"ESPAÑA 2000",2
12,"12032",23406,16895,16721,227,174,"ESPAÑA 2000",444
12,"12051",520,382,376,1,6,"ESPAÑA 2000",2
46,"46226",34,34,33,0,1,"ESPAÑA 2000",1
46,"46032",5583,4342,4287,39,55,"ESPAÑA 2000",13
46,"46153",445,374,366,7,8,"ESPAÑA 2000",2
46,"46234",388,308,307,3,1,"ESPAÑA 2000",1
46,"46248",4847,3655,3597,25,58,"ESPAÑA 2000",8
46,"46143",4278,3309,3266,46,43,"ESPAÑA 2000",14
12,"12131",92,78,78,1,0,"ESPAÑA 2000",0
12,"12141",116,97,97,0,0,"ESPAÑA 2000",0
12,"12038",195,135,134,8,1,"ESPAÑA 2000",0
12,"12134",147,107,107,3,0,"ESPAÑA 2000",0
12,"12064",118,91,89,1,2,"ESPAÑA 2000",2
12,"12110",253,199,195,3,4,"ESPAÑA 2000",1
12,"12087",22,20,20,0,0,"ESPAÑA 2000",0
46,"46041",369,255,255,1,0,"ESPAÑA 2000",0
46,"46146",1718,1395,1374,10,21,"ESPAÑA 2000",12
12,"12100",1380,1124,1109,11,15,"ESPAÑA 2000",5
46,"46124",768,641,632,10,9,"ESPAÑA 2000",0
46,"46181",17153,13332,13184,108,148,"ESPAÑA 2000",57
46,"46031",10580,7900,7809,87,91,"ESPAÑA 2000",28
46,"46228",2434,1881,1859,30,22,"ESPAÑA 2000",4
46,"46009",3140,2521,2498,15,23,"ESPAÑA 2000",12
12,"12138",18762,12489,12231,243,258,"ESPAÑA 2000",150
46,"46065",1606,1250,1234,15,16,"ESPAÑA 2000",9
12,"12053",2121,1745,1719,11,26,"ESPAÑA 2000",8
46,"46144",699,547,536,2,11,"ESPAÑA 2000",0
46,"46060",9510,7506,7408,52,98,"ESPAÑA 2000",25
46,"46063",1764,1441,1423,15,18,"ESPAÑA 2000",3
12,"12128",1448,1114,1092,16,22,"ESPAÑA 2000",10
12,"12142",158,122,121,1,1,"ESPAÑA 2000",1
12,"12008",236,203,199,4,4,"ESPAÑA 2000",1
46,"46196",159,145,144,1,1,"ESPAÑA 2000",0
12,"12006",185,160,153,0,7,"ESPAÑA 2000",0
46,"46230",14204,10650,10515,112,135,"ESPAÑA 2000",142
12,"12029",760,619,601,7,18,"ESPAÑA 2000",3
46,"46077",7637,5979,5845,64,134,"ESPAÑA 2000",10
46,"46242",361,288,280,4,8,"ESPAÑA 2000",1
46,"46253",118,105,102,7,3,"ESPAÑA 2000",1
46,"46250",574266,435877,431619,4626,4258,"ESPAÑA 2000",1303
12,"12071",1355,1069,1050,3,19,"ESPAÑA 2000",4
12,"12102",547,474,466,2,8,"ESPAÑA 2000",6
12,"12096",854,663,653,17,10,"ESPAÑA 2000",1
46,"46088",196,146,140,0,6,"ESPAÑA 2000",1
46,"46210",346,300,295,4,5,"ESPAÑA 2000",1
12,"12121",1197,1050,1020,4,30,"ESPAÑA 2000",1
46,"46131",49087,37846,37477,422,369,"ESPAÑA 2000",230
12,"12036",668,529,514,6,15,"ESPAÑA 2000",1
46,"46025",2495,1962,1941,24,21,"ESPAÑA 2000",7
46,"46168",1828,1461,1449,7,12,"ESPAÑA 2000",3
46,"46113",2338,1804,1797,14,7,"ESPAÑA 2000",10
12,"12065",181,155,155,0,0,"ESPAÑA 2000",0
46,"46903",5210,4037,4000,40,37,"ESPAÑA 2000",21
12,"12097",78,59,59,4,0,"ESPAÑA 2000",0
46,"46105",16708,12164,12040,100,124,"ESPAÑA 2000",33
12,"12034",1509,1125,1097,10,28,"ESPAÑA 2000",6
46,"46178",4406,3235,3201,22,34,"ESPAÑA 2000",14
12,"12117",3674,2846,2794,25,52,"ESPAÑA 2000",21
46,"46044",4301,3284,3169,50,115,"ESPAÑA 2000",3
46,"46259",537,426,424,9,2,"ESPAÑA 2000",0
46,"46112",582,475,463,4,12,"ESPAÑA 2000",1
46,"46100",307,264,255,0,9,"ESPAÑA 2000",0
46,"46222",378,321,310,1,11,"ESPAÑA 2000",0
12,"12063",59,42,41,0,1,"ESPAÑA 2000",0
46,"46183",5946,4718,4656,35,62,"ESPAÑA 2000",15
12,"12009",17124,12273,12098,150,175,"ESPAÑA 2000",239
46,"46001",863,647,641,5,6,"ESPAÑA 2000",3
12,"12004",4354,3145,3083,50,62,"ESPAÑA 2000",41
46,"46190",48324,34747,34424,431,323,"ESPAÑA 2000",113
46,"46093",2082,1722,1716,9,6,"ESPAÑA 2000",1
46,"46076",651,541,528,2,13,"ESPAÑA 2000",0
46,"46154",836,684,678,7,6,"ESPAÑA 2000",4
46,"46020",3793,3084,3046,21,38,"ESPAÑA 2000",12
46,"46157",3068,2523,2491,17,32,"ESPAÑA 2000",8
46,"46071",488,418,402,10,16,"ESPAÑA 2000",0
12,"12084",17219,12059,11911,165,148,"ESPAÑA 2000",227
12,"12103",85,65,65,4,0,"ESPAÑA 2000",1
12,"12125",235,203,201,1,2,"ESPAÑA 2000",0
46,"46209",1984,1606,1594,11,12,"ESPAÑA 2000",23
12,"12126",24420,18431,18136,231,295,"ESPAÑA 2000",210
46,"46092",304,206,201,1,5,"ESPAÑA 2000",0
46,"46064",547,463,458,2,5,"ESPAÑA 2000",1
46,"46161",1454,1192,1179,8,13,"ESPAÑA 2000",6
46,"46147",16527,11836,11716,105,120,"ESPAÑA 2000",63
46,"46220",48981,34657,34242,450,415,"ESPAÑA 2000",122
46,"46007",11576,8929,8848,71,81,"ESPAÑA 2000",78
12,"12105",866,679,673,6,6,"ESPAÑA 2000",4
46,"46173",1393,1156,1137,10,19,"ESPAÑA 2000",2
46,"46016",1097,927,917,12,10,"ESPAÑA 2000",3
46,"46233",3911,3025,2988,10,37,"ESPAÑA 2000",8
12,"12061",431,324,316,6,8,"ESPAÑA 2000",0
46,"46099",987,764,754,2,10,"ESPAÑA 2000",2
46,"46247",1059,829,823,6,6,"ESPAÑA 2000",2
46,"46201",83,50,49,0,1,"ESPAÑA 2000",0
46,"46089",2116,1653,1627,9,26,"ESPAÑA 2000",1
46,"46019",8671,7195,7109,70,86,"ESPAÑA 2000",18
12,"12116",56,45,45,0,0,"ESPAÑA 2000",0
12,"12017",183,143,141,6,2,"ESPAÑA 2000",1
12,"12057",650,530,515,6,15,"ESPAÑA 2000",1
46,"46238",13401,10371,10283,96,88,"ESPAÑA 2000",48
46,"46257",5579,4546,4512,32,34,"ESPAÑA 2000",11
46,"46249",9650,7288,7191,125,97,"ESPAÑA 2000",14
46,"46235",21966,16641,16465,167,176,"ESPAÑA 2000",61
12,"12081",654,519,515,2,4,"ESPAÑA 2000",3
46,"46185",422,360,359,7,1,"ESPAÑA 2000",0
46,"46163",1811,1487,1463,12,24,"ESPAÑA 2000",9
46,"46114",565,501,495,3,6,"ESPAÑA 2000",0
46,"46008",2727,2249,2233,17,16,"ESPAÑA 2000",5
12,"12132",524,407,401,4,6,"ESPAÑA 2000",3
46,"46239",457,331,323,2,8,"ESPAÑA 2000",2
46,"46050",161,126,123,1,3,"ESPAÑA 2000",0
12,"12014",191,139,137,4,2,"ESPAÑA 2000",1
46,"46171",16753,12565,12399,122,166,"ESPAÑA 2000",35
46,"46138",338,297,296,1,1,"ESPAÑA 2000",1
46,"46035",6470,5115,5047,38,68,"ESPAÑA 2000",14
46,"46179",2186,1849,1804,17,45,"ESPAÑA 2000",7
46,"46162",1230,1045,1027,6,18,"ESPAÑA 2000",2
46,"46254",1085,847,834,12,13,"ESPAÑA 2000",1
12,"12026",946,728,702,16,26,"ESPAÑA 2000",0
46,"46165",6962,5390,5322,53,68,"ESPAÑA 2000",30
46,"46241",440,336,314,4,22,"ESPAÑA 2000",1
46,"46263",333,243,241,2,2,"ESPAÑA 2000",2
12,"12010",280,232,229,3,3,"ESPAÑA 2000",0
46,"46202",15578,11811,11676,110,135,"ESPAÑA 2000",36
46,"46123",1808,1440,1410,7,30,"ESPAÑA 2000",11
12,"12902",2056,1454,1411,14,43,"ESPAÑA 2000",22
46,"46224",179,131,128,0,3,"ESPAÑA 2000",0
46,"46003",988,864,847,13,17,"ESPAÑA 2000",3
46,"46251",2599,2215,2179,21,36,"ESPAÑA 2000",9
46,"46128",1649,1322,1292,14,30,"ESPAÑA 2000",2
12,"12043",620,499,487,2,12,"ESPAÑA 2000",4
46,"46055",1286,1083,1067,11,16,"ESPAÑA 2000",7
46,"46023",318,275,267,2,8,"ESPAÑA 2000",0
46,"46152",96,70,70,0,0,"ESPAÑA 2000",0
46,"46068",326,292,285,3,7,"ESPAÑA 2000",0
46,"46189",490,400,396,3,4,"ESPAÑA 2000",1
46,"46051",8122,6432,6378,57,54,"ESPAÑA 2000",30
12,"12001",1098,821,817,8,4,"ESPAÑA 2000",1
46,"46039",2200,1849,1820,12,29,"ESPAÑA 2000",5
46,"46236",996,853,844,7,9,"ESPAÑA 2000",2
12,"12018",326,274,265,1,9,"ESPAÑA 2000",2
46,"46006",4643,3847,3785,32,62,"ESPAÑA 2000",5
12,"12114",228,178,173,2,5,"ESPAÑA 2000",0
46,"46079",381,304,299,3,5,"ESPAÑA 2000",0
12,"12095",1027,790,775,15,15,"ESPAÑA 2000",11
46,"46225",360,319,310,5,9,"ESPAÑA 2000",0
46,"46127",2790,2298,2267,23,31,"ESPAÑA 2000",3
46,"46160",1976,1591,1570,21,21,"ESPAÑA 2000",3
46,"46197",1902,1559,1554,15,5,"ESPAÑA 2000",1
46,"46244",57805,41885,41595,415,290,"ESPAÑA 2000",353
46,"46246",1081,917,904,5,13,"ESPAÑA 2000",3
46,"46132",2124,1845,1817,14,28,"ESPAÑA 2000",5
46,"46151",717,596,589,3,7,"ESPAÑA 2000",2
46,"46166",8260,6422,6324,60,98,"ESPAÑA 2000",16
46,"46214",15129,11609,11500,116,109,"ESPAÑA 2000",29
46,"46014",3092,2449,2420,26,29,"ESPAÑA 2000",10
46,"46103",1244,998,972,12,26,"ESPAÑA 2000",3
46,"46136",2476,1890,1865,16,25,"ESPAÑA 2000",0
46,"46106",1616,1196,1188,6,8,"ESPAÑA 2000",4
46,"46227",923,787,771,4,16,"ESPAÑA 2000",2
46,"46176",1965,1423,1405,12,18,"ESPAÑA 2000",9
12,"12101",385,309,296,3,13,"ESPAÑA 2000",0
12,"12049",471,366,344,10,22,"ESPAÑA 2000",0
12,"12118",83,63,62,0,1,"ESPAÑA 2000",11
12,"12033",1970,1547,1509,8,38,"ESPAÑA 2000",10
46,"46043",149,139,139,0,0,"ESPAÑA 2000",3
12,"12021",4433,3368,3292,42,76,"ESPAÑA 2000",29
27,"27023",2770,2196,2178,30,18,"EU-V",29
15,"15022",6102,4207,4164,52,43,"EU-V",142
36,"36028",4207,3294,3254,21,40,"EU-V",61
15,"15060",5599,4139,4069,82,70,"EU-V",147
36,"36040",2627,1938,1907,24,31,"EU-V",23
27,"27055",1494,1120,1107,8,13,"EU-V",6
36,"36043",5188,3435,3390,35,45,"EU-V",66
15,"15081",1139,869,853,9,16,"EU-V",23
36,"36021",11798,8742,8574,136,168,"EU-V",445
27,"27054",1332,1063,1054,12,9,"EU-V",13
15,"15093",4562,3314,3270,37,44,"EU-V",44
36,"36029",16178,11902,11636,148,266,"EU-V",519
15,"15017",18860,12975,12737,325,238,"EU-V",901
36,"36039",14581,11007,10782,167,225,"EU-V",504
15,"15032",3639,2642,2586,35,56,"EU-V",44
36,"36022",9203,6423,6226,100,197,"EU-V",425
36,"36055",13678,10508,10288,155,220,"EU-V",272
27,"27008",1458,1130,1115,18,15,"EU-V",17
15,"15024",4726,3634,3555,51,79,"EU-V",70
27,"27051",8224,6048,5953,108,95,"EU-V",267
15,"15015",2840,2006,1964,43,42,"EU-V",83
27,"27012",1519,886,880,6,6,"EU-V",11
32,"32085",10730,7588,7475,100,113,"EU-V",116
32,"32018",1351,1100,1092,9,8,"EU-V",3
15,"15065",7570,5710,5628,71,82,"EU-V",145
15,"15018",1211,821,805,11,16,"EU-V",26
36,"36035",14551,10675,10469,160,206,"EU-V",495
15,"15077",8677,6349,6269,82,80,"EU-V",85
27,"27043",1422,988,962,10,26,"EU-V",21
27,"27039",4363,3410,3346,63,64,"EU-V",78
15,"15003",1936,1400,1382,19,18,"EU-V",22
32,"32082",1403,1055,1047,9,8,"EU-V",2
15,"15009",11109,8179,8014,129,165,"EU-V",323
32,"32075",3839,2957,2910,51,47,"EU-V",57
32,"32044",939,774,764,8,10,"EU-V",66
32,"32061",1196,976,973,4,3,"EU-V",7
15,"15033",2581,2094,2079,15,15,"EU-V",45
15,"15087",6054,4004,3956,79,48,"EU-V",147
32,"32011",1026,660,650,4,10,"EU-V",4
27,"27047",1851,1293,1273,16,20,"EU-V",33
32,"32012",912,763,756,8,7,"EU-V",8
32,"32023",1360,1030,1011,6,19,"EU-V",12
27,"27002",1835,1455,1437,16,18,"EU-V",24
27,"27037",1205,857,845,13,12,"EU-V",17
32,"32074",1180,892,876,11,16,"EU-V",9
15,"15061",6105,4391,4307,64,84,"EU-V",94
32,"32013",2464,1695,1671,10,24,"EU-V",20
15,"15089",4354,3255,3216,55,39,"EU-V",78
32,"32056",1861,1378,1369,8,9,"EU-V",8
15,"15076",2766,1971,1936,18,35,"EU-V",27
15,"15031",22951,16018,15696,382,322,"EU-V",887
32,"32065",720,550,539,3,11,"EU-V",7
36,"36901",4085,3285,3235,21,50,"EU-V",78
15,"15080",1913,1407,1389,15,18,"EU-V",16
15,"15005",23875,15132,14895,356,237,"EU-V",702
32,"32003",950,736,727,3,9,"EU-V",11
32,"32089",1480,1063,1045,7,18,"EU-V",9
32,"32081",2240,1698,1682,13,16,"EU-V",30
15,"15058",26931,19505,19196,471,309,"EU-V",1232
36,"36057",236900,168990,166060,2833,2930,"EU-V",11966
15,"15036",60838,40345,39667,915,678,"EU-V",2728
15,"15025",1173,780,777,10,3,"EU-V",21
36,"36013",2690,1801,1778,11,23,"EU-V",40
32,"32038",497,360,358,2,2,"EU-V",10
15,"15041",9718,7514,7425,102,89,"EU-V",167
32,"32031",1079,837,828,5,9,"EU-V",8
36,"36046",4093,3175,3120,31,55,"EU-V",76
36,"36051",14288,10228,10079,124,149,"EU-V",278
36,"36007",1778,1258,1238,2,20,"EU-V",13
15,"15010",2009,1468,1441,24,27,"EU-V",16
32,"32002",2060,1566,1551,13,15,"EU-V",30
15,"15090",1267,959,953,4,6,"EU-V",13
32,"32077",1234,999,993,23,6,"EU-V",18
27,"27026",2605,1785,1751,19,34,"EU-V",31
15,"15012",3767,2973,2926,51,47,"EU-V",64
27,"27059",2320,1783,1763,25,20,"EU-V",24
15,"15008",5657,4224,4157,62,67,"EU-V",156
32,"32066",634,492,488,0,4,"EU-V",3
27,"27013",3950,3156,3090,39,66,"EU-V",161
27,"27035",194,119,119,0,0,"EU-V",10
15,"15053",8164,5679,5592,60,87,"EU-V",155
15,"15079",1709,1268,1253,14,15,"EU-V",12
32,"32052",2126,1690,1673,28,17,"EU-V",30
15,"15074",4254,3246,3219,35,27,"EU-V",51
32,"32062",963,735,729,10,6,"EU-V",7
15,"15064",2356,1859,1824,35,35,"EU-V",62
32,"32060",885,650,641,10,9,"EU-V",23
27,"27052",966,726,718,9,8,"EU-V",13
15,"15004",4891,3595,3545,61,50,"EU-V",152
27,"27032",3466,2565,2530,40,35,"EU-V",50
27,"27001",2582,1687,1669,31,18,"EU-V",16
36,"36033",12323,9328,9150,97,178,"EU-V",384
27,"27048",2404,1939,1909,36,30,"EU-V",26
27,"27031",16169,11446,11214,194,232,"EU-V",311
32,"32032",8284,6295,6198,84,97,"EU-V",94
32,"32051",1574,1296,1290,7,6,"EU-V",14
15,"15088",3769,2626,2599,21,27,"EU-V",28
32,"32008",7618,5529,5433,83,96,"EU-V",143
36,"36010",2987,2312,2282,30,30,"EU-V",93
27,"27038",1035,817,809,9,8,"EU-V",18
36,"36044",2595,1862,1834,23,28,"EU-V",52
27,"27007",3015,2426,2374,42,52,"EU-V",54
27,"27046",1626,1177,1153,17,24,"EU-V",31
32,"32037",828,660,654,10,6,"EU-V",11
32,"32080",394,311,309,3,2,"EU-V",2
36,"36011",1939,1189,1172,15,17,"EU-V",13
27,"27022",5093,3535,3486,74,49,"EU-V",63
32,"32025",1218,954,941,12,13,"EU-V",6
32,"32020",2958,2300,2283,19,17,"EU-V",21
27,"27016",7521,5439,5338,83,101,"EU-V",143
27,"27041",2644,1946,1915,29,31,"EU-V",35
27,"27056",1388,1043,1026,16,17,"EU-V",32
32,"32091",1971,1472,1466,12,6,"EU-V",9
36,"36017",18554,13573,13378,200,195,"EU-V",303
15,"15027",1537,1263,1242,22,21,"EU-V",31
32,"32021",1043,793,788,7,5,"EU-V",12
32,"32064",561,439,437,5,2,"EU-V",6
32,"32057",608,475,473,4,2,"EU-V",6
36,"36018",3492,2516,2494,25,22,"EU-V",19
15,"15092",6869,4965,4907,53,58,"EU-V",59
15,"15037",4181,2839,2804,25,35,"EU-V",54
36,"36059",5438,3874,3805,47,69,"EU-V",51
15,"15084",3681,2676,2656,34,20,"EU-V",27
27,"27027",2111,1652,1605,21,47,"EU-V",22
32,"32004",2071,1145,1142,7,3,"EU-V",6
32,"32040",1587,1226,1219,7,7,"EU-V",22
27,"27058",3908,2946,2915,28,31,"EU-V",34
15,"15006",5539,3940,3866,53,74,"EU-V",75
32,"32007",1674,1263,1243,4,20,"EU-V",9
15,"15068",5404,3780,3725,53,55,"EU-V",61
36,"36016",1373,865,853,7,12,"EU-V",5
32,"32078",1366,1026,1018,3,8,"EU-V",6
15,"15047",2606,1789,1761,33,28,"EU-V",33
32,"32024",5054,3668,3609,40,59,"EU-V",48
27,"27025",3005,2414,2377,25,37,"EU-V",63
32,"32047",2003,1595,1575,10,20,"EU-V",16
32,"32039",1424,1084,1069,10,15,"EU-V",10
36,"36053",5677,4204,4157,51,47,"EU-V",136
15,"15082",15075,11217,11046,187,171,"EU-V",459
27,"27040",3421,2718,2693,27,25,"EU-V",37
32,"32067",1487,1004,995,10,9,"EU-V",12
27,"27011",2663,1822,1785,23,37,"EU-V",34
15,"15039",1374,1027,998,27,29,"EU-V",20
27,"27057",11297,8174,8005,162,169,"EU-V",200
32,"32084",1084,818,805,0,13,"EU-V",7
32,"32092",596,367,364,2,3,"EU-V",2
15,"15046",6949,4641,4539,56,102,"EU-V",77
32,"32036",1528,1217,1202,13,15,"EU-V",12
36,"36032",3666,2789,2755,25,34,"EU-V",27
27,"27062",681,535,532,7,3,"EU-V",19
32,"32068",1631,1187,1174,4,13,"EU-V",12
27,"27053",606,429,426,4,3,"EU-V",3
32,"32049",863,566,563,7,3,"EU-V",12
32,"32088",1749,1232,1217,10,15,"EU-V",31
27,"27005",2792,2101,2076,21,25,"EU-V",53
15,"15049",1211,851,843,7,8,"EU-V",16
32,"32043",2679,2006,1985,14,21,"EU-V",34
32,"32086",2874,2026,2003,18,23,"EU-V",21
32,"32048",1004,687,671,48,16,"EU-V",17
32,"32073",1415,1111,1100,8,11,"EU-V",14
27,"27063",1916,1469,1440,14,29,"EU-V",36
15,"15050",1971,1110,1097,27,13,"EU-V",22
15,"15059",10658,7889,7728,125,161,"EU-V",175
27,"27061",1170,917,906,8,11,"EU-V",15
32,"32005",957,760,753,8,7,"EU-V",3
27,"27024",1759,1346,1324,17,22,"EU-V",28
15,"15069",7019,5036,4938,85,98,"EU-V",266
15,"15021",5114,3527,3475,77,52,"EU-V",153
27,"27066",12908,9554,9329,171,225,"EU-V",347
15,"15043",5491,4033,3971,45,62,"EU-V",81
15,"15045",4178,2743,2727,22,16,"EU-V",32
27,"27019",8247,6146,6022,101,124,"EU-V",208
36,"36042",17897,12635,12437,157,198,"EU-V",621
32,"32022",1591,1219,1207,9,12,"EU-V",13
36,"36034",3684,2686,2651,32,35,"EU-V",70
15,"15070",9684,6627,6464,141,163,"EU-V",307
36,"36054",10862,8201,8087,87,114,"EU-V",198
15,"15023",6629,4879,4795,52,84,"EU-V",115
27,"27042",1888,1427,1407,12,20,"EU-V",18
36,"36025",2442,1531,1516,10,15,"EU-V",33
15,"15035",11969,8239,8120,192,119,"EU-V",612
36,"36058",5021,3589,3516,54,73,"EU-V",91
15,"15066",4180,3098,3062,38,36,"EU-V",80
27,"27015",4587,3465,3409,55,56,"EU-V",60
32,"32035",1632,1100,1088,8,12,"EU-V",10
36,"36049",6608,5189,5097,56,92,"EU-V",175
32,"32010",457,362,356,0,6,"EU-V",5
27,"27902",7198,5074,4976,106,98,"EU-V",184
27,"27021",1936,1295,1271,19,24,"EU-V",16
27,"27060",2938,2063,2028,26,35,"EU-V",46
27,"27006",2789,1949,1911,22,38,"EU-V",32
36,"36048",5416,4045,3971,55,74,"EU-V",106
15,"15063",2849,2022,2001,28,21,"EU-V",43
32,"32053",1500,1206,1199,19,7,"EU-V",13
32,"32019",11469,8297,8180,134,117,"EU-V",142
36,"36061",8729,6747,6640,68,107,"EU-V",140
36,"36038",65661,47940,47214,836,726,"EU-V",1852
15,"15075",12042,8639,8486,147,153,"EU-V",421
27,"27034",1297,871,867,3,4,"EU-V",13
36,"36005",8231,5985,5873,84,112,"EU-V",159
32,"32001",4938,3715,3667,50,48,"EU-V",96
32,"32083",960,675,672,0,3,"EU-V",10
32,"32072",3949,2881,2841,32,40,"EU-V",80
32,"32059",1983,1526,1510,27,16,"EU-V",19
36,"36015",4379,3151,3101,38,50,"EU-V",61
27,"27009",2354,1812,1782,19,30,"EU-V",13
15,"15052",4567,3539,3493,22,46,"EU-V",48
36,"36036",2616,1981,1948,24,33,"EU-V",33
27,"27030",3744,2587,2525,32,62,"EU-V",57
15,"15086",3110,2281,2259,30,22,"EU-V",37
36,"36027",4478,3376,3339,29,37,"EU-V",54
15,"15073",21991,14686,14456,216,230,"EU-V",356
15,"15901",3855,2463,2419,48,44,"EU-V",45
27,"27004",1379,981,966,4,15,"EU-V",11
32,"32055",1412,1056,1037,5,19,"EU-V",15
27,"27045",1149,817,812,7,5,"EU-V",15
15,"15055",4780,3247,3181,70,66,"EU-V",228
36,"36050",7602,5424,5339,50,85,"EU-V",163
15,"15083",1198,874,855,8,19,"EU-V",10
27,"27044",3089,2167,2125,31,42,"EU-V",36
32,"32050",2663,1991,1974,17,17,"EU-V",17
36,"36002",3154,2381,2358,35,23,"EU-V",53
32,"32076",2358,1835,1823,18,12,"EU-V",16
32,"32034",1228,995,990,5,5,"EU-V",18
27,"27028",78862,57097,55890,1246,1207,"EU-V",2794
15,"15085",3576,2656,2612,29,44,"EU-V",46
27,"27029",1525,1243,1221,18,22,"EU-V",40
36,"36009",5138,3147,3108,24,39,"EU-V",69
15,"15048",4769,3470,3415,57,55,"EU-V",107
32,"32046",1375,976,962,3,14,"EU-V",14
36,"36012",3839,2884,2825,14,59,"EU-V",91
15,"15072",9868,7077,6951,79,126,"EU-V",178
36,"36045",24724,17794,17459,237,335,"EU-V",951
36,"36003",9876,7155,7007,100,148,"EU-V",281
36,"36056",5087,3883,3830,37,53,"EU-V",76
32,"32042",1784,1292,1282,13,10,"EU-V",13
32,"32015",995,697,694,9,3,"EU-V",11
27,"27003",2064,1531,1516,19,15,"EU-V",20
15,"15044",1436,1083,1068,10,15,"EU-V",13
32,"32041",884,576,568,2,8,"EU-V",7
15,"15038",2363,1643,1610,29,33,"EU-V",19
32,"32006",1814,1344,1330,20,14,"EU-V",14
15,"15040",2891,2160,2129,18,31,"EU-V",55
15,"15002",21528,15479,15218,314,261,"EU-V",861
36,"36041",13141,9405,9238,114,167,"EU-V",272
15,"15071",8233,5751,5668,93,83,"EU-V",143
32,"32028",1805,1369,1354,16,15,"EU-V",4
36,"36047",2723,1875,1853,27,22,"EU-V",22
32,"32027",1156,850,836,15,14,"EU-V",1
36,"36004",10264,7383,7263,80,120,"EU-V",205
36,"36014",2145,1568,1548,9,20,"EU-V",25
15,"15067",8142,6054,5978,73,76,"EU-V",137
32,"32070",660,457,452,1,5,"EU-V",5
32,"32033",843,595,583,7,12,"EU-V",8
15,"15091",1171,839,829,9,10,"EU-V",35
32,"32090",834,662,657,4,5,"EU-V",3
27,"27010",4725,3427,3368,55,59,"EU-V",83
36,"36006",11387,8911,8727,72,184,"EU-V",215
32,"32014",1271,939,925,9,14,"EU-V",8
36,"36031",572,484,479,5,5,"EU-V",10
15,"15034",3116,2146,2114,20,32,"EU-V",21
32,"32029",557,426,424,1,2,"EU-V",3
32,"32054",87289,63027,61875,1263,1152,"EU-V",2334
36,"36030",4387,3206,3177,35,29,"EU-V",57
15,"15057",12467,8936,8744,102,192,"EU-V",246
27,"27050",3236,2475,2438,11,37,"EU-V",27
36,"36019",1681,1204,1188,14,16,"EU-V",17
27,"27901",2559,1847,1831,27,16,"EU-V",25
32,"32026",2775,2096,2064,37,32,"EU-V",67
15,"15030",201751,141022,138934,2981,2088,"EU-V",9648
15,"15014",4239,3151,3104,39,47,"EU-V",42
36,"36026",20494,14048,13798,232,250,"EU-V",504
32,"32017",1333,906,895,10,11,"EU-V",20
32,"32079",1448,1103,1094,14,9,"EU-V",23
32,"32087",1935,1609,1591,11,18,"EU-V",32
32,"32030",1120,857,846,9,11,"EU-V",13
15,"15001",4985,3560,3506,63,54,"EU-V",116
27,"27020",3807,3204,3161,33,43,"EU-V",38
15,"15011",15507,10935,10751,123,184,"EU-V",319
32,"32071",1614,1121,1112,4,9,"EU-V",9
15,"15026",2025,1426,1413,17,13,"EU-V",13
27,"27033",723,536,529,10,7,"EU-V",4
15,"15062",6304,4418,4356,44,62,"EU-V",78
36,"36037",2727,1923,1896,18,27,"EU-V",55
15,"15019",26096,18466,18187,350,279,"EU-V",432
36,"36020",2581,1947,1922,27,25,"EU-V",15
15,"15013",6160,4229,4165,70,64,"EU-V",163
15,"15078",78092,56506,55597,1110,909,"EU-V",2940
27,"27014",3511,2470,2437,45,33,"EU-V",38
36,"36008",21702,15366,15037,261,329,"EU-V",1047
36,"36023",8522,6206,6062,64,144,"EU-V",213
15,"15029",6266,4668,4618,49,50,"EU-V",70
36,"36001",3138,2060,2049,13,11,"EU-V",25
32,"32009",10752,7778,7684,120,94,"EU-V",205
15,"15020",4187,2802,2781,18,21,"EU-V",75
15,"15051",4780,3333,3289,61,44,"EU-V",284
27,"27049",1554,1073,1062,6,11,"EU-V",14
27,"27064",1706,1233,1214,14,19,"EU-V",20
15,"15028",1485,1130,1118,14,12,"EU-V",49
15,"15007",3702,2670,2642,19,28,"EU-V",27
32,"32016",1021,781,776,2,5,"EU-V",3
36,"36024",17164,12723,12500,163,223,"EU-V",253
32,"32063",2127,1469,1444,22,25,"EU-V",58
36,"36052",7517,5563,5461,54,102,"EU-V",96
32,"32058",5253,3872,3821,57,51,"EU-V",119
36,"36060",30264,21398,21051,344,347,"EU-V",1037
32,"32045",2640,1999,1980,23,19,"EU-V",24
15,"15054",32172,20472,20154,519,318,"EU-V",1250
15,"15042",3249,2341,2303,25,38,"EU-V",42
27,"27017",1138,789,787,6,2,"EU-V",10
32,"32069",4573,3624,3580,35,44,"EU-V",113
27,"27018",3871,2523,2489,32,34,"EU-V",67
15,"15056",5873,4205,4150,63,55,"EU-V",70
27,"27065",13035,9432,9254,168,178,"EU-V",186
15,"15016",5135,3816,3771,22,45,"EU-V",52
7,"7052",4578,2671,2651,46,20,"ESQUERRA",27
7,"7061",9429,5937,5800,125,137,"ESQUERRA",75
7,"7041",2077,1583,1549,27,34,"ESQUERRA",21
7,"7021",255,197,193,1,4,"ESQUERRA",3
7,"7014",6697,3818,3757,38,61,"ESQUERRA",14
7,"7059",3011,2077,2012,22,65,"ESQUERRA",20
7,"7054",19930,11186,11028,196,158,"ESQUERRA",108
7,"7022",11700,7512,7371,128,141,"ESQUERRA",195
7,"7039",4920,3488,3377,54,111,"ESQUERRA",19
7,"7007",454,304,300,4,4,"ESQUERRA",11
7,"7065",2061,1376,1345,29,31,"ESQUERRA",57
7,"7045",1189,843,823,23,20,"ESQUERRA",12
7,"7044",8326,6044,5846,99,198,"ESQUERRA",141
7,"7032",19658,12168,11959,238,209,"ESQUERRA",99
7,"7019",230,165,164,1,1,"ESQUERRA",4
7,"7011",26954,16786,16595,299,191,"ESQUERRA",62
7,"7003",10671,6262,6149,79,113,"ESQUERRA",66
7,"7029",4090,2921,2866,44,55,"ESQUERRA",28
7,"7017",800,556,539,14,17,"ESQUERRA",6
7,"7013",6525,4528,4409,78,119,"ESQUERRA",48
7,"7051",4925,2993,2947,66,46,"ESQUERRA",52
7,"7033",25954,14975,14738,328,237,"ESQUERRA",525
7,"7058",2803,2100,2046,38,54,"ESQUERRA",26
7,"7028",876,607,595,6,12,"ESQUERRA",8
7,"7040",266127,162699,160491,2698,2208,"ESQUERRA",1072
7,"7037",3269,1737,1700,37,37,"ESQUERRA",26
7,"7048",15296,8559,8439,176,120,"ESQUERRA",112
7,"7036",25502,17151,16914,294,237,"ESQUERRA",98
7,"7025",457,355,346,3,9,"ESQUERRA",1
7,"7002",6305,4188,4073,80,115,"ESQUERRA",36
7,"7055",7000,4471,4379,67,92,"ESQUERRA",18
7,"7047",2161,1447,1407,31,40,"ESQUERRA",15
7,"7046",13748,8294,8183,183,111,"ESQUERRA",67
7,"7901",642,483,470,5,13,"ESQUERRA",1
7,"7062",7206,4073,4035,72,38,"ESQUERRA",40
7,"7018",389,275,271,0,4,"ESQUERRA",3
7,"7030",1576,1150,1135,26,15,"ESQUERRA",6
7,"7024",6070,3232,3170,60,62,"ESQUERRA",51
7,"7042",10393,6536,6421,96,115,"ESQUERRA",200
7,"7010",4668,3229,3174,58,55,"ESQUERRA",70
7,"7038",1962,1504,1480,20,24,"ESQUERRA",10
7,"7023",3541,2414,2365,88,49,"ESQUERRA",35
7,"7043",3522,2384,2345,35,39,"ESQUERRA",39
7,"7027",20045,12873,12678,204,195,"ESQUERRA",102
7,"7049",1482,1046,1037,14,9,"ESQUERRA",13
7,"7063",1414,1050,1030,25,20,"ESQUERRA",15
7,"7004",3669,2511,2453,51,58,"ESQUERRA",23
7,"7009",744,593,576,11,17,"ESQUERRA",15
7,"7006",4964,3234,3157,51,77,"ESQUERRA",52
7,"7064",5286,3340,3279,53,61,"ESQUERRA",39
7,"7053",1133,863,839,16,24,"ESQUERRA",11
7,"7008",5422,3782,3705,61,77,"ESQUERRA",44
7,"7005",6331,4128,4058,76,70,"ESQUERRA",11
7,"7902",1071,734,712,22,22,"ESQUERRA",8
7,"7034",971,724,708,10,16,"ESQUERRA",7
7,"7031",23371,14443,14213,285,230,"ESQUERRA",131
7,"7026",30036,16912,16661,294,251,"ESQUERRA",167
7,"7015",20783,12244,12016,381,228,"ESQUERRA",115
7,"7056",4701,3164,3090,55,74,"ESQUERRA",87
7,"7016",2726,1848,1809,34,39,"ESQUERRA",14
7,"7020",3455,2491,2453,46,38,"ESQUERRA",11
7,"7060",2534,1724,1697,30,27,"ESQUERRA",64
7,"7035",1542,1190,1161,19,29,"ESQUERRA",7
7,"7050",3099,2008,1979,45,29,"ESQUERRA",13
7,"7001",3450,2544,2470,36,74,"ESQUERRA",58
7,"7012",1880,1437,1405,20,32,"ESQUERRA",14
7,"7057",7102,4702,4611,85,91,"ESQUERRA",125
17,"17112",215,141,138,4,3,"ERC-RI.cat",13
43,"43096",103,81,77,3,4,"ERC-RI.cat",8
8,"8248",5239,3513,3443,71,70,"ERC-RI.cat",302
43,"43099",330,240,236,4,4,"ERC-RI.cat",14
8,"8217",24130,17554,17319,383,235,"ERC-RI.cat",719
17,"17124",1670,1087,1056,18,31,"ERC-RI.cat",116
8,"8121",85069,58372,57620,923,752,"ERC-RI.cat",3215
17,"17234",183,131,128,2,3,"ERC-RI.cat",19
8,"8124",36292,24541,24210,471,331,"ERC-RI.cat",996
43,"43007",635,448,441,7,7,"ERC-RI.cat",82
17,"17169",2460,1690,1651,34,39,"ERC-RI.cat",169
43,"43110",307,216,214,5,2,"ERC-RI.cat",12
8,"8008",193,119,114,5,5,"ERC-RI.cat",19
17,"17063",169,113,111,5,2,"ERC-RI.cat",11
8,"8013",1234,834,820,23,14,"ERC-RI.cat",81
8,"8304",822,587,578,16,9,"ERC-RI.cat",59
17,"17227",107,82,82,1,0,"ERC-RI.cat",9
17,"17135",380,273,269,9,4,"ERC-RI.cat",32
43,"43032",587,418,413,9,5,"ERC-RI.cat",43
43,"43100",3062,2058,2021,52,37,"ERC-RI.cat",111
17,"17058",177,115,114,2,1,"ERC-RI.cat",23
17,"17101",567,349,339,4,10,"ERC-RI.cat",27
8,"8039",365,264,260,5,4,"ERC-RI.cat",22
17,"17032",1613,933,918,11,15,"ERC-RI.cat",144
8,"8274",4887,3326,3279,36,47,"ERC-RI.cat",259
43,"43903",2368,1504,1492,22,12,"ERC-RI.cat",153
17,"17047",4803,2866,2803,30,63,"ERC-RI.cat",238
8,"8200",61189,40677,40069,736,608,"ERC-RI.cat",1454
8,"8084",1134,789,760,14,29,"ERC-RI.cat",112
8,"8190",281,201,197,3,4,"ERC-RI.cat",26
8,"8152",129,94,93,0,1,"ERC-RI.cat",20
17,"17161",978,693,687,21,6,"ERC-RI.cat",122
8,"8030",4849,3466,3422,50,44,"ERC-RI.cat",301
8,"8118",17077,11817,11598,203,219,"ERC-RI.cat",1002
8,"8228",303,230,227,5,3,"ERC-RI.cat",26
43,"43124",532,366,358,3,8,"ERC-RI.cat",36
17,"17140",684,476,470,10,6,"ERC-RI.cat",38
8,"8104",713,454,441,9,13,"ERC-RI.cat",77
43,"43030",454,321,307,5,14,"ERC-RI.cat",21
17,"17212",129,100,98,4,2,"ERC-RI.cat",11
8,"8219",14647,10347,10169,193,178,"ERC-RI.cat",724
17,"17107",301,203,200,8,3,"ERC-RI.cat",21
8,"8197",7316,4983,4926,69,57,"ERC-RI.cat",345
8,"8043",3067,2044,2023,29,21,"ERC-RI.cat",85
8,"8255",132,83,82,1,1,"ERC-RI.cat",12
8,"8307",47176,31341,30846,536,495,"ERC-RI.cat",2124
8,"8194",24757,15009,14799,245,210,"ERC-RI.cat",411
43,"43170",880,601,592,9,9,"ERC-RI.cat",61
8,"8119",6039,3991,3884,74,107,"ERC-RI.cat",197
8,"8094",1500,1102,1071,21,31,"ERC-RI.cat",111
17,"17120",779,501,485,9,16,"ERC-RI.cat",64
8,"8247",903,627,608,10,19,"ERC-RI.cat",91
8,"8005",5884,4114,4041,68,73,"ERC-RI.cat",372
8,"8230",7452,5349,5286,94,63,"ERC-RI.cat",329
43,"43066",165,113,112,2,1,"ERC-RI.cat",10
8,"8283",5862,3712,3618,72,94,"ERC-RI.cat",430
8,"8109",200,155,153,1,2,"ERC-RI.cat",46
8,"8033",12476,8513,8378,180,135,"ERC-RI.cat",883
43,"43045",156,110,109,1,1,"ERC-RI.cat",30
8,"8128",557,377,374,16,3,"ERC-RI.cat",44
8,"8183",4497,2914,2865,43,49,"ERC-RI.cat",407
17,"17222",108,86,86,1,0,"ERC-RI.cat",15
17,"17038",343,261,256,2,5,"ERC-RI.cat",30
8,"8300",5621,4021,3933,94,88,"ERC-RI.cat",240
17,"17146",2952,1895,1864,49,31,"ERC-RI.cat",174
17,"17066",25667,15429,15157,244,272,"ERC-RI.cat",1181
8,"8243",160,112,110,3,2,"ERC-RI.cat",9
8,"8218",7968,5014,4932,129,82,"ERC-RI.cat",275
43,"43020",2119,1463,1427,26,36,"ERC-RI.cat",56
17,"17184",1281,803,787,21,16,"ERC-RI.cat",130
17,"17118",12541,7817,7681,130,136,"ERC-RI.cat",720
8,"8203",2442,1526,1498,34,28,"ERC-RI.cat",122
17,"17086",1687,1148,1129,14,19,"ERC-RI.cat",154
43,"43108",1808,1183,1157,28,26,"ERC-RI.cat",150
17,"17105",257,152,146,4,6,"ERC-RI.cat",14
17,"17023",26941,17098,16799,344,299,"ERC-RI.cat",898
17,"17154",93,54,49,1,5,"ERC-RI.cat",3
43,"43167",390,284,280,12,4,"ERC-RI.cat",37
8,"8225",92,68,68,2,0,"ERC-RI.cat",12
17,"17100",201,140,135,1,5,"ERC-RI.cat",6
17,"17115",281,209,207,5,2,"ERC-RI.cat",21
8,"8035",12099,7838,7735,123,103,"ERC-RI.cat",729
8,"8015",155673,101652,100264,1628,1388,"ERC-RI.cat",4290
17,"17031",172,94,93,1,1,"ERC-RI.cat",10
43,"43061",55,31,31,1,0,"ERC-RI.cat",2
43,"43172",378,268,266,8,2,"ERC-RI.cat",32
8,"8081",332,232,225,2,7,"ERC-RI.cat",27
43,"43034",494,355,344,8,11,"ERC-RI.cat",46
8,"8191",5520,3601,3536,64,65,"ERC-RI.cat",377
8,"8017",2740,1800,1768,38,32,"ERC-RI.cat",165
8,"8176",166,111,109,0,2,"ERC-RI.cat",8
8,"8146",1321,876,862,18,14,"ERC-RI.cat",69
17,"17145",1593,1090,1068,10,22,"ERC-RI.cat",164
43,"43175",590,419,411,8,8,"ERC-RI.cat",32
8,"8127",2274,1371,1338,23,33,"ERC-RI.cat",124
8,"8063",434,336,333,8,3,"ERC-RI.cat",47
43,"43022",1559,1097,1074,22,23,"ERC-RI.cat",65
8,"8110",13366,8493,8329,144,164,"ERC-RI.cat",619
8,"8027",673,527,515,9,12,"ERC-RI.cat",55
8,"8061",1467,960,952,10,8,"ERC-RI.cat",45
8,"8241",80,61,61,1,0,"ERC-RI.cat",11
17,"17034",6723,4131,4064,77,67,"ERC-RI.cat",349
43,"43058",106,76,76,5,0,"ERC-RI.cat",14
8,"8116",600,401,393,9,8,"ERC-RI.cat",58
43,"43091",142,106,98,5,8,"ERC-RI.cat",11
8,"8025",1460,990,963,14,27,"ERC-RI.cat",86
8,"8037",1830,1247,1209,40,38,"ERC-RI.cat",200
43,"43095",2434,1658,1624,27,34,"ERC-RI.cat",137
17,"17067",732,483,470,16,13,"ERC-RI.cat",68
17,"17157",127,99,98,3,1,"ERC-RI.cat",12
8,"8165",1689,1091,1070,18,21,"ERC-RI.cat",83
8,"8164",873,606,584,13,22,"ERC-RI.cat",71
17,"17095",19245,11212,11067,160,145,"ERC-RI.cat",621
8,"8291",4516,2895,2855,56,40,"ERC-RI.cat",243
8,"8169",47505,31997,31566,555,431,"ERC-RI.cat",1003
8,"8245",78826,51185,50445,962,740,"ERC-RI.cat",1087
8,"8261",2273,1547,1525,30,22,"ERC-RI.cat",81
17,"17046",738,510,498,15,12,"ERC-RI.cat",63
17,"17044",6619,4293,4187,69,106,"ERC-RI.cat",600
8,"8297",138,99,99,2,0,"ERC-RI.cat",8
8,"8213",6188,4031,3970,113,61,"ERC-RI.cat",375
8,"8160",313,227,222,8,5,"ERC-RI.cat",31
43,"43177",338,242,236,6,6,"ERC-RI.cat",28
17,"17008",3745,2262,2195,34,67,"ERC-RI.cat",261
43,"43089",272,193,185,1,8,"ERC-RI.cat",17
17,"17111",789,584,574,15,10,"ERC-RI.cat",74
8,"8251",4771,3214,3140,57,74,"ERC-RI.cat",197
8,"8097",985,676,657,3,19,"ERC-RI.cat",78
8,"8210",4176,2661,2579,54,82,"ERC-RI.cat",300
8,"8001",8538,5929,5838,120,91,"ERC-RI.cat",253
17,"17181",3228,2116,2081,19,35,"ERC-RI.cat",196
17,"17003",101,67,64,2,3,"ERC-RI.cat",14
17,"17163",2478,1729,1681,41,48,"ERC-RI.cat",243
8,"8002",202,143,140,4,3,"ERC-RI.cat",17
8,"8137",255,190,190,3,0,"ERC-RI.cat",24
8,"8114",17629,11781,11579,189,202,"ERC-RI.cat",624
43,"43158",109,63,61,5,2,"ERC-RI.cat",11
43,"43015",104,69,68,2,1,"ERC-RI.cat",21
43,"43082",383,282,270,8,12,"ERC-RI.cat",28
43,"43145",3968,2781,2742,52,39,"ERC-RI.cat",239
43,"43138",2719,1775,1730,45,45,"ERC-RI.cat",84
8,"8148",2240,1246,1223,22,23,"ERC-RI.cat",59
17,"17015",12254,7759,7553,143,206,"ERC-RI.cat",1212
8,"8055",476,312,304,11,8,"ERC-RI.cat",59
43,"43028",2654,1620,1588,27,32,"ERC-RI.cat",123
8,"8151",504,345,338,6,7,"ERC-RI.cat",56
8,"8034",741,542,529,4,13,"ERC-RI.cat",78
8,"8289",4123,2802,2768,54,34,"ERC-RI.cat",294
17,"17188",167,124,122,9,2,"ERC-RI.cat",12
17,"17065",316,211,205,6,6,"ERC-RI.cat",46
43,"43084",573,383,378,6,5,"ERC-RI.cat",89
8,"8295",10579,6896,6769,137,127,"ERC-RI.cat",375
17,"17091",433,288,277,16,11,"ERC-RI.cat",26
8,"8032",1955,1330,1294,18,36,"ERC-RI.cat",100
8,"8054",8733,6215,6077,123,138,"ERC-RI.cat",359
17,"17083",2886,1825,1801,39,24,"ERC-RI.cat",174
8,"8168",418,268,266,0,2,"ERC-RI.cat",12
43,"43016",3437,2323,2266,40,57,"ERC-RI.cat",130
43,"43157",388,282,270,10,12,"ERC-RI.cat",43
17,"17195",324,220,214,6,6,"ERC-RI.cat",39
8,"8249",273,218,214,4,4,"ERC-RI.cat",24
8,"8178",450,311,304,3,7,"ERC-RI.cat",37
17,"17166",503,361,342,10,19,"ERC-RI.cat",56
43,"43065",443,278,270,8,8,"ERC-RI.cat",33
8,"8059",323,189,186,9,3,"ERC-RI.cat",29
8,"8040",10538,6916,6804,99,112,"ERC-RI.cat",714
43,"43053",190,149,149,2,0,"ERC-RI.cat",13
8,"8087",158,133,132,6,1,"ERC-RI.cat",22
8,"8077",33925,23896,23548,381,348,"ERC-RI.cat",955
17,"17206",167,108,107,2,1,"ERC-RI.cat",8
43,"43905",13621,8120,8011,131,109,"ERC-RI.cat",323
8,"8067",5657,3772,3671,75,101,"ERC-RI.cat",421
17,"17126",309,231,229,9,2,"ERC-RI.cat",45
43,"43102",517,377,366,2,11,"ERC-RI.cat",4
8,"8187",149633,104021,102629,1794,1392,"ERC-RI.cat",6260
8,"8281",4735,3239,3193,57,46,"ERC-RI.cat",350
17,"17198",404,264,259,9,5,"ERC-RI.cat",29
8,"8083",1626,1199,1178,23,21,"ERC-RI.cat",247
8,"8167",5703,3896,3831,82,65,"ERC-RI.cat",117
17,"17201",131,89,89,2,0,"ERC-RI.cat",14
17,"17138",1010,677,662,3,15,"ERC-RI.cat",72
8,"8271",74,45,44,3,1,"ERC-RI.cat",10
43,"43094",2209,1558,1524,31,34,"ERC-RI.cat",179
8,"8101",169663,112624,111107,1841,1517,"ERC-RI.cat",3441
43,"43137",1873,1241,1212,27,29,"ERC-RI.cat",123
8,"8135",6647,4753,4678,79,75,"ERC-RI.cat",162
17,"17077",580,374,372,5,2,"ERC-RI.cat",52
43,"43083",141,97,97,2,0,"ERC-RI.cat",7
17,"17129",126,91,90,3,1,"ERC-RI.cat",20
43,"43132",365,217,214,8,3,"ERC-RI.cat",31
43,"43136",10163,6312,6197,121,115,"ERC-RI.cat",698
8,"8227",2372,1591,1549,38,42,"ERC-RI.cat",125
43,"43031",1509,1016,992,20,24,"ERC-RI.cat",118
17,"17233",2192,1470,1434,33,36,"ERC-RI.cat",170
8,"8264",3983,2773,2744,30,29,"ERC-RI.cat",218
17,"17228",280,172,170,4,2,"ERC-RI.cat",24
8,"8273",2287,1594,1547,18,47,"ERC-RI.cat",178
8,"8045",70,42,42,2,0,"ERC-RI.cat",6
8,"8123",18751,13394,13154,238,240,"ERC-RI.cat",1108
17,"17087",230,170,161,6,9,"ERC-RI.cat",18
43,"43169",477,377,364,8,13,"ERC-RI.cat",74
43,"43152",472,355,351,9,4,"ERC-RI.cat",44
17,"17204",539,349,347,10,2,"ERC-RI.cat",35
17,"17084",269,177,175,4,2,"ERC-RI.cat",19
8,"8018",2664,1707,1669,29,38,"ERC-RI.cat",165
17,"17009",4089,2573,2490,59,83,"ERC-RI.cat",382
17,"17151",174,131,131,6,0,"ERC-RI.cat",18
43,"43044",3990,2768,2715,72,53,"ERC-RI.cat",154
17,"17025",1127,775,760,11,15,"ERC-RI.cat",104
43,"43004",6411,4089,4001,92,88,"ERC-RI.cat",621
17,"17116",369,230,227,3,3,"ERC-RI.cat",30
8,"8023",6546,4261,4194,86,67,"ERC-RI.cat",349
43,"43017",141,98,98,2,0,"ERC-RI.cat",9
43,"43036",836,503,494,4,9,"ERC-RI.cat",45
8,"8298",25338,16982,16690,353,292,"ERC-RI.cat",2514
17,"17173",174,121,119,1,2,"ERC-RI.cat",19
8,"8134",776,528,513,15,15,"ERC-RI.cat",56
8,"8012",1694,1155,1136,32,19,"ERC-RI.cat",166
43,"43131",4495,2842,2814,51,28,"ERC-RI.cat",93
43,"43139",2166,1319,1270,37,49,"ERC-RI.cat",150
43,"43107",378,255,248,18,7,"ERC-RI.cat",47
8,"8252",24033,16704,16402,368,302,"ERC-RI.cat",516
17,"17215",1918,1350,1321,40,29,"ERC-RI.cat",193
17,"17164",4092,2409,2346,60,63,"ERC-RI.cat",301
43,"43135",327,243,238,2,5,"ERC-RI.cat",12
8,"8009",8932,6188,6088,103,100,"ERC-RI.cat",529
17,"17167",2818,1886,1858,52,28,"ERC-RI.cat",256
43,"43056",931,537,515,18,22,"ERC-RI.cat",117
43,"43086",5269,3275,3196,92,79,"ERC-RI.cat",509
43,"43037",16656,9986,9812,163,174,"ERC-RI.cat",406
43,"43112",294,184,181,2,3,"ERC-RI.cat",45
8,"8100",1934,1437,1401,40,36,"ERC-RI.cat",198
43,"43014",14146,9153,8915,204,238,"ERC-RI.cat",1113
17,"17209",605,469,463,21,6,"ERC-RI.cat",57
43,"43090",1142,644,636,7,8,"ERC-RI.cat",27
43,"43101",146,94,93,3,1,"ERC-RI.cat",20
8,"8905",2268,1692,1657,28,35,"ERC-RI.cat",147
43,"43125",1008,706,701,10,5,"ERC-RI.cat",33
8,"8065",1224,796,778,13,18,"ERC-RI.cat",52
43,"43041",237,177,176,4,1,"ERC-RI.cat",13
8,"8269",2613,1840,1814,32,26,"ERC-RI.cat",222
8,"8280",116,74,72,3,2,"ERC-RI.cat",7
43,"43006",712,484,475,10,9,"ERC-RI.cat",26
43,"43078",841,557,547,7,10,"ERC-RI.cat",38
8,"8073",60247,41448,40843,770,605,"ERC-RI.cat",1316
43,"43113",454,321,316,10,5,"ERC-RI.cat",21
17,"17007",1778,1137,1113,16,24,"ERC-RI.cat",207
8,"8069",3028,2071,2029,36,42,"ERC-RI.cat",194
8,"8179",591,415,405,6,10,"ERC-RI.cat",65
8,"8006",10984,7255,7092,104,163,"ERC-RI.cat",673
17,"17012",1093,689,679,11,10,"ERC-RI.cat",61
43,"43093",3924,2507,2445,62,62,"ERC-RI.cat",236
17,"17085",295,212,208,12,4,"ERC-RI.cat",32
17,"17082",443,285,280,1,5,"ERC-RI.cat",14
8,"8126",8299,5599,5508,103,91,"ERC-RI.cat",357
17,"17011",625,472,467,5,5,"ERC-RI.cat",82
8,"8053",2850,1788,1772,21,16,"ERC-RI.cat",164
43,"43109",2040,1332,1316,28,16,"ERC-RI.cat",49
8,"8226",886,667,656,13,11,"ERC-RI.cat",104
17,"17022",6771,4247,4169,76,78,"ERC-RI.cat",595
17,"17079",62633,40844,40101,670,743,"ERC-RI.cat",4604
8,"8050",149,112,108,4,4,"ERC-RI.cat",15
8,"8204",2991,2076,2040,45,36,"ERC-RI.cat",149
17,"17035",548,385,379,7,6,"ERC-RI.cat",58
17,"17171",148,111,109,5,2,"ERC-RI.cat",8
8,"8145",2597,1823,1784,23,39,"ERC-RI.cat",159
17,"17223",787,523,514,8,9,"ERC-RI.cat",61
43,"43067",626,445,431,21,14,"ERC-RI.cat",27
43,"43062",298,227,223,7,4,"ERC-RI.cat",26
8,"8129",444,278,271,2,7,"ERC-RI.cat",45
43,"43164",298,233,231,4,2,"ERC-RI.cat",7
8,"8020",4542,3352,3298,77,54,"ERC-RI.cat",311
8,"8267",6215,4100,4011,82,89,"ERC-RI.cat",291
8,"8038",1406,911,895,24,16,"ERC-RI.cat",94
8,"8266",42860,30047,29521,536,526,"ERC-RI.cat",1438
8,"8276",249,188,187,9,1,"ERC-RI.cat",35
43,"43168",106,70,69,2,1,"ERC-RI.cat",8
17,"17189",1536,1061,1025,7,36,"ERC-RI.cat",237
43,"43142",1155,730,714,20,16,"ERC-RI.cat",74
43,"43046",114,80,79,5,1,"ERC-RI.cat",5
17,"17207",2357,1636,1584,40,52,"ERC-RI.cat",231
8,"8051",17397,12178,12002,240,176,"ERC-RI.cat",1039
8,"8175",3477,2303,2270,39,33,"ERC-RI.cat",304
8,"8096",40650,28247,27784,527,463,"ERC-RI.cat",1713
17,"17024",301,207,204,4,3,"ERC-RI.cat",23
17,"17001",557,370,365,7,5,"ERC-RI.cat",72
8,"8042",2172,1459,1448,30,11,"ERC-RI.cat",94
8,"8029",3389,2542,2514,45,28,"ERC-RI.cat",194
8,"8216",21,14,14,0,0,"ERC-RI.cat",2
17,"17014",64,39,37,0,2,"ERC-RI.cat",7
17,"17041",237,153,153,1,0,"ERC-RI.cat",31
43,"43074",1697,1150,1120,25,30,"ERC-RI.cat",111
8,"8107",10955,7236,7130,151,106,"ERC-RI.cat",391
8,"8144",769,494,481,16,13,"ERC-RI.cat",70
43,"43148",89309,59260,58346,1202,914,"ERC-RI.cat",2938
43,"43166",1521,1002,977,17,25,"ERC-RI.cat",126
17,"17018",478,337,332,8,5,"ERC-RI.cat",37
17,"17143",134,89,87,2,2,"ERC-RI.cat",6
17,"17199",6630,4242,4162,80,80,"ERC-RI.cat",551
17,"17218",568,361,350,11,11,"ERC-RI.cat",60
17,"17098",311,208,202,4,6,"ERC-RI.cat",23
17,"17128",309,232,224,5,8,"ERC-RI.cat",25
43,"43064",2063,1420,1391,37,29,"ERC-RI.cat",109
17,"17196",209,139,138,6,1,"ERC-RI.cat",27
17,"17226",852,539,535,0,4,"ERC-RI.cat",19
43,"43159",89,51,51,2,0,"ERC-RI.cat",2
17,"17074",490,345,342,5,3,"ERC-RI.cat",36
43,"43021",381,218,213,3,5,"ERC-RI.cat",27
8,"8293",246,145,145,4,0,"ERC-RI.cat",14
17,"17057",1010,640,634,19,6,"ERC-RI.cat",93
8,"8099",808,533,519,11,14,"ERC-RI.cat",43
17,"17027",2865,1955,1892,34,63,"ERC-RI.cat",312
8,"8031",2289,1619,1599,34,20,"ERC-RI.cat",137
17,"17071",1064,719,698,33,21,"ERC-RI.cat",117
8,"8184",52133,33696,33220,656,476,"ERC-RI.cat",1598
8,"8229",561,404,398,12,6,"ERC-RI.cat",45
8,"8092",3928,2511,2473,33,38,"ERC-RI.cat",301
8,"8174",409,294,292,10,2,"ERC-RI.cat",56
8,"8011",1754,1116,1085,29,31,"ERC-RI.cat",182
8,"8052",148,103,98,1,5,"ERC-RI.cat",7
8,"8143",2679,1772,1756,35,16,"ERC-RI.cat",133
17,"17043",159,101,100,2,1,"ERC-RI.cat",13
17,"17075",304,216,210,5,6,"ERC-RI.cat",29
8,"8253",134,91,91,2,0,"ERC-RI.cat",9
8,"8136",11117,7602,7478,174,124,"ERC-RI.cat",226
17,"17153",172,127,123,1,4,"ERC-RI.cat",21
43,"43001",706,481,473,12,8,"ERC-RI.cat",53
17,"17160",14852,9257,9128,145,129,"ERC-RI.cat",781
17,"17076",126,77,76,5,1,"ERC-RI.cat",14
8,"8016",1984,1319,1289,26,30,"ERC-RI.cat",106
17,"17186",3593,2358,2317,33,41,"ERC-RI.cat",272
8,"8185",189,131,126,1,5,"ERC-RI.cat",10
8,"8220",2277,1641,1604,44,37,"ERC-RI.cat",296
43,"43123",70216,45627,44828,906,799,"ERC-RI.cat",2746
17,"17183",261,178,176,2,2,"ERC-RI.cat",18
17,"17180",8076,4868,4767,81,101,"ERC-RI.cat",571
8,"8288",1735,985,957,13,28,"ERC-RI.cat",82
8,"8070",275,192,191,5,1,"ERC-RI.cat",37
8,"8234",3143,2040,2008,45,32,"ERC-RI.cat",186
8,"8305",26208,17810,17506,296,304,"ERC-RI.cat",1636
8,"8272",148,97,96,6,1,"ERC-RI.cat",17
17,"17019",1783,1264,1234,42,30,"ERC-RI.cat",152
8,"8224",771,538,528,26,10,"ERC-RI.cat",45
8,"8285",10168,6582,6423,152,159,"ERC-RI.cat",826
43,"43151",119,91,89,0,2,"ERC-RI.cat",30
17,"17061",175,123,123,4,0,"ERC-RI.cat",13
8,"8259",6362,4482,4420,97,62,"ERC-RI.cat",394
17,"17036",2822,1844,1806,36,38,"ERC-RI.cat",280
43,"43176",832,575,572,16,3,"ERC-RI.cat",91
17,"17220",780,550,545,13,5,"ERC-RI.cat",73
8,"8159",13482,9173,9040,239,133,"ERC-RI.cat",456
17,"17149",366,254,251,4,3,"ERC-RI.cat",51
8,"8170",458,300,288,13,12,"ERC-RI.cat",46
17,"17178",1075,683,679,15,4,"ERC-RI.cat",85
8,"8902",3600,2518,2496,57,22,"ERC-RI.cat",179
43,"43051",8749,5494,5411,78,83,"ERC-RI.cat",179
43,"43904",2918,1779,1732,49,47,"ERC-RI.cat",228
8,"8157",8256,5729,5624,119,105,"ERC-RI.cat",249
17,"17175",569,375,369,6,6,"ERC-RI.cat",25
43,"43054",2850,1815,1771,37,44,"ERC-RI.cat",250
43,"43907",4122,2759,2712,52,47,"ERC-RI.cat",99
8,"8153",502,357,350,7,7,"ERC-RI.cat",51
8,"8206",717,557,547,7,10,"ERC-RI.cat",46
17,"17081",236,165,162,2,3,"ERC-RI.cat",27
8,"8103",636,453,446,16,7,"ERC-RI.cat",65
43,"43161",17199,10765,10547,197,218,"ERC-RI.cat",1063
17,"17051",201,146,142,4,4,"ERC-RI.cat",21
8,"8036",172,124,124,4,0,"ERC-RI.cat",12
8,"8301",47343,32098,31664,672,434,"ERC-RI.cat",795
43,"43126",1170,802,783,19,19,"ERC-RI.cat",65
8,"8026",180,144,143,0,1,"ERC-RI.cat",17
8,"8268",1110,768,755,17,13,"ERC-RI.cat",59
43,"43050",2407,1528,1504,20,24,"ERC-RI.cat",57
8,"8240",9104,6355,6262,101,93,"ERC-RI.cat",737
43,"43118",439,318,313,7,5,"ERC-RI.cat",27
8,"8237",1692,1155,1127,22,28,"ERC-RI.cat",171
17,"17078",346,231,226,3,5,"ERC-RI.cat",29
17,"17141",5689,3485,3428,50,57,"ERC-RI.cat",289
8,"8141",4666,3124,3066,57,58,"ERC-RI.cat",392
8,"8080",42,33,33,2,0,"ERC-RI.cat",5
17,"17148",1546,980,957,24,23,"ERC-RI.cat",77
8,"8158",2996,2012,1986,19,26,"ERC-RI.cat",184
43,"43026",800,531,522,15,9,"ERC-RI.cat",90
8,"8003",6983,5061,4993,53,68,"ERC-RI.cat",426
43,"43002",1790,1252,1226,17,26,"ERC-RI.cat",38
43,"43160",1278,840,812,9,28,"ERC-RI.cat",51
8,"8047",4141,2610,2580,49,30,"ERC-RI.cat",274
17,"17096",182,96,94,2,2,"ERC-RI.cat",21
43,"43029",330,202,194,6,8,"ERC-RI.cat",68
17,"17026",542,404,398,3,6,"ERC-RI.cat",32
17,"17099",74,52,50,1,2,"ERC-RI.cat",4
43,"43146",45,33,30,1,3,"ERC-RI.cat",5
17,"17039",1850,1299,1275,31,24,"ERC-RI.cat",130
43,"43906",2050,1332,1298,28,34,"ERC-RI.cat",101
8,"8088",11250,8019,7861,144,158,"ERC-RI.cat",916
43,"43120",454,287,283,1,4,"ERC-RI.cat",10
43,"43144",1187,787,772,12,15,"ERC-RI.cat",87
8,"8202",12206,8265,8129,183,136,"ERC-RI.cat",590
8,"8082",1143,733,723,17,10,"ERC-RI.cat",49
8,"8062",863,595,583,8,12,"ERC-RI.cat",62
8,"8192",5450,3688,3634,79,54,"ERC-RI.cat",432
8,"8086",13267,8791,8669,200,122,"ERC-RI.cat",466
8,"8209",6596,4415,4351,69,64,"ERC-RI.cat",253
43,"43011",1013,745,729,21,16,"ERC-RI.cat",91
17,"17202",3799,2398,2366,44,32,"ERC-RI.cat",210
43,"43088",1810,1199,1177,29,22,"ERC-RI.cat",166
17,"17172",426,286,283,3,3,"ERC-RI.cat",29
43,"43009",1421,913,897,18,16,"ERC-RI.cat",87
17,"17097",185,136,136,4,0,"ERC-RI.cat",12
17,"17037",105,66,66,2,0,"ERC-RI.cat",11
17,"17103",4988,2788,2724,51,64,"ERC-RI.cat",258
43,"43174",152,104,101,1,3,"ERC-RI.cat",33
8,"8263",20729,13742,13563,232,179,"ERC-RI.cat",1076
8,"8193",928,565,554,15,11,"ERC-RI.cat",65
8,"8223",1855,1178,1155,19,23,"ERC-RI.cat",173
17,"17119",89,65,64,3,1,"ERC-RI.cat",9
17,"17109",759,428,414,10,14,"ERC-RI.cat",52
43,"43153",10307,6572,6450,94,122,"ERC-RI.cat",456
17,"17903",893,565,556,14,9,"ERC-RI.cat",86
8,"8060",167,102,101,0,1,"ERC-RI.cat",3
43,"43080",254,175,173,7,2,"ERC-RI.cat",39
8,"8904",10608,6654,6561,140,93,"ERC-RI.cat",124
17,"17193",3978,2365,2305,38,60,"ERC-RI.cat",199
17,"17052",134,84,83,2,1,"ERC-RI.cat",6
8,"8074",10224,6571,6479,116,92,"ERC-RI.cat",295
17,"17029",198,136,133,1,3,"ERC-RI.cat",23
17,"17197",144,103,102,3,1,"ERC-RI.cat",3
8,"8078",224,154,151,2,3,"ERC-RI.cat",22
8,"8112",12946,8533,8390,227,143,"ERC-RI.cat",992
8,"8235",3627,2506,2467,35,39,"ERC-RI.cat",345
8,"8014",1906,1338,1313,37,25,"ERC-RI.cat",124
43,"43072",97,73,70,0,3,"ERC-RI.cat",7
17,"17200",616,406,393,12,13,"ERC-RI.cat",69
43,"43048",830,547,530,16,17,"ERC-RI.cat",57
8,"8010",4124,2674,2611,44,63,"ERC-RI.cat",381
17,"17210",527,358,349,9,9,"ERC-RI.cat",46
8,"8004",228,176,172,2,4,"ERC-RI.cat",24
17,"17208",1012,642,622,12,20,"ERC-RI.cat",70
17,"17121",230,159,158,7,1,"ERC-RI.cat",21
17,"17216",158,100,97,1,3,"ERC-RI.cat",8
8,"8242",243,174,172,5,2,"ERC-RI.cat",19
17,"17182",257,177,175,2,2,"ERC-RI.cat",5
8,"8257",116,84,81,0,3,"ERC-RI.cat",13
17,"17211",864,628,612,12,16,"ERC-RI.cat",128
8,"8022",12437,7598,7445,169,153,"ERC-RI.cat",879
43,"43068",573,388,378,5,10,"ERC-RI.cat",26
17,"17134",235,149,148,3,1,"ERC-RI.cat",27
8,"8207",1718,1296,1256,28,40,"ERC-RI.cat",213
43,"43902",2761,1836,1811,25,25,"ERC-RI.cat",110
17,"17002",567,413,401,4,12,"ERC-RI.cat",64
8,"8113",52352,33606,33123,590,483,"ERC-RI.cat",3381
43,"43049",805,555,536,6,19,"ERC-RI.cat",104
17,"17224",355,246,241,10,5,"ERC-RI.cat",26
17,"17040",506,320,316,7,4,"ERC-RI.cat",51
17,"17221",4135,2789,2723,49,66,"ERC-RI.cat",168
43,"43178",1262,891,870,24,21,"ERC-RI.cat",70
8,"8161",10991,6841,6709,114,132,"ERC-RI.cat",394
17,"17132",1296,913,900,15,13,"ERC-RI.cat",77
8,"8254",1721,1189,1174,26,15,"ERC-RI.cat",203
43,"43085",229,178,171,0,7,"ERC-RI.cat",20
8,"8172",19889,13537,13333,267,204,"ERC-RI.cat",908
8,"8292",1083,775,764,21,11,"ERC-RI.cat",92
17,"17006",1203,759,754,17,5,"ERC-RI.cat",100
8,"8057",61,41,40,1,1,"ERC-RI.cat",2
8,"8024",409,266,260,4,6,"ERC-RI.cat",42
8,"8132",381,247,241,6,6,"ERC-RI.cat",16
8,"8222",1827,1343,1317,21,26,"ERC-RI.cat",134
43,"43005",3559,2191,2147,47,44,"ERC-RI.cat",190
8,"8201",458,305,298,12,7,"ERC-RI.cat",47
43,"43143",62,51,50,1,1,"ERC-RI.cat",1
43,"43098",362,251,247,1,4,"ERC-RI.cat",28
43,"43003",307,187,184,10,3,"ERC-RI.cat",11
17,"17125",132,90,89,1,1,"ERC-RI.cat",28
17,"17213",5282,3097,3041,42,56,"ERC-RI.cat",308
43,"43117",150,118,115,1,3,"ERC-RI.cat",5
17,"17136",173,124,120,0,4,"ERC-RI.cat",12
8,"8303",279,202,201,11,1,"ERC-RI.cat",27
8,"8246",1714,1175,1153,27,22,"ERC-RI.cat",170
8,"8079",335,255,243,14,12,"ERC-RI.cat",56
43,"43081",574,415,404,13,11,"ERC-RI.cat",44
8,"8195",88,64,64,2,0,"ERC-RI.cat",7
43,"43901",8849,5651,5540,179,111,"ERC-RI.cat",612
43,"43073",90,57,57,1,0,"ERC-RI.cat",5
43,"43060",3049,2030,1980,62,50,"ERC-RI.cat",277
43,"43115",171,112,110,3,2,"ERC-RI.cat",13
17,"17068",252,156,156,4,0,"ERC-RI.cat",14
8,"8117",2424,1685,1661,45,24,"ERC-RI.cat",155
8,"8056",39345,26705,26396,449,309,"ERC-RI.cat",915
17,"17176",141,96,95,3,1,"ERC-RI.cat",13
17,"17137",3331,2163,2110,39,53,"ERC-RI.cat",316
8,"8189",141,113,111,4,2,"ERC-RI.cat",8
17,"17214",695,470,461,10,9,"ERC-RI.cat",58
17,"17177",563,398,388,7,10,"ERC-RI.cat",39
8,"8140",4665,3160,3103,55,57,"ERC-RI.cat",231
43,"43130",196,132,131,7,1,"ERC-RI.cat",22
8,"8130",95,63,62,3,1,"ERC-RI.cat",6
43,"43055",2002,1404,1374,36,30,"ERC-RI.cat",195
17,"17048",6176,3818,3773,52,45,"ERC-RI.cat",248
8,"8244",5746,4044,3940,102,104,"ERC-RI.cat",260
8,"8019",1143222,778246,767530,12386,10716,"ERC-RI.cat",54842
17,"17106",140,105,104,0,1,"ERC-RI.cat",9
8,"8275",242,188,186,4,2,"ERC-RI.cat",41
17,"17073",1753,1320,1298,18,22,"ERC-RI.cat",141
8,"8238",13892,10237,10094,206,143,"ERC-RI.cat",784
8,"8098",2374,1552,1535,28,17,"ERC-RI.cat",121
43,"43008",333,206,197,3,9,"ERC-RI.cat",5
8,"8138",4014,2735,2679,46,56,"ERC-RI.cat",374
17,"17013",2774,1884,1859,21,25,"ERC-RI.cat",126
8,"8282",6092,4478,4405,79,73,"ERC-RI.cat",428
17,"17162",137,80,78,2,2,"ERC-RI.cat",11
8,"8142",127,83,83,4,0,"ERC-RI.cat",8
17,"17070",116,78,78,3,0,"ERC-RI.cat",9
17,"17168",393,285,281,8,4,"ERC-RI.cat",42
17,"17020",3446,2322,2268,45,54,"ERC-RI.cat",327
17,"17139",1346,899,869,21,30,"ERC-RI.cat",99
8,"8048",622,461,454,9,7,"ERC-RI.cat",73
17,"17050",645,438,425,15,13,"ERC-RI.cat",77
43,"43141",131,71,70,3,1,"ERC-RI.cat",6
8,"8294",1870,1205,1171,22,34,"ERC-RI.cat",125
43,"43013",4369,2795,2747,54,48,"ERC-RI.cat",309
43,"43052",1001,669,636,12,33,"ERC-RI.cat",63
8,"8181",7722,5280,5188,112,92,"ERC-RI.cat",346
43,"43076",467,308,300,7,8,"ERC-RI.cat",56
43,"43057",45,27,27,2,0,"ERC-RI.cat",3
43,"43150",1337,994,977,12,17,"ERC-RI.cat",90
17,"17192",145,107,105,4,2,"ERC-RI.cat",9
8,"8089",33316,22369,22107,437,262,"ERC-RI.cat",940
17,"17130",333,236,233,5,3,"ERC-RI.cat",35
8,"8049",1340,839,816,10,23,"ERC-RI.cat",118
8,"8120",6342,4801,4746,63,55,"ERC-RI.cat",427
8,"8284",11920,7059,6942,139,117,"ERC-RI.cat",387
43,"43042",2071,1504,1485,28,19,"ERC-RI.cat",142
8,"8071",248,172,167,2,5,"ERC-RI.cat",28
8,"8162",1955,1306,1271,28,35,"ERC-RI.cat",132
43,"43133",5697,3470,3388,76,82,"ERC-RI.cat",354
8,"8233",1867,1179,1169,29,10,"ERC-RI.cat",221
43,"43121",636,385,371,6,14,"ERC-RI.cat",113
17,"17190",811,548,532,7,16,"ERC-RI.cat",78
8,"8182",2802,1871,1852,35,19,"ERC-RI.cat",87
17,"17069",395,276,267,2,9,"ERC-RI.cat",27
43,"43069",194,131,127,3,4,"ERC-RI.cat",8
43,"43077",486,335,328,4,7,"ERC-RI.cat",7
17,"17225",208,138,134,1,4,"ERC-RI.cat",28
8,"8180",26210,17504,17214,366,290,"ERC-RI.cat",512
8,"8232",1793,1239,1220,20,19,"ERC-RI.cat",139
8,"8007",6338,4165,4050,89,115,"ERC-RI.cat",607
8,"8102",27850,18716,18470,373,246,"ERC-RI.cat",1780
8,"8150",245,181,178,11,3,"ERC-RI.cat",9
43,"43163",24903,15475,15241,263,234,"ERC-RI.cat",750
17,"17080",165,115,114,1,1,"ERC-RI.cat",26
8,"8108",4879,3475,3437,64,38,"ERC-RI.cat",150
8,"8156",10672,7359,7225,121,134,"ERC-RI.cat",362
17,"17089",5486,3328,3288,43,40,"ERC-RI.cat",336
43,"43043",3065,1952,1919,39,33,"ERC-RI.cat",154
17,"17230",456,326,320,10,6,"ERC-RI.cat",31
17,"17165",608,414,400,9,14,"ERC-RI.cat",60
8,"8239",471,338,333,6,5,"ERC-RI.cat",27
43,"43025",660,453,446,13,7,"ERC-RI.cat",73
17,"17021",108,86,79,0,7,"ERC-RI.cat",3
8,"8155",6573,4411,4334,85,77,"ERC-RI.cat",293
43,"43059",264,185,185,4,0,"ERC-RI.cat",19
8,"8256",669,498,496,16,2,"ERC-RI.cat",47
43,"43147",528,393,380,7,13,"ERC-RI.cat",43
8,"8199",712,507,499,15,8,"ERC-RI.cat",64
17,"17030",624,414,409,8,5,"ERC-RI.cat",31
8,"8277",134,90,90,4,0,"ERC-RI.cat",6
8,"8154",677,499,488,2,11,"ERC-RI.cat",32
8,"8308",145,116,115,1,1,"ERC-RI.cat",7
8,"8287",1053,738,730,26,8,"ERC-RI.cat",84
43,"43156",4120,2811,2741,66,70,"ERC-RI.cat",144
17,"17056",1704,1171,1158,21,13,"ERC-RI.cat",143
17,"17117",14022,8705,8595,129,110,"ERC-RI.cat",699
43,"43075",102,63,63,1,0,"ERC-RI.cat",5
17,"17016",725,491,481,8,10,"ERC-RI.cat",52
8,"8221",11348,8413,8306,109,107,"ERC-RI.cat",690
43,"43171",13906,8978,8855,167,123,"ERC-RI.cat",268
17,"17088",551,374,363,4,11,"ERC-RI.cat",69
8,"8111",220,188,188,4,0,"ERC-RI.cat",33
43,"43104",1821,1209,1178,34,31,"ERC-RI.cat",192
17,"17060",378,240,233,1,7,"ERC-RI.cat",25
43,"43129",4525,3032,2956,62,76,"ERC-RI.cat",261
17,"17055",158,121,121,4,0,"ERC-RI.cat",17
43,"43154",136,97,96,6,1,"ERC-RI.cat",7
8,"8212",508,366,363,1,3,"ERC-RI.cat",72
43,"43024",1459,958,937,17,21,"ERC-RI.cat",20
8,"8066",1315,985,965,16,20,"ERC-RI.cat",90
17,"17158",404,266,264,3,2,"ERC-RI.cat",22
43,"43155",22951,14114,13856,326,258,"ERC-RI.cat",1078
8,"8262",6835,4086,3993,94,93,"ERC-RI.cat",395
43,"43103",897,586,575,21,11,"ERC-RI.cat",30
8,"8236",1507,1027,1002,18,25,"ERC-RI.cat",148
8,"8021",76,49,47,1,2,"ERC-RI.cat",3
17,"17093",859,561,552,16,9,"ERC-RI.cat",52
17,"17142",2440,1713,1681,39,32,"ERC-RI.cat",178
43,"43019",1356,868,837,13,31,"ERC-RI.cat",66
43,"43070",265,198,196,3,2,"ERC-RI.cat",37
43,"43012",3392,2346,2295,48,51,"ERC-RI.cat",185
8,"8903",217,178,176,10,2,"ERC-RI.cat",18
8,"8231",19810,12359,12196,244,163,"ERC-RI.cat",746
8,"8901",249,180,180,2,0,"ERC-RI.cat",37
43,"43111",2096,1305,1281,19,24,"ERC-RI.cat",89
8,"8058",1699,1089,1061,25,28,"ERC-RI.cat",70
8,"8149",985,683,671,11,12,"ERC-RI.cat",161
8,"8196",18989,12658,12490,253,168,"ERC-RI.cat",417
8,"8076",15925,10435,10242,179,193,"ERC-RI.cat",657
17,"17144",217,145,143,4,2,"ERC-RI.cat",23
8,"8147",17023,11177,10961,184,216,"ERC-RI.cat",708
8,"8250",7083,4485,4426,72,59,"ERC-RI.cat",168
17,"17902",1330,898,874,11,24,"ERC-RI.cat",106
8,"8211",32035,23059,22687,453,372,"ERC-RI.cat",1019
17,"17147",8385,5401,5325,105,76,"ERC-RI.cat",945
43,"43038",20710,12999,12771,224,228,"ERC-RI.cat",632
17,"17114",22610,14079,13811,263,268,"ERC-RI.cat",1702
43,"43122",92,65,61,0,4,"ERC-RI.cat",4
8,"8041",10032,6880,6761,112,119,"ERC-RI.cat",199
8,"8091",5106,3379,3312,59,67,"ERC-RI.cat",294
43,"43097",379,283,278,6,5,"ERC-RI.cat",31
43,"43023",244,179,177,8,2,"ERC-RI.cat",13
43,"43165",624,471,459,6,12,"ERC-RI.cat",54
8,"8131",696,483,469,7,14,"ERC-RI.cat",67
43,"43079",387,259,255,26,4,"ERC-RI.cat",21
17,"17150",1428,1018,996,24,22,"ERC-RI.cat",113
8,"8044",4247,2763,2712,50,51,"ERC-RI.cat",275
43,"43149",711,529,516,13,13,"ERC-RI.cat",27
43,"43063",588,358,350,13,8,"ERC-RI.cat",40
17,"17205",198,146,138,3,8,"ERC-RI.cat",19
8,"8278",4668,3033,2949,67,84,"ERC-RI.cat",509
43,"43128",927,636,625,11,11,"ERC-RI.cat",68
8,"8028",1049,667,657,15,10,"ERC-RI.cat",51
17,"17092",3520,2273,2228,42,45,"ERC-RI.cat",233
17,"17185",2273,1416,1379,32,37,"ERC-RI.cat",166
17,"17090",548,412,404,7,8,"ERC-RI.cat",50
8,"8306",509,330,324,6,6,"ERC-RI.cat",15
17,"17004",504,340,337,6,3,"ERC-RI.cat",31
17,"17054",395,250,247,3,3,"ERC-RI.cat",30
8,"8171",2158,1385,1359,27,26,"ERC-RI.cat",307
17,"17028",327,220,217,4,3,"ERC-RI.cat",27
8,"8188",106,87,86,4,1,"ERC-RI.cat",19
17,"17155",14284,8528,8391,143,137,"ERC-RI.cat",661
8,"8125",24559,16065,15798,293,267,"ERC-RI.cat",658
17,"17159",639,408,397,3,11,"ERC-RI.cat",52
43,"43140",2393,1612,1583,23,29,"ERC-RI.cat",105
17,"17187",574,414,402,1,12,"ERC-RI.cat",54
17,"17152",10378,6239,6156,100,83,"ERC-RI.cat",410
43,"43039",117,85,83,3,2,"ERC-RI.cat",19
8,"8106",6858,4675,4559,113,116,"ERC-RI.cat",445
8,"8133",157,100,97,2,3,"ERC-RI.cat",6
17,"17217",347,267,251,5,16,"ERC-RI.cat",50
8,"8090",120,86,86,2,0,"ERC-RI.cat",10
43,"43105",175,119,116,14,3,"ERC-RI.cat",17
17,"17901",964,628,621,16,7,"ERC-RI.cat",92
17,"17174",183,120,117,5,3,"ERC-RI.cat",22
8,"8302",9271,5981,5892,82,89,"ERC-RI.cat",204
8,"8163",17986,11683,11548,159,135,"ERC-RI.cat",604
8,"8139",184,130,128,1,2,"ERC-RI.cat",19
43,"43127",778,530,524,6,6,"ERC-RI.cat",49
17,"17194",93,55,55,1,0,"ERC-RI.cat",16
8,"8068",6554,4323,4255,87,68,"ERC-RI.cat",243
8,"8198",4112,2766,2661,49,105,"ERC-RI.cat",284
43,"43047",4064,2412,2352,50,60,"ERC-RI.cat",195
8,"8205",54870,41064,40491,682,573,"ERC-RI.cat",3192
17,"17033",5157,3142,3095,44,47,"ERC-RI.cat",317
17,"17049",3056,1986,1944,43,42,"ERC-RI.cat",278
8,"8105",9642,6571,6483,110,88,"ERC-RI.cat",125
8,"8260",17869,11898,11686,215,212,"ERC-RI.cat",484
43,"43018",430,350,337,7,13,"ERC-RI.cat",78
17,"17203",171,97,94,3,3,"ERC-RI.cat",10
8,"8279",149233,101676,100363,1965,1313,"ERC-RI.cat",5497
8,"8214",6754,4659,4555,83,104,"ERC-RI.cat",434
8,"8115",3870,2693,2644,60,49,"ERC-RI.cat",147
8,"8286",2865,1843,1796,30,47,"ERC-RI.cat",89
17,"17232",159,107,104,0,3,"ERC-RI.cat",21
43,"43040",350,251,246,18,5,"ERC-RI.cat",53
17,"17123",365,274,266,8,8,"ERC-RI.cat",27
8,"8093",32,21,20,0,1,"ERC-RI.cat",8
8,"8046",12603,8826,8663,190,163,"ERC-RI.cat",822
8,"8270",17464,11828,11677,212,151,"ERC-RI.cat",768
8,"8215",2594,1763,1728,51,35,"ERC-RI.cat",202
43,"43027",177,129,128,6,1,"ERC-RI.cat",14
8,"8095",75,56,55,1,1,"ERC-RI.cat",4
8,"8265",1575,1065,1026,38,39,"ERC-RI.cat",165
43,"43119",739,500,496,5,4,"ERC-RI.cat",40
8,"8299",444,277,267,5,10,"ERC-RI.cat",29
8,"8258",845,577,555,23,22,"ERC-RI.cat",154
17,"17010",327,216,214,6,2,"ERC-RI.cat",51
8,"8290",1446,1075,1056,12,19,"ERC-RI.cat",175
43,"43071",975,677,664,14,13,"ERC-RI.cat",46
17,"17170",192,135,134,1,1,"ERC-RI.cat",41
43,"43114",383,238,234,6,4,"ERC-RI.cat",57
17,"17064",341,253,250,4,3,"ERC-RI.cat",23
8,"8122",1755,1063,1034,17,29,"ERC-RI.cat",99
43,"43173",114,65,64,0,1,"ERC-RI.cat",20
17,"17133",1336,889,866,14,23,"ERC-RI.cat",103
8,"8166",1138,726,706,10,20,"ERC-RI.cat",55
43,"43092",7051,4294,4220,45,74,"ERC-RI.cat",243
43,"43035",280,202,198,0,4,"ERC-RI.cat",16
43,"43116",494,328,325,5,3,"ERC-RI.cat",37
43,"43033",772,547,533,4,14,"ERC-RI.cat",52
17,"17191",153,116,114,0,2,"ERC-RI.cat",10
8,"8075",3906,2442,2414,31,28,"ERC-RI.cat",145
17,"17042",415,297,292,2,5,"ERC-RI.cat",21
17,"17094",1161,694,683,11,11,"ERC-RI.cat",53
17,"17005",404,258,254,12,4,"ERC-RI.cat",19
8,"8085",1033,731,720,10,11,"ERC-RI.cat",68
43,"43106",878,600,592,17,8,"ERC-RI.cat",83
8,"8208",5471,3859,3792,82,67,"ERC-RI.cat",251
17,"17102",571,354,350,7,4,"ERC-RI.cat",39
8,"8064",1847,1277,1246,14,31,"ERC-RI.cat",173
17,"17110",1359,930,917,12,13,"ERC-RI.cat",86
43,"43010",302,227,223,7,4,"ERC-RI.cat",17
43,"43162",4143,2892,2833,59,59,"ERC-RI.cat",169
8,"8072",9910,6326,6235,140,91,"ERC-RI.cat",400
8,"8177",52,31,31,1,0,"ERC-RI.cat",3
17,"17062",5994,3686,3614,69,72,"ERC-RI.cat",302
43,"43134",279,208,206,14,2,"ERC-RI.cat",10
8,"8296",1683,1227,1203,29,24,"ERC-RI.cat",99
25,"25208",294,174,170,3,4,"ERC - RI.cat / ESQUERRA",22
25,"25905",386,264,258,12,6,"ERC - RI.cat / ESQUERRA",12
25,"25155",714,490,485,8,5,"ERC - RI.cat / ESQUERRA",48
25,"25021",2693,1632,1605,40,27,"ERC - RI.cat / ESQUERRA",144
25,"25031",57,34,34,1,0,"ERC - RI.cat / ESQUERRA",0
25,"25118",378,232,226,4,6,"ERC - RI.cat / ESQUERRA",16
25,"25172",1838,1267,1230,35,37,"ERC - RI.cat / ESQUERRA",172
25,"25008",1187,834,818,15,16,"ERC - RI.cat / ESQUERRA",59
25,"25254",782,533,531,9,2,"ERC - RI.cat / ESQUERRA",36
25,"25141",171,111,107,2,4,"ERC - RI.cat / ESQUERRA",14
25,"25175",221,151,150,0,1,"ERC - RI.cat / ESQUERRA",8
25,"25037",396,275,273,9,2,"ERC - RI.cat / ESQUERRA",28
25,"25216",250,175,173,5,2,"ERC - RI.cat / ESQUERRA",21
25,"25907",506,297,292,6,5,"ERC - RI.cat / ESQUERRA",43
25,"25049",166,105,102,1,3,"ERC - RI.cat / ESQUERRA",14
25,"25043",830,483,467,17,16,"ERC - RI.cat / ESQUERRA",64
25,"25058",4390,2696,2650,57,46,"ERC - RI.cat / ESQUERRA",387
25,"25132",128,87,85,3,2,"ERC - RI.cat / ESQUERRA",10
25,"25234",4572,2707,2648,57,59,"ERC - RI.cat / ESQUERRA",270
25,"25247",142,80,78,3,2,"ERC - RI.cat / ESQUERRA",3
25,"25145",88,67,67,2,0,"ERC - RI.cat / ESQUERRA",10
25,"25913",100,78,78,0,0,"ERC - RI.cat / ESQUERRA",15
25,"25154",126,77,77,2,0,"ERC - RI.cat / ESQUERRA",7
25,"25001",146,76,76,1,0,"ERC - RI.cat / ESQUERRA",5
25,"25211",701,378,368,5,10,"ERC - RI.cat / ESQUERRA",37
25,"25061",75,45,45,0,0,"ERC - RI.cat / ESQUERRA",2
25,"25126",286,192,189,7,3,"ERC - RI.cat / ESQUERRA",12
25,"25231",515,402,395,4,7,"ERC - RI.cat / ESQUERRA",40
25,"25052",1611,1094,1062,21,32,"ERC - RI.cat / ESQUERRA",164
25,"25072",5921,3743,3637,81,106,"ERC - RI.cat / ESQUERRA",313
25,"25210",1164,799,789,13,10,"ERC - RI.cat / ESQUERRA",70
25,"25011",5241,3127,3080,48,47,"ERC - RI.cat / ESQUERRA",325
25,"25101",583,391,382,8,9,"ERC - RI.cat / ESQUERRA",55
25,"25250",358,237,234,4,3,"ERC - RI.cat / ESQUERRA",42
25,"25190",271,180,176,12,4,"ERC - RI.cat / ESQUERRA",31
25,"25205",563,373,362,12,11,"ERC - RI.cat / ESQUERRA",29
25,"25089",107,66,64,0,2,"ERC - RI.cat / ESQUERRA",12
25,"25227",674,375,372,2,3,"ERC - RI.cat / ESQUERRA",34
25,"25129",175,105,105,3,0,"ERC - RI.cat / ESQUERRA",22
25,"25007",1363,902,885,36,17,"ERC - RI.cat / ESQUERRA",45
25,"25177",379,240,236,2,4,"ERC - RI.cat / ESQUERRA",35
25,"25127",226,134,130,2,4,"ERC - RI.cat / ESQUERRA",22
25,"25051",1710,1060,1044,23,16,"ERC - RI.cat / ESQUERRA",129
25,"25243",3408,2280,2252,49,28,"ERC - RI.cat / ESQUERRA",57
25,"25098",266,177,177,0,0,"ERC - RI.cat / ESQUERRA",16
25,"25193",771,509,501,8,8,"ERC - RI.cat / ESQUERRA",75
25,"25181",189,128,123,3,5,"ERC - RI.cat / ESQUERRA",8
25,"25139",549,358,357,5,1,"ERC - RI.cat / ESQUERRA",59
25,"25180",245,167,165,3,2,"ERC - RI.cat / ESQUERRA",11
25,"25067",768,498,494,14,4,"ERC - RI.cat / ESQUERRA",37
25,"25111",116,70,70,0,0,"ERC - RI.cat / ESQUERRA",9
25,"25183",485,336,327,6,9,"ERC - RI.cat / ESQUERRA",25
25,"25046",438,299,286,6,13,"ERC - RI.cat / ESQUERRA",35
25,"25163",237,147,142,2,5,"ERC - RI.cat / ESQUERRA",15
25,"25027",1042,691,665,11,26,"ERC - RI.cat / ESQUERRA",95
25,"25017",248,160,159,1,1,"ERC - RI.cat / ESQUERRA",16
25,"25176",341,243,240,7,3,"ERC - RI.cat / ESQUERRA",18
25,"25134",657,421,416,4,5,"ERC - RI.cat / ESQUERRA",34
25,"25055",187,115,115,3,0,"ERC - RI.cat / ESQUERRA",12
25,"25223",951,562,546,14,16,"ERC - RI.cat / ESQUERRA",67
25,"25103",125,82,80,4,2,"ERC - RI.cat / ESQUERRA",1
25,"25186",231,168,168,3,0,"ERC - RI.cat / ESQUERRA",39
25,"25030",147,101,95,3,6,"ERC - RI.cat / ESQUERRA",13
25,"25909",141,82,78,0,4,"ERC - RI.cat / ESQUERRA",8
25,"25906",235,160,154,3,6,"ERC - RI.cat / ESQUERRA",14
25,"25150",185,119,113,4,6,"ERC - RI.cat / ESQUERRA",18
25,"25201",119,78,76,3,2,"ERC - RI.cat / ESQUERRA",10
25,"25078",1014,730,719,17,11,"ERC - RI.cat / ESQUERRA",64
25,"25109",279,183,183,2,0,"ERC - RI.cat / ESQUERRA",20
25,"25135",1077,739,722,18,17,"ERC - RI.cat / ESQUERRA",57
25,"25240",1398,976,958,17,18,"ERC - RI.cat / ESQUERRA",84
25,"25903",261,176,170,9,6,"ERC - RI.cat / ESQUERRA",21
25,"25023",4446,3079,3020,70,59,"ERC - RI.cat / ESQUERRA",177
25,"25203",8995,5418,5309,116,109,"ERC - RI.cat / ESQUERRA",420
25,"25040",10654,6905,6768,144,137,"ERC - RI.cat / ESQUERRA",505
25,"25069",471,291,289,9,2,"ERC - RI.cat / ESQUERRA",36
25,"25255",468,318,309,9,9,"ERC - RI.cat / ESQUERRA",34
25,"25221",125,76,76,0,0,"ERC - RI.cat / ESQUERRA",4
25,"25064",122,91,88,7,3,"ERC - RI.cat / ESQUERRA",12
25,"25124",161,110,109,4,1,"ERC - RI.cat / ESQUERRA",15
25,"25016",2203,1375,1357,20,18,"ERC - RI.cat / ESQUERRA",147
25,"25157",183,128,128,4,0,"ERC - RI.cat / ESQUERRA",13
25,"25120",90759,58761,57778,1325,983,"ERC - RI.cat / ESQUERRA",3030
25,"25137",8404,5264,5167,112,97,"ERC - RI.cat / ESQUERRA",380
25,"25148",232,144,144,5,0,"ERC - RI.cat / ESQUERRA",25
25,"25197",158,102,101,2,1,"ERC - RI.cat / ESQUERRA",18
25,"25166",177,127,125,3,2,"ERC - RI.cat / ESQUERRA",37
25,"25908",250,169,168,4,1,"ERC - RI.cat / ESQUERRA",33
25,"25130",208,117,112,4,5,"ERC - RI.cat / ESQUERRA",5
25,"25047",1048,760,748,24,12,"ERC - RI.cat / ESQUERRA",94
25,"25076",165,84,83,3,1,"ERC - RI.cat / ESQUERRA",9
25,"25191",353,234,227,5,7,"ERC - RI.cat / ESQUERRA",29
25,"25102",733,478,464,15,14,"ERC - RI.cat / ESQUERRA",17
25,"25014",264,170,164,11,6,"ERC - RI.cat / ESQUERRA",29
25,"25094",154,110,107,1,3,"ERC - RI.cat / ESQUERRA",9
25,"25238",231,158,156,1,2,"ERC - RI.cat / ESQUERRA",15
25,"25233",270,207,201,3,6,"ERC - RI.cat / ESQUERRA",11
25,"25173",1784,1177,1139,20,38,"ERC - RI.cat / ESQUERRA",55
25,"25220",1076,711,702,10,9,"ERC - RI.cat / ESQUERRA",86
25,"25038",1606,1104,1093,19,11,"ERC - RI.cat / ESQUERRA",91
25,"25042",211,131,127,0,4,"ERC - RI.cat / ESQUERRA",14
25,"25063",97,65,64,2,1,"ERC - RI.cat / ESQUERRA",0
25,"25156",761,535,529,15,6,"ERC - RI.cat / ESQUERRA",49
25,"25131",439,319,314,6,5,"ERC - RI.cat / ESQUERRA",19
25,"25097",102,70,69,3,1,"ERC - RI.cat / ESQUERRA",25
25,"25086",569,379,370,4,9,"ERC - RI.cat / ESQUERRA",74
25,"25168",510,385,378,19,7,"ERC - RI.cat / ESQUERRA",28
25,"25036",190,138,134,5,4,"ERC - RI.cat / ESQUERRA",8
25,"25115",878,542,542,17,0,"ERC - RI.cat / ESQUERRA",54
25,"25112",286,202,199,11,3,"ERC - RI.cat / ESQUERRA",22
25,"25048",1684,1120,1095,29,25,"ERC - RI.cat / ESQUERRA",107
25,"25113",1227,869,856,28,13,"ERC - RI.cat / ESQUERRA",110
25,"25239",627,310,310,7,0,"ERC - RI.cat / ESQUERRA",42
25,"25158",1647,1154,1135,27,19,"ERC - RI.cat / ESQUERRA",120
25,"25140",785,472,460,5,12,"ERC - RI.cat / ESQUERRA",54
25,"25174",438,289,283,4,6,"ERC - RI.cat / ESQUERRA",15
25,"25142",387,265,264,5,1,"ERC - RI.cat / ESQUERRA",47
25,"25161",361,222,218,1,4,"ERC - RI.cat / ESQUERRA",33
25,"25009",690,479,471,9,8,"ERC - RI.cat / ESQUERRA",57
25,"25253",175,132,129,1,3,"ERC - RI.cat / ESQUERRA",11
25,"25045",51,33,33,2,0,"ERC - RI.cat / ESQUERRA",1
25,"25138",605,440,428,13,12,"ERC - RI.cat / ESQUERRA",86
25,"25912",899,643,640,6,3,"ERC - RI.cat / ESQUERRA",19
25,"25228",2907,2043,2021,43,22,"ERC - RI.cat / ESQUERRA",122
25,"25015",394,264,264,14,0,"ERC - RI.cat / ESQUERRA",24
25,"25002",481,306,302,6,4,"ERC - RI.cat / ESQUERRA",52
25,"25151",641,451,444,20,7,"ERC - RI.cat / ESQUERRA",69
25,"25059",796,580,575,9,5,"ERC - RI.cat / ESQUERRA",11
25,"25182",1075,749,731,30,18,"ERC - RI.cat / ESQUERRA",69
25,"25252",536,361,352,13,9,"ERC - RI.cat / ESQUERRA",25
25,"25092",135,100,97,2,3,"ERC - RI.cat / ESQUERRA",18
25,"25039",299,189,186,7,3,"ERC - RI.cat / ESQUERRA",17
25,"25149",1401,1031,1010,17,21,"ERC - RI.cat / ESQUERRA",74
25,"25088",100,74,74,0,0,"ERC - RI.cat / ESQUERRA",3
25,"25020",328,216,209,4,7,"ERC - RI.cat / ESQUERRA",16
25,"25153",215,165,161,0,4,"ERC - RI.cat / ESQUERRA",17
25,"25226",257,162,158,5,4,"ERC - RI.cat / ESQUERRA",8
25,"25071",56,37,35,2,2,"ERC - RI.cat / ESQUERRA",5
25,"25050",3249,2056,1988,40,68,"ERC - RI.cat / ESQUERRA",266
25,"25019",4626,2971,2932,54,39,"ERC - RI.cat / ESQUERRA",155
25,"25074",178,137,132,3,5,"ERC - RI.cat / ESQUERRA",18
25,"25114",102,82,78,4,4,"ERC - RI.cat / ESQUERRA",10
25,"25005",291,194,190,7,4,"ERC - RI.cat / ESQUERRA",12
25,"25204",1313,888,881,21,7,"ERC - RI.cat / ESQUERRA",109
25,"25179",198,141,136,1,5,"ERC - RI.cat / ESQUERRA",14
25,"25189",2085,1348,1327,38,21,"ERC - RI.cat / ESQUERRA",102
25,"25196",127,87,86,3,1,"ERC - RI.cat / ESQUERRA",2
25,"25910",118,77,76,3,1,"ERC - RI.cat / ESQUERRA",15
25,"25164",404,270,264,5,6,"ERC - RI.cat / ESQUERRA",26
25,"25079",307,242,240,7,2,"ERC - RI.cat / ESQUERRA",42
25,"25081",332,212,206,6,6,"ERC - RI.cat / ESQUERRA",18
25,"25123",206,140,136,4,4,"ERC - RI.cat / ESQUERRA",31
25,"25242",787,501,490,11,11,"ERC - RI.cat / ESQUERRA",55
25,"25185",690,409,404,8,5,"ERC - RI.cat / ESQUERRA",36
25,"25217",10570,6660,6500,191,160,"ERC - RI.cat / ESQUERRA",717
25,"25911",472,306,296,2,10,"ERC - RI.cat / ESQUERRA",37
25,"25110",2662,1649,1602,44,47,"ERC - RI.cat / ESQUERRA",191
25,"25128",151,83,81,1,2,"ERC - RI.cat / ESQUERRA",4
25,"25032",71,44,42,1,2,"ERC - RI.cat / ESQUERRA",13
25,"25075",122,85,83,0,2,"ERC - RI.cat / ESQUERRA",16
25,"25022",119,83,83,0,0,"ERC - RI.cat / ESQUERRA",10
25,"25010",206,119,118,7,1,"ERC - RI.cat / ESQUERRA",19
25,"25245",445,312,306,4,6,"ERC - RI.cat / ESQUERRA",20
25,"25105",146,90,89,1,1,"ERC - RI.cat / ESQUERRA",12
25,"25251",670,476,473,1,3,"ERC - RI.cat / ESQUERRA",30
25,"25077",474,281,277,5,4,"ERC - RI.cat / ESQUERRA",23
25,"25152",160,92,90,4,2,"ERC - RI.cat / ESQUERRA",10
25,"25003",3853,2367,2340,68,27,"ERC - RI.cat / ESQUERRA",306
25,"25004",553,405,400,13,5,"ERC - RI.cat / ESQUERRA",32
25,"25093",657,465,455,8,10,"ERC - RI.cat / ESQUERRA",38
25,"25121",623,406,400,6,6,"ERC - RI.cat / ESQUERRA",11
25,"25100",207,125,115,2,10,"ERC - RI.cat / ESQUERRA",17
25,"25230",1665,1164,1140,36,24,"ERC - RI.cat / ESQUERRA",79
25,"25057",198,140,136,2,4,"ERC - RI.cat / ESQUERRA",4
25,"25096",988,633,613,12,20,"ERC - RI.cat / ESQUERRA",43
25,"25219",144,90,86,0,4,"ERC - RI.cat / ESQUERRA",11
25,"25013",2274,1344,1321,25,23,"ERC - RI.cat / ESQUERRA",67
25,"25143",86,58,58,1,0,"ERC - RI.cat / ESQUERRA",6
25,"25209",1558,1041,1009,22,32,"ERC - RI.cat / ESQUERRA",92
25,"25206",289,187,184,3,3,"ERC - RI.cat / ESQUERRA",20
25,"25165",301,202,198,6,4,"ERC - RI.cat / ESQUERRA",18
25,"25248",926,615,601,17,14,"ERC - RI.cat / ESQUERRA",93
25,"25232",1480,968,959,38,9,"ERC - RI.cat / ESQUERRA",62
25,"25146",227,150,149,0,1,"ERC - RI.cat / ESQUERRA",32
25,"25068",576,376,364,6,12,"ERC - RI.cat / ESQUERRA",29
25,"25222",69,55,54,0,1,"ERC - RI.cat / ESQUERRA",7
25,"25122",1956,1281,1256,33,25,"ERC - RI.cat / ESQUERRA",158
25,"25104",128,88,86,11,2,"ERC - RI.cat / ESQUERRA",3
25,"25034",2471,1622,1592,25,30,"ERC - RI.cat / ESQUERRA",280
25,"25218",94,75,73,1,2,"ERC - RI.cat / ESQUERRA",16
25,"25200",353,225,217,4,8,"ERC - RI.cat / ESQUERRA",27
25,"25171",2305,1496,1469,37,27,"ERC - RI.cat / ESQUERRA",195
25,"25133",748,499,483,7,16,"ERC - RI.cat / ESQUERRA",30
25,"25224",144,93,91,6,2,"ERC - RI.cat / ESQUERRA",3
25,"25060",92,53,52,1,1,"ERC - RI.cat / ESQUERRA",7
25,"25025",1307,874,859,32,15,"ERC - RI.cat / ESQUERRA",20
25,"25192",799,543,527,19,16,"ERC - RI.cat / ESQUERRA",67
25,"25202",110,62,59,3,3,"ERC - RI.cat / ESQUERRA",13
25,"25033",1125,738,718,17,20,"ERC - RI.cat / ESQUERRA",67
25,"25070",888,594,582,18,12,"ERC - RI.cat / ESQUERRA",73
25,"25085",153,103,100,2,3,"ERC - RI.cat / ESQUERRA",10
25,"25902",581,411,395,15,16,"ERC - RI.cat / ESQUERRA",50
25,"25170",271,197,196,4,1,"ERC - RI.cat / ESQUERRA",11
25,"25082",265,156,155,8,1,"ERC - RI.cat / ESQUERRA",16
25,"25099",1185,720,709,9,11,"ERC - RI.cat / ESQUERRA",58
25,"25212",233,185,185,8,0,"ERC - RI.cat / ESQUERRA",8
25,"25207",6253,3938,3872,91,66,"ERC - RI.cat / ESQUERRA",709
25,"25225",603,395,387,7,8,"ERC - RI.cat / ESQUERRA",75
25,"25029",1766,1145,1118,38,27,"ERC - RI.cat / ESQUERRA",125
25,"25169",201,134,134,6,0,"ERC - RI.cat / ESQUERRA",22
25,"25136",106,79,79,1,0,"ERC - RI.cat / ESQUERRA",9
25,"25125",450,297,289,10,8,"ERC - RI.cat / ESQUERRA",40
25,"25062",806,515,497,11,18,"ERC - RI.cat / ESQUERRA",57
25,"25053",1085,733,727,10,6,"ERC - RI.cat / ESQUERRA",52
25,"25041",625,432,420,20,12,"ERC - RI.cat / ESQUERRA",50
25,"25073",662,382,379,11,3,"ERC - RI.cat / ESQUERRA",42
25,"25035",428,289,284,5,5,"ERC - RI.cat / ESQUERRA",17
25,"25056",289,168,163,3,5,"ERC - RI.cat / ESQUERRA",22
25,"25087",65,41,39,0,2,"ERC - RI.cat / ESQUERRA",15
25,"25244",350,270,268,9,2,"ERC - RI.cat / ESQUERRA",13
25,"25215",399,229,226,4,3,"ERC - RI.cat / ESQUERRA",24
25,"25901",315,196,189,3,7,"ERC - RI.cat / ESQUERRA",24
25,"25194",440,292,283,11,9,"ERC - RI.cat / ESQUERRA",18
25,"25904",149,107,104,1,3,"ERC - RI.cat / ESQUERRA",9
25,"25006",362,231,228,2,3,"ERC - RI.cat / ESQUERRA",22
25,"25024",370,221,217,8,4,"ERC - RI.cat / ESQUERRA",31
25,"25249",207,151,150,4,1,"ERC - RI.cat / ESQUERRA",34
25,"25044",195,136,134,1,2,"ERC - RI.cat / ESQUERRA",13
25,"25167",253,176,172,0,4,"ERC - RI.cat / ESQUERRA",34
25,"25012",2204,1432,1406,29,26,"ERC - RI.cat / ESQUERRA",123
25,"25119",2297,1554,1513,46,41,"ERC - RI.cat / ESQUERRA",168
46,"46191",1952,1554,1528,9,26,"ERPV",1
12,"12095",1027,790,775,15,15,"ERPV",2
46,"46223",7685,6040,5996,62,44,"ERPV",12
3,"3904",1416,1104,1096,11,8,"ERPV",1
46,"46118",3883,3141,3105,28,36,"ERPV",8
46,"46152",96,70,70,0,0,"ERPV",0
46,"46182",1190,864,855,11,9,"ERPV",6
12,"12133",64,47,47,0,0,"ERPV",0
3,"3099",41561,32556,32248,288,308,"ERPV",28
3,"3010",330,269,266,3,3,"ERPV",2
3,"3096",5863,4550,4457,57,93,"ERPV",26
3,"3035",672,560,550,0,10,"ERPV",7
46,"46215",1451,1185,1169,8,16,"ERPV",3
46,"46047",551,479,469,10,10,"ERPV",1
46,"46039",2200,1849,1820,12,29,"ERPV",1
12,"12112",104,90,90,0,0,"ERPV",0
46,"46117",476,377,373,6,4,"ERPV",0
3,"3102",7346,5827,5751,39,76,"ERPV",36
3,"3032",112,90,88,0,2,"ERPV",0
46,"46044",4301,3284,3169,50,115,"ERPV",2
46,"46180",715,585,581,4,4,"ERPV",2
46,"46158",1037,829,822,9,7,"ERPV",0
3,"3076",8373,6319,6222,68,97,"ERPV",7
46,"46263",333,243,241,2,2,"ERPV",0
12,"12002",135,101,100,1,1,"ERPV",4
12,"12012",2747,2196,2135,24,61,"ERPV",3
3,"3009",47547,35945,35298,603,647,"ERPV",166
46,"46107",1998,1650,1623,8,27,"ERPV",3
46,"46154",836,684,678,7,6,"ERPV",1
3,"3027",150,131,130,1,1,"ERPV",1
12,"12101",385,309,296,3,13,"ERPV",6
12,"12120",218,180,177,0,3,"ERPV",0
46,"46150",1898,1555,1541,8,14,"ERPV",4
12,"12102",547,474,466,2,8,"ERPV",2
12,"12001",1098,821,817,8,4,"ERPV",8
3,"3093",19646,15399,15159,173,240,"ERPV",31
46,"46903",5210,4037,4000,40,37,"ERPV",2
12,"12017",183,143,141,6,2,"ERPV",0
46,"46193",8494,6662,6580,73,82,"ERPV",29
46,"46139",4594,3794,3734,28,60,"ERPV",7
12,"12053",2121,1745,1719,11,26,"ERPV",5
46,"46083",15427,12079,11941,109,138,"ERPV",35
46,"46132",2124,1845,1817,14,28,"ERPV",3
3,"3021",5594,4630,4517,46,113,"ERPV",11
12,"12094",807,612,604,14,8,"ERPV",4
12,"12106",1207,992,969,7,23,"ERPV",2
12,"12058",99,74,74,0,0,"ERPV",0
46,"46131",49087,37846,37477,422,369,"ERPV",85
3,"3105",5322,4218,4124,34,94,"ERPV",15
12,"12031",3748,2751,2687,35,64,"ERPV",8
46,"46258",2792,2196,2164,14,32,"ERPV",1
3,"3902",9578,7085,7007,65,78,"ERPV",12
46,"46253",118,105,102,7,3,"ERPV",0
12,"12067",563,458,439,8,19,"ERPV",2
46,"46160",1976,1591,1570,21,21,"ERPV",9
46,"46061",331,276,273,3,3,"ERPV",1
46,"46156",2065,1746,1721,14,25,"ERPV",5
3,"3023",1425,1259,1233,11,26,"ERPV",8
12,"12105",866,679,673,6,6,"ERPV",2
46,"46199",5661,4328,4280,38,48,"ERPV",9
46,"46077",7637,5979,5845,64,134,"ERPV",10
12,"12056",304,259,254,7,5,"ERPV",0
3,"3091",256,220,219,1,1,"ERPV",0
46,"46025",2495,1962,1941,24,21,"ERPV",2
3,"3079",18028,14580,14317,189,263,"ERPV",37
12,"12109",700,564,555,7,9,"ERPV",1
12,"12068",57,45,44,0,1,"ERPV",0
46,"46074",2656,2071,2053,22,18,"ERPV",7
3,"3078",528,424,423,2,1,"ERPV",1
46,"46140",379,314,313,0,1,"ERPV",1
12,"12119",153,87,87,0,0,"ERPV",0
46,"46045",1288,1065,1044,2,21,"ERPV",11
3,"3040",260,224,220,0,4,"ERPV",1
46,"46012",930,698,684,9,14,"ERPV",1
46,"46236",996,853,844,7,9,"ERPV",2
46,"46142",870,682,673,7,9,"ERPV",2
46,"46204",6906,5426,5357,62,69,"ERPV",11
46,"46245",478,357,354,1,3,"ERPV",0
46,"46109",6143,4731,4637,40,94,"ERPV",4
46,"46174",1003,854,847,6,7,"ERPV",4
3,"3073",219,199,199,0,0,"ERPV",0
3,"3083",5708,4267,4196,66,71,"ERPV",140
3,"3005",7482,6191,6146,49,45,"ERPV",1
46,"46052",532,471,463,2,8,"ERPV",3
12,"12089",4277,3009,2946,32,63,"ERPV",20
3,"3065",164772,124457,123236,1556,1221,"ERPV",258
46,"46187",1339,1096,1083,13,13,"ERPV",5
12,"12139",344,219,216,0,3,"ERPV",7
46,"46087",137,105,105,1,0,"ERPV",0
46,"46090",1668,1488,1452,9,36,"ERPV",4
46,"46106",1616,1196,1188,6,8,"ERPV",0
46,"46123",1808,1440,1410,7,30,"ERPV",7
3,"3013",1144,941,926,5,15,"ERPV",0
46,"46079",381,304,299,3,5,"ERPV",1
12,"12091",203,153,140,2,13,"ERPV",0
46,"46164",11634,8843,8724,90,119,"ERPV",9
46,"46101",868,720,716,8,4,"ERPV",1
12,"12122",835,674,658,14,16,"ERPV",10
46,"46231",2496,1831,1817,16,14,"ERPV",100
12,"12115",234,184,183,2,1,"ERPV",1
12,"12070",576,473,463,5,10,"ERPV",0
46,"46023",318,275,267,2,8,"ERPV",2
12,"12020",131,109,107,1,2,"ERPV",0
46,"46260",2576,2140,2106,24,34,"ERPV",3
46,"46233",3911,3025,2988,10,37,"ERPV",8
12,"12098",665,552,539,9,13,"ERPV",2
12,"12043",620,499,487,2,12,"ERPV",0
3,"3016",91,67,66,1,1,"ERPV",1
46,"46028",424,352,347,5,5,"ERPV",2
46,"46069",166,149,148,1,1,"ERPV",0
46,"46126",5471,4454,4392,53,62,"ERPV",10
12,"12024",146,129,128,1,1,"ERPV",1
46,"46128",1649,1322,1292,14,30,"ERPV",6
46,"46225",360,319,310,5,9,"ERPV",3
3,"3054",371,321,315,2,6,"ERPV",2
46,"46247",1059,829,823,6,6,"ERPV",2
46,"46114",565,501,495,3,6,"ERPV",0
46,"46017",32928,24879,24672,267,207,"ERPV",73
46,"46250",574266,435877,431619,4626,4258,"ERPV",886
3,"3084",593,518,513,2,5,"ERPV",3
46,"46033",220,183,181,0,2,"ERPV",0
3,"3014",234288,168004,166418,1795,1586,"ERPV",288
46,"46212",1598,1233,1218,5,15,"ERPV",3
3,"3003",460,382,370,1,12,"ERPV",2
46,"46042",3376,2873,2819,17,54,"ERPV",6
12,"12081",654,519,515,2,4,"ERPV",1
12,"12083",106,89,88,0,1,"ERPV",0
12,"12015",96,83,82,3,1,"ERPV",0
12,"12039",870,743,736,4,7,"ERPV",0
12,"12036",668,529,514,6,15,"ERPV",5
46,"46136",2476,1890,1865,16,25,"ERPV",2
3,"3121",20518,14464,14315,137,149,"ERPV",16
12,"12071",1355,1069,1050,3,19,"ERPV",2
46,"46095",632,505,495,1,10,"ERPV",2
12,"12129",1936,1372,1326,29,46,"ERPV",14
12,"12046",236,177,176,4,1,"ERPV",1
46,"46055",1286,1083,1067,11,16,"ERPV",4
12,"12073",168,135,135,1,0,"ERPV",0
46,"46063",1764,1441,1423,15,18,"ERPV",6
3,"3050",17818,12860,12706,160,154,"ERPV",44
3,"3046",1530,1136,1121,11,15,"ERPV",2
46,"46200",1915,1625,1595,15,30,"ERPV",9
46,"46157",3068,2523,2491,17,32,"ERPV",7
3,"3007",160,131,127,0,4,"ERPV",1
46,"46082",4661,3447,3401,46,46,"ERPV",11
3,"3125",340,276,275,2,1,"ERPV",0
3,"3048",4747,3878,3817,16,61,"ERPV",13
46,"46091",126,108,108,0,0,"ERPV",1
12,"12118",83,63,62,0,1,"ERPV",0
3,"3130",43,30,29,0,1,"ERPV",2
3,"3111",5244,4184,4146,39,38,"ERPV",0
3,"3138",3218,2403,2388,22,15,"ERPV",10
46,"46224",179,131,128,0,3,"ERPV",0
3,"3137",719,536,530,3,6,"ERPV",11
46,"46066",1264,1060,1050,5,10,"ERPV",2
46,"46163",1811,1487,1463,12,24,"ERPV",13
3,"3086",145,119,118,1,1,"ERPV",4
46,"46244",57805,41885,41595,415,290,"ERPV",72
46,"46904",782,659,650,6,9,"ERPV",2
3,"3053",7082,5754,5664,60,90,"ERPV",34
46,"46222",378,321,310,1,11,"ERPV",1
3,"3051",356,314,311,2,3,"ERPV",4
46,"46009",3140,2521,2498,15,23,"ERPV",5
3,"3034",1343,1140,1126,5,14,"ERPV",0
46,"46176",1965,1423,1405,12,18,"ERPV",3
46,"46220",48981,34657,34242,450,415,"ERPV",144
46,"46053",584,484,461,2,23,"ERPV",1
46,"46078",28197,20643,20415,205,228,"ERPV",32
12,"12014",191,139,137,4,2,"ERPV",0
3,"3012",1021,870,862,3,8,"ERPV",0
46,"46144",699,547,536,2,11,"ERPV",3
46,"46119",856,702,693,0,9,"ERPV",2
46,"46010",927,706,699,3,7,"ERPV",6
46,"46229",1065,840,831,8,9,"ERPV",0
46,"46190",48324,34747,34424,431,323,"ERPV",61
46,"46115",515,364,354,1,10,"ERPV",0
3,"3069",2830,2009,1979,22,30,"ERPV",14
3,"3103",288,248,243,2,5,"ERPV",0
3,"3062",206,175,175,0,0,"ERPV",0
12,"12114",228,178,173,2,5,"ERPV",1
12,"12050",1418,1183,1156,8,27,"ERPV",1
3,"3122",40476,29591,29265,341,326,"ERPV",52
46,"46006",4643,3847,3785,32,62,"ERPV",7
46,"46255",3135,2530,2508,11,22,"ERPV",14
46,"46026",1217,1043,1035,2,8,"ERPV",3
12,"12042",664,549,530,5,19,"ERPV",1
12,"12018",326,274,265,1,9,"ERPV",2
46,"46110",21420,15810,15671,134,139,"ERPV",28
12,"12125",235,203,201,1,2,"ERPV",2
46,"46137",273,232,229,1,3,"ERPV",4
3,"3002",3559,2747,2707,16,40,"ERPV",4
46,"46262",228,161,158,0,3,"ERPV",0
46,"46201",83,50,49,0,1,"ERPV",0
12,"12099",583,485,465,3,20,"ERPV",0
46,"46127",2790,2298,2267,23,31,"ERPV",8
12,"12132",524,407,401,4,6,"ERPV",3
46,"46179",2186,1849,1804,17,45,"ERPV",4
46,"46214",15129,11609,11500,116,109,"ERPV",14
3,"3072",331,284,277,2,7,"ERPV",6
3,"3015",12241,9734,9636,88,98,"ERPV",11
46,"46257",5579,4546,4512,32,34,"ERPV",11
12,"12032",23406,16895,16721,227,174,"ERPV",83
46,"46036",675,440,431,11,9,"ERPV",0
46,"46112",582,475,463,4,12,"ERPV",1
46,"46252",142,108,107,1,1,"ERPV",0
3,"3131",181,161,157,1,4,"ERPV",0
3,"3110",294,239,238,0,1,"ERPV",0
12,"12088",55,51,51,2,0,"ERPV",0
46,"46041",369,255,255,1,0,"ERPV",1
12,"12004",4354,3145,3083,50,62,"ERPV",10
46,"46125",858,724,710,6,14,"ERPV",1
46,"46081",10254,8188,8101,52,87,"ERPV",25
3,"3031",39966,27099,26802,291,297,"ERPV",65
3,"3118",2368,1746,1718,16,28,"ERPV",1
46,"46235",21966,16641,16465,167,176,"ERPV",113
46,"46064",547,463,458,2,5,"ERPV",1
46,"46067",1798,1487,1472,10,15,"ERPV",4
46,"46005",22815,17016,16838,185,178,"ERPV",53
12,"12104",6981,5464,5357,54,107,"ERPV",16
46,"46166",8260,6422,6324,60,98,"ERPV",17
46,"46234",388,308,307,3,1,"ERPV",1
46,"46217",912,758,751,4,7,"ERPV",0
12,"12061",431,324,316,6,8,"ERPV",10
3,"3028",1049,903,895,6,8,"ERPV",6
12,"12074",783,679,676,3,3,"ERPV",0
3,"3095",4498,3558,3517,29,41,"ERPV",18
12,"12022",367,282,279,4,3,"ERPV",0
46,"46194",15267,11622,11491,110,131,"ERPV",23
3,"3082",11741,8208,8102,80,106,"ERPV",48
3,"3045",233,204,203,2,1,"ERPV",1
3,"3114",1620,1320,1305,10,15,"ERPV",3
12,"12142",158,122,121,1,1,"ERPV",0
46,"46121",116,103,101,0,2,"ERPV",0
46,"46030",800,677,662,6,15,"ERPV",2
46,"46065",1606,1250,1234,15,16,"ERPV",1
12,"12902",2056,1454,1411,14,43,"ERPV",8
3,"3043",2933,2494,2447,27,47,"ERPV",3
3,"3001",359,296,292,2,4,"ERPV",0
12,"12111",423,375,363,6,12,"ERPV",6
3,"3039",92,70,66,1,4,"ERPV",1
12,"12131",92,78,78,1,0,"ERPV",0
46,"46188",660,579,576,4,3,"ERPV",0
3,"3020",108,87,86,1,1,"ERPV",0
46,"46019",8671,7195,7109,70,86,"ERPV",11
3,"3036",84,72,72,0,0,"ERPV",0
46,"46146",1718,1395,1374,10,21,"ERPV",7
46,"46168",1828,1461,1449,7,12,"ERPV",6
3,"3068",48,45,45,1,0,"ERPV",0
46,"46093",2082,1722,1716,9,6,"ERPV",2
46,"46241",440,336,314,4,22,"ERPV",4
46,"46071",488,418,402,10,16,"ERPV",0
3,"3119",15887,12128,11988,122,140,"ERPV",36
12,"12138",18762,12489,12231,243,258,"ERPV",223
46,"46103",1244,998,972,12,26,"ERPV",10
46,"46237",7261,5405,5350,54,55,"ERPV",9
46,"46177",4594,3576,3523,29,53,"ERPV",12
46,"46189",490,400,396,3,4,"ERPV",1
3,"3075",160,139,136,2,3,"ERPV",0
46,"46018",689,597,592,12,5,"ERPV",0
3,"3123",7435,5860,5744,63,116,"ERPV",7
46,"46048",3484,2915,2875,26,40,"ERPV",4
3,"3017",380,331,324,7,7,"ERPV",5
12,"12011",4663,3578,3525,28,53,"ERPV",13
46,"46058",1787,1460,1441,10,19,"ERPV",33
46,"46034",1791,1477,1468,8,9,"ERPV",3
46,"46089",2116,1653,1627,9,26,"ERPV",3
46,"46181",17153,13332,13184,108,148,"ERPV",57
46,"46216",4806,3857,3825,39,32,"ERPV",5
3,"3049",12150,10039,9892,88,147,"ERPV",9
46,"46161",1454,1192,1179,8,13,"ERPV",2
46,"46108",550,446,444,3,2,"ERPV",2
46,"46073",1119,931,915,14,16,"ERPV",0
46,"46068",326,292,285,3,7,"ERPV",1
12,"12041",115,98,98,2,0,"ERPV",0
46,"46120",1133,889,870,2,19,"ERPV",7
46,"46001",863,647,641,5,6,"ERPV",0
3,"3901",1070,826,818,14,8,"ERPV",5
46,"46155",1072,861,849,4,12,"ERPV",6
3,"3107",2288,1670,1647,15,23,"ERPV",7
3,"3006",479,380,369,2,11,"ERPV",6
46,"46210",346,300,295,4,5,"ERPV",0
46,"46050",161,126,123,1,3,"ERPV",1
46,"46054",11422,8666,8566,82,100,"ERPV",19
46,"46178",4406,3235,3201,22,34,"ERPV",4
3,"3133",40056,25746,25554,231,192,"ERPV",41
46,"46198",815,660,654,4,6,"ERPV",3
12,"12028",12115,9084,8992,137,92,"ERPV",26
46,"46098",2556,2072,2057,12,15,"ERPV",2
3,"3113",4154,3295,3251,24,44,"ERPV",2
12,"12005",8066,5835,5441,116,394,"ERPV",25
46,"46133",686,572,565,1,7,"ERPV",0
12,"12033",1970,1547,1509,8,38,"ERPV",2
12,"12038",195,135,134,8,1,"ERPV",0
46,"46240",226,188,185,3,3,"ERPV",2
46,"46159",23111,17258,17086,141,172,"ERPV",31
46,"46203",3669,3002,2964,36,38,"ERPV",12
46,"46080",1090,860,849,2,11,"ERPV",3
46,"46134",2326,1691,1664,20,27,"ERPV",5
46,"46104",2012,1691,1676,9,15,"ERPV",6
46,"46151",717,596,589,3,7,"ERPV",1
3,"3134",159,129,126,0,3,"ERPV",0
3,"3088",5381,4056,3988,47,68,"ERPV",8
3,"3098",526,410,400,6,10,"ERPV",1
3,"3057",232,179,178,0,1,"ERPV",1
12,"12078",365,273,267,5,6,"ERPV",0
46,"46206",595,497,495,3,2,"ERPV",0
46,"46032",5583,4342,4287,39,55,"ERPV",17
12,"12055",112,79,78,3,1,"ERPV",0
46,"46226",34,34,33,0,1,"ERPV",0
46,"46059",1310,1076,1058,2,18,"ERPV",13
46,"46254",1085,847,834,12,13,"ERPV",0
3,"3120",2329,1810,1785,16,25,"ERPV",1
46,"46116",12587,9821,9724,120,97,"ERPV",14
3,"3011",7341,5277,5218,72,59,"ERPV",8
3,"3042",1337,1028,1019,8,9,"ERPV",2
46,"46085",11344,8526,8426,87,100,"ERPV",21
46,"46060",9510,7506,7408,52,98,"ERPV",27
12,"12029",760,619,601,7,18,"ERPV",7
3,"3061",1052,842,836,6,6,"ERPV",1
46,"46129",553,430,423,4,7,"ERPV",0
46,"46084",1587,1363,1332,7,31,"ERPV",5
12,"12026",946,728,702,16,26,"ERPV",6
46,"46238",13401,10371,10283,96,88,"ERPV",62
46,"46096",320,267,267,0,0,"ERPV",1
12,"12034",1509,1125,1097,10,28,"ERPV",5
3,"3025",1252,1054,1044,4,10,"ERPV",0
3,"3058",4798,4126,4103,26,23,"ERPV",2
12,"12135",35189,25691,25345,380,346,"ERPV",116
3,"3060",124,100,98,0,2,"ERPV",1
46,"46228",2434,1881,1859,30,22,"ERPV",7
46,"46020",3793,3084,3046,21,38,"ERPV",6
46,"46057",483,357,349,9,8,"ERPV",0
46,"46014",3092,2449,2420,26,29,"ERPV",0
12,"12069",53,48,47,0,1,"ERPV",0
46,"46056",203,164,160,2,4,"ERPV",6
46,"46171",16753,12565,12399,122,166,"ERPV",40
12,"12134",147,107,107,3,0,"ERPV",0
3,"3092",6780,5364,5269,96,95,"ERPV",23
12,"12037",20,15,14,1,1,"ERPV",0
3,"3071",3993,3180,3128,40,52,"ERPV",26
46,"46145",21751,16601,16397,155,204,"ERPV",53
12,"12128",1448,1114,1092,16,22,"ERPV",4
46,"46162",1230,1045,1027,6,18,"ERPV",1
3,"3115",267,242,242,2,0,"ERPV",0
12,"12100",1380,1124,1109,11,15,"ERPV",9
12,"12077",4683,3476,3414,41,62,"ERPV",8
12,"12124",1902,1532,1499,15,33,"ERPV",6
12,"12021",4433,3368,3292,42,76,"ERPV",14
12,"12116",56,45,45,0,0,"ERPV",0
46,"46195",1975,1631,1631,33,0,"ERPV",2
46,"46015",7042,5644,5581,53,63,"ERPV",24
3,"3047",8867,6219,6113,76,106,"ERPV",25
12,"12076",105,79,79,0,0,"ERPV",2
12,"12049",471,366,344,10,22,"ERPV",2
46,"46249",9650,7288,7191,125,97,"ERPV",8
46,"46004",1933,1563,1541,8,22,"ERPV",3
46,"46149",398,307,305,1,2,"ERPV",0
46,"46196",159,145,144,1,1,"ERPV",0
46,"46232",920,730,722,6,8,"ERPV",0
46,"46097",890,674,662,2,12,"ERPV",0
12,"12009",17124,12273,12098,150,175,"ERPV",91
46,"46094",20341,15367,15222,152,145,"ERPV",35
12,"12027",16914,11657,11452,188,205,"ERPV",108
46,"46230",14204,10650,10515,112,135,"ERPV",20
12,"12107",358,314,311,4,3,"ERPV",2
46,"46202",15578,11811,11676,110,135,"ERPV",25
46,"46072",3711,3006,2932,38,74,"ERPV",12
3,"3030",522,464,453,6,11,"ERPV",2
12,"12045",388,301,286,2,15,"ERPV",1
3,"3063",25410,18205,17989,208,216,"ERPV",54
46,"46186",18444,14173,14029,135,144,"ERPV",17
3,"3070",1962,1582,1552,8,30,"ERPV",2
3,"3024",3908,3324,3271,34,53,"ERPV",4
3,"3019",14914,12087,11927,137,160,"ERPV",13
3,"3127",399,336,322,3,14,"ERPV",3
12,"12121",1197,1050,1020,4,30,"ERPV",1
3,"3136",484,393,386,1,7,"ERPV",1
3,"3080",1288,1116,1103,6,13,"ERPV",0
46,"46035",6470,5115,5047,38,68,"ERPV",15
46,"46027",997,869,855,4,14,"ERPV",0
3,"3064",4976,4098,4058,26,40,"ERPV",0
3,"3101",4648,3694,3607,29,87,"ERPV",33
46,"46031",10580,7900,7809,87,91,"ERPV",44
3,"3085",275,218,215,2,3,"ERPV",0
3,"3106",642,542,535,3,7,"ERPV",0
46,"46147",16527,11836,11716,105,120,"ERPV",27
46,"46209",1984,1606,1594,11,12,"ERPV",8
46,"46143",4278,3309,3266,46,43,"ERPV",12
46,"46902",425,333,332,3,1,"ERPV",1
12,"12126",24420,18431,18136,231,295,"ERPV",69
46,"46185",422,360,359,7,1,"ERPV",2
12,"12901",3383,2664,2632,34,32,"ERPV",16
12,"12065",181,155,155,0,0,"ERPV",0
12,"12080",2051,1692,1650,23,42,"ERPV",6
12,"12141",116,97,97,0,0,"ERPV",3
3,"3100",540,448,443,2,5,"ERPV",2
46,"46259",537,426,424,9,2,"ERPV",0
12,"12007",747,674,660,9,14,"ERPV",3
12,"12010",280,232,229,3,3,"ERPV",0
3,"3129",1188,936,918,10,18,"ERPV",4
3,"3038",338,294,291,2,3,"ERPV",0
3,"3044",4459,3798,3753,21,45,"ERPV",5
3,"3128",3944,2847,2812,16,35,"ERPV",9
46,"46239",457,331,323,2,8,"ERPV",0
46,"46141",424,338,336,2,2,"ERPV",0
46,"46122",2737,2154,2131,18,23,"ERPV",42
3,"3090",16226,12224,12116,139,108,"ERPV",66
3,"3117",381,321,317,4,4,"ERPV",3
46,"46251",2599,2215,2179,21,36,"ERPV",30
12,"12008",236,203,199,4,4,"ERPV",1
12,"12108",495,394,389,4,5,"ERPV",3
46,"46086",80,71,71,3,0,"ERPV",0
12,"12085",4941,3183,3125,32,58,"ERPV",9
12,"12084",17219,12059,11911,165,148,"ERPV",52
46,"46007",11576,8929,8848,71,81,"ERPV",21
3,"3140",26223,19998,19552,338,446,"ERPV",27
46,"46170",3464,2944,2908,24,36,"ERPV",4
12,"12063",59,42,41,0,1,"ERPV",0
12,"12090",127,109,107,2,2,"ERPV",0
12,"12137",47,36,35,0,1,"ERPV",0
46,"46038",368,264,260,1,4,"ERPV",1
46,"46221",350,319,317,3,2,"ERPV",0
3,"3052",984,837,820,10,17,"ERPV",0
46,"46184",26507,20314,20010,263,304,"ERPV",76
46,"46092",304,206,201,1,5,"ERPV",0
46,"46011",7727,5874,5777,75,97,"ERPV",10
12,"12048",293,208,205,2,3,"ERPV",1
46,"46175",469,406,401,5,5,"ERPV",1
46,"46040",1227,1028,1021,13,7,"ERPV",3
46,"46021",23273,17264,17091,163,173,"ERPV",22
46,"46076",651,541,528,2,13,"ERPV",0
12,"12052",627,510,491,9,19,"ERPV",2
3,"3104",26809,20511,20193,317,318,"ERPV",25
3,"3008",176,142,140,1,2,"ERPV",0
3,"3077",1411,1146,1130,14,16,"ERPV",2
46,"46070",15946,11979,11874,113,105,"ERPV",17
46,"46003",988,864,847,13,17,"ERPV",1
3,"3074",1752,1479,1466,5,13,"ERPV",1
46,"46043",149,139,139,0,0,"ERPV",0
12,"12060",467,367,353,2,14,"ERPV",3
46,"46192",755,564,554,9,10,"ERPV",2
46,"46130",934,745,734,6,11,"ERPV",2
3,"3018",11899,8855,8720,119,135,"ERPV",18
46,"46242",361,288,280,4,8,"ERPV",0
46,"46165",6962,5390,5322,53,68,"ERPV",11
46,"46218",1082,964,936,5,28,"ERPV",3
3,"3094",8442,6105,6053,70,52,"ERPV",9
12,"12079",450,360,353,3,7,"ERPV",0
46,"46100",307,264,255,0,9,"ERPV",1
3,"3037",354,293,289,1,4,"ERPV",0
46,"46051",8122,6432,6378,57,54,"ERPV",9
46,"46022",15090,10922,10840,99,82,"ERPV",20
46,"46256",6734,4902,4858,33,44,"ERPV",3
46,"46219",143,127,126,1,1,"ERPV",1
12,"12096",854,663,653,17,10,"ERPV",4
46,"46113",2338,1804,1797,14,7,"ERPV",3
3,"3004",624,497,486,7,11,"ERPV",5
46,"46243",149,120,117,0,3,"ERPV",0
46,"46024",448,365,358,1,7,"ERPV",0
12,"12075",139,106,102,0,4,"ERPV",2
12,"12006",185,160,153,0,7,"ERPV",1
46,"46167",411,312,309,0,3,"ERPV",1
3,"3124",482,420,415,7,5,"ERPV",3
46,"46062",4589,3794,3752,46,42,"ERPV",10
46,"46246",1081,917,904,5,13,"ERPV",0
46,"46105",16708,12164,12040,100,124,"ERPV",48
46,"46211",1716,1459,1447,9,12,"ERPV",4
12,"12097",78,59,59,4,0,"ERPV",0
46,"46049",292,249,245,0,4,"ERPV",1
12,"12087",22,20,20,0,0,"ERPV",0
46,"46138",338,297,296,1,1,"ERPV",0
12,"12117",3674,2846,2794,25,52,"ERPV",14
46,"46261",1706,1388,1366,13,22,"ERPV",1
46,"46013",16111,12469,12328,145,141,"ERPV",62
3,"3026",1210,1004,989,11,15,"ERPV",7
46,"46148",1400,1131,1114,13,17,"ERPV",0
3,"3041",5811,4325,4269,33,56,"ERPV",13
3,"3097",973,791,779,6,12,"ERPV",2
46,"46197",1902,1559,1554,15,5,"ERPV",3
46,"46248",4847,3655,3597,25,58,"ERPV",11
3,"3059",20261,15951,15825,82,126,"ERPV",119
46,"46029",20887,16124,15988,144,136,"ERPV",73
3,"3109",2745,2332,2302,18,30,"ERPV",3
12,"12082",9741,7555,7408,84,147,"ERPV",26
12,"12003",1058,830,813,15,17,"ERPV",3
12,"12025",146,106,105,0,1,"ERPV",2
12,"12051",520,382,376,1,6,"ERPV",1
12,"12016",1589,1309,1293,15,16,"ERPV",2
46,"46153",445,374,366,7,8,"ERPV",0
12,"12044",527,472,463,4,9,"ERPV",5
46,"46046",922,699,694,2,5,"ERPV",3
3,"3067",94,81,79,1,2,"ERPV",1
12,"12057",650,530,515,6,15,"ERPV",5
3,"3055",5128,4121,4076,43,45,"ERPV",3
3,"3029",260,191,186,0,5,"ERPV",0
3,"3033",127,102,97,2,5,"ERPV",0
12,"12013",180,131,130,0,1,"ERPV",0
46,"46227",923,787,771,4,16,"ERPV",5
46,"46008",2727,2249,2233,17,16,"ERPV",6
12,"12103",85,65,65,4,0,"ERPV",0
12,"12072",1191,1007,977,17,30,"ERPV",2
3,"3135",228,185,181,0,4,"ERPV",1
12,"12113",100,72,72,0,0,"ERPV",0
3,"3081",1409,1102,1087,14,15,"ERPV",5
3,"3132",571,464,461,8,3,"ERPV",3
3,"3056",8929,6927,6776,74,151,"ERPV",25
12,"12130",425,348,344,2,4,"ERPV",0
12,"12127",92,64,61,0,3,"ERPV",2
3,"3066",42697,31279,30833,566,446,"ERPV",49
46,"46016",1097,927,917,12,10,"ERPV",2
46,"46208",1141,990,978,6,12,"ERPV",1
46,"46213",15621,11361,11164,214,197,"ERPV",12
12,"12064",118,91,89,1,2,"ERPV",0
46,"46124",768,641,632,10,9,"ERPV",0
46,"46002",1166,942,915,7,27,"ERPV",6
46,"46037",1146,1007,1003,5,4,"ERPV",3
3,"3139",21796,15501,15320,160,181,"ERPV",68
46,"46205",14277,10882,10764,115,118,"ERPV",25
46,"46111",10589,7823,7710,94,113,"ERPV",14
46,"46075",166,148,145,3,3,"ERPV",0
12,"12059",276,227,227,1,0,"ERPV",2
3,"3112",684,566,561,4,5,"ERPV",3
46,"46172",4838,3492,3445,24,47,"ERPV",10
46,"46102",19880,15358,15179,122,179,"ERPV",24
46,"46207",6453,5086,5031,52,55,"ERPV",21
12,"12140",1204,975,954,9,21,"ERPV",1
46,"46135",9634,7671,7586,64,85,"ERPV",7
3,"3903",2431,1991,1960,18,31,"ERPV",5
3,"3089",9696,7447,7302,83,145,"ERPV",21
46,"46173",1393,1156,1137,10,19,"ERPV",4
3,"3116",1167,912,904,12,8,"ERPV",0
3,"3022",160,133,131,1,2,"ERPV",0
46,"46099",987,764,754,2,10,"ERPV",2
12,"12110",253,199,195,3,4,"ERPV",0
46,"46169",31753,24041,23802,270,239,"ERPV",43
12,"12040",116573,84142,83078,1257,1064,"ERPV",320
46,"46183",5946,4718,4656,35,62,"ERPV",5
12,"12123",70,50,48,2,2,"ERPV",1
46,"46088",196,146,140,0,6,"ERPV",0
12,"12093",254,190,187,0,3,"ERPV",2
12,"12136",2663,2325,2284,33,41,"ERPV",6
12,"12092",143,98,98,0,0,"ERPV",0
3,"3130",43,30,29,0,1,"EUPV-LV",0
3,"3088",5381,4056,3988,47,68,"EUPV-LV",253
3,"3021",5594,4630,4517,46,113,"EUPV-LV",199
3,"3043",2933,2494,2447,27,47,"EUPV-LV",180
3,"3053",7082,5754,5664,60,90,"EUPV-LV",344
3,"3075",160,139,136,2,3,"EUPV-LV",7
3,"3009",47547,35945,35298,603,647,"EUPV-LV",3278
3,"3133",40056,25746,25554,231,192,"EUPV-LV",1500
3,"3020",108,87,86,1,1,"EUPV-LV",4
3,"3086",145,119,118,1,1,"EUPV-LV",3
3,"3007",160,131,127,0,4,"EUPV-LV",7
3,"3010",330,269,266,3,3,"EUPV-LV",16
3,"3019",14914,12087,11927,137,160,"EUPV-LV",925
3,"3098",526,410,400,6,10,"EUPV-LV",42
3,"3135",228,185,181,0,4,"EUPV-LV",13
3,"3080",1288,1116,1103,6,13,"EUPV-LV",25
3,"3015",12241,9734,9636,88,98,"EUPV-LV",908
3,"3138",3218,2403,2388,22,15,"EUPV-LV",84
3,"3093",19646,15399,15159,173,240,"EUPV-LV",780
3,"3904",1416,1104,1096,11,8,"EUPV-LV",50
3,"3031",39966,27099,26802,291,297,"EUPV-LV",1300
3,"3026",1210,1004,989,11,15,"EUPV-LV",61
3,"3084",593,518,513,2,5,"EUPV-LV",26
3,"3027",150,131,130,1,1,"EUPV-LV",1
3,"3091",256,220,219,1,1,"EUPV-LV",7
3,"3012",1021,870,862,3,8,"EUPV-LV",33
3,"3082",11741,8208,8102,80,106,"EUPV-LV",361
3,"3099",41561,32556,32248,288,308,"EUPV-LV",1254
3,"3122",40476,29591,29265,341,326,"EUPV-LV",2862
3,"3050",17818,12860,12706,160,154,"EUPV-LV",968
3,"3109",2745,2332,2302,18,30,"EUPV-LV",60
3,"3901",1070,826,818,14,8,"EUPV-LV",53
3,"3069",2830,2009,1979,22,30,"EUPV-LV",89
3,"3119",15887,12128,11988,122,140,"EUPV-LV",931
3,"3018",11899,8855,8720,119,135,"EUPV-LV",572
3,"3032",112,90,88,0,2,"EUPV-LV",4
3,"3094",8442,6105,6053,70,52,"EUPV-LV",389
3,"3066",42697,31279,30833,566,446,"EUPV-LV",2220
3,"3011",7341,5277,5218,72,59,"EUPV-LV",317
3,"3038",338,294,291,2,3,"EUPV-LV",12
3,"3118",2368,1746,1718,16,28,"EUPV-LV",60
3,"3065",164772,124457,123236,1556,1221,"EUPV-LV",7129
3,"3095",4498,3558,3517,29,41,"EUPV-LV",223
3,"3044",4459,3798,3753,21,45,"EUPV-LV",92
3,"3107",2288,1670,1647,15,23,"EUPV-LV",110
3,"3096",5863,4550,4457,57,93,"EUPV-LV",301
3,"3024",3908,3324,3271,34,53,"EUPV-LV",81
3,"3063",25410,18205,17989,208,216,"EUPV-LV",1195
3,"3028",1049,903,895,6,8,"EUPV-LV",25
3,"3105",5322,4218,4124,34,94,"EUPV-LV",195
3,"3002",3559,2747,2707,16,40,"EUPV-LV",122
3,"3067",94,81,79,1,2,"EUPV-LV",1
3,"3077",1411,1146,1130,14,16,"EUPV-LV",43
3,"3001",359,296,292,2,4,"EUPV-LV",15
3,"3127",399,336,322,3,14,"EUPV-LV",16
3,"3068",48,45,45,1,0,"EUPV-LV",0
3,"3106",642,542,535,3,7,"EUPV-LV",16
3,"3040",260,224,220,0,4,"EUPV-LV",14
3,"3125",340,276,275,2,1,"EUPV-LV",10
3,"3006",479,380,369,2,11,"EUPV-LV",27
3,"3083",5708,4267,4196,66,71,"EUPV-LV",252
3,"3140",26223,19998,19552,338,446,"EUPV-LV",1359
3,"3078",528,424,423,2,1,"EUPV-LV",17
3,"3071",3993,3180,3128,40,52,"EUPV-LV",157
3,"3051",356,314,311,2,3,"EUPV-LV",11
3,"3056",8929,6927,6776,74,151,"EUPV-LV",488
3,"3005",7482,6191,6146,49,45,"EUPV-LV",208
3,"3048",4747,3878,3817,16,61,"EUPV-LV",149
3,"3036",84,72,72,0,0,"EUPV-LV",4
3,"3017",380,331,324,7,7,"EUPV-LV",31
3,"3076",8373,6319,6222,68,97,"EUPV-LV",341
3,"3073",219,199,199,0,0,"EUPV-LV",5
3,"3060",124,100,98,0,2,"EUPV-LV",5
3,"3064",4976,4098,4058,26,40,"EUPV-LV",112
3,"3033",127,102,97,2,5,"EUPV-LV",8
3,"3114",1620,1320,1305,10,15,"EUPV-LV",120
3,"3034",1343,1140,1126,5,14,"EUPV-LV",40
3,"3085",275,218,215,2,3,"EUPV-LV",14
3,"3124",482,420,415,7,5,"EUPV-LV",38
3,"3136",484,393,386,1,7,"EUPV-LV",21
3,"3023",1425,1259,1233,11,26,"EUPV-LV",62
3,"3062",206,175,175,0,0,"EUPV-LV",7
3,"3111",5244,4184,4146,39,38,"EUPV-LV",135
3,"3117",381,321,317,4,4,"EUPV-LV",14
3,"3042",1337,1028,1019,8,9,"EUPV-LV",34
3,"3072",331,284,277,2,7,"EUPV-LV",16
3,"3061",1052,842,836,6,6,"EUPV-LV",25
3,"3137",719,536,530,3,6,"EUPV-LV",40
3,"3113",4154,3295,3251,24,44,"EUPV-LV",155
3,"3090",16226,12224,12116,139,108,"EUPV-LV",898
3,"3903",2431,1991,1960,18,31,"EUPV-LV",88
3,"3074",1752,1479,1466,5,13,"EUPV-LV",11
3,"3081",1409,1102,1087,14,15,"EUPV-LV",61
3,"3037",354,293,289,1,4,"EUPV-LV",24
3,"3115",267,242,242,2,0,"EUPV-LV",19
3,"3103",288,248,243,2,5,"EUPV-LV",29
3,"3016",91,67,66,1,1,"EUPV-LV",5
3,"3902",9578,7085,7007,65,78,"EUPV-LV",170
3,"3129",1188,936,918,10,18,"EUPV-LV",79
3,"3070",1962,1582,1552,8,30,"EUPV-LV",63
3,"3003",460,382,370,1,12,"EUPV-LV",18
3,"3052",984,837,820,10,17,"EUPV-LV",27
3,"3030",522,464,453,6,11,"EUPV-LV",30
3,"3022",160,133,131,1,2,"EUPV-LV",10
3,"3104",26809,20511,20193,317,318,"EUPV-LV",1843
3,"3120",2329,1810,1785,16,25,"EUPV-LV",119
3,"3059",20261,15951,15825,82,126,"EUPV-LV",716
3,"3101",4648,3694,3607,29,87,"EUPV-LV",249
3,"3116",1167,912,904,12,8,"EUPV-LV",49
3,"3025",1252,1054,1044,4,10,"EUPV-LV",21
3,"3054",371,321,315,2,6,"EUPV-LV",9
3,"3134",159,129,126,0,3,"EUPV-LV",11
3,"3100",540,448,443,2,5,"EUPV-LV",39
3,"3045",233,204,203,2,1,"EUPV-LV",3
3,"3008",176,142,140,1,2,"EUPV-LV",1
3,"3131",181,161,157,1,4,"EUPV-LV",13
3,"3013",1144,941,926,5,15,"EUPV-LV",43
3,"3014",234288,168004,166418,1795,1586,"EUPV-LV",12535
3,"3029",260,191,186,0,5,"EUPV-LV",5
3,"3123",7435,5860,5744,63,116,"EUPV-LV",322
3,"3079",18028,14580,14317,189,263,"EUPV-LV",1296
3,"3102",7346,5827,5751,39,76,"EUPV-LV",253
3,"3047",8867,6219,6113,76,106,"EUPV-LV",360
3,"3049",12150,10039,9892,88,147,"EUPV-LV",606
3,"3089",9696,7447,7302,83,145,"EUPV-LV",366
3,"3139",21796,15501,15320,160,181,"EUPV-LV",1317
3,"3121",20518,14464,14315,137,149,"EUPV-LV",734
3,"3041",5811,4325,4269,33,56,"EUPV-LV",245
3,"3110",294,239,238,0,1,"EUPV-LV",7
3,"3046",1530,1136,1121,11,15,"EUPV-LV",100
3,"3055",5128,4121,4076,43,45,"EUPV-LV",145
3,"3112",684,566,561,4,5,"EUPV-LV",27
3,"3128",3944,2847,2812,16,35,"EUPV-LV",104
3,"3092",6780,5364,5269,96,95,"EUPV-LV",522
3,"3035",672,560,550,0,10,"EUPV-LV",26
3,"3097",973,791,779,6,12,"EUPV-LV",47
3,"3132",571,464,461,8,3,"EUPV-LV",47
3,"3039",92,70,66,1,4,"EUPV-LV",4
3,"3004",624,497,486,7,11,"EUPV-LV",37
3,"3057",232,179,178,0,1,"EUPV-LV",16
3,"3058",4798,4126,4103,26,23,"EUPV-LV",131
7,"7047",2161,1447,1407,31,40,"EUIB",81
7,"7022",11700,7512,7371,128,141,"EUIB",351
7,"7014",6697,3818,3757,38,61,"EUIB",203
7,"7059",3011,2077,2012,22,65,"EUIB",68
7,"7015",20783,12244,12016,381,228,"EUIB",567
7,"7048",15296,8559,8439,176,120,"EUIB",472
7,"7062",7206,4073,4035,72,38,"EUIB",198
7,"7051",4925,2993,2947,66,46,"EUIB",113
7,"7057",7102,4702,4611,85,91,"EUIB",171
7,"7065",2061,1376,1345,29,31,"EUIB",17
7,"7020",3455,2491,2453,46,38,"EUIB",86
7,"7033",25954,14975,14738,328,237,"EUIB",554
7,"7004",3669,2511,2453,51,58,"EUIB",82
7,"7008",5422,3782,3705,61,77,"EUIB",171
7,"7006",4964,3234,3157,51,77,"EUIB",115
7,"7007",454,304,300,4,4,"EUIB",8
7,"7041",2077,1583,1549,27,34,"EUIB",18
7,"7029",4090,2921,2866,44,55,"EUIB",86
7,"7036",25502,17151,16914,294,237,"EUIB",822
7,"7010",4668,3229,3174,58,55,"EUIB",139
7,"7024",6070,3232,3170,60,62,"EUIB",280
7,"7044",8326,6044,5846,99,198,"EUIB",174
7,"7060",2534,1724,1697,30,27,"EUIB",77
7,"7061",9429,5937,5800,125,137,"EUIB",248
7,"7026",30036,16912,16661,294,251,"EUIB",944
7,"7025",457,355,346,3,9,"EUIB",12
7,"7046",13748,8294,8183,183,111,"EUIB",340
7,"7023",3541,2414,2365,88,49,"EUIB",156
7,"7017",800,556,539,14,17,"EUIB",28
7,"7011",26954,16786,16595,299,191,"EUIB",770
7,"7054",19930,11186,11028,196,158,"EUIB",569
7,"7063",1414,1050,1030,25,20,"EUIB",39
7,"7031",23371,14443,14213,285,230,"EUIB",596
7,"7035",1542,1190,1161,19,29,"EUIB",30
7,"7042",10393,6536,6421,96,115,"EUIB",364
7,"7055",7000,4471,4379,67,92,"EUIB",139
7,"7032",19658,12168,11959,238,209,"EUIB",879
7,"7064",5286,3340,3279,53,61,"EUIB",347
7,"7021",255,197,193,1,4,"EUIB",0
7,"7003",10671,6262,6149,79,113,"EUIB",363
7,"7039",4920,3488,3377,54,111,"EUIB",96
7,"7009",744,593,576,11,17,"EUIB",12
7,"7040",266127,162699,160491,2698,2208,"EUIB",8577
7,"7028",876,607,595,6,12,"EUIB",24
7,"7019",230,165,164,1,1,"EUIB",3
7,"7018",389,275,271,0,4,"EUIB",13
7,"7002",6305,4188,4073,80,115,"EUIB",302
7,"7027",20045,12873,12678,204,195,"EUIB",567
7,"7052",4578,2671,2651,46,20,"EUIB",193
7,"7012",1880,1437,1405,20,32,"EUIB",27
7,"7037",3269,1737,1700,37,37,"EUIB",141
7,"7049",1482,1046,1037,14,9,"EUIB",24
7,"7038",1962,1504,1480,20,24,"EUIB",35
7,"7030",1576,1150,1135,26,15,"EUIB",27
7,"7043",3522,2384,2345,35,39,"EUIB",58
7,"7013",6525,4528,4409,78,119,"EUIB",103
7,"7001",3450,2544,2470,36,74,"EUIB",86
7,"7050",3099,2008,1979,45,29,"EUIB",67
7,"7058",2803,2100,2046,38,54,"EUIB",71
7,"7056",4701,3164,3090,55,74,"EUIB",164
7,"7053",1133,863,839,16,24,"EUIB",33
7,"7016",2726,1848,1809,34,39,"EUIB",69
7,"7005",6331,4128,4058,76,70,"EUIB",154
7,"7902",1071,734,712,22,22,"EUIB",42
7,"7045",1189,843,823,23,20,"EUIB",31
7,"7034",971,724,708,10,16,"EUIB",28
7,"7901",642,483,470,5,13,"EUIB",8
46,"46172",4838,3492,3445,24,47,"EUPV-EV",251
46,"46032",5583,4342,4287,39,55,"EUPV-EV",291
12,"12068",57,45,44,0,1,"EUPV-EV",3
12,"12078",365,273,267,5,6,"EUPV-EV",9
46,"46034",1791,1477,1468,8,9,"EUPV-EV",85
12,"12043",620,499,487,2,12,"EUPV-EV",17
12,"12081",654,519,515,2,4,"EUPV-EV",18
12,"12009",17124,12273,12098,150,175,"EUPV-EV",611
46,"46115",515,364,354,1,10,"EUPV-EV",6
12,"12902",2056,1454,1411,14,43,"EUPV-EV",69
46,"46229",1065,840,831,8,9,"EUPV-EV",59
12,"12051",520,382,376,1,6,"EUPV-EV",4
46,"46029",20887,16124,15988,144,136,"EUPV-EV",1090
46,"46226",34,34,33,0,1,"EUPV-EV",0
46,"46242",361,288,280,4,8,"EUPV-EV",12
46,"46258",2792,2196,2164,14,32,"EUPV-EV",182
46,"46232",920,730,722,6,8,"EUPV-EV",14
12,"12109",700,564,555,7,9,"EUPV-EV",21
46,"46072",3711,3006,2932,38,74,"EUPV-EV",188
46,"46024",448,365,358,1,7,"EUPV-EV",7
12,"12016",1589,1309,1293,15,16,"EUPV-EV",40
46,"46215",1451,1185,1169,8,16,"EUPV-EV",151
12,"12079",450,360,353,3,7,"EUPV-EV",8
46,"46126",5471,4454,4392,53,62,"EUPV-EV",293
12,"12040",116573,84142,83078,1257,1064,"EUPV-EV",4759
12,"12020",131,109,107,1,2,"EUPV-EV",0
12,"12099",583,485,465,3,20,"EUPV-EV",15
46,"46046",922,699,694,2,5,"EUPV-EV",43
12,"12901",3383,2664,2632,34,32,"EUPV-EV",95
46,"46075",166,148,145,3,3,"EUPV-EV",3
46,"46180",715,585,581,4,4,"EUPV-EV",55
46,"46099",987,764,754,2,10,"EUPV-EV",26
46,"46256",6734,4902,4858,33,44,"EUPV-EV",257
46,"46078",28197,20643,20415,205,228,"EUPV-EV",1692
46,"46248",4847,3655,3597,25,58,"EUPV-EV",140
46,"46144",699,547,536,2,11,"EUPV-EV",10
12,"12106",1207,992,969,7,23,"EUPV-EV",58
12,"12011",4663,3578,3525,28,53,"EUPV-EV",182
12,"12008",236,203,199,4,4,"EUPV-EV",6
46,"46216",4806,3857,3825,39,32,"EUPV-EV",228
46,"46101",868,720,716,8,4,"EUPV-EV",64
46,"46103",1244,998,972,12,26,"EUPV-EV",90
46,"46250",574266,435877,431619,4626,4258,"EUPV-EV",31059
46,"46237",7261,5405,5350,54,55,"EUPV-EV",406
12,"12013",180,131,130,0,1,"EUPV-EV",7
46,"46142",870,682,673,7,9,"EUPV-EV",35
46,"46150",1898,1555,1541,8,14,"EUPV-EV",157
46,"46121",116,103,101,0,2,"EUPV-EV",2
46,"46077",7637,5979,5845,64,134,"EUPV-EV",1219
46,"46259",537,426,424,9,2,"EUPV-EV",16
12,"12105",866,679,673,6,6,"EUPV-EV",10
46,"46109",6143,4731,4637,40,94,"EUPV-EV",380
12,"12092",143,98,98,0,0,"EUPV-EV",1
12,"12012",2747,2196,2135,24,61,"EUPV-EV",184
46,"46026",1217,1043,1035,2,8,"EUPV-EV",57
46,"46038",368,264,260,1,4,"EUPV-EV",22
46,"46183",5946,4718,4656,35,62,"EUPV-EV",163
46,"46042",3376,2873,2819,17,54,"EUPV-EV",89
46,"46212",1598,1233,1218,5,15,"EUPV-EV",66
12,"12137",47,36,35,0,1,"EUPV-EV",3
46,"46145",21751,16601,16397,155,204,"EUPV-EV",1454
46,"46223",7685,6040,5996,62,44,"EUPV-EV",392
12,"12118",83,63,62,0,1,"EUPV-EV",6
46,"46096",320,267,267,0,0,"EUPV-EV",13
46,"46129",553,430,423,4,7,"EUPV-EV",126
46,"46062",4589,3794,3752,46,42,"EUPV-EV",108
12,"12072",1191,1007,977,17,30,"EUPV-EV",21
46,"46123",1808,1440,1410,7,30,"EUPV-EV",68
12,"12026",946,728,702,16,26,"EUPV-EV",8
46,"46151",717,596,589,3,7,"EUPV-EV",27
46,"46904",782,659,650,6,9,"EUPV-EV",85
12,"12113",100,72,72,0,0,"EUPV-EV",6
12,"12032",23406,16895,16721,227,174,"EUPV-EV",778
46,"46049",292,249,245,0,4,"EUPV-EV",9
46,"46056",203,164,160,2,4,"EUPV-EV",5
12,"12107",358,314,311,4,3,"EUPV-EV",13
12,"12045",388,301,286,2,15,"EUPV-EV",17
12,"12141",116,97,97,0,0,"EUPV-EV",2
46,"46004",1933,1563,1541,8,22,"EUPV-EV",69
46,"46252",142,108,107,1,1,"EUPV-EV",1
46,"46192",755,564,554,9,10,"EUPV-EV",19
12,"12031",3748,2751,2687,35,64,"EUPV-EV",150
46,"46017",32928,24879,24672,267,207,"EUPV-EV",1414
46,"46184",26507,20314,20010,263,304,"EUPV-EV",1531
46,"46255",3135,2530,2508,11,22,"EUPV-EV",153
12,"12050",1418,1183,1156,8,27,"EUPV-EV",33
46,"46152",96,70,70,0,0,"EUPV-EV",1
46,"46085",11344,8526,8426,87,100,"EUPV-EV",224
12,"12136",2663,2325,2284,33,41,"EUPV-EV",49
12,"12088",55,51,51,2,0,"EUPV-EV",4
46,"46071",488,418,402,10,16,"EUPV-EV",16
12,"12024",146,129,128,1,1,"EUPV-EV",5
46,"46045",1288,1065,1044,2,21,"EUPV-EV",172
12,"12002",135,101,100,1,1,"EUPV-EV",15
46,"46110",21420,15810,15671,134,139,"EUPV-EV",1184
12,"12037",20,15,14,1,1,"EUPV-EV",1
12,"12071",1355,1069,1050,3,19,"EUPV-EV",91
46,"46010",927,706,699,3,7,"EUPV-EV",78
46,"46169",31753,24041,23802,270,239,"EUPV-EV",1968
46,"46013",16111,12469,12328,145,141,"EUPV-EV",839
46,"46104",2012,1691,1676,9,15,"EUPV-EV",60
46,"46112",582,475,463,4,12,"EUPV-EV",16
46,"46261",1706,1388,1366,13,22,"EUPV-EV",124
46,"46080",1090,860,849,2,11,"EUPV-EV",97
12,"12097",78,59,59,4,0,"EUPV-EV",4
46,"46005",22815,17016,16838,185,178,"EUPV-EV",1343
12,"12003",1058,830,813,15,17,"EUPV-EV",24
46,"46159",23111,17258,17086,141,172,"EUPV-EV",1469
12,"12093",254,190,187,0,3,"EUPV-EV",8
12,"12082",9741,7555,7408,84,147,"EUPV-EV",398
46,"46057",483,357,349,9,8,"EUPV-EV",10
46,"46097",890,674,662,2,12,"EUPV-EV",34
46,"46130",934,745,734,6,11,"EUPV-EV",15
12,"12001",1098,821,817,8,4,"EUPV-EV",28
12,"12111",423,375,363,6,12,"EUPV-EV",8
12,"12121",1197,1050,1020,4,30,"EUPV-EV",14
12,"12076",105,79,79,0,0,"EUPV-EV",1
46,"46222",378,321,310,1,11,"EUPV-EV",11
46,"46012",930,698,684,9,14,"EUPV-EV",37
46,"46125",858,724,710,6,14,"EUPV-EV",30
46,"46090",1668,1488,1452,9,36,"EUPV-EV",33
46,"46066",1264,1060,1050,5,10,"EUPV-EV",71
12,"12125",235,203,201,1,2,"EUPV-EV",14
46,"46201",83,50,49,0,1,"EUPV-EV",2
12,"12027",16914,11657,11452,188,205,"EUPV-EV",432
12,"12112",104,90,90,0,0,"EUPV-EV",2
46,"46190",48324,34747,34424,431,323,"EUPV-EV",2598
46,"46120",1133,889,870,2,19,"EUPV-EV",63
46,"46163",1811,1487,1463,12,24,"EUPV-EV",85
12,"12129",1936,1372,1326,29,46,"EUPV-EV",82
46,"46036",675,440,431,11,9,"EUPV-EV",23
46,"46204",6906,5426,5357,62,69,"EUPV-EV",334
46,"46199",5661,4328,4280,38,48,"EUPV-EV",269
12,"12077",4683,3476,3414,41,62,"EUPV-EV",161
46,"46245",478,357,354,1,3,"EUPV-EV",10
46,"46094",20341,15367,15222,152,145,"EUPV-EV",1082
46,"46091",126,108,108,0,0,"EUPV-EV",3
12,"12006",185,160,153,0,7,"EUPV-EV",8
12,"12096",854,663,653,17,10,"EUPV-EV",16
46,"46177",4594,3576,3523,29,53,"EUPV-EV",252
46,"46007",11576,8929,8848,71,81,"EUPV-EV",502
46,"46107",1998,1650,1623,8,27,"EUPV-EV",105
12,"12089",4277,3009,2946,32,63,"EUPV-EV",112
46,"46138",338,297,296,1,1,"EUPV-EV",4
46,"46065",1606,1250,1234,15,16,"EUPV-EV",84
46,"46262",228,161,158,0,3,"EUPV-EV",12
46,"46122",2737,2154,2131,18,23,"EUPV-EV",101
12,"12041",115,98,98,2,0,"EUPV-EV",5
46,"46143",4278,3309,3266,46,43,"EUPV-EV",152
12,"12087",22,20,20,0,0,"EUPV-EV",0
46,"46219",143,127,126,1,1,"EUPV-EV",5
12,"12100",1380,1124,1109,11,15,"EUPV-EV",42
46,"46157",3068,2523,2491,17,32,"EUPV-EV",62
12,"12004",4354,3145,3083,50,62,"EUPV-EV",159
46,"46027",997,869,855,4,14,"EUPV-EV",16
46,"46025",2495,1962,1941,24,21,"EUPV-EV",95
46,"46247",1059,829,823,6,6,"EUPV-EV",36
46,"46187",1339,1096,1083,13,13,"EUPV-EV",39
46,"46220",48981,34657,34242,450,415,"EUPV-EV",4293
46,"46206",595,497,495,3,2,"EUPV-EV",31
46,"46903",5210,4037,4000,40,37,"EUPV-EV",224
46,"46031",10580,7900,7809,87,91,"EUPV-EV",397
46,"46168",1828,1461,1449,7,12,"EUPV-EV",45
46,"46208",1141,990,978,6,12,"EUPV-EV",41
46,"46193",8494,6662,6580,73,82,"EUPV-EV",427
46,"46241",440,336,314,4,22,"EUPV-EV",25
46,"46001",863,647,641,5,6,"EUPV-EV",24
46,"46061",331,276,273,3,3,"EUPV-EV",8
46,"46158",1037,829,822,9,7,"EUPV-EV",59
46,"46244",57805,41885,41595,415,290,"EUPV-EV",2145
46,"46231",2496,1831,1817,16,14,"EUPV-EV",201
46,"46002",1166,942,915,7,27,"EUPV-EV",49
46,"46102",19880,15358,15179,122,179,"EUPV-EV",1208
46,"46069",166,149,148,1,1,"EUPV-EV",2
12,"12102",547,474,466,2,8,"EUPV-EV",14
12,"12085",4941,3183,3125,32,58,"EUPV-EV",127
46,"46153",445,374,366,7,8,"EUPV-EV",11
46,"46015",7042,5644,5581,53,63,"EUPV-EV",322
12,"12115",234,184,183,2,1,"EUPV-EV",4
12,"12084",17219,12059,11911,165,148,"EUPV-EV",555
46,"46253",118,105,102,7,3,"EUPV-EV",7
12,"12123",70,50,48,2,2,"EUPV-EV",2
12,"12048",293,208,205,2,3,"EUPV-EV",8
46,"46191",1952,1554,1528,9,26,"EUPV-EV",117
46,"46022",15090,10922,10840,99,82,"EUPV-EV",842
12,"12134",147,107,107,3,0,"EUPV-EV",2
46,"46016",1097,927,917,12,10,"EUPV-EV",38
46,"46170",3464,2944,2908,24,36,"EUPV-EV",55
46,"46243",149,120,117,0,3,"EUPV-EV",4
12,"12007",747,674,660,9,14,"EUPV-EV",34
12,"12117",3674,2846,2794,25,52,"EUPV-EV",83
46,"46178",4406,3235,3201,22,34,"EUPV-EV",188
12,"12090",127,109,107,2,2,"EUPV-EV",6
46,"46054",11422,8666,8566,82,100,"EUPV-EV",850
46,"46149",398,307,305,1,2,"EUPV-EV",4
46,"46198",815,660,654,4,6,"EUPV-EV",66
46,"46084",1587,1363,1332,7,31,"EUPV-EV",21
46,"46060",9510,7506,7408,52,98,"EUPV-EV",384
46,"46041",369,255,255,1,0,"EUPV-EV",24
46,"46182",1190,864,855,11,9,"EUPV-EV",71
46,"46139",4594,3794,3734,28,60,"EUPV-EV",159
46,"46047",551,479,469,10,10,"EUPV-EV",8
46,"46119",856,702,693,0,9,"EUPV-EV",38
12,"12122",835,674,658,14,16,"EUPV-EV",15
46,"46044",4301,3284,3169,50,115,"EUPV-EV",268
46,"46063",1764,1441,1423,15,18,"EUPV-EV",70
12,"12005",8066,5835,5441,116,394,"EUPV-EV",335
46,"46048",3484,2915,2875,26,40,"EUPV-EV",124
12,"12046",236,177,176,4,1,"EUPV-EV",7
46,"46188",660,579,576,4,3,"EUPV-EV",27
46,"46196",159,145,144,1,1,"EUPV-EV",2
46,"46156",2065,1746,1721,14,25,"EUPV-EV",74
46,"46164",11634,8843,8724,90,119,"EUPV-EV",668
46,"46239",457,331,323,2,8,"EUPV-EV",10
12,"12116",56,45,45,0,0,"EUPV-EV",0
46,"46088",196,146,140,0,6,"EUPV-EV",11
46,"46161",1454,1192,1179,8,13,"EUPV-EV",49
46,"46234",388,308,307,3,1,"EUPV-EV",13
46,"46202",15578,11811,11676,110,135,"EUPV-EV",741
12,"12025",146,106,105,0,1,"EUPV-EV",7
46,"46137",273,232,229,1,3,"EUPV-EV",0
12,"12063",59,42,41,0,1,"EUPV-EV",6
46,"46086",80,71,71,3,0,"EUPV-EV",6
46,"46070",15946,11979,11874,113,105,"EUPV-EV",631
12,"12060",467,367,353,2,14,"EUPV-EV",16
46,"46194",15267,11622,11491,110,131,"EUPV-EV",681
12,"12075",139,106,102,0,4,"EUPV-EV",7
46,"46105",16708,12164,12040,100,124,"EUPV-EV",483
46,"46068",326,292,285,3,7,"EUPV-EV",8
46,"46173",1393,1156,1137,10,19,"EUPV-EV",41
46,"46035",6470,5115,5047,38,68,"EUPV-EV",244
12,"12057",650,530,515,6,15,"EUPV-EV",21
46,"46076",651,541,528,2,13,"EUPV-EV",31
46,"46133",686,572,565,1,7,"EUPV-EV",22
46,"46147",16527,11836,11716,105,120,"EUPV-EV",772
12,"12138",18762,12489,12231,243,258,"EUPV-EV",549
46,"46114",565,501,495,3,6,"EUPV-EV",9
12,"12015",96,83,82,3,1,"EUPV-EV",15
12,"12065",181,155,155,0,0,"EUPV-EV",1
12,"12108",495,394,389,4,5,"EUPV-EV",10
12,"12080",2051,1692,1650,23,42,"EUPV-EV",43
46,"46174",1003,854,847,6,7,"EUPV-EV",21
46,"46106",1616,1196,1188,6,8,"EUPV-EV",109
12,"12055",112,79,78,3,1,"EUPV-EV",6
46,"46179",2186,1849,1804,17,45,"EUPV-EV",65
12,"12070",576,473,463,5,10,"EUPV-EV",10
12,"12098",665,552,539,9,13,"EUPV-EV",6
12,"12119",153,87,87,0,0,"EUPV-EV",5
12,"12058",99,74,74,0,0,"EUPV-EV",2
46,"46021",23273,17264,17091,163,173,"EUPV-EV",1323
12,"12132",524,407,401,4,6,"EUPV-EV",12
12,"12126",24420,18431,18136,231,295,"EUPV-EV",1684
12,"12064",118,91,89,1,2,"EUPV-EV",3
46,"46146",1718,1395,1374,10,21,"EUPV-EV",41
12,"12052",627,510,491,9,19,"EUPV-EV",9
46,"46210",346,300,295,4,5,"EUPV-EV",6
12,"12010",280,232,229,3,3,"EUPV-EV",13
46,"46211",1716,1459,1447,9,12,"EUPV-EV",64
12,"12127",92,64,61,0,3,"EUPV-EV",8
12,"12059",276,227,227,1,0,"EUPV-EV",23
12,"12103",85,65,65,4,0,"EUPV-EV",0
46,"46165",6962,5390,5322,53,68,"EUPV-EV",384
12,"12142",158,122,121,1,1,"EUPV-EV",1
12,"12114",228,178,173,2,5,"EUPV-EV",6
46,"46154",836,684,678,7,6,"EUPV-EV",14
46,"46140",379,314,313,0,1,"EUPV-EV",16
46,"46131",49087,37846,37477,422,369,"EUPV-EV",1941
12,"12049",471,366,344,10,22,"EUPV-EV",22
46,"46098",2556,2072,2057,12,15,"EUPV-EV",77
46,"46195",1975,1631,1631,33,0,"EUPV-EV",56
46,"46052",532,471,463,2,8,"EUPV-EV",11
12,"12124",1902,1532,1499,15,33,"EUPV-EV",13
46,"46079",381,304,299,3,5,"EUPV-EV",16
46,"46081",10254,8188,8101,52,87,"EUPV-EV",397
46,"46028",424,352,347,5,5,"EUPV-EV",8
46,"46018",689,597,592,12,5,"EUPV-EV",17
46,"46238",13401,10371,10283,96,88,"EUPV-EV",634
12,"12069",53,48,47,0,1,"EUPV-EV",1
12,"12036",668,529,514,6,15,"EUPV-EV",13
12,"12095",1027,790,775,15,15,"EUPV-EV",16
46,"46117",476,377,373,6,4,"EUPV-EV",22
46,"46128",1649,1322,1292,14,30,"EUPV-EV",55
46,"46023",318,275,267,2,8,"EUPV-EV",15
12,"12074",783,679,676,3,3,"EUPV-EV",11
12,"12067",563,458,439,8,19,"EUPV-EV",10
46,"46148",1400,1131,1114,13,17,"EUPV-EV",36
46,"46083",15427,12079,11941,109,138,"EUPV-EV",504
12,"12139",344,219,216,0,3,"EUPV-EV",8
46,"46902",425,333,332,3,1,"EUPV-EV",6
46,"46095",632,505,495,1,10,"EUPV-EV",14
46,"46236",996,853,844,7,9,"EUPV-EV",89
46,"46092",304,206,201,1,5,"EUPV-EV",3
46,"46073",1119,931,915,14,16,"EUPV-EV",35
46,"46132",2124,1845,1817,14,28,"EUPV-EV",45
46,"46108",550,446,444,3,2,"EUPV-EV",9
46,"46053",584,484,461,2,23,"EUPV-EV",18
46,"46037",1146,1007,1003,5,4,"EUPV-EV",23
12,"12133",64,47,47,0,0,"EUPV-EV",0
46,"46118",3883,3141,3105,28,36,"EUPV-EV",126
46,"46064",547,463,458,2,5,"EUPV-EV",15
12,"12028",12115,9084,8992,137,92,"EUPV-EV",522
12,"12135",35189,25691,25345,380,346,"EUPV-EV",1506
46,"46136",2476,1890,1865,16,25,"EUPV-EV",127
46,"46235",21966,16641,16465,167,176,"EUPV-EV",794
46,"46260",2576,2140,2106,24,34,"EUPV-EV",132
46,"46020",3793,3084,3046,21,38,"EUPV-EV",79
46,"46093",2082,1722,1716,9,6,"EUPV-EV",33
12,"12039",870,743,736,4,7,"EUPV-EV",33
46,"46251",2599,2215,2179,21,36,"EUPV-EV",83
12,"12034",1509,1125,1097,10,28,"EUPV-EV",27
12,"12042",664,549,530,5,19,"EUPV-EV",4
46,"46082",4661,3447,3401,46,46,"EUPV-EV",386
12,"12053",2121,1745,1719,11,26,"EUPV-EV",85
46,"46185",422,360,359,7,1,"EUPV-EV",16
46,"46221",350,319,317,3,2,"EUPV-EV",13
46,"46230",14204,10650,10515,112,135,"EUPV-EV",735
46,"46043",149,139,139,0,0,"EUPV-EV",3
46,"46189",490,400,396,3,4,"EUPV-EV",17
46,"46116",12587,9821,9724,120,97,"EUPV-EV",707
46,"46003",988,864,847,13,17,"EUPV-EV",21
46,"46228",2434,1881,1859,30,22,"EUPV-EV",124
46,"46058",1787,1460,1441,10,19,"EUPV-EV",61
46,"46217",912,758,751,4,7,"EUPV-EV",24
46,"46209",1984,1606,1594,11,12,"EUPV-EV",48
46,"46175",469,406,401,5,5,"EUPV-EV",16
12,"12131",92,78,78,1,0,"EUPV-EV",1
46,"46162",1230,1045,1027,6,18,"EUPV-EV",19
46,"46055",1286,1083,1067,11,16,"EUPV-EV",38
12,"12091",203,153,140,2,13,"EUPV-EV",7
46,"46135",9634,7671,7586,64,85,"EUPV-EV",627
46,"46141",424,338,336,2,2,"EUPV-EV",9
46,"46171",16753,12565,12399,122,166,"EUPV-EV",845
46,"46254",1085,847,834,12,13,"EUPV-EV",27
46,"46207",6453,5086,5031,52,55,"EUPV-EV",304
46,"46113",2338,1804,1797,14,7,"EUPV-EV",56
46,"46040",1227,1028,1021,13,7,"EUPV-EV",66
46,"46100",307,264,255,0,9,"EUPV-EV",8
46,"46233",3911,3025,2988,10,37,"EUPV-EV",141
12,"12061",431,324,316,6,8,"EUPV-EV",10
46,"46160",1976,1591,1570,21,21,"EUPV-EV",83
46,"46019",8671,7195,7109,70,86,"EUPV-EV",259
12,"12120",218,180,177,0,3,"EUPV-EV",2
46,"46246",1081,917,904,5,13,"EUPV-EV",16
46,"46197",1902,1559,1554,15,5,"EUPV-EV",407
46,"46009",3140,2521,2498,15,23,"EUPV-EV",116
12,"12073",168,135,135,1,0,"EUPV-EV",7
46,"46089",2116,1653,1627,9,26,"EUPV-EV",46
12,"12014",191,139,137,4,2,"EUPV-EV",6
12,"12017",183,143,141,6,2,"EUPV-EV",3
46,"46087",137,105,105,1,0,"EUPV-EV",5
46,"46050",161,126,123,1,3,"EUPV-EV",2
46,"46155",1072,861,849,4,12,"EUPV-EV",22
46,"46249",9650,7288,7191,125,97,"EUPV-EV",477
46,"46006",4643,3847,3785,32,62,"EUPV-EV",115
46,"46176",1965,1423,1405,12,18,"EUPV-EV",56
12,"12022",367,282,279,4,3,"EUPV-EV",18
46,"46257",5579,4546,4512,32,34,"EUPV-EV",380
46,"46227",923,787,771,4,16,"EUPV-EV",40
46,"46067",1798,1487,1472,10,15,"EUPV-EV",46
46,"46214",15129,11609,11500,116,109,"EUPV-EV",816
46,"46218",1082,964,936,5,28,"EUPV-EV",23
46,"46240",226,188,185,3,3,"EUPV-EV",9
46,"46186",18444,14173,14029,135,144,"EUPV-EV",1002
46,"46134",2326,1691,1664,20,27,"EUPV-EV",125
46,"46263",333,243,241,2,2,"EUPV-EV",4
12,"12021",4433,3368,3292,42,76,"EUPV-EV",223
46,"46213",15621,11361,11164,214,197,"EUPV-EV",684
46,"46181",17153,13332,13184,108,148,"EUPV-EV",548
46,"46059",1310,1076,1058,2,18,"EUPV-EV",179
46,"46166",8260,6422,6324,60,98,"EUPV-EV",474
12,"12128",1448,1114,1092,16,22,"EUPV-EV",54
46,"46039",2200,1849,1820,12,29,"EUPV-EV",118
12,"12029",760,619,601,7,18,"EUPV-EV",20
46,"46030",800,677,662,6,15,"EUPV-EV",32
46,"46224",179,131,128,0,3,"EUPV-EV",10
46,"46225",360,319,310,5,9,"EUPV-EV",7
46,"46033",220,183,181,0,2,"EUPV-EV",2
12,"12094",807,612,604,14,8,"EUPV-EV",41
46,"46127",2790,2298,2267,23,31,"EUPV-EV",76
12,"12110",253,199,195,3,4,"EUPV-EV",5
46,"46167",411,312,309,0,3,"EUPV-EV",18
12,"12018",326,274,265,1,9,"EUPV-EV",5
12,"12033",1970,1547,1509,8,38,"EUPV-EV",55
12,"12044",527,472,463,4,9,"EUPV-EV",1
46,"46200",1915,1625,1595,15,30,"EUPV-EV",37
46,"46008",2727,2249,2233,17,16,"EUPV-EV",240
46,"46111",10589,7823,7710,94,113,"EUPV-EV",485
12,"12104",6981,5464,5357,54,107,"EUPV-EV",305
46,"46014",3092,2449,2420,26,29,"EUPV-EV",176
12,"12038",195,135,134,8,1,"EUPV-EV",3
46,"46011",7727,5874,5777,75,97,"EUPV-EV",309
46,"46205",14277,10882,10764,115,118,"EUPV-EV",785
46,"46074",2656,2071,2053,22,18,"EUPV-EV",135
46,"46124",768,641,632,10,9,"EUPV-EV",17
12,"12083",106,89,88,0,1,"EUPV-EV",0
12,"12056",304,259,254,7,5,"EUPV-EV",21
12,"12101",385,309,296,3,13,"EUPV-EV",7
46,"46203",3669,3002,2964,36,38,"EUPV-EV",243
46,"46051",8122,6432,6378,57,54,"EUPV-EV",320
12,"12130",425,348,344,2,4,"EUPV-EV",4
12,"12140",1204,975,954,9,21,"EUPV-EV",80
20,"20054",476,350,348,1,2,"E.A.J.-P.N.V.",47
20,"20070",1109,817,815,4,2,"E.A.J.-P.N.V.",223
20,"20046",1157,734,729,6,5,"E.A.J.-P.N.V.",153
1,"1049",147,115,115,1,0,"E.A.J.-P.N.V.",43
20,"20064",12380,7568,7464,112,104,"E.A.J.-P.N.V.",1247
1,"1056",256,183,181,1,2,"E.A.J.-P.N.V.",88
1,"1011",245,189,185,7,4,"E.A.J.-P.N.V.",55
20,"20080",8104,5497,5454,52,43,"E.A.J.-P.N.V.",1052
20,"20034",3192,2035,2030,11,5,"E.A.J.-P.N.V.",415
20,"20025",1174,814,803,4,11,"E.A.J.-P.N.V.",287
1,"1006",181,133,127,2,6,"E.A.J.-P.N.V.",8
20,"20022",832,527,521,9,6,"E.A.J.-P.N.V.",141
1,"1004",1427,1021,996,15,25,"E.A.J.-P.N.V.",334
1,"1044",242,174,173,1,1,"E.A.J.-P.N.V.",35
20,"20042",3354,2131,2117,18,14,"E.A.J.-P.N.V.",399
20,"20029",4283,3014,2998,26,16,"E.A.J.-P.N.V.",887
20,"20056",3975,2692,2669,17,23,"E.A.J.-P.N.V.",900
20,"20052",1154,849,847,14,2,"E.A.J.-P.N.V.",234
20,"20902",14148,9874,9798,120,76,"E.A.J.-P.N.V.",1424
20,"20067",31173,20218,20017,270,201,"E.A.J.-P.N.V.",2726
20,"20066",467,316,316,0,0,"E.A.J.-P.N.V.",61
20,"20043",1782,1220,1214,13,6,"E.A.J.-P.N.V.",427
20,"20012",149,97,97,0,0,"E.A.J.-P.N.V.",31
20,"20035",497,346,344,1,2,"E.A.J.-P.N.V.",92
1,"1063",1803,1290,1284,18,6,"E.A.J.-P.N.V.",393
1,"1058",1342,877,872,8,5,"E.A.J.-P.N.V.",203
20,"20010",1392,949,941,8,8,"E.A.J.-P.N.V.",181
20,"20068",199,132,129,2,3,"E.A.J.-P.N.V.",34
1,"1009",1296,876,863,9,13,"E.A.J.-P.N.V.",231
20,"20019",10105,6640,6555,73,85,"E.A.J.-P.N.V.",1925
20,"20017",8670,5923,5890,27,33,"E.A.J.-P.N.V.",1764
1,"1043",2322,1623,1595,12,28,"E.A.J.-P.N.V.",231
1,"1039",211,164,158,1,6,"E.A.J.-P.N.V.",43
1,"1014",385,281,274,6,7,"E.A.J.-P.N.V.",70
20,"20071",14488,9499,9419,93,80,"E.A.J.-P.N.V.",2819
1,"1901",2254,1561,1528,24,33,"E.A.J.-P.N.V.",239
1,"1052",240,191,191,1,0,"E.A.J.-P.N.V.",76
20,"20036",12731,8519,8431,131,88,"E.A.J.-P.N.V.",3059
1,"1060",223,181,178,1,3,"E.A.J.-P.N.V.",47
20,"20079",17229,12010,11927,143,83,"E.A.J.-P.N.V.",3607
1,"1036",15236,10511,10372,141,139,"E.A.J.-P.N.V.",2815
1,"1062",333,236,232,5,4,"E.A.J.-P.N.V.",50
1,"1018",1395,952,943,7,9,"E.A.J.-P.N.V.",233
20,"20061",4011,2666,2653,23,13,"E.A.J.-P.N.V.",1008
1,"1033",679,537,532,2,5,"E.A.J.-P.N.V.",212
1,"1055",906,632,623,7,9,"E.A.J.-P.N.V.",182
1,"1021",473,332,324,3,8,"E.A.J.-P.N.V.",95
20,"20058",770,549,547,3,2,"E.A.J.-P.N.V.",122
20,"20011",1700,1265,1258,11,7,"E.A.J.-P.N.V.",292
1,"1032",536,412,400,0,12,"E.A.J.-P.N.V.",118
20,"20047",494,321,319,2,2,"E.A.J.-P.N.V.",82
1,"1028",1106,773,760,8,13,"E.A.J.-P.N.V.",133
20,"20031",179,114,113,1,1,"E.A.J.-P.N.V.",31
1,"1051",3662,2242,2210,26,32,"E.A.J.-P.N.V.",550
1,"1027",430,283,276,4,7,"E.A.J.-P.N.V.",85
20,"20074",11660,8003,7951,31,52,"E.A.J.-P.N.V.",2088
1,"1031",1229,916,899,13,17,"E.A.J.-P.N.V.",185
20,"20030",22191,15262,15148,164,114,"E.A.J.-P.N.V.",3504
20,"20059",8816,6335,6293,32,42,"E.A.J.-P.N.V.",1881
1,"1042",915,678,661,1,17,"E.A.J.-P.N.V.",239
20,"20907",136,94,94,0,0,"E.A.J.-P.N.V.",18
20,"20026",214,172,172,0,0,"E.A.J.-P.N.V.",69
20,"20027",2809,1929,1918,25,11,"E.A.J.-P.N.V.",555
20,"20903",3625,2282,2267,52,15,"E.A.J.-P.N.V.",486
1,"1001",2010,1362,1336,26,26,"E.A.J.-P.N.V.",293
1,"1059",183468,127839,125801,1422,2038,"E.A.J.-P.N.V.",20038
20,"20002",347,237,237,8,0,"E.A.J.-P.N.V.",42
1,"1016",461,241,237,2,4,"E.A.J.-P.N.V.",66
20,"20038",382,281,280,1,1,"E.A.J.-P.N.V.",76
20,"20033",884,650,641,4,9,"E.A.J.-P.N.V.",182
1,"1057",266,212,212,2,0,"E.A.J.-P.N.V.",90
20,"20904",98,67,66,0,1,"E.A.J.-P.N.V.",7
20,"20041",279,153,151,5,2,"E.A.J.-P.N.V.",39
1,"1054",959,680,675,8,5,"E.A.J.-P.N.V.",193
20,"20906",117,89,89,0,0,"E.A.J.-P.N.V.",26
20,"20078",1146,885,884,6,1,"E.A.J.-P.N.V.",148
20,"20007",300,203,202,2,1,"E.A.J.-P.N.V.",42
20,"20905",142,105,103,1,2,"E.A.J.-P.N.V.",30
20,"20023",451,260,259,2,1,"E.A.J.-P.N.V.",35
20,"20039",2003,1517,1512,9,5,"E.A.J.-P.N.V.",589
20,"20055",17856,11885,11791,91,94,"E.A.J.-P.N.V.",2415
20,"20028",2204,1400,1379,11,21,"E.A.J.-P.N.V.",268
1,"1017",910,629,621,17,8,"E.A.J.-P.N.V.",182
1,"1034",177,140,137,1,3,"E.A.J.-P.N.V.",46
1,"1053",590,341,333,4,8,"E.A.J.-P.N.V.",100
1,"1002",8057,5854,5757,48,97,"E.A.J.-P.N.V.",1866
20,"20015",1307,980,979,13,1,"E.A.J.-P.N.V.",273
1,"1023",290,236,235,1,1,"E.A.J.-P.N.V.",66
1,"1037",625,403,398,6,5,"E.A.J.-P.N.V.",126
20,"20075",4447,2823,2798,32,25,"E.A.J.-P.N.V.",564
20,"20062",995,687,667,5,20,"E.A.J.-P.N.V.",227
20,"20060",92,83,82,0,1,"E.A.J.-P.N.V.",2
20,"20024",400,238,235,0,3,"E.A.J.-P.N.V.",57
20,"20037",100,65,64,2,1,"E.A.J.-P.N.V.",21
20,"20901",1468,951,947,13,4,"E.A.J.-P.N.V.",289
20,"20050",293,213,211,3,2,"E.A.J.-P.N.V.",48
20,"20001",249,167,167,4,0,"E.A.J.-P.N.V.",55
20,"20077",5382,3766,3741,42,25,"E.A.J.-P.N.V.",973
20,"20049",4081,2741,2723,30,18,"E.A.J.-P.N.V.",582
20,"20044",368,258,257,1,1,"E.A.J.-P.N.V.",70
20,"20003",547,361,359,3,2,"E.A.J.-P.N.V.",77
20,"20051",7033,4843,4779,57,64,"E.A.J.-P.N.V.",1206
20,"20072",4643,2967,2948,46,19,"E.A.J.-P.N.V.",675
1,"1047",942,674,655,4,19,"E.A.J.-P.N.V.",131
20,"20073",4689,3196,3176,28,20,"E.A.J.-P.N.V.",542
1,"1020",317,222,220,0,2,"E.A.J.-P.N.V.",89
20,"20018",11027,7428,7387,53,41,"E.A.J.-P.N.V.",2372
20,"20006",277,177,175,6,2,"E.A.J.-P.N.V.",51
20,"20014",1101,660,654,8,6,"E.A.J.-P.N.V.",139
1,"1013",711,477,474,1,3,"E.A.J.-P.N.V.",146
1,"1046",629,428,421,5,7,"E.A.J.-P.N.V.",124
1,"1008",781,566,546,7,20,"E.A.J.-P.N.V.",166
1,"1003",1199,863,848,2,15,"E.A.J.-P.N.V.",195
20,"20005",1341,890,885,4,5,"E.A.J.-P.N.V.",198
20,"20081",7346,4957,4925,35,32,"E.A.J.-P.N.V.",1525
1,"1010",2276,1649,1618,27,31,"E.A.J.-P.N.V.",566
20,"20032",8949,6189,6117,55,72,"E.A.J.-P.N.V.",1896
20,"20057",194,122,122,0,0,"E.A.J.-P.N.V.",30
1,"1902",776,532,526,6,6,"E.A.J.-P.N.V.",136
20,"20004",254,153,153,5,0,"E.A.J.-P.N.V.",63
1,"1061",155,122,122,2,0,"E.A.J.-P.N.V.",47
20,"20048",175,102,102,1,0,"E.A.J.-P.N.V.",18
20,"20063",7889,5381,5340,48,41,"E.A.J.-P.N.V.",973
1,"1019",155,124,124,0,0,"E.A.J.-P.N.V.",73
20,"20065",3176,2156,2137,19,19,"E.A.J.-P.N.V.",473
20,"20021",216,122,122,0,0,"E.A.J.-P.N.V.",25
20,"20009",11794,7805,7725,103,80,"E.A.J.-P.N.V.",1352
20,"20040",15103,9781,9686,148,95,"E.A.J.-P.N.V.",1534
20,"20013",5331,3662,3637,33,25,"E.A.J.-P.N.V.",852
1,"1041",159,116,113,1,3,"E.A.J.-P.N.V.",26
20,"20020",143,104,104,1,0,"E.A.J.-P.N.V.",37
20,"20008",757,499,499,8,0,"E.A.J.-P.N.V.",107
20,"20016",1526,937,932,4,5,"E.A.J.-P.N.V.",386
1,"1030",170,123,120,1,3,"E.A.J.-P.N.V.",34
20,"20045",46542,30907,30536,425,371,"E.A.J.-P.N.V.",5384
20,"20076",6978,4823,4762,38,61,"E.A.J.-P.N.V.",1163
1,"1022",826,615,602,6,13,"E.A.J.-P.N.V.",85
20,"20069",146828,101992,101225,1287,767,"E.A.J.-P.N.V.",20588
20,"20053",4830,2895,2868,36,27,"E.A.J.-P.N.V.",450
48,"48081",1938,1449,1435,14,14,"EAJ-PNV",730
48,"48085",9893,6960,6885,93,75,"EAJ-PNV",2471
48,"48061",773,585,582,6,3,"EAJ-PNV",291
48,"48025",882,652,644,2,8,"EAJ-PNV",329
48,"48024",1026,845,841,3,4,"EAJ-PNV",406
48,"48007",354,254,253,1,1,"EAJ-PNV",107
48,"48008",600,432,428,3,4,"EAJ-PNV",271
48,"48902",19232,12809,12633,182,176,"EAJ-PNV",4424
48,"48017",13554,9303,9234,64,69,"EAJ-PNV",4611
48,"48029",8022,5488,5409,83,79,"EAJ-PNV",1391
48,"48092",792,603,600,5,3,"EAJ-PNV",325
48,"48006",285,246,243,3,3,"EAJ-PNV",107
48,"48062",317,263,262,1,1,"EAJ-PNV",137
48,"48060",3689,2477,2466,12,11,"EAJ-PNV",1079
48,"48912",2340,1794,1776,22,18,"EAJ-PNV",800
48,"48909",194,163,163,0,0,"EAJ-PNV",59
48,"48011",9742,6697,6628,82,69,"EAJ-PNV",2211
48,"48027",21610,15409,15274,145,135,"EAJ-PNV",5218
48,"48068",1577,1224,1213,4,11,"EAJ-PNV",706
48,"48034",13160,9290,9189,82,101,"EAJ-PNV",1225
48,"48045",5060,3912,3849,31,63,"EAJ-PNV",1755
48,"48088",148,110,109,0,1,"EAJ-PNV",30
48,"48023",601,499,492,4,7,"EAJ-PNV",209
48,"48003",14142,10268,10167,84,101,"EAJ-PNV",3761
48,"48040",1274,936,921,10,15,"EAJ-PNV",463
48,"48001",5842,4040,4020,23,20,"EAJ-PNV",952
48,"48094",3299,2398,2377,15,21,"EAJ-PNV",1004
48,"48082",38551,25768,25482,316,286,"EAJ-PNV",7467
48,"48049",564,446,446,2,0,"EAJ-PNV",229
48,"48013",81335,54452,53803,771,649,"EAJ-PNV",11914
48,"48906",796,625,622,5,3,"EAJ-PNV",273
48,"48065",3311,2340,2323,23,17,"EAJ-PNV",921
48,"48910",3063,2122,2104,14,18,"EAJ-PNV",596
48,"48903",1909,1455,1430,4,25,"EAJ-PNV",822
48,"48059",397,289,286,0,3,"EAJ-PNV",130
48,"48055",2620,1954,1934,22,20,"EAJ-PNV",675
48,"48071",6097,4307,4224,61,83,"EAJ-PNV",1656
48,"48019",3741,2613,2595,24,18,"EAJ-PNV",843
48,"48908",242,194,194,1,0,"EAJ-PNV",97
48,"48077",3398,2490,2477,33,13,"EAJ-PNV",1214
48,"48004",329,240,239,2,1,"EAJ-PNV",116
48,"48914",324,278,276,0,2,"EAJ-PNV",143
48,"48012",2036,1630,1616,9,14,"EAJ-PNV",886
48,"48097",1359,936,915,9,21,"EAJ-PNV",349
48,"48014",1211,838,834,4,4,"EAJ-PNV",354
48,"48901",4370,3156,3124,46,32,"EAJ-PNV",1201
48,"48052",1526,1213,1205,7,8,"EAJ-PNV",462
48,"48038",1087,826,821,7,5,"EAJ-PNV",391
48,"48021",1460,1024,1012,13,12,"EAJ-PNV",455
48,"48070",559,413,407,1,6,"EAJ-PNV",133
48,"48028",767,623,621,1,2,"EAJ-PNV",264
48,"48051",225,157,156,0,1,"EAJ-PNV",64
48,"48074",3384,2441,2397,20,44,"EAJ-PNV",887
48,"48050",216,173,172,0,1,"EAJ-PNV",58
48,"48015",34932,24209,23966,296,243,"EAJ-PNV",6911
48,"48016",5214,3782,3736,46,46,"EAJ-PNV",1279
48,"48090",6153,4682,4571,40,111,"EAJ-PNV",1990
48,"48030",626,487,483,0,4,"EAJ-PNV",218
48,"48066",350,277,277,0,0,"EAJ-PNV",172
48,"48913",1231,936,922,10,14,"EAJ-PNV",484
48,"48907",351,290,290,1,0,"EAJ-PNV",153
48,"48096",6607,5007,4900,54,107,"EAJ-PNV",2321
48,"48022",2396,1524,1504,12,20,"EAJ-PNV",806
48,"48057",5934,4407,4385,27,22,"EAJ-PNV",1631
48,"48083",7021,4722,4656,74,66,"EAJ-PNV",1483
48,"48091",1170,860,851,3,9,"EAJ-PNV",269
48,"48056",849,610,608,3,2,"EAJ-PNV",335
48,"48067",1204,895,892,4,3,"EAJ-PNV",402
48,"48041",721,588,585,9,3,"EAJ-PNV",309
48,"48005",93,65,64,0,1,"EAJ-PNV",27
48,"48009",767,585,580,4,5,"EAJ-PNV",258
48,"48036",23973,16491,16344,179,147,"EAJ-PNV",5719
48,"48033",223,171,171,1,0,"EAJ-PNV",86
48,"48915",362,273,271,2,2,"EAJ-PNV",114
48,"48044",63869,47453,47085,511,368,"EAJ-PNV",15362
48,"48072",1009,796,787,3,9,"EAJ-PNV",258
48,"48010",427,303,300,2,3,"EAJ-PNV",162
48,"48054",23712,16643,16439,215,204,"EAJ-PNV",5571
48,"48080",10161,6901,6815,95,86,"EAJ-PNV",2092
48,"48084",23491,15322,15084,213,238,"EAJ-PNV",3554
48,"48095",2367,1593,1577,20,16,"EAJ-PNV",360
48,"48046",12635,9231,9161,61,70,"EAJ-PNV",3637
48,"48020",276378,191777,190141,2335,1636,"EAJ-PNV",59604
48,"48037",727,528,519,2,9,"EAJ-PNV",273
48,"48026",1093,881,875,3,6,"EAJ-PNV",343
48,"48904",3510,2682,2665,26,17,"EAJ-PNV",1339
48,"48063",355,287,287,6,0,"EAJ-PNV",124
48,"48087",463,371,370,4,1,"EAJ-PNV",215
48,"48086",2087,1432,1420,11,12,"EAJ-PNV",542
48,"48073",7090,4865,4802,37,63,"EAJ-PNV",1564
48,"48039",263,217,216,4,1,"EAJ-PNV",107
48,"48048",547,423,423,5,0,"EAJ-PNV",199
48,"48042",1401,1116,1099,15,17,"EAJ-PNV",589
48,"48002",7971,5377,5290,65,87,"EAJ-PNV",1804
48,"48093",893,707,695,1,12,"EAJ-PNV",297
48,"48035",379,304,301,0,3,"EAJ-PNV",160
48,"48905",2600,1903,1869,14,34,"EAJ-PNV",844
48,"48058",977,706,700,2,6,"EAJ-PNV",218
48,"48018",905,591,587,8,4,"EAJ-PNV",232
48,"48075",1915,1362,1325,15,37,"EAJ-PNV",664
48,"48047",161,126,126,1,0,"EAJ-PNV",34
48,"48064",599,490,490,1,0,"EAJ-PNV",200
48,"48089",2878,2120,2089,19,31,"EAJ-PNV",875
48,"48911",373,300,296,1,4,"EAJ-PNV",87
48,"48076",294,226,226,0,0,"EAJ-PNV",138
48,"48053",856,683,680,8,3,"EAJ-PNV",356
48,"48069",12381,8760,8672,66,88,"EAJ-PNV",4266
48,"48079",470,391,391,2,0,"EAJ-PNV",200
48,"48043",4256,3066,3040,33,26,"EAJ-PNV",1406
48,"48078",39866,27311,26995,311,316,"EAJ-PNV",6560
48,"48032",5864,4257,4223,32,34,"EAJ-PNV",1233
48,"48031",370,296,296,1,0,"EAJ-PNV",159
5,"5256",119,101,100,0,1,"FE de las JONS",1
47,"47191",113,81,80,1,1,"FE de las JONS",0
34,"34174",213,179,178,4,1,"FE de las JONS",1
34,"34086",105,89,89,1,0,"FE de las JONS",0
14,"14047",1566,1154,1143,19,11,"FE de las JONS",1
34,"34141",190,162,160,0,2,"FE de las JONS",0
34,"34018",229,184,182,3,2,"FE de las JONS",4
40,"40195",946,722,707,13,15,"FE de las JONS",2
34,"34136",192,122,122,1,0,"FE de las JONS",0
40,"40084",65,53,53,2,0,"FE de las JONS",0
14,"14026",2043,1434,1421,10,13,"FE de las JONS",0
47,"47106",63,52,52,0,0,"FE de las JONS",0
47,"47116",426,363,358,0,5,"FE de las JONS",1
5,"5159",287,216,216,0,0,"FE de las JONS",1
41,"41055",15121,11082,10997,98,85,"FE de las JONS",1
47,"47038",128,91,91,0,0,"FE de las JONS",1
34,"34182",860,657,649,8,8,"FE de las JONS",3
41,"41035",1171,898,889,12,9,"FE de las JONS",0
40,"40008",44,37,36,0,1,"FE de las JONS",0
14,"14034",367,301,292,1,9,"FE de las JONS",1
47,"47179",408,315,306,6,9,"FE de las JONS",0
47,"47216",124,99,98,2,1,"FE de las JONS",6
5,"5226",92,67,67,0,0,"FE de las JONS",0
14,"14030",8519,6832,6753,64,79,"FE de las JONS",2
40,"40184",269,227,224,4,3,"FE de las JONS",0
40,"40154",23,21,21,1,0,"FE de las JONS",0
40,"40230",117,92,90,1,2,"FE de las JONS",1
47,"47091",97,82,80,3,2,"FE de las JONS",0
47,"47222",92,77,77,4,0,"FE de las JONS",0
47,"47227",62,52,52,1,0,"FE de las JONS",0
40,"40070",137,91,91,0,0,"FE de las JONS",0
41,"41017",13878,10053,9926,130,127,"FE de las JONS",10
34,"34155",142,118,117,3,1,"FE de las JONS",0
34,"34055",288,215,212,4,3,"FE de las JONS",0
5,"5082",569,467,462,1,5,"FE de las JONS",2
34,"34234",72,56,55,1,1,"FE de las JONS",0
41,"41014",2484,1956,1936,13,20,"FE de las JONS",0
40,"40012",280,215,213,2,2,"FE de las JONS",0
40,"40022",210,154,151,2,3,"FE de las JONS",0
5,"5115",590,458,450,1,8,"FE de las JONS",1
5,"5148",34,27,27,0,0,"FE de las JONS",0
40,"40139",302,243,238,5,5,"FE de las JONS",0
41,"41053",20729,16178,15971,142,207,"FE de las JONS",7
14,"14070",1385,1131,1111,4,20,"FE de las JONS",2
41,"41047",9810,7427,7321,99,106,"FE de las JONS",9
5,"5166",235,181,178,1,3,"FE de las JONS",0
5,"5056",94,78,73,1,5,"FE de las JONS",0
14,"14006",1326,1170,1148,12,22,"FE de las JONS",0
5,"5242",692,556,553,18,3,"FE de las JONS",0
34,"34071",186,160,160,1,0,"FE de las JONS",0
14,"14016",1406,1123,1115,9,8,"FE de las JONS",0
41,"41090",3488,2792,2751,22,41,"FE de las JONS",1
40,"40144",19,17,17,1,0,"FE de las JONS",0
47,"47043",330,267,264,1,3,"FE de las JONS",0
47,"47102",302,250,248,3,2,"FE de las JONS",0
5,"5905",253,200,198,1,2,"FE de las JONS",0
5,"5067",85,68,68,0,0,"FE de las JONS",0
5,"5218",148,123,117,1,6,"FE de las JONS",0
47,"47229",235,161,161,1,0,"FE de las JONS",0
34,"34039",66,57,56,0,1,"FE de las JONS",0
34,"34168",60,56,56,0,0,"FE de las JONS",0
41,"41001",1642,1314,1302,10,12,"FE de las JONS",0
5,"5079",68,52,50,1,2,"FE de las JONS",0
34,"34902",146,121,121,1,0,"FE de las JONS",0
41,"41079",9349,7095,7001,71,94,"FE de las JONS",4
41,"41094",6089,4757,4680,47,77,"FE de las JONS",6
5,"5156",260,188,185,0,3,"FE de las JONS",0
5,"5219",45,33,33,0,0,"FE de las JONS",0
40,"40204",187,139,134,4,5,"FE de las JONS",0
5,"5204",654,521,516,7,5,"FE de las JONS",4
47,"47061",266,227,223,0,4,"FE de las JONS",0
5,"5183",165,142,140,0,2,"FE de las JONS",0
40,"40174",402,292,290,5,2,"FE de las JONS",0
5,"5010",173,141,134,2,7,"FE de las JONS",1
5,"5093",431,330,329,1,1,"FE de las JONS",3
40,"40183",148,127,127,0,0,"FE de las JONS",1
5,"5147",174,141,135,4,6,"FE de las JONS",0
5,"5144",92,66,66,4,0,"FE de las JONS",0
40,"40149",563,446,434,9,12,"FE de las JONS",0
40,"40164",188,145,142,0,3,"FE de las JONS",0
5,"5222",155,132,132,1,0,"FE de las JONS",0
41,"41009",1272,914,899,8,15,"FE de las JONS",0
40,"40170",1383,1091,1072,11,19,"FE de las JONS",2
47,"47183",150,125,122,0,3,"FE de las JONS",0
41,"41057",299,191,189,0,2,"FE de las JONS",1
14,"14012",6305,4749,4690,44,59,"FE de las JONS",1
34,"34222",122,94,94,2,0,"FE de las JONS",0
34,"34076",632,524,520,13,4,"FE de las JONS",1
34,"34124",70,55,55,1,0,"FE de las JONS",0
34,"34001",36,29,29,2,0,"FE de las JONS",0
40,"40168",36,27,27,0,0,"FE de las JONS",0
5,"5125",60,52,52,0,0,"FE de las JONS",0
5,"5240",3351,2472,2428,22,44,"FE de las JONS",6
40,"40231",128,102,100,3,2,"FE de las JONS",1
47,"47096",139,109,107,0,2,"FE de las JONS",0
5,"5060",127,108,105,1,3,"FE de las JONS",0
5,"5172",147,122,122,0,0,"FE de las JONS",0
41,"41064",5629,4041,4006,28,35,"FE de las JONS",0
5,"5165",386,292,280,7,12,"FE de las JONS",0
41,"41049",8898,6881,6812,95,69,"FE de las JONS",8
47,"47203",69,57,56,0,1,"FE de las JONS",0
47,"47040",67,51,50,0,1,"FE de las JONS",0
40,"40054",145,103,102,1,1,"FE de las JONS",0
41,"41038",96442,66696,65945,1021,751,"FE de las JONS",84
47,"47210",396,324,321,5,3,"FE de las JONS",1
34,"34129",191,144,142,0,2,"FE de las JONS",1
40,"40180",319,259,255,3,4,"FE de las JONS",1
40,"40150",76,62,62,1,0,"FE de las JONS",0
14,"14003",1289,1046,1026,12,20,"FE de las JONS",0
34,"34087",108,88,87,1,1,"FE de las JONS",0
5,"5161",638,525,522,0,3,"FE de las JONS",2
41,"41052",2967,2305,2288,7,17,"FE de las JONS",1
41,"41050",5102,4224,4183,39,41,"FE de las JONS",1
34,"34202",28,21,21,0,0,"FE de las JONS",2
47,"47017",205,177,176,1,1,"FE de las JONS",0
5,"5112",125,88,87,0,1,"FE de las JONS",0
5,"5038",131,88,84,0,4,"FE de las JONS",0
47,"47153",135,94,93,1,1,"FE de las JONS",0
34,"34233",158,128,128,3,0,"FE de las JONS",1
40,"40901",379,292,288,11,4,"FE de las JONS",0
5,"5127",715,601,596,4,5,"FE de las JONS",1
5,"5257",153,105,104,0,1,"FE de las JONS",0
34,"34022",1136,926,908,5,18,"FE de las JONS",0
47,"47133",2382,1861,1841,30,20,"FE de las JONS",4
5,"5155",60,44,44,1,0,"FE de las JONS",0
40,"40131",48,41,41,0,0,"FE de las JONS",0
47,"47132",45,40,40,0,0,"FE de las JONS",0
40,"40071",52,45,45,4,0,"FE de las JONS",0
40,"40123",168,130,126,3,4,"FE de las JONS",0
5,"5126",78,70,70,0,0,"FE de las JONS",0
47,"47149",44,22,20,0,2,"FE de las JONS",0
5,"5221",398,298,297,10,1,"FE de las JONS",0
5,"5041",1051,840,827,13,13,"FE de las JONS",0
34,"34102",226,187,185,3,2,"FE de las JONS",0
41,"41903",6653,5134,5070,61,64,"FE de las JONS",3
40,"40214",243,204,199,0,5,"FE de las JONS",0
47,"47219",46,36,36,1,0,"FE de las JONS",0
5,"5022",1649,1335,1328,7,7,"FE de las JONS",1
5,"5154",46,35,35,0,0,"FE de las JONS",0
5,"5179",231,206,204,2,2,"FE de las JONS",0
14,"14005",6334,4262,4206,61,56,"FE de las JONS",1
40,"40074",271,221,218,3,3,"FE de las JONS",0
40,"40089",248,183,177,3,6,"FE de las JONS",0
40,"40047",47,37,36,0,1,"FE de las JONS",0
41,"41012",3115,2314,2271,29,43,"FE de las JONS",2
40,"40026",114,98,97,2,1,"FE de las JONS",0
5,"5051",194,165,154,0,11,"FE de las JONS",0
47,"47056",90,69,69,2,0,"FE de las JONS",0
34,"34175",101,80,80,2,0,"FE de las JONS",1
5,"5052",102,91,91,0,0,"FE de las JONS",0
34,"34048",72,58,56,3,2,"FE de las JONS",0
40,"40200",47,41,39,0,2,"FE de las JONS",0
47,"47105",210,181,179,1,2,"FE de las JONS",0
40,"40033",61,48,47,3,1,"FE de las JONS",0
40,"40127",45,33,33,0,0,"FE de las JONS",0
47,"47099",174,153,153,4,0,"FE de las JONS",0
47,"47046",124,105,103,0,2,"FE de las JONS",0
47,"47048",204,168,167,2,1,"FE de las JONS",2
34,"34130",228,187,186,6,1,"FE de las JONS",0
40,"40157",74,51,50,2,1,"FE de las JONS",0
40,"40142",53,43,41,1,2,"FE de las JONS",0
41,"41098",4650,3665,3603,43,62,"FE de las JONS",7
47,"47115",306,248,248,2,0,"FE de las JONS",0
47,"47130",105,86,85,2,1,"FE de las JONS",0
5,"5214",46,23,23,1,0,"FE de las JONS",0
34,"34160",154,119,116,0,3,"FE de las JONS",0
47,"47184",575,447,443,6,4,"FE de las JONS",0
40,"40194",40248,30946,30365,525,581,"FE de las JONS",94
34,"34032",47,36,36,1,0,"FE de las JONS",0
40,"40010",140,117,117,0,0,"FE de las JONS",0
47,"47045",839,636,632,3,4,"FE de las JONS",1
14,"14069",7733,5910,5824,68,86,"FE de las JONS",1
40,"40138",2195,1758,1725,18,33,"FE de las JONS",4
41,"41018",9457,6940,6867,66,73,"FE de las JONS",6
34,"34058",212,179,178,0,1,"FE de las JONS",0
5,"5045",104,82,82,0,0,"FE de las JONS",0
5,"5129",153,98,95,0,3,"FE de las JONS",0
14,"14067",3821,3105,3082,38,23,"FE de las JONS",2
14,"14040",3821,2986,2949,40,37,"FE de las JONS",2
5,"5140",112,100,99,1,1,"FE de las JONS",1
14,"14043",7664,5935,5874,53,61,"FE de las JONS",2
41,"41102",14343,11050,10837,206,213,"FE de las JONS",8
5,"5205",78,59,58,0,1,"FE de las JONS",0
5,"5048",131,112,111,0,1,"FE de las JONS",0
5,"5063",48,39,39,2,0,"FE de las JONS",0
47,"47140",132,109,108,1,1,"FE de las JONS",0
47,"47031",203,149,149,0,0,"FE de las JONS",0
47,"47139",1080,845,833,11,12,"FE de las JONS",0
5,"5083",155,120,113,1,7,"FE de las JONS",0
5,"5149",128,97,97,1,0,"FE de las JONS",0
40,"40215",109,94,91,0,3,"FE de las JONS",1
47,"47022",62,54,54,0,0,"FE de las JONS",0
5,"5224",104,90,90,0,0,"FE de las JONS",1
5,"5175",190,149,149,2,0,"FE de las JONS",0
34,"34081",53,42,41,0,1,"FE de las JONS",0
5,"5123",90,69,69,3,0,"FE de las JONS",0
47,"47028",31,21,20,0,1,"FE de las JONS",0
5,"5191",124,98,98,2,0,"FE de las JONS",0
47,"47209",43,33,33,0,0,"FE de las JONS",0
14,"14029",4380,3344,3308,35,36,"FE de las JONS",3
47,"47026",59,46,46,1,0,"FE de las JONS",0
34,"34180",84,68,68,0,0,"FE de las JONS",1
41,"41045",5505,3946,3889,68,57,"FE de las JONS",4
47,"47223",172,147,147,6,0,"FE de las JONS",0
34,"34010",560,458,451,7,7,"FE de las JONS",3
5,"5078",128,112,111,2,1,"FE de las JONS",0
40,"40006",23,20,20,0,0,"FE de las JONS",0
5,"5158",410,333,331,2,2,"FE de las JONS",2
5,"5232",106,84,80,1,4,"FE de las JONS",0
5,"5014",5559,4197,4101,53,96,"FE de las JONS",5
14,"14025",3061,2547,2517,13,30,"FE de las JONS",0
47,"47088",121,100,100,0,0,"FE de las JONS",0
40,"40057",1522,1272,1260,19,12,"FE de las JONS",3
34,"34099",56,49,47,1,2,"FE de las JONS",0
47,"47170",40,30,30,0,0,"FE de las JONS",0
41,"41020",12710,8954,8882,91,72,"FE de las JONS",3
40,"40007",86,70,69,0,1,"FE de las JONS",0
47,"47230",318,266,259,2,7,"FE de las JONS",2
14,"14064",352,265,261,3,4,"FE de las JONS",0
40,"40208",828,650,638,7,12,"FE de las JONS",1
5,"5136",110,75,75,3,0,"FE de las JONS",0
34,"34094",64,47,44,1,3,"FE de las JONS",0
41,"41059",31676,23199,22889,330,310,"FE de las JONS",28
47,"47138",259,198,195,3,3,"FE de las JONS",0
34,"34034",129,104,104,1,0,"FE de las JONS",1
14,"14048",1244,975,970,5,5,"FE de las JONS",0
34,"34114",240,171,171,0,0,"FE de las JONS",0
5,"5027",290,233,230,2,3,"FE de las JONS",1
34,"34903",240,161,160,2,1,"FE de las JONS",0
14,"14018",3795,3004,2970,24,34,"FE de las JONS",2
41,"41065",23028,15133,14958,191,175,"FE de las JONS",7
34,"34134",61,49,47,0,2,"FE de las JONS",0
5,"5151",100,86,82,1,4,"FE de las JONS",0
41,"41095",40097,27969,27731,354,238,"FE de las JONS",20
5,"5211",484,406,405,3,1,"FE de las JONS",0
40,"40004",534,428,420,3,8,"FE de las JONS",0
41,"41028",1880,1479,1458,28,21,"FE de las JONS",3
40,"40056",41,34,34,0,0,"FE de las JONS",0
41,"41080",1289,1010,997,13,13,"FE de las JONS",0
34,"34246",78,64,64,0,0,"FE de las JONS",1
40,"40105",60,51,51,1,0,"FE de las JONS",0
34,"34237",645,506,498,6,8,"FE de las JONS",0
41,"41023",7901,6050,5972,45,78,"FE de las JONS",0
5,"5107",74,54,53,0,1,"FE de las JONS",0
14,"14059",713,572,567,5,5,"FE de las JONS",3
47,"47181",170,128,128,1,0,"FE de las JONS",0
34,"34088",219,179,177,4,2,"FE de las JONS",0
5,"5245",344,285,284,5,1,"FE de las JONS",3
47,"47131",189,145,145,4,0,"FE de las JONS",1
40,"40032",394,293,288,6,5,"FE de las JONS",1
34,"34046",45,35,34,0,1,"FE de las JONS",0
5,"5030",43,39,39,0,0,"FE de las JONS",0
41,"41096",6079,4673,4595,47,78,"FE de las JONS",1
47,"47110",471,386,378,6,8,"FE de las JONS",0
47,"47126",49,43,42,1,1,"FE de las JONS",0
47,"47029",61,54,53,0,1,"FE de las JONS",0
47,"47035",956,778,768,5,10,"FE de las JONS",1
40,"40028",106,89,88,1,1,"FE de las JONS",0
5,"5259",132,115,114,1,1,"FE de las JONS",0
5,"5152",737,618,609,5,9,"FE de las JONS",0
34,"34240",102,84,83,1,1,"FE de las JONS",0
40,"40140",100,74,73,1,1,"FE de las JONS",0
34,"34029",832,696,683,11,13,"FE de las JONS",1
47,"47228",481,385,383,3,2,"FE de las JONS",0
14,"14014",2610,2160,2125,19,35,"FE de las JONS",2
14,"14038",31501,23683,23394,336,289,"FE de las JONS",14
41,"41036",4053,2930,2899,29,31,"FE de las JONS",0
34,"34100",141,105,105,1,0,"FE de las JONS",3
5,"5138",326,278,275,2,3,"FE de las JONS",0
47,"47211",45,38,38,1,0,"FE de las JONS",0
47,"47086",4062,3162,3120,37,42,"FE de las JONS",11
5,"5061",264,222,214,5,8,"FE de las JONS",0
5,"5164",34,24,24,0,0,"FE de las JONS",0
14,"14045",3093,2662,2642,14,20,"FE de las JONS",0
34,"34156",56,48,48,2,0,"FE de las JONS",0
41,"41011",15274,11359,11207,145,152,"FE de las JONS",3
40,"40212",29,22,20,0,2,"FE de las JONS",1
14,"14035",6153,4715,4656,51,59,"FE de las JONS",1
5,"5002",1996,1497,1476,15,21,"FE de las JONS",0
47,"47175",6562,5041,4957,62,84,"FE de las JONS",6
34,"34131",67,57,56,0,1,"FE de las JONS",0
34,"34093",101,74,74,1,0,"FE de las JONS",0
34,"34066",66,55,54,0,1,"FE de las JONS",0
40,"40082",131,111,110,5,1,"FE de las JONS",0
47,"47186",251279,193705,191693,2746,2012,"FE de las JONS",280
47,"47193",1538,1229,1211,23,18,"FE de las JONS",1
47,"47161",3886,3133,3105,45,28,"FE de las JONS",3
14,"14063",1121,875,866,9,9,"FE de las JONS",0
40,"40052",95,69,69,0,0,"FE de las JONS",0
47,"47079",67,56,56,1,0,"FE de las JONS",1
40,"40203",814,643,631,14,12,"FE de las JONS",3
5,"5143",81,61,61,0,0,"FE de las JONS",0
47,"47215",60,52,52,2,0,"FE de las JONS",0
40,"40101",770,584,577,16,7,"FE de las JONS",0
5,"5189",478,361,360,3,1,"FE de las JONS",1
5,"5057",2593,2172,2152,16,20,"FE de las JONS",2
5,"5025",108,86,86,2,0,"FE de las JONS",0
40,"40017",103,89,88,2,1,"FE de las JONS",0
14,"14074",2387,2002,1995,26,7,"FE de las JONS",0
41,"41062",2252,1719,1698,12,21,"FE de las JONS",0
5,"5251",80,58,58,0,0,"FE de las JONS",0
47,"47015",229,172,170,1,2,"FE de las JONS",0
47,"47009",117,88,88,1,0,"FE de las JONS",0
41,"41007",12177,8150,8016,126,134,"FE de las JONS",8
41,"41027",4061,2783,2752,28,31,"FE de las JONS",2
47,"47004",1261,1047,1031,11,16,"FE de las JONS",3
40,"40124",261,190,183,9,7,"FE de las JONS",0
5,"5105",349,275,272,12,3,"FE de las JONS",3
40,"40063",7290,5366,5171,68,195,"FE de las JONS",21
41,"41097",3096,2489,2451,21,38,"FE de las JONS",0
40,"40155",3083,2333,2280,73,53,"FE de las JONS",9
41,"41082",3448,2827,2796,15,31,"FE de las JONS",1
34,"34073",184,153,152,7,1,"FE de las JONS",2
47,"47111",1005,804,794,5,10,"FE de las JONS",1
47,"47002",30,27,27,1,0,"FE de las JONS",1
40,"40221",50,41,41,0,0,"FE de las JONS",0
47,"47124",435,364,358,5,6,"FE de las JONS",0
34,"34139",179,143,143,1,0,"FE de las JONS",1
5,"5024",268,205,201,2,4,"FE de las JONS",2
47,"47172",149,125,124,3,1,"FE de las JONS",2
40,"40020",200,155,149,2,6,"FE de las JONS",0
5,"5070",41,33,33,0,0,"FE de las JONS",0
34,"34171",1071,762,753,16,9,"FE de las JONS",1
34,"34098",756,544,540,10,4,"FE de las JONS",2
14,"14066",5911,4515,4473,54,42,"FE de las JONS",1
14,"14073",3009,2246,2224,32,22,"FE de las JONS",0
5,"5178",392,310,304,2,6,"FE de las JONS",0
5,"5135",440,363,360,0,3,"FE de las JONS",1
14,"14036",3774,2928,2909,51,19,"FE de las JONS",0
40,"40041",1035,819,799,14,20,"FE de las JONS",3
47,"47082",816,664,661,10,3,"FE de las JONS",4
41,"41029",13231,9756,9610,128,146,"FE de las JONS",18
5,"5059",112,91,88,1,3,"FE de las JONS",2
40,"40106",232,173,173,3,0,"FE de las JONS",0
41,"41044",6838,5064,5005,67,59,"FE de las JONS",11
40,"40132",75,50,50,1,0,"FE de las JONS",1
5,"5263",175,133,131,0,2,"FE de las JONS",1
40,"40906",1793,1428,1405,32,23,"FE de las JONS",1
40,"40219",635,519,505,7,14,"FE de las JONS",0
40,"40190",50,41,40,1,1,"FE de las JONS",0
34,"34158",336,202,200,0,2,"FE de las JONS",0
47,"47103",277,218,214,1,4,"FE de las JONS",0
34,"34062",175,126,124,3,2,"FE de las JONS",1
40,"40044",160,117,114,4,3,"FE de las JONS",0
5,"5180",109,92,91,1,1,"FE de las JONS",0
34,"34204",53,45,44,0,1,"FE de las JONS",0
5,"5090",72,64,63,1,1,"FE de las JONS",0
40,"40210",110,71,67,1,4,"FE de las JONS",0
5,"5015",100,78,78,0,0,"FE de las JONS",0
47,"47160",466,368,364,5,4,"FE de las JONS",1
14,"14022",4077,3147,3102,20,45,"FE de las JONS",4
5,"5099",555,472,466,4,6,"FE de las JONS",2
40,"40222",190,157,156,1,1,"FE de las JONS",0
40,"40145",1152,933,920,3,13,"FE de las JONS",0
34,"34223",233,175,175,2,0,"FE de las JONS",0
41,"41002",1510,1161,1140,4,21,"FE de las JONS",1
40,"40121",325,266,262,3,4,"FE de las JONS",0
40,"40009",49,41,41,0,0,"FE de las JONS",0
47,"47189",164,134,134,1,0,"FE de las JONS",0
5,"5053",94,73,71,0,2,"FE de las JONS",0
34,"34220",145,125,123,0,2,"FE de las JONS",0
5,"5095",301,253,250,2,3,"FE de las JONS",0
34,"34904",355,247,241,3,6,"FE de las JONS",0
41,"41083",1176,915,908,8,7,"FE de las JONS",0
34,"34211",202,175,170,1,5,"FE de las JONS",0
34,"34035",122,98,96,0,2,"FE de las JONS",0
5,"5074",755,639,638,5,1,"FE de las JONS",1
5,"5139",74,62,59,2,3,"FE de las JONS",0
5,"5258",123,105,104,1,1,"FE de las JONS",1
40,"40110",391,303,302,6,1,"FE de las JONS",0
34,"34161",23,20,20,0,0,"FE de las JONS",0
5,"5236",147,101,101,0,0,"FE de las JONS",0
47,"47167",258,230,229,3,1,"FE de las JONS",0
5,"5199",48,39,39,0,0,"FE de las JONS",0
40,"40043",1842,1494,1469,28,25,"FE de las JONS",1
41,"41015",5263,3820,3752,34,68,"FE de las JONS",5
5,"5097",525,378,373,4,5,"FE de las JONS",1
5,"5252",70,52,51,0,1,"FE de las JONS",0
41,"41061",2205,1798,1770,2,28,"FE de las JONS",0
40,"40189",560,455,438,6,17,"FE de las JONS",2
34,"34243",352,274,273,5,1,"FE de las JONS",1
5,"5243",101,69,68,0,1,"FE de las JONS",1
14,"14009",2864,2021,2003,8,18,"FE de las JONS",0
34,"34003",167,132,130,7,2,"FE de las JONS",0
41,"41088",542,414,408,1,6,"FE de las JONS",1
14,"14007",15871,11609,11477,121,132,"FE de las JONS",13
47,"47157",544,462,458,9,4,"FE de las JONS",0
40,"40014",60,39,39,1,0,"FE de las JONS",0
5,"5094",158,124,124,3,0,"FE de las JONS",0
41,"41013",4762,3359,3327,9,32,"FE de las JONS",0
41,"41074",3079,2406,2386,14,20,"FE de las JONS",1
5,"5116",131,114,109,0,5,"FE de las JONS",0
40,"40125",99,72,71,3,1,"FE de las JONS",0
41,"41043",647,457,454,5,3,"FE de las JONS",0
40,"40060",86,65,64,3,1,"FE de las JONS",0
47,"47101",1740,1458,1444,12,14,"FE de las JONS",0
40,"40034",85,73,73,1,0,"FE de las JONS",0
34,"34157",2471,1936,1912,26,24,"FE de las JONS",3
40,"40087",112,85,83,0,2,"FE de las JONS",0
40,"40001",713,575,562,10,13,"FE de las JONS",0
5,"5100",307,245,245,2,0,"FE de las JONS",1
34,"34201",212,178,172,1,6,"FE de las JONS",0
47,"47187",101,82,81,1,1,"FE de las JONS",0
5,"5217",69,54,54,0,0,"FE de las JONS",0
40,"40178",104,80,79,1,1,"FE de las JONS",0
14,"14052",9720,6444,6384,58,60,"FE de las JONS",10
40,"40148",259,213,212,3,1,"FE de las JONS",0
34,"34167",124,105,105,0,0,"FE de las JONS",0
40,"40207",724,551,540,9,11,"FE de las JONS",2
14,"14002",10991,8444,8358,106,86,"FE de las JONS",8
5,"5208",55,45,45,0,0,"FE de las JONS",1
47,"47152",94,65,65,0,0,"FE de las JONS",0
14,"14053",6040,4455,4376,78,79,"FE de las JONS",0
14,"14054",13632,10857,10652,194,205,"FE de las JONS",13
5,"5176",237,193,190,4,3,"FE de las JONS",0
34,"34108",561,477,465,6,12,"FE de las JONS",0
47,"47125",55,46,46,0,0,"FE de las JONS",1
40,"40176",418,344,341,8,3,"FE de las JONS",0
47,"47176",229,157,157,0,0,"FE de las JONS",0
5,"5101",297,224,222,4,2,"FE de las JONS",1
34,"34006",82,72,72,1,0,"FE de las JONS",0
5,"5246",68,57,56,1,1,"FE de las JONS",0
40,"40902",137,118,118,3,0,"FE de las JONS",0
34,"34213",67,50,50,0,0,"FE de las JONS",0
34,"34033",17,15,15,0,0,"FE de las JONS",0
40,"40103",157,121,120,0,1,"FE de las JONS",0
34,"34231",273,209,206,2,3,"FE de las JONS",1
40,"40055",41,32,31,0,1,"FE de las JONS",0
41,"41010",4338,2990,2958,48,32,"FE de las JONS",6
5,"5174",81,71,71,1,0,"FE de las JONS",0
5,"5018",27,24,24,0,0,"FE de las JONS",0
40,"40113",438,330,322,4,8,"FE de las JONS",4
47,"47033",209,170,168,3,2,"FE de las JONS",0
40,"40201",48,48,48,2,0,"FE de las JONS",0
41,"41042",5902,4572,4509,37,63,"FE de las JONS",0
5,"5207",743,595,591,1,4,"FE de las JONS",0
41,"41046",3055,2456,2418,23,38,"FE de las JONS",1
40,"40904",332,271,268,5,3,"FE de las JONS",0
41,"41031",1319,879,875,6,4,"FE de las JONS",0
41,"41086",15877,10246,10150,146,96,"FE de las JONS",18
5,"5264",68,48,48,1,0,"FE de las JONS",0
34,"34070",182,138,137,1,1,"FE de las JONS",0
34,"34184",54,37,36,0,1,"FE de las JONS",0
41,"41902",4682,3136,3101,34,35,"FE de las JONS",1
5,"5168",3682,2846,2801,43,45,"FE de las JONS",5
5,"5265",87,68,66,2,2,"FE de las JONS",0
47,"47054",673,545,541,8,4,"FE de las JONS",1
47,"47155",3043,2246,2225,35,21,"FE de las JONS",11
47,"47190",103,87,87,7,0,"FE de las JONS",0
40,"40199",110,88,86,3,2,"FE de las JONS",0
47,"47127",150,110,108,0,2,"FE de las JONS",0
5,"5254",212,186,185,2,1,"FE de las JONS",0
40,"40088",303,242,238,0,4,"FE de las JONS",2
40,"40213",99,75,74,1,1,"FE de las JONS",0
5,"5104",35,29,29,0,0,"FE de las JONS",0
40,"40122",551,417,414,9,3,"FE de las JONS",0
47,"47221",115,102,102,0,0,"FE de las JONS",0
40,"40037",47,35,35,0,0,"FE de las JONS",0
47,"47224",92,77,77,0,0,"FE de las JONS",0
47,"47213",122,99,99,1,0,"FE de las JONS",0
40,"40053",116,92,90,1,2,"FE de las JONS",0
5,"5193",224,197,197,2,0,"FE de las JONS",0
47,"47066",1114,891,888,10,3,"FE de las JONS",2
47,"47119",101,78,77,0,1,"FE de las JONS",0
40,"40143",97,72,72,0,0,"FE de las JONS",0
5,"5213",117,94,88,0,6,"FE de las JONS",0
40,"40045",123,102,102,0,0,"FE de las JONS",2
5,"5267",102,78,77,1,1,"FE de las JONS",0
40,"40030",520,432,425,9,7,"FE de las JONS",2
34,"34059",462,377,375,5,2,"FE de las JONS",0
34,"34072",189,169,166,2,3,"FE de las JONS",1
41,"41030",527,436,429,6,7,"FE de las JONS",3
47,"47100",169,146,144,1,2,"FE de las JONS",0
41,"41016",6950,5194,5120,45,74,"FE de las JONS",5
47,"47030",1075,822,801,13,21,"FE de las JONS",1
47,"47163",315,253,250,2,3,"FE de las JONS",0
14,"14068",581,460,457,7,3,"FE de las JONS",2
5,"5220",386,316,312,0,4,"FE de las JONS",0
34,"34031",29,26,26,0,0,"FE de las JONS",0
40,"40126",96,80,78,0,2,"FE de las JONS",0
5,"5062",213,188,184,3,4,"FE de las JONS",2
34,"34049",421,313,311,4,2,"FE de las JONS",0
47,"47192",99,84,84,0,0,"FE de las JONS",0
47,"47084",1230,981,968,19,13,"FE de las JONS",3
41,"41066",1417,1121,1113,9,8,"FE de las JONS",0
14,"14008",2905,2226,2200,18,26,"FE de las JONS",0
40,"40031",515,410,404,7,6,"FE de las JONS",4
34,"34224",53,42,41,0,1,"FE de las JONS",0
5,"5182",862,673,668,2,5,"FE de las JONS",1
47,"47058",199,157,157,3,0,"FE de las JONS",0
47,"47049",94,71,71,1,0,"FE de las JONS",0
5,"5192",96,78,77,1,1,"FE de las JONS",0
5,"5029",132,102,102,0,0,"FE de las JONS",1
47,"47207",325,265,263,4,2,"FE de las JONS",0
41,"41087",9827,7300,7150,51,150,"FE de las JONS",8
47,"47144",85,65,65,2,0,"FE de las JONS",0
40,"40078",180,143,143,1,0,"FE de las JONS",0
5,"5216",237,195,192,0,3,"FE de las JONS",0
5,"5066",480,397,392,5,5,"FE de las JONS",0
40,"40128",144,116,116,5,0,"FE de las JONS",0
40,"40069",87,76,75,0,1,"FE de las JONS",1
40,"40179",634,545,538,4,7,"FE de las JONS",0
47,"47185",97,76,75,1,1,"FE de las JONS",0
41,"41073",1789,1292,1272,5,20,"FE de las JONS",3
5,"5043",86,68,68,0,0,"FE de las JONS",0
5,"5206",29,23,21,2,2,"FE de las JONS",0
41,"41024",22383,15333,15160,213,173,"FE de las JONS",5
5,"5019",44095,34409,33934,505,475,"FE de las JONS",92
34,"34037",345,256,253,4,3,"FE de las JONS",1
14,"14042",18991,14726,14495,290,231,"FE de las JONS",11
40,"40065",520,401,393,6,8,"FE de las JONS",1
47,"47159",862,704,695,20,9,"FE de las JONS",0
47,"47074",155,125,124,0,1,"FE de las JONS",0
47,"47059",108,77,76,1,1,"FE de las JONS",0
40,"40216",753,621,611,15,10,"FE de las JONS",4
40,"40081",151,109,107,2,2,"FE de las JONS",0
34,"34151",184,125,123,1,2,"FE de las JONS",0
47,"47217",1812,1395,1377,20,18,"FE de las JONS",2
14,"14019",6486,5288,5243,65,45,"FE de las JONS",5
34,"34229",75,60,60,2,0,"FE de las JONS",1
34,"34025",54,42,42,0,0,"FE de las JONS",1
34,"34123",1798,1479,1436,18,43,"FE de las JONS",0
41,"41069",28331,21065,20877,252,188,"FE de las JONS",35
34,"34228",93,80,80,0,0,"FE de las JONS",0
5,"5021",2044,1592,1557,37,35,"FE de las JONS",4
5,"5121",250,181,178,1,3,"FE de las JONS",0
34,"34079",1391,1088,1077,17,11,"FE de las JONS",2
34,"34067",142,88,88,3,0,"FE de las JONS",0
47,"47060",262,220,218,1,2,"FE de las JONS",0
40,"40118",59,44,43,1,1,"FE de las JONS",0
40,"40162",420,320,314,1,6,"FE de las JONS",1
34,"34080",6066,4238,4169,57,69,"FE de las JONS",9
47,"47069",128,108,108,0,0,"FE de las JONS",0
40,"40229",45,37,37,0,0,"FE de las JONS",0
47,"47073",141,118,116,1,2,"FE de las JONS",0
34,"34017",960,772,760,15,12,"FE de las JONS",0
34,"34154",78,62,62,0,0,"FE de las JONS",1
34,"34068",32,23,23,0,0,"FE de las JONS",0
41,"41100",1097,894,878,8,16,"FE de las JONS",0
34,"34217",1089,866,849,19,17,"FE de las JONS",1
40,"40048",40,30,30,0,0,"FE de las JONS",0
34,"34163",61,56,56,1,0,"FE de las JONS",0
14,"14010",4087,3144,3121,15,23,"FE de las JONS",2
34,"34120",65774,49378,48608,830,770,"FE de las JONS",117
40,"40107",113,93,90,3,3,"FE de las JONS",1
40,"40013",67,56,54,1,2,"FE de las JONS",0
40,"40120",173,145,144,1,1,"FE de las JONS",0
34,"34125",99,77,75,1,2,"FE de las JONS",0
47,"47053",125,100,99,1,1,"FE de las JONS",0
5,"5023",177,160,158,1,2,"FE de las JONS",0
47,"47080",45,39,39,1,0,"FE de las JONS",0
5,"5037",296,213,212,0,1,"FE de las JONS",0
5,"5130",95,76,76,0,0,"FE de las JONS",0
47,"47180",96,82,81,0,1,"FE de las JONS",1
40,"40005",34,32,31,1,1,"FE de las JONS",0
34,"34232",802,632,623,9,9,"FE de las JONS",1
5,"5124",134,111,109,1,2,"FE de las JONS",0
47,"47051",351,269,256,5,13,"FE de las JONS",3
47,"47019",93,69,68,0,1,"FE de las JONS",0
5,"5210",105,83,82,2,1,"FE de las JONS",0
47,"47071",406,333,329,6,4,"FE de las JONS",1
41,"41019",4528,3194,3168,41,26,"FE de las JONS",3
47,"47171",453,371,368,10,3,"FE de las JONS",3
5,"5081",44,36,36,0,0,"FE de las JONS",0
47,"47118",159,122,122,2,0,"FE de las JONS",0
40,"40182",207,155,155,6,0,"FE de las JONS",0
5,"5092",172,142,139,0,3,"FE de las JONS",0
47,"47226",180,152,148,1,4,"FE de las JONS",0
47,"47090",2511,1907,1880,23,27,"FE de las JONS",5
47,"47063",107,87,87,2,0,"FE de las JONS",0
34,"34185",72,48,45,0,3,"FE de las JONS",0
47,"47098",607,496,492,9,4,"FE de las JONS",1
47,"47020",283,237,232,5,5,"FE de las JONS",1
47,"47113",166,136,135,1,1,"FE de las JONS",0
40,"40079",236,174,171,0,3,"FE de las JONS",2
5,"5132",1040,770,753,2,17,"FE de las JONS",0
5,"5266",112,92,89,0,3,"FE de las JONS",0
47,"47067",198,159,156,5,3,"FE de las JONS",0
41,"41078",2587,1979,1970,15,9,"FE de las JONS",0
14,"14020",415,323,319,3,4,"FE de las JONS",0
47,"47134",186,155,149,2,6,"FE de las JONS",0
5,"5196",69,54,54,2,0,"FE de las JONS",0
5,"5215",186,138,136,1,2,"FE de las JONS",0
47,"47021",84,61,61,2,0,"FE de las JONS",0
47,"47141",148,121,119,1,2,"FE de las JONS",0
40,"40049",52,39,39,1,0,"FE de las JONS",0
41,"41056",3697,3041,3008,25,33,"FE de las JONS",1
34,"34159",375,275,264,8,11,"FE de las JONS",2
47,"47147",129,96,96,0,0,"FE de las JONS",0
47,"47075",4999,4020,3957,39,63,"FE de las JONS",8
5,"5026",229,193,192,2,1,"FE de las JONS",1
14,"14017",10755,8220,8149,101,71,"FE de las JONS",10
41,"41085",3918,3173,3128,42,45,"FE de las JONS",4
5,"5194",147,131,130,4,1,"FE de las JONS",1
5,"5160",339,290,286,2,4,"FE de las JONS",0
34,"34210",103,93,91,2,2,"FE de las JONS",0
40,"40051",54,41,40,0,1,"FE de las JONS",0
5,"5167",274,230,224,6,6,"FE de las JONS",0
40,"40025",158,124,124,0,0,"FE de las JONS",1
5,"5235",136,120,119,2,1,"FE de las JONS",0
41,"41048",2296,1749,1726,21,23,"FE de las JONS",0
34,"34146",60,42,40,1,2,"FE de las JONS",0
40,"40188",120,82,81,0,1,"FE de las JONS",0
40,"40234",441,363,355,3,8,"FE de las JONS",0
47,"47093",865,658,642,11,16,"FE de las JONS",1
34,"34190",59,42,42,4,0,"FE de las JONS",0
5,"5128",361,288,280,3,8,"FE de las JONS",1
40,"40016",63,45,45,0,0,"FE de las JONS",0
47,"47232",107,77,75,1,2,"FE de las JONS",0
47,"47220",194,143,142,4,1,"FE de las JONS",0
47,"47057",237,198,198,3,0,"FE de las JONS",0
47,"47166",276,226,223,0,3,"FE de las JONS",1
5,"5118",91,66,66,0,0,"FE de las JONS",0
5,"5089",500,390,375,3,15,"FE de las JONS",1
40,"40163",62,51,51,5,0,"FE de las JONS",0
14,"14046",4587,3671,3641,35,30,"FE de las JONS",1
40,"40193",231,188,185,6,3,"FE de las JONS",0
40,"40021",33,32,32,0,0,"FE de las JONS",0
47,"47014",55,47,47,0,0,"FE de las JONS",0
34,"34028",154,128,126,1,2,"FE de las JONS",0
47,"47150",338,273,271,2,2,"FE de las JONS",0
34,"34177",170,147,143,2,4,"FE de las JONS",0
34,"34132",128,103,102,2,1,"FE de las JONS",0
5,"5096",74,56,56,0,0,"FE de las JONS",0
40,"40059",124,104,104,2,0,"FE de las JONS",1
14,"14027",7948,5944,5871,92,73,"FE de las JONS",4
34,"34149",26,18,18,0,0,"FE de las JONS",0
47,"47205",414,307,298,5,9,"FE de las JONS",1
5,"5141",99,90,89,0,1,"FE de las JONS",0
47,"47231",4272,3268,3243,64,25,"FE de las JONS",5
34,"34199",1354,1004,978,27,26,"FE de las JONS",1
47,"47151",32,29,29,0,0,"FE de las JONS",0
5,"5231",172,142,141,0,1,"FE de las JONS",0
14,"14055",18619,13802,13607,192,195,"FE de las JONS",42
40,"40130",139,106,106,4,0,"FE de las JONS",0
47,"47114",4107,2877,2834,37,43,"FE de las JONS",5
34,"34109",62,47,46,0,1,"FE de las JONS",0
5,"5033",184,159,155,3,4,"FE de las JONS",2
41,"41077",8817,6520,6375,53,145,"FE de las JONS",1
34,"34052",187,147,147,1,0,"FE de las JONS",0
5,"5261",48,32,31,0,1,"FE de las JONS",0
5,"5088",34,26,26,0,0,"FE de las JONS",0
40,"40177",171,145,145,2,0,"FE de las JONS",0
41,"41092",7649,5816,5738,39,78,"FE de las JONS",3
40,"40192",179,151,150,1,1,"FE de las JONS",0
47,"47195",449,350,346,5,4,"FE de las JONS",0
5,"5262",378,308,307,2,1,"FE de las JONS",0
40,"40035",146,114,112,3,2,"FE de las JONS",1
47,"47109",183,151,151,4,0,"FE de las JONS",0
41,"41026",4273,3577,3538,15,39,"FE de las JONS",1
5,"5008",244,200,196,1,4,"FE de las JONS",0
47,"47178",190,162,161,1,1,"FE de las JONS",1
40,"40100",303,241,231,5,10,"FE de las JONS",1
47,"47003",263,224,222,1,2,"FE de las JONS",1
40,"40166",275,247,246,2,1,"FE de las JONS",0
34,"34050",216,170,166,1,4,"FE de las JONS",0
47,"47081",57,44,44,1,0,"FE de las JONS",0
41,"41041",9646,7901,7791,58,110,"FE de las JONS",5
5,"5229",90,79,77,2,2,"FE de las JONS",0
47,"47076",16922,13030,12899,212,131,"FE de las JONS",19
34,"34011",406,327,327,4,0,"FE de las JONS",1
34,"34181",471,350,346,7,4,"FE de las JONS",1
34,"34225",4837,3650,3580,73,70,"FE de las JONS",7
41,"41099",4141,2818,2799,37,19,"FE de las JONS",3
47,"47158",906,716,710,10,6,"FE de las JONS",0
47,"47182",1371,991,982,12,9,"FE de las JONS",4
47,"47174",302,236,234,3,2,"FE de las JONS",0
14,"14044",1585,1279,1265,12,14,"FE de las JONS",4
47,"47135",93,77,76,0,1,"FE de las JONS",0
34,"34245",322,240,236,3,4,"FE de las JONS",0
40,"40225",1152,931,918,10,13,"FE de las JONS",0
40,"40108",120,83,82,1,1,"FE de las JONS",0
47,"47142",172,132,131,2,1,"FE de las JONS",1
34,"34096",56,41,39,1,2,"FE de las JONS",0
5,"5080",75,53,53,1,0,"FE de las JONS",0
40,"40076",6641,4958,4862,67,96,"FE de las JONS",12
5,"5177",164,134,133,0,1,"FE de las JONS",0
34,"34205",70,55,55,1,0,"FE de las JONS",0
40,"40165",95,72,71,1,1,"FE de las JONS",0
47,"47027",2680,2059,2024,23,35,"FE de las JONS",1
40,"40136",130,106,106,1,0,"FE de las JONS",1
34,"34110",96,83,81,2,2,"FE de las JONS",0
5,"5145",57,41,41,0,0,"FE de las JONS",0
40,"40218",111,81,80,1,1,"FE de las JONS",1
47,"47011",600,493,489,4,4,"FE de las JONS",1
34,"34045",84,75,74,1,1,"FE de las JONS",1
41,"41072",4083,3073,3046,12,27,"FE de las JONS",1
5,"5017",87,69,68,1,1,"FE de las JONS",0
40,"40152",750,615,595,4,20,"FE de las JONS",2
34,"34112",50,39,38,2,1,"FE de las JONS",0
5,"5013",890,746,739,4,7,"FE de las JONS",0
34,"34084",142,124,122,3,2,"FE de las JONS",0
40,"40173",148,121,120,3,1,"FE de las JONS",1
14,"14050",2418,1983,1966,23,17,"FE de las JONS",1
41,"41070",5598,4101,4039,79,62,"FE de las JONS",6
47,"47023",2863,2278,2258,38,20,"FE de las JONS",2
14,"14023",2084,1809,1787,13,22,"FE de las JONS",2
34,"34147",192,139,137,1,2,"FE de las JONS",2
5,"5110",710,584,581,1,3,"FE de las JONS",0
40,"40002",38,31,31,1,0,"FE de las JONS",0
47,"47041",166,135,133,2,2,"FE de las JONS",0
5,"5122",156,124,124,0,0,"FE de las JONS",0
40,"40003",144,123,120,1,3,"FE de las JONS",1
47,"47204",275,221,219,3,2,"FE de las JONS",0
34,"34019",139,108,108,5,0,"FE de las JONS",0
5,"5227",409,307,305,2,2,"FE de las JONS",0
41,"41068",13809,10171,10072,100,99,"FE de las JONS",2
47,"47129",954,744,731,4,13,"FE de las JONS",0
47,"47165",7036,5328,5258,67,70,"FE de las JONS",10
41,"41021",20767,14040,13822,240,218,"FE de las JONS",27
47,"47078",178,159,154,7,5,"FE de las JONS",0
34,"34169",431,331,329,5,2,"FE de las JONS",0
40,"40160",120,94,92,2,2,"FE de las JONS",0
34,"34113",35,28,27,0,1,"FE de las JONS",0
47,"47025",127,103,103,0,0,"FE de las JONS",0
14,"14051",1392,1148,1130,11,18,"FE de las JONS",0
5,"5244",66,45,45,0,0,"FE de las JONS",0
41,"41075",9987,7904,7809,71,95,"FE de las JONS",11
40,"40109",84,70,67,0,3,"FE de las JONS",0
40,"40015",33,30,30,1,0,"FE de las JONS",0
40,"40156",361,268,264,5,4,"FE de las JONS",1
34,"34074",764,610,597,11,13,"FE de las JONS",1
40,"40115",126,98,95,2,3,"FE de las JONS",0
14,"14039",2705,2204,2189,12,15,"FE de las JONS",3
5,"5084",81,70,69,0,1,"FE de las JONS",0
34,"34101",54,44,44,0,0,"FE de las JONS",0
41,"41093",17665,13712,13526,179,186,"FE de las JONS",11
47,"47034",90,65,63,0,2,"FE de las JONS",0
40,"40077",713,526,519,12,7,"FE de las JONS",1
47,"47112",2671,2231,2198,28,33,"FE de las JONS",1
34,"34176",146,120,118,2,2,"FE de las JONS",1
47,"47052",6207,4812,4761,79,51,"FE de las JONS",15
5,"5239",215,171,170,2,1,"FE de las JONS",1
41,"41003",2196,1803,1782,21,21,"FE de las JONS",0
40,"40905",143,103,103,1,0,"FE de las JONS",0
47,"47005",578,467,455,5,12,"FE de las JONS",2
34,"34012",368,277,275,9,2,"FE de las JONS",0
5,"5225",423,346,342,8,4,"FE de las JONS",1
14,"14013",17006,13114,12958,166,156,"FE de las JONS",42
40,"40036",531,440,424,10,16,"FE de las JONS",0
41,"41058",16497,12415,12248,181,167,"FE de las JONS",9
5,"5902",319,262,262,0,0,"FE de las JONS",1
34,"34192",103,75,74,1,1,"FE de las JONS",0
40,"40062",54,44,44,0,0,"FE de las JONS",0
5,"5200",56,43,42,0,1,"FE de las JONS",0
34,"34236",176,134,134,1,0,"FE de las JONS",0
40,"40191",265,191,190,1,1,"FE de las JONS",1
47,"47094",154,129,127,0,2,"FE de las JONS",1
40,"40095",507,437,425,2,12,"FE de las JONS",2
40,"40129",203,166,162,1,4,"FE de las JONS",0
47,"47188",125,112,109,3,3,"FE de las JONS",0
47,"47083",80,61,59,3,2,"FE de las JONS",1
40,"40181",4413,3439,3361,43,78,"FE de las JONS",6
5,"5195",241,168,164,0,4,"FE de las JONS",0
5,"5036",136,107,106,0,1,"FE de las JONS",0
5,"5114",1418,1195,1182,9,13,"FE de las JONS",3
14,"14032",434,377,375,1,2,"FE de las JONS",0
14,"14031",634,516,514,1,2,"FE de las JONS",1
41,"41101",5752,4663,4629,25,34,"FE de las JONS",1
47,"47068",41,28,28,0,0,"FE de las JONS",1
14,"14011",595,498,497,4,1,"FE de las JONS",0
47,"47095",41,36,36,3,0,"FE de las JONS",0
47,"47198",71,56,56,2,0,"FE de las JONS",0
34,"34165",86,67,67,0,0,"FE de las JONS",1
34,"34216",65,50,50,1,0,"FE de las JONS",0
41,"41034",22561,16014,15840,270,174,"FE de las JONS",23
34,"34127",118,77,74,1,3,"FE de las JONS",0
47,"47137",27,22,22,2,0,"FE de las JONS",0
14,"14033",1289,974,958,18,16,"FE de las JONS",0
34,"34152",142,114,109,1,5,"FE de las JONS",0
47,"47164",391,326,320,3,6,"FE de las JONS",0
34,"34206",952,796,780,9,16,"FE de las JONS",8
14,"14056",23507,17245,17071,259,174,"FE de las JONS",26
47,"47085",16967,12618,12472,208,146,"FE de las JONS",21
5,"5034",17,13,13,0,0,"FE de las JONS",0
5,"5186",1670,1306,1287,9,19,"FE de las JONS",1
5,"5162",107,71,71,0,0,"FE de las JONS",0
41,"41039",31429,23337,23138,294,199,"FE de las JONS",8
14,"14060",4843,3857,3787,47,70,"FE de las JONS",6
34,"34053",222,177,172,4,5,"FE de las JONS",2
34,"34230",12,8,8,0,0,"FE de las JONS",0
5,"5108",64,41,41,0,0,"FE de las JONS",0
5,"5085",35,34,34,0,0,"FE de las JONS",0
40,"40158",24,18,17,0,1,"FE de las JONS",0
41,"41004",55127,37662,37179,622,483,"FE de las JONS",110
41,"41091",545464,388043,383816,5325,4227,"FE de las JONS",513
47,"47064",30,21,21,1,0,"FE de las JONS",0
5,"5102",1850,1487,1475,11,12,"FE de las JONS",2
41,"41071",5603,3999,3932,28,67,"FE de las JONS",0
40,"40119",182,149,145,2,4,"FE de las JONS",0
5,"5001",210,180,176,2,4,"FE de las JONS",0
5,"5007",126,104,102,0,2,"FE de las JONS",0
40,"40903",102,75,75,0,0,"FE de las JONS",0
34,"34056",2147,1557,1535,21,22,"FE de las JONS",3
47,"47194",322,244,233,1,11,"FE de las JONS",0
40,"40024",920,712,704,7,8,"FE de las JONS",0
40,"40072",170,134,132,1,2,"FE de las JONS",0
34,"34057",483,365,357,2,8,"FE de las JONS",0
40,"40104",261,179,178,1,1,"FE de las JONS",1
47,"47062",185,153,153,5,0,"FE de las JONS",0
34,"34005",899,707,698,8,9,"FE de las JONS",0
5,"5035",105,87,87,2,0,"FE de las JONS",0
41,"41063",2678,1869,1853,22,16,"FE de las JONS",0
40,"40172",34,27,26,0,1,"FE de las JONS",0
41,"41005",8792,6642,6585,71,57,"FE de las JONS",4
41,"41060",15176,10797,10693,114,104,"FE de las JONS",10
34,"34221",190,143,143,3,0,"FE de las JONS",0
5,"5103",84,68,68,3,0,"FE de las JONS",0
40,"40198",30,21,20,0,1,"FE de las JONS",0
47,"47128",57,52,48,1,4,"FE de las JONS",0
34,"34116",76,50,49,1,1,"FE de las JONS",0
34,"34106",121,100,99,2,1,"FE de las JONS",0
34,"34901",1233,955,946,14,9,"FE de las JONS",0
34,"34047",1814,1435,1413,24,22,"FE de las JONS",2
40,"40091",140,111,109,1,2,"FE de las JONS",0
5,"5903",171,118,118,0,0,"FE de las JONS",0
40,"40083",88,72,72,1,0,"FE de las JONS",0
40,"40211",72,65,65,1,0,"FE de las JONS",0
34,"34133",108,90,90,0,0,"FE de las JONS",0
40,"40223",241,190,190,2,0,"FE de las JONS",0
41,"41033",5237,3915,3878,20,37,"FE de las JONS",1
40,"40111",72,57,55,0,2,"FE de las JONS",0
47,"47212",386,327,325,1,2,"FE de las JONS",2
47,"47047",217,171,170,5,1,"FE de las JONS",1
34,"34089",173,128,125,5,3,"FE de las JONS",0
5,"5072",91,72,72,1,0,"FE de las JONS",0
14,"14049",16358,12577,12478,137,99,"FE de las JONS",8
47,"47214",1517,1215,1191,34,24,"FE de las JONS",3
34,"34092",331,272,267,6,5,"FE de las JONS",0
40,"40135",298,247,242,4,5,"FE de las JONS",1
5,"5249",101,73,71,1,2,"FE de las JONS",0
5,"5044",301,217,217,3,0,"FE de las JONS",0
5,"5157",256,187,183,0,4,"FE de las JONS",0
47,"47208",56,45,43,1,2,"FE de las JONS",0
40,"40146",270,222,222,0,0,"FE de las JONS",1
47,"47143",146,108,107,0,1,"FE de las JONS",0
47,"47013",118,97,97,2,0,"FE de las JONS",0
40,"40093",88,77,72,0,5,"FE de las JONS",0
41,"41022",4281,3087,3066,15,21,"FE de las JONS",1
34,"34051",112,92,91,7,1,"FE de las JONS",2
5,"5076",477,397,385,4,12,"FE de las JONS",0
34,"34107",91,67,67,4,0,"FE de las JONS",1
34,"34143",181,142,140,3,2,"FE de las JONS",0
47,"47199",84,61,60,1,1,"FE de las JONS",0
34,"34215",166,146,145,1,1,"FE de las JONS",1
34,"34083",1888,1355,1338,15,17,"FE de las JONS",1
41,"41051",2103,1705,1686,7,19,"FE de las JONS",1
34,"34027",1224,875,861,14,14,"FE de las JONS",2
34,"34242",97,81,79,6,2,"FE de las JONS",0
47,"47037",194,160,159,1,1,"FE de las JONS",1
34,"34135",429,334,329,6,5,"FE de las JONS",0
5,"5188",55,47,47,0,0,"FE de las JONS",0
5,"5087",144,87,87,0,0,"FE de las JONS",0
47,"47016",94,77,77,1,0,"FE de las JONS",0
47,"47024",283,211,210,1,1,"FE de las JONS",0
14,"14024",1926,1557,1527,14,30,"FE de las JONS",1
34,"34179",32,21,21,0,0,"FE de las JONS",0
5,"5241",3145,2303,2273,27,30,"FE de las JONS",12
47,"47225",89,67,66,0,1,"FE de las JONS",1
47,"47196",43,29,29,0,0,"FE de las JONS",0
41,"41032",4059,3122,3062,22,60,"FE de las JONS",0
47,"47123",456,356,353,10,3,"FE de las JONS",1
47,"47122",2078,1697,1665,21,32,"FE de las JONS",3
34,"34208",62,52,52,2,0,"FE de las JONS",0
5,"5233",246,212,212,2,0,"FE de las JONS",0
41,"41040",9567,7305,7210,93,95,"FE de las JONS",10
47,"47055",212,169,168,3,1,"FE de las JONS",1
40,"40086",738,628,619,12,9,"FE de las JONS",0
40,"40151",52,42,42,0,0,"FE de las JONS",0
47,"47156",182,155,148,0,7,"FE de las JONS",0
34,"34121",208,153,152,0,1,"FE de las JONS",0
47,"47121",590,495,490,4,5,"FE de las JONS",0
40,"40112",2346,1848,1798,35,50,"FE de las JONS",3
34,"34091",136,105,103,1,2,"FE de las JONS",0
34,"34042",299,249,246,5,3,"FE de las JONS",0
40,"40228",539,446,437,2,9,"FE de las JONS",1
34,"34241",20,12,11,0,1,"FE de las JONS",0
5,"5237",198,157,155,3,2,"FE de las JONS",0
41,"41084",2875,2362,2335,9,27,"FE de las JONS",1
14,"14075",624,508,500,8,8,"FE de las JONS",0
14,"14037",3500,2662,2616,29,46,"FE de las JONS",2
34,"34041",100,79,78,1,1,"FE de las JONS",0
40,"40186",50,33,33,0,0,"FE de las JONS",0
40,"40092",132,100,100,0,0,"FE de las JONS",0
5,"5197",114,98,98,1,0,"FE de las JONS",2
34,"34004",5790,4354,4262,84,92,"FE de las JONS",7
47,"47146",236,196,195,4,1,"FE de las JONS",0
34,"34140",113,84,84,2,0,"FE de las JONS",0
34,"34126",284,226,224,3,2,"FE de las JONS",0
41,"41037",3228,2510,2483,27,27,"FE de las JONS",0
40,"40073",425,371,367,3,4,"FE de las JONS",2
47,"47117",306,231,228,4,3,"FE de las JONS",0
41,"41054",671,556,550,0,6,"FE de las JONS",2
5,"5198",80,65,65,1,0,"FE de las JONS",0
5,"5171",84,74,73,0,1,"FE de las JONS",0
5,"5169",241,218,218,0,0,"FE de las JONS",0
34,"34103",105,92,92,5,0,"FE de las JONS",0
14,"14058",8116,6274,6215,76,59,"FE de las JONS",12
5,"5153",112,89,89,5,0,"FE de las JONS",0
5,"5253",95,75,74,0,1,"FE de las JONS",0
5,"5131",118,86,86,3,0,"FE de las JONS",1
34,"34023",5318,3947,3891,64,56,"FE de las JONS",8
5,"5119",41,31,31,0,0,"FE de las JONS",0
40,"40094",375,286,284,4,2,"FE de las JONS",1
14,"14015",2198,1776,1755,16,21,"FE de las JONS",1
5,"5049",440,335,330,8,5,"FE de las JONS",2
41,"41076",2227,1507,1492,5,15,"FE de las JONS",1
14,"14061",841,700,693,3,7,"FE de las JONS",3
34,"34122",80,65,62,2,3,"FE de las JONS",0
47,"47169",70,57,57,0,0,"FE de las JONS",0
47,"47162",80,62,62,1,0,"FE de las JONS",0
5,"5142",113,97,96,0,1,"FE de las JONS",0
5,"5055",649,525,518,3,7,"FE de las JONS",0
5,"5047",4267,3345,3275,34,70,"FE de las JONS",3
5,"5228",193,146,145,1,1,"FE de las JONS",0
5,"5163",1762,1400,1380,5,20,"FE de las JONS",3
5,"5069",91,79,78,1,1,"FE de las JONS",1
34,"34036",211,159,157,0,2,"FE de las JONS",0
5,"5117",213,183,180,0,3,"FE de las JONS",0
5,"5106",39,26,26,0,0,"FE de las JONS",0
47,"47065",898,762,752,9,10,"FE de las JONS",0
47,"47173",862,683,675,5,8,"FE de las JONS",1
5,"5086",96,81,81,2,0,"FE de las JONS",0
47,"47042",63,50,49,3,1,"FE de las JONS",0
5,"5190",61,48,48,3,0,"FE de las JONS",1
40,"40134",769,628,620,19,8,"FE de las JONS",1
14,"14072",1169,925,922,5,3,"FE de las JONS",0
47,"47104",2917,2391,2357,31,34,"FE de las JONS",4
5,"5042",156,126,126,0,0,"FE de las JONS",0
34,"34238",348,289,287,4,2,"FE de las JONS",0
5,"5077",205,164,160,2,4,"FE de las JONS",0
41,"41089",6394,4593,4526,57,67,"FE de las JONS",2
34,"34170",72,56,56,1,0,"FE de las JONS",1
47,"47012",134,105,105,0,0,"FE de las JONS",0
14,"14062",1114,889,882,9,7,"FE de las JONS",0
5,"5134",47,37,37,0,0,"FE de las JONS",0
5,"5212",274,202,197,0,5,"FE de las JONS",0
5,"5238",815,649,641,6,8,"FE de las JONS",1
40,"40046",99,81,78,2,3,"FE de las JONS",0
34,"34009",34,31,31,3,0,"FE de las JONS",0
5,"5260",114,101,101,1,0,"FE de las JONS",0
47,"47001",51,44,42,2,2,"FE de las JONS",1
5,"5012",156,134,132,1,2,"FE de las JONS",0
14,"14021",259993,183200,181402,2936,1798,"FE de las JONS",217
40,"40061",66,53,52,1,1,"FE de las JONS",0
5,"5075",100,76,76,1,0,"FE de las JONS",3
34,"34104",274,224,224,4,0,"FE de las JONS",0
47,"47154",168,144,144,7,0,"FE de las JONS",0
5,"5173",62,55,55,1,0,"FE de las JONS",0
47,"47200",91,73,73,0,0,"FE de las JONS",0
40,"40171",32,25,25,0,0,"FE de las JONS",0
5,"5120",38,28,28,1,0,"FE de las JONS",0
40,"40202",79,59,58,0,1,"FE de las JONS",0
40,"40206",179,136,134,0,2,"FE de las JONS",0
47,"47218",983,776,767,7,9,"FE de las JONS",0
47,"47008",26,17,17,0,0,"FE de las JONS",0
34,"34218",486,366,365,3,1,"FE de las JONS",1
47,"47044",325,257,252,1,5,"FE de las JONS",0
40,"40080",68,53,52,0,1,"FE de las JONS",1
5,"5187",1833,1385,1361,16,24,"FE de las JONS",5
47,"47006",196,151,146,1,5,"FE de las JONS",0
47,"47036",257,212,212,1,0,"FE de las JONS",0
40,"40185",977,725,712,13,13,"FE de las JONS",5
40,"40040",2677,1990,1966,24,24,"FE de las JONS",3
5,"5016",6231,4831,4763,56,68,"FE de las JONS",16
5,"5064",117,94,93,4,1,"FE de las JONS",0
34,"34137",31,24,24,3,0,"FE de las JONS",0
5,"5133",62,49,49,0,0,"FE de las JONS",0
34,"34077",283,219,216,3,3,"FE de las JONS",0
5,"5170",63,50,50,0,0,"FE de las JONS",0
47,"47018",33,30,28,2,2,"FE de las JONS",0
47,"47010",11275,8800,8701,163,99,"FE de las JONS",11
34,"34082",96,79,75,0,4,"FE de las JONS",1
14,"14041",3215,2492,2439,45,53,"FE de las JONS",1
34,"34024",27,18,17,1,1,"FE de las JONS",0
5,"5040",77,59,59,1,0,"FE de las JONS",0
34,"34063",102,92,91,2,1,"FE de las JONS",0
47,"47077",291,232,232,1,0,"FE de las JONS",2
5,"5185",109,89,89,1,0,"FE de las JONS",1
34,"34038",284,228,225,9,3,"FE de las JONS",0
5,"5234",58,49,49,0,0,"FE de las JONS",0
40,"40068",39,32,32,0,0,"FE de las JONS",0
34,"34214",176,144,143,3,1,"FE de las JONS",0
47,"47197",932,739,730,15,9,"FE de las JONS",0
41,"41006",2743,1972,1957,13,15,"FE de las JONS",2
47,"47145",658,482,473,7,9,"FE de las JONS",2
47,"47032",161,130,129,3,1,"FE de las JONS",2
5,"5209",104,78,78,0,0,"FE de las JONS",0
40,"40058",368,306,304,1,2,"FE de las JONS",0
40,"40161",38,28,28,0,0,"FE de las JONS",1
5,"5181",39,26,26,0,0,"FE de las JONS",0
40,"40224",34,25,25,0,0,"FE de las JONS",0
41,"41901",2626,2190,2167,24,23,"FE de las JONS",0
40,"40018",102,88,87,2,1,"FE de las JONS",1
47,"47177",112,83,79,1,4,"FE de las JONS",0
14,"14028",333,279,277,1,2,"FE de las JONS",0
40,"40099",61,52,52,2,0,"FE de las JONS",0
47,"47007",3453,2616,2580,42,36,"FE de las JONS",5
34,"34020",63,44,44,0,0,"FE de las JONS",0
34,"34186",61,53,53,0,0,"FE de las JONS",0
40,"40196",44,34,34,3,0,"FE de las JONS",0
40,"40097",114,96,94,2,2,"FE de las JONS",0
5,"5054",1282,979,965,5,14,"FE de las JONS",0
47,"47206",111,99,99,0,0,"FE de las JONS",0
40,"40019",43,35,35,0,0,"FE de las JONS",0
5,"5901",289,197,196,4,1,"FE de las JONS",1
40,"40233",457,350,348,1,2,"FE de las JONS",2
47,"47168",32,29,28,1,1,"FE de las JONS",1
47,"47050",3557,2688,2651,50,37,"FE de las JONS",3
41,"41025",1999,1502,1476,13,26,"FE de las JONS",2
40,"40039",257,188,184,2,4,"FE de las JONS",5
41,"41067",7055,5368,5295,64,73,"FE de las JONS",8
5,"5201",557,444,437,2,7,"FE de las JONS",0
40,"40075",182,149,146,4,3,"FE de las JONS",0
47,"47089",184,139,138,1,1,"FE de las JONS",1
14,"14071",1025,739,733,8,6,"FE de las JONS",0
5,"5247",267,164,164,0,0,"FE de las JONS",0
34,"34189",59,47,47,3,0,"FE de las JONS",0
40,"40029",50,43,42,0,1,"FE de las JONS",0
34,"34178",106,93,93,1,0,"FE de las JONS",1
14,"14004",2016,1560,1543,8,17,"FE de las JONS",2
40,"40159",150,111,110,0,1,"FE de las JONS",0
5,"5073",319,258,254,7,4,"FE de las JONS",0
34,"34060",150,123,123,2,0,"FE de las JONS",0
47,"47087",376,320,315,7,5,"FE de las JONS",0
5,"5065",498,424,422,7,2,"FE de las JONS",0
5,"5184",288,225,224,0,1,"FE de las JONS",1
14,"14001",3633,3095,3064,25,31,"FE de las JONS",0
47,"47148",475,389,384,2,5,"FE de las JONS",1
5,"5058",81,61,59,0,2,"FE de las JONS",1
5,"5039",58,48,48,0,0,"FE de las JONS",0
41,"41008",1073,884,875,0,9,"FE de las JONS",0
5,"5230",79,73,73,1,0,"FE de las JONS",0
40,"40220",71,57,52,0,5,"FE de las JONS",3
47,"47097",345,291,289,7,2,"FE de las JONS",0
14,"14065",1846,1509,1492,14,17,"FE de las JONS",3
34,"34227",84,69,67,3,2,"FE de las JONS",0
40,"40141",881,658,647,9,11,"FE de las JONS",2
34,"34196",94,74,73,1,1,"FE de las JONS",1
47,"47092",123,100,99,2,1,"FE de las JONS",1
41,"41081",28121,20027,19785,275,242,"FE de las JONS",11
34,"34061",116,78,78,2,0,"FE de las JONS",0
47,"47070",33,30,30,1,0,"FE de las JONS",0
40,"40205",292,221,220,2,1,"FE de las JONS",0
5,"5005",199,170,169,1,1,"FE de las JONS",2
34,"34069",2330,1769,1749,25,20,"FE de las JONS",1
5,"5904",149,99,97,0,2,"FE de las JONS",0
5,"5109",438,359,351,5,8,"FE de las JONS",0
14,"14057",6115,5040,4975,71,65,"FE de las JONS",1
34,"34015",45,40,40,0,0,"FE de las JONS",0
5,"5046",44,39,38,1,1,"FE de las JONS",0
5,"5113",90,74,74,0,0,"FE de las JONS",0
47,"47039",196,163,163,1,0,"FE de las JONS",0
5,"5186",1670,1306,1287,9,19,"PFyV",1
5,"5038",131,88,84,0,4,"PFyV",0
5,"5122",156,124,124,0,0,"PFyV",0
5,"5206",29,23,21,2,2,"PFyV",0
5,"5010",173,141,134,2,7,"PFyV",0
7,"7040",266127,162699,160491,2698,2208,"PFyV",377
5,"5093",431,330,329,1,1,"PFyV",0
7,"7018",389,275,271,0,4,"PFyV",0
5,"5089",500,390,375,3,15,"PFyV",0
7,"7026",30036,16912,16661,294,251,"PFyV",13
5,"5144",92,66,66,4,0,"PFyV",0
5,"5108",64,41,41,0,0,"PFyV",0
5,"5266",112,92,89,0,3,"PFyV",0
5,"5082",569,467,462,1,5,"PFyV",1
7,"7029",4090,2921,2866,44,55,"PFyV",2
7,"7055",7000,4471,4379,67,92,"PFyV",4
7,"7047",2161,1447,1407,31,40,"PFyV",3
5,"5023",177,160,158,1,2,"PFyV",0
5,"5076",477,397,385,4,12,"PFyV",0
5,"5034",17,13,13,0,0,"PFyV",0
5,"5104",35,29,29,0,0,"PFyV",0
5,"5123",90,69,69,3,0,"PFyV",1
5,"5148",34,27,27,0,0,"PFyV",0
5,"5232",106,84,80,1,4,"PFyV",0
5,"5178",392,310,304,2,6,"PFyV",0
5,"5252",70,52,51,0,1,"PFyV",0
5,"5199",48,39,39,0,0,"PFyV",0
7,"7030",1576,1150,1135,26,15,"PFyV",0
5,"5067",85,68,68,0,0,"PFyV",0
5,"5166",235,181,178,1,3,"PFyV",1
5,"5240",3351,2472,2428,22,44,"PFyV",0
5,"5100",307,245,245,2,0,"PFyV",0
5,"5026",229,193,192,2,1,"PFyV",0
7,"7011",26954,16786,16595,299,191,"PFyV",27
5,"5207",743,595,591,1,4,"PFyV",0
5,"5247",267,164,164,0,0,"PFyV",0
7,"7062",7206,4073,4035,72,38,"PFyV",5
5,"5025",108,86,86,2,0,"PFyV",0
7,"7051",4925,2993,2947,66,46,"PFyV",6
7,"7039",4920,3488,3377,54,111,"PFyV",6
5,"5189",478,361,360,3,1,"PFyV",0
5,"5209",104,78,78,0,0,"PFyV",0
5,"5159",287,216,216,0,0,"PFyV",1
7,"7015",20783,12244,12016,381,228,"PFyV",11
5,"5112",125,88,87,0,1,"PFyV",0
5,"5155",60,44,44,1,0,"PFyV",0
7,"7003",10671,6262,6149,79,113,"PFyV",6
5,"5030",43,39,39,0,0,"PFyV",0
5,"5110",710,584,581,1,3,"PFyV",0
5,"5049",440,335,330,8,5,"PFyV",0
5,"5078",128,112,111,2,1,"PFyV",0
5,"5168",3682,2846,2801,43,45,"PFyV",1
5,"5152",737,618,609,5,9,"PFyV",1
5,"5135",440,363,360,0,3,"PFyV",0
5,"5190",61,48,48,3,0,"PFyV",0
7,"7028",876,607,595,6,12,"PFyV",0
5,"5046",44,39,38,1,1,"PFyV",0
5,"5079",68,52,50,1,2,"PFyV",0
5,"5176",237,193,190,4,3,"PFyV",1
5,"5057",2593,2172,2152,16,20,"PFyV",1
5,"5041",1051,840,827,13,13,"PFyV",1
5,"5136",110,75,75,3,0,"PFyV",0
7,"7035",1542,1190,1161,19,29,"PFyV",3
5,"5193",224,197,197,2,0,"PFyV",0
5,"5147",174,141,135,4,6,"PFyV",0
5,"5045",104,82,82,0,0,"PFyV",0
5,"5005",199,170,169,1,1,"PFyV",0
5,"5060",127,108,105,1,3,"PFyV",0
7,"7007",454,304,300,4,4,"PFyV",1
7,"7004",3669,2511,2453,51,58,"PFyV",4
5,"5259",132,115,114,1,1,"PFyV",0
5,"5218",148,123,117,1,6,"PFyV",0
7,"7031",23371,14443,14213,285,230,"PFyV",22
5,"5262",378,308,307,2,1,"PFyV",0
5,"5131",118,86,86,3,0,"PFyV",0
5,"5039",58,48,48,0,0,"PFyV",0
5,"5096",74,56,56,0,0,"PFyV",0
5,"5179",231,206,204,2,2,"PFyV",0
7,"7901",642,483,470,5,13,"PFyV",0
5,"5081",44,36,36,0,0,"PFyV",0
5,"5125",60,52,52,0,0,"PFyV",0
5,"5221",398,298,297,10,1,"PFyV",0
5,"5182",862,673,668,2,5,"PFyV",0
5,"5226",92,67,67,0,0,"PFyV",0
5,"5162",107,71,71,0,0,"PFyV",0
5,"5205",78,59,58,0,1,"PFyV",0
7,"7057",7102,4702,4611,85,91,"PFyV",4
5,"5022",1649,1335,1328,7,7,"PFyV",0
7,"7024",6070,3232,3170,60,62,"PFyV",2
5,"5140",112,100,99,1,1,"PFyV",0
7,"7002",6305,4188,4073,80,115,"PFyV",1
7,"7021",255,197,193,1,4,"PFyV",0
5,"5105",349,275,272,12,3,"PFyV",0
5,"5129",153,98,95,0,3,"PFyV",0
5,"5083",155,120,113,1,7,"PFyV",0
5,"5256",119,101,100,0,1,"PFyV",0
5,"5132",1040,770,753,2,17,"PFyV",0
7,"7065",2061,1376,1345,29,31,"PFyV",1
7,"7043",3522,2384,2345,35,39,"PFyV",4
7,"7014",6697,3818,3757,38,61,"PFyV",8
5,"5074",755,639,638,5,1,"PFyV",0
5,"5251",80,58,58,0,0,"PFyV",0
5,"5188",55,47,47,0,0,"PFyV",0
5,"5165",386,292,280,7,12,"PFyV",1
5,"5019",44095,34409,33934,505,475,"PFyV",46
5,"5143",81,61,61,0,0,"PFyV",0
5,"5053",94,73,71,0,2,"PFyV",0
7,"7013",6525,4528,4409,78,119,"PFyV",7
5,"5058",81,61,59,0,2,"PFyV",0
5,"5103",84,68,68,3,0,"PFyV",0
7,"7032",19658,12168,11959,238,209,"PFyV",13
5,"5101",297,224,222,4,2,"PFyV",1
7,"7058",2803,2100,2046,38,54,"PFyV",1
5,"5008",244,200,196,1,4,"PFyV",0
5,"5016",6231,4831,4763,56,68,"PFyV",2
5,"5035",105,87,87,2,0,"PFyV",2
7,"7046",13748,8294,8183,183,111,"PFyV",14
5,"5229",90,79,77,2,2,"PFyV",0
5,"5228",193,146,145,1,1,"PFyV",0
5,"5029",132,102,102,0,0,"PFyV",0
5,"5002",1996,1497,1476,15,21,"PFyV",1
7,"7044",8326,6044,5846,99,198,"PFyV",4
5,"5180",109,92,91,1,1,"PFyV",0
5,"5211",484,406,405,3,1,"PFyV",1
5,"5196",69,54,54,2,0,"PFyV",0
5,"5063",48,39,39,2,0,"PFyV",0
7,"7009",744,593,576,11,17,"PFyV",0
5,"5175",190,149,149,2,0,"PFyV",0
5,"5239",215,171,170,2,1,"PFyV",0
7,"7036",25502,17151,16914,294,237,"PFyV",24
5,"5087",144,87,87,0,0,"PFyV",0
5,"5238",815,649,641,6,8,"PFyV",0
5,"5085",35,34,34,0,0,"PFyV",0
5,"5208",55,45,45,0,0,"PFyV",0
5,"5024",268,205,201,2,4,"PFyV",0
7,"7005",6331,4128,4058,76,70,"PFyV",3
5,"5092",172,142,139,0,3,"PFyV",0
5,"5161",638,525,522,0,3,"PFyV",0
5,"5902",319,262,262,0,0,"PFyV",0
5,"5118",91,66,66,0,0,"PFyV",0
5,"5055",649,525,518,3,7,"PFyV",1
5,"5017",87,69,68,1,1,"PFyV",0
5,"5128",361,288,280,3,8,"PFyV",0
5,"5066",480,397,392,5,5,"PFyV",0
7,"7025",457,355,346,3,9,"PFyV",0
5,"5905",253,200,198,1,2,"PFyV",0
5,"5215",186,138,136,1,2,"PFyV",0
7,"7001",3450,2544,2470,36,74,"PFyV",3
5,"5014",5559,4197,4101,53,96,"PFyV",0
5,"5194",147,131,130,4,1,"PFyV",0
5,"5145",57,41,41,0,0,"PFyV",0
5,"5072",91,72,72,1,0,"PFyV",0
5,"5172",147,122,122,0,0,"PFyV",0
5,"5121",250,181,178,1,3,"PFyV",0
5,"5070",41,33,33,0,0,"PFyV",0
5,"5056",94,78,73,1,5,"PFyV",0
5,"5258",123,105,104,1,1,"PFyV",0
5,"5216",237,195,192,0,3,"PFyV",0
5,"5075",100,76,76,1,0,"PFyV",0
5,"5130",95,76,76,0,0,"PFyV",0
5,"5115",590,458,450,1,8,"PFyV",1
5,"5236",147,101,101,0,0,"PFyV",0
7,"7064",5286,3340,3279,53,61,"PFyV",3
5,"5158",410,333,331,2,2,"PFyV",0
7,"7017",800,556,539,14,17,"PFyV",0
5,"5052",102,91,91,0,0,"PFyV",0
5,"5241",3145,2303,2273,27,30,"PFyV",3
5,"5191",124,98,98,2,0,"PFyV",0
5,"5244",66,45,45,0,0,"PFyV",0
5,"5261",48,32,31,0,1,"PFyV",0
5,"5901",289,197,196,4,1,"PFyV",0
5,"5021",2044,1592,1557,37,35,"PFyV",0
5,"5174",81,71,71,1,0,"PFyV",0
5,"5246",68,57,56,1,1,"PFyV",0
5,"5192",96,78,77,1,1,"PFyV",0
5,"5254",212,186,185,2,1,"PFyV",0
5,"5233",246,212,212,2,0,"PFyV",0
5,"5042",156,126,126,0,0,"PFyV",0
5,"5265",87,68,66,2,2,"PFyV",0
5,"5116",131,114,109,0,5,"PFyV",0
5,"5151",100,86,82,1,4,"PFyV",0
5,"5107",74,54,53,0,1,"PFyV",0
5,"5051",194,165,154,0,11,"PFyV",0
5,"5015",100,78,78,0,0,"PFyV",0
7,"7023",3541,2414,2365,88,49,"PFyV",2
5,"5195",241,168,164,0,4,"PFyV",0
7,"7056",4701,3164,3090,55,74,"PFyV",3
5,"5167",274,230,224,6,6,"PFyV",0
7,"7054",19930,11186,11028,196,158,"PFyV",12
5,"5044",301,217,217,3,0,"PFyV",0
7,"7061",9429,5937,5800,125,137,"PFyV",18
7,"7041",2077,1583,1549,27,34,"PFyV",1
7,"7050",3099,2008,1979,45,29,"PFyV",2
7,"7016",2726,1848,1809,34,39,"PFyV",2
5,"5084",81,70,69,0,1,"PFyV",0
5,"5154",46,35,35,0,0,"PFyV",0
5,"5225",423,346,342,8,4,"PFyV",0
5,"5185",109,89,89,1,0,"PFyV",0
5,"5099",555,472,466,4,6,"PFyV",0
5,"5142",113,97,96,0,1,"PFyV",0
5,"5201",557,444,437,2,7,"PFyV",0
5,"5048",131,112,111,0,1,"PFyV",0
5,"5059",112,91,88,1,3,"PFyV",1
5,"5227",409,307,305,2,2,"PFyV",0
5,"5171",84,74,73,0,1,"PFyV",0
5,"5183",165,142,140,0,2,"PFyV",0
7,"7033",25954,14975,14738,328,237,"PFyV",27
7,"7053",1133,863,839,16,24,"PFyV",3
5,"5117",213,183,180,0,3,"PFyV",0
5,"5170",63,50,50,0,0,"PFyV",0
5,"5094",158,124,124,3,0,"PFyV",0
5,"5027",290,233,230,2,3,"PFyV",0
5,"5184",288,225,224,0,1,"PFyV",0
5,"5064",117,94,93,4,1,"PFyV",0
5,"5120",38,28,28,1,0,"PFyV",0
5,"5231",172,142,141,0,1,"PFyV",0
5,"5153",112,89,89,5,0,"PFyV",0
7,"7010",4668,3229,3174,58,55,"PFyV",5
5,"5077",205,164,160,2,4,"PFyV",0
5,"5013",890,746,739,4,7,"PFyV",0
5,"5149",128,97,97,1,0,"PFyV",0
5,"5114",1418,1195,1182,9,13,"PFyV",0
7,"7042",10393,6536,6421,96,115,"PFyV",11
5,"5065",498,424,422,7,2,"PFyV",0
5,"5267",102,78,77,1,1,"PFyV",0
5,"5001",210,180,176,2,4,"PFyV",0
5,"5245",344,285,284,5,1,"PFyV",1
7,"7037",3269,1737,1700,37,37,"PFyV",0
7,"7902",1071,734,712,22,22,"PFyV",1
5,"5141",99,90,89,0,1,"PFyV",0
5,"5260",114,101,101,1,0,"PFyV",0
5,"5264",68,48,48,1,0,"PFyV",0
5,"5119",41,31,31,0,0,"PFyV",0
5,"5124",134,111,109,1,2,"PFyV",0
5,"5224",104,90,90,0,0,"PFyV",0
5,"5062",213,188,184,3,4,"PFyV",0
5,"5257",153,105,104,0,1,"PFyV",0
5,"5204",654,521,516,7,5,"PFyV",0
5,"5249",101,73,71,1,2,"PFyV",0
5,"5217",69,54,54,0,0,"PFyV",0
7,"7063",1414,1050,1030,25,20,"PFyV",3
5,"5086",96,81,81,2,0,"PFyV",0
5,"5219",45,33,33,0,0,"PFyV",0
5,"5080",75,53,53,1,0,"PFyV",1
5,"5157",256,187,183,0,4,"PFyV",1
5,"5177",164,134,133,0,1,"PFyV",1
5,"5200",56,43,42,0,1,"PFyV",0
5,"5242",692,556,553,18,3,"PFyV",0
5,"5139",74,62,59,2,3,"PFyV",0
5,"5234",58,49,49,0,0,"PFyV",0
5,"5187",1833,1385,1361,16,24,"PFyV",0
5,"5088",34,26,26,0,0,"PFyV",0
7,"7008",5422,3782,3705,61,77,"PFyV",4
5,"5073",319,258,254,7,4,"PFyV",0
5,"5163",1762,1400,1380,5,20,"PFyV",1
7,"7022",11700,7512,7371,128,141,"PFyV",12
5,"5097",525,378,373,4,5,"PFyV",0
5,"5253",95,75,74,0,1,"PFyV",0
7,"7059",3011,2077,2012,22,65,"PFyV",3
5,"5214",46,23,23,1,0,"PFyV",0
5,"5212",274,202,197,0,5,"PFyV",0
5,"5061",264,222,214,5,8,"PFyV",0
5,"5213",117,94,88,0,6,"PFyV",1
5,"5181",39,26,26,0,0,"PFyV",0
5,"5126",78,70,70,0,0,"PFyV",0
7,"7048",15296,8559,8439,176,120,"PFyV",10
5,"5133",62,49,49,0,0,"PFyV",0
5,"5173",62,55,55,1,0,"PFyV",0
7,"7034",971,724,708,10,16,"PFyV",2
5,"5222",155,132,132,1,0,"PFyV",0
7,"7006",4964,3234,3157,51,77,"PFyV",8
5,"5054",1282,979,965,5,14,"PFyV",0
5,"5127",715,601,596,4,5,"PFyV",0
5,"5109",438,359,351,5,8,"PFyV",1
5,"5106",39,26,26,0,0,"PFyV",0
5,"5210",105,83,82,2,1,"PFyV",0
5,"5043",86,68,68,0,0,"PFyV",0
5,"5164",34,24,24,0,0,"PFyV",0
5,"5018",27,24,24,0,0,"PFyV",0
5,"5138",326,278,275,2,3,"PFyV",0
7,"7019",230,165,164,1,1,"PFyV",0
5,"5197",114,98,98,1,0,"PFyV",1
5,"5095",301,253,250,2,3,"PFyV",0
7,"7052",4578,2671,2651,46,20,"PFyV",2
5,"5903",171,118,118,0,0,"PFyV",0
7,"7020",3455,2491,2453,46,38,"PFyV",1
5,"5160",339,290,286,2,4,"PFyV",0
5,"5237",198,157,155,3,2,"PFyV",0
5,"5198",80,65,65,1,0,"PFyV",0
7,"7038",1962,1504,1480,20,24,"PFyV",1
7,"7012",1880,1437,1405,20,32,"PFyV",1
5,"5904",149,99,97,0,2,"PFyV",1
5,"5235",136,120,119,2,1,"PFyV",0
5,"5036",136,107,106,0,1,"PFyV",0
5,"5037",296,213,212,0,1,"PFyV",0
5,"5263",175,133,131,0,2,"PFyV",1
7,"7049",1482,1046,1037,14,9,"PFyV",1
7,"7060",2534,1724,1697,30,27,"PFyV",0
7,"7045",1189,843,823,23,20,"PFyV",1
5,"5047",4267,3345,3275,34,70,"PFyV",0
5,"5040",77,59,59,1,0,"PFyV",0
5,"5090",72,64,63,1,1,"PFyV",0
5,"5007",126,104,102,0,2,"PFyV",0
5,"5033",184,159,155,3,4,"PFyV",0
5,"5243",101,69,68,0,1,"PFyV",0
5,"5102",1850,1487,1475,11,12,"PFyV",1
5,"5220",386,316,312,0,4,"PFyV",0
7,"7027",20045,12873,12678,204,195,"PFyV",25
5,"5156",260,188,185,0,3,"PFyV",0
5,"5169",241,218,218,0,0,"PFyV",0
5,"5012",156,134,132,1,2,"PFyV",0
5,"5230",79,73,73,1,0,"PFyV",0
5,"5134",47,37,37,0,0,"PFyV",0
5,"5113",90,74,74,0,0,"PFyV",0
5,"5069",91,79,78,1,1,"PFyV",0
30,"30025",4780,3901,3874,18,27,"CYD",1
2,"2026",845,723,716,5,7,"CYD",0
2,"2040",631,569,566,3,3,"CYD",0
2,"2029",3210,2512,2481,37,31,"CYD",4
30,"30020",5989,4533,4487,14,46,"CYD",2
30,"30037",17942,13830,13734,90,96,"CYD",10
2,"2065",517,450,449,4,1,"CYD",0
2,"2086",2856,2019,2005,9,14,"CYD",1
2,"2077",51,46,45,0,1,"CYD",0
2,"2016",600,471,468,5,3,"CYD",0
2,"2061",715,570,565,4,5,"CYD",0
2,"2007",1139,923,916,0,7,"CYD",0
2,"2058",390,290,285,0,5,"CYD",0
30,"30028",6810,5333,5251,44,82,"CYD",1
2,"2031",626,507,502,3,5,"CYD",0
2,"2074",6093,4630,4548,57,82,"CYD",1
30,"30026",15165,10524,10369,80,155,"CYD",11
2,"2070",439,372,366,4,6,"CYD",0
30,"30006",823,719,711,5,8,"CYD",0
2,"2048",1320,1076,1061,11,15,"CYD",0
30,"30022",16489,12207,12042,152,165,"CYD",4
2,"2072",1598,1220,1198,5,22,"CYD",1
2,"2009",19661,14804,14570,259,234,"CYD",10
2,"2079",2936,2305,2235,29,70,"CYD",3
2,"2062",456,348,344,2,4,"CYD",0
2,"2013",158,123,121,1,2,"CYD",0
30,"30016",149046,103847,102890,1031,957,"CYD",79
30,"30023",3572,2859,2811,22,48,"CYD",1
30,"30032",2839,2361,2337,21,24,"CYD",4
30,"30034",1182,956,943,3,13,"CYD",2
2,"2012",1834,1632,1622,12,10,"CYD",0
30,"30009",11961,9992,9880,92,112,"CYD",3
30,"30012",9037,7242,7142,62,100,"CYD",2
2,"2021",1114,872,860,7,12,"CYD",0
2,"2081",18319,14324,14096,225,228,"CYD",13
2,"2019",2455,2107,2077,16,30,"CYD",3
30,"30042",1841,1531,1519,10,12,"CYD",0
2,"2068",379,290,284,3,6,"CYD",0
30,"30013",7369,5780,5731,53,49,"CYD",1
2,"2057",2138,1736,1712,30,24,"CYD",1
30,"30043",24501,19738,19416,230,322,"CYD",16
2,"2030",3180,2499,2456,13,43,"CYD",3
30,"30038",15057,11640,11555,82,85,"CYD",5
2,"2004",654,554,544,7,10,"CYD",0
2,"2064",413,350,348,7,2,"CYD",0
2,"2017",895,685,682,4,3,"CYD",2
2,"2080",580,450,443,4,7,"CYD",0
2,"2059",336,262,258,3,4,"CYD",0
30,"30004",1164,958,952,1,6,"CYD",0
2,"2043",1335,1120,1108,10,12,"CYD",0
2,"2056",1816,1518,1506,15,12,"CYD",0
2,"2076",371,292,287,3,5,"CYD",0
30,"30005",29081,22312,22142,184,170,"CYD",27
2,"2060",1232,974,964,10,10,"CYD",2
2,"2033",1955,1565,1536,15,29,"CYD",0
30,"30035",17849,12871,12744,133,127,"CYD",12
30,"30014",1686,1400,1387,10,13,"CYD",1
2,"2020",519,433,430,0,3,"CYD",0
2,"2047",109,94,94,0,0,"CYD",0
2,"2032",323,261,259,1,2,"CYD",0
30,"30021",8550,6423,6349,44,74,"CYD",1
2,"2042",897,712,709,6,3,"CYD",1
2,"2067",1197,938,924,6,14,"CYD",1
30,"30902",7463,5291,5228,38,63,"CYD",1
2,"2001",731,601,584,6,17,"CYD",0
2,"2034",1419,1153,1146,18,7,"CYD",0
2,"2073",4924,3923,3847,76,76,"CYD",2
2,"2085",345,288,284,2,4,"CYD",0
2,"2041",399,311,304,1,7,"CYD",0
2,"2008",1332,985,966,12,19,"CYD",0
2,"2036",104,78,78,0,0,"CYD",0
30,"30031",560,471,469,3,2,"CYD",0
2,"2018",922,759,754,7,5,"CYD",0
2,"2082",121,107,107,1,0,"CYD",0
30,"30039",18615,14213,14068,134,145,"CYD",11
2,"2006",612,540,534,1,6,"CYD",0
2,"2014",390,333,326,5,7,"CYD",0
30,"30901",10113,8265,8194,70,71,"CYD",9
2,"2053",3053,2550,2517,33,33,"CYD",3
30,"30029",11533,8854,8768,73,86,"CYD",6
30,"30017",11683,9332,9233,95,99,"CYD",4
2,"2037",22380,15942,15724,203,218,"CYD",10
2,"2069",11624,9091,8907,119,184,"CYD",5
30,"30040",733,640,635,2,5,"CYD",0
30,"30008",13289,9992,9849,86,143,"CYD",12
2,"2028",139,115,115,1,0,"CYD",0
30,"30007",6115,4651,4603,29,48,"CYD",1
2,"2078",967,770,756,9,14,"CYD",4
2,"2005",602,490,488,2,2,"CYD",0
2,"2002",479,411,407,3,4,"CYD",0
2,"2038",296,254,254,1,0,"CYD",0
2,"2050",121,95,95,1,0,"CYD",0
2,"2025",7496,6153,5985,69,168,"CYD",6
2,"2023",636,534,533,6,1,"CYD",0
2,"2046",1165,954,941,16,13,"CYD",0
2,"2024",3424,2765,2726,32,39,"CYD",0
2,"2071",1053,899,895,5,4,"CYD",2
2,"2055",1267,900,884,6,16,"CYD",0
30,"30010",6804,5691,5647,36,44,"CYD",3
30,"30011",4687,3776,3726,20,50,"CYD",2
2,"2051",1729,1318,1303,10,15,"CYD",2
2,"2044",1207,908,893,5,15,"CYD",1
2,"2084",362,276,270,2,6,"CYD",0
2,"2022",431,346,343,1,3,"CYD",0
2,"2045",3763,3086,3035,42,51,"CYD",1
2,"2083",246,215,215,0,0,"CYD",0
2,"2052",493,417,412,9,5,"CYD",0
30,"30019",25722,18740,18553,164,187,"CYD",9
30,"30033",9940,7794,7700,79,94,"CYD",2
2,"2049",937,717,708,2,9,"CYD",0
30,"30003",23570,16482,16354,169,128,"CYD",8
30,"30030",305669,236235,234391,2112,1844,"CYD",209
30,"30001",4763,3992,3956,26,36,"CYD",5
2,"2039",1050,862,848,16,14,"CYD",1
2,"2054",421,346,343,2,3,"CYD",0
30,"30015",18792,14453,14336,120,117,"CYD",5
2,"2015",1508,1230,1211,7,19,"CYD",0
2,"2027",347,301,301,2,0,"CYD",0
2,"2003",129078,98135,97009,1430,1126,"CYD",104
2,"2075",1689,1386,1372,10,14,"CYD",0
30,"30002",9802,7628,7553,48,75,"CYD",3
2,"2011",730,612,610,3,2,"CYD",0
2,"2063",1537,1252,1242,11,10,"CYD",0
2,"2066",258,219,217,2,2,"CYD",0
30,"30027",45194,35272,34973,366,299,"CYD",26
2,"2035",1988,1601,1586,19,15,"CYD",1
30,"30041",12957,9360,9288,89,72,"CYD",2
30,"30036",13978,10244,10141,94,103,"CYD",3
2,"2901",2223,1678,1667,19,11,"CYD",2
2,"2010",1877,1557,1519,15,38,"CYD",0
30,"30024",57868,41894,41513,393,381,"CYD",22
30,"30018",7493,6003,5922,52,81,"CYD",1
28,"28132",10987,8066,7943,90,123,"FAC",8
28,"28046",4208,3297,3272,31,25,"FAC",5
28,"28125",2808,2077,2055,19,22,"FAC",4
28,"28008",1734,1244,1221,11,23,"FAC",3
28,"28041",4006,3190,3154,45,36,"FAC",2
33,"33021",4932,3544,3502,45,42,"FAC",405
33,"33065",1150,791,784,16,7,"FAC",142
33,"33008",1934,1474,1459,11,15,"FAC",235
28,"28901",765,579,567,2,12,"FAC",1
28,"28160",7496,5680,5613,46,67,"FAC",13
28,"28112",168,138,137,0,1,"FAC",0
28,"28171",4148,2972,2929,21,43,"FAC",4
28,"28065",118796,93292,92186,919,1106,"FAC",94
28,"28022",30019,24469,24279,292,190,"FAC",82
28,"28019",1195,901,888,5,13,"FAC",0
28,"28012",830,654,651,6,3,"FAC",0
28,"28011",437,318,315,2,3,"FAC",1
33,"33055",1589,1212,1192,16,20,"FAC",125
28,"28029",538,416,414,4,2,"FAC",0
28,"28155",529,427,416,2,11,"FAC",0
28,"28140",2665,2167,2141,26,26,"FAC",1
28,"28122",504,367,366,2,1,"FAC",0
28,"28146",1672,1220,1205,4,15,"FAC",0
28,"28118",72,49,47,1,2,"FAC",0
28,"28014",31360,23434,23133,203,301,"FAC",20
28,"28045",30286,23148,22879,226,269,"FAC",39
28,"28086",4603,3286,3248,29,38,"FAC",5
28,"28075",5127,3976,3916,42,60,"FAC",3
33,"33022",992,709,696,12,13,"FAC",54
33,"33054",1780,1272,1263,8,9,"FAC",163
28,"28071",77,57,55,0,2,"FAC",0
33,"33038",2442,1757,1725,14,32,"FAC",222
33,"33071",671,528,523,4,5,"FAC",48
28,"28129",7219,5536,5461,71,75,"FAC",9
28,"28177",9470,7524,7466,87,58,"FAC",29
33,"33004",69056,49228,48730,726,498,"FAC",5753
28,"28170",2503,1744,1727,20,17,"FAC",2
33,"33045",4692,3347,3297,42,50,"FAC",520
28,"28082",5144,3967,3905,46,62,"FAC",9
28,"28088",251,174,173,5,1,"FAC",0
33,"33013",466,349,345,4,4,"FAC",97
33,"33046",546,429,421,3,8,"FAC",199
33,"33077",1351,938,931,7,7,"FAC",111
33,"33001",1772,984,971,14,13,"FAC",210
28,"28069",51,35,33,1,2,"FAC",0
33,"33016",19516,14345,14210,198,135,"FAC",1819
28,"28074",136617,106248,105095,1101,1153,"FAC",175
28,"28091",5202,3714,3671,34,43,"FAC",2
33,"33057",1635,1150,1132,16,18,"FAC",134
33,"33012",5341,3816,3777,43,39,"FAC",672
28,"28064",143,112,110,1,2,"FAC",2
28,"28158",632,505,495,4,10,"FAC",1
28,"28036",2301,1809,1784,13,25,"FAC",7
28,"28106",72603,53231,52524,681,707,"FAC",55
28,"28903",29222,23945,23689,296,256,"FAC",64
33,"33018",2971,2139,2121,32,18,"FAC",195
28,"28007",122891,95200,94139,990,1061,"FAC",96
33,"33064",237,175,173,1,2,"FAC",27
33,"33006",1674,1130,1120,10,10,"FAC",123
28,"28162",2263,1802,1786,32,16,"FAC",7
28,"28048",489,398,389,3,9,"FAC",0
33,"33043",710,529,528,1,1,"FAC",55
28,"28167",7818,6016,5942,82,74,"FAC",3
28,"28005",132097,100509,99506,1069,1003,"FAC",109
28,"28123",48429,38681,38187,429,494,"FAC",36
28,"28044",5403,4245,4188,27,57,"FAC",6
33,"33044",180964,129466,128346,1888,1120,"FAC",18539
33,"33056",5278,3576,3540,41,36,"FAC",753
28,"28001",61,46,45,1,1,"FAC",0
28,"28154",5232,3910,3860,40,50,"FAC",2
33,"33062",452,282,281,3,1,"FAC",14
28,"28026",5852,4506,4449,40,57,"FAC",9
28,"28108",3002,2254,2228,31,26,"FAC",5
28,"28180",5179,4033,3975,18,58,"FAC",3
28,"28121",185,153,152,0,1,"FAC",0
28,"28130",27391,21367,21111,235,256,"FAC",16
28,"28028",1615,1204,1173,11,31,"FAC",1
33,"33066",42885,29326,29013,460,313,"FAC",4175
33,"33002",10837,7667,7588,77,79,"FAC",786
28,"28095",1358,1092,1077,8,15,"FAC",0
28,"28134",55921,42676,42221,505,455,"FAC",70
33,"33003",737,475,471,6,4,"FAC",95
28,"28047",38404,28739,28436,312,303,"FAC",51
33,"33061",446,260,259,1,1,"FAC",24
28,"28073",11899,8877,8769,112,108,"FAC",11
28,"28104",11704,9455,9361,119,94,"FAC",19
28,"28093",1911,1537,1518,19,19,"FAC",4
33,"33051",7576,5379,5335,65,44,"FAC",730
28,"28067",3893,2996,2950,26,46,"FAC",5
28,"28076",417,325,321,1,4,"FAC",0
33,"33036",11674,8695,8605,104,90,"FAC",1112
33,"33033",10609,7179,7107,91,72,"FAC",843
33,"33037",37135,25522,25262,291,260,"FAC",2095
28,"28055",932,713,707,5,6,"FAC",2
33,"33039",1719,1325,1319,14,6,"FAC",171
33,"33042",4434,3172,3135,43,37,"FAC",363
28,"28136",618,527,516,2,11,"FAC",0
28,"28040",15089,9976,9852,116,124,"FAC",15
28,"28023",4350,3425,3392,32,33,"FAC",6
28,"28017",1120,905,888,8,17,"FAC",2
28,"28037",1598,1263,1250,10,13,"FAC",0
28,"28173",507,397,390,2,7,"FAC",0
28,"28032",4469,3412,3369,32,43,"FAC",1
28,"28010",9309,7304,7229,71,75,"FAC",1
28,"28092",148714,112174,110838,1215,1336,"FAC",110
28,"28150",2985,2363,2345,21,18,"FAC",4
28,"28043",5944,4199,4147,56,52,"FAC",3
33,"33047",1178,939,931,2,8,"FAC",93
28,"28004",5761,4098,4044,38,54,"FAC",4
28,"28060",1471,1205,1192,8,13,"FAC",1
33,"33063",467,367,363,4,4,"FAC",18
28,"28083",8037,6078,6025,66,53,"FAC",8
33,"33041",7488,5356,5309,65,47,"FAC",461
28,"28059",4061,3169,3130,38,39,"FAC",9
28,"28094",774,557,551,5,6,"FAC",0
28,"28035",1314,1058,1046,3,12,"FAC",2
33,"33078",159,108,106,1,2,"FAC",16
33,"33007",1680,1186,1179,10,7,"FAC",100
28,"28179",1385,1039,1027,10,12,"FAC",2
28,"28080",45696,36832,36529,402,303,"FAC",121
28,"28057",1419,1084,1074,12,10,"FAC",3
28,"28101",222,158,158,4,0,"FAC",0
33,"33031",38090,25034,24730,380,304,"FAC",2977
28,"28135",928,665,659,6,6,"FAC",1
28,"28097",127,94,92,0,2,"FAC",0
28,"28152",14903,11954,11865,125,89,"FAC",52
33,"33005",1600,1084,1080,6,4,"FAC",160
28,"28099",1670,1258,1246,9,12,"FAC",3
33,"33069",3611,2615,2597,25,18,"FAC",253
28,"28096",16844,12441,12308,117,133,"FAC",15
33,"33053",1206,817,811,6,6,"FAC",97
28,"28053",6035,4854,4783,61,71,"FAC",4
33,"33014",9318,6380,6320,66,60,"FAC",907
28,"28151",3025,2237,2185,9,52,"FAC",2
33,"33059",5049,3480,3447,37,33,"FAC",863
28,"28163",395,305,301,7,4,"FAC",0
28,"28174",1745,1233,1224,11,9,"FAC",1
33,"33075",305,191,190,0,1,"FAC",20
28,"28100",3970,2903,2865,32,38,"FAC",2
28,"28116",666,507,498,5,9,"FAC",1
28,"28128",366,280,275,2,5,"FAC",4
33,"33030",921,682,668,4,14,"FAC",80
28,"28120",1259,946,931,11,15,"FAC",1
33,"33028",1466,812,806,5,6,"FAC",144
33,"33058",1863,1307,1286,11,21,"FAC",113
33,"33025",9455,6331,6277,84,54,"FAC",815
33,"33040",4702,3285,3236,44,49,"FAC",547
28,"28164",2807,2194,2173,10,21,"FAC",6
28,"28090",7899,6216,6131,60,85,"FAC",18
28,"28009",13466,10392,10286,102,106,"FAC",7
33,"33020",13542,9300,9173,135,127,"FAC",1064
33,"33032",12060,8627,8491,107,136,"FAC",1066
28,"28159",629,482,478,2,4,"FAC",0
28,"28049",59507,46919,46379,488,540,"FAC",36
33,"33027",929,617,613,5,4,"FAC",43
33,"33067",802,650,639,12,11,"FAC",87
28,"28157",605,452,446,2,6,"FAC",0
28,"28110",1912,1492,1475,8,17,"FAC",2
28,"28062",311,233,226,0,7,"FAC",1
28,"28031",1981,1524,1500,9,24,"FAC",3
28,"28138",78,48,46,0,2,"FAC",0
33,"33074",3699,2643,2611,30,32,"FAC",183
28,"28148",79726,60405,59651,724,754,"FAC",71
33,"33050",653,406,402,0,4,"FAC",154
33,"33034",11390,7583,7501,85,82,"FAC",1548
33,"33073",9341,5825,5773,69,52,"FAC",872
28,"28085",3794,2980,2933,18,47,"FAC",7
28,"28182",219,179,178,2,1,"FAC",0
28,"28050",3576,2706,2663,21,43,"FAC",6
28,"28165",1689,1310,1295,5,15,"FAC",0
28,"28113",31318,23779,23436,271,343,"FAC",19
33,"33029",420,243,241,3,2,"FAC",27
33,"33052",758,526,518,2,8,"FAC",78
33,"33049",6806,4629,4581,70,48,"FAC",626
28,"28038",4999,3659,3590,32,69,"FAC",8
28,"28015",14491,11562,11417,155,145,"FAC",14
33,"33024",229816,164603,163179,2100,1424,"FAC",30376
28,"28052",3799,2753,2719,17,34,"FAC",0
28,"28114",148,110,110,0,0,"FAC",0
28,"28175",780,641,630,8,11,"FAC",0
28,"28068",10502,7857,7778,68,79,"FAC",14
33,"33035",11413,8105,8035,104,70,"FAC",1171
28,"28178",1017,799,791,11,8,"FAC",5
33,"33010",1922,1284,1277,14,7,"FAC",168
33,"33048",169,120,120,1,0,"FAC",11
28,"28061",19624,15082,14905,162,177,"FAC",45
28,"28166",325,269,268,8,1,"FAC",1
28,"28168",1144,821,810,15,11,"FAC",0
28,"28127",60108,48418,48039,568,379,"FAC",168
28,"28084",15408,11489,11355,122,134,"FAC",10
28,"28066",7033,5439,5383,45,56,"FAC",4
28,"28169",1244,971,962,8,9,"FAC",1
28,"28042",1091,814,808,5,6,"FAC",2
28,"28115",57612,46786,46458,458,328,"FAC",156
28,"28002",2650,2018,1993,24,25,"FAC",3
28,"28107",443,338,333,7,5,"FAC",0
28,"28183",935,663,649,7,14,"FAC",1
28,"28020",145,102,100,0,2,"FAC",0
28,"28006",74554,57439,56890,586,549,"FAC",96
28,"28054",10459,7798,7698,65,100,"FAC",8
28,"28072",5232,4065,4007,35,58,"FAC",8
28,"28051",1469,1147,1129,7,18,"FAC",4
28,"28141",5568,4097,4051,31,46,"FAC",5
28,"28102",913,700,693,9,7,"FAC",2
33,"33009",951,673,663,7,10,"FAC",112
28,"28089",3531,2786,2753,25,33,"FAC",0
28,"28039",139,103,103,1,0,"FAC",0
33,"33011",12085,7186,7116,89,70,"FAC",1327
28,"28003",196,154,151,2,3,"FAC",1
28,"28025",426,336,332,2,4,"FAC",0
33,"33072",1737,1171,1159,11,12,"FAC",120
28,"28027",1232,937,919,9,18,"FAC",0
33,"33060",15694,11036,10883,112,153,"FAC",959
28,"28030",1591,1268,1230,12,38,"FAC",1
28,"28117",116,90,90,1,0,"FAC",0
28,"28147",910,705,698,5,7,"FAC",0
28,"28124",83,55,53,0,2,"FAC",0
28,"28087",3150,2475,2453,26,22,"FAC",3
28,"28078",39,23,23,1,0,"FAC",0
28,"28149",5276,4132,4063,43,69,"FAC",6
28,"28131",12664,9454,9342,100,112,"FAC",31
33,"33076",12662,8733,8670,120,63,"FAC",1866
28,"28144",5663,4456,4410,47,46,"FAC",14
28,"28021",418,334,328,4,6,"FAC",0
28,"28013",38226,27886,27547,246,339,"FAC",34
28,"28119",1911,1527,1514,13,13,"FAC",3
33,"33068",1224,704,703,5,1,"FAC",126
28,"28156",958,742,733,12,9,"FAC",3
28,"28137",1626,1231,1222,9,9,"FAC",2
28,"28034",356,278,276,1,2,"FAC",0
28,"28133",5868,4236,4144,23,92,"FAC",2
28,"28181",20003,16133,15952,159,181,"FAC",27
28,"28145",2125,1643,1620,15,23,"FAC",0
28,"28109",1621,1121,1104,9,17,"FAC",2
28,"28018",3572,2837,2795,20,42,"FAC",1
28,"28153",608,422,406,1,16,"FAC",0
33,"33015",1695,1177,1161,12,16,"FAC",208
28,"28058",137542,103880,102686,1155,1194,"FAC",90
28,"28143",81,71,67,1,4,"FAC",0
28,"28056",782,604,586,6,18,"FAC",1
28,"28172",7648,6130,6076,65,54,"FAC",8
28,"28111",618,486,479,2,7,"FAC",1
33,"33017",3289,2378,2350,35,28,"FAC",183
28,"28033",3581,2712,2691,14,21,"FAC",1
28,"28902",453,338,329,3,9,"FAC",0
28,"28016",86,68,67,3,1,"FAC",0
28,"28161",44185,33371,32966,353,405,"FAC",42
28,"28176",10977,8790,8718,68,72,"FAC",22
28,"28126",59,37,37,0,0,"FAC",0
28,"28070",139,98,97,0,1,"FAC",0
28,"28079",2290453,1721837,1705310,17342,16527,"FAC",4123
28,"28024",156,132,132,5,0,"FAC",0
33,"33070",3481,2557,2521,33,36,"FAC",226
33,"33023",3410,2501,2485,40,16,"FAC",224
28,"28063",268,209,203,4,6,"FAC",0
33,"33019",3262,2283,2244,12,39,"FAC",393
33,"33026",9144,6019,5959,87,60,"FAC",668
31,"31208",2574,2003,1966,32,37,"GBAI",103
31,"31063",96,77,75,0,2,"GBAI",5
31,"31127",145,89,89,2,0,"GBAI",19
31,"31033",55,34,34,0,0,"GBAI",3
31,"31111",100,75,75,1,0,"GBAI",15
31,"31259",503,341,336,6,5,"GBAI",74
31,"31073",332,228,226,1,2,"GBAI",34
31,"31198",38,33,33,0,0,"GBAI",6
31,"31080",544,428,426,7,2,"GBAI",57
31,"31012",839,577,570,10,7,"GBAI",46
31,"31172",375,295,288,11,7,"GBAI",42
31,"31197",69,58,57,1,1,"GBAI",2
31,"31008",97,64,63,1,1,"GBAI",5
31,"31250",2887,1827,1802,20,25,"GBAI",397
31,"31202",4247,3014,2957,69,57,"GBAI",216
31,"31226",597,339,335,2,4,"GBAI",91
31,"31079",99,64,63,0,1,"GBAI",2
31,"31110",97,53,53,3,0,"GBAI",4
31,"31187",122,68,68,2,0,"GBAI",20
31,"31101",1305,892,874,15,18,"GBAI",160
31,"31901",15574,11165,10974,201,191,"GBAI",1690
31,"31212",173,117,117,3,0,"GBAI",5
31,"31201",144714,104019,102644,2027,1375,"GBAI",16084
31,"31044",276,224,223,0,1,"GBAI",46
31,"31046",58,41,41,3,0,"GBAI",0
31,"31042",2719,2100,2057,27,43,"GBAI",24
31,"31124",209,139,138,1,1,"GBAI",12
31,"31039",94,65,61,0,4,"GBAI",12
31,"31147",103,81,80,3,1,"GBAI",12
31,"31148",99,69,66,2,3,"GBAI",8
31,"31138",939,648,646,14,2,"GBAI",134
31,"31170",46,40,39,3,1,"GBAI",6
31,"31126",372,247,244,6,3,"GBAI",40
31,"31121",79,53,52,2,1,"GBAI",8
31,"31204",45,35,34,0,1,"GBAI",4
31,"31151",77,49,49,2,0,"GBAI",7
31,"31185",541,377,374,2,3,"GBAI",64
31,"31135",116,87,86,9,1,"GBAI",4
31,"31072",5098,3764,3698,75,66,"GBAI",86
31,"31236",1333,887,874,15,13,"GBAI",182
31,"31229",46,38,37,0,1,"GBAI",1
31,"31222",67,46,44,3,2,"GBAI",12
31,"31040",197,137,135,2,2,"GBAI",17
31,"31157",3567,2435,2393,32,42,"GBAI",170
31,"31223",1043,783,771,14,12,"GBAI",54
31,"31207",280,198,195,7,3,"GBAI",16
31,"31205",465,335,325,9,10,"GBAI",18
31,"31055",264,194,193,0,1,"GBAI",63
31,"31167",859,600,593,11,7,"GBAI",71
31,"31141",132,100,98,1,2,"GBAI",4
31,"31181",168,121,119,3,2,"GBAI",13
31,"31123",652,379,373,8,6,"GBAI",69
31,"31069",860,660,647,2,13,"GBAI",60
31,"31061",67,47,47,2,0,"GBAI",2
31,"31120",408,267,265,8,2,"GBAI",56
31,"31078",2502,1880,1852,33,28,"GBAI",60
31,"31018",422,303,299,8,4,"GBAI",41
31,"31254",1956,1495,1476,16,19,"GBAI",81
31,"31084",1949,1369,1361,11,8,"GBAI",237
31,"31136",438,283,283,10,0,"GBAI",50
31,"31240",553,360,359,3,1,"GBAI",82
31,"31020",488,247,246,0,1,"GBAI",32
31,"31191",2930,2194,2148,43,46,"GBAI",216
31,"31043",42,30,30,1,0,"GBAI",2
31,"31227",8257,5987,5884,125,103,"GBAI",621
31,"31239",302,229,224,7,5,"GBAI",61
31,"31904",1590,1054,1031,19,23,"GBAI",193
31,"31095",83,70,70,1,0,"GBAI",7
31,"31086",11499,8520,8389,214,131,"GBAI",1376
31,"31022",544,378,369,1,9,"GBAI",75
31,"31134",195,134,132,3,2,"GBAI",25
31,"31094",123,100,97,3,3,"GBAI",7
31,"31188",185,139,137,2,2,"GBAI",20
31,"31196",40,35,35,1,0,"GBAI",4
31,"31256",113,64,64,0,0,"GBAI",16
31,"31244",153,97,97,3,0,"GBAI",24
31,"31249",1926,1376,1361,30,15,"GBAI",42
31,"31246",148,101,100,3,1,"GBAI",16
31,"31092",676,447,446,6,1,"GBAI",100
31,"31162",53,35,34,1,1,"GBAI",3
31,"31071",17,15,15,0,0,"GBAI",0
31,"31010",5788,3716,3637,48,79,"GBAI",640
31,"31237",198,137,136,7,1,"GBAI",26
31,"31241",164,117,116,4,1,"GBAI",15
31,"31186",299,205,200,3,5,"GBAI",26
31,"31007",137,96,90,2,6,"GBAI",11
31,"31023",5338,3986,3920,120,66,"GBAI",622
31,"31053",595,430,418,6,12,"GBAI",33
31,"31173",881,754,733,12,21,"GBAI",6
31,"31091",365,227,224,3,3,"GBAI",45
31,"31182",45,28,28,2,0,"GBAI",5
31,"31026",154,125,122,1,3,"GBAI",7
31,"31102",162,80,78,0,2,"GBAI",8
31,"31253",123,102,97,0,5,"GBAI",20
31,"31088",5358,3655,3592,97,63,"GBAI",469
31,"31180",240,174,170,5,4,"GBAI",19
31,"31221",1182,774,767,12,7,"GBAI",155
31,"31049",733,479,479,4,0,"GBAI",64
31,"31252",91,60,58,0,2,"GBAI",11
31,"31169",2285,1621,1590,43,31,"GBAI",44
31,"31132",160,124,124,6,0,"GBAI",9
31,"31264",173,110,108,1,2,"GBAI",17
31,"31219",93,75,73,1,2,"GBAI",6
31,"31211",25,14,14,2,0,"GBAI",1
31,"31003",131,101,101,1,0,"GBAI",18
31,"31242",235,157,157,2,0,"GBAI",26
31,"31257",827,598,585,16,13,"GBAI",88
31,"31103",51,40,40,3,0,"GBAI",1
31,"31133",48,34,34,3,0,"GBAI",5
31,"31137",215,108,106,1,2,"GBAI",20
31,"31056",183,123,122,4,1,"GBAI",15
31,"31263",241,135,132,0,3,"GBAI",32
31,"31090",156,77,77,0,0,"GBAI",34
31,"31114",384,320,318,37,2,"GBAI",20
31,"31194",308,212,210,6,2,"GBAI",46
31,"31192",148,107,104,1,3,"GBAI",21
31,"31175",78,55,54,0,1,"GBAI",8
31,"31035",60,47,47,0,0,"GBAI",4
31,"31013",668,382,375,12,7,"GBAI",64
31,"31248",318,190,187,2,3,"GBAI",24
31,"31074",430,304,303,10,1,"GBAI",48
31,"31064",1500,1137,1120,12,17,"GBAI",47
31,"31199",161,103,103,1,0,"GBAI",17
31,"31179",558,384,384,3,0,"GBAI",22
31,"31047",283,208,204,3,4,"GBAI",17
31,"31077",5349,4025,3917,103,108,"GBAI",104
31,"31098",1762,1285,1262,34,23,"GBAI",232
31,"31161",321,251,246,5,5,"GBAI",44
31,"31238",125,99,98,3,1,"GBAI",20
31,"31032",1785,1330,1305,24,25,"GBAI",48
31,"31215",4618,3384,3315,54,69,"GBAI",75
31,"31245",87,59,58,5,1,"GBAI",12
31,"31062",1103,849,832,7,17,"GBAI",16
31,"31028",217,129,128,1,1,"GBAI",21
31,"31213",114,58,58,0,0,"GBAI",9
31,"31234",148,107,105,6,2,"GBAI",8
31,"31105",1619,1306,1284,30,22,"GBAI",20
31,"31109",1365,946,934,11,12,"GBAI",170
31,"31232",24440,17810,17436,420,374,"GBAI",662
31,"31163",2008,1458,1434,22,24,"GBAI",60
31,"31096",127,112,110,2,2,"GBAI",5
31,"31070",2706,1949,1912,34,37,"GBAI",44
31,"31905",2707,1913,1881,32,32,"GBAI",180
31,"31116",71,48,48,2,0,"GBAI",3
31,"31002",421,292,284,5,8,"GBAI",57
31,"31230",118,88,85,1,3,"GBAI",15
31,"31093",305,207,203,2,4,"GBAI",50
31,"31066",915,660,647,19,13,"GBAI",32
31,"31104",1990,1374,1355,20,19,"GBAI",99
31,"31214",95,64,64,1,0,"GBAI",20
31,"31117",670,471,467,3,4,"GBAI",37
31,"31261",271,202,201,4,1,"GBAI",14
31,"31083",50,37,37,0,0,"GBAI",2
31,"31009",717,510,497,14,13,"GBAI",59
31,"31075",96,61,61,0,0,"GBAI",15
31,"31153",2246,1504,1487,13,17,"GBAI",308
31,"31006",1988,1434,1395,22,39,"GBAI",44
31,"31128",406,261,261,4,0,"GBAI",40
31,"31048",154,118,117,0,1,"GBAI",2
31,"31193",1312,969,948,33,21,"GBAI",182
31,"31195",186,127,126,1,1,"GBAI",25
31,"31085",451,334,327,3,7,"GBAI",62
31,"31165",2868,2094,2046,43,48,"GBAI",60
31,"31027",824,611,609,2,2,"GBAI",129
31,"31099",68,50,50,0,0,"GBAI",8
31,"31087",163,122,121,3,1,"GBAI",32
31,"31125",269,172,169,6,3,"GBAI",21
31,"31164",604,462,448,9,14,"GBAI",14
31,"31154",229,133,133,4,0,"GBAI",23
31,"31025",751,501,495,12,6,"GBAI",90
31,"31113",147,87,85,2,2,"GBAI",11
31,"31106",676,534,518,10,16,"GBAI",11
31,"31082",634,402,398,10,4,"GBAI",65
31,"31265",81,52,50,0,2,"GBAI",6
31,"31184",66,60,59,0,1,"GBAI",11
31,"31011",688,437,432,17,5,"GBAI",50
31,"31031",234,144,143,1,1,"GBAI",21
31,"31081",335,249,243,8,6,"GBAI",66
31,"31076",2314,1843,1823,39,20,"GBAI",198
31,"31015",1989,1404,1380,29,24,"GBAI",98
31,"31262",219,158,157,4,1,"GBAI",37
31,"31258",7679,5561,5475,92,86,"GBAI",995
31,"31030",155,113,112,3,1,"GBAI",24
31,"31060",12916,8830,8687,158,143,"GBAI",1327
31,"31907",9914,7394,7282,198,112,"GBAI",1247
31,"31041",1397,938,913,26,25,"GBAI",121
31,"31065",1927,1391,1362,39,29,"GBAI",47
31,"31176",2777,1999,1955,57,44,"GBAI",43
31,"31158",264,174,173,1,1,"GBAI",32
31,"31247",171,121,121,1,0,"GBAI",20
31,"31118",182,114,114,6,0,"GBAI",36
31,"31017",358,220,219,12,1,"GBAI",53
31,"31059",204,140,139,3,1,"GBAI",20
31,"31052",89,62,58,1,4,"GBAI",7
31,"31130",319,213,209,1,4,"GBAI",33
31,"31051",270,182,181,8,1,"GBAI",11
31,"31177",264,162,158,3,4,"GBAI",26
31,"31005",312,209,206,4,3,"GBAI",21
31,"31001",88,58,58,1,0,"GBAI",12
31,"31115",171,112,109,2,3,"GBAI",32
31,"31068",3004,2258,2207,43,51,"GBAI",59
31,"31057",1863,1450,1409,32,41,"GBAI",28
31,"31149",2381,1626,1607,7,19,"GBAI",225
31,"31251",3147,2274,2225,39,49,"GBAI",207
31,"31159",1158,864,846,17,18,"GBAI",139
31,"31178",540,395,392,4,3,"GBAI",11
31,"31107",1706,1321,1311,17,10,"GBAI",27
31,"31131",841,610,594,12,16,"GBAI",106
31,"31050",6253,4045,3987,74,58,"GBAI",737
31,"31144",840,509,508,7,1,"GBAI",91
31,"31174",115,72,70,1,2,"GBAI",5
31,"31140",117,91,89,3,2,"GBAI",25
31,"31004",36,21,20,0,1,"GBAI",5
31,"31058",240,184,179,0,5,"GBAI",57
31,"31143",105,62,58,2,4,"GBAI",5
31,"31097",10461,7152,7029,129,123,"GBAI",944
31,"31119",49,28,28,0,0,"GBAI",8
31,"31183",667,516,508,8,8,"GBAI",69
31,"31225",40,32,32,0,0,"GBAI",7
31,"31210",219,169,167,3,2,"GBAI",30
31,"31166",274,183,182,2,1,"GBAI",18
31,"31908",997,692,683,9,9,"GBAI",182
31,"31171",738,521,495,7,26,"GBAI",45
31,"31235",189,111,110,0,1,"GBAI",8
31,"31089",246,198,195,4,3,"GBAI",27
31,"31019",1858,1288,1266,25,22,"GBAI",163
31,"31233",103,87,82,2,5,"GBAI",3
31,"31037",94,68,68,0,0,"GBAI",21
31,"31224",980,691,681,9,10,"GBAI",45
31,"31034",43,29,29,0,0,"GBAI",7
31,"31152",1406,1003,975,23,28,"GBAI",93
31,"31036",957,631,616,22,15,"GBAI",87
31,"31231",127,93,91,1,2,"GBAI",2
31,"31029",987,693,680,16,13,"GBAI",78
31,"31016",7377,5149,5072,101,77,"GBAI",869
31,"31155",264,187,183,7,4,"GBAI",13
31,"31243",313,227,223,5,4,"GBAI",33
31,"31100",298,193,193,2,0,"GBAI",29
31,"31217",382,256,244,5,12,"GBAI",17
31,"31038",1372,982,968,17,14,"GBAI",126
31,"31255",100,78,78,1,0,"GBAI",8
31,"31112",106,79,78,0,1,"GBAI",14
31,"31067",1982,1400,1363,28,37,"GBAI",109
31,"31142",1443,906,899,16,7,"GBAI",61
31,"31021",75,52,52,0,0,"GBAI",7
31,"31200",763,527,514,17,13,"GBAI",48
31,"31209",155,105,104,1,1,"GBAI",18
31,"31260",1263,788,780,11,8,"GBAI",100
31,"31906",2493,1796,1770,57,26,"GBAI",233
31,"31150",234,163,162,5,1,"GBAI",27
31,"31014",280,197,196,2,1,"GBAI",17
31,"31160",111,93,93,7,0,"GBAI",14
31,"31203",30,25,25,0,0,"GBAI",1
31,"31903",6058,3985,3919,67,66,"GBAI",418
31,"31146",46,34,34,1,0,"GBAI",4
31,"31228",540,376,364,13,12,"GBAI",57
31,"31045",501,384,377,16,7,"GBAI",57
31,"31145",173,129,127,2,2,"GBAI",6
31,"31220",771,584,572,9,12,"GBAI",18
31,"31108",1969,1474,1452,23,22,"GBAI",40
31,"31189",1229,745,740,5,5,"GBAI",116
31,"31139",172,97,97,1,0,"GBAI",12
31,"31902",3722,2670,2632,77,38,"GBAI",439
31,"31190",48,34,34,1,0,"GBAI",6
31,"31122",4506,3333,3281,76,52,"GBAI",656
31,"31168",247,165,163,0,2,"GBAI",24
31,"31129",405,285,281,1,4,"GBAI",65
31,"31156",268,202,201,5,1,"GBAI",38
31,"31216",3911,2699,2653,82,46,"GBAI",389
31,"31024",116,56,56,2,0,"GBAI",8
31,"31206",2079,1517,1475,33,42,"GBAI",226
31,"31054",498,310,308,1,2,"GBAI",42
45,"45098",2273,1799,1756,11,43,"HARTOS.ORG",2
43,"43066",165,113,112,2,1,"HARTOS.ORG",1
5,"5012",156,134,132,1,2,"HARTOS.ORG",0
43,"43061",55,31,31,1,0,"HARTOS.ORG",0
5,"5046",44,39,38,1,1,"HARTOS.ORG",0
45,"45086",491,406,399,3,7,"HARTOS.ORG",1
45,"45138",1185,998,973,5,25,"HARTOS.ORG",1
33,"33034",11390,7583,7501,85,82,"HARTOS.ORG",10
45,"45184",219,150,148,3,2,"HARTOS.ORG",0
45,"45135",4437,3621,3550,44,71,"HARTOS.ORG",2
43,"43077",486,335,328,4,7,"HARTOS.ORG",1
45,"45040",1504,1058,1046,5,12,"HARTOS.ORG",4
5,"5189",478,361,360,3,1,"HARTOS.ORG",2
5,"5082",569,467,462,1,5,"HARTOS.ORG",0
43,"43143",62,51,50,1,1,"HARTOS.ORG",0
5,"5156",260,188,185,0,3,"HARTOS.ORG",2
43,"43167",390,284,280,12,4,"HARTOS.ORG",1
43,"43118",439,318,313,7,5,"HARTOS.ORG",1
43,"43102",517,377,366,2,11,"HARTOS.ORG",0
45,"45163",8239,6203,6073,103,130,"HARTOS.ORG",12
5,"5176",237,193,190,4,3,"HARTOS.ORG",0
5,"5266",112,92,89,0,3,"HARTOS.ORG",0
43,"43124",532,366,358,3,8,"HARTOS.ORG",1
45,"45053",8208,6763,6663,103,100,"HARTOS.ORG",14
5,"5112",125,88,87,0,1,"HARTOS.ORG",0
43,"43165",624,471,459,6,12,"HARTOS.ORG",0
43,"43042",2071,1504,1485,28,19,"HARTOS.ORG",2
45,"45016",3804,2926,2876,52,50,"HARTOS.ORG",5
5,"5155",60,44,44,1,0,"HARTOS.ORG",0
45,"45025",1237,919,907,11,12,"HARTOS.ORG",3
45,"45145",2430,1866,1821,13,45,"HARTOS.ORG",13
45,"45012",683,572,566,10,6,"HARTOS.ORG",1
43,"43004",6411,4089,4001,92,88,"HARTOS.ORG",10
5,"5089",500,390,375,3,15,"HARTOS.ORG",0
43,"43069",194,131,127,3,4,"HARTOS.ORG",0
11,"11008",16655,11309,11189,184,120,"HARTOS.ORG",12
43,"43071",975,677,664,14,13,"HARTOS.ORG",1
33,"33005",1600,1084,1080,6,4,"HARTOS.ORG",0
5,"5104",35,29,29,0,0,"HARTOS.ORG",0
43,"43902",2761,1836,1811,25,25,"HARTOS.ORG",1
5,"5072",91,72,72,1,0,"HARTOS.ORG",0
5,"5219",45,33,33,0,0,"HARTOS.ORG",1
5,"5022",1649,1335,1328,7,7,"HARTOS.ORG",2
33,"33061",446,260,259,1,1,"HARTOS.ORG",0
45,"45123",2961,2081,2049,30,32,"HARTOS.ORG",4
33,"33031",38090,25034,24730,380,304,"HARTOS.ORG",32
5,"5118",91,66,66,0,0,"HARTOS.ORG",0
11,"11001",4389,3110,3072,13,38,"HARTOS.ORG",3
45,"45147",598,484,478,9,6,"HARTOS.ORG",0
5,"5246",68,57,56,1,1,"HARTOS.ORG",0
11,"11012",103946,68124,67375,856,749,"HARTOS.ORG",121
5,"5256",119,101,100,0,1,"HARTOS.ORG",0
45,"45200",4633,3768,3672,37,96,"HARTOS.ORG",7
45,"45134",1606,1260,1242,10,18,"HARTOS.ORG",3
5,"5060",127,108,105,1,3,"HARTOS.ORG",1
5,"5230",79,73,73,1,0,"HARTOS.ORG",0
43,"43148",89309,59260,58346,1202,914,"HARTOS.ORG",238
45,"45175",698,587,579,5,8,"HARTOS.ORG",1
5,"5078",128,112,111,2,1,"HARTOS.ORG",0
33,"33054",1780,1272,1263,8,9,"HARTOS.ORG",0
5,"5054",1282,979,965,5,14,"HARTOS.ORG",6
5,"5154",46,35,35,0,0,"HARTOS.ORG",0
5,"5258",123,105,104,1,1,"HARTOS.ORG",0
43,"43074",1697,1150,1120,25,30,"HARTOS.ORG",1
45,"45004",603,497,494,6,3,"HARTOS.ORG",0
45,"45101",3761,3212,3181,19,31,"HARTOS.ORG",1
45,"45139",231,198,194,0,4,"HARTOS.ORG",0
11,"11033",19983,12960,12807,199,153,"HARTOS.ORG",17
45,"45126",278,188,187,0,1,"HARTOS.ORG",1
5,"5222",155,132,132,1,0,"HARTOS.ORG",1
43,"43054",2850,1815,1771,37,44,"HARTOS.ORG",1
5,"5167",274,230,224,6,6,"HARTOS.ORG",1
5,"5139",74,62,59,2,3,"HARTOS.ORG",0
43,"43096",103,81,77,3,4,"HARTOS.ORG",0
43,"43001",706,481,473,12,8,"HARTOS.ORG",2
43,"43156",4120,2811,2741,66,70,"HARTOS.ORG",6
5,"5125",60,52,52,0,0,"HARTOS.ORG",0
33,"33066",42885,29326,29013,460,313,"HARTOS.ORG",54
5,"5211",484,406,405,3,1,"HARTOS.ORG",2
11,"11018",1528,1194,1178,9,16,"HARTOS.ORG",1
5,"5221",398,298,297,10,1,"HARTOS.ORG",0
43,"43175",590,419,411,8,8,"HARTOS.ORG",0
43,"43036",836,503,494,4,9,"HARTOS.ORG",0
33,"33062",452,282,281,3,1,"HARTOS.ORG",0
43,"43012",3392,2346,2295,48,51,"HARTOS.ORG",7
45,"45197",1972,1570,1538,8,32,"HARTOS.ORG",2
43,"43107",378,255,248,18,7,"HARTOS.ORG",4
45,"45170",257,186,183,0,3,"HARTOS.ORG",1
5,"5002",1996,1497,1476,15,21,"HARTOS.ORG",4
43,"43091",142,106,98,5,8,"HARTOS.ORG",0
45,"45058",409,334,332,2,2,"HARTOS.ORG",3
45,"45117",800,679,668,7,11,"HARTOS.ORG",0
45,"45003",607,515,511,3,4,"HARTOS.ORG",2
43,"43174",152,104,101,1,3,"HARTOS.ORG",0
45,"45049",394,315,315,6,0,"HARTOS.ORG",0
43,"43085",229,178,171,0,7,"HARTOS.ORG",0
43,"43110",307,216,214,5,2,"HARTOS.ORG",0
45,"45074",428,349,343,3,6,"HARTOS.ORG",0
45,"45165",62818,47242,46629,549,613,"HARTOS.ORG",83
33,"33028",1466,812,806,5,6,"HARTOS.ORG",0
5,"5252",70,52,51,0,1,"HARTOS.ORG",0
43,"43170",880,601,592,9,9,"HARTOS.ORG",1
45,"45070",1415,1175,1162,11,13,"HARTOS.ORG",0
5,"5161",638,525,522,0,3,"HARTOS.ORG",0
43,"43050",2407,1528,1504,20,24,"HARTOS.ORG",2
33,"33003",737,475,471,6,4,"HARTOS.ORG",0
45,"45152",653,503,497,2,6,"HARTOS.ORG",1
33,"33024",229816,164603,163179,2100,1424,"HARTOS.ORG",218
45,"45055",1052,886,870,10,16,"HARTOS.ORG",0
43,"43075",102,63,63,1,0,"HARTOS.ORG",0
5,"5070",41,33,33,0,0,"HARTOS.ORG",0
43,"43020",2119,1463,1427,26,36,"HARTOS.ORG",4
43,"43905",13621,8120,8011,131,109,"HARTOS.ORG",26
45,"45017",268,215,212,1,3,"HARTOS.ORG",0
45,"45077",554,430,423,7,7,"HARTOS.ORG",0
43,"43131",4495,2842,2814,51,28,"HARTOS.ORG",6
43,"43162",4143,2892,2833,59,59,"HARTOS.ORG",10
33,"33053",1206,817,811,6,6,"HARTOS.ORG",1
5,"5218",148,123,117,1,6,"HARTOS.ORG",0
5,"5162",107,71,71,0,0,"HARTOS.ORG",0
45,"45162",773,599,594,3,5,"HARTOS.ORG",0
5,"5212",274,202,197,0,5,"HARTOS.ORG",0
45,"45102",3539,2581,2533,23,48,"HARTOS.ORG",4
5,"5093",431,330,329,1,1,"HARTOS.ORG",1
43,"43136",10163,6312,6197,121,115,"HARTOS.ORG",2
43,"43078",841,557,547,7,10,"HARTOS.ORG",0
5,"5182",862,673,668,2,5,"HARTOS.ORG",0
43,"43151",119,91,89,0,2,"HARTOS.ORG",0
5,"5057",2593,2172,2152,16,20,"HARTOS.ORG",1
45,"45129",145,121,120,0,1,"HARTOS.ORG",0
5,"5159",287,216,216,0,0,"HARTOS.ORG",0
43,"43154",136,97,96,6,1,"HARTOS.ORG",0
11,"11036",725,484,482,10,2,"HARTOS.ORG",0
11,"11037",5640,4337,4285,32,52,"HARTOS.ORG",6
43,"43097",379,283,278,6,5,"HARTOS.ORG",1
5,"5048",131,112,111,0,1,"HARTOS.ORG",0
33,"33004",69056,49228,48730,726,498,"HARTOS.ORG",79
45,"45062",1161,959,928,8,31,"HARTOS.ORG",0
5,"5209",104,78,78,0,0,"HARTOS.ORG",1
5,"5035",105,87,87,2,0,"HARTOS.ORG",0
5,"5191",124,98,98,2,0,"HARTOS.ORG",0
45,"45092",252,223,221,0,2,"HARTOS.ORG",0
45,"45122",4828,3816,3746,48,70,"HARTOS.ORG",11
33,"33023",3410,2501,2485,40,16,"HARTOS.ORG",4
45,"45114",608,476,468,3,8,"HARTOS.ORG",0
45,"45106",7666,6045,5945,92,100,"HARTOS.ORG",11
45,"45039",236,197,190,2,7,"HARTOS.ORG",0
45,"45002",2500,1771,1756,26,15,"HARTOS.ORG",7
43,"43906",2050,1332,1298,28,34,"HARTOS.ORG",3
5,"5037",296,213,212,0,1,"HARTOS.ORG",0
45,"45091",419,311,309,5,2,"HARTOS.ORG",1
11,"11010",6452,4534,4510,61,24,"HARTOS.ORG",2
11,"11019",1871,1449,1425,9,24,"HARTOS.ORG",1
5,"5195",241,168,164,0,4,"HARTOS.ORG",0
45,"45069",1791,1409,1389,8,20,"HARTOS.ORG",1
5,"5204",654,521,516,7,5,"HARTOS.ORG",1
11,"11005",4617,3287,3214,26,73,"HARTOS.ORG",5
45,"45181",2276,1788,1764,10,24,"HARTOS.ORG",5
5,"5225",423,346,342,8,4,"HARTOS.ORG",0
33,"33013",466,349,345,4,4,"HARTOS.ORG",0
5,"5096",74,56,56,0,0,"HARTOS.ORG",1
11,"11039",9943,6634,6582,104,52,"HARTOS.ORG",9
33,"33051",7576,5379,5335,65,44,"HARTOS.ORG",6
5,"5233",246,212,212,2,0,"HARTOS.ORG",0
43,"43068",573,388,378,5,10,"HARTOS.ORG",0
33,"33018",2971,2139,2121,32,18,"HARTOS.ORG",4
5,"5199",48,39,39,0,0,"HARTOS.ORG",0
5,"5101",297,224,222,4,2,"HARTOS.ORG",1
45,"45089",1615,1238,1221,16,17,"HARTOS.ORG",0
45,"45158",2577,1948,1909,18,39,"HARTOS.ORG",5
43,"43044",3990,2768,2715,72,53,"HARTOS.ORG",3
5,"5045",104,82,82,0,0,"HARTOS.ORG",0
45,"45045",1313,992,979,12,13,"HARTOS.ORG",3
5,"5108",64,41,41,0,0,"HARTOS.ORG",0
45,"45078",1451,1243,1228,7,15,"HARTOS.ORG",1
11,"11009",636,430,424,2,6,"HARTOS.ORG",1
43,"43070",265,198,196,3,2,"HARTOS.ORG",0
5,"5094",158,124,124,3,0,"HARTOS.ORG",0
45,"45042",184,154,151,3,3,"HARTOS.ORG",0
33,"33057",1635,1150,1132,16,18,"HARTOS.ORG",0
43,"43005",3559,2191,2147,47,44,"HARTOS.ORG",10
43,"43127",778,530,524,6,6,"HARTOS.ORG",3
43,"43055",2002,1404,1374,36,30,"HARTOS.ORG",4
43,"43113",454,321,316,10,5,"HARTOS.ORG",1
43,"43009",1421,913,897,18,16,"HARTOS.ORG",3
11,"11007",17997,10781,10676,184,105,"HARTOS.ORG",14
5,"5007",126,104,102,0,2,"HARTOS.ORG",0
5,"5013",890,746,739,4,7,"HARTOS.ORG",0
5,"5242",692,556,553,18,3,"HARTOS.ORG",0
5,"5103",84,68,68,3,0,"HARTOS.ORG",0
45,"45105",426,326,322,2,4,"HARTOS.ORG",1
5,"5172",147,122,122,0,0,"HARTOS.ORG",0
33,"33043",710,529,528,1,1,"HARTOS.ORG",0
5,"5069",91,79,78,1,1,"HARTOS.ORG",1
43,"43164",298,233,231,4,2,"HARTOS.ORG",2
43,"43081",574,415,404,13,11,"HARTOS.ORG",0
11,"11020",163674,106898,106082,1655,816,"HARTOS.ORG",199
45,"45153",1704,1376,1353,9,23,"HARTOS.ORG",2
45,"45161",11339,7989,7869,95,120,"HARTOS.ORG",29
5,"5143",81,61,61,0,0,"HARTOS.ORG",0
45,"45196",1363,1092,1076,3,16,"HARTOS.ORG",0
43,"43033",772,547,533,4,14,"HARTOS.ORG",2
5,"5175",190,149,149,2,0,"HARTOS.ORG",0
43,"43137",1873,1241,1212,27,29,"HARTOS.ORG",1
43,"43094",2209,1558,1524,31,34,"HARTOS.ORG",2
43,"43017",141,98,98,2,0,"HARTOS.ORG",1
45,"45110",1918,1585,1570,10,15,"HARTOS.ORG",1
45,"45065",317,261,258,0,3,"HARTOS.ORG",0
33,"33001",1772,984,971,14,13,"HARTOS.ORG",1
5,"5165",386,292,280,7,12,"HARTOS.ORG",1
33,"33008",1934,1474,1459,11,15,"HARTOS.ORG",0
45,"45167",1552,1296,1278,14,18,"HARTOS.ORG",4
11,"11901",5576,4433,4398,69,35,"HARTOS.ORG",3
45,"45118",1980,1412,1390,13,22,"HARTOS.ORG",1
43,"43129",4525,3032,2956,62,76,"HARTOS.ORG",7
43,"43023",244,179,177,8,2,"HARTOS.ORG",2
45,"45029",233,207,202,4,5,"HARTOS.ORG",1
5,"5126",78,70,70,0,0,"HARTOS.ORG",0
45,"45054",4285,3321,3274,32,47,"HARTOS.ORG",2
5,"5117",213,183,180,0,3,"HARTOS.ORG",0
45,"45079",368,278,273,1,5,"HARTOS.ORG",0
43,"43176",832,575,572,16,3,"HARTOS.ORG",0
5,"5245",344,285,284,5,1,"HARTOS.ORG",1
45,"45128",2558,1831,1806,20,25,"HARTOS.ORG",2
5,"5257",153,105,104,0,1,"HARTOS.ORG",0
45,"45006",1524,1128,1110,13,18,"HARTOS.ORG",0
45,"45088",2038,1379,1356,14,23,"HARTOS.ORG",4
43,"43904",2918,1779,1732,49,47,"HARTOS.ORG",2
5,"5114",1418,1195,1182,9,13,"HARTOS.ORG",0
43,"43076",467,308,300,7,8,"HARTOS.ORG",0
43,"43149",711,529,516,13,13,"HARTOS.ORG",0
5,"5235",136,120,119,2,1,"HARTOS.ORG",0
5,"5107",74,54,53,0,1,"HARTOS.ORG",0
33,"33020",13542,9300,9173,135,127,"HARTOS.ORG",13
33,"33042",4434,3172,3135,43,37,"HARTOS.ORG",17
43,"43019",1356,868,837,13,31,"HARTOS.ORG",3
43,"43106",878,600,592,17,8,"HARTOS.ORG",1
5,"5021",2044,1592,1557,37,35,"HARTOS.ORG",0
5,"5261",48,32,31,0,1,"HARTOS.ORG",0
33,"33063",467,367,363,4,4,"HARTOS.ORG",0
33,"33071",671,528,523,4,5,"HARTOS.ORG",1
43,"43003",307,187,184,10,3,"HARTOS.ORG",1
43,"43134",279,208,206,14,2,"HARTOS.ORG",0
5,"5178",392,310,304,2,6,"HARTOS.ORG",0
45,"45188",2883,2180,2151,30,29,"HARTOS.ORG",5
33,"33064",237,175,173,1,2,"HARTOS.ORG",0
43,"43142",1155,730,714,20,16,"HARTOS.ORG",0
43,"43132",365,217,214,8,3,"HARTOS.ORG",2
45,"45035",307,236,236,3,0,"HARTOS.ORG",0
33,"33056",5278,3576,3540,41,36,"HARTOS.ORG",4
33,"33069",3611,2615,2597,25,18,"HARTOS.ORG",3
5,"5132",1040,770,753,2,17,"HARTOS.ORG",0
43,"43031",1509,1016,992,20,24,"HARTOS.ORG",3
5,"5005",199,170,169,1,1,"HARTOS.ORG",1
33,"33072",1737,1171,1159,11,12,"HARTOS.ORG",0
45,"45005",267,223,218,4,5,"HARTOS.ORG",0
45,"45032",471,340,333,2,7,"HARTOS.ORG",1
33,"33035",11413,8105,8035,104,70,"HARTOS.ORG",6
43,"43045",156,110,109,1,1,"HARTOS.ORG",0
5,"5090",72,64,63,1,1,"HARTOS.ORG",0
5,"5216",237,195,192,0,3,"HARTOS.ORG",0
33,"33027",929,617,613,5,4,"HARTOS.ORG",0
5,"5160",339,290,286,2,4,"HARTOS.ORG",1
5,"5095",301,253,250,2,3,"HARTOS.ORG",0
43,"43062",298,227,223,7,4,"HARTOS.ORG",0
43,"43016",3437,2323,2266,40,57,"HARTOS.ORG",7
43,"43104",1821,1209,1178,34,31,"HARTOS.ORG",2
33,"33060",15694,11036,10883,112,153,"HARTOS.ORG",6
33,"33032",12060,8627,8491,107,136,"HARTOS.ORG",9
33,"33033",10609,7179,7107,91,72,"HARTOS.ORG",6
45,"45112",2022,1470,1423,12,47,"HARTOS.ORG",0
33,"33040",4702,3285,3236,44,49,"HARTOS.ORG",8
45,"45027",433,352,349,1,3,"HARTOS.ORG",0
11,"11026",4834,3736,3691,27,45,"HARTOS.ORG",3
5,"5164",34,24,24,0,0,"HARTOS.ORG",0
43,"43014",14146,9153,8915,204,238,"HARTOS.ORG",20
5,"5214",46,23,23,1,0,"HARTOS.ORG",0
5,"5158",410,333,331,2,2,"HARTOS.ORG",0
43,"43011",1013,745,729,21,16,"HARTOS.ORG",1
5,"5249",101,73,71,1,2,"HARTOS.ORG",0
33,"33058",1863,1307,1286,11,21,"HARTOS.ORG",0
45,"45019",7033,5207,5110,89,97,"HARTOS.ORG",12
5,"5193",224,197,197,2,0,"HARTOS.ORG",0
45,"45057",222,197,189,0,8,"HARTOS.ORG",1
43,"43063",588,358,350,13,8,"HARTOS.ORG",0
43,"43150",1337,994,977,12,17,"HARTOS.ORG",2
45,"45036",704,559,537,4,22,"HARTOS.ORG",1
5,"5036",136,107,106,0,1,"HARTOS.ORG",1
45,"45024",1105,870,856,16,14,"HARTOS.ORG",0
43,"43058",106,76,76,5,0,"HARTOS.ORG",0
11,"11022",48624,26656,26430,345,226,"HARTOS.ORG",22
45,"45082",1333,1143,1123,14,20,"HARTOS.ORG",0
43,"43099",330,240,236,4,4,"HARTOS.ORG",0
43,"43115",171,112,110,3,2,"HARTOS.ORG",1
43,"43079",387,259,255,26,4,"HARTOS.ORG",1
45,"45094",441,358,353,6,5,"HARTOS.ORG",0
45,"45151",631,474,470,1,4,"HARTOS.ORG",1
45,"45051",1658,1305,1293,20,12,"HARTOS.ORG",2
5,"5240",3351,2472,2428,22,44,"HARTOS.ORG",2
43,"43086",5269,3275,3196,92,79,"HARTOS.ORG",8
43,"43013",4369,2795,2747,54,48,"HARTOS.ORG",8
11,"11041",9805,7136,7067,87,69,"HARTOS.ORG",3
43,"43111",2096,1305,1281,19,24,"HARTOS.ORG",1
5,"5073",319,258,254,7,4,"HARTOS.ORG",0
11,"11023",9209,6979,6929,81,50,"HARTOS.ORG",4
45,"45169",239,183,183,1,0,"HARTOS.ORG",1
43,"43051",8749,5494,5411,78,83,"HARTOS.ORG",22
11,"11035",13266,8794,8668,115,126,"HARTOS.ORG",18
45,"45144",839,701,691,11,10,"HARTOS.ORG",0
43,"43171",13906,8978,8855,167,123,"HARTOS.ORG",36
45,"45038",3125,2401,2374,33,27,"HARTOS.ORG",4
33,"33002",10837,7667,7588,77,79,"HARTOS.ORG",9
43,"43022",1559,1097,1074,22,23,"HARTOS.ORG",1
45,"45056",2246,1523,1502,16,21,"HARTOS.ORG",5
5,"5198",80,65,65,1,0,"HARTOS.ORG",0
5,"5131",118,86,86,3,0,"HARTOS.ORG",0
43,"43139",2166,1319,1270,37,49,"HARTOS.ORG",5
11,"11029",5360,3445,3423,27,22,"HARTOS.ORG",0
43,"43128",927,636,625,11,11,"HARTOS.ORG",0
45,"45174",343,289,288,0,1,"HARTOS.ORG",0
45,"45073",351,265,261,3,4,"HARTOS.ORG",1
33,"33046",546,429,421,3,8,"HARTOS.ORG",0
5,"5905",253,200,198,1,2,"HARTOS.ORG",1
45,"45195",2229,1806,1784,11,22,"HARTOS.ORG",0
11,"11042",1232,933,922,4,11,"HARTOS.ORG",1
5,"5030",43,39,39,0,0,"HARTOS.ORG",0
5,"5014",5559,4197,4101,53,96,"HARTOS.ORG",11
45,"45097",1094,934,925,9,9,"HARTOS.ORG",0
43,"43172",378,268,266,8,2,"HARTOS.ORG",0
45,"45171",1359,1114,1093,13,21,"HARTOS.ORG",1
5,"5262",378,308,307,2,1,"HARTOS.ORG",0
45,"45061",2523,1839,1813,20,26,"HARTOS.ORG",1
5,"5063",48,39,39,2,0,"HARTOS.ORG",0
5,"5140",112,100,99,1,1,"HARTOS.ORG",0
5,"5183",165,142,140,0,2,"HARTOS.ORG",0
5,"5053",94,73,71,0,2,"HARTOS.ORG",0
33,"33006",1674,1130,1120,10,10,"HARTOS.ORG",1
5,"5127",715,601,596,4,5,"HARTOS.ORG",1
43,"43021",381,218,213,3,5,"HARTOS.ORG",1
45,"45050",508,385,378,0,7,"HARTOS.ORG",1
45,"45111",65,47,44,1,3,"HARTOS.ORG",0
5,"5027",290,233,230,2,3,"HARTOS.ORG",0
5,"5244",66,45,45,0,0,"HARTOS.ORG",0
43,"43056",931,537,515,18,22,"HARTOS.ORG",0
45,"45115",2600,2140,2105,14,35,"HARTOS.ORG",6
43,"43103",897,586,575,21,11,"HARTOS.ORG",3
5,"5149",128,97,97,1,0,"HARTOS.ORG",0
45,"45116",682,576,565,0,11,"HARTOS.ORG",0
43,"43125",1008,706,701,10,5,"HARTOS.ORG",1
5,"5124",134,111,109,1,2,"HARTOS.ORG",0
45,"45076",603,420,419,3,1,"HARTOS.ORG",1
43,"43133",5697,3470,3388,76,82,"HARTOS.ORG",12
45,"45014",4087,2851,2816,36,35,"HARTOS.ORG",3
45,"45023",1936,1476,1456,18,20,"HARTOS.ORG",2
5,"5001",210,180,176,2,4,"HARTOS.ORG",0
45,"45081",16099,12232,12079,154,153,"HARTOS.ORG",44
45,"45179",608,476,471,3,5,"HARTOS.ORG",0
5,"5034",17,13,13,0,0,"HARTOS.ORG",0
45,"45121",6553,4720,4653,43,67,"HARTOS.ORG",7
43,"43049",805,555,536,6,19,"HARTOS.ORG",3
43,"43166",1521,1002,977,17,25,"HARTOS.ORG",1
11,"11027",67042,43386,43065,557,321,"HARTOS.ORG",86
33,"33041",7488,5356,5309,65,47,"HARTOS.ORG",7
5,"5135",440,363,360,0,3,"HARTOS.ORG",1
45,"45199",2712,1817,1796,17,21,"HARTOS.ORG",6
5,"5038",131,88,84,0,4,"HARTOS.ORG",0
5,"5168",3682,2846,2801,43,45,"HARTOS.ORG",3
5,"5025",108,86,86,2,0,"HARTOS.ORG",0
5,"5226",92,67,67,0,0,"HARTOS.ORG",0
45,"45146",117,99,98,0,1,"HARTOS.ORG",0
45,"45020",1396,1165,1151,15,14,"HARTOS.ORG",3
11,"11021",6838,5102,5049,67,53,"HARTOS.ORG",8
5,"5066",480,397,392,5,5,"HARTOS.ORG",0
11,"11024",6811,5241,5202,58,39,"HARTOS.ORG",1
43,"43047",4064,2412,2352,50,60,"HARTOS.ORG",13
5,"5042",156,126,126,0,0,"HARTOS.ORG",0
45,"45028",3696,3059,3024,40,35,"HARTOS.ORG",4
45,"45008",158,129,127,0,2,"HARTOS.ORG",0
45,"45176",3570,2619,2583,45,36,"HARTOS.ORG",9
43,"43029",330,202,194,6,8,"HARTOS.ORG",0
5,"5170",63,50,50,0,0,"HARTOS.ORG",0
33,"33029",420,243,241,3,2,"HARTOS.ORG",0
5,"5019",44095,34409,33934,505,475,"HARTOS.ORG",63
33,"33011",12085,7186,7116,89,70,"HARTOS.ORG",2
5,"5084",81,70,69,0,1,"HARTOS.ORG",0
5,"5153",112,89,89,5,0,"HARTOS.ORG",0
45,"45022",427,317,314,8,3,"HARTOS.ORG",0
5,"5220",386,316,312,0,4,"HARTOS.ORG",0
45,"45132",1916,1487,1473,9,14,"HARTOS.ORG",1
33,"33050",653,406,402,0,4,"HARTOS.ORG",0
5,"5210",105,83,82,2,1,"HARTOS.ORG",0
43,"43158",109,63,61,5,2,"HARTOS.ORG",0
43,"43067",626,445,431,21,14,"HARTOS.ORG",0
45,"45186",3217,2573,2527,24,46,"HARTOS.ORG",1
45,"45072",690,535,532,7,3,"HARTOS.ORG",1
45,"45133",2803,2241,2199,18,42,"HARTOS.ORG",2
5,"5110",710,584,581,1,3,"HARTOS.ORG",1
33,"33012",5341,3816,3777,43,39,"HARTOS.ORG",3
43,"43052",1001,669,636,12,33,"HARTOS.ORG",1
43,"43084",573,383,378,6,5,"HARTOS.ORG",0
33,"33045",4692,3347,3297,42,50,"HARTOS.ORG",8
5,"5208",55,45,45,0,0,"HARTOS.ORG",0
5,"5062",213,188,184,3,4,"HARTOS.ORG",0
5,"5128",361,288,280,3,8,"HARTOS.ORG",0
43,"43006",712,484,475,10,9,"HARTOS.ORG",4
33,"33073",9341,5825,5773,69,52,"HARTOS.ORG",10
43,"43112",294,184,181,2,3,"HARTOS.ORG",0
45,"45093",168,133,133,0,0,"HARTOS.ORG",0
5,"5010",173,141,134,2,7,"HARTOS.ORG",0
5,"5122",156,124,124,0,0,"HARTOS.ORG",0
5,"5196",69,54,54,2,0,"HARTOS.ORG",0
5,"5056",94,78,73,1,5,"HARTOS.ORG",0
5,"5097",525,378,373,4,5,"HARTOS.ORG",1
33,"33036",11674,8695,8605,104,90,"HARTOS.ORG",12
45,"45204",621,500,497,1,3,"HARTOS.ORG",1
43,"43088",1810,1199,1177,29,22,"HARTOS.ORG",1
43,"43153",10307,6572,6450,94,122,"HARTOS.ORG",25
43,"43053",190,149,149,2,0,"HARTOS.ORG",1
5,"5190",61,48,48,3,0,"HARTOS.ORG",0
43,"43032",587,418,413,9,5,"HARTOS.ORG",2
45,"45193",661,557,548,1,9,"HARTOS.ORG",0
45,"45164",191,160,158,0,2,"HARTOS.ORG",0
5,"5116",131,114,109,0,5,"HARTOS.ORG",0
5,"5903",171,118,118,0,0,"HARTOS.ORG",0
33,"33052",758,526,518,2,8,"HARTOS.ORG",1
43,"43157",388,282,270,10,12,"HARTOS.ORG",2
45,"45168",61519,47265,46528,736,737,"HARTOS.ORG",154
45,"45205",6333,4544,4451,58,93,"HARTOS.ORG",10
5,"5047",4267,3345,3275,34,70,"HARTOS.ORG",4
45,"45047",2404,1685,1662,7,23,"HARTOS.ORG",5
5,"5044",301,217,217,3,0,"HARTOS.ORG",0
5,"5043",86,68,68,0,0,"HARTOS.ORG",1
45,"45064",3801,2987,2953,38,34,"HARTOS.ORG",6
43,"43161",17199,10765,10547,197,218,"HARTOS.ORG",17
33,"33017",3289,2378,2350,35,28,"HARTOS.ORG",4
43,"43101",146,94,93,3,1,"HARTOS.ORG",0
5,"5041",1051,840,827,13,13,"HARTOS.ORG",2
5,"5121",250,181,178,1,3,"HARTOS.ORG",1
43,"43046",114,80,79,5,1,"HARTOS.ORG",0
43,"43120",454,287,283,1,4,"HARTOS.ORG",0
5,"5115",590,458,450,1,8,"HARTOS.ORG",0
43,"43060",3049,2030,1980,62,50,"HARTOS.ORG",5
43,"43025",660,453,446,13,7,"HARTOS.ORG",0
5,"5251",80,58,58,0,0,"HARTOS.ORG",0
5,"5186",1670,1306,1287,9,19,"HARTOS.ORG",6
45,"45085",1511,1111,1100,10,11,"HARTOS.ORG",2
11,"11015",59476,38207,37898,501,309,"HARTOS.ORG",44
45,"45149",638,542,533,2,9,"HARTOS.ORG",0
5,"5147",174,141,135,4,6,"HARTOS.ORG",0
5,"5215",186,138,136,1,2,"HARTOS.ORG",1
45,"45173",9133,7147,7035,78,112,"HARTOS.ORG",15
5,"5236",147,101,101,0,0,"HARTOS.ORG",0
45,"45007",747,641,632,1,9,"HARTOS.ORG",1
11,"11002",4291,3388,3374,19,14,"HARTOS.ORG",0
45,"45130",354,287,283,2,4,"HARTOS.ORG",0
5,"5205",78,59,58,0,1,"HARTOS.ORG",0
33,"33074",3699,2643,2611,30,32,"HARTOS.ORG",1
43,"43178",1262,891,870,24,21,"HARTOS.ORG",3
43,"43072",97,73,70,0,3,"HARTOS.ORG",0
5,"5083",155,120,113,1,7,"HARTOS.ORG",0
5,"5148",34,27,27,0,0,"HARTOS.ORG",0
43,"43083",141,97,97,2,0,"HARTOS.ORG",0
33,"33030",921,682,668,4,14,"HARTOS.ORG",1
43,"43122",92,65,61,0,4,"HARTOS.ORG",0
45,"45063",504,378,372,3,6,"HARTOS.ORG",0
45,"45189",655,510,502,3,8,"HARTOS.ORG",1
45,"45131",327,262,258,1,4,"HARTOS.ORG",0
43,"43173",114,65,64,0,1,"HARTOS.ORG",0
45,"45060",204,151,148,1,3,"HARTOS.ORG",0
45,"45124",2183,1868,1823,20,45,"HARTOS.ORG",5
5,"5145",57,41,41,0,0,"HARTOS.ORG",0
43,"43109",2040,1332,1316,28,16,"HARTOS.ORG",6
43,"43057",45,27,27,2,0,"HARTOS.ORG",0
43,"43155",22951,14114,13856,326,258,"HARTOS.ORG",40
5,"5052",102,91,91,0,0,"HARTOS.ORG",1
45,"45043",827,679,670,3,9,"HARTOS.ORG",0
43,"43082",383,282,270,8,12,"HARTOS.ORG",0
5,"5192",96,78,77,1,1,"HARTOS.ORG",0
45,"45108",564,461,456,2,5,"HARTOS.ORG",0
43,"43065",443,278,270,8,8,"HARTOS.ORG",0
45,"45194",57,41,41,0,0,"HARTOS.ORG",0
5,"5059",112,91,88,1,3,"HARTOS.ORG",1
5,"5254",212,186,185,2,1,"HARTOS.ORG",0
45,"45150",471,388,382,1,6,"HARTOS.ORG",1
5,"5081",44,36,36,0,0,"HARTOS.ORG",0
43,"43117",150,118,115,1,3,"HARTOS.ORG",0
43,"43035",280,202,198,0,4,"HARTOS.ORG",0
45,"45166",1734,1460,1429,8,31,"HARTOS.ORG",1
5,"5179",231,206,204,2,2,"HARTOS.ORG",0
43,"43010",302,227,223,7,4,"HARTOS.ORG",0
45,"45201",3439,2353,2317,31,36,"HARTOS.ORG",3
33,"33038",2442,1757,1725,14,32,"HARTOS.ORG",6
5,"5229",90,79,77,2,2,"HARTOS.ORG",0
45,"45172",757,597,594,7,3,"HARTOS.ORG",0
45,"45143",1302,916,901,6,15,"HARTOS.ORG",0
45,"45192",2549,2178,2155,39,23,"HARTOS.ORG",2
5,"5075",100,76,76,1,0,"HARTOS.ORG",0
5,"5049",440,335,330,8,5,"HARTOS.ORG",0
33,"33049",6806,4629,4581,70,48,"HARTOS.ORG",9
43,"43138",2719,1775,1730,45,45,"HARTOS.ORG",1
43,"43015",104,69,68,2,1,"HARTOS.ORG",0
33,"33026",9144,6019,5959,87,60,"HARTOS.ORG",4
5,"5228",193,146,145,1,1,"HARTOS.ORG",0
5,"5267",102,78,77,1,1,"HARTOS.ORG",1
5,"5051",194,165,154,0,11,"HARTOS.ORG",0
43,"43163",24903,15475,15241,263,234,"HARTOS.ORG",40
5,"5265",87,68,66,2,2,"HARTOS.ORG",0
5,"5024",268,205,201,2,4,"HARTOS.ORG",1
33,"33025",9455,6331,6277,84,54,"HARTOS.ORG",5
5,"5033",184,159,155,3,4,"HARTOS.ORG",0
5,"5207",743,595,591,1,4,"HARTOS.ORG",0
43,"43030",454,321,307,5,14,"HARTOS.ORG",1
5,"5188",55,47,47,0,0,"HARTOS.ORG",0
45,"45187",4187,3581,3512,25,69,"HARTOS.ORG",3
11,"11032",53183,32205,31982,441,223,"HARTOS.ORG",27
43,"43146",45,33,30,1,3,"HARTOS.ORG",0
43,"43037",16656,9986,9812,163,174,"HARTOS.ORG",45
45,"45901",811,595,591,2,4,"HARTOS.ORG",0
5,"5901",289,197,196,4,1,"HARTOS.ORG",0
33,"33077",1351,938,931,7,7,"HARTOS.ORG",0
45,"45041",3617,2672,2635,21,37,"HARTOS.ORG",5
43,"43123",70216,45627,44828,906,799,"HARTOS.ORG",147
45,"45137",1610,1057,1047,11,10,"HARTOS.ORG",0
5,"5008",244,200,196,1,4,"HARTOS.ORG",0
5,"5100",307,245,245,2,0,"HARTOS.ORG",2
11,"11011",1685,1231,1216,8,15,"HARTOS.ORG",0
43,"43907",4122,2759,2712,52,47,"HARTOS.ORG",14
43,"43093",3924,2507,2445,62,62,"HARTOS.ORG",11
5,"5092",172,142,139,0,3,"HARTOS.ORG",0
33,"33048",169,120,120,1,0,"HARTOS.ORG",3
5,"5237",198,157,155,3,2,"HARTOS.ORG",0
45,"45083",421,353,345,0,8,"HARTOS.ORG",1
43,"43024",1459,958,937,17,21,"HARTOS.ORG",6
5,"5017",87,69,68,1,1,"HARTOS.ORG",0
45,"45010",471,374,372,2,2,"HARTOS.ORG",0
45,"45009",588,430,422,2,8,"HARTOS.ORG",0
43,"43121",636,385,371,6,14,"HARTOS.ORG",0
45,"45154",1459,1148,1140,12,8,"HARTOS.ORG",4
5,"5243",101,69,68,0,1,"HARTOS.ORG",0
5,"5180",109,92,91,1,1,"HARTOS.ORG",0
5,"5200",56,43,42,0,1,"HARTOS.ORG",0
45,"45018",445,332,322,4,10,"HARTOS.ORG",0
5,"5039",58,48,48,0,0,"HARTOS.ORG",0
5,"5184",288,225,224,0,1,"HARTOS.ORG",2
5,"5181",39,26,26,0,0,"HARTOS.ORG",0
5,"5264",68,48,48,1,0,"HARTOS.ORG",2
5,"5224",104,90,90,0,0,"HARTOS.ORG",0
5,"5138",326,278,275,2,3,"HARTOS.ORG",0
5,"5142",113,97,96,0,1,"HARTOS.ORG",0
45,"45087",8428,6434,6292,74,142,"HARTOS.ORG",10
43,"43141",131,71,70,3,1,"HARTOS.ORG",0
33,"33022",992,709,696,12,13,"HARTOS.ORG",0
5,"5185",109,89,89,1,0,"HARTOS.ORG",0
43,"43048",830,547,530,16,17,"HARTOS.ORG",0
5,"5076",477,397,385,4,12,"HARTOS.ORG",0
5,"5213",117,94,88,0,6,"HARTOS.ORG",0
5,"5067",85,68,68,0,0,"HARTOS.ORG",0
11,"11016",14611,9848,9774,114,74,"HARTOS.ORG",9
11,"11004",87610,53062,52639,828,423,"HARTOS.ORG",74
5,"5234",58,49,49,0,0,"HARTOS.ORG",0
5,"5109",438,359,351,5,8,"HARTOS.ORG",0
5,"5133",62,49,49,0,0,"HARTOS.ORG",0
45,"45120",159,125,122,0,3,"HARTOS.ORG",0
43,"43027",177,129,128,6,1,"HARTOS.ORG",0
45,"45015",624,485,480,2,5,"HARTOS.ORG",3
45,"45011",316,271,268,1,3,"HARTOS.ORG",1
43,"43041",237,177,176,4,1,"HARTOS.ORG",2
33,"33078",159,108,106,1,2,"HARTOS.ORG",1
45,"45125",2407,1977,1949,22,28,"HARTOS.ORG",7
43,"43038",20710,12999,12771,224,228,"HARTOS.ORG",59
45,"45026",269,200,198,2,2,"HARTOS.ORG",1
5,"5120",38,28,28,1,0,"HARTOS.ORG",0
45,"45090",396,335,333,0,2,"HARTOS.ORG",0
5,"5088",34,26,26,0,0,"HARTOS.ORG",0
45,"45048",388,310,308,2,2,"HARTOS.ORG",1
5,"5157",256,187,183,0,4,"HARTOS.ORG",0
45,"45180",2714,2018,1980,19,38,"HARTOS.ORG",3
11,"11030",22528,14741,14557,195,184,"HARTOS.ORG",24
5,"5085",35,34,34,0,0,"HARTOS.ORG",0
45,"45031",2773,2011,1975,25,36,"HARTOS.ORG",5
45,"45113",2094,1589,1555,6,34,"HARTOS.ORG",3
43,"43160",1278,840,812,9,28,"HARTOS.ORG",1
5,"5141",99,90,89,0,1,"HARTOS.ORG",1
5,"5169",241,218,218,0,0,"HARTOS.ORG",0
5,"5040",77,59,59,1,0,"HARTOS.ORG",0
43,"43144",1187,787,772,12,15,"HARTOS.ORG",5
43,"43089",272,193,185,1,8,"HARTOS.ORG",0
43,"43018",430,350,337,7,13,"HARTOS.ORG",0
45,"45103",457,400,394,0,6,"HARTOS.ORG",1
33,"33015",1695,1177,1161,12,16,"HARTOS.ORG",1
5,"5206",29,23,21,2,2,"HARTOS.ORG",0
33,"33010",1922,1284,1277,14,7,"HARTOS.ORG",0
45,"45001",1901,1468,1431,14,37,"HARTOS.ORG",1
5,"5018",27,24,24,0,0,"HARTOS.ORG",0
45,"45203",2535,1883,1829,21,54,"HARTOS.ORG",10
5,"5217",69,54,54,0,0,"HARTOS.ORG",0
33,"33007",1680,1186,1179,10,7,"HARTOS.ORG",0
5,"5163",1762,1400,1380,5,20,"HARTOS.ORG",1
45,"45160",1104,911,896,12,15,"HARTOS.ORG",0
45,"45034",1375,1108,1079,18,29,"HARTOS.ORG",3
45,"45141",981,815,790,6,25,"HARTOS.ORG",1
45,"45127",739,550,538,5,12,"HARTOS.ORG",2
45,"45084",2395,1879,1842,21,37,"HARTOS.ORG",2
11,"11017",3219,2403,2388,18,15,"HARTOS.ORG",1
43,"43073",90,57,57,1,0,"HARTOS.ORG",0
5,"5232",106,84,80,1,4,"HARTOS.ORG",0
45,"45096",1021,800,778,5,22,"HARTOS.ORG",0
5,"5080",75,53,53,1,0,"HARTOS.ORG",0
5,"5077",205,164,160,2,4,"HARTOS.ORG",0
45,"45066",7334,5602,5536,52,66,"HARTOS.ORG",13
5,"5134",47,37,37,0,0,"HARTOS.ORG",0
43,"43901",8849,5651,5540,179,111,"HARTOS.ORG",13
33,"33067",802,650,639,12,11,"HARTOS.ORG",2
11,"11902",3578,2400,2376,21,24,"HARTOS.ORG",3
5,"5074",755,639,638,5,1,"HARTOS.ORG",0
45,"45021",2399,1834,1804,23,30,"HARTOS.ORG",4
45,"45191",601,506,498,1,8,"HARTOS.ORG",0
5,"5119",41,31,31,0,0,"HARTOS.ORG",0
45,"45142",7974,6294,6178,89,116,"HARTOS.ORG",16
5,"5239",215,171,170,2,1,"HARTOS.ORG",0
43,"43028",2654,1620,1588,27,32,"HARTOS.ORG",1
45,"45183",2189,1537,1514,10,23,"HARTOS.ORG",5
45,"45100",205,169,169,0,0,"HARTOS.ORG",2
45,"45080",3,3,3,0,0,"HARTOS.ORG",0
5,"5015",100,78,78,0,0,"HARTOS.ORG",0
43,"43130",196,132,131,7,1,"HARTOS.ORG",0
5,"5016",6231,4831,4763,56,68,"HARTOS.ORG",8
45,"45046",2455,1884,1862,11,22,"HARTOS.ORG",3
33,"33076",12662,8733,8670,120,63,"HARTOS.ORG",7
45,"45013",1870,1504,1486,5,18,"HARTOS.ORG",0
11,"11025",4371,3260,3226,34,34,"HARTOS.ORG",3
5,"5194",147,131,130,4,1,"HARTOS.ORG",0
43,"43145",3968,2781,2742,52,39,"HARTOS.ORG",8
5,"5902",319,262,262,0,0,"HARTOS.ORG",0
43,"43090",1142,644,636,7,8,"HARTOS.ORG",1
45,"45198",1950,1661,1641,9,20,"HARTOS.ORG",3
43,"43040",350,251,246,18,5,"HARTOS.ORG",2
43,"43152",472,355,351,9,4,"HARTOS.ORG",1
5,"5026",229,193,192,2,1,"HARTOS.ORG",0
33,"33016",19516,14345,14210,198,135,"HARTOS.ORG",20
11,"11014",16318,11093,11031,144,62,"HARTOS.ORG",8
11,"11013",2284,1691,1670,15,21,"HARTOS.ORG",1
43,"43095",2434,1658,1624,27,34,"HARTOS.ORG",9
5,"5174",81,71,71,1,0,"HARTOS.ORG",0
33,"33055",1589,1212,1192,16,20,"HARTOS.ORG",1
43,"43002",1790,1252,1226,17,26,"HARTOS.ORG",6
5,"5130",95,76,76,0,0,"HARTOS.ORG",0
43,"43177",338,242,236,6,6,"HARTOS.ORG",0
43,"43126",1170,802,783,19,19,"HARTOS.ORG",1
45,"45109",3030,2507,2417,30,90,"HARTOS.ORG",2
33,"33037",37135,25522,25262,291,260,"HARTOS.ORG",40
5,"5231",172,142,141,0,1,"HARTOS.ORG",0
43,"43903",2368,1504,1492,22,12,"HARTOS.ORG",0
33,"33075",305,191,190,0,1,"HARTOS.ORG",0
5,"5065",498,424,422,7,2,"HARTOS.ORG",0
45,"45159",100,84,84,1,0,"HARTOS.ORG",0
33,"33014",9318,6380,6320,66,60,"HARTOS.ORG",7
43,"43169",477,377,364,8,13,"HARTOS.ORG",1
45,"45052",2793,2247,2212,38,35,"HARTOS.ORG",8
5,"5247",267,164,164,0,0,"HARTOS.ORG",3
45,"45148",340,256,256,1,0,"HARTOS.ORG",0
33,"33039",1719,1325,1319,14,6,"HARTOS.ORG",1
43,"43114",383,238,234,6,4,"HARTOS.ORG",2
5,"5023",177,160,158,1,2,"HARTOS.ORG",0
5,"5173",62,55,55,1,0,"HARTOS.ORG",0
45,"45033",407,302,295,3,7,"HARTOS.ORG",1
5,"5055",649,525,518,3,7,"HARTOS.ORG",2
5,"5079",68,52,50,1,2,"HARTOS.ORG",0
33,"33019",3262,2283,2244,12,39,"HARTOS.ORG",0
43,"43147",528,393,380,7,13,"HARTOS.ORG",0
43,"43039",117,85,83,3,2,"HARTOS.ORG",0
5,"5151",100,86,82,1,4,"HARTOS.ORG",0
43,"43116",494,328,325,5,3,"HARTOS.ORG",0
43,"43059",264,185,185,4,0,"HARTOS.ORG",1
5,"5253",95,75,74,0,1,"HARTOS.ORG",0
11,"11040",411,317,309,0,8,"HARTOS.ORG",0
5,"5058",81,61,59,0,2,"HARTOS.ORG",1
45,"45071",1896,1592,1575,21,17,"HARTOS.ORG",1
5,"5029",132,102,102,0,0,"HARTOS.ORG",0
33,"33059",5049,3480,3447,37,33,"HARTOS.ORG",3
45,"45030",486,378,374,4,4,"HARTOS.ORG",0
33,"33009",951,673,663,7,10,"HARTOS.ORG",1
5,"5061",264,222,214,5,8,"HARTOS.ORG",1
5,"5106",39,26,26,0,0,"HARTOS.ORG",0
43,"43034",494,355,344,8,11,"HARTOS.ORG",0
45,"45140",1087,885,867,6,18,"HARTOS.ORG",1
5,"5064",117,94,93,4,1,"HARTOS.ORG",0
5,"5129",153,98,95,0,3,"HARTOS.ORG",0
5,"5187",1833,1385,1361,16,24,"HARTOS.ORG",0
5,"5197",114,98,98,1,0,"HARTOS.ORG",0
43,"43092",7051,4294,4220,45,74,"HARTOS.ORG",16
33,"33070",3481,2557,2521,33,36,"HARTOS.ORG",4
45,"45190",502,425,414,6,11,"HARTOS.ORG",0
43,"43080",254,175,173,7,2,"HARTOS.ORG",0
45,"45104",457,375,370,2,5,"HARTOS.ORG",2
45,"45157",2097,1519,1499,15,20,"HARTOS.ORG",7
43,"43043",3065,1952,1919,39,33,"HARTOS.ORG",6
45,"45119",3274,2279,2236,37,43,"HARTOS.ORG",4
5,"5086",96,81,81,2,0,"HARTOS.ORG",0
33,"33065",1150,791,784,16,7,"HARTOS.ORG",3
45,"45182",1077,873,856,11,17,"HARTOS.ORG",1
43,"43135",327,243,238,2,5,"HARTOS.ORG",0
43,"43105",175,119,116,14,3,"HARTOS.ORG",0
5,"5238",815,649,641,6,8,"HARTOS.ORG",1
5,"5099",555,472,466,4,6,"HARTOS.ORG",0
43,"43119",739,500,496,5,4,"HARTOS.ORG",6
45,"45202",3876,3037,2984,13,53,"HARTOS.ORG",1
43,"43064",2063,1420,1391,37,29,"HARTOS.ORG",2
43,"43026",800,531,522,15,9,"HARTOS.ORG",0
11,"11034",2381,1807,1784,19,23,"HARTOS.ORG",0
43,"43007",635,448,441,7,7,"HARTOS.ORG",0
45,"45068",164,135,133,1,2,"HARTOS.ORG",0
43,"43008",333,206,197,3,9,"HARTOS.ORG",0
33,"33068",1224,704,703,5,1,"HARTOS.ORG",2
43,"43098",362,251,247,1,4,"HARTOS.ORG",3
43,"43159",89,51,51,2,0,"HARTOS.ORG",1
11,"11031",76347,49071,48616,681,455,"HARTOS.ORG",104
5,"5102",1850,1487,1475,11,12,"HARTOS.ORG",0
45,"45059",1758,1465,1437,10,28,"HARTOS.ORG",2
43,"43140",2393,1612,1583,23,29,"HARTOS.ORG",2
45,"45067",2385,1923,1878,19,45,"HARTOS.ORG",3
5,"5105",349,275,272,12,3,"HARTOS.ORG",3
5,"5263",175,133,131,0,2,"HARTOS.ORG",0
5,"5201",557,444,437,2,7,"HARTOS.ORG",0
45,"45099",3449,2451,2405,22,46,"HARTOS.ORG",7
43,"43108",1808,1183,1157,28,26,"HARTOS.ORG",2
5,"5152",737,618,609,5,9,"HARTOS.ORG",1
43,"43168",106,70,69,2,1,"HARTOS.ORG",0
5,"5166",235,181,178,1,3,"HARTOS.ORG",0
45,"45155",481,382,375,3,7,"HARTOS.ORG",4
5,"5904",149,99,97,0,2,"HARTOS.ORG",0
5,"5259",132,115,114,1,1,"HARTOS.ORG",0
33,"33044",180964,129466,128346,1888,1120,"HARTOS.ORG",191
5,"5144",92,66,66,4,0,"HARTOS.ORG",0
45,"45107",3006,2344,2299,32,45,"HARTOS.ORG",8
45,"45177",2295,1898,1857,15,41,"HARTOS.ORG",5
5,"5123",90,69,69,3,0,"HARTOS.ORG",0
5,"5171",84,74,73,0,1,"HARTOS.ORG",0
5,"5087",144,87,87,0,0,"HARTOS.ORG",0
5,"5260",114,101,101,1,0,"HARTOS.ORG",0
5,"5113",90,74,74,0,0,"HARTOS.ORG",1
33,"33047",1178,939,931,2,8,"HARTOS.ORG",0
45,"45156",3528,2985,2924,19,61,"HARTOS.ORG",1
5,"5227",409,307,305,2,2,"HARTOS.ORG",0
11,"11028",32224,20706,20482,359,224,"HARTOS.ORG",50
45,"45095",742,606,585,2,21,"HARTOS.ORG",1
5,"5136",110,75,75,3,0,"HARTOS.ORG",1
11,"11038",13815,10849,10756,126,93,"HARTOS.ORG",13
11,"11006",24221,16564,16470,197,94,"HARTOS.ORG",17
45,"45075",205,162,159,4,3,"HARTOS.ORG",1
43,"43100",3062,2058,2021,52,37,"HARTOS.ORG",6
11,"11003",1290,952,940,8,12,"HARTOS.ORG",0
45,"45037",1730,1325,1304,15,21,"HARTOS.ORG",3
5,"5241",3145,2303,2273,27,30,"HARTOS.ORG",6
45,"45136",5891,4414,4368,55,46,"HARTOS.ORG",5
5,"5177",164,134,133,0,1,"HARTOS.ORG",0
45,"45185",7912,6321,6180,68,141,"HARTOS.ORG",10
33,"33021",4932,3544,3502,45,42,"HARTOS.ORG",7
37,"37147",201,153,151,1,2,"H.D.",0
37,"37134",250,192,189,1,3,"H.D.",1
37,"37366",46,35,34,0,1,"H.D.",0
37,"37030",90,71,70,4,1,"H.D.",0
37,"37303",207,158,152,3,6,"H.D.",0
37,"37361",91,67,62,0,5,"H.D.",0
37,"37021",86,70,68,2,2,"H.D.",0
37,"37140",731,490,475,0,15,"H.D.",0
37,"37208",92,59,58,0,1,"H.D.",0
37,"37177",310,242,241,1,1,"H.D.",0
37,"37165",27,20,20,1,0,"H.D.",0
37,"37115",135,107,101,2,6,"H.D.",0
37,"37159",100,77,75,0,2,"H.D.",0
37,"37032",530,410,409,4,1,"H.D.",0
37,"37126",36,26,26,0,0,"H.D.",0
37,"37136",702,494,485,4,9,"H.D.",0
37,"37357",283,216,214,0,2,"H.D.",0
37,"37281",36,34,33,0,1,"H.D.",0
37,"37071",90,80,80,1,0,"H.D.",0
37,"37150",43,36,34,0,2,"H.D.",0
37,"37284",334,256,254,1,2,"H.D.",0
37,"37327",191,148,148,9,0,"H.D.",0
37,"37329",40,36,36,2,0,"H.D.",0
37,"37163",44,36,36,0,0,"H.D.",0
37,"37045",27,21,21,0,0,"H.D.",0
37,"37193",432,310,309,5,1,"H.D.",1
37,"37201",263,196,196,5,0,"H.D.",0
37,"37351",305,261,258,2,3,"H.D.",0
37,"37325",102,77,77,0,0,"H.D.",0
37,"37213",97,77,76,0,1,"H.D.",1
37,"37348",114,91,90,1,1,"H.D.",1
37,"37175",408,319,311,6,8,"H.D.",0
37,"37288",252,194,194,3,0,"H.D.",0
37,"37183",425,321,316,3,5,"H.D.",0
37,"37251",137,98,93,3,5,"H.D.",0
37,"37267",210,169,165,0,4,"H.D.",0
37,"37022",287,237,232,0,5,"H.D.",0
37,"37341",52,32,32,0,0,"H.D.",0
37,"37157",94,65,65,0,0,"H.D.",0
37,"37302",337,230,229,5,1,"H.D.",0
37,"37244",132,97,95,5,2,"H.D.",0
37,"37250",405,277,274,1,3,"H.D.",0
37,"37378",118,85,85,3,0,"H.D.",0
37,"37099",104,64,62,1,2,"H.D.",0
37,"37172",857,584,580,5,4,"H.D.",0
37,"37215",156,106,106,1,0,"H.D.",0
37,"37096",235,199,197,3,2,"H.D.",0
37,"37131",200,150,148,1,2,"H.D.",0
37,"37127",229,183,182,3,1,"H.D.",1
37,"37372",145,109,109,0,0,"H.D.",0
37,"37109",191,142,141,1,1,"H.D.",0
37,"37297",441,376,369,1,7,"H.D.",0
37,"37368",18,15,15,1,0,"H.D.",0
37,"37257",52,43,43,0,0,"H.D.",0
37,"37263",361,277,275,1,2,"H.D.",0
37,"37279",780,580,571,6,9,"H.D.",0
37,"37069",952,737,723,12,14,"H.D.",1
37,"37225",119,101,95,3,6,"H.D.",0
37,"37027",242,196,192,2,4,"H.D.",0
37,"37300",586,430,421,6,9,"H.D.",0
37,"37301",78,58,58,0,0,"H.D.",1
37,"37133",108,79,77,0,2,"H.D.",0
37,"37106",289,199,196,2,3,"H.D.",0
37,"37229",144,108,108,0,0,"H.D.",0
37,"37144",398,302,301,3,1,"H.D.",1
37,"37353",142,119,119,2,0,"H.D.",0
37,"37231",285,227,225,6,2,"H.D.",0
37,"37223",127,102,101,1,1,"H.D.",1
37,"37024",101,80,80,0,0,"H.D.",1
37,"37374",1204,1018,1004,9,14,"H.D.",0
37,"37235",226,194,192,0,2,"H.D.",0
37,"37264",78,52,52,0,0,"H.D.",0
37,"37005",92,65,65,0,0,"H.D.",0
37,"37340",155,121,121,0,0,"H.D.",0
37,"37011",131,87,86,2,1,"H.D.",0
37,"37036",74,54,52,0,2,"H.D.",1
37,"37040",431,362,362,4,0,"H.D.",0
37,"37179",230,194,191,3,3,"H.D.",0
37,"37122",210,175,174,3,1,"H.D.",0
37,"37370",345,261,260,1,1,"H.D.",0
37,"37332",78,52,49,0,3,"H.D.",0
37,"37289",265,211,209,0,2,"H.D.",0
37,"37015",248,169,168,0,1,"H.D.",0
37,"37047",178,111,111,0,0,"H.D.",0
37,"37362",4333,3276,3238,65,38,"H.D.",1
37,"37299",237,167,165,2,2,"H.D.",0
37,"37253",137,115,115,1,0,"H.D.",1
37,"37016",539,424,420,8,4,"H.D.",0
37,"37285",457,349,347,2,2,"H.D.",0
37,"37139",199,167,163,1,4,"H.D.",0
37,"37169",196,137,136,1,1,"H.D.",0
37,"37086",105,75,72,3,3,"H.D.",0
37,"37322",2501,1692,1676,32,16,"H.D.",1
37,"37339",345,280,279,3,1,"H.D.",0
37,"37317",323,281,278,3,3,"H.D.",0
37,"37222",124,92,92,2,0,"H.D.",0
37,"37044",461,363,360,1,3,"H.D.",0
37,"37178",107,88,87,0,1,"H.D.",0
37,"37088",208,173,172,4,1,"H.D.",0
37,"37113",439,365,365,7,0,"H.D.",0
37,"37352",199,150,142,0,8,"H.D.",0
37,"37132",398,317,311,3,6,"H.D.",1
37,"37206",100,81,80,1,1,"H.D.",0
37,"37007",467,368,363,6,5,"H.D.",0
37,"37271",393,324,318,5,6,"H.D.",1
37,"37046",11929,8847,8683,146,164,"H.D.",6
37,"37101",185,143,141,1,2,"H.D.",0
37,"37356",90,66,66,1,0,"H.D.",0
37,"37269",475,383,382,2,1,"H.D.",1
37,"37319",138,94,94,1,0,"H.D.",0
37,"37280",84,64,64,0,0,"H.D.",0
37,"37236",163,123,119,4,4,"H.D.",0
37,"37012",155,124,120,1,4,"H.D.",1
37,"37196",93,74,70,1,4,"H.D.",0
37,"37283",130,104,104,1,0,"H.D.",0
37,"37167",164,140,132,6,8,"H.D.",0
37,"37034",91,72,72,0,0,"H.D.",0
37,"37277",58,39,38,1,1,"H.D.",0
37,"37360",252,194,194,1,0,"H.D.",0
37,"37247",216,176,173,1,3,"H.D.",0
37,"37097",47,39,39,1,0,"H.D.",0
37,"37275",136,98,98,0,0,"H.D.",0
37,"37261",255,191,191,2,0,"H.D.",0
37,"37025",264,217,216,1,1,"H.D.",1
37,"37214",134,94,94,4,0,"H.D.",0
37,"37090",59,54,50,0,4,"H.D.",0
37,"37246",5430,4363,4315,63,48,"H.D.",1
37,"37292",101,84,84,2,0,"H.D.",0
37,"37056",56,47,47,0,0,"H.D.",0
37,"37334",86,50,49,0,1,"H.D.",0
37,"37359",194,155,152,1,3,"H.D.",0
37,"37009",225,189,185,2,4,"H.D.",0
37,"37189",139,90,90,1,0,"H.D.",0
37,"37008",4316,3518,3457,31,61,"H.D.",1
37,"37310",154,115,115,1,0,"H.D.",0
37,"37242",99,73,72,0,1,"H.D.",0
37,"37287",341,247,246,1,1,"H.D.",0
37,"37149",78,69,69,0,0,"H.D.",0
37,"37363",121,100,99,0,1,"H.D.",0
37,"37376",2373,1720,1700,23,20,"H.D.",5
37,"37146",135,117,117,1,0,"H.D.",0
37,"37290",143,111,110,1,1,"H.D.",0
37,"37259",44,32,32,3,0,"H.D.",0
37,"37050",71,48,48,1,0,"H.D.",0
37,"37367",218,182,176,0,6,"H.D.",0
37,"37318",225,167,165,0,2,"H.D.",1
37,"37205",235,199,195,5,4,"H.D.",1
37,"37228",388,339,336,2,3,"H.D.",2
37,"37130",177,153,153,2,0,"H.D.",0
37,"37065",346,269,267,0,2,"H.D.",0
37,"37160",644,474,464,4,10,"H.D.",0
37,"37218",81,51,51,1,0,"H.D.",0
37,"37176",136,103,100,1,3,"H.D.",0
37,"37029",226,181,178,4,3,"H.D.",0
37,"37003",134,103,102,0,1,"H.D.",0
37,"37181",301,232,230,2,2,"H.D.",0
37,"37033",86,64,63,1,1,"H.D.",1
37,"37377",268,209,208,1,1,"H.D.",0
37,"37241",172,135,134,1,1,"H.D.",0
37,"37272",162,121,120,1,1,"H.D.",0
37,"37138",212,174,169,5,5,"H.D.",0
37,"37089",74,54,54,2,0,"H.D.",0
37,"37197",101,72,70,1,2,"H.D.",1
37,"37349",136,105,104,2,1,"H.D.",1
37,"37173",1643,1298,1285,26,13,"H.D.",1
37,"37148",451,344,343,3,1,"H.D.",0
37,"37186",109,88,88,2,0,"H.D.",0
37,"37365",172,152,149,2,3,"H.D.",0
37,"37321",169,144,144,1,0,"H.D.",0
37,"37354",4828,3589,3522,76,67,"H.D.",2
37,"37120",107,88,87,0,1,"H.D.",0
37,"37350",452,368,364,5,4,"H.D.",1
37,"37180",69,46,46,0,0,"H.D.",1
37,"37328",218,155,149,2,6,"H.D.",0
37,"37055",132,112,107,2,5,"H.D.",0
37,"37270",201,159,158,0,1,"H.D.",0
37,"37203",174,148,148,0,0,"H.D.",1
37,"37355",187,142,140,2,2,"H.D.",0
37,"37073",583,458,455,7,3,"H.D.",0
37,"37379",167,128,125,4,3,"H.D.",0
37,"37239",235,208,201,2,7,"H.D.",0
37,"37207",287,211,208,2,3,"H.D.",2
37,"37019",157,114,113,0,1,"H.D.",0
37,"37331",234,161,161,3,0,"H.D.",0
37,"37063",94,77,76,3,1,"H.D.",0
37,"37171",437,362,358,4,4,"H.D.",0
37,"37221",465,360,353,0,7,"H.D.",0
37,"37092",1403,1034,1022,12,12,"H.D.",2
37,"37187",567,449,448,3,1,"H.D.",3
37,"37020",449,371,365,7,6,"H.D.",1
37,"37143",410,342,338,3,4,"H.D.",1
37,"37248",160,130,130,1,0,"H.D.",1
37,"37204",286,216,214,0,2,"H.D.",0
37,"37104",32,24,23,0,1,"H.D.",0
37,"37168",470,357,353,1,4,"H.D.",0
37,"37305",206,153,152,4,1,"H.D.",1
37,"37276",188,136,135,0,1,"H.D.",0
37,"37119",115,98,98,0,0,"H.D.",0
37,"37151",150,125,121,1,4,"H.D.",1
37,"37013",133,93,85,5,8,"H.D.",0
37,"37293",131,108,106,5,2,"H.D.",0
37,"37052",274,213,212,1,1,"H.D.",0
37,"37209",376,258,253,4,5,"H.D.",1
37,"37373",793,591,589,4,2,"H.D.",0
37,"37337",140,122,121,0,1,"H.D.",0
37,"37312",278,232,229,1,3,"H.D.",0
37,"37245",357,273,272,2,1,"H.D.",0
37,"37333",247,160,154,2,6,"H.D.",0
37,"37067",2938,2306,2267,47,39,"H.D.",0
37,"37091",181,127,119,0,8,"H.D.",1
37,"37042",45,35,35,1,0,"H.D.",0
37,"37107",11407,8234,8116,123,118,"H.D.",7
37,"37212",123,95,92,1,3,"H.D.",0
37,"37346",264,211,210,1,1,"H.D.",0
37,"37049",163,119,119,0,0,"H.D.",0
37,"37262",81,66,64,2,2,"H.D.",0
37,"37039",325,241,236,0,5,"H.D.",0
37,"37125",243,184,180,3,4,"H.D.",0
37,"37291",261,215,214,1,1,"H.D.",0
37,"37058",68,44,44,0,0,"H.D.",0
37,"37072",184,157,155,5,2,"H.D.",0
37,"37254",189,168,164,1,4,"H.D.",0
37,"37079",77,64,63,1,1,"H.D.",0
37,"37347",481,374,371,6,3,"H.D.",1
37,"37191",127,86,85,1,1,"H.D.",0
37,"37243",123,89,88,1,1,"H.D.",0
37,"37343",56,42,40,0,2,"H.D.",0
37,"37103",483,354,351,1,3,"H.D.",0
37,"37268",113,78,77,1,1,"H.D.",0
37,"37230",221,173,171,0,2,"H.D.",0
37,"37155",81,57,57,0,0,"H.D.",0
37,"37142",613,436,434,7,2,"H.D.",0
37,"37311",251,210,209,8,1,"H.D.",0
37,"37252",127,92,92,0,0,"H.D.",0
37,"37226",167,129,127,1,2,"H.D.",1
37,"37028",175,130,125,1,5,"H.D.",0
37,"37232",412,374,373,1,1,"H.D.",0
37,"37164",280,217,213,9,4,"H.D.",0
37,"37041",80,53,53,1,0,"H.D.",0
37,"37017",249,200,199,0,1,"H.D.",0
37,"37240",781,552,540,10,12,"H.D.",0
37,"37080",242,187,185,1,2,"H.D.",0
37,"37083",190,165,165,3,0,"H.D.",0
37,"37336",54,49,47,0,2,"H.D.",0
37,"37110",112,89,88,1,1,"H.D.",0
37,"37026",201,176,176,3,0,"H.D.",0
37,"37001",224,182,181,0,1,"H.D.",0
37,"37324",415,338,334,2,4,"H.D.",1
37,"37057",223,190,190,0,0,"H.D.",0
37,"37316",792,565,559,7,6,"H.D.",1
37,"37166",206,172,171,3,1,"H.D.",0
37,"37062",92,73,73,1,0,"H.D.",0
37,"37282",238,169,168,3,1,"H.D.",0
37,"37313",581,440,435,7,5,"H.D.",0
37,"37286",231,166,160,2,6,"H.D.",0
37,"37085",4334,3254,3201,69,53,"H.D.",4
37,"37266",83,54,54,1,0,"H.D.",0
37,"37087",779,590,586,18,4,"H.D.",1
37,"37170",1571,1122,1107,22,15,"H.D.",2
37,"37117",1320,948,937,16,11,"H.D.",1
37,"37023",1040,819,811,11,8,"H.D.",0
37,"37234",376,275,272,2,3,"H.D.",0
37,"37035",220,176,173,1,3,"H.D.",0
37,"37216",300,270,266,2,4,"H.D.",0
37,"37121",557,458,451,8,7,"H.D.",0
37,"37192",362,229,221,3,8,"H.D.",0
37,"37296",385,311,308,3,3,"H.D.",0
37,"37309",42,26,25,3,1,"H.D.",0
37,"37198",212,176,173,2,3,"H.D.",0
37,"37338",82,69,67,0,2,"H.D.",0
37,"37200",192,142,142,0,0,"H.D.",0
37,"37314",79,61,61,3,0,"H.D.",0
37,"37260",175,122,122,1,0,"H.D.",0
37,"37060",229,179,173,2,6,"H.D.",1
37,"37364",893,653,644,10,9,"H.D.",2
37,"37217",60,49,48,1,1,"H.D.",0
37,"37118",141,115,114,3,1,"H.D.",0
37,"37344",259,212,211,5,1,"H.D.",0
37,"37190",235,195,193,1,2,"H.D.",0
37,"37381",153,114,109,3,5,"H.D.",1
37,"37306",316,194,192,1,2,"H.D.",0
37,"37059",132,110,110,2,0,"H.D.",0
37,"37184",381,295,289,5,6,"H.D.",0
37,"37129",247,198,198,4,0,"H.D.",0
37,"37195",48,32,32,0,0,"H.D.",0
37,"37123",206,166,165,1,1,"H.D.",0
37,"37037",130,100,99,0,1,"H.D.",0
37,"37237",330,250,242,1,8,"H.D.",0
37,"37108",108,95,95,1,0,"H.D.",0
37,"37358",163,143,139,0,4,"H.D.",0
37,"37307",177,132,130,0,2,"H.D.",0
37,"37380",57,45,44,1,1,"H.D.",0
37,"37054",273,230,229,2,1,"H.D.",0
37,"37078",888,728,714,9,14,"H.D.",0
37,"37135",1234,972,961,8,11,"H.D.",0
37,"37038",808,671,664,6,7,"H.D.",0
37,"37304",190,144,142,1,2,"H.D.",0
37,"37211",223,169,169,1,0,"H.D.",0
37,"37238",102,77,76,0,1,"H.D.",0
37,"37371",285,190,190,2,0,"H.D.",0
37,"37158",262,181,179,0,2,"H.D.",0
37,"37098",355,267,265,1,2,"H.D.",0
37,"37145",276,217,214,0,3,"H.D.",0
37,"37335",432,347,346,0,1,"H.D.",0
37,"37074",172,136,135,1,1,"H.D.",0
37,"37323",549,427,418,6,9,"H.D.",0
37,"37255",58,47,47,3,0,"H.D.",0
37,"37375",764,636,627,19,9,"H.D.",0
37,"37070",538,428,427,12,1,"H.D.",1
37,"37154",156,130,125,1,5,"H.D.",0
37,"37137",114,87,87,3,0,"H.D.",0
37,"37082",869,663,650,3,13,"H.D.",0
37,"37256",245,191,190,2,1,"H.D.",0
37,"37199",157,115,113,0,2,"H.D.",0
37,"37141",158,140,139,1,1,"H.D.",0
37,"37114",92,75,74,1,1,"H.D.",0
37,"37369",143,103,103,0,0,"H.D.",0
37,"37249",48,36,36,0,0,"H.D.",0
37,"37320",96,70,70,0,0,"H.D.",0
37,"37051",90,72,72,0,0,"H.D.",0
37,"37100",89,77,76,4,1,"H.D.",0
37,"37128",261,211,210,2,1,"H.D.",0
37,"37298",206,144,140,1,4,"H.D.",0
37,"37004",31,23,23,0,0,"H.D.",0
37,"37116",75,55,55,1,0,"H.D.",0
37,"37273",115,83,83,1,0,"H.D.",0
37,"37031",399,308,307,5,1,"H.D.",0
37,"37068",386,291,287,6,4,"H.D.",0
37,"37258",206,151,149,2,2,"H.D.",0
37,"37202",938,742,726,25,16,"H.D.",0
37,"37294",11233,8282,8167,139,115,"H.D.",12
37,"37018",128,89,87,0,2,"H.D.",0
37,"37219",197,121,120,0,1,"H.D.",0
37,"37382",202,172,171,3,1,"H.D.",0
37,"37185",602,452,448,8,4,"H.D.",0
37,"37233",59,46,45,1,1,"H.D.",0
37,"37274",123032,90819,89629,1506,1190,"H.D.",93
37,"37102",430,323,322,1,1,"H.D.",0
37,"37174",1150,942,922,3,20,"H.D.",0
37,"37081",1000,807,800,5,7,"H.D.",0
37,"37010",963,705,690,5,15,"H.D.",0
37,"37162",232,184,182,4,2,"H.D.",0
37,"37182",92,72,72,2,0,"H.D.",0
37,"37188",198,164,160,7,4,"H.D.",1
37,"37342",252,216,211,3,5,"H.D.",1
37,"37315",99,77,75,3,2,"H.D.",1
37,"37156",4319,3280,3233,28,47,"H.D.",4
37,"37152",474,357,351,2,6,"H.D.",1
37,"37161",157,118,116,1,2,"H.D.",0
37,"37278",736,538,529,7,9,"H.D.",0
37,"37345",179,156,156,2,0,"H.D.",0
37,"37330",338,272,270,3,2,"H.D.",0
37,"37265",224,192,191,1,1,"H.D.",0
37,"37112",162,124,124,3,0,"H.D.",0
37,"37224",216,190,186,5,4,"H.D.",0
37,"37124",227,181,179,3,2,"H.D.",0
37,"37014",1198,862,852,8,10,"H.D.",0
37,"37002",152,90,89,1,1,"H.D.",0
37,"37006",157,108,107,0,1,"H.D.",0
37,"37061",254,187,185,0,2,"H.D.",0
37,"37194",271,206,204,0,2,"H.D.",7
37,"37077",293,262,258,3,4,"H.D.",0
17,"17152",10378,6239,6156,100,83,"ICV-EUiA",174
43,"43061",55,31,31,1,0,"ICV-EUiA",5
43,"43078",841,557,547,7,10,"ICV-EUiA",13
43,"43005",3559,2191,2147,47,44,"ICV-EUiA",101
17,"17188",167,124,122,9,2,"ICV-EUiA",11
43,"43136",10163,6312,6197,121,115,"ICV-EUiA",320
43,"43138",2719,1775,1730,45,45,"ICV-EUiA",47
43,"43066",165,113,112,2,1,"ICV-EUiA",4
43,"43013",4369,2795,2747,54,48,"ICV-EUiA",142
43,"43042",2071,1504,1485,28,19,"ICV-EUiA",75
43,"43127",778,530,524,6,6,"ICV-EUiA",19
43,"43028",2654,1620,1588,27,32,"ICV-EUiA",86
17,"17089",5486,3328,3288,43,40,"ICV-EUiA",182
43,"43033",772,547,533,4,14,"ICV-EUiA",26
43,"43085",229,178,171,0,7,"ICV-EUiA",12
17,"17075",304,216,210,5,6,"ICV-EUiA",6
43,"43906",2050,1332,1298,28,34,"ICV-EUiA",52
17,"17098",311,208,202,4,6,"ICV-EUiA",21
17,"17118",12541,7817,7681,130,136,"ICV-EUiA",411
43,"43160",1278,840,812,9,28,"ICV-EUiA",52
43,"43904",2918,1779,1732,49,47,"ICV-EUiA",46
43,"43175",590,419,411,8,8,"ICV-EUiA",12
43,"43178",1262,891,870,24,21,"ICV-EUiA",31
17,"17096",182,96,94,2,2,"ICV-EUiA",7
17,"17221",4135,2789,2723,49,66,"ICV-EUiA",109
43,"43168",106,70,69,2,1,"ICV-EUiA",2
17,"17162",137,80,78,2,2,"ICV-EUiA",9
43,"43131",4495,2842,2814,51,28,"ICV-EUiA",122
17,"17216",158,100,97,1,3,"ICV-EUiA",7
43,"43064",2063,1420,1391,37,29,"ICV-EUiA",57
43,"43111",2096,1305,1281,19,24,"ICV-EUiA",101
17,"17129",126,91,90,3,1,"ICV-EUiA",1
43,"43154",136,97,96,6,1,"ICV-EUiA",5
43,"43010",302,227,223,7,4,"ICV-EUiA",9
17,"17119",89,65,64,3,1,"ICV-EUiA",6
17,"17180",8076,4868,4767,81,101,"ICV-EUiA",223
43,"43094",2209,1558,1524,31,34,"ICV-EUiA",81
43,"43137",1873,1241,1212,27,29,"ICV-EUiA",60
17,"17025",1127,775,760,11,15,"ICV-EUiA",34
17,"17028",327,220,217,4,3,"ICV-EUiA",10
43,"43146",45,33,30,1,3,"ICV-EUiA",9
43,"43150",1337,994,977,12,17,"ICV-EUiA",197
17,"17029",198,136,133,1,3,"ICV-EUiA",22
17,"17147",8385,5401,5325,105,76,"ICV-EUiA",168
43,"43062",298,227,223,7,4,"ICV-EUiA",6
17,"17120",779,501,485,9,16,"ICV-EUiA",15
17,"17077",580,374,372,5,2,"ICV-EUiA",23
43,"43044",3990,2768,2715,72,53,"ICV-EUiA",148
17,"17234",183,131,128,2,3,"ICV-EUiA",7
17,"17902",1330,898,874,11,24,"ICV-EUiA",42
43,"43095",2434,1658,1624,27,34,"ICV-EUiA",72
17,"17015",12254,7759,7553,143,206,"ICV-EUiA",425
43,"43053",190,149,149,2,0,"ICV-EUiA",8
17,"17067",732,483,470,16,13,"ICV-EUiA",25
43,"43006",712,484,475,10,9,"ICV-EUiA",27
43,"43102",517,377,366,2,11,"ICV-EUiA",5
17,"17116",369,230,227,3,3,"ICV-EUiA",11
43,"43031",1509,1016,992,20,24,"ICV-EUiA",24
17,"17069",395,276,267,2,9,"ICV-EUiA",16
17,"17043",159,101,100,2,1,"ICV-EUiA",3
17,"17130",333,236,233,5,3,"ICV-EUiA",10
43,"43153",10307,6572,6450,94,122,"ICV-EUiA",349
43,"43105",175,119,116,14,3,"ICV-EUiA",7
17,"17159",639,408,397,3,11,"ICV-EUiA",20
43,"43103",897,586,575,21,11,"ICV-EUiA",18
17,"17117",14022,8705,8595,129,110,"ICV-EUiA",418
17,"17149",366,254,251,4,3,"ICV-EUiA",13
17,"17036",2822,1844,1806,36,38,"ICV-EUiA",112
17,"17052",134,84,83,2,1,"ICV-EUiA",5
17,"17057",1010,640,634,19,6,"ICV-EUiA",47
43,"43907",4122,2759,2712,52,47,"ICV-EUiA",138
43,"43905",13621,8120,8011,131,109,"ICV-EUiA",383
43,"43080",254,175,173,7,2,"ICV-EUiA",1
43,"43048",830,547,530,16,17,"ICV-EUiA",27
43,"43007",635,448,441,7,7,"ICV-EUiA",35
17,"17160",14852,9257,9128,145,129,"ICV-EUiA",545
17,"17040",506,320,316,7,4,"ICV-EUiA",25
17,"17168",393,285,281,8,4,"ICV-EUiA",20
43,"43173",114,65,64,0,1,"ICV-EUiA",7
17,"17086",1687,1148,1129,14,19,"ICV-EUiA",47
43,"43156",4120,2811,2741,66,70,"ICV-EUiA",98
17,"17020",3446,2322,2268,45,54,"ICV-EUiA",123
43,"43169",477,377,364,8,13,"ICV-EUiA",21
17,"17189",1536,1061,1025,7,36,"ICV-EUiA",38
43,"43063",588,358,350,13,8,"ICV-EUiA",13
17,"17037",105,66,66,2,0,"ICV-EUiA",1
17,"17068",252,156,156,4,0,"ICV-EUiA",11
17,"17123",365,274,266,8,8,"ICV-EUiA",9
17,"17060",378,240,233,1,7,"ICV-EUiA",7
43,"43086",5269,3275,3196,92,79,"ICV-EUiA",236
43,"43176",832,575,572,16,3,"ICV-EUiA",35
17,"17007",1778,1137,1113,16,24,"ICV-EUiA",30
43,"43140",2393,1612,1583,23,29,"ICV-EUiA",66
43,"43113",454,321,316,10,5,"ICV-EUiA",13
17,"17012",1093,689,679,11,10,"ICV-EUiA",32
17,"17154",93,54,49,1,5,"ICV-EUiA",6
17,"17092",3520,2273,2228,42,45,"ICV-EUiA",111
43,"43072",97,73,70,0,3,"ICV-EUiA",3
43,"43050",2407,1528,1504,20,24,"ICV-EUiA",83
17,"17194",93,55,55,1,0,"ICV-EUiA",6
17,"17135",380,273,269,9,4,"ICV-EUiA",22
43,"43003",307,187,184,10,3,"ICV-EUiA",11
17,"17233",2192,1470,1434,33,36,"ICV-EUiA",64
17,"17192",145,107,105,4,2,"ICV-EUiA",4
17,"17193",3978,2365,2305,38,60,"ICV-EUiA",146
43,"43069",194,131,127,3,4,"ICV-EUiA",7
43,"43172",378,268,266,8,2,"ICV-EUiA",10
17,"17016",725,491,481,8,10,"ICV-EUiA",22
43,"43029",330,202,194,6,8,"ICV-EUiA",17
17,"17181",3228,2116,2081,19,35,"ICV-EUiA",105
17,"17201",131,89,89,2,0,"ICV-EUiA",5
17,"17228",280,172,170,4,2,"ICV-EUiA",8
17,"17157",127,99,98,3,1,"ICV-EUiA",3
43,"43158",109,63,61,5,2,"ICV-EUiA",0
43,"43132",365,217,214,8,3,"ICV-EUiA",11
17,"17222",108,86,86,1,0,"ICV-EUiA",5
17,"17184",1281,803,787,21,16,"ICV-EUiA",43
17,"17209",605,469,463,21,6,"ICV-EUiA",30
17,"17091",433,288,277,16,11,"ICV-EUiA",10
17,"17165",608,414,400,9,14,"ICV-EUiA",18
43,"43027",177,129,128,6,1,"ICV-EUiA",0
43,"43046",114,80,79,5,1,"ICV-EUiA",3
17,"17078",346,231,226,3,5,"ICV-EUiA",2
17,"17065",316,211,205,6,6,"ICV-EUiA",12
43,"43060",3049,2030,1980,62,50,"ICV-EUiA",110
17,"17903",893,565,556,14,9,"ICV-EUiA",25
17,"17197",144,103,102,3,1,"ICV-EUiA",9
17,"17055",158,121,121,4,0,"ICV-EUiA",22
43,"43161",17199,10765,10547,197,218,"ICV-EUiA",455
43,"43126",1170,802,783,19,19,"ICV-EUiA",41
17,"17153",172,127,123,1,4,"ICV-EUiA",9
17,"17071",1064,719,698,33,21,"ICV-EUiA",32
43,"43076",467,308,300,7,8,"ICV-EUiA",36
43,"43123",70216,45627,44828,906,799,"ICV-EUiA",2363
17,"17112",215,141,138,4,3,"ICV-EUiA",5
17,"17032",1613,933,918,11,15,"ICV-EUiA",55
43,"43148",89309,59260,58346,1202,914,"ICV-EUiA",3669
43,"43165",624,471,459,6,12,"ICV-EUiA",27
43,"43036",836,503,494,4,9,"ICV-EUiA",35
17,"17047",4803,2866,2803,30,63,"ICV-EUiA",113
43,"43004",6411,4089,4001,92,88,"ICV-EUiA",182
17,"17167",2818,1886,1858,52,28,"ICV-EUiA",72
17,"17066",25667,15429,15157,244,272,"ICV-EUiA",718
17,"17158",404,266,264,3,2,"ICV-EUiA",10
43,"43037",16656,9986,9812,163,174,"ICV-EUiA",663
17,"17143",134,89,87,2,2,"ICV-EUiA",5
43,"43135",327,243,238,2,5,"ICV-EUiA",11
43,"43157",388,282,270,10,12,"ICV-EUiA",12
43,"43124",532,366,358,3,8,"ICV-EUiA",18
17,"17026",542,404,398,3,6,"ICV-EUiA",14
43,"43162",4143,2892,2833,59,59,"ICV-EUiA",110
43,"43021",381,218,213,3,5,"ICV-EUiA",21
43,"43089",272,193,185,1,8,"ICV-EUiA",11
43,"43071",975,677,664,14,13,"ICV-EUiA",23
17,"17088",551,374,363,4,11,"ICV-EUiA",25
17,"17002",567,413,401,4,12,"ICV-EUiA",21
17,"17050",645,438,425,15,13,"ICV-EUiA",22
17,"17202",3799,2398,2366,44,32,"ICV-EUiA",113
17,"17046",738,510,498,15,12,"ICV-EUiA",16
17,"17163",2478,1729,1681,41,48,"ICV-EUiA",96
17,"17031",172,94,93,1,1,"ICV-EUiA",2
43,"43117",150,118,115,1,3,"ICV-EUiA",4
43,"43068",573,388,378,5,10,"ICV-EUiA",6
17,"17198",404,264,259,9,5,"ICV-EUiA",18
17,"17027",2865,1955,1892,34,63,"ICV-EUiA",122
17,"17008",3745,2262,2195,34,67,"ICV-EUiA",106
17,"17171",148,111,109,5,2,"ICV-EUiA",6
17,"17079",62633,40844,40101,670,743,"ICV-EUiA",2514
17,"17106",140,105,104,0,1,"ICV-EUiA",2
17,"17226",852,539,535,0,4,"ICV-EUiA",13
17,"17041",237,153,153,1,0,"ICV-EUiA",4
43,"43174",152,104,101,1,3,"ICV-EUiA",4
17,"17081",236,165,162,2,3,"ICV-EUiA",9
43,"43024",1459,958,937,17,21,"ICV-EUiA",38
43,"43009",1421,913,897,18,16,"ICV-EUiA",56
17,"17073",1753,1320,1298,18,22,"ICV-EUiA",47
43,"43018",430,350,337,7,13,"ICV-EUiA",7
43,"43902",2761,1836,1811,25,25,"ICV-EUiA",54
43,"43129",4525,3032,2956,62,76,"ICV-EUiA",83
43,"43084",573,383,378,6,5,"ICV-EUiA",35
43,"43118",439,318,313,7,5,"ICV-EUiA",22
43,"43074",1697,1150,1120,25,30,"ICV-EUiA",80
17,"17085",295,212,208,12,4,"ICV-EUiA",6
17,"17224",355,246,241,10,5,"ICV-EUiA",5
43,"43164",298,233,231,4,2,"ICV-EUiA",24
43,"43045",156,110,109,1,1,"ICV-EUiA",4
17,"17145",1593,1090,1068,10,22,"ICV-EUiA",55
17,"17187",574,414,402,1,12,"ICV-EUiA",34
17,"17164",4092,2409,2346,60,63,"ICV-EUiA",124
17,"17048",6176,3818,3773,52,45,"ICV-EUiA",159
43,"43122",92,65,61,0,4,"ICV-EUiA",5
17,"17049",3056,1986,1944,43,42,"ICV-EUiA",139
17,"17206",167,108,107,2,1,"ICV-EUiA",2
17,"17225",208,138,134,1,4,"ICV-EUiA",3
43,"43077",486,335,328,4,7,"ICV-EUiA",3
17,"17038",343,261,256,2,5,"ICV-EUiA",8
43,"43082",383,282,270,8,12,"ICV-EUiA",15
17,"17044",6619,4293,4187,69,106,"ICV-EUiA",159
17,"17166",503,361,342,10,19,"ICV-EUiA",16
17,"17115",281,209,207,5,2,"ICV-EUiA",8
43,"43093",3924,2507,2445,62,62,"ICV-EUiA",97
43,"43104",1821,1209,1178,34,31,"ICV-EUiA",63
17,"17140",684,476,470,10,6,"ICV-EUiA",19
17,"17178",1075,683,679,15,4,"ICV-EUiA",25
43,"43142",1155,730,714,20,16,"ICV-EUiA",29
17,"17175",569,375,369,6,6,"ICV-EUiA",15
17,"17100",201,140,135,1,5,"ICV-EUiA",2
17,"17125",132,90,89,1,1,"ICV-EUiA",5
17,"17137",3331,2163,2110,39,53,"ICV-EUiA",114
17,"17151",174,131,131,6,0,"ICV-EUiA",2
17,"17205",198,146,138,3,8,"ICV-EUiA",6
43,"43151",119,91,89,0,2,"ICV-EUiA",3
43,"43099",330,240,236,4,4,"ICV-EUiA",11
17,"17111",789,584,574,15,10,"ICV-EUiA",55
17,"17232",159,107,104,0,3,"ICV-EUiA",4
43,"43110",307,216,214,5,2,"ICV-EUiA",5
17,"17212",129,100,98,4,2,"ICV-EUiA",4
17,"17124",1670,1087,1056,18,31,"ICV-EUiA",48
43,"43107",378,255,248,18,7,"ICV-EUiA",17
17,"17173",174,121,119,1,2,"ICV-EUiA",8
43,"43106",878,600,592,17,8,"ICV-EUiA",17
43,"43170",880,601,592,9,9,"ICV-EUiA",27
43,"43001",706,481,473,12,8,"ICV-EUiA",26
17,"17014",64,39,37,0,2,"ICV-EUiA",2
17,"17204",539,349,347,10,2,"ICV-EUiA",10
17,"17196",209,139,138,6,1,"ICV-EUiA",5
43,"43143",62,51,50,1,1,"ICV-EUiA",2
17,"17006",1203,759,754,17,5,"ICV-EUiA",33
17,"17010",327,216,214,6,2,"ICV-EUiA",17
17,"17003",101,67,64,2,3,"ICV-EUiA",3
17,"17074",490,345,342,5,3,"ICV-EUiA",22
43,"43097",379,283,278,6,5,"ICV-EUiA",11
43,"43090",1142,644,636,7,8,"ICV-EUiA",46
17,"17141",5689,3485,3428,50,57,"ICV-EUiA",138
17,"17030",624,414,409,8,5,"ICV-EUiA",15
17,"17056",1704,1171,1158,21,13,"ICV-EUiA",49
17,"17138",1010,677,662,3,15,"ICV-EUiA",23
17,"17144",217,145,143,4,2,"ICV-EUiA",14
43,"43139",2166,1319,1270,37,49,"ICV-EUiA",43
17,"17183",261,178,176,2,2,"ICV-EUiA",7
17,"17142",2440,1713,1681,39,32,"ICV-EUiA",76
17,"17024",301,207,204,4,3,"ICV-EUiA",8
43,"43155",22951,14114,13856,326,258,"ICV-EUiA",860
17,"17011",625,472,467,5,5,"ICV-EUiA",18
17,"17097",185,136,136,4,0,"ICV-EUiA",11
43,"43014",14146,9153,8915,204,238,"ICV-EUiA",345
17,"17094",1161,694,683,11,11,"ICV-EUiA",23
17,"17001",557,370,365,7,5,"ICV-EUiA",15
43,"43038",20710,12999,12771,224,228,"ICV-EUiA",582
17,"17195",324,220,214,6,6,"ICV-EUiA",18
17,"17058",177,115,114,2,1,"ICV-EUiA",10
17,"17176",141,96,95,3,1,"ICV-EUiA",5
17,"17082",443,285,280,1,5,"ICV-EUiA",16
17,"17051",201,146,142,4,4,"ICV-EUiA",10
43,"43016",3437,2323,2266,40,57,"ICV-EUiA",148
17,"17190",811,548,532,7,16,"ICV-EUiA",28
43,"43159",89,51,51,2,0,"ICV-EUiA",1
17,"17062",5994,3686,3614,69,72,"ICV-EUiA",206
43,"43058",106,76,76,5,0,"ICV-EUiA",4
17,"17095",19245,11212,11067,160,145,"ICV-EUiA",698
43,"43119",739,500,496,5,4,"ICV-EUiA",35
17,"17105",257,152,146,4,6,"ICV-EUiA",12
17,"17126",309,231,229,9,2,"ICV-EUiA",13
17,"17146",2952,1895,1864,49,31,"ICV-EUiA",118
17,"17103",4988,2788,2724,51,64,"ICV-EUiA",140
17,"17177",563,398,388,7,10,"ICV-EUiA",15
17,"17035",548,385,379,7,6,"ICV-EUiA",15
43,"43019",1356,868,837,13,31,"ICV-EUiA",31
43,"43002",1790,1252,1226,17,26,"ICV-EUiA",49
17,"17227",107,82,82,1,0,"ICV-EUiA",1
17,"17901",964,628,621,16,7,"ICV-EUiA",37
17,"17110",1359,930,917,12,13,"ICV-EUiA",38
17,"17039",1850,1299,1275,31,24,"ICV-EUiA",48
43,"43098",362,251,247,1,4,"ICV-EUiA",14
43,"43163",24903,15475,15241,263,234,"ICV-EUiA",889
43,"43039",117,85,83,3,2,"ICV-EUiA",1
43,"43079",387,259,255,26,4,"ICV-EUiA",9
17,"17186",3593,2358,2317,33,41,"ICV-EUiA",106
43,"43166",1521,1002,977,17,25,"ICV-EUiA",45
17,"17084",269,177,175,4,2,"ICV-EUiA",10
17,"17083",2886,1825,1801,39,24,"ICV-EUiA",131
43,"43057",45,27,27,2,0,"ICV-EUiA",0
17,"17021",108,86,79,0,7,"ICV-EUiA",5
43,"43017",141,98,98,2,0,"ICV-EUiA",7
43,"43088",1810,1199,1177,29,22,"ICV-EUiA",65
43,"43091",142,106,98,5,8,"ICV-EUiA",13
43,"43054",2850,1815,1771,37,44,"ICV-EUiA",94
43,"43022",1559,1097,1074,22,23,"ICV-EUiA",42
17,"17034",6723,4131,4064,77,67,"ICV-EUiA",197
43,"43052",1001,669,636,12,33,"ICV-EUiA",36
17,"17161",978,693,687,21,6,"ICV-EUiA",34
17,"17218",568,361,350,11,11,"ICV-EUiA",20
17,"17042",415,297,292,2,5,"ICV-EUiA",22
43,"43114",383,238,234,6,4,"ICV-EUiA",28
17,"17214",695,470,461,10,9,"ICV-EUiA",17
43,"43008",333,206,197,3,9,"ICV-EUiA",8
43,"43901",8849,5651,5540,179,111,"ICV-EUiA",169
17,"17101",567,349,339,4,10,"ICV-EUiA",29
17,"17019",1783,1264,1234,42,30,"ICV-EUiA",63
17,"17022",6771,4247,4169,76,78,"ICV-EUiA",246
17,"17063",169,113,111,5,2,"ICV-EUiA",8
17,"17009",4089,2573,2490,59,83,"ICV-EUiA",178
43,"43101",146,94,93,3,1,"ICV-EUiA",5
17,"17136",173,124,120,0,4,"ICV-EUiA",14
17,"17064",341,253,250,4,3,"ICV-EUiA",21
17,"17132",1296,913,900,15,13,"ICV-EUiA",29
17,"17033",5157,3142,3095,44,47,"ICV-EUiA",217
17,"17099",74,52,50,1,2,"ICV-EUiA",1
43,"43141",131,71,70,3,1,"ICV-EUiA",2
17,"17054",395,250,247,3,3,"ICV-EUiA",11
43,"43120",454,287,283,1,4,"ICV-EUiA",22
17,"17004",504,340,337,6,3,"ICV-EUiA",27
17,"17200",616,406,393,12,13,"ICV-EUiA",29
43,"43023",244,179,177,8,2,"ICV-EUiA",13
43,"43109",2040,1332,1316,28,16,"ICV-EUiA",63
43,"43177",338,242,236,6,6,"ICV-EUiA",12
17,"17005",404,258,254,12,4,"ICV-EUiA",9
43,"43015",104,69,68,2,1,"ICV-EUiA",1
17,"17133",1336,889,866,14,23,"ICV-EUiA",50
43,"43121",636,385,371,6,14,"ICV-EUiA",13
17,"17013",2774,1884,1859,21,25,"ICV-EUiA",115
17,"17070",116,78,78,3,0,"ICV-EUiA",4
43,"43065",443,278,270,8,8,"ICV-EUiA",5
17,"17128",309,232,224,5,8,"ICV-EUiA",10
17,"17182",257,177,175,2,2,"ICV-EUiA",6
17,"17217",347,267,251,5,16,"ICV-EUiA",7
17,"17134",235,149,148,3,1,"ICV-EUiA",12
43,"43167",390,284,280,12,4,"ICV-EUiA",13
17,"17148",1546,980,957,24,23,"ICV-EUiA",45
43,"43055",2002,1404,1374,36,30,"ICV-EUiA",86
43,"43040",350,251,246,18,5,"ICV-EUiA",13
43,"43012",3392,2346,2295,48,51,"ICV-EUiA",197
43,"43032",587,418,413,9,5,"ICV-EUiA",7
43,"43083",141,97,97,2,0,"ICV-EUiA",4
43,"43125",1008,706,701,10,5,"ICV-EUiA",26
43,"43051",8749,5494,5411,78,83,"ICV-EUiA",344
43,"43030",454,321,307,5,14,"ICV-EUiA",19
17,"17211",864,628,612,12,16,"ICV-EUiA",27
43,"43128",927,636,625,11,11,"ICV-EUiA",31
17,"17076",126,77,76,5,1,"ICV-EUiA",3
43,"43133",5697,3470,3388,76,82,"ICV-EUiA",177
17,"17230",456,326,320,10,6,"ICV-EUiA",2
17,"17191",153,116,114,0,2,"ICV-EUiA",5
43,"43134",279,208,206,14,2,"ICV-EUiA",19
17,"17220",780,550,545,13,5,"ICV-EUiA",18
43,"43041",237,177,176,4,1,"ICV-EUiA",4
43,"43081",574,415,404,13,11,"ICV-EUiA",12
17,"17023",26941,17098,16799,344,299,"ICV-EUiA",1627
17,"17185",2273,1416,1379,32,37,"ICV-EUiA",37
43,"43047",4064,2412,2352,50,60,"ICV-EUiA",130
17,"17215",1918,1350,1321,40,29,"ICV-EUiA",51
43,"43096",103,81,77,3,4,"ICV-EUiA",3
17,"17080",165,115,114,1,1,"ICV-EUiA",5
17,"17155",14284,8528,8391,143,137,"ICV-EUiA",428
43,"43067",626,445,431,21,14,"ICV-EUiA",23
43,"43025",660,453,446,13,7,"ICV-EUiA",16
17,"17093",859,561,552,16,9,"ICV-EUiA",36
17,"17102",571,354,350,7,4,"ICV-EUiA",11
17,"17207",2357,1636,1584,40,52,"ICV-EUiA",82
17,"17213",5282,3097,3041,42,56,"ICV-EUiA",164
17,"17172",426,286,283,3,3,"ICV-EUiA",27
43,"43115",171,112,110,3,2,"ICV-EUiA",9
17,"17170",192,135,134,1,1,"ICV-EUiA",7
17,"17121",230,159,158,7,1,"ICV-EUiA",4
43,"43035",280,202,198,0,4,"ICV-EUiA",5
43,"43020",2119,1463,1427,26,36,"ICV-EUiA",109
43,"43011",1013,745,729,21,16,"ICV-EUiA",29
43,"43075",102,63,63,1,0,"ICV-EUiA",6
43,"43049",805,555,536,6,19,"ICV-EUiA",23
17,"17090",548,412,404,7,8,"ICV-EUiA",14
17,"17210",527,358,349,9,9,"ICV-EUiA",17
17,"17150",1428,1018,996,24,22,"ICV-EUiA",41
43,"43145",3968,2781,2742,52,39,"ICV-EUiA",143
17,"17199",6630,4242,4162,80,80,"ICV-EUiA",200
17,"17109",759,428,414,10,14,"ICV-EUiA",37
17,"17139",1346,899,869,21,30,"ICV-EUiA",33
17,"17174",183,120,117,5,3,"ICV-EUiA",5
43,"43034",494,355,344,8,11,"ICV-EUiA",17
17,"17169",2460,1690,1651,34,39,"ICV-EUiA",90
43,"43056",931,537,515,18,22,"ICV-EUiA",38
43,"43073",90,57,57,1,0,"ICV-EUiA",4
17,"17018",478,337,332,8,5,"ICV-EUiA",22
43,"43152",472,355,351,9,4,"ICV-EUiA",18
17,"17107",301,203,200,8,3,"ICV-EUiA",8
43,"43070",265,198,196,3,2,"ICV-EUiA",17
43,"43043",3065,1952,1919,39,33,"ICV-EUiA",148
17,"17223",787,523,514,8,9,"ICV-EUiA",32
43,"43059",264,185,185,4,0,"ICV-EUiA",11
43,"43144",1187,787,772,12,15,"ICV-EUiA",59
43,"43026",800,531,522,15,9,"ICV-EUiA",26
17,"17061",175,123,123,4,0,"ICV-EUiA",3
43,"43130",196,132,131,7,1,"ICV-EUiA",1
43,"43112",294,184,181,2,3,"ICV-EUiA",7
17,"17208",1012,642,622,12,20,"ICV-EUiA",49
43,"43171",13906,8978,8855,167,123,"ICV-EUiA",430
43,"43147",528,393,380,7,13,"ICV-EUiA",27
43,"43116",494,328,325,5,3,"ICV-EUiA",23
43,"43100",3062,2058,2021,52,37,"ICV-EUiA",145
17,"17203",171,97,94,3,3,"ICV-EUiA",4
43,"43149",711,529,516,13,13,"ICV-EUiA",19
17,"17087",230,170,161,6,9,"ICV-EUiA",17
43,"43092",7051,4294,4220,45,74,"ICV-EUiA",169
43,"43108",1808,1183,1157,28,26,"ICV-EUiA",66
17,"17114",22610,14079,13811,263,268,"ICV-EUiA",661
43,"43903",2368,1504,1492,22,12,"ICV-EUiA",34
8,"8053",2850,1788,1772,21,16,"ICV-EUiA",75
25,"25185",690,409,404,8,5,"ICV-EUiA",17
25,"25223",951,562,546,14,16,"ICV-EUiA",20
25,"25171",2305,1496,1469,37,27,"ICV-EUiA",77
25,"25061",75,45,45,0,0,"ICV-EUiA",3
8,"8087",158,133,132,6,1,"ICV-EUiA",8
8,"8089",33316,22369,22107,437,262,"ICV-EUiA",1821
25,"25255",468,318,309,9,9,"ICV-EUiA",4
8,"8217",24130,17554,17319,383,235,"ICV-EUiA",1846
8,"8263",20729,13742,13563,232,179,"ICV-EUiA",1270
8,"8012",1694,1155,1136,32,19,"ICV-EUiA",32
25,"25035",428,289,284,5,5,"ICV-EUiA",10
25,"25072",5921,3743,3637,81,106,"ICV-EUiA",140
8,"8086",13267,8791,8669,200,122,"ICV-EUiA",738
8,"8145",2597,1823,1784,23,39,"ICV-EUiA",106
25,"25904",149,107,104,1,3,"ICV-EUiA",7
25,"25110",2662,1649,1602,44,47,"ICV-EUiA",66
25,"25197",158,102,101,2,1,"ICV-EUiA",5
8,"8076",15925,10435,10242,179,193,"ICV-EUiA",782
25,"25166",177,127,125,3,2,"ICV-EUiA",0
8,"8028",1049,667,657,15,10,"ICV-EUiA",50
8,"8104",713,454,441,9,13,"ICV-EUiA",27
25,"25226",257,162,158,5,4,"ICV-EUiA",3
8,"8222",1827,1343,1317,21,26,"ICV-EUiA",112
25,"25243",3408,2280,2252,49,28,"ICV-EUiA",78
8,"8271",74,45,44,3,1,"ICV-EUiA",1
25,"25034",2471,1622,1592,25,30,"ICV-EUiA",35
25,"25017",248,160,159,1,1,"ICV-EUiA",7
8,"8002",202,143,140,4,3,"ICV-EUiA",12
25,"25030",147,101,95,3,6,"ICV-EUiA",4
8,"8130",95,63,62,3,1,"ICV-EUiA",4
8,"8293",246,145,145,4,0,"ICV-EUiA",1
8,"8168",418,268,266,0,2,"ICV-EUiA",12
25,"25227",674,375,372,2,3,"ICV-EUiA",18
8,"8226",886,667,656,13,11,"ICV-EUiA",15
8,"8257",116,84,81,0,3,"ICV-EUiA",6
25,"25042",211,131,127,0,4,"ICV-EUiA",1
8,"8218",7968,5014,4932,129,82,"ICV-EUiA",292
8,"8124",36292,24541,24210,471,331,"ICV-EUiA",2604
8,"8026",180,144,143,0,1,"ICV-EUiA",3
25,"25148",232,144,144,5,0,"ICV-EUiA",1
25,"25175",221,151,150,0,1,"ICV-EUiA",5
8,"8267",6215,4100,4011,82,89,"ICV-EUiA",360
8,"8261",2273,1547,1525,30,22,"ICV-EUiA",89
8,"8023",6546,4261,4194,86,67,"ICV-EUiA",226
8,"8178",450,311,304,3,7,"ICV-EUiA",19
8,"8303",279,202,201,11,1,"ICV-EUiA",14
8,"8179",591,415,405,6,10,"ICV-EUiA",19
8,"8252",24033,16704,16402,368,302,"ICV-EUiA",1784
8,"8191",5520,3601,3536,64,65,"ICV-EUiA",242
25,"25115",878,542,542,17,0,"ICV-EUiA",10
8,"8203",2442,1526,1498,34,28,"ICV-EUiA",115
25,"25074",178,137,132,3,5,"ICV-EUiA",1
8,"8137",255,190,190,3,0,"ICV-EUiA",18
8,"8210",4176,2661,2579,54,82,"ICV-EUiA",186
8,"8120",6342,4801,4746,63,55,"ICV-EUiA",94
25,"25001",146,76,76,1,0,"ICV-EUiA",7
8,"8199",712,507,499,15,8,"ICV-EUiA",16
25,"25169",201,134,134,6,0,"ICV-EUiA",6
8,"8155",6573,4411,4334,85,77,"ICV-EUiA",318
8,"8262",6835,4086,3993,94,93,"ICV-EUiA",240
25,"25252",536,361,352,13,9,"ICV-EUiA",6
25,"25212",233,185,185,8,0,"ICV-EUiA",2
8,"8164",873,606,584,13,22,"ICV-EUiA",29
8,"8165",1689,1091,1070,18,21,"ICV-EUiA",47
25,"25179",198,141,136,1,5,"ICV-EUiA",7
25,"25152",160,92,90,4,2,"ICV-EUiA",4
25,"25253",175,132,129,1,3,"ICV-EUiA",11
8,"8138",4014,2735,2679,46,56,"ICV-EUiA",166
8,"8094",1500,1102,1071,21,31,"ICV-EUiA",78
8,"8209",6596,4415,4351,69,64,"ICV-EUiA",369
8,"8052",148,103,98,1,5,"ICV-EUiA",1
8,"8274",4887,3326,3279,36,47,"ICV-EUiA",138
8,"8042",2172,1459,1448,30,11,"ICV-EUiA",89
8,"8278",4668,3033,2949,67,84,"ICV-EUiA",131
25,"25135",1077,739,722,18,17,"ICV-EUiA",22
8,"8192",5450,3688,3634,79,54,"ICV-EUiA",165
25,"25111",116,70,70,0,0,"ICV-EUiA",2
8,"8108",4879,3475,3437,64,38,"ICV-EUiA",244
8,"8067",5657,3772,3671,75,101,"ICV-EUiA",207
25,"25190",271,180,176,12,4,"ICV-EUiA",4
8,"8117",2424,1685,1661,45,24,"ICV-EUiA",46
25,"25005",291,194,190,7,4,"ICV-EUiA",7
25,"25039",299,189,186,7,3,"ICV-EUiA",23
25,"25118",378,232,226,4,6,"ICV-EUiA",5
25,"25082",265,156,155,8,1,"ICV-EUiA",2
8,"8078",224,154,151,2,3,"ICV-EUiA",9
25,"25191",353,234,227,5,7,"ICV-EUiA",1
25,"25165",301,202,198,6,4,"ICV-EUiA",5
8,"8072",9910,6326,6235,140,91,"ICV-EUiA",385
25,"25161",361,222,218,1,4,"ICV-EUiA",16
25,"25062",806,515,497,11,18,"ICV-EUiA",23
25,"25037",396,275,273,9,2,"ICV-EUiA",8
25,"25126",286,192,189,7,3,"ICV-EUiA",16
8,"8005",5884,4114,4041,68,73,"ICV-EUiA",264
25,"25907",506,297,292,6,5,"ICV-EUiA",13
25,"25010",206,119,118,7,1,"ICV-EUiA",0
25,"25007",1363,902,885,36,17,"ICV-EUiA",37
8,"8174",409,294,292,10,2,"ICV-EUiA",6
25,"25228",2907,2043,2021,43,22,"ICV-EUiA",58
8,"8069",3028,2071,2029,36,42,"ICV-EUiA",127
8,"8197",7316,4983,4926,69,57,"ICV-EUiA",210
8,"8073",60247,41448,40843,770,605,"ICV-EUiA",4854
8,"8077",33925,23896,23548,381,348,"ICV-EUiA",2263
8,"8185",189,131,126,1,5,"ICV-EUiA",4
25,"25098",266,177,177,0,0,"ICV-EUiA",6
8,"8200",61189,40677,40069,736,608,"ICV-EUiA",4204
8,"8272",148,97,96,6,1,"ICV-EUiA",5
25,"25029",1766,1145,1118,38,27,"ICV-EUiA",30
8,"8291",4516,2895,2855,56,40,"ICV-EUiA",233
25,"25055",187,115,115,3,0,"ICV-EUiA",4
25,"25094",154,110,107,1,3,"ICV-EUiA",2
25,"25240",1398,976,958,17,18,"ICV-EUiA",16
25,"25202",110,62,59,3,3,"ICV-EUiA",1
8,"8048",622,461,454,9,7,"ICV-EUiA",14
25,"25170",271,197,196,4,1,"ICV-EUiA",5
8,"8129",444,278,271,2,7,"ICV-EUiA",25
25,"25910",118,77,76,3,1,"ICV-EUiA",4
8,"8158",2996,2012,1986,19,26,"ICV-EUiA",160
25,"25086",569,379,370,4,9,"ICV-EUiA",10
8,"8097",985,676,657,3,19,"ICV-EUiA",51
25,"25221",125,76,76,0,0,"ICV-EUiA",5
25,"25254",782,533,531,9,2,"ICV-EUiA",16
8,"8147",17023,11177,10961,184,216,"ICV-EUiA",1088
8,"8029",3389,2542,2514,45,28,"ICV-EUiA",114
25,"25109",279,183,183,2,0,"ICV-EUiA",7
25,"25139",549,358,357,5,1,"ICV-EUiA",17
8,"8143",2679,1772,1756,35,16,"ICV-EUiA",61
8,"8300",5621,4021,3933,94,88,"ICV-EUiA",338
8,"8189",141,113,111,4,2,"ICV-EUiA",1
8,"8163",17986,11683,11548,159,135,"ICV-EUiA",686
8,"8247",903,627,608,10,19,"ICV-EUiA",14
25,"25078",1014,730,719,17,11,"ICV-EUiA",26
8,"8027",673,527,515,9,12,"ICV-EUiA",30
8,"8187",149633,104021,102629,1794,1392,"ICV-EUiA",10587
8,"8008",193,119,114,5,5,"ICV-EUiA",12
25,"25024",370,221,217,8,4,"ICV-EUiA",12
8,"8297",138,99,99,2,0,"ICV-EUiA",1
8,"8230",7452,5349,5286,94,63,"ICV-EUiA",333
8,"8304",822,587,578,16,9,"ICV-EUiA",26
8,"8134",776,528,513,15,15,"ICV-EUiA",30
25,"25138",605,440,428,13,12,"ICV-EUiA",7
25,"25149",1401,1031,1010,17,21,"ICV-EUiA",29
8,"8224",771,538,528,26,10,"ICV-EUiA",36
8,"8204",2991,2076,2040,45,36,"ICV-EUiA",217
8,"8227",2372,1591,1549,38,42,"ICV-EUiA",57
8,"8103",636,453,446,16,7,"ICV-EUiA",14
25,"25129",175,105,105,3,0,"ICV-EUiA",2
8,"8046",12603,8826,8663,190,163,"ICV-EUiA",778
25,"25087",65,41,39,0,2,"ICV-EUiA",1
8,"8242",243,174,172,5,2,"ICV-EUiA",13
25,"25232",1480,968,959,38,9,"ICV-EUiA",13
25,"25154",126,77,77,2,0,"ICV-EUiA",2
25,"25194",440,292,283,11,9,"ICV-EUiA",8
8,"8131",696,483,469,7,14,"ICV-EUiA",20
25,"25052",1611,1094,1062,21,32,"ICV-EUiA",27
25,"25067",768,498,494,14,4,"ICV-EUiA",33
8,"8159",13482,9173,9040,239,133,"ICV-EUiA",901
8,"8241",80,61,61,1,0,"ICV-EUiA",0
25,"25172",1838,1267,1230,35,37,"ICV-EUiA",40
25,"25141",171,111,107,2,4,"ICV-EUiA",5
8,"8172",19889,13537,13333,267,204,"ICV-EUiA",1267
8,"8056",39345,26705,26396,449,309,"ICV-EUiA",2233
25,"25210",1164,799,789,13,10,"ICV-EUiA",31
8,"8083",1626,1199,1178,23,21,"ICV-EUiA",50
8,"8090",120,86,86,2,0,"ICV-EUiA",1
25,"25013",2274,1344,1321,25,23,"ICV-EUiA",37
8,"8269",2613,1840,1814,32,26,"ICV-EUiA",89
8,"8150",245,181,178,11,3,"ICV-EUiA",13
25,"25196",127,87,86,3,1,"ICV-EUiA",6
25,"25025",1307,874,859,32,15,"ICV-EUiA",43
8,"8032",1955,1330,1294,18,36,"ICV-EUiA",66
25,"25140",785,472,460,5,12,"ICV-EUiA",32
8,"8161",10991,6841,6709,114,132,"ICV-EUiA",499
25,"25004",553,405,400,13,5,"ICV-EUiA",15
25,"25177",379,240,236,2,4,"ICV-EUiA",6
25,"25157",183,128,128,4,0,"ICV-EUiA",6
8,"8096",40650,28247,27784,527,463,"ICV-EUiA",2100
25,"25218",94,75,73,1,2,"ICV-EUiA",1
25,"25014",264,170,164,11,6,"ICV-EUiA",5
8,"8268",1110,768,755,17,13,"ICV-EUiA",15
8,"8207",1718,1296,1256,28,40,"ICV-EUiA",95
25,"25043",830,483,467,17,16,"ICV-EUiA",30
8,"8288",1735,985,957,13,28,"ICV-EUiA",48
25,"25104",128,88,86,11,2,"ICV-EUiA",1
8,"8121",85069,58372,57620,923,752,"ICV-EUiA",4522
8,"8080",42,33,33,2,0,"ICV-EUiA",0
25,"25234",4572,2707,2648,57,59,"ICV-EUiA",93
8,"8180",26210,17504,17214,366,290,"ICV-EUiA",1675
8,"8183",4497,2914,2865,43,49,"ICV-EUiA",106
25,"25027",1042,691,665,11,26,"ICV-EUiA",18
8,"8061",1467,960,952,10,8,"ICV-EUiA",57
25,"25076",165,84,83,3,1,"ICV-EUiA",1
8,"8139",184,130,128,1,2,"ICV-EUiA",10
8,"8232",1793,1239,1220,20,19,"ICV-EUiA",61
8,"8047",4141,2610,2580,49,30,"ICV-EUiA",73
25,"25136",106,79,79,1,0,"ICV-EUiA",5
8,"8292",1083,775,764,21,11,"ICV-EUiA",28
8,"8099",808,533,519,11,14,"ICV-EUiA",22
8,"8266",42860,30047,29521,536,526,"ICV-EUiA",3264
8,"8113",52352,33606,33123,590,483,"ICV-EUiA",1820
8,"8062",863,595,583,8,12,"ICV-EUiA",17
8,"8116",600,401,393,9,8,"ICV-EUiA",15
8,"8035",12099,7838,7735,123,103,"ICV-EUiA",418
8,"8219",14647,10347,10169,193,178,"ICV-EUiA",871
25,"25051",1710,1060,1044,23,16,"ICV-EUiA",45
8,"8025",1460,990,963,14,27,"ICV-EUiA",85
8,"8119",6039,3991,3884,74,107,"ICV-EUiA",309
25,"25071",56,37,35,2,2,"ICV-EUiA",3
25,"25085",153,103,100,2,3,"ICV-EUiA",2
25,"25103",125,82,80,4,2,"ICV-EUiA",8
25,"25156",761,535,529,15,6,"ICV-EUiA",24
8,"8133",157,100,97,2,3,"ICV-EUiA",2
8,"8154",677,499,488,2,11,"ICV-EUiA",24
8,"8171",2158,1385,1359,27,26,"ICV-EUiA",28
25,"25901",315,196,189,3,7,"ICV-EUiA",4
8,"8043",3067,2044,2023,29,21,"ICV-EUiA",142
8,"8196",18989,12658,12490,253,168,"ICV-EUiA",1199
25,"25168",510,385,378,19,7,"ICV-EUiA",7
25,"25036",190,138,134,5,4,"ICV-EUiA",7
25,"25239",627,310,310,7,0,"ICV-EUiA",8
25,"25045",51,33,33,2,0,"ICV-EUiA",4
8,"8114",17629,11781,11579,189,202,"ICV-EUiA",1152
8,"8295",10579,6896,6769,137,127,"ICV-EUiA",498
25,"25113",1227,869,856,28,13,"ICV-EUiA",28
25,"25123",206,140,136,4,4,"ICV-EUiA",4
8,"8019",1143222,778246,767530,12386,10716,"ICV-EUiA",77087
8,"8057",61,41,40,1,1,"ICV-EUiA",0
25,"25211",701,378,368,5,10,"ICV-EUiA",23
25,"25124",161,110,109,4,1,"ICV-EUiA",2
25,"25056",289,168,163,3,5,"ICV-EUiA",2
25,"25046",438,299,286,6,13,"ICV-EUiA",11
25,"25225",603,395,387,7,8,"ICV-EUiA",16
25,"25164",404,270,264,5,6,"ICV-EUiA",6
8,"8132",381,247,241,6,6,"ICV-EUiA",6
8,"8905",2268,1692,1657,28,35,"ICV-EUiA",153
8,"8201",458,305,298,12,7,"ICV-EUiA",6
25,"25130",208,117,112,4,5,"ICV-EUiA",6
25,"25244",350,270,268,9,2,"ICV-EUiA",6
8,"8001",8538,5929,5838,120,91,"ICV-EUiA",465
25,"25050",3249,2056,1988,40,68,"ICV-EUiA",50
25,"25173",1784,1177,1139,20,38,"ICV-EUiA",57
25,"25201",119,78,76,3,2,"ICV-EUiA",2
25,"25057",198,140,136,2,4,"ICV-EUiA",8
8,"8239",471,338,333,6,5,"ICV-EUiA",26
25,"25180",245,167,165,3,2,"ICV-EUiA",4
25,"25153",215,165,161,0,4,"ICV-EUiA",4
8,"8284",11920,7059,6942,139,117,"ICV-EUiA",321
8,"8273",2287,1594,1547,18,47,"ICV-EUiA",101
8,"8136",11117,7602,7478,174,124,"ICV-EUiA",1323
8,"8246",1714,1175,1153,27,22,"ICV-EUiA",26
25,"25134",657,421,416,4,5,"ICV-EUiA",14
8,"8033",12476,8513,8378,180,135,"ICV-EUiA",552
8,"8153",502,357,350,7,7,"ICV-EUiA",28
8,"8206",717,557,547,7,10,"ICV-EUiA",35
8,"8127",2274,1371,1338,23,33,"ICV-EUiA",71
8,"8107",10955,7236,7130,151,106,"ICV-EUiA",480
8,"8264",3983,2773,2744,30,29,"ICV-EUiA",117
8,"8141",4666,3124,3066,57,58,"ICV-EUiA",78
8,"8022",12437,7598,7445,169,153,"ICV-EUiA",369
25,"25250",358,237,234,4,3,"ICV-EUiA",7
8,"8063",434,336,333,8,3,"ICV-EUiA",15
8,"8298",25338,16982,16690,353,292,"ICV-EUiA",914
8,"8060",167,102,101,0,1,"ICV-EUiA",6
8,"8030",4849,3466,3422,50,44,"ICV-EUiA",166
8,"8305",26208,17810,17506,296,304,"ICV-EUiA",1277
8,"8213",6188,4031,3970,113,61,"ICV-EUiA",202
25,"25003",3853,2367,2340,68,27,"ICV-EUiA",75
25,"25031",57,34,34,1,0,"ICV-EUiA",0
8,"8148",2240,1246,1223,22,23,"ICV-EUiA",104
25,"25158",1647,1154,1135,27,19,"ICV-EUiA",28
25,"25102",733,478,464,15,14,"ICV-EUiA",12
25,"25012",2204,1432,1406,29,26,"ICV-EUiA",56
8,"8146",1321,876,862,18,14,"ICV-EUiA",56
8,"8259",6362,4482,4420,97,62,"ICV-EUiA",316
8,"8024",409,266,260,4,6,"ICV-EUiA",7
25,"25905",386,264,258,12,6,"ICV-EUiA",4
8,"8181",7722,5280,5188,112,92,"ICV-EUiA",351
25,"25079",307,242,240,7,2,"ICV-EUiA",9
8,"8160",313,227,222,8,5,"ICV-EUiA",4
8,"8276",249,188,187,9,1,"ICV-EUiA",12
8,"8010",4124,2674,2611,44,63,"ICV-EUiA",108
8,"8126",8299,5599,5508,103,91,"ICV-EUiA",492
25,"25100",207,125,115,2,10,"ICV-EUiA",7
25,"25206",289,187,184,3,3,"ICV-EUiA",1
8,"8250",7083,4485,4426,72,59,"ICV-EUiA",273
25,"25217",10570,6660,6500,191,160,"ICV-EUiA",267
25,"25093",657,465,455,8,10,"ICV-EUiA",16
8,"8256",669,498,496,16,2,"ICV-EUiA",73
25,"25119",2297,1554,1513,46,41,"ICV-EUiA",38
8,"8287",1053,738,730,26,8,"ICV-EUiA",29
25,"25174",438,289,283,4,6,"ICV-EUiA",17
8,"8066",1315,985,965,16,20,"ICV-EUiA",82
25,"25064",122,91,88,7,3,"ICV-EUiA",1
8,"8294",1870,1205,1171,22,34,"ICV-EUiA",99
25,"25909",141,82,78,0,4,"ICV-EUiA",8
8,"8216",21,14,14,0,0,"ICV-EUiA",0
25,"25081",332,212,206,6,6,"ICV-EUiA",14
8,"8100",1934,1437,1401,40,36,"ICV-EUiA",39
25,"25023",4446,3079,3020,70,59,"ICV-EUiA",102
8,"8049",1340,839,816,10,23,"ICV-EUiA",28
25,"25143",86,58,58,1,0,"ICV-EUiA",1
8,"8233",1867,1179,1169,29,10,"ICV-EUiA",32
8,"8111",220,188,188,4,0,"ICV-EUiA",3
25,"25247",142,80,78,3,2,"ICV-EUiA",6
25,"25002",481,306,302,6,4,"ICV-EUiA",8
8,"8254",1721,1189,1174,26,15,"ICV-EUiA",119
8,"8190",281,201,197,3,4,"ICV-EUiA",9
8,"8214",6754,4659,4555,83,104,"ICV-EUiA",331
8,"8275",242,188,186,4,2,"ICV-EUiA",5
8,"8194",24757,15009,14799,245,210,"ICV-EUiA",1486
8,"8118",17077,11817,11598,203,219,"ICV-EUiA",975
8,"8149",985,683,671,11,12,"ICV-EUiA",23
8,"8037",1830,1247,1209,40,38,"ICV-EUiA",35
25,"25009",690,479,471,9,8,"ICV-EUiA",9
25,"25231",515,402,395,4,7,"ICV-EUiA",8
8,"8128",557,377,374,16,3,"ICV-EUiA",13
8,"8054",8733,6215,6077,123,138,"ICV-EUiA",457
25,"25155",714,490,485,8,5,"ICV-EUiA",15
8,"8021",76,49,47,1,2,"ICV-EUiA",1
25,"25044",195,136,134,1,2,"ICV-EUiA",4
25,"25146",227,150,149,0,1,"ICV-EUiA",2
8,"8270",17464,11828,11677,212,151,"ICV-EUiA",830
8,"8175",3477,2303,2270,39,33,"ICV-EUiA",94
8,"8156",10672,7359,7225,121,134,"ICV-EUiA",528
8,"8253",134,91,91,2,0,"ICV-EUiA",6
8,"8202",12206,8265,8129,183,136,"ICV-EUiA",594
8,"8243",160,112,110,3,2,"ICV-EUiA",1
25,"25245",445,312,306,4,6,"ICV-EUiA",28
25,"25033",1125,738,718,17,20,"ICV-EUiA",27
8,"8167",5703,3896,3831,82,65,"ICV-EUiA",420
25,"25912",899,643,640,6,3,"ICV-EUiA",15
8,"8307",47176,31341,30846,536,495,"ICV-EUiA",2789
8,"8123",18751,13394,13154,238,240,"ICV-EUiA",1311
8,"8277",134,90,90,4,0,"ICV-EUiA",5
8,"8281",4735,3239,3193,57,46,"ICV-EUiA",228
8,"8240",9104,6355,6262,101,93,"ICV-EUiA",370
8,"8237",1692,1155,1127,22,28,"ICV-EUiA",28
25,"25913",100,78,78,0,0,"ICV-EUiA",1
25,"25207",6253,3938,3872,91,66,"ICV-EUiA",151
25,"25132",128,87,85,3,2,"ICV-EUiA",1
8,"8234",3143,2040,2008,45,32,"ICV-EUiA",171
8,"8044",4247,2763,2712,50,51,"ICV-EUiA",140
25,"25192",799,543,527,19,16,"ICV-EUiA",20
8,"8182",2802,1871,1852,35,19,"ICV-EUiA",109
8,"8110",13366,8493,8329,144,164,"ICV-EUiA",483
25,"25193",771,509,501,8,8,"ICV-EUiA",10
25,"25222",69,55,54,0,1,"ICV-EUiA",0
8,"8282",6092,4478,4405,79,73,"ICV-EUiA",323
25,"25121",623,406,400,6,6,"ICV-EUiA",11
25,"25205",563,373,362,12,11,"ICV-EUiA",17
25,"25059",796,580,575,9,5,"ICV-EUiA",24
8,"8041",10032,6880,6761,112,119,"ICV-EUiA",474
25,"25021",2693,1632,1605,40,27,"ICV-EUiA",58
8,"8102",27850,18716,18470,373,246,"ICV-EUiA",1034
25,"25070",888,594,582,18,12,"ICV-EUiA",23
8,"8248",5239,3513,3443,71,70,"ICV-EUiA",214
8,"8205",54870,41064,40491,682,573,"ICV-EUiA",3312
25,"25022",119,83,83,0,0,"ICV-EUiA",2
25,"25131",439,319,314,6,5,"ICV-EUiA",12
8,"8109",200,155,153,1,2,"ICV-EUiA",7
8,"8215",2594,1763,1728,51,35,"ICV-EUiA",49
25,"25016",2203,1375,1357,20,18,"ICV-EUiA",45
8,"8039",365,264,260,5,4,"ICV-EUiA",50
25,"25060",92,53,52,1,1,"ICV-EUiA",0
8,"8286",2865,1843,1796,30,47,"ICV-EUiA",93
8,"8071",248,172,167,2,5,"ICV-EUiA",17
25,"25189",2085,1348,1327,38,21,"ICV-EUiA",88
8,"8115",3870,2693,2644,60,49,"ICV-EUiA",248
8,"8225",92,68,68,2,0,"ICV-EUiA",1
25,"25249",207,151,150,4,1,"ICV-EUiA",1
25,"25008",1187,834,818,15,16,"ICV-EUiA",15
8,"8075",3906,2442,2414,31,28,"ICV-EUiA",164
8,"8301",47343,32098,31664,672,434,"ICV-EUiA",2993
25,"25063",97,65,64,2,1,"ICV-EUiA",2
8,"8193",928,565,554,15,11,"ICV-EUiA",35
25,"25089",107,66,64,0,2,"ICV-EUiA",14
25,"25220",1076,711,702,10,9,"ICV-EUiA",20
8,"8144",769,494,481,16,13,"ICV-EUiA",8
8,"8140",4665,3160,3103,55,57,"ICV-EUiA",190
25,"25209",1558,1041,1009,22,32,"ICV-EUiA",58
25,"25088",100,74,74,0,0,"ICV-EUiA",1
25,"25099",1185,720,709,9,11,"ICV-EUiA",30
25,"25908",250,169,168,4,1,"ICV-EUiA",10
25,"25068",576,376,364,6,12,"ICV-EUiA",1
25,"25077",474,281,277,5,4,"ICV-EUiA",5
8,"8244",5746,4044,3940,102,104,"ICV-EUiA",419
8,"8151",504,345,338,6,7,"ICV-EUiA",13
8,"8009",8932,6188,6088,103,100,"ICV-EUiA",377
25,"25058",4390,2696,2650,57,46,"ICV-EUiA",86
25,"25208",294,174,170,3,4,"ICV-EUiA",15
25,"25176",341,243,240,7,3,"ICV-EUiA",7
8,"8299",444,277,267,5,10,"ICV-EUiA",11
25,"25204",1313,888,881,21,7,"ICV-EUiA",26
25,"25203",8995,5418,5309,116,109,"ICV-EUiA",299
25,"25047",1048,760,748,24,12,"ICV-EUiA",17
8,"8074",10224,6571,6479,116,92,"ICV-EUiA",553
25,"25238",231,158,156,1,2,"ICV-EUiA",10
8,"8011",1754,1116,1085,29,31,"ICV-EUiA",42
25,"25142",387,265,264,5,1,"ICV-EUiA",5
25,"25105",146,90,89,1,1,"ICV-EUiA",1
8,"8014",1906,1338,1313,37,25,"ICV-EUiA",68
8,"8092",3928,2511,2473,33,38,"ICV-EUiA",94
25,"25053",1085,733,727,10,6,"ICV-EUiA",18
8,"8903",217,178,176,10,2,"ICV-EUiA",8
25,"25120",90759,58761,57778,1325,983,"ICV-EUiA",2701
25,"25242",787,501,490,11,11,"ICV-EUiA",16
25,"25075",122,85,83,0,2,"ICV-EUiA",7
8,"8255",132,83,82,1,1,"ICV-EUiA",5
25,"25902",581,411,395,15,16,"ICV-EUiA",9
25,"25200",353,225,217,4,8,"ICV-EUiA",4
8,"8260",17869,11898,11686,215,212,"ICV-EUiA",1384
8,"8290",1446,1075,1056,12,19,"ICV-EUiA",61
25,"25048",1684,1120,1095,29,25,"ICV-EUiA",27
8,"8093",32,21,20,0,1,"ICV-EUiA",1
8,"8308",145,116,115,1,1,"ICV-EUiA",1
25,"25233",270,207,201,3,6,"ICV-EUiA",6
8,"8152",129,94,93,0,1,"ICV-EUiA",2
25,"25903",261,176,170,9,6,"ICV-EUiA",16
25,"25041",625,432,420,20,12,"ICV-EUiA",6
25,"25006",362,231,228,2,3,"ICV-EUiA",4
25,"25122",1956,1281,1256,33,25,"ICV-EUiA",35
25,"25215",399,229,226,4,3,"ICV-EUiA",12
25,"25181",189,128,123,3,5,"ICV-EUiA",6
25,"25151",641,451,444,20,7,"ICV-EUiA",5
8,"8016",1984,1319,1289,26,30,"ICV-EUiA",44
8,"8006",10984,7255,7092,104,163,"ICV-EUiA",528
25,"25069",471,291,289,9,2,"ICV-EUiA",15
8,"8302",9271,5981,5892,82,89,"ICV-EUiA",329
8,"8018",2664,1707,1669,29,38,"ICV-EUiA",82
8,"8055",476,312,304,11,8,"ICV-EUiA",17
8,"8162",1955,1306,1271,28,35,"ICV-EUiA",100
25,"25182",1075,749,731,30,18,"ICV-EUiA",30
25,"25133",748,499,483,7,16,"ICV-EUiA",10
8,"8169",47505,31997,31566,555,431,"ICV-EUiA",3990
8,"8064",1847,1277,1246,14,31,"ICV-EUiA",58
8,"8082",1143,733,723,17,10,"ICV-EUiA",35
8,"8045",70,42,42,2,0,"ICV-EUiA",2
8,"8068",6554,4323,4255,87,68,"ICV-EUiA",279
25,"25216",250,175,173,5,2,"ICV-EUiA",10
8,"8177",52,31,31,1,0,"ICV-EUiA",0
8,"8059",323,189,186,9,3,"ICV-EUiA",11
25,"25230",1665,1164,1140,36,24,"ICV-EUiA",20
25,"25020",328,216,209,4,7,"ICV-EUiA",4
25,"25150",185,119,113,4,6,"ICV-EUiA",2
8,"8058",1699,1089,1061,25,28,"ICV-EUiA",73
8,"8105",9642,6571,6483,110,88,"ICV-EUiA",811
8,"8038",1406,911,895,24,16,"ICV-EUiA",46
25,"25167",253,176,172,0,4,"ICV-EUiA",3
8,"8236",1507,1027,1002,18,25,"ICV-EUiA",35
8,"8280",116,74,72,3,2,"ICV-EUiA",0
25,"25125",450,297,289,10,8,"ICV-EUiA",2
25,"25097",102,70,69,3,1,"ICV-EUiA",2
8,"8015",155673,101652,100264,1628,1388,"ICV-EUiA",9722
8,"8220",2277,1641,1604,44,37,"ICV-EUiA",56
8,"8101",169663,112624,111107,1841,1517,"ICV-EUiA",10763
8,"8221",11348,8413,8306,109,107,"ICV-EUiA",710
25,"25145",88,67,67,2,0,"ICV-EUiA",3
8,"8084",1134,789,760,14,29,"ICV-EUiA",25
8,"8088",11250,8019,7861,144,158,"ICV-EUiA",615
8,"8098",2374,1552,1535,28,17,"ICV-EUiA",88
25,"25073",662,382,379,11,3,"ICV-EUiA",14
25,"25019",4626,2971,2932,54,39,"ICV-EUiA",116
8,"8223",1855,1178,1155,19,23,"ICV-EUiA",62
25,"25224",144,93,91,6,2,"ICV-EUiA",5
25,"25011",5241,3127,3080,48,47,"ICV-EUiA",81
25,"25163",237,147,142,2,5,"ICV-EUiA",5
8,"8904",10608,6654,6561,140,93,"ICV-EUiA",706
8,"8195",88,64,64,2,0,"ICV-EUiA",2
8,"8228",303,230,227,5,3,"ICV-EUiA",4
8,"8211",32035,23059,22687,453,372,"ICV-EUiA",2780
25,"25219",144,90,86,0,4,"ICV-EUiA",6
8,"8085",1033,731,720,10,11,"ICV-EUiA",36
8,"8231",19810,12359,12196,244,163,"ICV-EUiA",801
8,"8285",10168,6582,6423,152,159,"ICV-EUiA",375
8,"8258",845,577,555,23,22,"ICV-EUiA",23
8,"8095",75,56,55,1,1,"ICV-EUiA",3
8,"8212",508,366,363,1,3,"ICV-EUiA",3
8,"8184",52133,33696,33220,656,476,"ICV-EUiA",3529
8,"8902",3600,2518,2496,57,22,"ICV-EUiA",185
8,"8229",561,404,398,12,6,"ICV-EUiA",11
8,"8170",458,300,288,13,12,"ICV-EUiA",10
25,"25128",151,83,81,1,2,"ICV-EUiA",5
8,"8036",172,124,124,4,0,"ICV-EUiA",4
8,"8081",332,232,225,2,7,"ICV-EUiA",18
25,"25251",670,476,473,1,3,"ICV-EUiA",12
8,"8188",106,87,86,4,1,"ICV-EUiA",1
25,"25248",926,615,601,17,14,"ICV-EUiA",15
8,"8176",166,111,109,0,2,"ICV-EUiA",3
8,"8198",4112,2766,2661,49,105,"ICV-EUiA",195
8,"8051",17397,12178,12002,240,176,"ICV-EUiA",856
25,"25137",8404,5264,5167,112,97,"ICV-EUiA",153
8,"8106",6858,4675,4559,113,116,"ICV-EUiA",264
25,"25112",286,202,199,11,3,"ICV-EUiA",6
8,"8251",4771,3214,3140,57,74,"ICV-EUiA",151
8,"8283",5862,3712,3618,72,94,"ICV-EUiA",143
8,"8079",335,255,243,14,12,"ICV-EUiA",10
8,"8135",6647,4753,4678,79,75,"ICV-EUiA",698
8,"8017",2740,1800,1768,38,32,"ICV-EUiA",93
25,"25040",10654,6905,6768,144,137,"ICV-EUiA",249
25,"25186",231,168,168,3,0,"ICV-EUiA",5
8,"8070",275,192,191,5,1,"ICV-EUiA",10
8,"8003",6983,5061,4993,53,68,"ICV-EUiA",238
8,"8166",1138,726,706,10,20,"ICV-EUiA",36
8,"8112",12946,8533,8390,227,143,"ICV-EUiA",517
8,"8040",10538,6916,6804,99,112,"ICV-EUiA",459
25,"25038",1606,1104,1093,19,11,"ICV-EUiA",14
25,"25015",394,264,264,14,0,"ICV-EUiA",16
8,"8157",8256,5729,5624,119,105,"ICV-EUiA",493
25,"25096",988,633,613,12,20,"ICV-EUiA",21
8,"8065",1224,796,778,13,18,"ICV-EUiA",28
8,"8007",6338,4165,4050,89,115,"ICV-EUiA",205
8,"8004",228,176,172,2,4,"ICV-EUiA",11
8,"8208",5471,3859,3792,82,67,"ICV-EUiA",332
8,"8296",1683,1227,1203,29,24,"ICV-EUiA",63
8,"8050",149,112,108,4,4,"ICV-EUiA",3
8,"8238",13892,10237,10094,206,143,"ICV-EUiA",766
8,"8013",1234,834,820,23,14,"ICV-EUiA",55
8,"8034",741,542,529,4,13,"ICV-EUiA",28
8,"8031",2289,1619,1599,34,20,"ICV-EUiA",56
25,"25183",485,336,327,6,9,"ICV-EUiA",21
25,"25127",226,134,130,2,4,"ICV-EUiA",9
8,"8235",3627,2506,2467,35,39,"ICV-EUiA",167
25,"25032",71,44,42,1,2,"ICV-EUiA",5
8,"8249",273,218,214,4,4,"ICV-EUiA",12
25,"25049",166,105,102,1,3,"ICV-EUiA",4
8,"8901",249,180,180,2,0,"ICV-EUiA",2
25,"25906",235,160,154,3,6,"ICV-EUiA",18
8,"8265",1575,1065,1026,38,39,"ICV-EUiA",49
8,"8245",78826,51185,50445,962,740,"ICV-EUiA",5713
25,"25101",583,391,382,8,9,"ICV-EUiA",8
8,"8306",509,330,324,6,6,"ICV-EUiA",33
8,"8279",149233,101676,100363,1965,1313,"ICV-EUiA",9473
8,"8289",4123,2802,2768,54,34,"ICV-EUiA",300
8,"8020",4542,3352,3298,77,54,"ICV-EUiA",243
25,"25911",472,306,296,2,10,"ICV-EUiA",3
8,"8125",24559,16065,15798,293,267,"ICV-EUiA",1773
8,"8142",127,83,83,4,0,"ICV-EUiA",6
8,"8122",1755,1063,1034,17,29,"ICV-EUiA",81
25,"25114",102,82,78,4,4,"ICV-EUiA",3
25,"25092",135,100,97,2,3,"ICV-EUiA",5
8,"8091",5106,3379,3312,59,67,"ICV-EUiA",325
48,"48047",161,126,126,1,0,"IU-LV",0
48,"48095",2367,1593,1577,20,16,"IU-LV",49
48,"48062",317,263,262,1,1,"IU-LV",0
48,"48017",13554,9303,9234,64,69,"IU-LV",120
48,"48066",350,277,277,0,0,"IU-LV",2
48,"48089",2878,2120,2089,19,31,"IU-LV",72
48,"48092",792,603,600,5,3,"IU-LV",14
48,"48096",6607,5007,4900,54,107,"IU-LV",130
48,"48027",21610,15409,15274,145,135,"IU-LV",479
48,"48083",7021,4722,4656,74,66,"IU-LV",241
48,"48029",8022,5488,5409,83,79,"IU-LV",301
48,"48014",1211,838,834,4,4,"IU-LV",26
48,"48080",10161,6901,6815,95,86,"IU-LV",351
48,"48036",23973,16491,16344,179,147,"IU-LV",779
48,"48084",23491,15322,15084,213,238,"IU-LV",812
48,"48061",773,585,582,6,3,"IU-LV",8
48,"48015",34932,24209,23966,296,243,"IU-LV",1042
48,"48048",547,423,423,5,0,"IU-LV",2
48,"48052",1526,1213,1205,7,8,"IU-LV",24
48,"48906",796,625,622,5,3,"IU-LV",4
48,"48008",600,432,428,3,4,"IU-LV",9
48,"48003",14142,10268,10167,84,101,"IU-LV",385
48,"48087",463,371,370,4,1,"IU-LV",4
48,"48910",3063,2122,2104,14,18,"IU-LV",64
48,"48053",856,683,680,8,3,"IU-LV",4
48,"48016",5214,3782,3736,46,46,"IU-LV",139
48,"48055",2620,1954,1934,22,20,"IU-LV",58
48,"48046",12635,9231,9161,61,70,"IU-LV",163
48,"48030",626,487,483,0,4,"IU-LV",2
48,"48039",263,217,216,4,1,"IU-LV",1
48,"48069",12381,8760,8672,66,88,"IU-LV",170
48,"48023",601,499,492,4,7,"IU-LV",4
48,"48074",3384,2441,2397,20,44,"IU-LV",72
48,"48082",38551,25768,25482,316,286,"IU-LV",1354
48,"48037",727,528,519,2,9,"IU-LV",6
48,"48060",3689,2477,2466,12,11,"IU-LV",22
48,"48904",3510,2682,2665,26,17,"IU-LV",79
48,"48094",3299,2398,2377,15,21,"IU-LV",35
48,"48028",767,623,621,1,2,"IU-LV",3
48,"48041",721,588,585,9,3,"IU-LV",6
48,"48012",2036,1630,1616,9,14,"IU-LV",23
48,"48042",1401,1116,1099,15,17,"IU-LV",34
48,"48033",223,171,171,1,0,"IU-LV",0
48,"48085",9893,6960,6885,93,75,"IU-LV",235
48,"48088",148,110,109,0,1,"IU-LV",4
48,"48034",13160,9290,9189,82,101,"IU-LV",690
48,"48093",893,707,695,1,12,"IU-LV",9
48,"48915",362,273,271,2,2,"IU-LV",0
48,"48009",767,585,580,4,5,"IU-LV",6
48,"48019",3741,2613,2595,24,18,"IU-LV",96
48,"48007",354,254,253,1,1,"IU-LV",2
48,"48067",1204,895,892,4,3,"IU-LV",8
48,"48004",329,240,239,2,1,"IU-LV",0
48,"48073",7090,4865,4802,37,63,"IU-LV",34
48,"48058",977,706,700,2,6,"IU-LV",16
48,"48056",849,610,608,3,2,"IU-LV",3
48,"48903",1909,1455,1430,4,25,"IU-LV",24
48,"48059",397,289,286,0,3,"IU-LV",0
48,"48905",2600,1903,1869,14,34,"IU-LV",55
48,"48907",351,290,290,1,0,"IU-LV",4
48,"48086",2087,1432,1420,11,12,"IU-LV",43
48,"48011",9742,6697,6628,82,69,"IU-LV",313
48,"48050",216,173,172,0,1,"IU-LV",4
48,"48026",1093,881,875,3,6,"IU-LV",9
48,"48063",355,287,287,6,0,"IU-LV",5
48,"48908",242,194,194,1,0,"IU-LV",1
48,"48914",324,278,276,0,2,"IU-LV",1
48,"48002",7971,5377,5290,65,87,"IU-LV",299
48,"48006",285,246,243,3,3,"IU-LV",0
48,"48078",39866,27311,26995,311,316,"IU-LV",1543
48,"48054",23712,16643,16439,215,204,"IU-LV",793
48,"48064",599,490,490,1,0,"IU-LV",5
48,"48010",427,303,300,2,3,"IU-LV",6
48,"48040",1274,936,921,10,15,"IU-LV",11
48,"48097",1359,936,915,9,21,"IU-LV",26
48,"48913",1231,936,922,10,14,"IU-LV",20
48,"48018",905,591,587,8,4,"IU-LV",2
48,"48001",5842,4040,4020,23,20,"IU-LV",117
48,"48051",225,157,156,0,1,"IU-LV",6
48,"48035",379,304,301,0,3,"IU-LV",6
48,"48079",470,391,391,2,0,"IU-LV",3
48,"48013",81335,54452,53803,771,649,"IU-LV",3120
48,"48005",93,65,64,0,1,"IU-LV",2
48,"48031",370,296,296,1,0,"IU-LV",0
48,"48021",1460,1024,1012,13,12,"IU-LV",12
48,"48024",1026,845,841,3,4,"IU-LV",8
48,"48912",2340,1794,1776,22,18,"IU-LV",44
48,"48070",559,413,407,1,6,"IU-LV",1
48,"48044",63869,47453,47085,511,368,"IU-LV",1212
48,"48090",6153,4682,4571,40,111,"IU-LV",134
48,"48032",5864,4257,4223,32,34,"IU-LV",77
48,"48020",276378,191777,190141,2335,1636,"IU-LV",6746
48,"48077",3398,2490,2477,33,13,"IU-LV",53
48,"48025",882,652,644,2,8,"IU-LV",5
48,"48902",19232,12809,12633,182,176,"IU-LV",531
48,"48045",5060,3912,3849,31,63,"IU-LV",81
48,"48071",6097,4307,4224,61,83,"IU-LV",160
48,"48072",1009,796,787,3,9,"IU-LV",11
48,"48076",294,226,226,0,0,"IU-LV",4
48,"48043",4256,3066,3040,33,26,"IU-LV",86
48,"48038",1087,826,821,7,5,"IU-LV",8
48,"48901",4370,3156,3124,46,32,"IU-LV",124
48,"48057",5934,4407,4385,27,22,"IU-LV",39
48,"48911",373,300,296,1,4,"IU-LV",2
48,"48065",3311,2340,2323,23,17,"IU-LV",68
48,"48081",1938,1449,1435,14,14,"IU-LV",25
48,"48909",194,163,163,0,0,"IU-LV",1
48,"48075",1915,1362,1325,15,37,"IU-LV",14
48,"48022",2396,1524,1504,12,20,"IU-LV",30
48,"48068",1577,1224,1213,4,11,"IU-LV",8
48,"48049",564,446,446,2,0,"IU-LV",2
48,"48091",1170,860,851,3,9,"IU-LV",23
31,"31253",123,102,97,0,5,"IZQUIERDA-EZKERRA",3
31,"31068",3004,2258,2207,43,51,"IZQUIERDA-EZKERRA",91
31,"31002",421,292,284,5,8,"IZQUIERDA-EZKERRA",8
31,"31130",319,213,209,1,4,"IZQUIERDA-EZKERRA",2
31,"31049",733,479,479,4,0,"IZQUIERDA-EZKERRA",6
31,"31905",2707,1913,1881,32,32,"IZQUIERDA-EZKERRA",147
31,"31208",2574,2003,1966,32,37,"IZQUIERDA-EZKERRA",154
31,"31008",97,64,63,1,1,"IZQUIERDA-EZKERRA",0
31,"31127",145,89,89,2,0,"IZQUIERDA-EZKERRA",1
31,"31249",1926,1376,1361,30,15,"IZQUIERDA-EZKERRA",92
31,"31907",9914,7394,7282,198,112,"IZQUIERDA-EZKERRA",511
31,"31174",115,72,70,1,2,"IZQUIERDA-EZKERRA",1
31,"31059",204,140,139,3,1,"IZQUIERDA-EZKERRA",1
31,"31211",25,14,14,2,0,"IZQUIERDA-EZKERRA",0
31,"31256",113,64,64,0,0,"IZQUIERDA-EZKERRA",0
31,"31201",144714,104019,102644,2027,1375,"IZQUIERDA-EZKERRA",5683
31,"31904",1590,1054,1031,19,23,"IZQUIERDA-EZKERRA",47
31,"31001",88,58,58,1,0,"IZQUIERDA-EZKERRA",3
31,"31099",68,50,50,0,0,"IZQUIERDA-EZKERRA",1
31,"31103",51,40,40,3,0,"IZQUIERDA-EZKERRA",0
31,"31093",305,207,203,2,4,"IZQUIERDA-EZKERRA",2
31,"31232",24440,17810,17436,420,374,"IZQUIERDA-EZKERRA",1576
31,"31126",372,247,244,6,3,"IZQUIERDA-EZKERRA",7
31,"31096",127,112,110,2,2,"IZQUIERDA-EZKERRA",2
31,"31071",17,15,15,0,0,"IZQUIERDA-EZKERRA",0
31,"31259",503,341,336,6,5,"IZQUIERDA-EZKERRA",1
31,"31195",186,127,126,1,1,"IZQUIERDA-EZKERRA",1
31,"31198",38,33,33,0,0,"IZQUIERDA-EZKERRA",3
31,"31046",58,41,41,3,0,"IZQUIERDA-EZKERRA",1
31,"31141",132,100,98,1,2,"IZQUIERDA-EZKERRA",1
31,"31069",860,660,647,2,13,"IZQUIERDA-EZKERRA",24
31,"31263",241,135,132,0,3,"IZQUIERDA-EZKERRA",0
31,"31183",667,516,508,8,8,"IZQUIERDA-EZKERRA",33
31,"31191",2930,2194,2148,43,46,"IZQUIERDA-EZKERRA",85
31,"31129",405,285,281,1,4,"IZQUIERDA-EZKERRA",3
31,"31219",93,75,73,1,2,"IZQUIERDA-EZKERRA",0
31,"31076",2314,1843,1823,39,20,"IZQUIERDA-EZKERRA",55
31,"31151",77,49,49,2,0,"IZQUIERDA-EZKERRA",3
31,"31192",148,107,104,1,3,"IZQUIERDA-EZKERRA",3
31,"31014",280,197,196,2,1,"IZQUIERDA-EZKERRA",11
31,"31137",215,108,106,1,2,"IZQUIERDA-EZKERRA",0
31,"31160",111,93,93,7,0,"IZQUIERDA-EZKERRA",6
31,"31062",1103,849,832,7,17,"IZQUIERDA-EZKERRA",71
31,"31257",827,598,585,16,13,"IZQUIERDA-EZKERRA",41
31,"31190",48,34,34,1,0,"IZQUIERDA-EZKERRA",0
31,"31005",312,209,206,4,3,"IZQUIERDA-EZKERRA",26
31,"31109",1365,946,934,11,12,"IZQUIERDA-EZKERRA",54
31,"31147",103,81,80,3,1,"IZQUIERDA-EZKERRA",4
31,"31140",117,91,89,3,2,"IZQUIERDA-EZKERRA",2
31,"31041",1397,938,913,26,25,"IZQUIERDA-EZKERRA",52
31,"31167",859,600,593,11,7,"IZQUIERDA-EZKERRA",43
31,"31016",7377,5149,5072,101,77,"IZQUIERDA-EZKERRA",511
31,"31032",1785,1330,1305,24,25,"IZQUIERDA-EZKERRA",43
31,"31013",668,382,375,12,7,"IZQUIERDA-EZKERRA",20
31,"31101",1305,892,874,15,18,"IZQUIERDA-EZKERRA",32
31,"31074",430,304,303,10,1,"IZQUIERDA-EZKERRA",15
31,"31242",235,157,157,2,0,"IZQUIERDA-EZKERRA",7
31,"31239",302,229,224,7,5,"IZQUIERDA-EZKERRA",1
31,"31073",332,228,226,1,2,"IZQUIERDA-EZKERRA",3
31,"31018",422,303,299,8,4,"IZQUIERDA-EZKERRA",11
31,"31084",1949,1369,1361,11,8,"IZQUIERDA-EZKERRA",17
31,"31125",269,172,169,6,3,"IZQUIERDA-EZKERRA",2
31,"31077",5349,4025,3917,103,108,"IZQUIERDA-EZKERRA",139
31,"31022",544,378,369,1,9,"IZQUIERDA-EZKERRA",1
31,"31060",12916,8830,8687,158,143,"IZQUIERDA-EZKERRA",593
31,"31111",100,75,75,1,0,"IZQUIERDA-EZKERRA",4
31,"31181",168,121,119,3,2,"IZQUIERDA-EZKERRA",1
31,"31092",676,447,446,6,1,"IZQUIERDA-EZKERRA",15
31,"31184",66,60,59,0,1,"IZQUIERDA-EZKERRA",0
31,"31066",915,660,647,19,13,"IZQUIERDA-EZKERRA",37
31,"31124",209,139,138,1,1,"IZQUIERDA-EZKERRA",5
31,"31089",246,198,195,4,3,"IZQUIERDA-EZKERRA",7
31,"31033",55,34,34,0,0,"IZQUIERDA-EZKERRA",4
31,"31133",48,34,34,3,0,"IZQUIERDA-EZKERRA",3
31,"31153",2246,1504,1487,13,17,"IZQUIERDA-EZKERRA",25
31,"31119",49,28,28,0,0,"IZQUIERDA-EZKERRA",1
31,"31207",280,198,195,7,3,"IZQUIERDA-EZKERRA",7
31,"31204",45,35,34,0,1,"IZQUIERDA-EZKERRA",0
31,"31039",94,65,61,0,4,"IZQUIERDA-EZKERRA",3
31,"31043",42,30,30,1,0,"IZQUIERDA-EZKERRA",2
31,"31030",155,113,112,3,1,"IZQUIERDA-EZKERRA",2
31,"31063",96,77,75,0,2,"IZQUIERDA-EZKERRA",1
31,"31154",229,133,133,4,0,"IZQUIERDA-EZKERRA",13
31,"31102",162,80,78,0,2,"IZQUIERDA-EZKERRA",2
31,"31128",406,261,261,4,0,"IZQUIERDA-EZKERRA",24
31,"31132",160,124,124,6,0,"IZQUIERDA-EZKERRA",4
31,"31003",131,101,101,1,0,"IZQUIERDA-EZKERRA",3
31,"31042",2719,2100,2057,27,43,"IZQUIERDA-EZKERRA",54
31,"31056",183,123,122,4,1,"IZQUIERDA-EZKERRA",6
31,"31136",438,283,283,10,0,"IZQUIERDA-EZKERRA",14
31,"31264",173,110,108,1,2,"IZQUIERDA-EZKERRA",2
31,"31010",5788,3716,3637,48,79,"IZQUIERDA-EZKERRA",173
31,"31226",597,339,335,2,4,"IZQUIERDA-EZKERRA",1
31,"31193",1312,969,948,33,21,"IZQUIERDA-EZKERRA",45
31,"31217",382,256,244,5,12,"IZQUIERDA-EZKERRA",6
31,"31255",100,78,78,1,0,"IZQUIERDA-EZKERRA",2
31,"31214",95,64,64,1,0,"IZQUIERDA-EZKERRA",5
31,"31176",2777,1999,1955,57,44,"IZQUIERDA-EZKERRA",101
31,"31097",10461,7152,7029,129,123,"IZQUIERDA-EZKERRA",408
31,"31061",67,47,47,2,0,"IZQUIERDA-EZKERRA",0
31,"31261",271,202,201,4,1,"IZQUIERDA-EZKERRA",6
31,"31230",118,88,85,1,3,"IZQUIERDA-EZKERRA",3
31,"31040",197,137,135,2,2,"IZQUIERDA-EZKERRA",1
31,"31238",125,99,98,3,1,"IZQUIERDA-EZKERRA",9
31,"31246",148,101,100,3,1,"IZQUIERDA-EZKERRA",7
31,"31244",153,97,97,3,0,"IZQUIERDA-EZKERRA",0
31,"31236",1333,887,874,15,13,"IZQUIERDA-EZKERRA",32
31,"31187",122,68,68,2,0,"IZQUIERDA-EZKERRA",2
31,"31120",408,267,265,8,2,"IZQUIERDA-EZKERRA",5
31,"31171",738,521,495,7,26,"IZQUIERDA-EZKERRA",22
31,"31194",308,212,210,6,2,"IZQUIERDA-EZKERRA",9
31,"31118",182,114,114,6,0,"IZQUIERDA-EZKERRA",6
31,"31188",185,139,137,2,2,"IZQUIERDA-EZKERRA",4
31,"31045",501,384,377,16,7,"IZQUIERDA-EZKERRA",23
31,"31222",67,46,44,3,2,"IZQUIERDA-EZKERRA",2
31,"31123",652,379,373,8,6,"IZQUIERDA-EZKERRA",12
31,"31086",11499,8520,8389,214,131,"IZQUIERDA-EZKERRA",671
31,"31173",881,754,733,12,21,"IZQUIERDA-EZKERRA",17
31,"31015",1989,1404,1380,29,24,"IZQUIERDA-EZKERRA",50
31,"31070",2706,1949,1912,34,37,"IZQUIERDA-EZKERRA",213
31,"31134",195,134,132,3,2,"IZQUIERDA-EZKERRA",2
31,"31110",97,53,53,3,0,"IZQUIERDA-EZKERRA",4
31,"31024",116,56,56,2,0,"IZQUIERDA-EZKERRA",0
31,"31215",4618,3384,3315,54,69,"IZQUIERDA-EZKERRA",119
31,"31212",173,117,117,3,0,"IZQUIERDA-EZKERRA",2
31,"31017",358,220,219,12,1,"IZQUIERDA-EZKERRA",7
31,"31028",217,129,128,1,1,"IZQUIERDA-EZKERRA",1
31,"31158",264,174,173,1,1,"IZQUIERDA-EZKERRA",6
31,"31170",46,40,39,3,1,"IZQUIERDA-EZKERRA",1
31,"31075",96,61,61,0,0,"IZQUIERDA-EZKERRA",1
31,"31166",274,183,182,2,1,"IZQUIERDA-EZKERRA",6
31,"31177",264,162,158,3,4,"IZQUIERDA-EZKERRA",5
31,"31012",839,577,570,10,7,"IZQUIERDA-EZKERRA",41
31,"31116",71,48,48,2,0,"IZQUIERDA-EZKERRA",0
31,"31159",1158,864,846,17,18,"IZQUIERDA-EZKERRA",57
31,"31052",89,62,58,1,4,"IZQUIERDA-EZKERRA",6
31,"31058",240,184,179,0,5,"IZQUIERDA-EZKERRA",3
31,"31011",688,437,432,17,5,"IZQUIERDA-EZKERRA",28
31,"31080",544,428,426,7,2,"IZQUIERDA-EZKERRA",29
31,"31050",6253,4045,3987,74,58,"IZQUIERDA-EZKERRA",67
31,"31169",2285,1621,1590,43,31,"IZQUIERDA-EZKERRA",32
31,"31064",1500,1137,1120,12,17,"IZQUIERDA-EZKERRA",28
31,"31199",161,103,103,1,0,"IZQUIERDA-EZKERRA",1
31,"31237",198,137,136,7,1,"IZQUIERDA-EZKERRA",10
31,"31121",79,53,52,2,1,"IZQUIERDA-EZKERRA",5
31,"31104",1990,1374,1355,20,19,"IZQUIERDA-EZKERRA",52
31,"31161",321,251,246,5,5,"IZQUIERDA-EZKERRA",13
31,"31079",99,64,63,0,1,"IZQUIERDA-EZKERRA",5
31,"31202",4247,3014,2957,69,57,"IZQUIERDA-EZKERRA",205
31,"31908",997,692,683,9,9,"IZQUIERDA-EZKERRA",26
31,"31072",5098,3764,3698,75,66,"IZQUIERDA-EZKERRA",153
31,"31051",270,182,181,8,1,"IZQUIERDA-EZKERRA",9
31,"31265",81,52,50,0,2,"IZQUIERDA-EZKERRA",4
31,"31142",1443,906,899,16,7,"IZQUIERDA-EZKERRA",40
31,"31245",87,59,58,5,1,"IZQUIERDA-EZKERRA",2
31,"31262",219,158,157,4,1,"IZQUIERDA-EZKERRA",14
31,"31078",2502,1880,1852,33,28,"IZQUIERDA-EZKERRA",64
31,"31044",276,224,223,0,1,"IZQUIERDA-EZKERRA",3
31,"31143",105,62,58,2,4,"IZQUIERDA-EZKERRA",3
31,"31901",15574,11165,10974,201,191,"IZQUIERDA-EZKERRA",814
31,"31009",717,510,497,14,13,"IZQUIERDA-EZKERRA",28
31,"31146",46,34,34,1,0,"IZQUIERDA-EZKERRA",1
31,"31020",488,247,246,0,1,"IZQUIERDA-EZKERRA",1
31,"31114",384,320,318,37,2,"IZQUIERDA-EZKERRA",18
31,"31100",298,193,193,2,0,"IZQUIERDA-EZKERRA",8
31,"31156",268,202,201,5,1,"IZQUIERDA-EZKERRA",12
31,"31162",53,35,34,1,1,"IZQUIERDA-EZKERRA",1
31,"31055",264,194,193,0,1,"IZQUIERDA-EZKERRA",0
31,"31168",247,165,163,0,2,"IZQUIERDA-EZKERRA",5
31,"31164",604,462,448,9,14,"IZQUIERDA-EZKERRA",13
31,"31178",540,395,392,4,3,"IZQUIERDA-EZKERRA",5
31,"31106",676,534,518,10,16,"IZQUIERDA-EZKERRA",16
31,"31131",841,610,594,12,16,"IZQUIERDA-EZKERRA",24
31,"31113",147,87,85,2,2,"IZQUIERDA-EZKERRA",4
31,"31163",2008,1458,1434,22,24,"IZQUIERDA-EZKERRA",59
31,"31241",164,117,116,4,1,"IZQUIERDA-EZKERRA",11
31,"31115",171,112,109,2,3,"IZQUIERDA-EZKERRA",5
31,"31903",6058,3985,3919,67,66,"IZQUIERDA-EZKERRA",348
31,"31200",763,527,514,17,13,"IZQUIERDA-EZKERRA",35
31,"31235",189,111,110,0,1,"IZQUIERDA-EZKERRA",8
31,"31088",5358,3655,3592,97,63,"IZQUIERDA-EZKERRA",239
31,"31180",240,174,170,5,4,"IZQUIERDA-EZKERRA",8
31,"31247",171,121,121,1,0,"IZQUIERDA-EZKERRA",1
31,"31108",1969,1474,1452,23,22,"IZQUIERDA-EZKERRA",78
31,"31175",78,55,54,0,1,"IZQUIERDA-EZKERRA",0
31,"31221",1182,774,767,12,7,"IZQUIERDA-EZKERRA",16
31,"31083",50,37,37,0,0,"IZQUIERDA-EZKERRA",2
31,"31053",595,430,418,6,12,"IZQUIERDA-EZKERRA",15
31,"31157",3567,2435,2393,32,42,"IZQUIERDA-EZKERRA",138
31,"31035",60,47,47,0,0,"IZQUIERDA-EZKERRA",1
31,"31065",1927,1391,1362,39,29,"IZQUIERDA-EZKERRA",40
31,"31082",634,402,398,10,4,"IZQUIERDA-EZKERRA",3
31,"31034",43,29,29,0,0,"IZQUIERDA-EZKERRA",3
31,"31095",83,70,70,1,0,"IZQUIERDA-EZKERRA",1
31,"31048",154,118,117,0,1,"IZQUIERDA-EZKERRA",5
31,"31252",91,60,58,0,2,"IZQUIERDA-EZKERRA",0
31,"31260",1263,788,780,11,8,"IZQUIERDA-EZKERRA",30
31,"31229",46,38,37,0,1,"IZQUIERDA-EZKERRA",4
31,"31197",69,58,57,1,1,"IZQUIERDA-EZKERRA",3
31,"31025",751,501,495,12,6,"IZQUIERDA-EZKERRA",22
31,"31196",40,35,35,1,0,"IZQUIERDA-EZKERRA",4
31,"31185",541,377,374,2,3,"IZQUIERDA-EZKERRA",6
31,"31023",5338,3986,3920,120,66,"IZQUIERDA-EZKERRA",208
31,"31019",1858,1288,1266,25,22,"IZQUIERDA-EZKERRA",53
31,"31165",2868,2094,2046,43,48,"IZQUIERDA-EZKERRA",157
31,"31149",2381,1626,1607,7,19,"IZQUIERDA-EZKERRA",9
31,"31027",824,611,609,2,2,"IZQUIERDA-EZKERRA",7
31,"31122",4506,3333,3281,76,52,"IZQUIERDA-EZKERRA",192
31,"31209",155,105,104,1,1,"IZQUIERDA-EZKERRA",4
31,"31906",2493,1796,1770,57,26,"IZQUIERDA-EZKERRA",153
31,"31107",1706,1321,1311,17,10,"IZQUIERDA-EZKERRA",19
31,"31036",957,631,616,22,15,"IZQUIERDA-EZKERRA",29
31,"31205",465,335,325,9,10,"IZQUIERDA-EZKERRA",11
31,"31091",365,227,224,3,3,"IZQUIERDA-EZKERRA",2
31,"31225",40,32,32,0,0,"IZQUIERDA-EZKERRA",2
31,"31139",172,97,97,1,0,"IZQUIERDA-EZKERRA",3
31,"31179",558,384,384,3,0,"IZQUIERDA-EZKERRA",12
31,"31233",103,87,82,2,5,"IZQUIERDA-EZKERRA",1
31,"31081",335,249,243,8,6,"IZQUIERDA-EZKERRA",4
31,"31037",94,68,68,0,0,"IZQUIERDA-EZKERRA",0
31,"31112",106,79,78,0,1,"IZQUIERDA-EZKERRA",2
31,"31234",148,107,105,6,2,"IZQUIERDA-EZKERRA",10
31,"31213",114,58,58,0,0,"IZQUIERDA-EZKERRA",3
31,"31057",1863,1450,1409,32,41,"IZQUIERDA-EZKERRA",41
31,"31182",45,28,28,2,0,"IZQUIERDA-EZKERRA",4
31,"31227",8257,5987,5884,125,103,"IZQUIERDA-EZKERRA",241
31,"31210",219,169,167,3,2,"IZQUIERDA-EZKERRA",5
31,"31258",7679,5561,5475,92,86,"IZQUIERDA-EZKERRA",407
31,"31090",156,77,77,0,0,"IZQUIERDA-EZKERRA",1
31,"31243",313,227,223,5,4,"IZQUIERDA-EZKERRA",15
31,"31155",264,187,183,7,4,"IZQUIERDA-EZKERRA",9
31,"31152",1406,1003,975,23,28,"IZQUIERDA-EZKERRA",40
31,"31248",318,190,187,2,3,"IZQUIERDA-EZKERRA",6
31,"31203",30,25,25,0,0,"IZQUIERDA-EZKERRA",0
31,"31085",451,334,327,3,7,"IZQUIERDA-EZKERRA",16
31,"31004",36,21,20,0,1,"IZQUIERDA-EZKERRA",0
31,"31224",980,691,681,9,10,"IZQUIERDA-EZKERRA",23
31,"31029",987,693,680,16,13,"IZQUIERDA-EZKERRA",32
31,"31135",116,87,86,9,1,"IZQUIERDA-EZKERRA",3
31,"31223",1043,783,771,14,12,"IZQUIERDA-EZKERRA",39
31,"31094",123,100,97,3,3,"IZQUIERDA-EZKERRA",0
31,"31067",1982,1400,1363,28,37,"IZQUIERDA-EZKERRA",47
31,"31231",127,93,91,1,2,"IZQUIERDA-EZKERRA",2
31,"31031",234,144,143,1,1,"IZQUIERDA-EZKERRA",1
31,"31054",498,310,308,1,2,"IZQUIERDA-EZKERRA",2
31,"31250",2887,1827,1802,20,25,"IZQUIERDA-EZKERRA",50
31,"31021",75,52,52,0,0,"IZQUIERDA-EZKERRA",0
31,"31150",234,163,162,5,1,"IZQUIERDA-EZKERRA",10
31,"31902",3722,2670,2632,77,38,"IZQUIERDA-EZKERRA",185
31,"31098",1762,1285,1262,34,23,"IZQUIERDA-EZKERRA",50
31,"31087",163,122,121,3,1,"IZQUIERDA-EZKERRA",2
31,"31144",840,509,508,7,1,"IZQUIERDA-EZKERRA",10
31,"31186",299,205,200,3,5,"IZQUIERDA-EZKERRA",3
31,"31038",1372,982,968,17,14,"IZQUIERDA-EZKERRA",49
31,"31117",670,471,467,3,4,"IZQUIERDA-EZKERRA",0
31,"31006",1988,1434,1395,22,39,"IZQUIERDA-EZKERRA",75
31,"31138",939,648,646,14,2,"IZQUIERDA-EZKERRA",15
31,"31189",1229,745,740,5,5,"IZQUIERDA-EZKERRA",21
31,"31172",375,295,288,11,7,"IZQUIERDA-EZKERRA",21
31,"31240",553,360,359,3,1,"IZQUIERDA-EZKERRA",5
31,"31206",2079,1517,1475,33,42,"IZQUIERDA-EZKERRA",85
31,"31220",771,584,572,9,12,"IZQUIERDA-EZKERRA",19
31,"31228",540,376,364,13,12,"IZQUIERDA-EZKERRA",25
31,"31216",3911,2699,2653,82,46,"IZQUIERDA-EZKERRA",144
31,"31251",3147,2274,2225,39,49,"IZQUIERDA-EZKERRA",118
31,"31145",173,129,127,2,2,"IZQUIERDA-EZKERRA",2
31,"31007",137,96,90,2,6,"IZQUIERDA-EZKERRA",3
31,"31254",1956,1495,1476,16,19,"IZQUIERDA-EZKERRA",54
31,"31026",154,125,122,1,3,"IZQUIERDA-EZKERRA",5
31,"31047",283,208,204,3,4,"IZQUIERDA-EZKERRA",6
31,"31105",1619,1306,1284,30,22,"IZQUIERDA-EZKERRA",17
31,"31148",99,69,66,2,3,"IZQUIERDA-EZKERRA",6
38,"38033",3987,2696,2656,23,40,"IUC-IpH-LV",88
38,"38015",4326,3132,3099,21,33,"IUC-IpH-LV",47
38,"38029",1456,732,715,4,17,"IUC-IpH-LV",23
38,"38050",2516,1765,1734,9,31,"IUC-IpH-LV",39
38,"38020",14520,9396,9202,121,194,"IUC-IpH-LV",379
38,"38043",18628,12966,12763,134,203,"IUC-IpH-LV",656
38,"38003",1446,1053,1044,4,9,"IUC-IpH-LV",33
38,"38044",2325,1550,1532,7,18,"IUC-IpH-LV",19
38,"38901",1389,917,907,16,10,"IUC-IpH-LV",49
38,"38037",13166,8509,8332,65,177,"IUC-IpH-LV",375
38,"38040",4697,3007,2962,31,45,"IUC-IpH-LV",58
38,"38042",3876,2850,2809,24,41,"IUC-IpH-LV",54
38,"38051",7081,5298,5229,64,69,"IUC-IpH-LV",137
38,"38023",118865,76393,75039,928,1354,"IUC-IpH-LV",4405
38,"38028",22003,14876,14589,158,287,"IUC-IpH-LV",717
38,"38021",1792,1184,1160,6,24,"IUC-IpH-LV",20
38,"38047",1819,1269,1239,12,30,"IUC-IpH-LV",31
38,"38004",4522,3034,2975,33,59,"IUC-IpH-LV",169
38,"38025",6649,4858,4778,52,80,"IUC-IpH-LV",115
38,"38031",28391,21797,21431,234,366,"IUC-IpH-LV",927
38,"38024",14851,9589,9399,93,190,"IUC-IpH-LV",270
38,"38039",10198,7548,7429,78,119,"IUC-IpH-LV",214
38,"38009",3910,2687,2633,31,54,"IUC-IpH-LV",91
38,"38053",3752,2459,2397,28,62,"IUC-IpH-LV",70
38,"38001",17632,9601,9475,121,126,"IUC-IpH-LV",378
38,"38002",991,716,708,1,8,"IUC-IpH-LV",7
38,"38038",161890,99555,97980,1101,1575,"IUC-IpH-LV",5061
38,"38007",1844,1209,1188,5,21,"IUC-IpH-LV",34
38,"38014",1446,1018,1007,8,11,"IUC-IpH-LV",30
38,"38048",3884,2615,2587,34,28,"IUC-IpH-LV",100
38,"38008",5430,3844,3772,46,72,"IUC-IpH-LV",116
38,"38016",1250,664,646,3,18,"IUC-IpH-LV",23
38,"38013",2823,1856,1843,18,13,"IUC-IpH-LV",51
38,"38035",8172,4990,4919,62,71,"IUC-IpH-LV",152
38,"38018",4397,3216,3163,27,53,"IUC-IpH-LV",88
38,"38017",24438,13769,13576,176,193,"IUC-IpH-LV",505
38,"38011",19299,12565,12313,152,252,"IUC-IpH-LV",594
38,"38019",12624,8174,8099,65,75,"IUC-IpH-LV",160
38,"38010",4054,2642,2599,17,43,"IUC-IpH-LV",98
38,"38005",5327,3316,3270,38,46,"IUC-IpH-LV",84
38,"38036",6477,4514,4422,40,92,"IUC-IpH-LV",187
38,"38034",4092,3034,2983,30,51,"IUC-IpH-LV",83
38,"38046",8848,6410,6301,75,109,"IUC-IpH-LV",406
38,"38032",13032,8487,8357,101,130,"IUC-IpH-LV",366
38,"38006",35862,18726,18500,209,226,"IUC-IpH-LV",656
38,"38049",2794,1721,1694,12,27,"IUC-IpH-LV",62
38,"38026",32174,24822,24431,283,391,"IUC-IpH-LV",1128
38,"38041",6780,4905,4813,57,92,"IUC-IpH-LV",210
38,"38022",18671,13075,12890,111,185,"IUC-IpH-LV",247
38,"38012",2535,1735,1716,11,19,"IUC-IpH-LV",68
38,"38052",1344,886,872,5,14,"IUC-IpH-LV",17
38,"38027",5392,3530,3459,41,71,"IUC-IpH-LV",103
38,"38045",4181,2176,2140,13,36,"IUC-IpH-LV",95
38,"38030",1875,1320,1301,11,19,"IUC-IpH-LV",28
33,"33065",1150,791,784,16,7,"IU-IX",101
33,"33044",180964,129466,128346,1888,1120,"IU-IX",14333
33,"33069",3611,2615,2597,25,18,"IU-IX",250
33,"33017",3289,2378,2350,35,28,"IU-IX",174
33,"33024",229816,164603,163179,2100,1424,"IU-IX",21383
33,"33015",1695,1177,1161,12,16,"IU-IX",218
33,"33013",466,349,345,4,4,"IU-IX",44
33,"33051",7576,5379,5335,65,44,"IU-IX",523
33,"33014",9318,6380,6320,66,60,"IU-IX",1029
33,"33059",5049,3480,3447,37,33,"IU-IX",268
33,"33019",3262,2283,2244,12,39,"IU-IX",179
33,"33026",9144,6019,5959,87,60,"IU-IX",925
33,"33075",305,191,190,0,1,"IU-IX",16
33,"33039",1719,1325,1319,14,6,"IU-IX",162
33,"33076",12662,8733,8670,120,63,"IU-IX",666
33,"33006",1674,1130,1120,10,10,"IU-IX",261
33,"33008",1934,1474,1459,11,15,"IU-IX",78
33,"33047",1178,939,931,2,8,"IU-IX",30
33,"33061",446,260,259,1,1,"IU-IX",24
33,"33037",37135,25522,25262,291,260,"IU-IX",6248
33,"33002",10837,7667,7588,77,79,"IU-IX",1179
33,"33054",1780,1272,1263,8,9,"IU-IX",113
33,"33077",1351,938,931,7,7,"IU-IX",64
33,"33071",671,528,523,4,5,"IU-IX",31
33,"33009",951,673,663,7,10,"IU-IX",56
33,"33055",1589,1212,1192,16,20,"IU-IX",65
33,"33028",1466,812,806,5,6,"IU-IX",76
33,"33052",758,526,518,2,8,"IU-IX",45
33,"33011",12085,7186,7116,89,70,"IU-IX",706
33,"33031",38090,25034,24730,380,304,"IU-IX",5209
33,"33042",4434,3172,3135,43,37,"IU-IX",366
33,"33045",4692,3347,3297,42,50,"IU-IX",277
33,"33058",1863,1307,1286,11,21,"IU-IX",333
33,"33010",1922,1284,1277,14,7,"IU-IX",181
33,"33025",9455,6331,6277,84,54,"IU-IX",869
33,"33064",237,175,173,1,2,"IU-IX",14
33,"33032",12060,8627,8491,107,136,"IU-IX",1682
33,"33070",3481,2557,2521,33,36,"IU-IX",246
33,"33062",452,282,281,3,1,"IU-IX",64
33,"33005",1600,1084,1080,6,4,"IU-IX",78
33,"33068",1224,704,703,5,1,"IU-IX",45
33,"33074",3699,2643,2611,30,32,"IU-IX",137
33,"33023",3410,2501,2485,40,16,"IU-IX",266
33,"33056",5278,3576,3540,41,36,"IU-IX",286
33,"33046",546,429,421,3,8,"IU-IX",11
33,"33016",19516,14345,14210,198,135,"IU-IX",2161
33,"33033",10609,7179,7107,91,72,"IU-IX",1332
33,"33036",11674,8695,8605,104,90,"IU-IX",608
33,"33004",69056,49228,48730,726,498,"IU-IX",7005
33,"33041",7488,5356,5309,65,47,"IU-IX",550
33,"33063",467,367,363,4,4,"IU-IX",20
33,"33043",710,529,528,1,1,"IU-IX",53
33,"33035",11413,8105,8035,104,70,"IU-IX",962
33,"33003",737,475,471,6,4,"IU-IX",29
33,"33029",420,243,241,3,2,"IU-IX",32
33,"33049",6806,4629,4581,70,48,"IU-IX",378
33,"33012",5341,3816,3777,43,39,"IU-IX",213
33,"33027",929,617,613,5,4,"IU-IX",54
33,"33022",992,709,696,12,13,"IU-IX",92
33,"33048",169,120,120,1,0,"IU-IX",8
33,"33018",2971,2139,2121,32,18,"IU-IX",206
33,"33020",13542,9300,9173,135,127,"IU-IX",1488
33,"33066",42885,29326,29013,460,313,"IU-IX",3602
33,"33021",4932,3544,3502,45,42,"IU-IX",288
33,"33001",1772,984,971,14,13,"IU-IX",39
33,"33034",11390,7583,7501,85,82,"IU-IX",583
33,"33050",653,406,402,0,4,"IU-IX",44
33,"33060",15694,11036,10883,112,153,"IU-IX",2209
33,"33030",921,682,668,4,14,"IU-IX",136
33,"33072",1737,1171,1159,11,12,"IU-IX",228
33,"33038",2442,1757,1725,14,32,"IU-IX",318
33,"33007",1680,1186,1179,10,7,"IU-IX",128
33,"33067",802,650,639,12,11,"IU-IX",98
33,"33078",159,108,106,1,2,"IU-IX",15
33,"33040",4702,3285,3236,44,49,"IU-IX",414
33,"33073",9341,5825,5773,69,52,"IU-IX",370
33,"33057",1635,1150,1132,16,18,"IU-IX",190
33,"33053",1206,817,811,6,6,"IU-IX",149
39,"39012",6666,5148,5061,43,87,"IUC",208
39,"39029",642,521,517,6,4,"IUC",11
39,"39074",6785,5287,5233,50,54,"IUC",147
39,"39094",927,702,691,0,11,"IUC",15
39,"39045",410,324,323,5,1,"IUC",10
39,"39066",895,710,703,6,7,"IUC",25
39,"39059",8476,6365,6284,73,81,"IUC",229
39,"39090",731,577,572,3,5,"IUC",8
39,"39007",479,348,347,3,1,"IUC",9
39,"39049",339,244,242,5,2,"IUC",7
39,"39023",6048,4795,4747,43,48,"IUC",130
39,"39069",1957,1595,1570,18,25,"IUC",57
39,"39095",2292,1824,1801,24,23,"IUC",65
39,"39081",440,372,369,3,3,"IUC",13
39,"39067",901,628,623,1,5,"IUC",10
39,"39052",17031,13198,13034,187,164,"IUC",480
39,"39070",152,118,118,0,0,"IUC",6
39,"39024",2065,1616,1601,8,15,"IUC",52
39,"39091",2026,1636,1628,14,8,"IUC",25
39,"39018",4077,3212,3160,44,52,"IUC",146
39,"39021",536,448,444,1,4,"IUC",2
39,"39064",1339,1072,1066,7,6,"IUC",21
39,"39043",1321,1082,1072,8,10,"IUC",21
39,"39098",1522,1256,1244,8,12,"IUC",25
39,"39075",140941,103308,102362,1364,946,"IUC",3841
39,"39085",6722,5198,5134,60,64,"IUC",162
39,"39096",719,521,518,4,3,"IUC",12
39,"39099",2987,2416,2391,28,25,"IUC",95
39,"39084",873,647,642,4,5,"IUC",14
39,"39017",588,424,419,2,5,"IUC",4
39,"39073",9275,6984,6903,83,81,"IUC",275
39,"39014",943,706,700,9,6,"IUC",17
39,"39040",4350,3413,3373,30,40,"IUC",79
39,"39038",1465,1065,1047,8,18,"IUC",36
39,"39057",2298,1735,1719,17,16,"IUC",57
39,"39046",1442,1071,1050,13,21,"IUC",22
39,"39037",2061,1609,1586,10,23,"IUC",37
39,"39055",1130,881,869,10,12,"IUC",24
39,"39011",1646,1295,1294,5,1,"IUC",25
39,"39086",386,282,280,1,2,"IUC",7
39,"39093",351,260,253,2,7,"IUC",18
39,"39015",898,692,688,7,4,"IUC",4
39,"39047",1987,1495,1482,9,13,"IUC",36
39,"39031",1227,965,956,4,9,"IUC",22
39,"39005",1319,1048,1026,3,22,"IUC",21
39,"39013",561,413,412,2,1,"IUC",8
39,"39022",985,735,734,5,1,"IUC",8
39,"39062",1759,1397,1387,9,10,"IUC",33
39,"39058",862,586,584,6,2,"IUC",28
39,"39072",375,234,234,4,0,"IUC",6
39,"39032",1576,1215,1209,10,6,"IUC",18
39,"39009",3200,2427,2402,24,25,"IUC",71
39,"39001",2146,1669,1645,20,24,"IUC",69
39,"39010",688,533,524,6,9,"IUC",11
39,"39027",3213,2506,2473,21,33,"IUC",105
39,"39088",70,61,61,1,0,"IUC",0
39,"39003",321,265,261,0,4,"IUC",3
39,"39034",289,209,209,3,0,"IUC",0
39,"39077",256,196,196,1,0,"IUC",4
39,"39033",604,480,473,3,7,"IUC",9
39,"39056",2387,1857,1835,22,22,"IUC",52
39,"39078",1407,1041,1033,10,8,"IUC",20
39,"39101",328,251,247,5,4,"IUC",5
39,"39083",1214,785,775,7,10,"IUC",9
39,"39008",13716,10396,10274,129,122,"IUC",511
39,"39036",1023,802,790,5,12,"IUC",43
39,"39041",1775,1432,1414,15,18,"IUC",49
39,"39079",9035,6959,6897,55,62,"IUC",108
39,"39061",3458,2673,2644,42,29,"IUC",77
39,"39053",251,179,179,1,0,"IUC",0
39,"39025",8985,7048,6955,70,93,"IUC",230
39,"39100",922,718,712,8,6,"IUC",9
39,"39048",1616,1326,1308,8,18,"IUC",60
39,"39092",1030,753,747,1,6,"IUC",32
39,"39054",4265,3338,3276,57,62,"IUC",127
39,"39060",6723,5453,5360,56,93,"IUC",231
39,"39035",10031,7685,7601,74,84,"IUC",237
39,"39087",43561,33709,33242,404,467,"IUC",1393
39,"39089",163,126,126,0,0,"IUC",1
39,"39071",463,358,358,2,0,"IUC",6
39,"39068",663,488,485,4,3,"IUC",18
39,"39044",3864,2940,2905,44,35,"IUC",103
39,"39006",1732,1381,1373,23,8,"IUC",21
39,"39097",732,476,470,4,6,"IUC",0
39,"39065",272,199,197,2,2,"IUC",3
39,"39004",1593,1321,1305,9,16,"IUC",31
39,"39030",1971,1397,1379,20,18,"IUC",54
39,"39039",648,496,493,0,3,"IUC",2
39,"39028",3513,2760,2718,23,42,"IUC",104
39,"39020",23947,15404,15122,267,282,"IUC",897
39,"39063",1018,769,762,6,7,"IUC",9
39,"39051",73,62,62,2,0,"IUC",7
39,"39082",1688,1280,1266,9,14,"IUC",12
39,"39016",24213,18549,18362,265,187,"IUC",762
39,"39102",2330,1748,1731,13,17,"IUC",37
39,"39042",5928,4680,4634,44,46,"IUC",103
39,"39002",3400,2554,2514,35,40,"IUC",62
39,"39050",305,207,205,1,2,"IUC",7
39,"39076",3388,2673,2641,22,32,"IUC",72
39,"39026",1825,1383,1371,12,12,"IUC",23
39,"39080",3627,2743,2693,19,50,"IUC",60
39,"39019",2009,1556,1536,10,20,"IUC",57
19,"19265",157,102,101,0,1,"IUCLM-LV",3
16,"16175",5058,4363,4295,70,68,"IUCLM-LV",117
19,"19178",45,34,34,0,0,"IUCLM-LV",6
16,"16238",560,484,479,3,5,"IUCLM-LV",8
19,"19156",1032,782,762,4,20,"IUCLM-LV",26
16,"16002",195,175,172,0,3,"IUCLM-LV",1
19,"19255",95,68,68,0,0,"IUCLM-LV",1
19,"19215",206,170,166,0,4,"IUCLM-LV",2
19,"19130",58473,45114,44362,688,752,"IUCLM-LV",3080
19,"19037",153,128,128,0,0,"IUCLM-LV",2
16,"16216",358,300,296,2,4,"IUCLM-LV",17
16,"16032",304,253,244,2,9,"IUCLM-LV",5
13,"13002",1576,1143,1134,4,9,"IUCLM-LV",10
19,"19138",298,223,219,3,4,"IUCLM-LV",17
19,"19307",30,27,27,0,0,"IUCLM-LV",1
13,"13078",9291,7062,6993,92,69,"IUCLM-LV",220
13,"13032",1218,926,922,9,4,"IUCLM-LV",41
16,"16041",395,289,287,6,2,"IUCLM-LV",17
19,"19148",56,41,38,1,3,"IUCLM-LV",1
19,"19011",286,219,218,3,1,"IUCLM-LV",6
16,"16115",60,45,45,0,0,"IUCLM-LV",0
19,"19096",99,79,78,1,1,"IUCLM-LV",3
16,"16048",432,339,337,8,2,"IUCLM-LV",9
2,"2032",323,261,259,1,2,"IUCLM-LV",39
16,"16228",202,146,144,2,2,"IUCLM-LV",1
19,"19125",54,42,42,2,0,"IUCLM-LV",2
16,"16106",2839,2351,2331,10,20,"IUCLM-LV",98
2,"2074",6093,4630,4548,57,82,"IUCLM-LV",170
19,"19090",107,87,86,0,1,"IUCLM-LV",10
13,"13010",910,729,726,8,3,"IUCLM-LV",17
13,"13098",2265,1805,1759,19,46,"IUCLM-LV",44
19,"19112",68,50,50,0,0,"IUCLM-LV",1
19,"19202",16,14,14,0,0,"IUCLM-LV",1
16,"16017",406,337,334,1,3,"IUCLM-LV",17
16,"16078",40954,30382,29933,568,449,"IUCLM-LV",1671
16,"16100",764,660,655,3,5,"IUCLM-LV",22
13,"13082",25643,17973,17798,257,175,"IUCLM-LV",901
19,"19089",33,22,22,1,0,"IUCLM-LV",0
16,"16171",1930,1616,1584,25,32,"IUCLM-LV",41
19,"19005",92,80,79,0,1,"IUCLM-LV",9
16,"16125",1734,1367,1350,12,17,"IUCLM-LV",36
16,"16111",171,130,128,0,2,"IUCLM-LV",12
16,"16149",179,140,138,2,2,"IUCLM-LV",24
16,"16264",505,440,438,6,2,"IUCLM-LV",8
16,"16088",125,103,103,1,0,"IUCLM-LV",6
16,"16009",79,63,62,0,1,"IUCLM-LV",4
19,"19152",674,505,498,2,7,"IUCLM-LV",22
16,"16101",160,142,142,0,0,"IUCLM-LV",4
2,"2077",51,46,45,0,1,"IUCLM-LV",5
13,"13028",10536,8503,8331,140,172,"IUCLM-LV",317
16,"16219",106,83,82,0,1,"IUCLM-LV",3
13,"13090",1202,994,972,4,22,"IUCLM-LV",21
19,"19040",73,42,42,1,0,"IUCLM-LV",1
2,"2017",895,685,682,4,3,"IUCLM-LV",18
13,"13043",251,208,206,1,2,"IUCLM-LV",0
19,"19251",41,35,34,0,1,"IUCLM-LV",2
19,"19203",35,27,27,0,0,"IUCLM-LV",1
19,"19306",42,31,31,1,0,"IUCLM-LV",1
16,"16181",73,62,62,1,0,"IUCLM-LV",1
19,"19099",337,211,210,6,1,"IUCLM-LV",16
2,"2033",1955,1565,1536,15,29,"IUCLM-LV",46
2,"2044",1207,908,893,5,15,"IUCLM-LV",39
19,"19232",89,68,67,0,1,"IUCLM-LV",0
19,"19020",52,39,39,3,0,"IUCLM-LV",2
19,"19073",24,20,19,0,1,"IUCLM-LV",0
13,"13027",3582,2770,2715,25,55,"IUCLM-LV",70
19,"19081",43,33,33,0,0,"IUCLM-LV",2
19,"19044",319,248,245,0,3,"IUCLM-LV",8
16,"16903",1097,855,828,9,27,"IUCLM-LV",22
19,"19050",21,19,19,0,0,"IUCLM-LV",2
13,"13083",2529,1837,1795,26,42,"IUCLM-LV",70
16,"16904",508,413,407,10,6,"IUCLM-LV",20
2,"2072",1598,1220,1198,5,22,"IUCLM-LV",83
16,"16133",4466,3522,3453,51,69,"IUCLM-LV",494
16,"16068",143,117,116,6,1,"IUCLM-LV",3
19,"19017",87,70,70,0,0,"IUCLM-LV",6
16,"16231",47,43,43,0,0,"IUCLM-LV",3
2,"2081",18319,14324,14096,225,228,"IUCLM-LV",737
19,"19322",35,28,27,1,1,"IUCLM-LV",0
19,"19226",40,31,30,0,1,"IUCLM-LV",1
16,"16271",659,568,566,4,2,"IUCLM-LV",28
16,"16198",1451,1126,1105,21,21,"IUCLM-LV",46
13,"13067",380,314,312,3,2,"IUCLM-LV",22
2,"2008",1332,985,966,12,19,"IUCLM-LV",48
2,"2084",362,276,270,2,6,"IUCLM-LV",4
13,"13031",2384,1908,1874,23,34,"IUCLM-LV",59
16,"16040",97,76,75,1,1,"IUCLM-LV",3
19,"19240",64,47,46,1,1,"IUCLM-LV",1
2,"2060",1232,974,964,10,10,"IUCLM-LV",26
19,"19134",22,14,14,0,0,"IUCLM-LV",3
19,"19218",60,35,35,0,0,"IUCLM-LV",1
16,"16135",192,127,125,0,2,"IUCLM-LV",4
19,"19036",279,238,236,1,2,"IUCLM-LV",9
16,"16275",15,12,12,0,0,"IUCLM-LV",0
2,"2058",390,290,285,0,5,"IUCLM-LV",15
19,"19223",129,94,90,1,4,"IUCLM-LV",2
19,"19200",150,105,105,1,0,"IUCLM-LV",6
2,"2061",715,570,565,4,5,"IUCLM-LV",12
19,"19001",64,56,56,1,0,"IUCLM-LV",1
16,"16129",112,79,74,0,5,"IUCLM-LV",1
2,"2001",731,601,584,6,17,"IUCLM-LV",14
19,"19326",1125,800,786,10,14,"IUCLM-LV",46
16,"16211",462,317,313,2,4,"IUCLM-LV",13
16,"16265",27,26,26,0,0,"IUCLM-LV",0
16,"16143",20,14,13,1,1,"IUCLM-LV",1
13,"13012",475,322,318,1,4,"IUCLM-LV",11
16,"16255",159,123,122,3,1,"IUCLM-LV",3
16,"16027",779,619,612,5,7,"IUCLM-LV",32
13,"13038",1770,1397,1380,8,17,"IUCLM-LV",89
19,"19076",36,29,29,0,0,"IUCLM-LV",1
16,"16051",166,140,140,1,0,"IUCLM-LV",3
16,"16274",147,125,125,1,0,"IUCLM-LV",1
16,"16010",184,135,133,1,2,"IUCLM-LV",0
2,"2056",1816,1518,1506,15,12,"IUCLM-LV",37
19,"19167",136,112,109,4,3,"IUCLM-LV",3
13,"13096",7716,5759,5659,70,100,"IUCLM-LV",163
16,"16052",596,469,464,2,5,"IUCLM-LV",26
2,"2070",439,372,366,4,6,"IUCLM-LV",12
2,"2014",390,333,326,5,7,"IUCLM-LV",51
13,"13902",497,396,394,3,2,"IUCLM-LV",30
19,"19329",62,52,50,0,2,"IUCLM-LV",1
16,"16215",285,192,186,2,6,"IUCLM-LV",11
13,"13049",838,654,648,0,6,"IUCLM-LV",10
2,"2028",139,115,115,1,0,"IUCLM-LV",8
2,"2052",493,417,412,9,5,"IUCLM-LV",18
19,"19212",795,644,632,2,12,"IUCLM-LV",21
19,"19168",324,233,231,6,2,"IUCLM-LV",10
19,"19139",32,23,23,0,0,"IUCLM-LV",1
19,"19008",34,25,25,1,0,"IUCLM-LV",7
19,"19043",92,82,82,1,0,"IUCLM-LV",4
19,"19901",43,34,34,0,0,"IUCLM-LV",2
16,"16192",54,37,37,1,0,"IUCLM-LV",1
19,"19261",42,31,31,1,0,"IUCLM-LV",1
13,"13068",1058,801,793,4,8,"IUCLM-LV",20
16,"16014",659,534,528,8,6,"IUCLM-LV",33
19,"19129",48,33,31,0,2,"IUCLM-LV",0
16,"16096",279,231,229,7,2,"IUCLM-LV",9
19,"19272",86,67,65,1,2,"IUCLM-LV",1
13,"13075",212,161,159,1,2,"IUCLM-LV",2
13,"13070",769,653,640,1,13,"IUCLM-LV",20
13,"13030",153,123,123,1,0,"IUCLM-LV",2
16,"16148",634,553,547,5,6,"IUCLM-LV",5
19,"19296",43,31,30,1,1,"IUCLM-LV",0
19,"19219",18,12,12,0,0,"IUCLM-LV",0
19,"19230",438,317,309,4,8,"IUCLM-LV",31
16,"16234",52,38,36,0,2,"IUCLM-LV",5
16,"16188",106,76,76,0,0,"IUCLM-LV",3
2,"2045",3763,3086,3035,42,51,"IUCLM-LV",785
16,"16185",63,45,44,0,1,"IUCLM-LV",1
2,"2049",937,717,708,2,9,"IUCLM-LV",18
2,"2064",413,350,348,7,2,"IUCLM-LV",6
16,"16039",466,330,326,1,4,"IUCLM-LV",11
16,"16005",275,215,215,2,0,"IUCLM-LV",12
2,"2085",345,288,284,2,4,"IUCLM-LV",3
13,"13064",1465,1127,1110,21,17,"IUCLM-LV",55
19,"19175",39,31,31,0,0,"IUCLM-LV",1
16,"16044",51,35,35,0,0,"IUCLM-LV",2
16,"16170",733,552,543,3,9,"IUCLM-LV",17
19,"19258",103,81,81,0,0,"IUCLM-LV",5
16,"16245",430,338,329,2,9,"IUCLM-LV",13
16,"16035",287,216,213,2,3,"IUCLM-LV",9
2,"2065",517,450,449,4,1,"IUCLM-LV",10
16,"16072",161,126,123,0,3,"IUCLM-LV",0
16,"16203",9839,7520,7342,101,178,"IUCLM-LV",369
16,"16140",34,27,27,0,0,"IUCLM-LV",0
13,"13066",2444,2094,2065,15,29,"IUCLM-LV",44
19,"19038",48,33,33,0,0,"IUCLM-LV",1
19,"19259",37,32,32,0,0,"IUCLM-LV",6
19,"19117",1526,1155,1132,26,23,"IUCLM-LV",95
19,"19078",58,49,48,0,1,"IUCLM-LV",0
16,"16053",414,334,326,2,8,"IUCLM-LV",35
16,"16280",205,177,175,1,2,"IUCLM-LV",2
19,"19087",22,16,16,0,0,"IUCLM-LV",3
19,"19124",420,293,291,3,2,"IUCLM-LV",19
2,"2025",7496,6153,5985,69,168,"IUCLM-LV",289
19,"19268",34,26,25,0,1,"IUCLM-LV",1
13,"13056",10945,8173,8070,111,103,"IUCLM-LV",666
2,"2036",104,78,78,0,0,"IUCLM-LV",2
2,"2037",22380,15942,15724,203,218,"IUCLM-LV",878
19,"19239",99,74,73,1,1,"IUCLM-LV",1
19,"19249",38,32,32,0,0,"IUCLM-LV",0
19,"19111",180,147,146,0,1,"IUCLM-LV",0
2,"2011",730,612,610,3,2,"IUCLM-LV",6
19,"19114",40,34,34,0,0,"IUCLM-LV",0
19,"19163",73,59,59,0,0,"IUCLM-LV",8
19,"19213",72,60,60,1,0,"IUCLM-LV",1
19,"19046",20318,15118,14892,219,226,"IUCLM-LV",1225
2,"2053",3053,2550,2517,33,33,"IUCLM-LV",199
19,"19015",104,88,87,0,1,"IUCLM-LV",1
16,"16156",122,91,91,0,0,"IUCLM-LV",2
13,"13053",14718,10958,10766,159,192,"IUCLM-LV",563
13,"13089",1906,1610,1553,12,57,"IUCLM-LV",36
16,"16031",62,34,32,4,2,"IUCLM-LV",0
16,"16250",94,71,71,0,0,"IUCLM-LV",8
19,"19334",50,37,37,0,0,"IUCLM-LV",4
13,"13009",1573,1265,1255,6,10,"IUCLM-LV",15
2,"2073",4924,3923,3847,76,76,"IUCLM-LV",444
2,"2069",11624,9091,8907,119,184,"IUCLM-LV",529
16,"16278",91,69,69,2,0,"IUCLM-LV",1
19,"19041",166,127,127,3,0,"IUCLM-LV",12
19,"19108",117,97,95,0,2,"IUCLM-LV",14
16,"16057",109,82,82,1,0,"IUCLM-LV",1
19,"19126",1552,1140,1119,16,21,"IUCLM-LV",80
16,"16242",367,315,313,4,2,"IUCLM-LV",5
13,"13001",1372,1087,1067,8,20,"IUCLM-LV",25
13,"13040",933,755,744,4,11,"IUCLM-LV",42
19,"19319",4203,3139,3104,28,35,"IUCLM-LV",257
16,"16165",84,70,70,0,0,"IUCLM-LV",2
13,"13092",1924,1655,1635,4,20,"IUCLM-LV",27
16,"16119",181,130,130,0,0,"IUCLM-LV",9
19,"19095",14,9,8,0,1,"IUCLM-LV",0
19,"19002",99,77,76,0,1,"IUCLM-LV",1
19,"19332",106,76,72,4,4,"IUCLM-LV",6
19,"19104",16,12,12,1,0,"IUCLM-LV",0
2,"2034",1419,1153,1146,18,7,"IUCLM-LV",78
16,"16174",209,170,167,0,3,"IUCLM-LV",7
19,"19147",58,45,40,0,5,"IUCLM-LV",5
19,"19032",202,11,11,0,0,"IUCLM-LV",1
19,"19006",873,634,620,1,14,"IUCLM-LV",22
19,"19300",746,595,585,3,10,"IUCLM-LV",49
19,"19057",79,56,56,0,0,"IUCLM-LV",7
16,"16270",192,156,155,0,1,"IUCLM-LV",2
16,"16023",468,332,327,3,5,"IUCLM-LV",16
19,"19051",94,83,83,1,0,"IUCLM-LV",0
2,"2048",1320,1076,1061,11,15,"IUCLM-LV",26
19,"19197",29,19,19,0,0,"IUCLM-LV",6
19,"19067",91,59,59,0,0,"IUCLM-LV",6
19,"19247",171,125,118,6,7,"IUCLM-LV",9
2,"2086",2856,2019,2005,9,14,"IUCLM-LV",60
19,"19228",39,30,29,0,1,"IUCLM-LV",2
16,"16162",51,36,36,0,0,"IUCLM-LV",0
16,"16906",104,83,82,0,1,"IUCLM-LV",2
19,"19107",349,289,288,1,1,"IUCLM-LV",5
19,"19064",97,84,83,1,1,"IUCLM-LV",1
16,"16258",288,215,213,1,2,"IUCLM-LV",4
16,"16019",252,210,207,2,3,"IUCLM-LV",1
16,"16128",70,64,64,2,0,"IUCLM-LV",0
16,"16166",277,210,202,0,8,"IUCLM-LV",5
19,"19198",22,19,19,0,0,"IUCLM-LV",0
13,"13055",738,585,578,8,7,"IUCLM-LV",31
19,"19115",41,26,26,1,0,"IUCLM-LV",1
16,"16218",207,170,169,4,1,"IUCLM-LV",3
16,"16042",1286,1101,1089,8,12,"IUCLM-LV",38
2,"2901",2223,1678,1667,19,11,"IUCLM-LV",52
19,"19192",1743,1370,1359,10,11,"IUCLM-LV",34
19,"19282",210,157,157,0,0,"IUCLM-LV",5
19,"19022",673,501,496,4,5,"IUCLM-LV",19
19,"19327",551,459,449,3,10,"IUCLM-LV",4
19,"19221",56,41,41,2,0,"IUCLM-LV",0
19,"19277",22,17,17,0,0,"IUCLM-LV",1
16,"16062",30,27,27,0,0,"IUCLM-LV",8
13,"13061",5898,4442,4373,56,69,"IUCLM-LV",227
16,"16097",196,167,166,2,1,"IUCLM-LV",8
13,"13901",945,734,719,6,15,"IUCLM-LV",18
19,"19195",41,30,30,1,0,"IUCLM-LV",1
13,"13008",473,362,360,4,2,"IUCLM-LV",9
13,"13020",4805,3475,3434,40,41,"IUCLM-LV",210
2,"2041",399,311,304,1,7,"IUCLM-LV",4
19,"19174",126,88,86,0,2,"IUCLM-LV",8
13,"13045",744,615,608,6,7,"IUCLM-LV",20
13,"13042",953,704,693,5,11,"IUCLM-LV",31
13,"13074",1000,886,878,15,8,"IUCLM-LV",78
19,"19325",127,105,102,4,3,"IUCLM-LV",6
19,"19288",22,21,21,0,0,"IUCLM-LV",2
13,"13093",4333,3281,3229,43,52,"IUCLM-LV",149
19,"19153",25,17,17,0,0,"IUCLM-LV",4
2,"2016",600,471,468,5,3,"IUCLM-LV",23
19,"19262",184,137,136,0,1,"IUCLM-LV",3
16,"16094",142,112,111,1,1,"IUCLM-LV",4
16,"16121",270,211,207,1,4,"IUCLM-LV",13
19,"19220",2225,1482,1456,7,26,"IUCLM-LV",150
2,"2013",158,123,121,1,2,"IUCLM-LV",0
16,"16176",61,45,43,0,2,"IUCLM-LV",0
2,"2018",922,759,754,7,5,"IUCLM-LV",29
19,"19274",881,652,644,8,8,"IUCLM-LV",52
19,"19283",40,33,33,0,0,"IUCLM-LV",0
16,"16173",249,189,188,0,1,"IUCLM-LV",6
19,"19061",76,57,55,3,2,"IUCLM-LV",3
19,"19291",1271,925,902,3,23,"IUCLM-LV",50
19,"19196",99,80,74,2,6,"IUCLM-LV",5
19,"19181",69,54,54,5,0,"IUCLM-LV",0
19,"19317",150,122,121,2,1,"IUCLM-LV",5
19,"19160",944,600,593,6,7,"IUCLM-LV",47
13,"13088",649,531,526,3,5,"IUCLM-LV",19
19,"19007",460,351,345,5,6,"IUCLM-LV",11
16,"16003",147,122,121,0,1,"IUCLM-LV",5
19,"19280",3415,2521,2490,27,31,"IUCLM-LV",231
16,"16020",20,15,15,0,0,"IUCLM-LV",0
19,"19321",46,29,29,0,0,"IUCLM-LV",2
19,"19113",519,396,395,4,1,"IUCLM-LV",22
16,"16123",110,74,73,1,1,"IUCLM-LV",8
19,"19155",61,52,50,1,2,"IUCLM-LV",3
16,"16118",1454,1221,1211,19,10,"IUCLM-LV",55
16,"16132",36,31,31,0,0,"IUCLM-LV",0
16,"16109",46,34,34,2,0,"IUCLM-LV",0
19,"19225",879,625,618,9,7,"IUCLM-LV",36
19,"19182",38,24,22,0,2,"IUCLM-LV",3
16,"16008",131,89,88,2,1,"IUCLM-LV",3
13,"13023",8731,6818,6732,94,86,"IUCLM-LV",171
16,"16153",1006,856,843,8,13,"IUCLM-LV",38
16,"16026",104,79,79,1,0,"IUCLM-LV",2
16,"16067",135,97,97,2,0,"IUCLM-LV",4
16,"16152",42,38,37,3,1,"IUCLM-LV",2
16,"16246",520,417,407,1,10,"IUCLM-LV",4
19,"19309",37,32,31,0,1,"IUCLM-LV",3
13,"13016",708,555,553,2,2,"IUCLM-LV",19
16,"16194",298,238,238,1,0,"IUCLM-LV",10
13,"13094",338,276,275,2,1,"IUCLM-LV",9
16,"16154",4946,3975,3914,58,61,"IUCLM-LV",215
19,"19244",95,82,82,6,0,"IUCLM-LV",2
19,"19279",66,56,56,0,0,"IUCLM-LV",2
13,"13050",533,427,421,3,6,"IUCLM-LV",5
19,"19331",2497,1898,1847,19,51,"IUCLM-LV",105
13,"13039",14349,10928,10776,149,152,"IUCLM-LV",729
13,"13047",5822,4735,4650,52,85,"IUCLM-LV",240
19,"19027",185,140,138,1,2,"IUCLM-LV",16
16,"16050",298,245,238,0,7,"IUCLM-LV",6
19,"19199",24,21,21,0,0,"IUCLM-LV",1
2,"2027",347,301,301,2,0,"IUCLM-LV",5
16,"16070",35,29,29,0,0,"IUCLM-LV",0
19,"19098",22,18,18,0,0,"IUCLM-LV",0
13,"13033",1719,1436,1419,6,17,"IUCLM-LV",50
19,"19257",3595,2593,2543,48,50,"IUCLM-LV",123
2,"2015",1508,1230,1211,7,19,"IUCLM-LV",95
19,"19214",94,78,78,2,0,"IUCLM-LV",2
19,"19004",67,56,56,0,0,"IUCLM-LV",1
13,"13026",482,387,384,1,3,"IUCLM-LV",68
19,"19127",97,66,66,1,0,"IUCLM-LV",0
16,"16083",58,30,30,1,0,"IUCLM-LV",0
19,"19042",41,32,32,0,0,"IUCLM-LV",4
19,"19184",88,63,62,1,1,"IUCLM-LV",5
19,"19185",40,21,19,0,2,"IUCLM-LV",2
19,"19053",2172,1602,1587,14,15,"IUCLM-LV",126
13,"13085",2455,2146,2118,21,28,"IUCLM-LV",63
13,"13034",56981,42819,42306,742,513,"IUCLM-LV",2490
19,"19162",71,52,51,0,1,"IUCLM-LV",5
16,"16092",158,132,132,0,0,"IUCLM-LV",2
16,"16213",39,32,32,1,0,"IUCLM-LV",1
2,"2040",631,569,566,3,3,"IUCLM-LV",11
16,"16197",73,50,50,1,0,"IUCLM-LV",3
2,"2004",654,554,544,7,10,"IUCLM-LV",15
16,"16110",98,81,81,3,0,"IUCLM-LV",0
13,"13086",209,167,166,0,1,"IUCLM-LV",3
16,"16001",79,66,66,1,0,"IUCLM-LV",0
19,"19143",1610,1287,1268,9,19,"IUCLM-LV",78
16,"16013",24,23,23,0,0,"IUCLM-LV",1
13,"13097",2309,1843,1825,20,18,"IUCLM-LV",51
16,"16081",64,46,45,1,1,"IUCLM-LV",3
13,"13072",803,638,633,13,5,"IUCLM-LV",13
16,"16134",4283,3398,3361,59,37,"IUCLM-LV",295
19,"19013",143,110,108,1,2,"IUCLM-LV",8
16,"16046",262,191,191,1,0,"IUCLM-LV",2
19,"19091",30,22,22,2,0,"IUCLM-LV",0
19,"19146",51,40,38,0,2,"IUCLM-LV",5
19,"19308",67,61,61,0,0,"IUCLM-LV",4
19,"19048",18,12,11,1,1,"IUCLM-LV",0
19,"19135",120,102,100,2,2,"IUCLM-LV",1
19,"19201",70,52,52,2,0,"IUCLM-LV",2
16,"16113",3075,2363,2338,36,25,"IUCLM-LV",103
19,"19157",66,56,56,4,0,"IUCLM-LV",2
13,"13062",595,490,480,4,10,"IUCLM-LV",24
13,"13022",403,314,314,2,0,"IUCLM-LV",8
19,"19224",119,95,94,0,1,"IUCLM-LV",3
2,"2059",336,262,258,3,4,"IUCLM-LV",5
16,"16112",1562,1159,1140,12,19,"IUCLM-LV",25
19,"19109",53,40,40,1,0,"IUCLM-LV",1
16,"16095",98,68,68,0,0,"IUCLM-LV",4
19,"19191",19,15,15,0,0,"IUCLM-LV",1
16,"16169",75,44,44,0,0,"IUCLM-LV",5
2,"2080",580,450,443,4,7,"IUCLM-LV",16
13,"13063",3839,2801,2771,31,30,"IUCLM-LV",126
13,"13052",6580,4869,4786,76,83,"IUCLM-LV",137
13,"13004",1130,937,923,6,14,"IUCLM-LV",27
19,"19281",25,24,22,3,2,"IUCLM-LV",1
16,"16193",77,68,67,0,1,"IUCLM-LV",2
13,"13073",565,459,456,2,3,"IUCLM-LV",17
16,"16902",165,128,126,1,2,"IUCLM-LV",6
19,"19171",4352,3299,3221,35,78,"IUCLM-LV",221
13,"13011",5166,3555,3500,31,55,"IUCLM-LV",227
19,"19133",103,89,88,2,1,"IUCLM-LV",5
19,"19193",30,29,29,1,0,"IUCLM-LV",0
16,"16202",908,753,744,10,9,"IUCLM-LV",32
16,"16251",1903,1510,1493,18,17,"IUCLM-LV",48
19,"19080",90,64,64,0,0,"IUCLM-LV",1
19,"19310",13,9,8,0,1,"IUCLM-LV",0
16,"16279",251,175,172,1,3,"IUCLM-LV",4
13,"13005",23052,18002,17700,255,302,"IUCLM-LV",1106
16,"16161",84,73,72,4,1,"IUCLM-LV",3
19,"19210",34,29,29,1,0,"IUCLM-LV",0
2,"2079",2936,2305,2235,29,70,"IUCLM-LV",482
2,"2046",1165,954,941,16,13,"IUCLM-LV",60
16,"16036",143,117,115,1,2,"IUCLM-LV",6
19,"19311",87,60,60,0,0,"IUCLM-LV",1
16,"16272",273,215,215,2,0,"IUCLM-LV",7
19,"19059",84,60,60,0,0,"IUCLM-LV",2
16,"16247",87,65,62,1,3,"IUCLM-LV",2
16,"16122",259,195,190,2,5,"IUCLM-LV",4
16,"16910",104,69,69,1,0,"IUCLM-LV",7
2,"2075",1689,1386,1372,10,14,"IUCLM-LV",56
19,"19246",48,38,38,1,0,"IUCLM-LV",0
13,"13077",3654,2535,2480,31,55,"IUCLM-LV",86
16,"16901",793,590,582,2,8,"IUCLM-LV",32
2,"2063",1537,1252,1242,11,10,"IUCLM-LV",38
16,"16254",213,166,165,2,1,"IUCLM-LV",3
19,"19120",107,95,95,1,0,"IUCLM-LV",6
13,"13058",4155,3320,3285,24,35,"IUCLM-LV",134
19,"19071",7346,5380,5294,76,86,"IUCLM-LV",339
13,"13059",232,186,184,0,2,"IUCLM-LV",7
19,"19151",1126,849,830,3,19,"IUCLM-LV",53
16,"16195",545,436,433,6,3,"IUCLM-LV",6
19,"19173",52,42,42,3,0,"IUCLM-LV",2
16,"16117",1130,871,857,8,14,"IUCLM-LV",44
19,"19264",45,39,39,0,0,"IUCLM-LV",2
16,"16263",936,730,719,8,11,"IUCLM-LV",33
16,"16139",346,279,277,2,2,"IUCLM-LV",6
16,"16087",229,193,187,4,6,"IUCLM-LV",1
19,"19121",277,219,217,0,2,"IUCLM-LV",8
19,"19254",57,50,50,0,0,"IUCLM-LV",1
19,"19033",79,55,55,0,0,"IUCLM-LV",5
16,"16190",5151,4229,4144,52,85,"IUCLM-LV",137
16,"16131",154,116,115,0,1,"IUCLM-LV",3
19,"19105",2235,1709,1686,23,23,"IUCLM-LV",131
2,"2024",3424,2765,2726,32,39,"IUCLM-LV",192
19,"19118",17,13,13,0,0,"IUCLM-LV",1
19,"19066",78,63,62,0,1,"IUCLM-LV",6
19,"19222",120,90,89,3,1,"IUCLM-LV",2
16,"16084",49,36,35,0,1,"IUCLM-LV",1
19,"19024",7736,5738,5646,82,92,"IUCLM-LV",446
16,"16209",153,129,129,0,0,"IUCLM-LV",5
19,"19165",51,43,42,0,1,"IUCLM-LV",4
19,"19293",1860,1407,1373,16,34,"IUCLM-LV",127
16,"16082",318,226,226,1,0,"IUCLM-LV",10
13,"13041",298,225,225,1,0,"IUCLM-LV",10
16,"16104",65,52,52,1,0,"IUCLM-LV",2
19,"19335",77,61,61,1,0,"IUCLM-LV",0
16,"16204",306,235,235,5,0,"IUCLM-LV",11
16,"16909",737,590,585,9,5,"IUCLM-LV",25
13,"13095",94,70,70,1,0,"IUCLM-LV",2
16,"16151",66,56,56,0,0,"IUCLM-LV",0
19,"19287",153,114,113,2,1,"IUCLM-LV",2
19,"19154",79,68,67,0,1,"IUCLM-LV",0
2,"2076",371,292,287,3,5,"IUCLM-LV",10
19,"19052",37,32,31,1,1,"IUCLM-LV",2
16,"16212",286,229,226,3,3,"IUCLM-LV",10
16,"16071",25,23,23,0,0,"IUCLM-LV",0
16,"16049",158,129,129,1,0,"IUCLM-LV",2
16,"16093",80,57,57,0,0,"IUCLM-LV",1
16,"16060",841,714,704,11,10,"IUCLM-LV",17
19,"19016",74,50,49,0,1,"IUCLM-LV",0
16,"16126",811,701,692,13,9,"IUCLM-LV",47
19,"19188",72,48,48,1,0,"IUCLM-LV",0
16,"16012",102,81,80,0,1,"IUCLM-LV",3
2,"2055",1267,900,884,6,16,"IUCLM-LV",31
13,"13019",5254,4038,3978,62,60,"IUCLM-LV",1035
2,"2068",379,290,284,3,6,"IUCLM-LV",12
16,"16227",128,95,94,0,1,"IUCLM-LV",2
13,"13037",901,752,745,2,7,"IUCLM-LV",11
13,"13060",291,235,229,0,6,"IUCLM-LV",26
19,"19256",48,44,43,0,1,"IUCLM-LV",0
16,"16187",78,61,60,3,1,"IUCLM-LV",2
2,"2035",1988,1601,1586,19,15,"IUCLM-LV",63
19,"19145",64,49,48,2,1,"IUCLM-LV",1
2,"2009",19661,14804,14570,259,234,"IUCLM-LV",841
19,"19189",136,99,97,0,2,"IUCLM-LV",5
16,"16191",1001,867,864,13,3,"IUCLM-LV",23
19,"19278",30,28,28,0,0,"IUCLM-LV",0
16,"16124",1909,1573,1555,14,18,"IUCLM-LV",161
16,"16248",887,733,710,20,23,"IUCLM-LV",31
16,"16063",97,81,81,0,0,"IUCLM-LV",1
19,"19285",26,20,20,2,0,"IUCLM-LV",0
19,"19110",73,59,57,4,2,"IUCLM-LV",3
13,"13080",418,310,309,1,1,"IUCLM-LV",9
19,"19297",34,29,29,0,0,"IUCLM-LV",1
19,"19209",50,40,39,0,1,"IUCLM-LV",1
16,"16043",105,86,86,1,0,"IUCLM-LV",8
19,"19190",2499,1829,1785,32,44,"IUCLM-LV",145
19,"19241",45,37,37,2,0,"IUCLM-LV",0
16,"16034",207,174,173,0,1,"IUCLM-LV",4
19,"19238",42,32,31,1,1,"IUCLM-LV",2
13,"13029",102,90,89,0,1,"IUCLM-LV",2
16,"16022",102,76,76,2,0,"IUCLM-LV",8
19,"19142",259,191,190,0,1,"IUCLM-LV",20
16,"16239",158,114,112,2,2,"IUCLM-LV",4
19,"19303",56,48,47,1,1,"IUCLM-LV",1
19,"19047",87,71,70,2,1,"IUCLM-LV",16
19,"19166",179,123,121,4,2,"IUCLM-LV",8
16,"16177",86,68,68,0,0,"IUCLM-LV",3
2,"2066",258,219,217,2,2,"IUCLM-LV",8
16,"16145",508,421,417,6,4,"IUCLM-LV",12
2,"2019",2455,2107,2077,16,30,"IUCLM-LV",104
19,"19243",53,39,39,0,0,"IUCLM-LV",2
19,"19039",73,57,57,0,0,"IUCLM-LV",4
16,"16236",964,762,758,10,4,"IUCLM-LV",25
19,"19031",18,11,11,0,0,"IUCLM-LV",1
16,"16237",116,98,98,3,0,"IUCLM-LV",2
13,"13048",538,441,433,5,8,"IUCLM-LV",55
13,"13903",564,461,454,2,7,"IUCLM-LV",7
16,"16011",39,30,30,0,0,"IUCLM-LV",2
2,"2057",2138,1736,1712,30,24,"IUCLM-LV",206
13,"13035",1043,794,770,10,24,"IUCLM-LV",34
16,"16253",340,256,256,4,0,"IUCLM-LV",5
19,"19023",121,95,94,5,1,"IUCLM-LV",6
19,"19227",95,64,63,1,1,"IUCLM-LV",7
19,"19150",128,112,108,0,4,"IUCLM-LV",6
13,"13017",307,230,226,0,4,"IUCLM-LV",3
2,"2012",1834,1632,1622,12,10,"IUCLM-LV",86
19,"19003",50,36,35,1,1,"IUCLM-LV",3
19,"19252",90,80,78,0,2,"IUCLM-LV",2
13,"13006",641,529,519,4,10,"IUCLM-LV",0
19,"19106",95,68,66,0,2,"IUCLM-LV",4
19,"19060",165,127,121,3,6,"IUCLM-LV",20
19,"19045",180,145,145,1,0,"IUCLM-LV",1
16,"16273",328,277,275,2,2,"IUCLM-LV",4
19,"19172",76,65,64,1,1,"IUCLM-LV",1
19,"19058",6455,5028,4933,63,95,"IUCLM-LV",388
16,"16244",735,615,606,3,9,"IUCLM-LV",22
19,"19092",437,331,326,4,5,"IUCLM-LV",13
19,"19263",34,27,27,0,0,"IUCLM-LV",0
16,"16172",413,330,318,1,12,"IUCLM-LV",2
13,"13014",565,457,452,3,5,"IUCLM-LV",21
16,"16249",2076,1728,1700,11,28,"IUCLM-LV",50
16,"16038",50,40,40,0,0,"IUCLM-LV",1
19,"19299",94,75,75,0,0,"IUCLM-LV",3
16,"16079",33,21,21,0,0,"IUCLM-LV",0
19,"19271",53,45,45,1,0,"IUCLM-LV",0
19,"19183",108,87,86,1,1,"IUCLM-LV",1
16,"16004",325,247,246,0,1,"IUCLM-LV",6
16,"16160",76,54,53,1,1,"IUCLM-LV",0
13,"13003",503,390,387,2,3,"IUCLM-LV",22
2,"2026",845,723,716,5,7,"IUCLM-LV",93
2,"2082",121,107,107,1,0,"IUCLM-LV",7
16,"16137",64,41,40,0,1,"IUCLM-LV",0
16,"16150",120,90,90,0,0,"IUCLM-LV",5
16,"16225",89,69,68,1,1,"IUCLM-LV",4
16,"16259",30,26,26,1,0,"IUCLM-LV",0
19,"19229",83,71,68,0,3,"IUCLM-LV",2
16,"16030",28,24,24,0,0,"IUCLM-LV",0
2,"2021",1114,872,860,7,12,"IUCLM-LV",34
16,"16024",134,92,91,1,1,"IUCLM-LV",9
2,"2029",3210,2512,2481,37,31,"IUCLM-LV",216
13,"13071",41043,28435,28183,370,252,"IUCLM-LV",2189
13,"13007",1319,1069,1051,18,18,"IUCLM-LV",58
16,"16217",113,95,92,0,3,"IUCLM-LV",6
19,"19075",81,53,50,4,3,"IUCLM-LV",0
19,"19216",143,112,105,2,7,"IUCLM-LV",14
16,"16276",32,23,22,1,1,"IUCLM-LV",0
2,"2047",109,94,94,0,0,"IUCLM-LV",0
16,"16142",118,93,93,1,0,"IUCLM-LV",6
13,"13044",2747,1996,1950,20,46,"IUCLM-LV",68
19,"19103",303,247,244,3,3,"IUCLM-LV",7
13,"13084",973,800,793,6,7,"IUCLM-LV",21
13,"13051",358,291,289,5,2,"IUCLM-LV",10
16,"16064",699,588,580,4,8,"IUCLM-LV",16
19,"19250",25,23,22,0,1,"IUCLM-LV",1
16,"16189",263,213,211,2,2,"IUCLM-LV",4
19,"19161",243,171,166,2,5,"IUCLM-LV",11
16,"16158",550,427,423,2,4,"IUCLM-LV",16
2,"2007",1139,923,916,0,7,"IUCLM-LV",38
19,"19304",235,169,166,1,3,"IUCLM-LV",13
16,"16073",214,170,170,2,0,"IUCLM-LV",3
19,"19177",82,67,66,0,1,"IUCLM-LV",2
16,"16196",658,578,568,6,10,"IUCLM-LV",19
16,"16108",68,56,55,0,1,"IUCLM-LV",3
16,"16056",495,377,374,11,3,"IUCLM-LV",5
19,"19211",450,340,334,0,6,"IUCLM-LV",13
19,"19333",142,86,84,0,2,"IUCLM-LV",8
16,"16224",96,69,69,0,0,"IUCLM-LV",14
16,"16065",454,380,374,4,6,"IUCLM-LV",3
16,"16015",407,311,311,4,0,"IUCLM-LV",14
16,"16206",250,188,188,2,0,"IUCLM-LV",3
13,"13054",5032,3901,3824,70,77,"IUCLM-LV",118
19,"19136",22,15,15,0,0,"IUCLM-LV",2
16,"16074",53,42,42,1,0,"IUCLM-LV",1
2,"2023",636,534,533,6,1,"IUCLM-LV",4
16,"16025",31,23,23,0,0,"IUCLM-LV",1
19,"19065",126,100,100,3,0,"IUCLM-LV",11
16,"16159",299,204,202,5,2,"IUCLM-LV",1
16,"16091",86,66,66,1,0,"IUCLM-LV",7
16,"16240",134,100,98,0,2,"IUCLM-LV",5
19,"19159",108,91,88,1,3,"IUCLM-LV",6
19,"19088",98,67,66,0,1,"IUCLM-LV",2
16,"16086",935,814,802,14,12,"IUCLM-LV",25
16,"16130",633,504,492,5,12,"IUCLM-LV",8
19,"19086",1655,1310,1295,10,15,"IUCLM-LV",59
13,"13079",12220,9665,9502,177,163,"IUCLM-LV",636
13,"13024",938,703,699,3,4,"IUCLM-LV",23
19,"19284",11,11,11,0,0,"IUCLM-LV",1
16,"16205",126,94,93,0,1,"IUCLM-LV",5
19,"19294",27,26,26,1,0,"IUCLM-LV",4
19,"19116",16,10,10,0,0,"IUCLM-LV",1
2,"2067",1197,938,924,6,14,"IUCLM-LV",36
19,"19217",85,57,54,2,3,"IUCLM-LV",1
16,"16163",75,57,57,0,0,"IUCLM-LV",1
19,"19187",64,54,54,0,0,"IUCLM-LV",3
19,"19009",253,187,184,0,3,"IUCLM-LV",4
13,"13015",5755,4334,4293,40,41,"IUCLM-LV",189
2,"2078",967,770,756,9,14,"IUCLM-LV",79
16,"16147",78,63,62,1,1,"IUCLM-LV",4
16,"16061",1035,861,848,15,13,"IUCLM-LV",37
16,"16107",161,101,98,1,3,"IUCLM-LV",6
13,"13091",570,484,478,0,6,"IUCLM-LV",9
16,"16066",2402,2064,1997,32,67,"IUCLM-LV",90
19,"19123",40,34,34,0,0,"IUCLM-LV",1
19,"19286",743,566,554,8,12,"IUCLM-LV",45
19,"19267",22,15,15,0,0,"IUCLM-LV",0
19,"19242",112,93,92,1,1,"IUCLM-LV",4
19,"19186",93,77,77,0,0,"IUCLM-LV",2
2,"2003",129078,98135,97009,1430,1126,"IUCLM-LV",6099
19,"19208",55,41,41,1,0,"IUCLM-LV",2
16,"16029",114,80,80,0,0,"IUCLM-LV",2
16,"16243",451,395,388,3,7,"IUCLM-LV",29
2,"2030",3180,2499,2456,13,43,"IUCLM-LV",103
2,"2043",1335,1120,1108,10,12,"IUCLM-LV",34
13,"13025",321,257,254,1,3,"IUCLM-LV",5
19,"19324",199,151,151,2,0,"IUCLM-LV",4
16,"16116",104,67,66,1,1,"IUCLM-LV",3
19,"19270",17,16,16,0,0,"IUCLM-LV",1
13,"13018",860,740,727,2,13,"IUCLM-LV",11
19,"19318",36,19,19,1,0,"IUCLM-LV",1
2,"2071",1053,899,895,5,4,"IUCLM-LV",21
19,"19132",105,79,79,0,0,"IUCLM-LV",3
19,"19079",7,7,7,0,0,"IUCLM-LV",0
16,"16045",226,177,176,2,1,"IUCLM-LV",4
2,"2031",626,507,502,3,5,"IUCLM-LV",45
19,"19082",91,68,67,1,1,"IUCLM-LV",3
19,"19102",122,101,100,0,1,"IUCLM-LV",5
13,"13057",1214,1018,998,9,20,"IUCLM-LV",22
16,"16103",310,263,259,4,4,"IUCLM-LV",1
16,"16277",128,100,100,3,0,"IUCLM-LV",0
16,"16908",227,181,179,1,2,"IUCLM-LV",16
16,"16146",96,74,70,0,4,"IUCLM-LV",1
13,"13013",7141,5682,5564,60,118,"IUCLM-LV",194
19,"19234",63,48,48,0,0,"IUCLM-LV",2
19,"19010",15,13,13,1,0,"IUCLM-LV",0
19,"19298",75,53,52,2,1,"IUCLM-LV",4
19,"19097",28,27,27,0,0,"IUCLM-LV",0
2,"2020",519,433,430,0,3,"IUCLM-LV",17
19,"19330",93,81,81,2,0,"IUCLM-LV",1
13,"13081",684,553,527,1,26,"IUCLM-LV",13
13,"13069",704,605,590,2,15,"IUCLM-LV",16
19,"19074",81,69,69,0,0,"IUCLM-LV",14
16,"16007",1272,1056,1051,7,5,"IUCLM-LV",13
19,"19204",168,129,126,2,3,"IUCLM-LV",20
16,"16102",1320,1016,1007,15,9,"IUCLM-LV",36
16,"16141",161,132,131,1,1,"IUCLM-LV",6
2,"2039",1050,862,848,16,14,"IUCLM-LV",40
2,"2006",612,540,534,1,6,"IUCLM-LV",17
19,"19231",16,14,14,0,0,"IUCLM-LV",0
19,"19290",872,622,613,7,9,"IUCLM-LV",52
19,"19302",64,60,60,2,0,"IUCLM-LV",0
13,"13065",3011,2105,2088,24,17,"IUCLM-LV",33
16,"16058",120,103,102,1,1,"IUCLM-LV",3
16,"16033",1792,1485,1454,10,31,"IUCLM-LV",121
2,"2054",421,346,343,2,3,"IUCLM-LV",6
19,"19266",278,234,231,4,3,"IUCLM-LV",6
19,"19237",53,40,39,2,1,"IUCLM-LV",1
19,"19260",44,41,41,1,0,"IUCLM-LV",1
2,"2038",296,254,254,1,0,"IUCLM-LV",17
19,"19323",50,41,39,0,2,"IUCLM-LV",5
19,"19248",64,53,53,0,0,"IUCLM-LV",2
16,"16266",402,334,325,4,9,"IUCLM-LV",10
16,"16905",1017,811,806,14,5,"IUCLM-LV",38
16,"16047",249,192,191,5,1,"IUCLM-LV",9
16,"16155",549,430,426,2,4,"IUCLM-LV",13
19,"19194",113,80,76,1,4,"IUCLM-LV",2
19,"19301",47,38,38,0,0,"IUCLM-LV",2
16,"16006",133,117,116,2,1,"IUCLM-LV",3
2,"2051",1729,1318,1303,10,15,"IUCLM-LV",21
2,"2062",456,348,344,2,4,"IUCLM-LV",13
16,"16157",229,187,182,2,5,"IUCLM-LV",9
19,"19122",96,65,65,0,0,"IUCLM-LV",8
13,"13046",786,654,644,2,10,"IUCLM-LV",8
19,"19049",19,11,11,0,0,"IUCLM-LV",0
19,"19021",1129,818,800,10,18,"IUCLM-LV",52
19,"19170",214,139,138,0,1,"IUCLM-LV",7
19,"19305",166,130,130,0,0,"IUCLM-LV",4
13,"13076",514,436,428,0,8,"IUCLM-LV",10
19,"19018",189,145,138,2,7,"IUCLM-LV",1
2,"2042",897,712,709,6,3,"IUCLM-LV",37
13,"13021",459,358,355,5,3,"IUCLM-LV",0
16,"16089",386,310,308,10,2,"IUCLM-LV",10
2,"2083",246,215,215,0,0,"IUCLM-LV",1
16,"16186",521,434,429,2,5,"IUCLM-LV",11
19,"19245",1222,954,943,10,11,"IUCLM-LV",36
16,"16018",417,350,342,3,8,"IUCLM-LV",5
2,"2002",479,411,407,3,4,"IUCLM-LV",7
13,"13036",837,671,666,3,5,"IUCLM-LV",19
13,"13904",556,448,441,14,7,"IUCLM-LV",33
19,"19055",54,41,37,1,4,"IUCLM-LV",3
19,"19289",33,28,28,1,0,"IUCLM-LV",2
19,"19179",109,77,75,3,2,"IUCLM-LV",6
2,"2005",602,490,488,2,2,"IUCLM-LV",11
16,"16055",698,485,481,8,4,"IUCLM-LV",15
19,"19314",46,41,41,0,0,"IUCLM-LV",1
2,"2010",1877,1557,1519,15,38,"IUCLM-LV",106
19,"19176",280,216,216,0,0,"IUCLM-LV",8
2,"2022",431,346,343,1,3,"IUCLM-LV",14
19,"19233",108,93,90,2,3,"IUCLM-LV",11
16,"16199",27,20,19,0,1,"IUCLM-LV",0
19,"19054",184,156,151,2,5,"IUCLM-LV",2
16,"16167",357,318,315,5,3,"IUCLM-LV",8
19,"19019",23,18,18,0,0,"IUCLM-LV",1
16,"16085",151,123,122,2,1,"IUCLM-LV",5
19,"19070",100,74,74,0,0,"IUCLM-LV",6
19,"19034",23,23,23,1,0,"IUCLM-LV",1
16,"16016",258,178,178,1,0,"IUCLM-LV",3
13,"13087",22953,16674,16376,298,298,"IUCLM-LV",954
2,"2050",121,95,95,1,0,"IUCLM-LV",0
16,"16099",232,180,178,5,2,"IUCLM-LV",9
16,"16269",494,412,407,5,5,"IUCLM-LV",13
19,"19119",93,80,79,2,1,"IUCLM-LV",3
19,"19269",103,84,83,0,1,"IUCLM-LV",22
19,"19235",121,92,87,0,5,"IUCLM-LV",2
19,"19169",51,35,35,0,0,"IUCLM-LV",0
16,"16098",586,480,474,10,6,"IUCLM-LV",27
45,"45006",1524,1128,1110,13,18,"IUCM-LV",45
45,"45036",704,559,537,4,22,"IUCM-LV",19
45,"45092",252,223,221,0,2,"IUCM-LV",2
45,"45122",4828,3816,3746,48,70,"IUCM-LV",227
45,"45165",62818,47242,46629,549,613,"IUCM-LV",2463
45,"45018",445,332,322,4,10,"IUCM-LV",42
45,"45110",1918,1585,1570,10,15,"IUCM-LV",12
45,"45067",2385,1923,1878,19,45,"IUCM-LV",62
45,"45015",624,485,480,2,5,"IUCM-LV",13
45,"45175",698,587,579,5,8,"IUCM-LV",9
45,"45192",2549,2178,2155,39,23,"IUCM-LV",72
45,"45118",1980,1412,1390,13,22,"IUCM-LV",77
45,"45200",4633,3768,3672,37,96,"IUCM-LV",156
45,"45025",1237,919,907,11,12,"IUCM-LV",43
45,"45115",2600,2140,2105,14,35,"IUCM-LV",81
45,"45034",1375,1108,1079,18,29,"IUCM-LV",83
45,"45194",57,41,41,0,0,"IUCM-LV",2
45,"45202",3876,3037,2984,13,53,"IUCM-LV",77
45,"45138",1185,998,973,5,25,"IUCM-LV",17
45,"45028",3696,3059,3024,40,35,"IUCM-LV",162
45,"45173",9133,7147,7035,78,112,"IUCM-LV",298
45,"45090",396,335,333,0,2,"IUCM-LV",5
45,"45016",3804,2926,2876,52,50,"IUCM-LV",152
45,"45190",502,425,414,6,11,"IUCM-LV",7
45,"45020",1396,1165,1151,15,14,"IUCM-LV",40
45,"45057",222,197,189,0,8,"IUCM-LV",2
45,"45047",2404,1685,1662,7,23,"IUCM-LV",89
45,"45164",191,160,158,0,2,"IUCM-LV",6
45,"45152",653,503,497,2,6,"IUCM-LV",41
45,"45063",504,378,372,3,6,"IUCM-LV",16
45,"45050",508,385,378,0,7,"IUCM-LV",22
45,"45055",1052,886,870,10,16,"IUCM-LV",27
45,"45005",267,223,218,4,5,"IUCM-LV",10
45,"45098",2273,1799,1756,11,43,"IUCM-LV",51
45,"45083",421,353,345,0,8,"IUCM-LV",10
45,"45074",428,349,343,3,6,"IUCM-LV",11
45,"45155",481,382,375,3,7,"IUCM-LV",13
45,"45147",598,484,478,9,6,"IUCM-LV",23
45,"45111",65,47,44,1,3,"IUCM-LV",4
45,"45140",1087,885,867,6,18,"IUCM-LV",34
45,"45136",5891,4414,4368,55,46,"IUCM-LV",258
45,"45163",8239,6203,6073,103,130,"IUCM-LV",411
45,"45142",7974,6294,6178,89,116,"IUCM-LV",260
45,"45053",8208,6763,6663,103,100,"IUCM-LV",271
45,"45086",491,406,399,3,7,"IUCM-LV",12
45,"45168",61519,47265,46528,736,737,"IUCM-LV",3016
45,"45148",340,256,256,1,0,"IUCM-LV",2
45,"45144",839,701,691,11,10,"IUCM-LV",18
45,"45037",1730,1325,1304,15,21,"IUCM-LV",49
45,"45186",3217,2573,2527,24,46,"IUCM-LV",601
45,"45132",1916,1487,1473,9,14,"IUCM-LV",51
45,"45001",1901,1468,1431,14,37,"IUCM-LV",52
45,"45009",588,430,422,2,8,"IUCM-LV",12
45,"45101",3761,3212,3181,19,31,"IUCM-LV",214
45,"45150",471,388,382,1,6,"IUCM-LV",12
45,"45033",407,302,295,3,7,"IUCM-LV",7
45,"45071",1896,1592,1575,21,17,"IUCM-LV",262
45,"45189",655,510,502,3,8,"IUCM-LV",31
45,"45204",621,500,497,1,3,"IUCM-LV",15
45,"45091",419,311,309,5,2,"IUCM-LV",14
45,"45185",7912,6321,6180,68,141,"IUCM-LV",397
45,"45199",2712,1817,1796,17,21,"IUCM-LV",152
45,"45065",317,261,258,0,3,"IUCM-LV",8
45,"45171",1359,1114,1093,13,21,"IUCM-LV",29
45,"45157",2097,1519,1499,15,20,"IUCM-LV",84
45,"45162",773,599,594,3,5,"IUCM-LV",5
45,"45172",757,597,594,7,3,"IUCM-LV",7
45,"45159",100,84,84,1,0,"IUCM-LV",3
45,"45176",3570,2619,2583,45,36,"IUCM-LV",167
45,"45027",433,352,349,1,3,"IUCM-LV",11
45,"45179",608,476,471,3,5,"IUCM-LV",10
45,"45181",2276,1788,1764,10,24,"IUCM-LV",54
45,"45126",278,188,187,0,1,"IUCM-LV",12
45,"45130",354,287,283,2,4,"IUCM-LV",5
45,"45114",608,476,468,3,8,"IUCM-LV",11
45,"45054",4285,3321,3274,32,47,"IUCM-LV",124
45,"45901",811,595,591,2,4,"IUCM-LV",27
45,"45102",3539,2581,2533,23,48,"IUCM-LV",172
45,"45127",739,550,538,5,12,"IUCM-LV",28
45,"45112",2022,1470,1423,12,47,"IUCM-LV",67
45,"45038",3125,2401,2374,33,27,"IUCM-LV",125
45,"45087",8428,6434,6292,74,142,"IUCM-LV",225
45,"45004",603,497,494,6,3,"IUCM-LV",33
45,"45151",631,474,470,1,4,"IUCM-LV",29
45,"45019",7033,5207,5110,89,97,"IUCM-LV",352
45,"45029",233,207,202,4,5,"IUCM-LV",5
45,"45099",3449,2451,2405,22,46,"IUCM-LV",212
45,"45013",1870,1504,1486,5,18,"IUCM-LV",45
45,"45056",2246,1523,1502,16,21,"IUCM-LV",80
45,"45174",343,289,288,0,1,"IUCM-LV",7
45,"45051",1658,1305,1293,20,12,"IUCM-LV",45
45,"45149",638,542,533,2,9,"IUCM-LV",24
45,"45145",2430,1866,1821,13,45,"IUCM-LV",105
45,"45113",2094,1589,1555,6,34,"IUCM-LV",46
45,"45003",607,515,511,3,4,"IUCM-LV",18
45,"45188",2883,2180,2151,30,29,"IUCM-LV",146
45,"45105",426,326,322,2,4,"IUCM-LV",7
45,"45079",368,278,273,1,5,"IUCM-LV",10
45,"45024",1105,870,856,16,14,"IUCM-LV",12
45,"45103",457,400,394,0,6,"IUCM-LV",3
45,"45059",1758,1465,1437,10,28,"IUCM-LV",33
45,"45046",2455,1884,1862,11,22,"IUCM-LV",64
45,"45167",1552,1296,1278,14,18,"IUCM-LV",41
45,"45203",2535,1883,1829,21,54,"IUCM-LV",121
45,"45106",7666,6045,5945,92,100,"IUCM-LV",560
45,"45180",2714,2018,1980,19,38,"IUCM-LV",92
45,"45123",2961,2081,2049,30,32,"IUCM-LV",187
45,"45058",409,334,332,2,2,"IUCM-LV",8
45,"45107",3006,2344,2299,32,45,"IUCM-LV",168
45,"45205",6333,4544,4451,58,93,"IUCM-LV",284
45,"45109",3030,2507,2417,30,90,"IUCM-LV",102
45,"45017",268,215,212,1,3,"IUCM-LV",14
45,"45045",1313,992,979,12,13,"IUCM-LV",50
45,"45120",159,125,122,0,3,"IUCM-LV",5
45,"45061",2523,1839,1813,20,26,"IUCM-LV",67
45,"45011",316,271,268,1,3,"IUCM-LV",1
45,"45032",471,340,333,2,7,"IUCM-LV",12
45,"45048",388,310,308,2,2,"IUCM-LV",7
45,"45043",827,679,670,3,9,"IUCM-LV",12
45,"45137",1610,1057,1047,11,10,"IUCM-LV",60
45,"45156",3528,2985,2924,19,61,"IUCM-LV",354
45,"45075",205,162,159,4,3,"IUCM-LV",5
45,"45026",269,200,198,2,2,"IUCM-LV",7
45,"45143",1302,916,901,6,15,"IUCM-LV",99
45,"45154",1459,1148,1140,12,8,"IUCM-LV",63
45,"45021",2399,1834,1804,23,30,"IUCM-LV",132
45,"45134",1606,1260,1242,10,18,"IUCM-LV",102
45,"45042",184,154,151,3,3,"IUCM-LV",9
45,"45195",2229,1806,1784,11,22,"IUCM-LV",97
45,"45089",1615,1238,1221,16,17,"IUCM-LV",98
45,"45141",981,815,790,6,25,"IUCM-LV",70
45,"45040",1504,1058,1046,5,12,"IUCM-LV",140
45,"45094",441,358,353,6,5,"IUCM-LV",17
45,"45069",1791,1409,1389,8,20,"IUCM-LV",91
45,"45073",351,265,261,3,4,"IUCM-LV",17
45,"45077",554,430,423,7,7,"IUCM-LV",14
45,"45158",2577,1948,1909,18,39,"IUCM-LV",98
45,"45201",3439,2353,2317,31,36,"IUCM-LV",177
45,"45183",2189,1537,1514,10,23,"IUCM-LV",101
45,"45008",158,129,127,0,2,"IUCM-LV",2
45,"45153",1704,1376,1353,9,23,"IUCM-LV",53
45,"45088",2038,1379,1356,14,23,"IUCM-LV",69
45,"45121",6553,4720,4653,43,67,"IUCM-LV",185
45,"45093",168,133,133,0,0,"IUCM-LV",4
45,"45139",231,198,194,0,4,"IUCM-LV",1
45,"45041",3617,2672,2635,21,37,"IUCM-LV",172
45,"45062",1161,959,928,8,31,"IUCM-LV",24
45,"45135",4437,3621,3550,44,71,"IUCM-LV",433
45,"45097",1094,934,925,9,9,"IUCM-LV",20
45,"45035",307,236,236,3,0,"IUCM-LV",12
45,"45081",16099,12232,12079,154,153,"IUCM-LV",715
45,"45197",1972,1570,1538,8,32,"IUCM-LV",26
45,"45085",1511,1111,1100,10,11,"IUCM-LV",53
45,"45131",327,262,258,1,4,"IUCM-LV",10
45,"45187",4187,3581,3512,25,69,"IUCM-LV",109
45,"45007",747,641,632,1,9,"IUCM-LV",28
45,"45198",1950,1661,1641,9,20,"IUCM-LV",19
45,"45082",1333,1143,1123,14,20,"IUCM-LV",38
45,"45160",1104,911,896,12,15,"IUCM-LV",58
45,"45039",236,197,190,2,7,"IUCM-LV",2
45,"45146",117,99,98,0,1,"IUCM-LV",0
45,"45193",661,557,548,1,9,"IUCM-LV",23
45,"45096",1021,800,778,5,22,"IUCM-LV",158
45,"45070",1415,1175,1162,11,13,"IUCM-LV",64
45,"45108",564,461,456,2,5,"IUCM-LV",1
45,"45078",1451,1243,1228,7,15,"IUCM-LV",35
45,"45014",4087,2851,2816,36,35,"IUCM-LV",265
45,"45002",2500,1771,1756,26,15,"IUCM-LV",134
45,"45117",800,679,668,7,11,"IUCM-LV",17
45,"45191",601,506,498,1,8,"IUCM-LV",18
45,"45124",2183,1868,1823,20,45,"IUCM-LV",67
45,"45196",1363,1092,1076,3,16,"IUCM-LV",45
45,"45012",683,572,566,10,6,"IUCM-LV",30
45,"45095",742,606,585,2,21,"IUCM-LV",12
45,"45076",603,420,419,3,1,"IUCM-LV",9
45,"45023",1936,1476,1456,18,20,"IUCM-LV",121
45,"45169",239,183,183,1,0,"IUCM-LV",2
45,"45170",257,186,183,0,3,"IUCM-LV",3
45,"45128",2558,1831,1806,20,25,"IUCM-LV",76
45,"45030",486,378,374,4,4,"IUCM-LV",16
45,"45184",219,150,148,3,2,"IUCM-LV",10
45,"45072",690,535,532,7,3,"IUCM-LV",32
45,"45031",2773,2011,1975,25,36,"IUCM-LV",101
45,"45049",394,315,315,6,0,"IUCM-LV",15
45,"45166",1734,1460,1429,8,31,"IUCM-LV",59
45,"45161",11339,7989,7869,95,120,"IUCM-LV",707
45,"45010",471,374,372,2,2,"IUCM-LV",17
45,"45100",205,169,169,0,0,"IUCM-LV",2
45,"45182",1077,873,856,11,17,"IUCM-LV",51
45,"45084",2395,1879,1842,21,37,"IUCM-LV",102
45,"45068",164,135,133,1,2,"IUCM-LV",9
45,"45066",7334,5602,5536,52,66,"IUCM-LV",285
45,"45119",3274,2279,2236,37,43,"IUCM-LV",216
45,"45060",204,151,148,1,3,"IUCM-LV",2
45,"45080",3,3,3,0,0,"IUCM-LV",0
45,"45052",2793,2247,2212,38,35,"IUCM-LV",177
45,"45064",3801,2987,2953,38,34,"IUCM-LV",442
45,"45133",2803,2241,2199,18,42,"IUCM-LV",110
45,"45104",457,375,370,2,5,"IUCM-LV",29
45,"45022",427,317,314,8,3,"IUCM-LV",10
45,"45129",145,121,120,0,1,"IUCM-LV",4
45,"45177",2295,1898,1857,15,41,"IUCM-LV",127
45,"45125",2407,1977,1949,22,28,"IUCM-LV",86
45,"45116",682,576,565,0,11,"IUCM-LV",23
49,"49027",178,134,127,1,7,"IUCL",5
40,"40224",34,25,25,0,0,"IUCL",0
34,"34041",100,79,78,1,1,"IUCL",3
9,"9345",134,102,102,1,0,"IUCL",6
34,"34124",70,55,55,1,0,"IUCL",0
49,"49047",120,91,90,1,1,"IUCL",4
40,"40128",144,116,116,5,0,"IUCL",8
49,"49206",948,706,692,15,14,"IUCL",34
9,"9407",31,27,27,0,0,"IUCL",3
40,"40083",88,72,72,1,0,"IUCL",3
49,"49226",279,235,233,1,2,"IUCL",9
40,"40021",33,32,32,0,0,"IUCL",2
49,"49028",119,103,103,1,0,"IUCL",2
49,"49255",455,372,367,1,5,"IUCL",9
40,"40123",168,130,126,3,4,"IUCL",12
9,"9439",909,720,697,16,23,"IUCL",40
47,"47144",85,65,65,2,0,"IUCL",4
47,"47082",816,664,661,10,3,"IUCL",22
34,"34243",352,274,273,5,1,"IUCL",7
9,"9035",336,255,251,3,4,"IUCL",22
9,"9456",142,110,110,3,0,"IUCL",2
9,"9048",1565,1166,1148,20,18,"IUCL",82
49,"49136",347,249,247,6,2,"IUCL",7
49,"49214",720,560,558,6,2,"IUCL",15
40,"40222",190,157,156,1,1,"IUCL",9
47,"47215",60,52,52,2,0,"IUCL",3
47,"47191",113,81,80,1,1,"IUCL",4
40,"40002",38,31,31,1,0,"IUCL",1
9,"9054",107,80,80,1,0,"IUCL",11
40,"40119",182,149,145,2,4,"IUCL",2
47,"47078",178,159,154,7,5,"IUCL",2
9,"9231",77,42,42,0,0,"IUCL",1
9,"9312",113,94,91,0,3,"IUCL",4
34,"34051",112,92,91,7,1,"IUCL",0
9,"9032",118,68,68,0,0,"IUCL",2
49,"49148",213,144,143,0,1,"IUCL",9
47,"47227",62,52,52,1,0,"IUCL",1
49,"49041",443,337,334,7,3,"IUCL",22
34,"34116",76,50,49,1,1,"IUCL",1
49,"49011",236,195,194,5,1,"IUCL",10
47,"47035",956,778,768,5,10,"IUCL",27
9,"9025",150,112,110,0,2,"IUCL",4
47,"47197",932,739,730,15,9,"IUCL",14
9,"9325",217,151,148,1,3,"IUCL",3
49,"49132",338,245,238,0,7,"IUCL",5
9,"9329",117,80,79,1,1,"IUCL",8
9,"9148",95,75,75,2,0,"IUCL",4
40,"40194",40248,30946,30365,525,581,"IUCL",1768
34,"34100",141,105,105,1,0,"IUCL",0
9,"9309",343,252,246,7,6,"IUCL",5
9,"9279",195,140,140,4,0,"IUCL",5
49,"49063",371,291,290,3,1,"IUCL",7
49,"49239",723,506,495,12,11,"IUCL",20
47,"47037",194,160,159,1,1,"IUCL",2
49,"49095",318,232,232,5,0,"IUCL",15
40,"40162",420,320,314,1,6,"IUCL",10
9,"9250",295,234,230,5,4,"IUCL",7
9,"9010",35,27,27,1,0,"IUCL",0
34,"34009",34,31,31,3,0,"IUCL",1
9,"9058",357,278,276,4,2,"IUCL",20
40,"40144",19,17,17,1,0,"IUCL",0
40,"40039",257,188,184,2,4,"IUCL",6
34,"34112",50,39,38,2,1,"IUCL",3
40,"40214",243,204,199,0,5,"IUCL",11
40,"40157",74,51,50,2,1,"IUCL",1
47,"47034",90,65,63,0,2,"IUCL",0
34,"34141",190,162,160,0,2,"IUCL",4
47,"47066",1114,891,888,10,3,"IUCL",46
47,"47061",266,227,223,0,4,"IUCL",19
9,"9358",261,200,199,3,1,"IUCL",4
40,"40028",106,89,88,1,1,"IUCL",3
9,"9014",190,113,113,3,0,"IUCL",5
34,"34068",32,23,23,0,0,"IUCL",1
34,"34222",122,94,94,2,0,"IUCL",3
9,"9269",39,33,33,0,0,"IUCL",1
49,"49110",382,236,233,1,3,"IUCL",6
9,"9418",79,60,58,0,2,"IUCL",1
49,"49046",283,240,235,2,5,"IUCL",5
40,"40084",65,53,53,2,0,"IUCL",5
40,"40087",112,85,83,0,2,"IUCL",3
49,"49162",217,157,155,2,2,"IUCL",5
49,"49125",1344,956,939,21,17,"IUCL",70
47,"47211",45,38,38,1,0,"IUCL",0
9,"9352",134,107,106,0,1,"IUCL",1
49,"49035",260,231,229,4,2,"IUCL",2
9,"9327",34,34,34,0,0,"IUCL",0
9,"9374",96,85,81,3,4,"IUCL",3
9,"9369",460,339,336,4,3,"IUCL",18
47,"47073",141,118,116,1,2,"IUCL",0
34,"34084",142,124,122,3,2,"IUCL",1
9,"9052",40,31,31,1,0,"IUCL",0
34,"34201",212,178,172,1,6,"IUCL",6
49,"49109",657,534,529,12,5,"IUCL",5
47,"47056",90,69,69,2,0,"IUCL",2
34,"34245",322,240,236,3,4,"IUCL",7
49,"49005",156,102,101,2,1,"IUCL",4
49,"49268",480,365,362,8,3,"IUCL",9
34,"34011",406,327,327,4,0,"IUCL",7
49,"49067",416,300,300,2,0,"IUCL",9
47,"47222",92,77,77,4,0,"IUCL",2
49,"49012",73,43,43,0,0,"IUCL",2
49,"49197",187,126,126,3,0,"IUCL",5
40,"40176",418,344,341,8,3,"IUCL",17
9,"9348",150,122,122,2,0,"IUCL",2
34,"34185",72,48,45,0,3,"IUCL",4
40,"40082",131,111,110,5,1,"IUCL",4
40,"40035",146,114,112,3,2,"IUCL",4
40,"40099",61,52,52,2,0,"IUCL",2
34,"34027",1224,875,861,14,14,"IUCL",41
9,"9276",420,275,245,5,30,"IUCL",35
40,"40069",87,76,75,0,1,"IUCL",3
34,"34010",560,458,451,7,7,"IUCL",16
34,"34228",93,80,80,0,0,"IUCL",3
9,"9039",58,50,49,0,1,"IUCL",0
40,"40200",47,41,39,0,2,"IUCL",5
40,"40057",1522,1272,1260,19,12,"IUCL",69
34,"34121",208,153,152,0,1,"IUCL",1
49,"49014",134,104,102,1,2,"IUCL",9
9,"9226",74,57,57,0,0,"IUCL",3
40,"40012",280,215,213,2,2,"IUCL",7
9,"9362",219,185,184,2,1,"IUCL",12
47,"47110",471,386,378,6,8,"IUCL",16
47,"47126",49,43,42,1,1,"IUCL",1
9,"9093",154,127,125,1,2,"IUCL",5
49,"49131",312,227,225,7,2,"IUCL",7
34,"34204",53,45,44,0,1,"IUCL",0
49,"49075",153,128,122,0,6,"IUCL",0
47,"47162",80,62,62,1,0,"IUCL",0
40,"40049",52,39,39,1,0,"IUCL",1
40,"40184",269,227,224,4,3,"IUCL",4
9,"9120",46,35,34,1,1,"IUCL",2
9,"9175",143,99,98,0,1,"IUCL",8
9,"9195",64,40,40,1,0,"IUCL",3
34,"34199",1354,1004,978,27,26,"IUCL",71
40,"40030",520,432,425,9,7,"IUCL",34
40,"40060",86,65,64,3,1,"IUCL",0
34,"34004",5790,4354,4262,84,92,"IUCL",262
9,"9283",63,36,36,0,0,"IUCL",1
34,"34130",228,187,186,6,1,"IUCL",5
40,"40108",120,83,82,1,1,"IUCL",3
47,"47101",1740,1458,1444,12,14,"IUCL",68
34,"34180",84,68,68,0,0,"IUCL",0
47,"47052",6207,4812,4761,79,51,"IUCL",434
49,"49150",169,129,126,0,3,"IUCL",2
9,"9102",44,36,36,0,0,"IUCL",4
49,"49061",141,106,105,1,1,"IUCL",1
40,"40136",130,106,106,1,0,"IUCL",7
9,"9239",52,42,42,1,0,"IUCL",0
9,"9281",159,134,132,5,2,"IUCL",4
40,"40229",45,37,37,0,0,"IUCL",3
40,"40182",207,155,155,6,0,"IUCL",8
9,"9216",390,278,272,2,6,"IUCL",20
49,"49112",131,93,93,2,0,"IUCL",0
49,"49233",119,78,78,2,0,"IUCL",0
47,"47020",283,237,232,5,5,"IUCL",3
34,"34157",2471,1936,1912,26,24,"IUCL",100
34,"34032",47,36,36,1,0,"IUCL",3
9,"9434",1167,916,902,24,14,"IUCL",55
9,"9298",90,74,74,1,0,"IUCL",3
9,"9119",51,38,38,0,0,"IUCL",1
40,"40054",145,103,102,1,1,"IUCL",8
49,"49090",207,168,168,4,0,"IUCL",5
9,"9255",90,68,68,0,0,"IUCL",1
9,"9478",53,41,41,1,0,"IUCL",0
9,"9114",88,75,73,0,2,"IUCL",5
9,"9013",48,41,41,1,0,"IUCL",2
9,"9287",201,159,158,4,1,"IUCL",8
9,"9447",36,33,33,0,0,"IUCL",1
49,"49057",125,98,94,1,4,"IUCL",0
34,"34158",336,202,200,0,2,"IUCL",15
9,"9065",152,137,137,1,0,"IUCL",11
9,"9011",86,56,56,1,0,"IUCL",4
47,"47103",277,218,214,1,4,"IUCL",7
9,"9088",77,40,40,0,0,"IUCL",0
49,"49232",95,78,78,1,0,"IUCL",3
47,"47083",80,61,59,3,2,"IUCL",3
49,"49275",53766,37940,37379,774,561,"IUCL",2798
49,"49168",96,78,78,1,0,"IUCL",5
40,"40109",84,70,67,0,3,"IUCL",2
49,"49237",157,110,110,0,0,"IUCL",0
49,"49116",401,308,305,4,3,"IUCL",11
47,"47206",111,99,99,0,0,"IUCL",0
9,"9332",137,88,85,1,3,"IUCL",9
34,"34229",75,60,60,2,0,"IUCL",2
9,"9192",74,55,53,0,2,"IUCL",4
9,"9020",276,222,222,6,0,"IUCL",7
49,"49262",401,317,313,1,4,"IUCL",7
49,"49219",7742,5643,5562,87,81,"IUCL",267
49,"49126",232,175,173,3,2,"IUCL",1
47,"47048",204,168,167,2,1,"IUCL",5
49,"49021",14682,10495,10296,194,199,"IUCL",716
34,"34022",1136,926,908,5,18,"IUCL",22
47,"47014",55,47,47,0,0,"IUCL",1
34,"34005",899,707,698,8,9,"IUCL",33
47,"47172",149,125,124,3,1,"IUCL",14
40,"40074",271,221,218,3,3,"IUCL",10
40,"40079",236,174,171,0,3,"IUCL",9
49,"49094",276,180,180,2,0,"IUCL",1
34,"34174",213,179,178,4,1,"IUCL",3
49,"49017",264,189,187,1,2,"IUCL",3
34,"34129",191,144,142,0,2,"IUCL",7
9,"9197",160,129,128,3,1,"IUCL",5
49,"49225",172,130,129,0,1,"IUCL",6
9,"9241",198,159,158,5,1,"IUCL",12
9,"9086",629,467,461,5,6,"IUCL",26
9,"9398",92,68,68,2,0,"IUCL",1
9,"9308",70,51,51,0,0,"IUCL",1
49,"49114",51,34,33,1,1,"IUCL",0
34,"34240",102,84,83,1,1,"IUCL",2
34,"34178",106,93,93,1,0,"IUCL",2
9,"9386",61,45,45,0,0,"IUCL",3
49,"49053",978,809,796,10,13,"IUCL",44
9,"9301",625,510,504,11,6,"IUCL",31
9,"9083",27,21,21,0,0,"IUCL",0
47,"47050",3557,2688,2651,50,37,"IUCL",173
9,"9051",181,136,133,2,3,"IUCL",7
9,"9041",27,27,27,0,0,"IUCL",1
9,"9448",225,188,186,1,2,"IUCL",4
9,"9272",319,225,225,5,0,"IUCL",9
9,"9016",87,55,54,1,1,"IUCL",1
9,"9306",127,94,94,0,0,"IUCL",2
34,"34073",184,153,152,7,1,"IUCL",8
9,"9191",45,34,33,1,1,"IUCL",2
34,"34017",960,772,760,15,12,"IUCL",23
47,"47226",180,152,148,1,4,"IUCL",5
9,"9421",269,189,189,5,0,"IUCL",11
49,"49102",217,178,176,3,2,"IUCL",15
9,"9297",326,270,266,7,4,"IUCL",8
9,"9356",57,38,37,1,1,"IUCL",1
9,"9415",290,192,192,4,0,"IUCL",1
47,"47195",449,350,346,5,4,"IUCL",20
40,"40223",241,190,190,2,0,"IUCL",12
49,"49088",90,67,66,3,1,"IUCL",0
9,"9009",167,129,128,8,1,"IUCL",3
40,"40142",53,43,41,1,2,"IUCL",0
40,"40189",560,455,438,6,17,"IUCL",16
47,"47179",408,315,306,6,9,"IUCL",11
9,"9323",71,44,44,2,0,"IUCL",0
40,"40148",259,213,212,3,1,"IUCL",9
40,"40179",634,545,538,4,7,"IUCL",19
49,"49147",301,243,239,4,4,"IUCL",7
47,"47080",45,39,39,1,0,"IUCL",5
40,"40231",128,102,100,3,2,"IUCL",3
9,"9177",1154,823,815,12,8,"IUCL",32
9,"9136",203,153,146,3,7,"IUCL",6
9,"9103",247,201,200,2,1,"IUCL",7
47,"47161",3886,3133,3105,45,28,"IUCL",97
9,"9209",4617,3269,3234,44,35,"IUCL",158
34,"34108",561,477,465,6,12,"IUCL",14
34,"34028",154,128,126,1,2,"IUCL",4
9,"9194",2033,1557,1535,28,22,"IUCL",69
9,"9133",39,33,33,1,0,"IUCL",1
47,"47032",161,130,129,3,1,"IUCL",3
9,"9390",645,522,518,9,4,"IUCL",22
34,"34182",860,657,649,8,8,"IUCL",19
9,"9261",486,342,338,7,4,"IUCL",12
49,"49129",903,671,661,16,10,"IUCL",36
9,"9078",41,37,35,0,2,"IUCL",4
40,"40124",261,190,183,9,7,"IUCL",6
47,"47060",262,220,218,1,2,"IUCL",8
40,"40034",85,73,73,1,0,"IUCL",4
9,"9326",156,119,114,2,5,"IUCL",10
9,"9295",78,54,53,0,1,"IUCL",1
9,"9372",207,169,165,1,4,"IUCL",9
47,"47115",306,248,248,2,0,"IUCL",3
49,"49055",115,96,95,1,1,"IUCL",4
47,"47198",71,56,56,2,0,"IUCL",1
9,"9024",159,124,123,2,1,"IUCL",1
34,"34233",158,128,128,3,0,"IUCL",1
49,"49209",568,374,372,1,2,"IUCL",12
9,"9168",329,254,254,2,0,"IUCL",8
47,"47063",107,87,87,2,0,"IUCL",9
9,"9229",213,163,163,1,0,"IUCL",7
34,"34018",229,184,182,3,2,"IUCL",9
49,"49193",503,365,357,4,8,"IUCL",9
49,"49272",102,87,86,0,1,"IUCL",0
49,"49151",680,494,491,6,3,"IUCL",39
9,"9249",54,44,42,1,2,"IUCL",1
47,"47091",97,82,80,3,2,"IUCL",1
34,"34186",61,53,53,0,0,"IUCL",1
49,"49210",493,358,356,6,2,"IUCL",15
47,"47119",101,78,77,0,1,"IUCL",4
40,"40210",110,71,67,1,4,"IUCL",5
49,"49004",137,105,105,3,0,"IUCL",7
9,"9259",239,178,177,2,1,"IUCL",3
40,"40230",117,92,90,1,2,"IUCL",3
40,"40089",248,183,177,3,6,"IUCL",8
49,"49230",122,98,95,1,3,"IUCL",0
49,"49180",169,113,107,2,6,"IUCL",6
9,"9026",384,296,295,8,1,"IUCL",19
9,"9198",115,85,85,1,0,"IUCL",8
9,"9901",407,319,308,8,11,"IUCL",23
47,"47170",40,30,30,0,0,"IUCL",6
49,"49153",183,141,139,1,2,"IUCL",8
40,"40216",753,621,611,15,10,"IUCL",23
47,"47220",194,143,142,4,1,"IUCL",4
40,"40120",173,145,144,1,1,"IUCL",3
34,"34114",240,171,171,0,0,"IUCL",0
9,"9403",98,75,75,0,0,"IUCL",3
47,"47111",1005,804,794,5,10,"IUCL",27
9,"9902",491,363,357,4,6,"IUCL",19
49,"49199",266,214,211,1,3,"IUCL",5
9,"9127",54,39,39,0,0,"IUCL",2
49,"49082",400,331,324,2,7,"IUCL",8
34,"34140",113,84,84,2,0,"IUCL",1
34,"34170",72,56,56,1,0,"IUCL",1
47,"47102",302,250,248,3,2,"IUCL",11
47,"47040",67,51,50,0,1,"IUCL",1
9,"9128",82,65,63,0,2,"IUCL",4
40,"40188",120,82,81,0,1,"IUCL",5
9,"9289",1540,1127,1117,16,10,"IUCL",25
34,"34904",355,247,241,3,6,"IUCL",16
49,"49200",1011,789,771,6,18,"IUCL",37
47,"47013",118,97,97,2,0,"IUCL",4
40,"40047",47,37,36,0,1,"IUCL",0
49,"49098",242,177,175,4,2,"IUCL",5
49,"49258",127,107,104,0,3,"IUCL",6
9,"9422",24,18,16,0,2,"IUCL",0
49,"49052",200,149,144,1,5,"IUCL",4
40,"40174",402,292,290,5,2,"IUCL",8
34,"34050",216,170,166,1,4,"IUCL",0
47,"47193",1538,1229,1211,23,18,"IUCL",93
40,"40106",232,173,173,3,0,"IUCL",8
9,"9236",41,38,37,0,1,"IUCL",0
34,"34094",64,47,44,1,3,"IUCL",0
49,"49099",127,96,96,1,0,"IUCL",1
34,"34149",26,18,18,0,0,"IUCL",0
9,"9414",197,159,159,2,0,"IUCL",2
47,"47067",198,159,156,5,3,"IUCL",1
9,"9384",310,223,218,3,5,"IUCL",10
9,"9189",146,101,99,2,2,"IUCL",3
49,"49085",1173,912,908,16,4,"IUCL",25
34,"34024",27,18,17,1,1,"IUCL",1
34,"34241",20,12,11,0,1,"IUCL",0
34,"34133",108,90,90,0,0,"IUCL",5
49,"49068",523,356,353,5,3,"IUCL",5
9,"9130",87,72,71,0,1,"IUCL",5
9,"9228",168,143,143,3,0,"IUCL",9
47,"47030",1075,822,801,13,21,"IUCL",85
34,"34210",103,93,91,2,2,"IUCL",3
47,"47231",4272,3268,3243,64,25,"IUCL",271
47,"47151",32,29,29,0,0,"IUCL",0
34,"34179",32,21,21,0,0,"IUCL",0
9,"9248",63,52,52,0,0,"IUCL",2
47,"47205",414,307,298,5,9,"IUCL",15
40,"40015",33,30,30,1,0,"IUCL",0
9,"9232",182,146,146,1,0,"IUCL",6
49,"49188",142,101,100,3,1,"IUCL",4
47,"47087",376,320,315,7,5,"IUCL",15
9,"9455",48,39,39,0,0,"IUCL",2
49,"49025",187,143,142,3,1,"IUCL",2
40,"40905",143,103,103,1,0,"IUCL",3
40,"40130",139,106,106,4,0,"IUCL",5
47,"47105",210,181,179,1,2,"IUCL",18
47,"47187",101,82,81,1,1,"IUCL",1
9,"9176",60,47,45,2,2,"IUCL",1
9,"9425",561,431,418,3,13,"IUCL",46
34,"34061",116,78,78,2,0,"IUCL",0
34,"34167",124,105,105,0,0,"IUCL",1
34,"34154",78,62,62,0,0,"IUCL",4
47,"47096",139,109,107,0,2,"IUCL",6
47,"47153",135,94,93,1,1,"IUCL",8
47,"47017",205,177,176,1,1,"IUCL",5
40,"40168",36,27,27,0,0,"IUCL",4
34,"34234",72,56,55,1,1,"IUCL",0
49,"49076",333,260,257,10,3,"IUCL",5
47,"47207",325,265,263,4,2,"IUCL",6
49,"49190",81,65,64,2,1,"IUCL",0
34,"34081",53,42,41,0,1,"IUCL",2
34,"34059",462,377,375,5,2,"IUCL",10
40,"40163",62,51,51,5,0,"IUCL",2
47,"47070",33,30,30,1,0,"IUCL",1
9,"9061",187,146,144,1,2,"IUCL",2
9,"9166",97,87,87,1,0,"IUCL",3
40,"40022",210,154,151,2,3,"IUCL",12
9,"9480",106,87,87,0,0,"IUCL",0
34,"34096",56,41,39,1,2,"IUCL",0
9,"9007",66,50,50,0,0,"IUCL",0
40,"40211",72,65,65,1,0,"IUCL",1
40,"40065",520,401,393,6,8,"IUCL",16
9,"9125",648,463,460,5,3,"IUCL",10
40,"40076",6641,4958,4862,67,96,"IUCL",358
9,"9467",65,49,49,0,0,"IUCL",2
9,"9351",63,46,44,0,2,"IUCL",4
34,"34083",1888,1355,1338,15,17,"IUCL",78
9,"9473",94,81,81,2,0,"IUCL",1
49,"49059",111,83,82,2,1,"IUCL",5
40,"40104",261,179,178,1,1,"IUCL",16
49,"49192",166,139,139,2,0,"IUCL",12
9,"9196",161,111,110,0,1,"IUCL",4
49,"49108",512,387,381,9,6,"IUCL",10
40,"40183",148,127,127,0,0,"IUCL",1
47,"47099",174,153,153,4,0,"IUCL",1
34,"34057",483,365,357,2,8,"IUCL",13
9,"9151",509,389,383,5,6,"IUCL",21
9,"9463",261,205,205,1,0,"IUCL",15
9,"9123",31,27,27,0,0,"IUCL",2
47,"47079",67,56,56,1,0,"IUCL",0
47,"47155",3043,2246,2225,35,21,"IUCL",202
49,"49243",117,85,85,0,0,"IUCL",5
9,"9064",353,277,277,6,0,"IUCL",5
9,"9316",108,87,84,0,3,"IUCL",0
49,"49166",1294,1003,988,29,15,"IUCL",99
40,"40037",47,35,35,0,0,"IUCL",0
40,"40159",150,111,110,0,1,"IUCL",5
9,"9135",41,29,29,1,0,"IUCL",2
47,"47046",124,105,103,0,2,"IUCL",4
34,"34208",62,52,52,2,0,"IUCL",2
9,"9380",85,71,71,1,0,"IUCL",1
9,"9230",41,33,33,0,0,"IUCL",0
47,"47139",1080,845,833,11,12,"IUCL",45
40,"40044",160,117,114,4,3,"IUCL",4
9,"9242",93,82,82,2,0,"IUCL",2
47,"47199",84,61,60,1,1,"IUCL",2
47,"47038",128,91,91,0,0,"IUCL",3
34,"34143",181,142,140,3,2,"IUCL",3
47,"47012",134,105,105,0,0,"IUCL",6
9,"9458",422,325,316,5,9,"IUCL",22
9,"9055",55,46,44,0,2,"IUCL",1
34,"34034",129,104,104,1,0,"IUCL",6
34,"34087",108,88,87,1,1,"IUCL",2
40,"40177",171,145,145,2,0,"IUCL",6
9,"9354",33,29,29,2,0,"IUCL",1
9,"9387",121,92,91,3,1,"IUCL",9
40,"40014",60,39,39,1,0,"IUCL",6
9,"9330",1562,1212,1176,10,36,"IUCL",55
40,"40125",99,72,71,3,1,"IUCL",3
9,"9244",53,44,44,0,0,"IUCL",2
9,"9067",460,335,328,5,7,"IUCL",8
40,"40141",881,658,647,9,11,"IUCL",24
49,"49065",1212,939,926,3,13,"IUCL",16
9,"9217",389,273,270,8,3,"IUCL",18
9,"9449",94,80,80,2,0,"IUCL",0
9,"9258",190,159,159,5,0,"IUCL",1
9,"9257",93,73,72,2,1,"IUCL",2
47,"47084",1230,981,968,19,13,"IUCL",31
40,"40001",713,575,562,10,13,"IUCL",8
9,"9446",13,9,9,0,0,"IUCL",0
49,"49066",531,392,386,2,6,"IUCL",8
49,"49022",319,266,261,3,5,"IUCL",6
40,"40127",45,33,33,0,0,"IUCL",2
49,"49184",190,135,133,1,2,"IUCL",2
34,"34177",170,147,143,2,4,"IUCL",5
49,"49229",134,99,99,2,0,"IUCL",2
9,"9443",197,160,154,5,6,"IUCL",10
9,"9274",1160,924,914,14,10,"IUCL",44
49,"49248",224,183,180,4,3,"IUCL",8
34,"34163",61,56,56,1,0,"IUCL",0
49,"49202",221,158,157,2,1,"IUCL",6
49,"49104",383,281,276,2,5,"IUCL",11
49,"49263",69,54,54,2,0,"IUCL",0
49,"49249",78,63,63,0,0,"IUCL",2
40,"40220",71,57,52,0,5,"IUCL",3
40,"40112",2346,1848,1798,35,50,"IUCL",113
9,"9045",283,196,196,4,0,"IUCL",4
9,"9219",28514,20244,19951,326,293,"IUCL",1551
9,"9292",98,73,71,3,2,"IUCL",5
47,"47185",97,76,75,1,1,"IUCL",3
49,"49222",404,297,294,4,3,"IUCL",9
40,"40068",39,32,32,0,0,"IUCL",0
47,"47024",283,211,210,1,1,"IUCL",15
49,"49181",386,308,307,2,1,"IUCL",5
49,"49033",761,563,556,9,7,"IUCL",19
9,"9215",426,290,287,1,3,"IUCL",17
49,"49054",929,690,687,12,3,"IUCL",23
47,"47022",62,54,54,0,0,"IUCL",1
40,"40145",1152,933,920,3,13,"IUCL",120
49,"49187",1317,967,954,31,13,"IUCL",23
47,"47169",70,57,57,0,0,"IUCL",2
34,"34135",429,334,329,6,5,"IUCL",27
9,"9163",642,526,518,3,8,"IUCL",8
34,"34038",284,228,225,9,3,"IUCL",5
9,"9220",82,60,60,2,0,"IUCL",1
9,"9476",67,52,52,0,0,"IUCL",2
9,"9047",62,48,45,0,3,"IUCL",0
9,"9343",94,77,76,0,1,"IUCL",2
9,"9310",14,10,9,2,1,"IUCL",4
9,"9056",4957,3607,3557,70,50,"IUCL",191
47,"47069",128,108,108,0,0,"IUCL",0
9,"9389",77,66,66,0,0,"IUCL",1
49,"49267",101,77,77,1,0,"IUCL",2
47,"47232",107,77,75,1,2,"IUCL",2
47,"47088",121,100,100,0,0,"IUCL",4
34,"34230",12,8,8,0,0,"IUCL",0
40,"40043",1842,1494,1469,28,25,"IUCL",65
47,"47097",345,291,289,7,2,"IUCL",18
9,"9223",46,40,40,0,0,"IUCL",2
49,"49040",118,102,98,1,4,"IUCL",2
9,"9073",889,672,663,12,9,"IUCL",60
9,"9077",38,26,25,0,1,"IUCL",2
47,"47003",263,224,222,1,2,"IUCL",4
40,"40906",1793,1428,1405,32,23,"IUCL",97
49,"49167",223,173,171,5,2,"IUCL",3
9,"9328",81,56,56,2,0,"IUCL",2
40,"40070",137,91,91,0,0,"IUCL",5
40,"40103",157,121,120,0,1,"IUCL",7
47,"47001",51,44,42,2,2,"IUCL",1
49,"49227",295,238,237,5,1,"IUCL",13
47,"47216",124,99,98,2,1,"IUCL",3
47,"47135",93,77,76,0,1,"IUCL",3
40,"40072",170,134,132,1,2,"IUCL",10
47,"47137",27,22,22,2,0,"IUCL",0
9,"9355",117,88,87,1,1,"IUCL",0
49,"49145",251,154,153,0,1,"IUCL",3
49,"49111",144,117,116,10,1,"IUCL",2
49,"49115",191,151,149,3,2,"IUCL",4
40,"40025",158,124,124,0,0,"IUCL",12
47,"47053",125,100,99,1,1,"IUCL",5
9,"9408",45,36,36,0,0,"IUCL",1
40,"40165",95,72,71,1,1,"IUCL",1
49,"49107",160,113,111,2,2,"IUCL",4
40,"40151",52,42,42,0,0,"IUCL",0
47,"47019",93,69,68,0,1,"IUCL",0
49,"49121",382,270,270,1,0,"IUCL",15
34,"34184",54,37,36,0,1,"IUCL",0
9,"9253",108,95,94,4,1,"IUCL",2
47,"47209",43,33,33,0,0,"IUCL",7
9,"9181",334,271,271,14,0,"IUCL",10
49,"49165",72,63,63,0,0,"IUCL",0
49,"49135",687,485,475,3,10,"IUCL",29
9,"9169",96,80,80,1,0,"IUCL",7
40,"40199",110,88,86,3,2,"IUCL",2
49,"49062",142,104,104,1,0,"IUCL",2
34,"34001",36,29,29,2,0,"IUCL",5
34,"34202",28,21,21,0,0,"IUCL",1
40,"40152",750,615,595,4,20,"IUCL",34
49,"49194",380,250,247,4,3,"IUCL",5
47,"47029",61,54,53,0,1,"IUCL",3
34,"34171",1071,762,753,16,9,"IUCL",63
49,"49036",592,410,403,5,7,"IUCL",9
49,"49156",265,217,214,6,3,"IUCL",5
40,"40185",977,725,712,13,13,"IUCL",21
40,"40205",292,221,220,2,1,"IUCL",7
40,"40170",1383,1091,1072,11,19,"IUCL",40
49,"49123",557,421,415,5,6,"IUCL",16
40,"40107",113,93,90,3,3,"IUCL",4
49,"49096",188,149,146,2,3,"IUCL",8
49,"49231",360,256,254,4,2,"IUCL",6
40,"40171",32,25,25,0,0,"IUCL",0
47,"47092",123,100,99,2,1,"IUCL",3
49,"49138",269,190,189,0,1,"IUCL",4
9,"9170",218,158,157,0,1,"IUCL",9
47,"47075",4999,4020,3957,39,63,"IUCL",124
34,"34159",375,275,264,8,11,"IUCL",20
47,"47194",322,244,233,1,11,"IUCL",53
49,"49002",77,59,59,1,0,"IUCL",3
47,"47039",196,163,163,1,0,"IUCL",12
9,"9335",62,52,51,1,1,"IUCL",6
49,"49169",42,34,33,1,1,"IUCL",1
40,"40172",34,27,26,0,1,"IUCL",0
34,"34020",63,44,44,0,0,"IUCL",2
9,"9138",92,77,74,0,3,"IUCL",2
9,"9159",57,49,48,0,1,"IUCL",3
34,"34146",60,42,40,1,2,"IUCL",2
47,"47112",2671,2231,2198,28,33,"IUCL",90
47,"47057",237,198,198,3,0,"IUCL",11
9,"9001",29,25,25,0,0,"IUCL",0
40,"40077",713,526,519,12,7,"IUCL",48
49,"49246",248,212,210,1,2,"IUCL",5
40,"40901",379,292,288,11,4,"IUCL",19
47,"47113",166,136,135,1,1,"IUCL",4
47,"47076",16922,13030,12899,212,131,"IUCL",1104
40,"40078",180,143,143,1,0,"IUCL",4
49,"49234",439,336,332,5,4,"IUCL",9
9,"9152",273,207,207,1,0,"IUCL",10
47,"47015",229,172,170,1,2,"IUCL",0
9,"9044",54,45,45,1,0,"IUCL",1
9,"9129",112,93,93,0,0,"IUCL",0
34,"34006",82,72,72,1,0,"IUCL",2
34,"34181",471,350,346,7,4,"IUCL",16
47,"47224",92,77,77,0,0,"IUCL",2
47,"47168",32,29,28,1,1,"IUCL",0
49,"49152",572,401,395,6,6,"IUCL",29
9,"9427",1561,1090,1078,18,12,"IUCL",36
34,"34227",84,69,67,3,2,"IUCL",1
40,"40190",50,41,40,1,1,"IUCL",0
47,"47085",16967,12618,12472,208,146,"IUCL",807
49,"49264",652,439,435,2,4,"IUCL",14
9,"9070",38,27,27,3,0,"IUCL",0
34,"34214",176,144,143,3,1,"IUCL",3
49,"49265",143,105,105,1,0,"IUCL",2
49,"49172",594,389,383,0,6,"IUCL",8
40,"40019",43,35,35,0,0,"IUCL",2
40,"40160",120,94,92,2,2,"IUCL",5
34,"34101",54,44,44,0,0,"IUCL",1
49,"49245",296,218,218,2,0,"IUCL",8
9,"9101",79,66,66,2,0,"IUCL",1
34,"34216",65,50,50,1,0,"IUCL",2
49,"49204",85,64,64,0,0,"IUCL",3
34,"34151",184,125,123,1,2,"IUCL",7
47,"47114",4107,2877,2834,37,43,"IUCL",119
49,"49173",430,272,272,5,0,"IUCL",11
9,"9454",46,31,30,1,1,"IUCL",0
47,"47124",435,364,358,5,6,"IUCL",26
9,"9033",104,82,80,1,2,"IUCL",0
40,"40052",95,69,69,0,0,"IUCL",2
34,"34123",1798,1479,1436,18,43,"IUCL",61
34,"34039",66,57,56,0,1,"IUCL",0
9,"9907",1385,1053,1041,31,12,"IUCL",66
34,"34080",6066,4238,4169,57,69,"IUCL",209
9,"9132",174,129,127,3,2,"IUCL",5
9,"9277",130,101,101,1,0,"IUCL",13
47,"47134",186,155,149,2,6,"IUCL",5
9,"9164",179,130,130,1,0,"IUCL",2
40,"40053",116,92,90,1,2,"IUCL",6
49,"49175",263,215,215,4,0,"IUCL",8
49,"49189",228,151,150,3,1,"IUCL",4
34,"34136",192,122,122,1,0,"IUCL",0
34,"34012",368,277,275,9,2,"IUCL",8
47,"47147",129,96,96,0,0,"IUCL",1
9,"9109",1181,664,631,16,33,"IUCL",71
9,"9350",502,384,376,7,8,"IUCL",8
34,"34192",103,75,74,1,1,"IUCL",2
49,"49018",341,281,279,5,2,"IUCL",10
47,"47064",30,21,21,1,0,"IUCL",2
47,"47009",117,88,88,1,0,"IUCL",8
49,"49118",215,174,173,2,1,"IUCL",5
9,"9036",32,27,27,2,0,"IUCL",2
9,"9266",87,72,72,0,0,"IUCL",6
47,"47036",257,212,212,1,0,"IUCL",3
34,"34218",486,366,365,3,1,"IUCL",10
34,"34125",99,77,75,1,2,"IUCL",3
47,"47189",164,134,134,1,0,"IUCL",3
49,"49042",271,216,216,1,0,"IUCL",8
40,"40005",34,32,31,1,1,"IUCL",0
40,"40097",114,96,94,2,2,"IUCL",7
49,"49270",156,112,112,6,0,"IUCL",7
40,"40150",76,62,62,1,0,"IUCL",4
9,"9149",37,25,25,0,0,"IUCL",1
34,"34139",179,143,143,1,0,"IUCL",11
49,"49149",422,305,303,6,2,"IUCL",5
9,"9179",45,37,37,0,0,"IUCL",3
34,"34098",756,544,540,10,4,"IUCL",46
40,"40040",2677,1990,1966,24,24,"IUCL",66
34,"34232",802,632,623,9,9,"IUCL",13
49,"49079",110,93,92,2,1,"IUCL",5
40,"40056",41,34,34,0,0,"IUCL",0
9,"9180",132,97,95,8,2,"IUCL",5
40,"40213",99,75,74,1,1,"IUCL",0
40,"40122",551,417,414,9,3,"IUCL",38
40,"40010",140,117,117,0,0,"IUCL",4
40,"40088",303,242,238,0,4,"IUCL",7
47,"47055",212,169,168,3,1,"IUCL",9
9,"9303",92,64,64,0,0,"IUCL",3
9,"9464",44,28,28,0,0,"IUCL",0
34,"34902",146,121,121,1,0,"IUCL",0
34,"34058",212,179,178,0,1,"IUCL",3
34,"34099",56,49,47,1,2,"IUCL",1
9,"9368",26,18,18,0,0,"IUCL",0
47,"47176",229,157,157,0,0,"IUCL",4
49,"49142",264,180,179,2,1,"IUCL",12
40,"40017",103,89,88,2,1,"IUCL",2
47,"47141",148,121,119,1,2,"IUCL",3
9,"9160",104,75,74,0,1,"IUCL",1
40,"40063",7290,5366,5171,68,195,"IUCL",419
40,"40139",302,243,238,5,5,"IUCL",6
40,"40154",23,21,21,1,0,"IUCL",0
9,"9423",34,28,28,1,0,"IUCL",1
34,"34019",139,108,108,5,0,"IUCL",1
49,"49019",256,206,205,5,1,"IUCL",2
9,"9365",38,27,27,0,0,"IUCL",2
40,"40201",48,48,48,2,0,"IUCL",2
9,"9137",177,134,134,6,0,"IUCL",9
9,"9227",131,100,100,1,0,"IUCL",4
47,"47174",302,236,234,3,2,"IUCL",24
9,"9395",164,134,133,1,1,"IUCL",11
34,"34033",17,15,15,0,0,"IUCL",2
40,"40233",457,350,348,1,2,"IUCL",37
47,"47200",91,73,73,0,0,"IUCL",8
40,"40202",79,59,58,0,1,"IUCL",1
9,"9155",27,17,17,0,0,"IUCL",1
49,"49139",195,146,146,0,0,"IUCL",4
47,"47122",2078,1697,1665,21,32,"IUCL",122
9,"9382",33,30,30,0,0,"IUCL",2
47,"47184",575,447,443,6,4,"IUCL",24
40,"40061",66,53,52,1,1,"IUCL",3
47,"47131",189,145,145,4,0,"IUCL",5
9,"9412",846,568,563,4,5,"IUCL",34
9,"9318",63,38,38,0,0,"IUCL",1
34,"34176",146,120,118,2,2,"IUCL",4
9,"9098",553,416,410,11,6,"IUCL",26
9,"9471",171,127,125,1,2,"IUCL",11
9,"9413",500,335,331,1,4,"IUCL",21
49,"49155",105,85,85,0,0,"IUCL",1
34,"34023",5318,3947,3891,64,56,"IUCL",370
9,"9100",56,46,44,0,2,"IUCL",1
9,"9140",136,110,110,1,0,"IUCL",5
49,"49201",330,280,278,9,2,"IUCL",2
34,"34217",1089,866,849,19,17,"IUCL",44
47,"47188",125,112,109,3,3,"IUCL",1
34,"34168",60,56,56,0,0,"IUCL",2
40,"40048",40,30,30,0,0,"IUCL",1
49,"49221",266,148,147,6,1,"IUCL",7
9,"9214",724,477,467,4,10,"IUCL",26
49,"49080",736,571,560,5,11,"IUCL",13
40,"40902",137,118,118,3,0,"IUCL",1
49,"49037",201,171,171,2,0,"IUCL",9
40,"40903",102,75,75,0,0,"IUCL",1
40,"40204",187,139,134,4,5,"IUCL",4
9,"9339",139,105,104,1,1,"IUCL",5
9,"9904",548,412,407,7,5,"IUCL",16
47,"47159",862,704,695,20,9,"IUCL",29
9,"9190",97,73,72,0,1,"IUCL",7
49,"49128",617,480,474,10,6,"IUCL",15
40,"40191",265,191,190,1,1,"IUCL",13
49,"49101",186,134,129,0,5,"IUCL",10
40,"40129",203,166,162,1,4,"IUCL",1
34,"34066",66,55,54,0,1,"IUCL",5
34,"34092",331,272,267,6,5,"IUCL",6
49,"49143",243,161,157,0,4,"IUCL",5
40,"40081",151,109,107,2,2,"IUCL",10
9,"9071",48,32,32,0,0,"IUCL",4
34,"34052",187,147,147,1,0,"IUCL",6
9,"9034",301,250,250,3,0,"IUCL",8
34,"34165",86,67,67,0,0,"IUCL",0
9,"9046",41,30,30,0,0,"IUCL",3
40,"40115",126,98,95,2,3,"IUCL",8
47,"47016",94,77,77,1,0,"IUCL",4
47,"47051",351,269,256,5,13,"IUCL",15
9,"9430",18,15,15,0,0,"IUCL",2
9,"9235",179,148,142,1,6,"IUCL",4
40,"40036",531,440,424,10,16,"IUCL",11
9,"9388",32,25,24,2,1,"IUCL",1
34,"34242",97,81,79,6,2,"IUCL",1
9,"9022",83,58,58,2,0,"IUCL",3
47,"47008",26,17,17,0,0,"IUCL",2
40,"40132",75,50,50,1,0,"IUCL",1
40,"40006",23,20,20,0,0,"IUCL",2
9,"9378",42,26,26,0,0,"IUCL",2
9,"9030",135,97,97,2,0,"IUCL",6
47,"47210",396,324,321,5,3,"IUCL",11
47,"47167",258,230,229,3,1,"IUCL",6
9,"9200",54,35,35,2,0,"IUCL",2
34,"34062",175,126,124,3,2,"IUCL",4
47,"47006",196,151,146,1,5,"IUCL",17
9,"9304",197,168,165,1,3,"IUCL",6
40,"40007",86,70,69,0,1,"IUCL",1
9,"9363",1047,798,792,9,6,"IUCL",21
9,"9444",81,54,52,1,2,"IUCL",0
40,"40101",770,584,577,16,7,"IUCL",37
40,"40195",946,722,707,13,15,"IUCL",29
47,"47117",306,231,228,4,3,"IUCL",13
9,"9105",111,85,81,2,4,"IUCL",9
49,"49240",237,190,186,1,4,"IUCL",8
47,"47010",11275,8800,8701,163,99,"IUCL",645
9,"9314",113,89,88,4,1,"IUCL",5
9,"9346",95,83,83,1,0,"IUCL",4
49,"49269",241,171,170,5,1,"IUCL",5
9,"9134",237,164,159,7,5,"IUCL",14
34,"34205",70,55,55,1,0,"IUCL",1
47,"47098",607,496,492,9,4,"IUCL",28
9,"9122",93,71,71,4,0,"IUCL",3
47,"47118",159,122,122,2,0,"IUCL",9
9,"9377",658,509,505,11,4,"IUCL",15
34,"34031",29,26,26,0,0,"IUCL",0
9,"9432",212,161,158,1,3,"IUCL",6
49,"49029",675,553,542,6,11,"IUCL",16
40,"40105",60,51,51,1,0,"IUCL",1
9,"9347",136,113,109,5,4,"IUCL",4
47,"47190",103,87,87,7,0,"IUCL",3
47,"47028",31,21,20,0,1,"IUCL",0
34,"34221",190,143,143,3,0,"IUCL",3
34,"34901",1233,955,946,14,9,"IUCL",31
34,"34071",186,160,160,1,0,"IUCL",6
40,"40041",1035,819,799,14,20,"IUCL",31
9,"9038",123,92,92,0,0,"IUCL",3
9,"9225",95,61,61,3,0,"IUCL",2
9,"9091",746,556,550,8,6,"IUCL",21
47,"47023",2863,2278,2258,38,20,"IUCL",133
40,"40208",828,650,638,7,12,"IUCL",16
9,"9173",135,116,116,1,0,"IUCL",1
40,"40118",59,44,43,1,1,"IUCL",4
34,"34093",101,74,74,1,0,"IUCL",1
40,"40094",375,286,284,4,2,"IUCL",19
49,"49220",161,122,118,5,4,"IUCL",0
47,"47221",115,102,102,0,0,"IUCL",2
40,"40058",368,306,304,1,2,"IUCL",3
49,"49235",486,344,340,6,4,"IUCL",22
9,"9466",151,111,110,1,1,"IUCL",1
9,"9410",3181,2079,2049,48,30,"IUCL",159
49,"49137",179,149,147,2,2,"IUCL",2
34,"34236",176,134,134,1,0,"IUCL",2
34,"34086",105,89,89,1,0,"IUCL",5
49,"49216",175,144,142,3,2,"IUCL",5
9,"9110",95,68,68,1,0,"IUCL",0
49,"49260",814,653,644,6,9,"IUCL",27
34,"34072",189,169,166,2,3,"IUCL",7
47,"47065",898,762,752,9,10,"IUCL",9
9,"9243",87,66,64,2,2,"IUCL",10
47,"47121",590,495,490,4,5,"IUCL",30
40,"40140",100,74,73,1,1,"IUCL",3
9,"9172",129,110,109,2,1,"IUCL",10
40,"40093",88,77,72,0,5,"IUCL",6
9,"9183",58,47,46,1,1,"IUCL",1
34,"34088",219,179,177,4,2,"IUCL",6
9,"9184",4,4,4,0,0,"IUCL",1
40,"40173",148,121,120,3,1,"IUCL",15
34,"34048",72,58,56,3,2,"IUCL",5
49,"49034",467,363,359,3,4,"IUCL",12
34,"34224",53,42,41,0,1,"IUCL",1
40,"40126",96,80,78,0,2,"IUCL",4
34,"34102",226,187,185,3,2,"IUCL",6
49,"49007",387,289,289,4,0,"IUCL",9
34,"34225",4837,3650,3580,73,70,"IUCL",349
47,"47049",94,71,71,1,0,"IUCL",5
49,"49084",306,234,234,8,0,"IUCL",19
47,"47058",199,157,157,3,0,"IUCL",5
9,"9139",104,84,80,3,4,"IUCL",3
9,"9311",70,51,51,0,0,"IUCL",7
49,"49185",171,140,140,3,0,"IUCL",2
9,"9406",242,193,193,2,0,"IUCL",15
49,"49141",397,289,286,7,3,"IUCL",15
40,"40219",635,519,505,7,14,"IUCL",18
34,"34132",128,103,102,2,1,"IUCL",5
40,"40203",814,643,631,14,12,"IUCL",45
9,"9338",220,173,168,5,5,"IUCL",5
34,"34036",211,159,157,0,2,"IUCL",5
47,"47182",1371,991,982,12,9,"IUCL",0
9,"9400",340,253,249,4,4,"IUCL",13
47,"47041",166,135,133,2,2,"IUCL",4
34,"34155",142,118,117,3,1,"IUCL",2
9,"9294",123,96,93,1,3,"IUCL",6
49,"49171",704,568,561,6,7,"IUCL",16
34,"34091",136,105,103,1,2,"IUCL",6
34,"34037",345,256,253,4,3,"IUCL",12
47,"47077",291,232,232,1,0,"IUCL",4
47,"47095",41,36,36,3,0,"IUCL",3
49,"49250",1330,998,985,19,13,"IUCL",24
9,"9275",202,140,139,5,1,"IUCL",6
9,"9115",96,71,70,4,1,"IUCL",1
9,"9340",72,41,41,0,0,"IUCL",1
47,"47068",41,28,28,0,0,"IUCL",0
9,"9085",486,348,339,8,9,"IUCL",16
49,"49069",414,276,270,1,6,"IUCL",5
9,"9442",385,295,289,4,6,"IUCL",13
40,"40904",332,271,268,5,3,"IUCL",0
47,"47178",190,162,161,1,1,"IUCL",9
40,"40051",54,41,40,0,1,"IUCL",0
49,"49086",127,108,107,1,1,"IUCL",7
49,"49159",289,225,225,2,0,"IUCL",8
40,"40020",200,155,149,2,6,"IUCL",10
34,"34067",142,88,88,3,0,"IUCL",10
9,"9208",252,192,192,6,0,"IUCL",2
49,"49087",581,358,356,3,2,"IUCL",5
9,"9021",62,33,33,1,0,"IUCL",2
34,"34152",142,114,109,1,5,"IUCL",5
34,"34025",54,42,42,0,0,"IUCL",2
47,"47152",94,65,65,0,0,"IUCL",5
40,"40138",2195,1758,1725,18,33,"IUCL",98
9,"9144",61,51,50,0,1,"IUCL",0
9,"9174",859,645,639,11,6,"IUCL",34
9,"9060",171,142,142,0,0,"IUCL",1
40,"40016",63,45,45,0,0,"IUCL",4
40,"40111",72,57,55,0,2,"IUCL",0
9,"9246",662,469,457,3,12,"IUCL",29
9,"9018",24688,17880,17508,345,372,"IUCL",1159
40,"40059",124,104,104,2,0,"IUCL",2
9,"9451",244,208,202,1,6,"IUCL",22
49,"49032",369,295,291,0,4,"IUCL",4
9,"9074",735,558,547,7,11,"IUCL",38
49,"49244",48,30,30,1,0,"IUCL",0
9,"9360",37,29,29,0,0,"IUCL",0
9,"9224",172,125,125,3,0,"IUCL",5
49,"49177",298,199,196,6,3,"IUCL",8
40,"40024",920,712,704,7,8,"IUCL",26
49,"49176",757,502,501,5,1,"IUCL",6
40,"40181",4413,3439,3361,43,78,"IUCL",287
47,"47027",2680,2059,2024,23,35,"IUCL",148
9,"9167",60,49,49,2,0,"IUCL",1
9,"9211",1489,1137,1121,28,16,"IUCL",27
34,"34169",431,331,329,5,2,"IUCL",17
49,"49133",344,247,243,3,4,"IUCL",2
49,"49016",272,216,211,1,5,"IUCL",3
40,"40086",738,628,619,12,9,"IUCL",18
9,"9315",362,267,265,9,2,"IUCL",19
40,"40228",539,446,437,2,9,"IUCL",8
40,"40198",30,21,20,0,1,"IUCL",0
47,"47128",57,52,48,1,4,"IUCL",2
47,"47045",839,636,632,3,4,"IUCL",77
34,"34045",84,75,74,1,1,"IUCL",1
40,"40073",425,371,367,3,4,"IUCL",6
49,"49178",679,469,461,9,8,"IUCL",10
49,"49271",221,178,176,2,2,"IUCL",4
49,"49179",401,285,284,2,1,"IUCL",6
49,"49044",80,63,63,3,0,"IUCL",3
49,"49031",150,128,127,2,1,"IUCL",1
47,"47138",259,198,195,3,3,"IUCL",11
49,"49242",503,421,410,5,11,"IUCL",19
9,"9113",503,397,390,7,7,"IUCL",34
47,"47164",391,326,320,3,6,"IUCL",7
47,"47196",43,29,29,0,0,"IUCL",1
34,"34103",105,92,92,5,0,"IUCL",3
34,"34053",222,177,172,4,5,"IUCL",3
9,"9068",25,19,19,2,0,"IUCL",3
40,"40032",394,293,288,6,5,"IUCL",7
49,"49009",430,309,309,0,0,"IUCL",3
47,"47093",865,658,642,11,16,"IUCL",47
9,"9019",153,104,104,1,0,"IUCL",4
34,"34196",94,74,73,1,1,"IUCL",0
9,"9124",1598,1151,1129,19,22,"IUCL",34
47,"47132",45,40,40,0,0,"IUCL",1
49,"49006",168,124,122,2,2,"IUCL",9
47,"47004",1261,1047,1031,11,16,"IUCL",24
9,"9334",52,40,39,1,1,"IUCL",1
49,"49048",162,119,119,2,0,"IUCL",4
47,"47129",954,744,731,4,13,"IUCL",27
9,"9066",62,44,42,0,2,"IUCL",1
9,"9437",298,249,247,5,2,"IUCL",4
9,"9256",369,254,252,2,2,"IUCL",15
49,"49158",229,174,172,0,2,"IUCL",9
34,"34134",61,49,47,0,2,"IUCL",2
34,"34237",645,506,498,6,8,"IUCL",14
47,"47157",544,462,458,9,4,"IUCL",22
9,"9017",96,76,74,0,2,"IUCL",2
47,"47175",6562,5041,4957,62,84,"IUCL",475
47,"47149",44,22,20,0,2,"IUCL",2
34,"34131",67,57,56,0,1,"IUCL",0
9,"9079",49,44,44,1,0,"IUCL",0
40,"40156",361,268,264,5,4,"IUCL",17
49,"49183",111,87,87,2,0,"IUCL",1
47,"47130",105,86,85,2,1,"IUCL",5
49,"49050",558,382,375,3,7,"IUCL",4
40,"40031",515,410,404,7,6,"IUCL",31
47,"47031",203,149,149,0,0,"IUCL",1
9,"9373",485,332,331,5,1,"IUCL",7
9,"9450",31,26,26,1,0,"IUCL",0
47,"47005",578,467,455,5,12,"IUCL",28
49,"49008",535,395,394,7,1,"IUCL",13
9,"9417",43,38,38,0,0,"IUCL",0
9,"9903",3299,2373,2349,45,24,"IUCL",98
47,"47212",386,327,325,1,2,"IUCL",8
49,"49103",435,354,350,6,4,"IUCL",7
9,"9143",24,14,14,1,0,"IUCL",0
9,"9057",155,125,124,0,1,"IUCL",18
9,"9082",49,41,41,0,0,"IUCL",0
49,"49170",111,87,85,1,2,"IUCL",1
34,"34089",173,128,125,5,3,"IUCL",11
34,"34238",348,289,287,4,2,"IUCL",10
47,"47150",338,273,271,2,2,"IUCL",18
49,"49023",1033,736,728,10,8,"IUCL",31
49,"49252",370,310,305,6,5,"IUCL",9
9,"9394",805,594,588,13,6,"IUCL",28
40,"40071",52,45,45,4,0,"IUCL",5
49,"49186",273,205,204,1,1,"IUCL",11
47,"47094",154,129,127,0,2,"IUCL",12
40,"40018",102,88,87,2,1,"IUCL",1
47,"47142",172,132,131,2,1,"IUCL",4
9,"9006",68,40,39,1,1,"IUCL",2
47,"47059",108,77,76,1,1,"IUCL",6
49,"49163",235,167,167,0,0,"IUCL",11
40,"40164",188,145,142,0,3,"IUCL",4
47,"47090",2511,1907,1880,23,27,"IUCL",110
34,"34215",166,146,145,1,1,"IUCL",8
49,"49223",770,606,601,8,5,"IUCL",10
9,"9202",26,24,24,1,0,"IUCL",0
47,"47042",63,50,49,3,1,"IUCL",1
40,"40113",438,330,322,4,8,"IUCL",16
34,"34122",80,65,62,2,3,"IUCL",1
9,"9084",200,147,147,4,0,"IUCL",10
9,"9906",1199,912,903,12,9,"IUCL",25
49,"49039",333,243,240,6,3,"IUCL",13
49,"49130",218,159,156,3,3,"IUCL",8
49,"49056",324,251,247,3,4,"IUCL",8
40,"40131",48,41,41,0,0,"IUCL",2
47,"47181",170,128,128,1,0,"IUCL",10
49,"49251",191,157,154,7,3,"IUCL",5
49,"49174",131,97,97,1,0,"IUCL",4
47,"47026",59,46,46,1,0,"IUCL",0
49,"49030",96,78,77,2,1,"IUCL",2
9,"9221",446,343,340,7,3,"IUCL",20
47,"47116",426,363,358,0,5,"IUCL",16
9,"9003",205,156,154,4,2,"IUCL",14
9,"9483",226,173,171,4,2,"IUCL",5
47,"47125",55,46,46,0,0,"IUCL",2
49,"49083",67,48,48,1,0,"IUCL",1
9,"9440",105,80,80,0,0,"IUCL",1
49,"49113",188,166,161,2,5,"IUCL",4
9,"9353",62,51,51,2,0,"IUCL",2
40,"40062",54,44,44,0,0,"IUCL",0
47,"47173",862,683,675,5,8,"IUCL",58
49,"49259",121,88,87,1,1,"IUCL",2
47,"47021",84,61,61,2,0,"IUCL",7
47,"47156",182,155,148,0,7,"IUCL",6
49,"49191",305,248,246,2,2,"IUCL",7
49,"49091",278,197,197,4,0,"IUCL",16
9,"9062",52,33,32,1,1,"IUCL",0
9,"9375",42,30,30,1,0,"IUCL",0
9,"9445",46,31,31,1,0,"IUCL",1
34,"34137",31,24,24,3,0,"IUCL",0
47,"47047",217,171,170,5,1,"IUCL",7
9,"9141",607,503,481,10,22,"IUCL",15
34,"34106",121,100,99,2,1,"IUCL",6
49,"49105",158,135,133,2,2,"IUCL",1
9,"9482",33,31,30,1,1,"IUCL",2
34,"34110",96,83,81,2,2,"IUCL",5
34,"34206",952,796,780,9,16,"IUCL",17
9,"9392",51,42,42,1,0,"IUCL",14
49,"49164",158,120,114,2,6,"IUCL",1
47,"47081",57,44,44,1,0,"IUCL",1
9,"9433",67,46,45,2,1,"IUCL",3
9,"9075",126,102,101,1,1,"IUCL",2
9,"9095",88,75,73,2,2,"IUCL",1
34,"34220",145,125,123,0,2,"IUCL",3
47,"47109",183,151,151,4,0,"IUCL",3
49,"49071",822,558,557,5,1,"IUCL",11
34,"34046",45,35,34,0,1,"IUCL",2
49,"49093",308,248,245,5,3,"IUCL",2
47,"47146",236,196,195,4,1,"IUCL",20
34,"34161",23,20,20,0,0,"IUCL",0
40,"40026",114,98,97,2,1,"IUCL",19
9,"9273",55,47,47,0,0,"IUCL",2
40,"40178",104,80,79,1,1,"IUCL",2
40,"40100",303,241,231,5,10,"IUCL",9
40,"40193",231,188,185,6,3,"IUCL",6
9,"9090",61,50,50,0,0,"IUCL",2
34,"34213",67,50,50,0,0,"IUCL",3
9,"9201",33,22,22,2,0,"IUCL",0
9,"9218",384,285,279,8,6,"IUCL",25
47,"47229",235,161,161,1,0,"IUCL",7
34,"34077",283,219,216,3,3,"IUCL",20
34,"34120",65774,49378,48608,830,770,"IUCL",3365
9,"9472",58,46,46,0,0,"IUCL",2
47,"47213",122,99,99,1,0,"IUCL",1
47,"47100",169,146,144,1,2,"IUCL",4
40,"40029",50,43,42,0,1,"IUCL",1
9,"9094",49,39,39,0,0,"IUCL",3
47,"47219",46,36,36,1,0,"IUCL",2
40,"40013",67,56,54,1,2,"IUCL",0
49,"49010",338,271,265,4,6,"IUCL",22
49,"49203",345,294,292,4,2,"IUCL",5
49,"49092",160,123,123,2,0,"IUCL",0
49,"49078",209,173,172,1,1,"IUCL",5
9,"9391",383,290,284,7,6,"IUCL",8
40,"40091",140,111,109,1,2,"IUCL",3
34,"34160",154,119,116,0,3,"IUCL",8
9,"9043",215,151,151,1,0,"IUCL",3
9,"9366",99,67,65,1,2,"IUCL",5
40,"40046",99,81,78,2,3,"IUCL",4
40,"40218",111,81,80,1,1,"IUCL",1
34,"34074",764,610,597,11,13,"IUCL",11
47,"47228",481,385,383,3,2,"IUCL",11
9,"9905",432,313,309,1,4,"IUCL",25
47,"47140",132,109,108,1,1,"IUCL",3
34,"34049",421,313,311,4,2,"IUCL",17
49,"49228",64,56,56,0,0,"IUCL",0
40,"40192",179,151,150,1,1,"IUCL",7
49,"49127",2227,1617,1587,48,30,"IUCL",86
40,"40110",391,303,302,6,1,"IUCL",18
49,"49013",300,230,228,6,2,"IUCL",9
9,"9405",143,106,105,2,1,"IUCL",2
34,"34055",288,215,212,4,3,"IUCL",5
9,"9213",370,260,260,5,0,"IUCL",9
9,"9268",108,78,78,0,0,"IUCL",7
47,"47218",983,776,767,7,9,"IUCL",97
47,"47002",30,27,27,1,0,"IUCL",0
47,"47225",89,67,66,0,1,"IUCL",0
40,"40143",97,72,72,0,0,"IUCL",8
47,"47158",906,716,710,10,6,"IUCL",38
40,"40095",507,437,425,2,12,"IUCL",12
47,"47204",275,221,219,3,2,"IUCL",2
9,"9485",62,56,56,0,0,"IUCL",1
34,"34113",35,28,27,0,1,"IUCL",1
47,"47160",466,368,364,5,4,"IUCL",25
47,"47074",155,125,124,0,1,"IUCL",10
9,"9050",77,52,52,0,0,"IUCL",4
49,"49236",86,64,64,0,0,"IUCL",0
40,"40221",50,41,41,0,0,"IUCL",4
9,"9247",28,21,20,0,1,"IUCL",0
47,"47127",150,110,108,0,2,"IUCL",9
34,"34246",78,64,64,0,0,"IUCL",0
40,"40080",68,53,52,0,1,"IUCL",0
49,"49157",177,140,140,0,0,"IUCL",4
9,"9428",124,107,107,1,0,"IUCL",1
34,"34104",274,224,224,4,0,"IUCL",4
47,"47025",127,103,103,0,0,"IUCL",1
49,"49122",701,542,534,7,8,"IUCL",32
47,"47214",1517,1215,1191,34,24,"IUCL",52
40,"40161",38,28,28,0,0,"IUCL",1
9,"9206",65,56,55,2,1,"IUCL",2
47,"47133",2382,1861,1841,30,20,"IUCL",165
40,"40206",179,136,134,0,2,"IUCL",19
49,"49208",428,266,261,1,5,"IUCL",1
9,"9131",412,332,321,6,11,"IUCL",21
9,"9265",44,36,35,2,1,"IUCL",2
49,"49097",97,55,55,1,0,"IUCL",1
34,"34127",118,77,74,1,3,"IUCL",3
47,"47223",172,147,147,6,0,"IUCL",8
9,"9117",82,59,59,1,0,"IUCL",1
9,"9419",82,61,61,0,0,"IUCL",0
47,"47054",673,545,541,8,4,"IUCL",18
9,"9108",399,287,283,5,4,"IUCL",29
49,"49117",505,376,369,5,7,"IUCL",18
40,"40225",1152,931,918,10,13,"IUCL",45
40,"40121",325,266,262,3,4,"IUCL",12
9,"9361",134,99,98,0,1,"IUCL",3
34,"34003",167,132,130,7,2,"IUCL",4
34,"34147",192,139,137,1,2,"IUCL",4
34,"34035",122,98,96,0,2,"IUCL",3
34,"34076",632,524,520,13,4,"IUCL",14
47,"47230",318,266,259,2,7,"IUCL",10
47,"47123",456,356,353,10,3,"IUCL",27
9,"9076",24,15,15,0,0,"IUCL",0
9,"9063",223,191,189,1,2,"IUCL",5
34,"34156",56,48,48,2,0,"IUCL",0
34,"34223",233,175,175,2,0,"IUCL",6
34,"34175",101,80,80,2,0,"IUCL",2
9,"9431",124,102,100,2,2,"IUCL",1
47,"47148",475,389,384,2,5,"IUCL",20
9,"9154",150,107,107,3,0,"IUCL",4
49,"49024",736,551,544,16,7,"IUCL",13
40,"40134",769,628,620,19,8,"IUCL",18
47,"47171",453,371,368,10,3,"IUCL",9
9,"9280",34,23,23,0,0,"IUCL",0
9,"9037",122,91,90,2,1,"IUCL",7
49,"49247",507,340,332,6,8,"IUCL",5
9,"9416",61,44,44,0,0,"IUCL",6
49,"49205",429,313,309,10,4,"IUCL",7
49,"49256",289,229,224,3,5,"IUCL",4
49,"49257",277,180,179,0,1,"IUCL",3
34,"34070",182,138,137,1,1,"IUCL",3
40,"40092",132,100,100,0,0,"IUCL",3
40,"40045",123,102,102,0,0,"IUCL",7
34,"34189",59,47,47,3,0,"IUCL",2
47,"47192",99,84,84,0,0,"IUCL",5
49,"49224",161,114,112,2,2,"IUCL",6
49,"49266",83,69,69,1,0,"IUCL",1
49,"49134",203,142,142,4,0,"IUCL",10
49,"49241",275,225,221,2,4,"IUCL",5
9,"9381",38,30,30,0,0,"IUCL",0
49,"49261",1579,1161,1145,36,16,"IUCL",93
49,"49238",289,233,231,3,2,"IUCL",9
40,"40234",441,363,355,3,8,"IUCL",11
40,"40215",109,94,91,0,3,"IUCL",3
9,"9908",509,328,321,5,7,"IUCL",10
47,"47203",69,57,56,0,1,"IUCL",0
47,"47033",209,170,168,3,2,"IUCL",5
9,"9267",135,118,118,3,0,"IUCL",1
47,"47177",112,83,79,1,4,"IUCL",6
40,"40158",24,18,17,0,1,"IUCL",0
9,"9307",119,89,88,1,1,"IUCL",2
47,"47143",146,108,107,0,1,"IUCL",3
9,"9429",64,44,44,2,0,"IUCL",2
40,"40166",275,247,246,2,1,"IUCL",6
47,"47166",276,226,223,0,3,"IUCL",9
47,"47011",600,493,489,4,4,"IUCL",13
9,"9441",70,59,59,2,0,"IUCL",0
47,"47062",185,153,153,5,0,"IUCL",6
9,"9178",61,48,48,0,0,"IUCL",2
9,"9302",116,87,87,3,0,"IUCL",2
9,"9337",126,88,87,1,1,"IUCL",3
9,"9262",158,139,137,7,2,"IUCL",1
34,"34063",102,92,91,2,1,"IUCL",0
40,"40008",44,37,36,0,1,"IUCL",1
40,"40003",144,123,120,1,3,"IUCL",2
47,"47007",3453,2616,2580,42,36,"IUCL",186
34,"34042",299,249,246,5,3,"IUCL",6
9,"9012",105,77,74,3,3,"IUCL",4
49,"49038",114,81,80,0,1,"IUCL",1
34,"34107",91,67,67,4,0,"IUCL",1
49,"49043",304,256,256,6,0,"IUCL",22
47,"47104",2917,2391,2357,31,34,"IUCL",96
9,"9059",137122,103909,102353,2008,1556,"IUCL",5600
34,"34082",96,79,75,0,4,"IUCL",1
9,"9162",122,94,93,1,1,"IUCL",5
9,"9104",56,49,49,0,0,"IUCL",2
9,"9321",1760,1338,1327,20,11,"IUCL",34
49,"49100",322,236,233,1,3,"IUCL",10
47,"47217",1812,1395,1377,20,18,"IUCL",130
49,"49003",896,650,647,11,3,"IUCL",25
47,"47145",658,482,473,7,9,"IUCL",39
9,"9072",272,210,209,4,1,"IUCL",7
40,"40004",534,428,420,3,8,"IUCL",21
34,"34056",2147,1557,1535,21,22,"IUCL",75
49,"49273",217,144,144,0,0,"IUCL",2
9,"9112",115,80,80,4,0,"IUCL",1
34,"34060",150,123,123,2,0,"IUCL",5
9,"9027",54,48,43,0,5,"IUCL",4
34,"34190",59,42,42,4,0,"IUCL",3
47,"47180",96,82,81,0,1,"IUCL",2
49,"49119",245,194,191,2,3,"IUCL",17
47,"47044",325,257,252,1,5,"IUCL",17
34,"34029",832,696,683,11,13,"IUCL",26
49,"49146",330,268,265,6,3,"IUCL",17
40,"40135",298,247,242,4,5,"IUCL",8
47,"47043",330,267,264,1,3,"IUCL",8
40,"40212",29,22,20,0,2,"IUCL",1
34,"34211",202,175,170,1,5,"IUCL",1
34,"34903",240,161,160,2,1,"IUCL",0
40,"40180",319,259,255,3,4,"IUCL",6
49,"49124",279,203,202,2,1,"IUCL",18
34,"34231",273,209,206,2,3,"IUCL",4
47,"47086",4062,3162,3120,37,42,"IUCL",127
47,"47106",63,52,52,0,0,"IUCL",1
40,"40196",44,34,34,3,0,"IUCL",1
49,"49058",341,262,259,4,3,"IUCL",8
47,"47071",406,333,329,6,4,"IUCL",21
9,"9409",138,105,102,0,3,"IUCL",8
40,"40009",49,41,41,0,0,"IUCL",0
49,"49064",566,372,368,8,4,"IUCL",17
9,"9438",547,440,433,9,7,"IUCL",23
49,"49154",147,104,102,1,2,"IUCL",0
34,"34079",1391,1088,1077,17,11,"IUCL",51
9,"9396",152,113,113,0,0,"IUCL",4
40,"40033",61,48,47,3,1,"IUCL",7
49,"49020",323,275,272,1,3,"IUCL",20
40,"40155",3083,2333,2280,73,53,"IUCL",174
49,"49081",1457,1166,1141,17,25,"IUCL",52
9,"9182",104,81,81,1,0,"IUCL",2
49,"49026",236,189,184,3,5,"IUCL",4
47,"47154",168,144,144,7,0,"IUCL",7
47,"47089",184,139,138,1,1,"IUCL",2
34,"34109",62,47,46,0,1,"IUCL",1
40,"40146",270,222,222,0,0,"IUCL",9
40,"40207",724,551,540,9,11,"IUCL",45
40,"40186",50,33,33,0,0,"IUCL",1
9,"9411",174,104,103,1,1,"IUCL",7
9,"9424",42,35,34,1,1,"IUCL",0
40,"40075",182,149,146,4,3,"IUCL",6
49,"49207",279,206,204,2,2,"IUCL",8
9,"9270",180,147,143,2,4,"IUCL",1
47,"47163",315,253,250,2,3,"IUCL",24
9,"9023",993,771,765,22,6,"IUCL",60
34,"34126",284,226,224,3,2,"IUCL",8
49,"49160",54,35,34,3,1,"IUCL",2
47,"47183",150,125,122,0,3,"IUCL",0
40,"40055",41,32,31,0,1,"IUCL",3
9,"9238",1026,612,601,6,11,"IUCL",21
34,"34069",2330,1769,1749,25,20,"IUCL",142
34,"34047",1814,1435,1413,24,22,"IUCL",36
47,"47165",7036,5328,5258,67,70,"IUCL",256
47,"47018",33,30,28,2,2,"IUCL",2
34,"34015",45,40,40,0,0,"IUCL",0
49,"49077",210,146,144,1,2,"IUCL",4
47,"47186",251279,193705,191693,2746,2012,"IUCL",15956
9,"9317",17,15,15,0,0,"IUCL",1
49,"49120",79,58,58,1,0,"IUCL",0
9,"9251",417,292,288,3,4,"IUCL",10
40,"40149",563,446,434,9,12,"IUCL",13
47,"47208",56,45,43,1,2,"IUCL",2
9,"9288",98,80,80,1,0,"IUCL",2
49,"49015",259,213,208,2,5,"IUCL",2
9,"9029",186,138,137,4,1,"IUCL",6
9,"9460",187,144,142,2,2,"IUCL",5
9,"9199",97,75,74,0,1,"IUCL",2
37,"37020",449,371,365,7,6,"IU CyL",11
37,"37241",172,135,134,1,1,"IU CyL",0
37,"37297",441,376,369,1,7,"IU CyL",5
37,"37102",430,323,322,1,1,"IU CyL",7
37,"37287",341,247,246,1,1,"IU CyL",4
37,"37215",156,106,106,1,0,"IU CyL",4
37,"37336",54,49,47,0,2,"IU CyL",7
37,"37109",191,142,141,1,1,"IU CyL",3
37,"37131",200,150,148,1,2,"IU CyL",5
37,"37099",104,64,62,1,2,"IU CyL",0
37,"37004",31,23,23,0,0,"IU CyL",0
37,"37229",144,108,108,0,0,"IU CyL",2
37,"37223",127,102,101,1,1,"IU CyL",1
37,"37265",224,192,191,1,1,"IU CyL",2
37,"37204",286,216,214,0,2,"IU CyL",12
37,"37364",893,653,644,10,9,"IU CyL",20
37,"37096",235,199,197,3,2,"IU CyL",4
37,"37057",223,190,190,0,0,"IU CyL",2
37,"37143",410,342,338,3,4,"IU CyL",9
37,"37245",357,273,272,2,1,"IU CyL",5
37,"37260",175,122,122,1,0,"IU CyL",4
37,"37378",118,85,85,3,0,"IU CyL",3
37,"37055",132,112,107,2,5,"IU CyL",3
37,"37341",52,32,32,0,0,"IU CyL",0
37,"37236",163,123,119,4,4,"IU CyL",1
37,"37253",137,115,115,1,0,"IU CyL",6
37,"37280",84,64,64,0,0,"IU CyL",3
37,"37329",40,36,36,2,0,"IU CyL",1
37,"37050",71,48,48,1,0,"IU CyL",0
37,"37301",78,58,58,0,0,"IU CyL",0
37,"37060",229,179,173,2,6,"IU CyL",5
37,"37281",36,34,33,0,1,"IU CyL",4
37,"37160",644,474,464,4,10,"IU CyL",13
37,"37135",1234,972,961,8,11,"IU CyL",43
37,"37331",234,161,161,3,0,"IU CyL",2
37,"37332",78,52,49,0,3,"IU CyL",0
37,"37373",793,591,589,4,2,"IU CyL",31
37,"37177",310,242,241,1,1,"IU CyL",9
37,"37272",162,121,120,1,1,"IU CyL",3
37,"37061",254,187,185,0,2,"IU CyL",6
37,"37248",160,130,130,1,0,"IU CyL",3
37,"37138",212,174,169,5,5,"IU CyL",6
37,"37151",150,125,121,1,4,"IU CyL",1
37,"37090",59,54,50,0,4,"IU CyL",6
37,"37147",201,153,151,1,2,"IU CyL",4
37,"37322",2501,1692,1676,32,16,"IU CyL",113
37,"37116",75,55,55,1,0,"IU CyL",1
37,"37353",142,119,119,2,0,"IU CyL",1
37,"37132",398,317,311,3,6,"IU CyL",4
37,"37333",247,160,154,2,6,"IU CyL",4
37,"37212",123,95,92,1,3,"IU CyL",15
37,"37214",134,94,94,4,0,"IU CyL",8
37,"37307",177,132,130,0,2,"IU CyL",0
37,"37125",243,184,180,3,4,"IU CyL",12
37,"37003",134,103,102,0,1,"IU CyL",1
37,"37187",567,449,448,3,1,"IU CyL",7
37,"37239",235,208,201,2,7,"IU CyL",24
37,"37126",36,26,26,0,0,"IU CyL",1
37,"37310",154,115,115,1,0,"IU CyL",5
37,"37036",74,54,52,0,2,"IU CyL",0
37,"37207",287,211,208,2,3,"IU CyL",5
37,"37335",432,347,346,0,1,"IU CyL",3
37,"37108",108,95,95,1,0,"IU CyL",3
37,"37271",393,324,318,5,6,"IU CyL",6
37,"37380",57,45,44,1,1,"IU CyL",5
37,"37344",259,212,211,5,1,"IU CyL",5
37,"37080",242,187,185,1,2,"IU CyL",8
37,"37284",334,256,254,1,2,"IU CyL",17
37,"37168",470,357,353,1,4,"IU CyL",7
37,"37213",97,77,76,0,1,"IU CyL",3
37,"37037",130,100,99,0,1,"IU CyL",1
37,"37360",252,194,194,1,0,"IU CyL",12
37,"37303",207,158,152,3,6,"IU CyL",10
37,"37092",1403,1034,1022,12,12,"IU CyL",40
37,"37005",92,65,65,0,0,"IU CyL",1
37,"37086",105,75,72,3,3,"IU CyL",1
37,"37277",58,39,38,1,1,"IU CyL",1
37,"37106",289,199,196,2,3,"IU CyL",5
37,"37181",301,232,230,2,2,"IU CyL",2
37,"37340",155,121,121,0,0,"IU CyL",1
37,"37077",293,262,258,3,4,"IU CyL",6
37,"37316",792,565,559,7,6,"IU CyL",15
37,"37319",138,94,94,1,0,"IU CyL",3
37,"37327",191,148,148,9,0,"IU CyL",7
37,"37028",175,130,125,1,5,"IU CyL",0
37,"37200",192,142,142,0,0,"IU CyL",3
37,"37197",101,72,70,1,2,"IU CyL",2
37,"37321",169,144,144,1,0,"IU CyL",9
37,"37158",262,181,179,0,2,"IU CyL",18
37,"37325",102,77,77,0,0,"IU CyL",0
37,"37346",264,211,210,1,1,"IU CyL",1
37,"37351",305,261,258,2,3,"IU CyL",5
37,"37167",164,140,132,6,8,"IU CyL",4
37,"37300",586,430,421,6,9,"IU CyL",20
37,"37355",187,142,140,2,2,"IU CyL",0
37,"37338",82,69,67,0,2,"IU CyL",4
37,"37188",198,164,160,7,4,"IU CyL",0
37,"37209",376,258,253,4,5,"IU CyL",7
37,"37363",121,100,99,0,1,"IU CyL",2
37,"37163",44,36,36,0,0,"IU CyL",0
37,"37359",194,155,152,1,3,"IU CyL",7
37,"37031",399,308,307,5,1,"IU CyL",8
37,"37191",127,86,85,1,1,"IU CyL",0
37,"37059",132,110,110,2,0,"IU CyL",1
37,"37171",437,362,358,4,4,"IU CyL",9
37,"37122",210,175,174,3,1,"IU CyL",6
37,"37217",60,49,48,1,1,"IU CyL",5
37,"37268",113,78,77,1,1,"IU CyL",3
37,"37196",93,74,70,1,4,"IU CyL",0
37,"37012",155,124,120,1,4,"IU CyL",0
37,"37083",190,165,165,3,0,"IU CyL",6
37,"37065",346,269,267,0,2,"IU CyL",4
37,"37040",431,362,362,4,0,"IU CyL",6
37,"37056",56,47,47,0,0,"IU CyL",0
37,"37240",781,552,540,10,12,"IU CyL",25
37,"37101",185,143,141,1,2,"IU CyL",3
37,"37357",283,216,214,0,2,"IU CyL",1
37,"37315",99,77,75,3,2,"IU CyL",2
37,"37366",46,35,34,0,1,"IU CyL",0
37,"37369",143,103,103,0,0,"IU CyL",2
37,"37110",112,89,88,1,1,"IU CyL",9
37,"37169",196,137,136,1,1,"IU CyL",2
37,"37185",602,452,448,8,4,"IU CyL",12
37,"37041",80,53,53,1,0,"IU CyL",0
37,"37314",79,61,61,3,0,"IU CyL",2
37,"37246",5430,4363,4315,63,48,"IU CyL",137
37,"37078",888,728,714,9,14,"IU CyL",51
37,"37062",92,73,73,1,0,"IU CyL",2
37,"37140",731,490,475,0,15,"IU CyL",13
37,"37294",11233,8282,8167,139,115,"IU CyL",444
37,"37286",231,166,160,2,6,"IU CyL",15
37,"37068",386,291,287,6,4,"IU CyL",6
37,"37199",157,115,113,0,2,"IU CyL",4
37,"37129",247,198,198,4,0,"IU CyL",12
37,"37225",119,101,95,3,6,"IU CyL",6
37,"37044",461,363,360,1,3,"IU CyL",10
37,"37027",242,196,192,2,4,"IU CyL",10
37,"37302",337,230,229,5,1,"IU CyL",3
37,"37222",124,92,92,2,0,"IU CyL",5
37,"37011",131,87,86,2,1,"IU CyL",3
37,"37019",157,114,113,0,1,"IU CyL",0
37,"37134",250,192,189,1,3,"IU CyL",2
37,"37247",216,176,173,1,3,"IU CyL",2
37,"37255",58,47,47,3,0,"IU CyL",0
37,"37356",90,66,66,1,0,"IU CyL",1
37,"37008",4316,3518,3457,31,61,"IU CyL",91
37,"37024",101,80,80,0,0,"IU CyL",0
37,"37298",206,144,140,1,4,"IU CyL",1
37,"37104",32,24,23,0,1,"IU CyL",0
37,"37231",285,227,225,6,2,"IU CyL",10
37,"37251",137,98,93,3,5,"IU CyL",1
37,"37192",362,229,221,3,8,"IU CyL",25
37,"37032",530,410,409,4,1,"IU CyL",11
37,"37306",316,194,192,1,2,"IU CyL",5
37,"37381",153,114,109,3,5,"IU CyL",4
37,"37328",218,155,149,2,6,"IU CyL",4
37,"37127",229,183,182,3,1,"IU CyL",16
37,"37009",225,189,185,2,4,"IU CyL",6
37,"37046",11929,8847,8683,146,164,"IU CyL",528
37,"37123",206,166,165,1,1,"IU CyL",0
37,"37205",235,199,195,5,4,"IU CyL",15
37,"37323",549,427,418,6,9,"IU CyL",11
37,"37349",136,105,104,2,1,"IU CyL",3
37,"37292",101,84,84,2,0,"IU CyL",1
37,"37273",115,83,83,1,0,"IU CyL",0
37,"37354",4828,3589,3522,76,67,"IU CyL",183
37,"37091",181,127,119,0,8,"IU CyL",0
37,"37058",68,44,44,0,0,"IU CyL",2
37,"37194",271,206,204,0,2,"IU CyL",7
37,"37154",156,130,125,1,5,"IU CyL",1
37,"37098",355,267,265,1,2,"IU CyL",12
37,"37174",1150,942,922,3,20,"IU CyL",25
37,"37275",136,98,98,0,0,"IU CyL",4
37,"37263",361,277,275,1,2,"IU CyL",7
37,"37243",123,89,88,1,1,"IU CyL",0
37,"37149",78,69,69,0,0,"IU CyL",3
37,"37262",81,66,64,2,2,"IU CyL",1
37,"37007",467,368,363,6,5,"IU CyL",4
37,"37150",43,36,34,0,2,"IU CyL",0
37,"37113",439,365,365,7,0,"IU CyL",4
37,"37183",425,321,316,3,5,"IU CyL",0
37,"37221",465,360,353,0,7,"IU CyL",8
37,"37179",230,194,191,3,3,"IU CyL",9
37,"37267",210,169,165,0,4,"IU CyL",5
37,"37195",48,32,32,0,0,"IU CyL",7
37,"37172",857,584,580,5,4,"IU CyL",21
37,"37089",74,54,54,2,0,"IU CyL",1
37,"37159",100,77,75,0,2,"IU CyL",0
37,"37235",226,194,192,0,2,"IU CyL",7
37,"37352",199,150,142,0,8,"IU CyL",5
37,"37348",114,91,90,1,1,"IU CyL",0
37,"37189",139,90,90,1,0,"IU CyL",3
37,"37051",90,72,72,0,0,"IU CyL",1
37,"37118",141,115,114,3,1,"IU CyL",2
37,"37025",264,217,216,1,1,"IU CyL",4
37,"37193",432,310,309,5,1,"IU CyL",6
37,"37115",135,107,101,2,6,"IU CyL",0
37,"37165",27,20,20,1,0,"IU CyL",2
37,"37070",538,428,427,12,1,"IU CyL",11
37,"37021",86,70,68,2,2,"IU CyL",0
37,"37285",457,349,347,2,2,"IU CyL",15
37,"37039",325,241,236,0,5,"IU CyL",5
37,"37311",251,210,209,8,1,"IU CyL",3
37,"37324",415,338,334,2,4,"IU CyL",2
37,"37358",163,143,139,0,4,"IU CyL",3
37,"37282",238,169,168,3,1,"IU CyL",3
37,"37120",107,88,87,0,1,"IU CyL",3
37,"37320",96,70,70,0,0,"IU CyL",2
37,"37162",232,184,182,4,2,"IU CyL",1
37,"37334",86,50,49,0,1,"IU CyL",0
37,"37018",128,89,87,0,2,"IU CyL",5
37,"37379",167,128,125,4,3,"IU CyL",5
37,"37121",557,458,451,8,7,"IU CyL",16
37,"37054",273,230,229,2,1,"IU CyL",16
37,"37318",225,167,165,0,2,"IU CyL",4
37,"37279",780,580,571,6,9,"IU CyL",19
37,"37103",483,354,351,1,3,"IU CyL",17
37,"37141",158,140,139,1,1,"IU CyL",6
37,"37063",94,77,76,3,1,"IU CyL",4
37,"37291",261,215,214,1,1,"IU CyL",7
37,"37234",376,275,272,2,3,"IU CyL",6
37,"37142",613,436,434,7,2,"IU CyL",16
37,"37088",208,173,172,4,1,"IU CyL",2
37,"37304",190,144,142,1,2,"IU CyL",1
37,"37156",4319,3280,3233,28,47,"IU CyL",104
37,"37100",89,77,76,4,1,"IU CyL",1
37,"37208",92,59,58,0,1,"IU CyL",3
37,"37244",132,97,95,5,2,"IU CyL",8
37,"37368",18,15,15,1,0,"IU CyL",0
37,"37015",248,169,168,0,1,"IU CyL",6
37,"37180",69,46,46,0,0,"IU CyL",2
37,"37218",81,51,51,1,0,"IU CyL",0
37,"37085",4334,3254,3201,69,53,"IU CyL",157
37,"37288",252,194,194,3,0,"IU CyL",4
37,"37293",131,108,106,5,2,"IU CyL",1
37,"37017",249,200,199,0,1,"IU CyL",4
37,"37029",226,181,178,4,3,"IU CyL",3
37,"37119",115,98,98,0,0,"IU CyL",4
37,"37257",52,43,43,0,0,"IU CyL",2
37,"37013",133,93,85,5,8,"IU CyL",0
37,"37216",300,270,266,2,4,"IU CyL",9
37,"37117",1320,948,937,16,11,"IU CyL",51
37,"37372",145,109,109,0,0,"IU CyL",2
37,"37010",963,705,690,5,15,"IU CyL",30
37,"37047",178,111,111,0,0,"IU CyL",2
37,"37312",278,232,229,1,3,"IU CyL",4
37,"37112",162,124,124,3,0,"IU CyL",5
37,"37178",107,88,87,0,1,"IU CyL",1
37,"37006",157,108,107,0,1,"IU CyL",3
37,"37190",235,195,193,1,2,"IU CyL",2
37,"37107",11407,8234,8116,123,118,"IU CyL",494
37,"37299",237,167,165,2,2,"IU CyL",1
37,"37238",102,77,76,0,1,"IU CyL",5
37,"37155",81,57,57,0,0,"IU CyL",3
37,"37276",188,136,135,0,1,"IU CyL",4
37,"37270",201,159,158,0,1,"IU CyL",6
37,"37186",109,88,88,2,0,"IU CyL",2
37,"37375",764,636,627,19,9,"IU CyL",17
37,"37371",285,190,190,2,0,"IU CyL",1
37,"37296",385,311,308,3,3,"IU CyL",2
37,"37309",42,26,25,3,1,"IU CyL",0
37,"37079",77,64,63,1,1,"IU CyL",2
37,"37347",481,374,371,6,3,"IU CyL",29
37,"37133",108,79,77,0,2,"IU CyL",0
37,"37361",91,67,62,0,5,"IU CyL",0
37,"37073",583,458,455,7,3,"IU CyL",8
37,"37097",47,39,39,1,0,"IU CyL",1
37,"37001",224,182,181,0,1,"IU CyL",1
37,"37130",177,153,153,2,0,"IU CyL",2
37,"37072",184,157,155,5,2,"IU CyL",3
37,"37252",127,92,92,0,0,"IU CyL",5
37,"37365",172,152,149,2,3,"IU CyL",2
37,"37256",245,191,190,2,1,"IU CyL",9
37,"37074",172,136,135,1,1,"IU CyL",1
37,"37139",199,167,163,1,4,"IU CyL",7
37,"37269",475,383,382,2,1,"IU CyL",17
37,"37033",86,64,63,1,1,"IU CyL",2
37,"37002",152,90,89,1,1,"IU CyL",4
37,"37173",1643,1298,1285,26,13,"IU CyL",37
37,"37026",201,176,176,3,0,"IU CyL",6
37,"37035",220,176,173,1,3,"IU CyL",1
37,"37266",83,54,54,1,0,"IU CyL",2
37,"37045",27,21,21,0,0,"IU CyL",0
37,"37330",338,272,270,3,2,"IU CyL",8
37,"37261",255,191,191,2,0,"IU CyL",3
37,"37081",1000,807,800,5,7,"IU CyL",18
37,"37278",736,538,529,7,9,"IU CyL",37
37,"37206",100,81,80,1,1,"IU CyL",0
37,"37382",202,172,171,3,1,"IU CyL",1
37,"37182",92,72,72,2,0,"IU CyL",3
37,"37184",381,295,289,5,6,"IU CyL",5
37,"37071",90,80,80,1,0,"IU CyL",1
37,"37176",136,103,100,1,3,"IU CyL",0
37,"37342",252,216,211,3,5,"IU CyL",12
37,"37250",405,277,274,1,3,"IU CyL",4
37,"37317",323,281,278,3,3,"IU CyL",10
37,"37313",581,440,435,7,5,"IU CyL",12
37,"37146",135,117,117,1,0,"IU CyL",1
37,"37170",1571,1122,1107,22,15,"IU CyL",19
37,"37259",44,32,32,3,0,"IU CyL",1
37,"37016",539,424,420,8,4,"IU CyL",25
37,"37283",130,104,104,1,0,"IU CyL",5
37,"37343",56,42,40,0,2,"IU CyL",1
37,"37198",212,176,173,2,3,"IU CyL",10
37,"37164",280,217,213,9,4,"IU CyL",14
37,"37233",59,46,45,1,1,"IU CyL",5
37,"37237",330,250,242,1,8,"IU CyL",4
37,"37161",157,118,116,1,2,"IU CyL",1
37,"37052",274,213,212,1,1,"IU CyL",2
37,"37226",167,129,127,1,2,"IU CyL",0
37,"37367",218,182,176,0,6,"IU CyL",1
37,"37376",2373,1720,1700,23,20,"IU CyL",61
37,"37289",265,211,209,0,2,"IU CyL",8
37,"37144",398,302,301,3,1,"IU CyL",5
37,"37305",206,153,152,4,1,"IU CyL",8
37,"37232",412,374,373,1,1,"IU CyL",9
37,"37049",163,119,119,0,0,"IU CyL",1
37,"37152",474,357,351,2,6,"IU CyL",14
37,"37157",94,65,65,0,0,"IU CyL",0
37,"37274",123032,90819,89629,1506,1190,"IU CyL",4315
37,"37290",143,111,110,1,1,"IU CyL",5
37,"37219",197,121,120,0,1,"IU CyL",9
37,"37128",261,211,210,2,1,"IU CyL",8
37,"37203",174,148,148,0,0,"IU CyL",10
37,"37202",938,742,726,25,16,"IU CyL",36
37,"37339",345,280,279,3,1,"IU CyL",6
37,"37145",276,217,214,0,3,"IU CyL",2
37,"37249",48,36,36,0,0,"IU CyL",0
37,"37082",869,663,650,3,13,"IU CyL",31
37,"37264",78,52,52,0,0,"IU CyL",0
37,"37201",263,196,196,5,0,"IU CyL",10
37,"37148",451,344,343,3,1,"IU CyL",7
37,"37374",1204,1018,1004,9,14,"IU CyL",40
37,"37242",99,73,72,0,1,"IU CyL",0
37,"37345",179,156,156,2,0,"IU CyL",0
37,"37254",189,168,164,1,4,"IU CyL",4
37,"37114",92,75,74,1,1,"IU CyL",1
37,"37023",1040,819,811,11,8,"IU CyL",45
37,"37230",221,173,171,0,2,"IU CyL",9
37,"37228",388,339,336,2,3,"IU CyL",9
37,"37022",287,237,232,0,5,"IU CyL",3
37,"37350",452,368,364,5,4,"IU CyL",5
37,"37166",206,172,171,3,1,"IU CyL",4
37,"37042",45,35,35,1,0,"IU CyL",0
37,"37014",1198,862,852,8,10,"IU CyL",34
37,"37224",216,190,186,5,4,"IU CyL",2
37,"37030",90,71,70,4,1,"IU CyL",3
37,"37087",779,590,586,18,4,"IU CyL",40
37,"37211",223,169,169,1,0,"IU CyL",6
37,"37136",702,494,485,4,9,"IU CyL",5
37,"37377",268,209,208,1,1,"IU CyL",4
37,"37069",952,737,723,12,14,"IU CyL",24
37,"37258",206,151,149,2,2,"IU CyL",1
37,"37370",345,261,260,1,1,"IU CyL",4
37,"37175",408,319,311,6,8,"IU CyL",5
37,"37067",2938,2306,2267,47,39,"IU CyL",163
37,"37137",114,87,87,3,0,"IU CyL",0
37,"37337",140,122,121,0,1,"IU CyL",0
37,"37034",91,72,72,0,0,"IU CyL",2
37,"37038",808,671,664,6,7,"IU CyL",30
37,"37362",4333,3276,3238,65,38,"IU CyL",147
37,"37124",227,181,179,3,2,"IU CyL",4
24,"24199",432,280,278,2,2,"IUCL",15
5,"5243",101,69,68,0,1,"IUCL",1
5,"5072",91,72,72,1,0,"IUCL",2
5,"5222",155,132,132,1,0,"IUCL",8
24,"24104",291,198,196,3,2,"IUCL",10
5,"5156",260,188,185,0,3,"IUCL",12
24,"24203",109,73,73,0,0,"IUCL",2
5,"5209",104,78,78,0,0,"IUCL",0
5,"5105",349,275,272,12,3,"IUCL",18
24,"24065",2104,1512,1488,27,24,"IUCL",88
5,"5023",177,160,158,1,2,"IUCL",0
5,"5266",112,92,89,0,3,"IUCL",0
5,"5199",48,39,39,0,0,"IUCL",1
24,"24134",3682,2636,2588,44,48,"IUCL",219
5,"5025",108,86,86,2,0,"IUCL",1
5,"5263",175,133,131,0,2,"IUCL",2
5,"5219",45,33,33,0,0,"IUCL",0
5,"5093",431,330,329,1,1,"IUCL",31
5,"5104",35,29,29,0,0,"IUCL",0
24,"24056",3200,2368,2332,53,36,"IUCL",100
5,"5200",56,43,42,0,1,"IUCL",1
24,"24042",79,68,68,0,0,"IUCL",2
24,"24011",244,131,129,0,2,"IUCL",1
5,"5115",590,458,450,1,8,"IUCL",17
5,"5038",131,88,84,0,4,"IUCL",1
24,"24095",293,211,208,1,3,"IUCL",2
24,"24188",3830,2987,2928,51,59,"IUCL",95
5,"5096",74,56,56,0,0,"IUCL",2
5,"5166",235,181,178,1,3,"IUCL",3
5,"5140",112,100,99,1,1,"IUCL",0
24,"24120",379,258,256,3,2,"IUCL",9
24,"24183",900,571,567,10,4,"IUCL",19
24,"24197",784,570,564,7,6,"IUCL",16
5,"5189",478,361,360,3,1,"IUCL",25
24,"24082",877,698,690,13,8,"IUCL",25
24,"24023",272,196,193,6,3,"IUCL",11
5,"5046",44,39,38,1,1,"IUCL",1
24,"24153",253,201,199,4,2,"IUCL",10
24,"24213",162,134,133,1,1,"IUCL",4
5,"5259",132,115,114,1,1,"IUCL",4
5,"5183",165,142,140,0,2,"IUCL",2
24,"24047",856,623,612,5,11,"IUCL",17
24,"24214",716,518,509,4,9,"IUCL",24
24,"24102",701,536,530,3,6,"IUCL",10
24,"24136",596,465,463,12,2,"IUCL",1
24,"24038",3206,2439,2399,37,40,"IUCL",124
5,"5110",710,584,581,1,3,"IUCL",15
5,"5211",484,406,405,3,1,"IUCL",11
24,"24131",813,583,580,9,3,"IUCL",13
24,"24129",125,88,86,5,2,"IUCL",2
24,"24107",316,208,206,1,2,"IUCL",3
5,"5252",70,52,51,0,1,"IUCL",1
24,"24077",237,205,199,2,6,"IUCL",3
24,"24068",500,357,349,3,8,"IUCL",20
5,"5030",43,39,39,0,0,"IUCL",8
5,"5151",100,86,82,1,4,"IUCL",2
24,"24064",1532,1128,1107,17,21,"IUCL",45
5,"5017",87,69,68,1,1,"IUCL",4
5,"5152",737,618,609,5,9,"IUCL",4
5,"5022",1649,1335,1328,7,7,"IUCL",34
24,"24033",214,157,152,3,5,"IUCL",2
5,"5133",62,49,49,0,0,"IUCL",0
24,"24162",1631,1214,1195,33,19,"IUCL",87
24,"24016",544,323,322,4,1,"IUCL",5
24,"24230",450,333,327,4,6,"IUCL",16
5,"5101",297,224,222,4,2,"IUCL",7
5,"5079",68,52,50,1,2,"IUCL",1
5,"5067",85,68,68,0,0,"IUCL",3
24,"24171",417,231,231,2,0,"IUCL",10
5,"5062",213,188,184,3,4,"IUCL",6
5,"5060",127,108,105,1,3,"IUCL",0
5,"5131",118,86,86,3,0,"IUCL",2
24,"24010",8550,6242,6111,100,131,"IUCL",203
24,"24158",333,223,223,6,0,"IUCL",5
5,"5258",123,105,104,1,1,"IUCL",8
5,"5122",156,124,124,0,0,"IUCL",2
5,"5169",241,218,218,0,0,"IUCL",3
24,"24175",1760,1324,1303,29,21,"IUCL",56
24,"24091",704,502,496,8,6,"IUCL",29
5,"5240",3351,2472,2428,22,44,"IUCL",116
24,"24146",284,223,221,0,2,"IUCL",3
5,"5016",6231,4831,4763,56,68,"IUCL",171
5,"5056",94,78,73,1,5,"IUCL",2
24,"24170",2006,1410,1394,14,16,"IUCL",79
24,"24130",468,343,337,6,6,"IUCL",9
5,"5196",69,54,54,2,0,"IUCL",1
24,"24167",813,509,509,8,0,"IUCL",20
24,"24223",2793,2121,2113,63,8,"IUCL",86
5,"5048",131,112,111,0,1,"IUCL",2
24,"24217",144,108,107,2,1,"IUCL",0
5,"5233",246,212,212,2,0,"IUCL",7
24,"24150",262,182,182,3,0,"IUCL",11
5,"5089",500,390,375,3,15,"IUCL",4
24,"24052",178,113,111,0,2,"IUCL",5
24,"24227",1664,1159,1148,16,11,"IUCL",50
5,"5218",148,123,117,1,6,"IUCL",18
24,"24103",330,180,177,0,3,"IUCL",4
24,"24137",1226,920,904,16,16,"IUCL",54
24,"24066",561,440,437,5,3,"IUCL",14
24,"24219",580,435,431,10,4,"IUCL",25
24,"24050",113,91,90,0,1,"IUCL",1
5,"5053",94,73,71,0,2,"IUCL",0
5,"5119",41,31,31,0,0,"IUCL",0
24,"24222",13915,9939,9751,304,188,"IUCL",654
24,"24028",426,350,331,3,19,"IUCL",15
24,"24037",429,282,277,4,5,"IUCL",14
5,"5208",55,45,45,0,0,"IUCL",2
5,"5204",654,521,516,7,5,"IUCL",28
5,"5162",107,71,71,0,0,"IUCL",1
5,"5192",96,78,77,1,1,"IUCL",3
24,"24110",1291,914,904,16,10,"IUCL",70
5,"5239",215,171,170,2,1,"IUCL",7
5,"5092",172,142,139,0,3,"IUCL",5
5,"5045",104,82,82,0,0,"IUCL",1
24,"24115",54654,38629,38010,716,619,"IUCL",2428
5,"5044",301,217,217,3,0,"IUCL",0
24,"24172",491,234,232,2,2,"IUCL",9
5,"5221",398,298,297,10,1,"IUCL",32
5,"5125",60,52,52,0,0,"IUCL",0
5,"5128",361,288,280,3,8,"IUCL",28
24,"24067",700,453,447,4,6,"IUCL",11
24,"24006",521,384,378,4,6,"IUCL",15
24,"24086",323,245,243,1,2,"IUCL",2
5,"5176",237,193,190,4,3,"IUCL",11
5,"5149",128,97,97,1,0,"IUCL",0
24,"24025",331,237,237,5,0,"IUCL",2
24,"24101",465,274,266,5,8,"IUCL",12
5,"5155",60,44,44,1,0,"IUCL",1
5,"5085",35,34,34,0,0,"IUCL",0
24,"24060",660,382,382,0,0,"IUCL",17
5,"5242",692,556,553,18,3,"IUCL",12
5,"5902",319,262,262,0,0,"IUCL",9
24,"24031",220,180,176,3,4,"IUCL",11
24,"24046",1002,704,696,20,8,"IUCL",14
24,"24179",331,219,214,4,5,"IUCL",6
24,"24154",1068,803,795,6,8,"IUCL",34
5,"5168",3682,2846,2801,43,45,"IUCL",69
24,"24185",512,414,402,3,12,"IUCL",18
24,"24165",400,284,279,4,5,"IUCL",7
24,"24191",112,88,88,1,0,"IUCL",3
5,"5262",378,308,307,2,1,"IUCL",12
5,"5143",81,61,61,0,0,"IUCL",1
5,"5236",147,101,101,0,0,"IUCL",7
24,"24210",532,329,328,2,1,"IUCL",14
5,"5179",231,206,204,2,2,"IUCL",1
24,"24032",134,102,101,1,1,"IUCL",2
5,"5205",78,59,58,0,1,"IUCL",0
24,"24166",1521,1137,1112,27,25,"IUCL",33
24,"24020",480,326,324,9,2,"IUCL",7
5,"5088",34,26,26,0,0,"IUCL",1
5,"5144",92,66,66,4,0,"IUCL",1
24,"24159",1901,1492,1477,11,15,"IUCL",29
24,"24024",717,501,498,10,3,"IUCL",20
5,"5112",125,88,87,0,1,"IUCL",7
5,"5005",199,170,169,1,1,"IUCL",10
5,"5147",174,141,135,4,6,"IUCL",1
5,"5008",244,200,196,1,4,"IUCL",3
5,"5175",190,149,149,2,0,"IUCL",1
5,"5235",136,120,119,2,1,"IUCL",2
5,"5178",392,310,304,2,6,"IUCL",6
5,"5251",80,58,58,0,0,"IUCL",0
5,"5257",153,105,104,0,1,"IUCL",7
5,"5052",102,91,91,0,0,"IUCL",1
24,"24043",144,77,77,0,0,"IUCL",2
5,"5181",39,26,26,0,0,"IUCL",0
5,"5160",339,290,286,2,4,"IUCL",4
24,"24206",1831,1362,1341,13,21,"IUCL",51
24,"24181",1652,1303,1288,12,15,"IUCL",22
5,"5193",224,197,197,2,0,"IUCL",4
5,"5042",156,126,126,0,0,"IUCL",0
24,"24174",525,393,387,6,6,"IUCL",1
24,"24041",602,403,396,3,7,"IUCL",15
5,"5029",132,102,102,0,0,"IUCL",2
24,"24202",8677,5486,5377,103,109,"IUCL",736
5,"5232",106,84,80,1,4,"IUCL",6
24,"24027",1184,853,837,7,16,"IUCL",68
5,"5107",74,54,53,0,1,"IUCL",1
5,"5118",91,66,66,0,0,"IUCL",1
24,"24144",781,551,541,13,10,"IUCL",17
5,"5065",498,424,422,7,2,"IUCL",13
5,"5084",81,70,69,0,1,"IUCL",5
5,"5249",101,73,71,1,2,"IUCL",11
5,"5021",2044,1592,1557,37,35,"IUCL",91
24,"24087",670,513,513,12,0,"IUCL",6
24,"24901",994,698,686,8,12,"IUCL",48
5,"5015",100,78,78,0,0,"IUCL",3
24,"24051",484,375,368,2,7,"IUCL",11
24,"24141",101,83,80,6,3,"IUCL",3
24,"24226",223,154,153,1,1,"IUCL",2
5,"5226",92,67,67,0,0,"IUCL",0
5,"5063",48,39,39,2,0,"IUCL",0
24,"24198",644,423,417,7,6,"IUCL",15
24,"24178",83,67,67,2,0,"IUCL",0
24,"24090",366,225,224,2,1,"IUCL",8
5,"5229",90,79,77,2,2,"IUCL",4
5,"5246",68,57,56,1,1,"IUCL",1
24,"24119",742,524,510,15,14,"IUCL",25
24,"24055",747,557,549,11,8,"IUCL",17
24,"24040",494,369,366,6,3,"IUCL",18
5,"5136",110,75,75,3,0,"IUCL",0
24,"24004",535,391,390,0,1,"IUCL",10
24,"24177",477,325,319,3,6,"IUCL",5
24,"24164",397,215,213,2,2,"IUCL",9
5,"5095",301,253,250,2,3,"IUCL",19
5,"5191",124,98,98,2,0,"IUCL",22
5,"5083",155,120,113,1,7,"IUCL",0
24,"24168",493,397,391,7,6,"IUCL",10
24,"24009",362,188,184,0,4,"IUCL",13
5,"5099",555,472,466,4,6,"IUCL",2
24,"24112",323,230,228,0,2,"IUCL",7
24,"24209",3016,2006,1984,20,22,"IUCL",91
24,"24207",320,274,272,5,2,"IUCL",16
5,"5142",113,97,96,0,1,"IUCL",3
24,"24080",228,165,164,0,1,"IUCL",3
24,"24081",143,111,110,1,1,"IUCL",2
5,"5139",74,62,59,2,3,"IUCL",0
5,"5214",46,23,23,1,0,"IUCL",1
24,"24169",3205,2317,2282,33,35,"IUCL",159
5,"5002",1996,1497,1476,15,21,"IUCL",84
24,"24123",835,559,555,6,4,"IUCL",27
24,"24036",321,190,188,0,2,"IUCL",7
24,"24187",881,664,659,14,5,"IUCL",27
5,"5256",119,101,100,0,1,"IUCL",6
24,"24002",271,213,213,2,0,"IUCL",5
24,"24124",419,286,282,0,4,"IUCL",6
5,"5081",44,36,36,0,0,"IUCL",1
5,"5070",41,33,33,0,0,"IUCL",5
5,"5035",105,87,87,2,0,"IUCL",3
5,"5182",862,673,668,2,5,"IUCL",29
5,"5225",423,346,342,8,4,"IUCL",9
5,"5075",100,76,76,1,0,"IUCL",1
5,"5010",173,141,134,2,7,"IUCL",2
5,"5186",1670,1306,1287,9,19,"IUCL",58
5,"5224",104,90,90,0,0,"IUCL",4
5,"5120",38,28,28,1,0,"IUCL",0
24,"24145",656,420,420,11,0,"IUCL",10
24,"24022",364,231,230,2,1,"IUCL",13
24,"24149",149,120,118,3,2,"IUCL",2
24,"24099",199,164,162,0,2,"IUCL",6
24,"24218",476,344,340,11,4,"IUCL",6
24,"24205",995,719,712,9,7,"IUCL",22
5,"5061",264,222,214,5,8,"IUCL",14
24,"24176",336,267,261,3,6,"IUCL",0
24,"24097",244,161,156,4,5,"IUCL",7
5,"5073",319,258,254,7,4,"IUCL",9
5,"5170",63,50,50,0,0,"IUCL",4
5,"5121",250,181,178,1,3,"IUCL",9
5,"5201",557,444,437,2,7,"IUCL",15
24,"24008",9789,7277,7179,110,98,"IUCL",348
5,"5238",815,649,641,6,8,"IUCL",39
5,"5097",525,378,373,4,5,"IUCL",16
24,"24015",2391,1812,1782,20,30,"IUCL",40
24,"24157",2580,2046,2000,39,46,"IUCL",100
5,"5024",268,205,201,2,4,"IUCL",11
5,"5231",172,142,141,0,1,"IUCL",2
5,"5135",440,363,360,0,3,"IUCL",9
24,"24026",1304,1015,1001,17,14,"IUCL",36
24,"24044",176,138,136,2,2,"IUCL",4
24,"24062",151,107,107,0,0,"IUCL",5
24,"24059",956,592,585,9,7,"IUCL",25
24,"24127",327,258,255,1,3,"IUCL",7
5,"5078",128,112,111,2,1,"IUCL",4
24,"24007",798,582,566,2,16,"IUCL",47
24,"24106",340,229,228,6,1,"IUCL",11
5,"5903",171,118,118,0,0,"IUCL",4
5,"5014",5559,4197,4101,53,96,"IUCL",218
24,"24098",1251,837,819,19,18,"IUCL",58
5,"5254",212,186,185,2,1,"IUCL",9
24,"24094",1466,1023,1006,24,17,"IUCL",57
24,"24005",437,308,305,3,3,"IUCL",3
5,"5905",253,200,198,1,2,"IUCL",37
24,"24073",521,385,382,4,3,"IUCL",16
5,"5267",102,78,77,1,1,"IUCL",9
5,"5041",1051,840,827,13,13,"IUCL",33
5,"5159",287,216,216,0,0,"IUCL",4
5,"5194",147,131,130,4,1,"IUCL",5
24,"24148",1759,1362,1348,29,14,"IUCL",55
5,"5195",241,168,164,0,4,"IUCL",13
5,"5018",27,24,24,0,0,"IUCL",3
24,"24155",524,428,420,6,8,"IUCL",9
24,"24108",421,316,314,6,2,"IUCL",8
5,"5213",117,94,88,0,6,"IUCL",1
24,"24001",241,148,147,3,1,"IUCL",3
24,"24084",182,133,132,1,1,"IUCL",2
24,"24096",145,96,93,0,3,"IUCL",0
24,"24019",367,293,287,5,6,"IUCL",24
24,"24078",426,323,316,0,7,"IUCL",11
24,"24089",106265,77385,76124,1666,1261,"IUCL",3850
5,"5154",46,35,35,0,0,"IUCL",0
5,"5228",193,146,145,1,1,"IUCL",2
5,"5184",288,225,224,0,1,"IUCL",15
24,"24142",24843,17695,17371,409,324,"IUCL",1056
24,"24014",7677,5352,5289,75,63,"IUCL",290
5,"5904",149,99,97,0,2,"IUCL",13
24,"24161",307,231,228,1,3,"IUCL",6
24,"24189",5410,3630,3572,83,58,"IUCL",166
24,"24063",453,323,322,2,1,"IUCL",10
5,"5013",890,746,739,4,7,"IUCL",36
24,"24116",451,297,294,5,3,"IUCL",13
5,"5126",78,70,70,0,0,"IUCL",1
24,"24092",883,707,702,6,5,"IUCL",19
5,"5054",1282,979,965,5,14,"IUCL",66
24,"24105",1460,1095,1075,27,20,"IUCL",60
24,"24224",665,490,484,8,6,"IUCL",9
24,"24143",515,376,373,6,3,"IUCL",14
5,"5103",84,68,68,3,0,"IUCL",6
5,"5158",410,333,331,2,2,"IUCL",12
5,"5265",87,68,66,2,2,"IUCL",0
5,"5187",1833,1385,1361,16,24,"IUCL",94
24,"24018",180,150,149,1,1,"IUCL",10
5,"5244",66,45,45,0,0,"IUCL",2
24,"24012",291,196,194,2,2,"IUCL",9
5,"5261",48,32,31,0,1,"IUCL",0
5,"5165",386,292,280,7,12,"IUCL",16
5,"5161",638,525,522,0,3,"IUCL",8
5,"5245",344,285,284,5,1,"IUCL",8
5,"5185",109,89,89,1,0,"IUCL",2
24,"24902",375,292,289,1,3,"IUCL",9
5,"5215",186,138,136,1,2,"IUCL",7
24,"24071",1060,808,797,6,11,"IUCL",20
5,"5172",147,122,122,0,0,"IUCL",1
24,"24216",782,582,574,3,8,"IUCL",9
5,"5220",386,316,312,0,4,"IUCL",13
5,"5037",296,213,212,0,1,"IUCL",3
5,"5034",17,13,13,0,0,"IUCL",0
5,"5132",1040,770,753,2,17,"IUCL",24
24,"24030",4397,3272,3229,54,43,"IUCL",244
24,"24017",630,476,468,11,8,"IUCL",15
5,"5027",290,233,230,2,3,"IUCL",10
24,"24100",760,563,553,14,10,"IUCL",26
24,"24049",1528,1144,1124,22,20,"IUCL",49
5,"5167",274,230,224,6,6,"IUCL",6
5,"5109",438,359,351,5,8,"IUCL",24
5,"5124",134,111,109,1,2,"IUCL",0
24,"24076",1210,917,907,26,10,"IUCL",54
5,"5039",58,48,48,0,0,"IUCL",0
5,"5116",131,114,109,0,5,"IUCL",2
24,"24053",503,338,332,3,6,"IUCL",7
5,"5094",158,124,124,3,0,"IUCL",2
5,"5134",47,37,37,0,0,"IUCL",0
24,"24221",850,635,619,6,16,"IUCL",23
5,"5066",480,397,392,5,5,"IUCL",49
5,"5100",307,245,245,2,0,"IUCL",16
24,"24190",183,134,131,1,3,"IUCL",1
24,"24201",1123,790,777,14,13,"IUCL",25
5,"5188",55,47,47,0,0,"IUCL",0
5,"5059",112,91,88,1,3,"IUCL",6
24,"24133",379,279,279,0,0,"IUCL",10
5,"5207",743,595,591,1,4,"IUCL",10
24,"24212",1105,856,846,14,10,"IUCL",37
24,"24182",448,339,333,9,6,"IUCL",14
24,"24058",224,166,163,1,3,"IUCL",2
24,"24156",264,187,186,6,1,"IUCL",4
5,"5230",79,73,73,1,0,"IUCL",3
5,"5019",44095,34409,33934,505,475,"IUCL",1954
5,"5007",126,104,102,0,2,"IUCL",2
24,"24057",1459,1121,1092,16,29,"IUCL",75
24,"24211",291,226,224,3,2,"IUCL",2
5,"5164",34,24,24,0,0,"IUCL",0
24,"24160",741,545,539,17,6,"IUCL",27
5,"5210",105,83,82,2,1,"IUCL",3
24,"24093",388,262,258,1,4,"IUCL",5
5,"5148",34,27,27,0,0,"IUCL",0
5,"5051",194,165,154,0,11,"IUCL",7
24,"24034",3434,2524,2481,37,43,"IUCL",204
24,"24225",1089,798,784,15,14,"IUCL",32
5,"5055",649,525,518,3,7,"IUCL",14
5,"5141",99,90,89,0,1,"IUCL",2
5,"5138",326,278,275,2,3,"IUCL",5
24,"24152",481,326,322,5,4,"IUCL",13
5,"5260",114,101,101,1,0,"IUCL",4
5,"5153",112,89,89,5,0,"IUCL",1
5,"5036",136,107,106,0,1,"IUCL",1
5,"5198",80,65,65,1,0,"IUCL",0
24,"24061",1713,1223,1210,34,13,"IUCL",75
5,"5253",95,75,74,0,1,"IUCL",4
24,"24229",473,348,344,8,4,"IUCL",5
5,"5114",1418,1195,1182,9,13,"IUCL",19
5,"5234",58,49,49,0,0,"IUCL",5
5,"5090",72,64,63,1,1,"IUCL",0
24,"24069",53,44,44,0,0,"IUCL",1
5,"5123",90,69,69,3,0,"IUCL",0
24,"24029",840,590,579,11,11,"IUCL",33
5,"5174",81,71,71,1,0,"IUCL",1
24,"24109",1098,672,663,12,9,"IUCL",41
5,"5064",117,94,93,4,1,"IUCL",0
5,"5227",409,307,305,2,2,"IUCL",26
24,"24021",1791,1251,1228,14,23,"IUCL",64
5,"5033",184,159,155,3,4,"IUCL",3
24,"24193",371,254,252,3,2,"IUCL",7
5,"5049",440,335,330,8,5,"IUCL",20
24,"24196",2183,1573,1543,11,30,"IUCL",92
5,"5069",91,79,78,1,1,"IUCL",1
5,"5040",77,59,59,1,0,"IUCL",0
5,"5117",213,183,180,0,3,"IUCL",2
5,"5217",69,54,54,0,0,"IUCL",2
5,"5216",237,195,192,0,3,"IUCL",8
24,"24088",1103,903,885,4,18,"IUCL",17
5,"5076",477,397,385,4,12,"IUCL",20
5,"5082",569,467,462,1,5,"IUCL",21
5,"5086",96,81,81,2,0,"IUCL",1
5,"5157",256,187,183,0,4,"IUCL",4
5,"5080",75,53,53,1,0,"IUCL",1
5,"5127",715,601,596,4,5,"IUCL",17
5,"5077",205,164,160,2,4,"IUCL",6
5,"5190",61,48,48,3,0,"IUCL",0
24,"24151",514,391,387,6,4,"IUCL",11
5,"5173",62,55,55,1,0,"IUCL",0
5,"5026",229,193,192,2,1,"IUCL",22
5,"5087",144,87,87,0,0,"IUCL",2
24,"24070",4434,3199,3136,34,63,"IUCL",372
5,"5106",39,26,26,0,0,"IUCL",0
5,"5130",95,76,76,0,0,"IUCL",3
24,"24054",492,359,351,1,8,"IUCL",4
5,"5264",68,48,48,1,0,"IUCL",1
24,"24039",2157,1738,1727,30,11,"IUCL",45
5,"5901",289,197,196,4,1,"IUCL",18
5,"5113",90,74,74,0,0,"IUCL",2
24,"24122",1424,1001,992,9,9,"IUCL",124
24,"24139",2320,1687,1654,16,33,"IUCL",56
5,"5129",153,98,95,0,3,"IUCL",0
24,"24118",132,96,96,2,0,"IUCL",4
5,"5206",29,23,21,2,2,"IUCL",3
5,"5212",274,202,197,0,5,"IUCL",5
5,"5057",2593,2172,2152,16,20,"IUCL",59
5,"5043",86,68,68,0,0,"IUCL",2
5,"5102",1850,1487,1475,11,12,"IUCL",37
24,"24173",1023,757,747,4,10,"IUCL",19
5,"5108",64,41,41,0,0,"IUCL",2
5,"5001",210,180,176,2,4,"IUCL",6
5,"5180",109,92,91,1,1,"IUCL",0
5,"5171",84,74,73,0,1,"IUCL",2
5,"5074",755,639,638,5,1,"IUCL",17
5,"5247",267,164,164,0,0,"IUCL",4
5,"5163",1762,1400,1380,5,20,"IUCL",62
5,"5058",81,61,59,0,2,"IUCL",0
5,"5197",114,98,98,1,0,"IUCL",3
24,"24074",107,87,87,0,0,"IUCL",4
24,"24114",3441,2322,2304,42,18,"IUCL",191
24,"24163",3706,2760,2714,57,46,"IUCL",153
24,"24180",1196,868,862,22,6,"IUCL",39
5,"5237",198,157,155,3,2,"IUCL",0
24,"24194",327,237,236,5,1,"IUCL",7
5,"5047",4267,3345,3275,34,70,"IUCL",87
24,"24003",725,528,520,8,8,"IUCL",10
24,"24228",732,543,529,4,14,"IUCL",17
24,"24215",169,121,120,1,1,"IUCL",4
24,"24083",1165,831,819,17,12,"IUCL",32
24,"24184",206,111,111,0,0,"IUCL",4
24,"24113",404,318,310,3,8,"IUCL",3
24,"24125",545,374,373,5,1,"IUCL",8
5,"5177",164,134,133,0,1,"IUCL",8
5,"5241",3145,2303,2273,27,30,"IUCL",128
24,"24132",683,440,435,5,5,"IUCL",22
24,"24121",645,511,502,10,9,"IUCL",57
5,"5145",57,41,41,0,0,"IUCL",1
5,"5012",156,134,132,1,2,"IUCL",2
24,"24117",493,376,369,2,7,"IUCL",9
24,"24079",1045,721,710,15,11,"IUCL",34
42,"42014",83,55,55,1,0,"IUCyL",0
42,"42007",143,110,110,2,0,"IUCyL",2
42,"42043",3905,2931,2875,48,56,"IUCyL",165
42,"42184",76,50,49,0,1,"IUCyL",1
42,"42006",166,110,107,3,3,"IUCyL",4
42,"42206",10,9,9,1,0,"IUCyL",4
42,"42125",73,65,64,4,1,"IUCyL",2
42,"42123",172,128,128,3,0,"IUCyL",4
42,"42216",27,22,22,0,0,"IUCyL",0
42,"42105",54,45,45,0,0,"IUCyL",1
42,"42163",53,41,41,0,0,"IUCyL",3
42,"42141",124,90,87,1,3,"IUCyL",1
42,"42029",164,114,113,1,1,"IUCyL",2
42,"42054",20,14,14,0,0,"IUCyL",2
42,"42162",2482,1871,1850,23,21,"IUCyL",70
42,"42182",62,53,53,2,0,"IUCyL",1
42,"42166",68,49,48,1,1,"IUCyL",2
42,"42063",69,53,53,4,0,"IUCyL",2
42,"42025",1305,964,945,15,19,"IUCyL",35
42,"42152",96,71,69,1,2,"IUCyL",2
42,"42028",62,45,43,2,2,"IUCyL",1
42,"42031",31,19,19,0,0,"IUCyL",1
42,"42115",72,48,48,0,0,"IUCyL",0
42,"42088",69,56,56,1,0,"IUCyL",0
42,"42158",112,79,79,6,0,"IUCyL",0
42,"42075",91,71,70,1,1,"IUCyL",0
42,"42069",1591,1122,1114,33,8,"IUCyL",61
42,"42209",155,114,110,2,4,"IUCyL",4
42,"42053",27,26,25,1,1,"IUCyL",0
42,"42118",26,20,20,0,0,"IUCyL",0
42,"42190",102,71,71,3,0,"IUCyL",5
42,"42111",310,228,222,2,6,"IUCyL",11
42,"42200",98,70,67,1,3,"IUCyL",1
42,"42140",17,10,10,0,0,"IUCyL",0
42,"42048",78,63,62,3,1,"IUCyL",3
42,"42058",129,103,101,1,2,"IUCyL",2
42,"42205",99,70,70,0,0,"IUCyL",2
42,"42096",316,218,215,9,3,"IUCyL",10
42,"42021",101,70,70,1,0,"IUCyL",1
42,"42121",77,56,56,1,0,"IUCyL",3
42,"42177",78,64,62,4,2,"IUCyL",3
42,"42116",63,50,48,3,2,"IUCyL",2
42,"42011",22,14,14,1,0,"IUCyL",1
42,"42173",28809,20268,19748,632,520,"IUCyL",1112
42,"42153",19,16,16,0,0,"IUCyL",1
42,"42148",14,14,14,0,0,"IUCyL",0
42,"42218",86,59,59,0,0,"IUCyL",2
42,"42194",200,165,163,4,2,"IUCyL",5
42,"42051",23,12,11,0,1,"IUCyL",0
42,"42145",140,111,111,2,0,"IUCyL",5
42,"42192",43,36,36,2,0,"IUCyL",1
42,"42057",197,133,133,6,0,"IUCyL",3
42,"42033",54,48,48,0,0,"IUCyL",0
42,"42149",404,292,286,12,6,"IUCyL",13
42,"42103",626,487,481,3,6,"IUCyL",11
42,"42139",22,18,17,0,1,"IUCyL",0
42,"42078",1110,829,817,15,12,"IUCyL",26
42,"42045",345,238,234,2,4,"IUCyL",10
42,"42212",75,45,45,2,0,"IUCyL",1
42,"42020",4385,3055,2957,74,98,"IUCyL",158
42,"42041",36,25,25,4,0,"IUCyL",3
42,"42042",46,35,33,1,2,"IUCyL",1
42,"42175",28,19,19,0,0,"IUCyL",0
42,"42061",297,190,188,4,2,"IUCyL",9
42,"42038",42,32,31,3,1,"IUCyL",0
42,"42039",270,172,169,2,3,"IUCyL",8
42,"42132",159,132,127,4,5,"IUCyL",5
42,"42024",95,80,73,1,7,"IUCyL",7
42,"42082",9,9,9,0,0,"IUCyL",0
42,"42131",53,38,37,0,1,"IUCyL",0
42,"42157",18,16,15,0,1,"IUCyL",0
42,"42127",47,35,35,0,0,"IUCyL",1
42,"42013",45,35,34,1,1,"IUCyL",0
42,"42015",34,24,24,5,0,"IUCyL",0
42,"42159",40,31,31,1,0,"IUCyL",1
42,"42151",38,32,29,0,3,"IUCyL",0
42,"42198",24,17,17,0,0,"IUCyL",1
42,"42124",71,50,50,0,0,"IUCyL",1
42,"42207",49,37,34,0,3,"IUCyL",7
42,"42027",87,61,61,4,0,"IUCyL",5
42,"42030",115,88,86,2,2,"IUCyL",1
42,"42090",96,75,74,3,1,"IUCyL",2
42,"42201",27,24,24,2,0,"IUCyL",2
42,"42134",2626,1945,1896,36,49,"IUCyL",96
42,"42008",69,50,50,0,0,"IUCyL",2
42,"42196",14,11,11,0,0,"IUCyL",0
42,"42034",40,29,29,0,0,"IUCyL",1
42,"42193",17,10,10,0,0,"IUCyL",0
42,"42094",520,376,362,14,14,"IUCyL",20
42,"42026",25,16,16,0,0,"IUCyL",0
42,"42172",31,28,28,3,0,"IUCyL",0
42,"42056",26,23,22,1,1,"IUCyL",0
42,"42081",158,131,131,3,0,"IUCyL",2
42,"42211",92,69,68,0,1,"IUCyL",6
42,"42080",168,115,114,0,1,"IUCyL",4
42,"42183",131,95,94,7,1,"IUCyL",3
42,"42128",43,38,38,2,0,"IUCyL",2
42,"42055",183,128,127,4,1,"IUCyL",2
42,"42168",128,82,81,4,1,"IUCyL",5
42,"42059",23,19,19,1,0,"IUCyL",0
42,"42174",188,142,138,5,4,"IUCyL",7
42,"42185",29,23,23,1,0,"IUCyL",1
42,"42208",23,15,15,1,0,"IUCyL",0
42,"42083",28,25,25,0,0,"IUCyL",1
42,"42044",62,47,46,0,1,"IUCyL",1
42,"42076",237,185,179,6,6,"IUCyL",5
42,"42154",95,73,73,0,0,"IUCyL",3
42,"42217",38,32,32,0,0,"IUCyL",1
42,"42097",19,16,16,0,0,"IUCyL",1
42,"42001",308,242,237,4,5,"IUCyL",8
42,"42155",188,121,120,0,1,"IUCyL",2
42,"42017",154,134,130,2,4,"IUCyL",2
42,"42093",56,39,38,0,1,"IUCyL",1
42,"42108",13,10,10,1,0,"IUCyL",0
42,"42019",562,392,383,9,9,"IUCyL",15
42,"42052",17,10,10,0,0,"IUCyL",0
42,"42161",158,119,119,0,0,"IUCyL",5
42,"42087",48,38,37,1,1,"IUCyL",4
42,"42191",187,143,141,5,2,"IUCyL",10
42,"42120",148,91,91,4,0,"IUCyL",3
42,"42004",2383,1776,1740,30,36,"IUCyL",52
42,"42189",75,58,58,2,0,"IUCyL",2
42,"42062",36,23,22,0,1,"IUCyL",0
42,"42195",112,74,72,1,2,"IUCyL",1
42,"42204",64,49,44,4,5,"IUCyL",3
42,"42084",27,21,21,0,0,"IUCyL",2
42,"42035",847,600,592,4,8,"IUCyL",12
42,"42086",40,25,25,1,0,"IUCyL",0
42,"42012",43,29,29,1,0,"IUCyL",0
42,"42130",70,55,54,2,1,"IUCyL",2
42,"42089",54,44,44,3,0,"IUCyL",2
42,"42107",86,60,59,2,1,"IUCyL",5
42,"42144",464,343,331,3,12,"IUCyL",10
42,"42049",141,83,81,1,2,"IUCyL",1
42,"42085",219,167,167,2,0,"IUCyL",3
42,"42016",25,13,13,0,0,"IUCyL",0
42,"42100",31,31,31,0,0,"IUCyL",2
42,"42064",92,76,76,0,0,"IUCyL",6
42,"42167",305,223,222,3,1,"IUCyL",7
42,"42171",158,99,94,3,5,"IUCyL",1
42,"42095",1575,1136,1106,40,30,"IUCyL",52
42,"42215",821,561,545,19,16,"IUCyL",11
42,"42032",186,143,141,2,2,"IUCyL",1
42,"42070",45,29,28,0,1,"IUCyL",2
42,"42046",55,35,35,0,0,"IUCyL",4
42,"42156",30,21,21,0,0,"IUCyL",0
42,"42092",89,60,60,0,0,"IUCyL",5
42,"42181",453,357,347,7,10,"IUCyL",9
42,"42068",99,74,74,5,0,"IUCyL",0
42,"42117",146,115,111,1,4,"IUCyL",4
42,"42129",706,523,509,14,14,"IUCyL",19
42,"42010",19,15,15,1,0,"IUCyL",0
42,"42188",64,51,51,0,0,"IUCyL",1
42,"42219",45,33,33,1,0,"IUCyL",0
42,"42023",78,58,58,1,0,"IUCyL",0
42,"42036",52,40,39,2,1,"IUCyL",2
42,"42073",84,53,53,0,0,"IUCyL",3
42,"42119",192,124,123,0,1,"IUCyL",1
42,"42197",90,71,71,0,0,"IUCyL",0
42,"42106",15,14,14,0,0,"IUCyL",0
42,"42160",288,222,221,2,1,"IUCyL",16
42,"42178",144,105,104,3,1,"IUCyL",3
42,"42018",178,129,124,0,5,"IUCyL",3
42,"42110",82,58,58,2,0,"IUCyL",3
42,"42050",29,20,20,1,0,"IUCyL",0
42,"42213",31,24,24,2,0,"IUCyL",0
42,"42164",1699,1244,1209,13,35,"IUCyL",72
42,"42009",97,69,67,2,2,"IUCyL",3
42,"42202",33,15,14,1,1,"IUCyL",0
42,"42142",55,41,38,2,3,"IUCyL",0
42,"42176",30,22,22,0,0,"IUCyL",0
42,"42098",14,8,8,0,0,"IUCyL",0
42,"42071",186,104,103,3,1,"IUCyL",5
42,"42037",38,23,20,3,3,"IUCyL",0
42,"42003",76,54,51,0,3,"IUCyL",1
42,"42022",253,177,171,2,6,"IUCyL",1
42,"42165",424,291,280,6,11,"IUCyL",11
42,"42079",32,25,25,0,0,"IUCyL",0
42,"42113",553,412,404,7,8,"IUCyL",11
42,"42135",89,59,59,1,0,"IUCyL",2
42,"42060",33,22,22,0,0,"IUCyL",0
42,"42065",28,24,24,0,0,"IUCyL",0
42,"42187",65,51,51,0,0,"IUCyL",0
26,"26076",144,124,123,3,1,"I.U.",3
26,"26166",152,139,136,1,3,"I.U.",1
26,"26126",32,31,31,1,0,"I.U.",0
26,"26030",12,12,12,0,0,"I.U.",0
26,"26044",60,48,46,1,2,"I.U.",0
26,"26101",46,35,34,0,1,"I.U.",0
26,"26070",203,179,177,3,2,"I.U.",1
26,"26138",4646,3468,3398,46,70,"I.U.",191
26,"26063",131,104,102,2,2,"I.U.",3
26,"26013",350,267,264,5,3,"I.U.",18
26,"26121",33,28,28,0,0,"I.U.",0
26,"26061",1552,1119,1099,31,20,"I.U.",42
26,"26049",189,141,137,1,4,"I.U.",8
26,"26084",5999,4440,4399,56,41,"I.U.",163
26,"26054",381,298,292,2,6,"I.U.",5
26,"26100",59,51,51,1,0,"I.U.",0
26,"26021",2758,2190,2163,21,27,"I.U.",47
26,"26114",87,74,72,0,2,"I.U.",1
26,"26019",365,296,295,6,1,"I.U.",10
26,"26119",223,186,185,2,1,"I.U.",16
26,"26154",12,12,12,3,0,"I.U.",0
26,"26169",83,73,72,0,1,"I.U.",1
26,"26073",100,85,84,1,1,"I.U.",3
26,"26003",446,388,387,8,1,"I.U.",7
26,"26160",684,538,528,5,10,"I.U.",24
26,"26096",244,204,201,2,3,"I.U.",9
26,"26161",9,8,8,0,0,"I.U.",0
26,"26149",67,50,49,1,1,"I.U.",1
26,"26092",112,89,88,2,1,"I.U.",1
26,"26173",10,10,10,1,0,"I.U.",1
26,"26141",132,101,101,2,0,"I.U.",2
26,"26111",266,203,200,4,3,"I.U.",14
26,"26162",116,94,93,2,1,"I.U.",6
26,"26136",111,90,90,3,0,"I.U.",8
26,"26125",2720,2121,2084,26,37,"I.U.",42
26,"26179",49,39,36,0,3,"I.U.",0
26,"26115",20,20,20,4,0,"I.U.",0
26,"26071",8475,6088,5964,92,124,"I.U.",358
26,"26093",60,41,41,0,0,"I.U.",4
26,"26057",52,42,42,0,0,"I.U.",5
26,"26009",426,318,313,4,5,"I.U.",15
26,"26164",70,42,42,1,0,"I.U.",1
26,"26066",277,229,228,9,1,"I.U.",10
26,"26036",16873,12341,12167,190,174,"I.U.",394
26,"26118",64,58,56,0,2,"I.U.",1
26,"26134",102,82,80,2,2,"I.U.",1
26,"26006",1853,1456,1430,15,26,"I.U.",52
26,"26113",35,31,31,1,0,"I.U.",0
26,"26016",32,27,27,0,0,"I.U.",2
26,"26144",196,163,162,2,1,"I.U.",4
26,"26176",69,55,54,0,1,"I.U.",0
26,"26131",44,36,36,0,0,"I.U.",0
26,"26081",23,17,17,0,0,"I.U.",0
26,"26183",65,54,54,0,0,"I.U.",4
26,"26040",67,63,62,2,1,"I.U.",0
26,"26165",350,297,294,1,3,"I.U.",9
26,"26105",2181,1712,1690,24,22,"I.U.",79
26,"26135",181,139,137,1,2,"I.U.",3
26,"26050",114,84,81,1,3,"I.U.",1
26,"26180",243,185,181,4,4,"I.U.",6
26,"26146",141,98,96,0,2,"I.U.",4
26,"26027",169,126,126,1,0,"I.U.",32
26,"26004",82,64,64,1,0,"I.U.",0
26,"26065",57,43,43,0,0,"I.U.",0
26,"26158",296,238,237,7,1,"I.U.",2
26,"26017",380,277,276,3,1,"I.U.",17
26,"26026",1344,1108,1096,14,12,"I.U.",29
26,"26048",29,27,26,1,1,"I.U.",0
26,"26008",1909,1544,1527,19,17,"I.U.",34
26,"26053",221,177,173,5,4,"I.U.",3
26,"26062",94,78,77,1,1,"I.U.",3
26,"26074",128,102,101,0,1,"I.U.",4
26,"26177",322,276,274,2,2,"I.U.",6
26,"26007",551,434,422,3,12,"I.U.",39
26,"26103",796,616,611,11,5,"I.U.",11
26,"26130",229,181,177,0,4,"I.U.",3
26,"26067",22,19,19,1,0,"I.U.",1
26,"26095",126,102,102,0,0,"I.U.",6
26,"26124",860,705,694,3,11,"I.U.",15
26,"26039",44,38,36,1,2,"I.U.",0
26,"26043",397,313,306,6,7,"I.U.",4
26,"26080",529,427,425,2,2,"I.U.",7
26,"26034",678,526,510,3,16,"I.U.",18
26,"26059",1137,887,869,9,18,"I.U.",28
26,"26001",211,174,168,3,6,"I.U.",4
26,"26072",310,270,264,4,6,"I.U.",8
26,"26032",58,52,52,1,0,"I.U.",1
26,"26033",183,157,156,2,1,"I.U.",10
26,"26152",38,31,31,0,0,"I.U.",0
26,"26181",14,12,12,0,0,"I.U.",0
26,"26037",150,129,128,1,1,"I.U.",0
26,"26010",98,82,79,1,3,"I.U.",2
26,"26167",66,51,51,2,0,"I.U.",1
26,"26091",165,139,139,0,0,"I.U.",2
26,"26110",178,149,147,3,2,"I.U.",10
26,"26172",35,29,29,0,0,"I.U.",1
26,"26140",268,213,207,2,6,"I.U.",13
26,"26012",17,15,15,1,0,"I.U.",0
26,"26042",852,660,651,11,9,"I.U.",29
26,"26153",12,9,8,0,1,"I.U.",0
26,"26060",100,71,71,3,0,"I.U.",0
26,"26014",472,358,353,6,5,"I.U.",19
26,"26163",143,118,116,2,2,"I.U.",3
26,"26088",48,41,41,0,0,"I.U.",4
26,"26024",273,220,219,2,1,"I.U.",9
26,"26108",324,245,243,4,2,"I.U.",15
26,"26129",1010,794,780,7,14,"I.U.",11
26,"26127",236,206,204,1,2,"I.U.",1
26,"26120",1515,1215,1198,20,17,"I.U.",38
26,"26023",505,386,380,6,6,"I.U.",8
26,"26087",222,180,178,5,2,"I.U.",11
26,"26107",97,79,79,1,0,"I.U.",3
26,"26175",57,46,45,1,1,"I.U.",0
26,"26109",105,87,84,0,3,"I.U.",7
26,"26025",78,69,69,1,0,"I.U.",4
26,"26086",18,17,17,0,0,"I.U.",0
26,"26058",151,114,109,1,5,"I.U.",9
26,"26174",154,122,122,2,0,"I.U.",6
26,"26079",690,568,562,5,6,"I.U.",9
26,"26094",97,86,85,0,1,"I.U.",4
26,"26178",88,74,73,1,1,"I.U.",5
26,"26099",1281,1050,1025,19,25,"I.U.",26
26,"26029",33,25,24,1,1,"I.U.",3
26,"26171",212,171,170,6,1,"I.U.",1
26,"26128",116,94,93,0,1,"I.U.",4
26,"26083",303,234,234,1,0,"I.U.",4
26,"26045",13,13,13,0,0,"I.U.",0
26,"26068",83,65,64,0,1,"I.U.",1
26,"26051",271,219,214,4,5,"I.U.",10
26,"26104",18,16,16,0,0,"I.U.",2
26,"26047",2076,1702,1682,17,20,"I.U.",40
26,"26020",506,372,364,10,8,"I.U.",7
26,"26064",2341,1770,1749,26,21,"I.U.",177
26,"26031",120,100,100,0,0,"I.U.",0
26,"26089",108356,81446,80090,1450,1356,"I.U.",4266
26,"26075",377,297,289,4,8,"I.U.",0
26,"26139",68,55,55,4,0,"I.U.",2
26,"26106",78,70,69,0,1,"I.U.",5
26,"26077",15,15,15,1,0,"I.U.",1
26,"26168",5055,3534,3484,47,50,"I.U.",215
26,"26132",130,98,96,2,2,"I.U.",4
26,"26151",455,384,382,1,2,"I.U.",4
26,"26148",189,151,150,0,1,"I.U.",10
26,"26052",181,146,146,0,0,"I.U.",15
26,"26122",109,94,92,2,2,"I.U.",5
26,"26046",1617,1237,1219,14,18,"I.U.",51
26,"26035",22,14,14,0,0,"I.U.",1
26,"26069",276,211,208,5,3,"I.U.",8
26,"26150",129,104,104,0,0,"I.U.",0
26,"26041",152,106,104,0,2,"I.U.",0
26,"26098",99,74,73,2,1,"I.U.",7
26,"26038",93,71,69,1,2,"I.U.",3
26,"26002",805,617,605,6,12,"I.U.",20
26,"26056",440,345,339,4,6,"I.U.",3
26,"26102",6158,4794,4716,60,78,"I.U.",206
26,"26170",471,353,348,4,5,"I.U.",2
26,"26011",7455,5452,5353,93,99,"I.U.",200
26,"26142",804,661,648,1,13,"I.U.",22
26,"26143",187,154,151,4,3,"I.U.",4
26,"26015",205,167,165,1,2,"I.U.",4
26,"26022",232,191,190,1,1,"I.U.",6
26,"26147",34,29,29,2,0,"I.U.",1
26,"26145",251,201,199,3,2,"I.U.",3
26,"26078",85,69,69,0,0,"I.U.",4
26,"26123",129,113,113,1,0,"I.U.",8
26,"26112",270,201,200,0,1,"I.U.",8
26,"26117",2152,1682,1655,20,27,"I.U.",43
26,"26155",173,134,134,1,0,"I.U.",2
26,"26082",121,95,95,0,0,"I.U.",4
26,"26028",135,108,106,2,2,"I.U.",9
26,"26157",306,268,263,1,5,"I.U.",4
26,"26055",38,32,30,0,2,"I.U.",4
26,"26018",10396,8186,8041,161,145,"I.U.",398
26,"26005",2251,1602,1580,18,22,"I.U.",48
29,"29004",343,281,281,0,0,"IULV-CA",22
23,"23002",17740,14007,13858,171,149,"IULV-CA",845
14,"14061",841,700,693,3,7,"IULV-CA",68
14,"14013",17006,13114,12958,166,156,"IULV-CA",769
11,"11031",76347,49071,48616,681,455,"IULV-CA",3311
14,"14011",595,498,497,4,1,"IULV-CA",20
41,"41068",13809,10171,10072,100,99,"IULV-CA",520
29,"29060",775,573,572,1,1,"IULV-CA",8
11,"11025",4371,3260,3226,34,34,"IULV-CA",269
41,"41067",7055,5368,5295,64,73,"IULV-CA",407
21,"21057",1054,699,697,9,2,"IULV-CA",23
21,"21013",10601,7384,7231,110,153,"IULV-CA",814
29,"29098",1312,1043,1036,22,7,"IULV-CA",94
41,"41015",5263,3820,3752,34,68,"IULV-CA",163
23,"23011",2227,1644,1620,25,24,"IULV-CA",195
29,"29090",1805,1265,1260,5,5,"IULV-CA",78
29,"29016",272,180,179,5,1,"IULV-CA",10
21,"21064",6331,4390,4352,46,38,"IULV-CA",264
23,"23024",12634,9916,9673,116,243,"IULV-CA",484
41,"41044",6838,5064,5005,67,59,"IULV-CA",311
23,"23074",3039,2491,2451,29,40,"IULV-CA",176
14,"14034",367,301,292,1,9,"IULV-CA",12
18,"18044",208,132,132,4,0,"IULV-CA",2
23,"23101",413,324,321,3,3,"IULV-CA",11
23,"23901",1194,1048,1045,8,3,"IULV-CA",21
23,"23904",3070,2047,2033,19,14,"IULV-CA",97
29,"29074",818,631,630,3,1,"IULV-CA",24
23,"23084",1046,817,812,4,5,"IULV-CA",14
29,"29049",3137,2365,2352,19,13,"IULV-CA",385
18,"18048",2277,1705,1688,19,17,"IULV-CA",160
23,"23066",4348,3687,3654,21,33,"IULV-CA",143
29,"29050",483,341,340,1,1,"IULV-CA",20
41,"41079",9349,7095,7001,71,94,"IULV-CA",667
14,"14044",1585,1279,1265,12,14,"IULV-CA",58
14,"14050",2418,1983,1966,23,17,"IULV-CA",478
29,"29031",1652,1123,1118,11,5,"IULV-CA",166
11,"11901",5576,4433,4398,69,35,"IULV-CA",209
14,"14064",352,265,261,3,4,"IULV-CA",13
18,"18003",13486,10245,10100,145,145,"IULV-CA",1032
41,"41039",31429,23337,23138,294,199,"IULV-CA",1393
23,"23042",359,278,277,0,1,"IULV-CA",9
18,"18175",11534,8772,8698,68,74,"IULV-CA",545
14,"14026",2043,1434,1421,10,13,"IULV-CA",83
29,"29042",14047,9845,9735,118,110,"IULV-CA",865
21,"21004",1530,1059,1042,9,17,"IULV-CA",48
11,"11023",9209,6979,6929,81,50,"IULV-CA",1048
29,"29035",1717,1280,1270,14,10,"IULV-CA",177
18,"18043",140,89,87,1,2,"IULV-CA",6
29,"29079",2500,2016,2000,23,16,"IULV-CA",317
41,"41016",6950,5194,5120,45,74,"IULV-CA",607
23,"23005",30698,23126,22916,310,210,"IULV-CA",1151
29,"29010",1703,1411,1377,7,34,"IULV-CA",79
41,"41027",4061,2783,2752,28,31,"IULV-CA",496
18,"18057",5045,3755,3721,44,34,"IULV-CA",313
18,"18040",246,147,146,0,1,"IULV-CA",7
21,"21001",628,434,428,5,6,"IULV-CA",37
29,"29019",908,720,714,0,6,"IULV-CA",244
23,"23091",790,668,664,3,4,"IULV-CA",8
29,"29014",250,152,150,0,2,"IULV-CA",22
18,"18014",5667,4132,4085,43,47,"IULV-CA",249
18,"18067",704,526,521,1,5,"IULV-CA",13
11,"11001",4389,3110,3072,13,38,"IULV-CA",208
29,"29002",1246,896,893,11,3,"IULV-CA",33
41,"41049",8898,6881,6812,95,69,"IULV-CA",1047
21,"21008",2717,1994,1978,11,16,"IULV-CA",60
23,"23049",1942,1514,1486,16,28,"IULV-CA",138
41,"41013",4762,3359,3327,9,32,"IULV-CA",609
23,"23004",478,416,415,1,1,"IULV-CA",10
41,"41038",96442,66696,65945,1021,751,"IULV-CA",6093
18,"18011",4246,3195,3172,23,23,"IULV-CA",267
18,"18905",12975,9260,9209,155,51,"IULV-CA",613
18,"18170",377,238,237,0,1,"IULV-CA",8
18,"18148",874,714,706,6,8,"IULV-CA",35
41,"41047",9810,7427,7321,99,106,"IULV-CA",480
18,"18180",655,450,447,1,3,"IULV-CA",114
18,"18183",685,502,500,3,2,"IULV-CA",22
29,"29080",6598,4703,4663,31,40,"IULV-CA",626
29,"29006",721,516,508,5,8,"IULV-CA",12
14,"14020",415,323,319,3,4,"IULV-CA",14
21,"21069",1778,1245,1242,11,3,"IULV-CA",31
23,"23080",1832,1425,1414,3,11,"IULV-CA",42
41,"41065",23028,15133,14958,191,175,"IULV-CA",1157
41,"41021",20767,14040,13822,240,218,"IULV-CA",1247
23,"23079",3750,3084,3063,19,21,"IULV-CA",70
14,"14068",581,460,457,7,3,"IULV-CA",24
18,"18902",950,769,762,6,7,"IULV-CA",35
21,"21020",398,282,282,3,0,"IULV-CA",17
18,"18146",1059,791,776,2,15,"IULV-CA",78
14,"14008",2905,2226,2200,18,26,"IULV-CA",166
18,"18030",612,457,456,0,1,"IULV-CA",19
29,"29023",1661,1080,1074,15,6,"IULV-CA",42
14,"14032",434,377,375,1,2,"IULV-CA",10
41,"41033",5237,3915,3878,20,37,"IULV-CA",193
18,"18034",510,377,375,2,2,"IULV-CA",82
14,"14035",6153,4715,4656,51,59,"IULV-CA",157
23,"23081",1643,1245,1234,12,11,"IULV-CA",55
23,"23039",2239,1799,1764,9,35,"IULV-CA",84
18,"18161",220,180,178,0,2,"IULV-CA",4
14,"14052",9720,6444,6384,58,60,"IULV-CA",345
23,"23045",2180,1671,1667,3,4,"IULV-CA",440
18,"18101",8990,6659,6556,96,103,"IULV-CA",536
23,"23030",1270,1052,1045,3,7,"IULV-CA",15
11,"11020",163674,106898,106082,1655,816,"IULV-CA",9839
29,"29076",2022,1384,1374,14,10,"IULV-CA",96
18,"18162",947,726,721,8,5,"IULV-CA",19
21,"21038",1146,786,767,9,19,"IULV-CA",59
23,"23051",2805,2312,2290,8,22,"IULV-CA",64
41,"41090",3488,2792,2751,22,41,"IULV-CA",325
29,"29015",31805,22566,22347,272,219,"IULV-CA",1767
29,"29025",34637,22545,22354,268,191,"IULV-CA",1921
18,"18174",470,368,363,1,5,"IULV-CA",16
41,"41903",6653,5134,5070,61,64,"IULV-CA",398
18,"18094",2398,1882,1868,16,14,"IULV-CA",92
21,"21003",691,540,536,7,4,"IULV-CA",63
29,"29067",420165,273593,271376,3342,2217,"IULV-CA",24648
23,"23007",3116,2483,2458,15,25,"IULV-CA",73
14,"14037",3500,2662,2616,29,46,"IULV-CA",118
41,"41094",6089,4757,4680,47,77,"IULV-CA",231
21,"21076",2108,1647,1628,22,19,"IULV-CA",137
18,"18053",1836,1345,1340,11,5,"IULV-CA",97
18,"18913",827,653,646,2,7,"IULV-CA",18
18,"18100",7304,5807,5737,62,70,"IULV-CA",328
41,"41074",3079,2406,2386,14,20,"IULV-CA",369
41,"41005",8792,6642,6585,71,57,"IULV-CA",825
14,"14022",4077,3147,3102,20,45,"IULV-CA",759
21,"21044",17018,11390,11290,132,100,"IULV-CA",479
29,"29097",4076,3060,3018,40,42,"IULV-CA",331
29,"29084",28386,19450,19202,296,248,"IULV-CA",1480
41,"41025",1999,1502,1476,13,26,"IULV-CA",250
21,"21050",12322,8772,8679,99,93,"IULV-CA",331
14,"14066",5911,4515,4473,54,42,"IULV-CA",1041
18,"18908",827,669,660,7,9,"IULV-CA",31
29,"29064",584,428,422,4,6,"IULV-CA",34
29,"29055",1837,1478,1454,12,24,"IULV-CA",166
18,"18168",864,613,605,4,8,"IULV-CA",49
14,"14005",6334,4262,4206,61,56,"IULV-CA",636
23,"23018",2415,1791,1781,9,10,"IULV-CA",263
14,"14043",7664,5935,5874,53,61,"IULV-CA",625
18,"18096",348,289,287,1,2,"IULV-CA",6
18,"18018",658,520,514,4,6,"IULV-CA",33
18,"18150",6452,4666,4625,56,41,"IULV-CA",588
23,"23903",3537,2892,2877,12,15,"IULV-CA",445
29,"29051",37991,24498,24095,381,403,"IULV-CA",1607
29,"29095",3431,2660,2607,23,53,"IULV-CA",442
29,"29037",227,170,170,0,0,"IULV-CA",1
41,"41053",20729,16178,15971,142,207,"IULV-CA",1390
18,"18119",1778,1401,1391,14,10,"IULV-CA",55
18,"18151",276,191,188,0,3,"IULV-CA",15
29,"29073",1520,1032,1021,10,11,"IULV-CA",173
11,"11015",59476,38207,37898,501,309,"IULV-CA",2725
18,"18049",632,476,474,5,2,"IULV-CA",46
18,"18137",1057,875,868,8,7,"IULV-CA",15
18,"18126",1461,1129,1121,15,8,"IULV-CA",287
41,"41076",2227,1507,1492,5,15,"IULV-CA",172
18,"18912",1576,1193,1185,7,8,"IULV-CA",38
29,"29902",2577,1689,1665,20,24,"IULV-CA",107
21,"21033",508,385,382,7,3,"IULV-CA",64
18,"18115",2380,1843,1823,14,20,"IULV-CA",174
21,"21077",1690,1335,1321,8,14,"IULV-CA",34
18,"18037",488,408,404,0,4,"IULV-CA",16
29,"29057",413,311,308,2,3,"IULV-CA",7
29,"29020",3188,2448,2424,30,24,"IULV-CA",809
29,"29048",1508,1254,1245,6,9,"IULV-CA",397
29,"29038",16309,10579,10494,152,85,"IULV-CA",859
23,"23065",1701,1238,1226,10,12,"IULV-CA",38
41,"41022",4281,3087,3066,15,21,"IULV-CA",752
29,"29085",156,116,113,0,3,"IULV-CA",7
29,"29091",8777,6226,6126,64,100,"IULV-CA",715
23,"23052",1186,1012,997,1,15,"IULV-CA",31
41,"41902",4682,3136,3101,34,35,"IULV-CA",252
41,"41054",671,556,550,0,6,"IULV-CA",39
41,"41046",3055,2456,2418,23,38,"IULV-CA",617
11,"11007",17997,10781,10676,184,105,"IULV-CA",738
29,"29024",414,271,261,6,10,"IULV-CA",8
29,"29089",3343,2514,2489,14,25,"IULV-CA",763
41,"41089",6394,4593,4526,57,67,"IULV-CA",617
18,"18144",779,592,590,3,2,"IULV-CA",66
18,"18109",607,461,456,1,5,"IULV-CA",14
41,"41014",2484,1956,1936,13,20,"IULV-CA",618
21,"21073",1840,1249,1236,13,13,"IULV-CA",33
11,"11011",1685,1231,1216,8,15,"IULV-CA",88
21,"21002",14281,10297,10173,141,124,"IULV-CA",779
21,"21046",1715,1354,1343,15,11,"IULV-CA",40
29,"29083",2212,1679,1652,15,27,"IULV-CA",108
41,"41081",28121,20027,19785,275,242,"IULV-CA",2257
21,"21066",522,440,431,4,9,"IULV-CA",10
29,"29070",35228,23374,23146,258,228,"IULV-CA",1584
21,"21070",6278,4489,4445,42,44,"IULV-CA",637
41,"41062",2252,1719,1698,12,21,"IULV-CA",379
41,"41012",3115,2314,2271,29,43,"IULV-CA",102
18,"18071",5589,4268,4205,44,63,"IULV-CA",298
23,"23060",19107,14365,14264,130,101,"IULV-CA",652
21,"21016",1076,823,790,11,33,"IULV-CA",114
18,"18076",880,676,676,3,0,"IULV-CA",33
14,"14057",6115,5040,4975,71,65,"IULV-CA",1092
18,"18013",4392,3268,3223,23,45,"IULV-CA",241
29,"29087",409,306,305,3,1,"IULV-CA",59
29,"29066",363,263,260,1,3,"IULV-CA",31
11,"11040",411,317,309,0,8,"IULV-CA",11
29,"29094",54317,36540,36174,410,366,"IULV-CA",2357
21,"21061",5089,3657,3635,33,22,"IULV-CA",131
21,"21051",272,202,201,5,1,"IULV-CA",11
18,"18045",1211,892,885,4,7,"IULV-CA",22
23,"23088",6177,4955,4872,94,83,"IULV-CA",611
23,"23087",11474,9197,9123,90,74,"IULV-CA",1807
18,"18152",1037,822,818,9,4,"IULV-CA",42
29,"29077",225,157,157,1,0,"IULV-CA",9
18,"18078",768,638,637,1,1,"IULV-CA",71
14,"14045",3093,2662,2642,14,20,"IULV-CA",96
23,"23057",823,717,711,4,6,"IULV-CA",186
23,"23048",884,691,679,6,12,"IULV-CA",8
23,"23093",3313,2706,2673,13,33,"IULV-CA",92
23,"23073",4671,3778,3735,19,43,"IULV-CA",165
21,"21068",1009,726,721,10,5,"IULV-CA",17
11,"11041",9805,7136,7067,87,69,"IULV-CA",502
18,"18079",3497,2729,2706,15,23,"IULV-CA",384
21,"21056",2992,2172,2096,29,76,"IULV-CA",172
23,"23058",8497,6642,6591,44,51,"IULV-CA",426
18,"18012",2693,1841,1831,11,10,"IULV-CA",42
18,"18056",3695,2961,2940,25,21,"IULV-CA",361
11,"11042",1232,933,922,4,11,"IULV-CA",14
29,"29021",153,113,113,0,0,"IULV-CA",5
11,"11036",725,484,482,10,2,"IULV-CA",49
11,"11033",19983,12960,12807,199,153,"IULV-CA",865
18,"18020",1473,1111,1106,7,5,"IULV-CA",30
23,"23064",1680,1483,1478,8,5,"IULV-CA",29
11,"11024",6811,5241,5202,58,39,"IULV-CA",625
41,"41064",5629,4041,4006,28,35,"IULV-CA",460
18,"18068",1456,1105,1088,13,17,"IULV-CA",70
14,"14070",1385,1131,1111,4,20,"IULV-CA",31
29,"29093",2299,1767,1732,7,35,"IULV-CA",138
23,"23021",541,464,453,0,11,"IULV-CA",35
29,"29062",647,573,571,1,2,"IULV-CA",11
18,"18099",1551,1217,1205,11,12,"IULV-CA",123
29,"29056",1177,807,794,3,13,"IULV-CA",31
41,"41009",1272,914,899,8,15,"IULV-CA",22
21,"21023",2106,1471,1456,7,15,"IULV-CA",99
18,"18159",1051,873,869,4,4,"IULV-CA",278
41,"41101",5752,4663,4629,25,34,"IULV-CA",617
29,"29088",2784,2019,1975,14,44,"IULV-CA",147
29,"29013",1718,1302,1283,4,19,"IULV-CA",238
21,"21021",11825,7657,7574,108,83,"IULV-CA",421
11,"11028",32224,20706,20482,359,224,"IULV-CA",1844
18,"18103",803,653,647,5,6,"IULV-CA",17
41,"41007",12177,8150,8016,126,134,"IULV-CA",1122
41,"41082",3448,2827,2796,15,31,"IULV-CA",354
41,"41901",2626,2190,2167,24,23,"IULV-CA",156
14,"14051",1392,1148,1130,11,18,"IULV-CA",37
29,"29092",596,457,454,10,3,"IULV-CA",109
29,"29026",1130,815,799,7,16,"IULV-CA",103
21,"21078",2865,2085,2066,21,19,"IULV-CA",462
18,"18128",361,284,283,5,1,"IULV-CA",19
18,"18114",678,508,508,6,0,"IULV-CA",30
21,"21025",3969,2731,2686,33,45,"IULV-CA",134
41,"41095",40097,27969,27731,354,238,"IULV-CA",1649
11,"11035",13266,8794,8668,115,126,"IULV-CA",501
21,"21062",1444,1003,991,7,12,"IULV-CA",30
14,"14036",3774,2928,2909,51,19,"IULV-CA",285
21,"21049",3468,2327,2283,18,44,"IULV-CA",269
18,"18194",2258,1656,1652,11,4,"IULV-CA",82
14,"14033",1289,974,958,18,16,"IULV-CA",54
18,"18046",1960,1327,1312,5,15,"IULV-CA",167
18,"18038",1097,906,900,3,6,"IULV-CA",116
23,"23050",91354,68649,67925,990,724,"IULV-CA",3367
18,"18036",3553,2762,2741,20,21,"IULV-CA",212
18,"18909",668,536,534,2,2,"IULV-CA",16
29,"29053",1715,1239,1221,7,18,"IULV-CA",65
21,"21029",1633,1276,1259,15,17,"IULV-CA",116
11,"11005",4617,3287,3214,26,73,"IULV-CA",312
29,"29022",202,142,141,2,1,"IULV-CA",12
41,"41099",4141,2818,2799,37,19,"IULV-CA",199
14,"14006",1326,1170,1148,12,22,"IULV-CA",60
18,"18122",16253,12271,12109,132,162,"IULV-CA",709
11,"11021",6838,5102,5049,67,53,"IULV-CA",578
18,"18062",9418,6916,6835,62,81,"IULV-CA",447
41,"41088",542,414,408,1,6,"IULV-CA",26
14,"14027",7948,5944,5871,92,73,"IULV-CA",1178
11,"11009",636,430,424,2,6,"IULV-CA",29
29,"29100",2442,1834,1824,14,10,"IULV-CA",129
18,"18072",710,507,499,2,8,"IULV-CA",13
41,"41010",4338,2990,2958,48,32,"IULV-CA",445
18,"18123",307,239,238,1,1,"IULV-CA",4
23,"23096",2678,2298,2276,18,22,"IULV-CA",174
11,"11003",1290,952,940,8,12,"IULV-CA",34
21,"21034",1253,875,861,7,14,"IULV-CA",57
14,"14007",15871,11609,11477,121,132,"IULV-CA",1061
29,"29075",12666,8284,8218,62,66,"IULV-CA",797
14,"14038",31501,23683,23394,336,289,"IULV-CA",1467
23,"23062",1476,1274,1264,2,10,"IULV-CA",28
23,"23034",2591,2146,2124,13,22,"IULV-CA",47
29,"29901",41445,27372,27158,295,214,"IULV-CA",2055
21,"21048",327,226,226,5,0,"IULV-CA",17
29,"29059",2551,1986,1964,11,22,"IULV-CA",565
23,"23097",6510,4687,4639,36,48,"IULV-CA",181
14,"14073",3009,2246,2224,32,22,"IULV-CA",139
21,"21031",1309,903,871,9,32,"IULV-CA",53
14,"14059",713,572,567,5,5,"IULV-CA",38
23,"23040",1538,1319,1311,3,8,"IULV-CA",326
18,"18042",425,344,342,2,2,"IULV-CA",20
21,"21032",1790,1362,1347,14,15,"IULV-CA",147
18,"18176",265,183,181,0,2,"IULV-CA",16
14,"14060",4843,3857,3787,47,70,"IULV-CA",363
23,"23063",3960,3073,3037,21,36,"IULV-CA",233
41,"41052",2967,2305,2288,7,17,"IULV-CA",215
23,"23095",8882,6668,6628,31,40,"IULV-CA",292
18,"18102",8556,6358,6272,42,86,"IULV-CA",774
14,"14047",1566,1154,1143,19,11,"IULV-CA",62
41,"41035",1171,898,889,12,9,"IULV-CA",11
18,"18177",463,285,281,4,4,"IULV-CA",14
11,"11002",4291,3388,3374,19,14,"IULV-CA",1390
14,"14067",3821,3105,3082,38,23,"IULV-CA",427
18,"18111",2647,1957,1941,24,16,"IULV-CA",140
18,"18085",818,538,532,4,6,"IULV-CA",21
11,"11012",103946,68124,67375,856,749,"IULV-CA",5925
41,"41085",3918,3173,3128,42,45,"IULV-CA",193
21,"21040",3096,2370,2351,28,19,"IULV-CA",171
14,"14072",1169,925,922,5,3,"IULV-CA",159
21,"21030",1757,1448,1426,14,22,"IULV-CA",37
41,"41097",3096,2489,2451,21,38,"IULV-CA",104
41,"41011",15274,11359,11207,145,152,"IULV-CA",1169
14,"14042",18991,14726,14495,290,231,"IULV-CA",2182
14,"14024",1926,1557,1527,14,30,"IULV-CA",112
41,"41037",3228,2510,2483,27,27,"IULV-CA",640
29,"29068",6209,4025,3983,41,42,"IULV-CA",366
41,"41042",5902,4572,4509,37,63,"IULV-CA",491
41,"41034",22561,16014,15840,270,174,"IULV-CA",1160
23,"23043",554,411,407,6,4,"IULV-CA",4
14,"14069",7733,5910,5824,68,86,"IULV-CA",318
18,"18087",187449,138136,136783,1548,1353,"IULV-CA",9782
11,"11038",13815,10849,10756,126,93,"IULV-CA",620
41,"41069",28331,21065,20877,252,188,"IULV-CA",3142
14,"14002",10991,8444,8358,106,86,"IULV-CA",788
14,"14025",3061,2547,2517,13,30,"IULV-CA",871
23,"23014",2529,2058,2039,13,19,"IULV-CA",256
21,"21045",261,200,200,5,0,"IULV-CA",19
18,"18004",818,601,594,2,7,"IULV-CA",13
41,"41078",2587,1979,1970,15,9,"IULV-CA",273
18,"18147",3742,2419,2386,20,33,"IULV-CA",128
29,"29043",2596,1670,1647,24,23,"IULV-CA",172
23,"23059",5974,4910,4852,37,58,"IULV-CA",382
14,"14023",2084,1809,1787,13,22,"IULV-CA",50
23,"23016",442,355,354,5,1,"IULV-CA",25
41,"41073",1789,1292,1272,5,20,"IULV-CA",79
14,"14074",2387,2002,1995,26,7,"IULV-CA",150
18,"18005",366,279,277,3,2,"IULV-CA",9
11,"11018",1528,1194,1178,9,16,"IULV-CA",26
18,"18088",1576,1258,1253,2,5,"IULV-CA",325
41,"41070",5598,4101,4039,79,62,"IULV-CA",426
41,"41100",1097,894,878,8,16,"IULV-CA",41
29,"29096",2880,2012,1971,28,41,"IULV-CA",229
18,"18097",1022,758,752,4,6,"IULV-CA",41
23,"23041",519,455,448,2,7,"IULV-CA",6
18,"18163",327,246,238,0,8,"IULV-CA",10
41,"41056",3697,3041,3008,25,33,"IULV-CA",286
21,"21053",3278,2363,2325,20,38,"IULV-CA",69
18,"18193",13680,9874,9764,130,110,"IULV-CA",1032
41,"41059",31676,23199,22889,330,310,"IULV-CA",2092
21,"21054",8024,6159,6072,67,87,"IULV-CA",174
18,"18178",834,685,683,3,2,"IULV-CA",17
23,"23033",1382,1166,1152,7,14,"IULV-CA",30
18,"18188",1659,1329,1308,9,21,"IULV-CA",64
21,"21071",216,169,169,5,0,"IULV-CA",8
18,"18171",2093,1719,1704,10,15,"IULV-CA",392
21,"21058",2609,1867,1857,15,10,"IULV-CA",96
11,"11026",4834,3736,3691,27,45,"IULV-CA",220
29,"29082",29311,20220,20051,223,169,"IULV-CA",1743
29,"29052",245,151,151,0,0,"IULV-CA",2
29,"29072",3258,2484,2447,30,37,"IULV-CA",249
21,"21065",295,212,211,0,1,"IULV-CA",3
18,"18117",535,444,440,2,4,"IULV-CA",20
18,"18051",1196,857,852,4,5,"IULV-CA",24
41,"41066",1417,1121,1113,9,8,"IULV-CA",98
18,"18185",608,484,479,2,5,"IULV-CA",38
29,"29018",2088,1565,1540,9,25,"IULV-CA",280
14,"14015",2198,1776,1755,16,21,"IULV-CA",263
41,"41003",2196,1803,1782,21,21,"IULV-CA",71
18,"18084",3954,3039,3015,50,24,"IULV-CA",191
29,"29028",1253,887,876,8,11,"IULV-CA",114
41,"41029",13231,9756,9610,128,146,"IULV-CA",648
23,"23035",1066,919,912,3,7,"IULV-CA",31
23,"23020",1623,1414,1400,16,14,"IULV-CA",375
23,"23090",1371,1188,1177,6,11,"IULV-CA",26
21,"21039",313,233,232,2,1,"IULV-CA",10
14,"14003",1289,1046,1026,12,20,"IULV-CA",23
18,"18132",3461,2797,2772,19,25,"IULV-CA",353
21,"21036",213,172,167,1,5,"IULV-CA",14
23,"23046",2441,2049,2027,13,22,"IULV-CA",186
18,"18165",3942,2819,2776,27,43,"IULV-CA",256
14,"14053",6040,4455,4376,78,79,"IULV-CA",478
29,"29040",1934,1344,1332,12,12,"IULV-CA",62
23,"23055",48167,33913,33612,400,301,"IULV-CA",2881
18,"18154",1062,770,769,0,1,"IULV-CA",7
18,"18901",583,374,368,3,6,"IULV-CA",32
14,"14030",8519,6832,6753,64,79,"IULV-CA",743
18,"18910",832,601,594,6,7,"IULV-CA",30
41,"41030",527,436,429,6,7,"IULV-CA",39
18,"18143",949,722,704,2,18,"IULV-CA",76
14,"14048",1244,975,970,5,5,"IULV-CA",46
23,"23076",831,681,671,5,10,"IULV-CA",29
41,"41086",15877,10246,10150,146,96,"IULV-CA",762
18,"18181",253,183,182,0,1,"IULV-CA",2
21,"21014",4063,3424,3408,27,16,"IULV-CA",143
18,"18024",882,696,688,12,8,"IULV-CA",71
29,"29032",6673,5204,5140,43,64,"IULV-CA",878
23,"23056",3182,2539,2523,20,16,"IULV-CA",432
18,"18120",274,238,237,2,1,"IULV-CA",14
41,"41036",4053,2930,2899,29,31,"IULV-CA",872
18,"18022",12448,8777,8659,111,118,"IULV-CA",997
41,"41028",1880,1479,1458,28,21,"IULV-CA",144
23,"23053",9431,7160,7128,42,32,"IULV-CA",1869
18,"18136",1973,1679,1668,5,11,"IULV-CA",161
21,"21024",502,363,358,10,5,"IULV-CA",68
21,"21072",10233,7829,7666,124,163,"IULV-CA",607
41,"41031",1319,879,875,6,4,"IULV-CA",65
41,"41075",9987,7904,7809,71,95,"IULV-CA",668
23,"23082",1985,1464,1451,9,13,"IULV-CA",53
14,"14019",6486,5288,5243,65,45,"IULV-CA",850
18,"18124",387,270,267,0,3,"IULV-CA",4
23,"23054",393,288,286,1,2,"IULV-CA",5
21,"21022",173,123,123,1,0,"IULV-CA",9
41,"41055",15121,11082,10997,98,85,"IULV-CA",850
41,"41041",9646,7901,7791,58,110,"IULV-CA",465
23,"23094",3917,3200,3166,32,34,"IULV-CA",291
41,"41018",9457,6940,6867,66,73,"IULV-CA",704
23,"23037",513,430,424,3,6,"IULV-CA",11
18,"18039",3733,2901,2878,18,23,"IULV-CA",79
18,"18906",955,736,731,5,5,"IULV-CA",21
18,"18002",625,505,504,2,1,"IULV-CA",12
18,"18187",587,432,432,0,0,"IULV-CA",43
29,"29065",207,151,149,1,2,"IULV-CA",3
41,"41024",22383,15333,15160,213,173,"IULV-CA",1250
21,"21012",331,254,246,2,8,"IULV-CA",25
41,"41091",545464,388043,383816,5325,4227,"IULV-CA",25507
29,"29001",4176,3339,3303,23,36,"IULV-CA",494
14,"14041",3215,2492,2439,45,53,"IULV-CA",730
29,"29041",2796,1950,1921,24,29,"IULV-CA",425
18,"18904",858,620,612,3,8,"IULV-CA",42
21,"21041",114169,74740,73814,1129,926,"IULV-CA",5839
23,"23003",8778,6945,6877,51,68,"IULV-CA",209
18,"18112",132,90,90,1,0,"IULV-CA",2
18,"18138",2460,1751,1741,1,10,"IULV-CA",384
14,"14046",4587,3671,3641,35,30,"IULV-CA",1357
41,"41045",5505,3946,3889,68,57,"IULV-CA",721
21,"21017",3581,2416,2389,27,27,"IULV-CA",140
11,"11022",48624,26656,26430,345,226,"IULV-CA",1431
18,"18095",1916,1428,1306,21,122,"IULV-CA",156
18,"18157",1062,793,783,9,10,"IULV-CA",45
21,"21052",4741,2897,2839,21,58,"IULV-CA",345
41,"41043",647,457,454,5,3,"IULV-CA",24
21,"21079",749,556,553,6,3,"IULV-CA",75
29,"29039",2822,2091,2074,8,17,"IULV-CA",617
21,"21018",1821,1283,1273,19,10,"IULV-CA",77
18,"18035",1254,991,982,7,9,"IULV-CA",23
11,"11010",6452,4534,4510,61,24,"IULV-CA",621
23,"23902",2495,2081,2067,4,14,"IULV-CA",50
23,"23031",771,649,646,6,3,"IULV-CA",47
18,"18179",583,417,409,7,8,"IULV-CA",19
29,"29046",2777,2032,2013,10,19,"IULV-CA",157
41,"41102",14343,11050,10837,206,213,"IULV-CA",1489
41,"41017",13878,10053,9926,130,127,"IULV-CA",586
23,"23001",1058,922,920,6,2,"IULV-CA",20
41,"41087",9827,7300,7150,51,150,"IULV-CA",379
21,"21005",15205,11006,10909,108,97,"IULV-CA",985
18,"18141",484,326,325,1,1,"IULV-CA",16
18,"18016",339,254,253,2,1,"IULV-CA",8
18,"18192",1581,1331,1318,6,13,"IULV-CA",157
18,"18107",988,769,760,3,9,"IULV-CA",18
29,"29012",9817,7063,6991,51,72,"IULV-CA",770
23,"23099",4649,3638,3594,39,44,"IULV-CA",168
29,"29003",1133,902,900,5,2,"IULV-CA",130
41,"41023",7901,6050,5972,45,78,"IULV-CA",524
41,"41032",4059,3122,3062,22,60,"IULV-CA",311
23,"23010",14447,10777,10704,109,73,"IULV-CA",560
18,"18023",16072,11594,11488,131,106,"IULV-CA",722
23,"23075",3404,2800,2782,24,18,"IULV-CA",186
11,"11016",14611,9848,9774,114,74,"IULV-CA",1171
29,"29045",1750,1246,1239,6,7,"IULV-CA",71
18,"18167",1927,1397,1380,13,17,"IULV-CA",77
29,"29044",866,631,627,3,4,"IULV-CA",22
18,"18066",2072,1558,1552,8,6,"IULV-CA",127
11,"11037",5640,4337,4285,32,52,"IULV-CA",2200
21,"21074",2752,1981,1968,15,13,"IULV-CA",141
18,"18089",15803,10794,10712,95,82,"IULV-CA",566
18,"18069",506,375,371,4,4,"IULV-CA",30
14,"14031",634,516,514,1,2,"IULV-CA",19
18,"18047",5603,3833,3805,67,28,"IULV-CA",355
41,"41019",4528,3194,3168,41,26,"IULV-CA",326
41,"41080",1289,1010,997,13,13,"IULV-CA",48
18,"18133",2256,1783,1773,12,10,"IULV-CA",40
29,"29069",80337,50235,49723,690,512,"IULV-CA",3815
23,"23098",923,808,807,6,1,"IULV-CA",32
18,"18153",8348,6170,6118,88,52,"IULV-CA",986
41,"41057",299,191,189,0,2,"IULV-CA",14
23,"23019",1590,1355,1339,7,16,"IULV-CA",323
29,"29027",2416,1907,1893,15,14,"IULV-CA",226
21,"21028",419,320,315,3,5,"IULV-CA",26
41,"41040",9567,7305,7210,93,95,"IULV-CA",391
14,"14016",1406,1123,1115,9,8,"IULV-CA",142
18,"18182",1982,1405,1397,6,8,"IULV-CA",54
41,"41020",12710,8954,8882,91,72,"IULV-CA",705
23,"23006",4644,3913,3871,36,42,"IULV-CA",192
21,"21019",645,464,458,2,6,"IULV-CA",41
41,"41061",2205,1798,1770,2,28,"IULV-CA",1161
29,"29047",1165,973,969,0,4,"IULV-CA",245
18,"18010",576,464,458,4,6,"IULV-CA",23
14,"14040",3821,2986,2949,40,37,"IULV-CA",1048
41,"41006",2743,1972,1957,13,15,"IULV-CA",95
18,"18134",5528,3751,3679,57,72,"IULV-CA",342
21,"21063",2624,2109,2097,13,12,"IULV-CA",71
18,"18903",960,761,753,1,8,"IULV-CA",20
41,"41084",2875,2362,2335,9,27,"IULV-CA",212
29,"29008",14069,9934,9859,118,75,"IULV-CA",654
11,"11030",22528,14741,14557,195,184,"IULV-CA",865
41,"41004",55127,37662,37179,622,483,"IULV-CA",2989
21,"21060",11685,8026,7932,135,94,"IULV-CA",315
29,"29071",915,601,598,4,3,"IULV-CA",34
14,"14065",1846,1509,1492,14,17,"IULV-CA",118
41,"41002",1510,1161,1140,4,21,"IULV-CA",78
41,"41050",5102,4224,4183,39,41,"IULV-CA",498
18,"18149",5096,3949,3900,36,49,"IULV-CA",241
29,"29054",39904,27540,27307,240,233,"IULV-CA",1492
11,"11902",3578,2400,2376,21,24,"IULV-CA",79
18,"18189",723,547,541,6,6,"IULV-CA",76
18,"18021",16026,11376,11219,186,157,"IULV-CA",798
14,"14028",333,279,277,1,2,"IULV-CA",5
23,"23067",2523,2004,1974,16,30,"IULV-CA",358
29,"29061",1045,861,855,7,6,"IULV-CA",270
18,"18028",992,826,821,4,5,"IULV-CA",46
23,"23044",4897,3943,3893,13,50,"IULV-CA",651
23,"23071",1811,1444,1431,13,13,"IULV-CA",48
21,"21055",6320,4819,4760,46,59,"IULV-CA",194
29,"29030",839,669,668,5,1,"IULV-CA",163
41,"41098",4650,3665,3603,43,62,"IULV-CA",193
14,"14049",16358,12577,12478,137,99,"IULV-CA",1196
14,"14063",1121,875,866,9,9,"IULV-CA",26
14,"14009",2864,2021,2003,8,18,"IULV-CA",204
18,"18911",6796,4923,4867,74,56,"IULV-CA",375
18,"18074",297,245,245,5,0,"IULV-CA",6
11,"11032",53183,32205,31982,441,223,"IULV-CA",3706
18,"18064",419,347,345,3,2,"IULV-CA",4
21,"21009",916,622,608,6,14,"IULV-CA",90
23,"23085",2350,1963,1956,8,7,"IULV-CA",82
18,"18033",282,227,226,0,1,"IULV-CA",8
29,"29099",958,739,730,5,9,"IULV-CA",16
41,"41051",2103,1705,1686,7,19,"IULV-CA",71
23,"23047",1658,1342,1339,6,3,"IULV-CA",54
41,"41058",16497,12415,12248,181,167,"IULV-CA",1158
21,"21007",6088,4174,4123,57,51,"IULV-CA",507
18,"18059",4055,3232,3191,37,41,"IULV-CA",543
18,"18116",2972,2237,2213,19,24,"IULV-CA",119
18,"18127",15897,11597,11483,133,114,"IULV-CA",1362
29,"29009",1525,1126,1109,9,17,"IULV-CA",273
11,"11013",2284,1691,1670,15,21,"IULV-CA",284
23,"23028",6428,4855,4802,26,53,"IULV-CA",326
23,"23070",4142,2877,2846,20,31,"IULV-CA",103
14,"14017",10755,8220,8149,101,71,"IULV-CA",514
18,"18121",135,109,109,0,0,"IULV-CA",6
11,"11029",5360,3445,3423,27,22,"IULV-CA",825
21,"21043",1898,1382,1350,9,32,"IULV-CA",86
18,"18015",465,381,379,1,2,"IULV-CA",37
11,"11017",3219,2403,2388,18,15,"IULV-CA",512
41,"41063",2678,1869,1853,22,16,"IULV-CA",245
18,"18082",912,691,683,8,8,"IULV-CA",28
11,"11006",24221,16564,16470,197,94,"IULV-CA",783
21,"21035",9657,6943,6871,64,72,"IULV-CA",388
14,"14029",4380,3344,3308,35,36,"IULV-CA",137
23,"23009",12876,10335,10231,109,104,"IULV-CA",588
29,"29011",3013,1893,1876,7,17,"IULV-CA",126
21,"21059",203,166,162,1,4,"IULV-CA",11
18,"18017",17990,12070,11962,80,108,"IULV-CA",890
14,"14062",1114,889,882,9,7,"IULV-CA",18
14,"14071",1025,739,733,8,6,"IULV-CA",36
11,"11034",2381,1807,1784,19,23,"IULV-CA",154
18,"18027",2575,1913,1899,15,14,"IULV-CA",373
29,"29063",358,272,271,2,1,"IULV-CA",14
21,"21015",728,453,447,6,6,"IULV-CA",47
18,"18070",287,240,239,2,1,"IULV-CA",12
18,"18158",10328,7336,7254,69,82,"IULV-CA",737
11,"11014",16318,11093,11031,144,62,"IULV-CA",1604
18,"18145",10083,7592,7499,78,93,"IULV-CA",537
11,"11004",87610,53062,52639,828,423,"IULV-CA",3222
23,"23072",2063,1661,1643,16,18,"IULV-CA",54
14,"14021",259993,183200,181402,2936,1798,"IULV-CA",16274
18,"18083",296,242,242,1,0,"IULV-CA",6
18,"18061",1109,882,869,1,13,"IULV-CA",119
29,"29033",1385,878,868,4,10,"IULV-CA",65
23,"23015",1476,1189,1179,10,10,"IULV-CA",47
14,"14055",18619,13802,13607,192,195,"IULV-CA",771
21,"21042",15246,8640,8572,154,68,"IULV-CA",283
18,"18108",892,674,673,2,1,"IULV-CA",45
21,"21067",418,318,312,5,6,"IULV-CA",29
14,"14004",2016,1560,1543,8,17,"IULV-CA",64
18,"18135",4752,3252,3212,34,40,"IULV-CA",143
21,"21047",1965,1355,1325,17,30,"IULV-CA",280
23,"23027",763,619,616,1,3,"IULV-CA",7
21,"21011",3531,2672,2639,15,33,"IULV-CA",179
23,"23026",3872,3051,2994,23,57,"IULV-CA",100
23,"23086",11411,8918,8798,129,120,"IULV-CA",927
21,"21006",3565,2477,2441,29,36,"IULV-CA",147
18,"18029",1892,1355,1347,6,8,"IULV-CA",30
18,"18086",397,321,321,3,0,"IULV-CA",9
23,"23008",1552,1280,1266,9,14,"IULV-CA",115
21,"21075",375,294,291,12,3,"IULV-CA",3
41,"41060",15176,10797,10693,114,104,"IULV-CA",803
41,"41077",8817,6520,6375,53,145,"IULV-CA",1168
18,"18032",248,166,166,2,0,"IULV-CA",9
14,"14039",2705,2204,2189,12,15,"IULV-CA",151
21,"21027",67,52,52,0,0,"IULV-CA",0
21,"21026",255,181,169,2,12,"IULV-CA",17
23,"23012",4250,3235,3216,19,19,"IULV-CA",113
18,"18063",1189,795,789,7,6,"IULV-CA",24
18,"18140",42971,28391,28126,335,265,"IULV-CA",2080
14,"14014",2610,2160,2125,19,35,"IULV-CA",118
29,"29034",462,360,357,0,3,"IULV-CA",17
41,"41093",17665,13712,13526,179,186,"IULV-CA",703
11,"11008",16655,11309,11189,184,120,"IULV-CA",618
11,"11027",67042,43386,43065,557,321,"IULV-CA",3587
41,"41096",6079,4673,4595,47,78,"IULV-CA",458
14,"14010",4087,3144,3121,15,23,"IULV-CA",254
14,"14058",8116,6274,6215,76,59,"IULV-CA",564
14,"14001",3633,3095,3064,25,31,"IULV-CA",395
41,"41083",1176,915,908,8,7,"IULV-CA",24
21,"21037",491,386,378,1,8,"IULV-CA",24
23,"23017",1668,1392,1377,10,15,"IULV-CA",48
18,"18105",5222,3866,3839,32,27,"IULV-CA",702
23,"23092",27970,20921,20651,284,270,"IULV-CA",1580
41,"41001",1642,1314,1302,10,12,"IULV-CA",219
23,"23061",7309,5637,5584,60,53,"IULV-CA",156
11,"11019",1871,1449,1425,9,24,"IULV-CA",167
23,"23038",3273,2658,2638,29,20,"IULV-CA",98
41,"41072",4083,3073,3046,12,27,"IULV-CA",966
23,"23029",924,730,727,2,3,"IULV-CA",6
23,"23069",5489,4656,4586,36,70,"IULV-CA",147
21,"21010",14308,8960,8861,154,99,"IULV-CA",506
18,"18907",1997,1627,1612,5,15,"IULV-CA",24
18,"18098",6440,4743,4679,44,64,"IULV-CA",243
14,"14018",3795,3004,2970,24,34,"IULV-CA",497
23,"23032",598,518,515,0,3,"IULV-CA",25
41,"41092",7649,5816,5738,39,78,"IULV-CA",270
14,"14056",23507,17245,17071,259,174,"IULV-CA",1298
18,"18025",326,242,238,0,4,"IULV-CA",15
29,"29029",452,339,336,0,3,"IULV-CA",9
29,"29058",1560,1103,1096,5,7,"IULV-CA",66
18,"18164",1881,1351,1342,16,9,"IULV-CA",72
41,"41026",4273,3577,3538,15,39,"IULV-CA",1087
41,"41008",1073,884,875,0,9,"IULV-CA",89
29,"29086",814,538,536,9,2,"IULV-CA",44
29,"29036",670,504,499,4,5,"IULV-CA",110
14,"14054",13632,10857,10652,194,205,"IULV-CA",620
41,"41071",5603,3999,3932,28,67,"IULV-CA",803
23,"23905",1884,1447,1438,4,9,"IULV-CA",49
11,"11039",9943,6634,6582,104,52,"IULV-CA",390
18,"18093",2580,1837,1820,8,17,"IULV-CA",43
29,"29007",25572,17726,17564,227,162,"IULV-CA",1403
18,"18173",8858,6238,6187,64,51,"IULV-CA",555
18,"18050",1657,1209,1196,5,13,"IULV-CA",109
14,"14075",624,508,500,8,8,"IULV-CA",38
18,"18001",288,212,212,1,0,"IULV-CA",4
18,"18006",4116,2862,2831,25,31,"IULV-CA",164
41,"41048",2296,1749,1726,21,23,"IULV-CA",77
18,"18054",879,646,644,4,2,"IULV-CA",23
23,"23025",2845,2292,2271,17,21,"IULV-CA",63
29,"29081",290,226,226,3,0,"IULV-CA",3
14,"14012",6305,4749,4690,44,59,"IULV-CA",582
29,"29005",4307,2967,2951,18,16,"IULV-CA",132
18,"18184",2140,1663,1645,18,18,"IULV-CA",153
18,"18007",808,602,591,5,11,"IULV-CA",30
29,"29017",6766,5162,5114,48,48,"IULV-CA",746
23,"23077",668,523,518,2,5,"IULV-CA",14
4,"4072",339,272,271,0,1,"IULV-CA",5
4,"4001",1139,890,884,6,6,"IULV-CA",34
4,"4024",3049,2396,2361,19,35,"IULV-CA",164
4,"4094",206,152,152,0,0,"IULV-CA",4
4,"4036",246,205,204,1,1,"IULV-CA",8
4,"4089",805,607,597,1,10,"IULV-CA",39
4,"4056",144,118,118,0,0,"IULV-CA",5
4,"4055",418,368,367,5,1,"IULV-CA",12
4,"4071",452,364,363,1,1,"IULV-CA",18
4,"4002",1146,891,884,1,7,"IULV-CA",40
4,"4901",576,427,426,5,1,"IULV-CA",28
4,"4037",1393,1090,1079,8,11,"IULV-CA",50
4,"4097",299,229,227,0,2,"IULV-CA",15
4,"4045",1877,1512,1497,23,15,"IULV-CA",73
4,"4038",3140,2258,2231,44,27,"IULV-CA",143
4,"4083",1933,1511,1497,16,14,"IULV-CA",79
4,"4032",5476,3666,3643,34,23,"IULV-CA",209
4,"4019",269,210,209,3,1,"IULV-CA",10
4,"4046",826,645,634,4,11,"IULV-CA",25
4,"4067",657,526,524,1,2,"IULV-CA",40
4,"4101",3927,2827,2804,34,23,"IULV-CA",140
4,"4004",458,367,364,6,3,"IULV-CA",15
4,"4073",389,289,286,4,3,"IULV-CA",7
4,"4044",1517,1232,1224,8,8,"IULV-CA",72
4,"4050",818,611,602,5,9,"IULV-CA",41
4,"4082",309,216,214,3,2,"IULV-CA",8
4,"4902",42901,28927,28711,338,216,"IULV-CA",1314
4,"4098",1616,1255,1249,7,6,"IULV-CA",51
4,"4079",45851,31893,31644,430,249,"IULV-CA",1946
4,"4027",260,186,186,0,0,"IULV-CA",4
4,"4009",165,124,122,2,2,"IULV-CA",2
4,"4008",530,423,418,4,5,"IULV-CA",13
4,"4092",2897,2351,2325,13,26,"IULV-CA",136
4,"4029",10682,7542,7474,63,68,"IULV-CA",241
4,"4087",198,162,159,2,3,"IULV-CA",6
4,"4063",1199,871,862,6,9,"IULV-CA",37
4,"4061",668,541,536,7,5,"IULV-CA",14
4,"4035",8213,6218,6171,51,47,"IULV-CA",198
4,"4068",187,137,137,1,0,"IULV-CA",0
4,"4054",384,328,325,0,3,"IULV-CA",13
4,"4057",1454,1081,1071,1,10,"IULV-CA",73
4,"4031",2495,1942,1931,13,11,"IULV-CA",69
4,"4052",11567,8189,8124,158,65,"IULV-CA",588
4,"4074",2731,1959,1936,26,23,"IULV-CA",111
4,"4011",2814,2283,2263,25,20,"IULV-CA",193
4,"4033",161,120,119,1,1,"IULV-CA",3
4,"4103",1555,1159,1157,8,2,"IULV-CA",12
4,"4088",2516,1849,1832,7,17,"IULV-CA",77
4,"4091",380,322,318,3,4,"IULV-CA",10
4,"4099",5086,4023,3980,26,43,"IULV-CA",127
4,"4078",1069,837,832,6,5,"IULV-CA",169
4,"4064",2585,1817,1803,18,14,"IULV-CA",110
4,"4020",361,265,263,1,2,"IULV-CA",0
4,"4090",435,338,335,3,3,"IULV-CA",12
4,"4102",12940,9247,9152,90,95,"IULV-CA",414
4,"4100",7918,5465,5425,52,40,"IULV-CA",223
4,"4070",1649,1267,1255,9,12,"IULV-CA",52
4,"4080",194,169,168,1,1,"IULV-CA",7
4,"4095",777,547,541,8,6,"IULV-CA",45
4,"4012",230,195,195,2,0,"IULV-CA",3
4,"4043",520,439,435,3,4,"IULV-CA",11
4,"4065",387,320,318,1,2,"IULV-CA",13
4,"4053",12062,9283,9180,119,103,"IULV-CA",334
4,"4085",453,384,383,0,1,"IULV-CA",11
4,"4048",1459,1110,1100,11,10,"IULV-CA",70
4,"4093",1869,1341,1334,10,7,"IULV-CA",65
4,"4015",149,115,115,0,0,"IULV-CA",3
4,"4086",1903,1376,1371,11,5,"IULV-CA",36
4,"4006",7156,5175,5106,51,69,"IULV-CA",184
4,"4022",375,296,295,0,1,"IULV-CA",10
4,"4018",293,250,245,2,5,"IULV-CA",7
4,"4023",144,116,116,2,0,"IULV-CA",3
4,"4016",2184,1699,1677,15,22,"IULV-CA",65
4,"4049",4981,3652,3630,34,22,"IULV-CA",166
4,"4060",486,373,372,0,1,"IULV-CA",16
4,"4903",4331,3183,3164,31,19,"IULV-CA",106
4,"4034",152,106,105,1,1,"IULV-CA",4
4,"4059",1231,837,830,8,7,"IULV-CA",25
4,"4077",343,313,313,1,0,"IULV-CA",6
4,"4021",188,157,157,2,0,"IULV-CA",4
4,"4014",162,136,136,0,0,"IULV-CA",4
4,"4028",239,212,207,0,5,"IULV-CA",9
4,"4075",4783,3731,3700,33,31,"IULV-CA",136
4,"4069",4729,3740,3706,52,34,"IULV-CA",217
4,"4066",13570,9018,8963,97,55,"IULV-CA",423
4,"4017",1337,965,960,7,5,"IULV-CA",48
4,"4007",791,599,599,5,0,"IULV-CA",73
4,"4026",75,58,58,0,0,"IULV-CA",2
4,"4047",2290,1956,1937,9,19,"IULV-CA",58
4,"4005",631,531,524,6,7,"IULV-CA",15
4,"4010",602,492,491,10,1,"IULV-CA",24
4,"4030",1222,930,924,5,6,"IULV-CA",33
4,"4013",137455,94867,94142,1203,725,"IULV-CA",6004
4,"4076",1325,1050,1041,7,9,"IULV-CA",45
4,"4003",17244,11933,11840,94,93,"IULV-CA",332
4,"4081",367,312,309,0,3,"IULV-CA",45
4,"4062",4604,3711,3654,22,57,"IULV-CA",152
4,"4041",334,247,245,0,2,"IULV-CA",13
4,"4084",370,290,285,6,5,"IULV-CA",17
4,"4058",402,324,322,5,2,"IULV-CA",15
4,"4051",476,406,400,3,6,"IULV-CA",9
4,"4096",293,220,219,1,1,"IULV-CA",14
28,"28146",1672,1220,1205,4,15,"IU-LV",49
28,"28158",632,505,495,4,10,"IU-LV",16
28,"28112",168,138,137,0,1,"IU-LV",5
28,"28051",1469,1147,1129,7,18,"IU-LV",77
28,"28010",9309,7304,7229,71,75,"IU-LV",599
28,"28140",2665,2167,2141,26,26,"IU-LV",114
28,"28179",1385,1039,1027,10,12,"IU-LV",75
28,"28099",1670,1258,1246,9,12,"IU-LV",66
28,"28903",29222,23945,23689,296,256,"IU-LV",2192
28,"28069",51,35,33,1,2,"IU-LV",3
28,"28143",81,71,67,1,4,"IU-LV",4
28,"28020",145,102,100,0,2,"IU-LV",16
28,"28084",15408,11489,11355,122,134,"IU-LV",1120
28,"28024",156,132,132,5,0,"IU-LV",18
28,"28064",143,112,110,1,2,"IU-LV",5
28,"28089",3531,2786,2753,25,33,"IU-LV",163
28,"28011",437,318,315,2,3,"IU-LV",33
28,"28172",7648,6130,6076,65,54,"IU-LV",365
28,"28114",148,110,110,0,0,"IU-LV",6
28,"28029",538,416,414,4,2,"IU-LV",24
28,"28132",10987,8066,7943,90,123,"IU-LV",672
28,"28078",39,23,23,1,0,"IU-LV",2
28,"28171",4148,2972,2929,21,43,"IU-LV",102
28,"28106",72603,53231,52524,681,707,"IU-LV",5683
28,"28167",7818,6016,5942,82,74,"IU-LV",498
28,"28122",504,367,366,2,1,"IU-LV",26
28,"28035",1314,1058,1046,3,12,"IU-LV",80
28,"28101",222,158,158,4,0,"IU-LV",12
28,"28124",83,55,53,0,2,"IU-LV",4
28,"28150",2985,2363,2345,21,18,"IU-LV",178
28,"28126",59,37,37,0,0,"IU-LV",0
28,"28072",5232,4065,4007,35,58,"IU-LV",275
28,"28057",1419,1084,1074,12,10,"IU-LV",95
28,"28181",20003,16133,15952,159,181,"IU-LV",832
28,"28148",79726,60405,59651,724,754,"IU-LV",4937
28,"28031",1981,1524,1500,9,24,"IU-LV",71
28,"28086",4603,3286,3248,29,38,"IU-LV",172
28,"28159",629,482,478,2,4,"IU-LV",20
28,"28173",507,397,390,2,7,"IU-LV",17
28,"28082",5144,3967,3905,46,62,"IU-LV",374
28,"28005",132097,100509,99506,1069,1003,"IU-LV",8404
28,"28125",2808,2077,2055,19,22,"IU-LV",148
28,"28095",1358,1092,1077,8,15,"IU-LV",105
28,"28021",418,334,328,4,6,"IU-LV",26
28,"28019",1195,901,888,5,13,"IU-LV",106
28,"28044",5403,4245,4188,27,57,"IU-LV",328
28,"28097",127,94,92,0,2,"IU-LV",11
28,"28052",3799,2753,2719,17,34,"IU-LV",133
28,"28083",8037,6078,6025,66,53,"IU-LV",554
28,"28117",116,90,90,1,0,"IU-LV",10
28,"28147",910,705,698,5,7,"IU-LV",32
28,"28100",3970,2903,2865,32,38,"IU-LV",229
28,"28041",4006,3190,3154,45,36,"IU-LV",201
28,"28088",251,174,173,5,1,"IU-LV",16
28,"28151",3025,2237,2185,9,52,"IU-LV",118
28,"28062",311,233,226,0,7,"IU-LV",13
28,"28155",529,427,416,2,11,"IU-LV",33
28,"28104",11704,9455,9361,119,94,"IU-LV",637
28,"28015",14491,11562,11417,155,145,"IU-LV",699
28,"28046",4208,3297,3272,31,25,"IU-LV",251
28,"28177",9470,7524,7466,87,58,"IU-LV",330
28,"28901",765,579,567,2,12,"IU-LV",47
28,"28157",605,452,446,2,6,"IU-LV",28
28,"28068",10502,7857,7778,68,79,"IU-LV",486
28,"28002",2650,2018,1993,24,25,"IU-LV",110
28,"28168",1144,821,810,15,11,"IU-LV",21
28,"28090",7899,6216,6131,60,85,"IU-LV",498
28,"28174",1745,1233,1224,11,9,"IU-LV",59
28,"28136",618,527,516,2,11,"IU-LV",35
28,"28107",443,338,333,7,5,"IU-LV",19
28,"28128",366,280,275,2,5,"IU-LV",26
28,"28032",4469,3412,3369,32,43,"IU-LV",254
28,"28091",5202,3714,3671,34,43,"IU-LV",364
28,"28048",489,398,389,3,9,"IU-LV",48
28,"28093",1911,1537,1518,19,19,"IU-LV",77
28,"28014",31360,23434,23133,203,301,"IU-LV",1817
28,"28182",219,179,178,2,1,"IU-LV",15
28,"28169",1244,971,962,8,9,"IU-LV",43
28,"28055",932,713,707,5,6,"IU-LV",11
28,"28110",1912,1492,1475,8,17,"IU-LV",94
28,"28001",61,46,45,1,1,"IU-LV",1
28,"28123",48429,38681,38187,429,494,"IU-LV",6506
28,"28074",136617,106248,105095,1101,1153,"IU-LV",9919
28,"28137",1626,1231,1222,9,9,"IU-LV",59
28,"28058",137542,103880,102686,1155,1194,"IU-LV",9535
28,"28180",5179,4033,3975,18,58,"IU-LV",190
28,"28049",59507,46919,46379,488,540,"IU-LV",5137
28,"28094",774,557,551,5,6,"IU-LV",49
28,"28080",45696,36832,36529,402,303,"IU-LV",1646
28,"28092",148714,112174,110838,1215,1336,"IU-LV",9021
28,"28165",1689,1310,1295,5,15,"IU-LV",49
28,"28033",3581,2712,2691,14,21,"IU-LV",159
28,"28026",5852,4506,4449,40,57,"IU-LV",332
28,"28145",2125,1643,1620,15,23,"IU-LV",130
28,"28060",1471,1205,1192,8,13,"IU-LV",148
28,"28144",5663,4456,4410,47,46,"IU-LV",233
28,"28066",7033,5439,5383,45,56,"IU-LV",288
28,"28037",1598,1263,1250,10,13,"IU-LV",56
28,"28059",4061,3169,3130,38,39,"IU-LV",190
28,"28063",268,209,203,4,6,"IU-LV",21
28,"28163",395,305,301,7,4,"IU-LV",22
28,"28096",16844,12441,12308,117,133,"IU-LV",736
28,"28175",780,641,630,8,11,"IU-LV",41
28,"28039",139,103,103,1,0,"IU-LV",9
28,"28116",666,507,498,5,9,"IU-LV",34
28,"28152",14903,11954,11865,125,89,"IU-LV",483
28,"28038",4999,3659,3590,32,69,"IU-LV",404
28,"28160",7496,5680,5613,46,67,"IU-LV",374
28,"28153",608,422,406,1,16,"IU-LV",46
28,"28129",7219,5536,5461,71,75,"IU-LV",352
28,"28113",31318,23779,23436,271,343,"IU-LV",1906
28,"28067",3893,2996,2950,26,46,"IU-LV",228
28,"28176",10977,8790,8718,68,72,"IU-LV",322
28,"28073",11899,8877,8769,112,108,"IU-LV",657
28,"28053",6035,4854,4783,61,71,"IU-LV",391
28,"28115",57612,46786,46458,458,328,"IU-LV",1721
28,"28076",417,325,321,1,4,"IU-LV",21
28,"28006",74554,57439,56890,586,549,"IU-LV",3664
28,"28056",782,604,586,6,18,"IU-LV",62
28,"28050",3576,2706,2663,21,43,"IU-LV",186
28,"28022",30019,24469,24279,292,190,"IU-LV",910
28,"28085",3794,2980,2933,18,47,"IU-LV",209
28,"28023",4350,3425,3392,32,33,"IU-LV",286
28,"28061",19624,15082,14905,162,177,"IU-LV",1081
28,"28166",325,269,268,8,1,"IU-LV",21
28,"28134",55921,42676,42221,505,455,"IU-LV",3560
28,"28170",2503,1744,1727,20,17,"IU-LV",253
28,"28130",27391,21367,21111,235,256,"IU-LV",3042
28,"28040",15089,9976,9852,116,124,"IU-LV",1015
28,"28133",5868,4236,4144,23,92,"IU-LV",246
28,"28030",1591,1268,1230,12,38,"IU-LV",95
28,"28162",2263,1802,1786,32,16,"IU-LV",118
28,"28043",5944,4199,4147,56,52,"IU-LV",237
28,"28045",30286,23148,22879,226,269,"IU-LV",1762
28,"28131",12664,9454,9342,100,112,"IU-LV",641
28,"28119",1911,1527,1514,13,13,"IU-LV",69
28,"28121",185,153,152,0,1,"IU-LV",16
28,"28004",5761,4098,4044,38,54,"IU-LV",237
28,"28149",5276,4132,4063,43,69,"IU-LV",254
28,"28012",830,654,651,6,3,"IU-LV",27
28,"28108",3002,2254,2228,31,26,"IU-LV",171
28,"28109",1621,1121,1104,9,17,"IU-LV",71
28,"28042",1091,814,808,5,6,"IU-LV",48
28,"28008",1734,1244,1221,11,23,"IU-LV",45
28,"28054",10459,7798,7698,65,100,"IU-LV",541
28,"28018",3572,2837,2795,20,42,"IU-LV",242
28,"28164",2807,2194,2173,10,21,"IU-LV",138
28,"28028",1615,1204,1173,11,31,"IU-LV",175
28,"28127",60108,48418,48039,568,379,"IU-LV",2143
28,"28036",2301,1809,1784,13,25,"IU-LV",253
28,"28118",72,49,47,1,2,"IU-LV",4
28,"28111",618,486,479,2,7,"IU-LV",52
28,"28016",86,68,67,3,1,"IU-LV",5
28,"28009",13466,10392,10286,102,106,"IU-LV",682
28,"28034",356,278,276,1,2,"IU-LV",9
28,"28065",118796,93292,92186,919,1106,"IU-LV",9999
28,"28161",44185,33371,32966,353,405,"IU-LV",2568
28,"28156",958,742,733,12,9,"IU-LV",50
28,"28138",78,48,46,0,2,"IU-LV",1
28,"28047",38404,28739,28436,312,303,"IU-LV",2496
28,"28154",5232,3910,3860,40,50,"IU-LV",226
28,"28120",1259,946,931,11,15,"IU-LV",40
28,"28141",5568,4097,4051,31,46,"IU-LV",250
28,"28027",1232,937,919,9,18,"IU-LV",60
28,"28102",913,700,693,9,7,"IU-LV",43
28,"28003",196,154,151,2,3,"IU-LV",13
28,"28079",2290453,1721837,1705310,17342,16527,"IU-LV",134596
28,"28070",139,98,97,0,1,"IU-LV",9
28,"28183",935,663,649,7,14,"IU-LV",70
28,"28135",928,665,659,6,6,"IU-LV",48
28,"28007",122891,95200,94139,990,1061,"IU-LV",7614
28,"28075",5127,3976,3916,42,60,"IU-LV",301
28,"28071",77,57,55,0,2,"IU-LV",6
28,"28902",453,338,329,3,9,"IU-LV",45
28,"28025",426,336,332,2,4,"IU-LV",15
28,"28087",3150,2475,2453,26,22,"IU-LV",135
28,"28013",38226,27886,27547,246,339,"IU-LV",2132
28,"28178",1017,799,791,11,8,"IU-LV",35
28,"28017",1120,905,888,8,17,"IU-LV",69
1,"1037",625,403,398,6,5,"I.U.",9
1,"1902",776,532,526,6,6,"I.U.",27
1,"1041",159,116,113,1,3,"I.U.",3
1,"1018",1395,952,943,7,9,"I.U.",20
1,"1014",385,281,274,6,7,"I.U.",15
1,"1032",536,412,400,0,12,"I.U.",5
1,"1049",147,115,115,1,0,"I.U.",1
1,"1042",915,678,661,1,17,"I.U.",9
1,"1001",2010,1362,1336,26,26,"I.U.",61
1,"1058",1342,877,872,8,5,"I.U.",28
1,"1027",430,283,276,4,7,"I.U.",11
1,"1017",910,629,621,17,8,"I.U.",17
1,"1054",959,680,675,8,5,"I.U.",20
1,"1046",629,428,421,5,7,"I.U.",16
1,"1043",2322,1623,1595,12,28,"I.U.",85
1,"1023",290,236,235,1,1,"I.U.",2
1,"1009",1296,876,863,9,13,"I.U.",26
1,"1016",461,241,237,2,4,"I.U.",11
1,"1052",240,191,191,1,0,"I.U.",4
1,"1060",223,181,178,1,3,"I.U.",10
1,"1047",942,674,655,4,19,"I.U.",28
1,"1062",333,236,232,5,4,"I.U.",12
1,"1019",155,124,124,0,0,"I.U.",3
1,"1053",590,341,333,4,8,"I.U.",10
1,"1004",1427,1021,996,15,25,"I.U.",26
1,"1039",211,164,158,1,6,"I.U.",5
1,"1057",266,212,212,2,0,"I.U.",3
1,"1059",183468,127839,125801,1422,2038,"I.U.",5544
1,"1022",826,615,602,6,13,"I.U.",31
1,"1003",1199,863,848,2,15,"I.U.",7
1,"1061",155,122,122,2,0,"I.U.",3
1,"1031",1229,916,899,13,17,"I.U.",19
1,"1036",15236,10511,10372,141,139,"I.U.",320
1,"1901",2254,1561,1528,24,33,"I.U.",81
1,"1011",245,189,185,7,4,"I.U.",2
1,"1002",8057,5854,5757,48,97,"I.U.",160
1,"1034",177,140,137,1,3,"I.U.",2
1,"1010",2276,1649,1618,27,31,"I.U.",44
1,"1056",256,183,181,1,2,"I.U.",5
1,"1033",679,537,532,2,5,"I.U.",19
1,"1030",170,123,120,1,3,"I.U.",1
1,"1008",781,566,546,7,20,"I.U.",11
1,"1013",711,477,474,1,3,"I.U.",7
1,"1051",3662,2242,2210,26,32,"I.U.",67
1,"1063",1803,1290,1284,18,6,"I.U.",27
1,"1044",242,174,173,1,1,"I.U.",6
1,"1021",473,332,324,3,8,"I.U.",17
1,"1028",1106,773,760,8,13,"I.U.",34
1,"1006",181,133,127,2,6,"I.U.",5
1,"1055",906,632,623,7,9,"I.U.",16
1,"1020",317,222,220,0,2,"I.U.",1
20,"20039",2003,1517,1512,9,5,"IU-LV",14
20,"20063",7889,5381,5340,48,41,"IU-LV",100
20,"20016",1526,937,932,4,5,"IU-LV",13
20,"20021",216,122,122,0,0,"IU-LV",1
20,"20005",1341,890,885,4,5,"IU-LV",11
20,"20062",995,687,667,5,20,"IU-LV",9
20,"20038",382,281,280,1,1,"IU-LV",3
20,"20041",279,153,151,5,2,"IU-LV",3
20,"20003",547,361,359,3,2,"IU-LV",0
20,"20904",98,67,66,0,1,"IU-LV",0
20,"20015",1307,980,979,13,1,"IU-LV",7
20,"20040",15103,9781,9686,148,95,"IU-LV",300
20,"20022",832,527,521,9,6,"IU-LV",5
20,"20052",1154,849,847,14,2,"IU-LV",21
20,"20019",10105,6640,6555,73,85,"IU-LV",185
20,"20008",757,499,499,8,0,"IU-LV",9
20,"20002",347,237,237,8,0,"IU-LV",6
20,"20080",8104,5497,5454,52,43,"IU-LV",240
20,"20006",277,177,175,6,2,"IU-LV",0
20,"20051",7033,4843,4779,57,64,"IU-LV",137
20,"20068",199,132,129,2,3,"IU-LV",3
20,"20029",4283,3014,2998,26,16,"IU-LV",79
20,"20011",1700,1265,1258,11,7,"IU-LV",14
20,"20056",3975,2692,2669,17,23,"IU-LV",41
20,"20001",249,167,167,4,0,"IU-LV",0
20,"20043",1782,1220,1214,13,6,"IU-LV",9
20,"20013",5331,3662,3637,33,25,"IU-LV",127
20,"20905",142,105,103,1,2,"IU-LV",0
20,"20058",770,549,547,3,2,"IU-LV",11
20,"20076",6978,4823,4762,38,61,"IU-LV",163
20,"20027",2809,1929,1918,25,11,"IU-LV",20
20,"20055",17856,11885,11791,91,94,"IU-LV",530
20,"20017",8670,5923,5890,27,33,"IU-LV",114
20,"20034",3192,2035,2030,11,5,"IU-LV",84
20,"20907",136,94,94,0,0,"IU-LV",1
20,"20045",46542,30907,30536,425,371,"IU-LV",1625
20,"20065",3176,2156,2137,19,19,"IU-LV",44
20,"20067",31173,20218,20017,270,201,"IU-LV",1020
20,"20074",11660,8003,7951,31,52,"IU-LV",203
20,"20078",1146,885,884,6,1,"IU-LV",12
20,"20026",214,172,172,0,0,"IU-LV",0
20,"20075",4447,2823,2798,32,25,"IU-LV",80
20,"20010",1392,949,941,8,8,"IU-LV",15
20,"20007",300,203,202,2,1,"IU-LV",1
20,"20903",3625,2282,2267,52,15,"IU-LV",81
20,"20037",100,65,64,2,1,"IU-LV",2
20,"20046",1157,734,729,6,5,"IU-LV",14
20,"20004",254,153,153,5,0,"IU-LV",1
20,"20902",14148,9874,9798,120,76,"IU-LV",399
20,"20070",1109,817,815,4,2,"IU-LV",5
20,"20064",12380,7568,7464,112,104,"IU-LV",373
20,"20079",17229,12010,11927,143,83,"IU-LV",269
20,"20033",884,650,641,4,9,"IU-LV",14
20,"20014",1101,660,654,8,6,"IU-LV",11
20,"20050",293,213,211,3,2,"IU-LV",0
20,"20054",476,350,348,1,2,"IU-LV",4
20,"20059",8816,6335,6293,32,42,"IU-LV",105
20,"20073",4689,3196,3176,28,20,"IU-LV",86
20,"20048",175,102,102,1,0,"IU-LV",3
20,"20061",4011,2666,2653,23,13,"IU-LV",40
20,"20047",494,321,319,2,2,"IU-LV",5
20,"20077",5382,3766,3741,42,25,"IU-LV",142
20,"20081",7346,4957,4925,35,32,"IU-LV",127
20,"20069",146828,101992,101225,1287,767,"IU-LV",3494
20,"20018",11027,7428,7387,53,41,"IU-LV",70
20,"20031",179,114,113,1,1,"IU-LV",1
20,"20906",117,89,89,0,0,"IU-LV",2
20,"20042",3354,2131,2117,18,14,"IU-LV",67
20,"20066",467,316,316,0,0,"IU-LV",0
20,"20009",11794,7805,7725,103,80,"IU-LV",405
20,"20030",22191,15262,15148,164,114,"IU-LV",560
20,"20036",12731,8519,8431,131,88,"IU-LV",256
20,"20012",149,97,97,0,0,"IU-LV",0
20,"20901",1468,951,947,13,4,"IU-LV",22
20,"20060",92,83,82,0,1,"IU-LV",0
20,"20028",2204,1400,1379,11,21,"IU-LV",19
20,"20072",4643,2967,2948,46,19,"IU-LV",93
20,"20071",14488,9499,9419,93,80,"IU-LV",211
20,"20053",4830,2895,2868,36,27,"IU-LV",101
20,"20035",497,346,344,1,2,"IU-LV",2
20,"20023",451,260,259,2,1,"IU-LV",4
20,"20020",143,104,104,1,0,"IU-LV",0
20,"20057",194,122,122,0,0,"IU-LV",2
20,"20044",368,258,257,1,1,"IU-LV",7
20,"20049",4081,2741,2723,30,18,"IU-LV",61
20,"20025",1174,814,803,4,11,"IU-LV",8
20,"20032",8949,6189,6117,55,72,"IU-LV",179
20,"20024",400,238,235,0,3,"IU-LV",3
51,"51001",58533,32223,31745,498,478,"IU-PDSC",576
30,"30028",6810,5333,5251,44,82,"IUV-RM",530
30,"30031",560,471,469,3,2,"IUV-RM",6
30,"30035",17849,12871,12744,133,127,"IUV-RM",547
30,"30002",9802,7628,7553,48,75,"IUV-RM",367
30,"30026",15165,10524,10369,80,155,"IUV-RM",540
30,"30004",1164,958,952,1,6,"IUV-RM",65
30,"30043",24501,19738,19416,230,322,"IUV-RM",1782
30,"30008",13289,9992,9849,86,143,"IUV-RM",926
30,"30005",29081,22312,22142,184,170,"IUV-RM",1083
30,"30034",1182,956,943,3,13,"IUV-RM",22
30,"30037",17942,13830,13734,90,96,"IUV-RM",588
30,"30003",23570,16482,16354,169,128,"IUV-RM",1235
30,"30041",12957,9360,9288,89,72,"IUV-RM",477
30,"30030",305669,236235,234391,2112,1844,"IUV-RM",12965
30,"30022",16489,12207,12042,152,165,"IUV-RM",794
30,"30025",4780,3901,3874,18,27,"IUV-RM",129
30,"30020",5989,4533,4487,14,46,"IUV-RM",352
30,"30006",823,719,711,5,8,"IUV-RM",15
30,"30023",3572,2859,2811,22,48,"IUV-RM",172
30,"30901",10113,8265,8194,70,71,"IUV-RM",455
30,"30032",2839,2361,2337,21,24,"IUV-RM",74
30,"30011",4687,3776,3726,20,50,"IUV-RM",107
30,"30009",11961,9992,9880,92,112,"IUV-RM",589
30,"30014",1686,1400,1387,10,13,"IUV-RM",57
30,"30038",15057,11640,11555,82,85,"IUV-RM",482
30,"30015",18792,14453,14336,120,117,"IUV-RM",729
30,"30040",733,640,635,2,5,"IUV-RM",23
30,"30902",7463,5291,5228,38,63,"IUV-RM",260
30,"30036",13978,10244,10141,94,103,"IUV-RM",329
30,"30013",7369,5780,5731,53,49,"IUV-RM",291
30,"30017",11683,9332,9233,95,99,"IUV-RM",466
30,"30027",45194,35272,34973,366,299,"IUV-RM",1981
30,"30007",6115,4651,4603,29,48,"IUV-RM",166
30,"30029",11533,8854,8768,73,86,"IUV-RM",517
30,"30012",9037,7242,7142,62,100,"IUV-RM",429
30,"30010",6804,5691,5647,36,44,"IUV-RM",166
30,"30039",18615,14213,14068,134,145,"IUV-RM",1179
30,"30033",9940,7794,7700,79,94,"IUV-RM",548
30,"30021",8550,6423,6349,44,74,"IUV-RM",241
30,"30016",149046,103847,102890,1031,957,"IUV-RM",5538
30,"30001",4763,3992,3956,26,36,"IUV-RM",72
30,"30019",25722,18740,18553,164,187,"IUV-RM",1264
30,"30042",1841,1531,1519,10,12,"IUV-RM",61
30,"30024",57868,41894,41513,393,381,"IUV-RM",2954
30,"30018",7493,6003,5922,52,81,"IUV-RM",202
6,"6067",2030,1583,1572,16,11,"IU-VERDES-SIEX: La Izquierda Plural",42
6,"6077",373,307,304,4,3,"IU-VERDES-SIEX: La Izquierda Plural",35
6,"6159",2341,1522,1510,8,12,"IU-VERDES-SIEX: La Izquierda Plural",116
6,"6002",4321,3272,3195,32,77,"IU-VERDES-SIEX: La Izquierda Plural",327
6,"6016",3013,2363,2306,31,57,"IU-VERDES-SIEX: La Izquierda Plural",90
6,"6066",1798,1348,1340,7,8,"IU-VERDES-SIEX: La Izquierda Plural",15
6,"6017",292,250,250,0,0,"IU-VERDES-SIEX: La Izquierda Plural",5
6,"6158",13094,9945,9753,131,192,"IU-VERDES-SIEX: La Izquierda Plural",682
6,"6006",4664,3435,3367,50,68,"IU-VERDES-SIEX: La Izquierda Plural",161
6,"6032",76,59,59,1,0,"IU-VERDES-SIEX: La Izquierda Plural",0
6,"6056",487,411,411,1,0,"IU-VERDES-SIEX: La Izquierda Plural",10
6,"6036",5228,4075,4028,22,47,"IU-VERDES-SIEX: La Izquierda Plural",286
6,"6093",4599,3658,3612,22,46,"IU-VERDES-SIEX: La Izquierda Plural",203
6,"6123",4699,3509,3448,54,61,"IU-VERDES-SIEX: La Izquierda Plural",293
6,"6127",2922,2306,2279,27,27,"IU-VERDES-SIEX: La Izquierda Plural",73
6,"6154",2830,2108,2080,38,28,"IU-VERDES-SIEX: La Izquierda Plural",96
6,"6128",4466,3310,3264,50,46,"IU-VERDES-SIEX: La Izquierda Plural",250
6,"6097",2475,1934,1902,27,32,"IU-VERDES-SIEX: La Izquierda Plural",111
6,"6113",2750,2143,2105,26,38,"IU-VERDES-SIEX: La Izquierda Plural",190
6,"6108",2355,1773,1746,24,27,"IU-VERDES-SIEX: La Izquierda Plural",103
6,"6901",2113,1729,1706,26,23,"IU-VERDES-SIEX: La Izquierda Plural",69
6,"6082",373,315,311,3,4,"IU-VERDES-SIEX: La Izquierda Plural",0
6,"6098",537,436,435,6,1,"IU-VERDES-SIEX: La Izquierda Plural",5
6,"6096",254,202,201,0,1,"IU-VERDES-SIEX: La Izquierda Plural",16
6,"6072",2370,1907,1885,9,22,"IU-VERDES-SIEX: La Izquierda Plural",64
6,"6046",1288,1050,1042,11,8,"IU-VERDES-SIEX: La Izquierda Plural",16
6,"6143",3308,2625,2595,24,30,"IU-VERDES-SIEX: La Izquierda Plural",258
6,"6103",4777,3702,3671,31,31,"IU-VERDES-SIEX: La Izquierda Plural",192
6,"6138",1070,838,829,13,9,"IU-VERDES-SIEX: La Izquierda Plural",48
6,"6043",661,542,532,3,10,"IU-VERDES-SIEX: La Izquierda Plural",26
6,"6149",10390,8354,8215,111,139,"IU-VERDES-SIEX: La Izquierda Plural",347
6,"6047",878,686,680,5,6,"IU-VERDES-SIEX: La Izquierda Plural",18
6,"6012",3263,2498,2476,31,22,"IU-VERDES-SIEX: La Izquierda Plural",252
6,"6015",116077,82756,81836,989,920,"IU-VERDES-SIEX: La Izquierda Plural",4736
6,"6147",390,321,319,3,2,"IU-VERDES-SIEX: La Izquierda Plural",32
6,"6022",2719,2274,2245,14,29,"IU-VERDES-SIEX: La Izquierda Plural",83
6,"6071",257,236,230,1,6,"IU-VERDES-SIEX: La Izquierda Plural",9
6,"6011",24301,17977,17819,268,158,"IU-VERDES-SIEX: La Izquierda Plural",957
6,"6076",854,639,631,9,8,"IU-VERDES-SIEX: La Izquierda Plural",92
6,"6051",1606,1314,1302,10,12,"IU-VERDES-SIEX: La Izquierda Plural",27
6,"6107",1610,1131,1128,6,3,"IU-VERDES-SIEX: La Izquierda Plural",63
6,"6153",20332,15398,15216,239,182,"IU-VERDES-SIEX: La Izquierda Plural",856
6,"6157",497,350,343,0,7,"IU-VERDES-SIEX: La Izquierda Plural",3
6,"6116",1680,1331,1317,15,14,"IU-VERDES-SIEX: La Izquierda Plural",90
6,"6005",1699,1332,1320,19,12,"IU-VERDES-SIEX: La Izquierda Plural",71
6,"6111",502,389,387,8,2,"IU-VERDES-SIEX: La Izquierda Plural",41
6,"6112",411,330,326,0,4,"IU-VERDES-SIEX: La Izquierda Plural",11
6,"6152",1327,983,967,8,16,"IU-VERDES-SIEX: La Izquierda Plural",75
6,"6086",1270,956,949,2,7,"IU-VERDES-SIEX: La Izquierda Plural",25
6,"6092",592,468,456,5,12,"IU-VERDES-SIEX: La Izquierda Plural",13
6,"6139",600,489,481,5,8,"IU-VERDES-SIEX: La Izquierda Plural",17
6,"6031",490,387,385,8,2,"IU-VERDES-SIEX: La Izquierda Plural",5
6,"6057",575,481,474,2,7,"IU-VERDES-SIEX: La Izquierda Plural",9
6,"6061",1116,1000,989,8,11,"IU-VERDES-SIEX: La Izquierda Plural",28
6,"6117",1471,1155,1130,8,25,"IU-VERDES-SIEX: La Izquierda Plural",23
6,"6133",1744,1343,1328,22,15,"IU-VERDES-SIEX: La Izquierda Plural",30
6,"6038",816,621,620,6,1,"IU-VERDES-SIEX: La Izquierda Plural",9
6,"6142",284,240,235,4,5,"IU-VERDES-SIEX: La Izquierda Plural",7
6,"6110",176,130,124,0,6,"IU-VERDES-SIEX: La Izquierda Plural",4
6,"6021",971,761,747,6,14,"IU-VERDES-SIEX: La Izquierda Plural",21
6,"6048",879,758,740,4,18,"IU-VERDES-SIEX: La Izquierda Plural",22
6,"6151",1109,850,846,6,4,"IU-VERDES-SIEX: La Izquierda Plural",43
6,"6041",459,406,404,4,2,"IU-VERDES-SIEX: La Izquierda Plural",52
6,"6122",6620,4904,4797,44,107,"IU-VERDES-SIEX: La Izquierda Plural",340
6,"6118",228,181,181,1,0,"IU-VERDES-SIEX: La Izquierda Plural",1
6,"6001",730,546,538,4,8,"IU-VERDES-SIEX: La Izquierda Plural",58
6,"6034",190,134,129,3,5,"IU-VERDES-SIEX: La Izquierda Plural",9
6,"6162",2964,2415,2390,19,25,"IU-VERDES-SIEX: La Izquierda Plural",45
6,"6020",1852,1476,1462,5,14,"IU-VERDES-SIEX: La Izquierda Plural",81
6,"6120",3508,2772,2741,31,31,"IU-VERDES-SIEX: La Izquierda Plural",183
6,"6106",447,335,333,7,2,"IU-VERDES-SIEX: La Izquierda Plural",17
6,"6060",5865,4657,4592,67,65,"IU-VERDES-SIEX: La Izquierda Plural",325
6,"6121",3436,2700,2662,35,38,"IU-VERDES-SIEX: La Izquierda Plural",153
6,"6068",481,383,378,3,5,"IU-VERDES-SIEX: La Izquierda Plural",14
6,"6042",1017,824,820,5,4,"IU-VERDES-SIEX: La Izquierda Plural",147
6,"6045",513,418,412,8,6,"IU-VERDES-SIEX: La Izquierda Plural",6
6,"6052",3965,3176,3134,33,42,"IU-VERDES-SIEX: La Izquierda Plural",149
6,"6085",3437,2566,2530,32,36,"IU-VERDES-SIEX: La Izquierda Plural",148
6,"6155",1911,1384,1363,18,21,"IU-VERDES-SIEX: La Izquierda Plural",185
6,"6089",607,530,529,2,1,"IU-VERDES-SIEX: La Izquierda Plural",18
6,"6062",638,493,492,3,1,"IU-VERDES-SIEX: La Izquierda Plural",4
6,"6104",701,588,584,12,4,"IU-VERDES-SIEX: La Izquierda Plural",19
6,"6087",2258,1855,1832,24,23,"IU-VERDES-SIEX: La Izquierda Plural",57
6,"6115",1261,893,885,7,8,"IU-VERDES-SIEX: La Izquierda Plural",75
6,"6100",1000,828,821,3,7,"IU-VERDES-SIEX: La Izquierda Plural",18
6,"6069",3116,2316,2288,46,28,"IU-VERDES-SIEX: La Izquierda Plural",74
6,"6902",1688,1325,1313,21,12,"IU-VERDES-SIEX: La Izquierda Plural",89
6,"6081",1114,870,865,10,5,"IU-VERDES-SIEX: La Izquierda Plural",30
6,"6073",787,563,552,9,11,"IU-VERDES-SIEX: La Izquierda Plural",171
6,"6010",1144,903,898,6,5,"IU-VERDES-SIEX: La Izquierda Plural",168
6,"6059",1959,1476,1466,8,10,"IU-VERDES-SIEX: La Izquierda Plural",65
6,"6058",2048,1595,1574,22,21,"IU-VERDES-SIEX: La Izquierda Plural",95
6,"6054",5468,4305,4185,35,120,"IU-VERDES-SIEX: La Izquierda Plural",224
6,"6004",1607,1317,1309,10,8,"IU-VERDES-SIEX: La Izquierda Plural",41
6,"6102",1045,851,840,7,11,"IU-VERDES-SIEX: La Izquierda Plural",19
6,"6099",1127,815,805,6,10,"IU-VERDES-SIEX: La Izquierda Plural",50
6,"6027",732,655,645,8,10,"IU-VERDES-SIEX: La Izquierda Plural",21
6,"6040",1032,807,807,11,0,"IU-VERDES-SIEX: La Izquierda Plural",34
6,"6091",3854,2961,2906,33,55,"IU-VERDES-SIEX: La Izquierda Plural",110
6,"6131",1037,871,865,8,6,"IU-VERDES-SIEX: La Izquierda Plural",127
6,"6145",929,746,743,5,3,"IU-VERDES-SIEX: La Izquierda Plural",32
6,"6130",216,182,180,0,2,"IU-VERDES-SIEX: La Izquierda Plural",9
6,"6137",1035,848,842,2,6,"IU-VERDES-SIEX: La Izquierda Plural",18
6,"6024",1215,1015,1006,4,9,"IU-VERDES-SIEX: La Izquierda Plural",112
6,"6161",335,261,259,2,2,"IU-VERDES-SIEX: La Izquierda Plural",9
6,"6146",1188,951,936,8,15,"IU-VERDES-SIEX: La Izquierda Plural",100
6,"6119",680,539,534,3,5,"IU-VERDES-SIEX: La Izquierda Plural",26
6,"6037",1789,1258,1252,6,6,"IU-VERDES-SIEX: La Izquierda Plural",30
6,"6029",1230,884,880,5,4,"IU-VERDES-SIEX: La Izquierda Plural",116
6,"6014",6843,4894,4839,30,55,"IU-VERDES-SIEX: La Izquierda Plural",220
6,"6160",3190,2343,2314,12,29,"IU-VERDES-SIEX: La Izquierda Plural",122
6,"6008",636,561,552,6,9,"IU-VERDES-SIEX: La Izquierda Plural",8
6,"6039",1848,1564,1546,13,18,"IU-VERDES-SIEX: La Izquierda Plural",115
6,"6055",2105,1623,1599,13,24,"IU-VERDES-SIEX: La Izquierda Plural",81
6,"6132",876,656,648,2,8,"IU-VERDES-SIEX: La Izquierda Plural",121
6,"6148",991,826,818,9,8,"IU-VERDES-SIEX: La Izquierda Plural",120
6,"6025",5083,3898,3851,51,47,"IU-VERDES-SIEX: La Izquierda Plural",425
6,"6125",1852,1419,1399,11,20,"IU-VERDES-SIEX: La Izquierda Plural",51
6,"6084",1105,932,917,5,15,"IU-VERDES-SIEX: La Izquierda Plural",19
6,"6134",561,399,398,5,1,"IU-VERDES-SIEX: La Izquierda Plural",29
6,"6003",875,705,691,4,14,"IU-VERDES-SIEX: La Izquierda Plural",50
6,"6124",1750,1418,1378,17,40,"IU-VERDES-SIEX: La Izquierda Plural",47
6,"6136",1621,1300,1283,11,17,"IU-VERDES-SIEX: La Izquierda Plural",155
6,"6114",152,122,122,0,0,"IU-VERDES-SIEX: La Izquierda Plural",4
6,"6105",655,450,448,1,2,"IU-VERDES-SIEX: La Izquierda Plural",24
6,"6023",4572,3301,3261,34,40,"IU-VERDES-SIEX: La Izquierda Plural",142
6,"6019",2111,1621,1596,24,25,"IU-VERDES-SIEX: La Izquierda Plural",111
6,"6009",214,178,178,2,0,"IU-VERDES-SIEX: La Izquierda Plural",4
6,"6050",4277,3500,3457,36,43,"IU-VERDES-SIEX: La Izquierda Plural",182
6,"6007",1557,1200,1189,4,11,"IU-VERDES-SIEX: La Izquierda Plural",78
6,"6065",327,262,259,2,3,"IU-VERDES-SIEX: La Izquierda Plural",2
6,"6049",1088,847,829,3,18,"IU-VERDES-SIEX: La Izquierda Plural",33
6,"6070",7805,6083,6001,76,82,"IU-VERDES-SIEX: La Izquierda Plural",308
6,"6063",3079,2467,2454,16,13,"IU-VERDES-SIEX: La Izquierda Plural",48
6,"6026",865,671,665,4,6,"IU-VERDES-SIEX: La Izquierda Plural",11
6,"6013",283,245,244,1,1,"IU-VERDES-SIEX: La Izquierda Plural",18
6,"6033",1387,1075,1068,6,7,"IU-VERDES-SIEX: La Izquierda Plural",42
6,"6126",2199,1706,1686,14,20,"IU-VERDES-SIEX: La Izquierda Plural",68
6,"6080",1942,1519,1507,9,12,"IU-VERDES-SIEX: La Izquierda Plural",101
6,"6109",4006,3435,3372,21,63,"IU-VERDES-SIEX: La Izquierda Plural",223
6,"6090",904,724,710,10,14,"IU-VERDES-SIEX: La Izquierda Plural",32
6,"6094",1508,1130,1119,6,11,"IU-VERDES-SIEX: La Izquierda Plural",28
6,"6035",1048,879,871,5,8,"IU-VERDES-SIEX: La Izquierda Plural",20
6,"6088",12879,9362,9222,153,140,"IU-VERDES-SIEX: La Izquierda Plural",587
6,"6064",900,715,706,2,9,"IU-VERDES-SIEX: La Izquierda Plural",141
6,"6053",642,466,454,4,12,"IU-VERDES-SIEX: La Izquierda Plural",31
6,"6079",623,525,522,6,3,"IU-VERDES-SIEX: La Izquierda Plural",19
6,"6129",631,493,490,2,3,"IU-VERDES-SIEX: La Izquierda Plural",43
6,"6141",1803,1419,1397,23,22,"IU-VERDES-SIEX: La Izquierda Plural",37
6,"6150",860,722,710,2,12,"IU-VERDES-SIEX: La Izquierda Plural",141
6,"6030",171,132,131,0,1,"IU-VERDES-SIEX: La Izquierda Plural",0
6,"6101",489,397,395,5,2,"IU-VERDES-SIEX: La Izquierda Plural",7
6,"6140",654,533,523,7,10,"IU-VERDES-SIEX: La Izquierda Plural",5
6,"6028",4366,3881,3809,35,72,"IU-VERDES-SIEX: La Izquierda Plural",136
6,"6135",1094,898,890,14,8,"IU-VERDES-SIEX: La Izquierda Plural",17
6,"6078",548,457,453,2,4,"IU-VERDES-SIEX: La Izquierda Plural",13
6,"6095",9330,6974,6873,129,101,"IU-VERDES-SIEX: La Izquierda Plural",819
6,"6074",4777,3730,3659,41,71,"IU-VERDES-SIEX: La Izquierda Plural",284
6,"6018",808,608,598,5,10,"IU-VERDES-SIEX: La Izquierda Plural",64
6,"6144",588,476,464,2,12,"IU-VERDES-SIEX: La Izquierda Plural",32
6,"6044",28321,21143,20931,232,212,"IU-VERDES-SIEX: La Izquierda Plural",1101
6,"6156",1190,989,978,9,11,"IU-VERDES-SIEX: La Izquierda Plural",58
6,"6083",45013,31929,31491,527,438,"IU-VERDES-SIEX: La Izquierda Plural",2044
6,"6075",517,433,429,3,4,"IU-VERDES-SIEX: La Izquierda Plural",17
10,"10190",569,438,435,6,3,"IU-V-SIEX: LA IZQUIERDA PLURAL",17
10,"10155",1156,829,819,4,10,"IU-V-SIEX: LA IZQUIERDA PLURAL",30
10,"10058",994,751,738,13,13,"IU-V-SIEX: LA IZQUIERDA PLURAL",18
10,"10180",5446,3957,3917,28,40,"IU-V-SIEX: LA IZQUIERDA PLURAL",166
10,"10054",551,435,428,6,7,"IU-V-SIEX: LA IZQUIERDA PLURAL",17
10,"10132",420,293,287,1,6,"IU-V-SIEX: LA IZQUIERDA PLURAL",16
10,"10023",854,688,682,9,6,"IU-V-SIEX: LA IZQUIERDA PLURAL",30
10,"10118",306,262,261,2,1,"IU-V-SIEX: LA IZQUIERDA PLURAL",17
10,"10041",1070,850,846,8,4,"IU-V-SIEX: LA IZQUIERDA PLURAL",20
10,"10031",189,158,158,1,0,"IU-V-SIEX: LA IZQUIERDA PLURAL",9
10,"10141",289,209,209,0,0,"IU-V-SIEX: LA IZQUIERDA PLURAL",4
10,"10219",1408,984,971,11,13,"IU-V-SIEX: LA IZQUIERDA PLURAL",55
10,"10091",391,327,324,3,3,"IU-V-SIEX: LA IZQUIERDA PLURAL",15
10,"10022",442,377,370,1,7,"IU-V-SIEX: LA IZQUIERDA PLURAL",14
10,"10050",1208,1003,983,8,20,"IU-V-SIEX: LA IZQUIERDA PLURAL",16
10,"10131",12797,9017,8922,131,95,"IU-V-SIEX: LA IZQUIERDA PLURAL",400
10,"10185",587,457,450,1,7,"IU-V-SIEX: LA IZQUIERDA PLURAL",14
10,"10096",3384,2581,2533,32,48,"IU-V-SIEX: LA IZQUIERDA PLURAL",210
10,"10158",367,307,306,3,1,"IU-V-SIEX: LA IZQUIERDA PLURAL",5
10,"10072",892,663,655,3,8,"IU-V-SIEX: LA IZQUIERDA PLURAL",15
10,"10153",331,266,263,1,3,"IU-V-SIEX: LA IZQUIERDA PLURAL",12
10,"10029",447,362,355,1,7,"IU-V-SIEX: LA IZQUIERDA PLURAL",12
10,"10103",480,385,380,3,5,"IU-V-SIEX: LA IZQUIERDA PLURAL",19
10,"10128",5805,4456,4336,50,120,"IU-V-SIEX: LA IZQUIERDA PLURAL",243
10,"10140",1143,941,927,9,14,"IU-V-SIEX: LA IZQUIERDA PLURAL",22
10,"10006",1306,1081,1070,7,11,"IU-V-SIEX: LA IZQUIERDA PLURAL",22
10,"10086",342,259,250,5,9,"IU-V-SIEX: LA IZQUIERDA PLURAL",13
10,"10040",455,344,334,8,10,"IU-V-SIEX: LA IZQUIERDA PLURAL",10
10,"10082",1947,1601,1572,10,29,"IU-V-SIEX: LA IZQUIERDA PLURAL",75
10,"10138",551,451,443,7,8,"IU-V-SIEX: LA IZQUIERDA PLURAL",20
10,"10018",1761,1321,1296,17,25,"IU-V-SIEX: LA IZQUIERDA PLURAL",73
10,"10032",1768,1438,1415,9,23,"IU-V-SIEX: LA IZQUIERDA PLURAL",154
10,"10181",739,607,598,6,9,"IU-V-SIEX: LA IZQUIERDA PLURAL",25
10,"10212",1688,1276,1242,16,34,"IU-V-SIEX: LA IZQUIERDA PLURAL",109
10,"10113",2440,1891,1859,11,32,"IU-V-SIEX: LA IZQUIERDA PLURAL",179
10,"10056",605,484,476,5,8,"IU-V-SIEX: LA IZQUIERDA PLURAL",18
10,"10008",1393,1105,1086,10,19,"IU-V-SIEX: LA IZQUIERDA PLURAL",46
10,"10186",1031,906,896,8,10,"IU-V-SIEX: LA IZQUIERDA PLURAL",42
10,"10203",4770,3397,3327,40,70,"IU-V-SIEX: LA IZQUIERDA PLURAL",196
10,"10081",183,143,142,0,1,"IU-V-SIEX: LA IZQUIERDA PLURAL",4
10,"10187",486,349,345,2,4,"IU-V-SIEX: LA IZQUIERDA PLURAL",19
10,"10189",2728,2108,2063,24,45,"IU-V-SIEX: LA IZQUIERDA PLURAL",94
10,"10210",599,453,452,3,1,"IU-V-SIEX: LA IZQUIERDA PLURAL",15
10,"10147",1263,1003,965,5,38,"IU-V-SIEX: LA IZQUIERDA PLURAL",63
10,"10035",1941,1517,1492,15,25,"IU-V-SIEX: LA IZQUIERDA PLURAL",84
10,"10011",611,527,519,5,8,"IU-V-SIEX: LA IZQUIERDA PLURAL",23
10,"10211",461,341,334,3,7,"IU-V-SIEX: LA IZQUIERDA PLURAL",1
10,"10169",587,460,450,2,10,"IU-V-SIEX: LA IZQUIERDA PLURAL",8
10,"10170",269,217,215,4,2,"IU-V-SIEX: LA IZQUIERDA PLURAL",6
10,"10098",412,317,313,5,4,"IU-V-SIEX: LA IZQUIERDA PLURAL",8
10,"10122",253,197,191,2,6,"IU-V-SIEX: LA IZQUIERDA PLURAL",9
10,"10003",616,463,458,3,5,"IU-V-SIEX: LA IZQUIERDA PLURAL",8
10,"10149",434,323,319,1,4,"IU-V-SIEX: LA IZQUIERDA PLURAL",13
10,"10013",305,242,237,1,5,"IU-V-SIEX: LA IZQUIERDA PLURAL",6
10,"10151",245,204,202,2,2,"IU-V-SIEX: LA IZQUIERDA PLURAL",7
10,"10085",334,244,243,1,1,"IU-V-SIEX: LA IZQUIERDA PLURAL",5
10,"10039",448,352,350,0,2,"IU-V-SIEX: LA IZQUIERDA PLURAL",11
10,"10179",340,262,257,3,5,"IU-V-SIEX: LA IZQUIERDA PLURAL",11
10,"10184",771,609,597,7,12,"IU-V-SIEX: LA IZQUIERDA PLURAL",21
10,"10171",376,287,282,0,5,"IU-V-SIEX: LA IZQUIERDA PLURAL",4
10,"10062",421,332,325,3,7,"IU-V-SIEX: LA IZQUIERDA PLURAL",35
10,"10090",552,404,396,3,8,"IU-V-SIEX: LA IZQUIERDA PLURAL",10
10,"10143",169,135,131,1,4,"IU-V-SIEX: LA IZQUIERDA PLURAL",4
10,"10199",181,142,140,1,2,"IU-V-SIEX: LA IZQUIERDA PLURAL",6
10,"10127",4663,3554,3498,38,56,"IU-V-SIEX: LA IZQUIERDA PLURAL",344
10,"10163",374,310,308,0,2,"IU-V-SIEX: LA IZQUIERDA PLURAL",7
10,"10201",202,173,171,3,2,"IU-V-SIEX: LA IZQUIERDA PLURAL",3
10,"10012",615,525,520,4,5,"IU-V-SIEX: LA IZQUIERDA PLURAL",11
10,"10207",499,394,392,1,2,"IU-V-SIEX: LA IZQUIERDA PLURAL",13
10,"10088",244,168,168,0,0,"IU-V-SIEX: LA IZQUIERDA PLURAL",2
10,"10095",346,290,283,3,7,"IU-V-SIEX: LA IZQUIERDA PLURAL",13
10,"10206",237,177,174,0,3,"IU-V-SIEX: LA IZQUIERDA PLURAL",33
10,"10092",316,263,262,1,1,"IU-V-SIEX: LA IZQUIERDA PLURAL",7
10,"10213",605,478,477,1,1,"IU-V-SIEX: LA IZQUIERDA PLURAL",10
10,"10164",770,557,547,2,10,"IU-V-SIEX: LA IZQUIERDA PLURAL",23
10,"10165",274,231,229,0,2,"IU-V-SIEX: LA IZQUIERDA PLURAL",10
10,"10144",999,782,773,7,9,"IU-V-SIEX: LA IZQUIERDA PLURAL",15
10,"10159",341,278,277,1,1,"IU-V-SIEX: LA IZQUIERDA PLURAL",5
10,"10115",3622,2872,2800,52,72,"IU-V-SIEX: LA IZQUIERDA PLURAL",160
10,"10004",733,576,565,6,11,"IU-V-SIEX: LA IZQUIERDA PLURAL",12
10,"10195",7917,6143,6054,36,89,"IU-V-SIEX: LA IZQUIERDA PLURAL",301
10,"10114",926,670,652,8,18,"IU-V-SIEX: LA IZQUIERDA PLURAL",96
10,"10106",144,123,123,4,0,"IU-V-SIEX: LA IZQUIERDA PLURAL",6
10,"10038",98,84,83,0,1,"IU-V-SIEX: LA IZQUIERDA PLURAL",2
10,"10061",1765,1305,1290,13,15,"IU-V-SIEX: LA IZQUIERDA PLURAL",50
10,"10197",143,96,94,1,2,"IU-V-SIEX: LA IZQUIERDA PLURAL",7
10,"10007",680,537,519,5,18,"IU-V-SIEX: LA IZQUIERDA PLURAL",11
10,"10134",585,420,412,1,8,"IU-V-SIEX: LA IZQUIERDA PLURAL",4
10,"10148",32554,23348,22955,365,393,"IU-V-SIEX: LA IZQUIERDA PLURAL",1521
10,"10150",374,331,328,2,3,"IU-V-SIEX: LA IZQUIERDA PLURAL",18
10,"10152",499,424,418,4,6,"IU-V-SIEX: LA IZQUIERDA PLURAL",10
10,"10055",709,523,508,13,15,"IU-V-SIEX: LA IZQUIERDA PLURAL",25
10,"10161",76,59,59,1,0,"IU-V-SIEX: LA IZQUIERDA PLURAL",3
10,"10097",109,97,96,0,1,"IU-V-SIEX: LA IZQUIERDA PLURAL",3
10,"10080",385,294,287,0,7,"IU-V-SIEX: LA IZQUIERDA PLURAL",12
10,"10053",303,253,246,5,7,"IU-V-SIEX: LA IZQUIERDA PLURAL",7
10,"10121",8063,6048,5988,51,60,"IU-V-SIEX: LA IZQUIERDA PLURAL",335
10,"10048",299,232,231,0,1,"IU-V-SIEX: LA IZQUIERDA PLURAL",2
10,"10009",285,223,221,0,2,"IU-V-SIEX: LA IZQUIERDA PLURAL",9
10,"10049",3952,3348,3259,36,89,"IU-V-SIEX: LA IZQUIERDA PLURAL",151
10,"10104",5233,3904,3824,30,80,"IU-V-SIEX: LA IZQUIERDA PLURAL",204
10,"10077",719,551,543,3,8,"IU-V-SIEX: LA IZQUIERDA PLURAL",39
10,"10136",289,229,228,0,1,"IU-V-SIEX: LA IZQUIERDA PLURAL",9
10,"10015",688,539,523,5,16,"IU-V-SIEX: LA IZQUIERDA PLURAL",17
10,"10021",5421,4189,4099,47,90,"IU-V-SIEX: LA IZQUIERDA PLURAL",372
10,"10044",1520,1120,1103,10,17,"IU-V-SIEX: LA IZQUIERDA PLURAL",51
10,"10176",384,300,293,5,7,"IU-V-SIEX: LA IZQUIERDA PLURAL",11
10,"10135",1366,1004,998,3,6,"IU-V-SIEX: LA IZQUIERDA PLURAL",18
10,"10005",551,439,424,4,15,"IU-V-SIEX: LA IZQUIERDA PLURAL",17
10,"10019",1414,1054,1037,10,17,"IU-V-SIEX: LA IZQUIERDA PLURAL",62
10,"10146",1439,991,975,11,16,"IU-V-SIEX: LA IZQUIERDA PLURAL",58
10,"10172",728,531,522,3,9,"IU-V-SIEX: LA IZQUIERDA PLURAL",33
10,"10137",428,373,371,1,2,"IU-V-SIEX: LA IZQUIERDA PLURAL",11
10,"10002",396,317,314,5,3,"IU-V-SIEX: LA IZQUIERDA PLURAL",18
10,"10105",2599,1869,1835,25,34,"IU-V-SIEX: LA IZQUIERDA PLURAL",56
10,"10030",502,364,362,5,2,"IU-V-SIEX: LA IZQUIERDA PLURAL",12
10,"10108",231,152,152,0,0,"IU-V-SIEX: LA IZQUIERDA PLURAL",3
10,"10192",910,679,670,3,9,"IU-V-SIEX: LA IZQUIERDA PLURAL",21
10,"10078",451,349,341,3,8,"IU-V-SIEX: LA IZQUIERDA PLURAL",34
10,"10045",1119,884,859,5,25,"IU-V-SIEX: LA IZQUIERDA PLURAL",25
10,"10167",322,265,264,1,1,"IU-V-SIEX: LA IZQUIERDA PLURAL",4
10,"10174",177,145,145,2,0,"IU-V-SIEX: LA IZQUIERDA PLURAL",9
10,"10120",168,122,119,1,3,"IU-V-SIEX: LA IZQUIERDA PLURAL",5
10,"10107",1062,832,821,7,11,"IU-V-SIEX: LA IZQUIERDA PLURAL",20
10,"10116",3762,2781,2705,36,76,"IU-V-SIEX: LA IZQUIERDA PLURAL",245
10,"10020",1671,1386,1374,14,12,"IU-V-SIEX: LA IZQUIERDA PLURAL",89
10,"10089",1399,1043,1032,15,11,"IU-V-SIEX: LA IZQUIERDA PLURAL",43
10,"10047",978,795,780,9,15,"IU-V-SIEX: LA IZQUIERDA PLURAL",62
10,"10117",264,174,174,2,0,"IU-V-SIEX: LA IZQUIERDA PLURAL",5
10,"10145",132,112,111,0,1,"IU-V-SIEX: LA IZQUIERDA PLURAL",0
10,"10067",10392,7979,7804,111,175,"IU-V-SIEX: LA IZQUIERDA PLURAL",437
10,"10178",797,604,597,5,7,"IU-V-SIEX: LA IZQUIERDA PLURAL",16
10,"10016",321,266,262,2,4,"IU-V-SIEX: LA IZQUIERDA PLURAL",22
10,"10196",309,244,244,1,0,"IU-V-SIEX: LA IZQUIERDA PLURAL",8
10,"10139",117,98,97,1,1,"IU-V-SIEX: LA IZQUIERDA PLURAL",1
10,"10130",1745,1360,1341,10,19,"IU-V-SIEX: LA IZQUIERDA PLURAL",55
10,"10157",289,218,212,1,6,"IU-V-SIEX: LA IZQUIERDA PLURAL",13
10,"10154",194,150,145,0,5,"IU-V-SIEX: LA IZQUIERDA PLURAL",6
10,"10076",825,619,610,7,9,"IU-V-SIEX: LA IZQUIERDA PLURAL",19
10,"10198",1213,1068,1054,12,14,"IU-V-SIEX: LA IZQUIERDA PLURAL",17
10,"10214",226,178,176,2,2,"IU-V-SIEX: LA IZQUIERDA PLURAL",7
10,"10204",489,364,351,3,13,"IU-V-SIEX: LA IZQUIERDA PLURAL",28
10,"10129",374,279,276,2,3,"IU-V-SIEX: LA IZQUIERDA PLURAL",10
10,"10042",79,63,62,2,1,"IU-V-SIEX: LA IZQUIERDA PLURAL",1
10,"10069",858,680,673,2,7,"IU-V-SIEX: LA IZQUIERDA PLURAL",20
10,"10126",1660,1221,1201,9,20,"IU-V-SIEX: LA IZQUIERDA PLURAL",50
10,"10901",1148,844,839,18,5,"IU-V-SIEX: LA IZQUIERDA PLURAL",34
10,"10073",759,589,583,3,6,"IU-V-SIEX: LA IZQUIERDA PLURAL",24
10,"10087",1754,1283,1262,4,21,"IU-V-SIEX: LA IZQUIERDA PLURAL",40
10,"10168",318,240,238,1,2,"IU-V-SIEX: LA IZQUIERDA PLURAL",3
10,"10215",437,338,333,3,5,"IU-V-SIEX: LA IZQUIERDA PLURAL",9
10,"10010",2358,1597,1576,18,21,"IU-V-SIEX: LA IZQUIERDA PLURAL",50
10,"10173",557,436,431,6,5,"IU-V-SIEX: LA IZQUIERDA PLURAL",14
10,"10024",663,490,480,3,10,"IU-V-SIEX: LA IZQUIERDA PLURAL",16
10,"10193",1410,1179,1158,16,21,"IU-V-SIEX: LA IZQUIERDA PLURAL",39
10,"10064",1549,1229,1209,6,20,"IU-V-SIEX: LA IZQUIERDA PLURAL",17
10,"10057",166,133,133,0,0,"IU-V-SIEX: LA IZQUIERDA PLURAL",5
10,"10066",182,136,133,1,3,"IU-V-SIEX: LA IZQUIERDA PLURAL",12
10,"10218",1184,896,893,0,3,"IU-V-SIEX: LA IZQUIERDA PLURAL",15
10,"10063",175,142,142,1,0,"IU-V-SIEX: LA IZQUIERDA PLURAL",11
10,"10102",534,447,440,4,7,"IU-V-SIEX: LA IZQUIERDA PLURAL",11
10,"10052",186,138,138,0,0,"IU-V-SIEX: LA IZQUIERDA PLURAL",3
10,"10133",1247,1045,1028,7,17,"IU-V-SIEX: LA IZQUIERDA PLURAL",65
10,"10036",345,262,251,2,11,"IU-V-SIEX: LA IZQUIERDA PLURAL",11
10,"10160",235,183,183,1,0,"IU-V-SIEX: LA IZQUIERDA PLURAL",10
10,"10209",297,217,213,3,4,"IU-V-SIEX: LA IZQUIERDA PLURAL",12
10,"10083",105,74,74,0,0,"IU-V-SIEX: LA IZQUIERDA PLURAL",5
10,"10001",270,231,229,2,2,"IU-V-SIEX: LA IZQUIERDA PLURAL",7
10,"10075",276,189,189,1,0,"IU-V-SIEX: LA IZQUIERDA PLURAL",11
10,"10014",1907,1507,1488,14,19,"IU-V-SIEX: LA IZQUIERDA PLURAL",24
10,"10205",2081,1486,1457,19,29,"IU-V-SIEX: LA IZQUIERDA PLURAL",117
10,"10110",2326,1751,1703,11,48,"IU-V-SIEX: LA IZQUIERDA PLURAL",78
10,"10109",1834,1307,1287,18,20,"IU-V-SIEX: LA IZQUIERDA PLURAL",74
10,"10071",179,133,133,1,0,"IU-V-SIEX: LA IZQUIERDA PLURAL",2
10,"10162",616,505,496,1,9,"IU-V-SIEX: LA IZQUIERDA PLURAL",24
10,"10175",1509,1149,1127,4,22,"IU-V-SIEX: LA IZQUIERDA PLURAL",52
10,"10183",1022,818,805,5,13,"IU-V-SIEX: LA IZQUIERDA PLURAL",32
10,"10037",74974,56844,55950,898,894,"IU-V-SIEX: LA IZQUIERDA PLURAL",3300
10,"10124",873,707,707,16,0,"IU-V-SIEX: LA IZQUIERDA PLURAL",25
10,"10156",116,91,91,0,0,"IU-V-SIEX: LA IZQUIERDA PLURAL",4
10,"10046",216,185,184,1,1,"IU-V-SIEX: LA IZQUIERDA PLURAL",11
10,"10191",527,421,414,3,7,"IU-V-SIEX: LA IZQUIERDA PLURAL",37
10,"10202",665,533,523,7,10,"IU-V-SIEX: LA IZQUIERDA PLURAL",13
10,"10123",601,502,492,0,10,"IU-V-SIEX: LA IZQUIERDA PLURAL",13
10,"10065",188,123,123,1,0,"IU-V-SIEX: LA IZQUIERDA PLURAL",7
10,"10017",884,681,673,6,8,"IU-V-SIEX: LA IZQUIERDA PLURAL",14
10,"10208",141,118,118,1,0,"IU-V-SIEX: LA IZQUIERDA PLURAL",1
10,"10194",557,449,440,0,9,"IU-V-SIEX: LA IZQUIERDA PLURAL",28
10,"10100",792,554,538,1,16,"IU-V-SIEX: LA IZQUIERDA PLURAL",38
10,"10034",376,283,278,5,5,"IU-V-SIEX: LA IZQUIERDA PLURAL",11
10,"10119",714,489,482,3,7,"IU-V-SIEX: LA IZQUIERDA PLURAL",17
10,"10200",499,368,368,0,0,"IU-V-SIEX: LA IZQUIERDA PLURAL",5
10,"10217",535,423,422,3,1,"IU-V-SIEX: LA IZQUIERDA PLURAL",5
10,"10068",780,624,595,5,29,"IU-V-SIEX: LA IZQUIERDA PLURAL",27
10,"10059",414,352,349,4,3,"IU-V-SIEX: LA IZQUIERDA PLURAL",0
10,"10177",1692,1351,1318,15,33,"IU-V-SIEX: LA IZQUIERDA PLURAL",88
10,"10079",891,711,706,6,5,"IU-V-SIEX: LA IZQUIERDA PLURAL",13
10,"10033",440,340,336,4,4,"IU-V-SIEX: LA IZQUIERDA PLURAL",3
10,"10094",247,212,211,0,1,"IU-V-SIEX: LA IZQUIERDA PLURAL",15
10,"10903",813,620,615,3,5,"IU-V-SIEX: LA IZQUIERDA PLURAL",29
10,"10182",146,112,108,0,4,"IU-V-SIEX: LA IZQUIERDA PLURAL",4
10,"10051",489,373,373,2,0,"IU-V-SIEX: LA IZQUIERDA PLURAL",1
10,"10166",351,246,238,2,8,"IU-V-SIEX: LA IZQUIERDA PLURAL",2
10,"10093",413,339,332,2,7,"IU-V-SIEX: LA IZQUIERDA PLURAL",17
10,"10902",727,608,599,5,9,"IU-V-SIEX: LA IZQUIERDA PLURAL",9
10,"10216",1549,1247,1235,15,12,"IU-V-SIEX: LA IZQUIERDA PLURAL",46
10,"10111",1453,1052,1046,13,6,"IU-V-SIEX: LA IZQUIERDA PLURAL",35
10,"10070",765,614,613,5,1,"IU-V-SIEX: LA IZQUIERDA PLURAL",29
10,"10043",866,636,622,1,14,"IU-V-SIEX: LA IZQUIERDA PLURAL",26
10,"10142",822,635,625,4,10,"IU-V-SIEX: LA IZQUIERDA PLURAL",54
10,"10026",598,458,447,5,11,"IU-V-SIEX: LA IZQUIERDA PLURAL",32
10,"10112",1582,1299,1284,5,15,"IU-V-SIEX: LA IZQUIERDA PLURAL",77
10,"10027",88,78,78,0,0,"IU-V-SIEX: LA IZQUIERDA PLURAL",2
10,"10028",125,88,88,0,0,"IU-V-SIEX: LA IZQUIERDA PLURAL",4
10,"10125",925,705,689,3,16,"IU-V-SIEX: LA IZQUIERDA PLURAL",44
10,"10101",172,134,129,1,5,"IU-V-SIEX: LA IZQUIERDA PLURAL",3
10,"10099",633,458,450,4,8,"IU-V-SIEX: LA IZQUIERDA PLURAL",21
10,"10060",1037,758,742,9,16,"IU-V-SIEX: LA IZQUIERDA PLURAL",17
10,"10025",408,355,337,4,18,"IU-V-SIEX: LA IZQUIERDA PLURAL",13
10,"10188",553,473,468,2,5,"IU-V-SIEX: LA IZQUIERDA PLURAL",7
10,"10084",1416,994,972,12,22,"IU-V-SIEX: LA IZQUIERDA PLURAL",50
51,"51001",58533,32223,31745,498,478,"LV-GV",289
30,"30004",1164,958,952,1,6,"+MAS+",0
30,"30029",11533,8854,8768,73,86,"+MAS+",8
30,"30008",13289,9992,9849,86,143,"+MAS+",12
30,"30017",11683,9332,9233,95,99,"+MAS+",2
30,"30043",24501,19738,19416,230,322,"+MAS+",18
30,"30009",11961,9992,9880,92,112,"+MAS+",8
30,"30033",9940,7794,7700,79,94,"+MAS+",1
30,"30025",4780,3901,3874,18,27,"+MAS+",2
30,"30019",25722,18740,18553,164,187,"+MAS+",16
30,"30901",10113,8265,8194,70,71,"+MAS+",11
30,"30028",6810,5333,5251,44,82,"+MAS+",2
30,"30007",6115,4651,4603,29,48,"+MAS+",6
30,"30041",12957,9360,9288,89,72,"+MAS+",8
30,"30020",5989,4533,4487,14,46,"+MAS+",3
30,"30031",560,471,469,3,2,"+MAS+",1
30,"30002",9802,7628,7553,48,75,"+MAS+",6
30,"30037",17942,13830,13734,90,96,"+MAS+",10
30,"30016",149046,103847,102890,1031,957,"+MAS+",137
30,"30039",18615,14213,14068,134,145,"+MAS+",11
30,"30013",7369,5780,5731,53,49,"+MAS+",4
30,"30015",18792,14453,14336,120,117,"+MAS+",12
30,"30003",23570,16482,16354,169,128,"+MAS+",8
30,"30010",6804,5691,5647,36,44,"+MAS+",5
30,"30001",4763,3992,3956,26,36,"+MAS+",4
30,"30034",1182,956,943,3,13,"+MAS+",0
30,"30035",17849,12871,12744,133,127,"+MAS+",14
30,"30005",29081,22312,22142,184,170,"+MAS+",18
30,"30022",16489,12207,12042,152,165,"+MAS+",7
30,"30012",9037,7242,7142,62,100,"+MAS+",7
30,"30040",733,640,635,2,5,"+MAS+",1
30,"30024",57868,41894,41513,393,381,"+MAS+",78
30,"30902",7463,5291,5228,38,63,"+MAS+",9
30,"30011",4687,3776,3726,20,50,"+MAS+",8
30,"30027",45194,35272,34973,366,299,"+MAS+",37
30,"30042",1841,1531,1519,10,12,"+MAS+",0
30,"30006",823,719,711,5,8,"+MAS+",1
30,"30026",15165,10524,10369,80,155,"+MAS+",6
30,"30038",15057,11640,11555,82,85,"+MAS+",6
30,"30023",3572,2859,2811,22,48,"+MAS+",2
30,"30021",8550,6423,6349,44,74,"+MAS+",9
30,"30032",2839,2361,2337,21,24,"+MAS+",1
30,"30014",1686,1400,1387,10,13,"+MAS+",2
30,"30030",305669,236235,234391,2112,1844,"+MAS+",275
30,"30036",13978,10244,10141,94,103,"+MAS+",8
30,"30018",7493,6003,5922,52,81,"+MAS+",4
23,"23086",11411,8918,8798,129,120,"P.A.",58
23,"23097",6510,4687,4639,36,48,"P.A.",49
23,"23066",4348,3687,3654,21,33,"P.A.",16
23,"23038",3273,2658,2638,29,20,"P.A.",8
23,"23060",19107,14365,14264,130,101,"P.A.",481
23,"23032",598,518,515,0,3,"P.A.",3
23,"23905",1884,1447,1438,4,9,"P.A.",8
23,"23005",30698,23126,22916,310,210,"P.A.",659
23,"23056",3182,2539,2523,20,16,"P.A.",17
23,"23045",2180,1671,1667,3,4,"P.A.",11
23,"23010",14447,10777,10704,109,73,"P.A.",104
23,"23094",3917,3200,3166,32,34,"P.A.",17
23,"23021",541,464,453,0,11,"P.A.",1
23,"23054",393,288,286,1,2,"P.A.",8
23,"23034",2591,2146,2124,13,22,"P.A.",63
23,"23091",790,668,664,3,4,"P.A.",5
23,"23085",2350,1963,1956,8,7,"P.A.",172
23,"23042",359,278,277,0,1,"P.A.",1
23,"23096",2678,2298,2276,18,22,"P.A.",13
23,"23065",1701,1238,1226,10,12,"P.A.",2
23,"23025",2845,2292,2271,17,21,"P.A.",27
23,"23035",1066,919,912,3,7,"P.A.",3
23,"23037",513,430,424,3,6,"P.A.",3
23,"23020",1623,1414,1400,16,14,"P.A.",11
23,"23055",48167,33913,33612,400,301,"P.A.",312
23,"23073",4671,3778,3735,19,43,"P.A.",27
23,"23002",17740,14007,13858,171,149,"P.A.",172
23,"23099",4649,3638,3594,39,44,"P.A.",39
23,"23057",823,717,711,4,6,"P.A.",0
23,"23080",1832,1425,1414,3,11,"P.A.",9
23,"23902",2495,2081,2067,4,14,"P.A.",28
23,"23039",2239,1799,1764,9,35,"P.A.",4
23,"23028",6428,4855,4802,26,53,"P.A.",33
23,"23101",413,324,321,3,3,"P.A.",0
23,"23067",2523,2004,1974,16,30,"P.A.",9
23,"23901",1194,1048,1045,8,3,"P.A.",1
23,"23017",1668,1392,1377,10,15,"P.A.",2
23,"23040",1538,1319,1311,3,8,"P.A.",7
23,"23014",2529,2058,2039,13,19,"P.A.",13
23,"23904",3070,2047,2033,19,14,"P.A.",5
23,"23082",1985,1464,1451,9,13,"P.A.",5
23,"23006",4644,3913,3871,36,42,"P.A.",48
23,"23041",519,455,448,2,7,"P.A.",15
23,"23098",923,808,807,6,1,"P.A.",0
23,"23090",1371,1188,1177,6,11,"P.A.",3
23,"23095",8882,6668,6628,31,40,"P.A.",27
23,"23059",5974,4910,4852,37,58,"P.A.",113
23,"23033",1382,1166,1152,7,14,"P.A.",4
23,"23031",771,649,646,6,3,"P.A.",4
23,"23079",3750,3084,3063,19,21,"P.A.",205
23,"23063",3960,3073,3037,21,36,"P.A.",16
23,"23001",1058,922,920,6,2,"P.A.",4
23,"23062",1476,1274,1264,2,10,"P.A.",6
23,"23084",1046,817,812,4,5,"P.A.",5
23,"23053",9431,7160,7128,42,32,"P.A.",29
23,"23024",12634,9916,9673,116,243,"P.A.",113
23,"23012",4250,3235,3216,19,19,"P.A.",10
23,"23043",554,411,407,6,4,"P.A.",2
23,"23051",2805,2312,2290,8,22,"P.A.",41
23,"23011",2227,1644,1620,25,24,"P.A.",6
23,"23903",3537,2892,2877,12,15,"P.A.",13
23,"23077",668,523,518,2,5,"P.A.",1
23,"23049",1942,1514,1486,16,28,"P.A.",11
23,"23019",1590,1355,1339,7,16,"P.A.",7
23,"23030",1270,1052,1045,3,7,"P.A.",1
23,"23027",763,619,616,1,3,"P.A.",1
23,"23072",2063,1661,1643,16,18,"P.A.",11
23,"23009",12876,10335,10231,109,104,"P.A.",53
23,"23087",11474,9197,9123,90,74,"P.A.",91
23,"23061",7309,5637,5584,60,53,"P.A.",41
23,"23081",1643,1245,1234,12,11,"P.A.",12
23,"23015",1476,1189,1179,10,10,"P.A.",4
23,"23069",5489,4656,4586,36,70,"P.A.",145
23,"23088",6177,4955,4872,94,83,"P.A.",19
23,"23048",884,691,679,6,12,"P.A.",7
23,"23044",4897,3943,3893,13,50,"P.A.",22
23,"23004",478,416,415,1,1,"P.A.",1
23,"23026",3872,3051,2994,23,57,"P.A.",12
23,"23029",924,730,727,2,3,"P.A.",0
23,"23064",1680,1483,1478,8,5,"P.A.",6
23,"23058",8497,6642,6591,44,51,"P.A.",36
23,"23071",1811,1444,1431,13,13,"P.A.",6
23,"23016",442,355,354,5,1,"P.A.",0
23,"23092",27970,20921,20651,284,270,"P.A.",310
23,"23070",4142,2877,2846,20,31,"P.A.",86
23,"23008",1552,1280,1266,9,14,"P.A.",14
23,"23046",2441,2049,2027,13,22,"P.A.",6
23,"23052",1186,1012,997,1,15,"P.A.",6
23,"23007",3116,2483,2458,15,25,"P.A.",249
23,"23074",3039,2491,2451,29,40,"P.A.",28
23,"23018",2415,1791,1781,9,10,"P.A.",2
23,"23075",3404,2800,2782,24,18,"P.A.",24
23,"23093",3313,2706,2673,13,33,"P.A.",84
23,"23076",831,681,671,5,10,"P.A.",4
23,"23003",8778,6945,6877,51,68,"P.A.",36
23,"23050",91354,68649,67925,990,724,"P.A.",498
23,"23047",1658,1342,1339,6,3,"P.A.",1
14,"14026",2043,1434,1421,10,13,"PA",11
41,"41084",2875,2362,2335,9,27,"PA",17
29,"29069",80337,50235,49723,690,512,"PA",421
29,"29093",2299,1767,1732,7,35,"PA",6
18,"18144",779,592,590,3,2,"PA",1
18,"18002",625,505,504,2,1,"PA",0
41,"41035",1171,898,889,12,9,"PA",7
41,"41083",1176,915,908,8,7,"PA",6
4,"4068",187,137,137,1,0,"PA",1
29,"29073",1520,1032,1021,10,11,"PA",2
18,"18093",2580,1837,1820,8,17,"PA",6
29,"29063",358,272,271,2,1,"PA",0
11,"11034",2381,1807,1784,19,23,"PA",20
29,"29034",462,360,357,0,3,"PA",13
14,"14022",4077,3147,3102,20,45,"PA",16
18,"18020",1473,1111,1106,7,5,"PA",0
18,"18185",608,484,479,2,5,"PA",2
18,"18168",864,613,605,4,8,"PA",2
18,"18107",988,769,760,3,9,"PA",5
18,"18902",950,769,762,6,7,"PA",2
21,"21062",1444,1003,991,7,12,"PA",10
41,"41003",2196,1803,1782,21,21,"PA",9
21,"21047",1965,1355,1325,17,30,"PA",1
4,"4097",299,229,227,0,2,"PA",0
18,"18159",1051,873,869,4,4,"PA",1
29,"29052",245,151,151,0,0,"PA",7
21,"21057",1054,699,697,9,2,"PA",1
41,"41088",542,414,408,1,6,"PA",2
41,"41032",4059,3122,3062,22,60,"PA",28
4,"4080",194,169,168,1,1,"PA",3
41,"41090",3488,2792,2751,22,41,"PA",6
18,"18094",2398,1882,1868,16,14,"PA",6
4,"4085",453,384,383,0,1,"PA",0
41,"41049",8898,6881,6812,95,69,"PA",43
29,"29086",814,538,536,9,2,"PA",6
18,"18184",2140,1663,1645,18,18,"PA",7
18,"18015",465,381,379,1,2,"PA",0
41,"41043",647,457,454,5,3,"PA",7
21,"21019",645,464,458,2,6,"PA",9
14,"14047",1566,1154,1143,19,11,"PA",11
29,"29019",908,720,714,0,6,"PA",0
21,"21039",313,233,232,2,1,"PA",2
14,"14034",367,301,292,1,9,"PA",1
18,"18029",1892,1355,1347,6,8,"PA",33
18,"18057",5045,3755,3721,44,34,"PA",48
21,"21070",6278,4489,4445,42,44,"PA",34
14,"14064",352,265,261,3,4,"PA",1
21,"21016",1076,823,790,11,33,"PA",2
18,"18039",3733,2901,2878,18,23,"PA",117
4,"4057",1454,1081,1071,1,10,"PA",11
18,"18027",2575,1913,1899,15,14,"PA",4
29,"29035",1717,1280,1270,14,10,"PA",5
18,"18154",1062,770,769,0,1,"PA",11
21,"21009",916,622,608,6,14,"PA",7
18,"18174",470,368,363,1,5,"PA",1
21,"21049",3468,2327,2283,18,44,"PA",19
18,"18071",5589,4268,4205,44,63,"PA",124
41,"41053",20729,16178,15971,142,207,"PA",435
4,"4072",339,272,271,0,1,"PA",13
4,"4052",11567,8189,8124,158,65,"PA",68
14,"14043",7664,5935,5874,53,61,"PA",88
29,"29089",3343,2514,2489,14,25,"PA",55
41,"41017",13878,10053,9926,130,127,"PA",108
18,"18109",607,461,456,1,5,"PA",0
18,"18087",187449,138136,136783,1548,1353,"PA",614
18,"18141",484,326,325,1,1,"PA",0
11,"11036",725,484,482,10,2,"PA",11
4,"4001",1139,890,884,6,6,"PA",4
18,"18022",12448,8777,8659,111,118,"PA",42
14,"14046",4587,3671,3641,35,30,"PA",28
14,"14067",3821,3105,3082,38,23,"PA",27
11,"11027",67042,43386,43065,557,321,"PA",2757
29,"29047",1165,973,969,0,4,"PA",4
18,"18909",668,536,534,2,2,"PA",1
18,"18906",955,736,731,5,5,"PA",2
4,"4102",12940,9247,9152,90,95,"PA",47
18,"18051",1196,857,852,4,5,"PA",2
29,"29096",2880,2012,1971,28,41,"PA",14
4,"4090",435,338,335,3,3,"PA",1
21,"21077",1690,1335,1321,8,14,"PA",17
4,"4013",137455,94867,94142,1203,725,"PA",676
41,"41021",20767,14040,13822,240,218,"PA",202
14,"14069",7733,5910,5824,68,86,"PA",15
41,"41028",1880,1479,1458,28,21,"PA",34
18,"18153",8348,6170,6118,88,52,"PA",49
14,"14039",2705,2204,2189,12,15,"PA",17
11,"11030",22528,14741,14557,195,184,"PA",768
18,"18133",2256,1783,1773,12,10,"PA",5
41,"41080",1289,1010,997,13,13,"PA",1
4,"4020",361,265,263,1,2,"PA",2
41,"41008",1073,884,875,0,9,"PA",1
14,"14049",16358,12577,12478,137,99,"PA",668
4,"4012",230,195,195,2,0,"PA",1
11,"11001",4389,3110,3072,13,38,"PA",21
41,"41023",7901,6050,5972,45,78,"PA",96
41,"41081",28121,20027,19785,275,242,"PA",221
29,"29009",1525,1126,1109,9,17,"PA",2
41,"41012",3115,2314,2271,29,43,"PA",39
4,"4902",42901,28927,28711,338,216,"PA",138
18,"18192",1581,1331,1318,6,13,"PA",4
29,"29062",647,573,571,1,2,"PA",9
4,"4023",144,116,116,2,0,"PA",0
29,"29015",31805,22566,22347,272,219,"PA",191
29,"29042",14047,9845,9735,118,110,"PA",273
29,"29016",272,180,179,5,1,"PA",6
29,"29028",1253,887,876,8,11,"PA",4
4,"4083",1933,1511,1497,16,14,"PA",8
4,"4094",206,152,152,0,0,"PA",2
18,"18162",947,726,721,8,5,"PA",10
14,"14037",3500,2662,2616,29,46,"PA",63
29,"29058",1560,1103,1096,5,7,"PA",13
29,"29075",12666,8284,8218,62,66,"PA",68
21,"21018",1821,1283,1273,19,10,"PA",93
11,"11042",1232,933,922,4,11,"PA",77
18,"18905",12975,9260,9209,155,51,"PA",76
18,"18010",576,464,458,4,6,"PA",5
18,"18170",377,238,237,0,1,"PA",2
21,"21072",10233,7829,7666,124,163,"PA",81
29,"29079",2500,2016,2000,23,16,"PA",8
11,"11012",103946,68124,67375,856,749,"PA",1140
4,"4036",246,205,204,1,1,"PA",1
4,"4093",1869,1341,1334,10,7,"PA",18
41,"41040",9567,7305,7210,93,95,"PA",121
21,"21063",2624,2109,2097,13,12,"PA",25
18,"18070",287,240,239,2,1,"PA",0
18,"18084",3954,3039,3015,50,24,"PA",15
14,"14036",3774,2928,2909,51,19,"PA",64
41,"41073",1789,1292,1272,5,20,"PA",39
4,"4005",631,531,524,6,7,"PA",0
18,"18018",658,520,514,4,6,"PA",15
14,"14074",2387,2002,1995,26,7,"PA",6
18,"18102",8556,6358,6272,42,86,"PA",186
11,"11021",6838,5102,5049,67,53,"PA",62
4,"4074",2731,1959,1936,26,23,"PA",11
18,"18177",463,285,281,4,4,"PA",4
18,"18151",276,191,188,0,3,"PA",1
18,"18132",3461,2797,2772,19,25,"PA",12
18,"18126",1461,1129,1121,15,8,"PA",7
4,"4059",1231,837,830,8,7,"PA",1
21,"21079",749,556,553,6,3,"PA",1
11,"11002",4291,3388,3374,19,14,"PA",9
18,"18016",339,254,253,2,1,"PA",1
29,"29053",1715,1239,1221,7,18,"PA",126
18,"18128",361,284,283,5,1,"PA",0
4,"4067",657,526,524,1,2,"PA",3
41,"41091",545464,388043,383816,5325,4227,"PA",7091
21,"21029",1633,1276,1259,15,17,"PA",8
21,"21033",508,385,382,7,3,"PA",2
18,"18007",808,602,591,5,11,"PA",17
29,"29091",8777,6226,6126,64,100,"PA",90
41,"41067",7055,5368,5295,64,73,"PA",52
21,"21002",14281,10297,10173,141,124,"PA",127
41,"41902",4682,3136,3101,34,35,"PA",31
29,"29002",1246,896,893,11,3,"PA",26
29,"29024",414,271,261,6,10,"PA",5
11,"11031",76347,49071,48616,681,455,"PA",1104
41,"41009",1272,914,899,8,15,"PA",4
29,"29094",54317,36540,36174,410,366,"PA",477
18,"18183",685,502,500,3,2,"PA",6
11,"11011",1685,1231,1216,8,15,"PA",70
21,"21041",114169,74740,73814,1129,926,"PA",1285
14,"14063",1121,875,866,9,9,"PA",15
21,"21059",203,166,162,1,4,"PA",0
41,"41082",3448,2827,2796,15,31,"PA",20
41,"41057",299,191,189,0,2,"PA",0
18,"18079",3497,2729,2706,15,23,"PA",8
4,"4046",826,645,634,4,11,"PA",3
21,"21005",15205,11006,10909,108,97,"PA",105
18,"18032",248,166,166,2,0,"PA",3
41,"41075",9987,7904,7809,71,95,"PA",241
14,"14031",634,516,514,1,2,"PA",35
18,"18042",425,344,342,2,2,"PA",0
4,"4087",198,162,159,2,3,"PA",0
41,"41093",17665,13712,13526,179,186,"PA",234
18,"18111",2647,1957,1941,24,16,"PA",9
4,"4006",7156,5175,5106,51,69,"PA",28
29,"29011",3013,1893,1876,7,17,"PA",9
21,"21015",728,453,447,6,6,"PA",4
14,"14002",10991,8444,8358,106,86,"PA",289
14,"14066",5911,4515,4473,54,42,"PA",29
14,"14005",6334,4262,4206,61,56,"PA",212
14,"14003",1289,1046,1026,12,20,"PA",10
41,"41094",6089,4757,4680,47,77,"PA",47
41,"41005",8792,6642,6585,71,57,"PA",235
29,"29006",721,516,508,5,8,"PA",38
18,"18099",1551,1217,1205,11,12,"PA",18
18,"18178",834,685,683,3,2,"PA",1
18,"18176",265,183,181,0,2,"PA",2
18,"18085",818,538,532,4,6,"PA",5
4,"4002",1146,891,884,1,7,"PA",6
14,"14006",1326,1170,1148,12,22,"PA",2
4,"4010",602,492,491,10,1,"PA",2
21,"21048",327,226,226,5,0,"PA",1
4,"4056",144,118,118,0,0,"PA",3
21,"21026",255,181,169,2,12,"PA",5
11,"11033",19983,12960,12807,199,153,"PA",493
21,"21043",1898,1382,1350,9,32,"PA",10
41,"41069",28331,21065,20877,252,188,"PA",1682
4,"4008",530,423,418,4,5,"PA",2
4,"4028",239,212,207,0,5,"PA",0
41,"41076",2227,1507,1492,5,15,"PA",51
29,"29064",584,428,422,4,6,"PA",4
14,"14045",3093,2662,2642,14,20,"PA",254
29,"29055",1837,1478,1454,12,24,"PA",13
18,"18096",348,289,287,1,2,"PA",0
4,"4009",165,124,122,2,2,"PA",1
41,"41102",14343,11050,10837,206,213,"PA",451
18,"18179",583,417,409,7,8,"PA",1
18,"18115",2380,1843,1823,14,20,"PA",3
21,"21021",11825,7657,7574,108,83,"PA",198
18,"18025",326,242,238,0,4,"PA",0
29,"29013",1718,1302,1283,4,19,"PA",10
14,"14060",4843,3857,3787,47,70,"PA",37
21,"21058",2609,1867,1857,15,10,"PA",46
11,"11014",16318,11093,11031,144,62,"PA",380
41,"41096",6079,4673,4595,47,78,"PA",51
4,"4901",576,427,426,5,1,"PA",0
14,"14050",2418,1983,1966,23,17,"PA",17
14,"14059",713,572,567,5,5,"PA",3
21,"21052",4741,2897,2839,21,58,"PA",41
41,"41064",5629,4041,4006,28,35,"PA",33
21,"21075",375,294,291,12,3,"PA",2
4,"4061",668,541,536,7,5,"PA",3
29,"29080",6598,4703,4663,31,40,"PA",44
18,"18024",882,696,688,12,8,"PA",10
21,"21020",398,282,282,3,0,"PA",2
29,"29005",4307,2967,2951,18,16,"PA",162
18,"18053",1836,1345,1340,11,5,"PA",20
41,"41059",31676,23199,22889,330,310,"PA",430
29,"29022",202,142,141,2,1,"PA",0
18,"18138",2460,1751,1741,1,10,"PA",7
29,"29045",1750,1246,1239,6,7,"PA",40
4,"4032",5476,3666,3643,34,23,"PA",15
41,"41011",15274,11359,11207,145,152,"PA",193
41,"41085",3918,3173,3128,42,45,"PA",22
14,"14025",3061,2547,2517,13,30,"PA",12
18,"18076",880,676,676,3,0,"PA",2
18,"18122",16253,12271,12109,132,162,"PA",48
14,"14032",434,377,375,1,2,"PA",0
29,"29076",2022,1384,1374,14,10,"PA",6
21,"21078",2865,2085,2066,21,19,"PA",7
4,"4099",5086,4023,3980,26,43,"PA",52
11,"11029",5360,3445,3423,27,22,"PA",22
18,"18164",1881,1351,1342,16,9,"PA",9
11,"11007",17997,10781,10676,184,105,"PA",617
4,"4011",2814,2283,2263,25,20,"PA",13
18,"18180",655,450,447,1,3,"PA",0
18,"18028",992,826,821,4,5,"PA",1
11,"11015",59476,38207,37898,501,309,"PA",679
14,"14008",2905,2226,2200,18,26,"PA",95
14,"14068",581,460,457,7,3,"PA",2
21,"21076",2108,1647,1628,22,19,"PA",5
41,"41002",1510,1161,1140,4,21,"PA",33
4,"4082",309,216,214,3,2,"PA",1
18,"18911",6796,4923,4867,74,56,"PA",22
18,"18012",2693,1841,1831,11,10,"PA",7
14,"14073",3009,2246,2224,32,22,"PA",15
29,"29902",2577,1689,1665,20,24,"PA",10
21,"21007",6088,4174,4123,57,51,"PA",41
29,"29090",1805,1265,1260,5,5,"PA",18
4,"4096",293,220,219,1,1,"PA",0
18,"18098",6440,4743,4679,44,64,"PA",31
21,"21068",1009,726,721,10,5,"PA",32
11,"11008",16655,11309,11189,184,120,"PA",1069
41,"41041",9646,7901,7791,58,110,"PA",973
14,"14030",8519,6832,6753,64,79,"PA",83
41,"41047",9810,7427,7321,99,106,"PA",115
11,"11018",1528,1194,1178,9,16,"PA",53
29,"29084",28386,19450,19202,296,248,"PA",774
29,"29010",1703,1411,1377,7,34,"PA",4
29,"29027",2416,1907,1893,15,14,"PA",19
4,"4063",1199,871,862,6,9,"PA",12
11,"11005",4617,3287,3214,26,73,"PA",28
41,"41070",5598,4101,4039,79,62,"PA",59
18,"18137",1057,875,868,8,7,"PA",12
11,"11901",5576,4433,4398,69,35,"PA",42
41,"41024",22383,15333,15160,213,173,"PA",226
4,"4062",4604,3711,3654,22,57,"PA",29
14,"14058",8116,6274,6215,76,59,"PA",99
41,"41054",671,556,550,0,6,"PA",22
14,"14052",9720,6444,6384,58,60,"PA",86
18,"18147",3742,2419,2386,20,33,"PA",14
29,"29098",1312,1043,1036,22,7,"PA",10
21,"21056",2992,2172,2096,29,76,"PA",9
4,"4019",269,210,209,3,1,"PA",0
18,"18067",704,526,521,1,5,"PA",2
18,"18108",892,674,673,2,1,"PA",8
29,"29038",16309,10579,10494,152,85,"PA",54
4,"4051",476,406,400,3,6,"PA",1
11,"11004",87610,53062,52639,828,423,"PA",1981
18,"18056",3695,2961,2940,25,21,"PA",8
18,"18194",2258,1656,1652,11,4,"PA",20
21,"21066",522,440,431,4,9,"PA",0
18,"18005",366,279,277,3,2,"PA",10
29,"29018",2088,1565,1540,9,25,"PA",4
14,"14019",6486,5288,5243,65,45,"PA",161
4,"4027",260,186,186,0,0,"PA",1
18,"18148",874,714,706,6,8,"PA",0
21,"21045",261,200,200,5,0,"PA",1
18,"18101",8990,6659,6556,96,103,"PA",26
21,"21014",4063,3424,3408,27,16,"PA",146
21,"21036",213,172,167,1,5,"PA",1
41,"41087",9827,7300,7150,51,150,"PA",83
18,"18064",419,347,345,3,2,"PA",0
18,"18033",282,227,226,0,1,"PA",0
41,"41015",5263,3820,3752,34,68,"PA",183
41,"41056",3697,3041,3008,25,33,"PA",33
21,"21037",491,386,378,1,8,"PA",4
14,"14013",17006,13114,12958,166,156,"PA",900
11,"11038",13815,10849,10756,126,93,"PA",649
21,"21035",9657,6943,6871,64,72,"PA",37
14,"14070",1385,1131,1111,4,20,"PA",10
18,"18145",10083,7592,7499,78,93,"PA",34
18,"18030",612,457,456,0,1,"PA",4
18,"18045",1211,892,885,4,7,"PA",2
29,"29051",37991,24498,24095,381,403,"PA",274
4,"4066",13570,9018,8963,97,55,"PA",113
4,"4022",375,296,295,0,1,"PA",2
4,"4034",152,106,105,1,1,"PA",3
11,"11902",3578,2400,2376,21,24,"PA",36
18,"18059",4055,3232,3191,37,41,"PA",9
4,"4048",1459,1110,1100,11,10,"PA",3
4,"4070",1649,1267,1255,9,12,"PA",5
18,"18193",13680,9874,9764,130,110,"PA",58
4,"4084",370,290,285,6,5,"PA",6
29,"29039",2822,2091,2074,8,17,"PA",3
18,"18095",1916,1428,1306,21,122,"PA",8
41,"41046",3055,2456,2418,23,38,"PA",20
41,"41029",13231,9756,9610,128,146,"PA",131
18,"18061",1109,882,869,1,13,"PA",0
14,"14016",1406,1123,1115,9,8,"PA",4
11,"11017",3219,2403,2388,18,15,"PA",26
14,"14009",2864,2021,2003,8,18,"PA",36
18,"18124",387,270,267,0,3,"PA",2
18,"18173",8858,6238,6187,64,51,"PA",62
4,"4078",1069,837,832,6,5,"PA",4
29,"29025",34637,22545,22354,268,191,"PA",156
21,"21069",1778,1245,1242,11,3,"PA",6
18,"18150",6452,4666,4625,56,41,"PA",20
18,"18158",10328,7336,7254,69,82,"PA",11
29,"29067",420165,273593,271376,3342,2217,"PA",1990
41,"41095",40097,27969,27731,354,238,"PA",1443
41,"41033",5237,3915,3878,20,37,"PA",135
21,"21032",1790,1362,1347,14,15,"PA",28
18,"18119",1778,1401,1391,14,10,"PA",13
18,"18049",632,476,474,5,2,"PA",1
29,"29037",227,170,170,0,0,"PA",1
18,"18037",488,408,404,0,4,"PA",2
11,"11016",14611,9848,9774,114,74,"PA",303
29,"29048",1508,1254,1245,6,9,"PA",2
18,"18068",1456,1105,1088,13,17,"PA",1
14,"14033",1289,974,958,18,16,"PA",11
18,"18910",832,601,594,6,7,"PA",6
18,"18011",4246,3195,3172,23,23,"PA",6
29,"29014",250,152,150,0,2,"PA",3
29,"29026",1130,815,799,7,16,"PA",3
41,"41045",5505,3946,3889,68,57,"PA",38
11,"11023",9209,6979,6929,81,50,"PA",90
4,"4007",791,599,599,5,0,"PA",2
4,"4004",458,367,364,6,3,"PA",1
41,"41048",2296,1749,1726,21,23,"PA",57
21,"21061",5089,3657,3635,33,22,"PA",178
21,"21042",15246,8640,8572,154,68,"PA",552
14,"14029",4380,3344,3308,35,36,"PA",74
11,"11020",163674,106898,106082,1655,816,"PA",1971
11,"11010",6452,4534,4510,61,24,"PA",116
41,"41018",9457,6940,6867,66,73,"PA",43
29,"29092",596,457,454,10,3,"PA",3
18,"18189",723,547,541,6,6,"PA",3
29,"29083",2212,1679,1652,15,27,"PA",20
29,"29021",153,113,113,0,0,"PA",0
41,"41078",2587,1979,1970,15,9,"PA",10
18,"18182",1982,1405,1397,6,8,"PA",7
4,"4016",2184,1699,1677,15,22,"PA",68
4,"4035",8213,6218,6171,51,47,"PA",246
14,"14053",6040,4455,4376,78,79,"PA",210
4,"4038",3140,2258,2231,44,27,"PA",5
4,"4079",45851,31893,31644,430,249,"PA",181
18,"18078",768,638,637,1,1,"PA",2
4,"4024",3049,2396,2361,19,35,"PA",7
29,"29012",9817,7063,6991,51,72,"PA",20
41,"41100",1097,894,878,8,16,"PA",5
18,"18912",1576,1193,1185,7,8,"PA",46
14,"14020",415,323,319,3,4,"PA",0
41,"41050",5102,4224,4183,39,41,"PA",38
21,"21050",12322,8772,8679,99,93,"PA",161
14,"14048",1244,975,970,5,5,"PA",176
21,"21031",1309,903,871,9,32,"PA",2
21,"21046",1715,1354,1343,15,11,"PA",9
41,"41065",23028,15133,14958,191,175,"PA",98
41,"41036",4053,2930,2899,29,31,"PA",28
14,"14072",1169,925,922,5,3,"PA",8
21,"21038",1146,786,767,9,19,"PA",7
14,"14041",3215,2492,2439,45,53,"PA",13
4,"4030",1222,930,924,5,6,"PA",1
4,"4033",161,120,119,1,1,"PA",1
41,"41071",5603,3999,3932,28,67,"PA",56
11,"11032",53183,32205,31982,441,223,"PA",677
41,"41051",2103,1705,1686,7,19,"PA",8
41,"41086",15877,10246,10150,146,96,"PA",146
4,"4100",7918,5465,5425,52,40,"PA",318
41,"41060",15176,10797,10693,114,104,"PA",525
21,"21004",1530,1059,1042,9,17,"PA",8
21,"21055",6320,4819,4760,46,59,"PA",31
29,"29043",2596,1670,1647,24,23,"PA",10
11,"11024",6811,5241,5202,58,39,"PA",43
14,"14062",1114,889,882,9,7,"PA",1
14,"14015",2198,1776,1755,16,21,"PA",89
41,"41020",12710,8954,8882,91,72,"PA",194
41,"41026",4273,3577,3538,15,39,"PA",10
4,"4071",452,364,363,1,1,"PA",4
29,"29065",207,151,149,1,2,"PA",2
21,"21025",3969,2731,2686,33,45,"PA",12
4,"4031",2495,1942,1931,13,11,"PA",3
18,"18074",297,245,245,5,0,"PA",0
18,"18046",1960,1327,1312,5,15,"PA",7
18,"18152",1037,822,818,9,4,"PA",1
41,"41098",4650,3665,3603,43,62,"PA",28
29,"29097",4076,3060,3018,40,42,"PA",16
18,"18082",912,691,683,8,8,"PA",9
18,"18088",1576,1258,1253,2,5,"PA",0
4,"4053",12062,9283,9180,119,103,"PA",40
18,"18097",1022,758,752,4,6,"PA",17
41,"41030",527,436,429,6,7,"PA",0
29,"29056",1177,807,794,3,13,"PA",8
29,"29085",156,116,113,0,3,"PA",3
4,"4026",75,58,58,0,0,"PA",0
14,"14018",3795,3004,2970,24,34,"PA",54
41,"41063",2678,1869,1853,22,16,"PA",18
18,"18048",2277,1705,1688,19,17,"PA",8
41,"41077",8817,6520,6375,53,145,"PA",64
18,"18907",1997,1627,1612,5,15,"PA",7
18,"18083",296,242,242,1,0,"PA",2
29,"29023",1661,1080,1074,15,6,"PA",8
18,"18157",1062,793,783,9,10,"PA",9
21,"21027",67,52,52,0,0,"PA",0
41,"41089",6394,4593,4526,57,67,"PA",172
18,"18038",1097,906,900,3,6,"PA",20
29,"29072",3258,2484,2447,30,37,"PA",2
21,"21017",3581,2416,2389,27,27,"PA",27
14,"14035",6153,4715,4656,51,59,"PA",33
4,"4064",2585,1817,1803,18,14,"PA",11
41,"41052",2967,2305,2288,7,17,"PA",97
41,"41006",2743,1972,1957,13,15,"PA",9
4,"4089",805,607,597,1,10,"PA",7
14,"14011",595,498,497,4,1,"PA",0
14,"14001",3633,3095,3064,25,31,"PA",25
41,"41055",15121,11082,10997,98,85,"PA",224
21,"21001",628,434,428,5,6,"PA",3
41,"41072",4083,3073,3046,12,27,"PA",32
29,"29046",2777,2032,2013,10,19,"PA",50
4,"4060",486,373,372,0,1,"PA",3
18,"18105",5222,3866,3839,32,27,"PA",7
41,"41061",2205,1798,1770,2,28,"PA",7
21,"21054",8024,6159,6072,67,87,"PA",60
41,"41031",1319,879,875,6,4,"PA",7
18,"18149",5096,3949,3900,36,49,"PA",11
18,"18116",2972,2237,2213,19,24,"PA",30
41,"41022",4281,3087,3066,15,21,"PA",27
21,"21053",3278,2363,2325,20,38,"PA",199
29,"29031",1652,1123,1118,11,5,"PA",5
41,"41058",16497,12415,12248,181,167,"PA",358
18,"18163",327,246,238,0,8,"PA",2
18,"18901",583,374,368,3,6,"PA",0
29,"29032",6673,5204,5140,43,64,"PA",17
41,"41010",4338,2990,2958,48,32,"PA",45
18,"18040",246,147,146,0,1,"PA",1
29,"29095",3431,2660,2607,23,53,"PA",21
18,"18063",1189,795,789,7,6,"PA",3
41,"41014",2484,1956,1936,13,20,"PA",10
29,"29030",839,669,668,5,1,"PA",8
41,"41066",1417,1121,1113,9,8,"PA",17
18,"18044",208,132,132,4,0,"PA",3
4,"4081",367,312,309,0,3,"PA",2
41,"41001",1642,1314,1302,10,12,"PA",7
18,"18014",5667,4132,4085,43,47,"PA",30
11,"11028",32224,20706,20482,359,224,"PA",1194
4,"4015",149,115,115,0,0,"PA",0
4,"4037",1393,1090,1079,8,11,"PA",9
18,"18001",288,212,212,1,0,"PA",0
14,"14056",23507,17245,17071,259,174,"PA",256
18,"18036",3553,2762,2741,20,21,"PA",10
29,"29049",3137,2365,2352,19,13,"PA",9
14,"14038",31501,23683,23394,336,289,"PA",681
29,"29001",4176,3339,3303,23,36,"PA",84
29,"29057",413,311,308,2,3,"PA",0
18,"18908",827,669,660,7,9,"PA",13
18,"18117",535,444,440,2,4,"PA",3
18,"18903",960,761,753,1,8,"PA",2
21,"21008",2717,1994,1978,11,16,"PA",15
14,"14057",6115,5040,4975,71,65,"PA",89
29,"29061",1045,861,855,7,6,"PA",13
29,"29020",3188,2448,2424,30,24,"PA",15
29,"29088",2784,2019,1975,14,44,"PA",14
41,"41034",22561,16014,15840,270,174,"PA",704
14,"14012",6305,4749,4690,44,59,"PA",112
18,"18136",1973,1679,1668,5,11,"PA",6
18,"18167",1927,1397,1380,13,17,"PA",13
21,"21073",1840,1249,1236,13,13,"PA",33
18,"18134",5528,3751,3679,57,72,"PA",27
4,"4075",4783,3731,3700,33,31,"PA",33
18,"18127",15897,11597,11483,133,114,"PA",76
21,"21012",331,254,246,2,8,"PA",3
4,"4044",1517,1232,1224,8,8,"PA",7
18,"18062",9418,6916,6835,62,81,"PA",82
4,"4088",2516,1849,1832,7,17,"PA",23
18,"18004",818,601,594,2,7,"PA",0
29,"29033",1385,878,868,4,10,"PA",13
4,"4101",3927,2827,2804,34,23,"PA",9
4,"4058",402,324,322,5,2,"PA",0
4,"4045",1877,1512,1497,23,15,"PA",39
41,"41027",4061,2783,2752,28,31,"PA",32
18,"18123",307,239,238,1,1,"PA",0
18,"18112",132,90,90,1,0,"PA",0
4,"4049",4981,3652,3630,34,22,"PA",23
29,"29004",343,281,281,0,0,"PA",0
41,"41037",3228,2510,2483,27,27,"PA",13
4,"4018",293,250,245,2,5,"PA",3
21,"21028",419,320,315,3,5,"PA",1
11,"11019",1871,1449,1425,9,24,"PA",58
41,"41099",4141,2818,2799,37,19,"PA",37
18,"18047",5603,3833,3805,67,28,"PA",19
18,"18121",135,109,109,0,0,"PA",1
14,"14014",2610,2160,2125,19,35,"PA",46
4,"4055",418,368,367,5,1,"PA",1
21,"21024",502,363,358,10,5,"PA",2
18,"18140",42971,28391,28126,335,265,"PA",359
29,"29003",1133,902,900,5,2,"PA",2
18,"18043",140,89,87,1,2,"PA",0
4,"4086",1903,1376,1371,11,5,"PA",7
4,"4041",334,247,245,0,2,"PA",2
29,"29066",363,263,260,1,3,"PA",3
11,"11035",13266,8794,8668,115,126,"PA",365
4,"4069",4729,3740,3706,52,34,"PA",24
21,"21011",3531,2672,2639,15,33,"PA",44
18,"18175",11534,8772,8698,68,74,"PA",38
29,"29099",958,739,730,5,9,"PA",25
41,"41038",96442,66696,65945,1021,751,"PA",1135
4,"4098",1616,1255,1249,7,6,"PA",3
29,"29081",290,226,226,3,0,"PA",4
18,"18146",1059,791,776,2,15,"PA",10
29,"29036",670,504,499,4,5,"PA",2
11,"11026",4834,3736,3691,27,45,"PA",79
14,"14061",841,700,693,3,7,"PA",0
29,"29901",41445,27372,27158,295,214,"PA",133
14,"14023",2084,1809,1787,13,22,"PA",16
18,"18114",678,508,508,6,0,"PA",1
14,"14017",10755,8220,8149,101,71,"PA",119
21,"21040",3096,2370,2351,28,19,"PA",38
4,"4095",777,547,541,8,6,"PA",2
29,"29044",866,631,627,3,4,"PA",1
18,"18003",13486,10245,10100,145,145,"PA",101
18,"18165",3942,2819,2776,27,43,"PA",9
21,"21022",173,123,123,1,0,"PA",1
14,"14051",1392,1148,1130,11,18,"PA",2
4,"4003",17244,11933,11840,94,93,"PA",60
29,"29100",2442,1834,1824,14,10,"PA",13
4,"4014",162,136,136,0,0,"PA",0
21,"21065",295,212,211,0,1,"PA",1
41,"41074",3079,2406,2386,14,20,"PA",7
11,"11013",2284,1691,1670,15,21,"PA",21
41,"41101",5752,4663,4629,25,34,"PA",10
29,"29041",2796,1950,1921,24,29,"PA",18
29,"29070",35228,23374,23146,258,228,"PA",510
18,"18161",220,180,178,0,2,"PA",0
21,"21044",17018,11390,11290,132,100,"PA",504
18,"18103",803,653,647,5,6,"PA",0
14,"14075",624,508,500,8,8,"PA",9
21,"21051",272,202,201,5,1,"PA",2
18,"18086",397,321,321,3,0,"PA",0
4,"4076",1325,1050,1041,7,9,"PA",3
21,"21003",691,540,536,7,4,"PA",6
18,"18034",510,377,375,2,2,"PA",2
18,"18066",2072,1558,1552,8,6,"PA",1
18,"18135",4752,3252,3212,34,40,"PA",72
4,"4091",380,322,318,3,4,"PA",3
14,"14027",7948,5944,5871,92,73,"PA",178
14,"14055",18619,13802,13607,192,195,"PA",1685
14,"14040",3821,2986,2949,40,37,"PA",6
29,"29054",39904,27540,27307,240,233,"PA",393
41,"41092",7649,5816,5738,39,78,"PA",339
4,"4050",818,611,602,5,9,"PA",0
41,"41004",55127,37662,37179,622,483,"PA",1338
14,"14042",18991,14726,14495,290,231,"PA",369
29,"29082",29311,20220,20051,223,169,"PA",158
21,"21034",1253,875,861,7,14,"PA",10
29,"29074",818,631,630,3,1,"PA",2
4,"4103",1555,1159,1157,8,2,"PA",30
11,"11025",4371,3260,3226,34,34,"PA",66
18,"18143",949,722,704,2,18,"PA",6
21,"21060",11685,8026,7932,135,94,"PA",152
11,"11041",9805,7136,7067,87,69,"PA",564
21,"21006",3565,2477,2441,29,36,"PA",25
11,"11022",48624,26656,26430,345,226,"PA",1042
18,"18035",1254,991,982,7,9,"PA",4
18,"18188",1659,1329,1308,9,21,"PA",5
29,"29059",2551,1986,1964,11,22,"PA",7
21,"21074",2752,1981,1968,15,13,"PA",4
4,"4073",389,289,286,4,3,"PA",3
4,"4021",188,157,157,2,0,"PA",0
14,"14007",15871,11609,11477,121,132,"PA",129
4,"4903",4331,3183,3164,31,19,"PA",6
21,"21023",2106,1471,1456,7,15,"PA",19
14,"14021",259993,183200,181402,2936,1798,"PA",2157
21,"21067",418,318,312,5,6,"PA",2
18,"18904",858,620,612,3,8,"PA",21
41,"41042",5902,4572,4509,37,63,"PA",59
29,"29040",1934,1344,1332,12,12,"PA",8
18,"18171",2093,1719,1704,10,15,"PA",3
18,"18181",253,183,182,0,1,"PA",0
18,"18069",506,375,371,4,4,"PA",7
18,"18120",274,238,237,2,1,"PA",0
41,"41016",6950,5194,5120,45,74,"PA",54
18,"18187",587,432,432,0,0,"PA",2
14,"14044",1585,1279,1265,12,14,"PA",94
41,"41068",13809,10171,10072,100,99,"PA",75
11,"11040",411,317,309,0,8,"PA",11
41,"41013",4762,3359,3327,9,32,"PA",23
41,"41039",31429,23337,23138,294,199,"PA",802
4,"4092",2897,2351,2325,13,26,"PA",35
18,"18054",879,646,644,4,2,"PA",2
18,"18017",17990,12070,11962,80,108,"PA",166
11,"11039",9943,6634,6582,104,52,"PA",76
18,"18021",16026,11376,11219,186,157,"PA",80
11,"11037",5640,4337,4285,32,52,"PA",41
21,"21010",14308,8960,8861,154,99,"PA",186
18,"18023",16072,11594,11488,131,106,"PA",231
18,"18100",7304,5807,5737,62,70,"PA",18
11,"11006",24221,16564,16470,197,94,"PA",405
41,"41019",4528,3194,3168,41,26,"PA",41
11,"11009",636,430,424,2,6,"PA",6
14,"14028",333,279,277,1,2,"PA",1
14,"14004",2016,1560,1543,8,17,"PA",21
29,"29008",14069,9934,9859,118,75,"PA",61
29,"29068",6209,4025,3983,41,42,"PA",56
29,"29077",225,157,157,1,0,"PA",0
18,"18050",1657,1209,1196,5,13,"PA",3
29,"29017",6766,5162,5114,48,48,"PA",30
41,"41901",2626,2190,2167,24,23,"PA",14
4,"4065",387,320,318,1,2,"PA",1
4,"4043",520,439,435,3,4,"PA",0
21,"21071",216,169,169,5,0,"PA",0
41,"41062",2252,1719,1698,12,21,"PA",77
4,"4047",2290,1956,1937,9,19,"PA",2
29,"29060",775,573,572,1,1,"PA",4
11,"11003",1290,952,940,8,12,"PA",39
29,"29007",25572,17726,17564,227,162,"PA",131
18,"18913",827,653,646,2,7,"PA",8
4,"4077",343,313,313,1,0,"PA",0
41,"41025",1999,1502,1476,13,26,"PA",17
21,"21030",1757,1448,1426,14,22,"PA",8
14,"14071",1025,739,733,8,6,"PA",14
41,"41044",6838,5064,5005,67,59,"PA",75
29,"29050",483,341,340,1,1,"PA",1
14,"14010",4087,3144,3121,15,23,"PA",72
21,"21013",10601,7384,7231,110,153,"PA",68
41,"41079",9349,7095,7001,71,94,"PA",137
18,"18006",4116,2862,2831,25,31,"PA",13
21,"21064",6331,4390,4352,46,38,"PA",160
29,"29029",452,339,336,0,3,"PA",4
41,"41007",12177,8150,8016,126,134,"PA",85
4,"4054",384,328,325,0,3,"PA",0
29,"29071",915,601,598,4,3,"PA",18
14,"14065",1846,1509,1492,14,17,"PA",14
41,"41903",6653,5134,5070,61,64,"PA",55
29,"29087",409,306,305,3,1,"PA",19
18,"18013",4392,3268,3223,23,45,"PA",38
4,"4029",10682,7542,7474,63,68,"PA",25
14,"14024",1926,1557,1527,14,30,"PA",59
41,"41097",3096,2489,2451,21,38,"PA",19
18,"18072",710,507,499,2,8,"PA",3
14,"14054",13632,10857,10652,194,205,"PA",204
18,"18089",15803,10794,10712,95,82,"PA",235
4,"4017",1337,965,960,7,5,"PA",47
49,"49119",245,194,191,2,3,"PACMA",2
50,"50163",3427,2448,2413,62,35,"PACMA",27
40,"40084",65,53,53,2,0,"PACMA",0
50,"50182",3704,2551,2515,44,36,"PACMA",16
19,"19242",112,93,92,1,1,"PACMA",0
26,"26111",266,203,200,4,3,"PACMA",2
15,"15071",8233,5751,5668,93,83,"PACMA",33
40,"40086",738,628,619,12,9,"PACMA",3
28,"28138",78,48,46,0,2,"PACMA",0
16,"16082",318,226,226,1,0,"PACMA",0
44,"44158",1159,904,873,15,31,"PACMA",1
12,"12075",139,106,102,0,4,"PACMA",0
19,"19323",50,41,39,0,2,"PACMA",0
47,"47214",1517,1215,1191,34,24,"PACMA",2
10,"10133",1247,1045,1028,7,17,"PACMA",0
9,"9133",39,33,33,1,0,"PACMA",0
44,"44074",435,344,337,5,7,"PACMA",0
48,"48054",23712,16643,16439,215,204,"PACMA",106
10,"10136",289,229,228,0,1,"PACMA",0
18,"18045",1211,892,885,4,7,"PACMA",1
19,"19142",259,191,190,0,1,"PACMA",4
25,"25102",733,478,464,15,14,"PACMA",1
19,"19309",37,32,31,0,1,"PACMA",0
39,"39064",1339,1072,1066,7,6,"PACMA",6
1,"1030",170,123,120,1,3,"PACMA",2
44,"44145",1078,723,714,26,9,"PACMA",2
25,"25175",221,151,150,0,1,"PACMA",1
37,"37170",1571,1122,1107,22,15,"PACMA",1
37,"37206",100,81,80,1,1,"PACMA",0
3,"3041",5811,4325,4269,33,56,"PACMA",19
7,"7002",6305,4188,4073,80,115,"PACMA",30
49,"49082",400,331,324,2,7,"PACMA",0
16,"16158",550,427,423,2,4,"PACMA",3
15,"15028",1485,1130,1118,14,12,"PACMA",1
49,"49097",97,55,55,1,0,"PACMA",0
47,"47208",56,45,43,1,2,"PACMA",0
18,"18164",1881,1351,1342,16,9,"PACMA",2
18,"18149",5096,3949,3900,36,49,"PACMA",11
47,"47223",172,147,147,6,0,"PACMA",2
10,"10029",447,362,355,1,7,"PACMA",0
18,"18147",3742,2419,2386,20,33,"PACMA",2
5,"5228",193,146,145,1,1,"PACMA",0
6,"6151",1109,850,846,6,4,"PACMA",1
12,"12065",181,155,155,0,0,"PACMA",0
46,"46170",3464,2944,2908,24,36,"PACMA",6
24,"24224",665,490,484,8,6,"PACMA",1
10,"10088",244,168,168,0,0,"PACMA",0
6,"6129",631,493,490,2,3,"PACMA",0
22,"22239",90,76,76,2,0,"PACMA",0
19,"19298",75,53,52,2,1,"PACMA",0
47,"47144",85,65,65,2,0,"PACMA",1
26,"26028",135,108,106,2,2,"PACMA",0
27,"27007",3015,2426,2374,42,52,"PACMA",8
12,"12041",115,98,98,2,0,"PACMA",0
24,"24062",151,107,107,0,0,"PACMA",0
34,"34215",166,146,145,1,1,"PACMA",0
24,"24030",4397,3272,3229,54,43,"PACMA",16
47,"47078",178,159,154,7,5,"PACMA",0
33,"33004",69056,49228,48730,726,498,"PACMA",198
24,"24065",2104,1512,1488,27,24,"PACMA",6
46,"46008",2727,2249,2233,17,16,"PACMA",7
37,"37214",134,94,94,4,0,"PACMA",0
34,"34134",61,49,47,0,2,"PACMA",0
49,"49087",581,358,356,3,2,"PACMA",0
10,"10027",88,78,78,0,0,"PACMA",0
38,"38015",4326,3132,3099,21,33,"PACMA",10
27,"27048",2404,1939,1909,36,30,"PACMA",3
49,"49145",251,154,153,0,1,"PACMA",0
44,"44115",121,100,100,0,0,"PACMA",2
39,"39071",463,358,358,2,0,"PACMA",0
15,"15091",1171,839,829,9,10,"PACMA",3
10,"10173",557,436,431,6,5,"PACMA",0
50,"50001",130,96,96,0,0,"PACMA",0
9,"9430",18,15,15,0,0,"PACMA",0
37,"37294",11233,8282,8167,139,115,"PACMA",28
3,"3059",20261,15951,15825,82,126,"PACMA",62
19,"19150",128,112,108,0,4,"PACMA",0
50,"50140",172,108,108,1,0,"PACMA",0
24,"24092",883,707,702,6,5,"PACMA",2
37,"37190",235,195,193,1,2,"PACMA",0
50,"50214",31,22,21,1,1,"PACMA",0
10,"10023",854,688,682,9,6,"PACMA",0
6,"6120",3508,2772,2741,31,31,"PACMA",8
32,"32054",87289,63027,61875,1263,1152,"PACMA",280
15,"15007",3702,2670,2642,19,28,"PACMA",3
49,"49069",414,276,270,1,6,"PACMA",2
1,"1043",2322,1623,1595,12,28,"PACMA",10
2,"2040",631,569,566,3,3,"PACMA",0
44,"44082",90,67,66,1,1,"PACMA",0
18,"18047",5603,3833,3805,67,28,"PACMA",23
18,"18101",8990,6659,6556,96,103,"PACMA",25
9,"9266",87,72,72,0,0,"PACMA",0
10,"10163",374,310,308,0,2,"PACMA",0
49,"49108",512,387,381,9,6,"PACMA",0
10,"10016",321,266,262,2,4,"PACMA",6
7,"7017",800,556,539,14,17,"PACMA",4
5,"5094",158,124,124,3,0,"PACMA",0
1,"1021",473,332,324,3,8,"PACMA",3
36,"36007",1778,1258,1238,2,20,"PACMA",9
34,"34060",150,123,123,2,0,"PACMA",0
32,"32057",608,475,473,4,2,"PACMA",0
50,"50229",62,47,46,2,1,"PACMA",0
27,"27009",2354,1812,1782,19,30,"PACMA",7
34,"34236",176,134,134,1,0,"PACMA",0
46,"46046",922,699,694,2,5,"PACMA",0
37,"37157",94,65,65,0,0,"PACMA",0
22,"22103",697,532,523,10,9,"PACMA",6
19,"19178",45,34,34,0,0,"PACMA",0
13,"13007",1319,1069,1051,18,18,"PACMA",2
12,"12100",1380,1124,1109,11,15,"PACMA",3
37,"37181",301,232,230,2,2,"PACMA",0
3,"3016",91,67,66,1,1,"PACMA",0
29,"29076",2022,1384,1374,14,10,"PACMA",6
9,"9219",28514,20244,19951,326,293,"PACMA",117
10,"10079",891,711,706,6,5,"PACMA",0
10,"10040",455,344,334,8,10,"PACMA",0
24,"24058",224,166,163,1,3,"PACMA",0
25,"25244",350,270,268,9,2,"PACMA",2
3,"3044",4459,3798,3753,21,45,"PACMA",9
34,"34205",70,55,55,1,0,"PACMA",0
10,"10150",374,331,328,2,3,"PACMA",0
25,"25131",439,319,314,6,5,"PACMA",0
16,"16181",73,62,62,1,0,"PACMA",0
24,"24028",426,350,331,3,19,"PACMA",0
9,"9202",26,24,24,1,0,"PACMA",0
9,"9055",55,46,44,0,2,"PACMA",0
47,"47126",49,43,42,1,1,"PACMA",0
19,"19006",873,634,620,1,14,"PACMA",2
50,"50227",105,79,79,2,0,"PACMA",0
6,"6117",1471,1155,1130,8,25,"PACMA",2
25,"25099",1185,720,709,9,11,"PACMA",6
48,"48088",148,110,109,0,1,"PACMA",0
47,"47199",84,61,60,1,1,"PACMA",0
39,"39042",5928,4680,4634,44,46,"PACMA",8
27,"27902",7198,5074,4976,106,98,"PACMA",54
15,"15058",26931,19505,19196,471,309,"PACMA",87
47,"47055",212,169,168,3,1,"PACMA",0
30,"30043",24501,19738,19416,230,322,"PACMA",72
16,"16162",51,36,36,0,0,"PACMA",0
16,"16103",310,263,259,4,4,"PACMA",0
24,"24040",494,369,366,6,3,"PACMA",0
12,"12048",293,208,205,2,3,"PACMA",0
15,"15080",1913,1407,1389,15,18,"PACMA",2
47,"47222",92,77,77,4,0,"PACMA",0
12,"12006",185,160,153,0,7,"PACMA",1
11,"11007",17997,10781,10676,184,105,"PACMA",42
15,"15072",9868,7077,6951,79,126,"PACMA",23
2,"2046",1165,954,941,16,13,"PACMA",3
35,"35005",1170,864,853,7,11,"PACMA",3
50,"50188",34,28,27,0,1,"PACMA",0
49,"49177",298,199,196,6,3,"PACMA",1
39,"39090",731,577,572,3,5,"PACMA",1
9,"9093",154,127,125,1,2,"PACMA",2
5,"5245",344,285,284,5,1,"PACMA",0
37,"37245",357,273,272,2,1,"PACMA",0
12,"12107",358,314,311,4,3,"PACMA",1
24,"24022",364,231,230,2,1,"PACMA",1
3,"3037",354,293,289,1,4,"PACMA",0
10,"10006",1306,1081,1070,7,11,"PACMA",1
6,"6029",1230,884,880,5,4,"PACMA",2
25,"25103",125,82,80,4,2,"PACMA",0
19,"19202",16,14,14,0,0,"PACMA",0
10,"10097",109,97,96,0,1,"PACMA",0
5,"5131",118,86,86,3,0,"PACMA",0
27,"27013",3950,3156,3090,39,66,"PACMA",22
44,"44096",173,139,133,4,6,"PACMA",0
36,"36025",2442,1531,1516,10,15,"PACMA",7
42,"42010",19,15,15,1,0,"PACMA",0
18,"18016",339,254,253,2,1,"PACMA",0
49,"49185",171,140,140,3,0,"PACMA",0
39,"39068",663,488,485,4,3,"PACMA",1
47,"47221",115,102,102,0,0,"PACMA",0
32,"32076",2358,1835,1823,18,12,"PACMA",3
46,"46253",118,105,102,7,3,"PACMA",1
1,"1037",625,403,398,6,5,"PACMA",3
18,"18010",576,464,458,4,6,"PACMA",0
2,"2013",158,123,121,1,2,"PACMA",0
46,"46194",15267,11622,11491,110,131,"PACMA",46
12,"12114",228,178,173,2,5,"PACMA",1
24,"24199",432,280,278,2,2,"PACMA",0
50,"50200",534,436,432,9,4,"PACMA",0
5,"5079",68,52,50,1,2,"PACMA",0
44,"44172",345,257,251,3,6,"PACMA",2
13,"13095",94,70,70,1,0,"PACMA",0
28,"28163",395,305,301,7,4,"PACMA",4
26,"26170",471,353,348,4,5,"PACMA",0
40,"40039",257,188,184,2,4,"PACMA",0
49,"49133",344,247,243,3,4,"PACMA",0
18,"18157",1062,793,783,9,10,"PACMA",0
9,"9050",77,52,52,0,0,"PACMA",2
50,"50222",1695,1117,1091,16,26,"PACMA",3
12,"12051",520,382,376,1,6,"PACMA",1
21,"21064",6331,4390,4352,46,38,"PACMA",11
42,"42175",28,19,19,0,0,"PACMA",0
9,"9213",370,260,260,5,0,"PACMA",2
10,"10069",858,680,673,2,7,"PACMA",0
13,"13059",232,186,184,0,2,"PACMA",0
28,"28109",1621,1121,1104,9,17,"PACMA",1
9,"9090",61,50,50,0,0,"PACMA",1
39,"39047",1987,1495,1482,9,13,"PACMA",5
15,"15048",4769,3470,3415,57,55,"PACMA",26
50,"50192",240,188,184,9,4,"PACMA",0
5,"5104",35,29,29,0,0,"PACMA",0
24,"24002",271,213,213,2,0,"PACMA",0
47,"47114",4107,2877,2834,37,43,"PACMA",2
18,"18180",655,450,447,1,3,"PACMA",1
13,"13061",5898,4442,4373,56,69,"PACMA",19
25,"25154",126,77,77,2,0,"PACMA",0
46,"46204",6906,5426,5357,62,69,"PACMA",16
22,"22116",1571,1127,1114,37,13,"PACMA",4
48,"48056",849,610,608,3,2,"PACMA",5
10,"10103",480,385,380,3,5,"PACMA",1
24,"24064",1532,1128,1107,17,21,"PACMA",2
44,"44009",805,608,595,18,13,"PACMA",0
7,"7018",389,275,271,0,4,"PACMA",5
48,"48045",5060,3912,3849,31,63,"PACMA",16
5,"5189",478,361,360,3,1,"PACMA",0
18,"18138",2460,1751,1741,1,10,"PACMA",2
10,"10058",994,751,738,13,13,"PACMA",3
18,"18039",3733,2901,2878,18,23,"PACMA",3
2,"2014",390,333,326,5,7,"PACMA",0
15,"15012",3767,2973,2926,51,47,"PACMA",11
28,"28135",928,665,659,6,6,"PACMA",6
42,"42001",308,242,237,4,5,"PACMA",0
27,"27053",606,429,426,4,3,"PACMA",0
36,"36055",13678,10508,10288,155,220,"PACMA",76
26,"26051",271,219,214,4,5,"PACMA",3
21,"21067",418,318,312,5,6,"PACMA",1
5,"5904",149,99,97,0,2,"PACMA",0
47,"47042",63,50,49,3,1,"PACMA",2
37,"37215",156,106,106,1,0,"PACMA",0
47,"47101",1740,1458,1444,12,14,"PACMA",1
39,"39085",6722,5198,5134,60,64,"PACMA",18
46,"46022",15090,10922,10840,99,82,"PACMA",45
10,"10101",172,134,129,1,5,"PACMA",0
49,"49138",269,190,189,0,1,"PACMA",0
6,"6115",1261,893,885,7,8,"PACMA",0
26,"26176",69,55,54,0,1,"PACMA",0
22,"22126",100,81,80,2,1,"PACMA",0
18,"18087",187449,138136,136783,1548,1353,"PACMA",466
6,"6085",3437,2566,2530,32,36,"PACMA",5
42,"42125",73,65,64,4,1,"PACMA",0
26,"26043",397,313,306,6,7,"PACMA",2
44,"44258",75,56,55,0,1,"PACMA",0
39,"39048",1616,1326,1308,8,18,"PACMA",5
9,"9119",51,38,38,0,0,"PACMA",0
46,"46047",551,479,469,10,10,"PACMA",2
19,"19112",68,50,50,0,0,"PACMA",0
37,"37104",32,24,23,0,1,"PACMA",0
25,"25140",785,472,460,5,12,"PACMA",5
40,"40036",531,440,424,10,16,"PACMA",1
36,"36002",3154,2381,2358,35,23,"PACMA",7
46,"46071",488,418,402,10,16,"PACMA",2
6,"6072",2370,1907,1885,9,22,"PACMA",3
50,"50212",52,48,48,0,0,"PACMA",0
49,"49152",572,401,395,6,6,"PACMA",2
7,"7029",4090,2921,2866,44,55,"PACMA",22
29,"29003",1133,902,900,5,2,"PACMA",0
50,"50254",179,136,136,0,0,"PACMA",0
50,"50178",325,228,225,4,3,"PACMA",0
18,"18177",463,285,281,4,4,"PACMA",1
25,"25182",1075,749,731,30,18,"PACMA",2
37,"37143",410,342,338,3,4,"PACMA",0
21,"21063",2624,2109,2097,13,12,"PACMA",0
44,"44052",96,60,59,2,1,"PACMA",0
42,"42064",92,76,76,0,0,"PACMA",0
50,"50181",1053,787,760,9,27,"PACMA",4
9,"9247",28,21,20,0,1,"PACMA",0
19,"19107",349,289,288,1,1,"PACMA",1
25,"25073",662,382,379,11,3,"PACMA",0
37,"37293",131,108,106,5,2,"PACMA",0
37,"37106",289,199,196,2,3,"PACMA",0
40,"40004",534,428,420,3,8,"PACMA",1
10,"10064",1549,1229,1209,6,20,"PACMA",0
49,"49025",187,143,142,3,1,"PACMA",0
36,"36015",4379,3151,3101,38,50,"PACMA",8
13,"13070",769,653,640,1,13,"PACMA",0
6,"6075",517,433,429,3,4,"PACMA",0
26,"26138",4646,3468,3398,46,70,"PACMA",10
49,"49237",157,110,110,0,0,"PACMA",0
5,"5088",34,26,26,0,0,"PACMA",0
5,"5002",1996,1497,1476,15,21,"PACMA",4
37,"37300",586,430,421,6,9,"PACMA",4
9,"9168",329,254,254,2,0,"PACMA",0
44,"44206",156,119,117,3,2,"PACMA",0
50,"50234",251,201,191,13,10,"PACMA",2
12,"12139",344,219,216,0,3,"PACMA",0
48,"48011",9742,6697,6628,82,69,"PACMA",32
12,"12098",665,552,539,9,13,"PACMA",0
47,"47116",426,363,358,0,5,"PACMA",0
22,"22036",101,82,82,1,0,"PACMA",1
3,"3050",17818,12860,12706,160,154,"PACMA",71
49,"49103",435,354,350,6,4,"PACMA",1
5,"5229",90,79,77,2,2,"PACMA",1
37,"37247",216,176,173,1,3,"PACMA",0
10,"10081",183,143,142,0,1,"PACMA",0
24,"24901",994,698,686,8,12,"PACMA",1
18,"18027",2575,1913,1899,15,14,"PACMA",5
25,"25127",226,134,130,2,4,"PACMA",2
28,"28177",9470,7524,7466,87,58,"PACMA",29
44,"44184",34,21,21,2,0,"PACMA",0
12,"12119",153,87,87,0,0,"PACMA",0
48,"48034",13160,9290,9189,82,101,"PACMA",50
16,"16010",184,135,133,1,2,"PACMA",0
26,"26096",244,204,201,2,3,"PACMA",3
34,"34204",53,45,44,0,1,"PACMA",0
28,"28125",2808,2077,2055,19,22,"PACMA",9
44,"44106",173,132,131,8,1,"PACMA",0
47,"47103",277,218,214,1,4,"PACMA",0
22,"22051",108,86,84,2,2,"PACMA",0
34,"34246",78,64,64,0,0,"PACMA",0
36,"36053",5677,4204,4157,51,47,"PACMA",14
37,"37112",162,124,124,3,0,"PACMA",0
5,"5210",105,83,82,2,1,"PACMA",0
9,"9075",126,102,101,1,1,"PACMA",0
49,"49209",568,374,372,1,2,"PACMA",0
21,"21018",1821,1283,1273,19,10,"PACMA",2
50,"50104",379,306,303,4,3,"PACMA",0
44,"44007",194,152,145,3,7,"PACMA",0
40,"40196",44,34,34,3,0,"PACMA",0
44,"44187",224,170,163,2,7,"PACMA",0
22,"22044",278,195,191,7,4,"PACMA",0
46,"46152",96,70,70,0,0,"PACMA",0
9,"9112",115,80,80,4,0,"PACMA",0
48,"48070",559,413,407,1,6,"PACMA",0
42,"42161",158,119,119,0,0,"PACMA",0
12,"12125",235,203,201,1,2,"PACMA",1
6,"6147",390,321,319,3,2,"PACMA",0
22,"22019",190,141,138,4,3,"PACMA",0
49,"49098",242,177,175,4,2,"PACMA",1
16,"16048",432,339,337,8,2,"PACMA",0
2,"2049",937,717,708,2,9,"PACMA",0
10,"10004",733,576,565,6,11,"PACMA",0
2,"2050",121,95,95,1,0,"PACMA",1
28,"28158",632,505,495,4,10,"PACMA",0
42,"42177",78,64,62,4,2,"PACMA",0
39,"39061",3458,2673,2644,42,29,"PACMA",9
25,"25008",1187,834,818,15,16,"PACMA",4
40,"40154",23,21,21,1,0,"PACMA",0
7,"7007",454,304,300,4,4,"PACMA",2
39,"39049",339,244,242,5,2,"PACMA",4
24,"24095",293,211,208,1,3,"PACMA",0
50,"50175",1088,742,732,10,10,"PACMA",0
46,"46199",5661,4328,4280,38,48,"PACMA",24
19,"19190",2499,1829,1785,32,44,"PACMA",8
42,"42016",25,13,13,0,0,"PACMA",1
19,"19132",105,79,79,0,0,"PACMA",0
6,"6054",5468,4305,4185,35,120,"PACMA",10
46,"46229",1065,840,831,8,9,"PACMA",2
16,"16050",298,245,238,0,7,"PACMA",0
9,"9172",129,110,109,2,1,"PACMA",3
50,"50136",617,469,462,4,7,"PACMA",1
18,"18040",246,147,146,0,1,"PACMA",1
24,"24018",180,150,149,1,1,"PACMA",0
15,"15013",6160,4229,4165,70,64,"PACMA",28
19,"19234",63,48,48,0,0,"PACMA",0
10,"10073",759,589,583,3,6,"PACMA",1
39,"39059",8476,6365,6284,73,81,"PACMA",12
34,"34160",154,119,116,0,3,"PACMA",1
33,"33005",1600,1084,1080,6,4,"PACMA",3
39,"39007",479,348,347,3,1,"PACMA",2
9,"9257",93,73,72,2,1,"PACMA",0
44,"44174",435,310,309,3,1,"PACMA",0
49,"49242",503,421,410,5,11,"PACMA",0
35,"35018",11652,6488,6367,107,121,"PACMA",28
16,"16044",51,35,35,0,0,"PACMA",0
49,"49113",188,166,161,2,5,"PACMA",0
46,"46131",49087,37846,37477,422,369,"PACMA",182
49,"49189",228,151,150,3,1,"PACMA",0
21,"21045",261,200,200,5,0,"PACMA",1
48,"48093",893,707,695,1,12,"PACMA",1
45,"45045",1313,992,979,12,13,"PACMA",5
40,"40094",375,286,284,4,2,"PACMA",0
18,"18053",1836,1345,1340,11,5,"PACMA",0
34,"34103",105,92,92,5,0,"PACMA",0
34,"34240",102,84,83,1,1,"PACMA",0
37,"37351",305,261,258,2,3,"PACMA",1
16,"16006",133,117,116,2,1,"PACMA",0
50,"50169",371,275,274,5,1,"PACMA",0
38,"38020",14520,9396,9202,121,194,"PACMA",52
3,"3047",8867,6219,6113,76,106,"PACMA",39
24,"24033",214,157,152,3,5,"PACMA",3
10,"10035",1941,1517,1492,15,25,"PACMA",1
22,"22094",109,76,74,5,2,"PACMA",1
15,"15052",4567,3539,3493,22,46,"PACMA",4
2,"2054",421,346,343,2,3,"PACMA",1
9,"9115",96,71,70,4,1,"PACMA",0
2,"2067",1197,938,924,6,14,"PACMA",3
6,"6134",561,399,398,5,1,"PACMA",0
18,"18143",949,722,704,2,18,"PACMA",2
38,"38021",1792,1184,1160,6,24,"PACMA",1
25,"25133",748,499,483,7,16,"PACMA",1
47,"47142",172,132,131,2,1,"PACMA",0
6,"6105",655,450,448,1,2,"PACMA",0
10,"10037",74974,56844,55950,898,894,"PACMA",366
34,"34165",86,67,67,0,0,"PACMA",2
24,"24009",362,188,184,0,4,"PACMA",1
26,"26151",455,384,382,1,2,"PACMA",0
2,"2007",1139,923,916,0,7,"PACMA",2
50,"50255",219,150,148,1,2,"PACMA",0
28,"28154",5232,3910,3860,40,50,"PACMA",16
46,"46244",57805,41885,41595,415,290,"PACMA",165
34,"34034",129,104,104,1,0,"PACMA",0
3,"3046",1530,1136,1121,11,15,"PACMA",6
7,"7006",4964,3234,3157,51,77,"PACMA",11
44,"44175",138,111,111,4,0,"PACMA",0
18,"18128",361,284,283,5,1,"PACMA",0
18,"18051",1196,857,852,4,5,"PACMA",1
33,"33020",13542,9300,9173,135,127,"PACMA",31
45,"45191",601,506,498,1,8,"PACMA",0
46,"46063",1764,1441,1423,15,18,"PACMA",7
37,"37078",888,728,714,9,14,"PACMA",1
42,"42189",75,58,58,2,0,"PACMA",0
10,"10148",32554,23348,22955,365,393,"PACMA",99
40,"40179",634,545,538,4,7,"PACMA",1
10,"10053",303,253,246,5,7,"PACMA",1
6,"6062",638,493,492,3,1,"PACMA",3
7,"7059",3011,2077,2012,22,65,"PACMA",13
34,"34068",32,23,23,0,0,"PACMA",0
10,"10067",10392,7979,7804,111,175,"PACMA",12
21,"21077",1690,1335,1321,8,14,"PACMA",3
2,"2010",1877,1557,1519,15,38,"PACMA",3
45,"45159",100,84,84,1,0,"PACMA",0
25,"25043",830,483,467,17,16,"PACMA",0
39,"39063",1018,769,762,6,7,"PACMA",0
21,"21057",1054,699,697,9,2,"PACMA",0
9,"9223",46,40,40,0,0,"PACMA",0
16,"16024",134,92,91,1,1,"PACMA",0
22,"22012",93,74,74,5,0,"PACMA",0
32,"32053",1500,1206,1199,19,7,"PACMA",0
39,"39012",6666,5148,5061,43,87,"PACMA",13
35,"35031",6968,4927,4862,71,65,"PACMA",21
26,"26155",173,134,134,1,0,"PACMA",0
45,"45051",1658,1305,1293,20,12,"PACMA",4
9,"9179",45,37,37,0,0,"PACMA",1
1,"1901",2254,1561,1528,24,33,"PACMA",13
25,"25063",97,65,64,2,1,"PACMA",1
22,"22043",112,72,71,2,1,"PACMA",0
22,"22013",304,239,236,3,3,"PACMA",0
34,"34070",182,138,137,1,1,"PACMA",0
26,"26157",306,268,263,1,5,"PACMA",1
3,"3020",108,87,86,1,1,"PACMA",0
2,"2084",362,276,270,2,6,"PACMA",0
34,"34901",1233,955,946,14,9,"PACMA",3
45,"45105",426,326,322,2,4,"PACMA",2
16,"16219",106,83,82,0,1,"PACMA",0
1,"1008",781,566,546,7,20,"PACMA",3
19,"19081",43,33,33,0,0,"PACMA",0
39,"39037",2061,1609,1586,10,23,"PACMA",3
39,"39019",2009,1556,1536,10,20,"PACMA",19
16,"16106",2839,2351,2331,10,20,"PACMA",0
49,"49179",401,285,284,2,1,"PACMA",2
33,"33041",7488,5356,5309,65,47,"PACMA",13
19,"19156",1032,782,762,4,20,"PACMA",0
13,"13031",2384,1908,1874,23,34,"PACMA",6
34,"34099",56,49,47,1,2,"PACMA",0
37,"37239",235,208,201,2,7,"PACMA",2
10,"10017",884,681,673,6,8,"PACMA",1
9,"9136",203,153,146,3,7,"PACMA",0
44,"44241",575,442,427,4,15,"PACMA",0
47,"47190",103,87,87,7,0,"PACMA",0
5,"5093",431,330,329,1,1,"PACMA",3
18,"18183",685,502,500,3,2,"PACMA",0
49,"49110",382,236,233,1,3,"PACMA",0
32,"32085",10730,7588,7475,100,113,"PACMA",15
42,"42148",14,14,14,0,0,"PACMA",0
6,"6114",152,122,122,0,0,"PACMA",2
10,"10141",289,209,209,0,0,"PACMA",2
18,"18062",9418,6916,6835,62,81,"PACMA",27
18,"18069",506,375,371,4,4,"PACMA",0
6,"6024",1215,1015,1006,4,9,"PACMA",3
45,"45005",267,223,218,4,5,"PACMA",0
5,"5181",39,26,26,0,0,"PACMA",0
6,"6038",816,621,620,6,1,"PACMA",0
28,"28166",325,269,268,8,1,"PACMA",0
26,"26147",34,29,29,2,0,"PACMA",0
24,"24057",1459,1121,1092,16,29,"PACMA",2
32,"32038",497,360,358,2,2,"PACMA",0
34,"34087",108,88,87,1,1,"PACMA",0
25,"25047",1048,760,748,24,12,"PACMA",3
46,"46216",4806,3857,3825,39,32,"PACMA",8
10,"10209",297,217,213,3,4,"PACMA",1
28,"28114",148,110,110,0,0,"PACMA",0
47,"47192",99,84,84,0,0,"PACMA",0
25,"25097",102,70,69,3,1,"PACMA",1
21,"21048",327,226,226,5,0,"PACMA",0
11,"11035",13266,8794,8668,115,126,"PACMA",38
26,"26164",70,42,42,1,0,"PACMA",0
48,"48085",9893,6960,6885,93,75,"PACMA",51
12,"12112",104,90,90,0,0,"PACMA",0
19,"19281",25,24,22,3,2,"PACMA",0
34,"34005",899,707,698,8,9,"PACMA",2
38,"38009",3910,2687,2633,31,54,"PACMA",9
6,"6026",865,671,665,4,6,"PACMA",0
15,"15089",4354,3255,3216,55,39,"PACMA",16
50,"50205",98,72,71,2,1,"PACMA",0
42,"42048",78,63,62,3,1,"PACMA",0
3,"3003",460,382,370,1,12,"PACMA",1
46,"46048",3484,2915,2875,26,40,"PACMA",10
44,"44220",137,97,96,1,1,"PACMA",0
44,"44085",61,38,38,0,0,"PACMA",0
50,"50196",110,87,86,4,1,"PACMA",1
37,"37268",113,78,77,1,1,"PACMA",0
6,"6073",787,563,552,9,11,"PACMA",6
45,"45205",6333,4544,4451,58,93,"PACMA",35
15,"15090",1267,959,953,4,6,"PACMA",2
6,"6118",228,181,181,1,0,"PACMA",0
6,"6135",1094,898,890,14,8,"PACMA",1
40,"40049",52,39,39,1,0,"PACMA",0
16,"16147",78,63,62,1,1,"PACMA",0
18,"18044",208,132,132,4,0,"PACMA",0
50,"50298",5319,4023,3955,72,68,"PACMA",16
9,"9231",77,42,42,0,0,"PACMA",0
5,"5141",99,90,89,0,1,"PACMA",0
24,"24180",1196,868,862,22,6,"PACMA",3
37,"37169",196,137,136,1,1,"PACMA",0
46,"46219",143,127,126,1,1,"PACMA",0
46,"46243",149,120,117,0,3,"PACMA",1
25,"25142",387,265,264,5,1,"PACMA",4
46,"46097",890,674,662,2,12,"PACMA",9
44,"44168",194,154,152,4,2,"PACMA",0
25,"25050",3249,2056,1988,40,68,"PACMA",6
27,"27014",3511,2470,2437,45,33,"PACMA",6
40,"40115",126,98,95,2,3,"PACMA",0
37,"37154",156,130,125,1,5,"PACMA",0
49,"49200",1011,789,771,6,18,"PACMA",5
6,"6040",1032,807,807,11,0,"PACMA",1
3,"3043",2933,2494,2447,27,47,"PACMA",2
24,"24187",881,664,659,14,5,"PACMA",2
19,"19160",944,600,593,6,7,"PACMA",5
19,"19050",21,19,19,0,0,"PACMA",0
37,"37133",108,79,77,0,2,"PACMA",1
13,"13027",3582,2770,2715,25,55,"PACMA",4
3,"3039",92,70,66,1,4,"PACMA",0
6,"6122",6620,4904,4797,44,107,"PACMA",14
5,"5010",173,141,134,2,7,"PACMA",0
29,"29062",647,573,571,1,2,"PACMA",1
42,"42011",22,14,14,1,0,"PACMA",0
5,"5022",1649,1335,1328,7,7,"PACMA",3
44,"44117",357,278,275,0,3,"PACMA",2
37,"37109",191,142,141,1,1,"PACMA",0
24,"24052",178,113,111,0,2,"PACMA",0
34,"34231",273,209,206,2,3,"PACMA",0
50,"50122",68,47,45,2,2,"PACMA",0
21,"21036",213,172,167,1,5,"PACMA",0
37,"37248",160,130,130,1,0,"PACMA",0
34,"34137",31,24,24,3,0,"PACMA",0
2,"2022",431,346,343,1,3,"PACMA",1
3,"3109",2745,2332,2302,18,30,"PACMA",4
10,"10217",535,423,422,3,1,"PACMA",0
26,"26081",23,17,17,0,0,"PACMA",0
18,"18116",2972,2237,2213,19,24,"PACMA",1
44,"44173",107,87,77,5,10,"PACMA",0
5,"5124",134,111,109,1,2,"PACMA",0
24,"24172",491,234,232,2,2,"PACMA",1
9,"9267",135,118,118,3,0,"PACMA",1
10,"10204",489,364,351,3,13,"PACMA",1
48,"48002",7971,5377,5290,65,87,"PACMA",19
7,"7038",1962,1504,1480,20,24,"PACMA",7
3,"3053",7082,5754,5664,60,90,"PACMA",35
42,"42088",69,56,56,1,0,"PACMA",0
33,"33017",3289,2378,2350,35,28,"PACMA",4
32,"32083",960,675,672,0,3,"PACMA",1
10,"10056",605,484,476,5,8,"PACMA",1
49,"49192",166,139,139,2,0,"PACMA",0
18,"18150",6452,4666,4625,56,41,"PACMA",6
2,"2060",1232,974,964,10,10,"PACMA",0
19,"19099",337,211,210,6,1,"PACMA",2
9,"9159",57,49,48,0,1,"PACMA",1
34,"34136",192,122,122,1,0,"PACMA",0
12,"12080",2051,1692,1650,23,42,"PACMA",11
28,"28903",29222,23945,23689,296,256,"PACMA",99
28,"28143",81,71,67,1,4,"PACMA",0
27,"27901",2559,1847,1831,27,16,"PACMA",3
47,"47029",61,54,53,0,1,"PACMA",0
13,"13021",459,358,355,5,3,"PACMA",0
44,"44121",63,48,48,1,0,"PACMA",0
28,"28120",1259,946,931,11,15,"PACMA",1
15,"15049",1211,851,843,7,8,"PACMA",4
28,"28164",2807,2194,2173,10,21,"PACMA",17
16,"16125",1734,1367,1350,12,17,"PACMA",4
50,"50269",316,186,185,1,1,"PACMA",1
46,"46021",23273,17264,17091,163,173,"PACMA",76
28,"28134",55921,42676,42221,505,455,"PACMA",152
47,"47164",391,326,320,3,6,"PACMA",0
49,"49180",169,113,107,2,6,"PACMA",0
44,"44217",37,28,27,0,1,"PACMA",0
45,"45029",233,207,202,4,5,"PACMA",0
6,"6099",1127,815,805,6,10,"PACMA",1
44,"44023",13,11,11,0,0,"PACMA",0
24,"24122",1424,1001,992,9,9,"PACMA",0
15,"15050",1971,1110,1097,27,13,"PACMA",0
6,"6069",3116,2316,2288,46,28,"PACMA",6
33,"33012",5341,3816,3777,43,39,"PACMA",6
34,"34210",103,93,91,2,2,"PACMA",1
5,"5083",155,120,113,1,7,"PACMA",2
44,"44163",119,91,91,0,0,"PACMA",0
37,"37140",731,490,475,0,15,"PACMA",0
12,"12014",191,139,137,4,2,"PACMA",0
46,"46224",179,131,128,0,3,"PACMA",0
16,"16004",325,247,246,0,1,"PACMA",1
5,"5901",289,197,196,4,1,"PACMA",0
34,"34101",54,44,44,0,0,"PACMA",0
50,"50271",283,209,207,4,2,"PACMA",0
46,"46006",4643,3847,3785,32,62,"PACMA",12
26,"26088",48,41,41,0,0,"PACMA",0
49,"49154",147,104,102,1,2,"PACMA",0
16,"16040",97,76,75,1,1,"PACMA",0
12,"12043",620,499,487,2,12,"PACMA",3
18,"18117",535,444,440,2,4,"PACMA",3
47,"47140",132,109,108,1,1,"PACMA",0
42,"42165",424,291,280,6,11,"PACMA",0
25,"25123",206,140,136,4,4,"PACMA",0
25,"25181",189,128,123,3,5,"PACMA",0
10,"10061",1765,1305,1290,13,15,"PACMA",1
28,"28145",2125,1643,1620,15,23,"PACMA",5
19,"19009",253,187,184,0,3,"PACMA",0
25,"25247",142,80,78,3,2,"PACMA",3
37,"37141",158,140,139,1,1,"PACMA",0
27,"27026",2605,1785,1751,19,34,"PACMA",6
42,"42020",4385,3055,2957,74,98,"PACMA",9
37,"37256",245,191,190,2,1,"PACMA",0
27,"27042",1888,1427,1407,12,20,"PACMA",1
5,"5030",43,39,39,0,0,"PACMA",2
28,"28167",7818,6016,5942,82,74,"PACMA",31
10,"10104",5233,3904,3824,30,80,"PACMA",17
5,"5140",112,100,99,1,1,"PACMA",0
34,"34149",26,18,18,0,0,"PACMA",0
24,"24061",1713,1223,1210,34,13,"PACMA",4
9,"9162",122,94,93,1,1,"PACMA",1
19,"19123",40,34,34,0,0,"PACMA",0
22,"22129",193,124,123,4,1,"PACMA",0
32,"32090",834,662,657,4,5,"PACMA",0
19,"19010",15,13,13,1,0,"PACMA",0
36,"36048",5416,4045,3971,55,74,"PACMA",12
18,"18123",307,239,238,1,1,"PACMA",1
7,"7045",1189,843,823,23,20,"PACMA",11
37,"37218",81,51,51,1,0,"PACMA",0
26,"26093",60,41,41,0,0,"PACMA",0
22,"22039",920,721,710,12,11,"PACMA",1
24,"24076",1210,917,907,26,10,"PACMA",3
18,"18054",879,646,644,4,2,"PACMA",0
16,"16047",249,192,191,5,1,"PACMA",1
15,"15035",11969,8239,8120,192,119,"PACMA",34
9,"9372",207,169,165,1,4,"PACMA",1
39,"39045",410,324,323,5,1,"PACMA",2
18,"18079",3497,2729,2706,15,23,"PACMA",4
12,"12027",16914,11657,11452,188,205,"PACMA",50
47,"47155",3043,2246,2225,35,21,"PACMA",12
49,"49263",69,54,54,2,0,"PACMA",0
16,"16049",158,129,129,1,0,"PACMA",0
45,"45195",2229,1806,1784,11,22,"PACMA",4
37,"37145",276,217,214,0,3,"PACMA",0
6,"6046",1288,1050,1042,11,8,"PACMA",2
18,"18093",2580,1837,1820,8,17,"PACMA",0
45,"45146",117,99,98,0,1,"PACMA",0
15,"15064",2356,1859,1824,35,35,"PACMA",4
15,"15008",5657,4224,4157,62,67,"PACMA",19
6,"6108",2355,1773,1746,24,27,"PACMA",9
50,"50284",176,131,130,1,1,"PACMA",0
32,"32068",1631,1187,1174,4,13,"PACMA",0
34,"34081",53,42,41,0,1,"PACMA",1
3,"3084",593,518,513,2,5,"PACMA",0
19,"19262",184,137,136,0,1,"PACMA",1
5,"5240",3351,2472,2428,22,44,"PACMA",12
9,"9073",889,672,663,12,9,"PACMA",5
42,"42069",1591,1122,1114,33,8,"PACMA",5
39,"39055",1130,881,869,10,12,"PACMA",0
18,"18192",1581,1331,1318,6,13,"PACMA",1
9,"9036",32,27,27,2,0,"PACMA",0
16,"16095",98,68,68,0,0,"PACMA",0
50,"50276",148,116,114,3,2,"PACMA",0
42,"42070",45,29,28,0,1,"PACMA",0
5,"5080",75,53,53,1,0,"PACMA",0
34,"34155",142,118,117,3,1,"PACMA",0
25,"25096",988,633,613,12,20,"PACMA",1
19,"19231",16,14,14,0,0,"PACMA",0
34,"34232",802,632,623,9,9,"PACMA",1
28,"28013",38226,27886,27547,246,339,"PACMA",110
19,"19117",1526,1155,1132,26,23,"PACMA",7
50,"50239",65,44,44,0,0,"PACMA",0
22,"22193",318,266,264,7,2,"PACMA",2
29,"29064",584,428,422,4,6,"PACMA",0
6,"6095",9330,6974,6873,129,101,"PACMA",20
37,"37299",237,167,165,2,2,"PACMA",0
49,"49121",382,270,270,1,0,"PACMA",1
37,"37186",109,88,88,2,0,"PACMA",0
6,"6131",1037,871,865,8,6,"PACMA",0
1,"1014",385,281,274,6,7,"PACMA",1
2,"2037",22380,15942,15724,203,218,"PACMA",55
13,"13042",953,704,693,5,11,"PACMA",0
9,"9421",269,189,189,5,0,"PACMA",0
50,"50008",5110,3458,3406,56,52,"PACMA",17
18,"18182",1982,1405,1397,6,8,"PACMA",0
13,"13064",1465,1127,1110,21,17,"PACMA",9
18,"18071",5589,4268,4205,44,63,"PACMA",19
27,"27021",1936,1295,1271,19,24,"PACMA",10
18,"18909",668,536,534,2,2,"PACMA",0
34,"34129",191,144,142,0,2,"PACMA",1
27,"27005",2792,2101,2076,21,25,"PACMA",17
22,"22001",242,177,173,2,4,"PACMA",0
45,"45114",608,476,468,3,8,"PACMA",2
40,"40184",269,227,224,4,3,"PACMA",1
24,"24029",840,590,579,11,11,"PACMA",0
18,"18119",1778,1401,1391,14,10,"PACMA",0
2,"2062",456,348,344,2,4,"PACMA",1
16,"16099",232,180,178,5,2,"PACMA",0
9,"9039",58,50,49,0,1,"PACMA",0
42,"42059",23,19,19,1,0,"PACMA",0
19,"19327",551,459,449,3,10,"PACMA",1
37,"37189",139,90,90,1,0,"PACMA",0
49,"49167",223,173,171,5,2,"PACMA",1
13,"13011",5166,3555,3500,31,55,"PACMA",8
39,"39032",1576,1215,1209,10,6,"PACMA",0
40,"40171",32,25,25,0,0,"PACMA",0
2,"2015",1508,1230,1211,7,19,"PACMA",1
9,"9198",115,85,85,1,0,"PACMA",0
50,"50194",102,67,67,2,0,"PACMA",0
36,"36022",9203,6423,6226,100,197,"PACMA",30
24,"24206",1831,1362,1341,13,21,"PACMA",1
37,"37115",135,107,101,2,6,"PACMA",0
19,"19020",52,39,39,3,0,"PACMA",0
25,"25067",768,498,494,14,4,"PACMA",0
3,"3056",8929,6927,6776,74,151,"PACMA",35
5,"5151",100,86,82,1,4,"PACMA",0
18,"18902",950,769,762,6,7,"PACMA",0
38,"38030",1875,1320,1301,11,19,"PACMA",1
6,"6005",1699,1332,1320,19,12,"PACMA",3
19,"19155",61,52,50,1,2,"PACMA",1
34,"34238",348,289,287,4,2,"PACMA",0
19,"19226",40,31,30,0,1,"PACMA",0
46,"46263",333,243,241,2,2,"PACMA",0
7,"7021",255,197,193,1,4,"PACMA",2
25,"25161",361,222,218,1,4,"PACMA",0
24,"24046",1002,704,696,20,8,"PACMA",0
28,"28174",1745,1233,1224,11,9,"PACMA",0
47,"47131",189,145,145,4,0,"PACMA",0
25,"25163",237,147,142,2,5,"PACMA",1
10,"10117",264,174,174,2,0,"PACMA",0
9,"9218",384,285,279,8,6,"PACMA",0
24,"24179",331,219,214,4,5,"PACMA",2
35,"35028",8810,4687,4603,71,84,"PACMA",12
34,"34163",61,56,56,1,0,"PACMA",0
33,"33044",180964,129466,128346,1888,1120,"PACMA",435
2,"2042",897,712,709,6,3,"PACMA",2
29,"29041",2796,1950,1921,24,29,"PACMA",4
46,"46088",196,146,140,0,6,"PACMA",0
9,"9174",859,645,639,11,6,"PACMA",0
32,"32016",1021,781,776,2,5,"PACMA",0
32,"32004",2071,1145,1142,7,3,"PACMA",2
50,"50216",267,201,194,8,7,"PACMA",0
27,"27012",1519,886,880,6,6,"PACMA",0
50,"50109",101,79,79,2,0,"PACMA",0
18,"18167",1927,1397,1380,13,17,"PACMA",8
25,"25070",888,594,582,18,12,"PACMA",4
3,"3026",1210,1004,989,11,15,"PACMA",5
50,"50225",1638,1079,1062,7,17,"PACMA",1
13,"13081",684,553,527,1,26,"PACMA",0
29,"29042",14047,9845,9735,118,110,"PACMA",19
45,"45120",159,125,122,0,3,"PACMA",3
46,"46016",1097,927,917,12,10,"PACMA",0
26,"26108",324,245,243,4,2,"PACMA",1
12,"12029",760,619,601,7,18,"PACMA",2
18,"18136",1973,1679,1668,5,11,"PACMA",2
37,"37233",59,46,45,1,1,"PACMA",0
21,"21004",1530,1059,1042,9,17,"PACMA",3
34,"34180",84,68,68,0,0,"PACMA",0
49,"49112",131,93,93,2,0,"PACMA",0
32,"32063",2127,1469,1444,22,25,"PACMA",5
16,"16193",77,68,67,0,1,"PACMA",0
22,"22009",704,488,473,15,15,"PACMA",3
48,"48033",223,171,171,1,0,"PACMA",0
25,"25134",657,421,416,4,5,"PACMA",0
10,"10121",8063,6048,5988,51,60,"PACMA",12
37,"37234",376,275,272,2,3,"PACMA",0
18,"18137",1057,875,868,8,7,"PACMA",0
42,"42120",148,91,91,4,0,"PACMA",0
24,"24063",453,323,322,2,1,"PACMA",0
5,"5067",85,68,68,0,0,"PACMA",0
46,"46002",1166,942,915,7,27,"PACMA",2
2,"2082",121,107,107,1,0,"PACMA",0
12,"12032",23406,16895,16721,227,174,"PACMA",99
12,"12129",1936,1372,1326,29,46,"PACMA",9
49,"49175",263,215,215,4,0,"PACMA",0
3,"3096",5863,4550,4457,57,93,"PACMA",21
46,"46188",660,579,576,4,3,"PACMA",4
44,"44198",205,160,160,5,0,"PACMA",0
18,"18037",488,408,404,0,4,"PACMA",0
46,"46115",515,364,354,1,10,"PACMA",1
24,"24012",291,196,194,2,2,"PACMA",1
16,"16150",120,90,90,0,0,"PACMA",1
5,"5090",72,64,63,1,1,"PACMA",0
46,"46019",8671,7195,7109,70,86,"PACMA",23
37,"37197",101,72,70,1,2,"PACMA",0
22,"22207",135,86,79,4,7,"PACMA",1
24,"24215",169,121,120,1,1,"PACMA",0
49,"49028",119,103,103,1,0,"PACMA",0
12,"12069",53,48,47,0,1,"PACMA",0
28,"28149",5276,4132,4063,43,69,"PACMA",17
27,"27003",2064,1531,1516,19,15,"PACMA",4
19,"19016",74,50,49,0,1,"PACMA",0
49,"49002",77,59,59,1,0,"PACMA",0
34,"34220",145,125,123,0,2,"PACMA",1
38,"38036",6477,4514,4422,40,92,"PACMA",24
46,"46189",490,400,396,3,4,"PACMA",2
39,"39013",561,413,412,2,1,"PACMA",0
16,"16066",2402,2064,1997,32,67,"PACMA",8
50,"50247",794,572,567,7,5,"PACMA",1
1,"1018",1395,952,943,7,9,"PACMA",7
50,"50211",277,193,193,1,0,"PACMA",0
33,"33018",2971,2139,2121,32,18,"PACMA",7
37,"37113",439,365,365,7,0,"PACMA",0
46,"46190",48324,34747,34424,431,323,"PACMA",176
26,"26144",196,163,162,2,1,"PACMA",0
12,"12132",524,407,401,4,6,"PACMA",0
37,"37213",97,77,76,0,1,"PACMA",3
37,"37363",121,100,99,0,1,"PACMA",0
19,"19044",319,248,245,0,3,"PACMA",0
19,"19005",92,80,79,0,1,"PACMA",2
25,"25138",605,440,428,13,12,"PACMA",2
49,"49230",122,98,95,1,3,"PACMA",0
6,"6113",2750,2143,2105,26,38,"PACMA",8
49,"49095",318,232,232,5,0,"PACMA",0
6,"6158",13094,9945,9753,131,192,"PACMA",74
47,"47218",983,776,767,7,9,"PACMA",3
19,"19145",64,49,48,2,1,"PACMA",0
22,"22059",1149,792,764,23,28,"PACMA",5
2,"2901",2223,1678,1667,19,11,"PACMA",3
15,"15031",22951,16018,15696,382,322,"PACMA",74
10,"10114",926,670,652,8,18,"PACMA",3
18,"18030",612,457,456,0,1,"PACMA",1
6,"6144",588,476,464,2,12,"PACMA",3
5,"5191",124,98,98,2,0,"PACMA",0
5,"5127",715,601,596,4,5,"PACMA",0
2,"2027",347,301,301,2,0,"PACMA",0
24,"24152",481,326,322,5,4,"PACMA",0
50,"50019",79,57,55,1,2,"PACMA",0
22,"22060",1180,909,891,13,18,"PACMA",3
47,"47056",90,69,69,2,0,"PACMA",0
42,"42045",345,238,234,2,4,"PACMA",0
22,"22214",131,101,100,2,1,"PACMA",0
24,"24219",580,435,431,10,4,"PACMA",0
15,"15088",3769,2626,2599,21,27,"PACMA",0
21,"21031",1309,903,871,9,32,"PACMA",4
37,"37354",4828,3589,3522,76,67,"PACMA",13
50,"50029",676,527,517,6,10,"PACMA",1
37,"37203",174,148,148,0,0,"PACMA",0
12,"12101",385,309,296,3,13,"PACMA",0
22,"22061",6611,4789,4698,110,91,"PACMA",31
49,"49084",306,234,234,8,0,"PACMA",1
46,"46160",1976,1591,1570,21,21,"PACMA",5
25,"25112",286,202,199,11,3,"PACMA",0
3,"3002",3559,2747,2707,16,40,"PACMA",11
19,"19247",171,125,118,6,7,"PACMA",0
25,"25171",2305,1496,1469,37,27,"PACMA",7
13,"13023",8731,6818,6732,94,86,"PACMA",13
3,"3035",672,560,550,0,10,"PACMA",1
10,"10130",1745,1360,1341,10,19,"PACMA",4
50,"50059",790,593,586,12,7,"PACMA",0
25,"25077",474,281,277,5,4,"PACMA",2
39,"39069",1957,1595,1570,18,25,"PACMA",5
2,"2017",895,685,682,4,3,"PACMA",0
28,"28091",5202,3714,3671,34,43,"PACMA",11
49,"49264",652,439,435,2,4,"PACMA",2
13,"13024",938,703,699,3,4,"PACMA",0
36,"36036",2616,1981,1948,24,33,"PACMA",6
46,"46169",31753,24041,23802,270,239,"PACMA",114
28,"28160",7496,5680,5613,46,67,"PACMA",28
33,"33013",466,349,345,4,4,"PACMA",1
45,"45167",1552,1296,1278,14,18,"PACMA",4
6,"6058",2048,1595,1574,22,21,"PACMA",2
21,"21033",508,385,382,7,3,"PACMA",1
9,"9019",153,104,104,1,0,"PACMA",2
49,"49236",86,64,64,0,0,"PACMA",0
32,"32078",1366,1026,1018,3,8,"PACMA",1
2,"2056",1816,1518,1506,15,12,"PACMA",4
50,"50236",124,103,103,2,0,"PACMA",0
18,"18112",132,90,90,1,0,"PACMA",2
28,"28161",44185,33371,32966,353,405,"PACMA",156
50,"50061",228,191,183,3,8,"PACMA",0
45,"45168",61519,47265,46528,736,737,"PACMA",197
39,"39018",4077,3212,3160,44,52,"PACMA",17
24,"24101",465,274,266,5,8,"PACMA",1
28,"28004",5761,4098,4044,38,54,"PACMA",11
3,"3038",338,294,291,2,3,"PACMA",4
19,"19136",22,15,15,0,0,"PACMA",0
49,"49224",161,114,112,2,2,"PACMA",0
18,"18063",1189,795,789,7,6,"PACMA",0
49,"49026",236,189,184,3,5,"PACMA",0
9,"9429",64,44,44,2,0,"PACMA",0
37,"37334",86,50,49,0,1,"PACMA",0
12,"12128",1448,1114,1092,16,22,"PACMA",2
44,"44171",186,127,124,3,3,"PACMA",2
15,"15092",6869,4965,4907,53,58,"PACMA",10
10,"10134",585,420,412,1,8,"PACMA",0
37,"37322",2501,1692,1676,32,16,"PACMA",8
26,"26124",860,705,694,3,11,"PACMA",2
42,"42053",27,26,25,1,1,"PACMA",0
6,"6138",1070,838,829,13,9,"PACMA",1
6,"6153",20332,15398,15216,239,182,"PACMA",48
5,"5186",1670,1306,1287,9,19,"PACMA",3
47,"47215",60,52,52,2,0,"PACMA",0
21,"21026",255,181,169,2,12,"PACMA",0
45,"45171",1359,1114,1093,13,21,"PACMA",3
10,"10095",346,290,283,3,7,"PACMA",0
16,"16266",402,334,325,4,9,"PACMA",0
19,"19220",2225,1482,1456,7,26,"PACMA",12
45,"45024",1105,870,856,16,14,"PACMA",0
21,"21006",3565,2477,2441,29,36,"PACMA",11
3,"3007",160,131,127,0,4,"PACMA",1
24,"24104",291,198,196,3,2,"PACMA",0
3,"3040",260,224,220,0,4,"PACMA",2
28,"28005",132097,100509,99506,1069,1003,"PACMA",370
26,"26126",32,31,31,1,0,"PACMA",0
3,"3903",2431,1991,1960,18,31,"PACMA",6
19,"19252",90,80,78,0,2,"PACMA",0
1,"1051",3662,2242,2210,26,32,"PACMA",13
15,"15084",3681,2676,2656,34,20,"PACMA",5
28,"28118",72,49,47,1,2,"PACMA",0
19,"19198",22,19,19,0,0,"PACMA",0
37,"37014",1198,862,852,8,10,"PACMA",0
24,"24149",149,120,118,3,2,"PACMA",2
46,"46197",1902,1559,1554,15,5,"PACMA",1
46,"46027",997,869,855,4,14,"PACMA",4
24,"24229",473,348,344,8,4,"PACMA",0
48,"48025",882,652,644,2,8,"PACMA",1
24,"24027",1184,853,837,7,16,"PACMA",1
49,"49061",141,106,105,1,1,"PACMA",0
37,"37212",123,95,92,1,3,"PACMA",0
9,"9330",1562,1212,1176,10,36,"PACMA",4
9,"9302",116,87,87,3,0,"PACMA",0
24,"24202",8677,5486,5377,103,109,"PACMA",14
5,"5070",41,33,33,0,0,"PACMA",0
3,"3009",47547,35945,35298,603,647,"PACMA",359
22,"22027",351,251,250,8,1,"PACMA",0
47,"47146",236,196,195,4,1,"PACMA",0
7,"7028",876,607,595,6,12,"PACMA",3
9,"9269",39,33,33,0,0,"PACMA",0
50,"50193",635,483,465,3,18,"PACMA",4
10,"10003",616,463,458,3,5,"PACMA",1
44,"44216",25877,18461,18057,467,404,"PACMA",83
42,"42108",13,10,10,1,0,"PACMA",0
19,"19255",95,68,68,0,0,"PACMA",0
6,"6036",5228,4075,4028,22,47,"PACMA",4
2,"2025",7496,6153,5985,69,168,"PACMA",22
34,"34141",190,162,160,0,2,"PACMA",0
46,"46053",584,484,461,2,23,"PACMA",0
37,"37288",252,194,194,3,0,"PACMA",1
19,"19082",91,68,67,1,1,"PACMA",1
9,"9109",1181,664,631,16,33,"PACMA",10
33,"33034",11390,7583,7501,85,82,"PACMA",10
47,"47064",30,21,21,1,0,"PACMA",0
50,"50037",140,110,103,3,7,"PACMA",0
24,"24043",144,77,77,0,0,"PACMA",0
24,"24083",1165,831,819,17,12,"PACMA",0
22,"22002",107,85,84,3,1,"PACMA",1
34,"34114",240,171,171,0,0,"PACMA",0
44,"44122",1441,1009,990,21,19,"PACMA",4
19,"19257",3595,2593,2543,48,50,"PACMA",10
49,"49199",266,214,211,1,3,"PACMA",0
27,"27039",4363,3410,3346,63,64,"PACMA",14
40,"40233",457,350,348,1,2,"PACMA",0
24,"24070",4434,3199,3136,34,63,"PACMA",7
35,"35017",22331,13463,13144,217,319,"PACMA",55
40,"40141",881,658,647,9,11,"PACMA",1
5,"5106",39,26,26,0,0,"PACMA",0
26,"26132",130,98,96,2,2,"PACMA",0
29,"29030",839,669,668,5,1,"PACMA",0
34,"34102",226,187,185,3,2,"PACMA",0
44,"44050",3183,2208,2154,78,54,"PACMA",11
37,"37366",46,35,34,0,1,"PACMA",25
37,"37254",189,168,164,1,4,"PACMA",0
46,"46201",83,50,49,0,1,"PACMA",0
19,"19046",20318,15118,14892,219,226,"PACMA",95
50,"50243",346,277,272,2,5,"PACMA",0
12,"12015",96,83,82,3,1,"PACMA",0
16,"16005",275,215,215,2,0,"PACMA",0
37,"37216",300,270,266,2,4,"PACMA",0
28,"28097",127,94,92,0,2,"PACMA",1
15,"15042",3249,2341,2303,25,38,"PACMA",2
28,"28052",3799,2753,2719,17,34,"PACMA",6
18,"18122",16253,12271,12109,132,162,"PACMA",21
13,"13035",1043,794,770,10,24,"PACMA",1
47,"47093",865,658,642,11,16,"PACMA",2
46,"46129",553,430,423,4,7,"PACMA",0
40,"40003",144,123,120,1,3,"PACMA",0
18,"18154",1062,770,769,0,1,"PACMA",1
5,"5005",199,170,169,1,1,"PACMA",0
37,"37020",449,371,365,7,6,"PACMA",0
19,"19294",27,26,26,1,0,"PACMA",0
16,"16091",86,66,66,1,0,"PACMA",1
37,"37008",4316,3518,3457,31,61,"PACMA",6
34,"34199",1354,1004,978,27,26,"PACMA",3
19,"19194",113,80,76,1,4,"PACMA",0
21,"21044",17018,11390,11290,132,100,"PACMA",27
15,"15044",1436,1083,1068,10,15,"PACMA",4
16,"16173",249,189,188,0,1,"PACMA",0
22,"22080",288,217,217,4,0,"PACMA",0
22,"22186",217,173,173,3,0,"PACMA",2
46,"46130",934,745,734,6,11,"PACMA",1
46,"46057",483,357,349,9,8,"PACMA",0
44,"44222",136,99,99,2,0,"PACMA",0
19,"19162",71,52,51,0,1,"PACMA",0
22,"22130",9983,6691,6573,148,118,"PACMA",58
34,"34151",184,125,123,1,2,"PACMA",0
46,"46257",5579,4546,4512,32,34,"PACMA",10
32,"32079",1448,1103,1094,14,9,"PACMA",2
2,"2019",2455,2107,2077,16,30,"PACMA",2
44,"44128",84,56,56,3,0,"PACMA",0
6,"6137",1035,848,842,2,6,"PACMA",3
19,"19011",286,219,218,3,1,"PACMA",1
37,"37195",48,32,32,0,0,"PACMA",0
26,"26079",690,568,562,5,6,"PACMA",0
49,"49205",429,313,309,10,4,"PACMA",0
5,"5045",104,82,82,0,0,"PACMA",0
12,"12018",326,274,265,1,9,"PACMA",0
9,"9208",252,192,192,6,0,"PACMA",0
37,"37023",1040,819,811,11,8,"PACMA",2
39,"39080",3627,2743,2693,19,50,"PACMA",4
46,"46050",161,126,123,1,3,"PACMA",0
12,"12077",4683,3476,3414,41,62,"PACMA",4
47,"47061",266,227,223,0,4,"PACMA",0
42,"42103",626,487,481,3,6,"PACMA",2
22,"22068",79,51,51,2,0,"PACMA",1
2,"2070",439,372,366,4,6,"PACMA",3
50,"50190",751,576,565,7,11,"PACMA",2
47,"47153",135,94,93,1,1,"PACMA",1
18,"18094",2398,1882,1868,16,14,"PACMA",7
3,"3051",356,314,311,2,3,"PACMA",1
28,"28055",932,713,707,5,6,"PACMA",2
45,"45037",1730,1325,1304,15,21,"PACMA",3
25,"25251",670,476,473,1,3,"PACMA",0
40,"40008",44,37,36,0,1,"PACMA",0
25,"25006",362,231,228,2,3,"PACMA",1
46,"46059",1310,1076,1058,2,18,"PACMA",3
34,"34029",832,696,683,11,13,"PACMA",2
19,"19197",29,19,19,0,0,"PACMA",0
16,"16137",64,41,40,0,1,"PACMA",0
49,"49120",79,58,58,1,0,"PACMA",0
45,"45185",7912,6321,6180,68,141,"PACMA",17
50,"50025",4569,3319,3271,68,48,"PACMA",10
24,"24080",228,165,164,0,1,"PACMA",0
37,"37026",201,176,176,3,0,"PACMA",0
42,"42123",172,128,128,3,0,"PACMA",0
13,"13041",298,225,225,1,0,"PACMA",0
26,"26142",804,661,648,1,13,"PACMA",3
44,"44060",42,34,34,0,0,"PACMA",0
6,"6096",254,202,201,0,1,"PACMA",0
3,"3121",20518,14464,14315,137,149,"PACMA",72
9,"9253",108,95,94,4,1,"PACMA",2
42,"42208",23,15,15,1,0,"PACMA",0
50,"50036",103,81,80,2,1,"PACMA",0
37,"37374",1204,1018,1004,9,14,"PACMA",0
19,"19168",324,233,231,6,2,"PACMA",0
6,"6051",1606,1314,1302,10,12,"PACMA",2
46,"46206",595,497,495,3,2,"PACMA",9
34,"34233",158,128,128,3,0,"PACMA",0
49,"49109",657,534,529,12,5,"PACMA",0
49,"49272",102,87,86,0,1,"PACMA",0
39,"39075",140941,103308,102362,1364,946,"PACMA",391
6,"6097",2475,1934,1902,27,32,"PACMA",2
3,"3021",5594,4630,4517,46,113,"PACMA",25
36,"36054",10862,8201,8087,87,114,"PACMA",30
28,"28127",60108,48418,48039,568,379,"PACMA",153
25,"25098",266,177,177,0,0,"PACMA",0
28,"28106",72603,53231,52524,681,707,"PACMA",332
44,"44190",81,52,52,0,0,"PACMA",0
37,"37114",92,75,74,1,1,"PACMA",0
10,"10113",2440,1891,1859,11,32,"PACMA",9
45,"45151",631,474,470,1,4,"PACMA",0
16,"16042",1286,1101,1089,8,12,"PACMA",3
25,"25222",69,55,54,0,1,"PACMA",0
2,"2038",296,254,254,1,0,"PACMA",0
2,"2002",479,411,407,3,4,"PACMA",0
26,"26162",116,94,93,2,1,"PACMA",1
46,"46192",755,564,554,9,10,"PACMA",6
34,"34223",233,175,175,2,0,"PACMA",0
46,"46030",800,677,662,6,15,"PACMA",0
9,"9901",407,319,308,8,11,"PACMA",3
40,"40108",120,83,82,1,1,"PACMA",0
46,"46111",10589,7823,7710,94,113,"PACMA",34
19,"19170",214,139,138,0,1,"PACMA",0
39,"39033",604,480,473,3,7,"PACMA",0
49,"49124",279,203,202,2,1,"PACMA",1
12,"12094",807,612,604,14,8,"PACMA",1
9,"9216",390,278,272,2,6,"PACMA",3
18,"18133",2256,1783,1773,12,10,"PACMA",0
24,"24006",521,384,378,4,6,"PACMA",2
13,"13045",744,615,608,6,7,"PACMA",1
9,"9258",190,159,159,5,0,"PACMA",0
22,"22143",244,166,161,2,5,"PACMA",1
12,"12061",431,324,316,6,8,"PACMA",0
26,"26105",2181,1712,1690,24,22,"PACMA",7
46,"46233",3911,3025,2988,10,37,"PACMA",14
10,"10034",376,283,278,5,5,"PACMA",0
3,"3024",3908,3324,3271,34,53,"PACMA",8
34,"34161",23,20,20,0,0,"PACMA",0
28,"28108",3002,2254,2228,31,26,"PACMA",10
37,"37231",285,227,225,6,2,"PACMA",1
11,"11011",1685,1231,1216,8,15,"PACMA",1
2,"2078",967,770,756,9,14,"PACMA",5
24,"24087",670,513,513,12,0,"PACMA",2
49,"49085",1173,912,908,16,4,"PACMA",1
12,"12028",12115,9084,8992,137,92,"PACMA",49
34,"34214",176,144,143,3,1,"PACMA",2
42,"42034",40,29,29,0,0,"PACMA",0
26,"26022",232,191,190,1,1,"PACMA",0
44,"44234",76,63,63,0,0,"PACMA",0
27,"27058",3908,2946,2915,28,31,"PACMA",3
7,"7022",11700,7512,7371,128,141,"PACMA",47
24,"24088",1103,903,885,4,18,"PACMA",1
35,"35002",21673,14480,14253,172,227,"PACMA",48
50,"50078",278,210,208,2,2,"PACMA",0
44,"44067",132,89,89,0,0,"PACMA",0
34,"34122",80,65,62,2,3,"PACMA",0
9,"9400",340,253,249,4,4,"PACMA",0
22,"22203",92,79,79,0,0,"PACMA",0
22,"22095",87,61,61,1,0,"PACMA",0
28,"28175",780,641,630,8,11,"PACMA",9
3,"3060",124,100,98,0,2,"PACMA",0
5,"5087",144,87,87,0,0,"PACMA",0
33,"33029",420,243,241,3,2,"PACMA",0
49,"49265",143,105,105,1,0,"PACMA",0
44,"44196",152,116,114,2,2,"PACMA",0
40,"40161",38,28,28,0,0,"PACMA",0
19,"19060",165,127,121,3,6,"PACMA",0
26,"26152",38,31,31,0,0,"PACMA",0
16,"16160",76,54,53,1,1,"PACMA",0
44,"44169",403,285,278,0,7,"PACMA",1
5,"5262",378,308,307,2,1,"PACMA",0
15,"15063",2849,2022,2001,28,21,"PACMA",4
24,"24077",237,205,199,2,6,"PACMA",0
44,"44068",690,544,528,6,16,"PACMA",0
3,"3028",1049,903,895,6,8,"PACMA",2
22,"22099",532,411,408,6,3,"PACMA",0
50,"50080",41,31,31,1,0,"PACMA",1
22,"22251",391,288,278,4,10,"PACMA",2
24,"24130",468,343,337,6,6,"PACMA",1
47,"47152",94,65,65,0,0,"PACMA",0
49,"49252",370,310,305,6,5,"PACMA",0
19,"19105",2235,1709,1686,23,23,"PACMA",5
37,"37159",100,77,75,0,2,"PACMA",0
29,"29016",272,180,179,5,1,"PACMA",0
37,"37271",393,324,318,5,6,"PACMA",0
3,"3062",206,175,175,0,0,"PACMA",1
25,"25072",5921,3743,3637,81,106,"PACMA",13
19,"19241",45,37,37,2,0,"PACMA",0
46,"46091",126,108,108,0,0,"PACMA",3
40,"40163",62,51,51,5,0,"PACMA",0
22,"22252",130,98,96,5,2,"PACMA",0
37,"37160",644,474,464,4,10,"PACMA",1
37,"37348",114,91,90,1,1,"PACMA",0
49,"49269",241,171,170,5,1,"PACMA",0
25,"25197",158,102,101,2,1,"PACMA",0
30,"30041",12957,9360,9288,89,72,"PACMA",52
27,"27064",1706,1233,1214,14,19,"PACMA",5
9,"9011",86,56,56,1,0,"PACMA",1
10,"10041",1070,850,846,8,4,"PACMA",0
50,"50257",195,154,154,0,0,"PACMA",0
29,"29091",8777,6226,6126,64,100,"PACMA",12
49,"49256",289,229,224,3,5,"PACMA",0
50,"50172",187,140,138,4,2,"PACMA",1
12,"12034",1509,1125,1097,10,28,"PACMA",2
6,"6110",176,130,124,0,6,"PACMA",0
34,"34126",284,226,224,3,2,"PACMA",0
35,"35006",29515,20731,20286,362,445,"PACMA",87
15,"15057",12467,8936,8744,102,192,"PACMA",37
19,"19277",22,17,17,0,0,"PACMA",0
6,"6156",1190,989,978,9,11,"PACMA",2
49,"49228",64,56,56,0,0,"PACMA",0
40,"40151",52,42,42,0,0,"PACMA",2
28,"28104",11704,9455,9361,119,94,"PACMA",38
5,"5158",410,333,331,2,2,"PACMA",1
2,"2085",345,288,284,2,4,"PACMA",0
11,"11017",3219,2403,2388,18,15,"PACMA",2
39,"39014",943,706,700,9,6,"PACMA",2
50,"50231",285,231,224,7,7,"PACMA",0
37,"37003",134,103,102,0,1,"PACMA",0
29,"29073",1520,1032,1021,10,11,"PACMA",0
37,"37263",361,277,275,1,2,"PACMA",0
9,"9013",48,41,41,1,0,"PACMA",1
13,"13053",14718,10958,10766,159,192,"PACMA",47
12,"12102",547,474,466,2,8,"PACMA",4
44,"44203",8,8,8,0,0,"PACMA",0
46,"46142",870,682,673,7,9,"PACMA",2
5,"5222",155,132,132,1,0,"PACMA",0
46,"46069",166,149,148,1,1,"PACMA",0
29,"29019",908,720,714,0,6,"PACMA",0
37,"37004",31,23,23,0,0,"PACMA",0
24,"24218",476,344,340,11,4,"PACMA",0
22,"22903",672,555,547,6,8,"PACMA",0
9,"9410",3181,2079,2049,48,30,"PACMA",22
49,"49231",360,256,254,4,2,"PACMA",0
24,"24004",535,391,390,0,1,"PACMA",0
35,"35025",1941,1345,1328,12,17,"PACMA",1
40,"40155",3083,2333,2280,73,53,"PACMA",17
50,"50185",150,109,109,2,0,"PACMA",1
13,"13044",2747,1996,1950,20,46,"PACMA",5
39,"39015",898,692,688,7,4,"PACMA",1
42,"42003",76,54,51,0,3,"PACMA",0
44,"44244",93,56,56,5,0,"PACMA",1
10,"10005",551,439,424,4,15,"PACMA",2
37,"37278",736,538,529,7,9,"PACMA",2
19,"19280",3415,2521,2490,27,31,"PACMA",19
46,"46070",15946,11979,11874,113,105,"PACMA",53
28,"28023",4350,3425,3392,32,33,"PACMA",6
3,"3067",94,81,79,1,2,"PACMA",1
16,"16030",28,24,24,0,0,"PACMA",0
10,"10210",599,453,452,3,1,"PACMA",0
1,"1041",159,116,113,1,3,"PACMA",0
19,"19215",206,170,166,0,4,"PACMA",0
9,"9229",213,163,163,1,0,"PACMA",0
6,"6162",2964,2415,2390,19,25,"PACMA",7
44,"44165",182,140,140,1,0,"PACMA",1
37,"37242",99,73,72,0,1,"PACMA",0
22,"22111",180,126,125,3,1,"PACMA",0
24,"24019",367,293,287,5,6,"PACMA",0
12,"12005",8066,5835,5441,116,394,"PACMA",16
29,"29095",3431,2660,2607,23,53,"PACMA",6
26,"26034",678,526,510,3,16,"PACMA",2
40,"40032",394,293,288,6,5,"PACMA",0
42,"42095",1575,1136,1106,40,30,"PACMA",5
15,"15005",23875,15132,14895,356,237,"PACMA",95
6,"6027",732,655,645,8,10,"PACMA",0
5,"5129",153,98,95,0,3,"PACMA",0
19,"19183",108,87,86,1,1,"PACMA",0
22,"22217",406,314,309,4,5,"PACMA",1
40,"40033",61,48,47,3,1,"PACMA",0
39,"39017",588,424,419,2,5,"PACMA",2
37,"37168",470,357,353,1,4,"PACMA",0
3,"3070",1962,1582,1552,8,30,"PACMA",7
50,"50088",337,273,264,4,9,"PACMA",0
18,"18078",768,638,637,1,1,"PACMA",0
10,"10132",420,293,287,1,6,"PACMA",0
13,"13025",321,257,254,1,3,"PACMA",0
10,"10009",285,223,221,0,2,"PACMA",0
9,"9190",97,73,72,0,1,"PACMA",0
45,"45095",742,606,585,2,21,"PACMA",4
15,"15034",3116,2146,2114,20,32,"PACMA",3
19,"19151",1126,849,830,3,19,"PACMA",6
50,"50264",184,140,134,0,6,"PACMA",2
18,"18178",834,685,683,3,2,"PACMA",1
47,"47007",3453,2616,2580,42,36,"PACMA",20
50,"50089",6673,4936,4877,120,59,"PACMA",27
12,"12007",747,674,660,9,14,"PACMA",0
5,"5034",17,13,13,0,0,"PACMA",0
42,"42098",14,8,8,0,0,"PACMA",0
45,"45157",2097,1519,1499,15,20,"PACMA",8
5,"5142",113,97,96,0,1,"PACMA",1
24,"24158",333,223,223,6,0,"PACMA",0
44,"44017",316,232,229,1,3,"PACMA",1
24,"24011",244,131,129,0,2,"PACMA",0
28,"28025",426,336,332,2,4,"PACMA",0
46,"46074",2656,2071,2053,22,18,"PACMA",10
25,"25081",332,212,206,6,6,"PACMA",0
21,"21035",9657,6943,6871,64,72,"PACMA",7
29,"29069",80337,50235,49723,690,512,"PACMA",228
46,"46001",863,647,641,5,6,"PACMA",0
16,"16161",84,73,72,4,1,"PACMA",0
3,"3072",331,284,277,2,7,"PACMA",1
18,"18082",912,691,683,8,8,"PACMA",0
37,"37283",130,104,104,1,0,"PACMA",0
50,"50005",245,199,195,1,4,"PACMA",0
10,"10175",1509,1149,1127,4,22,"PACMA",1
10,"10013",305,242,237,1,5,"PACMA",0
9,"9103",247,201,200,2,1,"PACMA",1
6,"6078",548,457,453,2,4,"PACMA",3
46,"46026",1217,1043,1035,2,8,"PACMA",6
19,"19041",166,127,127,3,0,"PACMA",0
49,"49104",383,281,276,2,5,"PACMA",0
7,"7004",3669,2511,2453,51,58,"PACMA",17
10,"10176",384,300,293,5,7,"PACMA",1
3,"3073",219,199,199,0,0,"PACMA",0
37,"37051",90,72,72,0,0,"PACMA",0
18,"18181",253,183,182,0,1,"PACMA",0
42,"42012",43,29,29,1,0,"PACMA",0
32,"32045",2640,1999,1980,23,19,"PACMA",5
2,"2059",336,262,258,3,4,"PACMA",0
49,"49191",305,248,246,2,2,"PACMA",0
46,"46221",350,319,317,3,2,"PACMA",0
18,"18070",287,240,239,2,1,"PACMA",0
28,"28141",5568,4097,4051,31,46,"PACMA",20
9,"9105",111,85,81,2,4,"PACMA",1
12,"12110",253,199,195,3,4,"PACMA",1
45,"45063",504,378,372,3,6,"PACMA",1
46,"46003",988,864,847,13,17,"PACMA",0
5,"5231",172,142,141,0,1,"PACMA",0
22,"22025",1104,790,767,27,23,"PACMA",1
19,"19080",90,64,64,0,0,"PACMA",0
18,"18048",2277,1705,1688,19,17,"PACMA",3
21,"21038",1146,786,767,9,19,"PACMA",2
27,"27019",8247,6146,6022,101,124,"PACMA",41
34,"34139",179,143,143,1,0,"PACMA",0
24,"24106",340,229,228,6,1,"PACMA",0
2,"2024",3424,2765,2726,32,39,"PACMA",13
37,"37250",405,277,274,1,3,"PACMA",0
25,"25025",1307,874,859,32,15,"PACMA",2
9,"9151",509,389,383,5,6,"PACMA",1
34,"34222",122,94,94,2,0,"PACMA",0
45,"45015",624,485,480,2,5,"PACMA",2
26,"26129",1010,794,780,7,14,"PACMA",2
19,"19189",136,99,97,0,2,"PACMA",0
21,"21069",1778,1245,1242,11,3,"PACMA",3
50,"50184",132,106,106,1,0,"PACMA",0
10,"10057",166,133,133,0,0,"PACMA",0
1,"1003",1199,863,848,2,15,"PACMA",2
26,"26174",154,122,122,2,0,"PACMA",0
9,"9152",273,207,207,1,0,"PACMA",0
25,"25027",1042,691,665,11,26,"PACMA",1
49,"49063",371,291,290,3,1,"PACMA",0
34,"34186",61,53,53,0,0,"PACMA",0
24,"24151",514,391,387,6,4,"PACMA",0
42,"42163",53,41,41,0,0,"PACMA",0
37,"37365",172,152,149,2,3,"PACMA",1
9,"9137",177,134,134,6,0,"PACMA",0
6,"6160",3190,2343,2314,12,29,"PACMA",3
10,"10154",194,150,145,0,5,"PACMA",2
6,"6023",4572,3301,3261,34,40,"PACMA",5
47,"47228",481,385,383,3,2,"PACMA",0
37,"37056",56,47,47,0,0,"PACMA",0
34,"34143",181,142,140,3,2,"PACMA",0
37,"37253",137,115,115,1,0,"PACMA",0
46,"46151",717,596,589,3,7,"PACMA",0
42,"42164",1699,1244,1209,13,35,"PACMA",3
32,"32050",2663,1991,1974,17,17,"PACMA",1
37,"37178",107,88,87,0,1,"PACMA",0
19,"19086",1655,1310,1295,10,15,"PACMA",0
49,"49020",323,275,272,1,3,"PACMA",1
47,"47149",44,22,20,0,2,"PACMA",0
18,"18050",1657,1209,1196,5,13,"PACMA",1
44,"44262",141,114,113,2,1,"PACMA",0
19,"19192",1743,1370,1359,10,11,"PACMA",3
18,"18185",608,484,479,2,5,"PACMA",0
34,"34192",103,75,74,1,1,"PACMA",0
44,"44012",389,297,293,5,4,"PACMA",0
34,"34190",59,42,42,4,0,"PACMA",0
29,"29002",1246,896,893,11,3,"PACMA",0
9,"9382",33,30,30,0,0,"PACMA",0
46,"46055",1286,1083,1067,11,16,"PACMA",9
46,"46225",360,319,310,5,9,"PACMA",2
46,"46031",10580,7900,7809,87,91,"PACMA",30
49,"49248",224,183,180,4,3,"PACMA",0
49,"49201",330,280,278,9,2,"PACMA",0
24,"24073",521,385,382,4,3,"PACMA",0
37,"37331",234,161,161,3,0,"PACMA",0
6,"6087",2258,1855,1832,24,23,"PACMA",0
46,"46226",34,34,33,0,1,"PACMA",0
44,"44138",158,109,106,0,3,"PACMA",0
16,"16224",96,69,69,0,0,"PACMA",0
37,"37292",101,84,84,2,0,"PACMA",0
13,"13036",837,671,666,3,5,"PACMA",0
49,"49114",51,34,33,1,1,"PACMA",0
50,"50069",68,32,32,0,0,"PACMA",0
49,"49203",345,294,292,4,2,"PACMA",1
5,"5043",86,68,68,0,0,"PACMA",0
24,"24034",3434,2524,2481,37,43,"PACMA",3
44,"44014",2603,1965,1912,25,53,"PACMA",20
10,"10186",1031,906,896,8,10,"PACMA",1
34,"34063",102,92,91,2,1,"PACMA",0
9,"9032",118,68,68,0,0,"PACMA",0
46,"46227",923,787,771,4,16,"PACMA",5
6,"6089",607,530,529,2,1,"PACMA",0
44,"44142",39,28,28,1,0,"PACMA",0
37,"37061",254,187,185,0,2,"PACMA",0
34,"34066",66,55,54,0,1,"PACMA",1
39,"39053",251,179,179,1,0,"PACMA",0
6,"6044",28321,21143,20931,232,212,"PACMA",74
28,"28124",83,55,53,0,2,"PACMA",2
19,"19218",60,35,35,0,0,"PACMA",0
24,"24212",1105,856,846,14,10,"PACMA",0
34,"34135",429,334,329,6,5,"PACMA",0
42,"42172",31,28,28,3,0,"PACMA",0
9,"9143",24,14,14,1,0,"PACMA",0
15,"15073",21991,14686,14456,216,230,"PACMA",56
28,"28033",3581,2712,2691,14,21,"PACMA",15
25,"25153",215,165,161,0,4,"PACMA",2
18,"18056",3695,2961,2940,25,21,"PACMA",4
22,"22082",320,231,229,1,2,"PACMA",0
46,"46009",3140,2521,2498,15,23,"PACMA",9
26,"26012",17,15,15,1,0,"PACMA",0
3,"3083",5708,4267,4196,66,71,"PACMA",31
34,"34202",28,21,21,0,0,"PACMA",0
24,"24078",426,323,316,0,7,"PACMA",1
24,"24116",451,297,294,5,3,"PACMA",0
37,"37184",381,295,289,5,6,"PACMA",0
27,"27001",2582,1687,1669,31,18,"PACMA",3
25,"25061",75,45,45,0,0,"PACMA",0
24,"24159",1901,1492,1477,11,15,"PACMA",1
1,"1062",333,236,232,5,4,"PACMA",0
40,"40054",145,103,102,1,1,"PACMA",0
9,"9035",336,255,251,3,4,"PACMA",3
44,"44018",27,23,23,0,0,"PACMA",0
12,"12089",4277,3009,2946,32,63,"PACMA",14
50,"50015",109,73,73,0,0,"PACMA",0
10,"10190",569,438,435,6,3,"PACMA",1
27,"27002",1835,1455,1437,16,18,"PACMA",9
37,"37298",206,144,140,1,4,"PACMA",0
19,"19052",37,32,31,1,1,"PACMA",0
9,"9251",417,292,288,3,4,"PACMA",4
6,"6094",1508,1130,1119,6,11,"PACMA",2
37,"37185",602,452,448,8,4,"PACMA",1
37,"37209",376,258,253,4,5,"PACMA",0
24,"24039",2157,1738,1727,30,11,"PACMA",5
46,"46084",1587,1363,1332,7,31,"PACMA",2
49,"49029",675,553,542,6,11,"PACMA",1
18,"18193",13680,9874,9764,130,110,"PACMA",41
19,"19095",14,9,8,0,1,"PACMA",0
21,"21078",2865,2085,2066,21,19,"PACMA",5
50,"50277",82,63,63,0,0,"PACMA",0
42,"42073",84,53,53,0,0,"PACMA",0
25,"25007",1363,902,885,36,17,"PACMA",6
2,"2072",1598,1220,1198,5,22,"PACMA",7
22,"22226",823,640,627,11,13,"PACMA",0
16,"16052",596,469,464,2,5,"PACMA",1
49,"49030",96,78,77,2,1,"PACMA",0
50,"50017",1734,1232,1212,41,20,"PACMA",7
24,"24041",602,403,396,3,7,"PACMA",4
12,"12122",835,674,658,14,16,"PACMA",1
46,"46260",2576,2140,2106,24,34,"PACMA",9
37,"37287",341,247,246,1,1,"PACMA",0
29,"29028",1253,887,876,8,11,"PACMA",0
19,"19096",99,79,78,1,1,"PACMA",0
50,"50105",343,263,259,2,4,"PACMA",1
35,"35024",12420,6978,6819,131,159,"PACMA",32
26,"26017",380,277,276,3,1,"PACMA",2
47,"47099",174,153,153,4,0,"PACMA",1
2,"2074",6093,4630,4548,57,82,"PACMA",29
27,"27006",2789,1949,1911,22,38,"PACMA",10
3,"3022",160,133,131,1,2,"PACMA",1
15,"15021",5114,3527,3475,77,52,"PACMA",16
21,"21050",12322,8772,8679,99,93,"PACMA",18
24,"24042",79,68,68,0,0,"PACMA",0
12,"12123",70,50,48,2,2,"PACMA",0
34,"34159",375,275,264,8,11,"PACMA",0
10,"10072",892,663,655,3,8,"PACMA",0
40,"40059",124,104,104,2,0,"PACMA",0
2,"2075",1689,1386,1372,10,14,"PACMA",4
47,"47219",46,36,36,1,0,"PACMA",0
46,"46200",1915,1625,1595,15,30,"PACMA",1
40,"40201",48,48,48,2,0,"PACMA",0
50,"50279",111,79,79,1,0,"PACMA",0
49,"49168",96,78,78,1,0,"PACMA",0
29,"29011",3013,1893,1876,7,17,"PACMA",3
47,"47100",169,146,144,1,2,"PACMA",1
19,"19201",70,52,52,2,0,"PACMA",0
28,"28082",5144,3967,3905,46,62,"PACMA",21
49,"49034",467,363,359,3,4,"PACMA",0
24,"24005",437,308,305,3,3,"PACMA",0
10,"10033",440,340,336,4,4,"PACMA",0
26,"26019",365,296,295,6,1,"PACMA",4
42,"42182",62,53,53,2,0,"PACMA",1
19,"19303",56,48,47,1,1,"PACMA",0
10,"10075",276,189,189,1,0,"PACMA",0
48,"48040",1274,936,921,10,15,"PACMA",4
13,"13078",9291,7062,6993,92,69,"PACMA",20
25,"25100",207,125,115,2,10,"PACMA",0
9,"9128",82,65,63,0,2,"PACMA",0
37,"37072",184,157,155,5,2,"PACMA",0
40,"40157",74,51,50,2,1,"PACMA",0
28,"28152",14903,11954,11865,125,89,"PACMA",37
6,"6102",1045,851,840,7,11,"PACMA",1
16,"16189",263,213,211,2,2,"PACMA",0
19,"19171",4352,3299,3221,35,78,"PACMA",13
19,"19021",1129,818,800,10,18,"PACMA",2
5,"5182",862,673,668,2,5,"PACMA",1
36,"36058",5021,3589,3516,54,73,"PACMA",7
19,"19304",235,169,166,1,3,"PACMA",3
18,"18033",282,227,226,0,1,"PACMA",0
37,"37155",81,57,57,0,0,"PACMA",0
50,"50108",50,31,31,0,0,"PACMA",0
40,"40204",187,139,134,4,5,"PACMA",0
49,"49128",617,480,474,10,6,"PACMA",0
22,"22149",321,244,241,5,3,"PACMA",2
10,"10158",367,307,306,3,1,"PACMA",0
50,"50197",89,65,65,3,0,"PACMA",0
18,"18100",7304,5807,5737,62,70,"PACMA",9
18,"18003",13486,10245,10100,145,145,"PACMA",34
2,"2079",2936,2305,2235,29,70,"PACMA",6
40,"40205",292,221,220,2,1,"PACMA",0
25,"25041",625,432,420,20,12,"PACMA",2
6,"6104",701,588,584,12,4,"PACMA",3
7,"7056",4701,3164,3090,55,74,"PACMA",31
42,"42035",847,600,592,4,8,"PACMA",1
2,"2043",1335,1120,1108,10,12,"PACMA",1
12,"12127",92,64,61,0,3,"PACMA",0
26,"26064",2341,1770,1749,26,21,"PACMA",6
37,"37034",91,72,72,0,0,"PACMA",0
19,"19208",55,41,41,1,0,"PACMA",0
46,"46089",2116,1653,1627,9,26,"PACMA",7
18,"18004",818,601,594,2,7,"PACMA",0
34,"34229",75,60,60,2,0,"PACMA",0
50,"50246",48,33,33,1,0,"PACMA",0
29,"29024",414,271,261,6,10,"PACMA",0
42,"42219",45,33,33,1,0,"PACMA",0
6,"6152",1327,983,967,8,16,"PACMA",2
6,"6015",116077,82756,81836,989,920,"PACMA",431
18,"18102",8556,6358,6272,42,86,"PACMA",10
46,"46017",32928,24879,24672,267,207,"PACMA",121
50,"50283",73,55,55,1,0,"PACMA",0
5,"5056",94,78,73,1,5,"PACMA",0
49,"49174",131,97,97,1,0,"PACMA",0
10,"10080",385,294,287,0,7,"PACMA",0
33,"33076",12662,8733,8670,120,63,"PACMA",20
33,"33031",38090,25034,24730,380,304,"PACMA",83
9,"9177",1154,823,815,12,8,"PACMA",5
49,"49040",118,102,98,1,4,"PACMA",0
27,"27016",7521,5439,5338,83,101,"PACMA",26
37,"37079",77,64,63,1,1,"PACMA",0
37,"37196",93,74,70,1,4,"PACMA",0
10,"10203",4770,3397,3327,40,70,"PACMA",7
50,"50142",45,25,24,0,1,"PACMA",0
19,"19106",95,68,66,0,2,"PACMA",0
19,"19308",67,61,61,0,0,"PACMA",0
46,"46018",689,597,592,12,5,"PACMA",1
47,"47106",63,52,52,0,0,"PACMA",0
12,"12130",425,348,344,2,4,"PACMA",0
5,"5057",2593,2172,2152,16,20,"PACMA",4
13,"13051",358,291,289,5,2,"PACMA",0
24,"24053",503,338,332,3,6,"PACMA",1
1,"1033",679,537,532,2,5,"PACMA",4
10,"10083",105,74,74,0,0,"PACMA",1
12,"12033",1970,1547,1509,8,38,"PACMA",5
25,"25044",195,136,134,1,2,"PACMA",0
9,"9444",81,54,52,1,2,"PACMA",0
9,"9445",46,31,31,1,0,"PACMA",0
44,"44119",119,84,84,2,0,"PACMA",0
5,"5058",81,61,59,0,2,"PACMA",0
34,"34170",72,56,56,1,0,"PACMA",0
47,"47002",30,27,27,1,0,"PACMA",0
40,"40072",170,134,132,1,2,"PACMA",0
42,"42041",36,25,25,4,0,"PACMA",0
25,"25136",106,79,79,1,0,"PACMA",0
46,"46141",424,338,336,2,2,"PACMA",0
28,"28150",2985,2363,2345,21,18,"PACMA",2
22,"22209",161,115,115,4,0,"PACMA",0
50,"50173",175,104,104,2,0,"PACMA",2
28,"28112",168,138,137,0,1,"PACMA",0
44,"44034",150,117,117,1,0,"PACMA",1
46,"46117",476,377,373,6,4,"PACMA",0
45,"45199",2712,1817,1796,17,21,"PACMA",18
34,"34171",1071,762,753,16,9,"PACMA",2
3,"3065",164772,124457,123236,1556,1221,"PACMA",694
39,"39040",4350,3413,3373,30,40,"PACMA",9
44,"44160",473,315,312,8,3,"PACMA",0
40,"40213",99,75,74,1,1,"PACMA",0
2,"2086",2856,2019,2005,9,14,"PACMA",3
45,"45200",4633,3768,3672,37,96,"PACMA",8
42,"42043",3905,2931,2875,48,56,"PACMA",8
44,"44035",122,99,98,3,1,"PACMA",0
16,"16251",1903,1510,1493,18,17,"PACMA",2
38,"38039",10198,7548,7429,78,119,"PACMA",22
10,"10167",322,265,264,1,1,"PACMA",0
16,"16253",340,256,256,4,0,"PACMA",0
9,"9054",107,80,80,1,0,"PACMA",0
44,"44161",487,363,358,9,5,"PACMA",0
19,"19070",100,74,74,0,0,"PACMA",0
18,"18108",892,674,673,2,1,"PACMA",0
26,"26117",2152,1682,1655,20,27,"PACMA",5
7,"7052",4578,2671,2651,46,20,"PACMA",23
49,"49033",761,563,556,9,7,"PACMA",0
5,"5027",290,233,230,2,3,"PACMA",0
37,"37041",80,53,53,1,0,"PACMA",0
39,"39067",901,628,623,1,5,"PACMA",0
5,"5061",264,222,214,5,8,"PACMA",1
22,"22163",431,353,344,5,9,"PACMA",0
18,"18011",4246,3195,3172,23,23,"PACMA",2
9,"9448",225,188,186,1,2,"PACMA",1
50,"50204",2519,1823,1804,24,19,"PACMA",2
25,"25139",549,358,357,5,1,"PACMA",2
42,"42196",14,11,11,0,0,"PACMA",0
3,"3001",359,296,292,2,4,"PACMA",1
5,"5062",213,188,184,3,4,"PACMA",0
49,"49233",119,78,78,2,0,"PACMA",0
5,"5095",301,253,250,2,3,"PACMA",0
37,"37087",779,590,586,18,4,"PACMA",5
34,"34225",4837,3650,3580,73,70,"PACMA",20
10,"10007",680,537,519,5,18,"PACMA",0
7,"7032",19658,12168,11959,238,209,"PACMA",99
50,"50290",436,334,331,4,3,"PACMA",0
5,"5162",107,71,71,0,0,"PACMA",0
36,"36035",14551,10675,10469,160,206,"PACMA",48
47,"47193",1538,1229,1211,23,18,"PACMA",7
47,"47031",203,149,149,0,0,"PACMA",1
13,"13090",1202,994,972,4,22,"PACMA",0
1,"1042",915,678,661,1,17,"PACMA",3
34,"34089",173,128,125,5,3,"PACMA",1
42,"42198",24,17,17,0,0,"PACMA",0
22,"22165",515,409,403,9,6,"PACMA",4
18,"18145",10083,7592,7499,78,93,"PACMA",21
18,"18111",2647,1957,1941,24,16,"PACMA",4
42,"42007",143,110,110,2,0,"PACMA",0
50,"50119",997,740,720,13,20,"PACMA",2
50,"50263",235,160,160,1,0,"PACMA",0
16,"16116",104,67,66,1,1,"PACMA",0
9,"9058",357,278,276,4,2,"PACMA",0
10,"10091",391,327,324,3,3,"PACMA",1
42,"42096",316,218,215,9,3,"PACMA",0
25,"25205",563,373,362,12,11,"PACMA",3
22,"22218",49,33,33,1,0,"PACMA",0
42,"42008",69,50,50,0,0,"PACMA",0
37,"37009",225,189,185,2,4,"PACMA",0
16,"16117",1130,871,857,8,14,"PACMA",0
34,"34091",136,105,103,1,2,"PACMA",1
6,"6074",4777,3730,3659,41,71,"PACMA",25
34,"34228",93,80,80,0,0,"PACMA",0
39,"39070",152,118,118,0,0,"PACMA",0
16,"16263",936,730,719,8,11,"PACMA",1
44,"44041",67,56,51,1,5,"PACMA",1
47,"47033",209,170,168,3,2,"PACMA",0
7,"7902",1071,734,712,22,22,"PACMA",2
9,"9232",182,146,146,1,0,"PACMA",0
24,"24129",125,88,86,5,2,"PACMA",1
37,"37270",201,159,158,0,1,"PACMA",0
50,"50189",776,588,576,9,12,"PACMA",0
13,"13060",291,235,229,0,6,"PACMA",1
1,"1046",629,428,421,5,7,"PACMA",5
50,"50293",492,339,338,6,1,"PACMA",0
40,"40082",131,111,110,5,1,"PACMA",0
19,"19076",36,29,29,0,0,"PACMA",0
19,"19002",99,77,76,0,1,"PACMA",0
18,"18148",874,714,706,6,8,"PACMA",2
34,"34230",12,8,8,0,0,"PACMA",0
46,"46220",48981,34657,34242,450,415,"PACMA",158
50,"50121",297,250,245,6,5,"PACMA",0
25,"25239",627,310,310,7,0,"PACMA",3
34,"34093",101,74,74,1,0,"PACMA",0
19,"19322",35,28,27,1,1,"PACMA",0
37,"37171",437,362,358,4,4,"PACMA",0
45,"45098",2273,1799,1756,11,43,"PACMA",1
28,"28117",116,90,90,1,0,"PACMA",0
9,"9456",142,110,110,3,0,"PACMA",0
49,"49014",134,104,102,1,2,"PACMA",0
12,"12109",700,564,555,7,9,"PACMA",4
28,"28093",1911,1537,1518,19,19,"PACMA",3
9,"9194",2033,1557,1535,28,22,"PACMA",5
24,"24184",206,111,111,0,0,"PACMA",0
15,"15009",11109,8179,8014,129,165,"PACMA",33
44,"44044",103,79,78,0,1,"PACMA",1
19,"19116",16,10,10,0,0,"PACMA",0
49,"49190",81,65,64,2,1,"PACMA",0
49,"49058",341,262,259,4,3,"PACMA",0
50,"50034",923,634,617,10,17,"PACMA",1
38,"38014",1446,1018,1007,8,11,"PACMA",0
30,"30024",57868,41894,41513,393,381,"PACMA",85
19,"19221",56,41,41,2,0,"PACMA",0
7,"7005",6331,4128,4058,76,70,"PACMA",35
50,"50007",61,45,45,0,0,"PACMA",1
24,"24066",561,440,437,5,3,"PACMA",0
13,"13096",7716,5759,5659,70,100,"PACMA",8
9,"9195",64,40,40,1,0,"PACMA",0
9,"9460",187,144,142,2,2,"PACMA",0
15,"15066",4180,3098,3062,38,36,"PACMA",5
36,"36042",17897,12635,12437,157,198,"PACMA",54
49,"49016",272,216,211,1,5,"PACMA",0
5,"5037",296,213,212,0,1,"PACMA",0
34,"34098",756,544,540,10,4,"PACMA",3
45,"45026",269,200,198,2,2,"PACMA",0
28,"28095",1358,1092,1077,8,15,"PACMA",6
25,"25243",3408,2280,2252,49,28,"PACMA",9
34,"34185",72,48,45,0,3,"PACMA",1
12,"12046",236,177,176,4,1,"PACMA",0
47,"47198",71,56,56,2,0,"PACMA",0
50,"50093",113,84,84,2,0,"PACMA",0
5,"5232",106,84,80,1,4,"PACMA",0
37,"37138",212,174,169,5,5,"PACMA",1
24,"24068",500,357,349,3,8,"PACMA",0
42,"42209",155,114,110,2,4,"PACMA",0
29,"29056",1177,807,794,3,13,"PACMA",1
5,"5266",112,92,89,0,3,"PACMA",0
45,"45028",3696,3059,3024,40,35,"PACMA",8
34,"34234",72,56,55,1,1,"PACMA",0
45,"45138",1185,998,973,5,25,"PACMA",2
16,"16002",195,175,172,0,3,"PACMA",0
49,"49018",341,281,279,5,2,"PACMA",0
27,"27038",1035,817,809,9,8,"PACMA",2
16,"16272",273,215,215,2,0,"PACMA",0
28,"28096",16844,12441,12308,117,133,"PACMA",48
28,"28050",3576,2706,2663,21,43,"PACMA",16
5,"5073",319,258,254,7,4,"PACMA",0
3,"3033",127,102,97,2,5,"PACMA",2
5,"5160",339,290,286,2,4,"PACMA",0
5,"5040",77,59,59,1,0,"PACMA",0
48,"48028",767,623,621,1,2,"PACMA",0
40,"40092",132,100,100,0,0,"PACMA",0
36,"36044",2595,1862,1834,23,28,"PACMA",12
13,"13901",945,734,719,6,15,"PACMA",3
37,"37329",40,36,36,2,0,"PACMA",0
39,"39076",3388,2673,2641,22,32,"PACMA",11
49,"49064",566,372,368,8,4,"PACMA",2
22,"22178",107,92,92,1,0,"PACMA",0
19,"19007",460,351,345,5,6,"PACMA",0
32,"32087",1935,1609,1591,11,18,"PACMA",3
42,"42018",178,129,124,0,5,"PACMA",0
37,"37290",143,111,110,1,1,"PACMA",0
13,"13001",1372,1087,1067,8,20,"PACMA",1
34,"34237",645,506,498,6,8,"PACMA",0
18,"18022",12448,8777,8659,111,118,"PACMA",30
9,"9200",54,35,35,2,0,"PACMA",0
27,"27041",2644,1946,1915,29,31,"PACMA",6
6,"6132",876,656,648,2,8,"PACMA",0
40,"40047",47,37,36,0,1,"PACMA",0
9,"9289",1540,1127,1117,16,10,"PACMA",1
39,"39051",73,62,62,2,0,"PACMA",0
24,"24191",112,88,88,1,0,"PACMA",0
19,"19193",30,29,29,1,0,"PACMA",0
22,"22078",468,302,301,8,1,"PACMA",6
30,"30029",11533,8854,8768,73,86,"PACMA",23
32,"32088",1749,1232,1217,10,15,"PACMA",0
44,"44051",2783,2144,2089,38,55,"PACMA",8
46,"46177",4594,3576,3523,29,53,"PACMA",16
9,"9201",33,22,22,2,0,"PACMA",0
29,"29059",2551,1986,1964,11,22,"PACMA",2
5,"5903",171,118,118,0,0,"PACMA",0
42,"42167",305,223,222,3,1,"PACMA",0
12,"12016",1589,1309,1293,15,16,"PACMA",1
9,"9427",1561,1090,1078,18,12,"PACMA",4
28,"28123",48429,38681,38187,429,494,"PACMA",188
13,"13003",503,390,387,2,3,"PACMA",2
44,"44181",82,63,63,3,0,"PACMA",1
29,"29060",775,573,572,1,1,"PACMA",1
21,"21013",10601,7384,7231,110,153,"PACMA",35
45,"45143",1302,916,901,6,15,"PACMA",4
28,"28168",1144,821,810,15,11,"PACMA",4
19,"19227",95,64,63,1,1,"PACMA",0
47,"47041",166,135,133,2,2,"PACMA",1
22,"22037",115,87,79,0,8,"PACMA",0
19,"19228",39,30,29,0,1,"PACMA",0
40,"40904",332,271,268,5,3,"PACMA",0
49,"49204",85,64,64,0,0,"PACMA",0
24,"24157",2580,2046,2000,39,46,"PACMA",9
6,"6045",513,418,412,8,6,"PACMA",1
26,"26123",129,113,113,1,0,"PACMA",0
39,"39097",732,476,470,4,6,"PACMA",0
19,"19321",46,29,29,0,0,"PACMA",0
35,"35021",14982,9948,9749,138,199,"PACMA",45
5,"5110",710,584,581,1,3,"PACMA",0
50,"50217",496,380,379,0,1,"PACMA",0
26,"26094",97,86,85,0,1,"PACMA",0
38,"38023",118865,76393,75039,928,1354,"PACMA",632
44,"44267",79,63,61,2,2,"PACMA",0
6,"6091",3854,2961,2906,33,55,"PACMA",5
25,"25250",358,237,234,4,3,"PACMA",1
37,"37108",108,95,95,1,0,"PACMA",0
18,"18124",387,270,267,0,3,"PACMA",0
36,"36050",7602,5424,5339,50,85,"PACMA",24
18,"18025",326,242,238,0,4,"PACMA",0
21,"21076",2108,1647,1628,22,19,"PACMA",3
40,"40100",303,241,231,5,10,"PACMA",0
19,"19126",1552,1140,1119,16,21,"PACMA",9
10,"10026",598,458,447,5,11,"PACMA",4
46,"46034",1791,1477,1468,8,9,"PACMA",8
37,"37024",101,80,80,0,0,"PACMA",0
13,"13006",641,529,519,4,10,"PACMA",0
44,"44056",577,436,434,7,2,"PACMA",0
49,"49076",333,260,257,10,3,"PACMA",2
37,"37297",441,376,369,1,7,"PACMA",1
46,"46180",715,585,581,4,4,"PACMA",3
34,"34245",322,240,236,3,4,"PACMA",0
18,"18126",1461,1129,1121,15,8,"PACMA",4
34,"34109",62,47,46,0,1,"PACMA",0
33,"33069",3611,2615,2597,25,18,"PACMA",4
5,"5046",44,39,38,1,1,"PACMA",0
19,"19127",97,66,66,1,0,"PACMA",0
3,"3120",2329,1810,1785,16,25,"PACMA",5
50,"50191",505,395,390,4,5,"PACMA",0
49,"49208",428,266,261,1,5,"PACMA",1
6,"6140",654,533,523,7,10,"PACMA",1
37,"37110",112,89,88,1,1,"PACMA",0
26,"26099",1281,1050,1025,19,25,"PACMA",1
12,"12057",650,530,515,6,15,"PACMA",2
44,"44059",571,446,434,10,12,"PACMA",0
50,"50133",126,101,100,1,1,"PACMA",0
50,"50016",51,30,30,1,0,"PACMA",0
5,"5047",4267,3345,3275,34,70,"PACMA",7
9,"9482",33,31,30,1,1,"PACMA",0
13,"13008",473,362,360,4,2,"PACMA",1
27,"27004",1379,981,966,4,15,"PACMA",3
5,"5081",44,36,36,0,0,"PACMA",0
9,"9076",24,15,15,0,0,"PACMA",0
25,"25252",536,361,352,13,9,"PACMA",2
24,"24081",143,111,110,1,1,"PACMA",0
1,"1902",776,532,526,6,6,"PACMA",3
21,"21079",749,556,553,6,3,"PACMA",1
25,"25129",175,105,105,3,0,"PACMA",0
49,"49122",701,542,534,7,8,"PACMA",4
16,"16185",63,45,44,0,1,"PACMA",0
1,"1019",155,124,124,0,0,"PACMA",0
40,"40199",110,88,86,3,2,"PACMA",1
19,"19233",108,93,90,2,3,"PACMA",2
28,"28172",7648,6130,6076,65,54,"PACMA",27
50,"50135",100,76,75,2,1,"PACMA",0
12,"12059",276,227,227,1,0,"PACMA",0
10,"10071",179,133,133,1,0,"PACMA",0
1,"1020",317,222,220,0,2,"PACMA",0
6,"6007",1557,1200,1189,4,11,"PACMA",0
21,"21019",645,464,458,2,6,"PACMA",2
13,"13076",514,436,428,0,8,"PACMA",0
18,"18132",3461,2797,2772,19,25,"PACMA",4
37,"37228",388,339,336,2,3,"PACMA",0
26,"26102",6158,4794,4716,60,78,"PACMA",21
40,"40045",123,102,102,0,0,"PACMA",2
25,"25254",782,533,531,9,2,"PACMA",2
34,"34903",240,161,160,2,1,"PACMA",0
22,"22047",228,200,200,5,0,"PACMA",1
30,"30036",13978,10244,10141,94,103,"PACMA",33
24,"24165",400,284,279,4,5,"PACMA",0
47,"47129",954,744,731,4,13,"PACMA",0
44,"44063",82,55,55,2,0,"PACMA",0
37,"37229",144,108,108,0,0,"PACMA",0
10,"10115",3622,2872,2800,52,72,"PACMA",14
24,"24084",182,133,132,1,1,"PACMA",0
25,"25039",299,189,186,7,3,"PACMA",0
49,"49219",7742,5643,5562,87,81,"PACMA",13
19,"19235",121,92,87,0,5,"PACMA",0
24,"24086",323,245,243,1,2,"PACMA",0
49,"49083",67,48,48,1,0,"PACMA",0
19,"19134",22,14,14,0,0,"PACMA",0
15,"15079",1709,1268,1253,14,15,"PACMA",2
2,"2077",51,46,45,0,1,"PACMA",0
18,"18032",248,166,166,2,0,"PACMA",0
49,"49220",161,122,118,5,4,"PACMA",0
28,"28107",443,338,333,7,5,"PACMA",1
3,"3127",399,336,322,3,14,"PACMA",2
50,"50050",109,73,73,1,0,"PACMA",0
25,"25068",576,376,364,6,12,"PACMA",3
16,"16908",227,181,179,1,2,"PACMA",0
27,"27010",4725,3427,3368,55,59,"PACMA",21
13,"13013",7141,5682,5564,60,118,"PACMA",6
6,"6148",991,826,818,9,8,"PACMA",4
9,"9308",70,51,51,0,0,"PACMA",1
40,"40062",54,44,44,0,0,"PACMA",0
30,"30038",15057,11640,11555,82,85,"PACMA",45
49,"49222",404,297,294,4,3,"PACMA",0
42,"42184",76,50,49,0,1,"PACMA",0
19,"19022",673,501,496,4,5,"PACMA",1
22,"22007",863,636,621,8,15,"PACMA",2
6,"6012",3263,2498,2476,31,22,"PACMA",9
34,"34121",208,153,152,0,1,"PACMA",0
6,"6013",283,245,244,1,1,"PACMA",2
13,"13014",565,457,452,3,5,"PACMA",1
37,"37119",115,98,98,0,0,"PACMA",0
2,"2006",612,540,534,1,6,"PACMA",0
49,"49086",127,108,107,1,1,"PACMA",0
25,"25902",581,411,395,15,16,"PACMA",2
39,"39009",3200,2427,2402,24,25,"PACMA",9
22,"22150",491,342,336,9,6,"PACMA",0
12,"12064",118,91,89,1,2,"PACMA",0
35,"35003",4764,2733,2680,34,53,"PACMA",5
3,"3129",1188,936,918,10,18,"PACMA",4
30,"30039",18615,14213,14068,134,145,"PACMA",36
37,"37120",107,88,87,0,1,"PACMA",0
19,"19023",121,95,94,5,1,"PACMA",0
27,"27060",2938,2063,2028,26,35,"PACMA",8
5,"5905",253,200,198,1,2,"PACMA",0
39,"39088",70,61,61,1,0,"PACMA",0
18,"18036",3553,2762,2741,20,21,"PACMA",10
9,"9221",446,343,340,7,3,"PACMA",5
5,"5055",649,525,518,3,7,"PACMA",0
50,"50902",97,85,85,1,0,"PACMA",0
19,"19024",7736,5738,5646,82,92,"PACMA",35
26,"26109",105,87,84,0,3,"PACMA",0
34,"34123",1798,1479,1436,18,43,"PACMA",4
46,"46187",1339,1096,1083,13,13,"PACMA",4
33,"33008",1934,1474,1459,11,15,"PACMA",0
36,"36061",8729,6747,6640,68,107,"PACMA",26
6,"6107",1610,1131,1128,6,3,"PACMA",0
9,"9086",629,467,461,5,6,"PACMA",2
49,"49090",207,168,168,4,0,"PACMA",2
19,"19138",298,223,219,3,4,"PACMA",0
25,"25166",177,127,125,3,2,"PACMA",0
6,"6016",3013,2363,2306,31,57,"PACMA",3
1,"1032",536,412,400,0,12,"PACMA",0
16,"16023",468,332,327,3,5,"PACMA",1
36,"36901",4085,3285,3235,21,50,"PACMA",16
2,"2009",19661,14804,14570,259,234,"PACMA",53
27,"27063",1916,1469,1440,14,29,"PACMA",4
6,"6017",292,250,250,0,0,"PACMA",0
49,"49091",278,197,197,4,0,"PACMA",1
34,"34125",99,77,75,1,2,"PACMA",0
12,"12068",57,45,44,0,1,"PACMA",0
19,"19139",32,23,23,0,0,"PACMA",0
37,"37123",206,166,165,1,1,"PACMA",0
33,"33009",951,673,663,7,10,"PACMA",3
3,"3030",522,464,453,6,11,"PACMA",1
10,"10123",601,502,492,0,10,"PACMA",0
24,"24093",388,262,258,1,4,"PACMA",1
12,"12131",92,78,78,1,0,"PACMA",0
21,"21027",67,52,52,0,0,"PACMA",0
42,"42191",187,143,141,5,2,"PACMA",0
18,"18007",808,602,591,5,11,"PACMA",0
37,"37349",136,105,104,2,1,"PACMA",0
3,"3031",39966,27099,26802,291,297,"PACMA",125
24,"24094",1466,1023,1006,24,17,"PACMA",0
13,"13019",5254,4038,3978,62,60,"PACMA",4
49,"49271",221,178,176,2,2,"PACMA",1
22,"22158",11978,8404,8279,149,125,"PACMA",32
28,"28157",605,452,446,2,6,"PACMA",0
38,"38038",161890,99555,97980,1101,1575,"PACMA",839
5,"5188",55,47,47,0,0,"PACMA",0
1,"1036",15236,10511,10372,141,139,"PACMA",63
37,"37313",581,440,435,7,5,"PACMA",0
9,"9316",108,87,84,0,3,"PACMA",0
5,"5092",172,142,139,0,3,"PACMA",0
24,"24175",1760,1324,1303,29,21,"PACMA",7
15,"15030",201751,141022,138934,2981,2088,"PACMA",727
49,"49094",276,180,180,2,0,"PACMA",0
6,"6021",971,761,747,6,14,"PACMA",1
33,"33010",1922,1284,1277,14,7,"PACMA",2
22,"22058",194,138,137,5,1,"PACMA",2
28,"28179",1385,1039,1027,10,12,"PACMA",6
19,"19033",79,55,55,0,0,"PACMA",0
25,"25074",178,137,132,3,5,"PACMA",1
28,"28113",31318,23779,23436,271,343,"PACMA",138
19,"19179",109,77,75,3,2,"PACMA",0
26,"26115",20,20,20,4,0,"PACMA",0
35,"35008",6151,4514,4419,59,95,"PACMA",12
10,"10086",342,259,250,5,9,"PACMA",1
44,"44243",38,27,26,3,1,"PACMA",0
12,"12133",64,47,47,0,0,"PACMA",0
39,"39006",1732,1381,1373,23,8,"PACMA",3
25,"25908",250,169,168,4,1,"PACMA",1
22,"22016",654,476,464,10,12,"PACMA",1
47,"47030",1075,822,801,13,21,"PACMA",1
21,"21030",1757,1448,1426,14,22,"PACMA",1
40,"40125",99,72,71,3,1,"PACMA",0
49,"49096",188,149,146,2,3,"PACMA",0
16,"16155",549,430,426,2,4,"PACMA",1
12,"12072",1191,1007,977,17,30,"PACMA",4
32,"32001",4938,3715,3667,50,48,"PACMA",13
19,"19147",58,45,40,0,5,"PACMA",0
35,"35009",19678,13799,13442,155,357,"PACMA",53
34,"34130",228,187,186,6,1,"PACMA",0
39,"39094",927,702,691,0,11,"PACMA",1
9,"9183",58,47,46,1,1,"PACMA",0
24,"24178",83,67,67,2,0,"PACMA",0
3,"3137",719,536,530,3,6,"PACMA",3
30,"30902",7463,5291,5228,38,63,"PACMA",27
6,"6116",1680,1331,1317,15,14,"PACMA",4
10,"10089",1399,1043,1032,15,11,"PACMA",2
9,"9095",88,75,73,2,2,"PACMA",0
32,"32002",2060,1566,1551,13,15,"PACMA",1
19,"19037",153,128,128,0,0,"PACMA",1
3,"3138",3218,2403,2388,22,15,"PACMA",8
45,"45166",1734,1460,1429,8,31,"PACMA",1
9,"9368",26,18,18,0,0,"PACMA",0
26,"26119",223,186,185,2,1,"PACMA",0
10,"10008",1393,1105,1086,10,19,"PACMA",7
37,"37129",247,198,198,4,0,"PACMA",0
3,"3036",84,72,72,0,0,"PACMA",3
25,"25233",270,207,201,3,6,"PACMA",0
49,"49099",127,96,96,1,0,"PACMA",0
45,"45057",222,197,189,0,8,"PACMA",0
16,"16157",229,187,182,2,5,"PACMA",0
37,"37319",138,94,94,1,0,"PACMA",1
34,"34133",108,90,90,0,0,"PACMA",0
9,"9100",56,46,44,0,2,"PACMA",0
18,"18146",1059,791,776,2,15,"PACMA",3
49,"49100",322,236,233,1,3,"PACMA",0
19,"19248",64,53,53,0,0,"PACMA",0
22,"22113",512,357,353,8,4,"PACMA",1
19,"19217",85,57,54,2,3,"PACMA",0
46,"46024",448,365,358,1,7,"PACMA",1
50,"50235",2371,1723,1701,36,22,"PACMA",11
9,"9369",460,339,336,4,3,"PACMA",0
26,"26077",15,15,15,1,0,"PACMA",0
46,"46049",292,249,245,0,4,"PACMA",0
10,"10010",2358,1597,1576,18,21,"PACMA",5
19,"19039",73,57,57,0,0,"PACMA",0
22,"22064",184,139,137,3,2,"PACMA",0
16,"16159",299,204,202,5,2,"PACMA",0
37,"37010",963,705,690,5,15,"PACMA",2
44,"44087",98,87,87,2,0,"PACMA",0
12,"12076",105,79,79,0,0,"PACMA",1
5,"5184",288,225,224,0,1,"PACMA",0
45,"45059",1758,1465,1437,10,28,"PACMA",0
48,"48055",2620,1954,1934,22,20,"PACMA",5
38,"38011",19299,12565,12313,152,252,"PACMA",79
50,"50151",713,536,531,5,5,"PACMA",0
45,"45170",257,186,183,0,3,"PACMA",1
40,"40222",190,157,156,1,1,"PACMA",0
5,"5100",307,245,245,2,0,"PACMA",0
3,"3006",479,380,369,2,11,"PACMA",4
2,"2021",1114,872,860,7,12,"PACMA",1
13,"13093",4333,3281,3229,43,52,"PACMA",4
16,"16035",287,216,213,2,3,"PACMA",0
35,"35013",6779,5059,4961,105,98,"PACMA",11
7,"7003",10671,6262,6149,79,113,"PACMA",73
10,"10012",615,525,520,4,5,"PACMA",2
37,"37011",131,87,86,2,1,"PACMA",0
33,"33016",19516,14345,14210,198,135,"PACMA",49
21,"21066",522,440,431,4,9,"PACMA",0
37,"37134",250,192,189,1,3,"PACMA",0
46,"46245",478,357,354,1,3,"PACMA",1
42,"42054",20,14,14,0,0,"PACMA",0
28,"28901",765,579,567,2,12,"PACMA",4
49,"49240",237,190,186,1,4,"PACMA",1
42,"42105",54,45,45,0,0,"PACMA",0
9,"9104",56,49,49,0,0,"PACMA",0
39,"39020",23947,15404,15122,267,282,"PACMA",152
11,"11025",4371,3260,3226,34,34,"PACMA",5
48,"48090",6153,4682,4571,40,111,"PACMA",21
15,"15037",4181,2839,2804,25,35,"PACMA",5
21,"21037",491,386,378,1,8,"PACMA",0
42,"42206",10,9,9,1,0,"PACMA",0
19,"19154",79,68,67,0,1,"PACMA",0
28,"28006",74554,57439,56890,586,549,"PACMA",204
39,"39073",9275,6984,6903,83,81,"PACMA",13
9,"9238",1026,612,601,6,11,"PACMA",3
24,"24105",1460,1095,1075,27,20,"PACMA",17
42,"42106",15,14,14,0,0,"PACMA",0
39,"39021",536,448,444,1,4,"PACMA",1
44,"44092",89,68,68,0,0,"PACMA",0
15,"15010",2009,1468,1441,24,27,"PACMA",3
50,"50153",1002,757,748,12,9,"PACMA",2
50,"50210",39,28,24,0,4,"PACMA",0
15,"15901",3855,2463,2419,48,44,"PACMA",6
29,"29072",3258,2484,2447,30,37,"PACMA",2
45,"45173",9133,7147,7035,78,112,"PACMA",22
22,"22072",209,130,128,2,2,"PACMA",1
39,"39022",985,735,734,5,1,"PACMA",3
13,"13097",2309,1843,1825,20,18,"PACMA",1
26,"26128",116,94,93,0,1,"PACMA",0
47,"47226",180,152,148,1,4,"PACMA",0
25,"25055",187,115,115,3,0,"PACMA",0
9,"9241",198,159,158,5,1,"PACMA",4
16,"16084",49,36,35,0,1,"PACMA",0
25,"25086",569,379,370,4,9,"PACMA",0
40,"40138",2195,1758,1725,18,33,"PACMA",2
34,"34140",113,84,84,2,0,"PACMA",1
37,"37015",248,169,168,0,1,"PACMA",0
46,"46150",1898,1555,1541,8,14,"PACMA",11
47,"47227",62,52,52,1,0,"PACMA",0
45,"45175",698,587,579,5,8,"PACMA",1
2,"2026",845,723,716,5,7,"PACMA",1
40,"40231",128,102,100,3,2,"PACMA",0
28,"28007",122891,95200,94139,990,1061,"PACMA",344
9,"9242",93,82,82,2,0,"PACMA",0
32,"32012",912,763,756,8,7,"PACMA",2
5,"5200",56,43,42,0,1,"PACMA",0
26,"26130",229,181,177,0,4,"PACMA",0
37,"37240",781,552,540,10,12,"PACMA",1
6,"6084",1105,932,917,5,15,"PACMA",5
19,"19157",66,56,56,4,0,"PACMA",0
6,"6130",216,182,180,0,2,"PACMA",2
12,"12082",9741,7555,7408,84,147,"PACMA",25
45,"45067",2385,1923,1878,19,45,"PACMA",4
49,"49245",296,218,218,2,0,"PACMA",1
5,"5001",210,180,176,2,4,"PACMA",0
15,"15041",9718,7514,7425,102,89,"PACMA",17
10,"10142",822,635,625,4,10,"PACMA",2
50,"50242",102,82,82,2,0,"PACMA",0
44,"44218",37,26,26,2,0,"PACMA",0
46,"46127",2790,2298,2267,23,31,"PACMA",6
39,"39024",2065,1616,1601,8,15,"PACMA",4
1,"1056",256,183,181,1,2,"PACMA",0
13,"13034",56981,42819,42306,742,513,"PACMA",176
37,"37018",128,89,87,0,2,"PACMA",0
34,"34022",1136,926,908,5,18,"PACMA",0
19,"19159",108,91,88,1,3,"PACMA",0
10,"10143",169,135,131,1,4,"PACMA",0
50,"50157",313,253,250,7,3,"PACMA",2
25,"25088",100,74,74,0,0,"PACMA",0
29,"29075",12666,8284,8218,62,66,"PACMA",17
13,"13002",1576,1143,1134,4,9,"PACMA",1
2,"2028",139,115,115,1,0,"PACMA",0
3,"3013",1144,941,926,5,15,"PACMA",3
35,"35019",30279,17607,17380,158,227,"PACMA",58
33,"33066",42885,29326,29013,460,313,"PACMA",114
5,"5042",156,126,126,0,0,"PACMA",0
7,"7010",4668,3229,3174,58,55,"PACMA",37
46,"46056",203,164,160,2,4,"PACMA",0
9,"9113",503,397,390,7,7,"PACMA",0
26,"26008",1909,1544,1527,19,17,"PACMA",5
28,"28122",504,367,366,2,1,"PACMA",1
50,"50244",215,155,155,6,0,"PACMA",0
15,"15043",5491,4033,3971,45,62,"PACMA",8
47,"47150",338,273,271,2,2,"PACMA",0
16,"16046",262,191,191,1,0,"PACMA",0
3,"3081",1409,1102,1087,14,15,"PACMA",3
26,"26135",181,139,137,1,2,"PACMA",0
45,"45181",2276,1788,1764,10,24,"PACMA",2
7,"7012",1880,1437,1405,20,32,"PACMA",4
32,"32017",1333,906,895,10,11,"PACMA",2
26,"26136",111,90,90,3,0,"PACMA",0
40,"40144",19,17,17,1,0,"PACMA",0
5,"5007",126,104,102,0,2,"PACMA",0
47,"47231",4272,3268,3243,64,25,"PACMA",17
35,"35020",6142,4227,4192,24,35,"PACMA",13
39,"39027",3213,2506,2473,21,33,"PACMA",6
3,"3049",12150,10039,9892,88,147,"PACMA",34
44,"44102",30,29,28,0,1,"PACMA",0
42,"42118",26,20,20,0,0,"PACMA",1
10,"10024",663,490,480,3,10,"PACMA",0
40,"40005",34,32,31,1,1,"PACMA",1
29,"29052",245,151,151,0,0,"PACMA",0
47,"47151",32,29,29,0,0,"PACMA",0
50,"50160",2397,1905,1865,19,40,"PACMA",4
50,"50274",78,45,45,1,0,"PACMA",0
45,"45183",2189,1537,1514,10,23,"PACMA",10
5,"5207",743,595,591,1,4,"PACMA",1
16,"16133",4466,3522,3453,51,69,"PACMA",7
11,"11004",87610,53062,52639,828,423,"PACMA",254
46,"46106",1616,1196,1188,6,8,"PACMA",2
11,"11033",19983,12960,12807,199,153,"PACMA",47
25,"25093",657,465,455,8,10,"PACMA",0
32,"32019",11469,8297,8180,134,117,"PACMA",32
40,"40148",259,213,212,3,1,"PACMA",0
9,"9297",326,270,266,7,4,"PACMA",0
47,"47043",330,267,264,1,3,"PACMA",0
25,"25094",154,110,107,1,3,"PACMA",2
45,"45073",351,265,261,3,4,"PACMA",0
7,"7048",15296,8559,8439,176,120,"PACMA",64
44,"44105",82,63,63,2,0,"PACMA",0
46,"46156",2065,1746,1721,14,25,"PACMA",5
32,"32020",2958,2300,2283,19,17,"PACMA",2
5,"5112",125,88,87,0,1,"PACMA",0
49,"49255",455,372,367,1,5,"PACMA",1
40,"40101",770,584,577,16,7,"PACMA",1
10,"10149",434,323,319,1,4,"PACMA",1
37,"37147",201,153,151,1,2,"PACMA",0
21,"21047",1965,1355,1325,17,30,"PACMA",1
50,"50162",160,108,108,2,0,"PACMA",0
24,"24117",493,376,369,2,7,"PACMA",0
39,"39081",440,372,369,3,3,"PACMA",0
22,"22084",524,362,354,11,8,"PACMA",1
32,"32021",1043,793,788,7,5,"PACMA",0
39,"39029",642,521,517,6,4,"PACMA",0
37,"37261",255,191,191,2,0,"PACMA",0
5,"5113",90,74,74,0,0,"PACMA",0
7,"7016",2726,1848,1809,34,39,"PACMA",10
46,"46205",14277,10882,10764,115,118,"PACMA",46
29,"29082",29311,20220,20051,223,169,"PACMA",84
40,"40009",49,41,41,0,0,"PACMA",0
46,"46259",537,426,424,9,2,"PACMA",1
16,"16901",793,590,582,2,8,"PACMA",2
18,"18028",992,826,821,4,5,"PACMA",0
44,"44107",233,161,154,3,7,"PACMA",0
46,"46133",686,572,565,1,7,"PACMA",0
46,"46060",9510,7506,7408,52,98,"PACMA",34
19,"19053",2172,1602,1587,14,15,"PACMA",6
48,"48003",14142,10268,10167,84,101,"PACMA",51
22,"22243",45,27,27,1,0,"PACMA",0
40,"40010",140,117,117,0,0,"PACMA",0
5,"5115",590,458,450,1,8,"PACMA",0
19,"19199",24,21,21,0,0,"PACMA",0
49,"49210",493,358,356,6,2,"PACMA",0
22,"22045",104,83,80,2,3,"PACMA",1
34,"34208",62,52,52,2,0,"PACMA",0
9,"9214",724,477,467,4,10,"PACMA",1
10,"10112",1582,1299,1284,5,15,"PACMA",3
48,"48004",329,240,239,2,1,"PACMA",1
48,"48906",796,625,622,5,3,"PACMA",1
22,"22244",61,46,44,1,2,"PACMA",0
13,"13043",251,208,206,1,2,"PACMA",0
2,"2001",731,601,584,6,17,"PACMA",0
13,"13010",910,729,726,8,3,"PACMA",1
49,"49260",814,653,644,6,9,"PACMA",2
45,"45188",2883,2180,2151,30,29,"PACMA",8
16,"16055",698,485,481,8,4,"PACMA",0
26,"26145",251,201,199,3,2,"PACMA",2
46,"46261",1706,1388,1366,13,22,"PACMA",2
48,"48908",242,194,194,1,0,"PACMA",1
9,"9256",369,254,252,2,2,"PACMA",2
6,"6053",642,466,454,4,12,"PACMA",0
9,"9395",164,134,133,1,1,"PACMA",1
26,"26018",10396,8186,8041,161,145,"PACMA",35
33,"33027",929,617,613,5,4,"PACMA",3
6,"6008",636,561,552,6,9,"PACMA",1
5,"5016",6231,4831,4763,56,68,"PACMA",13
16,"16056",495,377,374,11,3,"PACMA",2
7,"7020",3455,2491,2453,46,38,"PACMA",21
2,"2039",1050,862,848,16,14,"PACMA",0
50,"50166",282,216,210,1,6,"PACMA",0
37,"37152",474,357,351,2,6,"PACMA",0
46,"46184",26507,20314,20010,263,304,"PACMA",96
50,"50252",5345,3860,3792,79,68,"PACMA",8
24,"24123",835,559,555,6,4,"PACMA",1
37,"37030",90,71,70,4,1,"PACMA",0
44,"44111",101,68,68,4,0,"PACMA",0
49,"49262",401,317,313,1,4,"PACMA",2
34,"34116",76,50,49,1,1,"PACMA",0
44,"44112",473,353,350,4,3,"PACMA",1
28,"28016",86,68,67,3,1,"PACMA",0
37,"37266",83,54,54,1,0,"PACMA",0
22,"22049",88,70,69,5,1,"PACMA",0
28,"28129",7219,5536,5461,71,75,"PACMA",20
19,"19058",6455,5028,4933,63,95,"PACMA",30
35,"35001",4663,3639,3569,39,70,"PACMA",8
48,"48910",3063,2122,2104,14,18,"PACMA",4
34,"34120",65774,49378,48608,830,770,"PACMA",178
45,"45154",1459,1148,1140,12,8,"PACMA",10
9,"9082",49,41,41,0,0,"PACMA",0
16,"16060",841,714,704,11,10,"PACMA",2
21,"21053",3278,2363,2325,20,38,"PACMA",2
48,"48008",600,432,428,3,4,"PACMA",2
29,"29013",1718,1302,1283,4,19,"PACMA",2
16,"16190",5151,4229,4144,52,85,"PACMA",8
3,"3058",4798,4126,4103,26,23,"PACMA",6
24,"24008",9789,7277,7179,110,98,"PACMA",25
10,"10036",345,262,251,2,11,"PACMA",0
13,"13047",5822,4735,4650,52,85,"PACMA",13
45,"45193",661,557,548,1,9,"PACMA",1
19,"19173",52,42,42,3,0,"PACMA",0
19,"19270",17,16,16,0,0,"PACMA",0
40,"40018",102,88,87,2,1,"PACMA",0
37,"37269",475,383,382,2,1,"PACMA",0
49,"49129",903,671,661,16,10,"PACMA",0
18,"18066",2072,1558,1552,8,6,"PACMA",0
28,"28130",27391,21367,21111,235,256,"PACMA",112
29,"29014",250,152,150,0,2,"PACMA",1
12,"12097",78,59,59,4,0,"PACMA",0
22,"22096",301,239,237,8,2,"PACMA",2
10,"10160",235,183,183,1,0,"PACMA",0
25,"25012",2204,1432,1406,29,26,"PACMA",7
39,"39036",1023,802,790,5,12,"PACMA",6
9,"9906",1199,912,903,12,9,"PACMA",4
10,"10120",168,122,119,1,3,"PACMA",0
33,"33007",1680,1186,1179,10,7,"PACMA",0
42,"42084",27,21,21,0,0,"PACMA",0
32,"32067",1487,1004,995,10,9,"PACMA",5
33,"33053",1206,817,811,6,6,"PACMA",1
37,"37035",220,176,173,1,3,"PACMA",0
13,"13049",838,654,648,0,6,"PACMA",1
26,"26153",12,9,8,0,1,"PACMA",0
21,"21055",6320,4819,4760,46,59,"PACMA",16
10,"10161",76,59,59,1,0,"PACMA",0
40,"40118",59,44,43,1,1,"PACMA",0
21,"21056",2992,2172,2096,29,76,"PACMA",5
40,"40021",33,32,32,0,0,"PACMA",0
49,"49131",312,227,225,7,2,"PACMA",1
6,"6061",1116,1000,989,8,11,"PACMA",0
50,"50081",562,410,400,7,10,"PACMA",0
9,"9132",174,129,127,3,2,"PACMA",0
37,"37122",210,175,174,3,1,"PACMA",1
40,"40022",210,154,151,2,3,"PACMA",1
18,"18171",2093,1719,1704,10,15,"PACMA",0
12,"12099",583,485,465,3,20,"PACMA",2
28,"28132",10987,8066,7943,90,123,"PACMA",39
49,"49132",338,245,238,0,7,"PACMA",1
25,"25104",128,88,86,11,2,"PACMA",1
26,"26154",12,12,12,3,0,"PACMA",0
5,"5023",177,160,158,1,2,"PACMA",0
15,"15056",5873,4205,4150,63,55,"PACMA",12
47,"47162",80,62,62,1,0,"PACMA",0
6,"6063",3079,2467,2454,16,13,"PACMA",4
6,"6064",900,715,706,2,9,"PACMA",1
19,"19065",126,100,100,3,0,"PACMA",0
25,"25105",146,90,89,1,1,"PACMA",0
39,"39038",1465,1065,1047,8,18,"PACMA",5
16,"16065",454,380,374,4,6,"PACMA",3
24,"24133",379,279,279,0,0,"PACMA",0
37,"37237",330,250,242,1,8,"PACMA",0
49,"49270",156,112,112,6,0,"PACMA",0
7,"7027",20045,12873,12678,204,195,"PACMA",90
10,"10042",79,63,62,2,1,"PACMA",0
18,"18173",8858,6238,6187,64,51,"PACMA",7
50,"50143",608,427,424,5,3,"PACMA",0
21,"21058",2609,1867,1857,15,10,"PACMA",1
50,"50230",1295,914,903,13,11,"PACMA",2
5,"5221",398,298,297,10,1,"PACMA",2
9,"9012",105,77,74,3,3,"PACMA",3
9,"9091",746,556,550,8,6,"PACMA",1
39,"39092",1030,753,747,1,6,"PACMA",3
49,"49093",308,248,245,5,3,"PACMA",0
9,"9409",138,105,102,0,3,"PACMA",0
50,"50144",36,32,32,0,0,"PACMA",0
33,"33033",10609,7179,7107,91,72,"PACMA",8
49,"49004",137,105,105,3,0,"PACMA",2
50,"50174",107,92,90,0,2,"PACMA",0
10,"10166",351,246,238,2,8,"PACMA",1
35,"35033",6415,4394,4302,51,92,"PACMA",8
28,"28021",418,334,328,4,6,"PACMA",3
6,"6067",2030,1583,1572,16,11,"PACMA",3
13,"13054",5032,3901,3824,70,77,"PACMA",8
50,"50084",84,64,64,1,0,"PACMA",0
22,"22015",336,237,235,11,2,"PACMA",5
49,"49273",217,144,144,0,0,"PACMA",0
26,"26161",9,8,8,0,0,"PACMA",0
6,"6068",481,383,378,3,5,"PACMA",0
6,"6022",2719,2274,2245,14,29,"PACMA",6
32,"32037",828,660,654,10,6,"PACMA",2
49,"49137",179,149,147,2,2,"PACMA",1
10,"10045",1119,884,859,5,25,"PACMA",2
37,"37127",229,183,182,3,1,"PACMA",0
28,"28180",5179,4033,3975,18,58,"PACMA",5
2,"2051",1729,1318,1303,10,15,"PACMA",0
34,"34175",101,80,80,2,0,"PACMA",0
24,"24137",1226,920,904,16,16,"PACMA",5
47,"47165",7036,5328,5258,67,70,"PACMA",8
29,"29020",3188,2448,2424,30,24,"PACMA",2
37,"37042",45,35,35,1,0,"PACMA",0
22,"22904",908,660,653,14,7,"PACMA",3
15,"15060",5599,4139,4069,82,70,"PACMA",11
2,"2052",493,417,412,9,5,"PACMA",0
19,"19181",69,54,54,5,0,"PACMA",0
9,"9056",4957,3607,3557,70,50,"PACMA",15
5,"5029",132,102,102,0,0,"PACMA",0
26,"26033",183,157,156,2,1,"PACMA",2
34,"34049",421,313,311,4,2,"PACMA",0
16,"16031",62,34,32,4,2,"PACMA",0
18,"18144",779,592,590,3,2,"PACMA",1
6,"6071",257,236,230,1,6,"PACMA",0
10,"10047",978,795,780,9,15,"PACMA",1
10,"10170",269,217,215,4,2,"PACMA",0
15,"15061",6105,4391,4307,64,84,"PACMA",13
12,"12105",866,679,673,6,6,"PACMA",1
45,"45203",2535,1883,1829,21,54,"PACMA",17
2,"2053",3053,2550,2517,33,33,"PACMA",5
28,"28136",618,527,516,2,11,"PACMA",1
47,"47167",258,230,229,3,1,"PACMA",0
45,"45204",621,500,497,1,3,"PACMA",1
16,"16032",304,253,244,2,9,"PACMA",0
18,"18076",880,676,676,3,0,"PACMA",0
34,"34050",216,170,166,1,4,"PACMA",0
50,"50177",355,268,265,4,3,"PACMA",0
28,"28024",156,132,132,5,0,"PACMA",0
26,"26165",350,297,294,1,3,"PACMA",0
9,"9274",1160,924,914,14,10,"PACMA",3
12,"12106",1207,992,969,7,23,"PACMA",2
49,"49009",430,309,309,0,0,"PACMA",1
46,"46145",21751,16601,16397,155,204,"PACMA",59
10,"10131",12797,9017,8922,131,95,"PACMA",35
37,"37131",200,150,148,1,2,"PACMA",0
44,"44208",32,23,23,1,0,"PACMA",0
9,"9141",607,503,481,10,22,"PACMA",5
10,"10050",1208,1003,983,8,20,"PACMA",4
7,"7001",3450,2544,2470,36,74,"PACMA",11
50,"50004",613,445,441,6,4,"PACMA",1
7,"7034",971,724,708,10,16,"PACMA",4
9,"9415",290,192,192,4,0,"PACMA",0
47,"47168",32,29,28,1,1,"PACMA",0
49,"49143",243,161,157,0,4,"PACMA",0
39,"39044",3864,2940,2905,44,35,"PACMA",11
34,"34179",32,21,21,0,0,"PACMA",0
21,"21065",295,212,211,0,1,"PACMA",1
22,"22066",699,479,464,8,15,"PACMA",3
24,"24144",781,551,541,13,10,"PACMA",2
44,"44209",892,666,649,6,17,"PACMA",2
49,"49102",217,178,176,3,2,"PACMA",1
12,"12108",495,394,389,4,5,"PACMA",3
36,"36005",8231,5985,5873,84,112,"PACMA",14
6,"6076",854,639,631,9,8,"PACMA",2
48,"48022",2396,1524,1504,12,20,"PACMA",3
33,"33015",1695,1177,1161,12,16,"PACMA",5
37,"37358",163,143,139,0,4,"PACMA",0
22,"22067",82,54,49,3,5,"PACMA",0
16,"16079",33,21,21,0,0,"PACMA",0
29,"29098",1312,1043,1036,22,7,"PACMA",3
50,"50265",63,46,46,1,0,"PACMA",0
9,"9277",130,101,101,1,0,"PACMA",0
49,"49013",300,230,228,6,2,"PACMA",1
24,"24145",656,420,420,11,0,"PACMA",0
25,"25913",100,78,78,0,0,"PACMA",0
9,"9235",179,148,142,1,6,"PACMA",0
3,"3902",9578,7085,7007,65,78,"PACMA",30
25,"25082",265,156,155,8,1,"PACMA",0
24,"24025",331,237,237,5,0,"PACMA",0
5,"5036",136,107,106,0,1,"PACMA",0
37,"37285",457,349,347,2,2,"PACMA",0
15,"15065",7570,5710,5628,71,82,"PACMA",12
22,"22117",2585,1880,1848,57,32,"PACMA",10
39,"39046",1442,1071,1050,13,21,"PACMA",0
49,"49148",213,144,143,0,1,"PACMA",0
10,"10177",1692,1351,1318,15,33,"PACMA",8
50,"50006",978,758,749,16,9,"PACMA",1
50,"50267",648,450,441,8,9,"PACMA",0
28,"28027",1232,937,919,9,18,"PACMA",0
36,"36008",21702,15366,15037,261,329,"PACMA",89
19,"19187",64,54,54,0,0,"PACMA",0
24,"24026",1304,1015,1001,17,14,"PACMA",4
22,"22119",1433,994,981,14,13,"PACMA",1
33,"33040",4702,3285,3236,44,49,"PACMA",9
49,"49149",422,305,303,6,2,"PACMA",2
25,"25119",2297,1554,1513,46,41,"PACMA",3
10,"10178",797,604,597,5,7,"PACMA",2
47,"47171",453,371,368,10,3,"PACMA",2
26,"26127",236,206,204,1,2,"PACMA",0
6,"6080",1942,1519,1507,9,12,"PACMA",6
50,"50183",369,277,274,5,3,"PACMA",3
44,"44132",64,57,56,0,1,"PACMA",0
32,"32047",2003,1595,1575,10,20,"PACMA",5
34,"34017",960,772,760,15,12,"PACMA",0
40,"40183",148,127,127,0,0,"PACMA",1
46,"46004",1933,1563,1541,8,22,"PACMA",2
5,"5135",440,363,360,0,3,"PACMA",2
37,"37175",408,319,311,6,8,"PACMA",0
9,"9378",42,26,26,0,0,"PACMA",2
47,"47172",149,125,124,3,1,"PACMA",0
9,"9283",63,36,36,0,0,"PACMA",1
22,"22124",229,171,170,2,1,"PACMA",0
18,"18085",818,538,532,4,6,"PACMA",0
46,"46247",1059,829,823,6,6,"PACMA",0
49,"49151",680,494,491,6,3,"PACMA",2
5,"5039",58,48,48,0,0,"PACMA",0
25,"25120",90759,58761,57778,1325,983,"PACMA",344
44,"44133",21,16,16,0,0,"PACMA",0
28,"28029",538,416,414,4,2,"PACMA",0
48,"48027",21610,15409,15274,145,135,"PACMA",69
38,"38017",24438,13769,13576,176,193,"PACMA",89
10,"10181",739,607,598,6,9,"PACMA",1
12,"12113",100,72,72,0,0,"PACMA",0
24,"24069",53,44,44,0,0,"PACMA",0
18,"18086",397,321,321,3,0,"PACMA",0
5,"5138",326,278,275,2,3,"PACMA",0
10,"10018",1761,1321,1296,17,25,"PACMA",1
12,"12013",180,131,130,0,1,"PACMA",1
44,"44136",51,39,39,0,0,"PACMA",0
37,"37289",265,211,209,0,2,"PACMA",0
37,"37057",223,190,190,0,0,"PACMA",0
39,"39050",305,207,205,1,2,"PACMA",0
37,"37177",310,242,241,1,1,"PACMA",1
44,"44010",189,138,138,2,0,"PACMA",0
50,"50010",77,65,64,5,1,"PACMA",0
3,"3078",528,424,423,2,1,"PACMA",2
10,"10020",1671,1386,1374,14,12,"PACMA",1
22,"22181",91,57,55,0,2,"PACMA",0
25,"25212",233,185,185,8,0,"PACMA",0
10,"10060",1037,758,742,9,16,"PACMA",0
19,"19291",1271,925,902,3,23,"PACMA",6
50,"50011",131,113,113,8,0,"PACMA",0
21,"21072",10233,7829,7666,124,163,"PACMA",21
47,"47014",55,47,47,0,0,"PACMA",0
6,"6086",1270,956,949,2,7,"PACMA",2
19,"19258",103,81,81,0,0,"PACMA",0
33,"33043",710,529,528,1,1,"PACMA",0
34,"34062",175,126,124,3,2,"PACMA",0
2,"2065",517,450,449,4,1,"PACMA",1
19,"19047",87,71,70,2,1,"PACMA",1
46,"46104",2012,1691,1676,9,15,"PACMA",5
19,"19088",98,67,66,0,1,"PACMA",0
10,"10062",421,332,325,3,7,"PACMA",0
1,"1009",1296,876,863,9,13,"PACMA",5
40,"40189",560,455,438,6,17,"PACMA",1
10,"10185",587,457,450,1,7,"PACMA",2
2,"2066",258,219,217,2,2,"PACMA",0
40,"40048",40,30,30,0,0,"PACMA",0
28,"28146",1672,1220,1205,4,15,"PACMA",2
25,"25124",161,110,109,4,1,"PACMA",1
2,"2030",3180,2499,2456,13,43,"PACMA",5
49,"49023",1033,736,728,10,8,"PACMA",5
12,"12116",56,45,45,0,0,"PACMA",0
6,"6088",12879,9362,9222,153,140,"PACMA",40
39,"39052",17031,13198,13034,187,164,"PACMA",52
49,"49157",177,140,140,0,0,"PACMA",0
44,"44265",203,169,158,6,11,"PACMA",0
50,"50099",3136,2333,2297,27,36,"PACMA",2
45,"45107",3006,2344,2299,32,45,"PACMA",13
30,"30004",1164,958,952,1,6,"PACMA",1
28,"28032",4469,3412,3369,32,43,"PACMA",13
1,"1011",245,189,185,7,4,"PACMA",1
47,"47016",94,77,77,1,0,"PACMA",0
50,"50273",36,22,22,0,0,"PACMA",0
29,"29005",4307,2967,2951,18,16,"PACMA",6
7,"7013",6525,4528,4409,78,119,"PACMA",36
45,"45072",690,535,532,7,3,"PACMA",2
12,"12118",83,63,62,0,1,"PACMA",0
28,"28147",910,705,698,5,7,"PACMA",5
45,"45182",1077,873,856,11,17,"PACMA",1
32,"32055",1412,1056,1037,5,19,"PACMA",3
46,"46082",4661,3447,3401,46,46,"PACMA",22
10,"10187",486,349,345,2,4,"PACMA",3
24,"24036",321,190,188,0,2,"PACMA",0
16,"16175",5058,4363,4295,70,68,"PACMA",3
10,"10188",553,473,468,2,5,"PACMA",0
50,"50100",355,273,266,3,7,"PACMA",1
2,"2069",11624,9091,8907,119,184,"PACMA",25
19,"19297",34,29,29,0,0,"PACMA",0
1,"1061",155,122,122,2,0,"PACMA",0
13,"13038",1770,1397,1380,8,17,"PACMA",2
45,"45110",1918,1585,1570,10,15,"PACMA",1
29,"29034",462,360,357,0,3,"PACMA",1
10,"10066",182,136,133,1,3,"PACMA",0
50,"50275",103,76,76,0,0,"PACMA",1
47,"47207",325,265,263,4,2,"PACMA",0
49,"49162",217,157,155,2,2,"PACMA",0
46,"46083",15427,12079,11941,109,138,"PACMA",42
25,"25126",286,192,189,7,3,"PACMA",0
15,"15074",4254,3246,3219,35,27,"PACMA",5
30,"30032",2839,2361,2337,21,24,"PACMA",3
13,"13072",803,638,633,13,5,"PACMA",0
22,"22135",200,152,147,5,5,"PACMA",0
5,"5144",92,66,66,4,0,"PACMA",0
9,"9166",97,87,87,1,0,"PACMA",0
18,"18159",1051,873,869,4,4,"PACMA",1
6,"6093",4599,3658,3612,22,46,"PACMA",3
44,"44019",75,38,37,0,1,"PACMA",0
40,"40195",946,722,707,13,15,"PACMA",0
26,"26055",38,32,30,0,2,"PACMA",0
47,"47180",96,82,81,0,1,"PACMA",0
46,"46157",3068,2523,2491,17,32,"PACMA",6
49,"49163",235,167,167,0,0,"PACMA",0
28,"28079",2290453,1721837,1705310,17342,16527,"PACMA",6060
12,"12120",218,180,177,0,3,"PACMA",0
40,"40056",41,34,34,0,0,"PACMA",0
45,"45112",2022,1470,1423,12,47,"PACMA",3
44,"44020",23,15,15,0,0,"PACMA",0
25,"25220",1076,711,702,10,9,"PACMA",0
26,"26056",440,345,339,4,6,"PACMA",4
13,"13074",1000,886,878,15,8,"PACMA",0
28,"28035",1314,1058,1046,3,12,"PACMA",4
42,"42027",87,61,61,4,0,"PACMA",0
10,"10192",910,679,670,3,9,"PACMA",1
49,"49165",72,63,63,0,0,"PACMA",0
18,"18096",348,289,287,1,2,"PACMA",0
44,"44108",352,228,225,8,3,"PACMA",0
16,"16097",196,167,166,2,1,"PACMA",0
40,"40106",232,173,173,3,0,"PACMA",0
34,"34032",47,36,36,1,0,"PACMA",0
10,"10030",502,364,362,5,2,"PACMA",1
50,"50075",89,74,74,1,0,"PACMA",0
9,"9169",96,80,80,1,0,"PACMA",0
46,"46231",2496,1831,1817,16,14,"PACMA",5
40,"40058",368,306,304,1,2,"PACMA",0
44,"44022",550,387,380,6,7,"PACMA",0
46,"46061",331,276,273,3,3,"PACMA",2
22,"22139",86,66,63,2,3,"PACMA",0
18,"18097",1022,758,752,4,6,"PACMA",1
42,"42178",144,105,104,3,1,"PACMA",0
16,"16239",158,114,112,2,2,"PACMA",0
28,"28151",3025,2237,2185,9,52,"PACMA",5
37,"37302",337,230,229,5,1,"PACMA",2
47,"47182",1371,991,982,12,9,"PACMA",3
49,"49166",1294,1003,988,29,15,"PACMA",3
46,"46013",16111,12469,12328,145,141,"PACMA",62
37,"37188",198,164,160,7,4,"PACMA",0
15,"15077",8677,6349,6269,82,80,"PACMA",10
44,"44150",30,30,30,0,0,"PACMA",0
5,"5051",194,165,154,0,11,"PACMA",0
25,"25130",208,117,112,4,5,"PACMA",1
9,"9306",127,94,94,0,0,"PACMA",0
7,"7053",1133,863,839,16,24,"PACMA",7
22,"22142",114,91,91,2,0,"PACMA",0
12,"12124",1902,1532,1499,15,33,"PACMA",0
47,"47183",150,125,122,0,3,"PACMA",0
19,"19267",22,15,15,0,0,"PACMA",0
22,"22003",148,117,116,2,1,"PACMA",1
44,"44151",215,143,140,1,3,"PACMA",0
50,"50107",953,785,780,13,5,"PACMA",0
36,"36023",8522,6206,6062,64,144,"PACMA",39
18,"18098",6440,4743,4679,44,64,"PACMA",4
34,"34074",764,610,597,11,13,"PACMA",1
29,"29012",9817,7063,6991,51,72,"PACMA",9
1,"1022",826,615,602,6,13,"PACMA",3
16,"16242",367,315,313,4,2,"PACMA",0
6,"6101",489,397,395,5,2,"PACMA",0
1,"1023",290,236,235,1,1,"PACMA",0
9,"9173",135,116,116,1,0,"PACMA",0
16,"16101",160,142,142,0,0,"PACMA",0
19,"19203",35,27,27,0,0,"PACMA",0
26,"26021",2758,2190,2163,21,27,"PACMA",5
40,"40203",814,643,631,14,12,"PACMA",6
18,"18099",1551,1217,1205,11,12,"PACMA",3
9,"9003",205,156,154,4,2,"PACMA",0
25,"25193",771,509,501,8,8,"PACMA",1
24,"24047",856,623,612,5,11,"PACMA",2
32,"32064",561,439,437,5,2,"PACMA",0
49,"49171",704,568,561,6,7,"PACMA",1
44,"44153",1882,1273,1246,10,27,"PACMA",1
16,"16102",1320,1016,1007,15,9,"PACMA",1
47,"47023",2863,2278,2258,38,20,"PACMA",19
12,"12126",24420,18431,18136,231,295,"PACMA",59
37,"37192",362,229,221,3,8,"PACMA",0
24,"24168",493,397,391,7,6,"PACMA",0
1,"1028",1106,773,760,8,13,"PACMA",6
9,"9175",143,99,98,0,1,"PACMA",0
24,"24049",1528,1144,1124,22,20,"PACMA",5
5,"5054",1282,979,965,5,14,"PACMA",7
10,"10078",451,349,341,3,8,"PACMA",0
5,"5153",112,89,89,5,0,"PACMA",0
37,"37306",316,194,192,1,2,"PACMA",0
5,"5154",46,35,35,0,0,"PACMA",0
37,"37193",432,310,309,5,1,"PACMA",0
2,"2080",580,450,443,4,7,"PACMA",0
44,"44154",271,196,195,7,1,"PACMA",1
46,"46162",1230,1045,1027,6,18,"PACMA",1
37,"37194",271,206,204,0,2,"PACMA",1
44,"44155",1162,819,801,24,18,"PACMA",5
24,"24010",8550,6242,6111,100,131,"PACMA",20
25,"25165",301,202,198,6,4,"PACMA",1
45,"45010",471,374,372,2,2,"PACMA",0
40,"40207",724,551,540,9,11,"PACMA",6
9,"9220",82,60,60,2,0,"PACMA",0
25,"25071",56,37,35,2,2,"PACMA",0
34,"34216",65,50,50,1,0,"PACMA",0
9,"9176",60,47,45,2,2,"PACMA",0
49,"49039",333,243,240,6,3,"PACMA",0
16,"16246",520,417,407,1,10,"PACMA",0
38,"38034",4092,3034,2983,30,51,"PACMA",8
27,"27015",4587,3465,3409,55,56,"PACMA",6
45,"45122",4828,3816,3746,48,70,"PACMA",19
9,"9311",70,51,51,0,0,"PACMA",1
15,"15083",1198,874,855,8,19,"PACMA",0
19,"19307",30,27,27,0,0,"PACMA",0
50,"50199",380,263,254,2,9,"PACMA",1
44,"44031",124,72,72,0,0,"PACMA",0
37,"37080",242,187,185,1,2,"PACMA",0
22,"22011",102,78,78,3,0,"PACMA",0
44,"44157",62,45,44,0,1,"PACMA",0
25,"25227",674,375,372,2,3,"PACMA",2
26,"26067",22,19,19,1,0,"PACMA",0
42,"42039",270,172,169,2,3,"PACMA",0
9,"9312",113,94,91,0,3,"PACMA",1
49,"49176",757,502,501,5,1,"PACMA",1
46,"46237",7261,5405,5350,54,55,"PACMA",38
40,"40071",52,45,45,4,0,"PACMA",0
6,"6109",4006,3435,3372,21,63,"PACMA",3
10,"10082",1947,1601,1572,10,29,"PACMA",3
34,"34082",96,79,75,0,4,"PACMA",0
27,"27017",1138,789,787,6,2,"PACMA",4
47,"47188",125,112,109,3,3,"PACMA",0
36,"36030",4387,3206,3177,35,29,"PACMA",2
25,"25228",2907,2043,2021,43,22,"PACMA",12
46,"46165",6962,5390,5322,53,68,"PACMA",14
2,"2047",109,94,94,0,0,"PACMA",0
28,"28156",958,742,733,12,9,"PACMA",2
37,"37124",227,181,179,3,2,"PACMA",0
10,"10205",2081,1486,1457,19,29,"PACMA",4
32,"32070",660,457,452,1,5,"PACMA",0
2,"2048",1320,1076,1061,11,15,"PACMA",2
36,"36031",572,484,479,5,5,"PACMA",3
37,"37198",212,176,173,2,3,"PACMA",2
42,"42042",46,35,33,1,2,"PACMA",0
46,"46020",3793,3084,3046,21,38,"PACMA",8
15,"15085",3576,2656,2612,29,44,"PACMA",7
6,"6111",502,389,387,8,2,"PACMA",0
12,"12001",1098,821,817,8,4,"PACMA",3
34,"34221",190,143,143,3,0,"PACMA",1
22,"22014",265,192,191,1,1,"PACMA",1
22,"22160",219,166,166,5,0,"PACMA",1
9,"9181",334,271,271,14,0,"PACMA",0
27,"27020",3807,3204,3161,33,43,"PACMA",6
24,"24055",747,557,549,11,8,"PACMA",1
40,"40214",243,204,199,0,5,"PACMA",2
32,"32072",3949,2881,2841,32,40,"PACMA",9
10,"10207",499,394,392,1,2,"PACMA",1
45,"45126",278,188,187,0,1,"PACMA",1
48,"48082",38551,25768,25482,316,286,"PACMA",135
5,"5060",127,108,105,1,3,"PACMA",0
19,"19311",87,60,60,0,0,"PACMA",0
19,"19213",72,60,60,1,0,"PACMA",0
32,"32036",1528,1217,1202,13,15,"PACMA",3
47,"47191",113,81,80,1,1,"PACMA",0
47,"47111",1005,804,794,5,10,"PACMA",3
37,"37201",263,196,196,5,0,"PACMA",0
27,"27022",5093,3535,3486,74,49,"PACMA",12
47,"47083",80,61,59,3,2,"PACMA",0
9,"9182",104,81,81,1,0,"PACMA",0
16,"16254",213,166,165,2,1,"PACMA",1
49,"49048",162,119,119,2,0,"PACMA",0
12,"12038",195,135,134,8,1,"PACMA",0
16,"16113",3075,2363,2338,36,25,"PACMA",5
9,"9318",63,38,38,0,0,"PACMA",0
25,"25232",1480,968,959,38,9,"PACMA",1
3,"3101",4648,3694,3607,29,87,"PACMA",10
48,"48050",216,173,172,0,1,"PACMA",0
22,"22017",917,677,661,8,16,"PACMA",4
29,"29048",1508,1254,1245,6,9,"PACMA",0
44,"44164",32,25,25,0,0,"PACMA",0
24,"24177",477,325,319,3,6,"PACMA",1
19,"19317",150,122,121,2,1,"PACMA",0
5,"5258",123,105,104,1,1,"PACMA",0
37,"37202",938,742,726,25,16,"PACMA",0
27,"27024",1759,1346,1324,17,22,"PACMA",2
16,"16255",159,123,122,3,1,"PACMA",0
46,"46241",440,336,314,4,22,"PACMA",0
32,"32075",3839,2957,2910,51,47,"PACMA",11
15,"15004",4891,3595,3545,61,50,"PACMA",11
28,"28159",629,482,478,2,4,"PACMA",3
24,"24059",956,592,585,9,7,"PACMA",0
5,"5063",48,39,39,2,0,"PACMA",0
50,"50030",232,164,160,1,4,"PACMA",2
46,"46023",318,275,267,2,8,"PACMA",0
50,"50118",2312,1737,1718,22,19,"PACMA",6
26,"26075",377,297,289,4,8,"PACMA",0
9,"9323",71,44,44,2,0,"PACMA",0
18,"18013",4392,3268,3223,23,45,"PACMA",4
10,"10090",552,404,396,3,8,"PACMA",1
30,"30021",8550,6423,6349,44,74,"PACMA",13
16,"16259",30,26,26,1,0,"PACMA",0
22,"22020",110,81,79,3,2,"PACMA",0
44,"44167",41,31,31,1,0,"PACMA",0
50,"50206",499,386,384,10,2,"PACMA",2
19,"19184",88,63,62,1,1,"PACMA",0
44,"44126",344,250,236,1,14,"PACMA",1
19,"19075",81,53,50,4,3,"PACMA",0
45,"45131",327,262,258,1,4,"PACMA",0
32,"32077",1234,999,993,23,6,"PACMA",2
27,"27027",2111,1652,1605,21,47,"PACMA",2
45,"45132",1916,1487,1473,9,14,"PACMA",4
10,"10213",605,478,477,1,1,"PACMA",1
27,"27028",78862,57097,55890,1246,1207,"PACMA",358
10,"10092",316,263,262,1,1,"PACMA",1
49,"49187",1317,967,954,31,13,"PACMA",0
49,"49054",929,690,687,12,3,"PACMA",1
40,"40081",151,109,107,2,2,"PACMA",0
38,"38044",2325,1550,1532,7,18,"PACMA",3
19,"19001",64,56,56,1,0,"PACMA",0
49,"49055",115,96,95,1,1,"PACMA",1
34,"34092",331,272,267,6,5,"PACMA",0
9,"9020",276,222,222,6,0,"PACMA",0
3,"3005",7482,6191,6146,49,45,"PACMA",17
36,"36038",65661,47940,47214,836,726,"PACMA",295
28,"28047",38404,28739,28436,312,303,"PACMA",126
22,"22022",582,448,438,12,10,"PACMA",1
28,"28092",148714,112174,110838,1215,1336,"PACMA",525
9,"9191",45,34,33,1,1,"PACMA",0
50,"50180",111,91,89,3,2,"PACMA",0
25,"25051",1710,1060,1044,23,16,"PACMA",5
27,"27030",3744,2587,2525,32,62,"PACMA",10
16,"16265",27,26,26,0,0,"PACMA",0
46,"46098",2556,2072,2057,12,15,"PACMA",8
21,"21005",15205,11006,10909,108,97,"PACMA",16
37,"37208",92,59,58,0,1,"PACMA",0
32,"32044",939,774,764,8,10,"PACMA",1
24,"24146",284,223,221,0,2,"PACMA",0
37,"37172",857,584,580,5,4,"PACMA",0
25,"25118",378,232,226,4,6,"PACMA",0
3,"3107",2288,1670,1647,15,23,"PACMA",15
10,"10216",1549,1247,1235,15,12,"PACMA",3
36,"36040",2627,1938,1907,24,31,"PACMA",4
9,"9061",187,146,144,1,2,"PACMA",0
6,"6123",4699,3509,3448,54,61,"PACMA",16
12,"12140",1204,975,954,9,21,"PACMA",1
27,"27032",3466,2565,2530,40,35,"PACMA",4
33,"33062",452,282,281,3,1,"PACMA",1
50,"50209",2559,1685,1661,34,24,"PACMA",14
16,"16122",259,195,190,2,5,"PACMA",0
6,"6124",1750,1418,1378,17,40,"PACMA",0
32,"32082",1403,1055,1047,9,8,"PACMA",1
25,"25052",1611,1094,1062,21,32,"PACMA",4
42,"42207",49,37,34,0,3,"PACMA",0
26,"26082",121,95,95,0,0,"PACMA",0
3,"3008",176,142,140,1,2,"PACMA",0
6,"6125",1852,1419,1399,11,20,"PACMA",3
19,"19324",199,151,151,2,0,"PACMA",0
12,"12141",116,97,97,0,0,"PACMA",0
46,"46246",1081,917,904,5,13,"PACMA",1
26,"26083",303,234,234,1,0,"PACMA",0
12,"12111",423,375,363,6,12,"PACMA",1
30,"30025",4780,3901,3874,18,27,"PACMA",12
42,"42056",26,23,22,1,1,"PACMA",0
44,"44045",373,303,301,4,2,"PACMA",0
16,"16124",1909,1573,1555,14,18,"PACMA",1
46,"46101",868,720,716,8,4,"PACMA",0
44,"44046",58,44,44,1,0,"PACMA",0
6,"6126",2199,1706,1686,14,20,"PACMA",3
3,"3111",5244,4184,4146,39,38,"PACMA",15
49,"49193",503,365,357,4,8,"PACMA",0
5,"5038",131,88,84,0,4,"PACMA",1
15,"15011",15507,10935,10751,123,184,"PACMA",49
6,"6127",2922,2306,2279,27,27,"PACMA",5
22,"22028",424,311,310,3,1,"PACMA",1
9,"9197",160,129,128,3,1,"PACMA",0
45,"45174",343,289,288,0,1,"PACMA",0
19,"19223",129,94,90,1,4,"PACMA",2
3,"3010",330,269,266,3,3,"PACMA",1
27,"27037",1205,857,845,13,12,"PACMA",1
1,"1054",959,680,675,8,5,"PACMA",3
6,"6128",4466,3310,3264,50,46,"PACMA",7
25,"25149",1401,1031,1010,17,21,"PACMA",3
10,"10100",792,554,538,1,16,"PACMA",0
40,"40089",248,183,177,3,6,"PACMA",0
30,"30027",45194,35272,34973,366,299,"PACMA",154
3,"3112",684,566,561,4,5,"PACMA",2
33,"33064",237,175,173,1,2,"PACMA",0
3,"3011",7341,5277,5218,72,59,"PACMA",22
49,"49019",256,206,205,5,1,"PACMA",1
50,"50038",1583,1194,1174,29,20,"PACMA",4
28,"28165",1689,1310,1295,5,15,"PACMA",0
26,"26087",222,180,178,5,2,"PACMA",0
5,"5170",63,50,50,0,0,"PACMA",0
44,"44177",120,85,85,1,0,"PACMA",0
12,"12902",2056,1454,1411,14,43,"PACMA",7
22,"22032",120,78,73,5,5,"PACMA",0
18,"18021",16026,11376,11219,186,157,"PACMA",68
32,"32086",2874,2026,2003,18,23,"PACMA",2
13,"13902",497,396,394,3,2,"PACMA",3
19,"19191",19,15,15,0,0,"PACMA",0
25,"25180",245,167,165,3,2,"PACMA",0
40,"40234",441,363,355,3,8,"PACMA",0
44,"44178",69,45,44,0,1,"PACMA",0
42,"42213",31,24,24,2,0,"PACMA",0
47,"47203",69,57,56,0,1,"PACMA",0
22,"22035",261,179,176,3,3,"PACMA",0
5,"5902",319,262,262,0,0,"PACMA",1
5,"5041",1051,840,827,13,13,"PACMA",3
24,"24071",1060,808,797,6,11,"PACMA",2
45,"45142",7974,6294,6178,89,116,"PACMA",26
11,"11002",4291,3388,3374,19,14,"PACMA",1
36,"36046",4093,3175,3120,31,55,"PACMA",16
32,"32015",995,697,694,9,3,"PACMA",1
44,"44179",369,245,243,6,2,"PACMA",3
19,"19122",96,65,65,0,0,"PACMA",0
24,"24193",371,254,252,3,2,"PACMA",2
42,"42062",36,23,22,0,1,"PACMA",0
42,"42063",69,53,53,4,0,"PACMA",0
28,"28099",1670,1258,1246,9,12,"PACMA",7
45,"45032",471,340,333,2,7,"PACMA",3
37,"37217",60,49,48,1,1,"PACMA",0
42,"42217",38,32,32,0,0,"PACMA",0
46,"46080",1090,860,849,2,11,"PACMA",4
32,"32089",1480,1063,1045,7,18,"PACMA",2
22,"22184",203,172,167,2,5,"PACMA",0
10,"10105",2599,1869,1835,25,34,"PACMA",2
46,"46032",5583,4342,4287,39,55,"PACMA",15
24,"24074",107,87,87,0,0,"PACMA",0
24,"24194",327,237,236,5,1,"PACMA",1
37,"37332",78,52,49,0,3,"PACMA",0
24,"24196",2183,1573,1543,11,30,"PACMA",5
5,"5173",62,55,55,1,0,"PACMA",0
26,"26010",98,82,79,1,3,"PACMA",0
33,"33067",802,650,639,12,11,"PACMA",0
3,"3015",12241,9734,9636,88,98,"PACMA",22
12,"12052",627,510,491,9,19,"PACMA",1
9,"9295",78,54,53,0,1,"PACMA",0
5,"5109",438,359,351,5,8,"PACMA",0
22,"22234",818,609,605,12,4,"PACMA",2
42,"42065",28,24,24,0,0,"PACMA",0
34,"34242",97,81,79,6,2,"PACMA",0
21,"21014",4063,3424,3408,27,16,"PACMA",3
13,"13004",1130,937,923,6,14,"PACMA",0
40,"40905",143,103,103,1,0,"PACMA",0
47,"47206",111,99,99,0,0,"PACMA",0
16,"16008",131,89,88,2,1,"PACMA",0
36,"36016",1373,865,853,7,12,"PACMA",0
9,"9072",272,210,209,4,1,"PACMA",2
5,"5078",128,112,111,2,1,"PACMA",0
34,"34243",352,274,273,5,1,"PACMA",1
16,"16279",251,175,172,1,3,"PACMA",0
15,"15045",4178,2743,2727,22,16,"PACMA",5
26,"26095",126,102,102,0,0,"PACMA",0
39,"39002",3400,2554,2514,35,40,"PACMA",9
27,"27047",1851,1293,1273,16,20,"PACMA",3
49,"49206",948,706,692,15,14,"PACMA",0
26,"26140",268,213,207,2,6,"PACMA",0
32,"32092",596,367,364,2,3,"PACMA",0
3,"3018",11899,8855,8720,119,135,"PACMA",36
37,"37222",124,92,92,2,0,"PACMA",0
37,"37336",54,49,47,0,2,"PACMA",0
29,"29007",25572,17726,17564,227,162,"PACMA",77
36,"36051",14288,10228,10079,124,149,"PACMA",53
50,"50132",697,544,536,11,8,"PACMA",4
15,"15018",1211,821,805,11,16,"PACMA",0
10,"10109",1834,1307,1287,18,20,"PACMA",3
24,"24079",1045,721,710,15,11,"PACMA",0
47,"47044",325,257,252,1,5,"PACMA",2
5,"5177",164,134,133,0,1,"PACMA",0
25,"25155",714,490,485,8,5,"PACMA",1
10,"10110",2326,1751,1703,11,48,"PACMA",4
50,"50219",3704,2672,2625,39,47,"PACMA",20
3,"3019",14914,12087,11927,137,160,"PACMA",60
37,"37337",140,122,121,0,1,"PACMA",0
44,"44185",117,91,90,0,1,"PACMA",0
37,"37224",216,190,186,5,4,"PACMA",0
36,"36052",7517,5563,5461,54,102,"PACMA",19
47,"47045",839,636,632,3,4,"PACMA",2
9,"9211",1489,1137,1121,28,16,"PACMA",5
27,"27050",3236,2475,2438,11,37,"PACMA",3
16,"16012",102,81,80,0,1,"PACMA",0
19,"19232",89,68,67,0,1,"PACMA",0
46,"46182",1190,864,855,11,9,"PACMA",8
33,"33071",671,528,523,4,5,"PACMA",2
9,"9483",226,173,171,4,2,"PACMA",0
10,"10111",1453,1052,1046,13,6,"PACMA",2
37,"37225",119,101,95,3,6,"PACMA",0
48,"48037",727,528,519,2,9,"PACMA",3
5,"5147",174,141,135,4,6,"PACMA",0
34,"34902",146,121,121,1,0,"PACMA",0
39,"39057",2298,1735,1719,17,16,"PACMA",4
7,"7051",4925,2993,2947,66,46,"PACMA",26
19,"19018",189,145,138,2,7,"PACMA",0
18,"18029",1892,1355,1347,6,8,"PACMA",1
11,"11008",16655,11309,11189,184,120,"PACMA",45
24,"24082",877,698,690,13,8,"PACMA",0
50,"50221",38,20,20,0,0,"PACMA",0
47,"47210",396,324,321,5,3,"PACMA",0
9,"9077",38,26,25,0,1,"PACMA",0
37,"37226",167,129,127,1,2,"PACMA",0
28,"28057",1419,1084,1074,12,10,"PACMA",4
9,"9485",62,56,56,0,0,"PACMA",0
19,"19019",23,18,18,0,0,"PACMA",0
33,"33003",737,475,471,6,4,"PACMA",0
9,"9215",426,290,287,1,3,"PACMA",4
44,"44062",38,34,34,0,0,"PACMA",0
42,"42078",1110,829,817,15,12,"PACMA",0
49,"49081",1457,1166,1141,17,25,"PACMA",3
16,"16015",407,311,311,4,0,"PACMA",0
16,"16905",1017,811,806,14,5,"PACMA",2
3,"3023",1425,1259,1233,11,26,"PACMA",3
25,"25158",1647,1154,1135,27,19,"PACMA",6
48,"48072",1009,796,787,3,9,"PACMA",1
37,"37265",224,192,191,1,1,"PACMA",0
3,"3124",482,420,415,7,5,"PACMA",1
12,"12060",467,367,353,2,14,"PACMA",0
34,"34904",355,247,241,3,6,"PACMA",0
2,"2003",129078,98135,97009,1430,1126,"PACMA",532
16,"16016",258,178,178,1,0,"PACMA",0
11,"11010",6452,4534,4510,61,24,"PACMA",2
50,"50137",1119,842,834,12,8,"PACMA",1
2,"2004",654,554,544,7,10,"PACMA",1
25,"25223",951,562,546,14,16,"PACMA",5
6,"6010",1144,903,898,6,5,"PACMA",1
3,"3125",340,276,275,2,1,"PACMA",2
5,"5084",81,70,69,0,1,"PACMA",0
36,"36057",236900,168990,166060,2833,2930,"PACMA",1087
9,"9217",389,273,270,8,3,"PACMA",0
47,"47049",94,71,71,1,0,"PACMA",0
5,"5085",35,34,34,0,0,"PACMA",0
39,"39086",386,282,280,1,2,"PACMA",0
44,"44065",60,40,40,0,0,"PACMA",0
33,"33074",3699,2643,2611,30,32,"PACMA",3
46,"46112",582,475,463,4,12,"PACMA",0
6,"6103",4777,3702,3671,31,31,"PACMA",16
18,"18134",5528,3751,3679,57,72,"PACMA",14
37,"37118",141,115,114,3,1,"PACMA",0
47,"47213",122,99,99,1,0,"PACMA",0
3,"3025",1252,1054,1044,4,10,"PACMA",1
44,"44194",128,92,89,1,3,"PACMA",0
10,"10118",306,262,261,2,1,"PACMA",0
45,"45155",481,382,375,3,7,"PACMA",0
6,"6149",10390,8354,8215,111,139,"PACMA",17
44,"44066",121,88,86,0,2,"PACMA",0
16,"16909",737,590,585,9,5,"PACMA",2
44,"44195",103,71,70,0,1,"PACMA",1
19,"19238",42,32,31,1,1,"PACMA",0
25,"25164",404,270,264,5,6,"PACMA",1
48,"48075",1915,1362,1325,15,37,"PACMA",5
39,"39087",43561,33709,33242,404,467,"PACMA",101
9,"9905",432,313,309,1,4,"PACMA",3
16,"16019",252,210,207,2,3,"PACMA",1
3,"3027",150,131,130,1,1,"PACMA",0
18,"18035",1254,991,982,7,9,"PACMA",1
24,"24089",106265,77385,76124,1666,1261,"PACMA",310
6,"6150",860,722,710,2,12,"PACMA",1
10,"10119",714,489,482,3,7,"PACMA",1
50,"50901",170,122,121,1,1,"PACMA",0
9,"9355",117,88,87,1,1,"PACMA",0
9,"9085",486,348,339,8,9,"PACMA",2
22,"22052",997,776,769,15,7,"PACMA",1
49,"49173",430,272,272,5,0,"PACMA",1
24,"24170",2006,1410,1394,14,16,"PACMA",2
24,"24090",366,225,224,2,1,"PACMA",1
46,"46114",565,501,495,3,6,"PACMA",0
48,"48077",3398,2490,2477,33,13,"PACMA",13
16,"16022",102,76,76,2,0,"PACMA",0
50,"50141",116,98,98,1,0,"PACMA",0
9,"9356",57,38,37,1,1,"PACMA",0
22,"22205",472,369,363,5,6,"PACMA",0
37,"37347",481,374,371,6,3,"PACMA",4
35,"35004",35462,18498,18196,325,302,"PACMA",102
24,"24091",704,502,496,8,6,"PACMA",0
39,"39011",1646,1295,1294,5,1,"PACMA",3
39,"39089",163,126,126,0,0,"PACMA",0
3,"3029",260,191,186,0,5,"PACMA",0
9,"9907",1385,1053,1041,31,12,"PACMA",3
28,"28110",1912,1492,1475,8,17,"PACMA",4
33,"33077",1351,938,931,7,7,"PACMA",2
47,"47134",186,155,149,2,6,"PACMA",0
13,"13017",307,230,226,0,4,"PACMA",2
6,"6154",2830,2108,2080,38,28,"PACMA",6
44,"44199",52,40,39,0,1,"PACMA",0
10,"10122",253,197,191,2,6,"PACMA",1
19,"19027",185,140,138,1,2,"PACMA",0
37,"37236",163,123,119,4,4,"PACMA",0
11,"11015",59476,38207,37898,501,309,"PACMA",199
9,"9908",509,328,321,5,7,"PACMA",1
48,"48079",470,391,391,2,0,"PACMA",0
9,"9360",37,29,29,0,0,"PACMA",0
49,"49227",295,238,237,5,1,"PACMA",0
22,"22055",347,291,289,5,2,"PACMA",1
19,"19211",450,340,334,0,6,"PACMA",0
30,"30042",1841,1531,1519,10,12,"PACMA",4
45,"45198",1950,1661,1641,9,20,"PACMA",2
45,"45161",11339,7989,7869,95,120,"PACMA",68
15,"15029",6266,4668,4618,49,50,"PACMA",8
37,"37350",452,368,364,5,4,"PACMA",0
26,"26113",35,31,31,1,0,"PACMA",0
37,"37238",102,77,76,0,1,"PACMA",0
6,"6020",1852,1476,1462,5,14,"PACMA",5
19,"19143",1610,1287,1268,9,19,"PACMA",6
18,"18038",1097,906,900,3,6,"PACMA",1
45,"45052",2793,2247,2212,38,35,"PACMA",9
37,"37083",190,165,165,3,0,"PACMA",1
46,"46044",4301,3284,3169,50,115,"PACMA",15
27,"27066",12908,9554,9329,171,225,"PACMA",51
16,"16026",104,79,79,1,0,"PACMA",0
37,"37125",243,184,180,3,4,"PACMA",0
18,"18141",484,326,325,1,1,"PACMA",0
45,"45162",773,599,594,3,5,"PACMA",0
45,"45053",8208,6763,6663,103,100,"PACMA",18
21,"21029",1633,1276,1259,15,17,"PACMA",2
24,"24217",144,108,107,2,1,"PACMA",0
9,"9362",219,185,184,2,1,"PACMA",0
24,"24016",544,323,322,4,1,"PACMA",0
38,"38005",5327,3316,3270,38,46,"PACMA",11
5,"5126",78,70,70,0,0,"PACMA",1
46,"46045",1288,1065,1044,2,21,"PACMA",2
24,"24176",336,267,261,3,6,"PACMA",0
50,"50146",211,168,167,4,1,"PACMA",0
28,"28001",61,46,45,1,1,"PACMA",0
50,"50057",1468,1022,1004,17,18,"PACMA",1
9,"9094",49,39,39,0,0,"PACMA",0
40,"40076",6641,4958,4862,67,96,"PACMA",25
46,"46191",1952,1554,1528,9,26,"PACMA",6
37,"37277",58,39,38,1,1,"PACMA",0
40,"40170",1383,1091,1072,11,19,"PACMA",1
48,"48083",7021,4722,4656,74,66,"PACMA",32
13,"13055",738,585,578,8,7,"PACMA",1
3,"3136",484,393,386,1,7,"PACMA",1
49,"49232",95,78,78,1,0,"PACMA",1
24,"24097",244,161,156,4,5,"PACMA",1
50,"50147",845,637,627,12,10,"PACMA",0
44,"44205",757,541,527,12,14,"PACMA",1
37,"37006",157,108,107,0,1,"PACMA",0
25,"25076",165,84,83,3,1,"PACMA",1
6,"6025",5083,3898,3851,51,47,"PACMA",8
18,"18042",425,344,342,2,2,"PACMA",1
37,"37241",172,135,134,1,1,"PACMA",0
2,"2016",600,471,468,5,3,"PACMA",0
48,"48084",23491,15322,15084,213,238,"PACMA",105
5,"5096",74,56,56,0,0,"PACMA",0
47,"47220",194,143,142,4,1,"PACMA",0
12,"12073",168,135,135,1,0,"PACMA",2
28,"28066",7033,5439,5383,45,56,"PACMA",22
50,"50148",365,256,251,2,5,"PACMA",0
28,"28115",57612,46786,46458,458,328,"PACMA",139
37,"37007",467,368,363,6,5,"PACMA",1
6,"6901",2113,1729,1706,26,23,"PACMA",5
34,"34132",128,103,102,2,1,"PACMA",0
35,"35010",3565,2178,2135,26,43,"PACMA",7
22,"22062",189,126,125,2,1,"PACMA",1
47,"47141",148,121,119,1,2,"PACMA",0
37,"37355",187,142,140,2,2,"PACMA",0
11,"11021",6838,5102,5049,67,53,"PACMA",10
6,"6902",1688,1325,1313,21,12,"PACMA",1
28,"28003",196,154,151,2,3,"PACMA",4
25,"25078",1014,730,719,17,11,"PACMA",4
5,"5097",525,378,373,4,5,"PACMA",0
37,"37356",90,66,66,1,0,"PACMA",1
24,"24223",2793,2121,2113,63,8,"PACMA",7
3,"3004",624,497,486,7,11,"PACMA",3
36,"36004",10264,7383,7263,80,120,"PACMA",20
28,"28067",3893,2996,2950,26,46,"PACMA",8
39,"39096",719,521,518,4,3,"PACMA",0
32,"32005",957,760,753,8,7,"PACMA",1
49,"49101",186,134,129,0,5,"PACMA",1
13,"13026",482,387,384,1,3,"PACMA",1
47,"47059",108,77,76,1,1,"PACMA",0
3,"3140",26223,19998,19552,338,446,"PACMA",96
50,"50150",716,430,427,10,3,"PACMA",1
25,"25173",1784,1177,1139,20,38,"PACMA",4
16,"16034",207,174,173,0,1,"PACMA",0
5,"5099",555,472,466,4,6,"PACMA",0
48,"48087",463,371,370,4,1,"PACMA",0
32,"32006",1814,1344,1330,20,14,"PACMA",4
12,"12042",664,549,530,5,19,"PACMA",0
46,"46195",1975,1631,1631,33,0,"PACMA",2
37,"37246",5430,4363,4315,63,48,"PACMA",7
6,"6030",171,132,131,0,1,"PACMA",0
44,"44088",32,31,31,1,0,"PACMA",0
25,"25174",438,289,283,4,6,"PACMA",0
32,"32080",394,311,309,3,2,"PACMA",1
22,"22221",108,70,69,5,1,"PACMA",0
25,"25912",899,643,640,6,3,"PACMA",5
40,"40131",48,41,41,0,0,"PACMA",0
50,"50237",103,76,75,0,1,"PACMA",0
49,"49238",289,233,231,3,2,"PACMA",0
50,"50062",1750,1298,1275,22,23,"PACMA",9
10,"10135",1366,1004,998,3,6,"PACMA",1
24,"24103",330,180,177,0,3,"PACMA",0
48,"48089",2878,2120,2089,19,31,"PACMA",19
28,"28048",489,398,389,3,9,"PACMA",2
6,"6031",490,387,385,8,2,"PACMA",1
34,"34012",368,277,275,9,2,"PACMA",0
9,"9374",96,85,81,3,4,"PACMA",0
49,"49239",723,506,495,12,11,"PACMA",0
16,"16038",50,40,40,0,0,"PACMA",0
50,"50238",114,82,80,0,2,"PACMA",0
26,"26125",2720,2121,2084,26,37,"PACMA",3
45,"45062",1161,959,928,8,31,"PACMA",2
35,"35014",9943,5438,5316,95,122,"PACMA",18
22,"22069",436,317,315,5,2,"PACMA",1
44,"44212",45,35,35,0,0,"PACMA",0
37,"37135",1234,972,961,8,11,"PACMA",1
10,"10014",1907,1507,1488,14,19,"PACMA",2
5,"5102",1850,1487,1475,11,12,"PACMA",1
37,"37249",48,36,36,0,0,"PACMA",0
50,"50064",469,377,373,5,4,"PACMA",0
49,"49107",160,113,111,2,2,"PACMA",0
44,"44213",60,48,48,0,0,"PACMA",0
39,"39099",2987,2416,2391,28,25,"PACMA",6
49,"49241",275,225,221,2,4,"PACMA",0
28,"28902",453,338,329,3,9,"PACMA",2
19,"19222",120,90,89,3,1,"PACMA",1
9,"9239",52,42,42,1,0,"PACMA",0
25,"25085",153,103,100,2,3,"PACMA",0
5,"5103",84,68,68,3,0,"PACMA",0
3,"3904",1416,1104,1096,11,8,"PACMA",7
32,"32010",457,362,356,0,6,"PACMA",0
28,"28071",77,57,55,0,2,"PACMA",0
22,"22074",311,227,219,5,8,"PACMA",2
50,"50154",129,98,97,1,1,"PACMA",0
50,"50240",1127,799,783,25,16,"PACMA",1
9,"9108",399,287,283,5,4,"PACMA",4
11,"11027",67042,43386,43065,557,321,"PACMA",289
37,"37251",137,98,93,3,5,"PACMA",0
37,"37137",114,87,87,3,0,"PACMA",0
18,"18151",276,191,188,0,3,"PACMA",0
47,"47011",600,493,489,4,4,"PACMA",2
42,"42162",2482,1871,1850,23,21,"PACMA",7
46,"46077",7637,5979,5845,64,134,"PACMA",19
39,"39101",328,251,247,5,4,"PACMA",1
15,"15040",2891,2160,2129,18,31,"PACMA",5
50,"50241",634,462,455,2,7,"PACMA",0
37,"37252",127,92,92,0,0,"PACMA",0
18,"18049",632,476,474,5,2,"PACMA",0
22,"22075",150,103,101,7,2,"PACMA",0
37,"37139",199,167,163,1,4,"PACMA",1
22,"22227",225,172,168,3,4,"PACMA",0
5,"5105",349,275,272,12,3,"PACMA",2
9,"9380",85,71,71,1,0,"PACMA",0
45,"45176",3570,2619,2583,45,36,"PACMA",29
50,"50156",234,186,183,2,3,"PACMA",0
28,"28008",1734,1244,1221,11,23,"PACMA",7
24,"24902",375,292,289,1,3,"PACMA",3
7,"7008",5422,3782,3705,61,77,"PACMA",20
18,"18152",1037,822,818,9,4,"PACMA",0
6,"6039",1848,1564,1546,13,18,"PACMA",2
29,"29074",818,631,630,3,1,"PACMA",2
22,"22229",127,93,89,4,4,"PACMA",2
34,"34020",63,44,44,0,0,"PACMA",0
24,"24109",1098,672,663,12,9,"PACMA",1
7,"7009",744,593,576,11,17,"PACMA",10
9,"9288",98,80,80,1,0,"PACMA",0
12,"12083",106,89,88,0,1,"PACMA",0
44,"44097",158,97,95,1,2,"PACMA",0
47,"47065",898,762,752,9,10,"PACMA",1
24,"24110",1291,914,904,16,10,"PACMA",1
40,"40001",713,575,562,10,13,"PACMA",0
45,"45068",164,135,133,1,2,"PACMA",1
42,"42115",72,48,48,0,0,"PACMA",0
44,"44099",724,519,511,4,8,"PACMA",3
16,"16171",1930,1616,1584,25,32,"PACMA",1
48,"48096",6607,5007,4900,54,107,"PACMA",24
37,"37019",157,114,113,0,1,"PACMA",0
12,"12084",17219,12059,11911,165,148,"PACMA",50
49,"49066",531,392,386,2,6,"PACMA",0
24,"24112",323,230,228,0,2,"PACMA",0
28,"28074",136617,106248,105095,1101,1153,"PACMA",430
37,"37367",218,182,176,0,6,"PACMA",4
5,"5108",64,41,41,0,0,"PACMA",1
34,"34147",192,139,137,1,2,"PACMA",0
37,"37255",58,47,47,3,0,"PACMA",0
6,"6042",1017,824,820,5,4,"PACMA",0
19,"19161",243,171,166,2,5,"PACMA",2
47,"47230",318,266,259,2,7,"PACMA",0
10,"10022",442,377,370,1,7,"PACMA",0
48,"48097",1359,936,915,9,21,"PACMA",6
49,"49249",78,63,63,0,0,"PACMA",0
46,"46202",15578,11811,11676,110,135,"PACMA",70
9,"9114",88,75,73,0,2,"PACMA",0
19,"19260",44,41,41,1,0,"PACMA",0
37,"37369",143,103,103,0,0,"PACMA",0
49,"49115",191,151,149,3,2,"PACMA",0
48,"48901",4370,3156,3124,46,32,"PACMA",18
25,"25003",3853,2367,2340,68,27,"PACMA",6
46,"46154",836,684,678,7,6,"PACMA",3
47,"47068",41,28,28,0,0,"PACMA",0
29,"29004",343,281,281,0,0,"PACMA",0
50,"50245",121,80,80,1,0,"PACMA",1
10,"10146",1439,991,975,11,16,"PACMA",3
29,"29033",1385,878,868,4,10,"PACMA",0
48,"48065",3311,2340,2323,23,17,"PACMA",8
25,"25183",485,336,327,6,9,"PACMA",3
37,"37257",52,43,43,0,0,"PACMA",0
19,"19049",19,11,11,0,0,"PACMA",0
42,"42119",192,124,123,0,1,"PACMA",0
19,"19261",42,31,31,1,0,"PACMA",0
49,"49117",505,376,369,5,7,"PACMA",1
25,"25004",553,405,400,13,5,"PACMA",1
10,"10107",1062,832,821,7,11,"PACMA",1
50,"50161",124,86,86,1,0,"PACMA",0
2,"2032",323,261,259,1,2,"PACMA",1
49,"49251",191,157,154,7,3,"PACMA",0
44,"44103",128,95,95,0,0,"PACMA",0
47,"47178",190,162,161,1,1,"PACMA",0
26,"26183",65,54,54,0,0,"PACMA",0
24,"24037",429,282,277,4,5,"PACMA",0
28,"28012",830,654,651,6,3,"PACMA",1
7,"7014",6697,3818,3757,38,61,"PACMA",21
46,"46010",927,706,699,3,7,"PACMA",2
19,"19091",30,22,22,2,0,"PACMA",0
37,"37259",44,32,32,3,0,"PACMA",0
29,"29006",721,516,508,5,8,"PACMA",0
48,"48903",1909,1455,1430,4,25,"PACMA",9
40,"40007",86,70,69,0,1,"PACMA",0
9,"9164",179,130,130,1,0,"PACMA",0
5,"5012",156,134,132,1,2,"PACMA",0
35,"35022",43892,27289,26876,326,413,"PACMA",112
48,"48001",5842,4040,4020,23,20,"PACMA",25
37,"37373",793,591,589,4,2,"PACMA",0
26,"26141",132,101,101,2,0,"PACMA",0
28,"28078",39,23,23,1,0,"PACMA",0
9,"9390",645,522,518,9,4,"PACMA",0
11,"11034",2381,1807,1784,19,23,"PACMA",2
6,"6049",1088,847,829,3,18,"PACMA",2
15,"15047",2606,1789,1761,33,28,"PACMA",2
10,"10028",125,88,88,0,0,"PACMA",0
13,"13040",933,755,744,4,11,"PACMA",0
37,"37025",264,217,216,1,1,"PACMA",0
48,"48905",2600,1903,1869,14,34,"PACMA",5
2,"2035",1988,1601,1586,19,15,"PACMA",5
39,"39030",1971,1397,1379,20,18,"PACMA",6
26,"26143",187,154,151,4,3,"PACMA",2
2,"2036",104,78,78,0,0,"PACMA",0
50,"50074",6516,4378,4222,77,156,"PACMA",23
32,"32022",1591,1219,1207,9,12,"PACMA",1
45,"45076",603,420,419,3,1,"PACMA",2
37,"37262",81,66,64,2,2,"PACMA",0
25,"25189",2085,1348,1327,38,21,"PACMA",10
6,"6050",4277,3500,3457,36,43,"PACMA",5
32,"32023",1360,1030,1011,6,19,"PACMA",3
5,"5014",5559,4197,4101,53,96,"PACMA",7
10,"10152",499,424,418,4,6,"PACMA",0
28,"28126",59,37,37,0,0,"PACMA",0
44,"44021",114,81,77,1,4,"PACMA",0
42,"42075",91,71,70,1,1,"PACMA",0
26,"26101",46,35,34,0,1,"PACMA",1
34,"34157",2471,1936,1912,26,24,"PACMA",9
19,"19265",157,102,101,0,1,"PACMA",0
24,"24120",379,258,256,3,2,"PACMA",0
37,"37375",764,636,627,19,9,"PACMA",0
11,"11036",725,484,482,10,2,"PACMA",0
24,"24003",725,528,520,8,8,"PACMA",0
37,"37028",175,130,125,1,5,"PACMA",0
46,"46134",2326,1691,1664,20,27,"PACMA",22
24,"24121",645,511,502,10,9,"PACMA",2
46,"46207",6453,5086,5031,52,55,"PACMA",17
37,"37376",2373,1720,1700,23,20,"PACMA",2
45,"45189",655,510,502,3,8,"PACMA",5
32,"32024",5054,3668,3609,40,59,"PACMA",10
5,"5015",100,78,78,0,0,"PACMA",0
19,"19266",278,234,231,4,3,"PACMA",0
12,"12093",254,190,187,0,3,"PACMA",1
44,"44110",57,45,45,0,0,"PACMA",0
37,"37377",268,209,208,1,1,"PACMA",0
50,"50251",8379,6225,6116,110,109,"PACMA",17
25,"25191",353,234,227,5,7,"PACMA",1
45,"45190",502,425,414,6,11,"PACMA",0
26,"26146",141,98,96,0,2,"PACMA",0
15,"15078",78092,56506,55597,1110,909,"PACMA",229
46,"46062",4589,3794,3752,46,42,"PACMA",15
5,"5117",213,183,180,0,3,"PACMA",0
26,"26020",506,372,364,10,8,"PACMA",2
42,"42129",706,523,509,14,14,"PACMA",2
9,"9396",152,113,113,0,0,"PACMA",1
50,"50167",235,191,184,1,7,"PACMA",0
16,"16188",106,76,76,0,0,"PACMA",0
46,"46209",1984,1606,1594,11,12,"PACMA",3
13,"13012",475,322,318,1,4,"PACMA",0
9,"9127",54,39,39,0,0,"PACMA",0
5,"5118",91,66,66,0,0,"PACMA",0
6,"6055",2105,1623,1599,13,24,"PACMA",2
3,"3057",232,179,178,0,1,"PACMA",0
37,"37379",167,128,125,4,3,"PACMA",1
15,"15051",4780,3333,3289,61,44,"PACMA",14
24,"24007",798,582,566,2,16,"PACMA",4
39,"39034",289,209,209,3,0,"PACMA",0
32,"32027",1156,850,836,15,14,"PACMA",3
5,"5017",87,69,68,1,1,"PACMA",0
6,"6057",575,481,474,2,7,"PACMA",0
27,"27057",11297,8174,8005,162,169,"PACMA",32
46,"46137",273,232,229,1,3,"PACMA",0
19,"19269",103,84,83,0,1,"PACMA",0
28,"28017",1120,905,888,8,17,"PACMA",3
19,"19059",84,60,60,0,0,"PACMA",0
45,"45192",2549,2178,2155,39,23,"PACMA",2
26,"26149",67,50,49,1,1,"PACMA",1
45,"45082",1333,1143,1123,14,20,"PACMA",3
25,"25011",5241,3127,3080,48,47,"PACMA",11
24,"24125",545,374,373,5,1,"PACMA",1
32,"32029",557,426,424,1,2,"PACMA",0
44,"44114",254,194,188,4,6,"PACMA",1
11,"11040",411,317,309,0,8,"PACMA",1
47,"47159",862,704,695,20,9,"PACMA",2
37,"37156",4319,3280,3233,28,47,"PACMA",7
21,"21054",8024,6159,6072,67,87,"PACMA",11
5,"5019",44095,34409,33934,505,475,"PACMA",121
10,"10159",341,278,277,1,1,"PACMA",0
5,"5120",38,28,28,1,0,"PACMA",0
42,"42134",2626,1945,1896,36,49,"PACMA",5
44,"44235",103,71,68,0,3,"PACMA",0
37,"37382",202,172,171,3,1,"PACMA",1
16,"16192",54,37,37,1,0,"PACMA",0
9,"9130",87,72,71,0,1,"PACMA",1
15,"15054",32172,20472,20154,519,318,"PACMA",107
13,"13048",538,441,433,5,8,"PACMA",0
25,"25903",261,176,170,9,6,"PACMA",0
2,"2044",1207,908,893,5,15,"PACMA",1
46,"46041",369,255,255,1,0,"PACMA",0
49,"49088",90,67,66,3,1,"PACMA",0
44,"44116",96,68,65,3,3,"PACMA",0
37,"37158",262,181,179,0,2,"PACMA",0
19,"19061",76,57,55,3,2,"PACMA",0
19,"19271",53,45,45,1,0,"PACMA",0
18,"18170",377,238,237,0,1,"PACMA",0
18,"18068",1456,1105,1088,13,17,"PACMA",3
49,"49267",101,77,77,1,0,"PACMA",0
3,"3061",1052,842,836,6,6,"PACMA",8
9,"9010",35,27,27,1,0,"PACMA",0
5,"5218",148,123,117,1,6,"PACMA",0
16,"16063",97,81,81,0,0,"PACMA",0
13,"13050",533,427,421,3,6,"PACMA",0
11,"11042",1232,933,922,4,11,"PACMA",1
5,"5122",156,124,124,0,0,"PACMA",0
28,"28019",1195,901,888,5,13,"PACMA",4
29,"29090",1805,1265,1260,5,5,"PACMA",2
37,"37272",162,121,120,1,1,"PACMA",2
19,"19272",86,67,65,1,2,"PACMA",0
11,"11901",5576,4433,4398,69,35,"PACMA",7
48,"48915",362,273,271,2,2,"PACMA",0
5,"5123",90,69,69,3,0,"PACMA",0
7,"7026",30036,16912,16661,294,251,"PACMA",100
24,"24131",813,583,580,9,3,"PACMA",0
25,"25200",353,225,217,4,8,"PACMA",1
24,"24132",683,440,435,5,5,"PACMA",0
46,"46067",1798,1487,1472,10,15,"PACMA",4
25,"25014",264,170,164,11,6,"PACMA",1
16,"16195",545,436,433,6,3,"PACMA",0
47,"47001",51,44,42,2,2,"PACMA",0
19,"19176",280,216,216,0,0,"PACMA",0
10,"10164",770,557,547,2,10,"PACMA",0
37,"37273",115,83,83,1,0,"PACMA",0
5,"5253",95,75,74,0,1,"PACMA",1
40,"40025",158,124,124,0,0,"PACMA",0
33,"33032",12060,8627,8491,107,136,"PACMA",12
42,"42144",464,343,331,3,12,"PACMA",0
50,"50258",54,37,37,0,0,"PACMA",0
3,"3064",4976,4098,4058,26,40,"PACMA",14
46,"46214",15129,11609,11500,116,109,"PACMA",49
49,"49135",687,485,475,3,10,"PACMA",2
6,"6065",327,262,259,2,3,"PACMA",0
32,"32035",1632,1100,1088,8,12,"PACMA",3
2,"2012",1834,1632,1622,12,10,"PACMA",3
37,"37275",136,98,98,0,0,"PACMA",0
49,"49003",896,650,647,11,3,"PACMA",4
37,"37163",44,36,36,0,0,"PACMA",1
50,"50259",89,53,53,1,0,"PACMA",0
21,"21059",203,166,162,1,4,"PACMA",0
40,"40168",36,27,27,0,0,"PACMA",0
25,"25109",279,183,183,2,0,"PACMA",2
26,"26160",684,538,528,5,10,"PACMA",2
42,"42145",140,111,111,2,0,"PACMA",1
24,"24136",596,465,463,12,2,"PACMA",2
16,"16198",1451,1126,1105,21,21,"PACMA",0
18,"18107",988,769,760,3,9,"PACMA",0
5,"5256",119,101,100,0,1,"PACMA",0
45,"45016",3804,2926,2876,52,50,"PACMA",14
3,"3066",42697,31279,30833,566,446,"PACMA",188
35,"35034",6372,2951,2921,33,30,"PACMA",11
37,"37276",188,136,135,0,1,"PACMA",0
46,"46215",1451,1185,1169,8,16,"PACMA",3
16,"16068",143,117,116,6,1,"PACMA",0
12,"12103",85,65,65,4,0,"PACMA",0
25,"25169",201,134,134,6,0,"PACMA",0
45,"45201",3439,2353,2317,31,36,"PACMA",22
46,"46094",20341,15367,15222,152,145,"PACMA",65
10,"10087",1754,1283,1262,4,21,"PACMA",1
9,"9411",174,104,103,1,1,"PACMA",0
27,"27023",2770,2196,2178,30,18,"PACMA",3
15,"15059",10658,7889,7728,125,161,"PACMA",18
18,"18072",710,507,499,2,8,"PACMA",0
45,"45202",3876,3037,2984,13,53,"PACMA",10
47,"47004",1261,1047,1031,11,16,"PACMA",0
22,"22109",243,178,178,2,0,"PACMA",2
48,"48017",13554,9303,9234,64,69,"PACMA",22
25,"25019",4626,2971,2932,54,39,"PACMA",11
24,"24139",2320,1687,1654,16,33,"PACMA",2
21,"21061",5089,3657,3635,33,22,"PACMA",1
25,"25111",116,70,70,0,0,"PACMA",1
40,"40172",34,27,26,0,1,"PACMA",0
50,"50002",166,130,130,2,0,"PACMA",0
5,"5128",361,288,280,3,8,"PACMA",1
42,"42004",2383,1776,1740,30,36,"PACMA",5
9,"9139",104,84,80,3,4,"PACMA",0
13,"13056",10945,8173,8070,111,103,"PACMA",35
37,"37044",461,363,360,1,3,"PACMA",0
47,"47005",578,467,455,5,12,"PACMA",3
16,"16072",161,126,123,0,3,"PACMA",0
25,"25204",1313,888,881,21,7,"PACMA",0
48,"48019",3741,2613,2595,24,18,"PACMA",13
10,"10171",376,287,282,0,5,"PACMA",0
39,"39043",1321,1082,1072,8,10,"PACMA",7
46,"46218",1082,964,936,5,28,"PACMA",4
37,"37167",164,140,132,6,8,"PACMA",0
37,"37280",84,64,64,0,0,"PACMA",0
3,"3069",2830,2009,1979,22,30,"PACMA",11
36,"36003",9876,7155,7007,100,148,"PACMA",24
19,"19074",81,69,69,0,0,"PACMA",0
22,"22907",1444,1034,1018,12,16,"PACMA",1
9,"9140",136,110,110,1,0,"PACMA",0
32,"32040",1587,1226,1219,7,7,"PACMA",6
33,"33036",11674,8695,8605,104,90,"PACMA",11
16,"16033",1792,1485,1454,10,31,"PACMA",8
5,"5064",117,94,93,4,1,"PACMA",0
24,"24143",515,376,373,6,3,"PACMA",1
5,"5227",409,307,305,2,2,"PACMA",0
13,"13058",4155,3320,3285,24,35,"PACMA",7
25,"25114",102,82,78,4,4,"PACMA",0
37,"37047",178,111,111,0,0,"PACMA",0
19,"19283",40,33,33,0,0,"PACMA",0
44,"44249",58,40,40,1,0,"PACMA",0
22,"22114",137,94,94,4,0,"PACMA",0
45,"45096",1021,800,778,5,22,"PACMA",0
37,"37282",238,169,168,3,1,"PACMA",0
44,"44127",79,62,61,0,1,"PACMA",0
3,"3071",3993,3180,3128,40,52,"PACMA",8
50,"50179",269,230,229,2,1,"PACMA",0
25,"25079",307,242,240,7,2,"PACMA",1
26,"26167",66,51,51,2,0,"PACMA",0
33,"33038",2442,1757,1725,14,32,"PACMA",4
32,"32042",1784,1292,1282,13,10,"PACMA",2
26,"26168",5055,3534,3484,47,50,"PACMA",27
9,"9416",61,44,44,0,0,"PACMA",0
42,"42100",31,31,31,0,0,"PACMA",0
19,"19285",26,20,20,2,0,"PACMA",0
37,"37049",163,119,119,0,0,"PACMA",0
9,"9144",61,51,50,0,1,"PACMA",0
9,"9417",43,38,38,0,0,"PACMA",0
26,"26039",44,38,36,1,2,"PACMA",0
7,"7036",25502,17151,16914,294,237,"PACMA",212
40,"40223",241,190,190,2,0,"PACMA",2
40,"40037",47,35,35,0,0,"PACMA",0
19,"19078",58,49,48,0,1,"PACMA",0
19,"19153",25,17,17,0,0,"PACMA",0
9,"9279",195,140,140,4,0,"PACMA",0
2,"2058",390,290,285,0,5,"PACMA",0
44,"44129",44,34,33,0,1,"PACMA",0
49,"49147",301,243,239,4,4,"PACMA",1
34,"34181",471,350,346,7,4,"PACMA",1
40,"40180",319,259,255,3,4,"PACMA",0
25,"25208",294,174,170,3,4,"PACMA",0
50,"50266",139,95,94,1,1,"PACMA",0
44,"44130",38,27,27,0,0,"PACMA",0
34,"34182",860,657,649,8,8,"PACMA",4
18,"18083",296,242,242,1,0,"PACMA",0
29,"29100",2442,1834,1824,14,10,"PACMA",1
47,"47089",184,139,138,1,1,"PACMA",0
44,"44131",26,20,20,0,0,"PACMA",0
5,"5134",47,37,37,0,0,"PACMA",0
48,"48024",1026,845,841,3,4,"PACMA",1
6,"6079",623,525,522,6,3,"PACMA",0
34,"34184",54,37,36,0,1,"PACMA",0
46,"46076",651,541,528,2,13,"PACMA",1
9,"9280",34,23,23,0,0,"PACMA",0
37,"37052",274,213,212,1,1,"PACMA",0
21,"21068",1009,726,721,10,5,"PACMA",1
9,"9149",37,25,25,0,0,"PACMA",0
26,"26042",852,660,651,11,9,"PACMA",3
46,"46222",378,321,310,1,11,"PACMA",1
42,"42014",83,55,55,1,0,"PACMA",0
50,"50268",59,46,46,3,0,"PACMA",0
49,"49150",169,129,126,0,3,"PACMA",0
15,"15067",8142,6054,5978,73,76,"PACMA",28
3,"3076",8373,6319,6222,68,97,"PACMA",34
37,"37054",273,230,229,2,1,"PACMA",3
25,"25210",1164,799,789,13,10,"PACMA",0
24,"24150",262,182,182,3,0,"PACMA",1
42,"42015",34,24,24,5,0,"PACMA",0
7,"7039",4920,3488,3377,54,111,"PACMA",13
6,"6082",373,315,311,3,4,"PACMA",0
48,"48059",397,289,286,0,3,"PACMA",0
50,"50296",417,313,310,6,3,"PACMA",1
42,"42058",129,103,101,1,2,"PACMA",0
38,"38016",1250,664,646,3,18,"PACMA",1
45,"45102",3539,2581,2533,23,48,"PACMA",5
32,"32048",1004,687,671,48,16,"PACMA",1
10,"10180",5446,3957,3917,28,40,"PACMA",9
50,"50125",421,284,280,1,4,"PACMA",0
46,"46223",7685,6040,5996,62,44,"PACMA",15
25,"25029",1766,1145,1118,38,27,"PACMA",3
13,"13065",3011,2105,2088,24,17,"PACMA",2
47,"47012",134,105,105,0,0,"PACMA",0
13,"13066",2444,2094,2065,15,29,"PACMA",3
46,"46005",22815,17016,16838,185,178,"PACMA",91
49,"49153",183,141,139,1,2,"PACMA",0
32,"32049",863,566,563,7,3,"PACMA",2
46,"46078",28197,20643,20415,205,228,"PACMA",116
38,"38018",4397,3216,3163,27,53,"PACMA",14
15,"15069",7019,5036,4938,85,98,"PACMA",20
50,"50009",122,93,93,0,0,"PACMA",0
47,"47013",118,97,97,2,0,"PACMA",0
2,"2064",413,350,348,7,2,"PACMA",3
25,"25122",1956,1281,1256,33,25,"PACMA",7
45,"45104",457,375,370,2,5,"PACMA",1
40,"40186",50,33,33,0,0,"PACMA",0
11,"11001",4389,3110,3072,13,38,"PACMA",0
46,"46103",1244,998,972,12,26,"PACMA",1
19,"19290",872,622,613,7,9,"PACMA",7
49,"49021",14682,10495,10296,194,199,"PACMA",26
32,"32051",1574,1296,1290,7,6,"PACMA",1
24,"24031",220,180,176,3,4,"PACMA",0
16,"16087",229,193,187,4,6,"PACMA",0
26,"26047",2076,1702,1682,17,20,"PACMA",3
44,"44011",67,47,47,0,0,"PACMA",0
7,"7043",3522,2384,2345,35,39,"PACMA",9
28,"28030",1591,1268,1230,12,38,"PACMA",7
24,"24154",1068,803,795,6,8,"PACMA",1
3,"3079",18028,14580,14317,189,263,"PACMA",86
2,"2029",3210,2512,2481,37,31,"PACMA",10
12,"12115",234,184,183,2,1,"PACMA",0
48,"48030",626,487,483,0,4,"PACMA",0
9,"9425",561,431,418,3,13,"PACMA",0
28,"28031",1981,1524,1500,9,24,"PACMA",0
50,"50187",72,45,45,1,0,"PACMA",0
21,"21073",1840,1249,1236,13,13,"PACMA",1
10,"10184",771,609,597,7,12,"PACMA",0
47,"47176",229,157,157,0,0,"PACMA",0
19,"19293",1860,1407,1373,16,34,"PACMA",14
24,"24155",524,428,420,6,8,"PACMA",1
5,"5237",198,157,155,3,2,"PACMA",0
26,"26179",49,39,36,0,3,"PACMA",0
9,"9294",123,96,93,1,3,"PACMA",0
29,"29032",6673,5204,5140,43,64,"PACMA",6
18,"18188",1659,1329,1308,9,21,"PACMA",1
40,"40190",50,41,40,1,1,"PACMA",0
10,"10063",175,142,142,1,0,"PACMA",0
37,"37060",229,179,173,2,6,"PACMA",3
24,"24114",3441,2322,2304,42,18,"PACMA",6
40,"40191",265,191,190,1,1,"PACMA",1
25,"25152",160,92,90,4,2,"PACMA",0
19,"19089",33,22,22,1,0,"PACMA",0
42,"42022",253,177,171,2,6,"PACMA",0
2,"2031",626,507,502,3,5,"PACMA",0
12,"12087",22,20,20,0,0,"PACMA",0
1,"1013",711,477,474,1,3,"PACMA",4
16,"16227",128,95,94,0,1,"PACMA",0
26,"26181",14,12,12,0,0,"PACMA",0
34,"34201",212,178,172,1,6,"PACMA",1
18,"18189",723,547,541,6,6,"PACMA",1
16,"16228",202,146,144,2,2,"PACMA",0
33,"33045",4692,3347,3297,42,50,"PACMA",10
25,"25217",10570,6660,6500,191,160,"PACMA",32
37,"37062",92,73,73,1,0,"PACMA",0
5,"5044",301,217,217,3,0,"PACMA",0
10,"10065",188,123,123,1,0,"PACMA",0
45,"45109",3030,2507,2417,30,90,"PACMA",6
16,"16009",79,63,62,0,1,"PACMA",0
37,"37221",465,360,353,0,7,"PACMA",0
3,"3017",380,331,324,7,7,"PACMA",1
44,"44144",326,233,227,7,6,"PACMA",1
28,"28148",79726,60405,59651,724,754,"PACMA",308
5,"5143",81,61,61,0,0,"PACMA",0
24,"24198",644,423,417,7,6,"PACMA",0
49,"49160",54,35,34,3,1,"PACMA",0
42,"42173",28809,20268,19748,632,520,"PACMA",71
16,"16231",47,43,43,0,0,"PACMA",0
42,"42025",1305,964,945,15,19,"PACMA",0
45,"45147",598,484,478,9,6,"PACMA",2
19,"19334",50,37,37,0,0,"PACMA",0
3,"3119",15887,12128,11988,122,140,"PACMA",47
46,"46107",1998,1650,1623,8,27,"PACMA",6
44,"44268",30,25,25,0,0,"PACMA",1
36,"36018",3492,2516,2494,25,22,"PACMA",9
47,"47179",408,315,306,6,9,"PACMA",1
47,"47018",33,30,28,2,2,"PACMA",0
45,"45111",65,47,44,1,3,"PACMA",1
2,"2071",1053,899,895,5,4,"PACMA",0
10,"10068",780,624,595,5,29,"PACMA",3
25,"25219",144,90,86,0,4,"PACMA",1
36,"36019",1681,1204,1188,14,16,"PACMA",2
7,"7049",1482,1046,1037,14,9,"PACMA",3
46,"46011",7727,5874,5777,75,97,"PACMA",24
29,"29036",670,504,499,4,5,"PACMA",2
39,"39056",2387,1857,1835,22,22,"PACMA",7
49,"49164",158,120,114,2,6,"PACMA",0
9,"9167",60,49,49,2,0,"PACMA",0
10,"10191",527,421,414,3,7,"PACMA",5
44,"44147",439,320,314,14,6,"PACMA",0
46,"46230",14204,10650,10515,112,135,"PACMA",43
47,"47098",607,496,492,9,4,"PACMA",2
37,"37068",386,291,287,6,4,"PACMA",0
30,"30008",13289,9992,9849,86,143,"PACMA",35
48,"48036",23973,16491,16344,179,147,"PACMA",76
42,"42176",30,22,22,0,0,"PACMA",0
45,"45003",607,515,511,3,4,"PACMA",0
34,"34206",952,796,780,9,16,"PACMA",1
16,"16013",24,23,23,0,0,"PACMA",0
18,"18061",1109,882,869,1,13,"PACMA",1
40,"40012",280,215,213,2,2,"PACMA",0
34,"34071",186,160,160,1,0,"PACMA",0
46,"46085",11344,8526,8426,87,100,"PACMA",12
10,"10193",1410,1179,1158,16,21,"PACMA",4
9,"9434",1167,916,902,24,14,"PACMA",6
16,"16238",560,484,479,3,5,"PACMA",0
36,"36021",11798,8742,8574,136,168,"PACMA",39
5,"5049",440,335,330,8,5,"PACMA",1
24,"24163",3706,2760,2714,57,46,"PACMA",9
32,"32060",885,650,641,10,9,"PACMA",2
6,"6098",537,436,435,6,1,"PACMA",0
37,"37301",78,58,58,0,0,"PACMA",0
25,"25037",396,275,273,9,2,"PACMA",0
45,"45004",603,497,494,6,3,"PACMA",3
5,"5180",109,92,91,1,1,"PACMA",0
9,"9350",502,384,376,7,8,"PACMA",0
48,"48038",1087,826,821,7,5,"PACMA",1
29,"29038",16309,10579,10494,152,85,"PACMA",46
24,"24164",397,215,213,2,2,"PACMA",0
33,"33049",6806,4629,4581,70,48,"PACMA",12
47,"47021",84,61,61,2,0,"PACMA",0
50,"50106",137,107,106,0,1,"PACMA",0
37,"37071",90,80,80,1,0,"PACMA",0
27,"27054",1332,1063,1054,12,9,"PACMA",1
2,"2076",371,292,287,3,5,"PACMA",0
9,"9438",547,440,433,9,7,"PACMA",2
46,"46014",3092,2449,2420,26,29,"PACMA",13
50,"50280",370,296,291,5,5,"PACMA",0
42,"42031",31,19,19,0,0,"PACMA",0
45,"45116",682,576,565,0,11,"PACMA",0
26,"26104",18,16,16,0,0,"PACMA",0
29,"29039",2822,2091,2074,8,17,"PACMA",4
44,"44024",24,19,19,0,0,"PACMA",0
46,"46087",137,105,105,1,0,"PACMA",0
49,"49035",260,231,229,4,2,"PACMA",0
10,"10197",143,96,94,1,2,"PACMA",0
9,"9043",215,151,151,1,0,"PACMA",0
34,"34213",67,50,50,0,0,"PACMA",0
22,"22004",146,97,97,2,0,"PACMA",1
3,"3091",256,220,219,1,1,"PACMA",0
22,"22144",258,203,203,5,0,"PACMA",0
10,"10076",825,619,610,7,9,"PACMA",0
46,"46015",7042,5644,5581,53,63,"PACMA",28
37,"37191",127,86,85,1,1,"PACMA",0
47,"47158",906,716,710,10,6,"PACMA",4
49,"49170",111,87,85,1,2,"PACMA",1
13,"13079",12220,9665,9502,177,163,"PACMA",16
37,"37305",206,153,152,4,1,"PACMA",0
5,"5152",737,618,609,5,9,"PACMA",1
25,"25224",144,93,91,6,2,"PACMA",3
9,"9044",54,45,45,1,0,"PACMA",0
46,"46161",1454,1192,1179,8,13,"PACMA",3
10,"10077",719,551,543,3,8,"PACMA",1
19,"19204",168,129,126,2,3,"PACMA",0
46,"46234",388,308,307,3,1,"PACMA",2
18,"18904",858,620,612,3,8,"PACMA",0
45,"45009",588,430,422,2,8,"PACMA",0
48,"48042",1401,1116,1099,15,17,"PACMA",3
9,"9045",283,196,196,4,0,"PACMA",1
46,"46235",21966,16641,16465,167,176,"PACMA",58
49,"49172",594,389,383,0,6,"PACMA",0
13,"13080",418,310,309,1,1,"PACMA",0
36,"36026",20494,14048,13798,232,250,"PACMA",75
9,"9046",41,30,30,0,0,"PACMA",0
40,"40206",179,136,134,0,2,"PACMA",2
24,"24169",3205,2317,2282,33,35,"PACMA",8
39,"39062",1759,1397,1387,9,10,"PACMA",0
47,"47024",283,211,210,1,1,"PACMA",0
16,"16245",430,338,329,2,9,"PACMA",1
9,"9310",14,10,9,2,1,"PACMA",0
40,"40020",200,155,149,2,6,"PACMA",0
28,"28040",15089,9976,9852,116,124,"PACMA",35
13,"13082",25643,17973,17798,257,175,"PACMA",60
25,"25226",257,162,158,5,4,"PACMA",1
46,"46236",996,853,844,7,9,"PACMA",1
24,"24051",484,375,368,2,7,"PACMA",0
42,"42037",38,23,20,3,3,"PACMA",0
2,"2081",18319,14324,14096,225,228,"PACMA",57
15,"15026",2025,1426,1413,17,13,"PACMA",1
19,"19209",50,40,39,0,1,"PACMA",0
44,"44029",637,495,490,6,5,"PACMA",1
34,"34217",1089,866,849,19,17,"PACMA",6
26,"26066",277,229,228,9,1,"PACMA",3
45,"45011",316,271,268,1,3,"PACMA",0
24,"24171",417,231,231,2,0,"PACMA",0
29,"29043",2596,1670,1647,24,23,"PACMA",3
13,"13083",2529,1837,1795,26,42,"PACMA",8
47,"47187",101,82,81,1,1,"PACMA",1
42,"42038",42,32,31,3,1,"PACMA",0
22,"22156",256,209,203,5,6,"PACMA",1
5,"5252",70,52,51,0,1,"PACMA",0
18,"18906",955,736,731,5,5,"PACMA",0
38,"38035",8172,4990,4919,62,71,"PACMA",28
36,"36029",16178,11902,11636,148,266,"PACMA",54
13,"13084",973,800,793,6,7,"PACMA",0
2,"2083",246,215,215,0,0,"PACMA",0
45,"45123",2961,2081,2049,30,32,"PACMA",17
9,"9178",61,48,48,0,0,"PACMA",0
16,"16249",2076,1728,1700,11,28,"PACMA",4
32,"32069",4573,3624,3580,35,44,"PACMA",9
50,"50285",635,452,445,8,7,"PACMA",0
37,"37081",1000,807,800,5,7,"PACMA",1
37,"37311",251,210,209,8,1,"PACMA",0
28,"28087",3150,2475,2453,26,22,"PACMA",9
27,"27018",3871,2523,2489,32,34,"PACMA",4
29,"29045",1750,1246,1239,6,7,"PACMA",2
40,"40120",173,145,144,1,1,"PACMA",0
10,"10124",873,707,707,16,0,"PACMA",2
5,"5157",256,187,183,0,4,"PACMA",0
37,"37312",278,232,229,1,3,"PACMA",0
44,"44159",47,43,43,0,0,"PACMA",0
24,"24054",492,359,351,1,8,"PACMA",0
18,"18908",827,669,660,7,9,"PACMA",0
9,"9180",132,97,95,8,2,"PACMA",0
9,"9315",362,267,265,9,2,"PACMA",6
40,"40073",425,371,367,3,4,"PACMA",0
47,"47189",164,134,134,1,0,"PACMA",0
50,"50287",298,214,211,10,3,"PACMA",1
10,"10206",237,177,174,0,3,"PACMA",0
10,"10085",334,244,243,1,1,"PACMA",0
19,"19212",795,644,632,2,12,"PACMA",2
45,"45125",2407,1977,1949,22,28,"PACMA",7
40,"40074",271,221,218,3,3,"PACMA",2
40,"40122",551,417,414,9,3,"PACMA",4
5,"5159",287,216,216,0,0,"PACMA",0
46,"46239",457,331,323,2,8,"PACMA",2
37,"37314",79,61,61,3,0,"PACMA",0
26,"26071",8475,6088,5964,92,124,"PACMA",36
40,"40123",168,130,126,3,4,"PACMA",0
19,"19279",66,56,56,0,0,"PACMA",0
45,"45090",396,335,333,0,2,"PACMA",0
34,"34086",105,89,89,1,0,"PACMA",1
42,"42044",62,47,46,0,1,"PACMA",0
15,"15086",3110,2281,2259,30,22,"PACMA",5
50,"50203",1083,814,798,28,16,"PACMA",9
50,"50028",120,86,85,2,1,"PACMA",0
22,"22162",135,107,107,3,0,"PACMA",0
19,"19214",94,78,78,2,0,"PACMA",0
16,"16112",1562,1159,1140,12,19,"PACMA",2
33,"33011",12085,7186,7116,89,70,"PACMA",4
12,"12003",1058,830,813,15,17,"PACMA",1
49,"49181",386,308,307,2,1,"PACMA",0
9,"9365",38,27,27,0,0,"PACMA",0
30,"30018",7493,6003,5922,52,81,"PACMA",32
50,"50289",71,59,59,0,0,"PACMA",0
49,"49047",120,91,90,1,1,"PACMA",1
44,"44037",483,349,344,10,5,"PACMA",3
6,"6161",335,261,259,2,2,"PACMA",1
13,"13088",649,531,526,3,5,"PACMA",0
15,"15032",3639,2642,2586,35,56,"PACMA",6
36,"36034",3684,2686,2651,32,35,"PACMA",12
26,"26074",128,102,101,0,1,"PACMA",0
49,"49050",558,382,375,3,7,"PACMA",0
34,"34224",53,42,41,0,1,"PACMA",0
50,"50117",131,101,100,1,1,"PACMA",0
29,"29049",3137,2365,2352,19,13,"PACMA",3
18,"18109",607,461,456,1,5,"PACMA",2
45,"45019",7033,5207,5110,89,97,"PACMA",19
3,"3102",7346,5827,5751,39,76,"PACMA",18
28,"28090",7899,6216,6131,60,85,"PACMA",31
9,"9450",31,26,26,1,0,"PACMA",0
19,"19318",36,19,19,1,0,"PACMA",0
21,"21002",14281,10297,10173,141,124,"PACMA",40
37,"37088",208,173,172,4,1,"PACMA",0
9,"9057",155,125,124,0,1,"PACMA",1
3,"3103",288,248,243,2,5,"PACMA",0
40,"40078",180,143,143,1,0,"PACMA",0
30,"30020",5989,4533,4487,14,46,"PACMA",8
12,"12136",2663,2325,2284,33,41,"PACMA",5
37,"37204",286,216,214,0,2,"PACMA",0
25,"25141",171,111,107,2,4,"PACMA",0
24,"24060",660,382,382,0,0,"PACMA",0
40,"40079",236,174,171,0,3,"PACMA",0
42,"42050",29,20,20,1,0,"PACMA",0
9,"9189",146,101,99,2,2,"PACMA",0
28,"28046",4208,3297,3272,31,25,"PACMA",17
35,"35011",23140,15550,15320,199,230,"PACMA",61
6,"6119",680,539,534,3,5,"PACMA",1
45,"45021",2399,1834,1804,23,30,"PACMA",9
25,"25238",231,158,156,1,2,"PACMA",2
50,"50291",112,75,73,0,2,"PACMA",0
37,"37090",59,54,50,0,4,"PACMA",0
47,"47194",322,244,233,1,11,"PACMA",1
5,"5164",34,24,24,0,0,"PACMA",0
24,"24181",1652,1303,1288,12,15,"PACMA",5
16,"16118",1454,1221,1211,19,10,"PACMA",3
9,"9326",156,119,114,2,5,"PACMA",1
3,"3105",5322,4218,4124,34,94,"PACMA",16
47,"47195",449,350,346,5,4,"PACMA",0
50,"50032",330,233,228,3,5,"PACMA",0
33,"33060",15694,11036,10883,112,153,"PACMA",31
50,"50207",126,97,95,1,2,"PACMA",1
45,"45133",2803,2241,2199,18,42,"PACMA",3
38,"38045",4181,2176,2140,13,36,"PACMA",3
42,"42204",64,49,44,4,5,"PACMA",0
12,"12138",18762,12489,12231,243,258,"PACMA",67
46,"46025",2495,1962,1941,24,21,"PACMA",4
3,"3106",642,542,535,3,7,"PACMA",1
24,"24182",448,339,333,9,6,"PACMA",1
10,"10094",247,212,211,0,1,"PACMA",0
5,"5165",386,292,280,7,12,"PACMA",1
33,"33061",446,260,259,1,1,"PACMA",2
49,"49056",324,251,247,3,4,"PACMA",0
28,"28183",935,663,649,7,14,"PACMA",4
19,"19185",40,21,19,0,2,"PACMA",0
22,"22023",474,382,380,4,2,"PACMA",0
18,"18115",2380,1843,1823,14,20,"PACMA",2
6,"6077",373,307,304,4,3,"PACMA",0
47,"47196",43,29,29,0,0,"PACMA",0
27,"27031",16169,11446,11214,194,232,"PACMA",63
16,"16121",270,211,207,1,4,"PACMA",2
47,"47035",956,778,768,5,10,"PACMA",0
32,"32081",2240,1698,1682,13,16,"PACMA",3
19,"19003",50,36,35,1,1,"PACMA",1
22,"22173",247,150,150,3,0,"PACMA",0
50,"50063",76,67,67,0,0,"PACMA",0
16,"16212",286,229,226,3,3,"PACMA",0
5,"5264",68,48,48,1,0,"PACMA",1
47,"47117",306,231,228,4,3,"PACMA",0
45,"45025",1237,919,907,11,12,"PACMA",5
46,"46100",307,264,255,0,9,"PACMA",0
27,"27033",723,536,529,10,7,"PACMA",2
38,"38047",1819,1269,1239,12,30,"PACMA",8
25,"25146",227,150,149,0,1,"PACMA",0
49,"49059",111,83,82,2,1,"PACMA",0
24,"24185",512,414,402,3,12,"PACMA",1
5,"5069",91,79,78,1,1,"PACMA",0
3,"3110",294,239,238,0,1,"PACMA",0
16,"16123",110,74,73,1,1,"PACMA",0
10,"10218",1184,896,893,0,3,"PACMA",1
50,"50295",54,42,41,0,1,"PACMA",0
27,"27034",1297,871,867,3,4,"PACMA",6
28,"28094",774,557,551,5,6,"PACMA",5
40,"40087",112,85,83,0,2,"PACMA",0
5,"5265",87,68,66,2,2,"PACMA",0
47,"47118",159,122,122,2,0,"PACMA",0
27,"27035",194,119,119,0,0,"PACMA",1
10,"10219",1408,984,971,11,13,"PACMA",1
10,"10098",412,317,313,5,4,"PACMA",1
42,"42057",197,133,133,6,0,"PACMA",0
16,"16001",79,66,66,1,0,"PACMA",0
50,"50124",474,375,367,11,8,"PACMA",0
5,"5169",241,218,218,0,0,"PACMA",0
37,"37327",191,148,148,9,0,"PACMA",0
50,"50065",59,37,37,2,0,"PACMA",0
16,"16166",277,210,202,0,8,"PACMA",0
45,"45101",3761,3212,3181,19,31,"PACMA",4
9,"9464",44,28,28,0,0,"PACMA",0
19,"19119",93,80,79,2,1,"PACMA",0
10,"10099",633,458,450,4,8,"PACMA",0
25,"25148",232,144,144,5,0,"PACMA",0
6,"6037",1789,1258,1252,6,6,"PACMA",1
44,"44047",267,162,160,4,2,"PACMA",0
9,"9065",152,137,137,1,0,"PACMA",0
46,"46102",19880,15358,15179,122,179,"PACMA",58
13,"13098",2265,1805,1759,19,46,"PACMA",3
37,"37100",89,77,76,4,1,"PACMA",0
21,"21010",14308,8960,8861,154,99,"PACMA",33
19,"19224",119,95,94,0,1,"PACMA",0
16,"16126",811,701,692,13,9,"PACMA",1
47,"47200",91,73,73,0,0,"PACMA",0
42,"42212",75,45,45,2,0,"PACMA",0
10,"10903",813,620,615,3,5,"PACMA",1
9,"9335",62,52,51,1,1,"PACMA",0
3,"3113",4154,3295,3251,24,44,"PACMA",18
16,"16128",70,64,64,2,0,"PACMA",1
24,"24190",183,134,131,1,3,"PACMA",1
21,"21011",3531,2672,2639,15,33,"PACMA",8
26,"26006",1853,1456,1430,15,26,"PACMA",4
48,"48095",2367,1593,1577,20,16,"PACMA",8
37,"37102",430,323,322,1,1,"PACMA",0
46,"46176",1965,1423,1405,12,18,"PACMA",8
19,"19121",277,219,217,0,2,"PACMA",0
42,"42061",297,190,188,4,2,"PACMA",0
29,"29058",1560,1103,1096,5,7,"PACMA",4
48,"48062",317,263,262,1,1,"PACMA",0
25,"25245",445,312,306,4,6,"PACMA",2
1,"1057",266,212,212,2,0,"PACMA",0
40,"40093",88,77,72,0,5,"PACMA",0
3,"3115",267,242,242,2,0,"PACMA",2
42,"42215",821,561,545,19,16,"PACMA",2
9,"9068",25,19,19,2,0,"PACMA",0
16,"16275",15,12,12,0,0,"PACMA",0
48,"48063",355,287,287,6,0,"PACMA",0
50,"50215",21,20,19,0,1,"PACMA",0
38,"38053",3752,2459,2397,28,62,"PACMA",8
50,"50039",580,450,446,3,4,"PACMA",0
5,"5172",147,122,122,0,0,"PACMA",0
16,"16130",633,504,492,5,12,"PACMA",1
13,"13903",564,461,454,2,7,"PACMA",0
9,"9246",662,469,457,3,12,"PACMA",2
39,"39078",1407,1041,1033,10,8,"PACMA",2
25,"25248",926,615,601,17,14,"PACMA",5
13,"13904",556,448,441,14,7,"PACMA",1
26,"26092",112,89,88,2,1,"PACMA",0
27,"27043",1422,988,962,10,26,"PACMA",2
34,"34104",274,224,224,4,0,"PACMA",1
19,"19331",2497,1898,1847,19,51,"PACMA",10
38,"38901",1389,917,907,16,10,"PACMA",4
49,"49068",523,356,353,5,3,"PACMA",0
34,"34241",20,12,11,0,1,"PACMA",0
42,"42021",101,70,70,1,0,"PACMA",0
29,"29077",225,157,157,1,0,"PACMA",0
33,"33022",992,709,696,12,13,"PACMA",1
27,"27044",3089,2167,2125,31,42,"PACMA",7
46,"46178",4406,3235,3201,22,34,"PACMA",17
50,"50013",244,195,195,1,0,"PACMA",0
26,"26180",243,185,181,4,4,"PACMA",0
6,"6136",1621,1300,1283,11,17,"PACMA",0
44,"44182",216,173,173,4,0,"PACMA",0
5,"5175",190,149,149,2,0,"PACMA",0
9,"9340",72,41,41,0,0,"PACMA",0
45,"45145",2430,1866,1821,13,45,"PACMA",9
22,"22040",155,129,127,3,2,"PACMA",0
45,"45034",1375,1108,1079,18,29,"PACMA",5
24,"24197",784,570,564,7,6,"PACMA",2
48,"48066",350,277,277,0,0,"PACMA",0
18,"18158",10328,7336,7254,69,82,"PACMA",17
22,"22188",100,68,66,3,2,"PACMA",1
50,"50042",16,14,14,0,0,"PACMA",0
44,"44223",80,55,55,0,0,"PACMA",0
50,"50014",169,108,108,1,0,"PACMA",0
40,"40193",231,188,185,6,3,"PACMA",0
3,"3118",2368,1746,1718,16,28,"PACMA",4
16,"16134",4283,3398,3361,59,37,"PACMA",10
44,"44183",78,49,46,0,3,"PACMA",0
7,"7047",2161,1447,1407,31,40,"PACMA",14
44,"44055",85,63,62,2,1,"PACMA",0
15,"15017",18860,12975,12737,325,238,"PACMA",80
22,"22041",175,138,138,1,0,"PACMA",1
6,"6001",730,546,538,4,8,"PACMA",1
45,"45184",219,150,148,3,2,"PACMA",4
37,"37260",175,122,122,1,0,"PACMA",0
19,"19263",34,27,27,0,0,"PACMA",0
50,"50072",181,128,127,1,1,"PACMA",1
19,"19230",438,317,309,4,8,"PACMA",5
29,"29063",358,272,271,2,1,"PACMA",1
9,"9346",95,83,83,1,0,"PACMA",0
1,"1063",1803,1290,1284,18,6,"PACMA",7
46,"46181",17153,13332,13184,108,148,"PACMA",40
16,"16135",192,127,125,0,2,"PACMA",0
28,"28170",2503,1744,1727,20,17,"PACMA",8
9,"9480",106,87,87,0,0,"PACMA",0
49,"49077",210,146,144,1,2,"PACMA",1
9,"9074",735,558,547,7,11,"PACMA",2
45,"45038",3125,2401,2374,33,27,"PACMA",16
45,"45148",340,256,256,1,0,"PACMA",0
34,"34156",56,48,48,2,0,"PACMA",0
9,"9347",136,113,109,5,4,"PACMA",0
33,"33002",10837,7667,7588,77,79,"PACMA",21
33,"33070",3481,2557,2521,33,36,"PACMA",9
40,"40105",60,51,51,1,0,"PACMA",0
49,"49078",209,173,172,1,1,"PACMA",2
47,"47127",150,110,108,0,2,"PACMA",0
45,"45149",638,542,533,2,9,"PACMA",0
46,"46109",6143,4731,4637,40,94,"PACMA",19
16,"16902",165,128,126,1,2,"PACMA",0
19,"19017",87,70,70,0,0,"PACMA",0
34,"34112",50,39,38,2,1,"PACMA",0
9,"9038",123,92,92,0,0,"PACMA",0
37,"37187",567,449,448,3,1,"PACMA",1
29,"29037",227,170,170,0,0,"PACMA",0
27,"27052",966,726,718,9,8,"PACMA",3
13,"13009",1573,1265,1255,6,10,"PACMA",1
5,"5082",569,467,462,1,5,"PACMA",3
45,"45150",471,388,382,1,6,"PACMA",2
24,"24203",109,73,73,0,0,"PACMA",0
9,"9124",1598,1151,1129,19,22,"PACMA",5
25,"25064",122,91,88,7,3,"PACMA",0
3,"3123",7435,5860,5744,63,116,"PACMA",25
24,"24205",995,719,712,9,7,"PACMA",1
42,"42076",237,185,179,6,6,"PACMA",1
29,"29066",363,263,260,1,3,"PACMA",0
45,"45041",3617,2672,2635,21,37,"PACMA",14
44,"44191",806,602,594,6,8,"PACMA",1
22,"22087",85,56,55,4,1,"PACMA",0
34,"34033",17,15,15,0,0,"PACMA",0
16,"16014",659,534,528,8,6,"PACMA",0
28,"28058",137542,103880,102686,1155,1194,"PACMA",579
37,"37340",155,121,121,0,0,"PACMA",1
45,"45152",653,503,497,2,6,"PACMA",2
46,"46038",368,264,260,1,4,"PACMA",1
47,"47047",217,171,170,5,1,"PACMA",0
33,"33072",1737,1171,1159,11,12,"PACMA",0
44,"44230",154,127,127,3,0,"PACMA",0
37,"37029",226,181,178,4,3,"PACMA",0
22,"22199",7259,4980,4861,128,119,"PACMA",26
45,"45042",184,154,151,3,3,"PACMA",0
50,"50048",43,33,33,1,0,"PACMA",0
6,"6009",214,178,178,2,0,"PACMA",0
36,"36056",5087,3883,3830,37,53,"PACMA",14
46,"46135",9634,7671,7586,64,85,"PACMA",29
47,"47211",45,38,38,1,0,"PACMA",0
46,"46039",2200,1849,1820,12,29,"PACMA",7
28,"28059",4061,3169,3130,38,39,"PACMA",12
19,"19133",103,89,88,2,1,"PACMA",0
27,"27055",1494,1120,1107,8,13,"PACMA",0
40,"40110",391,303,302,6,1,"PACMA",0
44,"44193",99,71,67,0,4,"PACMA",0
24,"24207",320,274,272,5,2,"PACMA",0
37,"37230",221,173,171,0,2,"PACMA",0
15,"15023",6629,4879,4795,52,84,"PACMA",13
37,"37343",56,42,40,0,2,"PACMA",0
24,"24124",419,286,282,0,4,"PACMA",1
10,"10116",3762,2781,2705,36,76,"PACMA",10
15,"15024",4726,3634,3555,51,79,"PACMA",8
16,"16145",508,421,417,6,4,"PACMA",0
25,"25069",471,291,289,9,2,"PACMA",1
39,"39008",13716,10396,10274,129,122,"PACMA",42
6,"6011",24301,17977,17819,268,158,"PACMA",67
5,"5086",96,81,81,2,0,"PACMA",0
5,"5183",165,142,140,0,2,"PACMA",0
16,"16146",96,74,70,0,4,"PACMA",1
37,"37344",259,212,211,5,1,"PACMA",0
42,"42081",158,131,131,3,0,"PACMA",0
19,"19135",120,102,100,2,2,"PACMA",0
46,"46040",1227,1028,1021,13,7,"PACMA",0
45,"45046",2455,1884,1862,11,22,"PACMA",2
46,"46113",2338,1804,1797,14,7,"PACMA",8
50,"50051",886,677,671,9,6,"PACMA",1
40,"40112",2346,1848,1798,35,50,"PACMA",4
18,"18135",4752,3252,3212,34,40,"PACMA",3
47,"47132",45,40,40,0,0,"PACMA",0
47,"47050",3557,2688,2651,50,37,"PACMA",18
16,"16910",104,69,69,1,0,"PACMA",0
16,"16020",20,15,15,0,0,"PACMA",0
36,"36059",5438,3874,3805,47,69,"PACMA",17
50,"50052",100,82,82,0,0,"PACMA",0
45,"45156",3528,2985,2924,19,61,"PACMA",3
24,"24211",291,226,224,3,2,"PACMA",0
40,"40113",438,330,322,4,8,"PACMA",0
22,"22204",1122,773,756,19,17,"PACMA",6
11,"11013",2284,1691,1670,15,21,"PACMA",2
16,"16148",634,553,547,5,6,"PACMA",2
13,"13015",5755,4334,4293,40,41,"PACMA",3
5,"5185",109,89,89,1,0,"PACMA",0
21,"21024",502,363,358,10,5,"PACMA",0
36,"36060",30264,21398,21051,344,347,"PACMA",89
40,"40162",420,320,314,1,6,"PACMA",0
21,"21025",3969,2731,2686,33,45,"PACMA",4
37,"37121",557,458,451,8,7,"PACMA",1
47,"47052",6207,4812,4761,79,51,"PACMA",27
11,"11014",16318,11093,11031,144,62,"PACMA",25
45,"45049",394,315,315,6,0,"PACMA",2
5,"5089",500,390,375,3,15,"PACMA",3
30,"30040",733,640,635,2,5,"PACMA",1
22,"22206",218,169,167,3,2,"PACMA",0
44,"44071",657,453,448,9,5,"PACMA",0
25,"25904",149,107,104,1,3,"PACMA",2
3,"3131",181,161,157,1,4,"PACMA",0
15,"15027",1537,1263,1242,22,21,"PACMA",3
45,"45196",1363,1092,1076,3,16,"PACMA",1
9,"9358",261,200,199,3,1,"PACMA",0
45,"45050",508,385,378,0,7,"PACMA",1
49,"49226",279,235,233,1,2,"PACMA",1
24,"24214",716,518,509,4,9,"PACMA",0
6,"6018",808,608,598,5,10,"PACMA",1
50,"50903",2234,1622,1597,35,25,"PACMA",6
22,"22054",1602,1040,982,42,58,"PACMA",21
16,"16151",66,56,56,0,0,"PACMA",0
6,"6155",1911,1384,1363,18,21,"PACMA",5
13,"13018",860,740,727,2,13,"PACMA",1
9,"9224",172,125,125,3,0,"PACMA",0
5,"5187",1833,1385,1361,16,24,"PACMA",3
2,"2011",730,612,610,3,2,"PACMA",0
11,"11902",3578,2400,2376,21,24,"PACMA",2
9,"9134",237,164,159,7,5,"PACMA",1
25,"25167",253,176,172,0,4,"PACMA",0
16,"16025",31,23,23,0,0,"PACMA",0
39,"39091",2026,1636,1628,14,8,"PACMA",1
28,"28178",1017,799,791,11,8,"PACMA",8
21,"21028",419,320,315,3,5,"PACMA",0
18,"18140",42971,28391,28126,335,265,"PACMA",88
47,"47054",673,545,541,8,4,"PACMA",0
37,"37002",152,90,89,1,1,"PACMA",0
34,"34127",118,77,74,1,3,"PACMA",0
49,"49229",134,99,99,2,0,"PACMA",0
25,"25016",2203,1375,1357,20,18,"PACMA",3
19,"19032",202,11,11,0,0,"PACMA",0
6,"6157",497,350,343,0,7,"PACMA",0
3,"3032",112,90,88,0,2,"PACMA",0
34,"34001",36,29,29,2,0,"PACMA",0
24,"24015",2391,1812,1782,20,30,"PACMA",3
44,"44076",2338,1839,1797,36,42,"PACMA",2
10,"10126",1660,1221,1201,9,20,"PACMA",3
37,"37126",36,26,26,0,0,"PACMA",0
42,"42090",96,75,74,3,1,"PACMA",0
40,"40028",106,89,88,1,1,"PACMA",0
9,"9052",40,31,31,1,0,"PACMA",0
36,"36032",3666,2789,2755,25,34,"PACMA",6
10,"10044",1520,1120,1103,10,17,"PACMA",3
5,"5190",61,48,48,3,0,"PACMA",0
45,"45163",8239,6203,6073,103,130,"PACMA",14
19,"19245",1222,954,943,10,11,"PACMA",0
25,"25075",122,85,83,0,2,"PACMA",0
10,"10127",4663,3554,3498,38,56,"PACMA",5
24,"24096",145,96,93,0,3,"PACMA",0
34,"34003",167,132,130,7,2,"PACMA",1
50,"50260",42,35,35,1,0,"PACMA",0
25,"25046",438,299,286,6,13,"PACMA",1
37,"37164",280,217,213,9,4,"PACMA",2
40,"40215",109,94,91,0,3,"PACMA",0
16,"16070",35,29,29,0,0,"PACMA",0
11,"11019",1871,1449,1425,9,24,"PACMA",2
37,"37005",92,65,65,0,0,"PACMA",0
45,"45055",1052,886,870,10,16,"PACMA",0
46,"46143",4278,3309,3266,46,43,"PACMA",21
42,"42093",56,39,38,0,1,"PACMA",0
9,"9138",92,77,74,0,3,"PACMA",0
3,"3034",1343,1140,1126,5,14,"PACMA",1
26,"26118",64,58,56,0,2,"PACMA",0
9,"9228",168,143,143,3,0,"PACMA",0
16,"16156",122,91,91,0,0,"PACMA",0
24,"24098",1251,837,819,19,18,"PACMA",8
24,"24221",850,635,619,6,16,"PACMA",0
11,"11020",163674,106898,106082,1655,816,"PACMA",418
22,"22215",137,90,90,1,0,"PACMA",1
34,"34131",67,57,56,0,1,"PACMA",0
39,"39016",24213,18549,18362,265,187,"PACMA",52
45,"45056",2246,1523,1502,16,21,"PACMA",11
9,"9098",553,416,410,11,6,"PACMA",0
47,"47058",199,157,157,3,0,"PACMA",1
24,"24222",13915,9939,9751,304,188,"PACMA",60
44,"44084",63,51,50,0,1,"PACMA",0
34,"34006",82,72,72,1,0,"PACMA",0
26,"26120",1515,1215,1198,20,17,"PACMA",1
24,"24099",199,164,162,0,2,"PACMA",0
19,"19216",143,112,105,2,7,"PACMA",0
40,"40127",45,33,33,0,0,"PACMA",0
48,"48086",2087,1432,1420,11,12,"PACMA",6
5,"5193",224,197,197,2,0,"PACMA",0
28,"28002",2650,2018,1993,24,25,"PACMA",4
45,"45058",409,334,332,2,2,"PACMA",2
37,"37130",177,153,153,2,0,"PACMA",0
24,"24100",760,563,553,14,10,"PACMA",4
32,"32041",884,576,568,2,8,"PACMA",0
28,"28137",1626,1231,1222,9,9,"PACMA",5
49,"49235",486,344,340,6,4,"PACMA",2
34,"34009",34,31,31,3,0,"PACMA",0
6,"6028",4366,3881,3809,35,72,"PACMA",10
25,"25911",472,306,296,2,10,"PACMA",1
5,"5194",147,131,130,4,1,"PACMA",1
21,"21034",1253,875,861,7,14,"PACMA",0
37,"37357",283,216,214,0,2,"PACMA",0
22,"22220",192,138,136,5,2,"PACMA",0
40,"40129",203,166,162,1,4,"PACMA",0
24,"24225",1089,798,784,15,14,"PACMA",0
37,"37132",398,317,311,3,6,"PACMA",0
40,"40130",139,106,106,4,0,"PACMA",2
7,"7035",1542,1190,1161,19,29,"PACMA",5
25,"25206",289,187,184,3,3,"PACMA",0
5,"5195",241,168,164,0,4,"PACMA",0
35,"35012",9662,5511,5446,45,65,"PACMA",13
3,"3901",1070,826,818,14,8,"PACMA",8
9,"9373",485,332,331,5,1,"PACMA",1
19,"19250",25,23,22,0,1,"PACMA",0
47,"47060",262,220,218,1,2,"PACMA",1
28,"28068",10502,7857,7778,68,79,"PACMA",37
24,"24102",701,536,530,3,6,"PACMA",1
36,"36006",11387,8911,8727,72,184,"PACMA",35
47,"47224",92,77,77,0,0,"PACMA",1
25,"25115",878,542,542,17,0,"PACMA",3
37,"37359",194,155,152,1,3,"PACMA",0
34,"34011",406,327,327,4,0,"PACMA",0
45,"45061",2523,1839,1813,20,26,"PACMA",6
15,"15036",60838,40345,39667,915,678,"PACMA",164
19,"19251",41,35,34,0,1,"PACMA",0
11,"11024",6811,5241,5202,58,39,"PACMA",6
44,"44089",57,50,49,0,1,"PACMA",1
44,"44211",39,32,32,2,0,"PACMA",0
46,"46196",159,145,144,1,1,"PACMA",0
22,"22222",510,367,365,6,2,"PACMA",2
37,"37360",252,194,194,1,0,"PACMA",0
26,"26040",67,63,62,2,1,"PACMA",0
5,"5196",69,54,54,2,0,"PACMA",1
37,"37012",155,124,120,1,4,"PACMA",0
5,"5197",114,98,98,1,0,"PACMA",0
19,"19042",41,32,32,0,0,"PACMA",0
46,"46051",8122,6432,6378,57,54,"PACMA",15
2,"2023",636,534,533,6,1,"PACMA",3
25,"25176",341,243,240,7,3,"PACMA",0
10,"10137",428,373,371,1,2,"PACMA",0
47,"47225",89,67,66,0,1,"PACMA",2
49,"49105",158,135,133,2,2,"PACMA",0
24,"24228",732,543,529,4,14,"PACMA",1
29,"29071",915,601,598,4,3,"PACMA",0
9,"9377",658,509,505,11,4,"PACMA",2
26,"26002",805,617,605,6,12,"PACMA",3
6,"6035",1048,879,871,5,8,"PACMA",4
37,"37362",4333,3276,3238,65,38,"PACMA",22
44,"44215",156,100,100,2,0,"PACMA",0
10,"10138",551,451,443,7,8,"PACMA",0
10,"10015",688,539,523,5,16,"PACMA",2
3,"3042",1337,1028,1019,8,9,"PACMA",148
19,"19254",57,50,50,0,0,"PACMA",1
47,"47063",107,87,87,2,0,"PACMA",0
40,"40136",130,106,106,1,0,"PACMA",0
28,"28119",1911,1527,1514,13,13,"PACMA",5
44,"44093",86,64,64,3,0,"PACMA",0
46,"46198",815,660,654,4,6,"PACMA",3
24,"24230",450,333,327,4,6,"PACMA",1
39,"39100",922,718,712,8,6,"PACMA",3
40,"40043",1842,1494,1469,28,25,"PACMA",2
34,"34058",212,179,178,0,1,"PACMA",0
9,"9064",353,277,277,6,0,"PACMA",0
37,"37055",132,112,107,2,5,"PACMA",0
29,"29902",2577,1689,1665,20,24,"PACMA",3
13,"13032",1218,926,922,9,4,"PACMA",0
10,"10140",1143,941,927,9,14,"PACMA",3
44,"44176",167,131,130,5,1,"PACMA",0
25,"25179",198,141,136,1,5,"PACMA",0
26,"26004",82,64,64,1,0,"PACMA",0
35,"35016",291589,181013,177964,2856,3049,"PACMA",918
50,"50066",2357,1677,1659,42,18,"PACMA",12
19,"19045",180,145,145,1,0,"PACMA",0
50,"50155",119,91,91,1,0,"PACMA",0
9,"9110",95,68,68,1,0,"PACMA",0
19,"19256",48,44,43,0,1,"PACMA",0
9,"9381",38,30,30,0,0,"PACMA",0
45,"45066",7334,5602,5536,52,66,"PACMA",14
16,"16169",75,44,44,0,0,"PACMA",1
42,"42111",310,228,222,2,6,"PACMA",1
33,"33019",3262,2283,2244,12,39,"PACMA",1
40,"40140",100,74,73,1,1,"PACMA",0
46,"46254",1085,847,834,12,13,"PACMA",1
46,"46054",11422,8666,8566,82,100,"PACMA",39
48,"48094",3299,2398,2377,15,21,"PACMA",7
24,"24153",253,201,199,4,2,"PACMA",0
30,"30002",9802,7628,7553,48,75,"PACMA",16
9,"9243",87,66,64,2,2,"PACMA",0
34,"34146",60,42,40,1,2,"PACMA",0
10,"10019",1414,1054,1037,10,17,"PACMA",7
5,"5201",557,444,437,2,7,"PACMA",0
13,"13067",380,314,312,3,2,"PACMA",0
18,"18153",8348,6170,6118,88,52,"PACMA",18
42,"42113",553,412,404,7,8,"PACMA",0
40,"40188",120,82,81,0,1,"PACMA",1
37,"37058",68,44,44,0,0,"PACMA",0
44,"44219",207,159,157,1,2,"PACMA",0
42,"42019",562,392,383,9,9,"PACMA",0
9,"9244",53,44,44,0,0,"PACMA",0
28,"28009",13466,10392,10286,102,106,"PACMA",52
46,"46128",1649,1322,1292,14,30,"PACMA",4
16,"16045",226,177,176,2,1,"PACMA",0
6,"6041",459,406,404,4,2,"PACMA",0
25,"25089",107,66,64,0,2,"PACMA",0
40,"40002",38,31,31,1,0,"PACMA",0
46,"46255",3135,2530,2508,11,22,"PACMA",13
10,"10144",999,782,773,7,9,"PACMA",1
44,"44013",11286,7797,7584,242,213,"PACMA",40
11,"11031",76347,49071,48616,681,455,"PACMA",323
40,"40143",97,72,72,0,0,"PACMA",0
42,"42116",63,50,48,3,2,"PACMA",0
42,"42117",146,115,111,1,4,"PACMA",1
19,"19259",37,32,32,0,0,"PACMA",0
7,"7011",26954,16786,16595,299,191,"PACMA",122
5,"5205",78,59,58,0,1,"PACMA",0
6,"6043",661,542,532,3,10,"PACMA",2
28,"28010",9309,7304,7229,71,75,"PACMA",29
50,"50159",728,554,544,4,10,"PACMA",0
50,"50040",98,77,76,2,1,"PACMA",0
42,"42168",128,82,81,4,1,"PACMA",3
50,"50098",215,150,146,2,4,"PACMA",0
37,"37021",86,70,68,2,2,"PACMA",0
25,"25092",135,100,97,2,3,"PACMA",3
11,"11032",53183,32205,31982,441,223,"PACMA",109
28,"28011",437,318,315,2,3,"PACMA",3
13,"13037",901,752,745,2,7,"PACMA",0
16,"16174",209,170,167,0,3,"PACMA",1
37,"37370",345,261,260,1,1,"PACMA",0
49,"49116",401,308,305,4,3,"PACMA",0
28,"28075",5127,3976,3916,42,60,"PACMA",32
37,"37022",287,237,232,0,5,"PACMA",0
34,"34152",142,114,109,1,5,"PACMA",0
5,"5008",244,200,196,1,4,"PACMA",0
47,"47069",128,108,108,0,0,"PACMA",0
13,"13071",41043,28435,28183,370,252,"PACMA",103
37,"37258",206,151,149,2,2,"PACMA",0
19,"19163",73,59,59,0,0,"PACMA",0
47,"47096",139,109,107,0,2,"PACMA",0
50,"50131",243,185,183,6,2,"PACMA",0
49,"49075",153,128,122,0,6,"PACMA",0
39,"39054",4265,3338,3276,57,62,"PACMA",14
34,"34027",1224,875,861,14,14,"PACMA",2
5,"5208",55,45,45,0,0,"PACMA",0
40,"40906",1793,1428,1405,32,23,"PACMA",6
28,"28076",417,325,321,1,4,"PACMA",0
22,"22236",266,213,213,3,0,"PACMA",0
2,"2033",1955,1565,1536,15,29,"PACMA",5
37,"37146",135,117,117,1,0,"PACMA",0
32,"32056",1861,1378,1369,8,9,"PACMA",1
36,"36017",18554,13573,13378,200,195,"PACMA",61
21,"21016",1076,823,790,11,33,"PACMA",1
48,"48067",1204,895,892,4,3,"PACMA",1
42,"42121",77,56,56,1,0,"PACMA",0
2,"2034",1419,1153,1146,18,7,"PACMA",1
40,"40149",563,446,434,9,12,"PACMA",3
18,"18057",5045,3755,3721,44,34,"PACMA",13
9,"9250",295,234,230,5,4,"PACMA",0
26,"26054",381,298,292,2,6,"PACMA",0
44,"44225",129,100,98,5,2,"PACMA",0
47,"47154",168,144,144,7,0,"PACMA",0
25,"25186",231,168,168,3,0,"PACMA",1
40,"40150",76,62,62,1,0,"PACMA",0
35,"35023",11640,8412,8178,97,234,"PACMA",20
24,"24001",241,148,147,3,1,"PACMA",0
7,"7015",20783,12244,12016,381,228,"PACMA",63
38,"38025",6649,4858,4778,52,80,"PACMA",23
44,"44226",163,112,112,3,0,"PACMA",0
37,"37148",451,344,343,3,1,"PACMA",0
9,"9122",93,71,71,4,0,"PACMA",0
44,"44227",81,59,59,0,0,"PACMA",1
29,"29008",14069,9934,9859,118,75,"PACMA",15
5,"5114",1418,1195,1182,9,13,"PACMA",2
10,"10151",245,204,202,2,2,"PACMA",0
32,"32058",5253,3872,3821,57,51,"PACMA",22
45,"45113",2094,1589,1555,6,34,"PACMA",4
18,"18162",947,726,721,8,5,"PACMA",1
34,"34031",29,26,26,0,0,"PACMA",0
49,"49258",127,107,104,0,3,"PACMA",0
19,"19129",48,33,31,0,2,"PACMA",0
25,"25253",175,132,129,1,3,"PACMA",0
45,"45077",554,430,423,7,7,"PACMA",2
3,"3054",371,321,315,2,6,"PACMA",0
9,"9392",51,42,42,1,0,"PACMA",0
22,"22086",207,149,147,1,2,"PACMA",0
50,"50278",207,152,149,4,3,"PACMA",0
28,"28036",2301,1809,1784,13,25,"PACMA",13
39,"39031",1227,965,956,4,9,"PACMA",4
49,"49259",121,88,87,1,1,"PACMA",0
9,"9394",805,594,588,13,6,"PACMA",2
40,"40013",67,56,54,1,2,"PACMA",0
5,"5116",131,114,109,0,5,"PACMA",0
49,"49123",557,421,415,5,6,"PACMA",0
47,"47074",155,125,124,0,1,"PACMA",0
30,"30009",11961,9992,9880,92,112,"PACMA",26
21,"21020",398,282,282,3,0,"PACMA",0
19,"19055",54,41,37,1,4,"PACMA",0
22,"22088",171,133,128,5,5,"PACMA",0
18,"18163",327,246,238,0,8,"PACMA",0
42,"42128",43,38,38,2,0,"PACMA",0
9,"9437",298,249,247,5,2,"PACMA",0
10,"10032",1768,1438,1415,9,23,"PACMA",2
40,"40014",60,39,39,1,0,"PACMA",0
34,"34073",184,153,152,7,1,"PACMA",0
46,"46159",23111,17258,17086,141,172,"PACMA",87
48,"48006",285,246,243,3,3,"PACMA",2
29,"29085",156,116,113,0,3,"PACMA",0
46,"46208",1141,990,978,6,12,"PACMA",4
10,"10155",1156,829,819,4,10,"PACMA",0
22,"22089",329,246,237,8,9,"PACMA",1
40,"40060",86,65,64,3,1,"PACMA",1
21,"21051",272,202,201,5,1,"PACMA",2
49,"49261",1579,1161,1145,36,16,"PACMA",3
49,"49125",1344,956,939,21,17,"PACMA",5
10,"10156",116,91,91,0,0,"PACMA",1
25,"25010",206,119,118,7,1,"PACMA",0
48,"48007",354,254,253,1,1,"PACMA",0
50,"50195",48,38,38,1,0,"PACMA",0
16,"16057",109,82,82,1,0,"PACMA",0
25,"25192",799,543,527,19,16,"PACMA",0
26,"26148",189,151,150,0,1,"PACMA",3
19,"19268",34,26,25,0,1,"PACMA",0
50,"50020",868,646,629,5,17,"PACMA",1
12,"12095",1027,790,775,15,15,"PACMA",1
18,"18165",3942,2819,2776,27,43,"PACMA",11
29,"29086",814,538,536,9,2,"PACMA",0
18,"18064",419,347,345,3,2,"PACMA",1
47,"47076",16922,13030,12899,212,131,"PACMA",52
48,"48911",373,300,296,1,4,"PACMA",1
46,"46210",346,300,295,4,5,"PACMA",0
22,"22248",119,94,92,3,2,"PACMA",0
29,"29087",409,306,305,3,1,"PACMA",0
42,"42132",159,132,127,4,5,"PACMA",0
34,"34036",211,159,157,0,2,"PACMA",2
9,"9006",68,40,39,1,1,"PACMA",0
37,"37380",57,45,44,1,1,"PACMA",0
46,"46902",425,333,332,3,1,"PACMA",0
26,"26150",129,104,104,0,0,"PACMA",0
40,"40159",150,111,110,0,1,"PACMA",0
24,"24127",327,258,255,1,3,"PACMA",3
7,"7023",3541,2414,2365,88,49,"PACMA",14
46,"46065",1606,1250,1234,15,16,"PACMA",1
6,"6059",1959,1476,1466,8,10,"PACMA",2
34,"34037",345,256,253,4,3,"PACMA",0
40,"40019",43,35,35,0,0,"PACMA",0
16,"16061",1035,861,848,15,13,"PACMA",3
5,"5249",101,73,71,1,2,"PACMA",0
48,"48010",427,303,300,2,3,"PACMA",1
22,"22250",368,261,255,12,6,"PACMA",3
11,"11041",9805,7136,7067,87,69,"PACMA",12
28,"28131",12664,9454,9342,100,112,"PACMA",41
50,"50170",411,316,313,2,3,"PACMA",0
35,"35029",3981,2341,2315,43,26,"PACMA",3
46,"46211",1716,1459,1447,9,12,"PACMA",5
19,"19174",126,88,86,0,2,"PACMA",0
38,"38001",17632,9601,9475,121,126,"PACMA",64
42,"42139",22,18,17,0,1,"PACMA",0
10,"10038",98,84,83,0,1,"PACMA",0
45,"45121",6553,4720,4653,43,67,"PACMA",23
44,"44236",77,48,47,0,1,"PACMA",0
7,"7024",6070,3232,3170,60,62,"PACMA",27
48,"48044",63869,47453,47085,511,368,"PACMA",222
9,"9009",167,129,128,8,1,"PACMA",1
2,"2045",3763,3086,3035,42,51,"PACMA",9
10,"10162",616,505,496,1,9,"PACMA",0
46,"46139",4594,3794,3734,28,60,"PACMA",8
10,"10039",448,352,350,0,2,"PACMA",0
45,"45086",491,406,399,3,7,"PACMA",2
7,"7025",457,355,346,3,9,"PACMA",2
46,"46904",782,659,650,6,9,"PACMA",3
16,"16194",298,238,238,1,0,"PACMA",1
10,"10202",665,533,523,7,10,"PACMA",6
19,"19175",39,31,31,0,0,"PACMA",0
34,"34168",60,56,56,0,0,"PACMA",1
19,"19274",881,652,644,8,8,"PACMA",3
40,"40164",188,145,142,0,3,"PACMA",0
38,"38003",1446,1053,1044,4,9,"PACMA",3
47,"47080",45,39,39,1,0,"PACMA",0
46,"46140",379,314,313,0,1,"PACMA",0
50,"50113",653,528,526,9,2,"PACMA",2
5,"5219",45,33,33,0,0,"PACMA",0
34,"34042",299,249,246,5,3,"PACMA",1
42,"42142",55,41,38,2,3,"PACMA",0
3,"3063",25410,18205,17989,208,216,"PACMA",118
26,"26069",276,211,208,5,3,"PACMA",0
7,"7060",2534,1724,1697,30,27,"PACMA",14
37,"37161",157,118,116,1,2,"PACMA",0
37,"37038",808,671,664,6,7,"PACMA",0
48,"48014",1211,838,834,4,4,"PACMA",7
38,"38004",4522,3034,2975,33,59,"PACMA",22
26,"26029",33,25,24,1,1,"PACMA",0
16,"16196",658,578,568,6,10,"PACMA",1
19,"19066",78,63,62,0,1,"PACMA",0
45,"45088",2038,1379,1356,14,23,"PACMA",14
6,"6066",1798,1348,1340,7,8,"PACMA",0
5,"5025",108,86,86,2,0,"PACMA",0
38,"38037",13166,8509,8332,65,177,"PACMA",41
28,"28133",5868,4236,4144,23,92,"PACMA",13
16,"16197",73,50,50,1,0,"PACMA",0
45,"45089",1615,1238,1221,16,17,"PACMA",0
46,"46166",8260,6422,6324,60,98,"PACMA",17
25,"25230",1665,1164,1140,36,24,"PACMA",2
13,"13020",4805,3475,3434,40,41,"PACMA",11
5,"5125",60,52,52,0,0,"PACMA",0
22,"22902",240,169,169,3,0,"PACMA",1
26,"26030",12,12,12,0,0,"PACMA",0
12,"12036",668,529,514,6,15,"PACMA",1
47,"47082",816,664,661,10,3,"PACMA",2
12,"12002",135,101,100,1,1,"PACMA",0
32,"32073",1415,1111,1100,8,11,"PACMA",3
9,"9014",190,113,113,3,0,"PACMA",0
25,"25017",248,160,159,1,1,"PACMA",0
29,"29093",2299,1767,1732,7,35,"PACMA",5
40,"40075",182,149,146,4,3,"PACMA",0
45,"45127",739,550,538,5,12,"PACMA",4
49,"49275",53766,37940,37379,774,561,"PACMA",205
49,"49006",168,124,122,2,2,"PACMA",1
37,"37315",99,77,75,3,2,"PACMA",0
16,"16154",4946,3975,3914,58,61,"PACMA",6
33,"33057",1635,1150,1132,16,18,"PACMA",2
9,"9270",180,147,143,2,4,"PACMA",1
15,"15003",1936,1400,1382,19,18,"PACMA",3
38,"38007",1844,1209,1188,5,21,"PACMA",5
40,"40030",520,432,425,9,7,"PACMA",2
22,"22110",822,602,588,3,14,"PACMA",1
37,"37086",105,75,72,3,3,"PACMA",0
34,"34048",72,58,56,3,2,"PACMA",0
10,"10128",5805,4456,4336,50,120,"PACMA",13
9,"9272",319,225,225,5,0,"PACMA",2
9,"9412",846,568,563,4,5,"PACMA",4
44,"44245",274,189,184,1,5,"PACMA",0
34,"34176",146,120,118,2,2,"PACMA",0
42,"42151",38,32,29,0,3,"PACMA",0
18,"18176",265,183,181,0,2,"PACMA",1
18,"18074",297,245,245,5,0,"PACMA",1
9,"9273",55,47,47,0,0,"PACMA",0
19,"19073",24,20,19,0,1,"PACMA",0
48,"48018",905,591,587,8,4,"PACMA",2
42,"42152",96,71,69,1,2,"PACMA",0
46,"46144",699,547,536,2,11,"PACMA",3
25,"25020",328,216,209,4,7,"PACMA",0
46,"46217",912,758,751,4,7,"PACMA",0
34,"34177",170,147,143,2,4,"PACMA",0
10,"10048",299,232,231,0,1,"PACMA",0
26,"26035",22,14,14,0,0,"PACMA",0
7,"7033",25954,14975,14738,328,237,"PACMA",84
25,"25172",1838,1267,1230,35,37,"PACMA",8
29,"29050",483,341,340,1,1,"PACMA",0
13,"13057",1214,1018,998,9,20,"PACMA",1
19,"19282",210,157,157,0,0,"PACMA",0
34,"34178",106,93,93,1,0,"PACMA",0
25,"25021",2693,1632,1605,40,27,"PACMA",4
26,"26036",16873,12341,12167,190,174,"PACMA",66
47,"47085",16967,12618,12472,208,146,"PACMA",45
5,"5163",1762,1400,1380,5,20,"PACMA",3
22,"22167",515,417,399,16,18,"PACMA",1
38,"38010",4054,2642,2599,17,43,"PACMA",10
5,"5260",114,101,101,1,0,"PACMA",0
2,"2055",1267,900,884,6,16,"PACMA",1
49,"49010",338,271,265,4,6,"PACMA",4
25,"25113",1227,869,856,28,13,"PACMA",2
40,"40034",85,73,73,1,0,"PACMA",0
29,"29097",4076,3060,3018,40,42,"PACMA",7
50,"50003",141,108,108,3,0,"PACMA",0
37,"37281",36,34,33,0,1,"PACMA",0
49,"49011",236,195,194,5,1,"PACMA",0
34,"34052",187,147,147,1,0,"PACMA",1
40,"40177",171,145,145,2,0,"PACMA",1
29,"29023",1661,1080,1074,15,6,"PACMA",9
10,"10214",226,178,176,2,2,"PACMA",0
42,"42202",33,15,14,1,1,"PACMA",0
45,"45901",811,595,591,2,4,"PACMA",3
18,"18179",583,417,409,7,8,"PACMA",0
42,"42009",97,69,67,2,2,"PACMA",0
47,"47008",26,17,17,0,0,"PACMA",0
2,"2057",2138,1736,1712,30,24,"PACMA",3
5,"5035",105,87,87,2,0,"PACMA",0
42,"42157",18,16,15,0,1,"PACMA",0
38,"38012",2535,1735,1716,11,19,"PACMA",8
44,"44043",126,94,94,7,0,"PACMA",0
44,"44251",271,218,218,5,0,"PACMA",0
9,"9327",34,34,34,0,0,"PACMA",1
12,"12008",236,203,199,4,4,"PACMA",0
9,"9060",171,142,142,0,0,"PACMA",1
34,"34055",288,215,212,4,3,"PACMA",0
36,"36039",14581,11007,10782,167,225,"PACMA",49
19,"19186",93,77,77,0,0,"PACMA",0
26,"26169",83,73,72,0,1,"PACMA",0
16,"16211",462,317,313,2,4,"PACMA",0
47,"47170",40,30,30,0,0,"PACMA",0
44,"44005",59,43,43,1,0,"PACMA",0
9,"9022",83,58,58,2,0,"PACMA",0
48,"48023",601,499,492,4,7,"PACMA",1
6,"6032",76,59,59,1,0,"PACMA",1
7,"7037",3269,1737,1700,37,37,"PACMA",12
37,"37050",71,48,48,1,0,"PACMA",0
42,"42158",112,79,79,6,0,"PACMA",1
50,"50091",56,39,39,1,0,"PACMA",0
12,"12009",17124,12273,12098,150,175,"PACMA",45
26,"26041",152,106,104,0,2,"PACMA",1
29,"29026",1130,815,799,7,16,"PACMA",1
45,"45099",3449,2451,2405,22,46,"PACMA",18
16,"16213",39,32,32,1,0,"PACMA",0
44,"44006",293,220,212,3,8,"PACMA",0
3,"3074",1752,1479,1466,5,13,"PACMA",6
40,"40182",207,155,155,6,0,"PACMA",1
10,"10055",709,523,508,13,15,"PACMA",1
42,"42013",45,35,34,1,1,"PACMA",0
9,"9063",223,191,189,1,2,"PACMA",0
37,"37324",415,338,334,2,4,"PACMA",0
44,"44257",184,132,131,6,1,"PACMA",0
26,"26172",35,29,29,0,0,"PACMA",0
36,"36009",5138,3147,3108,24,39,"PACMA",10
16,"16083",58,30,30,1,0,"PACMA",0
3,"3075",160,139,136,2,3,"PACMA",2
9,"9025",150,112,110,0,2,"PACMA",3
48,"48026",1093,881,875,3,6,"PACMA",4
37,"37174",1150,942,922,3,20,"PACMA",0
19,"19118",17,13,13,0,0,"PACMA",0
19,"19288",22,21,21,0,0,"PACMA",0
10,"10901",1148,844,839,18,5,"PACMA",3
37,"37099",104,64,62,1,2,"PACMA",0
21,"21009",916,622,608,6,14,"PACMA",0
2,"2061",715,570,565,4,5,"PACMA",0
26,"26084",5999,4440,4399,56,41,"PACMA",22
46,"46028",424,352,347,5,5,"PACMA",0
21,"21070",6278,4489,4445,42,44,"PACMA",5
5,"5136",110,75,75,3,0,"PACMA",0
10,"10139",117,98,97,1,1,"PACMA",0
49,"49194",380,250,247,4,3,"PACMA",0
7,"7040",266127,162699,160491,2698,2208,"PACMA",1595
22,"22177",101,79,75,1,4,"PACMA",1
47,"47091",97,82,80,3,2,"PACMA",0
30,"30001",4763,3992,3956,26,36,"PACMA",6
2,"2063",1537,1252,1242,11,10,"PACMA",3
9,"9287",201,159,158,4,1,"PACMA",0
36,"36011",1939,1189,1172,15,17,"PACMA",6
26,"26045",13,13,13,0,0,"PACMA",0
9,"9026",384,296,295,8,1,"PACMA",1
34,"34189",59,47,47,3,0,"PACMA",0
10,"10182",146,112,108,0,4,"PACMA",0
16,"16218",207,170,169,4,1,"PACMA",1
5,"5234",58,49,49,0,0,"PACMA",0
9,"9423",34,28,28,1,0,"PACMA",0
38,"38051",7081,5298,5229,64,69,"PACMA",12
36,"36012",3839,2884,2825,14,59,"PACMA",8
45,"45030",486,378,374,4,4,"PACMA",0
28,"28121",185,153,152,0,1,"PACMA",1
3,"3012",1021,870,862,3,8,"PACMA",1
27,"27040",3421,2718,2693,27,25,"PACMA",0
10,"10183",1022,818,805,5,13,"PACMA",1
39,"39077",256,196,196,1,0,"PACMA",0
18,"18121",135,109,109,0,0,"PACMA",0
25,"25030",147,101,95,3,6,"PACMA",1
9,"9155",27,17,17,0,0,"PACMA",0
25,"25150",185,119,113,4,6,"PACMA",0
45,"45141",981,815,790,6,25,"PACMA",1
40,"40046",99,81,78,2,3,"PACMA",1
3,"3114",1620,1320,1305,10,15,"PACMA",5
38,"38019",12624,8174,8099,65,75,"PACMA",20
24,"24032",134,102,101,1,1,"PACMA",1
18,"18187",587,432,432,0,0,"PACMA",0
15,"15070",9684,6627,6464,141,163,"PACMA",20
36,"36014",2145,1568,1548,9,20,"PACMA",4
26,"26048",29,27,26,1,1,"PACMA",0
49,"49022",319,266,261,3,5,"PACMA",0
45,"45106",7666,6045,5945,92,100,"PACMA",19
50,"50272",12481,8744,8642,176,102,"PACMA",65
33,"33021",4932,3544,3502,45,42,"PACMA",5
22,"22128",203,164,161,7,3,"PACMA",1
26,"26049",189,141,137,1,4,"PACMA",3
18,"18088",1576,1258,1253,2,5,"PACMA",1
25,"25216",250,175,173,5,2,"PACMA",0
46,"46153",445,374,366,7,8,"PACMA",4
26,"26050",114,84,81,1,3,"PACMA",1
44,"44141",147,99,95,0,4,"PACMA",1
46,"46081",10254,8188,8101,52,87,"PACMA",37
24,"24156",264,187,186,6,1,"PACMA",0
44,"44264",249,196,193,1,3,"PACMA",1
46,"46256",6734,4902,4858,33,44,"PACMA",18
16,"16277",128,100,100,3,0,"PACMA",0
3,"3048",4747,3878,3817,16,61,"PACMA",8
49,"49024",736,551,544,16,7,"PACMA",2
16,"16225",89,69,68,1,1,"PACMA",0
5,"5238",815,649,641,6,8,"PACMA",0
12,"12017",183,143,141,6,2,"PACMA",1
16,"16092",158,132,132,0,0,"PACMA",0
6,"6090",904,724,710,10,14,"PACMA",3
49,"49158",229,174,172,0,2,"PACMA",1
19,"19090",107,87,86,0,1,"PACMA",0
37,"37182",92,72,72,2,0,"PACMA",1
9,"9033",104,82,80,1,2,"PACMA",0
49,"49159",289,225,225,2,0,"PACMA",3
48,"48032",5864,4257,4223,32,34,"PACMA",4
42,"42171",158,99,94,3,5,"PACMA",0
40,"40052",95,69,69,0,0,"PACMA",0
26,"26139",68,55,55,4,0,"PACMA",0
25,"25125",450,297,289,10,8,"PACMA",0
19,"19125",54,42,42,2,0,"PACMA",0
10,"10025",408,355,337,4,18,"PACMA",0
11,"11005",4617,3287,3214,26,73,"PACMA",2
42,"42068",99,74,74,5,0,"PACMA",1
42,"42024",95,80,73,1,7,"PACMA",0
47,"47017",205,177,176,1,1,"PACMA",0
26,"26053",221,177,173,5,4,"PACMA",2
40,"40194",40248,30946,30365,525,581,"PACMA",139
38,"38024",14851,9589,9399,93,190,"PACMA",61
6,"6092",592,468,456,5,12,"PACMA",0
24,"24038",3206,2439,2399,37,40,"PACMA",6
45,"45036",704,559,537,4,22,"PACMA",0
50,"50218",113,92,92,0,0,"PACMA",1
25,"25185",690,409,404,8,5,"PACMA",0
19,"19165",51,43,42,0,1,"PACMA",0
16,"16280",205,177,175,1,2,"PACMA",0
28,"28101",222,158,158,4,0,"PACMA",2
37,"37065",346,269,267,0,2,"PACMA",0
9,"9298",90,74,74,1,0,"PACMA",0
50,"50102",918,722,713,12,9,"PACMA",1
30,"30033",9940,7794,7700,79,94,"PACMA",33
1,"1017",910,629,621,17,8,"PACMA",3
3,"3085",275,218,215,2,3,"PACMA",0
25,"25035",428,289,284,5,5,"PACMA",1
18,"18095",1916,1428,1306,21,122,"PACMA",3
16,"16236",964,762,758,10,4,"PACMA",4
15,"15075",12042,8639,8486,147,153,"PACMA",45
9,"9432",212,161,158,1,3,"PACMA",0
28,"28034",356,278,276,1,2,"PACMA",0
45,"45002",2500,1771,1756,26,15,"PACMA",3
47,"47019",93,69,68,0,1,"PACMA",0
21,"21017",3581,2416,2389,27,27,"PACMA",2
37,"37067",2938,2306,2267,47,39,"PACMA",5
12,"12022",367,282,279,4,3,"PACMA",2
32,"32059",1983,1526,1510,27,16,"PACMA",4
15,"15076",2766,1971,1936,18,35,"PACMA",7
5,"5178",392,310,304,2,6,"PACMA",0
39,"39004",1593,1321,1305,9,16,"PACMA",2
2,"2073",4924,3923,3847,76,76,"PACMA",7
46,"46012",930,698,684,9,14,"PACMA",5
42,"42028",62,45,43,2,2,"PACMA",0
13,"13075",212,161,159,1,2,"PACMA",0
37,"37150",43,36,34,0,2,"PACMA",0
38,"38027",5392,3530,3459,41,71,"PACMA",18
5,"5048",131,112,111,0,1,"PACMA",1
12,"12024",146,129,128,1,1,"PACMA",2
37,"37069",952,737,723,12,14,"PACMA",0
44,"44061",89,55,55,1,0,"PACMA",2
47,"47128",57,52,48,1,4,"PACMA",0
28,"28080",45696,36832,36529,402,303,"PACMA",110
5,"5243",101,69,68,0,1,"PACMA",0
44,"44148",98,77,77,3,0,"PACMA",0
10,"10194",557,449,440,0,9,"PACMA",1
18,"18901",583,374,368,3,6,"PACMA",1
40,"40200",47,41,39,0,2,"PACMA",0
19,"19200",150,105,105,1,0,"PACMA",0
48,"48071",6097,4307,4224,61,83,"PACMA",30
37,"37264",78,52,52,0,0,"PACMA",0
34,"34113",35,28,27,0,1,"PACMA",0
16,"16904",508,413,407,10,6,"PACMA",2
5,"5244",66,45,45,0,0,"PACMA",0
42,"42181",453,357,347,7,10,"PACMA",0
11,"11009",636,430,424,2,6,"PACMA",1
45,"45115",2600,2140,2105,14,35,"PACMA",3
39,"39058",862,586,584,6,2,"PACMA",0
49,"49216",175,144,142,3,2,"PACMA",0
28,"28128",366,280,275,2,5,"PACMA",0
9,"9041",27,27,27,0,0,"PACMA",0
32,"32062",963,735,729,10,6,"PACMA",1
34,"34211",202,175,170,1,5,"PACMA",0
38,"38029",1456,732,715,4,17,"PACMA",9
16,"16240",134,100,98,0,2,"PACMA",0
15,"15022",6102,4207,4164,52,43,"PACMA",15
50,"50223",956,751,745,14,6,"PACMA",0
42,"42032",186,143,141,2,2,"PACMA",2
9,"9352",134,107,106,0,1,"PACMA",0
37,"37304",190,144,142,1,2,"PACMA",0
49,"49169",42,34,33,1,1,"PACMA",0
9,"9307",119,89,88,1,1,"PACMA",0
42,"42130",70,55,54,2,1,"PACMA",0
39,"39060",6723,5453,5360,56,93,"PACMA",13
26,"26061",1552,1119,1099,31,20,"PACMA",3
7,"7054",19930,11186,11028,196,158,"PACMA",57
3,"3092",6780,5364,5269,96,95,"PACMA",25
30,"30037",17942,13830,13734,90,96,"PACMA",33
36,"36024",17164,12723,12500,163,223,"PACMA",42
45,"45118",1980,1412,1390,13,22,"PACMA",4
47,"47184",575,447,443,6,4,"PACMA",1
29,"29040",1934,1344,1332,12,12,"PACMA",7
38,"38031",28391,21797,21431,234,366,"PACMA",108
49,"49036",592,410,403,5,7,"PACMA",1
25,"25040",10654,6905,6768,144,137,"PACMA",25
19,"19102",122,101,100,0,1,"PACMA",1
22,"22006",319,203,197,5,6,"PACMA",2
40,"40111",72,57,55,0,2,"PACMA",1
24,"24167",813,509,509,8,0,"PACMA",0
5,"5053",94,73,71,0,2,"PACMA",0
7,"7055",7000,4471,4379,67,92,"PACMA",18
40,"40063",7290,5366,5171,68,195,"PACMA",22
44,"44027",168,140,140,2,0,"PACMA",1
28,"28039",139,103,103,1,0,"PACMA",0
47,"47185",97,76,75,1,1,"PACMA",1
9,"9309",343,252,246,7,6,"PACMA",0
40,"40065",520,401,393,6,8,"PACMA",0
27,"27059",2320,1783,1763,25,20,"PACMA",4
19,"19305",166,130,130,0,0,"PACMA",0
10,"10200",499,368,368,0,0,"PACMA",0
9,"9084",200,147,147,4,0,"PACMA",0
50,"50139",372,280,278,3,2,"PACMA",0
50,"50110",424,315,314,6,1,"PACMA",1
9,"9441",70,59,59,2,0,"PACMA",0
24,"24050",113,91,90,0,1,"PACMA",0
50,"50022",548,430,416,10,14,"PACMA",0
36,"36027",4478,3376,3339,29,37,"PACMA",7
44,"44028",202,159,156,2,3,"PACMA",0
26,"26065",57,43,43,0,0,"PACMA",1
46,"46163",1811,1487,1463,12,24,"PACMA",3
19,"19104",16,12,12,1,0,"PACMA",0
18,"18905",12975,9260,9209,155,51,"PACMA",33
5,"5251",80,58,58,0,0,"PACMA",0
29,"29015",31805,22566,22347,272,219,"PACMA",70
5,"5021",2044,1592,1557,37,35,"PACMA",4
5,"5155",60,44,44,1,0,"PACMA",0
13,"13016",708,555,553,2,2,"PACMA",0
47,"47105",210,181,179,1,2,"PACMA",0
37,"37310",154,115,115,1,0,"PACMA",0
1,"1031",1229,916,899,13,17,"PACMA",9
18,"18005",366,279,277,3,2,"PACMA",0
9,"9048",1565,1166,1148,20,18,"PACMA",1
49,"49225",172,130,129,0,1,"PACMA",0
9,"9443",197,160,154,5,6,"PACMA",1
50,"50111",191,141,138,2,3,"PACMA",0
46,"46164",11634,8843,8724,90,119,"PACMA",36
7,"7058",2803,2100,2046,38,54,"PACMA",23
37,"37235",226,194,192,0,2,"PACMA",0
49,"49268",480,365,362,8,3,"PACMA",0
16,"16248",887,733,710,20,23,"PACMA",1
18,"18006",4116,2862,2831,25,31,"PACMA",2
18,"18907",1997,1627,1612,5,15,"PACMA",2
40,"40210",110,71,67,1,4,"PACMA",1
42,"42190",102,71,71,3,0,"PACMA",0
19,"19210",34,29,29,1,0,"PACMA",0
30,"30015",18792,14453,14336,120,117,"PACMA",28
42,"42086",40,25,25,1,0,"PACMA",0
28,"28041",4006,3190,3154,45,36,"PACMA",16
9,"9314",113,89,88,4,1,"PACMA",0
16,"16108",68,56,55,0,1,"PACMA",2
45,"45013",1870,1504,1486,5,18,"PACMA",6
46,"46043",149,139,139,0,0,"PACMA",2
45,"45160",1104,911,896,12,15,"PACMA",2
6,"6019",2111,1621,1596,24,25,"PACMA",3
26,"26112",270,201,200,0,1,"PACMA",0
46,"46092",304,206,201,1,5,"PACMA",2
32,"32071",1614,1121,1112,4,9,"PACMA",1
44,"44200",41,30,30,0,0,"PACMA",0
50,"50201",466,366,363,7,3,"PACMA",1
7,"7061",9429,5937,5800,125,137,"PACMA",37
40,"40212",29,22,20,0,2,"PACMA",0
49,"49043",304,256,256,6,0,"PACMA",0
49,"49044",80,63,63,3,0,"PACMA",0
10,"10002",396,317,314,5,3,"PACMA",1
34,"34083",1888,1355,1338,15,17,"PACMA",4
48,"48048",547,423,423,5,0,"PACMA",0
19,"19108",117,97,95,0,2,"PACMA",1
47,"47138",259,198,195,3,3,"PACMA",0
12,"12070",576,473,463,5,10,"PACMA",1
30,"30017",11683,9332,9233,95,99,"PACMA",18
6,"6112",411,330,326,0,4,"PACMA",0
37,"37199",157,115,113,0,2,"PACMA",0
9,"9447",36,33,33,0,0,"PACMA",0
16,"16027",779,619,612,5,7,"PACMA",4
50,"50115",3280,2234,2205,32,29,"PACMA",8
9,"9446",13,9,9,0,0,"PACMA",0
48,"48015",34932,24209,23966,296,243,"PACMA",130
37,"37200",192,142,142,0,0,"PACMA",0
26,"26072",310,270,264,4,6,"PACMA",1
12,"12037",20,15,14,1,1,"PACMA",0
30,"30901",10113,8265,8194,70,71,"PACMA",31
16,"16029",114,80,80,0,0,"PACMA",0
50,"50116",220,154,153,0,1,"PACMA",0
36,"36033",12323,9328,9150,97,178,"PACMA",48
47,"47139",1080,845,833,11,12,"PACMA",2
24,"24017",630,476,468,11,8,"PACMA",2
39,"39041",1775,1432,1414,15,18,"PACMA",1
46,"46167",411,312,309,0,3,"PACMA",1
46,"46240",226,188,185,3,3,"PACMA",0
18,"18910",832,601,594,6,7,"PACMA",0
1,"1039",211,164,158,1,6,"PACMA",0
44,"44036",27,17,17,0,0,"PACMA",0
50,"50233",120,89,88,2,1,"PACMA",0
44,"44080",294,216,211,3,5,"PACMA",1
12,"12104",6981,5464,5357,54,107,"PACMA",21
19,"19036",279,238,236,1,2,"PACMA",0
19,"19111",180,147,146,0,1,"PACMA",1
12,"12134",147,107,107,3,0,"PACMA",0
45,"45128",2558,1831,1806,20,25,"PACMA",6
44,"44038",112,94,92,3,2,"PACMA",1
21,"21001",628,434,428,5,6,"PACMA",0
9,"9184",4,4,4,0,0,"PACMA",0
5,"5259",132,115,114,1,1,"PACMA",0
9,"9449",94,80,80,2,0,"PACMA",0
46,"46095",632,505,495,1,10,"PACMA",2
12,"12135",35189,25691,25345,380,346,"PACMA",111
22,"22018",357,272,271,4,1,"PACMA",1
45,"45129",145,121,120,0,1,"PACMA",0
40,"40218",111,81,80,1,1,"PACMA",0
49,"49184",190,135,133,1,2,"PACMA",1
38,"38042",3876,2850,2809,24,41,"PACMA",6
16,"16258",288,215,213,1,2,"PACMA",0
15,"15033",2581,2094,2079,15,15,"PACMA",3
10,"10211",461,341,334,3,7,"PACMA",0
45,"45094",441,358,353,6,5,"PACMA",2
46,"46096",320,267,267,0,0,"PACMA",0
45,"45130",354,287,283,2,4,"PACMA",1
10,"10212",1688,1276,1242,16,34,"PACMA",3
48,"48052",1526,1213,1205,7,8,"PACMA",1
38,"38043",18628,12966,12763,134,203,"PACMA",58
12,"12040",116573,84142,83078,1257,1064,"PACMA",391
40,"40080",68,53,52,0,1,"PACMA",0
40,"40128",144,116,116,5,0,"PACMA",1
19,"19038",48,33,33,0,0,"PACMA",0
19,"19319",4203,3139,3104,28,35,"PACMA",23
24,"24021",1791,1251,1228,14,23,"PACMA",4
18,"18014",5667,4132,4085,43,47,"PACMA",10
44,"44040",206,167,166,5,1,"PACMA",0
15,"15006",5539,3940,3866,53,74,"PACMA",4
13,"13092",1924,1655,1635,4,20,"PACMA",0
40,"40176",418,344,341,8,3,"PACMA",0
50,"50120",53,41,41,0,0,"PACMA",0
16,"16074",53,42,42,1,0,"PACMA",0
26,"26122",109,94,92,2,2,"PACMA",0
22,"22168",22,16,16,0,0,"PACMA",0
42,"42051",23,12,11,0,1,"PACMA",0
9,"9059",137122,103909,102353,2008,1556,"PACMA",508
22,"22187",295,222,222,3,0,"PACMA",2
9,"9276",420,275,245,5,30,"PACMA",3
22,"22021",2080,1524,1505,31,19,"PACMA",3
5,"5261",48,32,31,0,1,"PACMA",0
37,"37321",169,144,144,1,0,"PACMA",0
30,"30022",16489,12207,12042,152,165,"PACMA",20
6,"6121",3436,2700,2662,35,38,"PACMA",5
5,"5066",480,397,392,5,5,"PACMA",0
19,"19219",18,12,12,0,0,"PACMA",0
22,"22170",622,439,430,13,9,"PACMA",2
45,"45060",204,151,148,1,3,"PACMA",2
1,"1047",942,674,655,4,19,"PACMA",3
47,"47169",70,57,57,0,0,"PACMA",0
46,"46171",16753,12565,12399,122,166,"PACMA",62
49,"49146",330,268,265,6,3,"PACMA",0
25,"25143",86,58,58,1,0,"PACMA",0
18,"18046",1960,1327,1312,5,15,"PACMA",3
9,"9192",74,55,53,0,2,"PACMA",0
9,"9328",81,56,56,2,0,"PACMA",0
25,"25240",1398,976,958,17,18,"PACMA",6
49,"49057",125,98,94,1,4,"PACMA",0
5,"5166",235,181,178,1,3,"PACMA",0
5,"5263",175,133,131,0,2,"PACMA",0
50,"50294",77,58,57,0,1,"PACMA",0
5,"5230",79,73,73,1,0,"PACMA",1
9,"9236",41,38,37,0,1,"PACMA",0
28,"28026",5852,4506,4449,40,57,"PACMA",17
15,"15093",4562,3314,3270,37,44,"PACMA",4
47,"47197",932,739,730,15,9,"PACMA",1
34,"34096",56,41,39,1,2,"PACMA",0
37,"37097",47,39,39,1,0,"PACMA",0
37,"37096",235,199,197,3,2,"PACMA",0
25,"25145",88,67,67,2,0,"PACMA",0
45,"45136",5891,4414,4368,55,46,"PACMA",10
48,"48057",5934,4407,4385,27,22,"PACMA",5
46,"46173",1393,1156,1137,10,19,"PACMA",6
25,"25242",787,501,490,11,11,"PACMA",0
5,"5167",274,230,224,6,6,"PACMA",0
16,"16269",494,412,407,5,5,"PACMA",0
40,"40228",539,446,437,2,9,"PACMA",1
12,"12079",450,360,353,3,7,"PACMA",2
28,"28070",139,98,97,0,1,"PACMA",2
33,"33063",467,367,363,4,4,"PACMA",0
21,"21007",6088,4174,4123,57,51,"PACMA",15
19,"19325",127,105,102,4,3,"PACMA",1
47,"47037",194,160,159,1,1,"PACMA",0
28,"28049",59507,46919,46379,488,540,"PACMA",238
37,"37098",355,267,265,1,2,"PACMA",0
46,"46174",1003,854,847,6,7,"PACMA",3
16,"16270",192,156,155,0,1,"PACMA",3
5,"5199",48,39,39,0,0,"PACMA",0
39,"39074",6785,5287,5233,50,54,"PACMA",17
15,"15039",1374,1027,998,27,29,"PACMA",0
21,"21039",313,233,232,2,1,"PACMA",0
32,"32011",1026,660,650,4,10,"PACMA",2
32,"32084",1084,818,805,0,13,"PACMA",0
26,"26173",10,10,10,1,0,"PACMA",0
49,"49062",142,104,104,1,0,"PACMA",0
5,"5072",91,72,72,1,0,"PACMA",0
30,"30026",15165,10524,10369,80,155,"PACMA",28
5,"5233",246,212,212,2,0,"PACMA",0
16,"16041",395,289,287,6,2,"PACMA",2
12,"12901",3383,2664,2632,34,32,"PACMA",11
47,"47147",129,96,96,0,0,"PACMA",0
36,"36043",5188,3435,3390,35,45,"PACMA",11
42,"42211",92,69,68,0,1,"PACMA",0
37,"37016",539,424,420,8,4,"PACMA",0
24,"24108",421,316,314,6,2,"PACMA",0
37,"37101",185,143,141,1,2,"PACMA",0
18,"18120",274,238,237,2,1,"PACMA",0
22,"22029",130,99,98,6,1,"PACMA",0
40,"40091",140,111,109,1,2,"PACMA",0
50,"50213",117,83,82,0,1,"PACMA",0
25,"25056",289,168,163,3,5,"PACMA",1
12,"12049",471,366,344,10,22,"PACMA",1
48,"48061",773,585,582,6,3,"PACMA",1
26,"26005",2251,1602,1580,18,22,"PACMA",15
45,"45140",1087,885,867,6,18,"PACMA",3
47,"47148",475,389,384,2,5,"PACMA",0
1,"1006",181,133,127,2,6,"PACMA",2
49,"49111",144,117,116,10,1,"PACMA",0
21,"21041",114169,74740,73814,1129,926,"PACMA",347
5,"5074",755,639,638,5,1,"PACMA",0
36,"36045",24724,17794,17459,237,335,"PACMA",91
45,"45177",2295,1898,1857,15,41,"PACMA",6
19,"19225",879,625,618,9,7,"PACMA",5
47,"47122",2078,1697,1665,21,32,"PACMA",3
48,"48029",8022,5488,5409,83,79,"PACMA",40
47,"47092",123,100,99,2,1,"PACMA",0
50,"50128",36,30,29,0,1,"PACMA",0
50,"50068",2082,1514,1481,18,33,"PACMA",1
45,"45031",2773,2011,1975,25,36,"PACMA",10
5,"5075",100,76,76,1,0,"PACMA",0
25,"25058",4390,2696,2650,57,46,"PACMA",9
12,"12050",1418,1183,1156,8,27,"PACMA",4
37,"37103",483,354,351,1,3,"PACMA",0
9,"9471",171,127,125,1,2,"PACMA",0
26,"26091",165,139,139,0,0,"PACMA",0
45,"45069",1791,1409,1389,8,20,"PACMA",2
36,"36047",2723,1875,1853,27,22,"PACMA",1
9,"9030",135,97,97,2,0,"PACMA",0
32,"32052",2126,1690,1673,28,17,"PACMA",6
40,"40902",137,118,118,3,0,"PACMA",0
47,"47123",456,356,353,10,3,"PACMA",1
49,"49067",416,300,300,2,0,"PACMA",0
3,"3014",234288,168004,166418,1795,1586,"PACMA",1006
45,"45033",407,302,295,3,7,"PACMA",0
47,"47204",275,221,219,3,2,"PACMA",0
16,"16007",1272,1056,1051,7,5,"PACMA",0
9,"9339",139,105,104,1,1,"PACMA",0
16,"16131",154,116,115,0,1,"PACMA",1
28,"28053",6035,4854,4783,61,71,"PACMA",14
47,"47067",198,159,156,5,3,"PACMA",0
40,"40095",507,437,425,2,12,"PACMA",0
26,"26107",97,79,79,1,0,"PACMA",0
40,"40145",1152,933,920,3,13,"PACMA",0
47,"47205",414,307,298,5,9,"PACMA",0
39,"39079",9035,6959,6897,55,62,"PACMA",12
9,"9473",94,81,81,2,0,"PACMA",0
29,"29061",1045,861,855,7,6,"PACMA",3
50,"50079",281,213,210,2,3,"PACMA",0
12,"12053",2121,1745,1719,11,26,"PACMA",5
50,"50041",21,13,13,0,0,"PACMA",0
9,"9476",67,52,52,0,0,"PACMA",0
15,"15016",5135,3816,3771,22,45,"PACMA",7
44,"44054",125,97,97,2,0,"PACMA",0
37,"37144",398,302,301,3,1,"PACMA",0
46,"46155",1072,861,849,4,12,"PACMA",2
49,"49071",822,558,557,5,1,"PACMA",1
47,"47232",107,77,75,1,2,"PACMA",1
19,"19195",41,30,30,1,0,"PACMA",0
48,"48902",19232,12809,12633,182,176,"PACMA",88
37,"37296",385,311,308,3,3,"PACMA",0
22,"22133",123,87,85,2,2,"PACMA",0
47,"47125",55,46,46,0,0,"PACMA",0
19,"19013",143,110,108,1,2,"PACMA",0
10,"10108",231,152,152,0,0,"PACMA",0
12,"12055",112,79,78,3,1,"PACMA",1
49,"49118",215,174,173,2,1,"PACMA",0
44,"44224",26,15,15,0,0,"PACMA",0
46,"46258",2792,2196,2164,14,32,"PACMA",3
33,"33023",3410,2501,2485,40,16,"PACMA",3
26,"26026",1344,1108,1096,14,12,"PACMA",3
6,"6048",879,758,740,4,18,"PACMA",0
21,"21046",1715,1354,1343,15,11,"PACMA",1
22,"22042",115,93,91,1,2,"PACMA",0
33,"33001",1772,984,971,14,13,"PACMA",0
6,"6139",600,489,481,5,8,"PACMA",0
19,"19092",437,331,326,4,5,"PACMA",0
26,"26098",99,74,73,2,1,"PACMA",0
24,"24201",1123,790,777,14,13,"PACMA",2
16,"16011",39,30,30,0,0,"PACMA",0
40,"40104",261,179,178,1,1,"PACMA",1
37,"37223",127,102,101,1,1,"PACMA",0
27,"27049",1554,1073,1062,6,11,"PACMA",3
28,"28102",913,700,693,9,7,"PACMA",2
13,"13073",565,459,456,2,3,"PACMA",0
45,"45186",3217,2573,2527,24,46,"PACMA",5
25,"25062",806,515,497,11,18,"PACMA",0
18,"18161",220,180,178,0,2,"PACMA",0
15,"15019",26096,18466,18187,350,279,"PACMA",49
6,"6004",1607,1317,1309,10,8,"PACMA",0
50,"50220",59,43,43,1,0,"PACMA",0
48,"48069",12381,8760,8672,66,88,"PACMA",42
3,"3086",145,119,118,1,1,"PACMA",0
33,"33048",169,120,120,1,0,"PACMA",0
34,"34110",96,83,81,2,2,"PACMA",0
30,"30034",1182,956,943,3,13,"PACMA",1
49,"49079",110,93,92,2,1,"PACMA",0
39,"39083",1214,785,775,7,10,"PACMA",0
9,"9303",92,64,64,0,0,"PACMA",0
12,"12058",99,74,74,0,0,"PACMA",1
45,"45039",236,197,190,2,7,"PACMA",0
49,"49080",736,571,560,5,11,"PACMA",0
47,"47046",124,105,103,0,2,"PACMA",0
47,"47020",283,237,232,5,5,"PACMA",1
25,"25036",190,138,134,5,4,"PACMA",0
26,"26016",32,27,27,0,0,"PACMA",1
6,"6143",3308,2625,2595,24,30,"PACMA",2
6,"6006",4664,3435,3367,50,68,"PACMA",7
30,"30035",17849,12871,12744,133,127,"PACMA",70
46,"46183",5946,4718,4656,35,62,"PACMA",22
40,"40107",113,93,90,3,3,"PACMA",0
45,"45040",1504,1058,1046,5,12,"PACMA",2
10,"10031",189,158,158,1,0,"PACMA",0
19,"19301",47,38,38,0,0,"PACMA",0
48,"48005",93,65,64,0,1,"PACMA",0
28,"28015",14491,11562,11417,155,145,"PACMA",49
11,"11037",5640,4337,4285,32,52,"PACMA",7
22,"22141",129,103,102,3,1,"PACMA",0
28,"28173",507,397,390,2,7,"PACMA",1
6,"6145",929,746,743,5,3,"PACMA",1
50,"50076",113,89,89,0,0,"PACMA",0
48,"48039",263,217,216,4,1,"PACMA",0
7,"7019",230,165,164,1,1,"PACMA",2
33,"33050",653,406,402,0,4,"PACMA",0
47,"47157",544,462,458,9,4,"PACMA",1
44,"44192",401,324,322,5,2,"PACMA",0
19,"19057",79,56,56,0,0,"PACMA",0
5,"5213",117,94,88,0,6,"PACMA",0
42,"42079",32,25,25,0,0,"PACMA",0
11,"11038",13815,10849,10756,126,93,"PACMA",32
16,"16906",104,83,82,0,1,"PACMA",0
6,"6146",1188,951,936,8,15,"PACMA",1
22,"22048",12485,9146,9028,237,118,"PACMA",50
44,"44025",6168,4326,4150,68,176,"PACMA",12
42,"42080",168,115,114,0,1,"PACMA",0
22,"22201",287,203,198,2,5,"PACMA",0
16,"16143",20,14,13,1,1,"PACMA",0
27,"27056",1388,1043,1026,16,17,"PACMA",8
21,"21052",4741,2897,2839,21,58,"PACMA",7
45,"45081",16099,12232,12079,154,153,"PACMA",73
44,"44232",408,301,295,5,6,"PACMA",0
50,"50224",70,52,49,2,3,"PACMA",0
46,"46185",422,360,359,7,1,"PACMA",0
16,"16018",417,350,342,3,8,"PACMA",1
9,"9903",3299,2373,2349,45,24,"PACMA",13
48,"48074",3384,2441,2397,20,44,"PACMA",8
49,"49221",266,148,147,6,1,"PACMA",0
28,"28060",1471,1205,1192,8,13,"PACMA",7
9,"9129",112,93,93,0,0,"PACMA",0
26,"26106",78,70,69,0,1,"PACMA",0
50,"50138",49,43,43,2,0,"PACMA",0
12,"12063",59,42,41,0,1,"PACMA",0
9,"9904",548,412,407,7,5,"PACMA",1
3,"3128",3944,2847,2812,16,35,"PACMA",9
18,"18034",510,377,375,2,2,"PACMA",1
9,"9083",27,21,21,0,0,"PACMA",0
37,"37033",86,64,63,1,1,"PACMA",1
11,"11012",103946,68124,67375,856,749,"PACMA",543
40,"40160",120,94,92,2,2,"PACMA",0
44,"44086",485,380,371,5,9,"PACMA",2
45,"45083",421,353,345,0,8,"PACMA",0
47,"47077",291,232,232,1,0,"PACMA",0
6,"6014",6843,4894,4839,30,55,"PACMA",12
49,"49223",770,606,601,8,5,"PACMA",0
19,"19249",38,32,32,0,0,"PACMA",0
45,"45047",2404,1685,1662,7,23,"PACMA",13
18,"18168",864,613,605,4,8,"PACMA",3
47,"47051",351,269,256,5,13,"PACMA",4
45,"45048",388,310,308,2,2,"PACMA",0
37,"37346",264,211,210,1,1,"PACMA",0
47,"47133",2382,1861,1841,30,20,"PACMA",13
34,"34167",124,105,105,0,0,"PACMA",0
50,"50198",46,36,36,2,0,"PACMA",0
50,"50023",240,180,180,4,0,"PACMA",0
27,"27061",1170,917,906,8,11,"PACMA",3
33,"33030",921,682,668,4,14,"PACMA",0
28,"28062",311,233,226,0,7,"PACMA",0
34,"34124",70,55,55,1,0,"PACMA",0
45,"45158",2577,1948,1909,18,39,"PACMA",6
44,"44070",62,47,47,1,0,"PACMA",0
22,"22053",867,567,554,13,13,"PACMA",2
50,"50171",126,90,89,4,1,"PACMA",0
27,"27062",681,535,532,7,3,"PACMA",1
50,"50053",756,570,563,14,7,"PACMA",5
24,"24213",162,134,133,1,1,"PACMA",0
46,"46042",3376,2873,2819,17,54,"PACMA",4
40,"40132",75,50,50,1,0,"PACMA",0
38,"38002",991,716,708,1,8,"PACMA",2
47,"47161",3886,3133,3105,45,28,"PACMA",6
34,"34041",100,79,78,1,1,"PACMA",0
26,"26027",169,126,126,1,0,"PACMA",0
47,"47135",93,77,76,0,1,"PACMA",0
40,"40119",182,149,145,2,4,"PACMA",2
16,"16064",699,588,580,4,8,"PACMA",3
42,"42087",48,38,37,1,1,"PACMA",1
22,"22253",71,54,54,1,0,"PACMA",0
11,"11016",14611,9848,9774,114,74,"PACMA",27
28,"28063",268,209,203,4,6,"PACMA",0
47,"47216",124,99,98,2,1,"PACMA",0
48,"48046",12635,9231,9161,61,70,"PACMA",28
40,"40024",920,712,704,7,8,"PACMA",0
9,"9408",45,36,36,0,0,"PACMA",0
29,"29017",6766,5162,5114,48,48,"PACMA",17
28,"28111",618,486,479,2,7,"PACMA",1
51,"51001",58533,32223,31745,498,478,"PACMA",186
47,"47163",315,253,250,2,3,"PACMA",0
19,"19243",53,39,39,0,0,"PACMA",0
44,"44075",329,250,240,4,10,"PACMA",0
24,"24216",782,582,574,3,8,"PACMA",0
47,"47137",27,22,22,2,0,"PACMA",0
44,"44120",217,126,121,5,5,"PACMA",0
26,"26158",296,238,237,7,1,"PACMA",0
24,"24134",3682,2636,2588,44,48,"PACMA",8
10,"10125",925,705,689,3,16,"PACMA",2
9,"9268",108,78,78,0,0,"PACMA",0
50,"50202",182,125,122,2,3,"PACMA",0
25,"25906",235,160,154,3,6,"PACMA",0
3,"3134",159,129,126,0,3,"PACMA",0
9,"9226",74,57,57,0,0,"PACMA",0
35,"35007",569,392,391,2,1,"PACMA",0
22,"22107",131,81,77,1,4,"PACMA",0
13,"13086",209,167,166,0,1,"PACMA",0
16,"16067",135,97,97,2,0,"PACMA",0
25,"25045",51,33,33,2,0,"PACMA",1
37,"37040",431,362,362,4,0,"PACMA",1
48,"48016",5214,3782,3736,46,46,"PACMA",16
9,"9227",131,100,100,1,0,"PACMA",1
33,"33056",5278,3576,3540,41,36,"PACMA",7
29,"29047",1165,973,969,0,4,"PACMA",0
40,"40124",261,190,183,9,7,"PACMA",3
22,"22213",3152,2265,2230,62,35,"PACMA",9
21,"21060",11685,8026,7932,135,94,"PACMA",39
50,"50288",3252,2412,2380,50,32,"PACMA",11
9,"9317",17,15,15,0,0,"PACMA",0
40,"40029",50,43,42,0,1,"PACMA",0
42,"42149",404,292,286,12,6,"PACMA",0
7,"7030",1576,1150,1135,26,15,"PACMA",1
28,"28022",30019,24469,24279,292,190,"PACMA",81
28,"28065",118796,93292,92186,919,1106,"PACMA",341
19,"19071",7346,5380,5294,76,86,"PACMA",31
16,"16202",908,753,744,10,9,"PACMA",1
9,"9154",150,107,107,3,0,"PACMA",0
5,"5224",104,90,90,0,0,"PACMA",0
13,"13022",403,314,314,2,0,"PACMA",0
47,"47057",237,198,198,3,0,"PACMA",1
50,"50058",80,65,64,0,1,"PACMA",1
37,"37128",261,211,210,2,1,"PACMA",1
40,"40126",96,80,78,0,2,"PACMA",1
38,"38008",5430,3844,3772,46,72,"PACMA",22
45,"45165",62818,47242,46629,549,613,"PACMA",203
10,"10129",374,279,276,2,3,"PACMA",1
28,"28181",20003,16133,15952,159,181,"PACMA",51
9,"9366",99,67,65,1,2,"PACMA",0
16,"16203",9839,7520,7342,101,178,"PACMA",12
33,"33035",11413,8105,8035,104,70,"PACMA",22
46,"46193",8494,6662,6580,73,82,"PACMA",19
19,"19148",56,41,38,1,3,"PACMA",0
32,"32003",950,736,727,3,9,"PACMA",2
42,"42006",166,110,107,3,3,"PACMA",0
32,"32039",1424,1084,1069,10,15,"PACMA",1
25,"25910",118,77,76,3,1,"PACMA",2
49,"49052",200,149,144,1,5,"PACMA",0
12,"12074",783,679,676,3,3,"PACMA",2
42,"42049",141,83,81,1,2,"PACMA",1
16,"16073",214,170,170,2,0,"PACMA",0
37,"37244",132,97,95,5,2,"PACMA",0
9,"9230",41,33,33,0,0,"PACMA",0
26,"26121",33,28,28,0,0,"PACMA",0
39,"39095",2292,1824,1801,24,23,"PACMA",4
24,"24142",24843,17695,17371,409,324,"PACMA",97
46,"46072",3711,3006,2932,38,74,"PACMA",12
26,"26166",152,139,136,1,3,"PACMA",0
49,"49053",978,809,796,10,13,"PACMA",2
37,"37205",235,199,195,5,4,"PACMA",0
44,"44002",62,47,47,1,0,"PACMA",0
28,"28116",666,507,498,5,9,"PACMA",1
50,"50129",258,164,164,0,0,"PACMA",0
42,"42201",27,24,24,2,0,"PACMA",0
29,"29068",6209,4025,3983,41,42,"PACMA",12
12,"12137",47,36,35,0,1,"PACMA",1
33,"33037",37135,25522,25262,291,260,"PACMA",76
9,"9101",79,66,66,2,0,"PACMA",0
42,"42097",19,16,16,0,0,"PACMA",0
49,"49250",1330,998,985,19,13,"PACMA",1
34,"34025",54,42,42,0,0,"PACMA",0
9,"9454",46,31,30,1,1,"PACMA",0
10,"10051",489,373,373,2,0,"PACMA",0
19,"19152",674,505,498,2,7,"PACMA",1
2,"2020",519,433,430,0,3,"PACMA",0
10,"10011",611,527,519,5,8,"PACMA",0
47,"47143",146,108,107,0,1,"PACMA",0
19,"19040",73,42,42,1,0,"PACMA",1
46,"46122",2737,2154,2131,18,23,"PACMA",10
45,"45097",1094,934,925,9,9,"PACMA",2
24,"24024",717,501,498,10,3,"PACMA",0
24,"24023",272,196,193,6,3,"PACMA",2
22,"22909",349,259,252,3,7,"PACMA",4
25,"25207",6253,3938,3872,91,66,"PACMA",15
47,"47034",90,65,63,0,2,"PACMA",0
19,"19115",41,26,26,1,0,"PACMA",0
13,"13094",338,276,275,2,1,"PACMA",0
46,"46123",1808,1440,1410,7,30,"PACMA",4
24,"24226",223,154,153,1,1,"PACMA",0
29,"29053",1715,1239,1221,7,18,"PACMA",4
37,"37284",334,256,254,1,2,"PACMA",1
16,"16094",142,112,111,1,1,"PACMA",0
46,"46250",574266,435877,431619,4626,4258,"PACMA",2344
5,"5101",297,224,222,4,2,"PACMA",0
30,"30023",3572,2859,2811,22,48,"PACMA",6
16,"16036",143,117,115,1,2,"PACMA",0
25,"25024",370,221,217,8,4,"PACMA",1
40,"40134",769,628,620,19,8,"PACMA",0
9,"9148",95,75,75,2,0,"PACMA",2
6,"6033",1387,1075,1068,6,7,"PACMA",4
47,"47145",658,482,473,7,9,"PACMA",0
13,"13029",102,90,89,0,1,"PACMA",0
12,"12078",365,273,267,5,6,"PACMA",0
47,"47062",185,153,153,5,0,"PACMA",0
34,"34015",45,40,40,0,0,"PACMA",0
9,"9375",42,30,30,1,0,"PACMA",0
45,"45172",757,597,594,7,3,"PACMA",1
32,"32009",10752,7778,7684,120,94,"PACMA",13
13,"13030",153,123,123,1,0,"PACMA",0
44,"44090",84,71,71,0,0,"PACMA",0
49,"49015",259,213,208,2,5,"PACMA",0
36,"36041",13141,9405,9238,114,167,"PACMA",34
40,"40135",298,247,242,4,5,"PACMA",0
46,"46149",398,307,305,1,2,"PACMA",1
35,"35015",9065,4859,4770,64,89,"PACMA",10
11,"11026",4834,3736,3691,27,45,"PACMA",4
29,"29901",41445,27372,27158,295,214,"PACMA",180
19,"19043",92,82,82,1,0,"PACMA",0
5,"5198",80,65,65,1,0,"PACMA",0
49,"49243",117,85,85,0,0,"PACMA",0
22,"22122",62,57,57,3,0,"PACMA",0
45,"45065",317,261,258,0,3,"PACMA",0
29,"29055",1837,1478,1454,12,24,"PACMA",4
1,"1053",590,341,333,4,8,"PACMA",1
12,"12012",2747,2196,2135,24,61,"PACMA",4
25,"25177",379,240,236,2,4,"PACMA",0
24,"24067",700,453,447,4,6,"PACMA",0
9,"9463",261,205,205,1,0,"PACMA",0
12,"12142",158,122,121,1,1,"PACMA",0
24,"24107",316,208,206,1,2,"PACMA",1
46,"46029",20887,16124,15988,144,136,"PACMA",46
19,"19326",1125,800,786,10,14,"PACMA",4
12,"12081",654,519,515,2,4,"PACMA",1
36,"36010",2987,2312,2282,30,30,"PACMA",8
34,"34018",229,184,182,3,2,"PACMA",1
44,"44094",116,105,103,4,2,"PACMA",0
25,"25121",623,406,400,6,6,"PACMA",4
25,"25211",701,378,368,5,10,"PACMA",1
26,"26175",57,46,45,1,1,"PACMA",0
21,"21040",3096,2370,2351,28,19,"PACMA",8
32,"32013",2464,1695,1671,10,24,"PACMA",5
22,"22228",501,382,369,15,13,"PACMA",4
50,"50270",39,30,29,1,1,"PACMA",1
34,"34019",139,108,108,5,0,"PACMA",1
26,"26131",44,36,36,0,0,"PACMA",0
39,"39102",2330,1748,1731,13,17,"PACMA",5
47,"47174",302,236,234,3,2,"PACMA",7
37,"37017",249,200,199,0,1,"PACMA",0
26,"26060",100,71,71,3,0,"PACMA",2
16,"16273",328,277,275,2,2,"PACMA",1
7,"7042",10393,6536,6421,96,115,"PACMA",48
3,"3045",233,204,203,2,1,"PACMA",1
25,"25001",146,76,76,1,0,"PACMA",0
50,"50126",2473,1747,1724,41,23,"PACMA",2
16,"16274",147,125,125,1,0,"PACMA",0
50,"50186",44,30,29,0,1,"PACMA",0
44,"44137",215,165,163,5,2,"PACMA",0
10,"10102",534,447,440,4,7,"PACMA",0
16,"16129",112,79,74,0,5,"PACMA",0
26,"26089",108356,81446,80090,1450,1356,"PACMA",372
19,"19330",93,81,81,2,0,"PACMA",0
36,"36013",2690,1801,1778,11,23,"PACMA",11
45,"45179",608,476,471,3,5,"PACMA",0
26,"26134",102,82,80,2,2,"PACMA",0
39,"39025",8985,7048,6955,70,93,"PACMA",20
21,"21042",15246,8640,8572,154,68,"PACMA",38
47,"47066",1114,891,888,10,3,"PACMA",2
5,"5107",74,54,53,0,1,"PACMA",0
42,"42166",68,49,48,1,1,"PACMA",2
25,"25002",481,306,302,6,4,"PACMA",2
50,"50096",49,35,35,0,0,"PACMA",0
9,"9384",310,223,218,3,5,"PACMA",0
44,"44100",200,147,146,0,1,"PACMA",1
21,"21043",1898,1382,1350,9,32,"PACMA",0
37,"37142",613,436,434,7,2,"PACMA",3
45,"45070",1415,1175,1162,11,13,"PACMA",2
12,"12085",4941,3183,3125,32,58,"PACMA",20
5,"5206",29,23,21,2,2,"PACMA",0
22,"22079",126,97,97,4,0,"PACMA",1
44,"44221",377,305,297,6,8,"PACMA",0
9,"9386",61,45,45,0,0,"PACMA",0
34,"34024",27,18,17,1,1,"PACMA",0
25,"25059",796,580,575,9,5,"PACMA",7
5,"5247",267,164,164,0,0,"PACMA",0
25,"25194",440,292,283,11,9,"PACMA",2
37,"37381",153,114,109,3,5,"PACMA",0
10,"10199",181,142,140,1,2,"PACMA",0
44,"44101",60,47,47,1,0,"PACMA",1
50,"50070",70,42,41,0,1,"PACMA",0
29,"29079",2500,2016,2000,23,16,"PACMA",1
9,"9007",66,50,50,0,0,"PACMA",0
30,"30013",7369,5780,5731,53,49,"PACMA",8
2,"2068",379,290,284,3,6,"PACMA",2
46,"46203",3669,3002,2964,36,38,"PACMA",5
44,"44143",382,292,292,5,0,"PACMA",2
10,"10147",1263,1003,965,5,38,"PACMA",5
39,"39028",3513,2760,2718,23,42,"PACMA",12
16,"16278",91,69,69,2,0,"PACMA",0
42,"42023",78,58,58,1,0,"PACMA",0
9,"9117",82,59,59,1,0,"PACMA",1
46,"46228",2434,1881,1859,30,22,"PACMA",14
27,"27046",1626,1177,1153,17,24,"PACMA",3
33,"33068",1224,704,703,5,1,"PACMA",2
28,"28169",1244,971,962,8,9,"PACMA",3
46,"46179",2186,1849,1804,17,45,"PACMA",4
9,"9034",301,250,250,3,0,"PACMA",1
5,"5239",215,171,170,2,1,"PACMA",1
37,"37371",285,190,190,2,0,"PACMA",0
22,"22083",522,437,428,4,9,"PACMA",1
34,"34108",561,477,465,6,12,"PACMA",1
25,"25034",2471,1622,1592,25,30,"PACMA",3
34,"34154",78,62,62,0,0,"PACMA",0
22,"22102",194,152,149,4,3,"PACMA",0
48,"48078",39866,27311,26995,311,316,"PACMA",167
40,"40208",828,650,638,7,12,"PACMA",1
22,"22189",199,140,138,5,2,"PACMA",1
50,"50043",258,170,166,2,4,"PACMA",4
26,"26013",350,267,264,5,3,"PACMA",2
34,"34028",154,128,126,1,2,"PACMA",1
9,"9345",134,102,102,1,0,"PACMA",0
9,"9209",4617,3269,3234,44,35,"PACMA",12
48,"48904",3510,2682,2665,26,17,"PACMA",10
50,"50248",552,421,407,5,14,"PACMA",2
5,"5209",104,78,78,0,0,"PACMA",0
3,"3052",984,837,820,10,17,"PACMA",6
16,"16177",86,68,68,0,0,"PACMA",0
24,"24118",132,96,96,2,0,"PACMA",0
26,"26014",472,358,353,6,5,"PACMA",1
40,"40055",41,32,31,0,1,"PACMA",0
5,"5013",890,746,739,4,7,"PACMA",1
24,"24161",307,231,228,1,3,"PACMA",1
22,"22085",119,97,94,0,3,"PACMA",0
26,"26015",205,167,165,1,2,"PACMA",0
47,"47071",406,333,329,6,4,"PACMA",1
28,"28171",4148,2972,2929,21,43,"PACMA",5
16,"16096",279,231,229,7,2,"PACMA",0
36,"36020",2581,1947,1922,27,25,"PACMA",4
19,"19901",43,34,34,0,0,"PACMA",0
24,"24119",742,524,510,15,14,"PACMA",0
12,"12091",203,153,140,2,13,"PACMA",0
46,"46036",675,440,431,11,9,"PACMA",0
9,"9255",90,68,68,0,0,"PACMA",0
44,"44228",121,97,96,2,1,"PACMA",0
5,"5211",484,406,405,3,1,"PACMA",0
50,"50164",407,271,268,4,3,"PACMA",0
5,"5179",231,206,204,2,2,"PACMA",0
16,"16903",1097,855,828,9,27,"PACMA",1
49,"49031",150,128,127,2,1,"PACMA",0
10,"10153",331,266,263,1,3,"PACMA",4
5,"5148",34,27,27,0,0,"PACMA",0
12,"12092",143,98,98,0,0,"PACMA",0
5,"5212",274,202,197,0,5,"PACMA",0
50,"50165",1880,1339,1274,49,65,"PACMA",3
44,"44229",150,108,107,5,1,"PACMA",0
19,"19097",28,27,27,0,0,"PACMA",0
46,"46110",21420,15810,15671,134,139,"PACMA",86
49,"49214",720,560,558,6,2,"PACMA",0
25,"25157",183,128,128,4,0,"PACMA",0
25,"25009",690,479,471,9,8,"PACMA",2
28,"28014",31360,23434,23133,203,301,"PACMA",85
37,"37070",538,428,427,12,1,"PACMA",1
32,"32061",1196,976,973,4,3,"PACMA",0
42,"42030",115,88,86,2,2,"PACMA",0
22,"22046",784,618,599,15,19,"PACMA",1
46,"46086",80,71,71,3,0,"PACMA",0
45,"45079",368,278,273,1,5,"PACMA",0
34,"34004",5790,4354,4262,84,92,"PACMA",18
9,"9125",648,463,460,5,3,"PACMA",3
22,"22246",93,63,62,0,1,"PACMA",0
6,"6100",1000,828,821,3,7,"PACMA",1
26,"26103",796,616,611,11,5,"PACMA",3
37,"37378",118,85,85,3,0,"PACMA",0
47,"47130",105,86,85,2,1,"PACMA",0
40,"40156",361,268,264,5,4,"PACMA",1
48,"48909",194,163,163,0,0,"PACMA",1
32,"32026",2775,2096,2064,37,32,"PACMA",9
40,"40015",33,30,30,1,0,"PACMA",0
40,"40061",66,53,52,1,1,"PACMA",0
5,"5052",102,91,91,0,0,"PACMA",0
45,"45007",747,641,632,1,9,"PACMA",1
2,"2041",399,311,304,1,7,"PACMA",0
45,"45117",800,679,668,7,11,"PACMA",0
5,"5246",68,57,56,1,1,"PACMA",0
33,"33051",7576,5379,5335,65,44,"PACMA",17
49,"49126",232,175,173,3,2,"PACMA",0
25,"25101",583,391,382,8,9,"PACMA",0
9,"9398",92,68,68,2,0,"PACMA",0
32,"32028",1805,1369,1354,16,15,"PACMA",1
5,"5018",27,24,24,0,0,"PACMA",0
9,"9259",239,178,177,2,1,"PACMA",0
44,"44113",79,57,55,0,2,"PACMA",1
50,"50281",76,63,63,2,0,"PACMA",0
19,"19172",76,65,64,1,1,"PACMA",0
34,"34077",283,219,216,3,3,"PACMA",0
5,"5215",186,138,136,1,2,"PACMA",0
46,"46064",547,463,458,2,5,"PACMA",1
12,"12096",854,663,653,17,10,"PACMA",3
48,"48009",767,585,580,4,5,"PACMA",1
9,"9261",486,342,338,7,4,"PACMA",1
50,"50282",88,66,63,3,3,"PACMA",0
39,"39035",10031,7685,7601,74,84,"PACMA",23
15,"15062",6304,4418,4356,44,62,"PACMA",10
9,"9275",202,140,139,5,1,"PACMA",0
2,"2018",922,759,754,7,5,"PACMA",1
48,"48021",1460,1024,1012,13,12,"PACMA",2
46,"46138",338,297,296,1,1,"PACMA",0
42,"42187",65,51,51,0,0,"PACMA",0
29,"29088",2784,2019,1975,14,44,"PACMA",1
33,"33014",9318,6380,6320,66,60,"PACMA",18
5,"5033",184,159,155,3,4,"PACMA",0
5,"5121",250,181,178,1,3,"PACMA",0
42,"42188",64,51,51,0,0,"PACMA",1
42,"42135",89,59,59,1,0,"PACMA",0
16,"16062",30,27,27,0,0,"PACMA",2
9,"9262",158,139,137,7,2,"PACMA",0
32,"32030",1120,857,846,9,11,"PACMA",4
34,"34080",6066,4238,4169,57,69,"PACMA",12
6,"6060",5865,4657,4592,67,65,"PACMA",8
25,"25013",2274,1344,1321,25,23,"PACMA",5
46,"46066",1264,1060,1050,5,10,"PACMA",8
9,"9442",385,295,289,4,6,"PACMA",3
9,"9047",62,48,45,0,3,"PACMA",0
50,"50256",90,59,59,1,0,"PACMA",0
9,"9265",44,36,35,2,1,"PACMA",0
45,"45085",1511,1111,1100,10,11,"PACMA",1
44,"44237",450,352,343,5,9,"PACMA",0
12,"12031",3748,2751,2687,35,64,"PACMA",14
47,"47079",67,56,56,1,0,"PACMA",0
16,"16107",161,101,98,1,3,"PACMA",0
33,"33054",1780,1272,1263,8,9,"PACMA",2
45,"45134",1606,1260,1242,10,18,"PACMA",2
25,"25023",4446,3079,3020,70,59,"PACMA",9
46,"46075",166,148,145,3,3,"PACMA",4
48,"48914",324,278,276,0,2,"PACMA",0
16,"16247",87,65,62,1,3,"PACMA",0
34,"34218",486,366,365,3,1,"PACMA",0
45,"45197",1972,1570,1538,8,32,"PACMA",0
44,"44118",183,129,127,2,2,"PACMA",0
9,"9088",77,40,40,0,0,"PACMA",0
34,"34169",431,331,329,5,2,"PACMA",0
3,"3132",571,464,461,8,3,"PACMA",4
40,"40211",72,65,65,1,0,"PACMA",0
28,"28086",4603,3286,3248,29,38,"PACMA",15
32,"32033",843,595,583,7,12,"PACMA",0
42,"42141",124,90,87,1,3,"PACMA",0
49,"49092",160,123,123,2,0,"PACMA",0
46,"46238",13401,10371,10283,96,88,"PACMA",19
26,"26068",83,65,64,0,1,"PACMA",1
3,"3133",40056,25746,25554,231,192,"PACMA",163
49,"49134",203,142,142,4,0,"PACMA",0
24,"24014",7677,5352,5289,75,63,"PACMA",10
40,"40165",95,72,71,1,1,"PACMA",0
22,"22105",132,104,102,2,2,"PACMA",0
37,"37274",123032,90819,89629,1506,1190,"PACMA",290
37,"37162",232,184,182,4,2,"PACMA",0
39,"39039",648,496,493,0,3,"PACMA",1
47,"47081",57,44,44,1,0,"PACMA",0
10,"10084",1416,994,972,12,22,"PACMA",1
47,"47028",31,21,20,0,1,"PACMA",0
19,"19310",13,9,8,0,1,"PACMA",0
40,"40026",114,98,97,2,1,"PACMA",0
25,"25137",8404,5264,5167,112,97,"PACMA",23
9,"9225",95,61,61,3,0,"PACMA",0
15,"15001",4985,3560,3506,63,54,"PACMA",18
42,"42089",54,44,44,3,0,"PACMA",0
16,"16153",1006,856,843,8,13,"PACMA",0
16,"16111",171,130,128,0,2,"PACMA",0
34,"34084",142,124,122,3,2,"PACMA",0
25,"25168",510,385,378,19,7,"PACMA",3
16,"16216",358,300,296,2,4,"PACMA",0
18,"18174",470,368,363,1,5,"PACMA",0
24,"24056",3200,2368,2332,53,36,"PACMA",12
7,"7062",7206,4073,4035,72,38,"PACMA",34
34,"34174",213,179,178,4,1,"PACMA",0
19,"19244",95,82,82,6,0,"PACMA",0
3,"3135",228,185,181,0,4,"PACMA",0
39,"39066",895,710,703,6,7,"PACMA",1
25,"25110",2662,1649,1602,44,47,"PACMA",6
7,"7063",1414,1050,1030,25,20,"PACMA",14
39,"39093",351,260,253,2,7,"PACMA",1
45,"45164",191,160,158,0,2,"PACMA",1
19,"19110",73,59,57,4,2,"PACMA",0
10,"10208",141,118,118,1,0,"PACMA",0
15,"15087",6054,4004,3956,79,48,"PACMA",10
28,"28089",3531,2786,2753,25,33,"PACMA",6
10,"10046",216,185,184,1,1,"PACMA",0
37,"37353",142,119,119,2,0,"PACMA",0
44,"44261",777,600,594,8,6,"PACMA",0
26,"26046",1617,1237,1219,14,18,"PACMA",0
50,"50176",237,161,160,4,1,"PACMA",0
5,"5225",423,346,342,8,4,"PACMA",1
29,"29094",54317,36540,36174,410,366,"PACMA",107
36,"36001",3138,2060,2049,13,11,"PACMA",7
44,"44123",117,79,78,2,1,"PACMA",0
18,"18911",6796,4923,4867,74,56,"PACMA",19
3,"3068",48,45,45,1,0,"PACMA",0
49,"49139",195,146,146,0,0,"PACMA",1
44,"44124",88,63,61,3,2,"PACMA",1
19,"19182",38,24,22,0,2,"PACMA",1
37,"37317",323,281,278,3,3,"PACMA",0
34,"34088",219,179,177,4,2,"PACMA",1
44,"44246",1591,1030,997,15,33,"PACMA",1
50,"50262",1216,916,904,20,12,"PACMA",4
29,"29021",153,113,113,0,0,"PACMA",0
49,"49234",439,336,332,5,4,"PACMA",0
18,"18012",2693,1841,1831,11,10,"PACMA",2
49,"49141",397,289,286,7,3,"PACMA",1
18,"18043",140,89,87,1,2,"PACMA",0
44,"44125",78,57,57,1,0,"PACMA",0
40,"40219",635,519,505,7,14,"PACMA",3
47,"47032",161,130,129,3,1,"PACMA",0
37,"37318",225,167,165,0,2,"PACMA",0
44,"44247",335,251,243,10,8,"PACMA",0
29,"29022",202,142,141,2,1,"PACMA",0
9,"9414",197,159,159,2,0,"PACMA",0
47,"47113",166,136,135,1,1,"PACMA",1
1,"1044",242,174,173,1,1,"PACMA",1
40,"40220",71,57,52,0,5,"PACMA",1
29,"29096",2880,2012,1971,28,41,"PACMA",5
48,"48020",276378,191777,190141,2335,1636,"PACMA",1014
50,"50031",167,105,103,0,2,"PACMA",0
32,"32065",720,550,539,3,11,"PACMA",0
24,"24210",532,329,328,2,1,"PACMA",0
28,"28182",219,179,178,2,1,"PACMA",1
26,"26037",150,129,128,1,1,"PACMA",0
11,"11022",48624,26656,26430,345,226,"PACMA",144
42,"42154",95,73,73,0,0,"PACMA",0
25,"25022",119,83,83,0,0,"PACMA",0
18,"18024",882,696,688,12,8,"PACMA",0
3,"3117",381,321,317,4,4,"PACMA",1
40,"40192",179,151,150,1,1,"PACMA",1
9,"9071",48,32,32,0,0,"PACMA",0
50,"50292",138,117,115,4,2,"PACMA",0
40,"40035",146,114,112,3,2,"PACMA",0
44,"44003",19,19,19,0,0,"PACMA",0
10,"10174",177,145,145,2,0,"PACMA",1
26,"26038",93,71,69,1,2,"PACMA",1
22,"22115",415,307,304,2,3,"PACMA",0
44,"44004",450,334,332,2,2,"PACMA",1
49,"49188",142,101,100,3,1,"PACMA",1
10,"10093",413,339,332,2,7,"PACMA",1
37,"37207",287,211,208,2,3,"PACMA",0
10,"10215",437,338,333,3,5,"PACMA",1
5,"5065",498,424,422,7,2,"PACMA",0
32,"32043",2679,2006,1985,14,21,"PACMA",8
9,"9021",62,33,33,1,0,"PACMA",0
37,"37183",425,321,316,3,5,"PACMA",0
13,"13028",10536,8503,8331,140,172,"PACMA",27
47,"47009",117,88,88,1,0,"PACMA",0
22,"22172",613,463,452,6,11,"PACMA",1
49,"49027",178,134,127,1,7,"PACMA",0
9,"9249",54,44,42,1,2,"PACMA",0
19,"19064",97,84,83,1,1,"PACMA",0
44,"44252",78,63,60,0,3,"PACMA",0
28,"28069",51,35,33,1,2,"PACMA",0
19,"19051",94,83,83,1,0,"PACMA",0
29,"29070",35228,23374,23146,258,228,"PACMA",130
5,"5133",62,49,49,0,0,"PACMA",0
47,"47088",121,100,100,0,0,"PACMA",0
38,"38013",2823,1856,1843,18,13,"PACMA",3
9,"9458",422,325,316,5,9,"PACMA",2
42,"42159",40,31,31,1,0,"PACMA",0
46,"46148",1400,1131,1114,13,17,"PACMA",6
33,"33039",1719,1325,1319,14,6,"PACMA",0
26,"26171",212,171,170,6,1,"PACMA",1
25,"25209",1558,1041,1009,22,32,"PACMA",5
40,"40181",4413,3439,3361,43,78,"PACMA",17
37,"37173",1643,1298,1285,26,13,"PACMA",0
12,"12010",280,232,229,3,3,"PACMA",1
13,"13063",3839,2801,2771,31,30,"PACMA",6
46,"46124",768,641,632,10,9,"PACMA",4
46,"46251",2599,2215,2179,21,36,"PACMA",1
50,"50123",428,335,332,9,3,"PACMA",1
12,"12121",1197,1050,1020,4,30,"PACMA",3
45,"45100",205,169,169,0,0,"PACMA",1
28,"28028",1615,1204,1173,11,31,"PACMA",12
12,"12045",388,301,286,2,15,"PACMA",0
44,"44008",1695,1280,1257,11,23,"PACMA",0
6,"6081",1114,870,865,10,5,"PACMA",0
49,"49017",264,189,187,1,2,"PACMA",3
5,"5168",3682,2846,2801,43,45,"PACMA",3
9,"9332",137,88,85,1,3,"PACMA",2
45,"45064",3801,2987,2953,38,34,"PACMA",6
48,"48092",792,603,600,5,3,"PACMA",0
40,"40088",303,242,238,0,4,"PACMA",3
22,"22176",173,154,149,2,5,"PACMA",0
26,"26044",60,48,46,1,2,"PACMA",0
39,"39005",1319,1048,1026,3,22,"PACMA",3
40,"40057",1522,1272,1260,19,12,"PACMA",5
9,"9433",67,46,45,2,1,"PACMA",0
19,"19130",58473,45114,44362,688,752,"PACMA",187
47,"47173",862,683,675,5,8,"PACMA",0
42,"42110",82,58,58,2,0,"PACMA",0
34,"34100",141,105,105,1,0,"PACMA",0
19,"19289",33,28,28,1,0,"PACMA",0
47,"47038",128,91,91,0,0,"PACMA",0
46,"46126",5471,4454,4392,53,62,"PACMA",14
37,"37364",893,653,644,10,9,"PACMA",1
37,"37176",136,103,100,1,3,"PACMA",0
50,"50094",1744,1220,1193,25,27,"PACMA",2
29,"29029",452,339,336,0,3,"PACMA",1
1,"1055",906,632,623,7,9,"PACMA",0
7,"7041",2077,1583,1549,27,34,"PACMA",4
9,"9027",54,48,43,0,5,"PACMA",0
10,"10059",414,352,349,4,3,"PACMA",0
9,"9466",151,111,110,1,1,"PACMA",0
5,"5149",128,97,97,1,0,"PACMA",0
46,"46262",228,161,158,0,3,"PACMA",0
22,"22076",331,241,235,3,6,"PACMA",0
29,"29001",4176,3339,3303,23,36,"PACMA",9
49,"49246",248,212,210,1,2,"PACMA",0
5,"5171",84,74,73,0,1,"PACMA",1
16,"16170",733,552,543,3,9,"PACMA",0
9,"9067",460,335,328,5,7,"PACMA",1
47,"47121",590,495,490,4,5,"PACMA",0
19,"19329",62,52,50,0,2,"PACMA",1
22,"22127",483,357,353,9,4,"PACMA",2
9,"9029",186,138,137,4,1,"PACMA",1
19,"19246",48,38,38,1,0,"PACMA",0
47,"47040",67,51,50,0,1,"PACMA",0
37,"37179",230,194,191,3,3,"PACMA",0
5,"5139",74,62,59,2,3,"PACMA",0
49,"49155",105,85,85,0,0,"PACMA",0
44,"44263",332,249,243,10,6,"PACMA",4
25,"25031",57,34,34,1,0,"PACMA",0
49,"49156",265,217,214,6,3,"PACMA",1
34,"34023",5318,3947,3891,64,56,"PACMA",19
19,"19087",22,16,16,0,0,"PACMA",0
5,"5204",654,521,516,7,5,"PACMA",0
25,"25132",128,87,85,3,2,"PACMA",0
28,"28153",608,422,406,1,16,"PACMA",5
46,"46007",11576,8929,8848,71,81,"PACMA",33
37,"37180",69,46,46,0,0,"PACMA",0
9,"9160",104,75,74,0,1,"PACMA",0
47,"47015",229,172,170,1,2,"PACMA",0
21,"21074",2752,1981,1968,15,13,"PACMA",1
1,"1010",2276,1649,1618,27,31,"PACMA",9
47,"47094",154,129,127,0,2,"PACMA",0
25,"25032",71,44,42,1,2,"PACMA",0
9,"9070",38,27,27,3,0,"PACMA",0
36,"36037",2727,1923,1896,18,27,"PACMA",9
49,"49186",273,205,204,1,1,"PACMA",0
40,"40221",50,41,41,0,0,"PACMA",0
13,"13091",570,484,478,0,6,"PACMA",1
16,"16191",1001,867,864,13,3,"PACMA",1
9,"9428",124,107,107,1,0,"PACMA",0
44,"44053",111,77,76,2,1,"PACMA",1
25,"25225",603,395,387,7,8,"PACMA",4
47,"47104",2917,2391,2357,31,34,"PACMA",6
26,"26024",273,220,219,2,1,"PACMA",0
15,"15081",1139,869,853,9,16,"PACMA",3
30,"30005",29081,22312,22142,184,170,"PACMA",87
39,"39001",2146,1669,1645,20,24,"PACMA",5
22,"22131",96,79,77,2,2,"PACMA",1
37,"37219",197,121,120,0,1,"PACMA",0
18,"18089",15803,10794,10712,95,82,"PACMA",17
26,"26011",7455,5452,5353,93,99,"PACMA",21
12,"12088",55,51,51,2,0,"PACMA",0
40,"40006",23,20,20,0,0,"PACMA",0
50,"50071",134,97,96,0,1,"PACMA",1
9,"9248",63,52,52,0,0,"PACMA",0
24,"24115",54654,38629,38010,716,619,"PACMA",179
45,"45035",307,236,236,3,0,"PACMA",0
34,"34107",91,67,67,4,0,"PACMA",0
21,"21015",728,453,447,6,6,"PACMA",0
28,"28085",3794,2980,2933,18,47,"PACMA",9
19,"19196",99,80,74,2,6,"PACMA",0
9,"9389",77,66,66,0,0,"PACMA",0
13,"13039",14349,10928,10776,149,152,"PACMA",33
42,"42085",219,167,167,2,0,"PACMA",0
25,"25135",1077,739,722,18,17,"PACMA",4
46,"46172",4838,3492,3445,24,47,"PACMA",13
34,"34094",64,47,44,1,3,"PACMA",0
29,"29080",6598,4703,4663,31,40,"PACMA",9
42,"42140",17,10,10,0,0,"PACMA",0
19,"19015",104,88,87,0,1,"PACMA",0
1,"1016",461,241,237,2,4,"PACMA",1
40,"40103",157,121,120,0,1,"PACMA",1
48,"48012",2036,1630,1616,9,14,"PACMA",4
12,"12020",131,109,107,1,2,"PACMA",0
50,"50101",922,648,637,8,11,"PACMA",1
42,"42174",188,142,138,5,4,"PACMA",1
5,"5145",57,41,41,0,0,"PACMA",0
24,"24160",741,545,539,17,6,"PACMA",6
44,"44146",185,160,159,8,1,"PACMA",0
42,"42026",25,16,16,0,0,"PACMA",0
30,"30007",6115,4651,4603,29,48,"PACMA",7
9,"9301",625,510,504,11,6,"PACMA",0
19,"19299",94,75,75,0,0,"PACMA",0
16,"16051",166,140,140,1,0,"PACMA",0
18,"18059",4055,3232,3191,37,41,"PACMA",5
18,"18127",15897,11597,11483,133,114,"PACMA",47
16,"16152",42,38,37,3,1,"PACMA",0
18,"18194",2258,1656,1652,11,4,"PACMA",0
25,"25128",151,83,81,1,2,"PACMA",1
39,"39065",272,199,197,2,2,"PACMA",0
16,"16139",346,279,277,2,2,"PACMA",0
52,"52001",51028,26966,26659,496,307,"PACMA",135
9,"9037",122,91,90,2,1,"PACMA",1
3,"3088",5381,4056,3988,47,68,"PACMA",9
40,"40198",30,21,20,0,1,"PACMA",0
7,"7050",3099,2008,1979,45,29,"PACMA",6
10,"10070",765,614,613,5,1,"PACMA",1
19,"19300",746,595,585,3,10,"PACMA",3
47,"47181",170,128,128,1,0,"PACMA",0
16,"16053",414,334,326,2,8,"PACMA",2
28,"28064",143,112,110,1,2,"PACMA",0
26,"26114",87,74,72,0,2,"PACMA",0
9,"9348",150,122,122,2,0,"PACMA",0
40,"40230",117,92,90,1,2,"PACMA",1
9,"9304",197,168,165,1,3,"PACMA",0
42,"42029",164,114,113,1,1,"PACMA",0
26,"26058",151,114,109,1,5,"PACMA",1
16,"16098",586,480,474,10,6,"PACMA",2
42,"42127",47,35,35,0,0,"PACMA",0
16,"16186",521,434,429,2,5,"PACMA",0
45,"45078",1451,1243,1228,7,15,"PACMA",3
22,"22245",329,261,257,3,4,"PACMA",0
39,"39084",873,647,642,4,5,"PACMA",1
9,"9170",218,158,157,0,1,"PACMA",0
25,"25202",110,62,59,3,3,"PACMA",0
9,"9078",41,37,35,0,2,"PACMA",0
16,"16141",161,132,131,1,1,"PACMA",0
13,"13077",3654,2535,2480,31,55,"PACMA",3
32,"32025",1218,954,941,12,13,"PACMA",2
35,"35026",78933,49860,48955,780,905,"PACMA",180
42,"42195",112,74,72,1,2,"PACMA",0
37,"37165",27,20,20,1,0,"PACMA",0
16,"16100",764,660,655,3,5,"PACMA",1
3,"3090",16226,12224,12116,139,108,"PACMA",74
9,"9351",63,46,44,0,2,"PACMA",0
37,"37303",207,158,152,3,6,"PACMA",2
40,"40109",84,70,67,0,3,"PACMA",0
47,"47075",4999,4020,3957,39,63,"PACMA",10
45,"45153",1704,1376,1353,9,23,"PACMA",3
40,"40202",79,59,58,0,1,"PACMA",0
24,"24166",1521,1137,1112,27,25,"PACMA",3
45,"45006",1524,1128,1110,13,18,"PACMA",3
9,"9001",29,25,25,0,0,"PACMA",0
19,"19008",34,25,25,1,0,"PACMA",0
50,"50261",246,199,199,4,0,"PACMA",0
50,"50297",495260,360632,355561,7046,5071,"PACMA",2030
45,"45043",827,679,670,3,9,"PACMA",3
21,"21022",173,123,123,1,0,"PACMA",0
40,"40016",63,45,45,0,0,"PACMA",0
44,"44152",62,50,50,3,0,"PACMA",0
28,"28083",8037,6078,6025,66,53,"PACMA",22
30,"30012",9037,7242,7142,62,100,"PACMA",20
28,"28038",4999,3659,3590,32,69,"PACMA",12
27,"27011",2663,1822,1785,23,37,"PACMA",3
22,"22112",9618,6642,6533,205,109,"PACMA",32
25,"25234",4572,2707,2648,57,59,"PACMA",7
16,"16058",120,103,102,1,1,"PACMA",0
22,"22050",100,84,83,0,1,"PACMA",0
45,"45119",3274,2279,2236,37,43,"PACMA",24
38,"38032",13032,8487,8357,101,130,"PACMA",43
26,"26063",131,104,102,2,2,"PACMA",0
3,"3093",19646,15399,15159,173,240,"PACMA",79
16,"16244",735,615,606,3,9,"PACMA",0
33,"33006",1674,1130,1120,10,10,"PACMA",5
37,"37368",18,15,15,1,0,"PACMA",0
15,"15053",8164,5679,5592,60,87,"PACMA",11
50,"50021",42,34,33,1,1,"PACMA",0
19,"19113",519,396,395,4,1,"PACMA",1
46,"46073",1119,931,915,14,16,"PACMA",5
37,"37046",11929,8847,8683,146,164,"PACMA",25
37,"37232",412,374,373,1,1,"PACMA",1
50,"50060",187,138,136,1,2,"PACMA",0
47,"47124",435,364,358,5,6,"PACMA",0
22,"22081",268,197,196,4,1,"PACMA",2
36,"36049",6608,5189,5097,56,92,"PACMA",24
34,"34038",284,228,225,9,3,"PACMA",1
37,"37307",177,132,130,0,2,"PACMA",1
6,"6106",447,335,333,7,2,"PACMA",2
22,"22008",194,168,167,11,1,"PACMA",0
22,"22151",97,71,71,0,0,"PACMA",0
9,"9403",98,75,75,0,0,"PACMA",0
47,"47186",251279,193705,191693,2746,2012,"PACMA",771
19,"19306",42,31,31,1,0,"PACMA",0
49,"49130",218,159,156,3,3,"PACMA",0
39,"39010",688,533,524,6,9,"PACMA",1
28,"28061",19624,15082,14905,162,177,"PACMA",55
50,"50090",165,117,117,1,0,"PACMA",0
30,"30014",1686,1400,1387,10,13,"PACMA",3
28,"28155",529,427,416,2,11,"PACMA",0
16,"16093",80,57,57,0,0,"PACMA",0
26,"26110",178,149,147,3,2,"PACMA",0
19,"19240",64,47,46,1,1,"PACMA",0
16,"16149",179,140,138,2,2,"PACMA",0
15,"15046",6949,4641,4539,56,102,"PACMA",12
1,"1049",147,115,115,1,0,"PACMA",0
46,"46058",1787,1460,1441,10,19,"PACMA",9
36,"36028",4207,3294,3254,21,40,"PACMA",14
29,"29044",866,631,627,3,4,"PACMA",2
16,"16081",64,46,45,1,1,"PACMA",1
9,"9406",242,193,193,2,0,"PACMA",3
50,"50024",652,541,531,8,10,"PACMA",0
45,"45012",683,572,566,10,6,"PACMA",1
19,"19286",743,566,554,8,12,"PACMA",2
47,"47027",2680,2059,2024,23,35,"PACMA",5
37,"37037",130,100,99,0,1,"PACMA",0
47,"47053",125,100,99,1,1,"PACMA",0
18,"18103",803,653,647,5,6,"PACMA",0
19,"19004",67,56,56,0,0,"PACMA",0
45,"45087",8428,6434,6292,74,142,"PACMA",19
50,"50082",108,73,72,0,1,"PACMA",0
37,"37001",224,182,181,0,1,"PACMA",0
5,"5220",386,316,312,0,4,"PACMA",2
49,"49042",271,216,216,1,0,"PACMA",1
48,"48080",10161,6901,6815,95,86,"PACMA",35
13,"13085",2455,2146,2118,21,28,"PACMA",5
19,"19031",18,11,11,0,0,"PACMA",0
6,"6034",190,134,129,3,5,"PACMA",1
24,"24174",525,393,387,6,6,"PACMA",0
1,"1034",177,140,137,1,3,"PACMA",0
22,"22175",211,158,158,9,0,"PACMA",1
49,"49178",679,469,461,9,8,"PACMA",1
48,"48058",977,706,700,2,6,"PACMA",0
33,"33078",159,108,106,1,2,"PACMA",0
10,"10165",274,231,229,0,2,"PACMA",0
18,"18105",5222,3866,3839,32,27,"PACMA",3
48,"48081",1938,1449,1435,14,14,"PACMA",7
3,"3099",41561,32556,32248,288,308,"PACMA",84
22,"22057",377,283,278,3,5,"PACMA",1
44,"44201",526,449,443,9,6,"PACMA",0
50,"50045",1289,1011,992,14,19,"PACMA",0
24,"24188",3830,2987,2928,51,59,"PACMA",4
29,"29083",2212,1679,1652,15,27,"PACMA",6
3,"3122",40476,29591,29265,341,326,"PACMA",178
46,"46158",1037,829,822,9,7,"PACMA",1
34,"34046",45,35,34,0,1,"PACMA",0
28,"28043",5944,4199,4147,56,52,"PACMA",11
47,"47003",263,224,222,1,2,"PACMA",0
9,"9363",1047,798,792,9,6,"PACMA",0
45,"45054",4285,3321,3274,32,47,"PACMA",5
13,"13087",22953,16674,16376,298,298,"PACMA",64
6,"6159",2341,1522,1510,8,12,"PACMA",5
5,"5026",229,193,192,2,1,"PACMA",0
24,"24189",5410,3630,3572,83,58,"PACMA",16
44,"44204",24,21,21,0,0,"PACMA",0
50,"50085",205,143,143,3,0,"PACMA",1
25,"25231",515,402,395,4,7,"PACMA",1
45,"45091",419,311,309,5,2,"PACMA",1
19,"19314",46,41,41,0,0,"PACMA",0
50,"50095",12558,9029,8910,179,119,"PACMA",22
47,"47039",196,163,163,1,0,"PACMA",0
30,"30010",6804,5691,5647,36,44,"PACMA",22
10,"10168",318,240,238,1,2,"PACMA",0
45,"45092",252,223,221,0,2,"PACMA",0
40,"40077",713,526,519,12,7,"PACMA",7
37,"37316",792,565,559,7,6,"PACMA",0
42,"42046",55,35,35,0,0,"PACMA",0
7,"7064",5286,3340,3279,53,61,"PACMA",32
6,"6070",7805,6083,6001,76,82,"PACMA",17
5,"5161",638,525,522,0,3,"PACMA",5
49,"49183",111,87,87,2,0,"PACMA",0
9,"9321",1760,1338,1327,20,11,"PACMA",1
10,"10196",309,244,244,1,0,"PACMA",0
16,"16071",25,23,23,0,0,"PACMA",0
40,"40173",148,121,120,3,1,"PACMA",1
27,"27025",3005,2414,2377,25,37,"PACMA",10
9,"9413",500,335,331,1,4,"PACMA",2
12,"12039",870,743,736,4,7,"PACMA",1
50,"50087",31,25,25,0,0,"PACMA",0
25,"25909",141,82,78,0,4,"PACMA",0
37,"37243",123,89,88,1,1,"PACMA",0
24,"24020",480,326,324,9,2,"PACMA",0
7,"7065",2061,1376,1345,29,31,"PACMA",11
33,"33028",1466,812,806,5,6,"PACMA",1
2,"2005",602,490,488,2,2,"PACMA",1
18,"18912",1576,1193,1185,7,8,"PACMA",1
33,"33058",1863,1307,1286,11,21,"PACMA",2
46,"46242",361,288,280,4,8,"PACMA",0
34,"34227",84,69,67,3,2,"PACMA",0
46,"46121",116,103,101,0,2,"PACMA",0
34,"34051",112,92,91,7,1,"PACMA",0
16,"16205",126,94,93,0,1,"PACMA",0
42,"42200",98,70,67,1,3,"PACMA",1
48,"48053",856,683,680,8,3,"PACMA",0
42,"42185",29,23,23,1,0,"PACMA",0
10,"10049",3952,3348,3259,36,89,"PACMA",12
21,"21003",691,540,536,7,4,"PACMA",0
33,"33075",305,191,190,0,1,"PACMA",0
37,"37089",74,54,54,2,0,"PACMA",0
9,"9451",244,208,202,1,6,"PACMA",2
18,"18913",827,653,646,2,7,"PACMA",1
26,"26023",505,386,380,6,6,"PACMA",0
19,"19239",99,74,73,1,1,"PACMA",0
42,"42083",28,25,25,0,0,"PACMA",0
19,"19103",303,247,244,3,3,"PACMA",0
45,"45071",1896,1592,1575,21,17,"PACMA",4
16,"16206",250,188,188,2,0,"PACMA",0
16,"16264",505,440,438,6,2,"PACMA",0
19,"19114",40,34,34,0,0,"PACMA",0
9,"9455",48,39,39,0,0,"PACMA",0
18,"18015",465,381,379,1,2,"PACMA",0
27,"27029",1525,1243,1221,18,22,"PACMA",11
45,"45023",1936,1476,1456,18,20,"PACMA",9
10,"10052",186,138,138,0,0,"PACMA",0
44,"44250",20,11,11,1,0,"PACMA",0
5,"5132",1040,770,753,2,17,"PACMA",3
35,"35030",8295,5433,5315,54,118,"PACMA",6
42,"42156",30,21,21,0,0,"PACMA",0
46,"46147",16527,11836,11716,105,120,"PACMA",69
44,"44197",60,37,37,1,0,"PACMA",0
19,"19229",83,71,68,0,3,"PACMA",0
13,"13005",23052,18002,17700,255,302,"PACMA",40
39,"39072",375,234,234,4,0,"PACMA",1
32,"32007",1674,1263,1243,4,20,"PACMA",3
6,"6047",878,686,680,5,6,"PACMA",1
47,"47026",59,46,46,1,0,"PACMA",0
42,"42205",99,70,70,0,0,"PACMA",0
40,"40083",88,72,72,1,0,"PACMA",0
28,"28140",2665,2167,2141,26,26,"PACMA",9
40,"40224",34,25,25,0,0,"PACMA",0
37,"37372",145,109,109,0,0,"PACMA",0
29,"29099",958,739,730,5,9,"PACMA",1
25,"25005",291,194,190,7,4,"PACMA",1
40,"40225",1152,931,918,10,13,"PACMA",2
10,"10054",551,435,428,6,7,"PACMA",0
37,"37323",549,427,418,6,9,"PACMA",0
45,"45135",4437,3621,3550,44,71,"PACMA",9
48,"48068",1577,1224,1213,4,11,"PACMA",1
10,"10096",3384,2581,2533,32,48,"PACMA",2
42,"42055",183,128,127,4,1,"PACMA",0
22,"22174",520,401,394,11,7,"PACMA",0
9,"9329",117,80,79,1,1,"PACMA",0
29,"29054",39904,27540,27307,240,233,"PACMA",129
47,"47036",257,212,212,1,0,"PACMA",0
50,"50092",329,273,272,0,1,"PACMA",3
1,"1001",2010,1362,1336,26,26,"PACMA",11
12,"12090",127,109,107,2,2,"PACMA",0
6,"6141",1803,1419,1397,23,22,"PACMA",4
39,"39082",1688,1280,1266,9,14,"PACMA",0
50,"50044",259,175,175,0,0,"PACMA",1
15,"15038",2363,1643,1610,29,33,"PACMA",0
22,"22208",168,136,133,2,3,"PACMA",1
37,"37211",223,169,169,1,0,"PACMA",0
9,"9196",161,111,110,0,1,"PACMA",0
16,"16165",84,70,70,0,0,"PACMA",1
34,"34057",483,365,357,2,8,"PACMA",3
18,"18018",658,520,514,4,6,"PACMA",2
45,"45027",433,352,349,1,3,"PACMA",0
46,"46252",142,108,107,1,1,"PACMA",0
16,"16110",98,81,81,3,0,"PACMA",1
25,"25221",125,76,76,0,0,"PACMA",0
26,"26003",446,388,387,8,1,"PACMA",1
19,"19167",136,112,109,4,3,"PACMA",0
22,"22232",98,78,75,0,3,"PACMA",0
5,"5226",92,67,67,0,0,"PACMA",0
38,"38050",2516,1765,1734,9,31,"PACMA",3
16,"16271",659,568,566,4,2,"PACMA",3
49,"49244",48,30,30,1,0,"PACMA",0
28,"28072",5232,4065,4007,35,58,"PACMA",11
47,"47119",101,78,77,0,1,"PACMA",0
9,"9422",24,18,16,0,2,"PACMA",0
40,"40044",160,117,114,4,3,"PACMA",2
44,"44260",160,117,115,5,2,"PACMA",0
37,"37328",218,155,149,2,6,"PACMA",1
37,"37151",150,125,121,1,4,"PACMA",0
28,"28051",1469,1147,1129,7,18,"PACMA",6
16,"16217",113,95,92,0,3,"PACMA",0
19,"19120",107,95,95,1,0,"PACMA",0
44,"44049",886,652,627,6,25,"PACMA",1
16,"16003",147,122,121,0,1,"PACMA",0
26,"26059",1137,887,869,9,18,"PACMA",5
5,"5257",153,105,104,0,1,"PACMA",0
5,"5267",102,78,77,1,1,"PACMA",0
45,"45103",457,400,394,0,6,"PACMA",0
33,"33042",4434,3172,3135,43,37,"PACMA",11
21,"21071",216,169,169,5,0,"PACMA",3
22,"22077",421,327,323,14,4,"PACMA",0
33,"33073",9341,5825,5773,69,52,"PACMA",7
32,"32014",1271,939,925,9,14,"PACMA",0
30,"30028",6810,5333,5251,44,82,"PACMA",10
5,"5235",136,120,119,2,1,"PACMA",0
46,"46249",9650,7288,7191,125,97,"PACMA",19
33,"33065",1150,791,784,16,7,"PACMA",3
5,"5192",96,78,77,1,1,"PACMA",0
9,"9424",42,35,34,1,1,"PACMA",0
25,"25057",198,140,136,2,4,"PACMA",1
15,"15014",4239,3151,3104,39,47,"PACMA",5
22,"22182",271,160,150,4,10,"PACMA",0
47,"47229",235,161,161,1,0,"PACMA",0
21,"21012",331,254,246,2,8,"PACMA",0
11,"11030",22528,14741,14557,195,184,"PACMA",68
26,"26178",88,74,73,1,1,"PACMA",0
29,"29031",1652,1123,1118,11,5,"PACMA",0
25,"25218",94,75,73,1,2,"PACMA",0
9,"9478",53,41,41,1,0,"PACMA",0
30,"30011",4687,3776,3726,20,50,"PACMA",13
9,"9353",62,51,51,2,0,"PACMA",0
44,"44026",89,69,69,0,0,"PACMA",0
25,"25151",641,451,444,20,7,"PACMA",1
49,"49202",221,158,157,2,1,"PACMA",0
11,"11003",1290,952,940,8,12,"PACMA",0
3,"3116",1167,912,904,12,8,"PACMA",4
15,"15015",2840,2006,1964,43,42,"PACMA",6
40,"40903",102,75,75,0,0,"PACMA",0
16,"16276",32,23,22,1,1,"PACMA",0
5,"5130",95,76,76,0,0,"PACMA",1
10,"10145",132,112,111,0,1,"PACMA",0
45,"45180",2714,2018,1980,19,38,"PACMA",4
40,"40174",402,292,290,5,2,"PACMA",0
3,"3104",26809,20511,20193,317,318,"PACMA",133
25,"25049",166,105,102,1,3,"PACMA",0
42,"42153",19,16,16,0,0,"PACMA",0
46,"46146",1718,1395,1374,10,21,"PACMA",3
22,"22908",231,167,162,2,5,"PACMA",0
37,"37345",179,156,156,2,0,"PACMA",0
45,"45144",839,701,691,11,10,"PACMA",2
5,"5216",237,195,192,0,3,"PACMA",0
9,"9206",65,56,55,2,1,"PACMA",0
12,"12117",3674,2846,2794,25,52,"PACMA",5
46,"46033",220,183,181,0,2,"PACMA",0
9,"9387",121,92,91,3,1,"PACMA",0
32,"32091",1971,1472,1466,12,6,"PACMA",0
5,"5077",205,164,160,2,4,"PACMA",0
44,"44266",134,107,105,2,2,"PACMA",0
22,"22235",101,88,87,1,1,"PACMA",0
40,"40146",270,222,222,0,0,"PACMA",0
32,"32018",1351,1100,1092,9,8,"PACMA",0
42,"42052",17,10,10,0,0,"PACMA",0
9,"9388",32,25,24,2,1,"PACMA",0
3,"3130",43,30,29,0,1,"PACMA",0
26,"26025",78,69,69,1,0,"PACMA",0
50,"50228",295,238,236,10,2,"PACMA",1
37,"37036",74,54,52,0,2,"PACMA",0
22,"22137",1164,850,839,14,11,"PACMA",3
25,"25901",315,196,189,3,7,"PACMA",0
34,"34067",142,88,88,3,0,"PACMA",0
50,"50033",81,64,64,0,0,"PACMA",0
26,"26052",181,146,146,0,0,"PACMA",0
26,"26080",529,427,425,2,2,"PACMA",1
37,"37092",1403,1034,1022,12,12,"PACMA",4
38,"38046",8848,6410,6301,75,109,"PACMA",42
3,"3095",4498,3558,3517,29,41,"PACMA",9
45,"45074",428,349,343,3,6,"PACMA",1
44,"44238",2475,1718,1692,50,26,"PACMA",3
40,"40070",137,91,91,0,0,"PACMA",1
49,"49207",279,206,204,2,2,"PACMA",1
46,"46108",550,446,444,3,2,"PACMA",1
11,"11006",24221,16564,16470,197,94,"PACMA",30
50,"50152",1569,1151,1135,31,16,"PACMA",2
6,"6003",875,705,691,4,14,"PACMA",1
42,"42071",186,104,103,3,1,"PACMA",0
19,"19335",77,61,61,1,0,"PACMA",0
30,"30016",149046,103847,102890,1031,957,"PACMA",502
45,"45001",1901,1468,1431,14,37,"PACMA",7
12,"12021",4433,3368,3292,42,76,"PACMA",2
5,"5241",3145,2303,2273,27,30,"PACMA",8
19,"19166",179,123,121,4,2,"PACMA",2
46,"46213",15621,11361,11164,214,197,"PACMA",35
22,"22254",1175,868,856,14,12,"PACMA",6
10,"10001",270,231,229,2,2,"PACMA",0
40,"40121",325,266,262,3,4,"PACMA",0
5,"5059",112,91,88,1,3,"PACMA",0
40,"40041",1035,819,799,14,20,"PACMA",4
19,"19177",82,67,66,0,1,"PACMA",1
47,"47209",43,33,33,0,0,"PACMA",0
15,"15020",4187,2802,2781,18,21,"PACMA",4
26,"26100",59,51,51,1,0,"PACMA",0
25,"25156",761,535,529,15,6,"PACMA",2
6,"6142",284,240,235,4,5,"PACMA",0
16,"16140",34,27,27,0,0,"PACMA",0
46,"46125",858,724,710,6,14,"PACMA",0
37,"37027",242,196,192,2,4,"PACMA",0
22,"22195",231,193,189,6,4,"PACMA",2
47,"47212",386,327,325,1,2,"PACMA",1
46,"46212",1598,1233,1218,5,15,"PACMA",4
5,"5236",147,101,101,0,0,"PACMA",0
46,"46037",1146,1007,1003,5,4,"PACMA",7
29,"29065",207,151,149,1,2,"PACMA",0
22,"22197",504,395,390,7,5,"PACMA",0
33,"33026",9144,6019,5959,87,60,"PACMA",16
49,"49032",369,295,291,0,4,"PACMA",1
50,"50018",973,761,755,12,6,"PACMA",1
47,"47156",182,155,148,0,7,"PACMA",1
50,"50046",201,155,153,2,2,"PACMA",0
25,"25190",271,180,176,12,4,"PACMA",0
42,"42194",200,165,163,4,2,"PACMA",0
15,"15002",21528,15479,15218,314,261,"PACMA",67
38,"38006",35862,18726,18500,209,226,"PACMA",148
45,"45017",268,215,212,1,3,"PACMA",0
3,"3100",540,448,443,2,5,"PACMA",1
19,"19098",22,18,18,0,0,"PACMA",0
25,"25203",8995,5418,5309,116,109,"PACMA",35
29,"29057",413,311,308,2,3,"PACMA",0
16,"16086",935,814,802,14,12,"PACMA",1
46,"46232",920,730,722,6,8,"PACMA",0
18,"18001",288,212,212,1,0,"PACMA",0
25,"25038",1606,1104,1093,19,11,"PACMA",6
19,"19302",64,60,60,2,0,"PACMA",0
10,"10169",587,460,450,2,10,"PACMA",0
9,"9902",491,363,357,4,6,"PACMA",4
47,"47048",204,168,167,2,1,"PACMA",0
16,"16017",406,337,334,1,3,"PACMA",1
9,"9079",49,44,44,1,0,"PACMA",1
44,"44064",93,63,62,0,1,"PACMA",1
34,"34061",116,78,78,2,0,"PACMA",0
16,"16142",118,93,93,1,0,"PACMA",0
45,"45093",168,133,133,0,0,"PACMA",0
24,"24044",176,138,136,2,2,"PACMA",0
44,"44231",54,38,36,2,2,"PACMA",0
35,"35027",10510,7523,7375,88,148,"PACMA",30
19,"19237",53,40,39,2,1,"PACMA",0
40,"40158",24,18,17,0,1,"PACMA",0
24,"24209",3016,2006,1984,20,22,"PACMA",7
40,"40053",116,92,90,1,2,"PACMA",0
19,"19264",45,39,39,0,0,"PACMA",0
9,"9405",143,106,105,2,1,"PACMA",0
37,"37059",132,110,110,2,0,"PACMA",0
22,"22906",190,152,147,3,5,"PACMA",1
44,"44039",255,189,189,5,0,"PACMA",0
48,"48041",721,588,585,9,3,"PACMA",3
21,"21023",2106,1471,1456,7,15,"PACMA",2
37,"37074",172,136,135,1,1,"PACMA",0
9,"9354",33,29,29,2,0,"PACMA",0
28,"28084",15408,11489,11355,122,134,"PACMA",44
42,"42082",9,9,9,0,0,"PACMA",1
26,"26009",426,318,313,4,5,"PACMA",2
9,"9440",105,80,80,0,0,"PACMA",0
16,"16089",386,310,308,10,2,"PACMA",0
48,"48031",370,296,296,1,0,"PACMA",1
49,"49142",264,180,179,2,1,"PACMA",0
9,"9325",217,151,148,1,3,"PACMA",0
10,"10172",728,531,522,3,9,"PACMA",1
37,"37361",91,67,62,0,5,"PACMA",0
22,"22249",110,83,81,0,2,"PACMA",0
22,"22223",92,65,64,3,1,"PACMA",0
34,"34079",1391,1088,1077,17,11,"PACMA",3
50,"50130",415,288,288,7,0,"PACMA",0
37,"37077",293,262,258,3,4,"PACMA",0
46,"46903",5210,4037,4000,40,37,"PACMA",22
48,"48076",294,226,226,0,0,"PACMA",1
28,"28176",10977,8790,8718,68,72,"PACMA",41
5,"5217",69,54,54,0,0,"PACMA",0
15,"15082",15075,11217,11046,187,171,"PACMA",31
45,"45194",57,41,41,0,0,"PACMA",0
33,"33052",758,526,518,2,8,"PACMA",1
25,"25042",211,131,127,0,4,"PACMA",0
16,"16119",181,130,130,0,0,"PACMA",0
16,"16209",153,129,129,0,0,"PACMA",0
37,"37091",181,127,119,0,8,"PACMA",1
28,"28162",2263,1802,1786,32,16,"PACMA",8
49,"49012",73,43,43,0,0,"PACMA",0
34,"34039",66,57,56,0,1,"PACMA",0
37,"37338",82,69,67,0,2,"PACMA",0
3,"3080",1288,1116,1103,6,13,"PACMA",2
21,"21032",1790,1362,1347,14,15,"PACMA",2
33,"33046",546,429,421,3,8,"PACMA",1
37,"37267",210,169,165,0,4,"PACMA",1
46,"46099",987,764,754,2,10,"PACMA",5
34,"34047",1814,1435,1413,24,22,"PACMA",1
49,"49136",347,249,247,6,2,"PACMA",1
24,"24183",900,571,567,10,4,"PACMA",1
32,"32032",8284,6295,6198,84,97,"PACMA",8
29,"29025",34637,22545,22354,268,191,"PACMA",100
24,"24227",1664,1159,1148,16,11,"PACMA",4
19,"19079",7,7,7,0,0,"PACMA",0
49,"49041",443,337,334,7,3,"PACMA",0
16,"16163",75,57,57,0,0,"PACMA",0
9,"9431",124,102,100,2,2,"PACMA",1
50,"50073",2265,1773,1756,20,17,"PACMA",3
46,"46132",2124,1845,1817,14,28,"PACMA",3
13,"13062",595,490,480,4,10,"PACMA",1
29,"29010",1703,1411,1377,7,34,"PACMA",1
3,"3097",973,791,779,6,12,"PACMA",3
44,"44048",77,59,59,0,0,"PACMA",0
50,"50083",96,72,72,1,0,"PACMA",1
47,"47217",1812,1395,1377,20,18,"PACMA",13
9,"9418",79,60,58,0,2,"PACMA",0
22,"22225",2784,1839,1805,42,34,"PACMA",9
49,"49257",277,180,179,0,1,"PACMA",1
9,"9391",383,290,284,7,6,"PACMA",0
16,"16039",466,330,326,1,4,"PACMA",1
9,"9361",134,99,98,0,1,"PACMA",1
29,"29027",2416,1907,1893,15,14,"PACMA",2
25,"25201",119,78,76,3,2,"PACMA",0
33,"33055",1589,1212,1192,16,20,"PACMA",1
10,"10043",866,636,622,1,14,"PACMA",0
29,"29092",596,457,454,10,3,"PACMA",1
22,"22106",25,17,17,0,0,"PACMA",0
28,"28088",251,174,173,5,1,"PACMA",0
29,"29009",1525,1126,1109,9,17,"PACMA",0
37,"37339",345,280,279,3,1,"PACMA",1
37,"37279",780,580,571,6,9,"PACMA",1
32,"32031",1079,837,828,5,9,"PACMA",7
10,"10189",2728,2108,2063,24,45,"PACMA",5
49,"49127",2227,1617,1587,48,30,"PACMA",5
37,"37073",583,458,455,7,3,"PACMA",1
30,"30006",823,719,711,5,8,"PACMA",2
47,"47073",141,118,116,1,2,"PACMA",0
40,"40017",103,89,88,2,1,"PACMA",1
3,"3139",21796,15501,15320,160,181,"PACMA",101
26,"26031",120,100,100,0,0,"PACMA",0
37,"37085",4334,3254,3201,69,53,"PACMA",10
46,"46118",3883,3141,3105,28,36,"PACMA",7
18,"18175",11534,8772,8698,68,74,"PACMA",12
3,"3077",1411,1146,1130,14,16,"PACMA",7
40,"40139",302,243,238,5,5,"PACMA",0
13,"13033",1719,1436,1419,6,17,"PACMA",3
46,"46248",4847,3655,3597,25,58,"PACMA",7
22,"22125",38140,26924,26463,676,461,"PACMA",106
38,"38040",4697,3007,2962,31,45,"PACMA",9
16,"16043",105,86,86,1,0,"PACMA",0
9,"9472",58,46,46,0,0,"PACMA",0
44,"44149",106,79,78,2,1,"PACMA",0
26,"26001",211,174,168,3,6,"PACMA",3
16,"16187",78,61,60,3,1,"PACMA",0
11,"11029",5360,3445,3423,27,22,"PACMA",2
9,"9016",87,55,54,1,1,"PACMA",1
50,"50067",14124,10049,9870,203,179,"PACMA",30
9,"9017",96,76,74,0,2,"PACMA",0
25,"25170",271,197,196,4,1,"PACMA",0
47,"47112",2671,2231,2198,28,33,"PACMA",1
7,"7031",23371,14443,14213,285,230,"PACMA",144
46,"46120",1133,889,870,2,19,"PACMA",0
21,"21021",11825,7657,7574,108,83,"PACMA",14
40,"40031",515,410,404,7,6,"PACMA",5
16,"16115",60,45,45,0,0,"PACMA",0
47,"47166",276,226,223,0,3,"PACMA",0
49,"49008",535,395,394,7,1,"PACMA",0
42,"42197",90,71,71,0,0,"PACMA",0
24,"24141",101,83,80,6,3,"PACMA",0
22,"22905",312,249,247,4,2,"PACMA",0
16,"16250",94,71,71,0,0,"PACMA",0
50,"50249",333,280,272,2,8,"PACMA",0
40,"40166",275,247,246,2,1,"PACMA",0
19,"19333",142,86,84,0,2,"PACMA",0
37,"37063",94,77,76,3,1,"PACMA",0
40,"40142",53,43,41,1,2,"PACMA",0
5,"5119",41,31,31,0,0,"PACMA",0
45,"45008",158,129,127,0,2,"PACMA",3
18,"18020",1473,1111,1106,7,5,"PACMA",0
29,"29067",420165,273593,271376,3342,2217,"PACMA",1332
45,"45020",1396,1165,1151,15,14,"PACMA",2
28,"28045",30286,23148,22879,226,269,"PACMA",79
33,"33059",5049,3480,3447,37,33,"PACMA",4
37,"37045",27,21,21,0,0,"PACMA",0
49,"49037",201,171,171,2,0,"PACMA",1
26,"26076",144,124,123,3,1,"PACMA",0
6,"6133",1744,1343,1328,22,15,"PACMA",2
5,"5076",477,397,385,4,12,"PACMA",1
16,"16172",413,330,318,1,12,"PACMA",1
16,"16204",306,235,235,5,0,"PACMA",1
45,"45075",205,162,159,4,3,"PACMA",0
33,"33024",229816,164603,163179,2100,1424,"PACMA",700
18,"18184",2140,1663,1645,18,18,"PACMA",4
22,"22157",251,176,175,9,1,"PACMA",0
37,"37136",702,494,485,4,9,"PACMA",0
15,"15025",1173,780,777,10,3,"PACMA",1
45,"45108",564,461,456,2,5,"PACMA",2
29,"29051",37991,24498,24095,381,403,"PACMA",81
16,"16078",40954,30382,29933,568,449,"PACMA",129
9,"9102",44,36,36,0,0,"PACMA",1
19,"19284",11,11,11,0,0,"PACMA",0
44,"44210",754,573,567,3,6,"PACMA",0
11,"11023",9209,6979,6929,81,50,"PACMA",10
34,"34010",560,458,451,7,7,"PACMA",1
50,"50208",1831,1321,1305,24,16,"PACMA",2
25,"25060",92,53,52,1,1,"PACMA",0
9,"9131",412,332,321,6,11,"PACMA",0
40,"40178",104,80,79,1,1,"PACMA",0
34,"34053",222,177,172,4,5,"PACMA",0
19,"19278",30,28,28,0,0,"PACMA",0
49,"49247",507,340,332,6,8,"PACMA",0
26,"26177",322,276,274,2,2,"PACMA",2
5,"5214",46,23,23,1,0,"PACMA",0
13,"13068",1058,801,793,4,8,"PACMA",0
25,"25215",399,229,226,4,3,"PACMA",0
15,"15055",4780,3247,3181,70,66,"PACMA",9
22,"22090",115,82,82,5,0,"PACMA",1
21,"21062",1444,1003,991,7,12,"PACMA",1
26,"26086",18,17,17,0,0,"PACMA",0
48,"48060",3689,2477,2466,12,11,"PACMA",5
37,"37335",432,347,346,0,1,"PACMA",1
5,"5176",237,193,190,4,3,"PACMA",2
44,"44032",18,12,12,0,0,"PACMA",1
29,"29084",28386,19450,19202,296,248,"PACMA",47
22,"22024",222,144,139,3,5,"PACMA",0
19,"19034",23,23,23,1,0,"PACMA",0
44,"44077",80,62,62,1,0,"PACMA",0
12,"12044",527,472,463,4,9,"PACMA",0
16,"16234",52,38,36,0,2,"PACMA",0
12,"12025",146,106,105,0,1,"PACMA",0
32,"32074",1180,892,876,11,16,"PACMA",3
34,"34069",2330,1769,1749,25,20,"PACMA",5
9,"9023",993,771,765,22,6,"PACMA",2
19,"19188",72,48,48,1,0,"PACMA",0
25,"25053",1085,733,727,10,6,"PACMA",2
44,"44239",29,25,25,1,0,"PACMA",0
25,"25015",394,264,264,14,0,"PACMA",1
48,"48013",81335,54452,53803,771,649,"PACMA",355
9,"9407",31,27,27,0,0,"PACMA",0
22,"22242",75,53,52,0,1,"PACMA",0
37,"37286",231,166,160,2,6,"PACMA",0
13,"13052",6580,4869,4786,76,83,"PACMA",14
42,"42107",86,60,59,2,1,"PACMA",0
10,"10179",340,262,257,3,5,"PACMA",2
42,"42160",288,222,221,2,1,"PACMA",2
38,"38048",3884,2615,2587,34,28,"PACMA",10
16,"16215",285,192,186,2,6,"PACMA",0
45,"45187",4187,3581,3512,25,69,"PACMA",8
47,"47175",6562,5041,4957,62,84,"PACMA",14
26,"26057",52,42,42,0,0,"PACMA",1
9,"9123",31,27,27,0,0,"PACMA",0
44,"44156",57,40,38,1,2,"PACMA",0
40,"40069",87,76,75,0,1,"PACMA",0
2,"2008",1332,985,966,12,19,"PACMA",1
34,"34076",632,524,520,13,4,"PACMA",1
37,"37309",42,26,25,3,1,"PACMA",0
47,"47102",302,250,248,3,2,"PACMA",3
16,"16243",451,395,388,3,7,"PACMA",0
50,"50012",105,93,90,0,3,"PACMA",0
1,"1058",1342,877,872,8,5,"PACMA",2
19,"19169",51,35,35,0,0,"PACMA",0
50,"50250",58,43,43,4,0,"PACMA",0
44,"44109",123,86,84,2,2,"PACMA",0
22,"22233",94,69,69,0,0,"PACMA",0
6,"6052",3965,3176,3134,33,42,"PACMA",7
1,"1059",183468,127839,125801,1422,2038,"PACMA",929
34,"34059",462,377,375,5,2,"PACMA",1
6,"6083",45013,31929,31491,527,438,"PACMA",160
13,"13069",704,605,590,2,15,"PACMA",0
22,"22190",120,76,73,4,3,"PACMA",0
42,"42017",154,134,130,2,4,"PACMA",0
16,"16167",357,318,315,5,3,"PACMA",0
22,"22136",908,671,662,11,9,"PACMA",2
29,"29035",1717,1280,1270,14,10,"PACMA",1
27,"27008",1458,1130,1115,18,15,"PACMA",3
24,"24148",1759,1362,1348,29,14,"PACMA",4
12,"12026",946,728,702,16,26,"PACMA",2
47,"47022",62,54,54,0,0,"PACMA",0
42,"42060",33,22,22,0,0,"PACMA",0
9,"9199",97,75,74,0,1,"PACMA",0
9,"9467",65,49,49,0,0,"PACMA",0
26,"26163",143,118,116,2,2,"PACMA",0
13,"13089",1906,1610,1553,12,57,"PACMA",3
22,"22164",46,32,32,0,0,"PACMA",0
37,"37166",206,172,171,3,1,"PACMA",0
38,"38052",1344,886,872,5,14,"PACMA",0
46,"46079",381,304,299,3,5,"PACMA",0
18,"18114",678,508,508,6,0,"PACMA",0
28,"28037",1598,1263,1250,10,13,"PACMA",3
46,"46136",2476,1890,1865,16,25,"PACMA",3
5,"5242",692,556,553,18,3,"PACMA",1
22,"22230",302,234,231,11,3,"PACMA",0
50,"50253",461,381,375,3,6,"PACMA",0
12,"12067",563,458,439,8,19,"PACMA",1
22,"22247",31,21,20,1,1,"PACMA",0
16,"16088",125,103,103,1,0,"PACMA",0
42,"42183",131,95,94,7,1,"PACMA",0
48,"48907",351,290,290,1,0,"PACMA",1
3,"3089",9696,7447,7302,83,145,"PACMA",32
48,"48064",599,490,490,1,0,"PACMA",1
19,"19048",18,12,11,1,1,"PACMA",0
39,"39026",1825,1383,1371,12,12,"PACMA",2
39,"39098",1522,1256,1244,8,12,"PACMA",3
34,"34196",94,74,73,1,1,"PACMA",1
22,"22212",93,79,79,0,0,"PACMA",0
24,"24113",404,318,310,3,8,"PACMA",0
15,"15068",5404,3780,3725,53,55,"PACMA",9
18,"18023",16072,11594,11488,131,106,"PACMA",20
32,"32008",7618,5529,5433,83,96,"PACMA",22
9,"9334",52,40,39,1,1,"PACMA",1
6,"6002",4321,3272,3195,32,77,"PACMA",2
47,"47070",33,30,30,1,0,"PACMA",0
39,"39023",6048,4795,4747,43,48,"PACMA",12
44,"44256",37,35,35,9,0,"PACMA",0
46,"46186",18444,14173,14029,135,144,"PACMA",48
50,"50054",63,46,46,0,0,"PACMA",0
3,"3082",11741,8208,8102,80,106,"PACMA",21
19,"19296",43,31,30,1,1,"PACMA",0
47,"47095",41,36,36,3,0,"PACMA",0
27,"27045",1149,817,812,7,5,"PACMA",0
40,"40051",54,41,40,0,1,"PACMA",0
7,"7046",13748,8294,8183,183,111,"PACMA",43
37,"37107",11407,8234,8116,123,118,"PACMA",12
45,"45084",2395,1879,1842,21,37,"PACMA",3
33,"33025",9455,6331,6277,84,54,"PACMA",14
26,"26078",85,69,69,0,0,"PACMA",0
42,"42193",17,10,10,0,0,"PACMA",0
21,"21008",2717,1994,1978,11,16,"PACMA",1
32,"32034",1228,995,990,5,5,"PACMA",3
18,"18002",625,505,504,2,1,"PACMA",0
44,"44240",168,135,132,2,3,"PACMA",0
9,"9343",94,77,76,0,1,"PACMA",0
10,"10021",5421,4189,4099,47,90,"PACMA",10
29,"29089",3343,2514,2489,14,25,"PACMA",3
37,"37330",338,272,270,3,2,"PACMA",1
37,"37325",102,77,77,0,0,"PACMA",0
18,"18903",960,761,753,1,8,"PACMA",0
50,"50168",34,26,26,1,0,"PACMA",0
19,"19054",184,156,151,2,5,"PACMA",0
19,"19067",91,59,59,0,0,"PACMA",0
5,"5156",260,188,185,0,3,"PACMA",2
48,"48049",564,446,446,2,0,"PACMA",0
19,"19109",53,40,40,1,0,"PACMA",0
1,"1004",1427,1021,996,15,25,"PACMA",6
21,"21049",3468,2327,2283,18,44,"PACMA",17
12,"12056",304,259,254,7,5,"PACMA",2
49,"49005",156,102,101,2,1,"PACMA",0
46,"46175",469,406,401,5,5,"PACMA",1
50,"50056",450,329,328,4,1,"PACMA",3
10,"10902",727,608,599,5,9,"PACMA",0
11,"11018",1528,1194,1178,9,16,"PACMA",1
39,"39003",321,265,261,0,4,"PACMA",0
33,"33047",1178,939,931,2,8,"PACMA",0
48,"48035",379,304,301,0,3,"PACMA",0
32,"32046",1375,976,962,3,14,"PACMA",0
28,"28100",3970,2903,2865,32,38,"PACMA",18
46,"46035",6470,5115,5047,38,68,"PACMA",20
45,"45124",2183,1868,1823,20,45,"PACMA",5
27,"27065",13035,9432,9254,168,178,"PACMA",33
46,"46116",12587,9821,9724,120,97,"PACMA",43
45,"45014",4087,2851,2816,36,35,"PACMA",9
29,"29046",2777,2032,2013,10,19,"PACMA",4
50,"50134",134,102,101,3,1,"PACMA",0
42,"42094",520,376,362,14,14,"PACMA",0
37,"37149",78,69,69,0,0,"PACMA",1
37,"37342",252,216,211,3,5,"PACMA",0
48,"48051",225,157,156,0,1,"PACMA",1
9,"9337",126,88,87,1,1,"PACMA",0
48,"48047",161,126,126,1,0,"PACMA",0
30,"30003",23570,16482,16354,169,128,"PACMA",40
37,"37031",399,308,307,5,1,"PACMA",0
22,"22155",89,67,67,2,0,"PACMA",0
50,"50077",254,189,188,4,1,"PACMA",1
46,"46068",326,292,285,3,7,"PACMA",0
45,"45137",1610,1057,1047,11,10,"PACMA",4
47,"47109",183,151,151,4,0,"PACMA",0
37,"37032",530,410,409,4,1,"PACMA",2
10,"10157",289,218,212,1,6,"PACMA",2
44,"44001",69,48,47,0,1,"PACMA",0
34,"34158",336,202,200,0,2,"PACMA",0
1,"1027",430,283,276,4,7,"PACMA",0
7,"7044",8326,6044,5846,99,198,"PACMA",32
3,"3055",5128,4121,4076,43,45,"PACMA",22
42,"42216",27,22,22,0,0,"PACMA",2
9,"9338",220,173,168,5,5,"PACMA",0
11,"11028",32224,20706,20482,359,224,"PACMA",130
49,"49046",283,240,235,2,5,"PACMA",0
49,"49197",187,126,126,3,0,"PACMA",1
26,"26032",58,52,52,1,0,"PACMA",0
40,"40185",977,725,712,13,13,"PACMA",1
42,"42092",89,60,60,0,0,"PACMA",0
9,"9066",62,44,42,0,2,"PACMA",0
47,"47010",11275,8800,8701,163,99,"PACMA",59
48,"48091",1170,860,851,3,9,"PACMA",2
24,"24173",1023,757,747,4,10,"PACMA",1
34,"34056",2147,1557,1535,21,22,"PACMA",7
40,"40216",753,621,611,15,10,"PACMA",4
45,"45080",3,3,3,0,0,"PACMA",0
48,"48073",7090,4865,4802,37,63,"PACMA",7
37,"37116",75,55,55,1,0,"PACMA",0
22,"22200",271,198,191,3,7,"PACMA",1
46,"46090",1668,1488,1452,9,36,"PACMA",5
28,"28044",5403,4245,4188,27,57,"PACMA",14
10,"10201",202,173,171,3,2,"PACMA",1
45,"45018",445,332,322,4,10,"PACMA",2
46,"46093",2082,1722,1716,9,6,"PACMA",5
22,"22202",146,120,120,1,0,"PACMA",1
24,"24162",1631,1214,1195,33,19,"PACMA",7
25,"25048",1684,1120,1095,29,25,"PACMA",0
40,"40152",750,615,595,4,20,"PACMA",1
16,"16237",116,98,98,3,0,"PACMA",0
26,"26007",551,434,422,3,12,"PACMA",0
9,"9439",909,720,697,16,23,"PACMA",6
3,"3098",526,410,400,6,10,"PACMA",2
47,"47160",466,368,364,5,4,"PACMA",0
50,"50232",176,123,120,5,3,"PACMA",0
16,"16085",151,123,122,2,1,"PACMA",0
50,"50027",260,209,202,2,7,"PACMA",2
29,"29081",290,226,226,3,0,"PACMA",0
16,"16176",61,45,43,0,2,"PACMA",0
9,"9120",46,35,34,1,1,"PACMA",0
44,"44180",71,52,52,1,0,"PACMA",0
12,"12071",1355,1069,1050,3,19,"PACMA",1
19,"19146",51,40,38,0,2,"PACMA",0
47,"47110",471,386,378,6,8,"PACMA",1
45,"45139",231,198,194,0,4,"PACMA",0
46,"46119",856,702,693,0,9,"PACMA",0
50,"50035",78,61,56,2,5,"PACMA",0
49,"49266",83,69,69,1,0,"PACMA",0
25,"25907",506,297,292,6,5,"PACMA",4
44,"44135",149,110,109,1,1,"PACMA",1
49,"49007",387,289,289,4,0,"PACMA",1
38,"38041",6780,4905,4813,57,92,"PACMA",28
19,"19287",153,114,113,2,1,"PACMA",0
18,"18017",17990,12070,11962,80,108,"PACMA",36
3,"3094",8442,6105,6053,70,52,"PACMA",43
48,"48912",2340,1794,1776,22,18,"PACMA",7
18,"18067",704,526,521,1,5,"PACMA",0
16,"16104",65,52,52,1,0,"PACMA",0
28,"28056",782,604,586,6,18,"PACMA",5
46,"46168",1828,1461,1449,7,12,"PACMA",5
26,"26073",100,85,84,1,1,"PACMA",0
35,"35032",3432,2605,2548,37,57,"PACMA",3
26,"26070",203,179,177,3,2,"PACMA",1
9,"9018",24688,17880,17508,345,372,"PACMA",66
38,"38028",22003,14876,14589,158,287,"PACMA",79
38,"38026",32174,24822,24431,283,391,"PACMA",116
12,"12011",4663,3578,3525,28,53,"PACMA",11
40,"40901",379,292,288,11,4,"PACMA",1
25,"25255",468,318,309,9,9,"PACMA",5
50,"50286",90,73,73,2,0,"PACMA",0
34,"34035",122,98,96,0,2,"PACMA",0
47,"47084",1230,981,968,19,13,"PACMA",3
47,"47087",376,320,315,7,5,"PACMA",1
1,"1060",223,181,178,1,3,"PACMA",0
28,"28144",5663,4456,4410,47,46,"PACMA",17
11,"11039",9943,6634,6582,104,52,"PACMA",19
25,"25087",65,41,39,0,2,"PACMA",0
47,"47097",345,291,289,7,2,"PACMA",2
44,"44207",187,147,146,5,1,"PACMA",0
50,"50149",48,35,35,0,0,"PACMA",0
9,"9292",98,73,71,3,2,"PACMA",1
47,"47006",196,151,146,1,5,"PACMA",0
28,"28020",145,102,100,0,2,"PACMA",0
37,"37352",199,150,142,0,8,"PACMA",0
44,"44033",307,222,221,5,1,"PACMA",0
40,"40040",2677,1990,1966,24,24,"PACMA",4
16,"16199",27,20,19,0,1,"PACMA",0
18,"18084",3954,3039,3015,50,24,"PACMA",8
44,"44042",139,87,87,0,0,"PACMA",0
12,"12004",4354,3145,3083,50,62,"PACMA",18
40,"40229",45,37,37,0,0,"PACMA",0
50,"50114",157,120,120,1,0,"PACMA",0
46,"46052",532,471,463,2,8,"PACMA",0
9,"9062",52,33,32,1,1,"PACMA",0
37,"37013",133,93,85,5,8,"PACMA",1
9,"9135",41,29,29,1,0,"PACMA",1
42,"42124",71,50,50,0,0,"PACMA",0
16,"16132",36,31,31,0,0,"PACMA",0
37,"37320",96,70,70,0,0,"PACMA",0
9,"9051",181,136,133,2,3,"PACMA",1
47,"47115",306,248,248,2,0,"PACMA",0
45,"45169",239,183,183,1,0,"PACMA",0
42,"42131",53,38,37,0,1,"PACMA",0
34,"34072",189,169,166,2,3,"PACMA",0
6,"6056",487,411,411,1,0,"PACMA",0
10,"10198",1213,1068,1054,12,14,"PACMA",4
29,"29018",2088,1565,1540,9,25,"PACMA",4
27,"27051",8224,6048,5953,108,95,"PACMA",30
22,"22063",184,142,140,2,2,"PACMA",0
37,"37291",261,215,214,1,1,"PACMA",0
42,"42192",43,36,36,2,0,"PACMA",0
47,"47090",2511,1907,1880,23,27,"PACMA",5
46,"46105",16708,12164,12040,100,124,"PACMA",44
28,"28073",11899,8877,8769,112,108,"PACMA",54
49,"49065",1212,939,926,3,13,"PACMA",2
22,"22901",792,515,508,13,7,"PACMA",1
37,"37333",247,160,154,2,6,"PACMA",0
7,"7057",7102,4702,4611,85,91,"PACMA",28
40,"40097",114,96,94,2,2,"PACMA",0
7,"7901",642,483,470,5,13,"PACMA",3
26,"26062",94,78,77,1,1,"PACMA",1
9,"9419",82,61,61,0,0,"PACMA",0
10,"10195",7917,6143,6054,36,89,"PACMA",27
9,"9281",159,134,132,5,2,"PACMA",0
44,"44189",69,57,57,0,0,"PACMA",0
5,"5254",212,186,185,2,1,"PACMA",1
25,"25033",1125,738,718,17,20,"PACMA",3
10,"10106",144,123,123,4,0,"PACMA",0
28,"28042",1091,814,808,5,6,"PACMA",3
42,"42218",86,59,59,0,0,"PACMA",0
42,"42033",54,48,48,0,0,"PACMA",0
13,"13046",786,654,644,2,10,"PACMA",0
37,"37082",869,663,650,3,13,"PACMA",0
37,"37039",325,241,236,0,5,"PACMA",0
34,"34045",84,75,74,1,1,"PACMA",0
37,"37117",1320,948,937,16,11,"PACMA",7
47,"47025",127,103,103,0,0,"PACMA",0
9,"9163",642,526,518,3,8,"PACMA",0
5,"5024",268,205,201,2,4,"PACMA",0
9,"9024",159,124,123,2,1,"PACMA",0
28,"28054",10459,7798,7698,65,100,"PACMA",27
48,"48043",4256,3066,3040,33,26,"PACMA",14
38,"38022",18671,13075,12890,111,185,"PACMA",43
38,"38049",2794,1721,1694,12,27,"PACMA",8
50,"50055",3592,2520,2473,59,47,"PACMA",15
1,"1052",240,191,191,1,0,"PACMA",2
40,"40068",39,32,32,0,0,"PACMA",1
40,"40099",61,52,52,2,0,"PACMA",0
1,"1002",8057,5854,5757,48,97,"PACMA",31
30,"30031",560,471,469,3,2,"PACMA",2
21,"21075",375,294,291,12,3,"PACMA",0
50,"50047",60,34,34,2,0,"PACMA",0
50,"50026",459,360,354,5,6,"PACMA",1
25,"25905",386,264,258,12,6,"PACMA",1
5,"5174",81,71,71,1,0,"PACMA",1
34,"34106",121,100,99,2,1,"PACMA",0
48,"48913",1231,936,922,10,14,"PACMA",8
37,"37341",52,32,32,0,0,"PACMA",0
28,"28018",3572,2837,2795,20,42,"PACMA",12
16,"16109",46,34,34,2,0,"PACMA",0
38,"38033",3987,2696,2656,23,40,"PACMA",9
32,"32066",634,492,488,0,4,"PACMA",0
50,"50086",193,109,109,0,0,"PACMA",0
45,"45022",427,317,314,8,3,"PACMA",3
42,"42155",188,121,120,0,1,"PACMA",0
42,"42036",52,40,39,2,1,"PACMA",0
25,"25249",207,151,150,4,1,"PACMA",0
47,"47086",4062,3162,3120,37,42,"PACMA",3
44,"44016",541,384,379,5,5,"PACMA",0
30,"30019",25722,18740,18553,164,187,"PACMA",46
49,"49038",114,81,80,0,1,"PACMA",0
30,"30030",305669,236235,234391,2112,1844,"PACMA",894
19,"19332",106,76,72,4,4,"PACMA",0
25,"25196",127,87,86,3,1,"PACMA",0
47,"47177",112,83,79,1,4,"PACMA",0
19,"19124",420,293,291,3,2,"PACMA",3
20,"20063",7889,5381,5340,48,41,"PACMA",14
20,"20002",347,237,237,8,0,"PACMA",0
20,"20074",11660,8003,7951,31,52,"PACMA",23
20,"20001",249,167,167,4,0,"PACMA",0
20,"20040",15103,9781,9686,148,95,"PACMA",37
20,"20029",4283,3014,2998,26,16,"PACMA",14
20,"20016",1526,937,932,4,5,"PACMA",1
20,"20064",12380,7568,7464,112,104,"PACMA",59
20,"20017",8670,5923,5890,27,33,"PACMA",15
20,"20038",382,281,280,1,1,"PACMA",2
20,"20037",100,65,64,2,1,"PACMA",1
20,"20058",770,549,547,3,2,"PACMA",2
20,"20071",14488,9499,9419,93,80,"PACMA",30
20,"20027",2809,1929,1918,25,11,"PACMA",10
20,"20032",8949,6189,6117,55,72,"PACMA",23
20,"20044",368,258,257,1,1,"PACMA",3
20,"20021",216,122,122,0,0,"PACMA",1
20,"20051",7033,4843,4779,57,64,"PACMA",20
20,"20026",214,172,172,0,0,"PACMA",1
20,"20007",300,203,202,2,1,"PACMA",2
20,"20902",14148,9874,9798,120,76,"PACMA",78
20,"20045",46542,30907,30536,425,371,"PACMA",236
20,"20041",279,153,151,5,2,"PACMA",0
20,"20043",1782,1220,1214,13,6,"PACMA",1
20,"20042",3354,2131,2117,18,14,"PACMA",9
20,"20013",5331,3662,3637,33,25,"PACMA",9
20,"20907",136,94,94,0,0,"PACMA",0
20,"20057",194,122,122,0,0,"PACMA",0
20,"20019",10105,6640,6555,73,85,"PACMA",17
20,"20004",254,153,153,5,0,"PACMA",0
20,"20035",497,346,344,1,2,"PACMA",0
20,"20034",3192,2035,2030,11,5,"PACMA",11
20,"20075",4447,2823,2798,32,25,"PACMA",15
20,"20077",5382,3766,3741,42,25,"PACMA",16
20,"20062",995,687,667,5,20,"PACMA",1
20,"20052",1154,849,847,14,2,"PACMA",3
20,"20033",884,650,641,4,9,"PACMA",1
20,"20015",1307,980,979,13,1,"PACMA",0
20,"20031",179,114,113,1,1,"PACMA",1
20,"20018",11027,7428,7387,53,41,"PACMA",9
20,"20014",1101,660,654,8,6,"PACMA",0
20,"20008",757,499,499,8,0,"PACMA",0
20,"20046",1157,734,729,6,5,"PACMA",2
20,"20068",199,132,129,2,3,"PACMA",0
20,"20055",17856,11885,11791,91,94,"PACMA",45
20,"20006",277,177,175,6,2,"PACMA",1
20,"20066",467,316,316,0,0,"PACMA",0
20,"20079",17229,12010,11927,143,83,"PACMA",56
20,"20022",832,527,521,9,6,"PACMA",1
20,"20076",6978,4823,4762,38,61,"PACMA",15
20,"20010",1392,949,941,8,8,"PACMA",0
20,"20025",1174,814,803,4,11,"PACMA",4
20,"20056",3975,2692,2669,17,23,"PACMA",8
20,"20069",146828,101992,101225,1287,767,"PACMA",706
20,"20053",4830,2895,2868,36,27,"PACMA",17
20,"20028",2204,1400,1379,11,21,"PACMA",8
20,"20070",1109,817,815,4,2,"PACMA",1
20,"20067",31173,20218,20017,270,201,"PACMA",175
20,"20078",1146,885,884,6,1,"PACMA",3
20,"20030",22191,15262,15148,164,114,"PACMA",50
20,"20003",547,361,359,3,2,"PACMA",1
20,"20054",476,350,348,1,2,"PACMA",0
20,"20009",11794,7805,7725,103,80,"PACMA",44
20,"20039",2003,1517,1512,9,5,"PACMA",4
20,"20047",494,321,319,2,2,"PACMA",5
20,"20061",4011,2666,2653,23,13,"PACMA",6
20,"20060",92,83,82,0,1,"PACMA",0
20,"20073",4689,3196,3176,28,20,"PACMA",8
20,"20012",149,97,97,0,0,"PACMA",0
20,"20901",1468,951,947,13,4,"PACMA",7
20,"20906",117,89,89,0,0,"PACMA",1
20,"20905",142,105,103,1,2,"PACMA",0
20,"20059",8816,6335,6293,32,42,"PACMA",12
20,"20005",1341,890,885,4,5,"PACMA",3
20,"20050",293,213,211,3,2,"PACMA",2
20,"20049",4081,2741,2723,30,18,"PACMA",10
20,"20072",4643,2967,2948,46,19,"PACMA",11
20,"20080",8104,5497,5454,52,43,"PACMA",26
20,"20904",98,67,66,0,1,"PACMA",1
20,"20024",400,238,235,0,3,"PACMA",1
20,"20903",3625,2282,2267,52,15,"PACMA",7
20,"20081",7346,4957,4925,35,32,"PACMA",17
20,"20065",3176,2156,2137,19,19,"PACMA",7
20,"20048",175,102,102,1,0,"PACMA",0
20,"20020",143,104,104,1,0,"PACMA",2
20,"20011",1700,1265,1258,11,7,"PACMA",3
20,"20036",12731,8519,8431,131,88,"PACMA",45
20,"20023",451,260,259,2,1,"PACMA",0
16,"16905",1017,811,806,14,5,"PCAS",1
19,"19214",94,78,78,2,0,"PCAS",0
19,"19234",63,48,48,0,0,"PCAS",0
16,"16070",35,29,29,0,0,"PCAS",0
16,"16016",258,178,178,1,0,"PCAS",0
16,"16254",213,166,165,2,1,"PCAS",0
16,"16156",122,91,91,0,0,"PCAS",0
19,"19103",303,247,244,3,3,"PCAS",0
19,"19120",107,95,95,1,0,"PCAS",0
19,"19098",22,18,18,0,0,"PCAS",0
16,"16188",106,76,76,0,0,"PCAS",0
19,"19086",1655,1310,1295,10,15,"PCAS",1
19,"19097",28,27,27,0,0,"PCAS",0
16,"16126",811,701,692,13,9,"PCAS",0
19,"19326",1125,800,786,10,14,"PCAS",0
19,"19110",73,59,57,4,2,"PCAS",0
16,"16240",134,100,98,0,2,"PCAS",0
16,"16011",39,30,30,0,0,"PCAS",0
19,"19181",69,54,54,5,0,"PCAS",1
16,"16265",27,26,26,0,0,"PCAS",0
19,"19051",94,83,83,1,0,"PCAS",1
16,"16147",78,63,62,1,1,"PCAS",1
19,"19310",13,9,8,0,1,"PCAS",0
19,"19118",17,13,13,0,0,"PCAS",0
16,"16191",1001,867,864,13,3,"PCAS",1
19,"19227",95,64,63,1,1,"PCAS",0
19,"19054",184,156,151,2,5,"PCAS",0
19,"19009",253,187,184,0,3,"PCAS",0
16,"16245",430,338,329,2,9,"PCAS",1
19,"19064",97,84,83,1,1,"PCAS",1
16,"16185",63,45,44,0,1,"PCAS",0
19,"19044",319,248,245,0,3,"PCAS",0
16,"16187",78,61,60,3,1,"PCAS",0
16,"16169",75,44,44,0,0,"PCAS",0
19,"19022",673,501,496,4,5,"PCAS",0
16,"16225",89,69,68,1,1,"PCAS",0
19,"19111",180,147,146,0,1,"PCAS",0
19,"19281",25,24,22,3,2,"PCAS",0
19,"19246",48,38,38,1,0,"PCAS",0
19,"19197",29,19,19,0,0,"PCAS",0
16,"16199",27,20,19,0,1,"PCAS",0
19,"19256",48,44,43,0,1,"PCAS",0
16,"16113",3075,2363,2338,36,25,"PCAS",1
19,"19096",99,79,78,1,1,"PCAS",1
16,"16251",1903,1510,1493,18,17,"PCAS",2
16,"16097",196,167,166,2,1,"PCAS",0
19,"19173",52,42,42,3,0,"PCAS",0
16,"16063",97,81,81,0,0,"PCAS",0
19,"19081",43,33,33,0,0,"PCAS",0
19,"19217",85,57,54,2,3,"PCAS",0
16,"16100",764,660,655,3,5,"PCAS",0
19,"19153",25,17,17,0,0,"PCAS",0
19,"19049",19,11,11,0,0,"PCAS",0
19,"19282",210,157,157,0,0,"PCAS",0
19,"19148",56,41,38,1,3,"PCAS",0
19,"19318",36,19,19,1,0,"PCAS",0
19,"19108",117,97,95,0,2,"PCAS",0
16,"16157",229,187,182,2,5,"PCAS",0
16,"16032",304,253,244,2,9,"PCAS",0
19,"19232",89,68,67,0,1,"PCAS",0
16,"16081",64,46,45,1,1,"PCAS",1
19,"19135",120,102,100,2,2,"PCAS",0
16,"16019",252,210,207,2,3,"PCAS",0
19,"19105",2235,1709,1686,23,23,"PCAS",1
16,"16910",104,69,69,1,0,"PCAS",0
16,"16159",299,204,202,5,2,"PCAS",0
16,"16192",54,37,37,1,0,"PCAS",0
16,"16238",560,484,479,3,5,"PCAS",0
19,"19303",56,48,47,1,1,"PCAS",0
19,"19288",22,21,21,0,0,"PCAS",0
19,"19261",42,31,31,1,0,"PCAS",0
16,"16177",86,68,68,0,0,"PCAS",0
19,"19082",91,68,67,1,1,"PCAS",0
19,"19243",53,39,39,0,0,"PCAS",0
16,"16237",116,98,98,3,0,"PCAS",0
19,"19073",24,20,19,0,1,"PCAS",0
16,"16146",96,74,70,0,4,"PCAS",0
19,"19223",129,94,90,1,4,"PCAS",1
19,"19302",64,60,60,2,0,"PCAS",0
19,"19060",165,127,121,3,6,"PCAS",0
19,"19059",84,60,60,0,0,"PCAS",0
16,"16186",521,434,429,2,5,"PCAS",0
19,"19157",66,56,56,4,0,"PCAS",0
19,"19215",206,170,166,0,4,"PCAS",0
19,"19247",171,125,118,6,7,"PCAS",0
16,"16067",135,97,97,2,0,"PCAS",0
19,"19150",128,112,108,0,4,"PCAS",0
19,"19266",278,234,231,4,3,"PCAS",0
16,"16122",259,195,190,2,5,"PCAS",0
16,"16094",142,112,111,1,1,"PCAS",0
19,"19031",18,11,11,0,0,"PCAS",0
19,"19222",120,90,89,3,1,"PCAS",0
19,"19146",51,40,38,0,2,"PCAS",0
19,"19055",54,41,37,1,4,"PCAS",0
19,"19291",1271,925,902,3,23,"PCAS",0
19,"19087",22,16,16,0,0,"PCAS",1
16,"16010",184,135,133,1,2,"PCAS",0
19,"19265",157,102,101,0,1,"PCAS",0
16,"16015",407,311,311,4,0,"PCAS",2
16,"16255",159,123,122,3,1,"PCAS",1
16,"16129",112,79,74,0,5,"PCAS",0
16,"16908",227,181,179,1,2,"PCAS",0
19,"19142",259,191,190,0,1,"PCAS",0
16,"16140",34,27,27,0,0,"PCAS",0
16,"16151",66,56,56,0,0,"PCAS",0
19,"19092",437,331,326,4,5,"PCAS",0
16,"16038",50,40,40,0,0,"PCAS",0
16,"16103",310,263,259,4,4,"PCAS",0
16,"16049",158,129,129,1,0,"PCAS",0
19,"19169",51,35,35,0,0,"PCAS",0
19,"19089",33,22,22,1,0,"PCAS",0
19,"19189",136,99,97,0,2,"PCAS",0
19,"19228",39,30,29,0,1,"PCAS",0
16,"16042",1286,1101,1089,8,12,"PCAS",0
16,"16131",154,116,115,0,1,"PCAS",0
19,"19024",7736,5738,5646,82,92,"PCAS",8
16,"16006",133,117,116,2,1,"PCAS",0
16,"16149",179,140,138,2,2,"PCAS",1
19,"19314",46,41,41,0,0,"PCAS",0
16,"16061",1035,861,848,15,13,"PCAS",0
19,"19078",58,49,48,0,1,"PCAS",0
19,"19151",1126,849,830,3,19,"PCAS",0
19,"19037",153,128,128,0,0,"PCAS",1
16,"16031",62,34,32,4,2,"PCAS",0
16,"16263",936,730,719,8,11,"PCAS",1
16,"16030",28,24,24,0,0,"PCAS",0
19,"19163",73,59,59,0,0,"PCAS",0
19,"19196",99,80,74,2,6,"PCAS",0
19,"19123",40,34,34,0,0,"PCAS",0
19,"19168",324,233,231,6,2,"PCAS",1
16,"16244",735,615,606,3,9,"PCAS",0
16,"16092",158,132,132,0,0,"PCAS",2
19,"19255",95,68,68,0,0,"PCAS",0
16,"16155",549,430,426,2,4,"PCAS",0
19,"19192",1743,1370,1359,10,11,"PCAS",1
19,"19322",35,28,27,1,1,"PCAS",0
19,"19013",143,110,108,1,2,"PCAS",0
19,"19160",944,600,593,6,7,"PCAS",11
16,"16023",468,332,327,3,5,"PCAS",1
16,"16172",413,330,318,1,12,"PCAS",0
19,"19304",235,169,166,1,3,"PCAS",0
19,"19050",21,19,19,0,0,"PCAS",0
16,"16082",318,226,226,1,0,"PCAS",0
16,"16258",288,215,213,1,2,"PCAS",1
16,"16273",328,277,275,2,2,"PCAS",0
19,"19210",34,29,29,1,0,"PCAS",0
16,"16036",143,117,115,1,2,"PCAS",0
16,"16107",161,101,98,1,3,"PCAS",0
19,"19045",180,145,145,1,0,"PCAS",0
19,"19065",126,100,100,3,0,"PCAS",1
19,"19113",519,396,395,4,1,"PCAS",2
16,"16278",91,69,69,2,0,"PCAS",1
19,"19290",872,622,613,7,9,"PCAS",7
19,"19066",78,63,62,0,1,"PCAS",0
16,"16098",586,480,474,10,6,"PCAS",0
16,"16012",102,81,80,0,1,"PCAS",0
16,"16162",51,36,36,0,0,"PCAS",0
16,"16124",1909,1573,1555,14,18,"PCAS",1
16,"16216",358,300,296,2,4,"PCAS",0
16,"16272",273,215,215,2,0,"PCAS",0
19,"19324",199,151,151,2,0,"PCAS",0
19,"19330",93,81,81,2,0,"PCAS",0
19,"19306",42,31,31,1,0,"PCAS",0
19,"19212",795,644,632,2,12,"PCAS",0
19,"19208",55,41,41,1,0,"PCAS",0
19,"19278",30,28,28,0,0,"PCAS",0
16,"16250",94,71,71,0,0,"PCAS",0
16,"16084",49,36,35,0,1,"PCAS",0
19,"19178",45,34,34,0,0,"PCAS",0
19,"19171",4352,3299,3221,35,78,"PCAS",4
19,"19027",185,140,138,1,2,"PCAS",0
19,"19269",103,84,83,0,1,"PCAS",0
19,"19195",41,30,30,1,0,"PCAS",1
19,"19199",24,21,21,0,0,"PCAS",0
16,"16055",698,485,481,8,4,"PCAS",0
16,"16002",195,175,172,0,3,"PCAS",0
16,"16135",192,127,125,0,2,"PCAS",0
19,"19274",881,652,644,8,8,"PCAS",2
16,"16033",1792,1485,1454,10,31,"PCAS",0
19,"19126",1552,1140,1119,16,21,"PCAS",0
19,"19244",95,82,82,6,0,"PCAS",0
16,"16205",126,94,93,0,1,"PCAS",2
16,"16217",113,95,92,0,3,"PCAS",0
19,"19186",93,77,77,0,0,"PCAS",0
19,"19237",53,40,39,2,1,"PCAS",0
16,"16154",4946,3975,3914,58,61,"PCAS",4
16,"16053",414,334,326,2,8,"PCAS",2
19,"19201",70,52,52,2,0,"PCAS",0
19,"19270",17,16,16,0,0,"PCAS",0
19,"19245",1222,954,943,10,11,"PCAS",0
19,"19019",23,18,18,0,0,"PCAS",0
19,"19305",166,130,130,0,0,"PCAS",0
16,"16132",36,31,31,0,0,"PCAS",0
16,"16109",46,34,34,2,0,"PCAS",0
16,"16123",110,74,73,1,1,"PCAS",0
19,"19284",11,11,11,0,0,"PCAS",0
16,"16003",147,122,121,0,1,"PCAS",0
19,"19327",551,459,449,3,10,"PCAS",0
19,"19138",298,223,219,3,4,"PCAS",0
16,"16065",454,380,374,4,6,"PCAS",0
16,"16246",520,417,407,1,10,"PCAS",0
19,"19325",127,105,102,4,3,"PCAS",0
19,"19053",2172,1602,1587,14,15,"PCAS",1
19,"19008",34,25,25,1,0,"PCAS",0
16,"16903",1097,855,828,9,27,"PCAS",1
19,"19147",58,45,40,0,5,"PCAS",0
19,"19036",279,238,236,1,2,"PCAS",0
16,"16209",153,129,129,0,0,"PCAS",2
19,"19174",126,88,86,0,2,"PCAS",1
16,"16072",161,126,123,0,3,"PCAS",0
19,"19112",68,50,50,0,0,"PCAS",0
16,"16095",98,68,68,0,0,"PCAS",0
16,"16013",24,23,23,0,0,"PCAS",0
16,"16279",251,175,172,1,3,"PCAS",0
19,"19161",243,171,166,2,5,"PCAS",0
16,"16121",270,211,207,1,4,"PCAS",0
19,"19109",53,40,40,1,0,"PCAS",0
19,"19106",95,68,66,0,2,"PCAS",1
16,"16280",205,177,175,1,2,"PCAS",0
19,"19200",150,105,105,1,0,"PCAS",0
16,"16060",841,714,704,11,10,"PCAS",0
19,"19070",100,74,74,0,0,"PCAS",0
19,"19183",108,87,86,1,1,"PCAS",0
19,"19238",42,32,31,1,1,"PCAS",0
19,"19139",32,23,23,0,0,"PCAS",0
16,"16266",402,334,325,4,9,"PCAS",1
19,"19179",109,77,75,3,2,"PCAS",0
19,"19003",50,36,35,1,1,"PCAS",0
16,"16239",158,114,112,2,2,"PCAS",0
16,"16150",120,90,90,0,0,"PCAS",0
19,"19033",79,55,55,0,0,"PCAS",3
19,"19038",48,33,33,0,0,"PCAS",0
16,"16277",128,100,100,3,0,"PCAS",0
19,"19184",88,63,62,1,1,"PCAS",0
19,"19052",37,32,31,1,1,"PCAS",0
19,"19254",57,50,50,0,0,"PCAS",0
19,"19117",1526,1155,1132,26,23,"PCAS",3
16,"16190",5151,4229,4144,52,85,"PCAS",3
16,"16215",285,192,186,2,6,"PCAS",0
16,"16083",58,30,30,1,0,"PCAS",0
16,"16052",596,469,464,2,5,"PCAS",0
16,"16275",15,12,12,0,0,"PCAS",0
16,"16171",1930,1616,1584,25,32,"PCAS",2
16,"16228",202,146,144,2,2,"PCAS",0
19,"19317",150,122,121,2,1,"PCAS",0
19,"19124",420,293,291,3,2,"PCAS",0
16,"16134",4283,3398,3361,59,37,"PCAS",3
16,"16110",98,81,81,3,0,"PCAS",0
19,"19107",349,289,288,1,1,"PCAS",1
19,"19061",76,57,55,3,2,"PCAS",0
19,"19272",86,67,65,1,2,"PCAS",0
16,"16143",20,14,13,1,1,"PCAS",0
19,"19152",674,505,498,2,7,"PCAS",0
16,"16048",432,339,337,8,2,"PCAS",0
19,"19333",142,86,84,0,2,"PCAS",0
16,"16079",33,21,21,0,0,"PCAS",0
16,"16050",298,245,238,0,7,"PCAS",0
19,"19175",39,31,31,0,0,"PCAS",0
16,"16086",935,814,802,14,12,"PCAS",0
16,"16276",32,23,22,1,1,"PCAS",0
19,"19262",184,137,136,0,1,"PCAS",0
16,"16158",550,427,423,2,4,"PCAS",0
16,"16085",151,123,122,2,1,"PCAS",0
19,"19119",93,80,79,2,1,"PCAS",0
16,"16014",659,534,528,8,6,"PCAS",0
16,"16904",508,413,407,10,6,"PCAS",2
19,"19334",50,37,37,0,0,"PCAS",0
16,"16029",114,80,80,0,0,"PCAS",0
19,"19298",75,53,52,2,1,"PCAS",0
16,"16112",1562,1159,1140,12,19,"PCAS",1
16,"16024",134,92,91,1,1,"PCAS",0
16,"16047",249,192,191,5,1,"PCAS",0
16,"16227",128,95,94,0,1,"PCAS",0
16,"16091",86,66,66,1,0,"PCAS",0
19,"19277",22,17,17,0,0,"PCAS",0
19,"19191",19,15,15,0,0,"PCAS",0
19,"19010",15,13,13,1,0,"PCAS",1
19,"19080",90,64,64,0,0,"PCAS",0
19,"19043",92,82,82,1,0,"PCAS",0
16,"16096",279,231,229,7,2,"PCAS",0
19,"19901",43,34,34,0,0,"PCAS",0
19,"19271",53,45,45,1,0,"PCAS",0
16,"16106",2839,2351,2331,10,20,"PCAS",2
16,"16001",79,66,66,1,0,"PCAS",0
19,"19011",286,219,218,3,1,"PCAS",2
16,"16139",346,279,277,2,2,"PCAS",0
19,"19032",202,11,11,0,0,"PCAS",0
19,"19182",38,24,22,0,2,"PCAS",0
19,"19099",337,211,210,6,1,"PCAS",0
16,"16026",104,79,79,1,0,"PCAS",0
19,"19143",1610,1287,1268,9,19,"PCAS",1
19,"19125",54,42,42,2,0,"PCAS",0
16,"16009",79,63,62,0,1,"PCAS",0
19,"19240",64,47,46,1,1,"PCAS",0
16,"16175",5058,4363,4295,70,68,"PCAS",1
16,"16271",659,568,566,4,2,"PCAS",0
19,"19311",87,60,60,0,0,"PCAS",0
19,"19145",64,49,48,2,1,"PCAS",0
19,"19091",30,22,22,2,0,"PCAS",0
19,"19241",45,37,37,2,0,"PCAS",0
16,"16111",171,130,128,0,2,"PCAS",0
16,"16141",161,132,131,1,1,"PCAS",0
16,"16073",214,170,170,2,0,"PCAS",0
19,"19331",2497,1898,1847,19,51,"PCAS",0
16,"16007",1272,1056,1051,7,5,"PCAS",3
19,"19193",30,29,29,1,0,"PCAS",0
19,"19190",2499,1829,1785,32,44,"PCAS",1
19,"19102",122,101,100,0,1,"PCAS",0
19,"19034",23,23,23,1,0,"PCAS",0
19,"19116",16,10,10,0,0,"PCAS",0
16,"16068",143,117,116,6,1,"PCAS",0
16,"16099",232,180,178,5,2,"PCAS",0
19,"19162",71,52,51,0,1,"PCAS",0
19,"19249",38,32,32,0,0,"PCAS",0
16,"16074",53,42,42,1,0,"PCAS",0
19,"19039",73,57,57,0,0,"PCAS",0
19,"19299",94,75,75,0,0,"PCAS",0
19,"19075",81,53,50,4,3,"PCAS",0
16,"16119",181,130,130,0,0,"PCAS",1
19,"19250",25,23,22,0,1,"PCAS",0
19,"19300",746,595,585,3,10,"PCAS",1
16,"16137",64,41,40,0,1,"PCAS",0
19,"19017",87,70,70,0,0,"PCAS",0
16,"16203",9839,7520,7342,101,178,"PCAS",8
19,"19264",45,39,39,0,0,"PCAS",0
16,"16088",125,103,103,1,0,"PCAS",0
16,"16219",106,83,82,0,1,"PCAS",0
16,"16161",84,73,72,4,1,"PCAS",0
16,"16115",60,45,45,0,0,"PCAS",0
16,"16078",40954,30382,29933,568,449,"PCAS",63
16,"16093",80,57,57,0,0,"PCAS",0
19,"19230",438,317,309,4,8,"PCAS",1
16,"16231",47,43,43,0,0,"PCAS",0
19,"19209",50,40,39,0,1,"PCAS",0
19,"19297",34,29,29,0,0,"PCAS",0
19,"19229",83,71,68,0,3,"PCAS",0
19,"19041",166,127,127,3,0,"PCAS",0
16,"16194",298,238,238,1,0,"PCAS",0
19,"19307",30,27,27,0,0,"PCAS",0
19,"19067",91,59,59,0,0,"PCAS",0
19,"19259",37,32,32,0,0,"PCAS",0
19,"19048",18,12,11,1,1,"PCAS",0
16,"16167",357,318,315,5,3,"PCAS",0
19,"19301",47,38,38,0,0,"PCAS",0
19,"19289",33,28,28,1,0,"PCAS",0
19,"19319",4203,3139,3104,28,35,"PCAS",1
19,"19204",168,129,126,2,3,"PCAS",0
19,"19134",22,14,14,0,0,"PCAS",0
16,"16108",68,56,55,0,1,"PCAS",0
19,"19006",873,634,620,1,14,"PCAS",0
16,"16133",4466,3522,3453,51,69,"PCAS",4
19,"19308",67,61,61,0,0,"PCAS",0
16,"16234",52,38,36,0,2,"PCAS",0
16,"16248",887,733,710,20,23,"PCAS",1
16,"16196",658,578,568,6,10,"PCAS",0
16,"16066",2402,2064,1997,32,67,"PCAS",2
19,"19332",106,76,72,4,4,"PCAS",0
19,"19309",37,32,31,0,1,"PCAS",0
16,"16236",964,762,758,10,4,"PCAS",1
19,"19155",61,52,50,1,2,"PCAS",0
16,"16035",287,216,213,2,3,"PCAS",1
19,"19129",48,33,31,0,2,"PCAS",0
16,"16152",42,38,37,3,1,"PCAS",0
16,"16247",87,65,62,1,3,"PCAS",0
19,"19258",103,81,81,0,0,"PCAS",0
16,"16062",30,27,27,0,0,"PCAS",0
16,"16242",367,315,313,4,2,"PCAS",0
19,"19057",79,56,56,0,0,"PCAS",0
19,"19267",22,15,15,0,0,"PCAS",0
16,"16056",495,377,374,11,3,"PCAS",0
19,"19170",214,139,138,0,1,"PCAS",0
19,"19071",7346,5380,5294,76,86,"PCAS",1
19,"19018",189,145,138,2,7,"PCAS",0
19,"19194",113,80,76,1,4,"PCAS",0
19,"19188",72,48,48,1,0,"PCAS",0
19,"19224",119,95,94,0,1,"PCAS",0
16,"16044",51,35,35,0,0,"PCAS",0
16,"16041",395,289,287,6,2,"PCAS",0
16,"16253",340,256,256,4,0,"PCAS",0
16,"16176",61,45,43,0,2,"PCAS",0
19,"19002",99,77,76,0,1,"PCAS",0
19,"19216",143,112,105,2,7,"PCAS",0
16,"16243",451,395,388,3,7,"PCAS",1
19,"19203",35,27,27,0,0,"PCAS",0
16,"16116",104,67,66,1,1,"PCAS",0
16,"16206",250,188,188,2,0,"PCAS",0
16,"16160",76,54,53,1,1,"PCAS",0
19,"19130",58473,45114,44362,688,752,"PCAS",83
19,"19177",82,67,66,0,1,"PCAS",0
16,"16118",1454,1221,1211,19,10,"PCAS",6
19,"19219",18,12,12,0,0,"PCAS",0
19,"19321",46,29,29,0,0,"PCAS",0
19,"19020",52,39,39,3,0,"PCAS",1
16,"16101",160,142,142,0,0,"PCAS",0
19,"19283",40,33,33,0,0,"PCAS",0
19,"19211",450,340,334,0,6,"PCAS",0
16,"16039",466,330,326,1,4,"PCAS",0
16,"16034",207,174,173,0,1,"PCAS",0
19,"19132",105,79,79,0,0,"PCAS",0
16,"16259",30,26,26,1,0,"PCAS",0
16,"16117",1130,871,857,8,14,"PCAS",1
19,"19040",73,42,42,1,0,"PCAS",0
16,"16181",73,62,62,1,0,"PCAS",0
19,"19104",16,12,12,1,0,"PCAS",0
16,"16211",462,317,313,2,4,"PCAS",0
19,"19115",41,26,26,1,0,"PCAS",0
19,"19279",66,56,56,0,0,"PCAS",0
19,"19235",121,92,87,0,5,"PCAS",0
16,"16017",406,337,334,1,3,"PCAS",0
16,"16202",908,753,744,10,9,"PCAS",1
19,"19121",277,219,217,0,2,"PCAS",0
19,"19167",136,112,109,4,3,"PCAS",0
19,"19286",743,566,554,8,12,"PCAS",0
16,"16018",417,350,342,3,8,"PCAS",0
16,"16058",120,103,102,1,1,"PCAS",0
16,"16204",306,235,235,5,0,"PCAS",1
16,"16166",277,210,202,0,8,"PCAS",0
16,"16040",97,76,75,1,1,"PCAS",0
19,"19047",87,71,70,2,1,"PCAS",0
16,"16193",77,68,67,0,1,"PCAS",0
16,"16027",779,619,612,5,7,"PCAS",2
16,"16130",633,504,492,5,12,"PCAS",0
19,"19213",72,60,60,1,0,"PCAS",0
19,"19233",108,93,90,2,3,"PCAS",0
19,"19248",64,53,53,0,0,"PCAS",0
19,"19074",81,69,69,0,0,"PCAS",0
19,"19221",56,41,41,2,0,"PCAS",0
19,"19015",104,88,87,0,1,"PCAS",0
16,"16902",165,128,126,1,2,"PCAS",0
19,"19218",60,35,35,0,0,"PCAS",0
16,"16270",192,156,155,0,1,"PCAS",2
19,"19156",1032,782,762,4,20,"PCAS",0
16,"16125",1734,1367,1350,12,17,"PCAS",2
16,"16020",20,15,15,0,0,"PCAS",0
19,"19294",27,26,26,1,0,"PCAS",0
16,"16249",2076,1728,1700,11,28,"PCAS",0
19,"19079",7,7,7,0,0,"PCAS",0
19,"19042",41,32,32,0,0,"PCAS",0
19,"19095",14,9,8,0,1,"PCAS",0
19,"19172",76,65,64,1,1,"PCAS",0
16,"16145",508,421,417,6,4,"PCAS",0
19,"19293",1860,1407,1373,16,34,"PCAS",1
16,"16224",96,69,69,0,0,"PCAS",0
16,"16264",505,440,438,6,2,"PCAS",0
16,"16057",109,82,82,1,0,"PCAS",0
19,"19023",121,95,94,5,1,"PCAS",0
16,"16173",249,189,188,0,1,"PCAS",0
19,"19159",108,91,88,1,3,"PCAS",0
16,"16274",147,125,125,1,0,"PCAS",0
16,"16218",207,170,169,4,1,"PCAS",0
19,"19225",879,625,618,9,7,"PCAS",2
16,"16909",737,590,585,9,5,"PCAS",2
16,"16213",39,32,32,1,0,"PCAS",0
19,"19187",64,54,54,0,0,"PCAS",0
19,"19263",34,27,27,0,0,"PCAS",0
16,"16901",793,590,582,2,8,"PCAS",1
19,"19242",112,93,92,1,1,"PCAS",0
19,"19076",36,29,29,0,0,"PCAS",0
19,"19114",40,34,34,0,0,"PCAS",0
16,"16189",263,213,211,2,2,"PCAS",0
16,"16005",275,215,215,2,0,"PCAS",0
19,"19251",41,35,34,0,1,"PCAS",0
19,"19021",1129,818,800,10,18,"PCAS",2
16,"16045",226,177,176,2,1,"PCAS",0
16,"16064",699,588,580,4,8,"PCAS",0
16,"16102",1320,1016,1007,15,9,"PCAS",1
19,"19122",96,65,65,0,0,"PCAS",0
16,"16046",262,191,191,1,0,"PCAS",1
19,"19166",179,123,121,4,2,"PCAS",0
16,"16195",545,436,433,6,3,"PCAS",1
16,"16212",286,229,226,3,3,"PCAS",0
16,"16197",73,50,50,1,0,"PCAS",0
19,"19005",92,80,79,0,1,"PCAS",0
16,"16906",104,83,82,0,1,"PCAS",0
19,"19220",2225,1482,1456,7,26,"PCAS",1
19,"19260",44,41,41,1,0,"PCAS",0
19,"19280",3415,2521,2490,27,31,"PCAS",3
19,"19007",460,351,345,5,6,"PCAS",1
16,"16148",634,553,547,5,6,"PCAS",0
19,"19323",50,41,39,0,2,"PCAS",0
19,"19335",77,61,61,1,0,"PCAS",0
19,"19268",34,26,25,0,1,"PCAS",0
19,"19165",51,43,42,0,1,"PCAS",0
16,"16163",75,57,57,0,0,"PCAS",0
16,"16004",325,247,246,0,1,"PCAS",0
19,"19226",40,31,30,0,1,"PCAS",0
16,"16089",386,310,308,10,2,"PCAS",1
19,"19133",103,89,88,2,1,"PCAS",0
16,"16043",105,86,86,1,0,"PCAS",0
16,"16025",31,23,23,0,0,"PCAS",0
19,"19287",153,114,113,2,1,"PCAS",0
19,"19296",43,31,30,1,1,"PCAS",0
19,"19285",26,20,20,2,0,"PCAS",0
19,"19058",6455,5028,4933,63,95,"PCAS",6
16,"16104",65,52,52,1,0,"PCAS",0
19,"19185",40,21,19,0,2,"PCAS",0
16,"16170",733,552,543,3,9,"PCAS",0
19,"19231",16,14,14,0,0,"PCAS",0
19,"19239",99,74,73,1,1,"PCAS",0
16,"16142",118,93,93,1,0,"PCAS",0
19,"19088",98,67,66,0,1,"PCAS",0
16,"16022",102,76,76,2,0,"PCAS",0
16,"16198",1451,1126,1105,21,21,"PCAS",0
16,"16174",209,170,167,0,3,"PCAS",1
19,"19046",20318,15118,14892,219,226,"PCAS",22
16,"16008",131,89,88,2,1,"PCAS",0
19,"19001",64,56,56,1,0,"PCAS",0
19,"19198",22,19,19,0,0,"PCAS",0
19,"19252",90,80,78,0,2,"PCAS",0
19,"19202",16,14,14,0,0,"PCAS",0
16,"16128",70,64,64,2,0,"PCAS",0
16,"16153",1006,856,843,8,13,"PCAS",0
19,"19016",74,50,49,0,1,"PCAS",0
19,"19154",79,68,67,0,1,"PCAS",0
19,"19090",107,87,86,0,1,"PCAS",0
19,"19257",3595,2593,2543,48,50,"PCAS",5
19,"19329",62,52,50,0,2,"PCAS",0
16,"16269",494,412,407,5,5,"PCAS",1
19,"19176",280,216,216,0,0,"PCAS",0
16,"16071",25,23,23,0,0,"PCAS",0
16,"16165",84,70,70,0,0,"PCAS",0
19,"19136",22,15,15,0,0,"PCAS",0
16,"16087",229,193,187,4,6,"PCAS",0
16,"16051",166,140,140,1,0,"PCAS",0
19,"19004",67,56,56,0,0,"PCAS",1
19,"19127",97,66,66,1,0,"PCAS",0
15,"15041",9718,7514,7425,102,89,"P.C.P.E.",10
39,"39030",1971,1397,1379,20,18,"P.C.P.E.",2
24,"24071",1060,808,797,6,11,"P.C.P.E.",1
3,"3137",719,536,530,3,6,"P.C.P.E.",1
15,"15040",2891,2160,2129,18,31,"P.C.P.E.",1
24,"24110",1291,914,904,16,10,"P.C.P.E.",3
50,"50074",6516,4378,4222,77,156,"P.C.P.E.",12
29,"29056",1177,807,794,3,13,"P.C.P.E.",0
50,"50186",44,30,29,0,1,"P.C.P.E.",0
24,"24066",561,440,437,5,3,"P.C.P.E.",1
22,"22212",93,79,79,0,0,"P.C.P.E.",0
46,"46201",83,50,49,0,1,"P.C.P.E.",0
22,"22074",311,227,219,5,8,"P.C.P.E.",0
41,"41020",12710,8954,8882,91,72,"P.C.P.E.",16
18,"18141",484,326,325,1,1,"P.C.P.E.",0
50,"50214",31,22,21,1,1,"P.C.P.E.",0
18,"18007",808,602,591,5,11,"P.C.P.E.",3
22,"22019",190,141,138,4,3,"P.C.P.E.",0
45,"45175",698,587,579,5,8,"P.C.P.E.",2
26,"26157",306,268,263,1,5,"P.C.P.E.",1
26,"26084",5999,4440,4399,56,41,"P.C.P.E.",8
39,"39077",256,196,196,1,0,"P.C.P.E.",0
47,"47069",128,108,108,0,0,"P.C.P.E.",0
33,"33032",12060,8627,8491,107,136,"P.C.P.E.",21
46,"46037",1146,1007,1003,5,4,"P.C.P.E.",1
46,"46196",159,145,144,1,1,"P.C.P.E.",0
22,"22252",130,98,96,5,2,"P.C.P.E.",0
46,"46058",1787,1460,1441,10,19,"P.C.P.E.",2
18,"18036",3553,2762,2741,20,21,"P.C.P.E.",5
13,"13046",786,654,644,2,10,"P.C.P.E.",2
26,"26128",116,94,93,0,1,"P.C.P.E.",0
39,"39016",24213,18549,18362,265,187,"P.C.P.E.",17
22,"22058",194,138,137,5,1,"P.C.P.E.",0
13,"13001",1372,1087,1067,8,20,"P.C.P.E.",0
26,"26177",322,276,274,2,2,"P.C.P.E.",0
22,"22105",132,104,102,2,2,"P.C.P.E.",2
50,"50246",48,33,33,1,0,"P.C.P.E.",0
47,"47096",139,109,107,0,2,"P.C.P.E.",0
45,"45073",351,265,261,3,4,"P.C.P.E.",0
26,"26124",860,705,694,3,11,"P.C.P.E.",0
45,"45158",2577,1948,1909,18,39,"P.C.P.E.",5
22,"22215",137,90,90,1,0,"P.C.P.E.",0
41,"41903",6653,5134,5070,61,64,"P.C.P.E.",1
2,"2048",1320,1076,1061,11,15,"P.C.P.E.",0
24,"24068",500,357,349,3,8,"P.C.P.E.",0
13,"13074",1000,886,878,15,8,"P.C.P.E.",0
26,"26012",17,15,15,1,0,"P.C.P.E.",0
26,"26035",22,14,14,0,0,"P.C.P.E.",0
47,"47212",386,327,325,1,2,"P.C.P.E.",0
18,"18189",723,547,541,6,6,"P.C.P.E.",2
50,"50168",34,26,26,1,0,"P.C.P.E.",0
33,"33008",1934,1474,1459,11,15,"P.C.P.E.",4
41,"41017",13878,10053,9926,130,127,"P.C.P.E.",13
22,"22243",45,27,27,1,0,"P.C.P.E.",0
2,"2022",431,346,343,1,3,"P.C.P.E.",0
45,"45080",3,3,3,0,0,"P.C.P.E.",0
46,"46253",118,105,102,7,3,"P.C.P.E.",1
18,"18051",1196,857,852,4,5,"P.C.P.E.",0
15,"15005",23875,15132,14895,356,237,"P.C.P.E.",29
39,"39100",922,718,712,8,6,"P.C.P.E.",1
46,"46241",440,336,314,4,22,"P.C.P.E.",0
3,"3006",479,380,369,2,11,"P.C.P.E.",0
41,"41081",28121,20027,19785,275,242,"P.C.P.E.",28
22,"22040",155,129,127,3,2,"P.C.P.E.",0
22,"22078",468,302,301,8,1,"P.C.P.E.",3
47,"47058",199,157,157,3,0,"P.C.P.E.",2
46,"46071",488,418,402,10,16,"P.C.P.E.",0
24,"24133",379,279,279,0,0,"P.C.P.E.",0
39,"39017",588,424,419,2,5,"P.C.P.E.",0
45,"45169",239,183,183,1,0,"P.C.P.E.",0
41,"41087",9827,7300,7150,51,150,"P.C.P.E.",6
35,"35018",11652,6488,6367,107,121,"P.C.P.E.",14
15,"15086",3110,2281,2259,30,22,"P.C.P.E.",3
33,"33025",9455,6331,6277,84,54,"P.C.P.E.",4
46,"46072",3711,3006,2932,38,74,"P.C.P.E.",1
14,"14025",3061,2547,2517,13,30,"P.C.P.E.",1
47,"47146",236,196,195,4,1,"P.C.P.E.",0
41,"41021",20767,14040,13822,240,218,"P.C.P.E.",14
47,"47115",306,248,248,2,0,"P.C.P.E.",0
33,"33073",9341,5825,5773,69,52,"P.C.P.E.",10
24,"24024",717,501,498,10,3,"P.C.P.E.",1
46,"46014",3092,2449,2420,26,29,"P.C.P.E.",0
50,"50238",114,82,80,0,2,"P.C.P.E.",0
39,"39039",648,496,493,0,3,"P.C.P.E.",1
50,"50231",285,231,224,7,7,"P.C.P.E.",0
46,"46028",424,352,347,5,5,"P.C.P.E.",0
50,"50269",316,186,185,1,1,"P.C.P.E.",0
24,"24154",1068,803,795,6,8,"P.C.P.E.",0
3,"3066",42697,31279,30833,566,446,"P.C.P.E.",64
15,"15058",26931,19505,19196,471,309,"P.C.P.E.",22
46,"46176",1965,1423,1405,12,18,"P.C.P.E.",5
14,"14022",4077,3147,3102,20,45,"P.C.P.E.",5
24,"24212",1105,856,846,14,10,"P.C.P.E.",2
2,"2028",139,115,115,1,0,"P.C.P.E.",0
24,"24036",321,190,188,0,2,"P.C.P.E.",0
15,"15063",2849,2022,2001,28,21,"P.C.P.E.",0
46,"46191",1952,1554,1528,9,26,"P.C.P.E.",2
41,"41019",4528,3194,3168,41,26,"P.C.P.E.",1
3,"3032",112,90,88,0,2,"P.C.P.E.",0
3,"3045",233,204,203,2,1,"P.C.P.E.",0
35,"35024",12420,6978,6819,131,159,"P.C.P.E.",6
47,"47084",1230,981,968,19,13,"P.C.P.E.",2
18,"18144",779,592,590,3,2,"P.C.P.E.",0
47,"47173",862,683,675,5,8,"P.C.P.E.",0
41,"41038",96442,66696,65945,1021,751,"P.C.P.E.",84
33,"33038",2442,1757,1725,14,32,"P.C.P.E.",4
26,"26139",68,55,55,4,0,"P.C.P.E.",0
13,"13008",473,362,360,4,2,"P.C.P.E.",0
47,"47161",3886,3133,3105,45,28,"P.C.P.E.",4
26,"26056",440,345,339,4,6,"P.C.P.E.",0
3,"3011",7341,5277,5218,72,59,"P.C.P.E.",5
50,"50233",120,89,88,2,1,"P.C.P.E.",1
18,"18085",818,538,532,4,6,"P.C.P.E.",0
41,"41072",4083,3073,3046,12,27,"P.C.P.E.",2
33,"33033",10609,7179,7107,91,72,"P.C.P.E.",16
46,"46125",858,724,710,6,14,"P.C.P.E.",2
3,"3053",7082,5754,5664,60,90,"P.C.P.E.",15
15,"15092",6869,4965,4907,53,58,"P.C.P.E.",2
45,"45066",7334,5602,5536,52,66,"P.C.P.E.",8
3,"3005",7482,6191,6146,49,45,"P.C.P.E.",19
22,"22164",46,32,32,0,0,"P.C.P.E.",0
50,"50227",105,79,79,2,0,"P.C.P.E.",0
45,"45093",168,133,133,0,0,"P.C.P.E.",0
11,"11042",1232,933,922,4,11,"P.C.P.E.",3
26,"26019",365,296,295,6,1,"P.C.P.E.",0
22,"22028",424,311,310,3,1,"P.C.P.E.",2
30,"30033",9940,7794,7700,79,94,"P.C.P.E.",14
2,"2072",1598,1220,1198,5,22,"P.C.P.E.",0
47,"47088",121,100,100,0,0,"P.C.P.E.",0
46,"46066",1264,1060,1050,5,10,"P.C.P.E.",0
46,"46060",9510,7506,7408,52,98,"P.C.P.E.",13
15,"15089",4354,3255,3216,55,39,"P.C.P.E.",3
46,"46128",1649,1322,1292,14,30,"P.C.P.E.",7
41,"41057",299,191,189,0,2,"P.C.P.E.",0
24,"24027",1184,853,837,7,16,"P.C.P.E.",0
22,"22067",82,54,49,3,5,"P.C.P.E.",0
45,"45059",1758,1465,1437,10,28,"P.C.P.E.",2
22,"22086",207,149,147,1,2,"P.C.P.E.",0
29,"29061",1045,861,855,7,6,"P.C.P.E.",5
45,"45016",3804,2926,2876,52,50,"P.C.P.E.",12
50,"50141",116,98,98,1,0,"P.C.P.E.",0
46,"46143",4278,3309,3266,46,43,"P.C.P.E.",4
50,"50243",346,277,272,2,5,"P.C.P.E.",0
50,"50065",59,37,37,2,0,"P.C.P.E.",0
2,"2061",715,570,565,4,5,"P.C.P.E.",1
24,"24182",448,339,333,9,6,"P.C.P.E.",0
26,"26118",64,58,56,0,2,"P.C.P.E.",0
50,"50208",1831,1321,1305,24,16,"P.C.P.E.",0
47,"47057",237,198,198,3,0,"P.C.P.E.",0
41,"41015",5263,3820,3752,34,68,"P.C.P.E.",4
38,"38011",19299,12565,12313,152,252,"P.C.P.E.",12
50,"50180",111,91,89,3,2,"P.C.P.E.",0
50,"50194",102,67,67,2,0,"P.C.P.E.",0
18,"18001",288,212,212,1,0,"P.C.P.E.",0
50,"50184",132,106,106,1,0,"P.C.P.E.",0
26,"26160",684,538,528,5,10,"P.C.P.E.",1
45,"45076",603,420,419,3,1,"P.C.P.E.",0
47,"47218",983,776,767,7,9,"P.C.P.E.",2
13,"13034",56981,42819,42306,742,513,"P.C.P.E.",72
13,"13005",23052,18002,17700,255,302,"P.C.P.E.",33
26,"26037",150,129,128,1,1,"P.C.P.E.",7
50,"50023",240,180,180,4,0,"P.C.P.E.",0
45,"45060",204,151,148,1,3,"P.C.P.E.",0
33,"33034",11390,7583,7501,85,82,"P.C.P.E.",6
3,"3019",14914,12087,11927,137,160,"P.C.P.E.",21
45,"45196",1363,1092,1076,3,16,"P.C.P.E.",3
13,"13061",5898,4442,4373,56,69,"P.C.P.E.",2
47,"47214",1517,1215,1191,34,24,"P.C.P.E.",1
46,"46001",863,647,641,5,6,"P.C.P.E.",0
47,"47073",141,118,116,1,2,"P.C.P.E.",0
24,"24031",220,180,176,3,4,"P.C.P.E.",0
24,"24188",3830,2987,2928,51,59,"P.C.P.E.",7
22,"22131",96,79,77,2,2,"P.C.P.E.",0
15,"15032",3639,2642,2586,35,56,"P.C.P.E.",2
50,"50147",845,637,627,12,10,"P.C.P.E.",3
11,"11020",163674,106898,106082,1655,816,"P.C.P.E.",224
41,"41063",2678,1869,1853,22,16,"P.C.P.E.",1
50,"50177",355,268,265,4,3,"P.C.P.E.",3
45,"45185",7912,6321,6180,68,141,"P.C.P.E.",1
46,"46194",15267,11622,11491,110,131,"P.C.P.E.",11
50,"50155",119,91,91,1,0,"P.C.P.E.",0
26,"26120",1515,1215,1198,20,17,"P.C.P.E.",2
33,"33045",4692,3347,3297,42,50,"P.C.P.E.",3
26,"26110",178,149,147,3,2,"P.C.P.E.",0
45,"45035",307,236,236,3,0,"P.C.P.E.",2
3,"3083",5708,4267,4196,66,71,"P.C.P.E.",6
41,"41075",9987,7904,7809,71,95,"P.C.P.E.",3
24,"24007",798,582,566,2,16,"P.C.P.E.",0
47,"47060",262,220,218,1,2,"P.C.P.E.",0
36,"36039",14581,11007,10782,167,225,"P.C.P.E.",9
30,"30010",6804,5691,5647,36,44,"P.C.P.E.",3
41,"41007",12177,8150,8016,126,134,"P.C.P.E.",10
26,"26123",129,113,113,1,0,"P.C.P.E.",0
18,"18094",2398,1882,1868,16,14,"P.C.P.E.",1
22,"22084",524,362,354,11,8,"P.C.P.E.",1
39,"39069",1957,1595,1570,18,25,"P.C.P.E.",7
26,"26176",69,55,54,0,1,"P.C.P.E.",0
38,"38027",5392,3530,3459,41,71,"P.C.P.E.",1
3,"3082",11741,8208,8102,80,106,"P.C.P.E.",20
50,"50205",98,72,71,2,1,"P.C.P.E.",0
11,"11007",17997,10781,10676,184,105,"P.C.P.E.",15
39,"39080",3627,2743,2693,19,50,"P.C.P.E.",1
24,"24148",1759,1362,1348,29,14,"P.C.P.E.",1
46,"46031",10580,7900,7809,87,91,"P.C.P.E.",12
50,"50189",776,588,576,9,12,"P.C.P.E.",0
41,"41014",2484,1956,1936,13,20,"P.C.P.E.",2
24,"24185",512,414,402,3,12,"P.C.P.E.",0
22,"22055",347,291,289,5,2,"P.C.P.E.",1
46,"46238",13401,10371,10283,96,88,"P.C.P.E.",26
14,"14043",7664,5935,5874,53,61,"P.C.P.E.",10
46,"46092",304,206,201,1,5,"P.C.P.E.",1
46,"46231",2496,1831,1817,16,14,"P.C.P.E.",7
3,"3016",91,67,66,1,1,"P.C.P.E.",1
46,"46009",3140,2521,2498,15,23,"P.C.P.E.",0
22,"22047",228,200,200,5,0,"P.C.P.E.",1
18,"18056",3695,2961,2940,25,21,"P.C.P.E.",5
41,"41005",8792,6642,6585,71,57,"P.C.P.E.",5
26,"26038",93,71,69,1,2,"P.C.P.E.",0
26,"26022",232,191,190,1,1,"P.C.P.E.",0
46,"46179",2186,1849,1804,17,45,"P.C.P.E.",2
50,"50262",1216,916,904,20,12,"P.C.P.E.",1
2,"2033",1955,1565,1536,15,29,"P.C.P.E.",3
29,"29045",1750,1246,1239,6,7,"P.C.P.E.",1
26,"26003",446,388,387,8,1,"P.C.P.E.",0
24,"24014",7677,5352,5289,75,63,"P.C.P.E.",9
50,"50288",3252,2412,2380,50,32,"P.C.P.E.",6
35,"35032",3432,2605,2548,37,57,"P.C.P.E.",8
46,"46233",3911,3025,2988,10,37,"P.C.P.E.",1
26,"26001",211,174,168,3,6,"P.C.P.E.",1
18,"18076",880,676,676,3,0,"P.C.P.E.",0
35,"35030",8295,5433,5315,54,118,"P.C.P.E.",9
26,"26142",804,661,648,1,13,"P.C.P.E.",2
41,"41062",2252,1719,1698,12,21,"P.C.P.E.",0
47,"47142",172,132,131,2,1,"P.C.P.E.",0
46,"46161",1454,1192,1179,8,13,"P.C.P.E.",1
2,"2082",121,107,107,1,0,"P.C.P.E.",0
33,"33006",1674,1130,1120,10,10,"P.C.P.E.",3
18,"18046",1960,1327,1312,5,15,"P.C.P.E.",0
46,"46068",326,292,285,3,7,"P.C.P.E.",0
3,"3028",1049,903,895,6,8,"P.C.P.E.",0
39,"39059",8476,6365,6284,73,81,"P.C.P.E.",6
50,"50253",461,381,375,3,6,"P.C.P.E.",0
18,"18138",2460,1751,1741,1,10,"P.C.P.E.",2
24,"24053",503,338,332,3,6,"P.C.P.E.",0
46,"46160",1976,1591,1570,21,21,"P.C.P.E.",6
46,"46046",922,699,694,2,5,"P.C.P.E.",1
46,"46216",4806,3857,3825,39,32,"P.C.P.E.",2
39,"39042",5928,4680,4634,44,46,"P.C.P.E.",1
3,"3101",4648,3694,3607,29,87,"P.C.P.E.",12
41,"41023",7901,6050,5972,45,78,"P.C.P.E.",1
38,"38030",1875,1320,1301,11,19,"P.C.P.E.",2
11,"11024",6811,5241,5202,58,39,"P.C.P.E.",4
41,"41054",671,556,550,0,6,"P.C.P.E.",0
45,"45173",9133,7147,7035,78,112,"P.C.P.E.",18
11,"11025",4371,3260,3226,34,34,"P.C.P.E.",3
33,"33050",653,406,402,0,4,"P.C.P.E.",1
41,"41101",5752,4663,4629,25,34,"P.C.P.E.",3
15,"15019",26096,18466,18187,350,279,"P.C.P.E.",17
26,"26109",105,87,84,0,3,"P.C.P.E.",0
41,"41067",7055,5368,5295,64,73,"P.C.P.E.",8
24,"24103",330,180,177,0,3,"P.C.P.E.",0
50,"50174",107,92,90,0,2,"P.C.P.E.",0
33,"33011",12085,7186,7116,89,70,"P.C.P.E.",16
38,"38009",3910,2687,2633,31,54,"P.C.P.E.",3
50,"50176",237,161,160,4,1,"P.C.P.E.",0
3,"3010",330,269,266,3,3,"P.C.P.E.",0
47,"47199",84,61,60,1,1,"P.C.P.E.",0
2,"2008",1332,985,966,12,19,"P.C.P.E.",1
41,"41061",2205,1798,1770,2,28,"P.C.P.E.",0
50,"50157",313,253,250,7,3,"P.C.P.E.",1
18,"18153",8348,6170,6118,88,52,"P.C.P.E.",6
15,"15018",1211,821,805,11,16,"P.C.P.E.",0
24,"24214",716,518,509,4,9,"P.C.P.E.",0
24,"24160",741,545,539,17,6,"P.C.P.E.",0
50,"50024",652,541,531,8,10,"P.C.P.E.",0
15,"15071",8233,5751,5668,93,83,"P.C.P.E.",10
50,"50276",148,116,114,3,2,"P.C.P.E.",0
46,"46239",457,331,323,2,8,"P.C.P.E.",1
24,"24018",180,150,149,1,1,"P.C.P.E.",0
46,"46006",4643,3847,3785,32,62,"P.C.P.E.",2
46,"46195",1975,1631,1631,33,0,"P.C.P.E.",2
3,"3034",1343,1140,1126,5,14,"P.C.P.E.",2
24,"24102",701,536,530,3,6,"P.C.P.E.",0
41,"41039",31429,23337,23138,294,199,"P.C.P.E.",23
47,"47192",99,84,84,0,0,"P.C.P.E.",0
24,"24089",106265,77385,76124,1666,1261,"P.C.P.E.",115
3,"3038",338,294,291,2,3,"P.C.P.E.",1
22,"22051",108,86,84,2,2,"P.C.P.E.",0
13,"13059",232,186,184,0,2,"P.C.P.E.",0
22,"22220",192,138,136,5,2,"P.C.P.E.",1
24,"24144",781,551,541,13,10,"P.C.P.E.",1
24,"24095",293,211,208,1,3,"P.C.P.E.",1
13,"13010",910,729,726,8,3,"P.C.P.E.",0
33,"33020",13542,9300,9173,135,127,"P.C.P.E.",32
50,"50137",1119,842,834,12,8,"P.C.P.E.",0
45,"45022",427,317,314,8,3,"P.C.P.E.",0
22,"22174",520,401,394,11,7,"P.C.P.E.",0
22,"22022",582,448,438,12,10,"P.C.P.E.",2
46,"46087",137,105,105,1,0,"P.C.P.E.",0
22,"22009",704,488,473,15,15,"P.C.P.E.",3
50,"50297",495260,360632,355561,7046,5071,"P.C.P.E.",743
46,"46144",699,547,536,2,11,"P.C.P.E.",0
46,"46220",48981,34657,34242,450,415,"P.C.P.E.",52
46,"46025",2495,1962,1941,24,21,"P.C.P.E.",1
13,"13027",3582,2770,2715,25,55,"P.C.P.E.",0
39,"39057",2298,1735,1719,17,16,"P.C.P.E.",0
15,"15048",4769,3470,3415,57,55,"P.C.P.E.",2
26,"26072",310,270,264,4,6,"P.C.P.E.",1
50,"50120",53,41,41,0,0,"P.C.P.E.",0
50,"50191",505,395,390,4,5,"P.C.P.E.",0
47,"47018",33,30,28,2,2,"P.C.P.E.",0
45,"45090",396,335,333,0,2,"P.C.P.E.",0
11,"11022",48624,26656,26430,345,226,"P.C.P.E.",41
47,"47076",16922,13030,12899,212,131,"P.C.P.E.",18
46,"46229",1065,840,831,8,9,"P.C.P.E.",0
46,"46040",1227,1028,1021,13,7,"P.C.P.E.",1
26,"26080",529,427,425,2,2,"P.C.P.E.",2
47,"47079",67,56,56,1,0,"P.C.P.E.",0
30,"30022",16489,12207,12042,152,165,"P.C.P.E.",48
15,"15082",15075,11217,11046,187,171,"P.C.P.E.",12
22,"22017",917,677,661,8,16,"P.C.P.E.",3
22,"22119",1433,994,981,14,13,"P.C.P.E.",3
35,"35012",9662,5511,5446,45,65,"P.C.P.E.",15
50,"50239",65,44,44,0,0,"P.C.P.E.",0
29,"29017",6766,5162,5114,48,48,"P.C.P.E.",8
36,"36041",13141,9405,9238,114,167,"P.C.P.E.",7
45,"45063",504,378,372,3,6,"P.C.P.E.",0
41,"41045",5505,3946,3889,68,57,"P.C.P.E.",2
50,"50035",78,61,56,2,5,"P.C.P.E.",1
22,"22225",2784,1839,1805,42,34,"P.C.P.E.",7
22,"22160",219,166,166,5,0,"P.C.P.E.",3
50,"50056",450,329,328,4,1,"P.C.P.E.",1
2,"2024",3424,2765,2726,32,39,"P.C.P.E.",7
50,"50192",240,188,184,9,4,"P.C.P.E.",0
18,"18150",6452,4666,4625,56,41,"P.C.P.E.",4
46,"46036",675,440,431,11,9,"P.C.P.E.",1
46,"46244",57805,41885,41595,415,290,"P.C.P.E.",48
47,"47031",203,149,149,0,0,"P.C.P.E.",0
18,"18137",1057,875,868,8,7,"P.C.P.E.",0
41,"41026",4273,3577,3538,15,39,"P.C.P.E.",7
24,"24091",704,502,496,8,6,"P.C.P.E.",1
26,"26129",1010,794,780,7,14,"P.C.P.E.",1
24,"24016",544,323,322,4,1,"P.C.P.E.",0
39,"39021",536,448,444,1,4,"P.C.P.E.",1
47,"47118",159,122,122,2,0,"P.C.P.E.",0
15,"15036",60838,40345,39667,915,678,"P.C.P.E.",60
39,"39006",1732,1381,1373,23,8,"P.C.P.E.",0
41,"41027",4061,2783,2752,28,31,"P.C.P.E.",1
45,"45126",278,188,187,0,1,"P.C.P.E.",1
22,"22064",184,139,137,3,2,"P.C.P.E.",0
50,"50101",922,648,637,8,11,"P.C.P.E.",1
50,"50903",2234,1622,1597,35,25,"P.C.P.E.",4
29,"29050",483,341,340,1,1,"P.C.P.E.",0
22,"22042",115,93,91,1,2,"P.C.P.E.",0
3,"3026",1210,1004,989,11,15,"P.C.P.E.",3
39,"39022",985,735,734,5,1,"P.C.P.E.",2
39,"39089",163,126,126,0,0,"P.C.P.E.",0
24,"24173",1023,757,747,4,10,"P.C.P.E.",2
45,"45187",4187,3581,3512,25,69,"P.C.P.E.",2
50,"50195",48,38,38,1,0,"P.C.P.E.",0
45,"45096",1021,800,778,5,22,"P.C.P.E.",3
45,"45075",205,162,159,4,3,"P.C.P.E.",0
39,"39085",6722,5198,5134,60,64,"P.C.P.E.",4
50,"50222",1695,1117,1091,16,26,"P.C.P.E.",4
22,"22088",171,133,128,5,5,"P.C.P.E.",0
50,"50106",137,107,106,0,1,"P.C.P.E.",0
36,"36055",13678,10508,10288,155,220,"P.C.P.E.",15
47,"47183",150,125,122,0,3,"P.C.P.E.",0
46,"46022",15090,10922,10840,99,82,"P.C.P.E.",16
29,"29075",12666,8284,8218,62,66,"P.C.P.E.",1
18,"18074",297,245,245,5,0,"P.C.P.E.",0
18,"18121",135,109,109,0,0,"P.C.P.E.",0
50,"50068",2082,1514,1481,18,33,"P.C.P.E.",1
26,"26148",189,151,150,0,1,"P.C.P.E.",0
45,"45081",16099,12232,12079,154,153,"P.C.P.E.",14
24,"24063",453,323,322,2,1,"P.C.P.E.",0
45,"45154",1459,1148,1140,12,8,"P.C.P.E.",1
18,"18033",282,227,226,0,1,"P.C.P.E.",0
35,"35007",569,392,391,2,1,"P.C.P.E.",2
45,"45031",2773,2011,1975,25,36,"P.C.P.E.",9
45,"45142",7974,6294,6178,89,116,"P.C.P.E.",7
18,"18087",187449,138136,136783,1548,1353,"P.C.P.E.",147
26,"26173",10,10,10,1,0,"P.C.P.E.",0
18,"18151",276,191,188,0,3,"P.C.P.E.",1
29,"29019",908,720,714,0,6,"P.C.P.E.",0
30,"30026",15165,10524,10369,80,155,"P.C.P.E.",18
3,"3029",260,191,186,0,5,"P.C.P.E.",0
46,"46115",515,364,354,1,10,"P.C.P.E.",0
24,"24012",291,196,194,2,2,"P.C.P.E.",0
33,"33056",5278,3576,3540,41,36,"P.C.P.E.",2
35,"35002",21673,14480,14253,172,227,"P.C.P.E.",47
50,"50247",794,572,567,7,5,"P.C.P.E.",0
26,"26135",181,139,137,1,2,"P.C.P.E.",2
13,"13040",933,755,744,4,11,"P.C.P.E.",1
33,"33013",466,349,345,4,4,"P.C.P.E.",1
50,"50140",172,108,108,1,0,"P.C.P.E.",0
15,"15079",1709,1268,1253,14,15,"P.C.P.E.",3
24,"24023",272,196,193,6,3,"P.C.P.E.",1
39,"39010",688,533,524,6,9,"P.C.P.E.",0
50,"50156",234,186,183,2,3,"P.C.P.E.",0
45,"45042",184,154,151,3,3,"P.C.P.E.",0
46,"46186",18444,14173,14029,135,144,"P.C.P.E.",15
29,"29023",1661,1080,1074,15,6,"P.C.P.E.",0
39,"39062",1759,1397,1387,9,10,"P.C.P.E.",0
2,"2056",1816,1518,1506,15,12,"P.C.P.E.",0
45,"45084",2395,1879,1842,21,37,"P.C.P.E.",3
46,"46211",1716,1459,1447,9,12,"P.C.P.E.",2
29,"29068",6209,4025,3983,41,42,"P.C.P.E.",3
3,"3118",2368,1746,1718,16,28,"P.C.P.E.",5
13,"13037",901,752,745,2,7,"P.C.P.E.",2
24,"24157",2580,2046,2000,39,46,"P.C.P.E.",0
2,"2020",519,433,430,0,3,"P.C.P.E.",0
26,"26011",7455,5452,5353,93,99,"P.C.P.E.",5
3,"3117",381,321,317,4,4,"P.C.P.E.",0
36,"36049",6608,5189,5097,56,92,"P.C.P.E.",13
26,"26119",223,186,185,2,1,"P.C.P.E.",0
50,"50237",103,76,75,0,1,"P.C.P.E.",0
22,"22221",108,70,69,5,1,"P.C.P.E.",0
50,"50148",365,256,251,2,5,"P.C.P.E.",1
3,"3050",17818,12860,12706,160,154,"P.C.P.E.",36
39,"39028",3513,2760,2718,23,42,"P.C.P.E.",5
26,"26183",65,54,54,0,0,"P.C.P.E.",0
33,"33016",19516,14345,14210,198,135,"P.C.P.E.",25
2,"2058",390,290,285,0,5,"P.C.P.E.",1
46,"46077",7637,5979,5845,64,134,"P.C.P.E.",11
24,"24017",630,476,468,11,8,"P.C.P.E.",0
29,"29028",1253,887,876,8,11,"P.C.P.E.",0
46,"46150",1898,1555,1541,8,14,"P.C.P.E.",7
2,"2062",456,348,344,2,4,"P.C.P.E.",0
46,"46121",116,103,101,0,2,"P.C.P.E.",0
36,"36029",16178,11902,11636,148,266,"P.C.P.E.",18
11,"11021",6838,5102,5049,67,53,"P.C.P.E.",31
24,"24172",491,234,232,2,2,"P.C.P.E.",1
13,"13025",321,257,254,1,3,"P.C.P.E.",0
30,"30036",13978,10244,10141,94,103,"P.C.P.E.",12
50,"50061",228,191,183,3,8,"P.C.P.E.",0
45,"45165",62818,47242,46629,549,613,"P.C.P.E.",63
15,"15050",1971,1110,1097,27,13,"P.C.P.E.",4
26,"26167",66,51,51,2,0,"P.C.P.E.",0
47,"47078",178,159,154,7,5,"P.C.P.E.",0
41,"41071",5603,3999,3932,28,67,"P.C.P.E.",2
18,"18127",15897,11597,11483,133,114,"P.C.P.E.",23
26,"26082",121,95,95,0,0,"P.C.P.E.",0
50,"50133",126,101,100,1,1,"P.C.P.E.",0
2,"2035",1988,1601,1586,19,15,"P.C.P.E.",2
14,"14005",6334,4262,4206,61,56,"P.C.P.E.",9
14,"14035",6153,4715,4656,51,59,"P.C.P.E.",3
45,"45149",638,542,533,2,9,"P.C.P.E.",0
22,"22085",119,97,94,0,3,"P.C.P.E.",0
2,"2036",104,78,78,0,0,"P.C.P.E.",0
26,"26015",205,167,165,1,2,"P.C.P.E.",0
45,"45174",343,289,288,0,1,"P.C.P.E.",0
18,"18084",3954,3039,3015,50,24,"P.C.P.E.",6
46,"46222",378,321,310,1,11,"P.C.P.E.",0
47,"47152",94,65,65,0,0,"P.C.P.E.",0
47,"47175",6562,5041,4957,62,84,"P.C.P.E.",5
45,"45019",7033,5207,5110,89,97,"P.C.P.E.",26
50,"50042",16,14,14,0,0,"P.C.P.E.",0
2,"2013",158,123,121,1,2,"P.C.P.E.",0
47,"47099",174,153,153,4,0,"P.C.P.E.",0
22,"22124",229,171,170,2,1,"P.C.P.E.",1
3,"3054",371,321,315,2,6,"P.C.P.E.",1
18,"18061",1109,882,869,1,13,"P.C.P.E.",1
45,"45159",100,84,84,1,0,"P.C.P.E.",0
14,"14057",6115,5040,4975,71,65,"P.C.P.E.",8
50,"50015",109,73,73,0,0,"P.C.P.E.",0
30,"30006",823,719,711,5,8,"P.C.P.E.",0
29,"29035",1717,1280,1270,14,10,"P.C.P.E.",1
30,"30032",2839,2361,2337,21,24,"P.C.P.E.",1
47,"47064",30,21,21,1,0,"P.C.P.E.",0
46,"46034",1791,1477,1468,8,9,"P.C.P.E.",1
46,"46038",368,264,260,1,4,"P.C.P.E.",2
39,"39012",6666,5148,5061,43,87,"P.C.P.E.",8
46,"46188",660,579,576,4,3,"P.C.P.E.",0
45,"45181",2276,1788,1764,10,24,"P.C.P.E.",0
47,"47132",45,40,40,0,0,"P.C.P.E.",0
46,"46122",2737,2154,2131,18,23,"P.C.P.E.",1
22,"22089",329,246,237,8,9,"P.C.P.E.",0
50,"50034",923,634,617,10,17,"P.C.P.E.",0
41,"41083",1176,915,908,8,7,"P.C.P.E.",0
33,"33004",69056,49228,48730,726,498,"P.C.P.E.",117
50,"50058",80,65,64,0,1,"P.C.P.E.",0
29,"29048",1508,1254,1245,6,9,"P.C.P.E.",0
46,"46167",411,312,309,0,3,"P.C.P.E.",0
45,"45127",739,550,538,5,12,"P.C.P.E.",1
13,"13055",738,585,578,8,7,"P.C.P.E.",3
39,"39094",927,702,691,0,11,"P.C.P.E.",3
50,"50252",5345,3860,3792,79,68,"P.C.P.E.",4
45,"45116",682,576,565,0,11,"P.C.P.E.",0
30,"30028",6810,5333,5251,44,82,"P.C.P.E.",15
24,"24070",4434,3199,3136,34,63,"P.C.P.E.",4
13,"13067",380,314,312,3,2,"P.C.P.E.",0
13,"13023",8731,6818,6732,94,86,"P.C.P.E.",1
3,"3046",1530,1136,1121,11,15,"P.C.P.E.",4
11,"11033",19983,12960,12807,199,153,"P.C.P.E.",31
50,"50131",243,185,183,6,2,"P.C.P.E.",0
45,"45163",8239,6203,6073,103,130,"P.C.P.E.",14
24,"24123",835,559,555,6,4,"P.C.P.E.",2
50,"50107",953,785,780,13,5,"P.C.P.E.",1
35,"35027",10510,7523,7375,88,148,"P.C.P.E.",22
22,"22062",189,126,125,2,1,"P.C.P.E.",0
3,"3036",84,72,72,0,0,"P.C.P.E.",0
24,"24120",379,258,256,3,2,"P.C.P.E.",0
41,"41018",9457,6940,6867,66,73,"P.C.P.E.",23
50,"50250",58,43,43,4,0,"P.C.P.E.",0
24,"24082",877,698,690,13,8,"P.C.P.E.",2
2,"2074",6093,4630,4548,57,82,"P.C.P.E.",7
13,"13076",514,436,428,0,8,"P.C.P.E.",1
15,"15043",5491,4033,3971,45,62,"P.C.P.E.",2
46,"46242",361,288,280,4,8,"P.C.P.E.",3
45,"45180",2714,2018,1980,19,38,"P.C.P.E.",5
39,"39087",43561,33709,33242,404,467,"P.C.P.E.",102
50,"50298",5319,4023,3955,72,68,"P.C.P.E.",10
39,"39081",440,372,369,3,3,"P.C.P.E.",0
3,"3051",356,314,311,2,3,"P.C.P.E.",0
41,"41098",4650,3665,3603,43,62,"P.C.P.E.",4
18,"18045",1211,892,885,4,7,"P.C.P.E.",0
50,"50270",39,30,29,1,1,"P.C.P.E.",0
35,"35003",4764,2733,2680,34,53,"P.C.P.E.",6
15,"15035",11969,8239,8120,192,119,"P.C.P.E.",11
2,"2055",1267,900,884,6,16,"P.C.P.E.",1
45,"45193",661,557,548,1,9,"P.C.P.E.",1
38,"38044",2325,1550,1532,7,18,"P.C.P.E.",0
18,"18100",7304,5807,5737,62,70,"P.C.P.E.",8
39,"39097",732,476,470,4,6,"P.C.P.E.",2
18,"18147",3742,2419,2386,20,33,"P.C.P.E.",6
13,"13026",482,387,384,1,3,"P.C.P.E.",0
47,"47059",108,77,76,1,1,"P.C.P.E.",0
47,"47008",26,17,17,0,0,"P.C.P.E.",0
50,"50004",613,445,441,6,4,"P.C.P.E.",1
45,"45145",2430,1866,1821,13,45,"P.C.P.E.",6
46,"46163",1811,1487,1463,12,24,"P.C.P.E.",1
46,"46017",32928,24879,24672,267,207,"P.C.P.E.",25
45,"45121",6553,4720,4653,43,67,"P.C.P.E.",7
50,"50271",283,209,207,4,2,"P.C.P.E.",1
41,"41099",4141,2818,2799,37,19,"P.C.P.E.",1
3,"3024",3908,3324,3271,34,53,"P.C.P.E.",8
46,"46187",1339,1096,1083,13,13,"P.C.P.E.",2
24,"24130",468,343,337,6,6,"P.C.P.E.",1
35,"35004",35462,18498,18196,325,302,"P.C.P.E.",31
46,"46018",689,597,592,12,5,"P.C.P.E.",0
47,"47215",60,52,52,2,0,"P.C.P.E.",0
41,"41009",1272,914,899,8,15,"P.C.P.E.",0
13,"13042",953,704,693,5,11,"P.C.P.E.",0
50,"50244",215,155,155,6,0,"P.C.P.E.",0
18,"18126",1461,1129,1121,15,8,"P.C.P.E.",1
38,"38024",14851,9589,9399,93,190,"P.C.P.E.",13
18,"18146",1059,791,776,2,15,"P.C.P.E.",0
3,"3107",2288,1670,1647,15,23,"P.C.P.E.",2
11,"11015",59476,38207,37898,501,309,"P.C.P.E.",69
50,"50275",103,76,76,0,0,"P.C.P.E.",0
18,"18192",1581,1331,1318,6,13,"P.C.P.E.",4
46,"46032",5583,4342,4287,39,55,"P.C.P.E.",2
15,"15022",6102,4207,4164,52,43,"P.C.P.E.",1
45,"45033",407,302,295,3,7,"P.C.P.E.",0
50,"50210",39,28,24,0,4,"P.C.P.E.",0
47,"47223",172,147,147,6,0,"P.C.P.E.",0
50,"50063",76,67,67,0,0,"P.C.P.E.",0
24,"24105",1460,1095,1075,27,20,"P.C.P.E.",3
33,"33002",10837,7667,7588,77,79,"P.C.P.E.",18
46,"46043",149,139,139,0,0,"P.C.P.E.",0
18,"18161",220,180,178,0,2,"P.C.P.E.",0
50,"50143",608,427,424,5,3,"P.C.P.E.",4
3,"3064",4976,4098,4058,26,40,"P.C.P.E.",6
45,"45088",2038,1379,1356,14,23,"P.C.P.E.",5
14,"14015",2198,1776,1755,16,21,"P.C.P.E.",6
26,"26069",276,211,208,5,3,"P.C.P.E.",1
45,"45013",1870,1504,1486,5,18,"P.C.P.E.",0
3,"3030",522,464,453,6,11,"P.C.P.E.",1
46,"46116",12587,9821,9724,120,97,"P.C.P.E.",8
45,"45186",3217,2573,2527,24,46,"P.C.P.E.",3
47,"47071",406,333,329,6,4,"P.C.P.E.",1
50,"50017",1734,1232,1212,41,20,"P.C.P.E.",2
50,"50283",73,55,55,1,0,"P.C.P.E.",0
47,"47133",2382,1861,1841,30,20,"P.C.P.E.",1
50,"50144",36,32,32,0,0,"P.C.P.E.",0
22,"22015",336,237,235,11,2,"P.C.P.E.",0
22,"22209",161,115,115,4,0,"P.C.P.E.",0
41,"41029",13231,9756,9610,128,146,"P.C.P.E.",6
11,"11017",3219,2403,2388,18,15,"P.C.P.E.",0
26,"26169",83,73,72,0,1,"P.C.P.E.",0
3,"3072",331,284,277,2,7,"P.C.P.E.",1
30,"30017",11683,9332,9233,95,99,"P.C.P.E.",17
18,"18107",988,769,760,3,9,"P.C.P.E.",1
3,"3084",593,518,513,2,5,"P.C.P.E.",0
35,"35034",6372,2951,2921,33,30,"P.C.P.E.",7
14,"14016",1406,1123,1115,9,8,"P.C.P.E.",0
24,"24056",3200,2368,2332,53,36,"P.C.P.E.",0
26,"26161",9,8,8,0,0,"P.C.P.E.",0
41,"41030",527,436,429,6,7,"P.C.P.E.",0
47,"47009",117,88,88,1,0,"P.C.P.E.",1
47,"47159",862,704,695,20,9,"P.C.P.E.",2
46,"46059",1310,1076,1058,2,18,"P.C.P.E.",0
18,"18132",3461,2797,2772,19,25,"P.C.P.E.",4
26,"26131",44,36,36,0,0,"P.C.P.E.",0
47,"47130",105,86,85,2,1,"P.C.P.E.",0
46,"46248",4847,3655,3597,25,58,"P.C.P.E.",3
13,"13066",2444,2094,2065,15,29,"P.C.P.E.",1
41,"41031",1319,879,875,6,4,"P.C.P.E.",2
50,"50067",14124,10049,9870,203,179,"P.C.P.E.",24
3,"3056",8929,6927,6776,74,151,"P.C.P.E.",11
47,"47048",204,168,167,2,1,"P.C.P.E.",0
2,"2076",371,292,287,3,5,"P.C.P.E.",0
13,"13044",2747,1996,1950,20,46,"P.C.P.E.",1
14,"14018",3795,3004,2970,24,34,"P.C.P.E.",7
47,"47112",2671,2231,2198,28,33,"P.C.P.E.",1
3,"3001",359,296,292,2,4,"P.C.P.E.",1
24,"24177",477,325,319,3,6,"P.C.P.E.",2
29,"29058",1560,1103,1096,5,7,"P.C.P.E.",2
18,"18185",608,484,479,2,5,"P.C.P.E.",1
11,"11038",13815,10849,10756,126,93,"P.C.P.E.",23
41,"41032",4059,3122,3062,22,60,"P.C.P.E.",1
24,"24003",725,528,520,8,8,"P.C.P.E.",0
46,"46120",1133,889,870,2,19,"P.C.P.E.",0
3,"3068",48,45,45,1,0,"P.C.P.E.",0
22,"22905",312,249,247,4,2,"P.C.P.E.",2
36,"36035",14551,10675,10469,160,206,"P.C.P.E.",13
24,"24141",101,83,80,6,3,"P.C.P.E.",0
26,"26158",296,238,237,7,1,"P.C.P.E.",0
50,"50115",3280,2234,2205,32,29,"P.C.P.E.",2
47,"47176",229,157,157,0,0,"P.C.P.E.",0
50,"50079",281,213,210,2,3,"P.C.P.E.",1
50,"50259",89,53,53,1,0,"P.C.P.E.",0
14,"14041",3215,2492,2439,45,53,"P.C.P.E.",27
2,"2006",612,540,534,1,6,"P.C.P.E.",0
24,"24074",107,87,87,0,0,"P.C.P.E.",0
29,"29013",1718,1302,1283,4,19,"P.C.P.E.",2
30,"30021",8550,6423,6349,44,74,"P.C.P.E.",12
35,"35010",3565,2178,2135,26,43,"P.C.P.E.",3
36,"36018",3492,2516,2494,25,22,"P.C.P.E.",3
2,"2002",479,411,407,3,4,"P.C.P.E.",0
30,"30039",18615,14213,14068,134,145,"P.C.P.E.",28
18,"18168",864,613,605,4,8,"P.C.P.E.",0
45,"45194",57,41,41,0,0,"P.C.P.E.",0
39,"39036",1023,802,790,5,12,"P.C.P.E.",2
26,"26152",38,31,31,0,0,"P.C.P.E.",0
39,"39088",70,61,61,1,0,"P.C.P.E.",0
18,"18079",3497,2729,2706,15,23,"P.C.P.E.",16
24,"24114",3441,2322,2304,42,18,"P.C.P.E.",8
22,"22114",137,94,94,4,0,"P.C.P.E.",1
18,"18035",1254,991,982,7,9,"P.C.P.E.",0
47,"47050",3557,2688,2651,50,37,"P.C.P.E.",6
46,"46146",1718,1395,1374,10,21,"P.C.P.E.",1
13,"13071",41043,28435,28183,370,252,"P.C.P.E.",60
29,"29043",2596,1670,1647,24,23,"P.C.P.E.",3
50,"50207",126,97,95,1,2,"P.C.P.E.",0
29,"29052",245,151,151,0,0,"P.C.P.E.",0
45,"45133",2803,2241,2199,18,42,"P.C.P.E.",1
22,"22066",699,479,464,8,15,"P.C.P.E.",4
36,"36002",3154,2381,2358,35,23,"P.C.P.E.",3
50,"50033",81,64,64,0,0,"P.C.P.E.",0
15,"15008",5657,4224,4157,62,67,"P.C.P.E.",4
45,"45170",257,186,183,0,3,"P.C.P.E.",0
18,"18082",912,691,683,8,8,"P.C.P.E.",1
26,"26079",690,568,562,5,6,"P.C.P.E.",0
33,"33015",1695,1177,1161,12,16,"P.C.P.E.",3
29,"29098",1312,1043,1036,22,7,"P.C.P.E.",7
26,"26153",12,9,8,0,1,"P.C.P.E.",0
24,"24213",162,134,133,1,1,"P.C.P.E.",0
29,"29099",958,739,730,5,9,"P.C.P.E.",0
50,"50162",160,108,108,2,0,"P.C.P.E.",0
13,"13006",641,529,519,4,10,"P.C.P.E.",0
47,"47207",325,265,263,4,2,"P.C.P.E.",0
22,"22117",2585,1880,1848,57,32,"P.C.P.E.",1
50,"50081",562,410,400,7,10,"P.C.P.E.",0
18,"18037",488,408,404,0,4,"P.C.P.E.",0
29,"29041",2796,1950,1921,24,29,"P.C.P.E.",3
18,"18066",2072,1558,1552,8,6,"P.C.P.E.",1
46,"46189",490,400,396,3,4,"P.C.P.E.",3
41,"41094",6089,4757,4680,47,77,"P.C.P.E.",5
2,"2023",636,534,533,6,1,"P.C.P.E.",3
14,"14004",2016,1560,1543,8,17,"P.C.P.E.",0
29,"29007",25572,17726,17564,227,162,"P.C.P.E.",12
24,"24093",388,262,258,1,4,"P.C.P.E.",0
3,"3041",5811,4325,4269,33,56,"P.C.P.E.",5
46,"46100",307,264,255,0,9,"P.C.P.E.",0
45,"45025",1237,919,907,11,12,"P.C.P.E.",1
24,"24149",149,120,118,3,2,"P.C.P.E.",1
26,"26171",212,171,170,6,1,"P.C.P.E.",1
35,"35015",9065,4859,4770,64,89,"P.C.P.E.",9
46,"46251",2599,2215,2179,21,36,"P.C.P.E.",1
35,"35014",9943,5438,5316,95,122,"P.C.P.E.",15
47,"47171",453,371,368,10,3,"P.C.P.E.",1
50,"50064",469,377,373,5,4,"P.C.P.E.",2
18,"18117",535,444,440,2,4,"P.C.P.E.",1
26,"26127",236,206,204,1,2,"P.C.P.E.",0
3,"3042",1337,1028,1019,8,9,"P.C.P.E.",1
39,"39005",1319,1048,1026,3,22,"P.C.P.E.",0
3,"3088",5381,4056,3988,47,68,"P.C.P.E.",6
29,"29065",207,151,149,1,2,"P.C.P.E.",0
50,"50165",1880,1339,1274,49,65,"P.C.P.E.",5
47,"47164",391,326,320,3,6,"P.C.P.E.",0
24,"24901",994,698,686,8,12,"P.C.P.E.",3
2,"2025",7496,6153,5985,69,168,"P.C.P.E.",5
15,"15039",1374,1027,998,27,29,"P.C.P.E.",0
26,"26044",60,48,46,1,2,"P.C.P.E.",0
50,"50154",129,98,97,1,1,"P.C.P.E.",0
50,"50212",52,48,48,0,0,"P.C.P.E.",0
33,"33064",237,175,173,1,2,"P.C.P.E.",0
22,"22176",173,154,149,2,5,"P.C.P.E.",0
41,"41073",1789,1292,1272,5,20,"P.C.P.E.",3
18,"18909",668,536,534,2,2,"P.C.P.E.",0
50,"50241",634,462,455,2,7,"P.C.P.E.",1
2,"2050",121,95,95,1,0,"P.C.P.E.",0
45,"45147",598,484,478,9,6,"P.C.P.E.",1
45,"45086",491,406,399,3,7,"P.C.P.E.",0
39,"39041",1775,1432,1414,15,18,"P.C.P.E.",2
41,"41097",3096,2489,2451,21,38,"P.C.P.E.",0
35,"35025",1941,1345,1328,12,17,"P.C.P.E.",4
11,"11009",636,430,424,2,6,"P.C.P.E.",0
50,"50136",617,469,462,4,7,"P.C.P.E.",0
46,"46062",4589,3794,3752,46,42,"P.C.P.E.",1
29,"29011",3013,1893,1876,7,17,"P.C.P.E.",5
22,"22003",148,117,116,2,1,"P.C.P.E.",1
47,"47140",132,109,108,1,1,"P.C.P.E.",0
18,"18143",949,722,704,2,18,"P.C.P.E.",9
45,"45055",1052,886,870,10,16,"P.C.P.E.",1
41,"41013",4762,3359,3327,9,32,"P.C.P.E.",3
29,"29020",3188,2448,2424,30,24,"P.C.P.E.",2
39,"39050",305,207,205,1,2,"P.C.P.E.",0
39,"39024",2065,1616,1601,8,15,"P.C.P.E.",5
50,"50010",77,65,64,5,1,"P.C.P.E.",0
26,"26132",130,98,96,2,2,"P.C.P.E.",0
46,"46047",551,479,469,10,10,"P.C.P.E.",0
24,"24221",850,635,619,6,16,"P.C.P.E.",0
26,"26164",70,42,42,1,0,"P.C.P.E.",0
24,"24099",199,164,162,0,2,"P.C.P.E.",0
47,"47203",69,57,56,0,1,"P.C.P.E.",0
45,"45068",164,135,133,1,2,"P.C.P.E.",1
3,"3079",18028,14580,14317,189,263,"P.C.P.E.",102
26,"26007",551,434,422,3,12,"P.C.P.E.",0
45,"45179",608,476,471,3,5,"P.C.P.E.",0
22,"22230",302,234,231,11,3,"P.C.P.E.",1
13,"13057",1214,1018,998,9,20,"P.C.P.E.",0
22,"22063",184,142,140,2,2,"P.C.P.E.",0
47,"47141",148,121,119,1,2,"P.C.P.E.",1
26,"26178",88,74,73,1,1,"P.C.P.E.",0
18,"18187",587,432,432,0,0,"P.C.P.E.",1
2,"2042",897,712,709,6,3,"P.C.P.E.",0
47,"47023",2863,2278,2258,38,20,"P.C.P.E.",0
50,"50225",1638,1079,1062,7,17,"P.C.P.E.",1
22,"22249",110,83,81,0,2,"P.C.P.E.",0
45,"45020",1396,1165,1151,15,14,"P.C.P.E.",4
46,"46007",11576,8929,8848,71,81,"P.C.P.E.",7
41,"41091",545464,388043,383816,5325,4227,"P.C.P.E.",317
50,"50235",2371,1723,1701,36,22,"P.C.P.E.",1
50,"50060",187,138,136,1,2,"P.C.P.E.",0
39,"39052",17031,13198,13034,187,164,"P.C.P.E.",15
15,"15025",1173,780,777,10,3,"P.C.P.E.",0
33,"33029",420,243,241,3,2,"P.C.P.E.",0
45,"45156",3528,2985,2924,19,61,"P.C.P.E.",2
22,"22096",301,239,237,8,2,"P.C.P.E.",1
2,"2043",1335,1120,1108,10,12,"P.C.P.E.",3
45,"45083",421,353,345,0,8,"P.C.P.E.",0
39,"39035",10031,7685,7601,74,84,"P.C.P.E.",2
2,"2007",1139,923,916,0,7,"P.C.P.E.",5
36,"36037",2727,1923,1896,18,27,"P.C.P.E.",2
24,"24143",515,376,373,6,3,"P.C.P.E.",0
29,"29097",4076,3060,3018,40,42,"P.C.P.E.",4
50,"50901",170,122,121,1,1,"P.C.P.E.",0
33,"33014",9318,6380,6320,66,60,"P.C.P.E.",55
2,"2081",18319,14324,14096,225,228,"P.C.P.E.",10
3,"3105",5322,4218,4124,34,94,"P.C.P.E.",7
41,"41051",2103,1705,1686,7,19,"P.C.P.E.",1
26,"26051",271,219,214,4,5,"P.C.P.E.",0
22,"22187",295,222,222,3,0,"P.C.P.E.",1
26,"26094",97,86,85,0,1,"P.C.P.E.",0
50,"50274",78,45,45,1,0,"P.C.P.E.",0
45,"45109",3030,2507,2417,30,90,"P.C.P.E.",2
15,"15045",4178,2743,2727,22,16,"P.C.P.E.",2
24,"24116",451,297,294,5,3,"P.C.P.E.",0
11,"11005",4617,3287,3214,26,73,"P.C.P.E.",1
15,"15017",18860,12975,12737,325,238,"P.C.P.E.",31
18,"18158",10328,7336,7254,69,82,"P.C.P.E.",12
46,"46228",2434,1881,1859,30,22,"P.C.P.E.",1
3,"3039",92,70,66,1,4,"P.C.P.E.",0
13,"13028",10536,8503,8331,140,172,"P.C.P.E.",7
45,"45171",1359,1114,1093,13,21,"P.C.P.E.",3
26,"26125",2720,2121,2084,26,37,"P.C.P.E.",0
39,"39055",1130,881,869,10,12,"P.C.P.E.",1
45,"45074",428,349,343,3,6,"P.C.P.E.",2
15,"15074",4254,3246,3219,35,27,"P.C.P.E.",3
29,"29006",721,516,508,5,8,"P.C.P.E.",0
14,"14064",352,265,261,3,4,"P.C.P.E.",0
2,"2046",1165,954,941,16,13,"P.C.P.E.",1
24,"24227",1664,1159,1148,16,11,"P.C.P.E.",1
45,"45136",5891,4414,4368,55,46,"P.C.P.E.",6
29,"29026",1130,815,799,7,16,"P.C.P.E.",1
26,"26126",32,31,31,1,0,"P.C.P.E.",0
47,"47225",89,67,66,0,1,"P.C.P.E.",0
18,"18140",42971,28391,28126,335,265,"P.C.P.E.",28
22,"22025",1104,790,767,27,23,"P.C.P.E.",1
33,"33024",229816,164603,163179,2100,1424,"P.C.P.E.",275
24,"24001",241,148,147,3,1,"P.C.P.E.",1
36,"36052",7517,5563,5461,54,102,"P.C.P.E.",10
22,"22242",75,53,52,0,1,"P.C.P.E.",0
46,"46132",2124,1845,1817,14,28,"P.C.P.E.",2
41,"41028",1880,1479,1458,28,21,"P.C.P.E.",1
33,"33047",1178,939,931,2,8,"P.C.P.E.",0
45,"45002",2500,1771,1756,26,15,"P.C.P.E.",2
3,"3121",20518,14464,14315,137,149,"P.C.P.E.",17
38,"38026",32174,24822,24431,283,391,"P.C.P.E.",22
46,"46230",14204,10650,10515,112,135,"P.C.P.E.",9
3,"3086",145,119,118,1,1,"P.C.P.E.",0
15,"15076",2766,1971,1936,18,35,"P.C.P.E.",3
41,"41046",3055,2456,2418,23,38,"P.C.P.E.",1
3,"3020",108,87,86,1,1,"P.C.P.E.",0
22,"22137",1164,850,839,14,11,"P.C.P.E.",2
46,"46190",48324,34747,34424,431,323,"P.C.P.E.",71
26,"26144",196,163,162,2,1,"P.C.P.E.",0
47,"47138",259,198,195,3,3,"P.C.P.E.",0
33,"33048",169,120,120,1,0,"P.C.P.E.",0
47,"47209",43,33,33,0,0,"P.C.P.E.",0
22,"22001",242,177,173,2,4,"P.C.P.E.",0
15,"15077",8677,6349,6269,82,80,"P.C.P.E.",4
26,"26057",52,42,42,0,0,"P.C.P.E.",0
14,"14067",3821,3105,3082,38,23,"P.C.P.E.",2
45,"45113",2094,1589,1555,6,34,"P.C.P.E.",0
18,"18029",1892,1355,1347,6,8,"P.C.P.E.",1
26,"26100",59,51,51,1,0,"P.C.P.E.",1
47,"47055",212,169,168,3,1,"P.C.P.E.",0
26,"26174",154,122,122,2,0,"P.C.P.E.",0
46,"46142",870,682,673,7,9,"P.C.P.E.",0
45,"45201",3439,2353,2317,31,36,"P.C.P.E.",7
18,"18032",248,166,166,2,0,"P.C.P.E.",0
50,"50047",60,34,34,2,0,"P.C.P.E.",0
22,"22046",784,618,599,15,19,"P.C.P.E.",4
2,"2039",1050,862,848,16,14,"P.C.P.E.",0
26,"26031",120,100,100,0,0,"P.C.P.E.",0
15,"15059",10658,7889,7728,125,161,"P.C.P.E.",6
50,"50037",140,110,103,3,7,"P.C.P.E.",0
46,"46200",1915,1625,1595,15,30,"P.C.P.E.",4
39,"39007",479,348,347,3,1,"P.C.P.E.",2
33,"33019",3262,2283,2244,12,39,"P.C.P.E.",5
33,"33042",4434,3172,3135,43,37,"P.C.P.E.",3
50,"50126",2473,1747,1724,41,23,"P.C.P.E.",1
47,"47074",155,125,124,0,1,"P.C.P.E.",0
2,"2064",413,350,348,7,2,"P.C.P.E.",0
46,"46086",80,71,71,3,0,"P.C.P.E.",0
38,"38029",1456,732,715,4,17,"P.C.P.E.",2
46,"46159",23111,17258,17086,141,172,"P.C.P.E.",21
24,"24005",437,308,305,3,3,"P.C.P.E.",0
26,"26060",100,71,71,3,0,"P.C.P.E.",1
26,"26006",1853,1456,1430,15,26,"P.C.P.E.",3
14,"14058",8116,6274,6215,76,59,"P.C.P.E.",12
36,"36046",4093,3175,3120,31,55,"P.C.P.E.",2
36,"36012",3839,2884,2825,14,59,"P.C.P.E.",5
13,"13012",475,322,318,1,4,"P.C.P.E.",0
46,"46039",2200,1849,1820,12,29,"P.C.P.E.",0
14,"14039",2705,2204,2189,12,15,"P.C.P.E.",3
24,"24209",3016,2006,1984,20,22,"P.C.P.E.",0
14,"14009",2864,2021,2003,8,18,"P.C.P.E.",3
3,"3125",340,276,275,2,1,"P.C.P.E.",0
2,"2077",51,46,45,0,1,"P.C.P.E.",0
15,"15033",2581,2094,2079,15,15,"P.C.P.E.",0
2,"2017",895,685,682,4,3,"P.C.P.E.",3
13,"13024",938,703,699,3,4,"P.C.P.E.",1
14,"14060",4843,3857,3787,47,70,"P.C.P.E.",14
13,"13047",5822,4735,4650,52,85,"P.C.P.E.",5
13,"13069",704,605,590,2,15,"P.C.P.E.",0
47,"47150",338,273,271,2,2,"P.C.P.E.",0
39,"39096",719,521,518,4,3,"P.C.P.E.",1
39,"39026",1825,1383,1371,12,12,"P.C.P.E.",1
14,"14070",1385,1131,1111,4,20,"P.C.P.E.",0
14,"14040",3821,2986,2949,40,37,"P.C.P.E.",7
18,"18034",510,377,375,2,2,"P.C.P.E.",0
18,"18053",1836,1345,1340,11,5,"P.C.P.E.",1
50,"50254",179,136,136,0,0,"P.C.P.E.",1
14,"14061",841,700,693,3,7,"P.C.P.E.",0
50,"50170",411,316,313,2,3,"P.C.P.E.",0
24,"24129",125,88,86,5,2,"P.C.P.E.",1
15,"15081",1139,869,853,9,16,"P.C.P.E.",1
22,"22150",491,342,336,9,6,"P.C.P.E.",2
46,"46049",292,249,245,0,4,"P.C.P.E.",0
18,"18112",132,90,90,1,0,"P.C.P.E.",0
47,"47222",92,77,77,4,0,"P.C.P.E.",0
47,"47077",291,232,232,1,0,"P.C.P.E.",1
22,"22250",368,261,255,12,6,"P.C.P.E.",0
41,"41086",15877,10246,10150,146,96,"P.C.P.E.",10
47,"47086",4062,3162,3120,37,42,"P.C.P.E.",5
3,"3140",26223,19998,19552,338,446,"P.C.P.E.",36
15,"15091",1171,839,829,9,10,"P.C.P.E.",1
50,"50217",496,380,379,0,1,"P.C.P.E.",0
3,"3027",150,131,130,1,1,"P.C.P.E.",0
13,"13015",5755,4334,4293,40,41,"P.C.P.E.",9
3,"3095",4498,3558,3517,29,41,"P.C.P.E.",4
41,"41060",15176,10797,10693,114,104,"P.C.P.E.",14
46,"46236",996,853,844,7,9,"P.C.P.E.",4
30,"30040",733,640,635,2,5,"P.C.P.E.",0
3,"3061",1052,842,836,6,6,"P.C.P.E.",2
18,"18906",955,736,731,5,5,"P.C.P.E.",0
14,"14073",3009,2246,2224,32,22,"P.C.P.E.",3
45,"45048",388,310,308,2,2,"P.C.P.E.",0
47,"47052",6207,4812,4761,79,51,"P.C.P.E.",2
38,"38034",4092,3034,2983,30,51,"P.C.P.E.",4
45,"45049",394,315,315,6,0,"P.C.P.E.",0
50,"50053",756,570,563,14,7,"P.C.P.E.",0
18,"18148",874,714,706,6,8,"P.C.P.E.",0
47,"47232",107,77,75,1,2,"P.C.P.E.",0
26,"26096",244,204,201,2,3,"P.C.P.E.",0
47,"47134",186,155,149,2,6,"P.C.P.E.",1
33,"33077",1351,938,931,7,7,"P.C.P.E.",0
14,"14014",2610,2160,2125,19,35,"P.C.P.E.",2
47,"47027",2680,2059,2024,23,35,"P.C.P.E.",4
46,"46091",126,108,108,0,0,"P.C.P.E.",0
47,"47153",135,94,93,1,1,"P.C.P.E.",0
39,"39029",642,521,517,6,4,"P.C.P.E.",0
18,"18057",5045,3755,3721,44,34,"P.C.P.E.",3
2,"2071",1053,899,895,5,4,"P.C.P.E.",0
46,"46156",2065,1746,1721,14,25,"P.C.P.E.",2
22,"22239",90,76,76,2,0,"P.C.P.E.",0
18,"18149",5096,3949,3900,36,49,"P.C.P.E.",1
47,"47216",124,99,98,2,1,"P.C.P.E.",0
2,"2011",730,612,610,3,2,"P.C.P.E.",1
35,"35005",1170,864,853,7,11,"P.C.P.E.",2
45,"45051",1658,1305,1293,20,12,"P.C.P.E.",2
3,"3031",39966,27099,26802,291,297,"P.C.P.E.",64
33,"33009",951,673,663,7,10,"P.C.P.E.",0
3,"3133",40056,25746,25554,231,192,"P.C.P.E.",56
50,"50258",54,37,37,0,0,"P.C.P.E.",0
29,"29091",8777,6226,6126,64,100,"P.C.P.E.",2
45,"45124",2183,1868,1823,20,45,"P.C.P.E.",0
45,"45087",8428,6434,6292,74,142,"P.C.P.E.",4
18,"18070",287,240,239,2,1,"P.C.P.E.",0
50,"50083",96,72,72,1,0,"P.C.P.E.",0
50,"50104",379,306,303,4,3,"P.C.P.E.",0
18,"18194",2258,1656,1652,11,4,"P.C.P.E.",0
39,"39014",943,706,700,9,6,"P.C.P.E.",0
41,"41003",2196,1803,1782,21,21,"P.C.P.E.",0
30,"30043",24501,19738,19416,230,322,"P.C.P.E.",38
33,"33071",671,528,523,4,5,"P.C.P.E.",0
46,"46093",2082,1722,1716,9,6,"P.C.P.E.",0
38,"38038",161890,99555,97980,1101,1575,"P.C.P.E.",239
29,"29018",2088,1565,1540,9,25,"P.C.P.E.",1
2,"2049",937,717,708,2,9,"P.C.P.E.",0
39,"39066",895,710,703,6,7,"P.C.P.E.",0
29,"29092",596,457,454,10,3,"P.C.P.E.",0
3,"3134",159,129,126,0,3,"P.C.P.E.",0
41,"41012",3115,2314,2271,29,43,"P.C.P.E.",2
38,"38005",5327,3316,3270,38,46,"P.C.P.E.",7
38,"38049",2794,1721,1694,12,27,"P.C.P.E.",2
46,"46069",166,149,148,1,1,"P.C.P.E.",0
35,"35016",291589,181013,177964,2856,3049,"P.C.P.E.",678
22,"22075",150,103,101,7,2,"P.C.P.E.",1
45,"45152",653,503,497,2,6,"P.C.P.E.",0
35,"35026",78933,49860,48955,780,905,"P.C.P.E.",151
24,"24219",580,435,431,10,4,"P.C.P.E.",1
45,"45164",191,160,158,0,2,"P.C.P.E.",0
33,"33072",1737,1171,1159,11,12,"P.C.P.E.",2
39,"39076",3388,2673,2641,22,32,"P.C.P.E.",5
14,"14037",3500,2662,2616,29,46,"P.C.P.E.",2
46,"46208",1141,990,978,6,12,"P.C.P.E.",3
47,"47013",118,97,97,2,0,"P.C.P.E.",0
24,"24122",1424,1001,992,9,9,"P.C.P.E.",3
3,"3023",1425,1259,1233,11,26,"P.C.P.E.",3
46,"46232",920,730,722,6,8,"P.C.P.E.",1
26,"26073",100,85,84,1,1,"P.C.P.E.",0
13,"13043",251,208,206,1,2,"P.C.P.E.",1
38,"38040",4697,3007,2962,31,45,"P.C.P.E.",4
45,"45202",3876,3037,2984,13,53,"P.C.P.E.",7
2,"2015",1508,1230,1211,7,19,"P.C.P.E.",3
26,"26033",183,157,156,2,1,"P.C.P.E.",0
50,"50086",193,109,109,0,0,"P.C.P.E.",1
29,"29094",54317,36540,36174,410,366,"P.C.P.E.",39
13,"13089",1906,1610,1553,12,57,"P.C.P.E.",1
26,"26104",18,16,16,0,0,"P.C.P.E.",0
33,"33005",1600,1084,1080,6,4,"P.C.P.E.",3
3,"3035",672,560,550,0,10,"P.C.P.E.",1
41,"41040",9567,7305,7210,93,95,"P.C.P.E.",3
13,"13056",10945,8173,8070,111,103,"P.C.P.E.",25
3,"3002",3559,2747,2707,16,40,"P.C.P.E.",2
29,"29049",3137,2365,2352,19,13,"P.C.P.E.",2
18,"18176",265,183,181,0,2,"P.C.P.E.",1
26,"26074",128,102,101,0,1,"P.C.P.E.",0
14,"14019",6486,5288,5243,65,45,"P.C.P.E.",3
36,"36047",2723,1875,1853,27,22,"P.C.P.E.",1
46,"46104",2012,1691,1676,9,15,"P.C.P.E.",7
3,"3138",3218,2403,2388,22,15,"P.C.P.E.",3
41,"41059",31676,23199,22889,330,310,"P.C.P.E.",37
46,"46088",196,146,140,0,6,"P.C.P.E.",0
50,"50197",89,65,65,3,0,"P.C.P.E.",3
13,"13003",503,390,387,2,3,"P.C.P.E.",0
2,"2078",967,770,756,9,14,"P.C.P.E.",1
47,"47193",1538,1229,1211,23,18,"P.C.P.E.",3
45,"45167",1552,1296,1278,14,18,"P.C.P.E.",0
47,"47113",166,136,135,1,1,"P.C.P.E.",0
41,"41085",3918,3173,3128,42,45,"P.C.P.E.",2
50,"50291",112,75,73,0,2,"P.C.P.E.",0
41,"41100",1097,894,878,8,16,"P.C.P.E.",2
18,"18135",4752,3252,3212,34,40,"P.C.P.E.",3
46,"46016",1097,927,917,12,10,"P.C.P.E.",0
13,"13081",684,553,527,1,26,"P.C.P.E.",1
26,"26136",111,90,90,3,0,"P.C.P.E.",1
24,"24009",362,188,184,0,4,"P.C.P.E.",0
18,"18054",879,646,644,4,2,"P.C.P.E.",1
39,"39053",251,179,179,1,0,"P.C.P.E.",0
41,"41069",28331,21065,20877,252,188,"P.C.P.E.",29
2,"2019",2455,2107,2077,16,30,"P.C.P.E.",0
50,"50150",716,430,427,10,3,"P.C.P.E.",0
18,"18101",8990,6659,6556,96,103,"P.C.P.E.",9
29,"29088",2784,2019,1975,14,44,"P.C.P.E.",0
3,"3129",1188,936,918,10,18,"P.C.P.E.",2
36,"36060",30264,21398,21051,344,347,"P.C.P.E.",18
45,"45108",564,461,456,2,5,"P.C.P.E.",0
47,"47114",4107,2877,2834,37,43,"P.C.P.E.",4
29,"29051",37991,24498,24095,381,403,"P.C.P.E.",55
47,"47195",449,350,346,5,4,"P.C.P.E.",0
26,"26078",85,69,69,0,0,"P.C.P.E.",0
39,"39071",463,358,358,2,0,"P.C.P.E.",0
50,"50151",713,536,531,5,5,"P.C.P.E.",1
39,"39019",2009,1556,1536,10,20,"P.C.P.E.",1
24,"24226",223,154,153,1,1,"P.C.P.E.",0
47,"47034",90,65,63,0,2,"P.C.P.E.",0
47,"47143",146,108,107,0,1,"P.C.P.E.",0
45,"45097",1094,934,925,9,9,"P.C.P.E.",0
3,"3106",642,542,535,3,7,"P.C.P.E.",0
38,"38012",2535,1735,1716,11,19,"P.C.P.E.",1
39,"39063",1018,769,762,6,7,"P.C.P.E.",0
50,"50228",295,238,236,10,2,"P.C.P.E.",1
36,"36006",11387,8911,8727,72,184,"P.C.P.E.",7
14,"14023",2084,1809,1787,13,22,"P.C.P.E.",1
15,"15037",4181,2839,2804,25,35,"P.C.P.E.",2
45,"45098",2273,1799,1756,11,43,"P.C.P.E.",3
30,"30023",3572,2859,2811,22,48,"P.C.P.E.",4
50,"50181",1053,787,760,9,27,"P.C.P.E.",0
15,"15083",1198,874,855,8,19,"P.C.P.E.",1
13,"13017",307,230,226,0,4,"P.C.P.E.",0
22,"22054",1602,1040,982,42,58,"P.C.P.E.",7
29,"29090",1805,1265,1260,5,5,"P.C.P.E.",4
46,"46027",997,869,855,4,14,"P.C.P.E.",0
50,"50091",56,39,39,1,0,"P.C.P.E.",0
50,"50219",3704,2672,2625,39,47,"P.C.P.E.",4
26,"26170",471,353,348,4,5,"P.C.P.E.",0
2,"2059",336,262,258,3,4,"P.C.P.E.",0
3,"3008",176,142,140,1,2,"P.C.P.E.",0
46,"46051",8122,6432,6378,57,54,"P.C.P.E.",4
45,"45172",757,597,594,7,3,"P.C.P.E.",0
26,"26041",152,106,104,0,2,"P.C.P.E.",0
46,"46173",1393,1156,1137,10,19,"P.C.P.E.",0
33,"33062",452,282,281,3,1,"P.C.P.E.",0
33,"33040",4702,3285,3236,44,49,"P.C.P.E.",6
15,"15010",2009,1468,1441,24,27,"P.C.P.E.",0
22,"22027",351,251,250,8,1,"P.C.P.E.",0
26,"26083",303,234,234,1,0,"P.C.P.E.",1
22,"22072",209,130,128,2,2,"P.C.P.E.",0
24,"24028",426,350,331,3,19,"P.C.P.E.",1
39,"39048",1616,1326,1308,8,18,"P.C.P.E.",3
14,"14056",23507,17245,17071,259,174,"P.C.P.E.",26
24,"24229",473,348,344,8,4,"P.C.P.E.",1
41,"41090",3488,2792,2751,22,41,"P.C.P.E.",0
22,"22195",231,193,189,6,4,"P.C.P.E.",0
45,"45200",4633,3768,3672,37,96,"P.C.P.E.",5
29,"29902",2577,1689,1665,20,24,"P.C.P.E.",0
24,"24150",262,182,182,3,0,"P.C.P.E.",0
36,"36042",17897,12635,12437,157,198,"P.C.P.E.",14
46,"46004",1933,1563,1541,8,22,"P.C.P.E.",3
50,"50093",113,84,84,2,0,"P.C.P.E.",0
38,"38016",1250,664,646,3,18,"P.C.P.E.",0
18,"18183",685,502,500,3,2,"P.C.P.E.",0
29,"29073",1520,1032,1021,10,11,"P.C.P.E.",3
13,"13098",2265,1805,1759,19,46,"P.C.P.E.",4
3,"3021",5594,4630,4517,46,113,"P.C.P.E.",8
22,"22107",131,81,77,1,4,"P.C.P.E.",0
24,"24217",144,108,107,2,1,"P.C.P.E.",0
47,"47110",471,386,378,6,8,"P.C.P.E.",0
47,"47003",263,224,222,1,2,"P.C.P.E.",0
22,"22199",7259,4980,4861,128,119,"P.C.P.E.",12
45,"45078",1451,1243,1228,7,15,"P.C.P.E.",0
11,"11019",1871,1449,1425,9,24,"P.C.P.E.",2
18,"18062",9418,6916,6835,62,81,"P.C.P.E.",12
39,"39015",898,692,688,7,4,"P.C.P.E.",1
22,"22213",3152,2265,2230,62,35,"P.C.P.E.",8
2,"2003",129078,98135,97009,1430,1126,"P.C.P.E.",185
46,"46175",469,406,401,5,5,"P.C.P.E.",1
36,"36011",1939,1189,1172,15,17,"P.C.P.E.",2
50,"50204",2519,1823,1804,24,19,"P.C.P.E.",4
22,"22032",120,78,73,5,5,"P.C.P.E.",1
18,"18175",11534,8772,8698,68,74,"P.C.P.E.",15
46,"46127",2790,2298,2267,23,31,"P.C.P.E.",2
47,"47149",44,22,20,0,2,"P.C.P.E.",0
3,"3113",4154,3295,3251,24,44,"P.C.P.E.",6
22,"22077",421,327,323,14,4,"P.C.P.E.",1
13,"13902",497,396,394,3,2,"P.C.P.E.",2
50,"50095",12558,9029,8910,179,119,"P.C.P.E.",11
45,"45104",457,375,370,2,5,"P.C.P.E.",0
18,"18012",2693,1841,1831,11,10,"P.C.P.E.",191
2,"2016",600,471,468,5,3,"P.C.P.E.",2
22,"22035",261,179,176,3,3,"P.C.P.E.",0
14,"14059",713,572,567,5,5,"P.C.P.E.",2
14,"14029",4380,3344,3308,35,36,"P.C.P.E.",6
26,"26047",2076,1702,1682,17,20,"P.C.P.E.",1
46,"46079",381,304,299,3,5,"P.C.P.E.",0
46,"46152",96,70,70,0,0,"P.C.P.E.",0
39,"39051",73,62,62,2,0,"P.C.P.E.",0
45,"45057",222,197,189,0,8,"P.C.P.E.",2
18,"18122",16253,12271,12109,132,162,"P.C.P.E.",16
46,"46023",318,275,267,2,8,"P.C.P.E.",1
24,"24113",404,318,310,3,8,"P.C.P.E.",1
47,"47067",198,159,156,5,3,"P.C.P.E.",0
41,"41006",2743,1972,1957,13,15,"P.C.P.E.",1
50,"50159",728,554,544,4,10,"P.C.P.E.",0
24,"24008",9789,7277,7179,110,98,"P.C.P.E.",11
22,"22167",515,417,399,16,18,"P.C.P.E.",0
47,"47015",229,172,170,1,2,"P.C.P.E.",0
50,"50215",21,20,19,0,1,"P.C.P.E.",0
26,"26165",350,297,294,1,3,"P.C.P.E.",2
26,"26049",189,141,137,1,4,"P.C.P.E.",0
3,"3116",1167,912,904,12,8,"P.C.P.E.",11
45,"45143",1302,916,901,6,15,"P.C.P.E.",0
22,"22203",92,79,79,0,0,"P.C.P.E.",0
2,"2067",1197,938,924,6,14,"P.C.P.E.",11
41,"41034",22561,16014,15840,270,174,"P.C.P.E.",24
39,"39027",3213,2506,2473,21,33,"P.C.P.E.",3
45,"45120",159,125,122,0,3,"P.C.P.E.",0
47,"47186",251279,193705,191693,2746,2012,"P.C.P.E.",225
41,"41025",1999,1502,1476,13,26,"P.C.P.E.",0
47,"47151",32,29,29,0,0,"P.C.P.E.",0
24,"24115",54654,38629,38010,716,619,"P.C.P.E.",61
46,"46219",143,127,126,1,1,"P.C.P.E.",0
14,"14052",9720,6444,6384,58,60,"P.C.P.E.",5
50,"50236",124,103,103,2,0,"P.C.P.E.",0
47,"47033",209,170,168,3,2,"P.C.P.E.",0
15,"15026",2025,1426,1413,17,13,"P.C.P.E.",5
24,"24197",784,570,564,7,6,"P.C.P.E.",5
41,"41077",8817,6520,6375,53,145,"P.C.P.E.",5
45,"45072",690,535,532,7,3,"P.C.P.E.",4
22,"22081",268,197,196,4,1,"P.C.P.E.",2
18,"18024",882,696,688,12,8,"P.C.P.E.",0
13,"13038",1770,1397,1380,8,17,"P.C.P.E.",0
46,"46033",220,183,181,0,2,"P.C.P.E.",0
22,"22082",320,231,229,1,2,"P.C.P.E.",0
50,"50161",124,86,86,1,0,"P.C.P.E.",0
39,"39002",3400,2554,2514,35,40,"P.C.P.E.",2
2,"2069",11624,9091,8907,119,184,"P.C.P.E.",17
47,"47206",111,99,99,0,0,"P.C.P.E.",0
41,"41078",2587,1979,1970,15,9,"P.C.P.E.",2
46,"46002",1166,942,915,7,27,"P.C.P.E.",1
22,"22116",1571,1127,1114,37,13,"P.C.P.E.",2
46,"46010",927,706,699,3,7,"P.C.P.E.",0
46,"46204",6906,5426,5357,62,69,"P.C.P.E.",10
36,"36050",7602,5424,5339,50,85,"P.C.P.E.",10
26,"26140",268,213,207,2,6,"P.C.P.E.",1
50,"50132",697,544,536,11,8,"P.C.P.E.",0
46,"46083",15427,12079,11941,109,138,"P.C.P.E.",11
22,"22135",200,152,147,5,5,"P.C.P.E.",1
47,"47017",205,177,176,1,1,"P.C.P.E.",0
33,"33039",1719,1325,1319,14,6,"P.C.P.E.",2
50,"50006",978,758,749,16,9,"P.C.P.E.",1
41,"41079",9349,7095,7001,71,94,"P.C.P.E.",6
36,"36051",14288,10228,10079,124,149,"P.C.P.E.",14
45,"45135",4437,3621,3550,44,71,"P.C.P.E.",0
3,"3120",2329,1810,1785,16,25,"P.C.P.E.",1
22,"22043",112,72,71,2,1,"P.C.P.E.",0
41,"41080",1289,1010,997,13,13,"P.C.P.E.",0
24,"24201",1123,790,777,14,13,"P.C.P.E.",0
3,"3052",984,837,820,10,17,"P.C.P.E.",1
26,"26098",99,74,73,2,1,"P.C.P.E.",0
47,"47180",96,82,81,0,1,"P.C.P.E.",0
50,"50073",2265,1773,1756,20,17,"P.C.P.E.",3
3,"3085",275,218,215,2,3,"P.C.P.E.",0
22,"22190",120,76,73,4,3,"P.C.P.E.",0
14,"14066",5911,4515,4473,54,42,"P.C.P.E.",8
26,"26143",187,154,151,4,3,"P.C.P.E.",0
18,"18028",992,826,821,4,5,"P.C.P.E.",3
39,"39004",1593,1321,1305,9,16,"P.C.P.E.",1
18,"18095",1916,1428,1306,21,122,"P.C.P.E.",1
41,"41002",1510,1161,1140,4,21,"P.C.P.E.",0
24,"24119",742,524,510,15,14,"P.C.P.E.",1
46,"46109",6143,4731,4637,40,94,"P.C.P.E.",9
46,"46117",476,377,373,6,4,"P.C.P.E.",0
50,"50124",474,375,367,11,8,"P.C.P.E.",2
2,"2037",22380,15942,15724,203,218,"P.C.P.E.",24
13,"13009",1573,1265,1255,6,10,"P.C.P.E.",0
26,"26016",32,27,27,0,0,"P.C.P.E.",0
39,"39031",1227,965,956,4,9,"P.C.P.E.",2
29,"29009",1525,1126,1109,9,17,"P.C.P.E.",0
24,"24121",645,511,502,10,9,"P.C.P.E.",0
18,"18162",947,726,721,8,5,"P.C.P.E.",0
2,"2001",731,601,584,6,17,"P.C.P.E.",0
50,"50221",38,20,20,0,0,"P.C.P.E.",0
45,"45015",624,485,480,2,5,"P.C.P.E.",0
50,"50134",134,102,101,3,1,"P.C.P.E.",0
46,"46029",20887,16124,15988,144,136,"P.C.P.E.",12
41,"41047",9810,7427,7321,99,106,"P.C.P.E.",5
36,"36032",3666,2789,2755,25,34,"P.C.P.E.",0
46,"46013",16111,12469,12328,145,141,"P.C.P.E.",8
24,"24097",244,161,156,4,5,"P.C.P.E.",0
47,"47165",7036,5328,5258,67,70,"P.C.P.E.",2
29,"29038",16309,10579,10494,152,85,"P.C.P.E.",22
47,"47083",80,61,59,3,2,"P.C.P.E.",0
18,"18152",1037,822,818,9,4,"P.C.P.E.",0
18,"18050",1657,1209,1196,5,13,"P.C.P.E.",4
50,"50213",117,83,82,0,1,"P.C.P.E.",0
46,"46183",5946,4718,4656,35,62,"P.C.P.E.",4
13,"13011",5166,3555,3500,31,55,"P.C.P.E.",4
22,"22178",107,92,92,1,0,"P.C.P.E.",0
24,"24084",182,133,132,1,1,"P.C.P.E.",0
29,"29039",2822,2091,2074,8,17,"P.C.P.E.",7
46,"46262",228,161,158,0,3,"P.C.P.E.",0
14,"14038",31501,23683,23394,336,289,"P.C.P.E.",32
45,"45091",419,311,309,5,2,"P.C.P.E.",0
22,"22142",114,91,91,2,0,"P.C.P.E.",0
24,"24165",400,284,279,4,5,"P.C.P.E.",1
47,"47157",544,462,458,9,4,"P.C.P.E.",0
24,"24006",521,384,378,4,6,"P.C.P.E.",0
46,"46103",1244,998,972,12,26,"P.C.P.E.",0
15,"15013",6160,4229,4165,70,64,"P.C.P.E.",7
26,"26020",506,372,364,10,8,"P.C.P.E.",3
46,"46184",26507,20314,20010,263,304,"P.C.P.E.",30
3,"3057",232,179,178,0,1,"P.C.P.E.",2
45,"45007",747,641,632,1,9,"P.C.P.E.",3
36,"36023",8522,6206,6062,64,144,"P.C.P.E.",9
45,"45117",800,679,668,7,11,"P.C.P.E.",0
2,"2004",654,554,544,7,10,"P.C.P.E.",1
26,"26034",678,526,510,3,16,"P.C.P.E.",0
13,"13002",1576,1143,1134,4,9,"P.C.P.E.",2
3,"3103",288,248,243,2,5,"P.C.P.E.",0
50,"50069",68,32,32,0,0,"P.C.P.E.",0
38,"38020",14520,9396,9202,121,194,"P.C.P.E.",17
39,"39061",3458,2673,2644,42,29,"P.C.P.E.",1
33,"33044",180964,129466,128346,1888,1120,"P.C.P.E.",202
47,"47041",166,135,133,2,2,"P.C.P.E.",0
14,"14010",4087,3144,3121,15,23,"P.C.P.E.",1
50,"50078",278,210,208,2,2,"P.C.P.E.",0
46,"46015",7042,5644,5581,53,63,"P.C.P.E.",2
46,"46234",388,308,307,3,1,"P.C.P.E.",2
47,"47213",122,99,99,1,0,"P.C.P.E.",1
3,"3128",3944,2847,2812,16,35,"P.C.P.E.",6
24,"24088",1103,903,885,4,18,"P.C.P.E.",3
2,"2030",3180,2499,2456,13,43,"P.C.P.E.",1
2,"2080",580,450,443,4,7,"P.C.P.E.",0
46,"46227",923,787,771,4,16,"P.C.P.E.",1
33,"33075",305,191,190,0,1,"P.C.P.E.",0
50,"50160",2397,1905,1865,19,40,"P.C.P.E.",1
46,"46024",448,365,358,1,7,"P.C.P.E.",1
18,"18067",704,526,521,1,5,"P.C.P.E.",0
2,"2079",2936,2305,2235,29,70,"P.C.P.E.",2
24,"24127",327,258,255,1,3,"P.C.P.E.",0
11,"11040",411,317,309,0,8,"P.C.P.E.",1
24,"24211",291,226,224,3,2,"P.C.P.E.",0
18,"18136",1973,1679,1668,5,11,"P.C.P.E.",2
50,"50003",141,108,108,3,0,"P.C.P.E.",0
50,"50052",100,82,82,0,0,"P.C.P.E.",0
47,"47051",351,269,256,5,13,"P.C.P.E.",0
50,"50198",46,36,36,2,0,"P.C.P.E.",0
15,"15054",32172,20472,20154,519,318,"P.C.P.E.",27
3,"3130",43,30,29,0,1,"P.C.P.E.",0
41,"41035",1171,898,889,12,9,"P.C.P.E.",0
22,"22099",532,411,408,6,3,"P.C.P.E.",0
13,"13049",838,654,648,0,6,"P.C.P.E.",0
22,"22251",391,288,278,4,10,"P.C.P.E.",0
18,"18102",8556,6358,6272,42,86,"P.C.P.E.",33
33,"33053",1206,817,811,6,6,"P.C.P.E.",3
24,"24011",244,131,129,0,2,"P.C.P.E.",0
46,"46212",1598,1233,1218,5,15,"P.C.P.E.",4
2,"2045",3763,3086,3035,42,51,"P.C.P.E.",10
39,"39011",1646,1295,1294,5,1,"P.C.P.E.",1
2,"2009",19661,14804,14570,259,234,"P.C.P.E.",29
45,"45122",4828,3816,3746,48,70,"P.C.P.E.",10
50,"50172",187,140,138,4,2,"P.C.P.E.",0
13,"13083",2529,1837,1795,26,42,"P.C.P.E.",3
15,"15027",1537,1263,1242,22,21,"P.C.P.E.",3
15,"15055",4780,3247,3181,70,66,"P.C.P.E.",5
3,"3131",181,161,157,1,4,"P.C.P.E.",0
15,"15046",6949,4641,4539,56,102,"P.C.P.E.",4
33,"33069",3611,2615,2597,25,18,"P.C.P.E.",1
50,"50229",62,47,46,2,1,"P.C.P.E.",0
30,"30041",12957,9360,9288,89,72,"P.C.P.E.",17
3,"3018",11899,8855,8720,119,135,"P.C.P.E.",20
39,"39064",1339,1072,1066,7,6,"P.C.P.E.",0
46,"46019",8671,7195,7109,70,86,"P.C.P.E.",3
22,"22012",93,74,74,5,0,"P.C.P.E.",0
47,"47001",51,44,42,2,2,"P.C.P.E.",0
13,"13051",358,291,289,5,2,"P.C.P.E.",0
11,"11902",3578,2400,2376,21,24,"P.C.P.E.",3
45,"45198",1950,1661,1641,9,20,"P.C.P.E.",0
47,"47002",30,27,27,1,0,"P.C.P.E.",0
46,"46213",15621,11361,11164,214,197,"P.C.P.E.",14
2,"2084",362,276,270,2,6,"P.C.P.E.",0
50,"50114",157,120,120,1,0,"P.C.P.E.",0
26,"26155",173,134,134,1,0,"P.C.P.E.",0
13,"13085",2455,2146,2118,21,28,"P.C.P.E.",5
50,"50055",3592,2520,2473,59,47,"P.C.P.E.",8
30,"30016",149046,103847,102890,1031,957,"P.C.P.E.",172
45,"45162",773,599,594,3,5,"P.C.P.E.",0
13,"13019",5254,4038,3978,62,60,"P.C.P.E.",10
13,"13020",4805,3475,3434,40,41,"P.C.P.E.",11
47,"47181",170,128,128,1,0,"P.C.P.E.",0
24,"24081",143,111,110,1,1,"P.C.P.E.",0
41,"41037",3228,2510,2483,27,27,"P.C.P.E.",0
45,"45052",2793,2247,2212,38,35,"P.C.P.E.",4
39,"39092",1030,753,747,1,6,"P.C.P.E.",1
45,"45125",2407,1977,1949,22,28,"P.C.P.E.",2
50,"50084",84,64,64,1,0,"P.C.P.E.",0
22,"22901",792,515,508,13,7,"P.C.P.E.",1
24,"24175",1760,1324,1303,29,21,"P.C.P.E.",2
47,"47029",61,54,53,0,1,"P.C.P.E.",0
26,"26114",87,74,72,0,2,"P.C.P.E.",1
45,"45138",1185,998,973,5,25,"P.C.P.E.",0
45,"45053",8208,6763,6663,103,100,"P.C.P.E.",8
2,"2086",2856,2019,2005,9,14,"P.C.P.E.",2
29,"29093",2299,1767,1732,7,35,"P.C.P.E.",0
47,"47012",134,105,105,0,0,"P.C.P.E.",0
22,"22016",654,476,464,10,12,"P.C.P.E.",2
3,"3022",160,133,131,1,2,"P.C.P.E.",0
46,"46207",6453,5086,5031,52,55,"P.C.P.E.",3
14,"14048",1244,975,970,5,5,"P.C.P.E.",2
24,"24069",53,44,44,0,0,"P.C.P.E.",0
47,"47047",217,171,170,5,1,"P.C.P.E.",1
41,"41004",55127,37662,37179,622,483,"P.C.P.E.",40
24,"24083",1165,831,819,17,12,"P.C.P.E.",4
26,"26162",116,94,93,2,1,"P.C.P.E.",1
39,"39068",663,488,485,4,3,"P.C.P.E.",0
29,"29085",156,116,113,0,3,"P.C.P.E.",0
18,"18042",425,344,342,2,2,"P.C.P.E.",0
30,"30902",7463,5291,5228,38,63,"P.C.P.E.",6
50,"50289",71,59,59,0,0,"P.C.P.E.",0
47,"47004",1261,1047,1031,11,16,"P.C.P.E.",0
22,"22181",91,57,55,0,2,"P.C.P.E.",0
2,"2051",1729,1318,1303,10,15,"P.C.P.E.",0
38,"38007",1844,1209,1188,5,21,"P.C.P.E.",1
24,"24058",224,166,163,1,3,"P.C.P.E.",0
45,"45128",2558,1831,1806,20,25,"P.C.P.E.",0
30,"30019",25722,18740,18553,164,187,"P.C.P.E.",23
2,"2040",631,569,566,3,3,"P.C.P.E.",0
22,"22214",131,101,100,2,1,"P.C.P.E.",0
47,"47166",276,226,223,0,3,"P.C.P.E.",0
24,"24098",1251,837,819,19,18,"P.C.P.E.",1
29,"29095",3431,2660,2607,23,53,"P.C.P.E.",8
33,"33035",11413,8105,8035,104,70,"P.C.P.E.",8
15,"15004",4891,3595,3545,61,50,"P.C.P.E.",4
47,"47005",578,467,455,5,12,"P.C.P.E.",1
18,"18022",12448,8777,8659,111,118,"P.C.P.E.",17
33,"33021",4932,3544,3502,45,42,"P.C.P.E.",8
2,"2029",3210,2512,2481,37,31,"P.C.P.E.",4
50,"50234",251,201,191,13,10,"P.C.P.E.",0
50,"50187",72,45,45,1,0,"P.C.P.E.",0
3,"3115",267,242,242,2,0,"P.C.P.E.",0
24,"24087",670,513,513,12,0,"P.C.P.E.",0
24,"24047",856,623,612,5,11,"P.C.P.E.",0
50,"50206",499,386,384,10,2,"P.C.P.E.",0
22,"22112",9618,6642,6533,205,109,"P.C.P.E.",29
24,"24179",331,219,214,4,5,"P.C.P.E.",0
50,"50149",48,35,35,0,0,"P.C.P.E.",0
26,"26076",144,124,123,3,1,"P.C.P.E.",0
24,"24223",2793,2121,2113,63,8,"P.C.P.E.",4
15,"15034",3116,2146,2114,20,32,"P.C.P.E.",0
46,"46902",425,333,332,3,1,"P.C.P.E.",0
13,"13014",565,457,452,3,5,"P.C.P.E.",0
50,"50051",886,677,671,9,6,"P.C.P.E.",1
41,"41092",7649,5816,5738,39,78,"P.C.P.E.",4
3,"3060",124,100,98,0,2,"P.C.P.E.",0
35,"35020",6142,4227,4192,24,35,"P.C.P.E.",1
45,"45058",409,334,332,2,2,"P.C.P.E.",1
15,"15006",5539,3940,3866,53,74,"P.C.P.E.",5
45,"45901",811,595,591,2,4,"P.C.P.E.",1
22,"22908",231,167,162,2,5,"P.C.P.E.",0
26,"26122",109,94,92,2,2,"P.C.P.E.",1
50,"50264",184,140,134,0,6,"P.C.P.E.",0
26,"26108",324,245,243,4,2,"P.C.P.E.",0
24,"24077",237,205,199,2,6,"P.C.P.E.",0
14,"14032",434,377,375,1,2,"P.C.P.E.",0
47,"47095",41,36,36,3,0,"P.C.P.E.",0
46,"46097",890,674,662,2,12,"P.C.P.E.",2
13,"13092",1924,1655,1635,4,20,"P.C.P.E.",2
22,"22170",622,439,430,13,9,"P.C.P.E.",2
13,"13060",291,235,229,0,6,"P.C.P.E.",2
13,"13093",4333,3281,3229,43,52,"P.C.P.E.",3
22,"22115",415,307,304,2,3,"P.C.P.E.",0
3,"3901",1070,826,818,14,8,"P.C.P.E.",0
50,"50090",165,117,117,1,0,"P.C.P.E.",0
46,"46098",2556,2072,2057,12,15,"P.C.P.E.",2
45,"45061",2523,1839,1813,20,26,"P.C.P.E.",4
50,"50265",63,46,46,1,0,"P.C.P.E.",0
46,"46050",161,126,123,1,3,"P.C.P.E.",0
47,"47224",92,77,77,0,0,"P.C.P.E.",0
47,"47144",85,65,65,2,0,"P.C.P.E.",1
41,"41044",6838,5064,5005,67,59,"P.C.P.E.",3
3,"3902",9578,7085,7007,65,78,"P.C.P.E.",14
39,"39020",23947,15404,15122,267,282,"P.C.P.E.",40
24,"24025",331,237,237,5,0,"P.C.P.E.",0
35,"35013",6779,5059,4961,105,98,"P.C.P.E.",12
50,"50209",2559,1685,1661,34,24,"P.C.P.E.",1
26,"26026",1344,1108,1096,14,12,"P.C.P.E.",2
22,"22253",71,54,54,1,0,"P.C.P.E.",0
24,"24065",2104,1512,1488,27,24,"P.C.P.E.",4
18,"18083",296,242,242,1,0,"P.C.P.E.",0
38,"38047",1819,1269,1239,12,30,"P.C.P.E.",2
24,"24104",291,198,196,3,2,"P.C.P.E.",2
18,"18017",17990,12070,11962,80,108,"P.C.P.E.",11
46,"46003",988,864,847,13,17,"P.C.P.E.",0
46,"46246",1081,917,904,5,13,"P.C.P.E.",0
38,"38014",1446,1018,1007,8,11,"P.C.P.E.",1
46,"46221",350,319,317,3,2,"P.C.P.E.",1
50,"50267",648,450,441,8,9,"P.C.P.E.",0
50,"50007",61,45,45,0,0,"P.C.P.E.",1
22,"22069",436,317,315,5,2,"P.C.P.E.",0
50,"50153",1002,757,748,12,9,"P.C.P.E.",1
47,"47145",658,482,473,7,9,"P.C.P.E.",2
15,"15038",2363,1643,1610,29,33,"P.C.P.E.",3
26,"26002",805,617,605,6,12,"P.C.P.E.",0
47,"47172",149,125,124,3,1,"P.C.P.E.",0
33,"33017",3289,2378,2350,35,28,"P.C.P.E.",1
3,"3009",47547,35945,35298,603,647,"P.C.P.E.",97
47,"47011",600,493,489,4,4,"P.C.P.E.",0
15,"15029",6266,4668,4618,49,50,"P.C.P.E.",0
47,"47054",673,545,541,8,4,"P.C.P.E.",0
50,"50240",1127,799,783,25,16,"P.C.P.E.",2
15,"15067",8142,6054,5978,73,76,"P.C.P.E.",4
45,"45027",433,352,349,1,3,"P.C.P.E.",1
46,"46252",142,108,107,1,1,"P.C.P.E.",0
39,"39023",6048,4795,4747,43,48,"P.C.P.E.",3
18,"18049",632,476,474,5,2,"P.C.P.E.",0
13,"13031",2384,1908,1874,23,34,"P.C.P.E.",1
18,"18119",1778,1401,1391,14,10,"P.C.P.E.",4
45,"45102",3539,2581,2533,23,48,"P.C.P.E.",0
45,"45077",554,430,423,7,7,"P.C.P.E.",0
18,"18020",1473,1111,1106,7,5,"P.C.P.E.",2
18,"18174",470,368,363,1,5,"P.C.P.E.",1
24,"24151",514,391,387,6,4,"P.C.P.E.",0
13,"13054",5032,3901,3824,70,77,"P.C.P.E.",4
18,"18040",246,147,146,0,1,"P.C.P.E.",0
26,"26115",20,20,20,4,0,"P.C.P.E.",0
46,"46215",1451,1185,1169,8,16,"P.C.P.E.",1
36,"36022",9203,6423,6226,100,197,"P.C.P.E.",14
50,"50046",201,155,153,2,2,"P.C.P.E.",0
14,"14017",10755,8220,8149,101,71,"P.C.P.E.",7
50,"50260",42,35,35,1,0,"P.C.P.E.",0
50,"50085",205,143,143,3,0,"P.C.P.E.",1
35,"35017",22331,13463,13144,217,319,"P.C.P.E.",49
2,"2026",845,723,716,5,7,"P.C.P.E.",0
14,"14027",7948,5944,5871,92,73,"P.C.P.E.",10
2,"2027",347,301,301,2,0,"P.C.P.E.",0
45,"45030",486,378,374,4,4,"P.C.P.E.",1
24,"24190",183,134,131,1,3,"P.C.P.E.",0
45,"45140",1087,885,867,6,18,"P.C.P.E.",1
50,"50279",111,79,79,1,0,"P.C.P.E.",0
45,"45177",2295,1898,1857,15,41,"P.C.P.E.",5
24,"24152",481,326,322,5,4,"P.C.P.E.",0
41,"41022",4281,3087,3066,15,21,"P.C.P.E.",3
50,"50242",102,82,82,2,0,"P.C.P.E.",0
11,"11001",4389,3110,3072,13,38,"P.C.P.E.",0
45,"45056",2246,1523,1502,16,21,"P.C.P.E.",4
15,"15023",6629,4879,4795,52,84,"P.C.P.E.",2
22,"22048",12485,9146,9028,237,118,"P.C.P.E.",28
38,"38052",1344,886,872,5,14,"P.C.P.E.",0
45,"45105",426,326,322,2,4,"P.C.P.E.",0
29,"29002",1246,896,893,11,3,"P.C.P.E.",2
33,"33066",42885,29326,29013,460,313,"P.C.P.E.",45
24,"24193",371,254,252,3,2,"P.C.P.E.",0
47,"47122",2078,1697,1665,21,32,"P.C.P.E.",3
24,"24166",1521,1137,1112,27,25,"P.C.P.E.",2
2,"2041",399,311,304,1,7,"P.C.P.E.",0
50,"50059",790,593,586,12,7,"P.C.P.E.",2
30,"30029",11533,8854,8768,73,86,"P.C.P.E.",15
50,"50087",31,25,25,0,0,"P.C.P.E.",0
18,"18145",10083,7592,7499,78,93,"P.C.P.E.",3
30,"30003",23570,16482,16354,169,128,"P.C.P.E.",44
22,"22020",110,81,79,3,2,"P.C.P.E.",2
29,"29003",1133,902,900,5,2,"P.C.P.E.",0
35,"35019",30279,17607,17380,158,227,"P.C.P.E.",44
46,"46129",553,430,423,4,7,"P.C.P.E.",1
3,"3047",8867,6219,6113,76,106,"P.C.P.E.",18
14,"14030",8519,6832,6753,64,79,"P.C.P.E.",21
22,"22129",193,124,123,4,1,"P.C.P.E.",0
29,"29077",225,157,157,1,0,"P.C.P.E.",2
46,"46202",15578,11811,11676,110,135,"P.C.P.E.",17
36,"36048",5416,4045,3971,55,74,"P.C.P.E.",4
39,"39078",1407,1041,1033,10,8,"P.C.P.E.",0
33,"33052",758,526,518,2,8,"P.C.P.E.",2
39,"39070",152,118,118,0,0,"P.C.P.E.",1
46,"46235",21966,16641,16465,167,176,"P.C.P.E.",7
47,"47042",63,50,49,3,1,"P.C.P.E.",0
50,"50070",70,42,41,0,1,"P.C.P.E.",0
11,"11032",53183,32205,31982,441,223,"P.C.P.E.",97
24,"24076",1210,917,907,26,10,"P.C.P.E.",0
22,"22080",288,217,217,4,0,"P.C.P.E.",1
15,"15044",1436,1083,1068,10,15,"P.C.P.E.",1
45,"45095",742,606,585,2,21,"P.C.P.E.",1
14,"14011",595,498,497,4,1,"P.C.P.E.",0
46,"46113",2338,1804,1797,14,7,"P.C.P.E.",0
22,"22204",1122,773,756,19,17,"P.C.P.E.",0
14,"14062",1114,889,882,9,7,"P.C.P.E.",2
18,"18188",1659,1329,1308,9,21,"P.C.P.E.",5
50,"50130",415,288,288,7,0,"P.C.P.E.",1
26,"26093",60,41,41,0,0,"P.C.P.E.",0
45,"45183",2189,1537,1514,10,23,"P.C.P.E.",2
33,"33023",3410,2501,2485,40,16,"P.C.P.E.",2
15,"15073",21991,14686,14456,216,230,"P.C.P.E.",18
41,"41052",2967,2305,2288,7,17,"P.C.P.E.",3
29,"29079",2500,2016,2000,23,16,"P.C.P.E.",1
46,"46155",1072,861,849,4,12,"P.C.P.E.",0
24,"24158",333,223,223,6,0,"P.C.P.E.",0
26,"26095",126,102,102,0,0,"P.C.P.E.",0
22,"22236",266,213,213,3,0,"P.C.P.E.",0
22,"22041",175,138,138,1,0,"P.C.P.E.",1
24,"24198",644,423,417,7,6,"P.C.P.E.",0
29,"29062",647,573,571,1,2,"P.C.P.E.",0
22,"22083",522,437,428,4,9,"P.C.P.E.",1
33,"33046",546,429,421,3,8,"P.C.P.E.",0
50,"50072",181,128,127,1,1,"P.C.P.E.",0
47,"47044",325,257,252,1,5,"P.C.P.E.",1
26,"26053",221,177,173,5,4,"P.C.P.E.",2
18,"18116",2972,2237,2213,19,24,"P.C.P.E.",4
50,"50043",258,170,166,2,4,"P.C.P.E.",0
26,"26141",132,101,101,2,0,"P.C.P.E.",0
13,"13007",1319,1069,1051,18,18,"P.C.P.E.",2
45,"45037",1730,1325,1304,15,21,"P.C.P.E.",0
45,"45148",340,256,256,1,0,"P.C.P.E.",0
50,"50163",3427,2448,2413,62,35,"P.C.P.E.",4
39,"39003",321,265,261,0,4,"P.C.P.E.",1
29,"29081",290,226,226,3,0,"P.C.P.E.",0
47,"47070",33,30,30,1,0,"P.C.P.E.",0
46,"46084",1587,1363,1332,7,31,"P.C.P.E.",0
15,"15075",12042,8639,8486,147,153,"P.C.P.E.",7
50,"50016",51,30,30,1,0,"P.C.P.E.",1
50,"50220",59,43,43,1,0,"P.C.P.E.",1
39,"39082",1688,1280,1266,9,14,"P.C.P.E.",2
18,"18059",4055,3232,3191,37,41,"P.C.P.E.",7
29,"29082",29311,20220,20051,223,169,"P.C.P.E.",20
46,"46035",6470,5115,5047,38,68,"P.C.P.E.",9
46,"46259",537,426,424,9,2,"P.C.P.E.",1
47,"47019",93,69,68,0,1,"P.C.P.E.",0
11,"11035",13266,8794,8668,115,126,"P.C.P.E.",10
46,"46052",532,471,463,2,8,"P.C.P.E.",0
29,"29083",2212,1679,1652,15,27,"P.C.P.E.",5
47,"47155",3043,2246,2225,35,21,"P.C.P.E.",2
46,"46260",2576,2140,2106,24,34,"P.C.P.E.",4
24,"24162",1631,1214,1195,33,19,"P.C.P.E.",1
24,"24002",271,213,213,2,0,"P.C.P.E.",0
46,"46158",1037,829,822,9,7,"P.C.P.E.",2
45,"45003",607,515,511,3,4,"P.C.P.E.",0
14,"14036",3774,2928,2909,51,19,"P.C.P.E.",10
46,"46261",1706,1388,1366,13,22,"P.C.P.E.",2
46,"46247",1059,829,823,6,6,"P.C.P.E.",1
39,"39075",140941,103308,102362,1364,946,"P.C.P.E.",171
47,"47227",62,52,52,1,0,"P.C.P.E.",0
3,"3135",228,185,181,0,4,"P.C.P.E.",0
13,"13087",22953,16674,16376,298,298,"P.C.P.E.",21
26,"26130",229,181,177,0,4,"P.C.P.E.",0
3,"3044",4459,3798,3753,21,45,"P.C.P.E.",8
22,"22002",107,85,84,3,1,"P.C.P.E.",1
3,"3136",484,393,386,1,7,"P.C.P.E.",0
22,"22059",1149,792,764,23,28,"P.C.P.E.",5
46,"46254",1085,847,834,12,13,"P.C.P.E.",1
41,"41048",2296,1749,1726,21,23,"P.C.P.E.",0
24,"24030",4397,3272,3229,54,43,"P.C.P.E.",3
45,"45189",655,510,502,3,8,"P.C.P.E.",0
26,"26018",10396,8186,8041,161,145,"P.C.P.E.",16
11,"11037",5640,4337,4285,32,52,"P.C.P.E.",9
39,"39058",862,586,584,6,2,"P.C.P.E.",2
22,"22246",93,63,62,0,1,"P.C.P.E.",0
24,"24206",1831,1362,1341,13,21,"P.C.P.E.",6
41,"41056",3697,3041,3008,25,33,"P.C.P.E.",1
30,"30018",7493,6003,5922,52,81,"P.C.P.E.",3
22,"22060",1180,909,891,13,18,"P.C.P.E.",1
46,"46070",15946,11979,11874,113,105,"P.C.P.E.",12
45,"45079",368,278,273,1,5,"P.C.P.E.",2
18,"18098",6440,4743,4679,44,64,"P.C.P.E.",1
3,"3090",16226,12224,12116,139,108,"P.C.P.E.",22
47,"47039",196,163,163,1,0,"P.C.P.E.",0
45,"45092",252,223,221,0,2,"P.C.P.E.",0
38,"38008",5430,3844,3772,46,72,"P.C.P.E.",5
46,"46135",9634,7671,7586,64,85,"P.C.P.E.",7
47,"47211",45,38,38,1,0,"P.C.P.E.",0
24,"24086",323,245,243,1,2,"P.C.P.E.",0
41,"41084",2875,2362,2335,9,27,"P.C.P.E.",2
18,"18133",2256,1783,1773,12,10,"P.C.P.E.",1
22,"22004",146,97,97,2,0,"P.C.P.E.",0
33,"33058",1863,1307,1286,11,21,"P.C.P.E.",8
50,"50117",131,101,100,1,1,"P.C.P.E.",2
15,"15042",3249,2341,2303,25,38,"P.C.P.E.",4
46,"46193",8494,6662,6580,73,82,"P.C.P.E.",6
13,"13035",1043,794,770,10,24,"P.C.P.E.",1
45,"45032",471,340,333,2,7,"P.C.P.E.",1
26,"26106",78,70,69,0,1,"P.C.P.E.",0
22,"22232",98,78,75,0,3,"P.C.P.E.",0
33,"33074",3699,2643,2611,30,32,"P.C.P.E.",1
18,"18064",419,347,345,3,2,"P.C.P.E.",0
36,"36025",2442,1531,1516,10,15,"P.C.P.E.",2
41,"41058",16497,12415,12248,181,167,"P.C.P.E.",16
47,"47184",575,447,443,6,4,"P.C.P.E.",0
26,"26150",129,104,104,0,0,"P.C.P.E.",0
24,"24168",493,397,391,7,6,"P.C.P.E.",0
22,"22050",100,84,83,0,1,"P.C.P.E.",0
47,"47177",112,83,79,1,4,"P.C.P.E.",0
24,"24034",3434,2524,2481,37,43,"P.C.P.E.",7
29,"29004",343,281,281,0,0,"P.C.P.E.",0
36,"36059",5438,3874,3805,47,69,"P.C.P.E.",7
50,"50022",548,430,416,10,14,"P.C.P.E.",2
46,"46138",338,297,296,1,1,"P.C.P.E.",0
22,"22095",87,61,61,1,0,"P.C.P.E.",0
35,"35028",8810,4687,4603,71,84,"P.C.P.E.",8
46,"46065",1606,1250,1234,15,16,"P.C.P.E.",0
18,"18004",818,601,594,2,7,"P.C.P.E.",0
22,"22168",22,16,16,0,0,"P.C.P.E.",0
46,"46203",3669,3002,2964,36,38,"P.C.P.E.",2
26,"26181",14,12,12,0,0,"P.C.P.E.",0
11,"11013",2284,1691,1670,15,21,"P.C.P.E.",1
46,"46041",369,255,255,1,0,"P.C.P.E.",5
29,"29042",14047,9845,9735,118,110,"P.C.P.E.",13
46,"46090",1668,1488,1452,9,36,"P.C.P.E.",0
30,"30014",1686,1400,1387,10,13,"P.C.P.E.",1
50,"50171",126,90,89,4,1,"P.C.P.E.",0
47,"47160",466,368,364,5,4,"P.C.P.E.",0
22,"22151",97,71,71,0,0,"P.C.P.E.",2
45,"45011",316,271,268,1,3,"P.C.P.E.",1
11,"11014",16318,11093,11031,144,62,"P.C.P.E.",17
36,"36061",8729,6747,6640,68,107,"P.C.P.E.",14
47,"47187",101,82,81,1,1,"P.C.P.E.",0
22,"22053",867,567,554,13,13,"P.C.P.E.",1
22,"22205",472,369,363,5,6,"P.C.P.E.",1
46,"46139",4594,3794,3734,28,60,"P.C.P.E.",2
50,"50199",380,263,254,2,9,"P.C.P.E.",1
24,"24051",484,375,368,2,7,"P.C.P.E.",1
14,"14013",17006,13114,12958,166,156,"P.C.P.E.",16
41,"41010",4338,2990,2958,48,32,"P.C.P.E.",1
50,"50257",195,154,154,0,0,"P.C.P.E.",1
47,"47026",59,46,46,1,0,"P.C.P.E.",0
33,"33031",38090,25034,24730,380,304,"P.C.P.E.",63
26,"26054",381,298,292,2,6,"P.C.P.E.",1
36,"36901",4085,3285,3235,21,50,"P.C.P.E.",3
38,"38002",991,716,708,1,8,"P.C.P.E.",0
18,"18069",506,375,371,4,4,"P.C.P.E.",1
47,"47135",93,77,76,0,1,"P.C.P.E.",0
2,"2010",1877,1557,1519,15,38,"P.C.P.E.",2
39,"39091",2026,1636,1628,14,8,"P.C.P.E.",10
13,"13018",860,740,727,2,13,"P.C.P.E.",1
41,"41088",542,414,408,1,6,"P.C.P.E.",0
47,"47188",125,112,109,3,3,"P.C.P.E.",1
46,"46165",6962,5390,5322,53,68,"P.C.P.E.",9
26,"26112",270,201,200,0,1,"P.C.P.E.",0
39,"39013",561,413,412,2,1,"P.C.P.E.",0
47,"47109",183,151,151,4,0,"P.C.P.E.",0
3,"3132",571,464,461,8,3,"P.C.P.E.",1
22,"22254",1175,868,856,14,12,"P.C.P.E.",2
36,"36030",4387,3206,3177,35,29,"P.C.P.E.",2
26,"26028",135,108,106,2,2,"P.C.P.E.",0
50,"50113",653,528,526,9,2,"P.C.P.E.",1
26,"26029",33,25,24,1,1,"P.C.P.E.",0
45,"45199",2712,1817,1796,17,21,"P.C.P.E.",2
47,"47081",57,44,44,1,0,"P.C.P.E.",0
47,"47137",27,22,22,2,0,"P.C.P.E.",0
45,"45039",236,197,190,2,7,"P.C.P.E.",0
14,"14046",4587,3671,3641,35,30,"P.C.P.E.",0
38,"38004",4522,3034,2975,33,59,"P.C.P.E.",20
29,"29046",2777,2032,2013,10,19,"P.C.P.E.",4
24,"24174",525,393,387,6,6,"P.C.P.E.",1
22,"22106",25,17,17,0,0,"P.C.P.E.",0
50,"50287",298,214,211,10,3,"P.C.P.E.",0
47,"47190",103,87,87,7,0,"P.C.P.E.",0
45,"45089",1615,1238,1221,16,17,"P.C.P.E.",0
47,"47028",31,21,20,0,1,"P.C.P.E.",0
39,"39083",1214,785,775,7,10,"P.C.P.E.",0
36,"36021",11798,8742,8574,136,168,"P.C.P.E.",10
24,"24203",109,73,73,0,0,"P.C.P.E.",0
3,"3111",5244,4184,4146,39,38,"P.C.P.E.",4
3,"3065",164772,124457,123236,1556,1221,"P.C.P.E.",267
26,"26071",8475,6088,5964,92,124,"P.C.P.E.",17
38,"38006",35862,18726,18500,209,226,"P.C.P.E.",48
35,"35033",6415,4394,4302,51,92,"P.C.P.E.",16
24,"24164",397,215,213,2,2,"P.C.P.E.",0
41,"41082",3448,2827,2796,15,31,"P.C.P.E.",1
50,"50193",635,483,465,3,18,"P.C.P.E.",2
18,"18163",327,246,238,0,8,"P.C.P.E.",0
50,"50076",113,89,89,0,0,"P.C.P.E.",0
47,"47219",46,36,36,1,0,"P.C.P.E.",0
47,"47139",1080,845,833,11,12,"P.C.P.E.",0
22,"22061",6611,4789,4698,110,91,"P.C.P.E.",15
41,"41066",1417,1121,1113,9,8,"P.C.P.E.",1
46,"46192",755,564,554,9,10,"P.C.P.E.",0
18,"18011",4246,3195,3172,23,23,"P.C.P.E.",3
15,"15031",22951,16018,15696,382,322,"P.C.P.E.",25
11,"11029",5360,3445,3423,27,22,"P.C.P.E.",2
3,"3078",528,424,423,2,1,"P.C.P.E.",1
47,"47174",302,236,234,3,2,"P.C.P.E.",0
50,"50261",246,199,199,4,0,"P.C.P.E.",1
18,"18072",710,507,499,2,8,"P.C.P.E.",2
22,"22904",908,660,653,14,7,"P.C.P.E.",1
50,"50029",676,527,517,6,10,"P.C.P.E.",1
13,"13045",744,615,608,6,7,"P.C.P.E.",0
45,"45043",827,679,670,3,9,"P.C.P.E.",2
47,"47220",194,143,142,4,1,"P.C.P.E.",0
2,"2052",493,417,412,9,5,"P.C.P.E.",1
24,"24019",367,293,287,5,6,"P.C.P.E.",1
45,"45166",1734,1460,1429,8,31,"P.C.P.E.",4
13,"13090",1202,994,972,4,22,"P.C.P.E.",2
18,"18109",607,461,456,1,5,"P.C.P.E.",0
47,"47014",55,47,47,0,0,"P.C.P.E.",0
47,"47040",67,51,50,0,1,"P.C.P.E.",0
26,"26089",108356,81446,80090,1450,1356,"P.C.P.E.",204
22,"22036",101,82,82,1,0,"P.C.P.E.",0
3,"3025",1252,1054,1044,4,10,"P.C.P.E.",7
45,"45130",354,287,283,2,4,"P.C.P.E.",0
45,"45070",1415,1175,1162,11,13,"P.C.P.E.",5
24,"24125",545,374,373,5,1,"P.C.P.E.",1
18,"18177",463,285,281,4,4,"P.C.P.E.",2
14,"14050",2418,1983,1966,23,17,"P.C.P.E.",1
18,"18111",2647,1957,1941,24,16,"P.C.P.E.",1
18,"18044",208,132,132,4,0,"P.C.P.E.",1
3,"3069",2830,2009,1979,22,30,"P.C.P.E.",6
26,"26121",33,28,28,0,0,"P.C.P.E.",0
22,"22906",190,152,147,3,5,"P.C.P.E.",0
14,"14020",415,323,319,3,4,"P.C.P.E.",0
3,"3037",354,293,289,1,4,"P.C.P.E.",2
50,"50178",325,228,225,4,3,"P.C.P.E.",1
41,"41033",5237,3915,3878,20,37,"P.C.P.E.",8
45,"45047",2404,1685,1662,7,23,"P.C.P.E.",4
47,"47185",97,76,75,1,1,"P.C.P.E.",0
22,"22021",2080,1524,1505,31,19,"P.C.P.E.",0
26,"26166",152,139,136,1,3,"P.C.P.E.",0
45,"45168",61519,47265,46528,736,737,"P.C.P.E.",80
33,"33060",15694,11036,10883,112,153,"P.C.P.E.",28
50,"50292",138,117,115,4,2,"P.C.P.E.",0
24,"24022",364,231,230,2,1,"P.C.P.E.",0
39,"39044",3864,2940,2905,44,35,"P.C.P.E.",3
45,"45182",1077,873,856,11,17,"P.C.P.E.",3
50,"50179",269,230,229,2,1,"P.C.P.E.",0
45,"45071",1896,1592,1575,21,17,"P.C.P.E.",0
47,"47205",414,307,298,5,9,"P.C.P.E.",0
45,"45034",1375,1108,1079,18,29,"P.C.P.E.",3
45,"45132",1916,1487,1473,9,14,"P.C.P.E.",0
36,"36038",65661,47940,47214,836,726,"P.C.P.E.",63
15,"15007",3702,2670,2642,19,28,"P.C.P.E.",0
46,"46170",3464,2944,2908,24,36,"P.C.P.E.",3
18,"18179",583,417,409,7,8,"P.C.P.E.",5
3,"3071",3993,3180,3128,40,52,"P.C.P.E.",8
29,"29069",80337,50235,49723,690,512,"P.C.P.E.",63
24,"24183",900,571,567,10,4,"P.C.P.E.",2
24,"24225",1089,798,784,15,14,"P.C.P.E.",2
47,"47169",70,57,57,0,0,"P.C.P.E.",0
11,"11023",9209,6979,6929,81,50,"P.C.P.E.",5
45,"45134",1606,1260,1242,10,18,"P.C.P.E.",0
26,"26039",44,38,36,1,2,"P.C.P.E.",0
47,"47196",43,29,29,0,0,"P.C.P.E.",0
46,"46123",1808,1440,1410,7,30,"P.C.P.E.",0
39,"39072",375,234,234,4,0,"P.C.P.E.",0
26,"26040",67,63,62,2,1,"P.C.P.E.",0
46,"46026",1217,1043,1035,2,8,"P.C.P.E.",0
47,"47170",40,30,30,0,0,"P.C.P.E.",0
50,"50266",139,95,94,1,1,"P.C.P.E.",0
22,"22156",256,209,203,5,6,"P.C.P.E.",1
18,"18047",5603,3833,3805,67,28,"P.C.P.E.",3
29,"29070",35228,23374,23146,258,228,"P.C.P.E.",34
24,"24146",284,223,221,0,2,"P.C.P.E.",1
18,"18181",253,183,182,0,1,"P.C.P.E.",0
24,"24228",732,543,529,4,14,"P.C.P.E.",2
26,"26081",23,17,17,0,0,"P.C.P.E.",0
13,"13029",102,90,89,0,1,"P.C.P.E.",0
47,"47197",932,739,730,15,9,"P.C.P.E.",0
50,"50152",1569,1151,1135,31,16,"P.C.P.E.",0
39,"39073",9275,6984,6903,83,81,"P.C.P.E.",34
11,"11006",24221,16564,16470,197,94,"P.C.P.E.",21
14,"14055",18619,13802,13607,192,195,"P.C.P.E.",21
50,"50182",3704,2551,2515,44,36,"P.C.P.E.",4
13,"13063",3839,2801,2771,31,30,"P.C.P.E.",0
2,"2060",1232,974,964,10,10,"P.C.P.E.",0
26,"26172",35,29,29,0,0,"P.C.P.E.",0
47,"47198",71,56,56,2,0,"P.C.P.E.",0
3,"3904",1416,1104,1096,11,8,"P.C.P.E.",4
46,"46197",1902,1559,1554,15,5,"P.C.P.E.",0
3,"3075",160,139,136,2,3,"P.C.P.E.",1
45,"45100",205,169,169,0,0,"P.C.P.E.",0
29,"29901",41445,27372,27158,295,214,"P.C.P.E.",30
46,"46044",4301,3284,3169,50,115,"P.C.P.E.",3
29,"29027",2416,1907,1893,15,14,"P.C.P.E.",1
13,"13064",1465,1127,1110,21,17,"P.C.P.E.",2
46,"46174",1003,854,847,6,7,"P.C.P.E.",0
47,"47226",180,152,148,1,4,"P.C.P.E.",1
36,"36009",5138,3147,3108,24,39,"P.C.P.E.",8
22,"22122",62,57,57,3,0,"P.C.P.E.",0
3,"3076",8373,6319,6222,68,97,"P.C.P.E.",8
39,"39101",328,251,247,5,4,"P.C.P.E.",1
46,"46198",815,660,654,4,6,"P.C.P.E.",0
47,"47037",194,160,159,1,1,"P.C.P.E.",0
22,"22226",823,640,627,11,13,"P.C.P.E.",3
29,"29036",670,504,499,4,5,"P.C.P.E.",2
15,"15070",9684,6627,6464,141,163,"P.C.P.E.",6
46,"46055",1286,1083,1067,11,16,"P.C.P.E.",1
50,"50135",100,76,75,2,1,"P.C.P.E.",0
46,"46223",7685,6040,5996,62,44,"P.C.P.E.",9
45,"45065",317,261,258,0,3,"P.C.P.E.",0
18,"18071",5589,4268,4205,44,63,"P.C.P.E.",9
24,"24136",596,465,463,12,2,"P.C.P.E.",2
50,"50146",211,168,167,4,1,"P.C.P.E.",2
22,"22903",672,555,547,6,8,"P.C.P.E.",0
13,"13021",459,358,355,5,3,"P.C.P.E.",0
45,"45029",233,207,202,4,5,"P.C.P.E.",0
38,"38017",24438,13769,13576,176,193,"P.C.P.E.",32
22,"22125",38140,26924,26463,676,461,"P.C.P.E.",60
18,"18184",2140,1663,1645,18,18,"P.C.P.E.",2
26,"26045",13,13,13,0,0,"P.C.P.E.",0
29,"29001",4176,3339,3303,23,36,"P.C.P.E.",5
26,"26046",1617,1237,1219,14,18,"P.C.P.E.",2
33,"33027",929,617,613,5,4,"P.C.P.E.",0
47,"47100",169,146,144,1,2,"P.C.P.E.",0
22,"22163",431,353,344,5,9,"P.C.P.E.",2
47,"47121",590,495,490,4,5,"P.C.P.E.",0
30,"30002",9802,7628,7553,48,75,"P.C.P.E.",11
22,"22229",127,93,89,4,4,"P.C.P.E.",1
47,"47092",123,100,99,2,1,"P.C.P.E.",1
36,"36034",3684,2686,2651,32,35,"P.C.P.E.",6
22,"22143",244,166,161,2,5,"P.C.P.E.",0
50,"50223",956,751,745,14,6,"P.C.P.E.",0
36,"36045",24724,17794,17459,237,335,"P.C.P.E.",40
22,"22127",483,357,353,9,4,"P.C.P.E.",0
38,"38019",12624,8174,8099,65,75,"P.C.P.E.",14
46,"46249",9650,7288,7191,125,97,"P.C.P.E.",21
50,"50280",370,296,291,5,5,"P.C.P.E.",0
47,"47101",1740,1458,1444,12,14,"P.C.P.E.",3
50,"50038",1583,1194,1174,29,20,"P.C.P.E.",3
24,"24222",13915,9939,9751,304,188,"P.C.P.E.",22
2,"2053",3053,2550,2517,33,33,"P.C.P.E.",3
47,"47123",456,356,353,10,3,"P.C.P.E.",0
18,"18043",140,89,87,1,2,"P.C.P.E.",0
29,"29031",1652,1123,1118,11,5,"P.C.P.E.",1
2,"2070",439,372,366,4,6,"P.C.P.E.",0
36,"36017",18554,13573,13378,200,195,"P.C.P.E.",14
45,"45069",1791,1409,1389,8,20,"P.C.P.E.",4
36,"36014",2145,1568,1548,9,20,"P.C.P.E.",3
2,"2066",258,219,217,2,2,"P.C.P.E.",1
11,"11031",76347,49071,48616,681,455,"P.C.P.E.",83
3,"3014",234288,168004,166418,1795,1586,"P.C.P.E.",516
3,"3080",1288,1116,1103,6,13,"P.C.P.E.",1
24,"24033",214,157,152,3,5,"P.C.P.E.",0
45,"45107",3006,2344,2299,32,45,"P.C.P.E.",4
22,"22233",94,69,69,0,0,"P.C.P.E.",0
50,"50040",98,77,76,2,1,"P.C.P.E.",1
24,"24101",465,274,266,5,8,"P.C.P.E.",0
24,"24156",264,187,186,6,1,"P.C.P.E.",0
3,"3048",4747,3878,3817,16,61,"P.C.P.E.",11
50,"50273",36,22,22,0,0,"P.C.P.E.",0
29,"29032",6673,5204,5140,43,64,"P.C.P.E.",6
47,"47016",94,77,77,1,0,"P.C.P.E.",0
46,"46008",2727,2249,2233,17,16,"P.C.P.E.",0
50,"50245",121,80,80,1,0,"P.C.P.E.",1
13,"13058",4155,3320,3285,24,35,"P.C.P.E.",0
18,"18157",1062,793,783,9,10,"P.C.P.E.",2
3,"3049",12150,10039,9892,88,147,"P.C.P.E.",8
26,"26024",273,220,219,2,1,"P.C.P.E.",0
46,"46903",5210,4037,4000,40,37,"P.C.P.E.",1
33,"33068",1224,704,703,5,1,"P.C.P.E.",4
46,"46178",4406,3235,3201,22,34,"P.C.P.E.",6
22,"22052",997,776,769,15,7,"P.C.P.E.",2
45,"45157",2097,1519,1499,15,20,"P.C.P.E.",5
46,"46082",4661,3447,3401,46,46,"P.C.P.E.",7
46,"46257",5579,4546,4512,32,34,"P.C.P.E.",6
41,"41093",17665,13712,13526,179,186,"P.C.P.E.",12
18,"18093",2580,1837,1820,8,17,"P.C.P.E.",1
46,"46130",934,745,734,6,11,"P.C.P.E.",1
26,"26066",277,229,228,9,1,"P.C.P.E.",0
14,"14012",6305,4749,4690,44,59,"P.C.P.E.",2
39,"39054",4265,3338,3276,57,62,"P.C.P.E.",6
46,"46131",49087,37846,37477,422,369,"P.C.P.E.",45
50,"50218",113,92,92,0,0,"P.C.P.E.",0
14,"14033",1289,974,958,18,16,"P.C.P.E.",0
11,"11026",4834,3736,3691,27,45,"P.C.P.E.",3
47,"47049",94,71,71,1,0,"P.C.P.E.",0
50,"50190",751,576,565,7,11,"P.C.P.E.",1
41,"41053",20729,16178,15971,142,207,"P.C.P.E.",15
24,"24038",3206,2439,2399,37,40,"P.C.P.E.",4
14,"14074",2387,2002,1995,26,7,"P.C.P.E.",1
26,"26013",350,267,264,5,3,"P.C.P.E.",3
24,"24117",493,376,369,2,7,"P.C.P.E.",0
22,"22189",199,140,138,5,2,"P.C.P.E.",0
2,"2034",1419,1153,1146,18,7,"P.C.P.E.",1
24,"24079",1045,721,710,15,11,"P.C.P.E.",0
14,"14003",1289,1046,1026,12,20,"P.C.P.E.",0
24,"24199",432,280,278,2,2,"P.C.P.E.",0
24,"24039",2157,1738,1727,30,11,"P.C.P.E.",0
15,"15047",2606,1789,1761,33,28,"P.C.P.E.",5
29,"29008",14069,9934,9859,118,75,"P.C.P.E.",10
46,"46067",1798,1487,1472,10,15,"P.C.P.E.",0
18,"18027",2575,1913,1899,15,14,"P.C.P.E.",4
24,"24040",494,369,366,6,3,"P.C.P.E.",0
18,"18193",13680,9874,9764,130,110,"P.C.P.E.",9
39,"39038",1465,1065,1047,8,18,"P.C.P.E.",4
50,"50277",82,63,63,0,0,"P.C.P.E.",0
24,"24080",228,165,164,0,1,"P.C.P.E.",0
47,"47045",839,636,632,3,4,"P.C.P.E.",2
47,"47098",607,496,492,9,4,"P.C.P.E.",1
46,"46157",3068,2523,2491,17,32,"P.C.P.E.",1
24,"24094",1466,1023,1006,24,17,"P.C.P.E.",0
39,"39056",2387,1857,1835,22,22,"P.C.P.E.",2
33,"33070",3481,2557,2521,33,36,"P.C.P.E.",1
46,"46182",1190,864,855,11,9,"P.C.P.E.",7
45,"45150",471,388,382,1,6,"P.C.P.E.",0
18,"18096",348,289,287,1,2,"P.C.P.E.",0
50,"50278",207,152,149,4,3,"P.C.P.E.",0
41,"41096",6079,4673,4595,47,78,"P.C.P.E.",1
11,"11036",725,484,482,10,2,"P.C.P.E.",0
18,"18128",361,284,283,5,1,"P.C.P.E.",1
33,"33026",9144,6019,5959,87,60,"P.C.P.E.",10
47,"47020",283,237,232,5,5,"P.C.P.E.",0
47,"47128",57,52,48,1,4,"P.C.P.E.",0
14,"14006",1326,1170,1148,12,22,"P.C.P.E.",4
15,"15080",1913,1407,1389,15,18,"P.C.P.E.",1
47,"47105",210,181,179,1,2,"P.C.P.E.",0
45,"45082",1333,1143,1123,14,20,"P.C.P.E.",0
41,"41064",5629,4041,4006,28,35,"P.C.P.E.",0
30,"30035",17849,12871,12744,133,127,"P.C.P.E.",20
39,"39084",873,647,642,4,5,"P.C.P.E.",0
14,"14007",15871,11609,11477,121,132,"P.C.P.E.",10
26,"26102",6158,4794,4716,60,78,"P.C.P.E.",8
2,"2075",1689,1386,1372,10,14,"P.C.P.E.",2
15,"15068",5404,3780,3725,53,55,"P.C.P.E.",5
47,"47148",475,389,384,2,5,"P.C.P.E.",2
30,"30009",11961,9992,9880,92,112,"P.C.P.E.",11
18,"18097",1022,758,752,4,6,"P.C.P.E.",0
24,"24205",995,719,712,9,7,"P.C.P.E.",2
38,"38028",22003,14876,14589,158,287,"P.C.P.E.",17
47,"47075",4999,4020,3957,39,63,"P.C.P.E.",3
13,"13077",3654,2535,2480,31,55,"P.C.P.E.",8
26,"26146",141,98,96,0,2,"P.C.P.E.",0
50,"50001",130,96,96,0,0,"P.C.P.E.",2
46,"46094",20341,15367,15222,152,145,"P.C.P.E.",11
47,"47065",898,762,752,9,10,"P.C.P.E.",3
26,"26117",2152,1682,1655,20,27,"P.C.P.E.",0
46,"46054",11422,8666,8566,82,100,"P.C.P.E.",17
18,"18164",1881,1351,1342,16,9,"P.C.P.E.",3
33,"33065",1150,791,784,16,7,"P.C.P.E.",1
13,"13033",1719,1436,1419,6,17,"P.C.P.E.",4
36,"36056",5087,3883,3830,37,53,"P.C.P.E.",10
38,"38041",6780,4905,4813,57,92,"P.C.P.E.",4
15,"15088",3769,2626,2599,21,27,"P.C.P.E.",0
29,"29040",1934,1344,1332,12,12,"P.C.P.E.",0
46,"46209",1984,1606,1594,11,12,"P.C.P.E.",2
39,"39060",6723,5453,5360,56,93,"P.C.P.E.",12
47,"47022",62,54,54,0,0,"P.C.P.E.",0
36,"36001",3138,2060,2049,13,11,"P.C.P.E.",1
3,"3102",7346,5827,5751,39,76,"P.C.P.E.",8
3,"3114",1620,1320,1305,10,15,"P.C.P.E.",3
47,"47204",275,221,219,3,2,"P.C.P.E.",0
46,"46255",3135,2530,2508,11,22,"P.C.P.E.",3
50,"50138",49,43,43,2,0,"P.C.P.E.",0
11,"11030",22528,14741,14557,195,184,"P.C.P.E.",36
13,"13016",708,555,553,2,2,"P.C.P.E.",0
50,"50123",428,335,332,9,3,"P.C.P.E.",0
29,"29016",272,180,179,5,1,"P.C.P.E.",0
18,"18099",1551,1217,1205,11,12,"P.C.P.E.",1
11,"11011",1685,1231,1216,8,15,"P.C.P.E.",1
50,"50050",109,73,73,1,0,"P.C.P.E.",0
30,"30011",4687,3776,3726,20,50,"P.C.P.E.",6
50,"50196",110,87,86,4,1,"P.C.P.E.",0
45,"45046",2455,1884,1862,11,22,"P.C.P.E.",10
50,"50021",42,34,33,1,1,"P.C.P.E.",0
45,"45155",481,382,375,3,7,"P.C.P.E.",1
24,"24210",532,329,328,2,1,"P.C.P.E.",2
50,"50139",372,280,278,3,2,"P.C.P.E.",0
46,"46256",6734,4902,4858,33,44,"P.C.P.E.",3
11,"11012",103946,68124,67375,856,749,"P.C.P.E.",105
3,"3059",20261,15951,15825,82,126,"P.C.P.E.",27
15,"15053",8164,5679,5592,60,87,"P.C.P.E.",9
26,"26151",455,384,382,1,2,"P.C.P.E.",0
3,"3093",19646,15399,15159,173,240,"P.C.P.E.",22
46,"46089",2116,1653,1627,9,26,"P.C.P.E.",0
47,"47007",3453,2616,2580,42,36,"P.C.P.E.",0
26,"26138",4646,3468,3398,46,70,"P.C.P.E.",3
47,"47231",4272,3268,3243,64,25,"P.C.P.E.",2
14,"14001",3633,3095,3064,25,31,"P.C.P.E.",3
47,"47043",330,267,264,1,3,"P.C.P.E.",0
2,"2031",626,507,502,3,5,"P.C.P.E.",0
11,"11041",9805,7136,7067,87,69,"P.C.P.E.",6
38,"38001",17632,9601,9475,121,126,"P.C.P.E.",29
18,"18015",465,381,379,1,2,"P.C.P.E.",0
24,"24181",1652,1303,1288,12,15,"P.C.P.E.",0
24,"24050",113,91,90,0,1,"P.C.P.E.",0
36,"36027",4478,3376,3339,29,37,"P.C.P.E.",6
45,"45085",1511,1111,1100,10,11,"P.C.P.E.",3
50,"50080",41,31,31,1,0,"P.C.P.E.",0
41,"41008",1073,884,875,0,9,"P.C.P.E.",0
18,"18180",655,450,447,1,3,"P.C.P.E.",2
46,"46171",16753,12565,12399,122,166,"P.C.P.E.",20
39,"39037",2061,1609,1586,10,23,"P.C.P.E.",3
29,"29089",3343,2514,2489,14,25,"P.C.P.E.",9
50,"50902",97,85,85,1,0,"P.C.P.E.",0
30,"30008",13289,9992,9849,86,143,"P.C.P.E.",31
47,"47006",196,151,146,1,5,"P.C.P.E.",0
47,"47167",258,230,229,3,1,"P.C.P.E.",1
24,"24131",813,583,580,9,3,"P.C.P.E.",2
26,"26067",22,19,19,1,0,"P.C.P.E.",0
26,"26111",266,203,200,4,3,"P.C.P.E.",0
45,"45024",1105,870,856,16,14,"P.C.P.E.",1
45,"45050",508,385,378,0,7,"P.C.P.E.",2
36,"36028",4207,3294,3254,21,40,"P.C.P.E.",2
33,"33076",12662,8733,8670,120,63,"P.C.P.E.",10
18,"18006",4116,2862,2831,25,31,"P.C.P.E.",5
46,"46237",7261,5405,5350,54,55,"P.C.P.E.",7
2,"2047",109,94,94,0,0,"P.C.P.E.",0
14,"14075",624,508,500,8,8,"P.C.P.E.",2
41,"41901",2626,2190,2167,24,23,"P.C.P.E.",0
24,"24215",169,121,120,1,1,"P.C.P.E.",1
15,"15066",4180,3098,3062,38,36,"P.C.P.E.",6
26,"26068",83,65,64,0,1,"P.C.P.E.",0
13,"13052",6580,4869,4786,76,83,"P.C.P.E.",5
29,"29054",39904,27540,27307,240,233,"P.C.P.E.",53
22,"22013",304,239,236,3,3,"P.C.P.E.",0
38,"38003",1446,1053,1044,4,9,"P.C.P.E.",3
18,"18048",2277,1705,1688,19,17,"P.C.P.E.",1
45,"45026",269,200,198,2,2,"P.C.P.E.",1
41,"41011",15274,11359,11207,145,152,"P.C.P.E.",6
46,"46149",398,307,305,1,2,"P.C.P.E.",0
50,"50173",175,104,104,2,0,"P.C.P.E.",0
2,"2012",1834,1632,1622,12,10,"P.C.P.E.",0
46,"46214",15129,11609,11500,116,109,"P.C.P.E.",8
50,"50202",182,125,122,2,3,"P.C.P.E.",0
15,"15085",3576,2656,2612,29,44,"P.C.P.E.",3
24,"24134",3682,2636,2588,44,48,"P.C.P.E.",8
2,"2085",345,288,284,2,4,"P.C.P.E.",0
3,"3099",41561,32556,32248,288,308,"P.C.P.E.",78
24,"24055",747,557,549,11,8,"P.C.P.E.",1
13,"13053",14718,10958,10766,159,192,"P.C.P.E.",10
3,"3098",526,410,400,6,10,"P.C.P.E.",0
13,"13075",212,161,159,1,2,"P.C.P.E.",0
2,"2021",1114,872,860,7,12,"P.C.P.E.",2
33,"33061",446,260,259,1,1,"P.C.P.E.",1
39,"39095",2292,1824,1801,24,23,"P.C.P.E.",4
46,"46021",23273,17264,17091,163,173,"P.C.P.E.",26
41,"41016",6950,5194,5120,45,74,"P.C.P.E.",3
29,"29047",1165,973,969,0,4,"P.C.P.E.",2
13,"13065",3011,2105,2088,24,17,"P.C.P.E.",3
2,"2014",390,333,326,5,7,"P.C.P.E.",0
46,"46045",1288,1065,1044,2,21,"P.C.P.E.",1
22,"22197",504,395,390,7,5,"P.C.P.E.",1
18,"18030",612,457,456,0,1,"P.C.P.E.",3
24,"24218",476,344,340,11,4,"P.C.P.E.",1
47,"47056",90,69,69,2,0,"P.C.P.E.",0
50,"50057",1468,1022,1004,17,18,"P.C.P.E.",3
22,"22109",243,178,178,2,0,"P.C.P.E.",0
33,"33012",5341,3816,3777,43,39,"P.C.P.E.",4
26,"26032",58,52,52,1,0,"P.C.P.E.",0
35,"35009",19678,13799,13442,155,357,"P.C.P.E.",36
47,"47200",91,73,73,0,0,"P.C.P.E.",0
26,"26088",48,41,41,0,0,"P.C.P.E.",0
18,"18910",832,601,594,6,7,"P.C.P.E.",2
3,"3012",1021,870,862,3,8,"P.C.P.E.",3
15,"15003",1936,1400,1382,19,18,"P.C.P.E.",1
24,"24109",1098,672,663,12,9,"P.C.P.E.",2
45,"45006",1524,1128,1110,13,18,"P.C.P.E.",0
14,"14028",333,279,277,1,2,"P.C.P.E.",0
22,"22126",100,81,80,2,1,"P.C.P.E.",0
15,"15051",4780,3333,3289,61,44,"P.C.P.E.",3
50,"50048",43,33,33,1,0,"P.C.P.E.",0
22,"22018",357,272,271,4,1,"P.C.P.E.",4
24,"24059",956,592,585,9,7,"P.C.P.E.",2
29,"29021",153,113,113,0,0,"P.C.P.E.",0
24,"24139",2320,1687,1654,16,33,"P.C.P.E.",2
29,"29030",839,669,668,5,1,"P.C.P.E.",0
24,"24191",112,88,88,1,0,"P.C.P.E.",1
22,"22111",180,126,125,3,1,"P.C.P.E.",1
3,"3013",1144,941,926,5,15,"P.C.P.E.",1
50,"50128",36,30,29,0,1,"P.C.P.E.",0
38,"38042",3876,2850,2809,24,41,"P.C.P.E.",4
18,"18016",339,254,253,2,1,"P.C.P.E.",1
22,"22158",11978,8404,8279,149,125,"P.C.P.E.",35
46,"46226",34,34,33,0,1,"P.C.P.E.",0
45,"45023",1936,1476,1456,18,20,"P.C.P.E.",3
47,"47221",115,102,102,0,0,"P.C.P.E.",1
47,"47035",956,778,768,5,10,"P.C.P.E.",1
46,"46145",21751,16601,16397,155,204,"P.C.P.E.",11
46,"46169",31753,24041,23802,270,239,"P.C.P.E.",31
15,"15090",1267,959,953,4,6,"P.C.P.E.",2
26,"26075",377,297,289,4,8,"P.C.P.E.",4
24,"24142",24843,17695,17371,409,324,"P.C.P.E.",38
18,"18013",4392,3268,3223,23,45,"P.C.P.E.",2
39,"39043",1321,1082,1072,8,10,"P.C.P.E.",0
38,"38010",4054,2642,2599,17,43,"P.C.P.E.",4
38,"38032",13032,8487,8357,101,130,"P.C.P.E.",17
41,"41042",5902,4572,4509,37,63,"P.C.P.E.",2
35,"35011",23140,15550,15320,199,230,"P.C.P.E.",76
24,"24062",151,107,107,0,0,"P.C.P.E.",0
18,"18014",5667,4132,4085,43,47,"P.C.P.E.",3
24,"24224",665,490,484,8,6,"P.C.P.E.",1
47,"47124",435,364,358,5,6,"P.C.P.E.",1
47,"47168",32,29,28,1,1,"P.C.P.E.",0
22,"22039",920,721,710,12,11,"P.C.P.E.",2
50,"50088",337,273,264,4,9,"P.C.P.E.",0
2,"2068",379,290,284,3,6,"P.C.P.E.",0
22,"22008",194,168,167,11,1,"P.C.P.E.",1
30,"30005",29081,22312,22142,184,170,"P.C.P.E.",19
29,"29033",1385,878,868,4,10,"P.C.P.E.",2
29,"29015",31805,22566,22347,272,219,"P.C.P.E.",34
24,"24169",3205,2317,2282,33,35,"P.C.P.E.",6
18,"18114",678,508,508,6,0,"P.C.P.E.",0
50,"50032",330,233,228,3,5,"P.C.P.E.",0
24,"24037",429,282,277,4,5,"P.C.P.E.",0
46,"46074",2656,2071,2053,22,18,"P.C.P.E.",4
2,"2044",1207,908,893,5,15,"P.C.P.E.",0
18,"18170",377,238,237,0,1,"P.C.P.E.",0
29,"29024",414,271,261,6,10,"P.C.P.E.",1
46,"46147",16527,11836,11716,105,120,"P.C.P.E.",14
33,"33055",1589,1212,1192,16,20,"P.C.P.E.",0
24,"24112",323,230,228,0,2,"P.C.P.E.",0
29,"29034",462,360,357,0,3,"P.C.P.E.",0
50,"50039",580,450,446,3,4,"P.C.P.E.",2
36,"36040",2627,1938,1907,24,31,"P.C.P.E.",0
50,"50011",131,113,113,8,0,"P.C.P.E.",0
50,"50294",77,58,57,0,1,"P.C.P.E.",0
22,"22102",194,152,149,4,3,"P.C.P.E.",0
46,"46250",574266,435877,431619,4626,4258,"P.C.P.E.",501
22,"22173",247,150,150,3,0,"P.C.P.E.",2
14,"14054",13632,10857,10652,194,205,"P.C.P.E.",15
15,"15009",11109,8179,8014,129,165,"P.C.P.E.",8
22,"22223",92,65,64,3,1,"P.C.P.E.",1
14,"14034",367,301,292,1,9,"P.C.P.E.",0
3,"3903",2431,1991,1960,18,31,"P.C.P.E.",4
47,"47062",185,153,153,5,0,"P.C.P.E.",0
46,"46075",166,148,145,3,3,"P.C.P.E.",0
15,"15065",7570,5710,5628,71,82,"P.C.P.E.",4
29,"29063",358,272,271,2,1,"P.C.P.E.",2
47,"47154",168,144,144,7,0,"P.C.P.E.",0
36,"36007",1778,1258,1238,2,20,"P.C.P.E.",1
3,"3074",1752,1479,1466,5,13,"P.C.P.E.",2
3,"3063",25410,18205,17989,208,216,"P.C.P.E.",61
3,"3109",2745,2332,2302,18,30,"P.C.P.E.",3
13,"13030",153,123,123,1,0,"P.C.P.E.",0
24,"24161",307,231,228,1,3,"P.C.P.E.",0
13,"13041",298,225,225,1,0,"P.C.P.E.",0
46,"46124",768,641,632,10,9,"P.C.P.E.",0
29,"29064",584,428,422,4,6,"P.C.P.E.",1
29,"29071",915,601,598,4,3,"P.C.P.E.",0
46,"46076",651,541,528,2,13,"P.C.P.E.",1
26,"26042",852,660,651,11,9,"P.C.P.E.",3
50,"50211",277,193,193,1,0,"P.C.P.E.",0
24,"24187",881,664,659,14,5,"P.C.P.E.",3
18,"18018",658,520,514,4,6,"P.C.P.E.",0
26,"26043",397,313,306,6,7,"P.C.P.E.",2
45,"45137",1610,1057,1047,11,10,"P.C.P.E.",5
50,"50036",103,81,80,2,1,"P.C.P.E.",0
13,"13097",2309,1843,1825,20,18,"P.C.P.E.",2
33,"33018",2971,2139,2121,32,18,"P.C.P.E.",1
38,"38053",3752,2459,2397,28,62,"P.C.P.E.",2
18,"18025",326,242,238,0,4,"P.C.P.E.",0
29,"29072",3258,2484,2447,30,37,"P.C.P.E.",1
22,"22133",123,87,85,2,2,"P.C.P.E.",0
29,"29059",2551,1986,1964,11,22,"P.C.P.E.",1
45,"45036",704,559,537,4,22,"P.C.P.E.",1
22,"22128",203,164,161,7,3,"P.C.P.E.",0
33,"33003",737,475,471,6,4,"P.C.P.E.",0
47,"47156",182,155,148,0,7,"P.C.P.E.",0
13,"13032",1218,926,922,9,4,"P.C.P.E.",2
46,"46126",5471,4454,4392,53,62,"P.C.P.E.",7
14,"14047",1566,1154,1143,19,11,"P.C.P.E.",1
30,"30901",10113,8265,8194,70,71,"P.C.P.E.",9
39,"39102",2330,1748,1731,13,17,"P.C.P.E.",1
46,"46199",5661,4328,4280,38,48,"P.C.P.E.",0
41,"41074",3079,2406,2386,14,20,"P.C.P.E.",2
26,"26087",222,180,178,5,2,"P.C.P.E.",1
15,"15069",7019,5036,4938,85,98,"P.C.P.E.",5
26,"26175",57,46,45,1,1,"P.C.P.E.",0
18,"18086",397,321,321,3,0,"P.C.P.E.",0
14,"14068",581,460,457,7,3,"P.C.P.E.",0
15,"15078",78092,56506,55597,1110,909,"P.C.P.E.",75
24,"24902",375,292,289,1,3,"P.C.P.E.",0
3,"3100",540,448,443,2,5,"P.C.P.E.",0
26,"26005",2251,1602,1580,18,22,"P.C.P.E.",0
50,"50185",150,109,109,2,0,"P.C.P.E.",1
46,"46078",28197,20643,20415,205,228,"P.C.P.E.",45
22,"22228",501,382,369,15,13,"P.C.P.E.",1
46,"46224",179,131,128,0,3,"P.C.P.E.",0
45,"45018",445,332,322,4,10,"P.C.P.E.",2
26,"26163",143,118,116,2,2,"P.C.P.E.",0
18,"18063",1189,795,789,7,6,"P.C.P.E.",2
45,"45141",981,815,790,6,25,"P.C.P.E.",0
24,"24044",176,138,136,2,2,"P.C.P.E.",1
24,"24153",253,201,199,4,2,"P.C.P.E.",0
14,"14069",7733,5910,5824,68,86,"P.C.P.E.",11
18,"18911",6796,4923,4867,74,56,"P.C.P.E.",9
3,"3067",94,81,79,1,2,"P.C.P.E.",0
41,"41043",647,457,454,5,3,"P.C.P.E.",0
50,"50062",1750,1298,1275,22,23,"P.C.P.E.",3
30,"30031",560,471,469,3,2,"P.C.P.E.",2
50,"50008",5110,3458,3406,56,52,"P.C.P.E.",13
39,"39086",386,282,280,1,2,"P.C.P.E.",1
22,"22007",863,636,621,8,15,"P.C.P.E.",2
46,"46107",1998,1650,1623,8,27,"P.C.P.E.",1
39,"39034",289,209,209,3,0,"P.C.P.E.",0
18,"18159",1051,873,869,4,4,"P.C.P.E.",4
46,"46177",4594,3576,3523,29,53,"P.C.P.E.",2
26,"26091",165,139,139,0,0,"P.C.P.E.",1
15,"15015",2840,2006,1964,43,42,"P.C.P.E.",1
26,"26008",1909,1544,1527,19,17,"P.C.P.E.",0
29,"29060",775,573,572,1,1,"P.C.P.E.",1
13,"13904",556,448,441,14,7,"P.C.P.E.",2
11,"11003",1290,952,940,8,12,"P.C.P.E.",0
24,"24194",327,237,236,5,1,"P.C.P.E.",0
26,"26009",426,318,313,4,5,"P.C.P.E.",0
18,"18089",15803,10794,10712,95,82,"P.C.P.E.",3
22,"22186",217,173,173,3,0,"P.C.P.E.",0
36,"36015",4379,3151,3101,38,50,"P.C.P.E.",6
50,"50041",21,13,13,0,0,"P.C.P.E.",0
22,"22130",9983,6691,6573,148,118,"P.C.P.E.",17
13,"13070",769,653,640,1,13,"P.C.P.E.",0
50,"50089",6673,4936,4877,120,59,"P.C.P.E.",6
46,"46154",836,684,678,7,6,"P.C.P.E.",1
39,"39018",4077,3212,3160,44,52,"P.C.P.E.",9
50,"50119",997,740,720,13,20,"P.C.P.E.",0
50,"50099",3136,2333,2297,27,36,"P.C.P.E.",2
35,"35021",14982,9948,9749,138,199,"P.C.P.E.",34
50,"50110",424,315,314,6,1,"P.C.P.E.",1
35,"35029",3981,2341,2315,43,26,"P.C.P.E.",3
30,"30030",305669,236235,234391,2112,1844,"P.C.P.E.",264
24,"24170",2006,1410,1394,14,16,"P.C.P.E.",0
50,"50071",134,97,96,0,1,"P.C.P.E.",0
36,"36016",1373,865,853,7,12,"P.C.P.E.",0
18,"18905",12975,9260,9209,155,51,"P.C.P.E.",16
29,"29005",4307,2967,2951,18,16,"P.C.P.E.",2
26,"26052",181,146,146,0,0,"P.C.P.E.",0
46,"46012",930,698,684,9,14,"P.C.P.E.",0
2,"2073",4924,3923,3847,76,76,"P.C.P.E.",11
22,"22045",104,83,80,2,3,"P.C.P.E.",0
35,"35001",4663,3639,3569,39,70,"P.C.P.E.",2
41,"41102",14343,11050,10837,206,213,"P.C.P.E.",7
47,"47061",266,227,223,0,4,"P.C.P.E.",0
45,"45192",2549,2178,2155,39,23,"P.C.P.E.",3
46,"46114",565,501,495,3,6,"P.C.P.E.",0
45,"45008",158,129,127,0,2,"P.C.P.E.",0
45,"45184",219,150,148,3,2,"P.C.P.E.",0
29,"29053",1715,1239,1221,7,18,"P.C.P.E.",0
46,"46904",782,659,650,6,9,"P.C.P.E.",1
47,"47179",408,315,306,6,9,"P.C.P.E.",0
35,"35022",43892,27289,26876,326,413,"P.C.P.E.",69
50,"50248",552,421,407,5,14,"P.C.P.E.",2
46,"46258",2792,2196,2164,14,32,"P.C.P.E.",3
39,"39090",731,577,572,3,5,"P.C.P.E.",0
50,"50142",45,25,24,0,1,"P.C.P.E.",0
13,"13084",973,800,793,6,7,"P.C.P.E.",0
33,"33001",1772,984,971,14,13,"P.C.P.E.",1
50,"50044",259,175,175,0,0,"P.C.P.E.",0
41,"41036",4053,2930,2899,29,31,"P.C.P.E.",0
45,"45099",3449,2451,2405,22,46,"P.C.P.E.",4
35,"35023",11640,8412,8178,97,234,"P.C.P.E.",10
26,"26014",472,358,353,6,5,"P.C.P.E.",1
46,"46148",1400,1131,1114,13,17,"P.C.P.E.",2
47,"47189",164,134,134,1,0,"P.C.P.E.",0
30,"30007",6115,4651,4603,29,48,"P.C.P.E.",3
22,"22157",251,176,175,9,1,"P.C.P.E.",0
24,"24026",1304,1015,1001,17,14,"P.C.P.E.",1
26,"26099",1281,1050,1025,19,25,"P.C.P.E.",0
3,"3097",973,791,779,6,12,"P.C.P.E.",3
33,"33078",159,108,106,1,2,"P.C.P.E.",0
46,"46020",3793,3084,3046,21,38,"P.C.P.E.",1
3,"3122",40476,29591,29265,341,326,"P.C.P.E.",69
30,"30034",1182,956,943,3,13,"P.C.P.E.",1
15,"15020",4187,2802,2781,18,21,"P.C.P.E.",3
46,"46133",686,572,565,1,7,"P.C.P.E.",2
41,"41055",15121,11082,10997,98,85,"P.C.P.E.",7
33,"33022",992,709,696,12,13,"P.C.P.E.",2
47,"47163",315,253,250,2,3,"P.C.P.E.",2
36,"36005",8231,5985,5873,84,112,"P.C.P.E.",3
50,"50256",90,59,59,1,0,"P.C.P.E.",0
18,"18182",1982,1405,1397,6,8,"P.C.P.E.",1
13,"13096",7716,5759,5659,70,100,"P.C.P.E.",4
33,"33030",921,682,668,4,14,"P.C.P.E.",2
15,"15061",6105,4391,4307,64,84,"P.C.P.E.",3
50,"50284",176,131,130,1,1,"P.C.P.E.",0
3,"3127",399,336,322,3,14,"P.C.P.E.",0
3,"3058",4798,4126,4103,26,23,"P.C.P.E.",6
22,"22902",240,169,169,3,0,"P.C.P.E.",2
22,"22087",85,56,55,4,1,"P.C.P.E.",0
29,"29084",28386,19450,19202,296,248,"P.C.P.E.",33
45,"45040",1504,1058,1046,5,12,"P.C.P.E.",2
18,"18120",274,238,237,2,1,"P.C.P.E.",0
18,"18901",583,374,368,3,6,"P.C.P.E.",0
47,"47129",954,744,731,4,13,"P.C.P.E.",1
50,"50075",89,74,74,1,0,"P.C.P.E.",0
22,"22245",329,261,257,3,4,"P.C.P.E.",1
26,"26059",1137,887,869,9,18,"P.C.P.E.",0
45,"45054",4285,3321,3274,32,47,"P.C.P.E.",1
29,"29010",1703,1411,1377,7,34,"P.C.P.E.",1
13,"13022",403,314,314,2,0,"P.C.P.E.",0
46,"46240",226,188,185,3,3,"P.C.P.E.",0
22,"22141",129,103,102,3,1,"P.C.P.E.",0
18,"18021",16026,11376,11219,186,157,"P.C.P.E.",16
15,"15002",21528,15479,15218,314,261,"P.C.P.E.",8
46,"46151",717,596,589,3,7,"P.C.P.E.",0
38,"38051",7081,5298,5229,64,69,"P.C.P.E.",8
47,"47068",41,28,28,0,0,"P.C.P.E.",0
47,"47178",190,162,161,1,1,"P.C.P.E.",0
46,"46030",800,677,662,6,15,"P.C.P.E.",0
24,"24207",320,274,272,5,2,"P.C.P.E.",0
22,"22110",822,602,588,3,14,"P.C.P.E.",0
3,"3124",482,420,415,7,5,"P.C.P.E.",0
13,"13078",9291,7062,6993,92,69,"P.C.P.E.",7
50,"50030",232,164,160,1,4,"P.C.P.E.",0
15,"15060",5599,4139,4069,82,70,"P.C.P.E.",3
39,"39040",4350,3413,3373,30,40,"P.C.P.E.",3
47,"47025",127,103,103,0,0,"P.C.P.E.",0
36,"36031",572,484,479,5,5,"P.C.P.E.",0
26,"26070",203,179,177,3,2,"P.C.P.E.",0
26,"26048",29,27,26,1,1,"P.C.P.E.",0
26,"26134",102,82,80,2,2,"P.C.P.E.",0
45,"45204",621,500,497,1,3,"P.C.P.E.",1
47,"47087",376,320,315,7,5,"P.C.P.E.",0
18,"18154",1062,770,769,0,1,"P.C.P.E.",0
22,"22155",89,67,67,2,0,"P.C.P.E.",0
13,"13050",533,427,421,3,6,"P.C.P.E.",1
36,"36057",236900,168990,166060,2833,2930,"P.C.P.E.",267
46,"46048",3484,2915,2875,26,40,"P.C.P.E.",14
18,"18002",625,505,504,2,1,"P.C.P.E.",1
47,"47102",302,250,248,3,2,"P.C.P.E.",4
30,"30020",5989,4533,4487,14,46,"P.C.P.E.",7
36,"36036",2616,1981,1948,24,33,"P.C.P.E.",3
29,"29087",409,306,305,3,1,"P.C.P.E.",0
46,"46162",1230,1045,1027,6,18,"P.C.P.E.",2
26,"26107",97,79,79,1,0,"P.C.P.E.",0
47,"47103",277,218,214,1,4,"P.C.P.E.",0
30,"30013",7369,5780,5731,53,49,"P.C.P.E.",8
18,"18167",1927,1397,1380,13,17,"P.C.P.E.",3
26,"26023",505,386,380,6,6,"P.C.P.E.",0
45,"45009",588,430,422,2,8,"P.C.P.E.",2
18,"18123",307,239,238,1,1,"P.C.P.E.",0
50,"50031",167,105,103,0,2,"P.C.P.E.",0
36,"36004",10264,7383,7263,80,120,"P.C.P.E.",2
18,"18173",8858,6238,6187,64,51,"P.C.P.E.",7
39,"39047",1987,1495,1482,9,13,"P.C.P.E.",4
22,"22193",318,266,264,7,2,"P.C.P.E.",0
45,"45038",3125,2401,2374,33,27,"P.C.P.E.",6
15,"15016",5135,3816,3771,22,45,"P.C.P.E.",4
39,"39001",2146,1669,1645,20,24,"P.C.P.E.",1
50,"50255",219,150,148,1,2,"P.C.P.E.",0
33,"33067",802,650,639,12,11,"P.C.P.E.",0
24,"24090",366,225,224,2,1,"P.C.P.E.",1
14,"14042",18991,14726,14495,290,231,"P.C.P.E.",31
2,"2032",323,261,259,1,2,"P.C.P.E.",0
45,"45195",2229,1806,1784,11,22,"P.C.P.E.",3
46,"46095",632,505,495,1,10,"P.C.P.E.",5
15,"15011",15507,10935,10751,123,184,"P.C.P.E.",19
3,"3043",2933,2494,2447,27,47,"P.C.P.E.",4
24,"24107",316,208,206,1,2,"P.C.P.E.",0
24,"24145",656,420,420,11,0,"P.C.P.E.",0
26,"26168",5055,3534,3484,47,50,"P.C.P.E.",18
13,"13072",803,638,633,13,5,"P.C.P.E.",1
22,"22182",271,160,150,4,10,"P.C.P.E.",1
38,"38045",4181,2176,2140,13,36,"P.C.P.E.",1
24,"24020",480,326,324,9,2,"P.C.P.E.",0
50,"50002",166,130,130,2,0,"P.C.P.E.",0
3,"3096",5863,4550,4457,57,93,"P.C.P.E.",19
39,"39046",1442,1071,1050,13,21,"P.C.P.E.",0
29,"29044",866,631,627,3,4,"P.C.P.E.",0
33,"33054",1780,1272,1263,8,9,"P.C.P.E.",2
15,"15056",5873,4205,4150,63,55,"P.C.P.E.",3
22,"22068",79,51,51,2,0,"P.C.P.E.",2
3,"3073",219,199,199,0,0,"P.C.P.E.",0
11,"11034",2381,1807,1784,19,23,"P.C.P.E.",1
14,"14024",1926,1557,1527,14,30,"P.C.P.E.",3
30,"30042",1841,1531,1519,10,12,"P.C.P.E.",1
15,"15084",3681,2676,2656,34,20,"P.C.P.E.",2
47,"47117",306,231,228,4,3,"P.C.P.E.",0
41,"41095",40097,27969,27731,354,238,"P.C.P.E.",44
3,"3062",206,175,175,0,0,"P.C.P.E.",0
11,"11016",14611,9848,9774,114,74,"P.C.P.E.",12
47,"47097",345,291,289,7,2,"P.C.P.E.",0
36,"36008",21702,15366,15037,261,329,"P.C.P.E.",33
47,"47228",481,385,383,3,2,"P.C.P.E.",0
39,"39067",901,628,623,1,5,"P.C.P.E.",3
45,"45067",2385,1923,1878,19,45,"P.C.P.E.",2
13,"13004",1130,937,923,6,14,"P.C.P.E.",0
50,"50164",407,271,268,4,3,"P.C.P.E.",0
45,"45064",3801,2987,2953,38,34,"P.C.P.E.",1
46,"46205",14277,10882,10764,115,118,"P.C.P.E.",9
26,"26113",35,31,31,1,0,"P.C.P.E.",0
50,"50230",1295,914,903,13,11,"P.C.P.E.",2
22,"22208",168,136,133,2,3,"P.C.P.E.",0
47,"47217",1812,1395,1377,20,18,"P.C.P.E.",6
26,"26030",12,12,12,0,0,"P.C.P.E.",0
22,"22235",101,88,87,1,1,"P.C.P.E.",0
46,"46111",10589,7823,7710,94,113,"P.C.P.E.",11
24,"24041",602,403,396,3,7,"P.C.P.E.",2
46,"46206",595,497,495,3,2,"P.C.P.E.",0
24,"24106",340,229,228,6,1,"P.C.P.E.",0
38,"38037",13166,8509,8332,65,177,"P.C.P.E.",8
47,"47036",257,212,212,1,0,"P.C.P.E.",0
14,"14053",6040,4455,4376,78,79,"P.C.P.E.",39
24,"24073",521,385,382,4,3,"P.C.P.E.",0
29,"29080",6598,4703,4663,31,40,"P.C.P.E.",12
46,"46245",478,357,354,1,3,"P.C.P.E.",0
29,"29022",202,142,141,2,1,"P.C.P.E.",0
47,"47046",124,105,103,0,2,"P.C.P.E.",0
15,"15021",5114,3527,3475,77,52,"P.C.P.E.",2
47,"47082",816,664,661,10,3,"P.C.P.E.",1
24,"24029",840,590,579,11,11,"P.C.P.E.",0
50,"50018",973,761,755,12,6,"P.C.P.E.",0
3,"3033",127,102,97,2,5,"P.C.P.E.",0
50,"50175",1088,742,732,10,10,"P.C.P.E.",1
11,"11018",1528,1194,1178,9,16,"P.C.P.E.",0
15,"15087",6054,4004,3956,79,48,"P.C.P.E.",2
35,"35008",6151,4514,4419,59,95,"P.C.P.E.",4
24,"24189",5410,3630,3572,83,58,"P.C.P.E.",8
18,"18108",892,674,673,2,1,"P.C.P.E.",0
3,"3112",684,566,561,4,5,"P.C.P.E.",0
50,"50125",421,284,280,1,4,"P.C.P.E.",0
46,"46119",856,702,693,0,9,"P.C.P.E.",0
50,"50028",120,86,85,2,1,"P.C.P.E.",0
3,"3104",26809,20511,20193,317,318,"P.C.P.E.",50
47,"47089",184,139,138,1,1,"P.C.P.E.",0
30,"30015",18792,14453,14336,120,117,"P.C.P.E.",32
46,"46140",379,314,313,0,1,"P.C.P.E.",0
26,"26010",98,82,79,1,3,"P.C.P.E.",0
29,"29074",818,631,630,3,1,"P.C.P.E.",1
38,"38018",4397,3216,3163,27,53,"P.C.P.E.",1
50,"50167",235,191,184,1,7,"P.C.P.E.",0
14,"14049",16358,12577,12478,137,99,"P.C.P.E.",13
39,"39033",604,480,473,3,7,"P.C.P.E.",0
24,"24178",83,67,67,2,0,"P.C.P.E.",0
46,"46217",912,758,751,4,7,"P.C.P.E.",1
45,"45010",471,374,372,2,2,"P.C.P.E.",0
14,"14008",2905,2226,2200,18,26,"P.C.P.E.",0
18,"18105",5222,3866,3839,32,27,"P.C.P.E.",12
50,"50026",459,360,354,5,6,"P.C.P.E.",1
2,"2057",2138,1736,1712,30,24,"P.C.P.E.",4
22,"22049",88,70,69,5,1,"P.C.P.E.",0
50,"50296",417,313,310,6,3,"P.C.P.E.",0
18,"18124",387,270,267,0,3,"P.C.P.E.",0
50,"50224",70,52,49,2,3,"P.C.P.E.",0
47,"47066",1114,891,888,10,3,"P.C.P.E.",0
24,"24064",1532,1128,1107,17,21,"P.C.P.E.",3
13,"13091",570,484,478,0,6,"P.C.P.E.",1
46,"46056",203,164,160,2,4,"P.C.P.E.",0
24,"24100",760,563,553,14,10,"P.C.P.E.",1
33,"33059",5049,3480,3447,37,33,"P.C.P.E.",8
24,"24155",524,428,420,6,8,"P.C.P.E.",0
22,"22165",515,409,403,9,6,"P.C.P.E.",4
3,"3081",1409,1102,1087,14,15,"P.C.P.E.",3
36,"36003",9876,7155,7007,100,148,"P.C.P.E.",13
3,"3070",1962,1582,1552,8,30,"P.C.P.E.",0
22,"22113",512,357,353,8,4,"P.C.P.E.",0
18,"18178",834,685,683,3,2,"P.C.P.E.",0
2,"2018",922,759,754,7,5,"P.C.P.E.",0
46,"46073",1119,931,915,14,16,"P.C.P.E.",0
18,"18913",827,653,646,2,7,"P.C.P.E.",3
14,"14021",259993,183200,181402,2936,1798,"P.C.P.E.",326
47,"47032",161,130,129,3,1,"P.C.P.E.",0
50,"50054",63,46,46,0,0,"P.C.P.E.",0
13,"13088",649,531,526,3,5,"P.C.P.E.",0
24,"24057",1459,1121,1092,16,29,"P.C.P.E.",3
50,"50203",1083,814,798,28,16,"P.C.P.E.",4
39,"39099",2987,2416,2391,28,25,"P.C.P.E.",2
14,"14072",1169,925,922,5,3,"P.C.P.E.",0
47,"47104",2917,2391,2357,31,34,"P.C.P.E.",4
24,"24196",2183,1573,1543,11,30,"P.C.P.E.",5
26,"26064",2341,1770,1749,26,21,"P.C.P.E.",4
33,"33007",1680,1186,1179,10,7,"P.C.P.E.",0
18,"18068",1456,1105,1088,13,17,"P.C.P.E.",2
38,"38033",3987,2696,2656,23,40,"P.C.P.E.",2
47,"47127",150,110,108,0,2,"P.C.P.E.",1
13,"13082",25643,17973,17798,257,175,"P.C.P.E.",18
29,"29055",1837,1478,1454,12,24,"P.C.P.E.",0
50,"50027",260,209,202,2,7,"P.C.P.E.",1
39,"39065",272,199,197,2,2,"P.C.P.E.",0
45,"45146",117,99,98,0,1,"P.C.P.E.",0
39,"39045",410,324,323,5,1,"P.C.P.E.",0
2,"2005",602,490,488,2,2,"P.C.P.E.",2
46,"46180",715,585,581,4,4,"P.C.P.E.",1
26,"26025",78,69,69,1,0,"P.C.P.E.",0
41,"41049",8898,6881,6812,95,69,"P.C.P.E.",9
22,"22188",100,68,66,3,2,"P.C.P.E.",0
22,"22011",102,78,78,3,0,"P.C.P.E.",0
50,"50122",68,47,45,2,2,"P.C.P.E.",0
39,"39098",1522,1256,1244,8,12,"P.C.P.E.",0
3,"3007",160,131,127,0,4,"P.C.P.E.",0
3,"3119",15887,12128,11988,122,140,"P.C.P.E.",24
38,"38013",2823,1856,1843,18,13,"P.C.P.E.",3
11,"11901",5576,4433,4398,69,35,"P.C.P.E.",3
38,"38035",8172,4990,4919,62,71,"P.C.P.E.",6
15,"15028",1485,1130,1118,14,12,"P.C.P.E.",4
15,"15093",4562,3314,3270,37,44,"P.C.P.E.",1
45,"45111",65,47,44,1,3,"P.C.P.E.",0
18,"18103",803,653,647,5,6,"P.C.P.E.",0
46,"46011",7727,5874,5777,75,97,"P.C.P.E.",2
47,"47126",49,43,42,1,1,"P.C.P.E.",0
45,"45123",2961,2081,2049,30,32,"P.C.P.E.",2
38,"38043",18628,12966,12763,134,203,"P.C.P.E.",20
47,"47162",80,62,62,1,0,"P.C.P.E.",0
47,"47080",45,39,39,1,0,"P.C.P.E.",0
50,"50295",54,42,41,0,1,"P.C.P.E.",0
45,"45001",1901,1468,1431,14,37,"P.C.P.E.",4
50,"50249",333,280,272,2,8,"P.C.P.E.",1
36,"36019",1681,1204,1188,14,16,"P.C.P.E.",1
45,"45161",11339,7989,7869,95,120,"P.C.P.E.",16
47,"47010",11275,8800,8701,163,99,"P.C.P.E.",13
50,"50183",369,277,274,5,3,"P.C.P.E.",0
47,"47063",107,87,87,2,0,"P.C.P.E.",0
3,"3094",8442,6105,6053,70,52,"P.C.P.E.",6
46,"46168",1828,1461,1449,7,12,"P.C.P.E.",0
14,"14045",3093,2662,2642,14,20,"P.C.P.E.",4
26,"26103",796,616,611,11,5,"P.C.P.E.",4
47,"47090",2511,1907,1880,23,27,"P.C.P.E.",0
38,"38048",3884,2615,2587,34,28,"P.C.P.E.",8
38,"38015",4326,3132,3099,21,33,"P.C.P.E.",5
18,"18908",827,669,660,7,9,"P.C.P.E.",0
15,"15064",2356,1859,1824,35,35,"P.C.P.E.",1
15,"15024",4726,3634,3555,51,79,"P.C.P.E.",5
33,"33043",710,529,528,1,1,"P.C.P.E.",2
14,"14063",1121,875,866,9,9,"P.C.P.E.",0
26,"26149",67,50,49,1,1,"P.C.P.E.",1
47,"47230",318,266,259,2,7,"P.C.P.E.",1
46,"46166",8260,6422,6324,60,98,"P.C.P.E.",11
11,"11027",67042,43386,43065,557,321,"P.C.P.E.",67
47,"47021",84,61,61,2,0,"P.C.P.E.",0
39,"39093",351,260,253,2,7,"P.C.P.E.",0
2,"2063",1537,1252,1242,11,10,"P.C.P.E.",1
50,"50009",122,93,93,0,0,"P.C.P.E.",0
30,"30001",4763,3992,3956,26,36,"P.C.P.E.",3
39,"39049",339,244,242,5,2,"P.C.P.E.",0
45,"45176",3570,2619,2583,45,36,"P.C.P.E.",4
18,"18010",576,464,458,4,6,"P.C.P.E.",2
46,"46005",22815,17016,16838,185,178,"P.C.P.E.",20
45,"45005",267,223,218,4,5,"P.C.P.E.",0
24,"24043",144,77,77,0,0,"P.C.P.E.",0
11,"11028",32224,20706,20482,359,224,"P.C.P.E.",30
18,"18003",13486,10245,10100,145,145,"P.C.P.E.",10
41,"41001",1642,1314,1302,10,12,"P.C.P.E.",0
24,"24176",336,267,261,3,6,"P.C.P.E.",0
13,"13062",595,490,480,4,10,"P.C.P.E.",0
50,"50082",108,73,72,0,1,"P.C.P.E.",0
50,"50013",244,195,195,1,0,"P.C.P.E.",0
26,"26050",114,84,81,1,3,"P.C.P.E.",0
50,"50188",34,28,27,0,1,"P.C.P.E.",0
11,"11004",87610,53062,52639,828,423,"P.C.P.E.",78
50,"50019",79,57,55,1,2,"P.C.P.E.",0
45,"45129",145,121,120,0,1,"P.C.P.E.",0
45,"45190",502,425,414,6,11,"P.C.P.E.",1
36,"36053",5677,4204,4157,51,47,"P.C.P.E.",2
13,"13048",538,441,433,5,8,"P.C.P.E.",3
45,"45153",1704,1376,1353,9,23,"P.C.P.E.",0
50,"50201",466,366,363,7,3,"P.C.P.E.",1
45,"45014",4087,2851,2816,36,35,"P.C.P.E.",5
45,"45101",3761,3212,3181,19,31,"P.C.P.E.",7
24,"24230",450,333,327,4,6,"P.C.P.E.",0
50,"50286",90,73,73,2,0,"P.C.P.E.",0
50,"50005",245,199,195,1,4,"P.C.P.E.",0
50,"50293",492,339,338,6,1,"P.C.P.E.",3
18,"18115",2380,1843,1823,14,20,"P.C.P.E.",2
46,"46064",547,463,458,2,5,"P.C.P.E.",0
45,"45110",1918,1585,1570,10,15,"P.C.P.E.",1
24,"24159",1901,1492,1477,11,15,"P.C.P.E.",0
15,"15052",4567,3539,3493,22,46,"P.C.P.E.",0
41,"41024",22383,15333,15160,213,173,"P.C.P.E.",15
47,"47085",16967,12618,12472,208,146,"P.C.P.E.",13
50,"50118",2312,1737,1718,22,19,"P.C.P.E.",0
29,"29096",2880,2012,1971,28,41,"P.C.P.E.",5
50,"50290",436,334,331,4,3,"P.C.P.E.",0
46,"46153",445,374,366,7,8,"P.C.P.E.",0
38,"38021",1792,1184,1160,6,24,"P.C.P.E.",2
26,"26179",49,39,36,0,3,"P.C.P.E.",0
50,"50012",105,93,90,0,3,"P.C.P.E.",0
13,"13036",837,671,666,3,5,"P.C.P.E.",0
46,"46057",483,357,349,9,8,"P.C.P.E.",0
47,"47024",283,211,210,1,1,"P.C.P.E.",0
36,"36026",20494,14048,13798,232,250,"P.C.P.E.",18
24,"24118",132,96,96,2,0,"P.C.P.E.",0
33,"33057",1635,1150,1132,16,18,"P.C.P.E.",1
18,"18171",2093,1719,1704,10,15,"P.C.P.E.",0
45,"45112",2022,1470,1423,12,47,"P.C.P.E.",2
47,"47094",154,129,127,0,2,"P.C.P.E.",1
22,"22136",908,671,662,11,9,"P.C.P.E.",0
26,"26055",38,32,30,0,2,"P.C.P.E.",0
47,"47208",56,45,43,1,2,"P.C.P.E.",0
50,"50109",101,79,79,2,0,"P.C.P.E.",0
46,"46105",16708,12164,12040,100,124,"P.C.P.E.",4
24,"24010",8550,6242,6111,100,131,"P.C.P.E.",9
26,"26065",57,43,43,0,0,"P.C.P.E.",0
45,"45203",2535,1883,1829,21,54,"P.C.P.E.",2
24,"24015",2391,1812,1782,20,30,"P.C.P.E.",3
46,"46101",868,720,716,8,4,"P.C.P.E.",1
14,"14044",1585,1279,1265,12,14,"P.C.P.E.",1
29,"29025",34637,22545,22354,268,191,"P.C.P.E.",31
24,"24054",492,359,351,1,8,"P.C.P.E.",0
36,"36020",2581,1947,1922,27,25,"P.C.P.E.",0
15,"15057",12467,8936,8744,102,192,"P.C.P.E.",13
22,"22175",211,158,158,9,0,"P.C.P.E.",1
46,"46225",360,319,310,5,9,"P.C.P.E.",0
29,"29076",2022,1384,1374,14,10,"P.C.P.E.",7
50,"50100",355,273,266,3,7,"P.C.P.E.",0
22,"22090",115,82,82,5,0,"P.C.P.E.",0
41,"41041",9646,7901,7791,58,110,"P.C.P.E.",4
41,"41070",5598,4101,4039,79,62,"P.C.P.E.",8
50,"50285",635,452,445,8,7,"P.C.P.E.",2
45,"45205",6333,4544,4451,58,93,"P.C.P.E.",11
47,"47111",1005,804,794,5,10,"P.C.P.E.",0
22,"22206",218,169,167,3,2,"P.C.P.E.",1
13,"13039",14349,10928,10776,149,152,"P.C.P.E.",10
30,"30024",57868,41894,41513,393,381,"P.C.P.E.",79
24,"24184",206,111,111,0,0,"P.C.P.E.",0
47,"47191",113,81,80,1,1,"P.C.P.E.",0
13,"13073",565,459,456,2,3,"P.C.P.E.",0
50,"50200",534,436,432,9,4,"P.C.P.E.",0
29,"29100",2442,1834,1824,14,10,"P.C.P.E.",0
14,"14065",1846,1509,1492,14,17,"P.C.P.E.",0
46,"46108",550,446,444,3,2,"P.C.P.E.",3
41,"41065",23028,15133,14958,191,175,"P.C.P.E.",7
26,"26147",34,29,29,2,0,"P.C.P.E.",0
47,"47210",396,324,321,5,3,"P.C.P.E.",0
46,"46080",1090,860,849,2,11,"P.C.P.E.",2
22,"22149",321,244,241,5,3,"P.C.P.E.",0
38,"38025",6649,4858,4778,52,80,"P.C.P.E.",4
14,"14031",634,516,514,1,2,"P.C.P.E.",0
38,"38022",18671,13075,12890,111,185,"P.C.P.E.",20
22,"22234",818,609,605,12,4,"P.C.P.E.",0
30,"30004",1164,958,952,1,6,"P.C.P.E.",2
41,"41902",4682,3136,3101,34,35,"P.C.P.E.",2
22,"22044",278,195,191,7,4,"P.C.P.E.",1
18,"18902",950,769,762,6,7,"P.C.P.E.",1
47,"47182",1371,991,982,12,9,"P.C.P.E.",2
50,"50102",918,722,713,12,9,"P.C.P.E.",1
24,"24042",79,68,68,0,0,"P.C.P.E.",0
39,"39074",6785,5287,5233,50,54,"P.C.P.E.",4
24,"24202",8677,5486,5377,103,109,"P.C.P.E.",8
24,"24216",782,582,574,3,8,"P.C.P.E.",1
14,"14026",2043,1434,1421,10,13,"P.C.P.E.",1
13,"13086",209,167,166,0,1,"P.C.P.E.",0
14,"14002",10991,8444,8358,106,86,"P.C.P.E.",206
30,"30038",15057,11640,11555,82,85,"P.C.P.E.",19
38,"38023",118865,76393,75039,928,1354,"P.C.P.E.",157
18,"18005",366,279,277,3,2,"P.C.P.E.",2
24,"24167",813,509,509,8,0,"P.C.P.E.",1
22,"22218",49,33,33,1,0,"P.C.P.E.",0
15,"15001",4985,3560,3506,63,54,"P.C.P.E.",4
45,"45021",2399,1834,1804,23,30,"P.C.P.E.",4
39,"39032",1576,1215,1209,10,6,"P.C.P.E.",1
46,"46110",21420,15810,15671,134,139,"P.C.P.E.",23
45,"45041",3617,2672,2635,21,37,"P.C.P.E.",6
46,"46134",2326,1691,1664,20,27,"P.C.P.E.",2
39,"39009",3200,2427,2402,24,25,"P.C.P.E.",2
26,"26058",151,114,109,1,5,"P.C.P.E.",2
13,"13901",945,734,719,6,15,"P.C.P.E.",2
22,"22162",135,107,107,3,0,"P.C.P.E.",2
47,"47030",1075,822,801,13,21,"P.C.P.E.",0
24,"24137",1226,920,904,16,16,"P.C.P.E.",12
50,"50092",329,273,272,0,1,"P.C.P.E.",0
22,"22217",406,314,309,4,5,"P.C.P.E.",1
33,"33036",11674,8695,8605,104,90,"P.C.P.E.",9
22,"22207",135,86,79,4,7,"P.C.P.E.",0
45,"45131",327,262,258,1,4,"P.C.P.E.",1
3,"3004",624,497,486,7,11,"P.C.P.E.",1
26,"26036",16873,12341,12167,190,174,"P.C.P.E.",19
50,"50268",59,46,46,3,0,"P.C.P.E.",0
50,"50045",1289,1011,992,14,19,"P.C.P.E.",1
22,"22200",271,198,191,3,7,"P.C.P.E.",0
11,"11010",6452,4534,4510,61,24,"P.C.P.E.",2
36,"36013",2690,1801,1778,11,23,"P.C.P.E.",3
46,"46181",17153,13332,13184,108,148,"P.C.P.E.",12
38,"38039",10198,7548,7429,78,119,"P.C.P.E.",8
13,"13068",1058,801,793,4,8,"P.C.P.E.",0
46,"46096",320,267,267,0,0,"P.C.P.E.",0
15,"15901",3855,2463,2419,48,44,"P.C.P.E.",0
35,"35006",29515,20731,20286,362,445,"P.C.P.E.",50
45,"45119",3274,2279,2236,37,43,"P.C.P.E.",7
50,"50116",220,154,153,0,1,"P.C.P.E.",0
46,"46063",1764,1441,1423,15,18,"P.C.P.E.",1
46,"46106",1616,1196,1188,6,8,"P.C.P.E.",4
50,"50272",12481,8744,8642,176,102,"P.C.P.E.",39
46,"46218",1082,964,936,5,28,"P.C.P.E.",1
24,"24180",1196,868,862,22,6,"P.C.P.E.",0
22,"22023",474,382,380,4,2,"P.C.P.E.",0
50,"50014",169,108,108,1,0,"P.C.P.E.",1
50,"50025",4569,3319,3271,68,48,"P.C.P.E.",9
33,"33037",37135,25522,25262,291,260,"P.C.P.E.",92
45,"45191",601,506,498,1,8,"P.C.P.E.",2
50,"50108",50,31,31,0,0,"P.C.P.E.",0
45,"45012",683,572,566,10,6,"P.C.P.E.",0
33,"33063",467,367,363,4,4,"P.C.P.E.",0
13,"13080",418,310,309,1,1,"P.C.P.E.",1
26,"26063",131,104,102,2,2,"P.C.P.E.",0
29,"29014",250,152,150,0,2,"P.C.P.E.",0
24,"24049",1528,1144,1124,22,20,"P.C.P.E.",0
47,"47125",55,46,46,0,0,"P.C.P.E.",0
35,"35031",6968,4927,4862,71,65,"P.C.P.E.",5
45,"45017",268,215,212,1,3,"P.C.P.E.",0
50,"50121",297,250,245,6,5,"P.C.P.E.",0
47,"47116",426,363,358,0,5,"P.C.P.E.",1
50,"50105",343,263,259,2,4,"P.C.P.E.",1
46,"46243",149,120,117,0,3,"P.C.P.E.",1
26,"26017",380,277,276,3,1,"P.C.P.E.",0
13,"13095",94,70,70,1,0,"P.C.P.E.",0
18,"18038",1097,906,900,3,6,"P.C.P.E.",4
30,"30025",4780,3901,3874,18,27,"P.C.P.E.",7
50,"50216",267,201,194,8,7,"P.C.P.E.",0
45,"45144",839,701,691,11,10,"P.C.P.E.",3
24,"24132",683,440,435,5,5,"P.C.P.E.",1
3,"3092",6780,5364,5269,96,95,"P.C.P.E.",9
45,"45106",7666,6045,5945,92,100,"P.C.P.E.",12
3,"3015",12241,9734,9636,88,98,"P.C.P.E.",17
22,"22177",101,79,75,1,4,"P.C.P.E.",0
50,"50111",191,141,138,2,3,"P.C.P.E.",0
41,"41089",6394,4593,4526,57,67,"P.C.P.E.",5
15,"15012",3767,2973,2926,51,47,"P.C.P.E.",1
15,"15030",201751,141022,138934,2981,2088,"P.C.P.E.",159
47,"47131",189,145,145,4,0,"P.C.P.E.",0
47,"47119",101,78,77,0,1,"P.C.P.E.",0
13,"13079",12220,9665,9502,177,163,"P.C.P.E.",17
47,"47229",235,161,161,1,0,"P.C.P.E.",0
15,"15072",9868,7077,6951,79,126,"P.C.P.E.",8
36,"36044",2595,1862,1834,23,28,"P.C.P.E.",5
45,"45139",231,198,194,0,4,"P.C.P.E.",0
3,"3139",21796,15501,15320,160,181,"P.C.P.E.",44
22,"22079",126,97,97,4,0,"P.C.P.E.",0
47,"47106",63,52,52,0,0,"P.C.P.E.",0
3,"3040",260,224,220,0,4,"P.C.P.E.",3
24,"24060",660,382,382,0,0,"P.C.P.E.",0
18,"18023",16072,11594,11488,131,106,"P.C.P.E.",17
46,"46141",424,338,336,2,2,"P.C.P.E.",1
22,"22222",510,367,365,6,2,"P.C.P.E.",0
26,"26027",169,126,126,1,0,"P.C.P.E.",0
45,"45062",1161,959,928,8,31,"P.C.P.E.",0
22,"22909",349,259,252,3,7,"P.C.P.E.",0
15,"15014",4239,3151,3104,39,47,"P.C.P.E.",3
45,"45045",1313,992,979,12,13,"P.C.P.E.",2
41,"41050",5102,4224,4183,39,41,"P.C.P.E.",2
22,"22103",697,532,523,10,9,"P.C.P.E.",2
45,"45151",631,474,470,1,4,"P.C.P.E.",1
41,"41076",2227,1507,1492,5,15,"P.C.P.E.",85
46,"46042",3376,2873,2819,17,54,"P.C.P.E.",3
2,"2901",2223,1678,1667,19,11,"P.C.P.E.",4
38,"38031",28391,21797,21431,234,366,"P.C.P.E.",26
22,"22014",265,192,191,1,1,"P.C.P.E.",0
39,"39079",9035,6959,6897,55,62,"P.C.P.E.",7
36,"36033",12323,9328,9150,97,178,"P.C.P.E.",15
26,"26077",15,15,15,1,0,"P.C.P.E.",0
47,"47194",322,244,233,1,11,"P.C.P.E.",0
22,"22248",119,94,92,3,2,"P.C.P.E.",0
14,"14071",1025,739,733,8,6,"P.C.P.E.",2
46,"46061",331,276,273,3,3,"P.C.P.E.",1
24,"24052",178,113,111,0,2,"P.C.P.E.",0
50,"50098",215,150,146,2,4,"P.C.P.E.",1
29,"29086",814,538,536,9,2,"P.C.P.E.",1
46,"46172",4838,3492,3445,24,47,"P.C.P.E.",11
45,"45094",441,358,353,6,5,"P.C.P.E.",0
22,"22057",377,283,278,3,5,"P.C.P.E.",3
26,"26180",243,185,181,4,4,"P.C.P.E.",0
24,"24067",700,453,447,4,6,"P.C.P.E.",1
18,"18078",768,638,637,1,1,"P.C.P.E.",0
2,"2083",246,215,215,0,0,"P.C.P.E.",0
45,"45118",1980,1412,1390,13,22,"P.C.P.E.",2
45,"45103",457,400,394,0,6,"P.C.P.E.",0
22,"22227",225,172,168,3,4,"P.C.P.E.",1
22,"22202",146,120,120,1,0,"P.C.P.E.",0
38,"38046",8848,6410,6301,75,109,"P.C.P.E.",10
33,"33051",7576,5379,5335,65,44,"P.C.P.E.",11
50,"50066",2357,1677,1659,42,18,"P.C.P.E.",1
46,"46118",3883,3141,3105,28,36,"P.C.P.E.",4
3,"3110",294,239,238,0,1,"P.C.P.E.",1
24,"24004",535,391,390,0,1,"P.C.P.E.",0
18,"18907",1997,1627,1612,5,15,"P.C.P.E.",2
3,"3017",380,331,324,7,7,"P.C.P.E.",1
47,"47053",125,100,99,1,1,"P.C.P.E.",0
29,"29057",413,311,308,2,3,"P.C.P.E.",1
22,"22037",115,87,79,0,8,"P.C.P.E.",0
13,"13903",564,461,454,2,7,"P.C.P.E.",1
24,"24061",1713,1223,1210,34,13,"P.C.P.E.",5
26,"26062",94,78,77,1,1,"P.C.P.E.",0
2,"2054",421,346,343,2,3,"P.C.P.E.",0
22,"22024",222,144,139,3,5,"P.C.P.E.",0
33,"33010",1922,1284,1277,14,7,"P.C.P.E.",5
41,"41068",13809,10171,10072,100,99,"P.C.P.E.",6
50,"50077",254,189,188,4,1,"P.C.P.E.",2
36,"36024",17164,12723,12500,163,223,"P.C.P.E.",17
38,"38036",6477,4514,4422,40,92,"P.C.P.E.",18
26,"26004",82,64,64,1,0,"P.C.P.E.",0
24,"24078",426,323,316,0,7,"P.C.P.E.",1
45,"45160",1104,911,896,12,15,"P.C.P.E.",1
45,"45197",1972,1570,1538,8,32,"P.C.P.E.",7
50,"50096",49,35,35,0,0,"P.C.P.E.",0
14,"14051",1392,1148,1130,11,18,"P.C.P.E.",0
45,"45115",2600,2140,2105,14,35,"P.C.P.E.",4
29,"29066",363,263,260,1,3,"P.C.P.E.",0
47,"47038",128,91,91,0,0,"P.C.P.E.",0
26,"26021",2758,2190,2163,21,27,"P.C.P.E.",3
24,"24171",417,231,231,2,0,"P.C.P.E.",0
45,"45004",603,497,494,6,3,"P.C.P.E.",3
46,"46102",19880,15358,15179,122,179,"P.C.P.E.",33
50,"50129",258,164,164,0,0,"P.C.P.E.",1
47,"47147",129,96,96,0,0,"P.C.P.E.",0
2,"2065",517,450,449,4,1,"P.C.P.E.",0
36,"36058",5021,3589,3516,54,73,"P.C.P.E.",3
46,"46053",584,484,461,2,23,"P.C.P.E.",0
22,"22006",319,203,197,5,6,"P.C.P.E.",0
33,"33028",1466,812,806,5,6,"P.C.P.E.",2
13,"13094",338,276,275,2,1,"P.C.P.E.",0
22,"22172",613,463,452,6,11,"P.C.P.E.",1
33,"33049",6806,4629,4581,70,48,"P.C.P.E.",2
18,"18912",1576,1193,1185,7,8,"P.C.P.E.",0
46,"46099",987,764,754,2,10,"P.C.P.E.",1
3,"3089",9696,7447,7302,83,145,"P.C.P.E.",9
18,"18039",3733,2901,2878,18,23,"P.C.P.E.",3
30,"30027",45194,35272,34973,366,299,"P.C.P.E.",65
50,"50169",371,275,274,5,1,"P.C.P.E.",0
26,"26086",18,17,17,0,0,"P.C.P.E.",0
30,"30012",9037,7242,7142,62,100,"P.C.P.E.",12
36,"36043",5188,3435,3390,35,45,"P.C.P.E.",5
15,"15062",6304,4418,4356,44,62,"P.C.P.E.",3
11,"11002",4291,3388,3374,19,14,"P.C.P.E.",4
46,"46136",2476,1890,1865,16,25,"P.C.P.E.",0
24,"24046",1002,704,696,20,8,"P.C.P.E.",0
36,"36054",10862,8201,8087,87,114,"P.C.P.E.",8
46,"46164",11634,8843,8724,90,119,"P.C.P.E.",15
26,"26105",2181,1712,1690,24,22,"P.C.P.E.",1
26,"26092",112,89,88,2,1,"P.C.P.E.",0
39,"39008",13716,10396,10274,129,122,"P.C.P.E.",13
24,"24092",883,707,702,6,5,"P.C.P.E.",1
33,"33041",7488,5356,5309,65,47,"P.C.P.E.",3
18,"18904",858,620,612,3,8,"P.C.P.E.",0
22,"22029",130,99,98,6,1,"P.C.P.E.",0
29,"29037",227,170,170,0,0,"P.C.P.E.",0
29,"29067",420165,273593,271376,3342,2217,"P.C.P.E.",488
26,"26154",12,12,12,3,0,"P.C.P.E.",0
38,"38050",2516,1765,1734,9,31,"P.C.P.E.",3
22,"22094",109,76,74,5,2,"P.C.P.E.",0
46,"46085",11344,8526,8426,87,100,"P.C.P.E.",13
18,"18165",3942,2819,2776,27,43,"P.C.P.E.",8
50,"50094",1744,1220,1193,25,27,"P.C.P.E.",5
46,"46081",10254,8188,8101,52,87,"P.C.P.E.",9
46,"46210",346,300,295,4,5,"P.C.P.E.",0
50,"50251",8379,6225,6116,110,109,"P.C.P.E.",11
45,"45028",3696,3059,3024,40,35,"P.C.P.E.",4
50,"50282",88,66,63,3,3,"P.C.P.E.",0
13,"13013",7141,5682,5564,60,118,"P.C.P.E.",5
22,"22907",1444,1034,1018,12,16,"P.C.P.E.",0
47,"47158",906,716,710,10,6,"P.C.P.E.",0
26,"26145",251,201,199,3,2,"P.C.P.E.",0
22,"22144",258,203,203,5,0,"P.C.P.E.",1
11,"11039",9943,6634,6582,104,52,"P.C.P.E.",6
18,"18903",960,761,753,1,8,"P.C.P.E.",0
26,"26101",46,35,34,0,1,"P.C.P.E.",0
38,"38901",1389,917,907,16,10,"P.C.P.E.",1
24,"24108",421,316,314,6,2,"P.C.P.E.",0
22,"22201",287,203,198,2,5,"P.C.P.E.",0
24,"24021",1791,1251,1228,14,23,"P.C.P.E.",1
22,"22076",331,241,235,3,6,"P.C.P.E.",3
22,"22184",203,172,167,2,5,"P.C.P.E.",0
24,"24032",134,102,101,1,1,"P.C.P.E.",0
39,"39025",8985,7048,6955,70,93,"P.C.P.E.",10
45,"45188",2883,2180,2151,30,29,"P.C.P.E.",5
50,"50166",282,216,210,1,6,"P.C.P.E.",0
46,"46112",582,475,463,4,12,"P.C.P.E.",0
18,"18088",1576,1258,1253,2,5,"P.C.P.E.",2
3,"3091",256,220,219,1,1,"P.C.P.E.",0
50,"50020",868,646,629,5,17,"P.C.P.E.",1
46,"46263",333,243,241,2,2,"P.C.P.E.",0
29,"29029",452,339,336,0,3,"P.C.P.E.",2
3,"3123",7435,5860,5744,63,116,"P.C.P.E.",12
50,"50263",235,160,160,1,0,"P.C.P.E.",1
3,"3055",5128,4121,4076,43,45,"P.C.P.E.",6
2,"2038",296,254,254,1,0,"P.C.P.E.",3
50,"50281",76,63,63,2,0,"P.C.P.E.",0
45,"45114",608,476,468,3,8,"P.C.P.E.",0
26,"26061",1552,1119,1099,31,20,"P.C.P.E.",3
22,"22247",31,21,20,1,1,"P.C.P.E.",0
24,"24096",145,96,93,0,3,"P.C.P.E.",0
29,"29012",9817,7063,6991,51,72,"P.C.P.E.",7
30,"30037",17942,13830,13734,90,96,"P.C.P.E.",22
15,"15049",1211,851,843,7,8,"P.C.P.E.",0
3,"3003",460,382,370,1,12,"P.C.P.E.",1
3,"3077",1411,1146,1130,14,16,"P.C.P.E.",0
50,"50232",176,123,120,5,3,"P.C.P.E.",0
18,"18134",5528,3751,3679,57,72,"P.C.P.E.",10
22,"22244",61,46,44,1,2,"P.C.P.E.",0
46,"46185",422,360,359,7,1,"P.C.P.E.",0
46,"46137",273,232,229,1,3,"P.C.P.E.",0
24,"24124",419,286,282,0,4,"P.C.P.E.",0
22,"22139",86,66,63,2,3,"P.C.P.E.",0
36,"36010",2987,2312,2282,30,30,"P.C.P.E.",2
11,"11008",16655,11309,11189,184,120,"P.C.P.E.",20
47,"47093",865,658,642,11,16,"P.C.P.E.",0
47,"47091",97,82,80,3,2,"P.C.P.E.",0
24,"24163",3706,2760,2714,57,46,"P.C.P.E.",6
21,"21014",4063,3424,3408,27,16,"PCPE",4
21,"21044",17018,11390,11290,132,100,"PCPE",12
21,"21021",11825,7657,7574,108,83,"PCPE",17
28,"28123",48429,38681,38187,429,494,"PCPE",56
21,"21047",1965,1355,1325,17,30,"PCPE",2
28,"28001",61,46,45,1,1,"PCPE",0
21,"21012",331,254,246,2,8,"PCPE",0
28,"28032",4469,3412,3369,32,43,"PCPE",4
21,"21060",11685,8026,7932,135,94,"PCPE",6
28,"28135",928,665,659,6,6,"PCPE",1
28,"28055",932,713,707,5,6,"PCPE",0
28,"28065",118796,93292,92186,919,1106,"PCPE",129
28,"28114",148,110,110,0,0,"PCPE",0
28,"28120",1259,946,931,11,15,"PCPE",0
28,"28166",325,269,268,8,1,"PCPE",0
28,"28049",59507,46919,46379,488,540,"PCPE",68
28,"28089",3531,2786,2753,25,33,"PCPE",2
28,"28172",7648,6130,6076,65,54,"PCPE",4
28,"28090",7899,6216,6131,60,85,"PCPE",3
28,"28066",7033,5439,5383,45,56,"PCPE",3
28,"28058",137542,103880,102686,1155,1194,"PCPE",176
28,"28073",11899,8877,8769,112,108,"PCPE",12
21,"21032",1790,1362,1347,14,15,"PCPE",1
21,"21016",1076,823,790,11,33,"PCPE",0
28,"28152",14903,11954,11865,125,89,"PCPE",4
21,"21069",1778,1245,1242,11,3,"PCPE",1
28,"28046",4208,3297,3272,31,25,"PCPE",3
28,"28158",632,505,495,4,10,"PCPE",1
28,"28086",4603,3286,3248,29,38,"PCPE",4
28,"28051",1469,1147,1129,7,18,"PCPE",1
21,"21024",502,363,358,10,5,"PCPE",1
28,"28150",2985,2363,2345,21,18,"PCPE",11
28,"28005",132097,100509,99506,1069,1003,"PCPE",146
28,"28062",311,233,226,0,7,"PCPE",0
21,"21026",255,181,169,2,12,"PCPE",0
28,"28182",219,179,178,2,1,"PCPE",0
28,"28053",6035,4854,4783,61,71,"PCPE",1
28,"28132",10987,8066,7943,90,123,"PCPE",11
21,"21033",508,385,382,7,3,"PCPE",3
21,"21020",398,282,282,3,0,"PCPE",0
28,"28022",30019,24469,24279,292,190,"PCPE",6
28,"28014",31360,23434,23133,203,301,"PCPE",31
28,"28107",443,338,333,7,5,"PCPE",0
28,"28023",4350,3425,3392,32,33,"PCPE",4
21,"21031",1309,903,871,9,32,"PCPE",0
28,"28072",5232,4065,4007,35,58,"PCPE",2
28,"28084",15408,11489,11355,122,134,"PCPE",18
28,"28004",5761,4098,4044,38,54,"PCPE",3
28,"28109",1621,1121,1104,9,17,"PCPE",0
21,"21001",628,434,428,5,6,"PCPE",3
28,"28181",20003,16133,15952,159,181,"PCPE",5
28,"28903",29222,23945,23689,296,256,"PCPE",18
28,"28168",1144,821,810,15,11,"PCPE",1
21,"21054",8024,6159,6072,67,87,"PCPE",6
28,"28102",913,700,693,9,7,"PCPE",2
21,"21050",12322,8772,8679,99,93,"PCPE",9
21,"21058",2609,1867,1857,15,10,"PCPE",1
28,"28104",11704,9455,9361,119,94,"PCPE",7
28,"28056",782,604,586,6,18,"PCPE",1
28,"28031",1981,1524,1500,9,24,"PCPE",0
28,"28069",51,35,33,1,2,"PCPE",0
28,"28091",5202,3714,3671,34,43,"PCPE",4
28,"28148",79726,60405,59651,724,754,"PCPE",82
28,"28026",5852,4506,4449,40,57,"PCPE",3
21,"21040",3096,2370,2351,28,19,"PCPE",3
21,"21074",2752,1981,1968,15,13,"PCPE",1
28,"28036",2301,1809,1784,13,25,"PCPE",0
28,"28082",5144,3967,3905,46,62,"PCPE",4
21,"21061",5089,3657,3635,33,22,"PCPE",8
21,"21006",3565,2477,2441,29,36,"PCPE",5
21,"21005",15205,11006,10909,108,97,"PCPE",21
28,"28146",1672,1220,1205,4,15,"PCPE",0
28,"28128",366,280,275,2,5,"PCPE",0
28,"28106",72603,53231,52524,681,707,"PCPE",130
28,"28096",16844,12441,12308,117,133,"PCPE",9
21,"21057",1054,699,697,9,2,"PCPE",0
28,"28097",127,94,92,0,2,"PCPE",0
28,"28116",666,507,498,5,9,"PCPE",1
28,"28161",44185,33371,32966,353,405,"PCPE",54
28,"28149",5276,4132,4063,43,69,"PCPE",3
28,"28003",196,154,151,2,3,"PCPE",0
28,"28167",7818,6016,5942,82,74,"PCPE",3
28,"28151",3025,2237,2185,9,52,"PCPE",2
28,"28183",935,663,649,7,14,"PCPE",1
28,"28159",629,482,478,2,4,"PCPE",0
28,"28157",605,452,446,2,6,"PCPE",0
28,"28018",3572,2837,2795,20,42,"PCPE",2
28,"28131",12664,9454,9342,100,112,"PCPE",9
28,"28160",7496,5680,5613,46,67,"PCPE",4
28,"28112",168,138,137,0,1,"PCPE",0
28,"28137",1626,1231,1222,9,9,"PCPE",3
28,"28130",27391,21367,21111,235,256,"PCPE",33
28,"28092",148714,112174,110838,1215,1336,"PCPE",208
28,"28100",3970,2903,2865,32,38,"PCPE",2
21,"21055",6320,4819,4760,46,59,"PCPE",14
21,"21066",522,440,431,4,9,"PCPE",1
28,"28138",78,48,46,0,2,"PCPE",1
21,"21036",213,172,167,1,5,"PCPE",1
28,"28074",136617,106248,105095,1101,1153,"PCPE",195
28,"28108",3002,2254,2228,31,26,"PCPE",2
21,"21059",203,166,162,1,4,"PCPE",0
28,"28076",417,325,321,1,4,"PCPE",0
28,"28164",2807,2194,2173,10,21,"PCPE",3
28,"28071",77,57,55,0,2,"PCPE",0
21,"21018",1821,1283,1273,19,10,"PCPE",0
28,"28095",1358,1092,1077,8,15,"PCPE",1
28,"28080",45696,36832,36529,402,303,"PCPE",17
28,"28117",116,90,90,1,0,"PCPE",0
21,"21023",2106,1471,1456,7,15,"PCPE",4
28,"28165",1689,1310,1295,5,15,"PCPE",0
28,"28180",5179,4033,3975,18,58,"PCPE",3
21,"21010",14308,8960,8861,154,99,"PCPE",22
28,"28163",395,305,301,7,4,"PCPE",0
21,"21063",2624,2109,2097,13,12,"PCPE",0
28,"28011",437,318,315,2,3,"PCPE",0
28,"28007",122891,95200,94139,990,1061,"PCPE",159
21,"21070",6278,4489,4445,42,44,"PCPE",5
21,"21009",916,622,608,6,14,"PCPE",3
28,"28017",1120,905,888,8,17,"PCPE",2
28,"28024",156,132,132,5,0,"PCPE",0
28,"28025",426,336,332,2,4,"PCPE",0
28,"28035",1314,1058,1046,3,12,"PCPE",1
28,"28162",2263,1802,1786,32,16,"PCPE",1
28,"28121",185,153,152,0,1,"PCPE",1
28,"28030",1591,1268,1230,12,38,"PCPE",1
21,"21049",3468,2327,2283,18,44,"PCPE",12
28,"28064",143,112,110,1,2,"PCPE",0
28,"28037",1598,1263,1250,10,13,"PCPE",0
28,"28101",222,158,158,4,0,"PCPE",0
21,"21013",10601,7384,7231,110,153,"PCPE",5
21,"21004",1530,1059,1042,9,17,"PCPE",4
28,"28006",74554,57439,56890,586,549,"PCPE",70
28,"28126",59,37,37,0,0,"PCPE",0
28,"28110",1912,1492,1475,8,17,"PCPE",0
28,"28099",1670,1258,1246,9,12,"PCPE",0
28,"28010",9309,7304,7229,71,75,"PCPE",0
28,"28078",39,23,23,1,0,"PCPE",0
28,"28901",765,579,567,2,12,"PCPE",2
21,"21046",1715,1354,1343,15,11,"PCPE",2
28,"28052",3799,2753,2719,17,34,"PCPE",2
21,"21039",313,233,232,2,1,"PCPE",1
28,"28133",5868,4236,4144,23,92,"PCPE",2
21,"21029",1633,1276,1259,15,17,"PCPE",3
28,"28140",2665,2167,2141,26,26,"PCPE",1
28,"28145",2125,1643,1620,15,23,"PCPE",3
28,"28177",9470,7524,7466,87,58,"PCPE",1
28,"28093",1911,1537,1518,19,19,"PCPE",4
21,"21037",491,386,378,1,8,"PCPE",0
28,"28068",10502,7857,7778,68,79,"PCPE",6
21,"21041",114169,74740,73814,1129,926,"PCPE",121
21,"21077",1690,1335,1321,8,14,"PCPE",2
21,"21056",2992,2172,2096,29,76,"PCPE",7
28,"28127",60108,48418,48039,568,379,"PCPE",18
28,"28113",31318,23779,23436,271,343,"PCPE",30
28,"28174",1745,1233,1224,11,9,"PCPE",0
28,"28039",139,103,103,1,0,"PCPE",0
28,"28154",5232,3910,3860,40,50,"PCPE",4
28,"28147",910,705,698,5,7,"PCPE",0
28,"28054",10459,7798,7698,65,100,"PCPE",5
28,"28129",7219,5536,5461,71,75,"PCPE",3
28,"28122",504,367,366,2,1,"PCPE",0
21,"21051",272,202,201,5,1,"PCPE",0
28,"28134",55921,42676,42221,505,455,"PCPE",54
28,"28083",8037,6078,6025,66,53,"PCPE",14
21,"21038",1146,786,767,9,19,"PCPE",1
28,"28042",1091,814,808,5,6,"PCPE",0
28,"28047",38404,28739,28436,312,303,"PCPE",20
28,"28040",15089,9976,9852,116,124,"PCPE",22
21,"21052",4741,2897,2839,21,58,"PCPE",3
28,"28085",3794,2980,2933,18,47,"PCPE",7
28,"28019",1195,901,888,5,13,"PCPE",1
28,"28029",538,416,414,4,2,"PCPE",0
28,"28044",5403,4245,4188,27,57,"PCPE",2
21,"21043",1898,1382,1350,9,32,"PCPE",4
28,"28176",10977,8790,8718,68,72,"PCPE",2
28,"28048",489,398,389,3,9,"PCPE",0
28,"28043",5944,4199,4147,56,52,"PCPE",0
28,"28050",3576,2706,2663,21,43,"PCPE",3
28,"28115",57612,46786,46458,458,328,"PCPE",23
21,"21019",645,464,458,2,6,"PCPE",1
28,"28179",1385,1039,1027,10,12,"PCPE",0
21,"21030",1757,1448,1426,14,22,"PCPE",4
28,"28144",5663,4456,4410,47,46,"PCPE",2
21,"21053",3278,2363,2325,20,38,"PCPE",3
21,"21075",375,294,291,12,3,"PCPE",1
28,"28012",830,654,651,6,3,"PCPE",0
21,"21022",173,123,123,1,0,"PCPE",1
28,"28009",13466,10392,10286,102,106,"PCPE",7
21,"21072",10233,7829,7666,124,163,"PCPE",31
28,"28067",3893,2996,2950,26,46,"PCPE",5
28,"28008",1734,1244,1221,11,23,"PCPE",1
28,"28079",2290453,1721837,1705310,17342,16527,"PCPE",1662
21,"21008",2717,1994,1978,11,16,"PCPE",2
28,"28015",14491,11562,11417,155,145,"PCPE",12
28,"28063",268,209,203,4,6,"PCPE",0
28,"28124",83,55,53,0,2,"PCPE",0
21,"21071",216,169,169,5,0,"PCPE",0
28,"28061",19624,15082,14905,162,177,"PCPE",11
21,"21042",15246,8640,8572,154,68,"PCPE",9
28,"28153",608,422,406,1,16,"PCPE",0
21,"21011",3531,2672,2639,15,33,"PCPE",4
28,"28075",5127,3976,3916,42,60,"PCPE",4
28,"28094",774,557,551,5,6,"PCPE",0
21,"21079",749,556,553,6,3,"PCPE",1
28,"28088",251,174,173,5,1,"PCPE",0
21,"21025",3969,2731,2686,33,45,"PCPE",2
28,"28045",30286,23148,22879,226,269,"PCPE",28
21,"21035",9657,6943,6871,64,72,"PCPE",10
21,"21045",261,200,200,5,0,"PCPE",1
28,"28141",5568,4097,4051,31,46,"PCPE",3
28,"28136",618,527,516,2,11,"PCPE",0
28,"28059",4061,3169,3130,38,39,"PCPE",4
28,"28033",3581,2712,2691,14,21,"PCPE",0
28,"28171",4148,2972,2929,21,43,"PCPE",3
28,"28087",3150,2475,2453,26,22,"PCPE",6
21,"21064",6331,4390,4352,46,38,"PCPE",4
28,"28060",1471,1205,1192,8,13,"PCPE",0
21,"21067",418,318,312,5,6,"PCPE",2
21,"21048",327,226,226,5,0,"PCPE",0
21,"21068",1009,726,721,10,5,"PCPE",0
28,"28125",2808,2077,2055,19,22,"PCPE",1
28,"28175",780,641,630,8,11,"PCPE",0
28,"28038",4999,3659,3590,32,69,"PCPE",1
21,"21034",1253,875,861,7,14,"PCPE",3
21,"21073",1840,1249,1236,13,13,"PCPE",0
28,"28111",618,486,479,2,7,"PCPE",2
21,"21002",14281,10297,10173,141,124,"PCPE",11
28,"28155",529,427,416,2,11,"PCPE",0
28,"28027",1232,937,919,9,18,"PCPE",1
21,"21003",691,540,536,7,4,"PCPE",0
21,"21015",728,453,447,6,6,"PCPE",0
28,"28173",507,397,390,2,7,"PCPE",0
28,"28143",81,71,67,1,4,"PCPE",0
28,"28013",38226,27886,27547,246,339,"PCPE",35
21,"21078",2865,2085,2066,21,19,"PCPE",4
28,"28057",1419,1084,1074,12,10,"PCPE",2
21,"21017",3581,2416,2389,27,27,"PCPE",20
21,"21076",2108,1647,1628,22,19,"PCPE",4
21,"21028",419,320,315,3,5,"PCPE",0
28,"28070",139,98,97,0,1,"PCPE",0
28,"28169",1244,971,962,8,9,"PCPE",0
28,"28016",86,68,67,3,1,"PCPE",0
28,"28020",145,102,100,0,2,"PCPE",0
28,"28021",418,334,328,4,6,"PCPE",2
28,"28119",1911,1527,1514,13,13,"PCPE",1
28,"28170",2503,1744,1727,20,17,"PCPE",2
28,"28034",356,278,276,1,2,"PCPE",0
21,"21065",295,212,211,0,1,"PCPE",0
28,"28156",958,742,733,12,9,"PCPE",6
28,"28041",4006,3190,3154,45,36,"PCPE",2
21,"21027",67,52,52,0,0,"PCPE",0
28,"28178",1017,799,791,11,8,"PCPE",0
21,"21007",6088,4174,4123,57,51,"PCPE",2
28,"28028",1615,1204,1173,11,31,"PCPE",1
28,"28902",453,338,329,3,9,"PCPE",1
21,"21062",1444,1003,991,7,12,"PCPE",3
28,"28118",72,49,47,1,2,"PCPE",0
28,"28002",2650,2018,1993,24,25,"PCPE",3
9,"9202",26,24,24,1,0,"PCAL",0
9,"9323",71,44,44,2,0,"PCAL",0
9,"9073",889,672,663,12,9,"PCAL",1
9,"9056",4957,3607,3557,70,50,"PCAL",30
34,"34103",105,92,92,5,0,"PCAL",0
34,"34137",31,24,24,3,0,"PCAL",0
9,"9164",179,130,130,1,0,"PCAL",0
9,"9009",167,129,128,8,1,"PCAL",1
34,"34089",173,128,125,5,3,"PCAL",0
9,"9382",33,30,30,0,0,"PCAL",1
9,"9070",38,27,27,3,0,"PCAL",0
34,"34228",93,80,80,0,0,"PCAL",0
34,"34133",108,90,90,0,0,"PCAL",1
9,"9163",642,526,518,3,8,"PCAL",3
9,"9369",460,339,336,4,3,"PCAL",7
9,"9048",1565,1166,1148,20,18,"PCAL",4
9,"9250",295,234,230,5,4,"PCAL",0
9,"9190",97,73,72,0,1,"PCAL",0
9,"9104",56,49,49,0,0,"PCAL",0
9,"9154",150,107,107,3,0,"PCAL",1
9,"9173",135,116,116,1,0,"PCAL",1
34,"34059",462,377,375,5,2,"PCAL",1
9,"9047",62,48,45,0,3,"PCAL",1
34,"34083",1888,1355,1338,15,17,"PCAL",4
9,"9279",195,140,140,4,0,"PCAL",0
34,"34061",116,78,78,2,0,"PCAL",0
34,"34149",26,18,18,0,0,"PCAL",1
9,"9079",49,44,44,1,0,"PCAL",0
9,"9160",104,75,74,0,1,"PCAL",0
9,"9297",326,270,266,7,4,"PCAL",3
34,"34124",70,55,55,1,0,"PCAL",0
9,"9198",115,85,85,1,0,"PCAL",1
9,"9451",244,208,202,1,6,"PCAL",1
34,"34009",34,31,31,3,0,"PCAL",0
34,"34154",78,62,62,0,0,"PCAL",0
9,"9480",106,87,87,0,0,"PCAL",1
34,"34156",56,48,48,2,0,"PCAL",0
9,"9384",310,223,218,3,5,"PCAL",2
9,"9133",39,33,33,1,0,"PCAL",0
34,"34067",142,88,88,3,0,"PCAL",0
34,"34036",211,159,157,0,2,"PCAL",0
9,"9427",1561,1090,1078,18,12,"PCAL",1
9,"9010",35,27,27,1,0,"PCAL",0
9,"9168",329,254,254,2,0,"PCAL",2
9,"9311",70,51,51,0,0,"PCAL",1
34,"34129",191,144,142,0,2,"PCAL",0
9,"9386",61,45,45,0,0,"PCAL",0
34,"34005",899,707,698,8,9,"PCAL",2
9,"9343",94,77,76,0,1,"PCAL",1
9,"9182",104,81,81,1,0,"PCAL",1
34,"34028",154,128,126,1,2,"PCAL",4
9,"9011",86,56,56,1,0,"PCAL",1
9,"9054",107,80,80,1,0,"PCAL",0
9,"9144",61,51,50,0,1,"PCAL",0
34,"34073",184,153,152,7,1,"PCAL",1
9,"9078",41,37,35,0,2,"PCAL",0
9,"9389",77,66,66,0,0,"PCAL",0
34,"34034",129,104,104,1,0,"PCAL",0
34,"34224",53,42,41,0,1,"PCAL",0
9,"9169",96,80,80,1,0,"PCAL",1
9,"9194",2033,1557,1535,28,22,"PCAL",34
9,"9905",432,313,309,1,4,"PCAL",3
9,"9108",399,287,283,5,4,"PCAL",1
34,"34094",64,47,44,1,3,"PCAL",0
34,"34152",142,114,109,1,5,"PCAL",1
34,"34139",179,143,143,1,0,"PCAL",1
9,"9906",1199,912,903,12,9,"PCAL",3
34,"34098",756,544,540,10,4,"PCAL",10
34,"34201",212,178,172,1,6,"PCAL",0
34,"34216",65,50,50,1,0,"PCAL",0
9,"9129",112,93,93,0,0,"PCAL",0
34,"34902",146,121,121,1,0,"PCAL",0
34,"34131",67,57,56,0,1,"PCAL",0
9,"9353",62,51,51,2,0,"PCAL",2
9,"9466",151,111,110,1,1,"PCAL",1
9,"9027",54,48,43,0,5,"PCAL",0
34,"34070",182,138,137,1,1,"PCAL",1
9,"9269",39,33,33,0,0,"PCAL",0
34,"34181",471,350,346,7,4,"PCAL",0
9,"9181",334,271,271,14,0,"PCAL",7
34,"34099",56,49,47,1,2,"PCAL",0
34,"34012",368,277,275,9,2,"PCAL",1
9,"9013",48,41,41,1,0,"PCAL",0
34,"34039",66,57,56,0,1,"PCAL",0
9,"9356",57,38,37,1,1,"PCAL",1
9,"9414",197,159,159,2,0,"PCAL",0
34,"34062",175,126,124,3,2,"PCAL",1
9,"9304",197,168,165,1,3,"PCAL",2
9,"9253",108,95,94,4,1,"PCAL",3
34,"34031",29,26,26,0,0,"PCAL",0
34,"34135",429,334,329,6,5,"PCAL",0
9,"9463",261,205,205,1,0,"PCAL",5
9,"9007",66,50,50,0,0,"PCAL",0
34,"34004",5790,4354,4262,84,92,"PCAL",7
9,"9351",63,46,44,0,2,"PCAL",0
34,"34223",233,175,175,2,0,"PCAL",0
9,"9014",190,113,113,3,0,"PCAL",1
9,"9431",124,102,100,2,2,"PCAL",0
9,"9405",143,106,105,2,1,"PCAL",0
9,"9467",65,49,49,0,0,"PCAL",1
9,"9400",340,253,249,4,4,"PCAL",2
34,"34100",141,105,105,1,0,"PCAL",2
9,"9281",159,134,132,5,2,"PCAL",0
34,"34003",167,132,130,7,2,"PCAL",2
9,"9363",1047,798,792,9,6,"PCAL",9
9,"9149",37,25,25,0,0,"PCAL",1
9,"9037",122,91,90,2,1,"PCAL",0
34,"34066",66,55,54,0,1,"PCAL",0
9,"9391",383,290,284,7,6,"PCAL",0
9,"9330",1562,1212,1176,10,36,"PCAL",41
9,"9213",370,260,260,5,0,"PCAL",3
9,"9274",1160,924,914,14,10,"PCAL",3
34,"34240",102,84,83,1,1,"PCAL",0
9,"9428",124,107,107,1,0,"PCAL",2
9,"9100",56,46,44,0,2,"PCAL",2
34,"34155",142,118,117,3,1,"PCAL",0
9,"9167",60,49,49,2,0,"PCAL",0
9,"9380",85,71,71,1,0,"PCAL",1
9,"9270",180,147,143,2,4,"PCAL",2
34,"34018",229,184,182,3,2,"PCAL",4
9,"9109",1181,664,631,16,33,"PCAL",0
34,"34086",105,89,89,1,0,"PCAL",1
9,"9061",187,146,144,1,2,"PCAL",0
34,"34050",216,170,166,1,4,"PCAL",2
9,"9123",31,27,27,0,0,"PCAL",0
34,"34170",72,56,56,1,0,"PCAL",0
34,"34230",12,8,8,0,0,"PCAL",0
9,"9229",213,163,163,1,0,"PCAL",0
34,"34246",78,64,64,0,0,"PCAL",0
9,"9422",24,18,16,0,2,"PCAL",0
34,"34140",113,84,84,2,0,"PCAL",2
9,"9256",369,254,252,2,2,"PCAL",3
34,"34234",72,56,55,1,1,"PCAL",0
34,"34114",240,171,171,0,0,"PCAL",0
9,"9306",127,94,94,0,0,"PCAL",0
9,"9055",55,46,44,0,2,"PCAL",0
9,"9902",491,363,357,4,6,"PCAL",13
34,"34196",94,74,73,1,1,"PCAL",0
34,"34041",100,79,78,1,1,"PCAL",0
9,"9231",77,42,42,0,0,"PCAL",0
9,"9345",134,102,102,1,0,"PCAL",0
34,"34076",632,524,520,13,4,"PCAL",3
9,"9102",44,36,36,0,0,"PCAL",0
34,"34903",240,161,160,2,1,"PCAL",1
9,"9416",61,44,44,0,0,"PCAL",0
34,"34092",331,272,267,6,5,"PCAL",1
9,"9326",156,119,114,2,5,"PCAL",1
34,"34205",70,55,55,1,0,"PCAL",0
9,"9220",82,60,60,2,0,"PCAL",2
34,"34106",121,100,99,2,1,"PCAL",0
34,"34049",421,313,311,4,2,"PCAL",1
34,"34035",122,98,96,0,2,"PCAL",1
34,"34225",4837,3650,3580,73,70,"PCAL",14
9,"9184",4,4,4,0,0,"PCAL",0
9,"9077",38,26,25,0,1,"PCAL",0
9,"9214",724,477,467,4,10,"PCAL",1
34,"34017",960,772,760,15,12,"PCAL",15
9,"9152",273,207,207,1,0,"PCAL",2
34,"34001",36,29,29,2,0,"PCAL",1
9,"9197",160,129,128,3,1,"PCAL",1
9,"9035",336,255,251,3,4,"PCAL",3
9,"9328",81,56,56,2,0,"PCAL",0
9,"9064",353,277,277,6,0,"PCAL",14
9,"9456",142,110,110,3,0,"PCAL",0
9,"9235",179,148,142,1,6,"PCAL",2
9,"9201",33,22,22,2,0,"PCAL",0
34,"34163",61,56,56,1,0,"PCAL",0
34,"34160",154,119,116,0,3,"PCAL",0
9,"9446",13,9,9,0,0,"PCAL",0
9,"9136",203,153,146,3,7,"PCAL",0
34,"34227",84,69,67,3,2,"PCAL",1
9,"9026",384,296,295,8,1,"PCAL",2
9,"9236",41,38,37,0,1,"PCAL",0
9,"9441",70,59,59,2,0,"PCAL",1
9,"9365",38,27,27,0,0,"PCAL",0
9,"9130",87,72,71,0,1,"PCAL",0
9,"9901",407,319,308,8,11,"PCAL",0
9,"9437",298,249,247,5,2,"PCAL",3
9,"9170",218,158,157,0,1,"PCAL",0
9,"9423",34,28,28,1,0,"PCAL",0
9,"9246",662,469,457,3,12,"PCAL",1
9,"9044",54,45,45,1,0,"PCAL",1
9,"9259",239,178,177,2,1,"PCAL",0
9,"9191",45,34,33,1,1,"PCAL",0
9,"9390",645,522,518,9,4,"PCAL",3
9,"9460",187,144,142,2,2,"PCAL",1
9,"9347",136,113,109,5,4,"PCAL",4
9,"9085",486,348,339,8,9,"PCAL",4
9,"9392",51,42,42,1,0,"PCAL",0
9,"9075",126,102,101,1,1,"PCAL",1
9,"9131",412,332,321,6,11,"PCAL",5
9,"9355",117,88,87,1,1,"PCAL",0
9,"9302",116,87,87,3,0,"PCAL",3
34,"34038",284,228,225,9,3,"PCAL",0
9,"9196",161,111,110,0,1,"PCAL",1
9,"9378",42,26,26,0,0,"PCAL",0
9,"9439",909,720,697,16,23,"PCAL",7
9,"9139",104,84,80,3,4,"PCAL",2
34,"34202",28,21,21,0,0,"PCAL",0
9,"9368",26,18,18,0,0,"PCAL",0
9,"9334",52,40,39,1,1,"PCAL",0
9,"9464",44,28,28,0,0,"PCAL",1
9,"9312",113,94,91,0,3,"PCAL",2
9,"9447",36,33,33,0,0,"PCAL",1
9,"9241",198,159,158,5,1,"PCAL",0
34,"34218",486,366,365,3,1,"PCAL",1
34,"34136",192,122,122,1,0,"PCAL",0
34,"34168",60,56,56,0,0,"PCAL",0
9,"9025",150,112,110,0,2,"PCAL",0
9,"9413",500,335,331,1,4,"PCAL",3
34,"34178",106,93,93,1,0,"PCAL",0
9,"9244",53,44,44,0,0,"PCAL",0
34,"34019",139,108,108,5,0,"PCAL",1
34,"34121",208,153,152,0,1,"PCAL",0
9,"9101",79,66,66,2,0,"PCAL",0
9,"9183",58,47,46,1,1,"PCAL",0
34,"34143",181,142,140,3,2,"PCAL",0
34,"34159",375,275,264,8,11,"PCAL",1
34,"34904",355,247,241,3,6,"PCAL",3
9,"9110",95,68,68,1,0,"PCAL",0
9,"9063",223,191,189,1,2,"PCAL",2
9,"9140",136,110,110,1,0,"PCAL",2
9,"9012",105,77,74,3,3,"PCAL",0
9,"9122",93,71,71,4,0,"PCAL",1
9,"9276",420,275,245,5,30,"PCAL",0
34,"34052",187,147,147,1,0,"PCAL",2
9,"9071",48,32,32,0,0,"PCAL",1
34,"34185",72,48,45,0,3,"PCAL",0
9,"9162",122,94,93,1,1,"PCAL",1
9,"9403",98,75,75,0,0,"PCAL",0
9,"9352",134,107,106,0,1,"PCAL",0
34,"34213",67,50,50,0,0,"PCAL",0
34,"34074",764,610,597,11,13,"PCAL",14
34,"34088",219,179,177,4,2,"PCAL",0
9,"9449",94,80,80,2,0,"PCAL",0
9,"9228",168,143,143,3,0,"PCAL",3
9,"9225",95,61,61,3,0,"PCAL",0
9,"9348",150,122,122,2,0,"PCAL",1
9,"9082",49,41,41,0,0,"PCAL",0
9,"9249",54,44,42,1,2,"PCAL",0
9,"9298",90,74,74,1,0,"PCAL",1
9,"9124",1598,1151,1129,19,22,"PCAL",1
9,"9065",152,137,137,1,0,"PCAL",0
34,"34081",53,42,41,0,1,"PCAL",0
9,"9374",96,85,81,3,4,"PCAL",0
34,"34222",122,94,94,2,0,"PCAL",0
9,"9406",242,193,193,2,0,"PCAL",0
9,"9098",553,416,410,11,6,"PCAL",2
9,"9192",74,55,53,0,2,"PCAL",1
9,"9338",220,173,168,5,5,"PCAL",1
34,"34238",348,289,287,4,2,"PCAL",1
9,"9003",205,156,154,4,2,"PCAL",3
34,"34186",61,53,53,0,0,"PCAL",0
9,"9350",502,384,376,7,8,"PCAL",1
9,"9094",49,39,39,0,0,"PCAL",1
9,"9309",343,252,246,7,6,"PCAL",0
9,"9448",225,188,186,1,2,"PCAL",2
34,"34047",1814,1435,1413,24,22,"PCAL",1
34,"34141",190,162,160,0,2,"PCAL",0
34,"34210",103,93,91,2,2,"PCAL",0
34,"34179",32,21,21,0,0,"PCAL",0
9,"9421",269,189,189,5,0,"PCAL",0
34,"34229",75,60,60,2,0,"PCAL",0
34,"34180",84,68,68,0,0,"PCAL",6
34,"34042",299,249,246,5,3,"PCAL",2
9,"9419",82,61,61,0,0,"PCAL",0
9,"9373",485,332,331,5,1,"PCAL",2
9,"9455",48,39,39,0,0,"PCAL",0
9,"9001",29,25,25,0,0,"PCAL",1
9,"9340",72,41,41,0,0,"PCAL",0
34,"34241",20,12,11,0,1,"PCAL",0
34,"34215",166,146,145,1,1,"PCAL",0
9,"9117",82,59,59,1,0,"PCAL",1
9,"9029",186,138,137,4,1,"PCAL",1
9,"9172",129,110,109,2,1,"PCAL",1
34,"34233",158,128,128,3,0,"PCAL",0
9,"9316",108,87,84,0,3,"PCAL",0
9,"9366",99,67,65,1,2,"PCAL",0
9,"9430",18,15,15,0,0,"PCAL",0
9,"9189",146,101,99,2,2,"PCAL",0
9,"9258",190,159,159,5,0,"PCAL",0
9,"9022",83,58,58,2,0,"PCAL",0
9,"9093",154,127,125,1,2,"PCAL",0
34,"34127",118,77,74,1,3,"PCAL",1
34,"34093",101,74,74,1,0,"PCAL",0
9,"9266",87,72,72,0,0,"PCAL",1
34,"34167",124,105,105,0,0,"PCAL",0
34,"34123",1798,1479,1436,18,43,"PCAL",7
9,"9217",389,273,270,8,3,"PCAL",0
34,"34147",192,139,137,1,2,"PCAL",1
34,"34214",176,144,143,3,1,"PCAL",0
9,"9068",25,19,19,2,0,"PCAL",0
34,"34072",189,169,166,2,3,"PCAL",0
34,"34158",336,202,200,0,2,"PCAL",0
9,"9440",105,80,80,0,0,"PCAL",1
9,"9318",63,38,38,0,0,"PCAL",1
9,"9006",68,40,39,1,1,"PCAL",1
9,"9219",28514,20244,19951,326,293,"PCAL",71
9,"9016",87,55,54,1,1,"PCAL",0
34,"34174",213,179,178,4,1,"PCAL",3
9,"9215",426,290,287,1,3,"PCAL",1
9,"9408",45,36,36,0,0,"PCAL",0
9,"9280",34,23,23,0,0,"PCAL",0
9,"9482",33,31,30,1,1,"PCAL",1
34,"34134",61,49,47,0,2,"PCAL",0
9,"9032",118,68,68,0,0,"PCAL",0
9,"9377",658,509,505,11,4,"PCAL",1
34,"34057",483,365,357,2,8,"PCAL",0
9,"9060",171,142,142,0,0,"PCAL",1
34,"34022",1136,926,908,5,18,"PCAL",2
34,"34116",76,50,49,1,1,"PCAL",0
9,"9112",115,80,80,4,0,"PCAL",1
34,"34190",59,42,42,4,0,"PCAL",0
9,"9307",119,89,88,1,1,"PCAL",1
9,"9043",215,151,151,1,0,"PCAL",3
9,"9017",96,76,74,0,2,"PCAL",3
9,"9321",1760,1338,1327,20,11,"PCAL",36
9,"9021",62,33,33,1,0,"PCAL",1
34,"34071",186,160,160,1,0,"PCAL",2
9,"9208",252,192,192,6,0,"PCAL",2
34,"34080",6066,4238,4169,57,69,"PCAL",37
34,"34032",47,36,36,1,0,"PCAL",1
9,"9086",629,467,461,5,6,"PCAL",3
9,"9177",1154,823,815,12,8,"PCAL",3
9,"9226",74,57,57,0,0,"PCAL",1
9,"9178",61,48,48,0,0,"PCAL",0
9,"9239",52,42,42,1,0,"PCAL",1
34,"34177",170,147,143,2,4,"PCAL",1
34,"34055",288,215,212,4,3,"PCAL",1
9,"9113",503,397,390,7,7,"PCAL",4
9,"9218",384,285,279,8,6,"PCAL",2
34,"34023",5318,3947,3891,64,56,"PCAL",24
9,"9308",70,51,51,0,0,"PCAL",0
9,"9485",62,56,56,0,0,"PCAL",1
9,"9023",993,771,765,22,6,"PCAL",7
9,"9354",33,29,29,2,0,"PCAL",0
34,"34175",101,80,80,2,0,"PCAL",1
9,"9317",17,15,15,0,0,"PCAL",0
9,"9261",486,342,338,7,4,"PCAL",3
34,"34165",86,67,67,0,0,"PCAL",1
9,"9216",390,278,272,2,6,"PCAL",2
34,"34024",27,18,17,1,1,"PCAL",0
9,"9141",607,503,481,10,22,"PCAL",5
9,"9033",104,82,80,1,2,"PCAL",1
9,"9134",237,164,159,7,5,"PCAL",2
34,"34082",96,79,75,0,4,"PCAL",0
9,"9272",319,225,225,5,0,"PCAL",0
9,"9476",67,52,52,0,0,"PCAL",1
9,"9329",117,80,79,1,1,"PCAL",1
34,"34242",97,81,79,6,2,"PCAL",0
34,"34079",1391,1088,1077,17,11,"PCAL",7
9,"9046",41,30,30,0,0,"PCAL",0
34,"34122",80,65,62,2,3,"PCAL",0
9,"9176",60,47,45,2,2,"PCAL",0
9,"9155",27,17,17,0,0,"PCAL",0
34,"34087",108,88,87,1,1,"PCAL",0
9,"9396",152,113,113,0,0,"PCAL",0
9,"9090",61,50,50,0,0,"PCAL",1
9,"9052",40,31,31,1,0,"PCAL",0
9,"9483",226,173,171,4,2,"PCAL",1
9,"9076",24,15,15,0,0,"PCAL",0
9,"9034",301,250,250,3,0,"PCAL",0
9,"9091",746,556,550,8,6,"PCAL",3
9,"9255",90,68,68,0,0,"PCAL",0
9,"9327",34,34,34,0,0,"PCAL",7
34,"34901",1233,955,946,14,9,"PCAL",2
9,"9230",41,33,33,0,0,"PCAL",0
34,"34132",128,103,102,2,1,"PCAL",0
9,"9292",98,73,71,3,2,"PCAL",2
9,"9041",27,27,27,0,0,"PCAL",0
9,"9128",82,65,63,0,2,"PCAL",0
9,"9903",3299,2373,2349,45,24,"PCAL",9
9,"9057",155,125,124,0,1,"PCAL",0
9,"9045",283,196,196,4,0,"PCAL",1
9,"9287",201,159,158,4,1,"PCAL",0
9,"9039",58,50,49,0,1,"PCAL",1
34,"34091",136,105,103,1,2,"PCAL",0
9,"9175",143,99,98,0,1,"PCAL",0
9,"9227",131,100,100,1,0,"PCAL",0
9,"9137",177,134,134,6,0,"PCAL",0
34,"34063",102,92,91,2,1,"PCAL",0
34,"34033",17,15,15,0,0,"PCAL",0
9,"9335",62,52,51,1,1,"PCAL",0
9,"9267",135,118,118,3,0,"PCAL",1
9,"9415",290,192,192,4,0,"PCAL",1
9,"9019",153,104,104,1,0,"PCAL",1
9,"9024",159,124,123,2,1,"PCAL",0
9,"9251",417,292,288,3,4,"PCAL",22
9,"9199",97,75,74,0,1,"PCAL",3
9,"9289",1540,1127,1117,16,10,"PCAL",5
9,"9159",57,49,48,0,1,"PCAL",0
9,"9200",54,35,35,2,0,"PCAL",0
34,"34102",226,187,185,3,2,"PCAL",1
9,"9243",87,66,64,2,2,"PCAL",0
9,"9138",92,77,74,0,3,"PCAL",3
9,"9398",92,68,68,2,0,"PCAL",0
34,"34211",202,175,170,1,5,"PCAL",0
34,"34084",142,124,122,3,2,"PCAL",2
9,"9429",64,44,44,2,0,"PCAL",0
9,"9067",460,335,328,5,7,"PCAL",2
9,"9425",561,431,418,3,13,"PCAL",0
9,"9388",32,25,24,2,1,"PCAL",0
9,"9273",55,47,47,0,0,"PCAL",1
34,"34058",212,179,178,0,1,"PCAL",1
34,"34112",50,39,38,2,1,"PCAL",2
34,"34006",82,72,72,1,0,"PCAL",1
9,"9103",247,201,200,2,1,"PCAL",2
9,"9478",53,41,41,1,0,"PCAL",1
34,"34025",54,42,42,0,0,"PCAL",0
9,"9275",202,140,139,5,1,"PCAL",0
9,"9394",805,594,588,13,6,"PCAL",4
34,"34069",2330,1769,1749,25,20,"PCAL",7
34,"34192",103,75,74,1,1,"PCAL",1
9,"9114",88,75,73,0,2,"PCAL",0
9,"9174",859,645,639,11,6,"PCAL",15
9,"9434",1167,916,902,24,14,"PCAL",8
34,"34236",176,134,134,1,0,"PCAL",0
9,"9242",93,82,82,2,0,"PCAL",0
34,"34104",274,224,224,4,0,"PCAL",2
34,"34077",283,219,216,3,3,"PCAL",4
9,"9410",3181,2079,2049,48,30,"PCAL",4
9,"9288",98,80,80,1,0,"PCAL",1
34,"34176",146,120,118,2,2,"PCAL",0
9,"9438",547,440,433,9,7,"PCAL",11
9,"9095",88,75,73,2,2,"PCAL",0
34,"34015",45,40,40,0,0,"PCAL",0
9,"9247",28,21,20,0,1,"PCAL",0
34,"34101",54,44,44,0,0,"PCAL",0
34,"34182",860,657,649,8,8,"PCAL",4
9,"9066",62,44,42,0,2,"PCAL",0
9,"9206",65,56,55,2,1,"PCAL",0
34,"34237",645,506,498,6,8,"PCAL",2
9,"9442",385,295,289,4,6,"PCAL",8
9,"9337",126,88,87,1,1,"PCAL",2
9,"9224",172,125,125,3,0,"PCAL",1
9,"9301",625,510,504,11,6,"PCAL",6
9,"9395",164,134,133,1,1,"PCAL",2
9,"9115",96,71,70,4,1,"PCAL",0
9,"9361",134,99,98,0,1,"PCAL",0
34,"34053",222,177,172,4,5,"PCAL",0
9,"9132",174,129,127,3,2,"PCAL",1
9,"9135",41,29,29,1,0,"PCAL",0
9,"9443",197,160,154,5,6,"PCAL",1
9,"9417",43,38,38,0,0,"PCAL",0
9,"9221",446,343,340,7,3,"PCAL",3
9,"9907",1385,1053,1041,31,12,"PCAL",3
9,"9450",31,26,26,1,0,"PCAL",0
34,"34011",406,327,327,4,0,"PCAL",1
34,"34048",72,58,56,3,2,"PCAL",2
34,"34060",150,123,123,2,0,"PCAL",1
9,"9424",42,35,34,1,1,"PCAL",0
34,"34113",35,28,27,0,1,"PCAL",0
34,"34120",65774,49378,48608,830,770,"PCAL",262
34,"34161",23,20,20,0,0,"PCAL",0
9,"9030",135,97,97,2,0,"PCAL",1
9,"9471",171,127,125,1,2,"PCAL",0
9,"9084",200,147,147,4,0,"PCAL",0
9,"9904",548,412,407,7,5,"PCAL",0
9,"9179",45,37,37,0,0,"PCAL",0
9,"9223",46,40,40,0,0,"PCAL",0
9,"9411",174,104,103,1,1,"PCAL",1
34,"34171",1071,762,753,16,9,"PCAL",2
34,"34109",62,47,46,0,1,"PCAL",0
34,"34051",112,92,91,7,1,"PCAL",0
9,"9127",54,39,39,0,0,"PCAL",0
9,"9473",94,81,81,2,0,"PCAL",1
9,"9432",212,161,158,1,3,"PCAL",0
34,"34029",832,696,683,11,13,"PCAL",1
9,"9074",735,558,547,7,11,"PCAL",0
9,"9211",1489,1137,1121,28,16,"PCAL",3
34,"34020",63,44,44,0,0,"PCAL",0
9,"9310",14,10,9,2,1,"PCAL",0
34,"34146",60,42,40,1,2,"PCAL",0
9,"9381",38,30,30,0,0,"PCAL",0
34,"34037",345,256,253,4,3,"PCAL",2
9,"9908",509,328,321,5,7,"PCAL",3
34,"34204",53,45,44,0,1,"PCAL",0
9,"9059",137122,103909,102353,2008,1556,"PCAL",575
9,"9051",181,136,133,2,3,"PCAL",0
9,"9038",123,92,92,0,0,"PCAL",0
34,"34206",952,796,780,9,16,"PCAL",1
9,"9277",130,101,101,1,0,"PCAL",1
9,"9303",92,64,64,0,0,"PCAL",1
9,"9332",137,88,85,1,3,"PCAL",5
34,"34208",62,52,52,2,0,"PCAL",0
9,"9283",63,36,36,0,0,"PCAL",0
9,"9018",24688,17880,17508,345,372,"PCAL",209
34,"34189",59,47,47,3,0,"PCAL",0
9,"9166",97,87,87,1,0,"PCAL",0
9,"9151",509,389,383,5,6,"PCAL",3
9,"9088",77,40,40,0,0,"PCAL",0
9,"9020",276,222,222,6,0,"PCAL",2
9,"9195",64,40,40,1,0,"PCAL",0
9,"9143",24,14,14,1,0,"PCAL",0
9,"9294",123,96,93,1,3,"PCAL",1
34,"34199",1354,1004,978,27,26,"PCAL",2
9,"9472",58,46,46,0,0,"PCAL",1
9,"9125",648,463,460,5,3,"PCAL",3
34,"34130",228,187,186,6,1,"PCAL",1
34,"34231",273,209,206,2,3,"PCAL",0
9,"9265",44,36,35,2,1,"PCAL",0
9,"9268",108,78,78,0,0,"PCAL",0
34,"34126",284,226,224,3,2,"PCAL",0
34,"34010",560,458,451,7,7,"PCAL",2
34,"34125",99,77,75,1,2,"PCAL",0
9,"9257",93,73,72,2,1,"PCAL",1
9,"9180",132,97,95,8,2,"PCAL",2
9,"9412",846,568,563,4,5,"PCAL",0
9,"9362",219,185,184,2,1,"PCAL",0
9,"9325",217,151,148,1,3,"PCAL",0
9,"9120",46,35,34,1,1,"PCAL",0
34,"34151",184,125,123,1,2,"PCAL",0
34,"34245",322,240,236,3,4,"PCAL",2
9,"9358",261,200,199,3,1,"PCAL",0
9,"9072",272,210,209,4,1,"PCAL",2
34,"34217",1089,866,849,19,17,"PCAL",6
9,"9314",113,89,88,4,1,"PCAL",5
9,"9148",95,75,75,2,0,"PCAL",1
9,"9407",31,27,27,0,0,"PCAL",0
34,"34045",84,75,74,1,1,"PCAL",0
9,"9248",63,52,52,0,0,"PCAL",1
9,"9346",95,83,83,1,0,"PCAL",1
34,"34027",1224,875,861,14,14,"PCAL",5
34,"34068",32,23,23,0,0,"PCAL",0
9,"9372",207,169,165,1,4,"PCAL",3
9,"9409",138,105,102,0,3,"PCAL",1
34,"34046",45,35,34,0,1,"PCAL",0
9,"9105",111,85,81,2,4,"PCAL",2
9,"9238",1026,612,601,6,11,"PCAL",5
9,"9375",42,30,30,1,0,"PCAL",0
34,"34221",190,143,143,3,0,"PCAL",1
9,"9295",78,54,53,0,1,"PCAL",0
9,"9360",37,29,29,0,0,"PCAL",0
9,"9083",27,21,21,0,0,"PCAL",0
9,"9458",422,325,316,5,9,"PCAL",4
9,"9262",158,139,137,7,2,"PCAL",1
34,"34107",91,67,67,4,0,"PCAL",0
34,"34108",561,477,465,6,12,"PCAL",2
34,"34184",54,37,36,0,1,"PCAL",0
9,"9119",51,38,38,0,0,"PCAL",0
9,"9387",121,92,91,3,1,"PCAL",3
34,"34110",96,83,81,2,2,"PCAL",0
9,"9062",52,33,32,1,1,"PCAL",1
9,"9433",67,46,45,2,1,"PCAL",0
34,"34157",2471,1936,1912,26,24,"PCAL",7
9,"9058",357,278,276,4,2,"PCAL",1
9,"9232",182,146,146,1,0,"PCAL",1
9,"9445",46,31,31,1,0,"PCAL",0
9,"9454",46,31,30,1,1,"PCAL",0
34,"34220",145,125,123,0,2,"PCAL",1
9,"9315",362,267,265,9,2,"PCAL",2
34,"34096",56,41,39,1,2,"PCAL",0
9,"9418",79,60,58,0,2,"PCAL",0
9,"9036",32,27,27,2,0,"PCAL",0
9,"9339",139,105,104,1,1,"PCAL",0
9,"9209",4617,3269,3234,44,35,"PCAL",29
34,"34169",431,331,329,5,2,"PCAL",3
34,"34243",352,274,273,5,1,"PCAL",1
34,"34232",802,632,623,9,9,"PCAL",0
9,"9444",81,54,52,1,2,"PCAL",0
34,"34056",2147,1557,1535,21,22,"PCAL",14
9,"9050",77,52,52,0,0,"PCAL",2
11,"11012",103946,68124,67375,856,749,"INTERNET",132
11,"11003",1290,952,940,8,12,"INTERNET",0
11,"11011",1685,1231,1216,8,15,"INTERNET",3
11,"11025",4371,3260,3226,34,34,"INTERNET",0
11,"11002",4291,3388,3374,19,14,"INTERNET",0
11,"11032",53183,32205,31982,441,223,"INTERNET",15
11,"11036",725,484,482,10,2,"INTERNET",0
11,"11037",5640,4337,4285,32,52,"INTERNET",1
11,"11035",13266,8794,8668,115,126,"INTERNET",10
11,"11021",6838,5102,5049,67,53,"INTERNET",3
11,"11031",76347,49071,48616,681,455,"INTERNET",58
11,"11030",22528,14741,14557,195,184,"INTERNET",22
11,"11020",163674,106898,106082,1655,816,"INTERNET",108
11,"11017",3219,2403,2388,18,15,"INTERNET",0
11,"11013",2284,1691,1670,15,21,"INTERNET",0
11,"11026",4834,3736,3691,27,45,"INTERNET",1
11,"11004",87610,53062,52639,828,423,"INTERNET",52
11,"11006",24221,16564,16470,197,94,"INTERNET",16
11,"11029",5360,3445,3423,27,22,"INTERNET",0
11,"11009",636,430,424,2,6,"INTERNET",0
11,"11901",5576,4433,4398,69,35,"INTERNET",0
11,"11038",13815,10849,10756,126,93,"INTERNET",8
11,"11902",3578,2400,2376,21,24,"INTERNET",2
11,"11024",6811,5241,5202,58,39,"INTERNET",0
11,"11010",6452,4534,4510,61,24,"INTERNET",1
11,"11014",16318,11093,11031,144,62,"INTERNET",8
11,"11028",32224,20706,20482,359,224,"INTERNET",33
11,"11042",1232,933,922,4,11,"INTERNET",0
11,"11001",4389,3110,3072,13,38,"INTERNET",0
11,"11022",48624,26656,26430,345,226,"INTERNET",22
11,"11039",9943,6634,6582,104,52,"INTERNET",5
11,"11019",1871,1449,1425,9,24,"INTERNET",2
11,"11033",19983,12960,12807,199,153,"INTERNET",9
11,"11034",2381,1807,1784,19,23,"INTERNET",0
11,"11040",411,317,309,0,8,"INTERNET",0
11,"11027",67042,43386,43065,557,321,"INTERNET",39
11,"11018",1528,1194,1178,9,16,"INTERNET",0
11,"11016",14611,9848,9774,114,74,"INTERNET",4
11,"11015",59476,38207,37898,501,309,"INTERNET",32
11,"11007",17997,10781,10676,184,105,"INTERNET",7
11,"11005",4617,3287,3214,26,73,"INTERNET",2
11,"11041",9805,7136,7067,87,69,"INTERNET",3
11,"11008",16655,11309,11189,184,120,"INTERNET",2
11,"11023",9209,6979,6929,81,50,"INTERNET",3
50,"50291",112,75,73,0,2,"P-LIB",0
50,"50072",181,128,127,1,1,"P-LIB",0
28,"28177",9470,7524,7466,87,58,"P-LIB",2
50,"50215",21,20,19,0,1,"P-LIB",0
50,"50054",63,46,46,0,0,"P-LIB",0
50,"50063",76,67,67,0,0,"P-LIB",0
28,"28003",196,154,151,2,3,"P-LIB",0
28,"28046",4208,3297,3272,31,25,"P-LIB",1
28,"28123",48429,38681,38187,429,494,"P-LIB",16
50,"50015",109,73,73,0,0,"P-LIB",0
50,"50088",337,273,264,4,9,"P-LIB",0
50,"50043",258,170,166,2,4,"P-LIB",0
28,"28050",3576,2706,2663,21,43,"P-LIB",0
50,"50058",80,65,64,0,1,"P-LIB",0
50,"50149",48,35,35,0,0,"P-LIB",0
28,"28078",39,23,23,1,0,"P-LIB",0
28,"28037",1598,1263,1250,10,13,"P-LIB",0
50,"50136",617,469,462,4,7,"P-LIB",0
50,"50164",407,271,268,4,3,"P-LIB",0
50,"50263",235,160,160,1,0,"P-LIB",0
50,"50132",697,544,536,11,8,"P-LIB",0
28,"28073",11899,8877,8769,112,108,"P-LIB",4
28,"28101",222,158,158,4,0,"P-LIB",0
50,"50285",635,452,445,8,7,"P-LIB",1
50,"50155",119,91,91,1,0,"P-LIB",0
50,"50162",160,108,108,2,0,"P-LIB",0
50,"50186",44,30,29,0,1,"P-LIB",0
28,"28067",3893,2996,2950,26,46,"P-LIB",0
50,"50187",72,45,45,1,0,"P-LIB",0
50,"50081",562,410,400,7,10,"P-LIB",0
50,"50272",12481,8744,8642,176,102,"P-LIB",2
50,"50279",111,79,79,1,0,"P-LIB",0
50,"50019",79,57,55,1,2,"P-LIB",0
50,"50069",68,32,32,0,0,"P-LIB",0
50,"50002",166,130,130,2,0,"P-LIB",0
50,"50172",187,140,138,4,2,"P-LIB",0
28,"28072",5232,4065,4007,35,58,"P-LIB",5
28,"28162",2263,1802,1786,32,16,"P-LIB",0
28,"28074",136617,106248,105095,1101,1153,"P-LIB",58
28,"28031",1981,1524,1500,9,24,"P-LIB",0
50,"50261",246,199,199,4,0,"P-LIB",0
28,"28010",9309,7304,7229,71,75,"P-LIB",3
28,"28151",3025,2237,2185,9,52,"P-LIB",2
50,"50183",369,277,274,5,3,"P-LIB",0
50,"50147",845,637,627,12,10,"P-LIB",0
28,"28114",148,110,110,0,0,"P-LIB",0
50,"50174",107,92,90,0,2,"P-LIB",0
50,"50098",215,150,146,2,4,"P-LIB",0
50,"50212",52,48,48,0,0,"P-LIB",0
50,"50165",1880,1339,1274,49,65,"P-LIB",2
28,"28086",4603,3286,3248,29,38,"P-LIB",0
28,"28903",29222,23945,23689,296,256,"P-LIB",11
50,"50141",116,98,98,1,0,"P-LIB",0
50,"50223",956,751,745,14,6,"P-LIB",0
28,"28014",31360,23434,23133,203,301,"P-LIB",9
28,"28115",57612,46786,46458,458,328,"P-LIB",19
50,"50281",76,63,63,2,0,"P-LIB",0
28,"28148",79726,60405,59651,724,754,"P-LIB",34
50,"50159",728,554,544,4,10,"P-LIB",0
28,"28137",1626,1231,1222,9,9,"P-LIB",0
50,"50221",38,20,20,0,0,"P-LIB",0
50,"50229",62,47,46,2,1,"P-LIB",0
50,"50250",58,43,43,4,0,"P-LIB",0
50,"50075",89,74,74,1,0,"P-LIB",0
50,"50265",63,46,46,1,0,"P-LIB",0
50,"50050",109,73,73,1,0,"P-LIB",1
50,"50109",101,79,79,2,0,"P-LIB",0
50,"50282",88,66,63,3,3,"P-LIB",0
28,"28089",3531,2786,2753,25,33,"P-LIB",1
50,"50051",886,677,671,9,6,"P-LIB",1
50,"50106",137,107,106,0,1,"P-LIB",0
50,"50067",14124,10049,9870,203,179,"P-LIB",9
50,"50101",922,648,637,8,11,"P-LIB",1
50,"50204",2519,1823,1804,24,19,"P-LIB",0
50,"50060",187,138,136,1,2,"P-LIB",1
28,"28055",932,713,707,5,6,"P-LIB",0
50,"50037",140,110,103,3,7,"P-LIB",0
28,"28080",45696,36832,36529,402,303,"P-LIB",17
28,"28143",81,71,67,1,4,"P-LIB",0
50,"50124",474,375,367,11,8,"P-LIB",0
28,"28138",78,48,46,0,2,"P-LIB",0
50,"50068",2082,1514,1481,18,33,"P-LIB",1
28,"28159",629,482,478,2,4,"P-LIB",0
28,"28095",1358,1092,1077,8,15,"P-LIB",0
50,"50277",82,63,63,0,0,"P-LIB",0
50,"50128",36,30,29,0,1,"P-LIB",0
50,"50056",450,329,328,4,1,"P-LIB",0
50,"50259",89,53,53,1,0,"P-LIB",0
50,"50093",113,84,84,2,0,"P-LIB",0
50,"50084",84,64,64,1,0,"P-LIB",0
50,"50171",126,90,89,4,1,"P-LIB",1
28,"28061",19624,15082,14905,162,177,"P-LIB",23
50,"50005",245,199,195,1,4,"P-LIB",2
28,"28099",1670,1258,1246,9,12,"P-LIB",5
50,"50121",297,250,245,6,5,"P-LIB",0
28,"28062",311,233,226,0,7,"P-LIB",0
50,"50244",215,155,155,6,0,"P-LIB",0
50,"50034",923,634,617,10,17,"P-LIB",0
28,"28167",7818,6016,5942,82,74,"P-LIB",2
28,"28022",30019,24469,24279,292,190,"P-LIB",12
50,"50175",1088,742,732,10,10,"P-LIB",3
50,"50040",98,77,76,2,1,"P-LIB",0
28,"28039",139,103,103,1,0,"P-LIB",0
50,"50237",103,76,75,0,1,"P-LIB",0
50,"50253",461,381,375,3,6,"P-LIB",0
50,"50197",89,65,65,3,0,"P-LIB",0
50,"50092",329,273,272,0,1,"P-LIB",0
28,"28060",1471,1205,1192,8,13,"P-LIB",0
50,"50076",113,89,89,0,0,"P-LIB",0
50,"50213",117,83,82,0,1,"P-LIB",0
50,"50116",220,154,153,0,1,"P-LIB",0
50,"50156",234,186,183,2,3,"P-LIB",0
50,"50139",372,280,278,3,2,"P-LIB",0
50,"50061",228,191,183,3,8,"P-LIB",0
28,"28116",666,507,498,5,9,"P-LIB",0
50,"50198",46,36,36,2,0,"P-LIB",0
50,"50209",2559,1685,1661,34,24,"P-LIB",1
50,"50185",150,109,109,2,0,"P-LIB",0
50,"50039",580,450,446,3,4,"P-LIB",1
28,"28071",77,57,55,0,2,"P-LIB",0
50,"50233",120,89,88,2,1,"P-LIB",0
50,"50296",417,313,310,6,3,"P-LIB",0
50,"50243",346,277,272,2,5,"P-LIB",0
50,"50271",283,209,207,4,2,"P-LIB",0
28,"28145",2125,1643,1620,15,23,"P-LIB",1
28,"28002",2650,2018,1993,24,25,"P-LIB",1
50,"50026",459,360,354,5,6,"P-LIB",0
28,"28043",5944,4199,4147,56,52,"P-LIB",0
28,"28171",4148,2972,2929,21,43,"P-LIB",2
50,"50202",182,125,122,2,3,"P-LIB",0
50,"50902",97,85,85,1,0,"P-LIB",0
50,"50053",756,570,563,14,7,"P-LIB",0
50,"50011",131,113,113,8,0,"P-LIB",0
50,"50021",42,34,33,1,1,"P-LIB",0
50,"50177",355,268,265,4,3,"P-LIB",0
50,"50066",2357,1677,1659,42,18,"P-LIB",0
50,"50125",421,284,280,1,4,"P-LIB",0
28,"28155",529,427,416,2,11,"P-LIB",0
50,"50178",325,228,225,4,3,"P-LIB",0
28,"28005",132097,100509,99506,1069,1003,"P-LIB",42
28,"28036",2301,1809,1784,13,25,"P-LIB",0
50,"50082",108,73,72,0,1,"P-LIB",0
28,"28065",118796,93292,92186,919,1106,"P-LIB",43
50,"50294",77,58,57,0,1,"P-LIB",0
28,"28079",2290453,1721837,1705310,17342,16527,"P-LIB",835
50,"50123",428,335,332,9,3,"P-LIB",0
50,"50206",499,386,384,10,2,"P-LIB",0
50,"50099",3136,2333,2297,27,36,"P-LIB",0
28,"28011",437,318,315,2,3,"P-LIB",0
28,"28118",72,49,47,1,2,"P-LIB",0
50,"50126",2473,1747,1724,41,23,"P-LIB",1
28,"28035",1314,1058,1046,3,12,"P-LIB",1
50,"50073",2265,1773,1756,20,17,"P-LIB",0
50,"50176",237,161,160,4,1,"P-LIB",0
28,"28018",3572,2837,2795,20,42,"P-LIB",0
28,"28183",935,663,649,7,14,"P-LIB",0
28,"28133",5868,4236,4144,23,92,"P-LIB",1
50,"50095",12558,9029,8910,179,119,"P-LIB",20
28,"28028",1615,1204,1173,11,31,"P-LIB",0
50,"50134",134,102,101,3,1,"P-LIB",0
50,"50211",277,193,193,1,0,"P-LIB",0
28,"28056",782,604,586,6,18,"P-LIB",0
50,"50144",36,32,32,0,0,"P-LIB",0
50,"50065",59,37,37,2,0,"P-LIB",0
28,"28012",830,654,651,6,3,"P-LIB",0
28,"28007",122891,95200,94139,990,1061,"P-LIB",29
50,"50297",495260,360632,355561,7046,5071,"P-LIB",291
50,"50036",103,81,80,2,1,"P-LIB",1
50,"50118",2312,1737,1718,22,19,"P-LIB",3
28,"28019",1195,901,888,5,13,"P-LIB",1
28,"28040",15089,9976,9852,116,124,"P-LIB",7
50,"50090",165,117,117,1,0,"P-LIB",0
50,"50012",105,93,90,0,3,"P-LIB",0
28,"28129",7219,5536,5461,71,75,"P-LIB",1
50,"50122",68,47,45,2,2,"P-LIB",0
50,"50027",260,209,202,2,7,"P-LIB",2
50,"50275",103,76,76,0,0,"P-LIB",0
50,"50193",635,483,465,3,18,"P-LIB",1
50,"50031",167,105,103,0,2,"P-LIB",0
50,"50079",281,213,210,2,3,"P-LIB",1
50,"50146",211,168,167,4,1,"P-LIB",0
50,"50169",371,275,274,5,1,"P-LIB",0
28,"28091",5202,3714,3671,34,43,"P-LIB",1
28,"28024",156,132,132,5,0,"P-LIB",0
28,"28106",72603,53231,52524,681,707,"P-LIB",30
28,"28128",366,280,275,2,5,"P-LIB",0
50,"50047",60,34,34,2,0,"P-LIB",0
28,"28135",928,665,659,6,6,"P-LIB",2
50,"50070",70,42,41,0,1,"P-LIB",0
28,"28068",10502,7857,7778,68,79,"P-LIB",4
28,"28166",325,269,268,8,1,"P-LIB",1
50,"50289",71,59,59,0,0,"P-LIB",0
28,"28066",7033,5439,5383,45,56,"P-LIB",3
50,"50083",96,72,72,1,0,"P-LIB",0
28,"28049",59507,46919,46379,488,540,"P-LIB",11
50,"50120",53,41,41,0,0,"P-LIB",0
50,"50192",240,188,184,9,4,"P-LIB",0
28,"28044",5403,4245,4188,27,57,"P-LIB",1
28,"28030",1591,1268,1230,12,38,"P-LIB",1
28,"28121",185,153,152,0,1,"P-LIB",0
50,"50086",193,109,109,0,0,"P-LIB",0
28,"28083",8037,6078,6025,66,53,"P-LIB",4
50,"50154",129,98,97,1,1,"P-LIB",0
28,"28169",1244,971,962,8,9,"P-LIB",0
50,"50284",176,131,130,1,1,"P-LIB",0
50,"50218",113,92,92,0,0,"P-LIB",0
50,"50256",90,59,59,1,0,"P-LIB",0
50,"50096",49,35,35,0,0,"P-LIB",0
28,"28059",4061,3169,3130,38,39,"P-LIB",2
28,"28009",13466,10392,10286,102,106,"P-LIB",4
50,"50008",5110,3458,3406,56,52,"P-LIB",5
28,"28113",31318,23779,23436,271,343,"P-LIB",9
50,"50152",1569,1151,1135,31,16,"P-LIB",0
28,"28158",632,505,495,4,10,"P-LIB",0
50,"50129",258,164,164,0,0,"P-LIB",0
50,"50260",42,35,35,1,0,"P-LIB",0
28,"28052",3799,2753,2719,17,34,"P-LIB",2
50,"50113",653,528,526,9,2,"P-LIB",0
50,"50257",195,154,154,0,0,"P-LIB",0
50,"50022",548,430,416,10,14,"P-LIB",0
28,"28093",1911,1537,1518,19,19,"P-LIB",0
28,"28140",2665,2167,2141,26,26,"P-LIB",2
50,"50238",114,82,80,0,2,"P-LIB",0
28,"28001",61,46,45,1,1,"P-LIB",0
28,"28182",219,179,178,2,1,"P-LIB",0
50,"50130",415,288,288,7,0,"P-LIB",0
50,"50160",2397,1905,1865,19,40,"P-LIB",0
50,"50188",34,28,27,0,1,"P-LIB",0
50,"50245",121,80,80,1,0,"P-LIB",2
50,"50236",124,103,103,2,0,"P-LIB",0
28,"28161",44185,33371,32966,353,405,"P-LIB",19
28,"28157",605,452,446,2,6,"P-LIB",0
50,"50220",59,43,43,1,0,"P-LIB",0
50,"50293",492,339,338,6,1,"P-LIB",0
50,"50240",1127,799,783,25,16,"P-LIB",0
28,"28054",10459,7798,7698,65,100,"P-LIB",1
28,"28176",10977,8790,8718,68,72,"P-LIB",6
28,"28088",251,174,173,5,1,"P-LIB",0
28,"28016",86,68,67,3,1,"P-LIB",0
28,"28104",11704,9455,9361,119,94,"P-LIB",5
50,"50017",1734,1232,1212,41,20,"P-LIB",2
50,"50074",6516,4378,4222,77,156,"P-LIB",3
28,"28134",55921,42676,42221,505,455,"P-LIB",16
50,"50287",298,214,211,10,3,"P-LIB",1
50,"50205",98,72,71,2,1,"P-LIB",0
28,"28026",5852,4506,4449,40,57,"P-LIB",3
50,"50180",111,91,89,3,2,"P-LIB",0
28,"28117",116,90,90,1,0,"P-LIB",0
50,"50138",49,43,43,2,0,"P-LIB",0
50,"50168",34,26,26,1,0,"P-LIB",0
50,"50105",343,263,259,2,4,"P-LIB",0
28,"28174",1745,1233,1224,11,9,"P-LIB",0
50,"50247",794,572,567,7,5,"P-LIB",0
50,"50235",2371,1723,1701,36,22,"P-LIB",3
28,"28096",16844,12441,12308,117,133,"P-LIB",9
28,"28180",5179,4033,3975,18,58,"P-LIB",0
50,"50266",139,95,94,1,1,"P-LIB",0
28,"28179",1385,1039,1027,10,12,"P-LIB",0
50,"50028",120,86,85,2,1,"P-LIB",0
28,"28051",1469,1147,1129,7,18,"P-LIB",3
50,"50232",176,123,120,5,3,"P-LIB",1
28,"28058",137542,103880,102686,1155,1194,"P-LIB",43
50,"50035",78,61,56,2,5,"P-LIB",0
50,"50114",157,120,120,1,0,"P-LIB",0
28,"28094",774,557,551,5,6,"P-LIB",0
28,"28147",910,705,698,5,7,"P-LIB",0
28,"28020",145,102,100,0,2,"P-LIB",0
28,"28154",5232,3910,3860,40,50,"P-LIB",3
28,"28107",443,338,333,7,5,"P-LIB",0
50,"50239",65,44,44,0,0,"P-LIB",0
50,"50032",330,233,228,3,5,"P-LIB",0
28,"28112",168,138,137,0,1,"P-LIB",0
28,"28090",7899,6216,6131,60,85,"P-LIB",1
28,"28173",507,397,390,2,7,"P-LIB",1
28,"28069",51,35,33,1,2,"P-LIB",0
50,"50077",254,189,188,4,1,"P-LIB",0
50,"50111",191,141,138,2,3,"P-LIB",0
50,"50148",365,256,251,2,5,"P-LIB",0
50,"50014",169,108,108,1,0,"P-LIB",0
50,"50290",436,334,331,4,3,"P-LIB",0
28,"28033",3581,2712,2691,14,21,"P-LIB",0
28,"28085",3794,2980,2933,18,47,"P-LIB",1
50,"50224",70,52,49,2,3,"P-LIB",0
28,"28108",3002,2254,2228,31,26,"P-LIB",0
28,"28122",504,367,366,2,1,"P-LIB",1
28,"28153",608,422,406,1,16,"P-LIB",0
50,"50135",100,76,75,2,1,"P-LIB",0
50,"50234",251,201,191,13,10,"P-LIB",0
50,"50190",751,576,565,7,11,"P-LIB",1
50,"50046",201,155,153,2,2,"P-LIB",0
28,"28110",1912,1492,1475,8,17,"P-LIB",0
50,"50241",634,462,455,2,7,"P-LIB",0
28,"28008",1734,1244,1221,11,23,"P-LIB",0
28,"28084",15408,11489,11355,122,134,"P-LIB",4
50,"50298",5319,4023,3955,72,68,"P-LIB",4
28,"28017",1120,905,888,8,17,"P-LIB",0
28,"28149",5276,4132,4063,43,69,"P-LIB",1
28,"28027",1232,937,919,9,18,"P-LIB",1
50,"50003",141,108,108,3,0,"P-LIB",0
50,"50085",205,143,143,3,0,"P-LIB",0
28,"28111",618,486,479,2,7,"P-LIB",0
50,"50273",36,22,22,0,0,"P-LIB",0
28,"28004",5761,4098,4044,38,54,"P-LIB",0
50,"50182",3704,2551,2515,44,36,"P-LIB",2
50,"50283",73,55,55,1,0,"P-LIB",0
50,"50292",138,117,115,4,2,"P-LIB",0
50,"50045",1289,1011,992,14,19,"P-LIB",0
50,"50137",1119,842,834,12,8,"P-LIB",0
50,"50195",48,38,38,1,0,"P-LIB",0
50,"50150",716,430,427,10,3,"P-LIB",0
28,"28131",12664,9454,9342,100,112,"P-LIB",2
28,"28141",5568,4097,4051,31,46,"P-LIB",16
50,"50080",41,31,31,1,0,"P-LIB",0
50,"50179",269,230,229,2,1,"P-LIB",0
50,"50161",124,86,86,1,0,"P-LIB",0
50,"50268",59,46,46,3,0,"P-LIB",0
50,"50071",134,97,96,0,1,"P-LIB",0
28,"28119",1911,1527,1514,13,13,"P-LIB",0
28,"28150",2985,2363,2345,21,18,"P-LIB",1
50,"50228",295,238,236,10,2,"P-LIB",0
50,"50189",776,588,576,9,12,"P-LIB",0
50,"50199",380,263,254,2,9,"P-LIB",0
50,"50033",81,64,64,0,0,"P-LIB",0
50,"50157",313,253,250,7,3,"P-LIB",0
28,"28064",143,112,110,1,2,"P-LIB",0
28,"28021",418,334,328,4,6,"P-LIB",0
50,"50059",790,593,586,12,7,"P-LIB",1
28,"28120",1259,946,931,11,15,"P-LIB",3
28,"28136",618,527,516,2,11,"P-LIB",0
50,"50115",3280,2234,2205,32,29,"P-LIB",0
28,"28901",765,579,567,2,12,"P-LIB",1
50,"50203",1083,814,798,28,16,"P-LIB",1
50,"50270",39,30,29,1,1,"P-LIB",0
50,"50194",102,67,67,2,0,"P-LIB",0
50,"50288",3252,2412,2380,50,32,"P-LIB",0
50,"50251",8379,6225,6116,110,109,"P-LIB",4
28,"28032",4469,3412,3369,32,43,"P-LIB",1
50,"50166",282,216,210,1,6,"P-LIB",0
50,"50200",534,436,432,9,4,"P-LIB",0
28,"28168",1144,821,810,15,11,"P-LIB",0
50,"50170",411,316,313,2,3,"P-LIB",0
50,"50230",1295,914,903,13,11,"P-LIB",0
50,"50102",918,722,713,12,9,"P-LIB",0
28,"28042",1091,814,808,5,6,"P-LIB",1
28,"28047",38404,28739,28436,312,303,"P-LIB",16
28,"28109",1621,1121,1104,9,17,"P-LIB",0
50,"50286",90,73,73,2,0,"P-LIB",0
50,"50258",54,37,37,0,0,"P-LIB",0
28,"28082",5144,3967,3905,46,62,"P-LIB",1
28,"28092",148714,112174,110838,1215,1336,"P-LIB",79
50,"50901",170,122,121,1,1,"P-LIB",0
28,"28126",59,37,37,0,0,"P-LIB",0
28,"28178",1017,799,791,11,8,"P-LIB",0
50,"50262",1216,916,904,20,12,"P-LIB",0
50,"50001",130,96,96,0,0,"P-LIB",1
28,"28045",30286,23148,22879,226,269,"P-LIB",12
28,"28146",1672,1220,1205,4,15,"P-LIB",1
50,"50087",31,25,25,0,0,"P-LIB",0
50,"50196",110,87,86,4,1,"P-LIB",0
50,"50048",43,33,33,1,0,"P-LIB",0
50,"50030",232,164,160,1,4,"P-LIB",1
50,"50006",978,758,749,16,9,"P-LIB",0
28,"28127",60108,48418,48039,568,379,"P-LIB",20
28,"28181",20003,16133,15952,159,181,"P-LIB",9
50,"50042",16,14,14,0,0,"P-LIB",0
28,"28006",74554,57439,56890,586,549,"P-LIB",24
50,"50264",184,140,134,0,6,"P-LIB",0
28,"28057",1419,1084,1074,12,10,"P-LIB",0
50,"50024",652,541,531,8,10,"P-LIB",0
28,"28144",5663,4456,4410,47,46,"P-LIB",1
50,"50119",997,740,720,13,20,"P-LIB",0
28,"28160",7496,5680,5613,46,67,"P-LIB",5
50,"50225",1638,1079,1062,7,17,"P-LIB",1
50,"50181",1053,787,760,9,27,"P-LIB",0
28,"28025",426,336,332,2,4,"P-LIB",0
50,"50210",39,28,24,0,4,"P-LIB",0
28,"28063",268,209,203,4,6,"P-LIB",0
50,"50143",608,427,424,5,3,"P-LIB",0
50,"50252",5345,3860,3792,79,68,"P-LIB",2
50,"50903",2234,1622,1597,35,25,"P-LIB",1
50,"50089",6673,4936,4877,120,59,"P-LIB",6
50,"50276",148,116,114,3,2,"P-LIB",0
50,"50064",469,377,373,5,4,"P-LIB",1
50,"50173",175,104,104,2,0,"P-LIB",0
50,"50295",54,42,41,0,1,"P-LIB",0
28,"28097",127,94,92,0,2,"P-LIB",0
28,"28048",489,398,389,3,9,"P-LIB",0
50,"50104",379,306,303,4,3,"P-LIB",0
50,"50055",3592,2520,2473,59,47,"P-LIB",2
50,"50041",21,13,13,0,0,"P-LIB",0
28,"28172",7648,6130,6076,65,54,"P-LIB",4
28,"28124",83,55,53,0,2,"P-LIB",0
50,"50246",48,33,33,1,0,"P-LIB",0
50,"50217",496,380,379,0,1,"P-LIB",0
50,"50131",243,185,183,6,2,"P-LIB",0
50,"50091",56,39,39,1,0,"P-LIB",0
50,"50208",1831,1321,1305,24,16,"P-LIB",3
50,"50062",1750,1298,1275,22,23,"P-LIB",0
28,"28100",3970,2903,2865,32,38,"P-LIB",1
50,"50222",1695,1117,1091,16,26,"P-LIB",0
50,"50023",240,180,180,4,0,"P-LIB",0
50,"50231",285,231,224,7,7,"P-LIB",0
50,"50038",1583,1194,1174,29,20,"P-LIB",1
28,"28170",2503,1744,1727,20,17,"P-LIB",1
50,"50269",316,186,185,1,1,"P-LIB",0
50,"50278",207,152,149,4,3,"P-LIB",0
28,"28053",6035,4854,4783,61,71,"P-LIB",2
50,"50207",126,97,95,1,2,"P-LIB",0
28,"28165",1689,1310,1295,5,15,"P-LIB",0
28,"28070",139,98,97,0,1,"P-LIB",0
28,"28038",4999,3659,3590,32,69,"P-LIB",5
50,"50280",370,296,291,5,5,"P-LIB",0
50,"50094",1744,1220,1193,25,27,"P-LIB",2
50,"50018",973,761,755,12,6,"P-LIB",1
50,"50029",676,527,517,6,10,"P-LIB",0
28,"28902",453,338,329,3,9,"P-LIB",0
28,"28132",10987,8066,7943,90,123,"P-LIB",5
50,"50163",3427,2448,2413,62,35,"P-LIB",0
50,"50025",4569,3319,3271,68,48,"P-LIB",1
50,"50151",713,536,531,5,5,"P-LIB",1
50,"50214",31,22,21,1,1,"P-LIB",0
28,"28023",4350,3425,3392,32,33,"P-LIB",1
50,"50052",100,82,82,0,0,"P-LIB",0
28,"28015",14491,11562,11417,155,145,"P-LIB",2
28,"28029",538,416,414,4,2,"P-LIB",0
50,"50013",244,195,195,1,0,"P-LIB",0
50,"50140",172,108,108,1,0,"P-LIB",0
50,"50107",953,785,780,13,5,"P-LIB",1
50,"50242",102,82,82,2,0,"P-LIB",0
50,"50167",235,191,184,1,7,"P-LIB",0
28,"28076",417,325,321,1,4,"P-LIB",1
28,"28075",5127,3976,3916,42,60,"P-LIB",4
50,"50057",1468,1022,1004,17,18,"P-LIB",2
50,"50009",122,93,93,0,0,"P-LIB",0
50,"50108",50,31,31,0,0,"P-LIB",0
50,"50249",333,280,272,2,8,"P-LIB",0
50,"50044",259,175,175,0,0,"P-LIB",0
28,"28175",780,641,630,8,11,"P-LIB",1
28,"28152",14903,11954,11865,125,89,"P-LIB",5
50,"50227",105,79,79,2,0,"P-LIB",0
50,"50267",648,450,441,8,9,"P-LIB",0
28,"28034",356,278,276,1,2,"P-LIB",0
28,"28156",958,742,733,12,9,"P-LIB",0
50,"50016",51,30,30,1,0,"P-LIB",0
50,"50153",1002,757,748,12,9,"P-LIB",0
50,"50184",132,106,106,1,0,"P-LIB",0
50,"50254",179,136,136,0,0,"P-LIB",0
50,"50117",131,101,100,1,1,"P-LIB",0
28,"28163",395,305,301,7,4,"P-LIB",0
50,"50255",219,150,148,1,2,"P-LIB",0
50,"50142",45,25,24,0,1,"P-LIB",0
50,"50100",355,273,266,3,7,"P-LIB",0
28,"28130",27391,21367,21111,235,256,"P-LIB",15
50,"50216",267,201,194,8,7,"P-LIB",0
50,"50010",77,65,64,5,1,"P-LIB",0
50,"50201",466,366,363,7,3,"P-LIB",1
28,"28164",2807,2194,2173,10,21,"P-LIB",1
50,"50191",505,395,390,4,5,"P-LIB",0
28,"28087",3150,2475,2453,26,22,"P-LIB",0
28,"28041",4006,3190,3154,45,36,"P-LIB",9
50,"50020",868,646,629,5,17,"P-LIB",0
50,"50078",278,210,208,2,2,"P-LIB",0
50,"50274",78,45,45,1,0,"P-LIB",0
50,"50110",424,315,314,6,1,"P-LIB",0
50,"50219",3704,2672,2625,39,47,"P-LIB",5
50,"50248",552,421,407,5,14,"P-LIB",0
50,"50004",613,445,441,6,4,"P-LIB",0
50,"50007",61,45,45,0,0,"P-LIB",0
28,"28102",913,700,693,9,7,"P-LIB",0
28,"28125",2808,2077,2055,19,22,"P-LIB",1
50,"50133",126,101,100,1,1,"P-LIB",0
28,"28013",38226,27886,27547,246,339,"P-LIB",9
33,"33002",10837,7667,7588,77,79,"PDYC",1
33,"33056",5278,3576,3540,41,36,"PDYC",0
33,"33046",546,429,421,3,8,"PDYC",0
33,"33065",1150,791,784,16,7,"PDYC",0
33,"33003",737,475,471,6,4,"PDYC",0
33,"33008",1934,1474,1459,11,15,"PDYC",1
33,"33024",229816,164603,163179,2100,1424,"PDYC",49
33,"33009",951,673,663,7,10,"PDYC",0
33,"33044",180964,129466,128346,1888,1120,"PDYC",99
33,"33021",4932,3544,3502,45,42,"PDYC",3
33,"33066",42885,29326,29013,460,313,"PDYC",13
33,"33038",2442,1757,1725,14,32,"PDYC",0
33,"33074",3699,2643,2611,30,32,"PDYC",0
33,"33057",1635,1150,1132,16,18,"PDYC",0
33,"33060",15694,11036,10883,112,153,"PDYC",4
33,"33070",3481,2557,2521,33,36,"PDYC",3
33,"33031",38090,25034,24730,380,304,"PDYC",6
33,"33078",159,108,106,1,2,"PDYC",1
33,"33055",1589,1212,1192,16,20,"PDYC",0
33,"33063",467,367,363,4,4,"PDYC",0
33,"33033",10609,7179,7107,91,72,"PDYC",5
33,"33026",9144,6019,5959,87,60,"PDYC",6
33,"33042",4434,3172,3135,43,37,"PDYC",1
33,"33059",5049,3480,3447,37,33,"PDYC",1
33,"33015",1695,1177,1161,12,16,"PDYC",0
33,"33004",69056,49228,48730,726,498,"PDYC",30
33,"33013",466,349,345,4,4,"PDYC",0
33,"33001",1772,984,971,14,13,"PDYC",0
33,"33067",802,650,639,12,11,"PDYC",0
33,"33039",1719,1325,1319,14,6,"PDYC",1
33,"33047",1178,939,931,2,8,"PDYC",0
33,"33071",671,528,523,4,5,"PDYC",0
33,"33007",1680,1186,1179,10,7,"PDYC",0
33,"33032",12060,8627,8491,107,136,"PDYC",2
33,"33034",11390,7583,7501,85,82,"PDYC",2
33,"33011",12085,7186,7116,89,70,"PDYC",0
33,"33019",3262,2283,2244,12,39,"PDYC",2
33,"33076",12662,8733,8670,120,63,"PDYC",7
33,"33027",929,617,613,5,4,"PDYC",0
33,"33050",653,406,402,0,4,"PDYC",0
33,"33037",37135,25522,25262,291,260,"PDYC",11
33,"33054",1780,1272,1263,8,9,"PDYC",0
33,"33022",992,709,696,12,13,"PDYC",0
33,"33020",13542,9300,9173,135,127,"PDYC",5
33,"33077",1351,938,931,7,7,"PDYC",0
33,"33068",1224,704,703,5,1,"PDYC",0
33,"33017",3289,2378,2350,35,28,"PDYC",1
33,"33005",1600,1084,1080,6,4,"PDYC",0
33,"33018",2971,2139,2121,32,18,"PDYC",0
33,"33023",3410,2501,2485,40,16,"PDYC",0
33,"33041",7488,5356,5309,65,47,"PDYC",4
33,"33043",710,529,528,1,1,"PDYC",0
33,"33072",1737,1171,1159,11,12,"PDYC",0
33,"33016",19516,14345,14210,198,135,"PDYC",8
33,"33036",11674,8695,8605,104,90,"PDYC",3
33,"33062",452,282,281,3,1,"PDYC",0
33,"33040",4702,3285,3236,44,49,"PDYC",2
33,"33061",446,260,259,1,1,"PDYC",0
33,"33052",758,526,518,2,8,"PDYC",0
33,"33035",11413,8105,8035,104,70,"PDYC",5
33,"33049",6806,4629,4581,70,48,"PDYC",0
33,"33048",169,120,120,1,0,"PDYC",0
33,"33045",4692,3347,3297,42,50,"PDYC",3
33,"33028",1466,812,806,5,6,"PDYC",0
33,"33051",7576,5379,5335,65,44,"PDYC",2
33,"33064",237,175,173,1,2,"PDYC",0
33,"33073",9341,5825,5773,69,52,"PDYC",9
33,"33012",5341,3816,3777,43,39,"PDYC",1
33,"33010",1922,1284,1277,14,7,"PDYC",4
33,"33014",9318,6380,6320,66,60,"PDYC",1
33,"33025",9455,6331,6277,84,54,"PDYC",1
33,"33058",1863,1307,1286,11,21,"PDYC",0
33,"33075",305,191,190,0,1,"PDYC",0
33,"33030",921,682,668,4,14,"PDYC",0
33,"33053",1206,817,811,6,6,"PDYC",0
33,"33029",420,243,241,3,2,"PDYC",0
33,"33069",3611,2615,2597,25,18,"PDYC",0
33,"33006",1674,1130,1120,10,10,"PDYC",0
27,"27053",606,429,426,4,3,"PSdeG-PSOE",136
27,"27058",3908,2946,2915,28,31,"PSdeG-PSOE",713
27,"27051",8224,6048,5953,108,95,"PSdeG-PSOE",1508
27,"27006",2789,1949,1911,22,38,"PSdeG-PSOE",628
32,"32072",3949,2881,2841,32,40,"PSdeG-PSOE",936
32,"32008",7618,5529,5433,83,96,"PSdeG-PSOE",1537
32,"32077",1234,999,993,23,6,"PSdeG-PSOE",269
32,"32089",1480,1063,1045,7,18,"PSdeG-PSOE",229
27,"27016",7521,5439,5338,83,101,"PSdeG-PSOE",1268
27,"27066",12908,9554,9329,171,225,"PSdeG-PSOE",2721
27,"27039",4363,3410,3346,63,64,"PSdeG-PSOE",660
32,"32023",1360,1030,1011,6,19,"PSdeG-PSOE",392
27,"27021",1936,1295,1271,19,24,"PSdeG-PSOE",273
32,"32085",10730,7588,7475,100,113,"PSdeG-PSOE",1737
32,"32069",4573,3624,3580,35,44,"PSdeG-PSOE",1237
32,"32024",5054,3668,3609,40,59,"PSdeG-PSOE",947
32,"32020",2958,2300,2283,19,17,"PSdeG-PSOE",471
32,"32048",1004,687,671,48,16,"PSdeG-PSOE",235
32,"32082",1403,1055,1047,9,8,"PSdeG-PSOE",241
32,"32062",963,735,729,10,6,"PSdeG-PSOE",98
27,"27063",1916,1469,1440,14,29,"PSdeG-PSOE",436
27,"27004",1379,981,966,4,15,"PSdeG-PSOE",269
32,"32056",1861,1378,1369,8,9,"PSdeG-PSOE",306
27,"27040",3421,2718,2693,27,25,"PSdeG-PSOE",792
32,"32014",1271,939,925,9,14,"PSdeG-PSOE",158
32,"32011",1026,660,650,4,10,"PSdeG-PSOE",41
32,"32018",1351,1100,1092,9,8,"PSdeG-PSOE",525
32,"32080",394,311,309,3,2,"PSdeG-PSOE",51
32,"32044",939,774,764,8,10,"PSdeG-PSOE",121
32,"32004",2071,1145,1142,7,3,"PSdeG-PSOE",76
32,"32084",1084,818,805,0,13,"PSdeG-PSOE",186
27,"27011",2663,1822,1785,23,37,"PSdeG-PSOE",640
32,"32015",995,697,694,9,3,"PSdeG-PSOE",134
32,"32017",1333,906,895,10,11,"PSdeG-PSOE",183
27,"27047",1851,1293,1273,16,20,"PSdeG-PSOE",390
27,"27060",2938,2063,2028,26,35,"PSdeG-PSOE",531
27,"27048",2404,1939,1909,36,30,"PSdeG-PSOE",716
32,"32025",1218,954,941,12,13,"PSdeG-PSOE",223
32,"32074",1180,892,876,11,16,"PSdeG-PSOE",195
32,"32042",1784,1292,1282,13,10,"PSdeG-PSOE",276
27,"27901",2559,1847,1831,27,16,"PSdeG-PSOE",373
27,"27031",16169,11446,11214,194,232,"PSdeG-PSOE",3434
32,"32016",1021,781,776,2,5,"PSdeG-PSOE",337
32,"32076",2358,1835,1823,18,12,"PSdeG-PSOE",338
32,"32027",1156,850,836,15,14,"PSdeG-PSOE",306
27,"27023",2770,2196,2178,30,18,"PSdeG-PSOE",574
27,"27042",1888,1427,1407,12,20,"PSdeG-PSOE",328
32,"32001",4938,3715,3667,50,48,"PSdeG-PSOE",587
27,"27017",1138,789,787,6,2,"PSdeG-PSOE",212
32,"32053",1500,1206,1199,19,7,"PSdeG-PSOE",238
32,"32038",497,360,358,2,2,"PSdeG-PSOE",101
32,"32026",2775,2096,2064,37,32,"PSdeG-PSOE",800
32,"32071",1614,1121,1112,4,9,"PSdeG-PSOE",333
32,"32060",885,650,641,10,9,"PSdeG-PSOE",258
32,"32059",1983,1526,1510,27,16,"PSdeG-PSOE",426
27,"27015",4587,3465,3409,55,56,"PSdeG-PSOE",704
32,"32007",1674,1263,1243,4,20,"PSdeG-PSOE",230
27,"27010",4725,3427,3368,55,59,"PSdeG-PSOE",756
32,"32052",2126,1690,1673,28,17,"PSdeG-PSOE",314
27,"27044",3089,2167,2125,31,42,"PSdeG-PSOE",490
27,"27054",1332,1063,1054,12,9,"PSdeG-PSOE",223
32,"32090",834,662,657,4,5,"PSdeG-PSOE",47
27,"27008",1458,1130,1115,18,15,"PSdeG-PSOE",300
32,"32057",608,475,473,4,2,"PSdeG-PSOE",230
32,"32091",1971,1472,1466,12,6,"PSdeG-PSOE",501
27,"27032",3466,2565,2530,40,35,"PSdeG-PSOE",715
27,"27020",3807,3204,3161,33,43,"PSdeG-PSOE",658
27,"27037",1205,857,845,13,12,"PSdeG-PSOE",221
32,"32032",8284,6295,6198,84,97,"PSdeG-PSOE",1228
32,"32068",1631,1187,1174,4,13,"PSdeG-PSOE",372
32,"32029",557,426,424,1,2,"PSdeG-PSOE",62
27,"27057",11297,8174,8005,162,169,"PSdeG-PSOE",2428
32,"32051",1574,1296,1290,7,6,"PSdeG-PSOE",192
27,"27056",1388,1043,1026,16,17,"PSdeG-PSOE",291
32,"32035",1632,1100,1088,8,12,"PSdeG-PSOE",191
32,"32013",2464,1695,1671,10,24,"PSdeG-PSOE",295
32,"32002",2060,1566,1551,13,15,"PSdeG-PSOE",597
27,"27028",78862,57097,55890,1246,1207,"PSdeG-PSOE",17998
32,"32066",634,492,488,0,4,"PSdeG-PSOE",59
27,"27033",723,536,529,10,7,"PSdeG-PSOE",141
32,"32036",1528,1217,1202,13,15,"PSdeG-PSOE",194
27,"27062",681,535,532,7,3,"PSdeG-PSOE",160
32,"32031",1079,837,828,5,9,"PSdeG-PSOE",134
32,"32088",1749,1232,1217,10,15,"PSdeG-PSOE",419
27,"27027",2111,1652,1605,21,47,"PSdeG-PSOE",448
27,"27012",1519,886,880,6,6,"PSdeG-PSOE",360
27,"27024",1759,1346,1324,17,22,"PSdeG-PSOE",460
32,"32054",87289,63027,61875,1263,1152,"PSdeG-PSOE",21194
32,"32075",3839,2957,2910,51,47,"PSdeG-PSOE",729
27,"27038",1035,817,809,9,8,"PSdeG-PSOE",271
32,"32063",2127,1469,1444,22,25,"PSdeG-PSOE",432
27,"27009",2354,1812,1782,19,30,"PSdeG-PSOE",393
32,"32006",1814,1344,1330,20,14,"PSdeG-PSOE",216
27,"27005",2792,2101,2076,21,25,"PSdeG-PSOE",409
27,"27052",966,726,718,9,8,"PSdeG-PSOE",310
27,"27026",2605,1785,1751,19,34,"PSdeG-PSOE",496
32,"32040",1587,1226,1219,7,7,"PSdeG-PSOE",271
32,"32039",1424,1084,1069,10,15,"PSdeG-PSOE",182
32,"32046",1375,976,962,3,14,"PSdeG-PSOE",196
32,"32005",957,760,753,8,7,"PSdeG-PSOE",151
32,"32041",884,576,568,2,8,"PSdeG-PSOE",140
27,"27064",1706,1233,1214,14,19,"PSdeG-PSOE",223
32,"32003",950,736,727,3,9,"PSdeG-PSOE",174
32,"32009",10752,7778,7684,120,94,"PSdeG-PSOE",2465
32,"32086",2874,2026,2003,18,23,"PSdeG-PSOE",477
32,"32087",1935,1609,1591,11,18,"PSdeG-PSOE",293
32,"32067",1487,1004,995,10,9,"PSdeG-PSOE",181
27,"27061",1170,917,906,8,11,"PSdeG-PSOE",166
27,"27003",2064,1531,1516,19,15,"PSdeG-PSOE",298
32,"32083",960,675,672,0,3,"PSdeG-PSOE",199
27,"27035",194,119,119,0,0,"PSdeG-PSOE",58
32,"32092",596,367,364,2,3,"PSdeG-PSOE",84
32,"32049",863,566,563,7,3,"PSdeG-PSOE",171
32,"32061",1196,976,973,4,3,"PSdeG-PSOE",357
27,"27043",1422,988,962,10,26,"PSdeG-PSOE",274
32,"32028",1805,1369,1354,16,15,"PSdeG-PSOE",159
32,"32047",2003,1595,1575,10,20,"PSdeG-PSOE",229
27,"27055",1494,1120,1107,8,13,"PSdeG-PSOE",463
32,"32043",2679,2006,1985,14,21,"PSdeG-PSOE",445
27,"27029",1525,1243,1221,18,22,"PSdeG-PSOE",352
27,"27013",3950,3156,3090,39,66,"PSdeG-PSOE",1007
32,"32055",1412,1056,1037,5,19,"PSdeG-PSOE",240
27,"27041",2644,1946,1915,29,31,"PSdeG-PSOE",411
27,"27001",2582,1687,1669,31,18,"PSdeG-PSOE",241
32,"32010",457,362,356,0,6,"PSdeG-PSOE",88
27,"27034",1297,871,867,3,4,"PSdeG-PSOE",327
27,"27902",7198,5074,4976,106,98,"PSdeG-PSOE",1195
27,"27050",3236,2475,2438,11,37,"PSdeG-PSOE",536
32,"32081",2240,1698,1682,13,16,"PSdeG-PSOE",484
32,"32037",828,660,654,10,6,"PSdeG-PSOE",118
27,"27007",3015,2426,2374,42,52,"PSdeG-PSOE",443
27,"27002",1835,1455,1437,16,18,"PSdeG-PSOE",406
32,"32045",2640,1999,1980,23,19,"PSdeG-PSOE",630
27,"27065",13035,9432,9254,168,178,"PSdeG-PSOE",1917
32,"32050",2663,1991,1974,17,17,"PSdeG-PSOE",446
32,"32022",1591,1219,1207,9,12,"PSdeG-PSOE",289
32,"32065",720,550,539,3,11,"PSdeG-PSOE",196
32,"32012",912,763,756,8,7,"PSdeG-PSOE",161
32,"32019",11469,8297,8180,134,117,"PSdeG-PSOE",2092
32,"32058",5253,3872,3821,57,51,"PSdeG-PSOE",1017
27,"27045",1149,817,812,7,5,"PSdeG-PSOE",446
27,"27030",3744,2587,2525,32,62,"PSdeG-PSOE",650
32,"32079",1448,1103,1094,14,9,"PSdeG-PSOE",311
27,"27025",3005,2414,2377,25,37,"PSdeG-PSOE",451
27,"27046",1626,1177,1153,17,24,"PSdeG-PSOE",409
32,"32021",1043,793,788,7,5,"PSdeG-PSOE",360
32,"32064",561,439,437,5,2,"PSdeG-PSOE",58
32,"32030",1120,857,846,9,11,"PSdeG-PSOE",443
32,"32073",1415,1111,1100,8,11,"PSdeG-PSOE",363
27,"27049",1554,1073,1062,6,11,"PSdeG-PSOE",244
27,"27018",3871,2523,2489,32,34,"PSdeG-PSOE",1043
27,"27059",2320,1783,1763,25,20,"PSdeG-PSOE",350
27,"27019",8247,6146,6022,101,124,"PSdeG-PSOE",1849
27,"27014",3511,2470,2437,45,33,"PSdeG-PSOE",665
27,"27022",5093,3535,3486,74,49,"PSdeG-PSOE",920
32,"32034",1228,995,990,5,5,"PSdeG-PSOE",265
32,"32078",1366,1026,1018,3,8,"PSdeG-PSOE",176
32,"32033",843,595,583,7,12,"PSdeG-PSOE",144
32,"32070",660,457,452,1,5,"PSdeG-PSOE",88
15,"15052",4567,3539,3493,22,46,"PSdeG-PSOE",1293
15,"15081",1139,869,853,9,16,"PSdeG-PSOE",96
36,"36001",3138,2060,2049,13,11,"PSdeG-PSOE",405
36,"36055",13678,10508,10288,155,220,"PSdeG-PSOE",2093
15,"15087",6054,4004,3956,79,48,"PSdeG-PSOE",1005
15,"15040",2891,2160,2129,18,31,"PSdeG-PSOE",529
15,"15067",8142,6054,5978,73,76,"PSdeG-PSOE",1562
36,"36034",3684,2686,2651,32,35,"PSdeG-PSOE",633
15,"15024",4726,3634,3555,51,79,"PSdeG-PSOE",1036
36,"36016",1373,865,853,7,12,"PSdeG-PSOE",86
15,"15050",1971,1110,1097,27,13,"PSdeG-PSOE",297
36,"36026",20494,14048,13798,232,250,"PSdeG-PSOE",3625
15,"15048",4769,3470,3415,57,55,"PSdeG-PSOE",946
15,"15041",9718,7514,7425,102,89,"PSdeG-PSOE",1720
36,"36043",5188,3435,3390,35,45,"PSdeG-PSOE",754
15,"15022",6102,4207,4164,52,43,"PSdeG-PSOE",1085
36,"36028",4207,3294,3254,21,40,"PSdeG-PSOE",844
36,"36059",5438,3874,3805,47,69,"PSdeG-PSOE",750
15,"15082",15075,11217,11046,187,171,"PSdeG-PSOE",2547
36,"36022",9203,6423,6226,100,197,"PSdeG-PSOE",2083
15,"15003",1936,1400,1382,19,18,"PSdeG-PSOE",282
15,"15012",3767,2973,2926,51,47,"PSdeG-PSOE",559
15,"15061",6105,4391,4307,64,84,"PSdeG-PSOE",1130
15,"15043",5491,4033,3971,45,62,"PSdeG-PSOE",929
36,"36040",2627,1938,1907,24,31,"PSdeG-PSOE",499
36,"36003",9876,7155,7007,100,148,"PSdeG-PSOE",1675
15,"15008",5657,4224,4157,62,67,"PSdeG-PSOE",1128
15,"15059",10658,7889,7728,125,161,"PSdeG-PSOE",1597
15,"15064",2356,1859,1824,35,35,"PSdeG-PSOE",671
15,"15073",21991,14686,14456,216,230,"PSdeG-PSOE",2926
15,"15053",8164,5679,5592,60,87,"PSdeG-PSOE",1631
36,"36010",2987,2312,2282,30,30,"PSdeG-PSOE",732
36,"36025",2442,1531,1516,10,15,"PSdeG-PSOE",263
36,"36014",2145,1568,1548,9,20,"PSdeG-PSOE",346
15,"15090",1267,959,953,4,6,"PSdeG-PSOE",104
15,"15031",22951,16018,15696,382,322,"PSdeG-PSOE",5456
15,"15015",2840,2006,1964,43,42,"PSdeG-PSOE",552
36,"36901",4085,3285,3235,21,50,"PSdeG-PSOE",1376
36,"36046",4093,3175,3120,31,55,"PSdeG-PSOE",812
15,"15030",201751,141022,138934,2981,2088,"PSdeG-PSOE",43415
36,"36033",12323,9328,9150,97,178,"PSdeG-PSOE",2694
36,"36006",11387,8911,8727,72,184,"PSdeG-PSOE",1889
36,"36056",5087,3883,3830,37,53,"PSdeG-PSOE",757
15,"15049",1211,851,843,7,8,"PSdeG-PSOE",117
36,"36057",236900,168990,166060,2833,2930,"PSdeG-PSOE",55103
15,"15069",7019,5036,4938,85,98,"PSdeG-PSOE",1401
36,"36054",10862,8201,8087,87,114,"PSdeG-PSOE",1730
15,"15080",1913,1407,1389,15,18,"PSdeG-PSOE",212
15,"15028",1485,1130,1118,14,12,"PSdeG-PSOE",344
15,"15045",4178,2743,2727,22,16,"PSdeG-PSOE",418
15,"15056",5873,4205,4150,63,55,"PSdeG-PSOE",1168
15,"15060",5599,4139,4069,82,70,"PSdeG-PSOE",1047
15,"15068",5404,3780,3725,53,55,"PSdeG-PSOE",812
36,"36036",2616,1981,1948,24,33,"PSdeG-PSOE",490
36,"36002",3154,2381,2358,35,23,"PSdeG-PSOE",518
36,"36047",2723,1875,1853,27,22,"PSdeG-PSOE",464
36,"36024",17164,12723,12500,163,223,"PSdeG-PSOE",2204
15,"15042",3249,2341,2303,25,38,"PSdeG-PSOE",548
15,"15021",5114,3527,3475,77,52,"PSdeG-PSOE",968
15,"15036",60838,40345,39667,915,678,"PSdeG-PSOE",12039
36,"36029",16178,11902,11636,148,266,"PSdeG-PSOE",2665
36,"36009",5138,3147,3108,24,39,"PSdeG-PSOE",698
15,"15093",4562,3314,3270,37,44,"PSdeG-PSOE",541
15,"15076",2766,1971,1936,18,35,"PSdeG-PSOE",303
15,"15009",11109,8179,8014,129,165,"PSdeG-PSOE",2382
15,"15013",6160,4229,4165,70,64,"PSdeG-PSOE",1080
36,"36023",8522,6206,6062,64,144,"PSdeG-PSOE",1530
36,"36037",2727,1923,1896,18,27,"PSdeG-PSOE",337
15,"15023",6629,4879,4795,52,84,"PSdeG-PSOE",1458
36,"36049",6608,5189,5097,56,92,"PSdeG-PSOE",964
15,"15089",4354,3255,3216,55,39,"PSdeG-PSOE",727
36,"36020",2581,1947,1922,27,25,"PSdeG-PSOE",383
15,"15006",5539,3940,3866,53,74,"PSdeG-PSOE",797
36,"36039",14581,11007,10782,167,225,"PSdeG-PSOE",2551
15,"15083",1198,874,855,8,19,"PSdeG-PSOE",137
36,"36018",3492,2516,2494,25,22,"PSdeG-PSOE",537
36,"36045",24724,17794,17459,237,335,"PSdeG-PSOE",5865
15,"15032",3639,2642,2586,35,56,"PSdeG-PSOE",445
15,"15017",18860,12975,12737,325,238,"PSdeG-PSOE",3838
15,"15071",8233,5751,5668,93,83,"PSdeG-PSOE",1431
15,"15091",1171,839,829,9,10,"PSdeG-PSOE",178
36,"36058",5021,3589,3516,54,73,"PSdeG-PSOE",1036
36,"36013",2690,1801,1778,11,23,"PSdeG-PSOE",315
15,"15034",3116,2146,2114,20,32,"PSdeG-PSOE",902
15,"15033",2581,2094,2079,15,15,"PSdeG-PSOE",466
15,"15088",3769,2626,2599,21,27,"PSdeG-PSOE",483
15,"15001",4985,3560,3506,63,54,"PSdeG-PSOE",782
15,"15039",1374,1027,998,27,29,"PSdeG-PSOE",205
15,"15051",4780,3333,3289,61,44,"PSdeG-PSOE",975
15,"15065",7570,5710,5628,71,82,"PSdeG-PSOE",1337
15,"15055",4780,3247,3181,70,66,"PSdeG-PSOE",903
36,"36061",8729,6747,6640,68,107,"PSdeG-PSOE",1276
15,"15014",4239,3151,3104,39,47,"PSdeG-PSOE",592
15,"15086",3110,2281,2259,30,22,"PSdeG-PSOE",450
15,"15062",6304,4418,4356,44,62,"PSdeG-PSOE",824
15,"15005",23875,15132,14895,356,237,"PSdeG-PSOE",4226
15,"15901",3855,2463,2419,48,44,"PSdeG-PSOE",699
36,"36021",11798,8742,8574,136,168,"PSdeG-PSOE",2078
36,"36035",14551,10675,10469,160,206,"PSdeG-PSOE",2825
36,"36042",17897,12635,12437,157,198,"PSdeG-PSOE",3302
15,"15011",15507,10935,10751,123,184,"PSdeG-PSOE",2644
15,"15075",12042,8639,8486,147,153,"PSdeG-PSOE",2357
36,"36044",2595,1862,1834,23,28,"PSdeG-PSOE",384
15,"15027",1537,1263,1242,22,21,"PSdeG-PSOE",243
15,"15044",1436,1083,1068,10,15,"PSdeG-PSOE",301
36,"36017",18554,13573,13378,200,195,"PSdeG-PSOE",3342
15,"15010",2009,1468,1441,24,27,"PSdeG-PSOE",369
15,"15074",4254,3246,3219,35,27,"PSdeG-PSOE",496
15,"15002",21528,15479,15218,314,261,"PSdeG-PSOE",3957
15,"15077",8677,6349,6269,82,80,"PSdeG-PSOE",1161
36,"36048",5416,4045,3971,55,74,"PSdeG-PSOE",1019
36,"36012",3839,2884,2825,14,59,"PSdeG-PSOE",959
15,"15016",5135,3816,3771,22,45,"PSdeG-PSOE",1372
36,"36031",572,484,479,5,5,"PSdeG-PSOE",78
15,"15079",1709,1268,1253,14,15,"PSdeG-PSOE",272
36,"36004",10264,7383,7263,80,120,"PSdeG-PSOE",1529
15,"15029",6266,4668,4618,49,50,"PSdeG-PSOE",936
15,"15078",78092,56506,55597,1110,909,"PSdeG-PSOE",14761
36,"36015",4379,3151,3101,38,50,"PSdeG-PSOE",855
15,"15004",4891,3595,3545,61,50,"PSdeG-PSOE",1100
36,"36050",7602,5424,5339,50,85,"PSdeG-PSOE",1527
15,"15026",2025,1426,1413,17,13,"PSdeG-PSOE",271
36,"36019",1681,1204,1188,14,16,"PSdeG-PSOE",507
15,"15018",1211,821,805,11,16,"PSdeG-PSOE",312
36,"36051",14288,10228,10079,124,149,"PSdeG-PSOE",2543
36,"36060",30264,21398,21051,344,347,"PSdeG-PSOE",6730
15,"15046",6949,4641,4539,56,102,"PSdeG-PSOE",843
36,"36032",3666,2789,2755,25,34,"PSdeG-PSOE",759
36,"36053",5677,4204,4157,51,47,"PSdeG-PSOE",937
36,"36005",8231,5985,5873,84,112,"PSdeG-PSOE",1927
36,"36041",13141,9405,9238,114,167,"PSdeG-PSOE",2178
36,"36038",65661,47940,47214,836,726,"PSdeG-PSOE",13493
15,"15025",1173,780,777,10,3,"PSdeG-PSOE",160
15,"15019",26096,18466,18187,350,279,"PSdeG-PSOE",4397
15,"15058",26931,19505,19196,471,309,"PSdeG-PSOE",5476
15,"15070",9684,6627,6464,141,163,"PSdeG-PSOE",2337
36,"36007",1778,1258,1238,2,20,"PSdeG-PSOE",298
36,"36027",4478,3376,3339,29,37,"PSdeG-PSOE",755
15,"15035",11969,8239,8120,192,119,"PSdeG-PSOE",2388
15,"15057",12467,8936,8744,102,192,"PSdeG-PSOE",2256
15,"15072",9868,7077,6951,79,126,"PSdeG-PSOE",2008
15,"15084",3681,2676,2656,34,20,"PSdeG-PSOE",389
15,"15007",3702,2670,2642,19,28,"PSdeG-PSOE",689
15,"15085",3576,2656,2612,29,44,"PSdeG-PSOE",525
15,"15054",32172,20472,20154,519,318,"PSdeG-PSOE",5462
36,"36030",4387,3206,3177,35,29,"PSdeG-PSOE",676
36,"36008",21702,15366,15037,261,329,"PSdeG-PSOE",3971
15,"15020",4187,2802,2781,18,21,"PSdeG-PSOE",737
36,"36011",1939,1189,1172,15,17,"PSdeG-PSOE",302
15,"15092",6869,4965,4907,53,58,"PSdeG-PSOE",1172
15,"15038",2363,1643,1610,29,33,"PSdeG-PSOE",337
15,"15037",4181,2839,2804,25,35,"PSdeG-PSOE",671
15,"15047",2606,1789,1761,33,28,"PSdeG-PSOE",549
15,"15063",2849,2022,2001,28,21,"PSdeG-PSOE",444
15,"15066",4180,3098,3062,38,36,"PSdeG-PSOE",542
36,"36052",7517,5563,5461,54,102,"PSdeG-PSOE",1444
3,"3054",371,321,315,2,6,"PH",0
15,"15086",3110,2281,2259,30,22,"PH",2
50,"50202",182,125,122,2,3,"PH",0
3,"3112",684,566,561,4,5,"PH",0
50,"50212",52,48,48,0,0,"PH",0
3,"3010",330,269,266,3,3,"PH",0
28,"28113",31318,23779,23436,271,343,"PH",19
41,"41061",2205,1798,1770,2,28,"PH",0
39,"39049",339,244,242,5,2,"PH",0
15,"15039",1374,1027,998,27,29,"PH",1
29,"29043",2596,1670,1647,24,23,"PH",1
50,"50241",634,462,455,2,7,"PH",0
33,"33011",12085,7186,7116,89,70,"PH",5
28,"28131",12664,9454,9342,100,112,"PH",3
29,"29902",2577,1689,1665,20,24,"PH",0
3,"3901",1070,826,818,14,8,"PH",1
15,"15023",6629,4879,4795,52,84,"PH",4
46,"46001",863,647,641,5,6,"PH",1
46,"46233",3911,3025,2988,10,37,"PH",3
33,"33045",4692,3347,3297,42,50,"PH",0
28,"28124",83,55,53,0,2,"PH",0
46,"46114",565,501,495,3,6,"PH",1
3,"3123",7435,5860,5744,63,116,"PH",11
3,"3100",540,448,443,2,5,"PH",1
46,"46179",2186,1849,1804,17,45,"PH",2
29,"29002",1246,896,893,11,3,"PH",1
28,"28143",81,71,67,1,4,"PH",0
50,"50068",2082,1514,1481,18,33,"PH",1
50,"50071",134,97,96,0,1,"PH",0
28,"28016",86,68,67,3,1,"PH",0
28,"28148",79726,60405,59651,724,754,"PH",52
46,"46142",870,682,673,7,9,"PH",0
41,"41093",17665,13712,13526,179,186,"PH",13
28,"28083",8037,6078,6025,66,53,"PH",8
33,"33043",710,529,528,1,1,"PH",0
50,"50297",495260,360632,355561,7046,5071,"PH",320
46,"46199",5661,4328,4280,38,48,"PH",3
28,"28165",1689,1310,1295,5,15,"PH",1
46,"46004",1933,1563,1541,8,22,"PH",0
50,"50065",59,37,37,2,0,"PH",0
28,"28176",10977,8790,8718,68,72,"PH",7
50,"50094",1744,1220,1193,25,27,"PH",1
50,"50048",43,33,33,1,0,"PH",0
29,"29052",245,151,151,0,0,"PH",0
46,"46206",595,497,495,3,2,"PH",1
29,"29053",1715,1239,1221,7,18,"PH",0
3,"3039",92,70,66,1,4,"PH",1
28,"28078",39,23,23,1,0,"PH",0
50,"50275",103,76,76,0,0,"PH",0
41,"41073",1789,1292,1272,5,20,"PH",1
46,"46191",1952,1554,1528,9,26,"PH",1
28,"28021",418,334,328,4,6,"PH",1
28,"28062",311,233,226,0,7,"PH",0
46,"46158",1037,829,822,9,7,"PH",1
28,"28117",116,90,90,1,0,"PH",0
50,"50174",107,92,90,0,2,"PH",0
46,"46163",1811,1487,1463,12,24,"PH",4
28,"28088",251,174,173,5,1,"PH",0
50,"50080",41,31,31,1,0,"PH",0
46,"46055",1286,1083,1067,11,16,"PH",1
3,"3095",4498,3558,3517,29,41,"PH",6
33,"33053",1206,817,811,6,6,"PH",1
46,"46903",5210,4037,4000,40,37,"PH",1
28,"28120",1259,946,931,11,15,"PH",0
35,"35024",12420,6978,6819,131,159,"PH",5
39,"39092",1030,753,747,1,6,"PH",0
50,"50140",172,108,108,1,0,"PH",0
28,"28122",504,367,366,2,1,"PH",0
41,"41008",1073,884,875,0,9,"PH",0
41,"41051",2103,1705,1686,7,19,"PH",0
41,"41027",4061,2783,2752,28,31,"PH",9
29,"29047",1165,973,969,0,4,"PH",0
46,"46150",1898,1555,1541,8,14,"PH",2
50,"50132",697,544,536,11,8,"PH",0
46,"46204",6906,5426,5357,62,69,"PH",5
41,"41101",5752,4663,4629,25,34,"PH",1
28,"28172",7648,6130,6076,65,54,"PH",4
46,"46085",11344,8526,8426,87,100,"PH",4
28,"28064",143,112,110,1,2,"PH",0
50,"50151",713,536,531,5,5,"PH",1
41,"41055",15121,11082,10997,98,85,"PH",11
3,"3032",112,90,88,0,2,"PH",0
3,"3079",18028,14580,14317,189,263,"PH",47
46,"46006",4643,3847,3785,32,62,"PH",0
15,"15007",3702,2670,2642,19,28,"PH",1
28,"28037",1598,1263,1250,10,13,"PH",0
41,"41003",2196,1803,1782,21,21,"PH",0
39,"39081",440,372,369,3,3,"PH",1
33,"33032",12060,8627,8491,107,136,"PH",4
3,"3119",15887,12128,11988,122,140,"PH",16
29,"29069",80337,50235,49723,690,512,"PH",50
50,"50256",90,59,59,1,0,"PH",0
35,"35004",35462,18498,18196,325,302,"PH",28
46,"46257",5579,4546,4512,32,34,"PH",5
50,"50284",176,131,130,1,1,"PH",1
3,"3134",159,129,126,0,3,"PH",0
46,"46231",2496,1831,1817,16,14,"PH",2
15,"15093",4562,3314,3270,37,44,"PH",0
46,"46172",4838,3492,3445,24,47,"PH",2
50,"50231",285,231,224,7,7,"PH",0
39,"39060",6723,5453,5360,56,93,"PH",6
46,"46017",32928,24879,24672,267,207,"PH",25
15,"15030",201751,141022,138934,2981,2088,"PH",204
50,"50086",193,109,109,0,0,"PH",0
35,"35016",291589,181013,177964,2856,3049,"PH",522
3,"3043",2933,2494,2447,27,47,"PH",3
29,"29080",6598,4703,4663,31,40,"PH",5
46,"46060",9510,7506,7408,52,98,"PH",6
41,"41026",4273,3577,3538,15,39,"PH",1
50,"50120",53,41,41,0,0,"PH",0
41,"41084",2875,2362,2335,9,27,"PH",0
28,"28100",3970,2903,2865,32,38,"PH",4
3,"3066",42697,31279,30833,566,446,"PH",74
15,"15074",4254,3246,3219,35,27,"PH",2
46,"46258",2792,2196,2164,14,32,"PH",0
15,"15049",1211,851,843,7,8,"PH",0
46,"46261",1706,1388,1366,13,22,"PH",0
39,"39007",479,348,347,3,1,"PH",0
15,"15042",3249,2341,2303,25,38,"PH",1
15,"15004",4891,3595,3545,61,50,"PH",4
39,"39040",4350,3413,3373,30,40,"PH",1
15,"15011",15507,10935,10751,123,184,"PH",10
50,"50093",113,84,84,2,0,"PH",0
41,"41081",28121,20027,19785,275,242,"PH",18
33,"33033",10609,7179,7107,91,72,"PH",4
28,"28002",2650,2018,1993,24,25,"PH",0
46,"46195",1975,1631,1631,33,0,"PH",0
35,"35012",9662,5511,5446,45,65,"PH",4
46,"46034",1791,1477,1468,8,9,"PH",2
46,"46151",717,596,589,3,7,"PH",0
41,"41021",20767,14040,13822,240,218,"PH",10
39,"39017",588,424,419,2,5,"PH",0
39,"39037",2061,1609,1586,10,23,"PH",1
28,"28030",1591,1268,1230,12,38,"PH",1
50,"50107",953,785,780,13,5,"PH",2
50,"50220",59,43,43,1,0,"PH",0
46,"46133",686,572,565,1,7,"PH",0
50,"50062",1750,1298,1275,22,23,"PH",0
50,"50162",160,108,108,2,0,"PH",0
28,"28101",222,158,158,4,0,"PH",0
15,"15089",4354,3255,3216,55,39,"PH",3
46,"46037",1146,1007,1003,5,4,"PH",0
46,"46116",12587,9821,9724,120,97,"PH",9
33,"33050",653,406,402,0,4,"PH",0
29,"29081",290,226,226,3,0,"PH",0
33,"33048",169,120,120,1,0,"PH",0
50,"50259",89,53,53,1,0,"PH",0
46,"46174",1003,854,847,6,7,"PH",0
28,"28014",31360,23434,23133,203,301,"PH",11
3,"3107",2288,1670,1647,15,23,"PH",0
39,"39031",1227,965,956,4,9,"PH",0
50,"50004",613,445,441,6,4,"PH",0
46,"46109",6143,4731,4637,40,94,"PH",5
33,"33024",229816,164603,163179,2100,1424,"PH",73
28,"28145",2125,1643,1620,15,23,"PH",0
28,"28076",417,325,321,1,4,"PH",0
41,"41020",12710,8954,8882,91,72,"PH",5
15,"15087",6054,4004,3956,79,48,"PH",1
28,"28114",148,110,110,0,0,"PH",0
29,"29089",3343,2514,2489,14,25,"PH",2
35,"35009",19678,13799,13442,155,357,"PH",36
50,"50243",346,277,272,2,5,"PH",0
15,"15064",2356,1859,1824,35,35,"PH",0
46,"46166",8260,6422,6324,60,98,"PH",7
33,"33041",7488,5356,5309,65,47,"PH",2
28,"28127",60108,48418,48039,568,379,"PH",14
29,"29061",1045,861,855,7,6,"PH",0
15,"15055",4780,3247,3181,70,66,"PH",3
29,"29090",1805,1265,1260,5,5,"PH",1
46,"46029",20887,16124,15988,144,136,"PH",14
50,"50193",635,483,465,3,18,"PH",1
39,"39069",1957,1595,1570,18,25,"PH",0
28,"28007",122891,95200,94139,990,1061,"PH",82
41,"41096",6079,4673,4595,47,78,"PH",4
46,"46230",14204,10650,10515,112,135,"PH",6
41,"41023",7901,6050,5972,45,78,"PH",6
50,"50058",80,65,64,0,1,"PH",0
46,"46053",584,484,461,2,23,"PH",0
33,"33001",1772,984,971,14,13,"PH",0
28,"28179",1385,1039,1027,10,12,"PH",1
46,"46232",920,730,722,6,8,"PH",0
28,"28010",9309,7304,7229,71,75,"PH",5
3,"3051",356,314,311,2,3,"PH",1
50,"50289",71,59,59,0,0,"PH",0
28,"28090",7899,6216,6131,60,85,"PH",3
50,"50157",313,253,250,7,3,"PH",0
39,"39030",1971,1397,1379,20,18,"PH",0
41,"41903",6653,5134,5070,61,64,"PH",1
46,"46044",4301,3284,3169,50,115,"PH",3
46,"46103",1244,998,972,12,26,"PH",0
15,"15070",9684,6627,6464,141,163,"PH",5
46,"46143",4278,3309,3266,46,43,"PH",1
46,"46147",16527,11836,11716,105,120,"PH",10
41,"41065",23028,15133,14958,191,175,"PH",4
39,"39068",663,488,485,4,3,"PH",0
50,"50149",48,35,35,0,0,"PH",0
46,"46066",1264,1060,1050,5,10,"PH",0
28,"28115",57612,46786,46458,458,328,"PH",17
46,"46155",1072,861,849,4,12,"PH",0
3,"3105",5322,4218,4124,34,94,"PH",5
15,"15018",1211,821,805,11,16,"PH",0
15,"15008",5657,4224,4157,62,67,"PH",1
50,"50010",77,65,64,5,1,"PH",0
50,"50159",728,554,544,4,10,"PH",0
50,"50077",254,189,188,4,1,"PH",0
41,"41067",7055,5368,5295,64,73,"PH",2
29,"29034",462,360,357,0,3,"PH",2
46,"46042",3376,2873,2819,17,54,"PH",1
29,"29058",1560,1103,1096,5,7,"PH",0
28,"28097",127,94,92,0,2,"PH",0
46,"46250",574266,435877,431619,4626,4258,"PH",442
50,"50238",114,82,80,0,2,"PH",0
29,"29070",35228,23374,23146,258,228,"PH",31
3,"3028",1049,903,895,6,8,"PH",0
50,"50246",48,33,33,1,0,"PH",0
46,"46069",166,149,148,1,1,"PH",0
3,"3056",8929,6927,6776,74,151,"PH",14
28,"28155",529,427,416,2,11,"PH",0
33,"33031",38090,25034,24730,380,304,"PH",11
50,"50044",259,175,175,0,0,"PH",0
41,"41028",1880,1479,1458,28,21,"PH",2
46,"46253",118,105,102,7,3,"PH",0
46,"46117",476,377,373,6,4,"PH",0
15,"15032",3639,2642,2586,35,56,"PH",1
39,"39056",2387,1857,1835,22,22,"PH",0
33,"33061",446,260,259,1,1,"PH",0
50,"50124",474,375,367,11,8,"PH",0
39,"39084",873,647,642,4,5,"PH",0
3,"3118",2368,1746,1718,16,28,"PH",4
50,"50014",169,108,108,1,0,"PH",1
29,"29036",670,504,499,4,5,"PH",0
28,"28138",78,48,46,0,2,"PH",0
50,"50161",124,86,86,1,0,"PH",0
28,"28040",15089,9976,9852,116,124,"PH",8
15,"15056",5873,4205,4150,63,55,"PH",3
50,"50038",1583,1194,1174,29,20,"PH",2
35,"35015",9065,4859,4770,64,89,"PH",6
15,"15021",5114,3527,3475,77,52,"PH",5
50,"50056",450,329,328,4,1,"PH",0
50,"50277",82,63,63,0,0,"PH",0
29,"29083",2212,1679,1652,15,27,"PH",1
28,"28043",5944,4199,4147,56,52,"PH",0
46,"46056",203,164,160,2,4,"PH",0
50,"50192",240,188,184,9,4,"PH",0
3,"3060",124,100,98,0,2,"PH",0
39,"39101",328,251,247,5,4,"PH",0
39,"39067",901,628,623,1,5,"PH",1
39,"39059",8476,6365,6284,73,81,"PH",3
50,"50214",31,22,21,1,1,"PH",0
15,"15013",6160,4229,4165,70,64,"PH",7
46,"46159",23111,17258,17086,141,172,"PH",20
46,"46176",1965,1423,1405,12,18,"PH",0
46,"46125",858,724,710,6,14,"PH",0
46,"46099",987,764,754,2,10,"PH",0
50,"50104",379,306,303,4,3,"PH",0
46,"46022",15090,10922,10840,99,82,"PH",14
50,"50072",181,128,127,1,1,"PH",0
3,"3076",8373,6319,6222,68,97,"PH",3
50,"50276",148,116,114,3,2,"PH",1
46,"46014",3092,2449,2420,26,29,"PH",1
50,"50155",119,91,91,1,0,"PH",0
46,"46104",2012,1691,1676,9,15,"PH",0
46,"46071",488,418,402,10,16,"PH",0
3,"3138",3218,2403,2388,22,15,"PH",2
29,"29021",153,113,113,0,0,"PH",0
50,"50164",407,271,268,4,3,"PH",1
39,"39025",8985,7048,6955,70,93,"PH",8
50,"50152",1569,1151,1135,31,16,"PH",0
28,"28164",2807,2194,2173,10,21,"PH",0
50,"50195",48,38,38,1,0,"PH",0
46,"46086",80,71,71,3,0,"PH",0
50,"50271",283,209,207,4,2,"PH",0
33,"33074",3699,2643,2611,30,32,"PH",0
29,"29001",4176,3339,3303,23,36,"PH",0
39,"39100",922,718,712,8,6,"PH",0
15,"15062",6304,4418,4356,44,62,"PH",3
50,"50148",365,256,251,2,5,"PH",0
50,"50059",790,593,586,12,7,"PH",0
33,"33020",13542,9300,9173,135,127,"PH",4
41,"41018",9457,6940,6867,66,73,"PH",7
46,"46136",2476,1890,1865,16,25,"PH",1
33,"33073",9341,5825,5773,69,52,"PH",0
46,"46234",388,308,307,3,1,"PH",0
50,"50050",109,73,73,1,0,"PH",0
50,"50061",228,191,183,3,8,"PH",0
50,"50205",98,72,71,2,1,"PH",0
39,"39089",163,126,126,0,0,"PH",0
46,"46131",49087,37846,37477,422,369,"PH",27
50,"50249",333,280,272,2,8,"PH",0
46,"46135",9634,7671,7586,64,85,"PH",7
39,"39075",140941,103308,102362,1364,946,"PH",95
28,"28121",185,153,152,0,1,"PH",0
46,"46239",457,331,323,2,8,"PH",2
46,"46093",2082,1722,1716,9,6,"PH",0
29,"29063",358,272,271,2,1,"PH",0
50,"50057",1468,1022,1004,17,18,"PH",5
46,"46170",3464,2944,2908,24,36,"PH",4
46,"46106",1616,1196,1188,6,8,"PH",0
3,"3062",206,175,175,0,0,"PH",0
35,"35031",6968,4927,4862,71,65,"PH",15
41,"41001",1642,1314,1302,10,12,"PH",0
41,"41102",14343,11050,10837,206,213,"PH",6
39,"39098",1522,1256,1244,8,12,"PH",1
39,"39010",688,533,524,6,9,"PH",0
3,"3021",5594,4630,4517,46,113,"PH",6
41,"41095",40097,27969,27731,354,238,"PH",25
28,"28070",139,98,97,0,1,"PH",0
3,"3061",1052,842,836,6,6,"PH",1
41,"41034",22561,16014,15840,270,174,"PH",17
50,"50006",978,758,749,16,9,"PH",2
46,"46197",1902,1559,1554,15,5,"PH",1
29,"29017",6766,5162,5114,48,48,"PH",5
50,"50280",370,296,291,5,5,"PH",0
35,"35032",3432,2605,2548,37,57,"PH",2
46,"46078",28197,20643,20415,205,228,"PH",25
28,"28901",765,579,567,2,12,"PH",1
46,"46138",338,297,296,1,1,"PH",0
28,"28004",5761,4098,4044,38,54,"PH",3
39,"39036",1023,802,790,5,12,"PH",0
33,"33069",3611,2615,2597,25,18,"PH",1
28,"28162",2263,1802,1786,32,16,"PH",3
41,"41045",5505,3946,3889,68,57,"PH",2
39,"39083",1214,785,775,7,10,"PH",0
33,"33030",921,682,668,4,14,"PH",0
39,"39005",1319,1048,1026,3,22,"PH",0
50,"50154",129,98,97,1,1,"PH",0
28,"28049",59507,46919,46379,488,540,"PH",37
3,"3009",47547,35945,35298,603,647,"PH",69
50,"50180",111,91,89,3,2,"PH",0
3,"3018",11899,8855,8720,119,135,"PH",19
29,"29006",721,516,508,5,8,"PH",0
41,"41057",299,191,189,0,2,"PH",0
50,"50147",845,637,627,12,10,"PH",3
46,"46028",424,352,347,5,5,"PH",0
39,"39014",943,706,700,9,6,"PH",0
50,"50115",3280,2234,2205,32,29,"PH",3
33,"33019",3262,2283,2244,12,39,"PH",1
39,"39038",1465,1065,1047,8,18,"PH",0
46,"46091",126,108,108,0,0,"PH",0
41,"41010",4338,2990,2958,48,32,"PH",4
50,"50055",3592,2520,2473,59,47,"PH",4
15,"15057",12467,8936,8744,102,192,"PH",8
28,"28112",168,138,137,0,1,"PH",1
28,"28089",3531,2786,2753,25,33,"PH",1
15,"15048",4769,3470,3415,57,55,"PH",3
46,"46182",1190,864,855,11,9,"PH",1
28,"28074",136617,106248,105095,1101,1153,"PH",85
41,"41098",4650,3665,3603,43,62,"PH",3
50,"50047",60,34,34,2,0,"PH",0
46,"46094",20341,15367,15222,152,145,"PH",13
3,"3090",16226,12224,12116,139,108,"PH",20
41,"41043",647,457,454,5,3,"PH",0
3,"3012",1021,870,862,3,8,"PH",2
3,"3113",4154,3295,3251,24,44,"PH",3
50,"50036",103,81,80,2,1,"PH",0
50,"50221",38,20,20,0,0,"PH",0
50,"50134",134,102,101,3,1,"PH",0
41,"41038",96442,66696,65945,1021,751,"PH",93
3,"3065",164772,124457,123236,1556,1221,"PH",456
28,"28118",72,49,47,1,2,"PH",0
3,"3034",1343,1140,1126,5,14,"PH",1
46,"46128",1649,1322,1292,14,30,"PH",0
35,"35018",11652,6488,6367,107,121,"PH",10
50,"50252",5345,3860,3792,79,68,"PH",0
50,"50196",110,87,86,4,1,"PH",0
46,"46249",9650,7288,7191,125,97,"PH",2
29,"29049",3137,2365,2352,19,13,"PH",1
33,"33027",929,617,613,5,4,"PH",0
50,"50261",246,199,199,4,0,"PH",0
50,"50135",100,76,75,2,1,"PH",0
3,"3008",176,142,140,1,2,"PH",0
15,"15075",12042,8639,8486,147,153,"PH",5
39,"39016",24213,18549,18362,265,187,"PH",16
50,"50181",1053,787,760,9,27,"PH",0
46,"46007",11576,8929,8848,71,81,"PH",5
3,"3036",84,72,72,0,0,"PH",0
28,"28053",6035,4854,4783,61,71,"PH",0
50,"50197",89,65,65,3,0,"PH",0
39,"39043",1321,1082,1072,8,10,"PH",0
28,"28116",666,507,498,5,9,"PH",0
33,"33035",11413,8105,8035,104,70,"PH",6
41,"41041",9646,7901,7791,58,110,"PH",3
41,"41066",1417,1121,1113,9,8,"PH",0
39,"39094",927,702,691,0,11,"PH",0
35,"35026",78933,49860,48955,780,905,"PH",114
41,"41091",545464,388043,383816,5325,4227,"PH",380
46,"46227",923,787,771,4,16,"PH",2
15,"15035",11969,8239,8120,192,119,"PH",6
28,"28068",10502,7857,7778,68,79,"PH",0
3,"3140",26223,19998,19552,338,446,"PH",37
50,"50194",102,67,67,2,0,"PH",0
15,"15063",2849,2022,2001,28,21,"PH",2
28,"28025",426,336,332,2,4,"PH",0
46,"46244",57805,41885,41595,415,290,"PH",32
15,"15033",2581,2094,2079,15,15,"PH",2
50,"50177",355,268,265,4,3,"PH",0
28,"28003",196,154,151,2,3,"PH",0
46,"46240",226,188,185,3,3,"PH",0
3,"3005",7482,6191,6146,49,45,"PH",7
46,"46098",2556,2072,2057,12,15,"PH",0
41,"41069",28331,21065,20877,252,188,"PH",18
28,"28154",5232,3910,3860,40,50,"PH",0
50,"50189",776,588,576,9,12,"PH",1
39,"39019",2009,1556,1536,10,20,"PH",2
39,"39011",1646,1295,1294,5,1,"PH",1
50,"50217",496,380,379,0,1,"PH",0
46,"46187",1339,1096,1083,13,13,"PH",0
28,"28082",5144,3967,3905,46,62,"PH",4
28,"28152",14903,11954,11865,125,89,"PH",8
46,"46009",3140,2521,2498,15,23,"PH",2
35,"35013",6779,5059,4961,105,98,"PH",8
29,"29018",2088,1565,1540,9,25,"PH",1
41,"41079",9349,7095,7001,71,94,"PH",5
41,"41053",20729,16178,15971,142,207,"PH",15
29,"29016",272,180,179,5,1,"PH",0
28,"28033",3581,2712,2691,14,21,"PH",1
50,"50111",191,141,138,2,3,"PH",1
50,"50200",534,436,432,9,4,"PH",0
50,"50206",499,386,384,10,2,"PH",1
35,"35021",14982,9948,9749,138,199,"PH",18
28,"28147",910,705,698,5,7,"PH",0
46,"46025",2495,1962,1941,24,21,"PH",2
46,"46196",159,145,144,1,1,"PH",0
50,"50142",45,25,24,0,1,"PH",0
50,"50210",39,28,24,0,4,"PH",0
3,"3120",2329,1810,1785,16,25,"PH",1
29,"29007",25572,17726,17564,227,162,"PH",11
46,"46132",2124,1845,1817,14,28,"PH",1
33,"33070",3481,2557,2521,33,36,"PH",2
50,"50239",65,44,44,0,0,"PH",0
3,"3064",4976,4098,4058,26,40,"PH",8
39,"39074",6785,5287,5233,50,54,"PH",6
3,"3902",9578,7085,7007,65,78,"PH",10
28,"28141",5568,4097,4051,31,46,"PH",3
3,"3086",145,119,118,1,1,"PH",1
46,"46149",398,307,305,1,2,"PH",0
46,"46036",675,440,431,11,9,"PH",0
29,"29055",1837,1478,1454,12,24,"PH",0
3,"3099",41561,32556,32248,288,308,"PH",47
28,"28178",1017,799,791,11,8,"PH",1
50,"50075",89,74,74,1,0,"PH",0
50,"50074",6516,4378,4222,77,156,"PH",4
15,"15002",21528,15479,15218,314,261,"PH",17
46,"46068",326,292,285,3,7,"PH",0
39,"39082",1688,1280,1266,9,14,"PH",1
41,"41071",5603,3999,3932,28,67,"PH",1
29,"29046",2777,2032,2013,10,19,"PH",2
46,"46247",1059,829,823,6,6,"PH",1
50,"50244",215,155,155,6,0,"PH",0
41,"41024",22383,15333,15160,213,173,"PH",5
46,"46260",2576,2140,2106,24,34,"PH",1
39,"39058",862,586,584,6,2,"PH",0
50,"50008",5110,3458,3406,56,52,"PH",3
3,"3044",4459,3798,3753,21,45,"PH",4
28,"28903",29222,23945,23689,296,256,"PH",11
50,"50081",562,410,400,7,10,"PH",0
28,"28119",1911,1527,1514,13,13,"PH",2
39,"39047",1987,1495,1482,9,13,"PH",0
33,"33056",5278,3576,3540,41,36,"PH",1
29,"29088",2784,2019,1975,14,44,"PH",0
46,"46167",411,312,309,0,3,"PH",1
3,"3023",1425,1259,1233,11,26,"PH",1
50,"50117",131,101,100,1,1,"PH",0
33,"33012",5341,3816,3777,43,39,"PH",4
33,"33034",11390,7583,7501,85,82,"PH",1
41,"41082",3448,2827,2796,15,31,"PH",1
41,"41083",1176,915,908,8,7,"PH",1
50,"50067",14124,10049,9870,203,179,"PH",12
50,"50106",137,107,106,0,1,"PH",0
29,"29038",16309,10579,10494,152,85,"PH",3
28,"28150",2985,2363,2345,21,18,"PH",3
50,"50153",1002,757,748,12,9,"PH",0
3,"3114",1620,1320,1305,10,15,"PH",4
50,"50253",461,381,375,3,6,"PH",0
50,"50233",120,89,88,2,1,"PH",0
15,"15041",9718,7514,7425,102,89,"PH",7
46,"46254",1085,847,834,12,13,"PH",1
3,"3091",256,220,219,1,1,"PH",0
3,"3102",7346,5827,5751,39,76,"PH",8
3,"3035",672,560,550,0,10,"PH",0
39,"39077",256,196,196,1,0,"PH",0
3,"3024",3908,3324,3271,34,53,"PH",1
15,"15079",1709,1268,1253,14,15,"PH",0
33,"33042",4434,3172,3135,43,37,"PH",1
29,"29029",452,339,336,0,3,"PH",0
3,"3068",48,45,45,1,0,"PH",0
41,"41099",4141,2818,2799,37,19,"PH",1
15,"15046",6949,4641,4539,56,102,"PH",5
50,"50218",113,92,92,0,0,"PH",0
29,"29087",409,306,305,3,1,"PH",0
46,"46080",1090,860,849,2,11,"PH",0
15,"15043",5491,4033,3971,45,62,"PH",3
15,"15015",2840,2006,1964,43,42,"PH",4
46,"46177",4594,3576,3523,29,53,"PH",0
39,"39051",73,62,62,2,0,"PH",0
46,"46241",440,336,314,4,22,"PH",2
39,"39099",2987,2416,2391,28,25,"PH",4
15,"15065",7570,5710,5628,71,82,"PH",9
3,"3093",19646,15399,15159,173,240,"PH",22
29,"29068",6209,4025,3983,41,42,"PH",2
15,"15072",9868,7077,6951,79,126,"PH",8
41,"41092",7649,5816,5738,39,78,"PH",0
15,"15026",2025,1426,1413,17,13,"PH",0
35,"35011",23140,15550,15320,199,230,"PH",32
46,"46122",2737,2154,2131,18,23,"PH",0
3,"3071",3993,3180,3128,40,52,"PH",3
15,"15054",32172,20472,20154,519,318,"PH",19
50,"50052",100,82,82,0,0,"PH",0
3,"3027",150,131,130,1,1,"PH",0
46,"46008",2727,2249,2233,17,16,"PH",0
29,"29098",1312,1043,1036,22,7,"PH",1
28,"28169",1244,971,962,8,9,"PH",0
39,"39054",4265,3338,3276,57,62,"PH",2
28,"28075",5127,3976,3916,42,60,"PH",6
46,"46097",890,674,662,2,12,"PH",0
29,"29051",37991,24498,24095,381,403,"PH",21
39,"39080",3627,2743,2693,19,50,"PH",1
29,"29005",4307,2967,2951,18,16,"PH",0
46,"46082",4661,3447,3401,46,46,"PH",3
46,"46115",515,364,354,1,10,"PH",0
46,"46188",660,579,576,4,3,"PH",1
46,"46002",1166,942,915,7,27,"PH",1
41,"41044",6838,5064,5005,67,59,"PH",7
33,"33076",12662,8733,8670,120,63,"PH",3
41,"41090",3488,2792,2751,22,41,"PH",1
3,"3122",40476,29591,29265,341,326,"PH",65
50,"50033",81,64,64,0,0,"PH",0
28,"28110",1912,1492,1475,8,17,"PH",1
3,"3006",479,380,369,2,11,"PH",1
33,"33054",1780,1272,1263,8,9,"PH",1
41,"41035",1171,898,889,12,9,"PH",0
39,"39063",1018,769,762,6,7,"PH",0
46,"46129",553,430,423,4,7,"PH",0
35,"35023",11640,8412,8178,97,234,"PH",8
39,"39021",536,448,444,1,4,"PH",0
46,"46262",228,161,158,0,3,"PH",0
50,"50016",51,30,30,1,0,"PH",0
28,"28902",453,338,329,3,9,"PH",0
28,"28041",4006,3190,3154,45,36,"PH",3
39,"39064",1339,1072,1066,7,6,"PH",0
33,"33078",159,108,106,1,2,"PH",0
3,"3109",2745,2332,2302,18,30,"PH",4
39,"39073",9275,6984,6903,83,81,"PH",5
46,"46100",307,264,255,0,9,"PH",0
28,"28020",145,102,100,0,2,"PH",0
35,"35014",9943,5438,5316,95,122,"PH",7
50,"50143",608,427,424,5,3,"PH",0
29,"29071",915,601,598,4,3,"PH",0
29,"29008",14069,9934,9859,118,75,"PH",7
50,"50163",3427,2448,2413,62,35,"PH",0
33,"33025",9455,6331,6277,84,54,"PH",2
33,"33002",10837,7667,7588,77,79,"PH",1
28,"28104",11704,9455,9361,119,94,"PH",5
33,"33010",1922,1284,1277,14,7,"PH",0
28,"28171",4148,2972,2929,21,43,"PH",1
28,"28126",59,37,37,0,0,"PH",0
15,"15020",4187,2802,2781,18,21,"PH",0
50,"50268",59,46,46,3,0,"PH",0
3,"3020",108,87,86,1,1,"PH",0
46,"46052",532,471,463,2,8,"PH",1
50,"50017",1734,1232,1212,41,20,"PH",3
29,"29092",596,457,454,10,3,"PH",1
39,"39022",985,735,734,5,1,"PH",0
33,"33026",9144,6019,5959,87,60,"PH",2
46,"46201",83,50,49,0,1,"PH",0
3,"3139",21796,15501,15320,160,181,"PH",38
29,"29067",420165,273593,271376,3342,2217,"PH",411
41,"41064",5629,4041,4006,28,35,"PH",1
28,"28057",1419,1084,1074,12,10,"PH",2
41,"41012",3115,2314,2271,29,43,"PH",0
29,"29093",2299,1767,1732,7,35,"PH",1
50,"50024",652,541,531,8,10,"PH",0
28,"28055",932,713,707,5,6,"PH",0
15,"15050",1971,1110,1097,27,13,"PH",1
3,"3116",1167,912,904,12,8,"PH",5
46,"46083",15427,12079,11941,109,138,"PH",17
3,"3067",94,81,79,1,2,"PH",0
50,"50166",282,216,210,1,6,"PH",0
3,"3124",482,420,415,7,5,"PH",0
33,"33072",1737,1171,1159,11,12,"PH",1
50,"50116",220,154,153,0,1,"PH",0
3,"3136",484,393,386,1,7,"PH",0
46,"46038",368,264,260,1,4,"PH",0
28,"28096",16844,12441,12308,117,133,"PH",4
46,"46054",11422,8666,8566,82,100,"PH",7
46,"46062",4589,3794,3752,46,42,"PH",3
50,"50176",237,161,160,4,1,"PH",0
28,"28107",443,338,333,7,5,"PH",0
46,"46070",15946,11979,11874,113,105,"PH",12
29,"29075",12666,8284,8218,62,66,"PH",0
50,"50167",235,191,184,1,7,"PH",0
41,"41005",8792,6642,6585,71,57,"PH",0
28,"28180",5179,4033,3975,18,58,"PH",0
39,"39050",305,207,205,1,2,"PH",0
3,"3078",528,424,423,2,1,"PH",0
33,"33036",11674,8695,8605,104,90,"PH",1
50,"50137",1119,842,834,12,8,"PH",0
50,"50011",131,113,113,8,0,"PH",1
33,"33021",4932,3544,3502,45,42,"PH",1
46,"46120",1133,889,870,2,19,"PH",0
28,"28140",2665,2167,2141,26,26,"PH",1
35,"35030",8295,5433,5315,54,118,"PH",5
50,"50229",62,47,46,2,1,"PH",0
46,"46010",927,706,699,3,7,"PH",0
3,"3092",6780,5364,5269,96,95,"PH",10
15,"15052",4567,3539,3493,22,46,"PH",3
3,"3127",399,336,322,3,14,"PH",0
50,"50078",278,210,208,2,2,"PH",0
28,"28175",780,641,630,8,11,"PH",1
41,"41094",6089,4757,4680,47,77,"PH",5
39,"39090",731,577,572,3,5,"PH",0
46,"46183",5946,4718,4656,35,62,"PH",6
39,"39027",3213,2506,2473,21,33,"PH",1
33,"33067",802,650,639,12,11,"PH",0
46,"46902",425,333,332,3,1,"PH",2
46,"46162",1230,1045,1027,6,18,"PH",1
46,"46154",836,684,678,7,6,"PH",0
33,"33075",305,191,190,0,1,"PH",0
29,"29023",1661,1080,1074,15,6,"PH",1
50,"50264",184,140,134,0,6,"PH",0
46,"46073",1119,931,915,14,16,"PH",2
46,"46146",1718,1395,1374,10,21,"PH",0
15,"15006",5539,3940,3866,53,74,"PH",0
46,"46203",3669,3002,2964,36,38,"PH",2
41,"41060",15176,10797,10693,114,104,"PH",6
3,"3130",43,30,29,0,1,"PH",0
46,"46041",369,255,255,1,0,"PH",0
15,"15082",15075,11217,11046,187,171,"PH",5
46,"46090",1668,1488,1452,9,36,"PH",1
39,"39053",251,179,179,1,0,"PH",0
46,"46024",448,365,358,1,7,"PH",0
50,"50130",415,288,288,7,0,"PH",0
33,"33023",3410,2501,2485,40,16,"PH",1
46,"46236",996,853,844,7,9,"PH",0
46,"46033",220,183,181,0,2,"PH",0
15,"15045",4178,2743,2727,22,16,"PH",1
28,"28019",1195,901,888,5,13,"PH",1
35,"35033",6415,4394,4302,51,92,"PH",6
3,"3088",5381,4056,3988,47,68,"PH",5
39,"39095",2292,1824,1801,24,23,"PH",1
50,"50187",72,45,45,1,0,"PH",0
46,"46123",1808,1440,1410,7,30,"PH",0
46,"46107",1998,1650,1623,8,27,"PH",0
46,"46018",689,597,592,12,5,"PH",0
15,"15083",1198,874,855,8,19,"PH",0
33,"33077",1351,938,931,7,7,"PH",0
39,"39096",719,521,518,4,3,"PH",0
50,"50018",973,761,755,12,6,"PH",0
46,"46048",3484,2915,2875,26,40,"PH",1
41,"41036",4053,2930,2899,29,31,"PH",2
39,"39012",6666,5148,5061,43,87,"PH",1
46,"46003",988,864,847,13,17,"PH",0
46,"46124",768,641,632,10,9,"PH",0
46,"46051",8122,6432,6378,57,54,"PH",0
50,"50102",918,722,713,12,9,"PH",0
50,"50191",505,395,390,4,5,"PH",0
39,"39003",321,265,261,0,4,"PH",0
46,"46181",17153,13332,13184,108,148,"PH",3
28,"28006",74554,57439,56890,586,549,"PH",61
41,"41037",3228,2510,2483,27,27,"PH",1
15,"15029",6266,4668,4618,49,50,"PH",2
15,"15085",3576,2656,2612,29,44,"PH",0
3,"3085",275,218,215,2,3,"PH",1
39,"39039",648,496,493,0,3,"PH",0
50,"50240",1127,799,783,25,16,"PH",0
50,"50182",3704,2551,2515,44,36,"PH",7
3,"3110",294,239,238,0,1,"PH",1
50,"50287",298,214,211,10,3,"PH",0
50,"50045",1289,1011,992,14,19,"PH",0
15,"15001",4985,3560,3506,63,54,"PH",7
15,"15076",2766,1971,1936,18,35,"PH",3
46,"46190",48324,34747,34424,431,323,"PH",25
46,"46101",868,720,716,8,4,"PH",1
29,"29065",207,151,149,1,2,"PH",0
50,"50215",21,20,19,0,1,"PH",0
29,"29076",2022,1384,1374,14,10,"PH",2
28,"28026",5852,4506,4449,40,57,"PH",3
3,"3072",331,284,277,2,7,"PH",0
28,"28146",1672,1220,1205,4,15,"PH",1
33,"33059",5049,3480,3447,37,33,"PH",2
50,"50263",235,160,160,1,0,"PH",0
29,"29074",818,631,630,3,1,"PH",0
33,"33018",2971,2139,2121,32,18,"PH",0
28,"28029",538,416,414,4,2,"PH",0
15,"15028",1485,1130,1118,14,12,"PH",0
28,"28067",3893,2996,2950,26,46,"PH",3
3,"3084",593,518,513,2,5,"PH",1
46,"46208",1141,990,978,6,12,"PH",1
46,"46119",856,702,693,0,9,"PH",0
41,"41030",527,436,429,6,7,"PH",1
41,"41031",1319,879,875,6,4,"PH",1
15,"15003",1936,1400,1382,19,18,"PH",0
29,"29094",54317,36540,36174,410,366,"PH",24
28,"28073",11899,8877,8769,112,108,"PH",14
39,"39024",2065,1616,1601,8,15,"PH",0
15,"15022",6102,4207,4164,52,43,"PH",4
33,"33004",69056,49228,48730,726,498,"PH",37
28,"28008",1734,1244,1221,11,23,"PH",1
3,"3045",233,204,203,2,1,"PH",1
41,"41048",2296,1749,1726,21,23,"PH",0
3,"3001",359,296,292,2,4,"PH",0
29,"29085",156,116,113,0,3,"PH",0
41,"41040",9567,7305,7210,93,95,"PH",6
28,"28001",61,46,45,1,1,"PH",0
15,"15088",3769,2626,2599,21,27,"PH",1
50,"50096",49,35,35,0,0,"PH",0
33,"33005",1600,1084,1080,6,4,"PH",2
46,"46047",551,479,469,10,10,"PH",0
28,"28159",629,482,478,2,4,"PH",0
29,"29095",3431,2660,2607,23,53,"PH",3
33,"33013",466,349,345,4,4,"PH",0
50,"50262",1216,916,904,20,12,"PH",2
3,"3002",3559,2747,2707,16,40,"PH",2
46,"46063",1764,1441,1423,15,18,"PH",2
50,"50902",97,85,85,1,0,"PH",0
50,"50101",922,648,637,8,11,"PH",0
46,"46263",333,243,241,2,2,"PH",0
46,"46193",8494,6662,6580,73,82,"PH",1
50,"50237",103,76,75,0,1,"PH",0
50,"50042",16,14,14,0,0,"PH",0
46,"46904",782,659,650,6,9,"PH",1
50,"50003",141,108,108,3,0,"PH",0
41,"41015",5263,3820,3752,34,68,"PH",2
50,"50291",112,75,73,0,2,"PH",0
46,"46072",3711,3006,2932,38,74,"PH",1
3,"3096",5863,4550,4457,57,93,"PH",2
28,"28106",72603,53231,52524,681,707,"PH",74
28,"28060",1471,1205,1192,8,13,"PH",0
46,"46242",361,288,280,4,8,"PH",0
3,"3037",354,293,289,1,4,"PH",1
46,"46089",2116,1653,1627,9,26,"PH",1
39,"39018",4077,3212,3160,44,52,"PH",1
15,"15053",8164,5679,5592,60,87,"PH",6
46,"46065",1606,1250,1234,15,16,"PH",2
3,"3129",1188,936,918,10,18,"PH",2
50,"50089",6673,4936,4877,120,59,"PH",2
50,"50051",886,677,671,9,6,"PH",0
46,"46186",18444,14173,14029,135,144,"PH",12
50,"50255",219,150,148,1,2,"PH",0
46,"46211",1716,1459,1447,9,12,"PH",1
50,"50013",244,195,195,1,0,"PH",0
50,"50032",330,233,228,3,5,"PH",0
46,"46171",16753,12565,12399,122,166,"PH",10
39,"39071",463,358,358,2,0,"PH",0
15,"15091",1171,839,829,9,10,"PH",0
35,"35029",3981,2341,2315,43,26,"PH",0
50,"50274",78,45,45,1,0,"PH",0
50,"50035",78,61,56,2,5,"PH",0
50,"50216",267,201,194,8,7,"PH",1
41,"41052",2967,2305,2288,7,17,"PH",0
50,"50110",424,315,314,6,1,"PH",1
50,"50199",380,263,254,2,9,"PH",0
46,"46220",48981,34657,34242,450,415,"PH",30
29,"29072",3258,2484,2447,30,37,"PH",2
46,"46198",815,660,654,4,6,"PH",1
28,"28086",4603,3286,3248,29,38,"PH",2
46,"46180",715,585,581,4,4,"PH",0
28,"28181",20003,16133,15952,159,181,"PH",10
28,"28153",608,422,406,1,16,"PH",0
41,"41049",8898,6881,6812,95,69,"PH",5
33,"33046",546,429,421,3,8,"PH",0
46,"46212",1598,1233,1218,5,15,"PH",1
15,"15027",1537,1263,1242,22,21,"PH",0
29,"29056",1177,807,794,3,13,"PH",0
29,"29022",202,142,141,2,1,"PH",0
46,"46194",15267,11622,11491,110,131,"PH",13
46,"46245",478,357,354,1,3,"PH",0
33,"33062",452,282,281,3,1,"PH",0
15,"15037",4181,2839,2804,25,35,"PH",0
46,"46019",8671,7195,7109,70,86,"PH",4
15,"15084",3681,2676,2656,34,20,"PH",2
41,"41062",2252,1719,1698,12,21,"PH",0
28,"28156",958,742,733,12,9,"PH",1
46,"46251",2599,2215,2179,21,36,"PH",0
33,"33017",3289,2378,2350,35,28,"PH",1
3,"3074",1752,1479,1466,5,13,"PH",1
3,"3041",5811,4325,4269,33,56,"PH",6
50,"50258",54,37,37,0,0,"PH",0
29,"29026",1130,815,799,7,16,"PH",0
33,"33063",467,367,363,4,4,"PH",0
15,"15066",4180,3098,3062,38,36,"PH",2
50,"50123",428,335,332,9,3,"PH",0
50,"50092",329,273,272,0,1,"PH",0
3,"3031",39966,27099,26802,291,297,"PH",29
3,"3133",40056,25746,25554,231,192,"PH",51
50,"50144",36,32,32,0,0,"PH",0
29,"29011",3013,1893,1876,7,17,"PH",1
46,"46214",15129,11609,11500,116,109,"PH",8
28,"28050",3576,2706,2663,21,43,"PH",0
28,"28134",55921,42676,42221,505,455,"PH",53
15,"15067",8142,6054,5978,73,76,"PH",3
28,"28035",1314,1058,1046,3,12,"PH",0
28,"28066",7033,5439,5383,45,56,"PH",1
3,"3057",232,179,178,0,1,"PH",0
46,"46222",378,321,310,1,11,"PH",1
46,"46168",1828,1461,1449,7,12,"PH",2
50,"50247",794,572,567,7,5,"PH",0
46,"46058",1787,1460,1441,10,19,"PH",1
46,"46050",161,126,123,1,3,"PH",0
39,"39008",13716,10396,10274,129,122,"PH",7
29,"29009",1525,1126,1109,9,17,"PH",0
50,"50084",84,64,64,1,0,"PH",0
3,"3115",267,242,242,2,0,"PH",0
29,"29044",866,631,627,3,4,"PH",0
28,"28163",395,305,301,7,4,"PH",0
41,"41013",4762,3359,3327,9,32,"PH",1
46,"46192",755,564,554,9,10,"PH",1
39,"39032",1576,1215,1209,10,6,"PH",0
39,"39033",604,480,473,3,7,"PH",1
50,"50251",8379,6225,6116,110,109,"PH",11
41,"41004",55127,37662,37179,622,483,"PH",36
50,"50288",3252,2412,2380,50,32,"PH",3
50,"50242",102,82,82,2,0,"PH",0
50,"50019",79,57,55,1,2,"PH",1
15,"15069",7019,5036,4938,85,98,"PH",7
29,"29039",2822,2091,2074,8,17,"PH",1
50,"50028",120,86,85,2,1,"PH",0
41,"41014",2484,1956,1936,13,20,"PH",1
29,"29086",814,538,536,9,2,"PH",0
46,"46225",360,319,310,5,9,"PH",0
46,"46209",1984,1606,1594,11,12,"PH",0
3,"3101",4648,3694,3607,29,87,"PH",3
39,"39048",1616,1326,1308,8,18,"PH",3
3,"3137",719,536,530,3,6,"PH",0
46,"46095",632,505,495,1,10,"PH",0
28,"28044",5403,4245,4188,27,57,"PH",8
28,"28059",4061,3169,3130,38,39,"PH",0
50,"50039",580,450,446,3,4,"PH",0
50,"50131",243,185,183,6,2,"PH",0
41,"41017",13878,10053,9926,130,127,"PH",8
28,"28023",4350,3425,3392,32,33,"PH",2
41,"41078",2587,1979,1970,15,9,"PH",1
39,"39026",1825,1383,1371,12,12,"PH",0
29,"29003",1133,902,900,5,2,"PH",0
46,"46023",318,275,267,2,8,"PH",0
39,"39072",375,234,234,4,0,"PH",0
46,"46153",445,374,366,7,8,"PH",0
46,"46226",34,34,33,0,1,"PH",0
50,"50040",98,77,76,2,1,"PH",0
3,"3022",160,133,131,1,2,"PH",0
50,"50235",2371,1723,1701,36,22,"PH",0
50,"50272",12481,8744,8642,176,102,"PH",6
50,"50012",105,93,90,0,3,"PH",0
50,"50129",258,164,164,0,0,"PH",1
46,"46081",10254,8188,8101,52,87,"PH",6
39,"39079",9035,6959,6897,55,62,"PH",5
29,"29077",225,157,157,1,0,"PH",0
46,"46219",143,127,126,1,1,"PH",0
28,"28183",935,663,649,7,14,"PH",0
3,"3038",338,294,291,2,3,"PH",2
28,"28137",1626,1231,1222,9,9,"PH",0
3,"3070",1962,1582,1552,8,30,"PH",3
15,"15044",1436,1083,1068,10,15,"PH",3
28,"28018",3572,2837,2795,20,42,"PH",1
3,"3049",12150,10039,9892,88,147,"PH",12
28,"28032",4469,3412,3369,32,43,"PH",3
28,"28011",437,318,315,2,3,"PH",0
28,"28054",10459,7798,7698,65,100,"PH",8
50,"50292",138,117,115,4,2,"PH",0
3,"3125",340,276,275,2,1,"PH",1
39,"39066",895,710,703,6,7,"PH",0
39,"39013",561,413,412,2,1,"PH",0
15,"15017",18860,12975,12737,325,238,"PH",19
39,"39002",3400,2554,2514,35,40,"PH",0
3,"3017",380,331,324,7,7,"PH",1
41,"41011",15274,11359,11207,145,152,"PH",4
29,"29037",227,170,170,0,0,"PH",0
33,"33038",2442,1757,1725,14,32,"PH",0
3,"3013",1144,941,926,5,15,"PH",1
41,"41087",9827,7300,7150,51,150,"PH",5
3,"3029",260,191,186,0,5,"PH",0
50,"50141",116,98,98,1,0,"PH",0
39,"39086",386,282,280,1,2,"PH",0
41,"41009",1272,914,899,8,15,"PH",0
46,"46112",582,475,463,4,12,"PH",0
28,"28160",7496,5680,5613,46,67,"PH",3
3,"3077",1411,1146,1130,14,16,"PH",0
41,"41076",2227,1507,1492,5,15,"PH",1
41,"41047",9810,7427,7321,99,106,"PH",8
50,"50903",2234,1622,1597,35,25,"PH",0
46,"46035",6470,5115,5047,38,68,"PH",5
41,"41901",2626,2190,2167,24,23,"PH",0
50,"50063",76,67,67,0,0,"PH",0
50,"50257",195,154,154,0,0,"PH",0
46,"46148",1400,1131,1114,13,17,"PH",2
39,"39004",1593,1321,1305,9,16,"PH",0
46,"46108",550,446,444,3,2,"PH",2
50,"50073",2265,1773,1756,20,17,"PH",0
50,"50267",648,450,441,8,9,"PH",0
50,"50064",469,377,373,5,4,"PH",0
29,"29064",584,428,422,4,6,"PH",1
3,"3053",7082,5754,5664,60,90,"PH",8
46,"46084",1587,1363,1332,7,31,"PH",1
46,"46157",3068,2523,2491,17,32,"PH",2
28,"28063",268,209,203,4,6,"PH",0
15,"15038",2363,1643,1610,29,33,"PH",0
29,"29027",2416,1907,1893,15,14,"PH",0
33,"33022",992,709,696,12,13,"PH",1
28,"28128",366,280,275,2,5,"PH",0
50,"50223",956,751,745,14,6,"PH",0
15,"15058",26931,19505,19196,471,309,"PH",35
50,"50114",157,120,120,1,0,"PH",0
46,"46012",930,698,684,9,14,"PH",0
39,"39042",5928,4680,4634,44,46,"PH",1
50,"50128",36,30,29,0,1,"PH",0
46,"46144",699,547,536,2,11,"PH",0
33,"33066",42885,29326,29013,460,313,"PH",14
46,"46152",96,70,70,0,0,"PH",0
46,"46031",10580,7900,7809,87,91,"PH",7
28,"28136",618,527,516,2,11,"PH",2
39,"39055",1130,881,869,10,12,"PH",0
46,"46185",422,360,359,7,1,"PH",1
46,"46137",273,232,229,1,3,"PH",0
46,"46145",21751,16601,16397,155,204,"PH",12
50,"50171",126,90,89,4,1,"PH",0
46,"46015",7042,5644,5581,53,63,"PH",2
50,"50278",207,152,149,4,3,"PH",0
29,"29019",908,720,714,0,6,"PH",0
15,"15078",78092,56506,55597,1110,909,"PH",47
46,"46110",21420,15810,15671,134,139,"PH",18
50,"50175",1088,742,732,10,10,"PH",5
29,"29048",1508,1254,1245,6,9,"PH",1
46,"46045",1288,1065,1044,2,21,"PH",3
28,"28072",5232,4065,4007,35,58,"PH",1
41,"41056",3697,3041,3008,25,33,"PH",1
41,"41074",3079,2406,2386,14,20,"PH",0
46,"46030",800,677,662,6,15,"PH",0
28,"28151",3025,2237,2185,9,52,"PH",0
46,"46248",4847,3655,3597,25,58,"PH",1
50,"50204",2519,1823,1804,24,19,"PH",1
15,"15060",5599,4139,4069,82,70,"PH",2
39,"39034",289,209,209,3,0,"PH",0
50,"50186",44,30,29,0,1,"PH",0
46,"46238",13401,10371,10283,96,88,"PH",9
3,"3098",526,410,400,6,10,"PH",2
41,"41072",4083,3073,3046,12,27,"PH",1
3,"3111",5244,4184,4146,39,38,"PH",3
50,"50211",277,193,193,1,0,"PH",0
50,"50234",251,201,191,13,10,"PH",1
50,"50023",240,180,180,4,0,"PH",0
33,"33008",1934,1474,1459,11,15,"PH",1
46,"46074",2656,2071,2053,22,18,"PH",0
39,"39028",3513,2760,2718,23,42,"PH",2
29,"29015",31805,22566,22347,272,219,"PH",10
50,"50266",139,95,94,1,1,"PH",0
28,"28092",148714,112174,110838,1215,1336,"PH",97
50,"50098",215,150,146,2,4,"PH",0
28,"28012",830,654,651,6,3,"PH",0
50,"50053",756,570,563,14,7,"PH",0
29,"29059",2551,1986,1964,11,22,"PH",1
33,"33071",671,528,523,4,5,"PH",0
50,"50108",50,31,31,0,0,"PH",0
15,"15012",3767,2973,2926,51,47,"PH",2
46,"46040",1227,1028,1021,13,7,"PH",0
41,"41085",3918,3173,3128,42,45,"PH",2
3,"3026",1210,1004,989,11,15,"PH",2
50,"50119",997,740,720,13,20,"PH",0
46,"46235",21966,16641,16465,167,176,"PH",16
50,"50079",281,213,210,2,3,"PH",0
46,"46088",196,146,140,0,6,"PH",0
50,"50169",371,275,274,5,1,"PH",0
39,"39035",10031,7685,7601,74,84,"PH",5
3,"3082",11741,8208,8102,80,106,"PH",21
3,"3094",8442,6105,6053,70,52,"PH",12
41,"41086",15877,10246,10150,146,96,"PH",8
50,"50283",73,55,55,1,0,"PH",0
50,"50160",2397,1905,1865,19,40,"PH",0
46,"46016",1097,927,917,12,10,"PH",0
28,"28084",15408,11489,11355,122,134,"PH",13
50,"50170",411,316,313,2,3,"PH",0
29,"29014",250,152,150,0,2,"PH",0
15,"15051",4780,3333,3289,61,44,"PH",2
46,"46184",26507,20314,20010,263,304,"PH",21
41,"41046",3055,2456,2418,23,38,"PH",1
28,"28173",507,397,390,2,7,"PH",0
3,"3050",17818,12860,12706,160,154,"PH",23
50,"50007",61,45,45,0,0,"PH",0
39,"39057",2298,1735,1719,17,16,"PH",2
28,"28071",77,57,55,0,2,"PH",0
29,"29045",1750,1246,1239,6,7,"PH",1
50,"50281",76,63,63,2,0,"PH",0
28,"28038",4999,3659,3590,32,69,"PH",5
41,"41058",16497,12415,12248,181,167,"PH",9
15,"15036",60838,40345,39667,915,678,"PH",41
3,"3069",2830,2009,1979,22,30,"PH",6
3,"3046",1530,1136,1121,11,15,"PH",4
29,"29099",958,739,730,5,9,"PH",0
15,"15080",1913,1407,1389,15,18,"PH",1
28,"28058",137542,103880,102686,1155,1194,"PH",109
50,"50002",166,130,130,2,0,"PH",0
46,"46216",4806,3857,3825,39,32,"PH",1
46,"46027",997,869,855,4,14,"PH",0
33,"33016",19516,14345,14210,198,135,"PH",4
50,"50172",187,140,138,4,2,"PH",0
3,"3903",2431,1991,1960,18,31,"PH",7
39,"39029",642,521,517,6,4,"PH",0
41,"41002",1510,1161,1140,4,21,"PH",2
50,"50286",90,73,73,2,0,"PH",0
3,"3132",571,464,461,8,3,"PH",0
46,"46011",7727,5874,5777,75,97,"PH",4
41,"41088",542,414,408,1,6,"PH",0
50,"50083",96,72,72,1,0,"PH",0
29,"29082",29311,20220,20051,223,169,"PH",12
46,"46043",149,139,139,0,0,"PH",0
3,"3030",522,464,453,6,11,"PH",0
33,"33009",951,673,663,7,10,"PH",0
50,"50230",1295,914,903,13,11,"PH",1
50,"50248",552,421,407,5,14,"PH",1
50,"50026",459,360,354,5,6,"PH",0
3,"3083",5708,4267,4196,66,71,"PH",8
3,"3016",91,67,66,1,1,"PH",0
50,"50109",101,79,79,2,0,"PH",0
28,"28028",1615,1204,1173,11,31,"PH",2
50,"50183",369,277,274,5,3,"PH",0
50,"50087",31,25,25,0,0,"PH",0
50,"50029",676,527,517,6,10,"PH",0
29,"29033",1385,878,868,4,10,"PH",0
50,"50296",417,313,310,6,3,"PH",0
15,"15061",6105,4391,4307,64,84,"PH",2
50,"50090",165,117,117,1,0,"PH",0
41,"41070",5598,4101,4039,79,62,"PH",4
46,"46218",1082,964,936,5,28,"PH",1
50,"50228",295,238,236,10,2,"PH",0
50,"50293",492,339,338,6,1,"PH",1
3,"3058",4798,4126,4103,26,23,"PH",4
28,"28167",7818,6016,5942,82,74,"PH",2
33,"33049",6806,4629,4581,70,48,"PH",1
50,"50030",232,164,160,1,4,"PH",1
50,"50146",211,168,167,4,1,"PH",0
39,"39093",351,260,253,2,7,"PH",1
50,"50222",1695,1117,1091,16,26,"PH",0
39,"39015",898,692,688,7,4,"PH",0
50,"50085",205,143,143,3,0,"PH",0
3,"3011",7341,5277,5218,72,59,"PH",12
28,"28135",928,665,659,6,6,"PH",0
41,"41022",4281,3087,3066,15,21,"PH",0
50,"50270",39,30,29,1,1,"PH",0
39,"39085",6722,5198,5134,60,64,"PH",4
46,"46005",22815,17016,16838,185,178,"PH",10
33,"33065",1150,791,784,16,7,"PH",0
50,"50066",2357,1677,1659,42,18,"PH",2
50,"50126",2473,1747,1724,41,23,"PH",1
28,"28144",5663,4456,4410,47,46,"PH",4
50,"50095",12558,9029,8910,179,119,"PH",7
29,"29020",3188,2448,2424,30,24,"PH",1
46,"46178",4406,3235,3201,22,34,"PH",4
46,"46111",10589,7823,7710,94,113,"PH",9
28,"28079",2290453,1721837,1705310,17342,16527,"PH",1404
46,"46259",537,426,424,9,2,"PH",0
33,"33047",1178,939,931,2,8,"PH",0
46,"46059",1310,1076,1058,2,18,"PH",0
41,"41007",12177,8150,8016,126,134,"PH",8
28,"28157",605,452,446,2,6,"PH",0
46,"46020",3793,3084,3046,21,38,"PH",5
39,"39020",23947,15404,15122,267,282,"PH",20
46,"46141",424,338,336,2,2,"PH",0
28,"28095",1358,1092,1077,8,15,"PH",1
50,"50201",466,366,363,7,3,"PH",0
28,"28045",30286,23148,22879,226,269,"PH",13
50,"50118",2312,1737,1718,22,19,"PH",1
35,"35010",3565,2178,2135,26,43,"PH",2
50,"50100",355,273,266,3,7,"PH",1
28,"28174",1745,1233,1224,11,9,"PH",0
28,"28108",3002,2254,2228,31,26,"PH",0
41,"41006",2743,1972,1957,13,15,"PH",0
29,"29073",1520,1032,1021,10,11,"PH",2
15,"15005",23875,15132,14895,356,237,"PH",21
46,"46243",149,120,117,0,3,"PH",0
28,"28091",5202,3714,3671,34,43,"PH",0
28,"28046",4208,3297,3272,31,25,"PH",3
39,"39009",3200,2427,2402,24,25,"PH",1
15,"15090",1267,959,953,4,6,"PH",0
39,"39070",152,118,118,0,0,"PH",0
33,"33014",9318,6380,6320,66,60,"PH",3
15,"15034",3116,2146,2114,20,32,"PH",0
33,"33044",180964,129466,128346,1888,1120,"PH",54
28,"28017",1120,905,888,8,17,"PH",0
41,"41042",5902,4572,4509,37,63,"PH",1
50,"50179",269,230,229,2,1,"PH",0
29,"29079",2500,2016,2000,23,16,"PH",0
35,"35020",6142,4227,4192,24,35,"PH",0
46,"46113",2338,1804,1797,14,7,"PH",1
39,"39001",2146,1669,1645,20,24,"PH",0
15,"15010",2009,1468,1441,24,27,"PH",5
41,"41077",8817,6520,6375,53,145,"PH",1
50,"50901",170,122,121,1,1,"PH",1
33,"33068",1224,704,703,5,1,"PH",0
50,"50227",105,79,79,2,0,"PH",0
3,"3081",1409,1102,1087,14,15,"PH",0
46,"46076",651,541,528,2,13,"PH",0
46,"46252",142,108,107,1,1,"PH",0
39,"39091",2026,1636,1628,14,8,"PH",0
33,"33039",1719,1325,1319,14,6,"PH",0
50,"50294",77,58,57,0,1,"PH",0
46,"46217",912,758,751,4,7,"PH",0
39,"39045",410,324,323,5,1,"PH",0
28,"28129",7219,5536,5461,71,75,"PH",2
15,"15073",21991,14686,14456,216,230,"PH",10
28,"28085",3794,2980,2933,18,47,"PH",2
35,"35019",30279,17607,17380,158,227,"PH",35
29,"29062",647,573,571,1,2,"PH",0
33,"33028",1466,812,806,5,6,"PH",0
35,"35001",4663,3639,3569,39,70,"PH",1
3,"3003",460,382,370,1,12,"PH",0
46,"46077",7637,5979,5845,64,134,"PH",4
3,"3904",1416,1104,1096,11,8,"PH",2
46,"46246",1081,917,904,5,13,"PH",0
41,"41019",4528,3194,3168,41,26,"PH",0
3,"3040",260,224,220,0,4,"PH",1
35,"35022",43892,27289,26876,326,413,"PH",39
46,"46237",7261,5405,5350,54,55,"PH",10
46,"46221",350,319,317,3,2,"PH",0
28,"28094",774,557,551,5,6,"PH",0
41,"41089",6394,4593,4526,57,67,"PH",6
41,"41080",1289,1010,997,13,13,"PH",1
29,"29054",39904,27540,27307,240,233,"PH",36
35,"35005",1170,864,853,7,11,"PH",0
3,"3103",288,248,243,2,5,"PH",2
50,"50136",617,469,462,4,7,"PH",0
33,"33040",4702,3285,3236,44,49,"PH",3
46,"46224",179,131,128,0,3,"PH",0
15,"15047",2606,1789,1761,33,28,"PH",3
46,"46057",483,357,349,9,8,"PH",0
39,"39062",1759,1397,1387,9,10,"PH",0
46,"46105",16708,12164,12040,100,124,"PH",10
28,"28042",1091,814,808,5,6,"PH",1
50,"50041",21,13,13,0,0,"PH",0
50,"50025",4569,3319,3271,68,48,"PH",2
3,"3042",1337,1028,1019,8,9,"PH",1
39,"39023",6048,4795,4747,43,48,"PH",4
39,"39102",2330,1748,1731,13,17,"PH",0
3,"3075",160,139,136,2,3,"PH",0
50,"50037",140,110,103,3,7,"PH",0
33,"33058",1863,1307,1286,11,21,"PH",1
41,"41075",9987,7904,7809,71,95,"PH",2
28,"28031",1981,1524,1500,9,24,"PH",0
50,"50121",297,250,245,6,5,"PH",0
46,"46255",3135,2530,2508,11,22,"PH",2
28,"28052",3799,2753,2719,17,34,"PH",0
28,"28009",13466,10392,10286,102,106,"PH",8
46,"46064",547,463,458,2,5,"PH",1
35,"35006",29515,20731,20286,362,445,"PH",50
29,"29028",1253,887,876,8,11,"PH",0
28,"28166",325,269,268,8,1,"PH",0
35,"35008",6151,4514,4419,59,95,"PH",9
50,"50198",46,36,36,2,0,"PH",0
50,"50046",201,155,153,2,2,"PH",0
50,"50076",113,89,89,0,0,"PH",0
46,"46021",23273,17264,17091,163,173,"PH",12
50,"50279",111,79,79,1,0,"PH",0
28,"28158",632,505,495,4,10,"PH",0
29,"29057",413,311,308,2,3,"PH",0
46,"46013",16111,12469,12328,145,141,"PH",14
28,"28051",1469,1147,1129,7,18,"PH",0
15,"15071",8233,5751,5668,93,83,"PH",3
3,"3128",3944,2847,2812,16,35,"PH",6
3,"3080",1288,1116,1103,6,13,"PH",1
39,"39052",17031,13198,13034,187,164,"PH",9
35,"35003",4764,2733,2680,34,53,"PH",2
39,"39065",272,199,197,2,2,"PH",0
29,"29032",6673,5204,5140,43,64,"PH",3
50,"50273",36,22,22,0,0,"PH",0
46,"46032",5583,4342,4287,39,55,"PH",2
33,"33015",1695,1177,1161,12,16,"PH",0
28,"28047",38404,28739,28436,312,303,"PH",16
33,"33037",37135,25522,25262,291,260,"PH",6
29,"29060",775,573,572,1,1,"PH",0
50,"50020",868,646,629,5,17,"PH",1
28,"28109",1621,1121,1104,9,17,"PH",2
46,"46202",15578,11811,11676,110,135,"PH",10
46,"46130",934,745,734,6,11,"PH",0
41,"41050",5102,4224,4183,39,41,"PH",3
28,"28168",1144,821,810,15,11,"PH",0
46,"46139",4594,3794,3734,28,60,"PH",1
3,"3106",642,542,535,3,7,"PH",0
41,"41032",4059,3122,3062,22,60,"PH",1
3,"3048",4747,3878,3817,16,61,"PH",7
28,"28061",19624,15082,14905,162,177,"PH",10
46,"46039",2200,1849,1820,12,29,"PH",0
46,"46228",2434,1881,1859,30,22,"PH",1
28,"28177",9470,7524,7466,87,58,"PH",3
29,"29012",9817,7063,6991,51,72,"PH",7
50,"50236",124,103,103,2,0,"PH",0
46,"46061",331,276,273,3,3,"PH",0
28,"28013",38226,27886,27547,246,339,"PH",19
28,"28056",782,604,586,6,18,"PH",0
15,"15081",1139,869,853,9,16,"PH",1
35,"35028",8810,4687,4603,71,84,"PH",6
3,"3117",381,321,317,4,4,"PH",0
50,"50139",372,280,278,3,2,"PH",0
50,"50168",34,26,26,1,0,"PH",0
50,"50099",3136,2333,2297,27,36,"PH",3
50,"50091",56,39,39,1,0,"PH",0
15,"15014",4239,3151,3104,39,47,"PH",5
15,"15019",26096,18466,18187,350,279,"PH",18
39,"39006",1732,1381,1373,23,8,"PH",0
3,"3097",973,791,779,6,12,"PH",0
3,"3007",160,131,127,0,4,"PH",0
50,"50005",245,199,195,1,4,"PH",0
15,"15025",1173,780,777,10,3,"PH",1
33,"33007",1680,1186,1179,10,7,"PH",1
46,"46140",379,314,313,0,1,"PH",0
50,"50265",63,46,46,1,0,"PH",0
3,"3052",984,837,820,10,17,"PH",1
41,"41033",5237,3915,3878,20,37,"PH",2
28,"28069",51,35,33,1,2,"PH",0
50,"50232",176,123,120,5,3,"PH",1
46,"46079",381,304,299,3,5,"PH",0
15,"15901",3855,2463,2419,48,44,"PH",2
46,"46087",137,105,105,1,0,"PH",0
28,"28133",5868,4236,4144,23,92,"PH",2
39,"39088",70,61,61,1,0,"PH",0
50,"50113",653,528,526,9,2,"PH",1
50,"50001",130,96,96,0,0,"PH",0
28,"28005",132097,100509,99506,1069,1003,"PH",114
46,"46075",166,148,145,3,3,"PH",0
41,"41902",4682,3136,3101,34,35,"PH",0
50,"50133",126,101,100,1,1,"PH",0
46,"46118",3883,3141,3105,28,36,"PH",2
46,"46160",1976,1591,1570,21,21,"PH",0
35,"35017",22331,13463,13144,217,319,"PH",18
3,"3047",8867,6219,6113,76,106,"PH",21
41,"41016",6950,5194,5120,45,74,"PH",3
50,"50298",5319,4023,3955,72,68,"PH",2
41,"41029",13231,9756,9610,128,146,"PH",10
46,"46256",6734,4902,4858,33,44,"PH",2
46,"46067",1798,1487,1472,10,15,"PH",2
3,"3121",20518,14464,14315,137,149,"PH",28
50,"50070",70,42,41,0,1,"PH",0
50,"50125",421,284,280,1,4,"PH",0
50,"50190",751,576,565,7,11,"PH",0
29,"29040",1934,1344,1332,12,12,"PH",1
28,"28130",27391,21367,21111,235,256,"PH",24
50,"50088",337,273,264,4,9,"PH",1
50,"50150",716,430,427,10,3,"PH",0
50,"50224",70,52,49,2,3,"PH",0
50,"50031",167,105,103,0,2,"PH",0
39,"39076",3388,2673,2641,22,32,"PH",2
41,"41097",3096,2489,2451,21,38,"PH",0
29,"29901",41445,27372,27158,295,214,"PH",22
15,"15031",22951,16018,15696,382,322,"PH",17
46,"46213",15621,11361,11164,214,197,"PH",14
35,"35034",6372,2951,2921,33,30,"PH",5
33,"33052",758,526,518,2,8,"PH",0
50,"50015",109,73,73,0,0,"PH",0
50,"50208",1831,1321,1305,24,16,"PH",2
15,"15092",6869,4965,4907,53,58,"PH",3
28,"28027",1232,937,919,9,18,"PH",0
15,"15077",8677,6349,6269,82,80,"PH",5
46,"46223",7685,6040,5996,62,44,"PH",3
29,"29100",2442,1834,1824,14,10,"PH",0
46,"46046",922,699,694,2,5,"PH",0
41,"41068",13809,10171,10072,100,99,"PH",7
50,"50188",34,28,27,0,1,"PH",0
39,"39087",43561,33709,33242,404,467,"PH",32
50,"50207",126,97,95,1,2,"PH",0
3,"3063",25410,18205,17989,208,216,"PH",27
50,"50213",117,83,82,0,1,"PH",0
50,"50060",187,138,136,1,2,"PH",0
35,"35027",10510,7523,7375,88,148,"PH",14
28,"28111",618,486,479,2,7,"PH",0
46,"46165",6962,5390,5322,53,68,"PH",3
50,"50021",42,34,33,1,1,"PH",0
50,"50173",175,104,104,2,0,"PH",0
50,"50225",1638,1079,1062,7,17,"PH",1
29,"29013",1718,1302,1283,4,19,"PH",0
28,"28087",3150,2475,2453,26,22,"PH",0
50,"50178",325,228,225,4,3,"PH",0
50,"50285",635,452,445,8,7,"PH",0
46,"46096",320,267,267,0,0,"PH",2
15,"15059",10658,7889,7728,125,161,"PH",10
46,"46189",490,400,396,3,4,"PH",0
28,"28102",913,700,693,9,7,"PH",0
50,"50069",68,32,32,0,0,"PH",0
15,"15024",4726,3634,3555,51,79,"PH",3
46,"46049",292,249,245,0,4,"PH",0
33,"33006",1674,1130,1120,10,10,"PH",0
15,"15016",5135,3816,3771,22,45,"PH",0
28,"28048",489,398,389,3,9,"PH",0
50,"50034",923,634,617,10,17,"PH",2
50,"50054",63,46,46,0,0,"PH",0
15,"15040",2891,2160,2129,18,31,"PH",1
50,"50219",3704,2672,2625,39,47,"PH",3
29,"29031",1652,1123,1118,11,5,"PH",2
50,"50290",436,334,331,4,3,"PH",0
46,"46102",19880,15358,15179,122,179,"PH",12
50,"50203",1083,814,798,28,16,"PH",1
41,"41025",1999,1502,1476,13,26,"PH",2
29,"29030",839,669,668,5,1,"PH",0
28,"28182",219,179,178,2,1,"PH",0
28,"28022",30019,24469,24279,292,190,"PH",13
28,"28065",118796,93292,92186,919,1106,"PH",56
50,"50043",258,170,166,2,4,"PH",0
50,"50122",68,47,45,2,2,"PH",0
46,"46092",304,206,201,1,5,"PH",0
50,"50269",316,186,185,1,1,"PH",0
46,"46026",1217,1043,1035,2,8,"PH",1
3,"3135",228,185,181,0,4,"PH",1
46,"46121",116,103,101,0,2,"PH",0
46,"46127",2790,2298,2267,23,31,"PH",0
29,"29024",414,271,261,6,10,"PH",0
15,"15068",5404,3780,3725,53,55,"PH",1
50,"50082",108,73,72,0,1,"PH",0
33,"33055",1589,1212,1192,16,20,"PH",0
29,"29096",2880,2012,1971,28,41,"PH",0
28,"28024",156,132,132,5,0,"PH",0
3,"3104",26809,20511,20193,317,318,"PH",38
46,"46161",1454,1192,1179,8,13,"PH",1
28,"28039",139,103,103,1,0,"PH",1
39,"39046",1442,1071,1050,13,21,"PH",1
33,"33060",15694,11036,10883,112,153,"PH",1
29,"29004",343,281,281,0,0,"PH",0
50,"50295",54,42,41,0,1,"PH",0
29,"29066",363,263,260,1,3,"PH",0
28,"28099",1670,1258,1246,9,12,"PH",0
29,"29091",8777,6226,6126,64,100,"PH",5
29,"29010",1703,1411,1377,7,34,"PH",0
39,"39061",3458,2673,2644,42,29,"PH",3
3,"3059",20261,15951,15825,82,126,"PH",29
46,"46215",1451,1185,1169,8,16,"PH",1
28,"28093",1911,1537,1518,19,19,"PH",2
28,"28132",10987,8066,7943,90,123,"PH",4
3,"3015",12241,9734,9636,88,98,"PH",12
29,"29035",1717,1280,1270,14,10,"PH",1
3,"3019",14914,12087,11927,137,160,"PH",16
3,"3004",624,497,486,7,11,"PH",1
39,"39097",732,476,470,4,6,"PH",0
35,"35025",1941,1345,1328,12,17,"PH",0
28,"28125",2808,2077,2055,19,22,"PH",0
33,"33029",420,243,241,3,2,"PH",0
15,"15009",11109,8179,8014,129,165,"PH",5
28,"28149",5276,4132,4063,43,69,"PH",1
39,"39041",1775,1432,1414,15,18,"PH",0
39,"39078",1407,1041,1033,10,8,"PH",1
41,"41039",31429,23337,23138,294,199,"PH",19
46,"46173",1393,1156,1137,10,19,"PH",0
50,"50185",150,109,109,2,0,"PH",0
29,"29050",483,341,340,1,1,"PH",0
41,"41100",1097,894,878,8,16,"PH",0
46,"46205",14277,10882,10764,115,118,"PH",9
50,"50105",343,263,259,2,4,"PH",0
50,"50209",2559,1685,1661,34,24,"PH",2
50,"50156",234,186,183,2,3,"PH",0
50,"50250",58,43,43,4,0,"PH",0
46,"46175",469,406,401,5,5,"PH",0
50,"50282",88,66,63,3,3,"PH",0
46,"46229",1065,840,831,8,9,"PH",0
28,"28034",356,278,276,1,2,"PH",0
41,"41063",2678,1869,1853,22,16,"PH",0
50,"50254",179,136,136,0,0,"PH",0
28,"28080",45696,36832,36529,402,303,"PH",17
29,"29097",4076,3060,3018,40,42,"PH",4
46,"46200",1915,1625,1595,15,30,"PH",0
28,"28123",48429,38681,38187,429,494,"PH",31
3,"3089",9696,7447,7302,83,145,"PH",12
3,"3025",1252,1054,1044,4,10,"PH",1
28,"28170",2503,1744,1727,20,17,"PH",0
50,"50022",548,430,416,10,14,"PH",0
39,"39044",3864,2940,2905,44,35,"PH",1
50,"50165",1880,1339,1274,49,65,"PH",4
41,"41059",31676,23199,22889,330,310,"PH",26
50,"50138",49,43,43,2,0,"PH",0
46,"46164",11634,8843,8724,90,119,"PH",6
41,"41054",671,556,550,0,6,"PH",0
28,"28161",44185,33371,32966,353,405,"PH",23
29,"29042",14047,9845,9735,118,110,"PH",15
50,"50027",260,209,202,2,7,"PH",1
3,"3073",219,199,199,0,0,"PH",0
33,"33051",7576,5379,5335,65,44,"PH",2
46,"46156",2065,1746,1721,14,25,"PH",0
29,"29025",34637,22545,22354,268,191,"PH",20
28,"28036",2301,1809,1784,13,25,"PH",1
33,"33057",1635,1150,1132,16,18,"PH",0
3,"3033",127,102,97,2,5,"PH",0
50,"50245",121,80,80,1,0,"PH",0
3,"3055",5128,4121,4076,43,45,"PH",12
46,"46126",5471,4454,4392,53,62,"PH",3
46,"46210",346,300,295,4,5,"PH",0
35,"35002",21673,14480,14253,172,227,"PH",31
33,"33064",237,175,173,1,2,"PH",0
35,"35007",569,392,391,2,1,"PH",0
50,"50184",132,106,106,1,0,"PH",0
29,"29041",2796,1950,1921,24,29,"PH",2
33,"33003",737,475,471,6,4,"PH",2
50,"50009",122,93,93,0,0,"PH",0
46,"46169",31753,24041,23802,270,239,"PH",20
29,"29084",28386,19450,19202,296,248,"PH",13
3,"3014",234288,168004,166418,1795,1586,"PH",275
46,"46134",2326,1691,1664,20,27,"PH",0
3,"3131",181,161,157,1,4,"PH",0
50,"50260",42,35,35,1,0,"PH",0
28,"28015",14491,11562,11417,155,145,"PH",7
46,"46207",6453,5086,5031,52,55,"PH",4
12,"12003",1058,830,813,15,17,"P.O.S.I.",0
12,"12074",783,679,676,3,3,"P.O.S.I.",0
12,"12124",1902,1532,1499,15,33,"P.O.S.I.",4
12,"12040",116573,84142,83078,1257,1064,"P.O.S.I.",84
12,"12013",180,131,130,0,1,"P.O.S.I.",0
12,"12093",254,190,187,0,3,"P.O.S.I.",0
12,"12084",17219,12059,11911,165,148,"P.O.S.I.",12
12,"12092",143,98,98,0,0,"P.O.S.I.",0
12,"12020",131,109,107,1,2,"P.O.S.I.",0
12,"12106",1207,992,969,7,23,"P.O.S.I.",0
12,"12060",467,367,353,2,14,"P.O.S.I.",0
12,"12038",195,135,134,8,1,"P.O.S.I.",1
12,"12006",185,160,153,0,7,"P.O.S.I.",0
12,"12037",20,15,14,1,1,"P.O.S.I.",0
12,"12109",700,564,555,7,9,"P.O.S.I.",2
12,"12129",1936,1372,1326,29,46,"P.O.S.I.",0
12,"12119",153,87,87,0,0,"P.O.S.I.",0
12,"12075",139,106,102,0,4,"P.O.S.I.",0
12,"12081",654,519,515,2,4,"P.O.S.I.",0
12,"12028",12115,9084,8992,137,92,"P.O.S.I.",8
12,"12009",17124,12273,12098,150,175,"P.O.S.I.",5
12,"12002",135,101,100,1,1,"P.O.S.I.",1
12,"12012",2747,2196,2135,24,61,"P.O.S.I.",1
12,"12134",147,107,107,3,0,"P.O.S.I.",0
12,"12103",85,65,65,4,0,"P.O.S.I.",0
12,"12025",146,106,105,0,1,"P.O.S.I.",0
12,"12099",583,485,465,3,20,"P.O.S.I.",1
12,"12048",293,208,205,2,3,"P.O.S.I.",0
12,"12085",4941,3183,3125,32,58,"P.O.S.I.",1
12,"12055",112,79,78,3,1,"P.O.S.I.",0
12,"12073",168,135,135,1,0,"P.O.S.I.",0
12,"12116",56,45,45,0,0,"P.O.S.I.",0
12,"12059",276,227,227,1,0,"P.O.S.I.",0
12,"12016",1589,1309,1293,15,16,"P.O.S.I.",0
12,"12026",946,728,702,16,26,"P.O.S.I.",1
12,"12067",563,458,439,8,19,"P.O.S.I.",0
12,"12072",1191,1007,977,17,30,"P.O.S.I.",1
12,"12135",35189,25691,25345,380,346,"P.O.S.I.",37
12,"12029",760,619,601,7,18,"P.O.S.I.",0
12,"12090",127,109,107,2,2,"P.O.S.I.",0
12,"12102",547,474,466,2,8,"P.O.S.I.",0
12,"12070",576,473,463,5,10,"P.O.S.I.",0
12,"12104",6981,5464,5357,54,107,"P.O.S.I.",8
12,"12133",64,47,47,0,0,"P.O.S.I.",0
12,"12051",520,382,376,1,6,"P.O.S.I.",1
12,"12052",627,510,491,9,19,"P.O.S.I.",0
12,"12136",2663,2325,2284,33,41,"P.O.S.I.",1
12,"12113",100,72,72,0,0,"P.O.S.I.",0
12,"12107",358,314,311,4,3,"P.O.S.I.",1
12,"12118",83,63,62,0,1,"P.O.S.I.",0
12,"12053",2121,1745,1719,11,26,"P.O.S.I.",1
12,"12005",8066,5835,5441,116,394,"P.O.S.I.",7
12,"12058",99,74,74,0,0,"P.O.S.I.",0
12,"12901",3383,2664,2632,34,32,"P.O.S.I.",2
12,"12011",4663,3578,3525,28,53,"P.O.S.I.",3
12,"12043",620,499,487,2,12,"P.O.S.I.",0
12,"12004",4354,3145,3083,50,62,"P.O.S.I.",0
12,"12096",854,663,653,17,10,"P.O.S.I.",1
12,"12123",70,50,48,2,2,"P.O.S.I.",0
12,"12100",1380,1124,1109,11,15,"P.O.S.I.",0
12,"12089",4277,3009,2946,32,63,"P.O.S.I.",1
12,"12063",59,42,41,0,1,"P.O.S.I.",0
12,"12101",385,309,296,3,13,"P.O.S.I.",0
12,"12111",423,375,363,6,12,"P.O.S.I.",0
12,"12071",1355,1069,1050,3,19,"P.O.S.I.",0
12,"12001",1098,821,817,8,4,"P.O.S.I.",0
12,"12010",280,232,229,3,3,"P.O.S.I.",0
12,"12140",1204,975,954,9,21,"P.O.S.I.",0
12,"12098",665,552,539,9,13,"P.O.S.I.",1
12,"12132",524,407,401,4,6,"P.O.S.I.",0
12,"12039",870,743,736,4,7,"P.O.S.I.",2
12,"12115",234,184,183,2,1,"P.O.S.I.",1
12,"12095",1027,790,775,15,15,"P.O.S.I.",1
12,"12126",24420,18431,18136,231,295,"P.O.S.I.",13
12,"12097",78,59,59,4,0,"P.O.S.I.",0
12,"12141",116,97,97,0,0,"P.O.S.I.",0
12,"12139",344,219,216,0,3,"P.O.S.I.",0
12,"12088",55,51,51,2,0,"P.O.S.I.",0
12,"12021",4433,3368,3292,42,76,"P.O.S.I.",1
12,"12057",650,530,515,6,15,"P.O.S.I.",0
12,"12078",365,273,267,5,6,"P.O.S.I.",0
12,"12031",3748,2751,2687,35,64,"P.O.S.I.",1
12,"12045",388,301,286,2,15,"P.O.S.I.",0
12,"12032",23406,16895,16721,227,174,"P.O.S.I.",18
12,"12061",431,324,316,6,8,"P.O.S.I.",1
12,"12087",22,20,20,0,0,"P.O.S.I.",0
12,"12076",105,79,79,0,0,"P.O.S.I.",0
12,"12064",118,91,89,1,2,"P.O.S.I.",0
12,"12056",304,259,254,7,5,"P.O.S.I.",0
12,"12017",183,143,141,6,2,"P.O.S.I.",0
12,"12120",218,180,177,0,3,"P.O.S.I.",0
12,"12112",104,90,90,0,0,"P.O.S.I.",0
12,"12018",326,274,265,1,9,"P.O.S.I.",1
12,"12022",367,282,279,4,3,"P.O.S.I.",2
12,"12079",450,360,353,3,7,"P.O.S.I.",0
12,"12077",4683,3476,3414,41,62,"P.O.S.I.",1
12,"12050",1418,1183,1156,8,27,"P.O.S.I.",0
12,"12065",181,155,155,0,0,"P.O.S.I.",0
12,"12091",203,153,140,2,13,"P.O.S.I.",1
12,"12137",47,36,35,0,1,"P.O.S.I.",0
12,"12014",191,139,137,4,2,"P.O.S.I.",1
12,"12069",53,48,47,0,1,"P.O.S.I.",0
12,"12080",2051,1692,1650,23,42,"P.O.S.I.",1
12,"12138",18762,12489,12231,243,258,"P.O.S.I.",19
12,"12036",668,529,514,6,15,"P.O.S.I.",0
12,"12008",236,203,199,4,4,"P.O.S.I.",0
12,"12007",747,674,660,9,14,"P.O.S.I.",0
12,"12121",1197,1050,1020,4,30,"P.O.S.I.",0
12,"12110",253,199,195,3,4,"P.O.S.I.",0
12,"12122",835,674,658,14,16,"P.O.S.I.",0
12,"12105",866,679,673,6,6,"P.O.S.I.",3
12,"12083",106,89,88,0,1,"P.O.S.I.",0
12,"12094",807,612,604,14,8,"P.O.S.I.",0
12,"12131",92,78,78,1,0,"P.O.S.I.",0
12,"12068",57,45,44,0,1,"P.O.S.I.",0
12,"12117",3674,2846,2794,25,52,"P.O.S.I.",4
12,"12044",527,472,463,4,9,"P.O.S.I.",0
12,"12127",92,64,61,0,3,"P.O.S.I.",0
12,"12041",115,98,98,2,0,"P.O.S.I.",0
12,"12108",495,394,389,4,5,"P.O.S.I.",0
12,"12114",228,178,173,2,5,"P.O.S.I.",0
12,"12027",16914,11657,11452,188,205,"P.O.S.I.",20
12,"12902",2056,1454,1411,14,43,"P.O.S.I.",2
12,"12015",96,83,82,3,1,"P.O.S.I.",0
12,"12142",158,122,121,1,1,"P.O.S.I.",0
12,"12024",146,129,128,1,1,"P.O.S.I.",0
12,"12130",425,348,344,2,4,"P.O.S.I.",0
12,"12042",664,549,530,5,19,"P.O.S.I.",2
12,"12049",471,366,344,10,22,"P.O.S.I.",0
12,"12128",1448,1114,1092,16,22,"P.O.S.I.",0
12,"12125",235,203,201,1,2,"P.O.S.I.",0
12,"12046",236,177,176,4,1,"P.O.S.I.",0
12,"12034",1509,1125,1097,10,28,"P.O.S.I.",0
12,"12033",1970,1547,1509,8,38,"P.O.S.I.",0
12,"12082",9741,7555,7408,84,147,"P.O.S.I.",2
28,"28164",2807,2194,2173,10,21,"POSI",0
28,"28010",9309,7304,7229,71,75,"POSI",1
28,"28074",136617,106248,105095,1101,1153,"POSI",62
28,"28050",3576,2706,2663,21,43,"POSI",0
28,"28088",251,174,173,5,1,"POSI",0
28,"28172",7648,6130,6076,65,54,"POSI",1
28,"28111",618,486,479,2,7,"POSI",1
28,"28080",45696,36832,36529,402,303,"POSI",18
28,"28120",1259,946,931,11,15,"POSI",0
28,"28055",932,713,707,5,6,"POSI",0
28,"28101",222,158,158,4,0,"POSI",0
28,"28127",60108,48418,48039,568,379,"POSI",10
28,"28019",1195,901,888,5,13,"POSI",0
28,"28022",30019,24469,24279,292,190,"POSI",4
28,"28057",1419,1084,1074,12,10,"POSI",2
28,"28097",127,94,92,0,2,"POSI",0
28,"28023",4350,3425,3392,32,33,"POSI",2
28,"28078",39,23,23,1,0,"POSI",0
28,"28024",156,132,132,5,0,"POSI",0
28,"28174",1745,1233,1224,11,9,"POSI",1
28,"28134",55921,42676,42221,505,455,"POSI",24
28,"28026",5852,4506,4449,40,57,"POSI",3
28,"28150",2985,2363,2345,21,18,"POSI",0
28,"28117",116,90,90,1,0,"POSI",0
28,"28167",7818,6016,5942,82,74,"POSI",0
28,"28146",1672,1220,1205,4,15,"POSI",0
28,"28153",608,422,406,1,16,"POSI",0
28,"28159",629,482,478,2,4,"POSI",0
28,"28007",122891,95200,94139,990,1061,"POSI",76
28,"28107",443,338,333,7,5,"POSI",0
28,"28062",311,233,226,0,7,"POSI",0
28,"28137",1626,1231,1222,9,9,"POSI",0
28,"28173",507,397,390,2,7,"POSI",0
28,"28041",4006,3190,3154,45,36,"POSI",1
28,"28140",2665,2167,2141,26,26,"POSI",0
28,"28021",418,334,328,4,6,"POSI",0
28,"28095",1358,1092,1077,8,15,"POSI",0
28,"28082",5144,3967,3905,46,62,"POSI",1
28,"28155",529,427,416,2,11,"POSI",0
28,"28033",3581,2712,2691,14,21,"POSI",3
28,"28108",3002,2254,2228,31,26,"POSI",2
28,"28128",366,280,275,2,5,"POSI",0
28,"28178",1017,799,791,11,8,"POSI",0
28,"28122",504,367,366,2,1,"POSI",0
28,"28025",426,336,332,2,4,"POSI",0
28,"28031",1981,1524,1500,9,24,"POSI",1
28,"28169",1244,971,962,8,9,"POSI",0
28,"28069",51,35,33,1,2,"POSI",0
28,"28064",143,112,110,1,2,"POSI",0
28,"28044",5403,4245,4188,27,57,"POSI",0
28,"28110",1912,1492,1475,8,17,"POSI",0
28,"28065",118796,93292,92186,919,1106,"POSI",169
28,"28151",3025,2237,2185,9,52,"POSI",0
28,"28043",5944,4199,4147,56,52,"POSI",2
28,"28181",20003,16133,15952,159,181,"POSI",1
28,"28168",1144,821,810,15,11,"POSI",0
28,"28079",2290453,1721837,1705310,17342,16527,"POSI",707
28,"28011",437,318,315,2,3,"POSI",0
28,"28132",10987,8066,7943,90,123,"POSI",2
28,"28086",4603,3286,3248,29,38,"POSI",1
28,"28059",4061,3169,3130,38,39,"POSI",1
28,"28089",3531,2786,2753,25,33,"POSI",1
28,"28145",2125,1643,1620,15,23,"POSI",2
28,"28123",48429,38681,38187,429,494,"POSI",14
28,"28154",5232,3910,3860,40,50,"POSI",0
28,"28163",395,305,301,7,4,"POSI",0
28,"28028",1615,1204,1173,11,31,"POSI",0
28,"28092",148714,112174,110838,1215,1336,"POSI",78
28,"28901",765,579,567,2,12,"POSI",0
28,"28099",1670,1258,1246,9,12,"POSI",0
28,"28034",356,278,276,1,2,"POSI",0
28,"28009",13466,10392,10286,102,106,"POSI",2
28,"28147",910,705,698,5,7,"POSI",0
28,"28085",3794,2980,2933,18,47,"POSI",0
28,"28902",453,338,329,3,9,"POSI",0
28,"28096",16844,12441,12308,117,133,"POSI",3
28,"28071",77,57,55,0,2,"POSI",0
28,"28143",81,71,67,1,4,"POSI",0
28,"28106",72603,53231,52524,681,707,"POSI",97
28,"28176",10977,8790,8718,68,72,"POSI",3
28,"28141",5568,4097,4051,31,46,"POSI",1
28,"28161",44185,33371,32966,353,405,"POSI",13
28,"28058",137542,103880,102686,1155,1194,"POSI",93
28,"28003",196,154,151,2,3,"POSI",0
28,"28130",27391,21367,21111,235,256,"POSI",11
28,"28160",7496,5680,5613,46,67,"POSI",0
28,"28037",1598,1263,1250,10,13,"POSI",0
28,"28152",14903,11954,11865,125,89,"POSI",4
28,"28002",2650,2018,1993,24,25,"POSI",1
28,"28053",6035,4854,4783,61,71,"POSI",3
28,"28073",11899,8877,8769,112,108,"POSI",3
28,"28180",5179,4033,3975,18,58,"POSI",0
28,"28038",4999,3659,3590,32,69,"POSI",4
28,"28165",1689,1310,1295,5,15,"POSI",0
28,"28056",782,604,586,6,18,"POSI",0
28,"28182",219,179,178,2,1,"POSI",0
28,"28051",1469,1147,1129,7,18,"POSI",0
28,"28136",618,527,516,2,11,"POSI",0
28,"28131",12664,9454,9342,100,112,"POSI",4
28,"28129",7219,5536,5461,71,75,"POSI",5
28,"28032",4469,3412,3369,32,43,"POSI",0
28,"28005",132097,100509,99506,1069,1003,"POSI",42
28,"28066",7033,5439,5383,45,56,"POSI",3
28,"28076",417,325,321,1,4,"POSI",0
28,"28036",2301,1809,1784,13,25,"POSI",1
28,"28001",61,46,45,1,1,"POSI",0
28,"28162",2263,1802,1786,32,16,"POSI",0
28,"28093",1911,1537,1518,19,19,"POSI",1
28,"28135",928,665,659,6,6,"POSI",0
28,"28166",325,269,268,8,1,"POSI",0
28,"28040",15089,9976,9852,116,124,"POSI",9
28,"28052",3799,2753,2719,17,34,"POSI",0
28,"28035",1314,1058,1046,3,12,"POSI",0
28,"28116",666,507,498,5,9,"POSI",0
28,"28144",5663,4456,4410,47,46,"POSI",2
28,"28083",8037,6078,6025,66,53,"POSI",2
28,"28039",139,103,103,1,0,"POSI",0
28,"28012",830,654,651,6,3,"POSI",0
28,"28149",5276,4132,4063,43,69,"POSI",1
28,"28018",3572,2837,2795,20,42,"POSI",0
28,"28008",1734,1244,1221,11,23,"POSI",0
28,"28072",5232,4065,4007,35,58,"POSI",6
28,"28067",3893,2996,2950,26,46,"POSI",0
28,"28090",7899,6216,6131,60,85,"POSI",2
28,"28006",74554,57439,56890,586,549,"POSI",64
28,"28100",3970,2903,2865,32,38,"POSI",0
28,"28091",5202,3714,3671,34,43,"POSI",1
28,"28115",57612,46786,46458,458,328,"POSI",5
28,"28102",913,700,693,9,7,"POSI",0
28,"28004",5761,4098,4044,38,54,"POSI",1
28,"28084",15408,11489,11355,122,134,"POSI",5
28,"28048",489,398,389,3,9,"POSI",0
28,"28109",1621,1121,1104,9,17,"POSI",0
28,"28112",168,138,137,0,1,"POSI",0
28,"28179",1385,1039,1027,10,12,"POSI",0
28,"28068",10502,7857,7778,68,79,"POSI",5
28,"28121",185,153,152,0,1,"POSI",0
28,"28094",774,557,551,5,6,"POSI",0
28,"28124",83,55,53,0,2,"POSI",0
28,"28049",59507,46919,46379,488,540,"POSI",23
28,"28013",38226,27886,27547,246,339,"POSI",13
28,"28014",31360,23434,23133,203,301,"POSI",4
28,"28015",14491,11562,11417,155,145,"POSI",4
28,"28119",1911,1527,1514,13,13,"POSI",2
28,"28061",19624,15082,14905,162,177,"POSI",5
28,"28060",1471,1205,1192,8,13,"POSI",0
28,"28020",145,102,100,0,2,"POSI",0
28,"28148",79726,60405,59651,724,754,"POSI",31
28,"28070",139,98,97,0,1,"POSI",0
28,"28075",5127,3976,3916,42,60,"POSI",1
28,"28047",38404,28739,28436,312,303,"POSI",4
28,"28175",780,641,630,8,11,"POSI",0
28,"28054",10459,7798,7698,65,100,"POSI",1
28,"28171",4148,2972,2929,21,43,"POSI",0
28,"28030",1591,1268,1230,12,38,"POSI",1
28,"28158",632,505,495,4,10,"POSI",0
28,"28046",4208,3297,3272,31,25,"POSI",1
28,"28138",78,48,46,0,2,"POSI",0
28,"28183",935,663,649,7,14,"POSI",0
28,"28903",29222,23945,23689,296,256,"POSI",2
28,"28133",5868,4236,4144,23,92,"POSI",1
28,"28029",538,416,414,4,2,"POSI",0
28,"28027",1232,937,919,9,18,"POSI",0
28,"28157",605,452,446,2,6,"POSI",0
28,"28156",958,742,733,12,9,"POSI",0
28,"28016",86,68,67,3,1,"POSI",0
28,"28063",268,209,203,4,6,"POSI",0
28,"28118",72,49,47,1,2,"POSI",0
28,"28170",2503,1744,1727,20,17,"POSI",0
28,"28042",1091,814,808,5,6,"POSI",0
28,"28104",11704,9455,9361,119,94,"POSI",3
28,"28045",30286,23148,22879,226,269,"POSI",17
28,"28114",148,110,110,0,0,"POSI",0
28,"28125",2808,2077,2055,19,22,"POSI",0
28,"28113",31318,23779,23436,271,343,"POSI",8
28,"28017",1120,905,888,8,17,"POSI",0
28,"28126",59,37,37,0,0,"POSI",0
28,"28087",3150,2475,2453,26,22,"POSI",0
28,"28177",9470,7524,7466,87,58,"POSI",1
30,"30043",24501,19738,19416,230,322,"P.R.D.E.",20
30,"30026",15165,10524,10369,80,155,"P.R.D.E.",13
30,"30002",9802,7628,7553,48,75,"P.R.D.E.",7
30,"30040",733,640,635,2,5,"P.R.D.E.",1
30,"30032",2839,2361,2337,21,24,"P.R.D.E.",2
30,"30011",4687,3776,3726,20,50,"P.R.D.E.",5
30,"30902",7463,5291,5228,38,63,"P.R.D.E.",4
30,"30029",11533,8854,8768,73,86,"P.R.D.E.",7
30,"30020",5989,4533,4487,14,46,"P.R.D.E.",2
30,"30041",12957,9360,9288,89,72,"P.R.D.E.",4
30,"30027",45194,35272,34973,366,299,"P.R.D.E.",27
30,"30019",25722,18740,18553,164,187,"P.R.D.E.",9
30,"30018",7493,6003,5922,52,81,"P.R.D.E.",11
30,"30031",560,471,469,3,2,"P.R.D.E.",2
30,"30034",1182,956,943,3,13,"P.R.D.E.",0
30,"30015",18792,14453,14336,120,117,"P.R.D.E.",5
30,"30025",4780,3901,3874,18,27,"P.R.D.E.",3
30,"30024",57868,41894,41513,393,381,"P.R.D.E.",27
30,"30014",1686,1400,1387,10,13,"P.R.D.E.",0
30,"30017",11683,9332,9233,95,99,"P.R.D.E.",5
30,"30035",17849,12871,12744,133,127,"P.R.D.E.",15
30,"30007",6115,4651,4603,29,48,"P.R.D.E.",3
30,"30010",6804,5691,5647,36,44,"P.R.D.E.",4
30,"30038",15057,11640,11555,82,85,"P.R.D.E.",15
30,"30004",1164,958,952,1,6,"P.R.D.E.",0
30,"30023",3572,2859,2811,22,48,"P.R.D.E.",2
30,"30008",13289,9992,9849,86,143,"P.R.D.E.",11
30,"30037",17942,13830,13734,90,96,"P.R.D.E.",14
30,"30001",4763,3992,3956,26,36,"P.R.D.E.",2
30,"30013",7369,5780,5731,53,49,"P.R.D.E.",3
30,"30021",8550,6423,6349,44,74,"P.R.D.E.",5
30,"30033",9940,7794,7700,79,94,"P.R.D.E.",2
30,"30030",305669,236235,234391,2112,1844,"P.R.D.E.",247
30,"30036",13978,10244,10141,94,103,"P.R.D.E.",13
30,"30901",10113,8265,8194,70,71,"P.R.D.E.",5
30,"30028",6810,5333,5251,44,82,"P.R.D.E.",3
30,"30022",16489,12207,12042,152,165,"P.R.D.E.",6
30,"30012",9037,7242,7142,62,100,"P.R.D.E.",3
30,"30042",1841,1531,1519,10,12,"P.R.D.E.",0
30,"30003",23570,16482,16354,169,128,"P.R.D.E.",10
30,"30016",149046,103847,102890,1031,957,"P.R.D.E.",110
30,"30005",29081,22312,22142,184,170,"P.R.D.E.",24
30,"30009",11961,9992,9880,92,112,"P.R.D.E.",7
30,"30039",18615,14213,14068,134,145,"P.R.D.E.",15
30,"30006",823,719,711,5,8,"P.R.D.E.",0
44,"44111",101,68,68,4,0,"PIRATA",1
31,"31164",604,462,448,9,14,"PIRATA",2
31,"31080",544,428,426,7,2,"PIRATA",3
44,"44204",24,21,21,0,0,"PIRATA",0
44,"44024",24,19,19,0,0,"PIRATA",0
44,"44037",483,349,344,10,5,"PIRATA",1
12,"12097",78,59,59,4,0,"PIRATA",0
22,"22047",228,200,200,5,0,"PIRATA",0
22,"22029",130,99,98,6,1,"PIRATA",0
22,"22129",193,124,123,4,1,"PIRATA",0
31,"31121",79,53,52,2,1,"PIRATA",0
12,"12124",1902,1532,1499,15,33,"PIRATA",1
31,"31091",365,227,224,3,3,"PIRATA",0
22,"22095",87,61,61,1,0,"PIRATA",0
22,"22249",110,83,81,0,2,"PIRATA",0
22,"22133",123,87,85,2,2,"PIRATA",0
44,"44032",18,12,12,0,0,"PIRATA",0
31,"31090",156,77,77,0,0,"PIRATA",0
22,"22020",110,81,79,3,2,"PIRATA",0
12,"12140",1204,975,954,9,21,"PIRATA",5
22,"22024",222,144,139,3,5,"PIRATA",1
12,"12046",236,177,176,4,1,"PIRATA",0
44,"44031",124,72,72,0,0,"PIRATA",0
31,"31144",840,509,508,7,1,"PIRATA",3
12,"12072",1191,1007,977,17,30,"PIRATA",2
44,"44082",90,67,66,1,1,"PIRATA",0
22,"22068",79,51,51,2,0,"PIRATA",0
44,"44238",2475,1718,1692,50,26,"PIRATA",6
31,"31154",229,133,133,4,0,"PIRATA",2
44,"44225",129,100,98,5,2,"PIRATA",0
44,"44084",63,51,50,0,1,"PIRATA",0
31,"31117",670,471,467,3,4,"PIRATA",0
31,"31016",7377,5149,5072,101,77,"PIRATA",31
44,"44145",1078,723,714,26,9,"PIRATA",2
44,"44115",121,100,100,0,0,"PIRATA",0
31,"31093",305,207,203,2,4,"PIRATA",0
22,"22139",86,66,63,2,3,"PIRATA",1
31,"31252",91,60,58,0,2,"PIRATA",0
12,"12037",20,15,14,1,1,"PIRATA",0
22,"22142",114,91,91,2,0,"PIRATA",0
31,"31264",173,110,108,1,2,"PIRATA",1
44,"44044",103,79,78,0,1,"PIRATA",2
44,"44268",30,25,25,0,0,"PIRATA",0
44,"44221",377,305,297,6,8,"PIRATA",0
12,"12090",127,109,107,2,2,"PIRATA",0
31,"31046",58,41,41,3,0,"PIRATA",2
31,"31100",298,193,193,2,0,"PIRATA",2
31,"31130",319,213,209,1,4,"PIRATA",1
22,"22188",100,68,66,3,2,"PIRATA",1
31,"31127",145,89,89,2,0,"PIRATA",0
44,"44080",294,216,211,3,5,"PIRATA",0
44,"44265",203,169,158,6,11,"PIRATA",0
22,"22160",219,166,166,5,0,"PIRATA",3
44,"44121",63,48,48,1,0,"PIRATA",0
31,"31147",103,81,80,3,1,"PIRATA",0
31,"31208",2574,2003,1966,32,37,"PIRATA",6
31,"31001",88,58,58,1,0,"PIRATA",0
44,"44137",215,165,163,5,2,"PIRATA",1
22,"22184",203,172,167,2,5,"PIRATA",1
31,"31161",321,251,246,5,5,"PIRATA",0
44,"44195",103,71,70,0,1,"PIRATA",0
22,"22206",218,169,167,3,2,"PIRATA",3
31,"31109",1365,946,934,11,12,"PIRATA",9
31,"31136",438,283,283,10,0,"PIRATA",1
44,"44004",450,334,332,2,2,"PIRATA",1
22,"22214",131,101,100,2,1,"PIRATA",0
44,"44123",117,79,78,2,1,"PIRATA",0
31,"31182",45,28,28,2,0,"PIRATA",0
31,"31211",25,14,14,2,0,"PIRATA",0
44,"44117",357,278,275,0,3,"PIRATA",0
44,"44252",78,63,60,0,3,"PIRATA",0
22,"22156",256,209,203,5,6,"PIRATA",0
22,"22063",184,142,140,2,2,"PIRATA",0
44,"44014",2603,1965,1912,25,53,"PIRATA",13
22,"22054",1602,1040,982,42,58,"PIRATA",5
22,"22199",7259,4980,4861,128,119,"PIRATA",12
44,"44217",37,28,27,0,1,"PIRATA",0
12,"12103",85,65,65,4,0,"PIRATA",0
44,"44105",82,63,63,2,0,"PIRATA",0
12,"12089",4277,3009,2946,32,63,"PIRATA",10
31,"31066",915,660,647,19,13,"PIRATA",0
12,"12038",195,135,134,8,1,"PIRATA",0
22,"22088",171,133,128,5,5,"PIRATA",1
31,"31092",676,447,446,6,1,"PIRATA",2
12,"12050",1418,1183,1156,8,27,"PIRATA",2
31,"31259",503,341,336,6,5,"PIRATA",2
12,"12020",131,109,107,1,2,"PIRATA",0
22,"22168",22,16,16,0,0,"PIRATA",1
44,"44102",30,29,28,0,1,"PIRATA",0
12,"12018",326,274,265,1,9,"PIRATA",0
44,"44109",123,86,84,2,2,"PIRATA",0
22,"22109",243,178,178,2,0,"PIRATA",0
44,"44154",271,196,195,7,1,"PIRATA",0
44,"44114",254,194,188,4,6,"PIRATA",0
12,"12031",3748,2751,2687,35,64,"PIRATA",13
12,"12125",235,203,201,1,2,"PIRATA",1
44,"44260",160,117,115,5,2,"PIRATA",1
44,"44211",39,32,32,2,0,"PIRATA",0
44,"44085",61,38,38,0,0,"PIRATA",1
22,"22186",217,173,173,3,0,"PIRATA",1
22,"22045",104,83,80,2,3,"PIRATA",1
12,"12126",24420,18431,18136,231,295,"PIRATA",34
22,"22233",94,69,69,0,0,"PIRATA",0
31,"31002",421,292,284,5,8,"PIRATA",0
44,"44047",267,162,160,4,2,"PIRATA",0
22,"22086",207,149,147,1,2,"PIRATA",1
31,"31160",111,93,93,7,0,"PIRATA",0
31,"31243",313,227,223,5,4,"PIRATA",1
31,"31188",185,139,137,2,2,"PIRATA",2
22,"22163",431,353,344,5,9,"PIRATA",3
31,"31151",77,49,49,2,0,"PIRATA",0
44,"44041",67,56,51,1,5,"PIRATA",1
31,"31114",384,320,318,37,2,"PIRATA",0
44,"44161",487,363,358,9,5,"PIRATA",2
44,"44192",401,324,322,5,2,"PIRATA",2
44,"44240",168,135,132,2,3,"PIRATA",0
12,"12076",105,79,79,0,0,"PIRATA",0
31,"31073",332,228,226,1,2,"PIRATA",0
12,"12127",92,64,61,0,3,"PIRATA",0
31,"31120",408,267,265,8,2,"PIRATA",0
44,"44244",93,56,56,5,0,"PIRATA",1
31,"31902",3722,2670,2632,77,38,"PIRATA",23
44,"44219",207,159,157,1,2,"PIRATA",0
31,"31112",106,79,78,0,1,"PIRATA",0
12,"12065",181,155,155,0,0,"PIRATA",0
44,"44165",182,140,140,1,0,"PIRATA",0
31,"31105",1619,1306,1284,30,22,"PIRATA",2
44,"44138",158,109,106,0,3,"PIRATA",0
12,"12024",146,129,128,1,1,"PIRATA",1
31,"31232",24440,17810,17436,420,374,"PIRATA",167
12,"12067",563,458,439,8,19,"PIRATA",0
31,"31177",264,162,158,3,4,"PIRATA",0
22,"22205",472,369,363,5,6,"PIRATA",1
31,"31116",71,48,48,2,0,"PIRATA",0
22,"22243",45,27,27,1,0,"PIRATA",0
31,"31170",46,40,39,3,1,"PIRATA",0
44,"44118",183,129,127,2,2,"PIRATA",0
31,"31157",3567,2435,2393,32,42,"PIRATA",7
22,"22252",130,98,96,5,2,"PIRATA",0
44,"44019",75,38,37,0,1,"PIRATA",0
31,"31246",148,101,100,3,1,"PIRATA",0
12,"12055",112,79,78,3,1,"PIRATA",2
22,"22135",200,152,147,5,5,"PIRATA",0
31,"31167",859,600,593,11,7,"PIRATA",3
31,"31229",46,38,37,0,1,"PIRATA",2
31,"31178",540,395,392,4,3,"PIRATA",0
31,"31237",198,137,136,7,1,"PIRATA",1
22,"22102",194,152,149,4,3,"PIRATA",3
22,"22017",917,677,661,8,16,"PIRATA",6
31,"31070",2706,1949,1912,34,37,"PIRATA",6
22,"22032",120,78,73,5,5,"PIRATA",0
12,"12013",180,131,130,0,1,"PIRATA",0
44,"44087",98,87,87,2,0,"PIRATA",0
22,"22901",792,515,508,13,7,"PIRATA",1
22,"22066",699,479,464,8,15,"PIRATA",2
44,"44196",152,116,114,2,2,"PIRATA",0
31,"31195",186,127,126,1,1,"PIRATA",0
22,"22072",209,130,128,2,2,"PIRATA",0
44,"44107",233,161,154,3,7,"PIRATA",1
12,"12111",423,375,363,6,12,"PIRATA",0
22,"22149",321,244,241,5,3,"PIRATA",0
31,"31038",1372,982,968,17,14,"PIRATA",4
44,"44029",637,495,490,6,5,"PIRATA",0
31,"31025",751,501,495,12,6,"PIRATA",2
22,"22195",231,193,189,6,4,"PIRATA",0
22,"22904",908,660,653,14,7,"PIRATA",1
31,"31129",405,285,281,1,4,"PIRATA",0
31,"31190",48,34,34,1,0,"PIRATA",0
31,"31201",144714,104019,102644,2027,1375,"PIRATA",566
31,"31106",676,534,518,10,16,"PIRATA",3
31,"31119",49,28,28,0,0,"PIRATA",0
44,"44203",8,8,8,0,0,"PIRATA",0
44,"44022",550,387,380,6,7,"PIRATA",3
22,"22074",311,227,219,5,8,"PIRATA",0
44,"44216",25877,18461,18057,467,404,"PIRATA",64
22,"22239",90,76,76,2,0,"PIRATA",1
22,"22046",784,618,599,15,19,"PIRATA",0
22,"22902",240,169,169,3,0,"PIRATA",1
31,"31107",1706,1321,1311,17,10,"PIRATA",9
31,"31223",1043,783,771,14,12,"PIRATA",1
12,"12078",365,273,267,5,6,"PIRATA",1
31,"31222",67,46,44,3,2,"PIRATA",0
22,"22212",93,79,79,0,0,"PIRATA",0
12,"12012",2747,2196,2135,24,61,"PIRATA",2
22,"22228",501,382,369,15,13,"PIRATA",3
44,"44177",120,85,85,1,0,"PIRATA",0
22,"22060",1180,909,891,13,18,"PIRATA",3
31,"31009",717,510,497,14,13,"PIRATA",0
22,"22250",368,261,255,12,6,"PIRATA",1
31,"31244",153,97,97,3,0,"PIRATA",0
31,"31050",6253,4045,3987,74,58,"PIRATA",6
12,"12082",9741,7555,7408,84,147,"PIRATA",13
31,"31233",103,87,82,2,5,"PIRATA",3
31,"31263",241,135,132,0,3,"PIRATA",0
12,"12131",92,78,78,1,0,"PIRATA",1
12,"12049",471,366,344,10,22,"PIRATA",0
22,"22084",524,362,354,11,8,"PIRATA",2
12,"12107",358,314,311,4,3,"PIRATA",0
31,"31156",268,202,201,5,1,"PIRATA",0
44,"44215",156,100,100,2,0,"PIRATA",0
22,"22115",415,307,304,2,3,"PIRATA",1
12,"12007",747,674,660,9,14,"PIRATA",3
31,"31048",154,118,117,0,1,"PIRATA",0
44,"44227",81,59,59,0,0,"PIRATA",0
22,"22230",302,234,231,11,3,"PIRATA",0
31,"31255",100,78,78,1,0,"PIRATA",1
22,"22215",137,90,90,1,0,"PIRATA",1
31,"31183",667,516,508,8,8,"PIRATA",0
31,"31245",87,59,58,5,1,"PIRATA",0
12,"12022",367,282,279,4,3,"PIRATA",0
44,"44039",255,189,189,5,0,"PIRATA",1
22,"22128",203,164,161,7,3,"PIRATA",0
31,"31032",1785,1330,1305,24,25,"PIRATA",2
22,"22112",9618,6642,6533,205,109,"PIRATA",23
44,"44001",69,48,47,0,1,"PIRATA",0
44,"44094",116,105,103,4,2,"PIRATA",0
31,"31005",312,209,206,4,3,"PIRATA",2
44,"44212",45,35,35,0,0,"PIRATA",1
31,"31198",38,33,33,0,0,"PIRATA",1
22,"22007",863,636,621,8,15,"PIRATA",1
22,"22059",1149,792,764,23,28,"PIRATA",1
44,"44052",96,60,59,2,1,"PIRATA",0
12,"12040",116573,84142,83078,1257,1064,"PIRATA",375
12,"12136",2663,2325,2284,33,41,"PIRATA",6
31,"31226",597,339,335,2,4,"PIRATA",1
22,"22203",92,79,79,0,0,"PIRATA",0
44,"44208",32,23,23,1,0,"PIRATA",0
22,"22907",1444,1034,1018,12,16,"PIRATA",0
12,"12134",147,107,107,3,0,"PIRATA",0
44,"44086",485,380,371,5,9,"PIRATA",1
22,"22218",49,33,33,1,0,"PIRATA",2
22,"22246",93,63,62,0,1,"PIRATA",0
44,"44150",30,30,30,0,0,"PIRATA",0
22,"22136",908,671,662,11,9,"PIRATA",0
44,"44169",403,285,278,0,7,"PIRATA",0
31,"31023",5338,3986,3920,120,66,"PIRATA",28
44,"44250",20,11,11,1,0,"PIRATA",0
44,"44067",132,89,89,0,0,"PIRATA",0
22,"22157",251,176,175,9,1,"PIRATA",3
31,"31098",1762,1285,1262,34,23,"PIRATA",2
22,"22044",278,195,191,7,4,"PIRATA",4
31,"31108",1969,1474,1452,23,22,"PIRATA",12
12,"12121",1197,1050,1020,4,30,"PIRATA",0
31,"31132",160,124,124,6,0,"PIRATA",1
44,"44197",60,37,37,1,0,"PIRATA",0
22,"22151",97,71,71,0,0,"PIRATA",0
22,"22061",6611,4789,4698,110,91,"PIRATA",26
44,"44093",86,64,64,3,0,"PIRATA",0
31,"31139",172,97,97,1,0,"PIRATA",0
44,"44025",6168,4326,4150,68,176,"PIRATA",8
31,"31015",1989,1404,1380,29,24,"PIRATA",5
22,"22131",96,79,77,2,2,"PIRATA",0
12,"12042",664,549,530,5,19,"PIRATA",2
12,"12088",55,51,51,2,0,"PIRATA",0
22,"22222",510,367,365,6,2,"PIRATA",1
22,"22116",1571,1127,1114,37,13,"PIRATA",2
44,"44241",575,442,427,4,15,"PIRATA",1
44,"44035",122,99,98,3,1,"PIRATA",0
12,"12901",3383,2664,2632,34,32,"PIRATA",5
31,"31219",93,75,73,1,2,"PIRATA",0
22,"22167",515,417,399,16,18,"PIRATA",3
22,"22011",102,78,78,3,0,"PIRATA",1
31,"31086",11499,8520,8389,214,131,"PIRATA",54
12,"12129",1936,1372,1326,29,46,"PIRATA",7
31,"31076",2314,1843,1823,39,20,"PIRATA",7
44,"44071",657,453,448,9,5,"PIRATA",9
44,"44172",345,257,251,3,6,"PIRATA",0
44,"44106",173,132,131,8,1,"PIRATA",2
12,"12137",47,36,35,0,1,"PIRATA",0
31,"31152",1406,1003,975,23,28,"PIRATA",2
31,"31010",5788,3716,3637,48,79,"PIRATA",30
22,"22213",3152,2265,2230,62,35,"PIRATA",8
22,"22105",132,104,102,2,2,"PIRATA",1
31,"31060",12916,8830,8687,158,143,"PIRATA",67
12,"12069",53,48,47,0,1,"PIRATA",0
22,"22085",119,97,94,0,3,"PIRATA",0
31,"31149",2381,1626,1607,7,19,"PIRATA",0
31,"31209",155,105,104,1,1,"PIRATA",0
31,"31064",1500,1137,1120,12,17,"PIRATA",5
44,"44210",754,573,567,3,6,"PIRATA",0
44,"44021",114,81,77,1,4,"PIRATA",0
22,"22220",192,138,136,5,2,"PIRATA",3
22,"22053",867,567,554,13,13,"PIRATA",1
31,"31055",264,194,193,0,1,"PIRATA",0
22,"22122",62,57,57,3,0,"PIRATA",0
31,"31007",137,96,90,2,6,"PIRATA",0
44,"44108",352,228,225,8,3,"PIRATA",1
22,"22905",312,249,247,4,2,"PIRATA",1
12,"12039",870,743,736,4,7,"PIRATA",3
44,"44018",27,23,23,0,0,"PIRATA",0
31,"31221",1182,774,767,12,7,"PIRATA",1
31,"31068",3004,2258,2207,43,51,"PIRATA",10
31,"31008",97,64,63,1,1,"PIRATA",1
31,"31200",763,527,514,17,13,"PIRATA",5
44,"44228",121,97,96,2,1,"PIRATA",2
44,"44148",98,77,77,3,0,"PIRATA",0
22,"22155",89,67,67,2,0,"PIRATA",0
12,"12139",344,219,216,0,3,"PIRATA",1
31,"31239",302,229,224,7,5,"PIRATA",0
12,"12113",100,72,72,0,0,"PIRATA",0
22,"22189",199,140,138,5,2,"PIRATA",1
31,"31253",123,102,97,0,5,"PIRATA",1
22,"22903",672,555,547,6,8,"PIRATA",0
44,"44135",149,110,109,1,1,"PIRATA",0
22,"22002",107,85,84,3,1,"PIRATA",2
31,"31141",132,100,98,1,2,"PIRATA",1
22,"22075",150,103,101,7,2,"PIRATA",0
44,"44048",77,59,59,0,0,"PIRATA",1
44,"44077",80,62,62,1,0,"PIRATA",0
12,"12029",760,619,601,7,18,"PIRATA",3
31,"31124",209,139,138,1,1,"PIRATA",0
12,"12096",854,663,653,17,10,"PIRATA",0
44,"44122",1441,1009,990,21,19,"PIRATA",1
44,"44003",19,19,19,0,0,"PIRATA",0
44,"44023",13,11,11,0,0,"PIRATA",0
22,"22064",184,139,137,3,2,"PIRATA",0
44,"44063",82,55,55,2,0,"PIRATA",0
44,"44230",154,127,127,3,0,"PIRATA",1
44,"44239",29,25,25,1,0,"PIRATA",0
31,"31220",771,584,572,9,12,"PIRATA",2
31,"31004",36,21,20,0,1,"PIRATA",0
44,"44007",194,152,145,3,7,"PIRATA",0
31,"31231",127,93,91,1,2,"PIRATA",0
22,"22027",351,251,250,8,1,"PIRATA",1
44,"44152",62,50,50,3,0,"PIRATA",0
31,"31061",67,47,47,2,0,"PIRATA",1
44,"44038",112,94,92,3,2,"PIRATA",0
31,"31111",100,75,75,1,0,"PIRATA",1
12,"12091",203,153,140,2,13,"PIRATA",0
12,"12011",4663,3578,3525,28,53,"PIRATA",3
31,"31153",2246,1504,1487,13,17,"PIRATA",3
44,"44206",156,119,117,3,2,"PIRATA",1
31,"31235",189,111,110,0,1,"PIRATA",0
31,"31062",1103,849,832,7,17,"PIRATA",9
22,"22165",515,409,403,9,6,"PIRATA",3
22,"22019",190,141,138,4,3,"PIRATA",2
22,"22124",229,171,170,2,1,"PIRATA",0
22,"22197",504,395,390,7,5,"PIRATA",1
22,"22227",225,172,168,3,4,"PIRATA",0
12,"12032",23406,16895,16721,227,174,"PIRATA",51
12,"12048",293,208,205,2,3,"PIRATA",1
22,"22037",115,87,79,0,8,"PIRATA",0
44,"44027",168,140,140,2,0,"PIRATA",0
12,"12016",1589,1309,1293,15,16,"PIRATA",0
44,"44181",82,63,63,3,0,"PIRATA",0
12,"12116",56,45,45,0,0,"PIRATA",0
31,"31063",96,77,75,0,2,"PIRATA",0
31,"31175",78,55,54,0,1,"PIRATA",0
22,"22202",146,120,120,1,0,"PIRATA",0
12,"12071",1355,1069,1050,3,19,"PIRATA",3
22,"22245",329,261,257,3,4,"PIRATA",1
31,"31030",155,113,112,3,1,"PIRATA",0
31,"31003",131,101,101,1,0,"PIRATA",0
22,"22057",377,283,278,3,5,"PIRATA",1
44,"44209",892,666,649,6,17,"PIRATA",0
31,"31230",118,88,85,1,3,"PIRATA",1
31,"31094",123,100,97,3,3,"PIRATA",0
44,"44168",194,154,152,4,2,"PIRATA",0
31,"31185",541,377,374,2,3,"PIRATA",1
44,"44127",79,62,61,0,1,"PIRATA",1
44,"44213",60,48,48,0,0,"PIRATA",0
44,"44042",139,87,87,0,0,"PIRATA",0
31,"31216",3911,2699,2653,82,46,"PIRATA",7
31,"31065",1927,1391,1362,39,29,"PIRATA",3
31,"31024",116,56,56,2,0,"PIRATA",0
31,"31166",274,183,182,2,1,"PIRATA",1
44,"44236",77,48,47,0,1,"PIRATA",0
31,"31145",173,129,127,2,2,"PIRATA",0
44,"44011",67,47,47,0,0,"PIRATA",1
22,"22164",46,32,32,0,0,"PIRATA",0
44,"44267",79,63,61,2,2,"PIRATA",0
44,"44198",205,160,160,5,0,"PIRATA",2
44,"44116",96,68,65,3,3,"PIRATA",0
12,"12053",2121,1745,1719,11,26,"PIRATA",0
22,"22041",175,138,138,1,0,"PIRATA",0
44,"44223",80,55,55,0,0,"PIRATA",0
22,"22172",613,463,452,6,11,"PIRATA",0
31,"31096",127,112,110,2,2,"PIRATA",1
31,"31249",1926,1376,1361,30,15,"PIRATA",2
12,"12059",276,227,227,1,0,"PIRATA",1
31,"31053",595,430,418,6,12,"PIRATA",3
31,"31904",1590,1054,1031,19,23,"PIRATA",3
44,"44237",450,352,343,5,9,"PIRATA",0
44,"44258",75,56,55,0,1,"PIRATA",0
31,"31140",117,91,89,3,2,"PIRATA",1
31,"31192",148,107,104,1,3,"PIRATA",3
44,"44184",34,21,21,2,0,"PIRATA",0
22,"22042",115,93,91,1,2,"PIRATA",1
12,"12068",57,45,44,0,1,"PIRATA",0
44,"44234",76,63,63,0,0,"PIRATA",0
31,"31247",171,121,121,1,0,"PIRATA",1
22,"22162",135,107,107,3,0,"PIRATA",1
44,"44096",173,139,133,4,6,"PIRATA",0
31,"31040",197,137,135,2,2,"PIRATA",0
44,"44074",435,344,337,5,7,"PIRATA",1
31,"31043",42,30,30,1,0,"PIRATA",0
22,"22254",1175,868,856,14,12,"PIRATA",2
44,"44159",47,43,43,0,0,"PIRATA",0
31,"31067",1982,1400,1363,28,37,"PIRATA",6
31,"31118",182,114,114,6,0,"PIRATA",0
31,"31155",264,187,183,7,4,"PIRATA",0
44,"44257",184,132,131,6,1,"PIRATA",0
44,"44092",89,68,68,0,0,"PIRATA",0
44,"44046",58,44,44,1,0,"PIRATA",0
31,"31017",358,220,219,12,1,"PIRATA",0
44,"44147",439,320,314,14,6,"PIRATA",3
44,"44187",224,170,163,2,7,"PIRATA",0
22,"22137",1164,850,839,14,11,"PIRATA",3
44,"44008",1695,1280,1257,11,23,"PIRATA",1
22,"22175",211,158,158,9,0,"PIRATA",1
31,"31210",219,169,167,3,2,"PIRATA",0
31,"31018",422,303,299,8,4,"PIRATA",1
12,"12122",835,674,658,14,16,"PIRATA",0
31,"31907",9914,7394,7282,198,112,"PIRATA",60
22,"22209",161,115,115,4,0,"PIRATA",0
31,"31180",240,174,170,5,4,"PIRATA",0
31,"31150",234,163,162,5,1,"PIRATA",0
44,"44076",2338,1839,1797,36,42,"PIRATA",1
31,"31908",997,692,683,9,9,"PIRATA",11
31,"31187",122,68,68,2,0,"PIRATA",0
22,"22067",82,54,49,3,5,"PIRATA",0
31,"31191",2930,2194,2148,43,46,"PIRATA",9
44,"44149",106,79,78,2,1,"PIRATA",1
44,"44207",187,147,146,5,1,"PIRATA",0
44,"44247",335,251,243,10,8,"PIRATA",0
44,"44040",206,167,166,5,1,"PIRATA",0
12,"12112",104,90,90,0,0,"PIRATA",0
44,"44110",57,45,45,0,0,"PIRATA",0
12,"12092",143,98,98,0,0,"PIRATA",0
12,"12003",1058,830,813,15,17,"PIRATA",6
44,"44261",777,600,594,8,6,"PIRATA",0
12,"12106",1207,992,969,7,23,"PIRATA",2
12,"12006",185,160,153,0,7,"PIRATA",2
31,"31186",299,205,200,3,5,"PIRATA",0
12,"12060",467,367,353,2,14,"PIRATA",1
22,"22119",1433,994,981,14,13,"PIRATA",2
44,"44235",103,71,68,0,3,"PIRATA",1
12,"12064",118,91,89,1,2,"PIRATA",0
12,"12025",146,106,105,0,1,"PIRATA",0
44,"44164",32,25,25,0,0,"PIRATA",0
22,"22025",1104,790,767,27,23,"PIRATA",4
12,"12094",807,612,604,14,8,"PIRATA",4
22,"22090",115,82,82,5,0,"PIRATA",0
31,"31052",89,62,58,1,4,"PIRATA",1
12,"12027",16914,11657,11452,188,205,"PIRATA",44
31,"31102",162,80,78,0,2,"PIRATA",0
22,"22127",483,357,353,9,4,"PIRATA",1
22,"22077",421,327,323,14,4,"PIRATA",2
31,"31031",234,144,143,1,1,"PIRATA",0
12,"12104",6981,5464,5357,54,107,"PIRATA",13
22,"22018",357,272,271,4,1,"PIRATA",0
44,"44205",757,541,527,12,14,"PIRATA",1
12,"12073",168,135,135,1,0,"PIRATA",1
12,"12135",35189,25691,25345,380,346,"PIRATA",92
22,"22111",180,126,125,3,1,"PIRATA",0
31,"31214",95,64,64,1,0,"PIRATA",0
31,"31042",2719,2100,2057,27,43,"PIRATA",1
22,"22906",190,152,147,3,5,"PIRATA",2
22,"22094",109,76,74,5,2,"PIRATA",0
31,"31089",246,198,195,4,3,"PIRATA",0
31,"31099",68,50,50,0,0,"PIRATA",0
22,"22006",319,203,197,5,6,"PIRATA",0
22,"22050",100,84,83,0,1,"PIRATA",0
22,"22177",101,79,75,1,4,"PIRATA",0
12,"12123",70,50,48,2,2,"PIRATA",0
31,"31069",860,660,647,2,13,"PIRATA",3
22,"22217",406,314,309,4,5,"PIRATA",0
44,"44180",71,52,52,1,0,"PIRATA",0
44,"44141",147,99,95,0,4,"PIRATA",1
12,"12063",59,42,41,0,1,"PIRATA",0
31,"31174",115,72,70,1,2,"PIRATA",1
44,"44199",52,40,39,0,1,"PIRATA",0
12,"12093",254,190,187,0,3,"PIRATA",1
31,"31202",4247,3014,2957,69,57,"PIRATA",6
44,"44002",62,47,47,1,0,"PIRATA",0
22,"22141",129,103,102,3,1,"PIRATA",2
44,"44200",41,30,30,0,0,"PIRATA",0
12,"12021",4433,3368,3292,42,76,"PIRATA",6
22,"22080",288,217,217,4,0,"PIRATA",1
22,"22114",137,94,94,4,0,"PIRATA",0
31,"31125",269,172,169,6,3,"PIRATA",5
12,"12117",3674,2846,2794,25,52,"PIRATA",8
44,"44128",84,56,56,3,0,"PIRATA",0
31,"31075",96,61,61,0,0,"PIRATA",0
44,"44266",134,107,105,2,2,"PIRATA",0
12,"12041",115,98,98,2,0,"PIRATA",0
31,"31084",1949,1369,1361,11,8,"PIRATA",5
31,"31085",451,334,327,3,7,"PIRATA",1
22,"22009",704,488,473,15,15,"PIRATA",1
31,"31217",382,256,244,5,12,"PIRATA",1
31,"31197",69,58,57,1,1,"PIRATA",0
22,"22082",320,231,229,1,2,"PIRATA",0
44,"44055",85,63,62,2,1,"PIRATA",0
22,"22236",266,213,213,3,0,"PIRATA",0
44,"44156",57,40,38,1,2,"PIRATA",0
12,"12118",83,63,62,0,1,"PIRATA",0
12,"12087",22,20,20,0,0,"PIRATA",0
44,"44070",62,47,47,1,0,"PIRATA",0
12,"12080",2051,1692,1650,23,42,"PIRATA",5
44,"44005",59,43,43,1,0,"PIRATA",0
12,"12043",620,499,487,2,12,"PIRATA",1
22,"22083",522,437,428,4,9,"PIRATA",0
22,"22012",93,74,74,5,0,"PIRATA",0
12,"12084",17219,12059,11911,165,148,"PIRATA",53
22,"22232",98,78,75,0,3,"PIRATA",0
31,"31133",48,34,34,3,0,"PIRATA",0
22,"22107",131,81,77,1,4,"PIRATA",0
44,"44224",26,15,15,0,0,"PIRATA",0
31,"31019",1858,1288,1266,25,22,"PIRATA",8
44,"44056",577,436,434,7,2,"PIRATA",1
31,"31087",163,122,121,3,1,"PIRATA",0
31,"31181",168,121,119,3,2,"PIRATA",0
22,"22016",654,476,464,10,12,"PIRATA",3
31,"31257",827,598,585,16,13,"PIRATA",6
22,"22125",38140,26924,26463,676,461,"PIRATA",75
31,"31227",8257,5987,5884,125,103,"PIRATA",31
22,"22908",231,167,162,2,5,"PIRATA",1
12,"12017",183,143,141,6,2,"PIRATA",1
31,"31047",283,208,204,3,4,"PIRATA",1
31,"31138",939,648,646,14,2,"PIRATA",1
31,"31128",406,261,261,4,0,"PIRATA",0
12,"12120",218,180,177,0,3,"PIRATA",1
31,"31251",3147,2274,2225,39,49,"PIRATA",14
22,"22225",2784,1839,1805,42,34,"PIRATA",8
31,"31159",1158,864,846,17,18,"PIRATA",7
44,"44020",23,15,15,0,0,"PIRATA",0
22,"22193",318,266,264,7,2,"PIRATA",1
22,"22242",75,53,52,0,1,"PIRATA",1
12,"12034",1509,1125,1097,10,28,"PIRATA",3
44,"44189",69,57,57,0,0,"PIRATA",0
22,"22158",11978,8404,8279,149,125,"PIRATA",27
44,"44160",473,315,312,8,3,"PIRATA",0
12,"12101",385,309,296,3,13,"PIRATA",0
12,"12001",1098,821,817,8,4,"PIRATA",1
31,"31242",235,157,157,2,0,"PIRATA",1
44,"44175",138,111,111,4,0,"PIRATA",1
22,"22028",424,311,310,3,1,"PIRATA",1
44,"44009",805,608,595,18,13,"PIRATA",1
31,"31184",66,60,59,0,1,"PIRATA",1
12,"12142",158,122,121,1,1,"PIRATA",1
12,"12070",576,473,463,5,10,"PIRATA",1
12,"12036",668,529,514,6,15,"PIRATA",6
44,"44061",89,55,55,1,0,"PIRATA",0
31,"31059",204,140,139,3,1,"PIRATA",0
44,"44062",38,34,34,0,0,"PIRATA",0
31,"31049",733,479,479,4,0,"PIRATA",1
44,"44167",41,31,31,1,0,"PIRATA",0
44,"44190",81,52,52,0,0,"PIRATA",0
12,"12105",866,679,673,6,6,"PIRATA",0
31,"31110",97,53,53,3,0,"PIRATA",0
12,"12081",654,519,515,2,4,"PIRATA",1
44,"44036",27,17,17,0,0,"PIRATA",0
31,"31205",465,335,325,9,10,"PIRATA",0
31,"31171",738,521,495,7,26,"PIRATA",1
44,"44126",344,250,236,1,14,"PIRATA",2
22,"22207",135,86,79,4,7,"PIRATA",0
44,"44158",1159,904,873,15,31,"PIRATA",1
31,"31240",553,360,359,3,1,"PIRATA",1
44,"44249",58,40,40,1,0,"PIRATA",2
44,"44119",119,84,84,2,0,"PIRATA",0
22,"22178",107,92,92,1,0,"PIRATA",1
22,"22110",822,602,588,3,14,"PIRATA",2
44,"44231",54,38,36,2,2,"PIRATA",0
22,"22004",146,97,97,2,0,"PIRATA",0
22,"22078",468,302,301,8,1,"PIRATA",4
12,"12115",234,184,183,2,1,"PIRATA",0
22,"22247",31,21,20,1,1,"PIRATA",0
22,"22089",329,246,237,8,9,"PIRATA",0
22,"22200",271,198,191,3,7,"PIRATA",0
31,"31020",488,247,246,0,1,"PIRATA",2
12,"12004",4354,3145,3083,50,62,"PIRATA",5
31,"31095",83,70,70,1,0,"PIRATA",0
31,"31213",114,58,58,0,0,"PIRATA",4
12,"12008",236,203,199,4,4,"PIRATA",0
31,"31146",46,34,34,1,0,"PIRATA",0
22,"22036",101,82,82,1,0,"PIRATA",0
12,"12015",96,83,82,3,1,"PIRATA",0
31,"31901",15574,11165,10974,201,191,"PIRATA",75
22,"22023",474,382,380,4,2,"PIRATA",0
12,"12074",783,679,676,3,3,"PIRATA",0
31,"31083",50,37,37,0,0,"PIRATA",0
31,"31113",147,87,85,2,2,"PIRATA",0
31,"31163",2008,1458,1434,22,24,"PIRATA",16
44,"44113",79,57,55,0,2,"PIRATA",0
44,"44232",408,301,295,5,6,"PIRATA",0
12,"12028",12115,9084,8992,137,92,"PIRATA",38
31,"31079",99,64,63,0,1,"PIRATA",0
44,"44176",167,131,130,5,1,"PIRATA",2
31,"31039",94,65,61,0,4,"PIRATA",0
12,"12002",135,101,100,1,1,"PIRATA",1
31,"31029",987,693,680,16,13,"PIRATA",1
22,"22244",61,46,44,1,2,"PIRATA",0
12,"12009",17124,12273,12098,150,175,"PIRATA",41
44,"44157",62,45,44,0,1,"PIRATA",0
44,"44033",307,222,221,5,1,"PIRATA",0
12,"12119",153,87,87,0,0,"PIRATA",0
12,"12110",253,199,195,3,4,"PIRATA",0
12,"12085",4941,3183,3125,32,58,"PIRATA",11
31,"31027",824,611,609,2,2,"PIRATA",2
22,"22130",9983,6691,6573,148,118,"PIRATA",8
22,"22113",512,357,353,8,4,"PIRATA",0
31,"31199",161,103,103,1,0,"PIRATA",1
31,"31260",1263,788,780,11,8,"PIRATA",3
44,"44182",216,173,173,4,0,"PIRATA",0
22,"22251",391,288,278,4,10,"PIRATA",0
44,"44155",1162,819,801,24,18,"PIRATA",1
31,"31258",7679,5561,5475,92,86,"PIRATA",43
44,"44143",382,292,292,5,0,"PIRATA",0
22,"22052",997,776,769,15,7,"PIRATA",4
12,"12098",665,552,539,9,13,"PIRATA",0
31,"31115",171,112,109,2,3,"PIRATA",0
22,"22014",265,192,191,1,1,"PIRATA",1
31,"31207",280,198,195,7,3,"PIRATA",1
12,"12132",524,407,401,4,6,"PIRATA",0
31,"31078",2502,1880,1852,33,28,"PIRATA",6
44,"44183",78,49,46,0,3,"PIRATA",0
31,"31135",116,87,86,9,1,"PIRATA",1
12,"12058",99,74,74,0,0,"PIRATA",1
22,"22001",242,177,173,2,4,"PIRATA",1
31,"31194",308,212,210,6,2,"PIRATA",0
44,"44133",21,16,16,0,0,"PIRATA",0
44,"44043",126,94,94,7,0,"PIRATA",0
44,"44089",57,50,49,0,1,"PIRATA",0
12,"12099",583,485,465,3,20,"PIRATA",1
12,"12005",8066,5835,5441,116,394,"PIRATA",20
22,"22058",194,138,137,5,1,"PIRATA",1
22,"22248",119,94,92,3,2,"PIRATA",0
22,"22144",258,203,203,5,0,"PIRATA",0
31,"31123",652,379,373,8,6,"PIRATA",1
44,"44229",150,108,107,5,1,"PIRATA",2
44,"44194",128,92,89,1,3,"PIRATA",1
31,"31256",113,64,64,0,0,"PIRATA",0
44,"44191",806,602,594,6,8,"PIRATA",3
31,"31212",173,117,117,3,0,"PIRATA",0
12,"12133",64,47,47,0,0,"PIRATA",0
31,"31026",154,125,122,1,3,"PIRATA",0
31,"31056",183,123,122,4,1,"PIRATA",0
31,"31006",1988,1434,1395,22,39,"PIRATA",1
44,"44053",111,77,76,2,1,"PIRATA",0
22,"22208",168,136,133,2,3,"PIRATA",2
44,"44131",26,20,20,0,0,"PIRATA",0
44,"44222",136,99,99,2,0,"PIRATA",0
31,"31081",335,249,243,8,6,"PIRATA",1
12,"12045",388,301,286,2,15,"PIRATA",0
44,"44256",37,35,35,9,0,"PIRATA",0
22,"22143",244,166,161,2,5,"PIRATA",0
44,"44060",42,34,34,0,0,"PIRATA",0
31,"31169",2285,1621,1590,43,31,"PIRATA",2
44,"44245",274,189,184,1,5,"PIRATA",0
12,"12057",650,530,515,6,15,"PIRATA",2
44,"44132",64,57,56,0,1,"PIRATA",0
22,"22099",532,411,408,6,3,"PIRATA",1
44,"44201",526,449,443,9,6,"PIRATA",0
22,"22221",108,70,69,5,1,"PIRATA",1
22,"22909",349,259,252,3,7,"PIRATA",2
44,"44120",217,126,121,5,5,"PIRATA",0
31,"31028",217,129,128,1,1,"PIRATA",4
31,"31173",881,754,733,12,21,"PIRATA",1
44,"44124",88,63,61,3,2,"PIRATA",0
22,"22081",268,197,196,4,1,"PIRATA",3
22,"22049",88,70,69,5,1,"PIRATA",0
22,"22176",173,154,149,2,5,"PIRATA",0
22,"22015",336,237,235,11,2,"PIRATA",1
44,"44013",11286,7797,7584,242,213,"PIRATA",16
44,"44251",271,218,218,5,0,"PIRATA",0
44,"44153",1882,1273,1246,10,27,"PIRATA",3
31,"31262",219,158,157,4,1,"PIRATA",1
31,"31143",105,62,58,2,4,"PIRATA",0
44,"44066",121,88,86,0,2,"PIRATA",0
31,"31022",544,378,369,1,9,"PIRATA",0
44,"44026",89,69,69,0,0,"PIRATA",0
31,"31131",841,610,594,12,16,"PIRATA",3
22,"22087",85,56,55,4,1,"PIRATA",0
44,"44163",119,91,91,0,0,"PIRATA",0
31,"31137",215,108,106,1,2,"PIRATA",0
12,"12102",547,474,466,2,8,"PIRATA",0
12,"12109",700,564,555,7,9,"PIRATA",3
44,"44173",107,87,77,5,10,"PIRATA",0
31,"31148",99,69,66,2,3,"PIRATA",1
12,"12075",139,106,102,0,4,"PIRATA",2
44,"44226",163,112,112,3,0,"PIRATA",0
44,"44146",185,160,159,8,1,"PIRATA",0
31,"31158",264,174,173,1,1,"PIRATA",1
31,"31071",17,15,15,0,0,"PIRATA",0
31,"31044",276,224,223,0,1,"PIRATA",0
22,"22170",622,439,430,13,9,"PIRATA",2
31,"31142",1443,906,899,16,7,"PIRATA",1
31,"31041",1397,938,913,26,25,"PIRATA",11
31,"31176",2777,1999,1955,57,44,"PIRATA",11
31,"31122",4506,3333,3281,76,52,"PIRATA",15
12,"12128",1448,1114,1092,16,22,"PIRATA",7
31,"31088",5358,3655,3592,97,63,"PIRATA",35
31,"31034",43,29,29,0,0,"PIRATA",0
44,"44142",39,28,28,1,0,"PIRATA",0
31,"31058",240,184,179,0,5,"PIRATA",0
44,"44088",32,31,31,1,0,"PIRATA",0
44,"44193",99,71,67,0,4,"PIRATA",0
44,"44010",189,138,138,2,0,"PIRATA",1
22,"22226",823,640,627,11,13,"PIRATA",0
12,"12044",527,472,463,4,9,"PIRATA",0
31,"31021",75,52,52,0,0,"PIRATA",0
31,"31012",839,577,570,10,7,"PIRATA",3
31,"31072",5098,3764,3698,75,66,"PIRATA",7
44,"44171",186,127,124,3,3,"PIRATA",2
44,"44246",1591,1030,997,15,33,"PIRATA",2
22,"22182",271,160,150,4,10,"PIRATA",1
31,"31103",51,40,40,3,0,"PIRATA",0
31,"31236",1333,887,874,15,13,"PIRATA",4
22,"22079",126,97,97,4,0,"PIRATA",0
12,"12051",520,382,376,1,6,"PIRATA",0
31,"31035",60,47,47,0,0,"PIRATA",0
12,"12052",627,510,491,9,19,"PIRATA",2
44,"44064",93,63,62,0,1,"PIRATA",1
22,"22022",582,448,438,12,10,"PIRATA",4
44,"44243",38,27,26,3,1,"PIRATA",0
31,"31261",271,202,201,4,1,"PIRATA",2
44,"44016",541,384,379,5,5,"PIRATA",1
12,"12014",191,139,137,4,2,"PIRATA",0
31,"31134",195,134,132,3,2,"PIRATA",0
31,"31189",1229,745,740,5,5,"PIRATA",2
31,"31013",668,382,375,12,7,"PIRATA",1
22,"22055",347,291,289,5,2,"PIRATA",0
12,"12033",1970,1547,1509,8,38,"PIRATA",1
44,"44220",137,97,96,1,1,"PIRATA",0
22,"22106",25,17,17,0,0,"PIRATA",0
31,"31162",53,35,34,1,1,"PIRATA",0
31,"31172",375,295,288,11,7,"PIRATA",2
44,"44068",690,544,528,6,16,"PIRATA",1
31,"31082",634,402,398,10,4,"PIRATA",0
44,"44129",44,34,33,0,1,"PIRATA",0
22,"22201",287,203,198,2,5,"PIRATA",0
31,"31206",2079,1517,1475,33,42,"PIRATA",6
44,"44075",329,250,240,4,10,"PIRATA",0
22,"22096",301,239,237,8,2,"PIRATA",1
12,"12138",18762,12489,12231,243,258,"PIRATA",38
31,"31179",558,384,384,3,0,"PIRATA",2
22,"22013",304,239,236,3,3,"PIRATA",1
22,"22190",120,76,73,4,3,"PIRATA",0
44,"44103",128,95,95,0,0,"PIRATA",0
31,"31014",280,197,196,2,1,"PIRATA",0
44,"44112",473,353,350,4,3,"PIRATA",0
22,"22174",520,401,394,11,7,"PIRATA",0
31,"31234",148,107,105,6,2,"PIRATA",2
31,"31254",1956,1495,1476,16,19,"PIRATA",3
31,"31011",688,437,432,17,5,"PIRATA",4
44,"44263",332,249,243,10,6,"PIRATA",0
44,"44125",78,57,57,1,0,"PIRATA",0
44,"44100",200,147,146,0,1,"PIRATA",3
44,"44099",724,519,511,4,8,"PIRATA",0
31,"31126",372,247,244,6,3,"PIRATA",2
44,"44017",316,232,229,1,3,"PIRATA",1
31,"31077",5349,4025,3917,103,108,"PIRATA",13
22,"22043",112,72,71,2,1,"PIRATA",1
22,"22008",194,168,167,11,1,"PIRATA",1
31,"31248",318,190,187,2,3,"PIRATA",3
22,"22035",261,179,176,3,3,"PIRATA",0
12,"12095",1027,790,775,15,15,"PIRATA",0
22,"22204",1122,773,756,19,17,"PIRATA",4
12,"12130",425,348,344,2,4,"PIRATA",0
12,"12079",450,360,353,3,7,"PIRATA",0
22,"22117",2585,1880,1848,57,32,"PIRATA",8
31,"31033",55,34,34,0,0,"PIRATA",0
22,"22103",697,532,523,10,9,"PIRATA",2
31,"31104",1990,1374,1355,20,19,"PIRATA",0
44,"44034",150,117,117,1,0,"PIRATA",1
44,"44144",326,233,227,7,6,"PIRATA",0
31,"31906",2493,1796,1770,57,26,"PIRATA",19
31,"31037",94,68,68,0,0,"PIRATA",2
44,"44262",141,114,113,2,1,"PIRATA",0
22,"22021",2080,1524,1505,31,19,"PIRATA",6
31,"31204",45,35,34,0,1,"PIRATA",0
31,"31051",270,182,181,8,1,"PIRATA",1
44,"44054",125,97,97,2,0,"PIRATA",1
22,"22048",12485,9146,9028,237,118,"PIRATA",32
44,"44097",158,97,95,1,2,"PIRATA",1
44,"44136",51,39,39,0,0,"PIRATA",0
31,"31241",164,117,116,4,1,"PIRATA",0
31,"31250",2887,1827,1802,20,25,"PIRATA",8
44,"44045",373,303,301,4,2,"PIRATA",2
31,"31905",2707,1913,1881,32,32,"PIRATA",15
22,"22235",101,88,87,1,1,"PIRATA",0
22,"22069",436,317,315,5,2,"PIRATA",1
22,"22040",155,129,127,3,2,"PIRATA",0
31,"31238",125,99,98,3,1,"PIRATA",0
31,"31265",81,52,50,0,2,"PIRATA",0
31,"31165",2868,2094,2046,43,48,"PIRATA",4
22,"22062",189,126,125,2,1,"PIRATA",0
44,"44051",2783,2144,2089,38,55,"PIRATA",5
31,"31057",1863,1450,1409,32,41,"PIRATA",6
44,"44101",60,47,47,1,0,"PIRATA",0
12,"12077",4683,3476,3414,41,62,"PIRATA",8
12,"12108",495,394,389,4,5,"PIRATA",0
31,"31228",540,376,364,13,12,"PIRATA",4
22,"22253",71,54,54,1,0,"PIRATA",0
31,"31045",501,384,377,16,7,"PIRATA",4
31,"31036",957,631,616,22,15,"PIRATA",5
31,"31225",40,32,32,0,0,"PIRATA",0
44,"44012",389,297,293,5,4,"PIRATA",1
44,"44151",215,143,140,1,3,"PIRATA",2
31,"31074",430,304,303,10,1,"PIRATA",2
31,"31215",4618,3384,3315,54,69,"PIRATA",9
31,"31193",1312,969,948,33,21,"PIRATA",5
44,"44218",37,26,26,2,0,"PIRATA",0
12,"12141",116,97,97,0,0,"PIRATA",0
44,"44006",293,220,212,3,8,"PIRATA",0
44,"44264",249,196,193,1,3,"PIRATA",0
12,"12100",1380,1124,1109,11,15,"PIRATA",3
44,"44174",435,310,309,3,1,"PIRATA",0
12,"12056",304,259,254,7,5,"PIRATA",0
12,"12010",280,232,229,3,3,"PIRATA",0
12,"12061",431,324,316,6,8,"PIRATA",1
22,"22039",920,721,710,12,11,"PIRATA",1
22,"22181",91,57,55,0,2,"PIRATA",1
31,"31224",980,691,681,9,10,"PIRATA",1
31,"31903",6058,3985,3919,67,66,"PIRATA",32
31,"31168",247,165,163,0,2,"PIRATA",0
31,"31203",30,25,25,0,0,"PIRATA",0
44,"44130",38,27,27,0,0,"PIRATA",0
31,"31196",40,35,35,1,0,"PIRATA",0
22,"22234",818,609,605,12,4,"PIRATA",1
44,"44185",117,91,90,0,1,"PIRATA",0
22,"22187",295,222,222,3,0,"PIRATA",0
22,"22126",100,81,80,2,1,"PIRATA",0
22,"22051",108,86,84,2,2,"PIRATA",0
31,"31054",498,310,308,1,2,"PIRATA",1
44,"44028",202,159,156,2,3,"PIRATA",0
44,"44065",60,40,40,0,0,"PIRATA",0
31,"31097",10461,7152,7029,129,123,"PIRATA",36
12,"12026",946,728,702,16,26,"PIRATA",0
44,"44049",886,652,627,6,25,"PIRATA",0
12,"12902",2056,1454,1411,14,43,"PIRATA",8
12,"12083",106,89,88,0,1,"PIRATA",0
22,"22173",247,150,150,3,0,"PIRATA",1
12,"12114",228,178,173,2,5,"PIRATA",0
44,"44050",3183,2208,2154,78,54,"PIRATA",8
31,"31101",1305,892,874,15,18,"PIRATA",4
44,"44178",69,45,44,0,1,"PIRATA",0
22,"22076",331,241,235,3,6,"PIRATA",0
22,"22223",92,65,64,3,1,"PIRATA",0
22,"22229",127,93,89,4,4,"PIRATA",1
44,"44179",369,245,243,6,2,"PIRATA",0
22,"22003",148,117,116,2,1,"PIRATA",0
22,"22150",491,342,336,9,6,"PIRATA",2
44,"44059",571,446,434,10,12,"PIRATA",0
44,"44090",84,71,71,0,0,"PIRATA",0
1,"1001",2010,1362,1336,26,26,"P.P.",262
5,"5231",172,142,141,0,1,"P.P.",83
4,"4033",161,120,119,1,1,"P.P.",52
29,"29100",2442,1834,1824,14,10,"P.P.",628
49,"49015",259,213,208,2,5,"P.P.",136
12,"12010",280,232,229,3,3,"P.P.",111
34,"34056",2147,1557,1535,21,22,"P.P.",927
9,"9024",159,124,123,2,1,"P.P.",90
34,"34057",483,365,357,2,8,"P.P.",224
26,"26042",852,660,651,11,9,"P.P.",329
49,"49016",272,216,211,1,5,"P.P.",132
37,"37052",274,213,212,1,1,"P.P.",116
1,"1002",8057,5854,5757,48,97,"P.P.",784
40,"40182",207,155,155,6,0,"P.P.",88
46,"46149",398,307,305,1,2,"P.P.",202
49,"49017",264,189,187,1,2,"P.P.",139
14,"14056",23507,17245,17071,259,174,"P.P.",6598
45,"45101",3761,3212,3181,19,31,"P.P.",2088
4,"4035",8213,6218,6171,51,47,"P.P.",3495
16,"16215",285,192,186,2,6,"P.P.",78
40,"40183",148,127,127,0,0,"P.P.",120
37,"37054",273,230,229,2,1,"P.P.",120
34,"34058",212,179,178,0,1,"P.P.",106
23,"23005",30698,23126,22916,310,210,"P.P.",11551
14,"14057",6115,5040,4975,71,65,"P.P.",1755
23,"23006",4644,3913,3871,36,42,"P.P.",1223
1,"1003",1199,863,848,2,15,"P.P.",17
38,"38016",1250,664,646,3,18,"P.P.",266
49,"49018",341,281,279,5,2,"P.P.",165
19,"19082",91,68,67,1,1,"P.P.",30
29,"29902",2577,1689,1665,20,24,"P.P.",562
12,"12012",2747,2196,2135,24,61,"P.P.",1035
40,"40184",269,227,224,4,3,"P.P.",171
34,"34059",462,377,375,5,2,"P.P.",204
40,"40185",977,725,712,13,13,"P.P.",445
49,"49019",256,206,205,5,1,"P.P.",128
4,"4037",1393,1090,1079,8,11,"P.P.",436
37,"37056",56,47,47,0,0,"P.P.",33
38,"38017",24438,13769,13576,176,193,"P.P.",6247
1,"1004",1427,1021,996,15,25,"P.P.",200
34,"34189",59,47,47,3,0,"P.P.",33
23,"23007",3116,2483,2458,15,25,"P.P.",807
45,"45103",457,400,394,0,6,"P.P.",225
34,"34060",150,123,123,2,0,"P.P.",79
12,"12013",180,131,130,0,1,"P.P.",65
49,"49020",323,275,272,1,3,"P.P.",150
23,"23008",1552,1280,1266,9,14,"P.P.",413
24,"24030",4397,3272,3229,54,43,"P.P.",1590
38,"38018",4397,3216,3163,27,53,"P.P.",1385
1,"1006",181,133,127,2,6,"P.P.",63
45,"45104",457,375,370,2,5,"P.P.",147
38,"38019",12624,8174,8099,65,75,"P.P.",3463
49,"49021",14682,10495,10296,194,199,"P.P.",5418
40,"40188",120,82,81,0,1,"P.P.",56
23,"23009",12876,10335,10231,109,104,"P.P.",5163
45,"45105",426,326,322,2,4,"P.P.",202
1,"1008",781,566,546,7,20,"P.P.",141
34,"34061",116,78,78,2,0,"P.P.",71
15,"15070",9684,6627,6464,141,163,"P.P.",2306
18,"18087",187449,138136,136783,1548,1353,"P.P.",74656
49,"49155",105,85,85,0,0,"P.P.",66
9,"9029",186,138,137,4,1,"P.P.",69
4,"4041",334,247,245,0,2,"P.P.",140
19,"19087",22,16,16,0,0,"P.P.",10
34,"34062",175,126,124,3,2,"P.P.",93
12,"12015",96,83,82,3,1,"P.P.",39
1,"1009",1296,876,863,9,13,"P.P.",81
49,"49022",319,266,261,3,5,"P.P.",122
45,"45106",7666,6045,5945,92,100,"P.P.",2987
40,"40189",560,455,438,6,17,"P.P.",206
47,"47094",154,129,127,0,2,"P.P.",77
9,"9160",104,75,74,0,1,"P.P.",52
23,"23011",2227,1644,1620,25,24,"P.P.",562
1,"1010",2276,1649,1618,27,31,"P.P.",248
49,"49023",1033,736,728,10,8,"P.P.",500
37,"37060",229,179,173,2,6,"P.P.",101
40,"40190",50,41,40,1,1,"P.P.",29
4,"4043",520,439,435,3,4,"P.P.",243
12,"12016",1589,1309,1293,15,16,"P.P.",749
40,"40191",265,191,190,1,1,"P.P.",137
34,"34063",102,92,91,2,1,"P.P.",49
16,"16225",89,69,68,1,1,"P.P.",48
49,"49024",736,551,544,16,7,"P.P.",322
5,"5237",198,157,155,3,2,"P.P.",131
23,"23012",4250,3235,3216,19,19,"P.P.",1351
1,"1011",245,189,185,7,4,"P.P.",89
19,"19089",33,22,22,1,0,"P.P.",8
4,"4044",1517,1232,1224,8,8,"P.P.",706
49,"49158",229,174,172,0,2,"P.P.",85
34,"34066",66,55,54,0,1,"P.P.",44
23,"23014",2529,2058,2039,13,19,"P.P.",775
9,"9033",104,82,80,1,2,"P.P.",56
37,"37061",254,187,185,0,2,"P.P.",109
1,"1013",711,477,474,1,3,"P.P.",68
40,"40192",179,151,150,1,1,"P.P.",89
45,"45108",564,461,456,2,5,"P.P.",276
12,"12018",326,274,265,1,9,"P.P.",145
34,"34067",142,88,88,3,0,"P.P.",42
45,"45109",3030,2507,2417,30,90,"P.P.",1528
4,"4045",1877,1512,1497,23,15,"P.P.",472
23,"23015",1476,1189,1179,10,10,"P.P.",463
9,"9429",64,44,44,2,0,"P.P.",32
4,"4046",826,645,634,4,11,"P.P.",323
42,"42172",31,28,28,3,0,"P.P.",21
49,"49026",236,189,184,3,5,"P.P.",123
40,"40193",231,188,185,6,3,"P.P.",97
14,"14063",1121,875,866,9,9,"P.P.",380
37,"37063",94,77,76,3,1,"P.P.",46
1,"1014",385,281,274,6,7,"P.P.",104
40,"40194",40248,30946,30365,525,581,"P.P.",15867
45,"45110",1918,1585,1570,10,15,"P.P.",913
34,"34068",32,23,23,0,0,"P.P.",19
5,"5240",3351,2472,2428,22,44,"P.P.",1571
49,"49027",178,134,127,1,7,"P.P.",84
23,"23016",442,355,354,5,1,"P.P.",121
37,"37065",346,269,267,0,2,"P.P.",203
23,"23017",1668,1392,1377,10,15,"P.P.",492
1,"1016",461,241,237,2,4,"P.P.",69
42,"42174",188,142,138,5,4,"P.P.",62
49,"49028",119,103,103,1,0,"P.P.",82
34,"34069",2330,1769,1749,25,20,"P.P.",811
40,"40195",946,722,707,13,15,"P.P.",472
1,"1017",910,629,621,17,8,"P.P.",131
45,"45111",65,47,44,1,3,"P.P.",24
23,"23018",2415,1791,1781,9,10,"P.P.",426
49,"49029",675,553,542,6,11,"P.P.",390
12,"12021",4433,3368,3292,42,76,"P.P.",1626
41,"41054",671,556,550,0,6,"P.P.",167
14,"14065",1846,1509,1492,14,17,"P.P.",600
30,"30007",6115,4651,4603,29,48,"P.P.",3230
40,"40196",44,34,34,3,0,"P.P.",23
19,"19095",14,9,8,0,1,"P.P.",6
49,"49164",158,120,114,2,6,"P.P.",56
1,"1018",1395,952,943,7,9,"P.P.",166
42,"42176",30,22,22,0,0,"P.P.",20
40,"40198",30,21,20,0,1,"P.P.",19
12,"12022",367,282,279,4,3,"P.P.",153
49,"49165",72,63,63,0,0,"P.P.",41
34,"34070",182,138,137,1,1,"P.P.",80
49,"49030",96,78,77,2,1,"P.P.",65
45,"45113",2094,1589,1555,6,34,"P.P.",993
1,"1019",155,124,124,0,0,"P.P.",23
30,"30008",13289,9992,9849,86,143,"P.P.",6128
9,"9433",67,46,45,2,1,"P.P.",21
34,"34071",186,160,160,1,0,"P.P.",116
42,"42177",78,64,62,4,2,"P.P.",36
26,"26057",52,42,42,0,0,"P.P.",25
5,"5243",101,69,68,0,1,"P.P.",46
23,"23020",1623,1414,1400,16,14,"P.P.",454
49,"49031",150,128,127,2,1,"P.P.",99
49,"49032",369,295,291,0,4,"P.P.",197
40,"40200",47,41,39,0,2,"P.P.",22
12,"12024",146,129,128,1,1,"P.P.",60
34,"34072",189,169,166,2,3,"P.P.",116
23,"23021",541,464,453,0,11,"P.P.",160
9,"9039",58,50,49,0,1,"P.P.",42
1,"1020",317,222,220,0,2,"P.P.",34
4,"4051",476,406,400,3,6,"P.P.",209
16,"16239",158,114,112,2,2,"P.P.",45
38,"38028",22003,14876,14589,158,287,"P.P.",6982
40,"40201",48,48,48,2,0,"P.P.",37
45,"45115",2600,2140,2105,14,35,"P.P.",1230
1,"1021",473,332,324,3,8,"P.P.",100
23,"23024",12634,9916,9673,116,243,"P.P.",5273
12,"12025",146,106,105,0,1,"P.P.",64
49,"49033",761,563,556,9,7,"P.P.",363
47,"47101",1740,1458,1444,12,14,"P.P.",730
45,"45116",682,576,565,0,11,"P.P.",384
34,"34073",184,153,152,7,1,"P.P.",88
23,"23025",2845,2292,2271,17,21,"P.P.",1037
49,"49034",467,363,359,3,4,"P.P.",223
18,"18001",288,212,212,1,0,"P.P.",95
38,"38030",1875,1320,1301,11,19,"P.P.",416
12,"12026",946,728,702,16,26,"P.P.",438
1,"1022",826,615,602,6,13,"P.P.",230
4,"4052",11567,8189,8124,158,65,"P.P.",4439
40,"40202",79,59,58,0,1,"P.P.",44
37,"37072",184,157,155,5,2,"P.P.",114
42,"42183",131,95,94,7,1,"P.P.",73
34,"34074",764,610,597,11,13,"P.P.",335
18,"18002",625,505,504,2,1,"P.P.",153
16,"16242",367,315,313,4,2,"P.P.",226
5,"5052",102,91,91,0,0,"P.P.",76
4,"4053",12062,9283,9180,119,103,"P.P.",5633
49,"49035",260,231,229,4,2,"P.P.",127
12,"12027",16914,11657,11452,188,205,"P.P.",6288
23,"23026",3872,3051,2994,23,57,"P.P.",1518
5,"5246",68,57,56,1,1,"P.P.",41
38,"38031",28391,21797,21431,234,366,"P.P.",11088
1,"1023",290,236,235,1,1,"P.P.",93
34,"34076",632,524,520,13,4,"P.P.",348
1,"1027",430,283,276,4,7,"P.P.",61
12,"12028",12115,9084,8992,137,92,"P.P.",4964
49,"49036",592,410,403,5,7,"P.P.",244
40,"40204",187,139,134,4,5,"P.P.",101
45,"45118",1980,1412,1390,13,22,"P.P.",821
18,"18003",13486,10245,10100,145,145,"P.P.",4743
34,"34077",283,219,216,3,3,"P.P.",96
49,"49037",201,171,171,2,0,"P.P.",115
19,"19103",303,247,244,3,3,"P.P.",115
45,"45119",3274,2279,2236,37,43,"P.P.",1308
14,"14071",1025,739,733,8,6,"P.P.",281
16,"16244",735,615,606,3,9,"P.P.",417
1,"1028",1106,773,760,8,13,"P.P.",267
12,"12029",760,619,601,7,18,"P.P.",265
40,"40206",179,136,134,0,2,"P.P.",75
23,"23029",924,730,727,2,3,"P.P.",347
37,"37077",293,262,258,3,4,"P.P.",133
4,"4055",418,368,367,5,1,"P.P.",159
9,"9046",41,30,30,0,0,"P.P.",19
49,"49038",114,81,80,0,1,"P.P.",43
1,"1030",170,123,120,1,3,"P.P.",46
45,"45120",159,125,122,0,3,"P.P.",65
18,"18004",818,601,594,2,7,"P.P.",322
34,"34079",1391,1088,1077,17,11,"P.P.",586
30,"30013",7369,5780,5731,53,49,"P.P.",2931
46,"46163",1811,1487,1463,12,24,"P.P.",763
34,"34080",6066,4238,4169,57,69,"P.P.",2370
23,"23030",1270,1052,1045,3,7,"P.P.",346
40,"40207",724,551,540,9,11,"P.P.",242
1,"1031",1229,916,899,13,17,"P.P.",398
18,"18005",366,279,277,3,2,"P.P.",94
45,"45121",6553,4720,4653,43,67,"P.P.",2999
4,"4057",1454,1081,1071,1,10,"P.P.",447
40,"40208",828,650,638,7,12,"P.P.",405
49,"49040",118,102,98,1,4,"P.P.",43
9,"9047",62,48,45,0,3,"P.P.",33
23,"23031",771,649,646,6,3,"P.P.",159
42,"42189",75,58,58,2,0,"P.P.",41
30,"30014",1686,1400,1387,10,13,"P.P.",812
30,"30015",18792,14453,14336,120,117,"P.P.",8912
45,"45122",4828,3816,3746,48,70,"P.P.",2176
12,"12032",23406,16895,16721,227,174,"P.P.",9283
1,"1032",536,412,400,0,12,"P.P.",131
14,"14074",2387,2002,1995,26,7,"P.P.",693
40,"40210",110,71,67,1,4,"P.P.",45
34,"34081",53,42,41,0,1,"P.P.",24
49,"49041",443,337,334,7,3,"P.P.",151
18,"18006",4116,2862,2831,25,31,"P.P.",1559
47,"47106",63,52,52,0,0,"P.P.",36
5,"5252",70,52,51,0,1,"P.P.",40
23,"23033",1382,1166,1152,7,14,"P.P.",533
49,"49042",271,216,216,1,0,"P.P.",150
19,"19106",95,68,66,0,2,"P.P.",30
9,"9050",77,52,52,0,0,"P.P.",30
1,"1033",679,537,532,2,5,"P.P.",140
34,"34082",96,79,75,0,4,"P.P.",47
12,"12033",1970,1547,1509,8,38,"P.P.",893
42,"42191",187,143,141,5,2,"P.P.",73
19,"19107",349,289,288,1,1,"P.P.",184
1,"1034",177,140,137,1,3,"P.P.",17
45,"45124",2183,1868,1823,20,45,"P.P.",1033
37,"37198",212,176,173,2,3,"P.P.",85
40,"40212",29,22,20,0,2,"P.P.",11
34,"34083",1888,1355,1338,15,17,"P.P.",866
9,"9051",181,136,133,2,3,"P.P.",99
49,"49043",304,256,256,6,0,"P.P.",115
46,"46165",6962,5390,5322,53,68,"P.P.",2961
42,"42192",43,36,36,2,0,"P.P.",14
18,"18007",808,602,591,5,11,"P.P.",169
23,"23035",1066,919,912,3,7,"P.P.",395
37,"37082",869,663,650,3,13,"P.P.",369
45,"45125",2407,1977,1949,22,28,"P.P.",1034
26,"26070",203,179,177,3,2,"P.P.",114
40,"40213",99,75,74,1,1,"P.P.",49
45,"45126",278,188,187,0,1,"P.P.",95
9,"9446",13,9,9,0,0,"P.P.",5
15,"15002",21528,15479,15218,314,261,"P.P.",7354
34,"34084",142,124,122,3,2,"P.P.",92
1,"1036",15236,10511,10372,141,139,"P.P.",1797
49,"49046",283,240,235,2,5,"P.P.",153
37,"37083",190,165,165,3,0,"P.P.",87
38,"38039",10198,7548,7429,78,119,"P.P.",4301
42,"42194",200,165,163,4,2,"P.P.",92
40,"40214",243,204,199,0,5,"P.P.",126
1,"1037",625,403,398,6,5,"P.P.",105
18,"18010",576,464,458,4,6,"P.P.",121
34,"34086",105,89,89,1,0,"P.P.",44
4,"4062",4604,3711,3654,22,57,"P.P.",1853
40,"40215",109,94,91,0,3,"P.P.",74
23,"23038",3273,2658,2638,29,20,"P.P.",1472
12,"12037",20,15,14,1,1,"P.P.",6
1,"1039",211,164,158,1,6,"P.P.",46
49,"49047",120,91,90,1,1,"P.P.",59
45,"45127",739,550,538,5,12,"P.P.",358
49,"49048",162,119,119,2,0,"P.P.",95
45,"45128",2558,1831,1806,20,25,"P.P.",1004
18,"18011",4246,3195,3172,23,23,"P.P.",1419
40,"40216",753,621,611,15,10,"P.P.",360
12,"12038",195,135,134,8,1,"P.P.",94
19,"19110",73,59,57,4,2,"P.P.",40
16,"16254",213,166,165,2,1,"P.P.",100
18,"18012",2693,1841,1831,11,10,"P.P.",650
34,"34087",108,88,87,1,1,"P.P.",66
23,"23039",2239,1799,1764,9,35,"P.P.",808
1,"1041",159,116,113,1,3,"P.P.",60
49,"49050",558,382,375,3,7,"P.P.",269
45,"45129",145,121,120,0,1,"P.P.",73
19,"19111",180,147,146,0,1,"P.P.",94
38,"38041",6780,4905,4813,57,92,"P.P.",1818
12,"12039",870,743,736,4,7,"P.P.",413
23,"23040",1538,1319,1311,3,8,"P.P.",399
30,"30020",5989,4533,4487,14,46,"P.P.",3136
34,"34088",219,179,177,4,2,"P.P.",102
49,"49052",200,149,144,1,5,"P.P.",90
1,"1042",915,678,661,1,17,"P.P.",79
34,"34089",173,128,125,5,3,"P.P.",83
18,"18013",4392,3268,3223,23,45,"P.P.",1505
9,"9450",31,26,26,1,0,"P.P.",15
40,"40219",635,519,505,7,14,"P.P.",415
16,"16258",288,215,213,1,2,"P.P.",148
38,"38042",3876,2850,2809,24,41,"P.P.",1228
12,"12040",116573,84142,83078,1257,1064,"P.P.",41828
21,"21002",14281,10297,10173,141,124,"P.P.",5180
49,"49053",978,809,796,10,13,"P.P.",466
30,"30021",8550,6423,6349,44,74,"P.P.",4503
26,"26076",144,124,123,3,1,"P.P.",79
19,"19113",519,396,395,4,1,"P.P.",199
1,"1043",2322,1623,1595,12,28,"P.P.",584
18,"18014",5667,4132,4085,43,47,"P.P.",2059
23,"23042",359,278,277,0,1,"P.P.",157
1,"1044",242,174,173,1,1,"P.P.",50
12,"12041",115,98,98,2,0,"P.P.",74
9,"9058",357,278,276,4,2,"P.P.",153
45,"45131",327,262,258,1,4,"P.P.",139
3,"3104",26809,20511,20193,317,318,"P.P.",9805
15,"15006",5539,3940,3866,53,74,"P.P.",2286
42,"42201",27,24,24,2,0,"P.P.",10
49,"49054",929,690,687,12,3,"P.P.",403
23,"23043",554,411,407,6,4,"P.P.",199
40,"40221",50,41,41,0,0,"P.P.",25
37,"37320",96,70,70,0,0,"P.P.",46
40,"40222",190,157,156,1,1,"P.P.",93
19,"19114",40,34,34,0,0,"P.P.",20
18,"18015",465,381,379,1,2,"P.P.",150
1,"1046",629,428,421,5,7,"P.P.",119
9,"9455",48,39,39,0,0,"P.P.",26
37,"37091",181,127,119,0,8,"P.P.",83
49,"49055",115,96,95,1,1,"P.P.",59
12,"12042",664,549,530,5,19,"P.P.",393
34,"34093",101,74,74,1,0,"P.P.",68
4,"4067",657,526,524,1,2,"P.P.",168
40,"40223",241,190,190,2,0,"P.P.",103
1,"1047",942,674,655,4,19,"P.P.",252
45,"45133",2803,2241,2199,18,42,"P.P.",1230
37,"37092",1403,1034,1022,12,12,"P.P.",595
49,"49056",324,251,247,3,4,"P.P.",142
45,"45134",1606,1260,1242,10,18,"P.P.",718
23,"23045",2180,1671,1667,3,4,"P.P.",530
42,"42205",99,70,70,0,0,"P.P.",39
18,"18016",339,254,253,2,1,"P.P.",110
1,"1049",147,115,115,1,0,"P.P.",20
40,"40224",34,25,25,0,0,"P.P.",23
49,"49057",125,98,94,1,4,"P.P.",63
47,"47116",426,363,358,0,5,"P.P.",234
38,"38046",8848,6410,6301,75,109,"P.P.",2658
34,"34094",64,47,44,1,3,"P.P.",37
37,"37096",235,199,197,3,2,"P.P.",139
23,"23047",1658,1342,1339,6,3,"P.P.",516
21,"21006",3565,2477,2441,29,36,"P.P.",688
9,"9458",422,325,316,5,9,"P.P.",166
18,"18017",17990,12070,11962,80,108,"P.P.",7000
1,"1051",3662,2242,2210,26,32,"P.P.",355
4,"4069",4729,3740,3706,52,34,"P.P.",1927
42,"42206",10,9,9,1,0,"P.P.",4
45,"45136",5891,4414,4368,55,46,"P.P.",2792
49,"49059",111,83,82,2,1,"P.P.",52
15,"15009",11109,8179,8014,129,165,"P.P.",4088
9,"9460",187,144,142,2,2,"P.P.",94
34,"34096",56,41,39,1,2,"P.P.",28
37,"37097",47,39,39,1,0,"P.P.",28
4,"4070",1649,1267,1255,9,12,"P.P.",681
23,"23048",884,691,679,6,12,"P.P.",383
19,"19117",1526,1155,1132,26,23,"P.P.",481
40,"40228",539,446,437,2,9,"P.P.",292
1,"1052",240,191,191,1,0,"P.P.",19
18,"18018",658,520,514,4,6,"P.P.",195
18,"18117",535,444,440,2,4,"P.P.",175
34,"34098",756,544,540,10,4,"P.P.",270
40,"40229",45,37,37,0,0,"P.P.",25
23,"23049",1942,1514,1486,16,28,"P.P.",587
49,"49061",141,106,105,1,1,"P.P.",68
9,"9064",353,277,277,6,0,"P.P.",196
42,"42208",23,15,15,1,0,"P.P.",13
49,"49062",142,104,104,1,0,"P.P.",72
19,"19118",17,13,13,0,0,"P.P.",3
1,"1053",590,341,333,4,8,"P.P.",49
38,"38049",2794,1721,1694,12,27,"P.P.",736
34,"34099",56,49,47,1,2,"P.P.",37
40,"40230",117,92,90,1,2,"P.P.",48
1,"1054",959,680,675,8,5,"P.P.",64
12,"12046",236,177,176,4,1,"P.P.",86
23,"23050",91354,68649,67925,990,724,"P.P.",37086
18,"18020",1473,1111,1106,7,5,"P.P.",455
26,"26086",18,17,17,0,0,"P.P.",16
37,"37100",89,77,76,4,1,"P.P.",66
4,"4072",339,272,271,0,1,"P.P.",149
34,"34100",141,105,105,1,0,"P.P.",75
49,"49063",371,291,290,3,1,"P.P.",175
30,"30027",45194,35272,34973,366,299,"P.P.",22103
19,"19119",93,80,79,2,1,"P.P.",46
40,"40231",128,102,100,3,2,"P.P.",59
23,"23051",2805,2312,2290,8,22,"P.P.",1120
49,"49064",566,372,368,8,4,"P.P.",231
18,"18021",16026,11376,11219,186,157,"P.P.",5475
37,"37101",185,143,141,1,2,"P.P.",104
45,"45140",1087,885,867,6,18,"P.P.",412
4,"4073",389,289,286,4,3,"P.P.",170
23,"23052",1186,1012,997,1,15,"P.P.",383
1,"1055",906,632,623,7,9,"P.P.",213
34,"34101",54,44,44,0,0,"P.P.",27
5,"5073",319,258,254,7,4,"P.P.",180
26,"26088",48,41,41,0,0,"P.P.",21
23,"23053",9431,7160,7128,42,32,"P.P.",1592
49,"49065",1212,939,926,3,13,"P.P.",664
34,"34102",226,187,185,3,2,"P.P.",122
15,"15013",6160,4229,4165,70,64,"P.P.",2216
1,"1056",256,183,181,1,2,"P.P.",46
21,"21011",3531,2672,2639,15,33,"P.P.",852
46,"46103",1244,998,972,12,26,"P.P.",463
18,"18022",12448,8777,8659,111,118,"P.P.",3317
49,"49066",531,392,386,2,6,"P.P.",287
12,"12050",1418,1183,1156,8,27,"P.P.",542
46,"46176",1965,1423,1405,12,18,"P.P.",802
23,"23054",393,288,286,1,2,"P.P.",95
45,"45142",7974,6294,6178,89,116,"P.P.",3754
34,"34103",105,92,92,5,0,"P.P.",69
1,"1057",266,212,212,2,0,"P.P.",42
42,"42215",821,561,545,19,16,"P.P.",302
40,"40901",379,292,288,11,4,"P.P.",172
49,"49201",330,280,278,9,2,"P.P.",140
49,"49067",416,300,300,2,0,"P.P.",180
19,"19226",40,31,30,0,1,"P.P.",22
23,"23055",48167,33913,33612,400,301,"P.P.",15270
40,"40902",137,118,118,3,0,"P.P.",97
37,"37104",32,24,23,0,1,"P.P.",20
1,"1058",1342,877,872,8,5,"P.P.",84
30,"30029",11533,8854,8768,73,86,"P.P.",5475
18,"18023",16072,11594,11488,131,106,"P.P.",5424
38,"38901",1389,917,907,16,10,"P.P.",233
34,"34104",274,224,224,4,0,"P.P.",161
49,"49068",523,356,353,5,3,"P.P.",244
12,"12052",627,510,491,9,19,"P.P.",311
26,"26092",112,89,88,2,1,"P.P.",60
42,"42217",38,32,32,0,0,"P.P.",11
5,"5904",149,99,97,0,2,"P.P.",65
1,"1059",183468,127839,125801,1422,2038,"P.P.",36926
49,"49069",414,276,270,1,6,"P.P.",221
15,"15016",5135,3816,3771,22,45,"P.P.",2076
21,"21014",4063,3424,3408,27,16,"P.P.",1225
4,"4077",343,313,313,1,0,"P.P.",181
37,"37106",289,199,196,2,3,"P.P.",135
42,"42218",86,59,59,0,0,"P.P.",40
1,"1060",223,181,178,1,3,"P.P.",94
23,"23057",823,717,711,4,6,"P.P.",190
40,"40904",332,271,268,5,3,"P.P.",179
34,"34106",121,100,99,2,1,"P.P.",72
19,"19124",420,293,291,3,2,"P.P.",158
18,"18024",882,696,688,12,8,"P.P.",297
9,"9072",272,210,209,4,1,"P.P.",95
34,"34242",97,81,79,6,2,"P.P.",56
12,"12053",2121,1745,1719,11,26,"P.P.",980
34,"34107",91,67,67,4,0,"P.P.",50
40,"40905",143,103,103,1,0,"P.P.",83
1,"1061",155,122,122,2,0,"P.P.",6
23,"23058",8497,6642,6591,44,51,"P.P.",2964
40,"40906",1793,1428,1405,32,23,"P.P.",685
49,"49075",153,128,122,0,6,"P.P.",86
26,"26095",126,102,102,0,0,"P.P.",29
37,"37108",108,95,95,1,0,"P.P.",60
46,"46180",715,585,581,4,4,"P.P.",267
1,"1062",333,236,232,5,4,"P.P.",93
18,"18025",326,242,238,0,4,"P.P.",87
12,"12055",112,79,78,3,1,"P.P.",36
24,"24078",426,323,316,0,7,"P.P.",164
34,"34108",561,477,465,6,12,"P.P.",220
19,"19126",1552,1140,1119,16,21,"P.P.",628
45,"45147",598,484,478,9,6,"P.P.",247
24,"24199",432,280,278,2,2,"P.P.",160
16,"16010",184,135,133,1,2,"P.P.",107
23,"23060",19107,14365,14264,130,101,"P.P.",6078
49,"49076",333,260,257,10,3,"P.P.",172
24,"24079",1045,721,710,15,11,"P.P.",434
1,"1063",1803,1290,1284,18,6,"P.P.",246
49,"49077",210,146,144,1,2,"P.P.",97
45,"45148",340,256,256,1,0,"P.P.",158
18,"18027",2575,1913,1899,15,14,"P.P.",547
41,"41001",1642,1314,1302,10,12,"P.P.",391
34,"34109",62,47,46,0,1,"P.P.",40
23,"23061",7309,5637,5584,60,53,"P.P.",2505
19,"19127",97,66,66,1,0,"P.P.",51
16,"16901",793,590,582,2,8,"P.P.",347
37,"37224",216,190,186,5,4,"P.P.",152
4,"4081",367,312,309,0,3,"P.P.",113
37,"37112",162,124,124,3,0,"P.P.",80
41,"41002",1510,1161,1140,4,21,"P.P.",459
49,"49078",209,173,172,1,1,"P.P.",107
12,"12057",650,530,515,6,15,"P.P.",249
34,"34110",96,83,81,2,2,"P.P.",41
1,"1901",2254,1561,1528,24,33,"P.P.",467
18,"18028",992,826,821,4,5,"P.P.",401
37,"37225",119,101,95,3,6,"P.P.",65
4,"4082",309,216,214,3,2,"P.P.",121
23,"23063",3960,3073,3037,21,36,"P.P.",1183
45,"45149",638,542,533,2,9,"P.P.",311
45,"45150",471,388,382,1,6,"P.P.",166
30,"30034",1182,956,943,3,13,"P.P.",556
15,"15020",4187,2802,2781,18,21,"P.P.",1379
49,"49079",110,93,92,2,1,"P.P.",61
1,"1902",776,532,526,6,6,"P.P.",169
37,"37113",439,365,365,7,0,"P.P.",200
34,"34112",50,39,38,2,1,"P.P.",24
49,"49080",736,571,560,5,11,"P.P.",296
18,"18029",1892,1355,1347,6,8,"P.P.",460
47,"47128",57,52,48,1,4,"P.P.",41
2,"2001",731,601,584,6,17,"P.P.",344
23,"23064",1680,1483,1478,8,5,"P.P.",745
4,"4083",1933,1511,1497,16,14,"P.P.",673
34,"34113",35,28,27,0,1,"P.P.",18
15,"15021",5114,3527,3475,77,52,"P.P.",1854
2,"2002",479,411,407,3,4,"P.P.",225
9,"9077",38,26,25,0,1,"P.P.",18
26,"26102",6158,4794,4716,60,78,"P.P.",2649
49,"49081",1457,1166,1141,17,25,"P.P.",633
34,"34903",240,161,160,2,1,"P.P.",112
41,"41004",55127,37662,37179,622,483,"P.P.",14165
18,"18030",612,457,456,0,1,"P.P.",206
45,"45152",653,503,497,2,6,"P.P.",238
12,"12060",467,367,353,2,14,"P.P.",217
3,"3023",1425,1259,1233,11,26,"P.P.",619
26,"26103",796,616,611,11,5,"P.P.",332
49,"49082",400,331,324,2,7,"P.P.",158
34,"34114",240,171,171,0,0,"P.P.",152
15,"15022",6102,4207,4164,52,43,"P.P.",2299
30,"30036",13978,10244,10141,94,103,"P.P.",7168
18,"18032",248,166,166,2,0,"P.P.",102
23,"23066",4348,3687,3654,21,33,"P.P.",1754
2,"2003",129078,98135,97009,1430,1126,"P.P.",55858
4,"4085",453,384,383,0,1,"P.P.",225
45,"45153",1704,1376,1353,9,23,"P.P.",862
49,"49083",67,48,48,1,0,"P.P.",37
34,"34116",76,50,49,1,1,"P.P.",37
41,"41005",8792,6642,6585,71,57,"P.P.",2020
23,"23067",2523,2004,1974,16,30,"P.P.",842
26,"26104",18,16,16,0,0,"P.P.",10
4,"4086",1903,1376,1371,11,5,"P.P.",809
18,"18033",282,227,226,0,1,"P.P.",107
49,"49084",306,234,234,8,0,"P.P.",128
2,"2004",654,554,544,7,10,"P.P.",294
47,"47131",189,145,145,4,0,"P.P.",77
37,"37117",1320,948,937,16,11,"P.P.",520
34,"34120",65774,49378,48608,830,770,"P.P.",24714
12,"12063",59,42,41,0,1,"P.P.",10
16,"16909",737,590,585,9,5,"P.P.",249
2,"2005",602,490,488,2,2,"P.P.",287
30,"30038",15057,11640,11555,82,85,"P.P.",7959
19,"19135",120,102,100,2,2,"P.P.",71
46,"46185",422,360,359,7,1,"P.P.",79
49,"49085",1173,912,908,16,4,"P.P.",570
2,"2006",612,540,534,1,6,"P.P.",301
18,"18034",510,377,375,2,2,"P.P.",115
39,"39009",3200,2427,2402,24,25,"P.P.",1337
23,"23070",4142,2877,2846,20,31,"P.P.",1400
41,"41007",12177,8150,8016,126,134,"P.P.",2614
34,"34121",208,153,152,0,1,"P.P.",126
49,"49086",127,108,107,1,1,"P.P.",65
15,"15025",1173,780,777,10,3,"P.P.",506
9,"9905",432,313,309,1,4,"P.P.",181
45,"45156",3528,2985,2924,19,61,"P.P.",1470
23,"23071",1811,1444,1431,13,13,"P.P.",687
18,"18035",1254,991,982,7,9,"P.P.",518
19,"19136",22,15,15,0,0,"P.P.",7
12,"12064",118,91,89,1,2,"P.P.",34
49,"49087",581,358,356,3,2,"P.P.",276
45,"45157",2097,1519,1499,15,20,"P.P.",972
37,"37120",107,88,87,0,1,"P.P.",55
34,"34122",80,65,62,2,3,"P.P.",40
49,"49224",161,114,112,2,2,"P.P.",76
2,"2007",1139,923,916,0,7,"P.P.",332
9,"9220",82,60,60,2,0,"P.P.",34
12,"12065",181,155,155,0,0,"P.P.",108
49,"49088",90,67,66,3,1,"P.P.",48
41,"41008",1073,884,875,0,9,"P.P.",129
18,"18137",1057,875,868,8,7,"P.P.",478
19,"19138",298,223,219,3,4,"P.P.",101
18,"18036",3553,2762,2741,20,21,"P.P.",1538
34,"34123",1798,1479,1436,18,43,"P.P.",861
2,"2008",1332,985,966,12,19,"P.P.",506
45,"45158",2577,1948,1909,18,39,"P.P.",1101
46,"46188",660,579,576,4,3,"P.P.",312
15,"15027",1537,1263,1242,22,21,"P.P.",823
30,"30040",733,640,635,2,5,"P.P.",402
2,"2009",19661,14804,14570,259,234,"P.P.",7302
4,"4090",435,338,335,3,3,"P.P.",168
30,"30041",12957,9360,9288,89,72,"P.P.",6103
24,"24213",162,134,133,1,1,"P.P.",84
34,"34124",70,55,55,1,0,"P.P.",40
49,"49090",207,168,168,4,0,"P.P.",105
18,"18037",488,408,404,0,4,"P.P.",216
18,"18138",2460,1751,1741,1,10,"P.P.",468
49,"49091",278,197,197,4,0,"P.P.",108
45,"45159",100,84,84,1,0,"P.P.",46
34,"34125",99,77,75,1,2,"P.P.",55
23,"23075",3404,2800,2782,24,18,"P.P.",1114
4,"4091",380,322,318,3,4,"P.P.",105
46,"46189",490,400,396,3,4,"P.P.",173
2,"2010",1877,1557,1519,15,38,"P.P.",777
41,"41010",4338,2990,2958,48,32,"P.P.",1046
35,"35005",1170,864,853,7,11,"P.P.",445
2,"2011",730,612,610,3,2,"P.P.",307
19,"19142",259,191,190,0,1,"P.P.",75
49,"49092",160,123,123,2,0,"P.P.",80
23,"23076",831,681,671,5,10,"P.P.",372
4,"4092",2897,2351,2325,13,26,"P.P.",1219
12,"12069",53,48,47,0,1,"P.P.",27
18,"18038",1097,906,900,3,6,"P.P.",328
19,"19143",1610,1287,1268,9,19,"P.P.",714
34,"34126",284,226,224,3,2,"P.P.",162
23,"23077",668,523,518,2,5,"P.P.",240
30,"30042",1841,1531,1519,10,12,"P.P.",1003
49,"49093",308,248,245,5,3,"P.P.",131
2,"2012",1834,1632,1622,12,10,"P.P.",763
12,"12070",576,473,463,5,10,"P.P.",249
24,"24094",1466,1023,1006,24,17,"P.P.",576
45,"45162",773,599,594,3,5,"P.P.",350
13,"13020",4805,3475,3434,40,41,"P.P.",1726
41,"41011",15274,11359,11207,145,152,"P.P.",2851
18,"18039",3733,2901,2878,18,23,"P.P.",1109
41,"41090",3488,2792,2751,22,41,"P.P.",928
34,"34127",118,77,74,1,3,"P.P.",52
37,"37239",235,208,201,2,7,"P.P.",120
3,"3032",112,90,88,0,2,"P.P.",51
15,"15030",201751,141022,138934,2981,2088,"P.P.",63242
49,"49094",276,180,180,2,0,"P.P.",107
37,"37126",36,26,26,0,0,"P.P.",24
46,"46191",1952,1554,1528,9,26,"P.P.",819
2,"2013",158,123,121,1,2,"P.P.",72
23,"23080",1832,1425,1414,3,11,"P.P.",557
19,"19145",64,49,48,2,1,"P.P.",41
30,"30901",10113,8265,8194,70,71,"P.P.",5077
34,"34129",191,144,142,0,2,"P.P.",108
49,"49095",318,232,232,5,0,"P.P.",139
5,"5094",158,124,124,3,0,"P.P.",107
12,"12071",1355,1069,1050,3,19,"P.P.",533
45,"45163",8239,6203,6073,103,130,"P.P.",3381
18,"18040",246,147,146,0,1,"P.P.",58
37,"37127",229,183,182,3,1,"P.P.",85
49,"49096",188,149,146,2,3,"P.P.",75
2,"2014",390,333,326,5,7,"P.P.",146
45,"45164",191,160,158,0,2,"P.P.",110
34,"34130",228,187,186,6,1,"P.P.",93
23,"23081",1643,1245,1234,12,11,"P.P.",426
35,"35008",6151,4514,4419,59,95,"P.P.",2403
41,"41013",4762,3359,3327,9,32,"P.P.",722
2,"2015",1508,1230,1211,7,19,"P.P.",688
18,"18042",425,344,342,2,2,"P.P.",147
23,"23082",1985,1464,1451,9,13,"P.P.",702
34,"34131",67,57,56,0,1,"P.P.",51
49,"49097",97,55,55,1,0,"P.P.",34
30,"30902",7463,5291,5228,38,63,"P.P.",3328
49,"49233",119,78,78,2,0,"P.P.",41
45,"45165",62818,47242,46629,549,613,"P.P.",27524
9,"9095",88,75,73,2,2,"P.P.",54
19,"19147",58,45,40,0,5,"P.P.",16
12,"12073",168,135,135,1,0,"P.P.",77
2,"2016",600,471,468,5,3,"P.P.",296
4,"4097",299,229,227,0,2,"P.P.",104
49,"49098",242,177,175,4,2,"P.P.",122
18,"18043",140,89,87,1,2,"P.P.",53
37,"37129",247,198,198,4,0,"P.P.",104
9,"9098",553,416,410,11,6,"P.P.",235
34,"34132",128,103,102,2,1,"P.P.",65
49,"49099",127,96,96,1,0,"P.P.",51
23,"23085",2350,1963,1956,8,7,"P.P.",566
2,"2017",895,685,682,4,3,"P.P.",332
45,"45167",1552,1296,1278,14,18,"P.P.",758
12,"12074",783,679,676,3,3,"P.P.",365
5,"5097",525,378,373,4,5,"P.P.",229
37,"37130",177,153,153,2,0,"P.P.",131
21,"21033",508,385,382,7,3,"P.P.",80
15,"15034",3116,2146,2114,20,32,"P.P.",985
34,"34133",108,90,90,0,0,"P.P.",76
2,"2018",922,759,754,7,5,"P.P.",428
26,"26121",33,28,28,0,0,"P.P.",17
47,"47142",172,132,131,2,1,"P.P.",83
49,"49100",322,236,233,1,3,"P.P.",126
19,"19150",128,112,108,0,4,"P.P.",65
18,"18044",208,132,132,4,0,"P.P.",59
41,"41016",6950,5194,5120,45,74,"P.P.",2252
12,"12075",139,106,102,0,4,"P.P.",52
23,"23087",11474,9197,9123,90,74,"P.P.",4289
49,"49101",186,134,129,0,5,"P.P.",86
34,"34134",61,49,47,0,2,"P.P.",32
9,"9101",79,66,66,2,0,"P.P.",52
39,"39018",4077,3212,3160,44,52,"P.P.",1306
2,"2019",2455,2107,2077,16,30,"P.P.",968
45,"45169",239,183,183,1,0,"P.P.",112
18,"18147",3742,2419,2386,20,33,"P.P.",1028
12,"12076",105,79,79,0,0,"P.P.",41
49,"49102",217,178,176,3,2,"P.P.",83
41,"41017",13878,10053,9926,130,127,"P.P.",4724
18,"18045",1211,892,885,4,7,"P.P.",345
39,"39019",2009,1556,1536,10,20,"P.P.",807
26,"26123",129,113,113,1,0,"P.P.",67
2,"2020",519,433,430,0,3,"P.P.",218
24,"24102",701,536,530,3,6,"P.P.",286
19,"19152",674,505,498,2,7,"P.P.",282
47,"47143",146,108,107,0,1,"P.P.",87
34,"34135",429,334,329,6,5,"P.P.",213
9,"9102",44,36,36,0,0,"P.P.",22
45,"45170",257,186,183,0,3,"P.P.",117
49,"49103",435,354,350,6,4,"P.P.",261
26,"26124",860,705,694,3,11,"P.P.",429
2,"2021",1114,872,860,7,12,"P.P.",518
45,"45171",1359,1114,1093,13,21,"P.P.",609
18,"18046",1960,1327,1312,5,15,"P.P.",551
41,"41018",9457,6940,6867,66,73,"P.P.",1507
12,"12077",4683,3476,3414,41,62,"P.P.",1809
49,"49104",383,281,276,2,5,"P.P.",207
34,"34136",192,122,122,1,0,"P.P.",101
19,"19251",41,35,34,0,1,"P.P.",21
46,"46196",159,145,144,1,1,"P.P.",100
47,"47144",85,65,65,2,0,"P.P.",40
2,"2022",431,346,343,1,3,"P.P.",256
19,"19154",79,68,67,0,1,"P.P.",58
4,"4102",12940,9247,9152,90,95,"P.P.",5792
37,"37135",1234,972,961,8,11,"P.P.",589
18,"18047",5603,3833,3805,67,28,"P.P.",1704
15,"15037",4181,2839,2804,25,35,"P.P.",1679
9,"9238",1026,612,601,6,11,"P.P.",333
2,"2023",636,534,533,6,1,"P.P.",287
34,"34137",31,24,24,3,0,"P.P.",8
41,"41019",4528,3194,3168,41,26,"P.P.",1186
34,"34139",179,143,143,1,0,"P.P.",91
23,"23092",27970,20921,20651,284,270,"P.P.",9800
3,"3041",5811,4325,4269,33,56,"P.P.",2316
24,"24105",1460,1095,1075,27,20,"P.P.",522
49,"49107",160,113,111,2,2,"P.P.",51
18,"18048",2277,1705,1688,19,17,"P.P.",655
19,"19155",61,52,50,1,2,"P.P.",26
9,"9105",111,85,81,2,4,"P.P.",36
45,"45173",9133,7147,7035,78,112,"P.P.",4420
35,"35015",9065,4859,4770,64,89,"P.P.",1886
9,"9108",399,287,283,5,4,"P.P.",127
4,"4901",576,427,426,5,1,"P.P.",198
2,"2024",3424,2765,2726,32,39,"P.P.",1387
23,"23094",3917,3200,3166,32,34,"P.P.",1053
26,"26128",116,94,93,0,1,"P.P.",48
19,"19156",1032,782,762,4,20,"P.P.",479
34,"34140",113,84,84,2,0,"P.P.",65
49,"49108",512,387,381,9,6,"P.P.",231
2,"2025",7496,6153,5985,69,168,"P.P.",3702
49,"49109",657,534,529,12,5,"P.P.",340
21,"21039",313,233,232,2,1,"P.P.",67
46,"46199",5661,4328,4280,38,48,"P.P.",2412
24,"24107",316,208,206,1,2,"P.P.",112
23,"23095",8882,6668,6628,31,40,"P.P.",3161
41,"41021",20767,14040,13822,240,218,"P.P.",4636
16,"16041",395,289,287,6,2,"P.P.",171
45,"45175",698,587,579,5,8,"P.P.",333
9,"9109",1181,664,631,16,33,"P.P.",270
19,"19157",66,56,56,4,0,"P.P.",31
2,"2026",845,723,716,5,7,"P.P.",310
12,"12081",654,519,515,2,4,"P.P.",283
18,"18049",632,476,474,5,2,"P.P.",207
49,"49110",382,236,233,1,3,"P.P.",133
18,"18050",1657,1209,1196,5,13,"P.P.",546
21,"21040",3096,2370,2351,28,19,"P.P.",891
15,"15040",2891,2160,2129,18,31,"P.P.",1270
9,"9110",95,68,68,1,0,"P.P.",54
4,"4903",4331,3183,3164,31,19,"P.P.",2205
34,"34143",181,142,140,3,2,"P.P.",96
45,"45176",3570,2619,2583,45,36,"P.P.",1503
5,"5001",210,180,176,2,4,"P.P.",126
29,"29001",4176,3339,3303,23,36,"P.P.",771
2,"2027",347,301,301,2,0,"P.P.",183
49,"49111",144,117,116,10,1,"P.P.",68
23,"23097",6510,4687,4639,36,48,"P.P.",2112
34,"34146",60,42,40,1,2,"P.P.",28
9,"9112",115,80,80,4,0,"P.P.",48
12,"12083",106,89,88,0,1,"P.P.",43
18,"18153",8348,6170,6118,88,52,"P.P.",2702
23,"23098",923,808,807,6,1,"P.P.",356
26,"26132",130,98,96,2,2,"P.P.",55
47,"47149",44,22,20,0,2,"P.P.",14
2,"2028",139,115,115,1,0,"P.P.",45
41,"41023",7901,6050,5972,45,78,"P.P.",2146
49,"49112",131,93,93,2,0,"P.P.",51
34,"34147",192,139,137,1,2,"P.P.",100
23,"23099",4649,3638,3594,39,44,"P.P.",1851
19,"19160",944,600,593,6,7,"P.P.",354
49,"49113",188,166,161,2,5,"P.P.",124
18,"18051",1196,857,852,4,5,"P.P.",317
19,"19258",103,81,81,0,0,"P.P.",58
46,"46255",3135,2530,2508,11,22,"P.P.",1461
37,"37142",613,436,434,7,2,"P.P.",250
12,"12084",17219,12059,11911,165,148,"P.P.",6709
49,"49248",224,183,180,4,3,"P.P.",110
2,"2029",3210,2512,2481,37,31,"P.P.",1293
45,"45180",2714,2018,1980,19,38,"P.P.",1271
19,"19259",37,32,32,0,0,"P.P.",9
18,"18053",1836,1345,1340,11,5,"P.P.",522
49,"49114",51,34,33,1,1,"P.P.",23
21,"21043",1898,1382,1350,9,32,"P.P.",445
47,"47150",338,273,271,2,2,"P.P.",159
19,"19161",243,171,166,2,5,"P.P.",84
2,"2030",3180,2499,2456,13,43,"P.P.",1191
29,"29004",343,281,281,0,0,"P.P.",126
23,"23901",1194,1048,1045,8,3,"P.P.",452
12,"12085",4941,3183,3125,32,58,"P.P.",1811
19,"19260",44,41,41,1,0,"P.P.",14
45,"45181",2276,1788,1764,10,24,"P.P.",1088
2,"2031",626,507,502,3,5,"P.P.",259
19,"19162",71,52,51,0,1,"P.P.",24
49,"49115",191,151,149,3,2,"P.P.",91
49,"49116",401,308,305,4,3,"P.P.",188
23,"23902",2495,2081,2067,4,14,"P.P.",731
34,"34151",184,125,123,1,2,"P.P.",97
41,"41025",1999,1502,1476,13,26,"P.P.",585
12,"12087",22,20,20,0,0,"P.P.",19
42,"42118",26,20,20,0,0,"P.P.",19
18,"18054",879,646,644,4,2,"P.P.",379
45,"45182",1077,873,856,11,17,"P.P.",434
47,"47152",94,65,65,0,0,"P.P.",27
26,"26011",7455,5452,5353,93,99,"P.P.",2961
3,"3050",17818,12860,12706,160,154,"P.P.",6951
2,"2032",323,261,259,1,2,"P.P.",113
19,"19163",73,59,59,0,0,"P.P.",36
23,"23903",3537,2892,2877,12,15,"P.P.",1218
34,"34152",142,114,109,1,5,"P.P.",64
2,"2033",1955,1565,1536,15,29,"P.P.",841
41,"41093",17665,13712,13526,179,186,"P.P.",7357
49,"49117",505,376,369,5,7,"P.P.",213
15,"15045",4178,2743,2727,22,16,"P.P.",1866
45,"45184",219,150,148,3,2,"P.P.",60
18,"18056",3695,2961,2940,25,21,"P.P.",1075
34,"34154",78,62,62,0,0,"P.P.",44
49,"49118",215,174,173,2,1,"P.P.",110
39,"39028",3513,2760,2718,23,42,"P.P.",1604
23,"23904",3070,2047,2033,19,14,"P.P.",871
19,"19165",51,43,42,0,1,"P.P.",17
46,"46204",6906,5426,5357,62,69,"P.P.",2525
34,"34155",142,118,117,3,1,"P.P.",66
41,"41027",4061,2783,2752,28,31,"P.P.",1004
45,"45185",7912,6321,6180,68,141,"P.P.",3240
14,"14034",367,301,292,1,9,"P.P.",147
2,"2034",1419,1153,1146,18,7,"P.P.",542
23,"23905",1884,1447,1438,4,9,"P.P.",667
37,"37147",201,153,151,1,2,"P.P.",96
15,"15046",6949,4641,4539,56,102,"P.P.",2914
12,"12090",127,109,107,2,2,"P.P.",73
15,"15047",2606,1789,1761,33,28,"P.P.",914
29,"29007",25572,17726,17564,227,162,"P.P.",9414
41,"41028",1880,1479,1458,28,21,"P.P.",573
2,"2035",1988,1601,1586,19,15,"P.P.",886
24,"24001",241,148,147,3,1,"P.P.",78
39,"39030",1971,1397,1379,20,18,"P.P.",564
46,"46205",14277,10882,10764,115,118,"P.P.",5433
5,"5013",890,746,739,4,7,"P.P.",388
34,"34156",56,48,48,2,0,"P.P.",37
18,"18059",4055,3232,3191,37,41,"P.P.",1101
49,"49121",382,270,270,1,0,"P.P.",167
45,"45186",3217,2573,2527,24,46,"P.P.",1223
21,"21048",327,226,226,5,0,"P.P.",58
26,"26015",205,167,165,1,2,"P.P.",126
9,"9123",31,27,27,0,0,"P.P.",18
26,"26143",187,154,151,4,3,"P.P.",84
2,"2036",104,78,78,0,0,"P.P.",47
24,"24002",271,213,213,2,0,"P.P.",93
34,"34157",2471,1936,1912,26,24,"P.P.",1161
46,"46133",686,572,565,1,7,"P.P.",246
2,"2037",22380,15942,15724,203,218,"P.P.",8487
18,"18061",1109,882,869,1,13,"P.P.",402
49,"49122",701,542,534,7,8,"P.P.",295
5,"5014",5559,4197,4101,53,96,"P.P.",2331
19,"19168",324,233,231,6,2,"P.P.",118
24,"24003",725,528,520,8,8,"P.P.",313
41,"41096",6079,4673,4595,47,78,"P.P.",2041
41,"41029",13231,9756,9610,128,146,"P.P.",3745
12,"12092",143,98,98,0,0,"P.P.",60
41,"41030",527,436,429,6,7,"P.P.",147
47,"47156",182,155,148,0,7,"P.P.",96
19,"19169",51,35,35,0,0,"P.P.",12
2,"2038",296,254,254,1,0,"P.P.",157
34,"34158",336,202,200,0,2,"P.P.",114
49,"49123",557,421,415,5,6,"P.P.",215
18,"18062",9418,6916,6835,62,81,"P.P.",3325
15,"15049",1211,851,843,7,8,"P.P.",553
49,"49124",279,203,202,2,1,"P.P.",118
37,"37151",150,125,121,1,4,"P.P.",105
45,"45189",655,510,502,3,8,"P.P.",286
2,"2039",1050,862,848,16,14,"P.P.",455
12,"12093",254,190,187,0,3,"P.P.",102
34,"34159",375,275,264,8,11,"P.P.",124
37,"37152",474,357,351,2,6,"P.P.",240
39,"39033",604,480,473,3,7,"P.P.",194
5,"5016",6231,4831,4763,56,68,"P.P.",2982
49,"49125",1344,956,939,21,17,"P.P.",447
41,"41031",1319,879,875,6,4,"P.P.",242
49,"49261",1579,1161,1145,36,16,"P.P.",567
40,"40015",33,30,30,1,0,"P.P.",24
18,"18063",1189,795,789,7,6,"P.P.",321
45,"45190",502,425,414,6,11,"P.P.",225
37,"37154",156,130,125,1,5,"P.P.",102
12,"12094",807,612,604,14,8,"P.P.",213
37,"37030",90,71,70,4,1,"P.P.",39
2,"2040",631,569,566,3,3,"P.P.",294
45,"45191",601,506,498,1,8,"P.P.",241
49,"49126",232,175,173,3,2,"P.P.",98
41,"41032",4059,3122,3062,22,60,"P.P.",937
24,"24006",521,384,378,4,6,"P.P.",219
18,"18064",419,347,345,3,2,"P.P.",170
7,"7021",255,197,193,1,4,"P.P.",118
19,"19171",4352,3299,3221,35,78,"P.P.",1413
39,"39034",289,209,209,3,0,"P.P.",131
24,"24124",419,286,282,0,4,"P.P.",186
46,"46209",1984,1606,1594,11,12,"P.P.",866
2,"2041",399,311,304,1,7,"P.P.",219
34,"34161",23,20,20,0,0,"P.P.",17
49,"49127",2227,1617,1587,48,30,"P.P.",884
24,"24007",798,582,566,2,16,"P.P.",245
18,"18066",2072,1558,1552,8,6,"P.P.",445
5,"5119",41,31,31,0,0,"P.P.",23
45,"45192",2549,2178,2155,39,23,"P.P.",1180
49,"49128",617,480,474,10,6,"P.P.",251
2,"2042",897,712,709,6,3,"P.P.",345
24,"24008",9789,7277,7179,110,98,"P.P.",4415
34,"34163",61,56,56,1,0,"P.P.",37
45,"45193",661,557,548,1,9,"P.P.",342
12,"12096",854,663,653,17,10,"P.P.",296
13,"13047",5822,4735,4650,52,85,"P.P.",2417
15,"15053",8164,5679,5592,60,87,"P.P.",2874
24,"24009",362,188,184,0,4,"P.P.",131
2,"2043",1335,1120,1108,10,12,"P.P.",603
18,"18067",704,526,521,1,5,"P.P.",228
49,"49265",143,105,105,1,0,"P.P.",63
34,"34165",86,67,67,0,0,"P.P.",60
19,"19270",17,16,16,0,0,"P.P.",8
5,"5019",44095,34409,33934,505,475,"P.P.",19391
49,"49129",903,671,661,16,10,"P.P.",315
41,"41034",22561,16014,15840,270,174,"P.P.",5123
45,"45194",57,41,41,0,0,"P.P.",22
34,"34167",124,105,105,0,0,"P.P.",73
12,"12097",78,59,59,4,0,"P.P.",32
45,"45195",2229,1806,1784,11,22,"P.P.",867
9,"9405",143,106,105,2,1,"P.P.",73
2,"2044",1207,908,893,5,15,"P.P.",426
49,"49130",218,159,156,3,3,"P.P.",93
39,"39036",1023,802,790,5,12,"P.P.",418
18,"18068",1456,1105,1088,13,17,"P.P.",531
24,"24010",8550,6242,6111,100,131,"P.P.",3683
37,"37158",262,181,179,0,2,"P.P.",99
5,"5022",1649,1335,1328,7,7,"P.P.",991
49,"49131",312,227,225,7,2,"P.P.",150
19,"19175",39,31,31,0,0,"P.P.",28
24,"24011",244,131,129,0,2,"P.P.",21
2,"2045",3763,3086,3035,42,51,"P.P.",1287
9,"9132",174,129,127,3,2,"P.P.",76
12,"12099",583,485,465,3,20,"P.P.",325
47,"47161",3886,3133,3105,45,28,"P.P.",2003
33,"33031",38090,25034,24730,380,304,"P.P.",7469
46,"46212",1598,1233,1218,5,15,"P.P.",660
18,"18069",506,375,371,4,4,"P.P.",156
2,"2046",1165,954,941,16,13,"P.P.",529
9,"9133",39,33,33,1,0,"P.P.",20
45,"45196",1363,1092,1076,3,16,"P.P.",651
34,"34168",60,56,56,0,0,"P.P.",33
49,"49132",338,245,238,0,7,"P.P.",180
49,"49133",344,247,243,3,4,"P.P.",149
41,"41036",4053,2930,2899,29,31,"P.P.",623
41,"41901",2626,2190,2167,24,23,"P.P.",266
12,"12100",1380,1124,1109,11,15,"P.P.",564
34,"34169",431,331,329,5,2,"P.P.",224
45,"45197",1972,1570,1538,8,32,"P.P.",811
2,"2047",109,94,94,0,0,"P.P.",83
24,"24014",7677,5352,5289,75,63,"P.P.",2822
15,"15056",5873,4205,4150,63,55,"P.P.",2377
46,"46213",15621,11361,11164,214,197,"P.P.",6025
41,"41037",3228,2510,2483,27,27,"P.P.",450
49,"49134",203,142,142,4,0,"P.P.",79
39,"39039",648,496,493,0,3,"P.P.",270
2,"2048",1320,1076,1061,11,15,"P.P.",612
47,"47002",30,27,27,1,0,"P.P.",23
45,"45198",1950,1661,1641,9,20,"P.P.",1034
34,"34170",72,56,56,1,0,"P.P.",45
18,"18173",8858,6238,6187,64,51,"P.P.",2500
18,"18070",287,240,239,2,1,"P.P.",108
15,"15057",12467,8936,8744,102,192,"P.P.",4797
34,"34171",1071,762,753,16,9,"P.P.",470
2,"2049",937,717,708,2,9,"P.P.",337
5,"5025",108,86,86,2,0,"P.P.",73
19,"19178",45,34,34,0,0,"P.P.",14
41,"41038",96442,66696,65945,1021,751,"P.P.",23990
15,"15058",26931,19505,19196,471,309,"P.P.",9204
49,"49135",687,485,475,3,10,"P.P.",291
42,"42145",140,111,111,2,0,"P.P.",70
39,"39040",4350,3413,3373,30,40,"P.P.",1901
49,"49272",102,87,86,0,1,"P.P.",70
37,"37163",44,36,36,0,0,"P.P.",25
49,"49136",347,249,247,6,2,"P.P.",184
12,"12102",547,474,466,2,8,"P.P.",227
45,"45200",4633,3768,3672,37,96,"P.P.",1903
2,"2050",121,95,95,1,0,"P.P.",49
18,"18071",5589,4268,4205,44,63,"P.P.",1582
45,"45201",3439,2353,2317,31,36,"P.P.",1337
24,"24017",630,476,468,11,8,"P.P.",278
34,"34174",213,179,178,4,1,"P.P.",122
49,"49137",179,149,147,2,2,"P.P.",96
41,"41039",31429,23337,23138,294,199,"P.P.",11138
39,"39041",1775,1432,1414,15,18,"P.P.",713
26,"26161",9,8,8,0,0,"P.P.",8
34,"34175",101,80,80,2,0,"P.P.",58
15,"15059",10658,7889,7728,125,161,"P.P.",4701
12,"12103",85,65,65,4,0,"P.P.",53
45,"45202",3876,3037,2984,13,53,"P.P.",1890
2,"2051",1729,1318,1303,10,15,"P.P.",916
24,"24137",1226,920,904,16,16,"P.P.",361
18,"18072",710,507,499,2,8,"P.P.",218
24,"24018",180,150,149,1,1,"P.P.",107
18,"18074",297,245,245,5,0,"P.P.",102
49,"49138",269,190,189,0,1,"P.P.",140
34,"34176",146,120,118,2,2,"P.P.",97
39,"39042",5928,4680,4634,44,46,"P.P.",2729
24,"24019",367,293,287,5,6,"P.P.",116
2,"2052",493,417,412,9,5,"P.P.",208
12,"12104",6981,5464,5357,54,107,"P.P.",2988
9,"9138",92,77,74,0,3,"P.P.",50
37,"37166",206,172,171,3,1,"P.P.",113
21,"21062",1444,1003,991,7,12,"P.P.",442
47,"47166",276,226,223,0,3,"P.P.",137
49,"49139",195,146,146,0,0,"P.P.",80
2,"2053",3053,2550,2517,33,33,"P.P.",1114
49,"49141",397,289,286,7,3,"P.P.",162
18,"18076",880,676,676,3,0,"P.P.",197
26,"26164",70,42,42,1,0,"P.P.",24
49,"49008",535,395,394,7,1,"P.P.",256
24,"24020",480,326,324,9,2,"P.P.",172
12,"12105",866,679,673,6,6,"P.P.",484
24,"24141",101,83,80,6,3,"P.P.",40
45,"45204",621,500,497,1,3,"P.P.",305
19,"19183",108,87,86,1,1,"P.P.",36
15,"15061",6105,4391,4307,64,84,"P.P.",2654
2,"2054",421,346,343,2,3,"P.P.",202
39,"39043",1321,1082,1072,8,10,"P.P.",745
15,"15062",6304,4418,4356,44,62,"P.P.",2806
49,"49142",264,180,179,2,1,"P.P.",105
18,"18078",768,638,637,1,1,"P.P.",218
34,"34178",106,93,93,1,0,"P.P.",82
24,"24021",1791,1251,1228,14,23,"P.P.",622
49,"49143",243,161,157,0,4,"P.P.",117
12,"12106",1207,992,969,7,23,"P.P.",382
39,"39044",3864,2940,2905,44,35,"P.P.",1545
24,"24022",364,231,230,2,1,"P.P.",137
47,"47168",32,29,28,1,1,"P.P.",25
2,"2055",1267,900,884,6,16,"P.P.",488
19,"19184",88,63,62,1,1,"P.P.",44
34,"34179",32,21,21,0,0,"P.P.",20
41,"41042",5902,4572,4509,37,63,"P.P.",1070
45,"45901",811,595,591,2,4,"P.P.",345
18,"18179",583,417,409,7,8,"P.P.",202
37,"37169",196,137,136,1,1,"P.P.",86
18,"18079",3497,2729,2706,15,23,"P.P.",680
26,"26167",66,51,51,2,0,"P.P.",34
2,"2056",1816,1518,1506,15,12,"P.P.",741
49,"49145",251,154,153,0,1,"P.P.",117
24,"24023",272,196,193,6,3,"P.P.",130
13,"13060",291,235,229,0,6,"P.P.",104
37,"37206",100,81,80,1,1,"P.P.",48
19,"19185",40,21,19,0,2,"P.P.",10
2,"2057",2138,1736,1712,30,24,"P.P.",644
5,"5034",17,13,13,0,0,"P.P.",9
34,"34180",84,68,68,0,0,"P.P.",40
21,"21066",522,440,431,4,9,"P.P.",126
49,"49146",330,268,265,6,3,"P.P.",129
24,"24024",717,501,498,10,3,"P.P.",327
18,"18180",655,450,447,1,3,"P.P.",112
39,"39046",1442,1071,1050,13,21,"P.P.",420
19,"19186",93,77,77,0,0,"P.P.",37
46,"46220",48981,34657,34242,450,415,"P.P.",15728
12,"12109",700,564,555,7,9,"P.P.",284
18,"18082",912,691,683,8,8,"P.P.",319
34,"34181",471,350,346,7,4,"P.P.",147
49,"49147",301,243,239,4,4,"P.P.",165
5,"5035",105,87,87,2,0,"P.P.",47
5,"5133",62,49,49,0,0,"P.P.",31
2,"2058",390,290,285,0,5,"P.P.",128
21,"21067",418,318,312,5,6,"P.P.",62
24,"24025",331,237,237,5,0,"P.P.",175
37,"37172",857,584,580,5,4,"P.P.",409
41,"41044",6838,5064,5005,67,59,"P.P.",2327
18,"18083",296,242,242,1,0,"P.P.",118
34,"34182",860,657,649,8,8,"P.P.",355
49,"49148",213,144,143,0,1,"P.P.",79
12,"12110",253,199,195,3,4,"P.P.",91
40,"40181",4413,3439,3361,43,78,"P.P.",1405
2,"2059",336,262,258,3,4,"P.P.",99
49,"49149",422,305,303,6,2,"P.P.",216
41,"41045",5505,3946,3889,68,57,"P.P.",1152
26,"26171",212,171,170,6,1,"P.P.",116
39,"39047",1987,1495,1482,9,13,"P.P.",773
37,"37173",1643,1298,1285,26,13,"P.P.",756
2,"2060",1232,974,964,10,10,"P.P.",604
15,"15066",4180,3098,3062,38,36,"P.P.",2065
49,"49150",169,129,126,0,3,"P.P.",84
34,"34184",54,37,36,0,1,"P.P.",29
18,"18084",3954,3039,3015,50,24,"P.P.",1591
34,"34185",72,48,45,0,3,"P.P.",26
36,"36009",5138,3147,3108,24,39,"P.P.",2087
24,"24027",1184,853,837,7,16,"P.P.",400
7,"7039",4920,3488,3377,54,111,"P.P.",2132
12,"12011",4663,3578,3525,28,53,"P.P.",1577
12,"12111",423,375,363,6,12,"P.P.",190
46,"46222",378,321,310,1,11,"P.P.",132
2,"2061",715,570,565,4,5,"P.P.",341
24,"24028",426,350,331,3,19,"P.P.",149
26,"26173",10,10,10,1,0,"P.P.",6
49,"49151",680,494,491,6,3,"P.P.",255
18,"18085",818,538,532,4,6,"P.P.",211
46,"46004",1933,1563,1541,8,22,"P.P.",777
12,"12112",104,90,90,0,0,"P.P.",49
19,"19190",2499,1829,1785,32,44,"P.P.",864
19,"19081",43,33,33,0,0,"P.P.",25
24,"24151",514,391,387,6,4,"P.P.",230
2,"2062",456,348,344,2,4,"P.P.",195
49,"49152",572,401,395,6,6,"P.P.",251
34,"34186",61,53,53,0,0,"P.P.",36
39,"39049",339,244,242,5,2,"P.P.",121
46,"46223",7685,6040,5996,62,44,"P.P.",3284
5,"5039",58,48,48,0,0,"P.P.",42
46,"46224",179,131,128,0,3,"P.P.",68
41,"41047",9810,7427,7321,99,106,"P.P.",3548
2,"2063",1537,1252,1242,11,10,"P.P.",635
42,"42017",154,134,130,2,4,"P.P.",53
18,"18086",397,321,321,3,0,"P.P.",69
46,"46005",22815,17016,16838,185,178,"P.P.",8229
36,"36011",1939,1189,1172,15,17,"P.P.",750
19,"19191",19,15,15,0,0,"P.P.",6
46,"46078",28197,20643,20415,205,228,"P.P.",9852
49,"49153",183,141,139,1,2,"P.P.",87
13,"13066",2444,2094,2065,15,29,"P.P.",1069
41,"41048",2296,1749,1726,21,23,"P.P.",635
16,"16087",229,193,187,4,6,"P.P.",115
49,"49154",147,104,102,1,2,"P.P.",42
2,"2064",413,350,348,7,2,"P.P.",186
37,"37178",107,88,87,0,1,"P.P.",63
5,"5041",1051,840,827,13,13,"P.P.",603
47,"47175",6562,5041,4957,62,84,"P.P.",2251
36,"36012",3839,2884,2825,14,59,"P.P.",1468
34,"34190",59,42,42,4,0,"P.P.",32
9,"9155",27,17,17,0,0,"P.P.",13
19,"19291",1271,925,902,3,23,"P.P.",493
42,"42019",562,392,383,9,9,"P.P.",226
29,"29030",839,669,668,5,1,"P.P.",64
41,"41049",8898,6881,6812,95,69,"P.P.",2179
24,"24032",134,102,101,1,1,"P.P.",52
34,"34192",103,75,74,1,1,"P.P.",57
13,"13068",1058,801,793,4,8,"P.P.",460
18,"18187",587,432,432,0,0,"P.P.",127
2,"2065",517,450,449,4,1,"P.P.",245
18,"18088",1576,1258,1253,2,5,"P.P.",316
21,"21073",1840,1249,1236,13,13,"P.P.",591
26,"26178",88,74,73,1,1,"P.P.",38
49,"49156",265,217,214,6,3,"P.P.",139
36,"36014",2145,1568,1548,9,20,"P.P.",1049
42,"42020",4385,3055,2957,74,98,"P.P.",1670
24,"24033",214,157,152,3,5,"P.P.",93
30,"30003",23570,16482,16354,169,128,"P.P.",9961
49,"49157",177,140,140,0,0,"P.P.",77
2,"2066",258,219,217,2,2,"P.P.",107
46,"46008",2727,2249,2233,17,16,"P.P.",1103
19,"19194",113,80,76,1,4,"P.P.",41
5,"5043",86,68,68,0,0,"P.P.",41
37,"37180",69,46,46,0,0,"P.P.",33
13,"13069",704,605,590,2,15,"P.P.",283
15,"15072",9868,7077,6951,79,126,"P.P.",3161
24,"24034",3434,2524,2481,37,43,"P.P.",1070
21,"21074",2752,1981,1968,15,13,"P.P.",747
47,"47177",112,83,79,1,4,"P.P.",48
2,"2067",1197,938,924,6,14,"P.P.",500
26,"26180",243,185,181,4,4,"P.P.",127
42,"42022",253,177,171,2,6,"P.P.",133
2,"2068",379,290,284,3,6,"P.P.",122
41,"41051",2103,1705,1686,7,19,"P.P.",596
34,"34199",1354,1004,978,27,26,"P.P.",531
46,"46009",3140,2521,2498,15,23,"P.P.",1296
39,"39053",251,179,179,1,0,"P.P.",83
34,"34201",212,178,172,1,6,"P.P.",114
24,"24036",321,190,188,0,2,"P.P.",85
49,"49159",289,225,225,2,0,"P.P.",117
9,"9163",642,526,518,3,8,"P.P.",302
37,"37182",92,72,72,2,0,"P.P.",56
15,"15073",21991,14686,14456,216,230,"P.P.",8956
47,"47178",190,162,161,1,1,"P.P.",98
24,"24037",429,282,277,4,5,"P.P.",176
2,"2069",11624,9091,8907,119,184,"P.P.",5912
18,"18093",2580,1837,1820,8,17,"P.P.",885
5,"5045",104,82,82,0,0,"P.P.",68
34,"34202",28,21,21,0,0,"P.P.",16
46,"46228",2434,1881,1859,30,22,"P.P.",983
49,"49160",54,35,34,3,1,"P.P.",8
41,"41052",2967,2305,2288,7,17,"P.P.",600
2,"2070",439,372,366,4,6,"P.P.",82
24,"24038",3206,2439,2399,37,40,"P.P.",1109
49,"49162",217,157,155,2,2,"P.P.",97
37,"37184",381,295,289,5,6,"P.P.",181
41,"41053",20729,16178,15971,142,207,"P.P.",5218
34,"34204",53,45,44,0,1,"P.P.",33
47,"47179",408,315,306,6,9,"P.P.",189
18,"18094",2398,1882,1868,16,14,"P.P.",965
15,"15074",4254,3246,3219,35,27,"P.P.",2177
24,"24160",741,545,539,17,6,"P.P.",345
2,"2071",1053,899,895,5,4,"P.P.",492
5,"5046",44,39,38,1,1,"P.P.",27
49,"49163",235,167,167,0,0,"P.P.",103
12,"12120",218,180,177,0,3,"P.P.",107
24,"24039",2157,1738,1727,30,11,"P.P.",1071
34,"34205",70,55,55,1,0,"P.P.",37
26,"26055",38,32,30,0,2,"P.P.",21
18,"18095",1916,1428,1306,21,122,"P.P.",558
29,"29035",1717,1280,1270,14,10,"P.P.",346
46,"46011",7727,5874,5777,75,97,"P.P.",3499
39,"39056",2387,1857,1835,22,22,"P.P.",972
5,"5047",4267,3345,3275,34,70,"P.P.",1944
2,"2072",1598,1220,1198,5,22,"P.P.",634
18,"18193",13680,9874,9764,130,110,"P.P.",4705
19,"19198",22,19,19,0,0,"P.P.",8
46,"46084",1587,1363,1332,7,31,"P.P.",758
24,"24040",494,369,366,6,3,"P.P.",214
15,"15076",2766,1971,1936,18,35,"P.P.",977
36,"36020",2581,1947,1922,27,25,"P.P.",1341
12,"12121",1197,1050,1020,4,30,"P.P.",537
7,"7050",3099,2008,1979,45,29,"P.P.",1400
24,"24041",602,403,396,3,7,"P.P.",230
34,"34206",952,796,780,9,16,"P.P.",417
45,"45003",607,515,511,3,4,"P.P.",332
5,"5048",131,112,111,0,1,"P.P.",81
21,"21079",749,556,553,6,3,"P.P.",150
2,"2073",4924,3923,3847,76,76,"P.P.",1874
18,"18096",348,289,287,1,2,"P.P.",105
41,"41055",15121,11082,10997,98,85,"P.P.",4119
12,"12122",835,674,658,14,16,"P.P.",380
49,"49166",1294,1003,988,29,15,"P.P.",472
19,"19301",47,38,38,0,0,"P.P.",32
7,"7051",4925,2993,2947,66,46,"P.P.",1550
24,"24042",79,68,68,0,0,"P.P.",40
34,"34208",62,52,52,2,0,"P.P.",43
2,"2074",6093,4630,4548,57,82,"P.P.",2404
46,"46231",2496,1831,1817,16,14,"P.P.",736
12,"12123",70,50,48,2,2,"P.P.",27
15,"15077",8677,6349,6269,82,80,"P.P.",4383
19,"19200",150,105,105,1,0,"P.P.",59
41,"41056",3697,3041,3008,25,33,"P.P.",576
18,"18097",1022,758,752,4,6,"P.P.",371
34,"34210",103,93,91,2,2,"P.P.",63
46,"46013",16111,12469,12328,145,141,"P.P.",6131
49,"49167",223,173,171,5,2,"P.P.",117
24,"24043",144,77,77,0,0,"P.P.",31
5,"5051",194,165,154,0,11,"P.P.",100
2,"2075",1689,1386,1372,10,14,"P.P.",786
19,"19201",70,52,52,2,0,"P.P.",36
49,"49168",96,78,78,1,0,"P.P.",56
13,"13077",3654,2535,2480,31,55,"P.P.",1287
41,"41057",299,191,189,0,2,"P.P.",74
24,"24044",176,138,136,2,2,"P.P.",83
46,"46233",3911,3025,2988,10,37,"P.P.",1713
34,"34211",202,175,170,1,5,"P.P.",133
24,"24165",400,284,279,4,5,"P.P.",181
16,"16240",134,100,98,0,2,"P.P.",63
2,"2076",371,292,287,3,5,"P.P.",165
18,"18098",6440,4743,4679,44,64,"P.P.",2132
12,"12125",235,203,201,1,2,"P.P.",111
49,"49169",42,34,33,1,1,"P.P.",16
41,"41058",16497,12415,12248,181,167,"P.P.",5019
46,"46014",3092,2449,2420,26,29,"P.P.",1224
24,"24166",1521,1137,1112,27,25,"P.P.",632
15,"15079",1709,1268,1253,14,15,"P.P.",788
2,"2077",51,46,45,0,1,"P.P.",24
49,"49170",111,87,85,1,2,"P.P.",46
9,"9173",135,116,116,1,0,"P.P.",86
34,"34213",67,50,50,0,0,"P.P.",34
24,"24046",1002,704,696,20,8,"P.P.",354
24,"24167",813,509,509,8,0,"P.P.",315
5,"5053",94,73,71,0,2,"P.P.",57
18,"18099",1551,1217,1205,11,12,"P.P.",485
15,"15080",1913,1407,1389,15,18,"P.P.",986
2,"2078",967,770,756,9,14,"P.P.",341
34,"34214",176,144,143,3,1,"P.P.",86
46,"46015",7042,5644,5581,53,63,"P.P.",2948
19,"19203",35,27,27,0,0,"P.P.",12
41,"41059",31676,23199,22889,330,310,"P.P.",9387
24,"24047",856,623,612,5,11,"P.P.",391
9,"9174",859,645,639,11,6,"P.P.",344
2,"2079",2936,2305,2235,29,70,"P.P.",865
18,"18100",7304,5807,5737,62,70,"P.P.",2068
37,"37193",432,310,309,5,1,"P.P.",154
15,"15081",1139,869,853,9,16,"P.P.",676
47,"47185",97,76,75,1,1,"P.P.",49
49,"49172",594,389,383,0,6,"P.P.",276
34,"34215",166,146,145,1,1,"P.P.",74
24,"24049",1528,1144,1124,22,20,"P.P.",612
2,"2080",580,450,443,4,7,"P.P.",244
41,"41060",15176,10797,10693,114,104,"P.P.",3801
12,"12127",92,64,61,0,3,"P.P.",26
18,"18101",8990,6659,6556,96,103,"P.P.",3370
46,"46017",32928,24879,24672,267,207,"P.P.",13990
37,"37194",271,206,204,0,2,"P.P.",112
34,"34216",65,50,50,1,0,"P.P.",43
49,"49173",430,272,272,5,0,"P.P.",177
12,"12128",1448,1114,1092,16,22,"P.P.",530
2,"2081",18319,14324,14096,225,228,"P.P.",7936
19,"19208",55,41,41,1,0,"P.P.",26
49,"49174",131,97,97,1,0,"P.P.",71
18,"18102",8556,6358,6272,42,86,"P.P.",1929
47,"47025",127,103,103,0,0,"P.P.",77
19,"19105",2235,1709,1686,23,23,"P.P.",934
42,"42037",38,23,20,3,3,"P.P.",13
18,"18906",955,736,731,5,5,"P.P.",381
40,"40069",87,76,75,0,1,"P.P.",57
24,"24051",484,375,368,2,7,"P.P.",235
49,"49175",263,215,215,4,0,"P.P.",137
34,"34217",1089,866,849,19,17,"P.P.",463
41,"41061",2205,1798,1770,2,28,"P.P.",249
2,"2082",121,107,107,1,0,"P.P.",53
36,"36028",4207,3294,3254,21,40,"P.P.",1942
13,"13083",2529,1837,1795,26,42,"P.P.",1136
12,"12129",1936,1372,1326,29,46,"P.P.",546
5,"5057",2593,2172,2152,16,20,"P.P.",1248
19,"19210",34,29,29,1,0,"P.P.",20
37,"37196",93,74,70,1,4,"P.P.",43
2,"2083",246,215,215,0,0,"P.P.",102
18,"18103",803,653,647,5,6,"P.P.",305
49,"49176",757,502,501,5,1,"P.P.",404
46,"46237",7261,5405,5350,54,55,"P.P.",2617
42,"42039",270,172,169,2,3,"P.P.",77
34,"34218",486,366,365,3,1,"P.P.",280
12,"12130",425,348,344,2,4,"P.P.",299
24,"24172",491,234,232,2,2,"P.P.",160
24,"24053",503,338,332,3,6,"P.P.",226
34,"34220",145,125,123,0,2,"P.P.",72
37,"37197",101,72,70,1,2,"P.P.",49
5,"5058",81,61,59,0,2,"P.P.",41
18,"18105",5222,3866,3839,32,27,"P.P.",1116
9,"9179",45,37,37,0,0,"P.P.",22
49,"49177",298,199,196,6,3,"P.P.",109
42,"42041",36,25,25,4,0,"P.P.",9
29,"29045",1750,1246,1239,6,7,"P.P.",661
24,"24054",492,359,351,1,8,"P.P.",230
15,"15085",3576,2656,2612,29,44,"P.P.",1715
2,"2084",362,276,270,2,6,"P.P.",173
12,"12131",92,78,78,1,0,"P.P.",60
46,"46020",3793,3084,3046,21,38,"P.P.",1686
47,"47109",183,151,151,4,0,"P.P.",70
34,"34221",190,143,143,3,0,"P.P.",71
5,"5059",112,91,88,1,3,"P.P.",43
2,"2085",345,288,284,2,4,"P.P.",156
9,"9180",132,97,95,8,2,"P.P.",48
24,"24055",747,557,549,11,8,"P.P.",330
15,"15086",3110,2281,2259,30,22,"P.P.",1542
18,"18909",668,536,534,2,2,"P.P.",273
2,"2086",2856,2019,2005,9,14,"P.P.",1038
42,"42043",3905,2931,2875,48,56,"P.P.",1889
37,"37199",157,115,113,0,2,"P.P.",56
46,"46093",2082,1722,1716,9,6,"P.P.",982
18,"18107",988,769,760,3,9,"P.P.",294
49,"49179",401,285,284,2,1,"P.P.",206
12,"12133",64,47,47,0,0,"P.P.",39
24,"24175",1760,1324,1303,29,21,"P.P.",727
24,"24056",3200,2368,2332,53,36,"P.P.",1131
49,"49180",169,113,107,2,6,"P.P.",71
34,"34222",122,94,94,2,0,"P.P.",80
9,"9182",104,81,81,1,0,"P.P.",65
37,"37200",192,142,142,0,0,"P.P.",90
24,"24057",1459,1121,1092,16,29,"P.P.",563
46,"46094",20341,15367,15222,152,145,"P.P.",8314
46,"46021",23273,17264,17091,163,173,"P.P.",8508
24,"24176",336,267,261,3,6,"P.P.",197
2,"2901",2223,1678,1667,19,11,"P.P.",940
18,"18108",892,674,673,2,1,"P.P.",265
41,"41065",23028,15133,14958,191,175,"P.P.",4306
3,"3001",359,296,292,2,4,"P.P.",196
24,"24177",477,325,319,3,6,"P.P.",214
49,"49181",386,308,307,2,1,"P.P.",249
47,"47191",113,81,80,1,1,"P.P.",53
49,"49183",111,87,87,2,0,"P.P.",70
9,"9183",58,47,46,1,1,"P.P.",30
34,"34224",53,42,41,0,1,"P.P.",25
12,"12134",147,107,107,3,0,"P.P.",54
29,"29048",1508,1254,1245,6,9,"P.P.",181
46,"46022",15090,10922,10840,99,82,"P.P.",5569
41,"41066",1417,1121,1113,9,8,"P.P.",302
24,"24178",83,67,67,2,0,"P.P.",49
49,"49184",190,135,133,1,2,"P.P.",107
24,"24058",224,166,163,1,3,"P.P.",111
42,"42197",90,71,71,0,0,"P.P.",51
24,"24059",956,592,585,9,7,"P.P.",263
18,"18109",607,461,456,1,5,"P.P.",259
34,"34225",4837,3650,3580,73,70,"P.P.",1500
3,"3002",3559,2747,2707,16,40,"P.P.",1580
12,"12135",35189,25691,25345,380,346,"P.P.",12996
46,"46242",361,288,280,4,8,"P.P.",178
40,"40078",180,143,143,1,0,"P.P.",75
9,"9184",4,4,4,0,0,"P.P.",3
19,"19216",143,112,105,2,7,"P.P.",49
41,"41067",7055,5368,5295,64,73,"P.P.",2086
34,"34227",84,69,67,3,2,"P.P.",56
12,"12136",2663,2325,2284,33,41,"P.P.",1541
37,"37204",286,216,214,0,2,"P.P.",151
49,"49185",171,140,140,3,0,"P.P.",90
3,"3003",460,382,370,1,12,"P.P.",217
18,"18111",2647,1957,1941,24,16,"P.P.",804
47,"47193",1538,1229,1211,23,18,"P.P.",630
18,"18112",132,90,90,1,0,"P.P.",47
49,"49186",273,205,204,1,1,"P.P.",150
9,"9189",146,101,99,2,2,"P.P.",70
34,"34228",93,80,80,0,0,"P.P.",44
19,"19217",85,57,54,2,3,"P.P.",27
3,"3004",624,497,486,7,11,"P.P.",264
9,"9454",46,31,30,1,1,"P.P.",16
41,"41068",13809,10171,10072,100,99,"P.P.",3257
46,"46024",448,365,358,1,7,"P.P.",216
24,"24061",1713,1223,1210,34,13,"P.P.",619
49,"49187",1317,967,954,31,13,"P.P.",594
19,"19321",46,29,29,0,0,"P.P.",11
37,"37090",59,54,50,0,4,"P.P.",36
45,"45022",427,317,314,8,3,"P.P.",190
24,"24181",1652,1303,1288,12,15,"P.P.",707
5,"5065",498,424,422,7,2,"P.P.",296
3,"3005",7482,6191,6146,49,45,"P.P.",4192
18,"18114",678,508,508,6,0,"P.P.",167
41,"41069",28331,21065,20877,252,188,"P.P.",8043
24,"24062",151,107,107,0,0,"P.P.",43
37,"37010",963,705,690,5,15,"P.P.",379
15,"15091",1171,839,829,9,10,"P.P.",522
34,"34229",75,60,60,2,0,"P.P.",40
3,"3006",479,380,369,2,11,"P.P.",202
49,"49188",142,101,100,3,1,"P.P.",65
15,"15092",6869,4965,4907,53,58,"P.P.",2674
24,"24063",453,323,322,2,1,"P.P.",207
46,"46025",2495,1962,1941,24,21,"P.P.",996
46,"46026",1217,1043,1035,2,8,"P.P.",560
18,"18115",2380,1843,1823,14,20,"P.P.",678
36,"36039",14581,11007,10782,167,225,"P.P.",6018
49,"49189",228,151,150,3,1,"P.P.",121
46,"46099",987,764,754,2,10,"P.P.",404
34,"34230",12,8,8,0,0,"P.P.",8
24,"24064",1532,1128,1107,17,21,"P.P.",490
12,"12139",344,219,216,0,3,"P.P.",122
40,"40084",65,53,53,2,0,"P.P.",33
34,"34231",273,209,206,2,3,"P.P.",149
9,"9328",81,56,56,2,0,"P.P.",31
49,"49190",81,65,64,2,1,"P.P.",37
41,"41070",5598,4101,4039,79,62,"P.P.",1696
9,"9194",2033,1557,1535,28,22,"P.P.",908
3,"3007",160,131,127,0,4,"P.P.",70
19,"19220",2225,1482,1456,7,26,"P.P.",733
46,"46245",478,357,354,1,3,"P.P.",197
19,"19221",56,41,41,2,0,"P.P.",25
37,"37209",376,258,253,4,5,"P.P.",120
18,"18116",2972,2237,2213,19,24,"P.P.",1043
34,"34232",802,632,623,9,9,"P.P.",345
9,"9195",64,40,40,1,0,"P.P.",24
12,"12141",116,97,97,0,0,"P.P.",71
24,"24185",512,414,402,3,12,"P.P.",235
49,"49192",166,139,139,2,0,"P.P.",68
15,"15901",3855,2463,2419,48,44,"P.P.",1248
3,"3008",176,142,140,1,2,"P.P.",86
24,"24066",561,440,437,5,3,"P.P.",315
3,"3110",294,239,238,0,1,"P.P.",118
46,"46246",1081,917,904,5,13,"P.P.",608
36,"36042",17897,12635,12437,157,198,"P.P.",6391
41,"41072",4083,3073,3046,12,27,"P.P.",525
37,"37098",355,267,265,1,2,"P.P.",136
34,"34233",158,128,128,3,0,"P.P.",106
9,"9330",1562,1212,1176,10,36,"P.P.",677
16,"16001",79,66,66,1,0,"P.P.",40
3,"3009",47547,35945,35298,603,647,"P.P.",15278
49,"49193",503,365,357,4,8,"P.P.",244
5,"5070",41,33,33,0,0,"P.P.",14
47,"47198",71,56,56,2,0,"P.P.",39
12,"12142",158,122,121,1,1,"P.P.",83
3,"3010",330,269,266,3,3,"P.P.",135
18,"18119",1778,1401,1391,14,10,"P.P.",604
49,"49194",380,250,247,4,3,"P.P.",158
46,"46247",1059,829,823,6,6,"P.P.",577
3,"3111",5244,4184,4146,39,38,"P.P.",2794
24,"24068",500,357,349,3,8,"P.P.",122
39,"39075",140941,103308,102362,1364,946,"P.P.",56866
34,"34234",72,56,55,1,1,"P.P.",34
41,"41073",1789,1292,1272,5,20,"P.P.",525
19,"19223",129,94,90,1,4,"P.P.",57
37,"37213",97,77,76,0,1,"P.P.",54
12,"12901",3383,2664,2632,34,32,"P.P.",1339
19,"19224",119,95,94,0,1,"P.P.",81
34,"34236",176,134,134,1,0,"P.P.",109
49,"49197",187,126,126,3,0,"P.P.",74
46,"46029",20887,16124,15988,144,136,"P.P.",9278
24,"24069",53,44,44,0,0,"P.P.",36
18,"18120",274,238,237,2,1,"P.P.",66
3,"3011",7341,5277,5218,72,59,"P.P.",2911
49,"49199",266,214,211,1,3,"P.P.",119
3,"3012",1021,870,862,3,8,"P.P.",514
37,"37329",40,36,36,2,0,"P.P.",28
37,"37215",156,106,106,1,0,"P.P.",60
36,"36045",24724,17794,17459,237,335,"P.P.",7781
12,"12902",2056,1454,1411,14,43,"P.P.",805
34,"34237",645,506,498,6,8,"P.P.",324
3,"3113",4154,3295,3251,24,44,"P.P.",1775
13,"13902",497,396,394,3,2,"P.P.",191
46,"46030",800,677,662,6,15,"P.P.",333
41,"41074",3079,2406,2386,14,20,"P.P.",716
24,"24070",4434,3199,3136,34,63,"P.P.",1162
39,"39076",3388,2673,2641,22,32,"P.P.",1309
18,"18121",135,109,109,0,0,"P.P.",44
3,"3013",1144,941,926,5,15,"P.P.",584
13,"13001",1372,1087,1067,8,20,"P.P.",453
36,"36046",4093,3175,3120,31,55,"P.P.",1818
49,"49200",1011,789,771,6,18,"P.P.",425
37,"37216",300,270,266,2,4,"P.P.",186
41,"41075",9987,7904,7809,71,95,"P.P.",2904
34,"34238",348,289,287,4,2,"P.P.",125
39,"39077",256,196,196,1,0,"P.P.",111
13,"13002",1576,1143,1134,4,9,"P.P.",668
3,"3115",267,242,242,2,0,"P.P.",120
46,"46031",10580,7900,7809,87,91,"P.P.",4104
33,"33066",42885,29326,29013,460,313,"P.P.",10639
3,"3014",234288,168004,166418,1795,1586,"P.P.",88355
5,"5075",100,76,76,1,0,"P.P.",52
29,"29059",2551,1986,1964,11,22,"P.P.",471
18,"18122",16253,12271,12109,132,162,"P.P.",5340
37,"37217",60,49,48,1,1,"P.P.",24
49,"49202",221,158,157,2,1,"P.P.",104
13,"13003",503,390,387,2,3,"P.P.",239
41,"41076",2227,1507,1492,5,15,"P.P.",444
34,"34240",102,84,83,1,1,"P.P.",57
5,"5076",477,397,385,4,12,"P.P.",244
49,"49203",345,294,292,4,2,"P.P.",181
16,"16131",154,116,115,0,1,"P.P.",70
24,"24074",107,87,87,0,0,"P.P.",53
46,"46032",5583,4342,4287,39,55,"P.P.",2117
37,"37333",247,160,154,2,6,"P.P.",105
34,"34241",20,12,11,0,1,"P.P.",10
3,"3015",12241,9734,9636,88,98,"P.P.",5819
18,"18123",307,239,238,1,1,"P.P.",83
16,"16008",131,89,88,2,1,"P.P.",45
13,"13004",1130,937,923,6,14,"P.P.",470
41,"41077",8817,6520,6375,53,145,"P.P.",1901
47,"47205",414,307,298,5,9,"P.P.",206
3,"3016",91,67,66,1,1,"P.P.",42
24,"24076",1210,917,907,26,10,"P.P.",467
49,"49204",85,64,64,0,0,"P.P.",45
5,"5077",205,164,160,2,4,"P.P.",109
19,"19011",286,219,218,3,1,"P.P.",113
39,"39080",3627,2743,2693,19,50,"P.P.",1468
24,"24197",784,570,564,7,6,"P.P.",297
19,"19229",83,71,68,0,3,"P.P.",48
18,"18124",387,270,267,0,3,"P.P.",171
49,"49205",429,313,309,10,4,"P.P.",247
46,"46033",220,183,181,0,2,"P.P.",113
34,"34243",352,274,273,5,1,"P.P.",186
24,"24077",237,205,199,2,6,"P.P.",113
41,"41078",2587,1979,1970,15,9,"P.P.",543
16,"16009",79,63,62,0,1,"P.P.",42
49,"49206",948,706,692,15,14,"P.P.",397
3,"3017",380,331,324,7,7,"P.P.",129
19,"19013",143,110,108,1,2,"P.P.",46
36,"36050",7602,5424,5339,50,85,"P.P.",2646
41,"41079",9349,7095,7001,71,94,"P.P.",2033
3,"3018",11899,8855,8720,119,135,"P.P.",4562
37,"37222",124,92,92,2,0,"P.P.",61
37,"37109",191,142,141,1,1,"P.P.",118
11,"11006",24221,16564,16470,197,94,"P.P.",7118
46,"46034",1791,1477,1468,8,9,"P.P.",754
18,"18126",1461,1129,1121,15,8,"P.P.",305
37,"37336",54,49,47,0,2,"P.P.",29
34,"34245",322,240,236,3,4,"P.P.",161
37,"37223",127,102,101,1,1,"P.P.",60
49,"49207",279,206,204,2,2,"P.P.",119
3,"3019",14914,12087,11927,137,160,"P.P.",6635
13,"13007",1319,1069,1051,18,18,"P.P.",508
19,"19231",16,14,14,0,0,"P.P.",13
3,"3120",2329,1810,1785,16,25,"P.P.",1086
47,"47208",56,45,43,1,2,"P.P.",32
41,"41080",1289,1010,997,13,13,"P.P.",410
36,"36052",7517,5563,5461,54,102,"P.P.",3096
16,"16012",102,81,80,0,1,"P.P.",40
34,"34246",78,64,64,0,0,"P.P.",44
49,"49208",428,266,261,1,5,"P.P.",219
18,"18127",15897,11597,11483,133,114,"P.P.",4656
46,"46036",675,440,431,11,9,"P.P.",273
3,"3020",108,87,86,1,1,"P.P.",38
9,"9213",370,260,260,5,0,"P.P.",142
46,"46109",6143,4731,4637,40,94,"P.P.",2372
19,"19017",87,70,70,0,0,"P.P.",39
34,"34901",1233,955,946,14,9,"P.P.",646
24,"24081",143,111,110,1,1,"P.P.",90
49,"49209",568,374,372,1,2,"P.P.",244
16,"16013",24,23,23,0,0,"P.P.",16
13,"13009",1573,1265,1255,6,10,"P.P.",830
41,"41081",28121,20027,19785,275,242,"P.P.",5529
18,"18128",361,284,283,5,1,"P.P.",164
49,"49210",493,358,356,6,2,"P.P.",178
24,"24082",877,698,690,13,8,"P.P.",287
34,"34902",146,121,121,1,0,"P.P.",79
3,"3021",5594,4630,4517,46,113,"P.P.",2573
3,"3123",7435,5860,5744,63,116,"P.P.",3109
5,"5179",231,206,204,2,2,"P.P.",182
39,"39084",873,647,642,4,5,"P.P.",423
9,"9214",724,477,467,4,10,"P.P.",238
49,"49214",720,560,558,6,2,"P.P.",376
5,"5082",569,467,462,1,5,"P.P.",287
3,"3022",160,133,131,1,2,"P.P.",74
13,"13010",910,729,726,8,3,"P.P.",370
18,"18132",3461,2797,2772,19,25,"P.P.",654
24,"24083",1165,831,819,17,12,"P.P.",330
5,"5180",109,92,91,1,1,"P.P.",85
46,"46110",21420,15810,15671,134,139,"P.P.",7794
49,"49216",175,144,142,3,2,"P.P.",65
41,"41082",3448,2827,2796,15,31,"P.P.",776
13,"13011",5166,3555,3500,31,55,"P.P.",1850
36,"36055",13678,10508,10288,155,220,"P.P.",6252
41,"41083",1176,915,908,8,7,"P.P.",264
24,"24206",1831,1362,1341,13,21,"P.P.",624
42,"42078",1110,829,817,15,12,"P.P.",494
34,"34904",355,247,241,3,6,"P.P.",121
37,"37229",144,108,108,0,0,"P.P.",90
49,"49219",7742,5643,5562,87,81,"P.P.",3149
46,"46038",368,264,260,1,4,"P.P.",133
24,"24084",182,133,132,1,1,"P.P.",74
46,"46063",1764,1441,1423,15,18,"P.P.",717
36,"36056",5087,3883,3830,37,53,"P.P.",2503
46,"46111",10589,7823,7710,94,113,"P.P.",4134
18,"18133",2256,1783,1773,12,10,"P.P.",988
3,"3024",3908,3324,3271,34,53,"P.P.",1975
16,"16017",406,337,334,1,3,"P.P.",174
19,"19237",53,40,39,2,1,"P.P.",17
16,"16143",20,14,13,1,1,"P.P.",9
5,"5085",35,34,34,0,0,"P.P.",32
24,"24086",323,245,243,1,2,"P.P.",171
41,"41084",2875,2362,2335,9,27,"P.P.",719
49,"49220",161,122,118,5,4,"P.P.",53
24,"24087",670,513,513,12,0,"P.P.",375
46,"46039",2200,1849,1820,12,29,"P.P.",985
35,"35001",4663,3639,3569,39,70,"P.P.",1953
49,"49221",266,148,147,6,1,"P.P.",79
3,"3025",1252,1054,1044,4,10,"P.P.",684
18,"18134",5528,3751,3679,57,72,"P.P.",1789
13,"13013",7141,5682,5564,60,118,"P.P.",3450
47,"47213",122,99,99,1,0,"P.P.",48
41,"41085",3918,3173,3128,42,45,"P.P.",1371
9,"9218",384,285,279,8,6,"P.P.",139
49,"49222",404,297,294,4,3,"P.P.",100
14,"14010",4087,3144,3121,15,23,"P.P.",957
13,"13014",565,457,452,3,5,"P.P.",218
37,"37232",412,374,373,1,1,"P.P.",272
5,"5086",96,81,81,2,0,"P.P.",63
18,"18135",4752,3252,3212,34,40,"P.P.",1126
16,"16019",252,210,207,2,3,"P.P.",145
46,"46040",1227,1028,1021,13,7,"P.P.",501
35,"35002",21673,14480,14253,172,227,"P.P.",7321
5,"5087",144,87,87,0,0,"P.P.",65
19,"19239",99,74,73,1,1,"P.P.",55
3,"3026",1210,1004,989,11,15,"P.P.",486
18,"18136",1973,1679,1668,5,11,"P.P.",426
37,"37233",59,46,45,1,1,"P.P.",23
49,"49223",770,606,601,8,5,"P.P.",459
47,"47214",1517,1215,1191,34,24,"P.P.",651
5,"5184",288,225,224,0,1,"P.P.",122
3,"3027",150,131,130,1,1,"P.P.",79
16,"16148",634,553,547,5,6,"P.P.",372
35,"35003",4764,2733,2680,34,53,"P.P.",1406
47,"47051",351,269,256,5,13,"P.P.",146
37,"37234",376,275,272,2,3,"P.P.",150
3,"3130",43,30,29,0,1,"P.P.",24
36,"36060",30264,21398,21051,344,347,"P.P.",10202
24,"24212",1105,856,846,14,10,"P.P.",464
46,"46041",369,255,255,1,0,"P.P.",121
14,"14012",6305,4749,4690,44,59,"P.P.",1436
35,"35004",35462,18498,18196,325,302,"P.P.",7263
41,"41087",9827,7300,7150,51,150,"P.P.",3208
13,"13016",708,555,553,2,2,"P.P.",336
19,"19240",64,47,46,1,1,"P.P.",28
16,"16022",102,76,76,2,0,"P.P.",36
24,"24091",704,502,496,8,6,"P.P.",294
3,"3028",1049,903,895,6,8,"P.P.",466
49,"49225",172,130,129,0,1,"P.P.",89
16,"16023",468,332,327,3,5,"P.P.",169
47,"47215",60,52,52,2,0,"P.P.",34
3,"3029",260,191,186,0,5,"P.P.",84
45,"45049",394,315,315,6,0,"P.P.",212
13,"13017",307,230,226,0,4,"P.P.",130
14,"14013",17006,13114,12958,166,156,"P.P.",5770
16,"16024",134,92,91,1,1,"P.P.",44
49,"49226",279,235,233,1,2,"P.P.",136
33,"33009",951,673,663,7,10,"P.P.",255
37,"37348",114,91,90,1,1,"P.P.",73
24,"24214",716,518,509,4,9,"P.P.",281
49,"49227",295,238,237,5,1,"P.P.",142
37,"37236",163,123,119,4,4,"P.P.",88
5,"5090",72,64,63,1,1,"P.P.",35
37,"37001",224,182,181,0,1,"P.P.",111
3,"3030",522,464,453,6,11,"P.P.",183
13,"13018",860,740,727,2,13,"P.P.",302
39,"39090",731,577,572,3,5,"P.P.",297
35,"35006",29515,20731,20286,362,445,"P.P.",9395
9,"9360",37,29,29,0,0,"P.P.",20
49,"49228",64,56,56,0,0,"P.P.",47
24,"24093",388,262,258,1,4,"P.P.",154
41,"41089",6394,4593,4526,57,67,"P.P.",1373
37,"37002",152,90,89,1,1,"P.P.",48
19,"19032",202,11,11,0,0,"P.P.",8
16,"16025",31,23,23,0,0,"P.P.",18
3,"3133",40056,25746,25554,231,192,"P.P.",15099
18,"18140",42971,28391,28126,335,265,"P.P.",13758
49,"49229",134,99,99,2,0,"P.P.",58
9,"9361",134,99,98,0,1,"P.P.",75
3,"3031",39966,27099,26802,291,297,"P.P.",15255
9,"9091",746,556,550,8,6,"P.P.",377
33,"33010",1922,1284,1277,14,7,"P.P.",429
37,"37238",102,77,76,0,1,"P.P.",34
9,"9362",219,185,184,2,1,"P.P.",96
46,"46044",4301,3284,3169,50,115,"P.P.",1471
42,"42089",54,44,44,3,0,"P.P.",16
24,"24217",144,108,107,2,1,"P.P.",70
35,"35007",569,392,391,2,1,"P.P.",135
24,"24095",293,211,208,1,3,"P.P.",164
47,"47218",983,776,767,7,9,"P.P.",329
42,"42090",96,75,74,3,1,"P.P.",49
9,"9226",74,57,57,0,0,"P.P.",39
49,"49230",122,98,95,1,3,"P.P.",52
18,"18141",484,326,325,1,1,"P.P.",238
13,"13021",459,358,355,5,3,"P.P.",208
9,"9227",131,100,100,1,0,"P.P.",56
3,"3033",127,102,97,2,5,"P.P.",55
3,"3135",228,185,181,0,4,"P.P.",58
49,"49231",360,256,254,4,2,"P.P.",166
46,"46045",1288,1065,1044,2,21,"P.P.",507
19,"19245",1222,954,943,10,11,"P.P.",537
24,"24096",145,96,93,0,3,"P.P.",59
39,"39093",351,260,253,2,7,"P.P.",140
49,"49232",95,78,78,1,0,"P.P.",46
3,"3034",1343,1140,1126,5,14,"P.P.",712
18,"18143",949,722,704,2,18,"P.P.",241
24,"24219",580,435,431,10,4,"P.P.",244
13,"13022",403,314,314,2,0,"P.P.",166
37,"37241",172,135,134,1,1,"P.P.",105
18,"18144",779,592,590,3,2,"P.P.",295
12,"12072",1191,1007,977,17,30,"P.P.",475
5,"5095",301,253,250,2,3,"P.P.",160
35,"35009",19678,13799,13442,155,357,"P.P.",7030
40,"40126",96,80,78,0,2,"P.P.",59
46,"46047",551,479,469,10,10,"P.P.",211
13,"13023",8731,6818,6732,94,86,"P.P.",5086
9,"9366",99,67,65,1,2,"P.P.",38
9,"9229",213,163,163,1,0,"P.P.",88
5,"5096",74,56,56,0,0,"P.P.",21
19,"19247",171,125,118,6,7,"P.P.",52
49,"49234",439,336,332,5,4,"P.P.",183
3,"3035",672,560,550,0,10,"P.P.",257
18,"18145",10083,7592,7499,78,93,"P.P.",3906
37,"37007",467,368,363,6,5,"P.P.",210
33,"33013",466,349,345,4,4,"P.P.",106
35,"35010",3565,2178,2135,26,43,"P.P.",782
3,"3036",84,72,72,0,0,"P.P.",38
24,"24099",199,164,162,0,2,"P.P.",85
47,"47221",115,102,102,0,0,"P.P.",72
37,"37355",187,142,140,2,2,"P.P.",89
9,"9274",1160,924,914,14,10,"P.P.",500
37,"37243",123,89,88,1,1,"P.P.",77
24,"24100",760,563,553,14,10,"P.P.",331
49,"49235",486,344,340,6,4,"P.P.",167
3,"3139",21796,15501,15320,160,181,"P.P.",8764
39,"39096",719,521,518,4,3,"P.P.",312
3,"3037",354,293,289,1,4,"P.P.",128
18,"18146",1059,791,776,2,15,"P.P.",284
13,"13025",321,257,254,1,3,"P.P.",148
35,"35011",23140,15550,15320,199,230,"P.P.",8508
49,"49236",86,64,64,0,0,"P.P.",45
19,"19249",38,32,32,0,0,"P.P.",23
9,"9231",77,42,42,0,0,"P.P.",24
5,"5099",555,472,466,4,6,"P.P.",261
3,"3038",338,294,291,2,3,"P.P.",158
49,"49237",157,110,110,0,0,"P.P.",69
9,"9232",182,146,146,1,0,"P.P.",81
5,"5194",147,131,130,4,1,"P.P.",83
33,"33015",1695,1177,1161,12,16,"P.P.",356
46,"46049",292,249,245,0,4,"P.P.",156
14,"14022",4077,3147,3102,20,45,"P.P.",594
46,"46122",2737,2154,2131,18,23,"P.P.",933
34,"34052",187,147,147,1,0,"P.P.",104
5,"5100",307,245,245,2,0,"P.P.",147
16,"16035",287,216,213,2,3,"P.P.",91
15,"15035",11969,8239,8120,192,119,"P.P.",3147
3,"3039",92,70,66,1,4,"P.P.",28
13,"13027",3582,2770,2715,25,55,"P.P.",1570
35,"35012",9662,5511,5446,45,65,"P.P.",3493
19,"19250",25,23,22,0,1,"P.P.",13
49,"49238",289,233,231,3,2,"P.P.",135
7,"7003",10671,6262,6149,79,113,"P.P.",3134
18,"18148",874,714,706,6,8,"P.P.",377
35,"35013",6779,5059,4961,105,98,"P.P.",3181
49,"49239",723,506,495,12,11,"P.P.",234
5,"5101",297,224,222,4,2,"P.P.",178
46,"46050",161,126,123,1,3,"P.P.",46
37,"37012",155,124,120,1,4,"P.P.",89
46,"46123",1808,1440,1410,7,30,"P.P.",741
39,"39098",1522,1256,1244,8,12,"P.P.",670
3,"3040",260,224,220,0,4,"P.P.",120
18,"18149",5096,3949,3900,36,49,"P.P.",2137
13,"13028",10536,8503,8331,140,172,"P.P.",4876
37,"37248",160,130,130,1,0,"P.P.",97
9,"9236",41,38,37,0,1,"P.P.",36
49,"49240",237,190,186,1,4,"P.P.",131
24,"24104",291,198,196,3,2,"P.P.",118
19,"19042",41,32,32,0,0,"P.P.",12
49,"49241",275,225,221,2,4,"P.P.",168
46,"46051",8122,6432,6378,57,54,"P.P.",4018
24,"24228",732,543,529,4,14,"P.P.",369
46,"46124",768,641,632,10,9,"P.P.",308
35,"35014",9943,5438,5316,95,122,"P.P.",2681
37,"37013",133,93,85,5,8,"P.P.",60
16,"16163",75,57,57,0,0,"P.P.",24
3,"3042",1337,1028,1019,8,9,"P.P.",441
5,"5103",84,68,68,3,0,"P.P.",47
18,"18150",6452,4666,4625,56,41,"P.P.",1864
49,"49242",503,421,410,5,11,"P.P.",270
24,"24106",340,229,228,6,1,"P.P.",153
14,"14025",3061,2547,2517,13,30,"P.P.",604
9,"9377",658,509,505,11,4,"P.P.",343
37,"37250",405,277,274,1,3,"P.P.",167
13,"13030",153,123,123,1,0,"P.P.",60
19,"19254",57,50,50,0,0,"P.P.",36
16,"16040",97,76,75,1,1,"P.P.",59
46,"46052",532,471,463,2,8,"P.P.",243
42,"42108",13,10,10,1,0,"P.P.",8
7,"7006",4964,3234,3157,51,77,"P.P.",1222
49,"49243",117,85,85,0,0,"P.P.",57
3,"3043",2933,2494,2447,27,47,"P.P.",1163
35,"35016",291589,181013,177964,2856,3049,"P.P.",90946
7,"7007",454,304,300,4,4,"P.P.",119
18,"18183",685,502,500,3,2,"P.P.",205
5,"5104",35,29,29,0,0,"P.P.",28
18,"18151",276,191,188,0,3,"P.P.",52
37,"37016",539,424,420,8,4,"P.P.",264
13,"13032",1218,926,922,9,4,"P.P.",434
3,"3044",4459,3798,3753,21,45,"P.P.",2544
4,"4002",1146,891,884,1,7,"P.P.",361
24,"24108",421,316,314,6,2,"P.P.",206
46,"46053",584,484,461,2,23,"P.P.",193
9,"9242",93,82,82,2,0,"P.P.",58
49,"49244",48,30,30,1,0,"P.P.",19
35,"35017",22331,13463,13144,217,319,"P.P.",6319
49,"49245",296,218,218,2,0,"P.P.",129
3,"3045",233,204,203,2,1,"P.P.",107
4,"4003",17244,11933,11840,94,93,"P.P.",7722
24,"24109",1098,672,663,12,9,"P.P.",319
7,"7008",5422,3782,3705,61,77,"P.P.",1814
40,"40140",100,74,73,1,1,"P.P.",46
13,"13033",1719,1436,1419,6,17,"P.P.",529
16,"16043",105,86,86,1,0,"P.P.",60
18,"18152",1037,822,818,9,4,"P.P.",199
4,"4004",458,367,364,6,3,"P.P.",130
35,"35018",11652,6488,6367,107,121,"P.P.",2694
49,"49246",248,212,210,1,2,"P.P.",153
40,"40141",881,658,647,9,11,"P.P.",413
5,"5106",39,26,26,0,0,"P.P.",24
13,"13034",56981,42819,42306,742,513,"P.P.",24946
29,"29002",1246,896,893,11,3,"P.P.",385
37,"37018",128,89,87,0,2,"P.P.",64
5,"5107",74,54,53,0,1,"P.P.",39
3,"3046",1530,1136,1121,11,15,"P.P.",648
5,"5204",654,521,516,7,5,"P.P.",324
4,"4005",631,531,524,6,7,"P.P.",282
9,"9244",53,44,44,0,0,"P.P.",30
24,"24112",323,230,228,0,2,"P.P.",76
49,"49247",507,340,332,6,8,"P.P.",232
11,"11030",22528,14741,14557,195,184,"P.P.",7827
45,"45069",1791,1409,1389,8,20,"P.P.",793
41,"41091",545464,388043,383816,5325,4227,"P.P.",169938
29,"29003",1133,902,900,5,2,"P.P.",272
14,"14030",8519,6832,6753,64,79,"P.P.",2192
3,"3047",8867,6219,6113,76,106,"P.P.",3204
9,"9384",310,223,218,3,5,"P.P.",151
5,"5005",199,170,169,1,1,"P.P.",118
37,"37256",245,191,190,2,1,"P.P.",112
40,"40003",144,123,120,1,3,"P.P.",102
9,"9246",662,469,457,3,12,"P.P.",282
16,"16046",262,191,191,1,0,"P.P.",109
18,"18154",1062,770,769,0,1,"P.P.",414
35,"35019",30279,17607,17380,158,227,"P.P.",9274
46,"46129",553,430,423,4,7,"P.P.",138
3,"3048",4747,3878,3817,16,61,"P.P.",2522
24,"24113",404,318,310,3,8,"P.P.",207
42,"42117",146,115,111,1,4,"P.P.",75
41,"41092",7649,5816,5738,39,78,"P.P.",1557
37,"37257",52,43,43,0,0,"P.P.",28
37,"37369",143,103,103,0,0,"P.P.",72
18,"18157",1062,793,783,9,10,"P.P.",413
13,"13037",901,752,745,2,7,"P.P.",377
35,"35020",6142,4227,4192,24,35,"P.P.",1483
49,"49250",1330,998,985,19,13,"P.P.",581
5,"5109",438,359,351,5,8,"P.P.",214
46,"46057",483,357,349,9,8,"P.P.",221
9,"9115",96,71,70,4,1,"P.P.",51
3,"3049",12150,10039,9892,88,147,"P.P.",6482
37,"37370",345,261,260,1,1,"P.P.",199
24,"24115",54654,38629,38010,716,619,"P.P.",18584
9,"9248",63,52,52,0,0,"P.P.",27
40,"40146",270,222,222,0,0,"P.P.",123
49,"49251",191,157,154,7,3,"P.P.",81
18,"18158",10328,7336,7254,69,82,"P.P.",2024
46,"46257",5579,4546,4512,32,34,"P.P.",2235
7,"7013",6525,4528,4409,78,119,"P.P.",2812
49,"49252",370,310,305,6,5,"P.P.",165
14,"14033",1289,974,958,18,16,"P.P.",363
35,"35021",14982,9948,9749,138,199,"P.P.",5355
29,"29006",721,516,508,5,8,"P.P.",214
46,"46058",1787,1460,1441,10,19,"P.P.",679
5,"5112",125,88,87,0,1,"P.P.",56
35,"35022",43892,27289,26876,326,413,"P.P.",13381
3,"3051",356,314,311,2,3,"P.P.",161
13,"13039",14349,10928,10776,149,152,"P.P.",6133
24,"24117",493,376,369,2,7,"P.P.",293
33,"33023",3410,2501,2485,40,16,"P.P.",1064
7,"7015",20783,12244,12016,381,228,"P.P.",6095
29,"29081",290,226,226,3,0,"P.P.",98
46,"46258",2792,2196,2164,14,32,"P.P.",1156
37,"37260",175,122,122,1,0,"P.P.",69
49,"49119",245,194,191,2,3,"P.P.",87
49,"49255",455,372,367,1,5,"P.P.",251
18,"18159",1051,873,869,4,4,"P.P.",186
9,"9250",295,234,230,5,4,"P.P.",119
24,"24118",132,96,96,2,0,"P.P.",30
41,"41094",6089,4757,4680,47,77,"P.P.",1883
41,"41095",40097,27969,27731,354,238,"P.P.",9641
26,"26014",472,358,353,6,5,"P.P.",149
35,"35023",11640,8412,8178,97,234,"P.P.",4278
49,"49256",289,229,224,3,5,"P.P.",149
40,"40009",49,41,41,0,0,"P.P.",28
37,"37026",201,176,176,3,0,"P.P.",100
3,"3052",984,837,820,10,17,"P.P.",530
49,"49257",277,180,179,0,1,"P.P.",94
14,"14035",6153,4715,4656,51,59,"P.P.",2479
19,"19264",45,39,39,0,0,"P.P.",22
46,"46260",2576,2140,2106,24,34,"P.P.",1023
18,"18161",220,180,178,0,2,"P.P.",80
29,"29008",14069,9934,9859,118,75,"P.P.",5692
37,"37262",81,66,64,2,2,"P.P.",57
35,"35024",12420,6978,6819,131,159,"P.P.",2651
13,"13041",298,225,225,1,0,"P.P.",91
3,"3053",7082,5754,5664,60,90,"P.P.",3488
46,"46060",9510,7506,7408,52,98,"P.P.",4166
29,"29009",1525,1126,1109,9,17,"P.P.",220
37,"37068",386,291,287,6,4,"P.P.",202
3,"3054",371,321,315,2,6,"P.P.",198
13,"13042",953,704,693,5,11,"P.P.",385
49,"49258",127,107,104,0,3,"P.P.",61
16,"16053",414,334,326,2,8,"P.P.",133
9,"9392",51,42,42,1,0,"P.P.",15
49,"49259",121,88,87,1,1,"P.P.",67
47,"47073",141,118,116,1,2,"P.P.",88
19,"19265",157,102,101,0,1,"P.P.",80
5,"5116",131,114,109,0,5,"P.P.",93
41,"41097",3096,2489,2451,21,38,"P.P.",798
9,"9255",90,68,68,0,0,"P.P.",47
40,"40013",67,56,54,1,2,"P.P.",50
46,"46061",331,276,273,3,3,"P.P.",162
9,"9256",369,254,252,2,2,"P.P.",161
18,"18163",327,246,238,0,8,"P.P.",119
3,"3055",5128,4121,4076,43,45,"P.P.",2865
24,"24121",645,511,502,10,9,"P.P.",261
29,"29010",1703,1411,1377,7,34,"P.P.",437
49,"49260",814,653,644,6,9,"P.P.",386
24,"24122",1424,1001,992,9,9,"P.P.",575
5,"5117",213,183,180,0,3,"P.P.",138
3,"3056",8929,6927,6776,74,151,"P.P.",3363
35,"35026",78933,49860,48955,780,905,"P.P.",27528
13,"13044",2747,1996,1950,20,46,"P.P.",1103
41,"41098",4650,3665,3603,43,62,"P.P.",1707
9,"9257",93,73,72,2,1,"P.P.",58
14,"14038",31501,23683,23394,336,289,"P.P.",12249
29,"29011",3013,1893,1876,7,17,"P.P.",683
4,"4015",149,115,115,0,0,"P.P.",62
47,"47075",4999,4020,3957,39,63,"P.P.",2647
18,"18902",950,769,762,6,7,"P.P.",299
19,"19057",79,56,56,0,0,"P.P.",14
46,"46262",228,161,158,0,3,"P.P.",100
18,"18164",1881,1351,1342,16,9,"P.P.",689
26,"26147",34,29,29,2,0,"P.P.",12
24,"24123",835,559,555,6,4,"P.P.",284
49,"49262",401,317,313,1,4,"P.P.",190
3,"3057",232,179,178,0,1,"P.P.",100
41,"41099",4141,2818,2799,37,19,"P.P.",1061
4,"4016",2184,1699,1677,15,22,"P.P.",988
49,"49263",69,54,54,2,0,"P.P.",45
19,"19058",6455,5028,4933,63,95,"P.P.",2564
9,"9258",190,159,159,5,0,"P.P.",111
5,"5118",91,66,66,0,0,"P.P.",52
16,"16189",263,213,211,2,2,"P.P.",158
29,"29012",9817,7063,6991,51,72,"P.P.",2770
35,"35027",10510,7523,7375,88,148,"P.P.",4134
18,"18165",3942,2819,2776,27,43,"P.P.",1118
3,"3058",4798,4126,4103,26,23,"P.P.",2972
29,"29013",1718,1302,1283,4,19,"P.P.",363
7,"7022",11700,7512,7371,128,141,"P.P.",3844
42,"42132",159,132,127,4,5,"P.P.",83
5,"5215",186,138,136,1,2,"P.P.",94
37,"37380",57,45,44,1,1,"P.P.",23
49,"49264",652,439,435,2,4,"P.P.",312
37,"37033",86,64,63,1,1,"P.P.",39
24,"24125",545,374,373,5,1,"P.P.",232
18,"18167",1927,1397,1380,13,17,"P.P.",497
3,"3059",20261,15951,15825,82,126,"P.P.",9825
40,"40160",120,94,92,2,2,"P.P.",78
33,"33029",420,243,241,3,2,"P.P.",77
35,"35028",8810,4687,4603,71,84,"P.P.",2379
16,"16061",1035,861,848,15,13,"P.P.",437
18,"18168",864,613,605,4,8,"P.P.",298
19,"19060",165,127,121,3,6,"P.P.",42
37,"37269",475,383,382,2,1,"P.P.",203
42,"42134",2626,1945,1896,36,49,"P.P.",1014
24,"24127",327,258,255,1,3,"P.P.",179
5,"5120",38,28,28,1,0,"P.P.",18
35,"35029",3981,2341,2315,43,26,"P.P.",827
24,"24129",125,88,86,5,2,"P.P.",46
3,"3060",124,100,98,0,2,"P.P.",36
46,"46065",1606,1250,1234,15,16,"P.P.",660
37,"37034",91,72,72,0,0,"P.P.",29
15,"15054",32172,20472,20154,519,318,"P.P.",9853
3,"3061",1052,842,836,6,6,"P.P.",608
18,"18170",377,238,237,0,1,"P.P.",91
29,"29015",31805,22566,22347,272,219,"P.P.",11063
37,"37270",201,159,158,0,1,"P.P.",120
24,"24130",468,343,337,6,6,"P.P.",199
37,"37271",393,324,318,5,6,"P.P.",215
19,"19061",76,57,55,3,2,"P.P.",33
16,"16063",97,81,81,0,0,"P.P.",58
49,"49267",101,77,77,1,0,"P.P.",47
49,"49268",480,365,362,8,3,"P.P.",280
5,"5122",156,124,124,0,0,"P.P.",80
35,"35030",8295,5433,5315,54,118,"P.P.",2361
3,"3062",206,175,175,0,0,"P.P.",105
40,"40021",33,32,32,0,0,"P.P.",19
19,"19064",97,84,83,1,1,"P.P.",58
35,"35031",6968,4927,4862,71,65,"P.P.",2830
41,"41102",14343,11050,10837,206,213,"P.P.",3725
18,"18171",2093,1719,1704,10,15,"P.P.",517
37,"37272",162,121,120,1,1,"P.P.",68
19,"19274",881,652,644,8,8,"P.P.",316
49,"49269",241,171,170,5,1,"P.P.",116
13,"13051",358,291,289,5,2,"P.P.",156
16,"16195",545,436,433,6,3,"P.P.",181
24,"24132",683,440,435,5,5,"P.P.",249
38,"38003",1446,1053,1044,4,9,"P.P.",490
3,"3063",25410,18205,17989,208,216,"P.P.",8756
37,"37273",115,83,83,1,0,"P.P.",66
46,"46067",1798,1487,1472,10,15,"P.P.",853
29,"29017",6766,5162,5114,48,48,"P.P.",1642
35,"35032",3432,2605,2548,37,57,"P.P.",1572
49,"49270",156,112,112,6,0,"P.P.",48
47,"47001",51,44,42,2,2,"P.P.",30
41,"41902",4682,3136,3101,34,35,"P.P.",1061
9,"9267",135,118,118,3,0,"P.P.",92
40,"40025",158,124,124,0,0,"P.P.",94
19,"19277",22,17,17,0,0,"P.P.",8
26,"26029",33,25,24,1,1,"P.P.",14
24,"24133",379,279,279,0,0,"P.P.",166
13,"13052",6580,4869,4786,76,83,"P.P.",2990
16,"16196",658,578,568,6,10,"P.P.",255
46,"46068",326,292,285,3,7,"P.P.",141
37,"37274",123032,90819,89629,1506,1190,"P.P.",51982
3,"3064",4976,4098,4058,26,40,"P.P.",2744
7,"7028",876,607,595,6,12,"P.P.",272
29,"29018",2088,1565,1540,9,25,"P.P.",582
24,"24134",3682,2636,2588,44,48,"P.P.",1071
3,"3065",164772,124457,123236,1556,1221,"P.P.",67268
41,"41903",6653,5134,5070,61,64,"P.P.",1723
47,"47082",816,664,661,10,3,"P.P.",421
9,"9013",48,41,41,1,0,"P.P.",25
37,"37275",136,98,98,0,0,"P.P.",44
19,"19067",91,59,59,0,0,"P.P.",23
35,"35033",6415,4394,4302,51,92,"P.P.",2476
9,"9269",39,33,33,0,0,"P.P.",23
49,"49273",217,144,144,0,0,"P.P.",109
24,"24136",596,465,463,12,2,"P.P.",300
18,"18174",470,368,363,1,5,"P.P.",166
9,"9270",180,147,143,2,4,"P.P.",101
37,"37276",188,136,135,0,1,"P.P.",100
46,"46069",166,149,148,1,1,"P.P.",73
3,"3066",42697,31279,30833,566,446,"P.P.",15461
13,"13054",5032,3901,3824,70,77,"P.P.",2307
5,"5126",78,70,70,0,0,"P.P.",53
19,"19279",66,56,56,0,0,"P.P.",39
29,"29019",908,720,714,0,6,"P.P.",275
14,"14048",1244,975,970,5,5,"P.P.",257
49,"49275",53766,37940,37379,774,561,"P.P.",19977
35,"35034",6372,2951,2921,33,30,"P.P.",1449
3,"3067",94,81,79,1,2,"P.P.",45
18,"18175",11534,8772,8698,68,74,"P.P.",3980
37,"37042",45,35,35,1,0,"P.P.",31
46,"46070",15946,11979,11874,113,105,"P.P.",6667
5,"5127",715,601,596,4,5,"P.P.",376
29,"29020",3188,2448,2424,30,24,"P.P.",740
47,"47004",1261,1047,1031,11,16,"P.P.",527
42,"42003",76,54,51,0,3,"P.P.",39
46,"46071",488,418,402,10,16,"P.P.",208
18,"18176",265,183,181,0,2,"P.P.",36
36,"36001",3138,2060,2049,13,11,"P.P.",1253
47,"47005",578,467,455,5,12,"P.P.",267
42,"42004",2383,1776,1740,30,36,"P.P.",1106
13,"13056",10945,8173,8070,111,103,"P.P.",4051
19,"19281",25,24,22,3,2,"P.P.",7
19,"19073",24,20,19,0,1,"P.P.",11
29,"29095",3431,2660,2607,23,53,"P.P.",865
9,"9273",55,47,47,0,0,"P.P.",32
3,"3068",48,45,45,1,0,"P.P.",39
18,"18177",463,285,281,4,4,"P.P.",141
13,"13057",1214,1018,998,9,20,"P.P.",591
40,"40032",394,293,288,6,5,"P.P.",195
37,"37045",27,21,21,0,0,"P.P.",15
36,"36002",3154,2381,2358,35,23,"P.P.",1451
14,"14050",2418,1983,1966,23,17,"P.P.",802
24,"24142",24843,17695,17371,409,324,"P.P.",7600
3,"3069",2830,2009,1979,22,30,"P.P.",1142
36,"36036",2616,1981,1948,24,33,"P.P.",1208
42,"42007",143,110,110,2,0,"P.P.",67
5,"5129",153,98,95,0,3,"P.P.",88
47,"47085",16967,12618,12472,208,146,"P.P.",6710
18,"18178",834,685,683,3,2,"P.P.",320
29,"29096",2880,2012,1971,28,41,"P.P.",591
3,"3070",1962,1582,1552,8,30,"P.P.",978
36,"36003",9876,7155,7007,100,148,"P.P.",3990
13,"13058",4155,3320,3285,24,35,"P.P.",1821
42,"42008",69,50,50,0,0,"P.P.",39
16,"16074",53,42,42,1,0,"P.P.",22
12,"12006",185,160,153,0,7,"P.P.",75
37,"37281",36,34,33,0,1,"P.P.",11
29,"29023",1661,1080,1074,15,6,"P.P.",698
24,"24143",515,376,373,6,3,"P.P.",190
3,"3071",3993,3180,3128,40,52,"P.P.",1744
46,"46073",1119,931,915,14,16,"P.P.",433
19,"19283",40,33,33,0,0,"P.P.",17
42,"42155",188,121,120,0,1,"P.P.",89
36,"36004",10264,7383,7263,80,120,"P.P.",3738
13,"13059",232,186,184,0,2,"P.P.",94
9,"9276",420,275,245,5,30,"P.P.",84
37,"37282",238,169,168,3,1,"P.P.",117
36,"36005",8231,5985,5873,84,112,"P.P.",3025
42,"42009",97,69,67,2,2,"P.P.",52
46,"46244",57805,41885,41595,415,290,"P.P.",22706
24,"24182",448,339,333,9,6,"P.P.",197
5,"5228",193,146,145,1,1,"P.P.",132
42,"42010",19,15,15,1,0,"P.P.",12
3,"3072",331,284,277,2,7,"P.P.",125
9,"9021",62,33,33,1,0,"P.P.",20
24,"24145",656,420,420,11,0,"P.P.",197
29,"29024",414,271,261,6,10,"P.P.",113
37,"37283",130,104,104,1,0,"P.P.",60
38,"38012",2535,1735,1716,11,19,"P.P.",633
46,"46074",2656,2071,2053,22,18,"P.P.",1028
16,"16079",33,21,21,0,0,"P.P.",11
42,"42157",18,16,15,0,1,"P.P.",15
42,"42011",22,14,14,1,0,"P.P.",9
36,"36006",11387,8911,8727,72,184,"P.P.",5084
5,"5132",1040,770,753,2,17,"P.P.",439
19,"19285",26,20,20,2,0,"P.P.",7
24,"24146",284,223,221,0,2,"P.P.",154
19,"19078",58,49,48,0,1,"P.P.",12
29,"29025",34637,22545,22354,268,191,"P.P.",11685
3,"3073",219,199,199,0,0,"P.P.",113
42,"42012",43,29,29,1,0,"P.P.",15
36,"36007",1778,1258,1238,2,20,"P.P.",813
18,"18181",253,183,182,0,1,"P.P.",152
46,"46075",166,148,145,3,3,"P.P.",85
42,"42158",112,79,79,6,0,"P.P.",38
37,"37285",457,349,347,2,2,"P.P.",214
9,"9280",34,23,23,0,0,"P.P.",17
26,"26041",152,106,104,0,2,"P.P.",76
3,"3074",1752,1479,1466,5,13,"P.P.",1026
16,"16082",318,226,226,1,0,"P.P.",119
36,"36008",21702,15366,15037,261,329,"P.P.",6717
19,"19188",72,48,48,1,0,"P.P.",36
29,"29026",1130,815,799,7,16,"P.P.",314
16,"16213",39,32,32,1,0,"P.P.",14
7,"7038",1962,1504,1480,20,24,"P.P.",685
29,"29027",2416,1907,1893,15,14,"P.P.",954
42,"42013",45,35,34,1,1,"P.P.",20
3,"3075",160,139,136,2,3,"P.P.",82
24,"24149",149,120,118,3,2,"P.P.",78
42,"42014",83,55,55,1,0,"P.P.",34
29,"29901",41445,27372,27158,295,214,"P.P.",15263
13,"13063",3839,2801,2771,31,30,"P.P.",1595
38,"38015",4326,3132,3099,21,33,"P.P.",1334
23,"23004",478,416,415,1,1,"P.P.",256
16,"16084",49,36,35,0,1,"P.P.",17
40,"40041",1035,819,799,14,20,"P.P.",463
13,"13064",1465,1127,1110,21,17,"P.P.",589
37,"37287",341,247,246,1,1,"P.P.",175
3,"3076",8373,6319,6222,68,97,"P.P.",3700
47,"47011",600,493,489,4,4,"P.P.",330
24,"24150",262,182,182,3,0,"P.P.",115
36,"36010",2987,2312,2282,30,30,"P.P.",1063
42,"42058",129,103,101,1,2,"P.P.",77
13,"13065",3011,2105,2088,24,17,"P.P.",1349
15,"15067",8142,6054,5978,73,76,"P.P.",2928
16,"16216",358,300,296,2,4,"P.P.",146
3,"3077",1411,1146,1130,14,16,"P.P.",692
42,"42016",25,13,13,0,0,"P.P.",10
46,"46077",7637,5979,5845,64,134,"P.P.",2320
9,"9287",201,159,158,4,1,"P.P.",76
47,"47012",134,105,105,0,0,"P.P.",68
46,"46150",1898,1555,1541,8,14,"P.P.",882
33,"33041",7488,5356,5309,65,47,"P.P.",2305
18,"18184",2140,1663,1645,18,18,"P.P.",708
19,"19290",872,622,613,7,9,"P.P.",343
14,"14058",8116,6274,6215,76,59,"P.P.",2787
24,"24152",481,326,322,5,4,"P.P.",237
3,"3078",528,424,423,2,1,"P.P.",303
9,"9027",54,48,43,0,5,"P.P.",16
9,"9423",34,28,28,1,0,"P.P.",20
12,"12113",100,72,72,0,0,"P.P.",48
9,"9288",98,80,80,1,0,"P.P.",61
40,"40186",50,33,33,0,0,"P.P.",24
42,"42018",178,129,124,0,5,"P.P.",97
12,"12114",228,178,173,2,5,"P.P.",86
5,"5138",326,278,275,2,3,"P.P.",207
47,"47013",118,97,97,2,0,"P.P.",37
39,"39050",305,207,205,1,2,"P.P.",138
7,"7042",10393,6536,6421,96,115,"P.P.",2568
18,"18185",608,484,479,2,5,"P.P.",230
4,"4038",3140,2258,2231,44,27,"P.P.",1057
24,"24153",253,201,199,4,2,"P.P.",106
42,"42165",424,291,280,6,11,"P.P.",155
14,"14059",713,572,567,5,5,"P.P.",278
7,"7043",3522,2384,2345,35,39,"P.P.",1287
19,"19192",1743,1370,1359,10,11,"P.P.",902
9,"9289",1540,1127,1117,16,10,"P.P.",678
3,"3079",18028,14580,14317,189,263,"P.P.",7844
24,"24154",1068,803,795,6,8,"P.P.",444
38,"38020",14520,9396,9202,121,194,"P.P.",3964
14,"14060",4843,3857,3787,47,70,"P.P.",1293
3,"3080",1288,1116,1103,6,13,"P.P.",812
37,"37059",132,110,110,2,0,"P.P.",62
16,"16224",96,69,69,0,0,"P.P.",40
9,"9292",98,73,71,3,2,"P.P.",36
19,"19293",1860,1407,1373,16,34,"P.P.",702
7,"7044",8326,6044,5846,99,198,"P.P.",3475
12,"12116",56,45,45,0,0,"P.P.",36
29,"29031",1652,1123,1118,11,5,"P.P.",233
15,"15071",8233,5751,5668,93,83,"P.P.",3156
24,"24155",524,428,420,6,8,"P.P.",208
9,"9427",1561,1090,1078,18,12,"P.P.",783
24,"24156",264,187,186,6,1,"P.P.",119
3,"3081",1409,1102,1087,14,15,"P.P.",526
18,"18188",1659,1329,1308,9,21,"P.P.",484
33,"33044",180964,129466,128346,1888,1120,"P.P.",52515
14,"14061",841,700,693,3,7,"P.P.",258
29,"29032",6673,5204,5140,43,64,"P.P.",1683
36,"36015",4379,3151,3101,38,50,"P.P.",1678
46,"46081",10254,8188,8101,52,87,"P.P.",4687
37,"37293",131,108,106,5,2,"P.P.",68
5,"5141",99,90,89,0,1,"P.P.",60
19,"19294",27,26,26,1,0,"P.P.",14
16,"16227",128,95,94,0,1,"P.P.",58
13,"13070",769,653,640,1,13,"P.P.",352
3,"3082",11741,8208,8102,80,106,"P.P.",4508
19,"19090",107,87,86,0,1,"P.P.",35
9,"9295",78,54,53,0,1,"P.P.",43
37,"37294",11233,8282,8167,139,115,"P.P.",4667
36,"36016",1373,865,853,7,12,"P.P.",684
46,"46082",4661,3447,3401,46,46,"P.P.",1681
19,"19296",43,31,30,1,1,"P.P.",25
3,"3083",5708,4267,4196,66,71,"P.P.",1949
29,"29033",1385,878,868,4,10,"P.P.",312
24,"24158",333,223,223,6,0,"P.P.",138
18,"18189",723,547,541,6,6,"P.P.",240
42,"42023",78,58,58,1,0,"P.P.",45
42,"42024",95,80,73,1,7,"P.P.",42
38,"38023",118865,76393,75039,928,1354,"P.P.",29888
37,"37296",385,311,308,3,3,"P.P.",155
36,"36017",18554,13573,13378,200,195,"P.P.",7764
19,"19297",34,29,29,0,0,"P.P.",21
13,"13072",803,638,633,13,5,"P.P.",377
3,"3084",593,518,513,2,5,"P.P.",268
9,"9035",336,255,251,3,4,"P.P.",122
37,"37297",441,376,369,1,7,"P.P.",235
24,"24159",1901,1492,1477,11,15,"P.P.",1013
29,"29034",462,360,357,0,3,"P.P.",213
16,"16094",142,112,111,1,1,"P.P.",79
42,"42025",1305,964,945,15,19,"P.P.",503
18,"18192",1581,1331,1318,6,13,"P.P.",491
36,"36018",3492,2516,2494,25,22,"P.P.",1624
19,"19298",75,53,52,2,1,"P.P.",22
26,"26054",381,298,292,2,6,"P.P.",163
16,"16095",98,68,68,0,0,"P.P.",46
47,"47097",345,291,289,7,2,"P.P.",129
46,"46083",15427,12079,11941,109,138,"P.P.",7071
13,"13073",565,459,456,2,3,"P.P.",262
47,"47018",33,30,28,2,2,"P.P.",22
42,"42026",25,16,16,0,0,"P.P.",13
37,"37298",206,144,140,1,4,"P.P.",85
3,"3085",275,218,215,2,3,"P.P.",128
9,"9036",32,27,27,2,0,"P.P.",19
36,"36019",1681,1204,1188,14,16,"P.P.",517
42,"42027",87,61,61,4,0,"P.P.",35
16,"16096",279,231,229,7,2,"P.P.",118
3,"3086",145,119,118,1,1,"P.P.",51
45,"45112",2022,1470,1423,12,47,"P.P.",755
24,"24161",307,231,228,1,3,"P.P.",161
5,"5242",692,556,553,18,3,"P.P.",450
29,"29036",670,504,499,4,5,"P.P.",146
5,"5147",174,141,135,4,6,"P.P.",104
47,"47098",607,496,492,9,4,"P.P.",274
42,"42028",62,45,43,2,2,"P.P.",25
14,"14066",5911,4515,4473,54,42,"P.P.",1635
18,"18194",2258,1656,1652,11,4,"P.P.",474
40,"40057",1522,1272,1260,19,12,"P.P.",594
42,"42073",84,53,53,0,0,"P.P.",41
37,"37300",586,430,421,6,9,"P.P.",239
13,"13075",212,161,159,1,2,"P.P.",110
3,"3088",5381,4056,3988,47,68,"P.P.",2402
24,"24162",1631,1214,1195,33,19,"P.P.",551
29,"29037",227,170,170,0,0,"P.P.",100
24,"24163",3706,2760,2714,57,46,"P.P.",1513
46,"46085",11344,8526,8426,87,100,"P.P.",4845
9,"9169",96,80,80,1,0,"P.P.",45
40,"40199",110,88,86,3,2,"P.P.",51
3,"3089",9696,7447,7302,83,145,"P.P.",4300
37,"37301",78,58,58,0,0,"P.P.",43
13,"13076",514,436,428,0,8,"P.P.",228
5,"5148",34,27,27,0,0,"P.P.",20
47,"47021",84,61,61,2,0,"P.P.",37
45,"45004",603,497,494,6,3,"P.P.",262
26,"26058",151,114,109,1,5,"P.P.",66
18,"18901",583,374,368,3,6,"P.P.",175
36,"36022",9203,6423,6226,100,197,"P.P.",2700
29,"29038",16309,10579,10494,152,85,"P.P.",4922
42,"42030",115,88,86,2,2,"P.P.",72
3,"3090",16226,12224,12116,139,108,"P.P.",6624
24,"24164",397,215,213,2,2,"P.P.",130
46,"46086",80,71,71,3,0,"P.P.",11
42,"42031",31,19,19,0,0,"P.P.",16
37,"37303",207,158,152,3,6,"P.P.",83
5,"5149",128,97,97,1,0,"P.P.",71
38,"38029",1456,732,715,4,17,"P.P.",316
30,"30010",6804,5691,5647,36,44,"P.P.",3909
7,"7053",1133,863,839,16,24,"P.P.",436
36,"36023",8522,6206,6062,64,144,"P.P.",3316
33,"33073",9341,5825,5773,69,52,"P.P.",2602
26,"26060",100,71,71,3,0,"P.P.",44
45,"45006",1524,1128,1110,13,18,"P.P.",603
29,"29039",2822,2091,2074,8,17,"P.P.",770
9,"9043",215,151,151,1,0,"P.P.",102
16,"16101",160,142,142,0,0,"P.P.",70
5,"5151",100,86,82,1,4,"P.P.",67
42,"42032",186,143,141,2,2,"P.P.",87
13,"13078",9291,7062,6993,92,69,"P.P.",3966
19,"19303",56,48,47,1,1,"P.P.",37
3,"3091",256,220,219,1,1,"P.P.",127
46,"46087",137,105,105,1,0,"P.P.",39
46,"46088",196,146,140,0,6,"P.P.",72
18,"18903",960,761,753,1,8,"P.P.",347
3,"3092",6780,5364,5269,96,95,"P.P.",2644
36,"36024",17164,12723,12500,163,223,"P.P.",8557
9,"9308",70,51,51,0,0,"P.P.",39
19,"19304",235,169,166,1,3,"P.P.",81
42,"42033",54,48,48,0,0,"P.P.",32
13,"13079",12220,9665,9502,177,163,"P.P.",4578
30,"30012",9037,7242,7142,62,100,"P.P.",3789
40,"40063",7290,5366,5171,68,195,"P.P.",2915
42,"42034",40,29,29,0,0,"P.P.",14
5,"5153",112,89,89,5,0,"P.P.",63
36,"36025",2442,1531,1516,10,15,"P.P.",1057
29,"29041",2796,1950,1921,24,29,"P.P.",726
3,"3093",19646,15399,15159,173,240,"P.P.",8129
45,"45009",588,430,422,2,8,"P.P.",279
24,"24168",493,397,391,7,6,"P.P.",239
37,"37306",316,194,192,1,2,"P.P.",142
36,"36026",20494,14048,13798,232,250,"P.P.",7549
18,"18904",858,620,612,3,8,"P.P.",220
46,"46089",2116,1653,1627,9,26,"P.P.",992
19,"19305",166,130,130,0,0,"P.P.",76
38,"38033",3987,2696,2656,23,40,"P.P.",1106
29,"29042",14047,9845,9735,118,110,"P.P.",5213
16,"16245",430,338,329,2,9,"P.P.",203
18,"18905",12975,9260,9209,155,51,"P.P.",4299
3,"3094",8442,6105,6053,70,52,"P.P.",3608
24,"24169",3205,2317,2282,33,35,"P.P.",953
19,"19306",42,31,31,1,0,"P.P.",23
40,"40068",39,32,32,0,0,"P.P.",29
46,"46090",1668,1488,1452,9,36,"P.P.",768
47,"47104",2917,2391,2357,31,34,"P.P.",1499
38,"38034",4092,3034,2983,30,51,"P.P.",1405
3,"3095",4498,3558,3517,29,41,"P.P.",1804
29,"29043",2596,1670,1647,24,23,"P.P.",715
13,"13082",25643,17973,17798,257,175,"P.P.",11491
4,"4056",144,118,118,0,0,"P.P.",67
7,"7057",7102,4702,4611,85,91,"P.P.",2479
14,"14073",3009,2246,2224,32,22,"P.P.",768
47,"47105",210,181,179,1,2,"P.P.",95
16,"16106",2839,2351,2331,10,20,"P.P.",1330
5,"5155",60,44,44,1,0,"P.P.",25
24,"24171",417,231,231,2,0,"P.P.",168
37,"37310",154,115,115,1,0,"P.P.",65
3,"3096",5863,4550,4457,57,93,"P.P.",2415
42,"42038",42,32,31,3,1,"P.P.",27
19,"19209",50,40,39,0,1,"P.P.",25
37,"37079",77,64,63,1,1,"P.P.",46
29,"29044",866,631,627,3,4,"P.P.",342
9,"9312",113,94,91,0,3,"P.P.",69
23,"23074",3039,2491,2451,29,40,"P.P.",1012
39,"39063",1018,769,762,6,7,"P.P.",389
18,"18907",1997,1627,1612,5,15,"P.P.",776
13,"13084",973,800,793,6,7,"P.P.",374
36,"36029",16178,11902,11636,148,266,"P.P.",5759
47,"47188",125,112,109,3,3,"P.P.",68
24,"24052",178,113,111,0,2,"P.P.",53
46,"46091",126,108,108,0,0,"P.P.",80
5,"5157",256,187,183,0,4,"P.P.",107
14,"14075",624,508,500,8,8,"P.P.",143
7,"7060",2534,1724,1697,30,27,"P.P.",818
33,"33055",1589,1212,1192,16,20,"P.P.",519
38,"38036",6477,4514,4422,40,92,"P.P.",1473
3,"3097",973,791,779,6,12,"P.P.",369
46,"46092",304,206,201,1,5,"P.P.",125
47,"47027",2680,2059,2024,23,35,"P.P.",999
3,"3098",526,410,400,6,10,"P.P.",166
4,"4059",1231,837,830,8,7,"P.P.",324
24,"24173",1023,757,747,4,10,"P.P.",503
36,"36030",4387,3206,3177,35,29,"P.P.",1889
13,"13085",2455,2146,2118,21,28,"P.P.",1070
5,"5254",212,186,185,2,1,"P.P.",111
18,"18908",827,669,660,7,9,"P.P.",239
42,"42042",46,35,33,1,2,"P.P.",27
49,"49178",679,469,461,9,8,"P.P.",251
42,"42193",17,10,10,0,0,"P.P.",10
13,"13086",209,167,166,0,1,"P.P.",106
36,"36031",572,484,479,5,5,"P.P.",283
29,"29046",2777,2032,2013,10,19,"P.P.",687
3,"3134",159,129,126,0,3,"P.P.",71
3,"3099",41561,32556,32248,288,308,"P.P.",21748
19,"19108",117,97,95,0,2,"P.P.",44
33,"33056",5278,3576,3540,41,36,"P.P.",1285
24,"24174",525,393,387,6,6,"P.P.",218
36,"36032",3666,2789,2755,25,34,"P.P.",1561
46,"46166",8260,6422,6324,60,98,"P.P.",3240
16,"16111",171,130,128,0,2,"P.P.",54
40,"40074",271,221,218,3,3,"P.P.",156
3,"3100",540,448,443,2,5,"P.P.",216
26,"26071",8475,6088,5964,92,124,"P.P.",3092
13,"13087",22953,16674,16376,298,298,"P.P.",8835
9,"9317",17,15,15,0,0,"P.P.",7
7,"7063",1414,1050,1030,25,20,"P.P.",573
29,"29047",1165,973,969,0,4,"P.P.",194
19,"19311",87,60,60,0,0,"P.P.",43
42,"42044",62,47,46,0,1,"P.P.",41
42,"42195",112,74,72,1,2,"P.P.",51
13,"13088",649,531,526,3,5,"P.P.",282
5,"5257",153,105,104,0,1,"P.P.",69
18,"18910",832,601,594,6,7,"P.P.",308
42,"42045",345,238,234,2,4,"P.P.",151
36,"36033",12323,9328,9150,97,178,"P.P.",4635
45,"45017",268,215,212,1,3,"P.P.",93
15,"15003",1936,1400,1382,19,18,"P.P.",954
3,"3101",4648,3694,3607,29,87,"P.P.",1602
36,"36034",3684,2686,2651,32,35,"P.P.",1492
16,"16113",3075,2363,2338,36,25,"P.P.",1375
42,"42046",55,35,35,0,0,"P.P.",16
13,"13089",1906,1610,1553,12,57,"P.P.",776
37,"37087",779,590,586,18,4,"P.P.",360
9,"9449",94,80,80,2,0,"P.P.",61
5,"5161",638,525,522,0,3,"P.P.",342
19,"19317",150,122,121,2,1,"P.P.",70
15,"15004",4891,3595,3545,61,50,"P.P.",1674
7,"7065",2061,1376,1345,29,31,"P.P.",696
3,"3102",7346,5827,5751,39,76,"P.P.",2993
33,"33058",1863,1307,1286,11,21,"P.P.",311
18,"18911",6796,4923,4867,74,56,"P.P.",2226
46,"46095",632,505,495,1,10,"P.P.",281
29,"29049",3137,2365,2352,19,13,"P.P.",602
16,"16115",60,45,45,0,0,"P.P.",28
42,"42048",78,63,62,3,1,"P.P.",40
36,"36035",14551,10675,10469,160,206,"P.P.",5766
19,"19112",68,50,50,0,0,"P.P.",36
5,"5162",107,71,71,0,0,"P.P.",44
24,"24179",331,219,214,4,5,"P.P.",116
3,"3103",288,248,243,2,5,"P.P.",110
13,"13090",1202,994,972,4,22,"P.P.",479
41,"41015",5263,3820,3752,34,68,"P.P.",1257
9,"9323",71,44,44,2,0,"P.P.",28
18,"18912",1576,1193,1185,7,8,"P.P.",418
42,"42049",141,83,81,1,2,"P.P.",62
7,"7901",642,483,470,5,13,"P.P.",283
46,"46096",320,267,267,0,0,"P.P.",151
16,"16117",1130,871,857,8,14,"P.P.",435
29,"29050",483,341,340,1,1,"P.P.",149
24,"24180",1196,868,862,22,6,"P.P.",543
42,"42050",29,20,20,1,0,"P.P.",16
21,"21003",691,540,536,7,4,"P.P.",57
29,"29051",37991,24498,24095,381,403,"P.P.",13373
37,"37319",138,94,94,1,0,"P.P.",56
13,"13092",1924,1655,1635,4,20,"P.P.",945
18,"18913",827,653,646,2,7,"P.P.",396
42,"42051",23,12,11,0,1,"P.P.",11
7,"7902",1071,734,712,22,22,"P.P.",334
4,"4066",13570,9018,8963,97,55,"P.P.",5914
30,"30022",16489,12207,12042,152,165,"P.P.",7254
40,"40081",151,109,107,2,2,"P.P.",66
42,"42202",33,15,14,1,1,"P.P.",9
3,"3105",5322,4218,4124,34,94,"P.P.",2691
36,"36038",65661,47940,47214,836,726,"P.P.",21983
13,"13093",4333,3281,3229,43,52,"P.P.",1870
19,"19001",64,56,56,1,0,"P.P.",49
37,"37358",163,143,139,0,4,"P.P.",97
47,"47060",262,220,218,1,2,"P.P.",126
16,"16119",181,130,130,0,0,"P.P.",69
42,"42052",17,10,10,0,0,"P.P.",10
9,"9327",34,34,34,0,0,"P.P.",20
29,"29052",245,151,151,0,0,"P.P.",68
47,"47115",306,248,248,2,0,"P.P.",173
4,"4068",187,137,137,1,0,"P.P.",75
47,"47034",90,65,63,0,2,"P.P.",45
42,"42053",27,26,25,1,1,"P.P.",23
3,"3106",642,542,535,3,7,"P.P.",286
19,"19115",41,26,26,1,0,"P.P.",22
19,"19002",99,77,76,0,1,"P.P.",36
46,"46172",4838,3492,3445,24,47,"P.P.",1856
24,"24183",900,571,567,10,4,"P.P.",328
3,"3107",2288,1670,1647,15,23,"P.P.",878
29,"29053",1715,1239,1221,7,18,"P.P.",624
5,"5263",175,133,131,0,2,"P.P.",98
42,"42054",20,14,14,0,0,"P.P.",3
15,"15093",4562,3314,3270,37,44,"P.P.",2020
13,"13095",94,70,70,1,0,"P.P.",57
47,"47035",956,778,768,5,10,"P.P.",463
37,"37323",549,427,418,6,9,"P.P.",292
42,"42105",54,45,45,0,0,"P.P.",42
5,"5166",235,181,178,1,3,"P.P.",140
19,"19116",16,10,10,0,0,"P.P.",6
36,"36040",2627,1938,1907,24,31,"P.P.",1084
19,"19003",50,36,35,1,1,"P.P.",7
3,"3109",2745,2332,2302,18,30,"P.P.",1318
36,"36041",13141,9405,9238,114,167,"P.P.",5131
26,"26082",121,95,95,0,0,"P.P.",58
42,"42055",183,128,127,4,1,"P.P.",71
46,"46173",1393,1156,1137,10,19,"P.P.",597
40,"40086",738,628,619,12,9,"P.P.",347
21,"21007",6088,4174,4123,57,51,"P.P.",1438
19,"19004",67,56,56,0,0,"P.P.",44
29,"29054",39904,27540,27307,240,233,"P.P.",16119
15,"15010",2009,1468,1441,24,27,"P.P.",853
42,"42056",26,23,22,1,1,"P.P.",17
12,"12045",388,301,286,2,15,"P.P.",114
29,"29055",1837,1478,1454,12,24,"P.P.",538
37,"37211",223,169,169,1,0,"P.P.",121
24,"24187",881,664,659,14,5,"P.P.",417
30,"30025",4780,3901,3874,18,27,"P.P.",2286
16,"16124",1909,1573,1555,14,18,"P.P.",846
5,"5168",3682,2846,2801,43,45,"P.P.",1878
37,"37325",102,77,77,0,0,"P.P.",47
37,"37099",104,64,62,1,2,"P.P.",49
45,"45137",1610,1057,1047,11,10,"P.P.",461
42,"42057",197,133,133,6,0,"P.P.",101
29,"29056",1177,807,794,3,13,"P.P.",384
19,"19005",92,80,79,0,1,"P.P.",40
24,"24188",3830,2987,2928,51,59,"P.P.",1613
41,"41020",12710,8954,8882,91,72,"P.P.",2709
26,"26084",5999,4440,4399,56,41,"P.P.",2651
19,"19006",873,634,620,1,14,"P.P.",310
3,"3112",684,566,561,4,5,"P.P.",329
36,"36043",5188,3435,3390,35,45,"P.P.",2095
40,"40089",248,183,177,3,6,"P.P.",133
19,"19326",1125,800,786,10,14,"P.P.",446
13,"13098",2265,1805,1759,19,46,"P.P.",1059
42,"42059",23,19,19,1,0,"P.P.",8
29,"29057",413,311,308,2,3,"P.P.",131
16,"16126",811,701,692,13,9,"P.P.",366
36,"36044",2595,1862,1834,23,28,"P.P.",1054
5,"5170",63,50,50,0,0,"P.P.",34
24,"24189",5410,3630,3572,83,58,"P.P.",1886
46,"46102",19880,15358,15179,122,179,"P.P.",6758
13,"13901",945,734,719,6,15,"P.P.",371
24,"24190",183,134,131,1,3,"P.P.",87
47,"47039",196,163,163,1,0,"P.P.",76
9,"9066",62,44,42,0,2,"P.P.",21
19,"19007",460,351,345,5,6,"P.P.",197
26,"26087",222,180,178,5,2,"P.P.",106
47,"47121",590,495,490,4,5,"P.P.",215
9,"9335",62,52,51,1,1,"P.P.",23
37,"37102",430,323,322,1,1,"P.P.",223
42,"42213",31,24,24,2,0,"P.P.",18
42,"42060",33,22,22,0,0,"P.P.",21
11,"11001",4389,3110,3072,13,38,"P.P.",1264
4,"4074",2731,1959,1936,26,23,"P.P.",1021
15,"15041",9718,7514,7425,102,89,"P.P.",4541
16,"16129",112,79,74,0,5,"P.P.",57
5,"5171",84,74,73,0,1,"P.P.",56
19,"19008",34,25,25,1,0,"P.P.",13
9,"9467",65,49,49,0,0,"P.P.",30
29,"29058",1560,1103,1096,5,7,"P.P.",405
3,"3114",1620,1320,1305,10,15,"P.P.",847
42,"42061",297,190,188,4,2,"P.P.",95
40,"40094",375,286,284,4,2,"P.P.",169
19,"19330",93,81,81,2,0,"P.P.",39
11,"11002",4291,3388,3374,19,14,"P.P.",332
15,"15014",4239,3151,3104,39,47,"P.P.",2065
16,"16275",15,12,12,0,0,"P.P.",6
19,"19047",87,71,70,2,1,"P.P.",30
24,"24193",371,254,252,3,2,"P.P.",132
42,"42062",36,23,22,0,1,"P.P.",11
19,"19122",96,65,65,0,0,"P.P.",41
19,"19009",253,187,184,0,3,"P.P.",105
37,"37332",78,52,49,0,3,"P.P.",42
24,"24194",327,237,236,5,1,"P.P.",51
46,"46104",2012,1691,1676,9,15,"P.P.",842
36,"36047",2723,1875,1853,27,22,"P.P.",1171
4,"4076",1325,1050,1041,7,9,"P.P.",454
3,"3116",1167,912,904,12,8,"P.P.",543
36,"36048",5416,4045,3971,55,74,"P.P.",2196
5,"5173",62,55,55,1,0,"P.P.",46
13,"13904",556,448,441,14,7,"P.P.",190
19,"19048",18,12,11,1,1,"P.P.",4
19,"19332",106,76,72,4,4,"P.P.",43
47,"47124",435,364,358,5,6,"P.P.",208
9,"9339",139,105,104,1,1,"P.P.",60
3,"3117",381,321,317,4,4,"P.P.",180
24,"24196",2183,1573,1543,11,30,"P.P.",714
29,"29060",775,573,572,1,1,"P.P.",347
14,"14001",3633,3095,3064,25,31,"P.P.",1332
42,"42065",28,24,24,0,0,"P.P.",16
46,"46106",1616,1196,1188,6,8,"P.P.",644
29,"29061",1045,861,855,7,6,"P.P.",298
45,"45034",1375,1108,1079,18,29,"P.P.",528
36,"36049",6608,5189,5097,56,92,"P.P.",2904
15,"15044",1436,1083,1068,10,15,"P.P.",625
3,"3118",2368,1746,1718,16,28,"P.P.",1181
47,"47125",55,46,46,0,0,"P.P.",35
14,"14002",10991,8444,8358,106,86,"P.P.",2406
40,"40100",303,241,231,5,10,"P.P.",160
9,"9343",94,77,76,0,1,"P.P.",61
42,"42219",45,33,33,1,0,"P.P.",20
24,"24198",644,423,417,7,6,"P.P.",137
42,"42068",99,74,74,5,0,"P.P.",56
5,"5078",128,112,111,2,1,"P.P.",81
46,"46107",1998,1650,1623,8,27,"P.P.",854
37,"37023",1040,819,811,11,8,"P.P.",493
3,"3119",15887,12128,11988,122,140,"P.P.",6344
9,"9073",889,672,663,12,9,"P.P.",345
4,"4079",45851,31893,31644,430,249,"P.P.",19793
19,"19334",50,37,37,0,0,"P.P.",19
36,"36051",14288,10228,10079,124,149,"P.P.",5924
29,"29062",647,573,571,1,2,"P.P.",255
13,"13006",641,529,519,4,10,"P.P.",277
9,"9209",4617,3269,3234,44,35,"P.P.",2101
5,"5176",237,193,190,4,3,"P.P.",101
45,"45074",428,349,343,3,6,"P.P.",208
39,"39081",440,372,369,3,3,"P.P.",269
42,"42070",45,29,28,0,1,"P.P.",10
5,"5177",164,134,133,0,1,"P.P.",72
40,"40103",157,121,120,0,1,"P.P.",67
19,"19015",104,88,87,0,1,"P.P.",53
14,"14004",2016,1560,1543,8,17,"P.P.",654
45,"45037",1730,1325,1304,15,21,"P.P.",686
37,"37110",112,89,88,1,1,"P.P.",47
29,"29063",358,272,271,2,1,"P.P.",155
19,"19016",74,50,49,0,1,"P.P.",26
39,"39082",1688,1280,1266,9,14,"P.P.",798
42,"42071",186,104,103,3,1,"P.P.",66
29,"29064",584,428,422,4,6,"P.P.",219
3,"3121",20518,14464,14315,137,149,"P.P.",8539
47,"47045",839,636,632,3,4,"P.P.",256
33,"33070",3481,2557,2521,33,36,"P.P.",1097
26,"26099",1281,1050,1025,19,25,"P.P.",576
5,"5178",392,310,304,2,6,"P.P.",222
9,"9075",126,102,101,1,1,"P.P.",69
9,"9347",136,113,109,5,4,"P.P.",71
24,"24202",8677,5486,5377,103,109,"P.P.",2094
11,"11007",17997,10781,10676,184,105,"P.P.",5289
19,"19129",48,33,31,0,2,"P.P.",23
19,"19901",43,34,34,0,0,"P.P.",21
19,"19053",2172,1602,1587,14,15,"P.P.",889
29,"29065",207,151,149,1,2,"P.P.",78
45,"45039",236,197,190,2,7,"P.P.",128
3,"3122",40476,29591,29265,341,326,"P.P.",14858
46,"46182",1190,864,855,11,9,"P.P.",399
19,"19018",189,145,138,2,7,"P.P.",106
19,"19130",58473,45114,44362,688,752,"P.P.",24337
42,"42075",91,71,70,1,1,"P.P.",44
37,"37114",92,75,74,1,1,"P.P.",43
26,"26101",46,35,34,0,1,"P.P.",18
36,"36054",10862,8201,8087,87,114,"P.P.",4586
42,"42076",237,185,179,6,6,"P.P.",95
9,"9350",502,384,376,7,8,"P.P.",284
11,"11009",636,430,424,2,6,"P.P.",215
14,"14007",15871,11609,11477,121,132,"P.P.",4402
24,"24205",995,719,712,9,7,"P.P.",447
29,"29066",363,263,260,1,3,"P.P.",136
47,"47047",217,171,170,5,1,"P.P.",131
47,"47210",396,324,321,5,3,"P.P.",182
33,"33004",69056,49228,48730,726,498,"P.P.",17298
19,"19019",23,18,18,0,0,"P.P.",8
3,"3124",482,420,415,7,5,"P.P.",189
16,"16905",1017,811,806,14,5,"P.P.",416
4,"4084",370,290,285,6,5,"P.P.",129
37,"37341",52,32,32,0,0,"P.P.",23
19,"19234",63,48,48,0,0,"P.P.",25
19,"19132",105,79,79,0,0,"P.P.",61
5,"5181",39,26,26,0,0,"P.P.",16
42,"42079",32,25,25,0,0,"P.P.",24
47,"47048",204,168,167,2,1,"P.P.",123
9,"9351",63,46,44,0,2,"P.P.",35
19,"19267",22,15,15,0,0,"P.P.",10
46,"46062",4589,3794,3752,46,42,"P.P.",2185
39,"39007",479,348,347,3,1,"P.P.",157
37,"37116",75,55,55,1,0,"P.P.",38
14,"14008",2905,2226,2200,18,26,"P.P.",1059
24,"24207",320,274,272,5,2,"P.P.",147
19,"19020",52,39,39,3,0,"P.P.",28
37,"37342",252,216,211,3,5,"P.P.",135
19,"19235",121,92,87,0,5,"P.P.",35
3,"3125",340,276,275,2,1,"P.P.",148
5,"5182",862,673,668,2,5,"P.P.",475
42,"42080",168,115,114,0,1,"P.P.",79
36,"36057",236900,168990,166060,2833,2930,"P.P.",71827
19,"19134",22,14,14,0,0,"P.P.",7
3,"3127",399,336,322,3,14,"P.P.",172
45,"45045",1313,992,979,12,13,"P.P.",543
24,"24209",3016,2006,1984,20,22,"P.P.",1041
36,"36058",5021,3589,3516,54,73,"P.P.",1630
19,"19021",1129,818,800,10,18,"P.P.",436
9,"9353",62,51,51,2,0,"P.P.",35
42,"42081",158,131,131,3,0,"P.P.",83
37,"37344",259,212,211,5,1,"P.P.",124
9,"9904",548,412,407,7,5,"P.P.",259
4,"4087",198,162,159,2,3,"P.P.",88
3,"3128",3944,2847,2812,16,35,"P.P.",1680
36,"36059",5438,3874,3805,47,69,"P.P.",2534
19,"19022",673,501,496,4,5,"P.P.",336
5,"5183",165,142,140,0,2,"P.P.",120
37,"37345",179,156,156,2,0,"P.P.",95
11,"11012",103946,68124,67375,856,749,"P.P.",32960
33,"33006",1674,1130,1120,10,10,"P.P.",301
14,"14011",595,498,497,4,1,"P.P.",259
3,"3129",1188,936,918,10,18,"P.P.",577
19,"19023",121,95,94,5,1,"P.P.",56
42,"42083",28,25,25,0,0,"P.P.",19
9,"9355",117,88,87,1,1,"P.P.",83
4,"4089",805,607,597,1,10,"P.P.",331
16,"16147",78,63,62,1,1,"P.P.",39
15,"15026",2025,1426,1413,17,13,"P.P.",941
40,"40113",438,330,322,4,8,"P.P.",136
30,"30039",18615,14213,14068,134,145,"P.P.",9101
39,"39088",70,61,61,1,0,"P.P.",16
9,"9906",1199,912,903,12,9,"P.P.",584
37,"37346",264,211,210,1,1,"P.P.",155
37,"37121",557,458,451,8,7,"P.P.",258
19,"19024",7736,5738,5646,82,92,"P.P.",2904
21,"21025",3969,2731,2686,33,45,"P.P.",1131
42,"42084",27,21,21,0,0,"P.P.",17
46,"46114",565,501,495,3,6,"P.P.",312
47,"47052",6207,4812,4761,79,51,"P.P.",2312
46,"46115",515,364,354,1,10,"P.P.",218
9,"9907",1385,1053,1041,31,12,"P.P.",529
42,"42085",219,167,167,2,0,"P.P.",134
3,"3131",181,161,157,1,4,"P.P.",86
36,"36061",8729,6747,6640,68,107,"P.P.",4452
19,"19027",185,140,138,1,2,"P.P.",68
37,"37347",481,374,371,6,3,"P.P.",215
9,"9358",261,200,199,3,1,"P.P.",144
37,"37122",210,175,174,3,1,"P.P.",81
14,"14044",1585,1279,1265,12,14,"P.P.",320
9,"9908",509,328,321,5,7,"P.P.",190
42,"42086",40,25,25,1,0,"P.P.",17
36,"36901",4085,3285,3235,21,50,"P.P.",1382
33,"33077",1351,938,931,7,7,"P.P.",519
4,"4021",188,157,157,2,0,"P.P.",73
19,"19139",32,23,23,0,0,"P.P.",15
40,"40119",182,149,145,2,4,"P.P.",108
46,"46116",12587,9821,9724,120,97,"P.P.",4990
24,"24092",883,707,702,6,5,"P.P.",409
26,"26111",266,203,200,4,3,"P.P.",82
19,"19031",18,11,11,0,0,"P.P.",8
14,"14014",2610,2160,2125,19,35,"P.P.",704
3,"3132",571,464,461,8,3,"P.P.",208
42,"42087",48,38,37,1,1,"P.P.",16
47,"47135",93,77,76,0,1,"P.P.",44
51,"51001",58533,32223,31745,498,478,"P.P.",20944
24,"24215",169,121,120,1,1,"P.P.",89
14,"14015",2198,1776,1755,16,21,"P.P.",661
46,"46043",149,139,139,0,0,"P.P.",81
26,"26113",35,31,31,1,0,"P.P.",27
42,"42088",69,56,56,1,0,"P.P.",44
45,"45161",11339,7989,7869,95,120,"P.P.",4393
37,"37350",452,368,364,5,4,"P.P.",296
4,"4093",1869,1341,1334,10,7,"P.P.",801
5,"5092",172,142,139,0,3,"P.P.",95
9,"9225",95,61,61,3,0,"P.P.",29
14,"14016",1406,1123,1115,9,8,"P.P.",409
46,"46141",424,338,336,2,2,"P.P.",213
26,"26114",87,74,72,0,2,"P.P.",47
45,"45053",8208,6763,6663,103,100,"P.P.",3428
37,"37125",243,184,180,3,4,"P.P.",114
16,"16153",1006,856,843,8,13,"P.P.",431
37,"37003",134,103,102,0,1,"P.P.",72
46,"46118",3883,3141,3105,28,36,"P.P.",1542
37,"37351",305,261,258,2,3,"P.P.",174
23,"23079",3750,3084,3063,19,21,"P.P.",1236
40,"40123",168,130,126,3,4,"P.P.",64
21,"21029",1633,1276,1259,15,17,"P.P.",520
24,"24218",476,344,340,11,4,"P.P.",200
16,"16027",779,619,612,5,7,"P.P.",294
37,"37240",781,552,540,10,12,"P.P.",361
19,"19033",79,55,55,0,0,"P.P.",37
41,"41012",3115,2314,2271,29,43,"P.P.",881
11,"11018",1528,1194,1178,9,16,"P.P.",637
42,"42092",89,60,60,0,0,"P.P.",37
37,"37353",142,119,119,2,0,"P.P.",64
37,"37005",92,65,65,0,0,"P.P.",54
14,"14017",10755,8220,8149,101,71,"P.P.",3029
34,"34003",167,132,130,7,2,"P.P.",85
5,"5191",124,98,98,2,0,"P.P.",36
19,"19034",23,23,23,1,0,"P.P.",12
19,"19146",51,40,38,0,2,"P.P.",15
42,"42093",56,39,38,0,1,"P.P.",30
3,"3136",484,393,386,1,7,"P.P.",198
14,"14018",3795,3004,2970,24,34,"P.P.",1405
45,"45055",1052,886,870,10,16,"P.P.",498
16,"16030",28,24,24,0,0,"P.P.",17
37,"37006",157,108,107,0,1,"P.P.",77
24,"24098",1251,837,819,19,18,"P.P.",360
24,"24221",850,635,619,6,16,"P.P.",384
34,"34049",421,313,311,4,2,"P.P.",190
3,"3137",719,536,530,3,6,"P.P.",246
19,"19036",279,238,236,1,2,"P.P.",144
34,"34005",899,707,698,8,9,"P.P.",411
14,"14019",6486,5288,5243,65,45,"P.P.",1551
42,"42095",1575,1136,1106,40,30,"P.P.",525
3,"3138",3218,2403,2388,22,15,"P.P.",1504
39,"39016",24213,18549,18362,265,187,"P.P.",9455
19,"19037",153,128,128,0,0,"P.P.",82
34,"34006",82,72,72,1,0,"P.P.",55
5,"5193",224,197,197,2,0,"P.P.",134
46,"46120",1133,889,870,2,19,"P.P.",427
19,"19074",81,69,69,0,0,"P.P.",20
37,"37280",84,64,64,0,0,"P.P.",52
47,"47058",199,157,157,3,0,"P.P.",87
29,"29067",420165,273593,271376,3342,2217,"P.P.",137116
24,"24223",2793,2121,2113,63,8,"P.P.",1152
37,"37008",4316,3518,3457,31,61,"P.P.",2311
4,"4098",1616,1255,1249,7,6,"P.P.",571
42,"42096",316,218,215,9,3,"P.P.",145
19,"19038",48,33,33,0,0,"P.P.",25
14,"14020",415,323,319,3,4,"P.P.",121
19,"19248",64,53,53,0,0,"P.P.",31
42,"42097",19,16,16,0,0,"P.P.",6
46,"46121",116,103,101,0,2,"P.P.",55
29,"29068",6209,4025,3983,41,42,"P.P.",2100
16,"16159",299,204,202,5,2,"P.P.",123
3,"3140",26223,19998,19552,338,446,"P.P.",10392
34,"34009",34,31,31,3,0,"P.P.",25
9,"9372",207,169,165,1,4,"P.P.",95
37,"37357",283,216,214,0,2,"P.P.",130
19,"19039",73,57,57,0,0,"P.P.",34
42,"42098",14,8,8,0,0,"P.P.",5
19,"19151",1126,849,830,3,19,"P.P.",453
37,"37009",225,189,185,2,4,"P.P.",120
37,"37132",398,317,311,3,6,"P.P.",182
16,"16034",207,174,173,0,1,"P.P.",99
42,"42156",30,21,21,0,0,"P.P.",13
46,"46001",863,647,641,5,6,"P.P.",333
3,"3901",1070,826,818,14,8,"P.P.",403
40,"40130",139,106,106,4,0,"P.P.",69
4,"4031",2495,1942,1931,13,11,"P.P.",915
37,"37011",131,87,86,2,1,"P.P.",54
37,"37359",194,155,152,1,3,"P.P.",114
29,"29069",80337,50235,49723,690,512,"P.P.",25775
19,"19040",73,42,42,1,0,"P.P.",25
16,"16161",84,73,72,4,1,"P.P.",47
40,"40131",48,41,41,0,0,"P.P.",28
24,"24226",223,154,153,1,1,"P.P.",116
42,"42100",31,31,31,0,0,"P.P.",20
9,"9373",485,332,331,5,1,"P.P.",273
14,"14023",2084,1809,1787,13,22,"P.P.",957
29,"29070",35228,23374,23146,258,228,"P.P.",12029
42,"42103",626,487,481,3,6,"P.P.",313
3,"3902",9578,7085,7007,65,78,"P.P.",5091
15,"15036",60838,40345,39667,915,678,"P.P.",19026
37,"37134",250,192,189,1,3,"P.P.",106
9,"9374",96,85,81,3,4,"P.P.",53
21,"21036",213,172,167,1,5,"P.P.",70
24,"24227",1664,1159,1148,16,11,"P.P.",656
14,"14054",13632,10857,10652,194,205,"P.P.",4602
19,"19041",166,127,127,3,0,"P.P.",48
14,"14024",1926,1557,1527,14,30,"P.P.",534
11,"11025",4371,3260,3226,34,34,"P.P.",951
45,"45062",1161,959,928,8,31,"P.P.",698
45,"45172",757,597,594,7,3,"P.P.",350
47,"47062",185,153,153,5,0,"P.P.",126
3,"3903",2431,1991,1960,18,31,"P.P.",1179
12,"12079",450,360,353,3,7,"P.P.",235
37,"37361",91,67,62,0,5,"P.P.",49
29,"29071",915,601,598,4,3,"P.P.",275
39,"39021",536,448,444,1,4,"P.P.",250
5,"5198",80,65,65,1,0,"P.P.",54
33,"33017",3289,2378,2350,35,28,"P.P.",1067
19,"19043",92,82,82,1,0,"P.P.",55
3,"3904",1416,1104,1096,11,8,"P.P.",584
37,"37014",1198,862,852,8,10,"P.P.",502
47,"47063",107,87,87,2,0,"P.P.",54
46,"46252",142,108,107,1,1,"P.P.",65
37,"37362",4333,3276,3238,65,38,"P.P.",1974
24,"24229",473,348,344,8,4,"P.P.",235
14,"14026",2043,1434,1421,10,13,"P.P.",619
16,"16165",84,70,70,0,0,"P.P.",29
42,"42107",86,60,59,2,1,"P.P.",41
24,"24230",450,333,327,4,6,"P.P.",199
19,"19255",95,68,68,0,0,"P.P.",34
4,"4001",1139,890,884,6,6,"P.P.",434
19,"19044",319,248,245,0,3,"P.P.",172
26,"26003",446,388,387,8,1,"P.P.",264
37,"37015",248,169,168,0,1,"P.P.",99
5,"5233",246,212,212,2,0,"P.P.",146
26,"26044",60,48,46,1,2,"P.P.",28
19,"19189",136,99,97,0,2,"P.P.",66
40,"40138",2195,1758,1725,18,33,"P.P.",952
15,"15039",1374,1027,998,27,29,"P.P.",655
26,"26004",82,64,64,1,0,"P.P.",52
37,"37364",893,653,644,10,9,"P.P.",413
11,"11027",67042,43386,43065,557,321,"P.P.",22131
24,"24901",994,698,686,8,12,"P.P.",330
42,"42110",82,58,58,2,0,"P.P.",35
19,"19256",48,44,43,0,1,"P.P.",30
46,"46126",5471,4454,4392,53,62,"P.P.",2079
14,"14027",7948,5944,5871,92,73,"P.P.",1808
24,"24902",375,292,289,1,3,"P.P.",159
19,"19045",180,145,145,1,0,"P.P.",114
42,"42111",310,228,222,2,6,"P.P.",132
34,"34019",139,108,108,5,0,"P.P.",65
37,"37253",137,115,115,1,0,"P.P.",64
5,"5201",557,444,437,2,7,"P.P.",290
26,"26005",2251,1602,1580,18,22,"P.P.",971
47,"47065",898,762,752,9,10,"P.P.",445
16,"16169",75,44,44,0,0,"P.P.",18
42,"42113",553,412,404,7,8,"P.P.",280
14,"14028",333,279,277,1,2,"P.P.",107
19,"19159",108,91,88,1,3,"P.P.",61
19,"19046",20318,15118,14892,219,226,"P.P.",6969
11,"11029",5360,3445,3423,27,22,"P.P.",1056
37,"37140",731,490,475,0,15,"P.P.",342
16,"16218",207,170,169,4,1,"P.P.",85
46,"46128",1649,1322,1292,14,30,"P.P.",699
37,"37254",189,168,164,1,4,"P.P.",112
46,"46055",1286,1083,1067,11,16,"P.P.",520
37,"37019",157,114,113,0,1,"P.P.",103
29,"29075",12666,8284,8218,62,66,"P.P.",4379
9,"9113",503,397,390,7,7,"P.P.",205
5,"5002",1996,1497,1476,15,21,"P.P.",830
37,"37367",218,182,176,0,6,"P.P.",144
16,"16171",1930,1616,1584,25,32,"P.P.",862
42,"42115",72,48,48,0,0,"P.P.",38
46,"46201",83,50,49,0,1,"P.P.",15
7,"7010",4668,3229,3174,58,55,"P.P.",1599
19,"19193",30,29,29,1,0,"P.P.",8
42,"42116",63,50,48,3,2,"P.P.",28
15,"15042",3249,2341,2303,25,38,"P.P.",1430
40,"40143",97,72,72,0,0,"P.P.",47
9,"9114",88,75,73,0,2,"P.P.",49
26,"26135",181,139,137,1,2,"P.P.",88
37,"37020",449,371,365,7,6,"P.P.",206
47,"47067",198,159,156,5,3,"P.P.",122
9,"9386",61,45,45,0,0,"P.P.",38
5,"5205",78,59,58,0,1,"P.P.",42
37,"37368",18,15,15,1,0,"P.P.",11
37,"37021",86,70,68,2,2,"P.P.",43
37,"37143",410,342,338,3,4,"P.P.",212
4,"4006",7156,5175,5106,51,69,"P.P.",2849
19,"19123",40,34,34,0,0,"P.P.",23
46,"46202",15578,11811,11676,110,135,"P.P.",6656
34,"34024",27,18,17,1,1,"P.P.",13
13,"13036",837,671,666,3,5,"P.P.",383
21,"21044",17018,11390,11290,132,100,"P.P.",6788
16,"16173",249,189,188,0,1,"P.P.",101
4,"4007",791,599,599,5,0,"P.P.",233
19,"19049",19,11,11,0,0,"P.P.",6
37,"37022",287,237,232,0,5,"P.P.",159
29,"29079",2500,2016,2000,23,16,"P.P.",586
26,"26010",98,82,79,1,3,"P.P.",58
5,"5110",710,584,581,1,3,"P.P.",408
46,"46130",934,745,734,6,11,"P.P.",353
5,"5008",244,200,196,1,4,"P.P.",139
5,"5044",301,217,217,3,0,"P.P.",161
19,"19195",41,30,30,1,0,"P.P.",14
40,"40052",95,69,69,0,0,"P.P.",44
33,"33022",992,709,696,12,13,"P.P.",242
4,"4008",530,423,418,4,5,"P.P.",268
9,"9388",32,25,24,2,1,"P.P.",5
19,"19050",21,19,19,0,0,"P.P.",8
42,"42120",148,91,91,4,0,"P.P.",52
37,"37145",276,217,214,0,3,"P.P.",117
29,"29080",6598,4703,4663,31,40,"P.P.",2013
26,"26012",17,15,15,1,0,"P.P.",8
37,"37062",92,73,73,1,0,"P.P.",59
9,"9389",77,66,66,0,0,"P.P.",40
40,"40148",259,213,212,3,1,"P.P.",117
26,"26140",268,213,207,2,6,"P.P.",127
4,"4009",165,124,122,2,2,"P.P.",70
37,"37024",101,80,80,0,0,"P.P.",55
46,"46131",49087,37846,37477,422,369,"P.P.",21127
19,"19051",94,83,83,1,0,"P.P.",53
26,"26013",350,267,264,5,3,"P.P.",118
11,"11034",2381,1807,1784,19,23,"P.P.",553
14,"14003",1289,1046,1026,12,20,"P.P.",474
47,"47153",135,94,93,1,1,"P.P.",52
4,"4010",602,492,491,10,1,"P.P.",177
37,"37025",264,217,216,1,1,"P.P.",137
40,"40149",563,446,434,9,12,"P.P.",296
18,"18057",5045,3755,3721,44,34,"P.P.",1822
19,"19052",37,32,31,1,1,"P.P.",12
16,"16177",86,68,68,0,0,"P.P.",40
26,"26142",804,661,648,1,13,"P.P.",362
46,"46132",2124,1845,1817,14,28,"P.P.",1074
21,"21047",1965,1355,1325,17,30,"P.P.",476
42,"42123",172,128,128,3,0,"P.P.",83
5,"5012",156,134,132,1,2,"P.P.",100
5,"5210",105,83,82,2,1,"P.P.",65
16,"16051",166,140,140,1,0,"P.P.",79
47,"47154",168,144,144,7,0,"P.P.",88
29,"29082",29311,20220,20051,223,169,"P.P.",10805
37,"37148",451,344,343,3,1,"P.P.",238
4,"4011",2814,2283,2263,25,20,"P.P.",916
37,"37374",1204,1018,1004,9,14,"P.P.",605
47,"47071",406,333,329,6,4,"P.P.",197
42,"42124",71,50,50,0,0,"P.P.",33
47,"47155",3043,2246,2225,35,21,"P.P.",1096
5,"5114",1418,1195,1182,9,13,"P.P.",559
37,"37027",242,196,192,2,4,"P.P.",122
19,"19096",99,79,78,1,1,"P.P.",38
9,"9168",329,254,254,2,0,"P.P.",106
4,"4012",230,195,195,2,0,"P.P.",109
29,"29083",2212,1679,1652,15,27,"P.P.",684
16,"16185",63,45,44,0,1,"P.P.",22
37,"37375",764,636,627,19,9,"P.P.",284
26,"26144",196,163,162,2,1,"P.P.",118
40,"40154",23,21,21,1,0,"P.P.",12
46,"46261",1706,1388,1366,13,22,"P.P.",776
37,"37376",2373,1720,1700,23,20,"P.P.",1149
26,"26017",380,277,276,3,1,"P.P.",118
19,"19054",184,156,151,2,5,"P.P.",97
42,"42127",47,35,35,0,0,"P.P.",28
4,"4013",137455,94867,94142,1203,725,"P.P.",53152
9,"9394",805,594,588,13,6,"P.P.",304
42,"42128",43,38,38,2,0,"P.P.",21
46,"46134",2326,1691,1664,20,27,"P.P.",792
19,"19055",54,41,37,1,4,"P.P.",22
29,"29084",28386,19450,19202,296,248,"P.P.",9185
47,"47074",155,125,124,0,1,"P.P.",46
5,"5015",100,78,78,0,0,"P.P.",34
21,"21050",12322,8772,8679,99,93,"P.P.",3920
46,"46135",9634,7671,7586,64,85,"P.P.",3834
4,"4014",162,136,136,0,0,"P.P.",40
37,"37029",226,181,178,4,3,"P.P.",108
26,"26019",365,296,295,6,1,"P.P.",152
29,"29085",156,116,113,0,3,"P.P.",46
42,"42129",706,523,509,14,14,"P.P.",302
5,"5213",117,94,88,0,6,"P.P.",65
37,"37378",118,85,85,3,0,"P.P.",42
24,"24005",437,308,305,3,3,"P.P.",208
37,"37071",90,80,80,1,0,"P.P.",34
42,"42182",62,53,53,2,0,"P.P.",47
33,"33027",929,617,613,5,4,"P.P.",231
14,"14039",2705,2204,2189,12,15,"P.P.",858
46,"46136",2476,1890,1865,16,25,"P.P.",942
37,"37266",83,54,54,1,0,"P.P.",39
9,"9001",29,25,25,0,0,"P.P.",12
29,"29086",814,538,536,9,2,"P.P.",245
37,"37031",399,308,307,5,1,"P.P.",205
34,"34160",154,119,116,0,3,"P.P.",40
21,"21052",4741,2897,2839,21,58,"P.P.",714
5,"5214",46,23,23,1,0,"P.P.",16
19,"19268",34,26,25,0,1,"P.P.",13
9,"9398",92,68,68,2,0,"P.P.",36
45,"45081",16099,12232,12079,154,153,"P.P.",6934
37,"37073",583,458,455,7,3,"P.P.",302
9,"9003",205,156,154,4,2,"P.P.",75
37,"37032",530,410,409,4,1,"P.P.",271
14,"14040",3821,2986,2949,40,37,"P.P.",851
19,"19172",76,65,64,1,1,"P.P.",30
29,"29087",409,306,305,3,1,"P.P.",76
16,"16190",5151,4229,4144,52,85,"P.P.",2511
9,"9129",112,93,93,0,0,"P.P.",40
26,"26022",232,191,190,1,1,"P.P.",159
45,"45082",1333,1143,1123,14,20,"P.P.",584
19,"19059",84,60,60,0,0,"P.P.",46
47,"47159",862,704,695,20,9,"P.P.",346
46,"46137",273,232,229,1,3,"P.P.",117
16,"16060",841,714,704,11,10,"P.P.",348
4,"4017",1337,965,960,7,5,"P.P.",476
46,"46210",346,300,295,4,5,"P.P.",170
9,"9400",340,253,249,4,4,"P.P.",120
26,"26023",505,386,380,6,6,"P.P.",223
9,"9006",68,40,39,1,1,"P.P.",28
5,"5216",237,195,192,0,3,"P.P.",153
26,"26151",455,384,382,1,2,"P.P.",214
4,"4018",293,250,245,2,5,"P.P.",97
47,"47077",291,232,232,1,0,"P.P.",190
16,"16192",54,37,37,1,0,"P.P.",13
37,"37307",177,132,130,0,2,"P.P.",93
14,"14042",18991,14726,14495,290,231,"P.P.",5557
9,"9007",66,50,50,0,0,"P.P.",41
5,"5217",69,54,54,0,0,"P.P.",41
47,"47078",178,159,154,7,5,"P.P.",95
16,"16062",30,27,27,0,0,"P.P.",6
11,"11041",9805,7136,7067,87,69,"P.P.",3059
26,"26024",273,220,219,2,1,"P.P.",112
29,"29089",3343,2514,2489,14,25,"P.P.",551
4,"4019",269,210,209,3,1,"P.P.",72
40,"40162",420,320,314,1,6,"P.P.",237
11,"11042",1232,933,922,4,11,"P.P.",345
14,"14043",7664,5935,5874,53,61,"P.P.",2010
45,"45085",1511,1111,1100,10,11,"P.P.",814
9,"9009",167,129,128,8,1,"P.P.",75
37,"37035",220,176,173,1,3,"P.P.",116
38,"38001",17632,9601,9475,121,126,"P.P.",3981
46,"46139",4594,3794,3734,28,60,"P.P.",2105
37,"37159",100,77,75,0,2,"P.P.",60
29,"29090",1805,1265,1260,5,5,"P.P.",733
4,"4020",361,265,263,1,2,"P.P.",145
26,"26026",1344,1108,1096,14,12,"P.P.",641
37,"37036",74,54,52,0,2,"P.P.",39
15,"15083",1198,874,855,8,19,"P.P.",634
5,"5219",45,33,33,0,0,"P.P.",25
42,"42140",17,10,10,0,0,"P.P.",10
16,"16194",298,238,238,1,0,"P.P.",101
19,"19065",126,100,100,3,0,"P.P.",43
42,"42190",102,71,71,3,0,"P.P.",37
19,"19176",280,216,216,0,0,"P.P.",155
42,"42141",124,90,87,1,3,"P.P.",53
37,"37160",644,474,464,4,10,"P.P.",263
40,"40164",188,145,142,0,3,"P.P.",104
37,"37037",130,100,99,0,1,"P.P.",75
9,"9011",86,56,56,1,0,"P.P.",38
26,"26068",83,65,64,0,1,"P.P.",31
46,"46140",379,314,313,0,1,"P.P.",161
42,"42142",55,41,38,2,3,"P.P.",25
37,"37038",808,671,664,6,7,"P.P.",382
19,"19066",78,63,62,0,1,"P.P.",48
29,"29091",8777,6226,6126,64,100,"P.P.",3060
37,"37161",157,118,116,1,2,"P.P.",87
5,"5220",386,316,312,0,4,"P.P.",218
19,"19177",82,67,66,0,1,"P.P.",28
4,"4022",375,296,295,0,1,"P.P.",122
42,"42144",464,343,331,3,12,"P.P.",166
37,"37162",232,184,182,4,2,"P.P.",135
40,"40166",275,247,246,2,1,"P.P.",185
9,"9268",108,78,78,0,0,"P.P.",38
29,"29092",596,457,454,10,3,"P.P.",144
9,"9012",105,77,74,3,3,"P.P.",39
45,"45089",1615,1238,1221,16,17,"P.P.",543
49,"49044",80,63,63,3,0,"P.P.",34
4,"4023",144,116,116,2,0,"P.P.",73
37,"37039",325,241,236,0,5,"P.P.",127
21,"21059",203,166,162,1,4,"P.P.",20
37,"37313",581,440,435,7,5,"P.P.",288
14,"14046",4587,3671,3641,35,30,"P.P.",768
16,"16197",73,50,50,1,0,"P.P.",28
5,"5222",155,132,132,1,0,"P.P.",95
34,"34046",45,35,34,0,1,"P.P.",19
47,"47164",391,326,320,3,6,"P.P.",189
37,"37040",431,362,362,4,0,"P.P.",218
42,"42148",14,14,14,0,0,"P.P.",8
4,"4024",3049,2396,2361,19,35,"P.P.",1246
19,"19070",100,74,74,0,0,"P.P.",45
38,"38006",35862,18726,18500,209,226,"P.P.",8662
46,"46142",870,682,673,7,9,"P.P.",366
19,"19179",109,77,75,3,2,"P.P.",37
9,"9410",3181,2079,2049,48,30,"P.P.",842
9,"9014",190,113,113,3,0,"P.P.",76
9,"9411",174,104,103,1,1,"P.P.",56
16,"16070",35,29,29,0,0,"P.P.",12
49,"49006",168,124,122,2,2,"P.P.",66
4,"4026",75,58,58,0,0,"P.P.",47
47,"47083",80,61,59,3,2,"P.P.",41
37,"37041",80,53,53,1,0,"P.P.",44
40,"40029",50,43,42,0,1,"P.P.",22
26,"26032",58,52,52,1,0,"P.P.",24
5,"5224",104,90,90,0,0,"P.P.",66
16,"16202",908,753,744,10,9,"P.P.",417
4,"4027",260,186,186,0,0,"P.P.",121
9,"9016",87,55,54,1,1,"P.P.",0
19,"19071",7346,5380,5294,76,86,"P.P.",3037
46,"46144",699,547,536,2,11,"P.P.",357
12,"12004",4354,3145,3083,50,62,"P.P.",1620
14,"14049",16358,12577,12478,137,99,"P.P.",4571
38,"38008",5430,3844,3772,46,72,"P.P.",1518
15,"15088",3769,2626,2599,21,27,"P.P.",1601
37,"37044",461,363,360,1,3,"P.P.",260
15,"15060",5599,4139,4069,82,70,"P.P.",2290
9,"9412",846,568,563,4,5,"P.P.",360
4,"4028",239,212,207,0,5,"P.P.",66
9,"9017",96,76,74,0,2,"P.P.",36
42,"42152",96,71,69,1,2,"P.P.",53
5,"5029",132,102,102,0,0,"P.P.",75
34,"34177",170,147,143,2,4,"P.P.",87
45,"45130",354,287,283,2,4,"P.P.",165
9,"9139",104,84,80,3,4,"P.P.",36
37,"37167",164,140,132,6,8,"P.P.",57
46,"46145",21751,16601,16397,155,204,"P.P.",8417
33,"33059",5049,3480,3447,37,33,"P.P.",1304
5,"5063",48,39,39,2,0,"P.P.",33
9,"9018",24688,17880,17508,345,372,"P.P.",8682
42,"42153",19,16,16,0,0,"P.P.",13
16,"16204",306,235,235,5,0,"P.P.",160
40,"40174",402,292,290,5,2,"P.P.",236
47,"47167",258,230,229,3,1,"P.P.",136
14,"14051",1392,1148,1130,11,18,"P.P.",528
41,"41041",9646,7901,7791,58,110,"P.P.",2898
37,"37046",11929,8847,8683,146,164,"P.P.",5031
4,"4029",10682,7542,7474,63,68,"P.P.",4211
34,"34051",112,92,91,7,1,"P.P.",63
40,"40034",85,73,73,1,0,"P.P.",44
29,"29022",202,142,141,2,1,"P.P.",41
19,"19075",81,53,50,4,3,"P.P.",38
9,"9019",153,104,104,1,0,"P.P.",68
38,"38011",19299,12565,12313,152,252,"P.P.",5398
4,"4030",1222,930,924,5,6,"P.P.",453
37,"37047",178,111,111,0,0,"P.P.",88
21,"21064",6331,4390,4352,46,38,"P.P.",1756
14,"14052",9720,6444,6384,58,60,"P.P.",3235
9,"9020",276,222,222,6,0,"P.P.",145
19,"19076",36,29,29,0,0,"P.P.",19
9,"9415",290,192,192,4,0,"P.P.",149
26,"26038",93,71,69,1,2,"P.P.",36
34,"34092",331,272,267,6,5,"P.P.",176
45,"45132",1916,1487,1473,9,14,"P.P.",1049
9,"9060",171,142,142,0,0,"P.P.",99
15,"15007",3702,2670,2642,19,28,"P.P.",1660
16,"16264",505,440,438,6,2,"P.P.",255
37,"37049",163,119,119,0,0,"P.P.",71
19,"19284",11,11,11,0,0,"P.P.",2
14,"14053",6040,4455,4376,78,79,"P.P.",1573
12,"12108",495,394,389,4,5,"P.P.",207
29,"29098",1312,1043,1036,22,7,"P.P.",309
41,"41043",647,457,454,5,3,"P.P.",129
47,"47087",376,320,315,7,5,"P.P.",181
46,"46147",16527,11836,11716,105,120,"P.P.",6374
26,"26039",44,38,36,1,2,"P.P.",27
5,"5229",90,79,77,2,2,"P.P.",59
4,"4032",5476,3666,3643,34,23,"P.P.",2071
9,"9417",43,38,38,0,0,"P.P.",35
37,"37050",71,48,48,1,0,"P.P.",33
34,"34055",288,215,212,4,3,"P.P.",137
26,"26169",83,73,72,0,1,"P.P.",40
29,"29099",958,739,730,5,9,"P.P.",277
9,"9022",83,58,58,2,0,"P.P.",35
47,"47088",121,100,100,0,0,"P.P.",63
45,"45135",4437,3621,3550,44,71,"P.P.",1814
12,"12009",17124,12273,12098,150,175,"P.P.",6481
37,"37051",90,72,72,0,0,"P.P.",40
13,"13062",595,490,480,4,10,"P.P.",240
19,"19079",7,7,7,0,0,"P.P.",7
42,"42159",40,31,31,1,0,"P.P.",21
23,"23003",8778,6945,6877,51,68,"P.P.",3093
45,"45099",3449,2451,2405,22,46,"P.P.",1339
5,"5036",136,107,106,0,1,"P.P.",85
47,"47089",184,139,138,1,1,"P.P.",114
5,"5134",47,37,37,0,0,"P.P.",33
21,"21068",1009,726,721,10,5,"P.P.",272
24,"24026",1304,1015,1001,17,14,"P.P.",694
4,"4034",152,106,105,1,1,"P.P.",67
9,"9149",37,25,25,0,0,"P.P.",17
19,"19080",90,64,64,0,0,"P.P.",47
45,"45100",205,169,169,0,0,"P.P.",83
26,"26172",35,29,29,0,0,"P.P.",12
42,"42160",288,222,221,2,1,"P.P.",116
9,"9281",159,134,132,5,2,"P.P.",76
5,"5232",106,84,80,1,4,"P.P.",56
9,"9151",509,389,383,5,6,"P.P.",181
4,"4071",452,364,363,1,1,"P.P.",122
26,"26043",397,313,306,6,7,"P.P.",151
47,"47118",159,122,122,2,0,"P.P.",71
47,"47172",149,125,124,3,1,"P.P.",77
9,"9421",269,189,189,5,0,"P.P.",116
42,"42161",158,119,119,0,0,"P.P.",82
9,"9283",63,36,36,0,0,"P.P.",31
21,"21069",1778,1245,1242,11,3,"P.P.",445
46,"46174",1003,854,847,6,7,"P.P.",377
16,"16271",659,568,566,4,2,"P.P.",328
16,"16125",1734,1367,1350,12,17,"P.P.",847
42,"42015",34,24,24,5,0,"P.P.",19
16,"16002",195,175,172,0,3,"P.P.",121
5,"5136",110,75,75,3,0,"P.P.",51
37,"37055",132,112,107,2,5,"P.P.",67
42,"42162",2482,1871,1850,23,21,"P.P.",1220
4,"4036",246,205,204,1,1,"P.P.",109
30,"30001",4763,3992,3956,26,36,"P.P.",2634
16,"16217",113,95,92,0,3,"P.P.",70
26,"26045",13,13,13,0,0,"P.P.",6
5,"5234",58,49,49,0,0,"P.P.",36
9,"9422",24,18,16,0,2,"P.P.",15
15,"15068",5404,3780,3725,53,55,"P.P.",2384
37,"37177",310,242,241,1,1,"P.P.",171
26,"26175",57,46,45,1,1,"P.P.",27
5,"5040",77,59,59,1,0,"P.P.",46
47,"47174",302,236,234,3,2,"P.P.",109
33,"33065",1150,791,784,16,7,"P.P.",323
19,"19086",1655,1310,1295,10,15,"P.P.",666
9,"9154",150,107,107,3,0,"P.P.",76
37,"37290",143,111,110,1,1,"P.P.",65
5,"5074",755,639,638,5,1,"P.P.",428
42,"42164",1699,1244,1209,13,35,"P.P.",761
47,"47092",123,100,99,2,1,"P.P.",64
21,"21071",216,169,169,5,0,"P.P.",56
37,"37057",223,190,190,0,0,"P.P.",155
16,"16004",325,247,246,0,1,"P.P.",160
46,"46225",360,319,310,5,9,"P.P.",193
5,"5235",136,120,119,2,1,"P.P.",63
33,"33043",710,529,528,1,1,"P.P.",157
26,"26047",2076,1702,1682,17,20,"P.P.",960
9,"9337",126,88,87,1,1,"P.P.",42
5,"5139",74,62,59,2,3,"P.P.",51
24,"24031",220,180,176,3,4,"P.P.",94
16,"16219",106,83,82,0,1,"P.P.",29
21,"21072",10233,7829,7666,124,163,"P.P.",2977
37,"37179",230,194,191,3,3,"P.P.",125
37,"37291",261,215,214,1,1,"P.P.",119
46,"46153",445,374,366,7,8,"P.P.",172
26,"26134",102,82,80,2,2,"P.P.",59
5,"5042",156,126,126,0,0,"P.P.",99
46,"46226",34,34,33,0,1,"P.P.",10
9,"9338",220,173,168,5,5,"P.P.",88
34,"34023",5318,3947,3891,64,56,"P.P.",1808
37,"37292",101,84,84,2,0,"P.P.",58
19,"19088",98,67,66,0,1,"P.P.",43
21,"21013",10601,7384,7231,110,153,"P.P.",3042
26,"26049",189,141,137,1,4,"P.P.",91
40,"40048",40,30,30,0,0,"P.P.",17
42,"42167",305,223,222,3,1,"P.P.",142
45,"45107",3006,2344,2299,32,45,"P.P.",1299
34,"34196",94,74,73,1,1,"P.P.",58
42,"42021",101,70,70,1,0,"P.P.",61
9,"9247",28,21,20,0,1,"P.P.",19
7,"7045",1189,843,823,23,20,"P.P.",329
47,"47015",229,172,170,1,2,"P.P.",119
42,"42168",128,82,81,4,1,"P.P.",41
30,"30004",1164,958,952,1,6,"P.P.",542
9,"9294",123,96,93,1,3,"P.P.",44
40,"40051",54,41,40,0,1,"P.P.",28
16,"16091",86,66,66,1,0,"P.P.",22
5,"5238",815,649,641,6,8,"P.P.",346
9,"9162",122,94,93,1,1,"P.P.",43
49,"49025",187,143,142,3,1,"P.P.",81
18,"18089",15803,10794,10712,95,82,"P.P.",5195
42,"42171",158,99,94,3,5,"P.P.",70
45,"45145",2430,1866,1821,13,45,"P.P.",1120
40,"40005",34,32,31,1,1,"P.P.",22
45,"45035",307,236,236,3,0,"P.P.",117
16,"16228",202,146,144,2,2,"P.P.",102
12,"12118",83,63,62,0,1,"P.P.",35
39,"39054",4265,3338,3276,57,62,"P.P.",1544
9,"9034",301,250,250,3,0,"P.P.",166
21,"21076",2108,1647,1628,22,19,"P.P.",466
37,"37183",425,321,316,3,5,"P.P.",184
5,"5239",215,171,170,2,1,"P.P.",111
46,"46155",1072,861,849,4,12,"P.P.",448
9,"9208",252,192,192,6,0,"P.P.",126
47,"47096",139,109,107,0,2,"P.P.",69
40,"40053",116,92,90,1,2,"P.P.",48
46,"46010",927,706,699,3,7,"P.P.",400
38,"38024",14851,9589,9399,93,190,"P.P.",4555
9,"9430",18,15,15,0,0,"P.P.",6
9,"9164",179,130,130,1,0,"P.P.",95
26,"26096",244,204,201,2,3,"P.P.",100
19,"19092",437,331,326,4,5,"P.P.",206
14,"14064",352,265,261,3,4,"P.P.",118
37,"37146",135,117,117,1,0,"P.P.",100
9,"9431",124,102,100,2,2,"P.P.",73
40,"40054",145,103,102,1,1,"P.P.",60
38,"38025",6649,4858,4778,52,80,"P.P.",2317
39,"39055",1130,881,869,10,12,"P.P.",578
16,"16234",52,38,36,0,2,"P.P.",15
4,"4047",2290,1956,1937,9,19,"P.P.",1117
46,"46156",2065,1746,1721,14,25,"P.P.",917
46,"46229",1065,840,831,8,9,"P.P.",410
47,"47180",96,82,81,0,1,"P.P.",55
37,"37067",2938,2306,2267,47,39,"P.P.",1232
9,"9167",60,49,49,2,0,"P.P.",36
21,"21078",2865,2085,2066,21,19,"P.P.",465
40,"40104",261,179,178,1,1,"P.P.",99
38,"38026",32174,24822,24431,283,391,"P.P.",10697
4,"4048",1459,1110,1100,11,10,"P.P.",549
15,"15075",12042,8639,8486,147,153,"P.P.",4345
42,"42175",28,19,19,0,0,"P.P.",18
16,"16236",964,762,758,10,4,"P.P.",508
23,"23019",1590,1355,1339,7,16,"P.P.",465
9,"9037",122,91,90,2,1,"P.P.",27
47,"47019",93,69,68,0,1,"P.P.",50
23,"23062",1476,1274,1264,2,10,"P.P.",526
33,"33048",169,120,120,1,0,"P.P.",42
4,"4049",4981,3652,3630,34,22,"P.P.",2124
19,"19232",89,68,67,0,1,"P.P.",40
16,"16903",1097,855,828,9,27,"P.P.",603
47,"47099",174,153,153,4,0,"P.P.",103
47,"47181",170,128,128,1,0,"P.P.",69
37,"37069",952,737,723,12,14,"P.P.",438
9,"9038",123,92,92,0,0,"P.P.",56
14,"14067",3821,3105,3082,38,23,"P.P.",1344
37,"37187",567,449,448,3,1,"P.P.",274
16,"16238",560,484,479,3,5,"P.P.",248
47,"47020",283,237,232,5,5,"P.P.",175
42,"42029",164,114,113,1,1,"P.P.",84
19,"19097",28,27,27,0,0,"P.P.",23
45,"45151",631,474,470,1,4,"P.P.",247
30,"30009",11961,9992,9880,92,112,"P.P.",6114
4,"4050",818,611,602,5,9,"P.P.",308
40,"40058",368,306,304,1,2,"P.P.",226
42,"42178",144,105,104,3,1,"P.P.",80
9,"9434",1167,916,902,24,14,"P.P.",475
14,"14068",581,460,457,7,3,"P.P.",145
37,"37188",198,164,160,7,4,"P.P.",100
15,"15078",78092,56506,55597,1110,909,"P.P.",27278
37,"37070",538,428,427,12,1,"P.P.",259
37,"37302",337,230,229,5,1,"P.P.",144
5,"5244",66,45,45,0,0,"P.P.",37
47,"47100",169,146,144,1,2,"P.P.",88
42,"42181",453,357,347,7,10,"P.P.",149
46,"46159",23111,17258,17086,141,172,"P.P.",8658
39,"39059",8476,6365,6284,73,81,"P.P.",3149
12,"12124",1902,1532,1499,15,33,"P.P.",1073
40,"40060",86,65,64,3,1,"P.P.",48
19,"19098",22,18,18,0,0,"P.P.",5
9,"9216",390,278,272,2,6,"P.P.",163
19,"19133",103,89,88,2,1,"P.P.",36
19,"19202",16,14,14,0,0,"P.P.",8
46,"46232",920,730,722,6,8,"P.P.",340
40,"40109",84,70,67,0,3,"P.P.",57
30,"30037",17942,13830,13734,90,96,"P.P.",9860
5,"5245",344,285,284,5,1,"P.P.",178
14,"14069",7733,5910,5824,68,86,"P.P.",2168
16,"16906",104,83,82,0,1,"P.P.",46
9,"9438",547,440,433,9,7,"P.P.",239
40,"40203",814,643,631,14,12,"P.P.",318
40,"40061",66,53,52,1,1,"P.P.",42
47,"47102",302,250,248,3,2,"P.P.",135
30,"30011",4687,3776,3726,20,50,"P.P.",2440
14,"14070",1385,1131,1111,4,20,"P.P.",638
37,"37231",285,227,225,6,2,"P.P.",133
46,"46161",1454,1192,1179,8,13,"P.P.",599
39,"39060",6723,5453,5360,56,93,"P.P.",2538
9,"9044",54,45,45,1,0,"P.P.",29
19,"19102",122,101,100,0,1,"P.P.",61
42,"42184",76,50,49,0,1,"P.P.",30
16,"16102",1320,1016,1007,15,9,"P.P.",652
37,"37192",362,229,221,3,8,"P.P.",133
38,"38032",13032,8487,8357,101,130,"P.P.",3938
46,"46112",582,475,463,4,12,"P.P.",251
9,"9440",105,80,80,0,0,"P.P.",51
37,"37074",172,136,135,1,1,"P.P.",64
4,"4054",384,328,325,0,3,"P.P.",198
23,"23028",6428,4855,4802,26,53,"P.P.",2081
42,"42185",29,23,23,1,0,"P.P.",15
9,"9309",343,252,246,7,6,"P.P.",176
37,"37119",115,98,98,0,0,"P.P.",46
5,"5247",267,164,164,0,0,"P.P.",116
9,"9045",283,196,196,4,0,"P.P.",132
26,"26064",2341,1770,1749,26,21,"P.P.",863
19,"19204",168,129,126,2,3,"P.P.",55
9,"9441",70,59,59,2,0,"P.P.",51
5,"5154",46,35,35,0,0,"P.P.",27
46,"46235",21966,16641,16465,167,176,"P.P.",7751
37,"37382",202,172,171,3,1,"P.P.",99
5,"5249",101,73,71,1,2,"P.P.",31
42,"42187",65,51,51,0,0,"P.P.",41
33,"33052",758,526,518,2,8,"P.P.",159
14,"14072",1169,925,922,5,3,"P.P.",269
33,"33053",1206,817,811,6,6,"P.P.",169
5,"5055",649,525,518,3,7,"P.P.",316
19,"19104",16,12,12,1,0,"P.P.",8
37,"37078",888,728,714,9,14,"P.P.",410
26,"26065",57,43,43,0,0,"P.P.",33
9,"9311",70,51,51,0,0,"P.P.",18
5,"5251",80,58,58,0,0,"P.P.",44
42,"42188",64,51,51,0,0,"P.P.",22
19,"19307",30,27,27,0,0,"P.P.",16
49,"49039",333,243,240,6,3,"P.P.",137
16,"16247",87,65,62,1,3,"P.P.",30
9,"9443",197,160,154,5,6,"P.P.",104
26,"26066",277,229,228,9,1,"P.P.",141
46,"46018",689,597,592,12,5,"P.P.",305
5,"5056",94,78,73,1,5,"P.P.",50
47,"47026",59,46,46,1,0,"P.P.",40
7,"7058",2803,2100,2046,38,54,"P.P.",1047
9,"9048",1565,1166,1148,20,18,"P.P.",612
9,"9221",446,343,340,7,3,"P.P.",173
26,"26154",12,12,12,3,0,"P.P.",5
5,"5089",500,390,375,3,15,"P.P.",250
24,"24012",291,196,194,2,2,"P.P.",126
38,"38035",8172,4990,4919,62,71,"P.P.",2346
21,"21026",255,181,169,2,12,"P.P.",41
5,"5156",260,188,185,0,3,"P.P.",125
45,"45012",683,572,566,10,6,"P.P.",303
37,"37080",242,187,185,1,2,"P.P.",118
4,"4058",402,324,322,5,2,"P.P.",140
39,"39064",1339,1072,1066,7,6,"P.P.",583
46,"46164",11634,8843,8724,90,119,"P.P.",4451
19,"19242",112,93,92,1,1,"P.P.",74
37,"37081",1000,807,800,5,7,"P.P.",468
5,"5253",95,75,74,0,1,"P.P.",55
40,"40211",72,65,65,1,0,"P.P.",41
15,"15084",3681,2676,2656,34,20,"P.P.",1972
41,"41062",2252,1719,1698,12,21,"P.P.",196
19,"19211",450,340,334,0,6,"P.P.",197
39,"39065",272,199,197,2,2,"P.P.",102
16,"16249",2076,1728,1700,11,28,"P.P.",946
30,"30016",149046,103847,102890,1031,957,"P.P.",65987
40,"40072",170,134,132,1,2,"P.P.",69
15,"15001",4985,3560,3506,63,54,"P.P.",2088
19,"19310",13,9,8,0,1,"P.P.",2
5,"5158",410,333,331,2,2,"P.P.",235
47,"47137",27,22,22,2,0,"P.P.",17
4,"4060",486,373,372,0,1,"P.P.",225
12,"12034",1509,1125,1097,10,28,"P.P.",548
39,"39091",2026,1636,1628,14,8,"P.P.",955
39,"39013",561,413,412,2,1,"P.P.",270
16,"16250",94,71,71,0,0,"P.P.",41
39,"39066",895,710,703,6,7,"P.P.",323
49,"49004",137,105,105,3,0,"P.P.",54
38,"38038",161890,99555,97980,1101,1575,"P.P.",44492
30,"30017",11683,9332,9233,95,99,"P.P.",6019
47,"47029",61,54,53,0,1,"P.P.",40
9,"9052",40,31,31,1,0,"P.P.",29
9,"9447",36,33,33,0,0,"P.P.",15
13,"13053",14718,10958,10766,159,192,"P.P.",5610
5,"5060",127,108,105,1,3,"P.P.",78
30,"30018",7493,6003,5922,52,81,"P.P.",3625
4,"4061",668,541,536,7,5,"P.P.",216
5,"5256",119,101,100,0,1,"P.P.",58
37,"37085",4334,3254,3201,69,53,"P.P.",1950
41,"41064",5629,4041,4006,28,35,"P.P.",1081
19,"19109",53,40,40,1,0,"P.P.",35
37,"37201",263,196,196,5,0,"P.P.",131
26,"26072",310,270,264,4,6,"P.P.",129
15,"15087",6054,4004,3956,79,48,"P.P.",2286
37,"37086",105,75,72,3,3,"P.P.",48
39,"39067",901,628,623,1,5,"P.P.",258
46,"46167",411,312,309,0,3,"P.P.",178
9,"9055",55,46,44,0,2,"P.P.",30
46,"46240",226,188,185,3,3,"P.P.",93
42,"42196",14,11,11,0,0,"P.P.",9
5,"5061",264,222,214,5,8,"P.P.",110
5,"5258",123,105,104,1,1,"P.P.",68
19,"19214",94,78,78,2,0,"P.P.",51
47,"47112",2671,2231,2198,28,33,"P.P.",1459
47,"47192",99,84,84,0,0,"P.P.",53
7,"7031",23371,14443,14213,285,230,"P.P.",7446
40,"40077",713,526,519,12,7,"P.P.",245
4,"4063",1199,871,862,6,9,"P.P.",454
37,"37202",938,742,726,25,16,"P.P.",395
46,"46192",755,564,554,9,10,"P.P.",278
30,"30019",25722,18740,18553,164,187,"P.P.",11856
26,"26119",223,186,185,2,1,"P.P.",62
9,"9056",4957,3607,3557,70,50,"P.P.",2183
47,"47031",203,149,149,0,0,"P.P.",109
37,"37088",208,173,172,4,1,"P.P.",101
4,"4064",2585,1817,1803,18,14,"P.P.",1091
26,"26075",377,297,289,4,8,"P.P.",174
5,"5259",132,115,114,1,1,"P.P.",81
16,"16157",229,187,182,2,5,"P.P.",116
42,"42198",24,17,17,0,0,"P.P.",11
45,"45019",7033,5207,5110,89,97,"P.P.",2457
37,"37318",225,167,165,0,2,"P.P.",112
26,"26120",1515,1215,1198,20,17,"P.P.",678
9,"9368",26,18,18,0,0,"P.P.",16
12,"12005",8066,5835,5441,116,394,"P.P.",2857
9,"9057",155,125,124,0,1,"P.P.",69
38,"38043",18628,12966,12763,134,203,"P.P.",5822
24,"24060",660,382,382,0,0,"P.P.",221
39,"39069",1957,1595,1570,18,25,"P.P.",594
46,"46169",31753,24041,23802,270,239,"P.P.",11091
4,"4065",387,320,318,1,2,"P.P.",150
42,"42200",98,70,67,1,3,"P.P.",51
46,"46170",3464,2944,2908,24,36,"P.P.",1595
5,"5064",117,94,93,4,1,"P.P.",77
16,"16259",30,26,26,1,0,"P.P.",15
9,"9190",97,73,72,0,1,"P.P.",47
47,"47033",209,170,168,3,2,"P.P.",115
5,"5261",48,32,31,0,1,"P.P.",25
26,"26077",15,15,15,1,0,"P.P.",11
9,"9059",137122,103909,102353,2008,1556,"P.P.",54592
39,"39070",152,118,118,0,0,"P.P.",59
26,"26122",109,94,92,2,2,"P.P.",57
24,"24101",465,274,266,5,8,"P.P.",110
4,"4100",7918,5465,5425,52,40,"P.P.",3214
16,"16263",936,730,719,8,11,"P.P.",360
21,"21004",1530,1059,1042,9,17,"P.P.",317
46,"46171",16753,12565,12399,122,166,"P.P.",6278
46,"46219",143,127,126,1,1,"P.P.",82
47,"47223",172,147,147,6,0,"P.P.",66
7,"7035",1542,1190,1161,19,29,"P.P.",553
23,"23088",6177,4955,4872,94,83,"P.P.",1521
39,"39097",732,476,470,4,6,"P.P.",290
37,"37207",287,211,208,2,3,"P.P.",149
19,"19219",18,12,12,0,0,"P.P.",1
5,"5066",480,397,392,5,5,"P.P.",172
40,"40082",131,111,110,5,1,"P.P.",84
38,"38045",4181,2176,2140,13,36,"P.P.",777
26,"26079",690,568,562,5,6,"P.P.",417
5,"5262",378,308,307,2,1,"P.P.",161
9,"9192",74,55,53,0,2,"P.P.",26
19,"19322",35,28,27,1,1,"P.P.",14
37,"37208",92,59,58,0,1,"P.P.",46
9,"9061",187,146,144,1,2,"P.P.",129
26,"26080",529,427,425,2,2,"P.P.",303
30,"30023",3572,2859,2811,22,48,"P.P.",1687
15,"15008",5657,4224,4157,62,67,"P.P.",2213
16,"16265",27,26,26,0,0,"P.P.",15
19,"19323",50,41,39,0,2,"P.P.",21
39,"39072",375,234,234,4,0,"P.P.",124
30,"30024",57868,41894,41513,393,381,"P.P.",25462
33,"33016",19516,14345,14210,198,135,"P.P.",5675
19,"19153",25,17,17,0,0,"P.P.",4
5,"5264",68,48,48,1,0,"P.P.",30
24,"24065",2104,1512,1488,27,24,"P.P.",794
40,"40225",1152,931,918,10,13,"P.P.",581
26,"26081",23,17,17,0,0,"P.P.",17
38,"38047",1819,1269,1239,12,30,"P.P.",543
5,"5069",91,79,78,1,1,"P.P.",64
41,"41071",5603,3999,3932,28,67,"P.P.",1030
49,"49191",305,248,246,2,2,"P.P.",122
46,"46027",997,869,855,4,14,"P.P.",513
19,"19324",199,151,151,2,0,"P.P.",79
46,"46100",307,264,255,0,9,"P.P.",113
9,"9063",223,191,189,1,2,"P.P.",151
16,"16269",494,412,407,5,5,"P.P.",263
47,"47117",306,231,228,4,3,"P.P.",149
16,"16270",192,156,155,0,1,"P.P.",109
37,"37324",415,338,334,2,4,"P.P.",222
40,"40087",112,85,83,0,2,"P.P.",71
40,"40136",130,106,106,1,0,"P.P.",77
5,"5265",87,68,66,2,2,"P.P.",53
19,"19222",120,90,89,3,1,"P.P.",47
26,"26002",805,617,605,6,12,"P.P.",341
9,"9463",261,205,205,1,0,"P.P.",105
45,"45064",3801,2987,2953,38,34,"P.P.",1537
39,"39074",6785,5287,5233,50,54,"P.P.",3161
9,"9378",42,26,26,0,0,"P.P.",15
42,"42209",155,114,110,2,4,"P.P.",62
30,"30026",15165,10524,10369,80,155,"P.P.",6637
21,"21008",2717,1994,1978,11,16,"P.P.",606
39,"39022",985,735,734,5,1,"P.P.",490
39,"39048",1616,1326,1308,8,18,"P.P.",766
15,"15011",15507,10935,10751,123,184,"P.P.",5933
33,"33018",2971,2139,2121,32,18,"P.P.",1045
47,"47199",84,61,60,1,1,"P.P.",41
9,"9464",44,28,28,0,0,"P.P.",24
21,"21009",916,622,608,6,14,"P.P.",180
9,"9065",152,137,137,1,0,"P.P.",70
15,"15012",3767,2973,2926,51,47,"P.P.",1937
16,"16272",273,215,215,2,0,"P.P.",152
40,"40139",302,243,238,5,5,"P.P.",145
38,"38050",2516,1765,1734,9,31,"P.P.",643
42,"42211",92,69,68,0,1,"P.P.",45
42,"42212",75,45,45,2,0,"P.P.",30
21,"21010",14308,8960,8861,154,99,"P.P.",3981
40,"40233",457,350,348,1,2,"P.P.",161
46,"46175",469,406,401,5,5,"P.P.",205
38,"38051",7081,5298,5229,64,69,"P.P.",3042
47,"47148",475,389,384,2,5,"P.P.",237
19,"19120",107,95,95,1,0,"P.P.",58
16,"16128",70,64,64,2,0,"P.P.",35
12,"12049",471,366,344,10,22,"P.P.",125
7,"7009",744,593,576,11,17,"P.P.",269
19,"19225",879,625,618,9,7,"P.P.",309
19,"19329",62,52,50,0,2,"P.P.",28
16,"16274",147,125,125,1,0,"P.P.",63
38,"38052",1344,886,872,5,14,"P.P.",453
47,"47228",481,385,383,3,2,"P.P.",258
46,"46254",1085,847,834,12,13,"P.P.",474
24,"24110",1291,914,904,16,10,"P.P.",368
47,"47203",69,57,56,0,1,"P.P.",48
19,"19121",277,219,217,0,2,"P.P.",107
24,"24071",1060,808,797,6,11,"P.P.",476
47,"47122",2078,1697,1665,21,32,"P.P.",947
9,"9067",460,335,328,5,7,"P.P.",236
4,"4075",4783,3731,3700,33,31,"P.P.",2155
30,"30028",6810,5333,5251,44,82,"P.P.",2572
37,"37103",483,354,351,1,3,"P.P.",216
38,"38053",3752,2459,2397,28,62,"P.P.",1073
9,"9471",171,127,125,1,2,"P.P.",72
36,"36013",2690,1801,1778,11,23,"P.P.",1188
5,"5108",64,41,41,0,0,"P.P.",24
26,"26008",1909,1544,1527,19,17,"P.P.",803
47,"47176",229,157,157,0,0,"P.P.",102
9,"9068",25,19,19,2,0,"P.P.",7
9,"9070",38,27,27,3,0,"P.P.",12
39,"39026",1825,1383,1371,12,12,"P.P.",773
46,"46177",4594,3576,3523,29,53,"P.P.",1520
19,"19227",95,64,63,1,1,"P.P.",29
9,"9201",33,22,22,2,0,"P.P.",13
15,"15015",2840,2006,1964,43,42,"P.P.",1003
16,"16276",32,23,22,1,1,"P.P.",13
19,"19331",2497,1898,1847,19,51,"P.P.",956
23,"23056",3182,2539,2523,20,16,"P.P.",914
15,"15043",5491,4033,3971,45,62,"P.P.",2434
11,"11031",76347,49071,48616,681,455,"P.P.",24203
40,"40004",534,428,420,3,8,"P.P.",246
45,"45033",407,302,295,3,7,"P.P.",170
9,"9202",26,24,24,1,0,"P.P.",19
39,"39001",2146,1669,1645,20,24,"P.P.",891
30,"30030",305669,236235,234391,2112,1844,"P.P.",153377
16,"16277",128,100,100,3,0,"P.P.",82
37,"37107",11407,8234,8116,123,118,"P.P.",4888
4,"4078",1069,837,832,6,5,"P.P.",370
46,"46179",2186,1849,1804,17,45,"P.P.",981
16,"16278",91,69,69,2,0,"P.P.",34
26,"26094",97,86,85,0,1,"P.P.",56
19,"19261",42,31,31,1,0,"P.P.",25
5,"5142",113,97,96,0,1,"P.P.",68
24,"24157",2580,2046,2000,39,46,"P.P.",1142
5,"5175",190,149,149,2,0,"P.P.",110
39,"39002",3400,2554,2514,35,40,"P.P.",1252
30,"30031",560,471,469,3,2,"P.P.",365
19,"19125",54,42,42,2,0,"P.P.",25
37,"37221",465,360,353,0,7,"P.P.",203
15,"15017",18860,12975,12737,325,238,"P.P.",5872
5,"5905",253,200,198,1,2,"P.P.",130
47,"47043",330,267,264,1,3,"P.P.",136
34,"34027",1224,875,861,14,14,"P.P.",425
7,"7014",6697,3818,3757,38,61,"P.P.",1517
30,"30032",2839,2361,2337,21,24,"P.P.",1474
45,"45036",704,559,537,4,22,"P.P.",350
9,"9478",53,41,41,1,0,"P.P.",21
5,"5079",68,52,50,1,2,"P.P.",40
15,"15018",1211,821,805,11,16,"P.P.",325
39,"39029",642,521,517,6,4,"P.P.",296
9,"9345",134,102,102,1,0,"P.P.",50
37,"37335",432,347,346,0,1,"P.P.",256
26,"26053",221,177,173,5,4,"P.P.",87
5,"5010",173,141,134,2,7,"P.P.",100
5,"5144",92,66,66,4,0,"P.P.",46
47,"47207",325,265,263,4,2,"P.P.",178
21,"21016",1076,823,790,11,33,"P.P.",190
4,"4080",194,169,168,1,1,"P.P.",104
9,"9074",735,558,547,7,11,"P.P.",274
9,"9480",106,87,87,0,0,"P.P.",66
15,"15019",26096,18466,18187,350,279,"P.P.",9506
33,"33001",1772,984,971,14,13,"P.P.",386
46,"46181",17153,13332,13184,108,148,"P.P.",7166
21,"21017",3581,2416,2389,27,27,"P.P.",770
46,"46059",1310,1076,1058,2,18,"P.P.",413
40,"40150",76,62,62,1,0,"P.P.",33
39,"39004",1593,1321,1305,9,16,"P.P.",606
30,"30033",9940,7794,7700,79,94,"P.P.",4911
47,"47127",150,110,108,0,2,"P.P.",72
9,"9211",1489,1137,1121,28,16,"P.P.",745
33,"33002",10837,7667,7588,77,79,"P.P.",2815
9,"9122",93,71,71,4,0,"P.P.",47
16,"16902",165,128,126,1,2,"P.P.",55
24,"24119",742,524,510,15,14,"P.P.",269
5,"5081",44,36,36,0,0,"P.P.",31
39,"39083",1214,785,775,7,10,"P.P.",348
40,"40010",140,117,117,0,0,"P.P.",89
15,"15048",4769,3470,3415,57,55,"P.P.",1962
37,"37338",82,69,67,0,2,"P.P.",54
9,"9348",150,122,122,2,0,"P.P.",70
21,"21018",1821,1283,1273,19,10,"P.P.",347
19,"19233",108,93,90,2,3,"P.P.",42
41,"41003",2196,1803,1782,21,21,"P.P.",781
47,"47046",124,105,103,0,2,"P.P.",57
30,"30035",17849,12871,12744,133,127,"P.P.",8604
37,"37226",167,129,127,1,2,"P.P.",103
46,"46037",1146,1007,1003,5,4,"P.P.",547
16,"16904",508,413,407,10,6,"P.P.",211
45,"45188",2883,2180,2151,30,29,"P.P.",1012
12,"12059",276,227,227,1,0,"P.P.",104
16,"16014",659,534,528,8,6,"P.P.",244
33,"33071",671,528,523,4,5,"P.P.",160
37,"37340",155,121,121,0,0,"P.P.",100
39,"39006",1732,1381,1373,23,8,"P.P.",903
9,"9485",62,56,56,0,0,"P.P.",48
37,"37264",78,52,52,0,0,"P.P.",36
26,"26146",141,98,96,0,2,"P.P.",60
46,"46183",5946,4718,4656,35,62,"P.P.",2956
9,"9078",41,37,35,0,2,"P.P.",16
37,"37228",388,339,336,2,3,"P.P.",173
5,"5083",155,120,113,1,7,"P.P.",82
40,"40108",120,83,82,1,1,"P.P.",56
45,"45042",184,154,151,3,3,"P.P.",93
37,"37115",135,107,101,2,6,"P.P.",82
16,"16016",258,178,178,1,0,"P.P.",125
9,"9127",54,39,39,0,0,"P.P.",31
7,"7020",3455,2491,2453,46,38,"P.P.",969
34,"34034",129,104,104,1,0,"P.P.",51
16,"16188",106,76,76,0,0,"P.P.",32
9,"9306",127,94,94,0,0,"P.P.",71
47,"47157",544,462,458,9,4,"P.P.",257
42,"42130",70,55,54,2,1,"P.P.",40
47,"47130",105,86,85,2,1,"P.P.",51
12,"12061",431,324,316,6,8,"P.P.",122
15,"15051",4780,3333,3289,61,44,"P.P.",1438
37,"37230",221,173,171,0,2,"P.P.",92
11,"11011",1685,1231,1216,8,15,"P.P.",548
15,"15023",6629,4879,4795,52,84,"P.P.",2537
39,"39008",13716,10396,10274,129,122,"P.P.",5071
9,"9217",389,273,270,8,3,"P.P.",174
34,"34035",122,98,96,0,2,"P.P.",48
21,"21022",173,123,123,1,0,"P.P.",39
9,"9082",49,41,41,0,0,"P.P.",38
37,"37118",141,115,114,3,1,"P.P.",75
14,"14009",2864,2021,2003,8,18,"P.P.",819
15,"15024",4726,3634,3555,51,79,"P.P.",2015
41,"41006",2743,1972,1957,13,15,"P.P.",564
21,"21023",2106,1471,1456,7,15,"P.P.",443
47,"47049",94,71,71,1,0,"P.P.",49
15,"15052",4567,3539,3493,22,46,"P.P.",1869
11,"11040",411,317,309,0,8,"P.P.",96
21,"21053",3278,2363,2325,20,38,"P.P.",926
47,"47132",45,40,40,0,0,"P.P.",34
9,"9083",27,21,21,0,0,"P.P.",16
24,"24210",532,329,328,2,1,"P.P.",176
45,"45155",481,382,375,3,7,"P.P.",183
37,"37381",153,114,109,3,5,"P.P.",74
26,"26107",97,79,79,1,0,"P.P.",39
16,"16146",96,74,70,0,4,"P.P.",50
21,"21024",502,363,358,10,5,"P.P.",93
46,"46186",18444,14173,14029,135,144,"P.P.",6952
4,"4088",2516,1849,1832,7,17,"P.P.",873
16,"16910",104,69,69,1,0,"P.P.",33
9,"9084",200,147,147,4,0,"P.P.",90
24,"24211",291,226,224,3,2,"P.P.",144
14,"14041",3215,2492,2439,45,53,"P.P.",801
39,"39010",688,533,524,6,9,"P.P.",235
16,"16020",20,15,15,0,0,"P.P.",10
13,"13015",5755,4334,4293,40,41,"P.P.",2320
11,"11013",2284,1691,1670,15,21,"P.P.",599
41,"41086",15877,10246,10150,146,96,"P.P.",3632
42,"42135",89,59,59,1,0,"P.P.",38
45,"45048",388,310,308,2,2,"P.P.",162
33,"33007",1680,1186,1179,10,7,"P.P.",466
5,"5185",109,89,89,1,0,"P.P.",63
9,"9085",486,348,339,8,9,"P.P.",168
5,"5021",2044,1592,1557,37,35,"P.P.",952
46,"46187",1339,1096,1083,13,13,"P.P.",613
23,"23073",4671,3778,3735,19,43,"P.P.",1584
47,"47134",186,155,149,2,6,"P.P.",99
26,"26109",105,87,84,0,3,"P.P.",37
37,"37235",226,194,192,0,2,"P.P.",126
26,"26110",178,149,147,3,2,"P.P.",89
12,"12067",563,458,439,8,19,"P.P.",242
33,"33076",12662,8733,8670,120,63,"P.P.",3593
40,"40070",137,91,91,0,0,"P.P.",60
11,"11014",16318,11093,11031,144,62,"P.P.",4832
13,"13050",533,427,421,3,6,"P.P.",255
9,"9086",629,467,461,5,6,"P.P.",290
46,"46042",3376,2873,2819,17,54,"P.P.",1623
41,"41035",1171,898,889,12,9,"P.P.",335
16,"16064",699,588,580,4,8,"P.P.",362
26,"26027",169,126,126,1,0,"P.P.",57
12,"12068",57,45,44,0,1,"P.P.",27
11,"11015",59476,38207,37898,501,309,"P.P.",20022
16,"16065",454,380,374,4,6,"P.P.",244
7,"7026",30036,16912,16661,294,251,"P.P.",7536
21,"21027",67,52,52,0,0,"P.P.",28
39,"39012",6666,5148,5061,43,87,"P.P.",2455
37,"37123",206,166,165,1,1,"P.P.",147
37,"37237",330,250,242,1,8,"P.P.",135
11,"11016",14611,9848,9774,114,74,"P.P.",4887
9,"9090",61,50,50,0,0,"P.P.",37
19,"19243",53,39,39,0,0,"P.P.",23
47,"47054",673,545,541,8,4,"P.P.",366
40,"40121",325,266,262,3,4,"P.P.",167
37,"37124",227,181,179,3,2,"P.P.",111
33,"33078",159,108,106,1,2,"P.P.",48
46,"46190",48324,34747,34424,431,323,"P.P.",17330
15,"15029",6266,4668,4618,49,50,"P.P.",3011
49,"49003",896,650,647,11,3,"P.P.",415
16,"16152",42,38,37,3,1,"P.P.",27
40,"40026",114,98,97,2,1,"P.P.",31
12,"12101",385,309,296,3,13,"P.P.",182
45,"45199",2712,1817,1796,17,21,"P.P.",1011
26,"26158",296,238,237,7,1,"P.P.",169
16,"16026",104,79,79,1,0,"P.P.",47
45,"45015",624,485,480,2,5,"P.P.",265
47,"47190",103,87,87,7,0,"P.P.",58
5,"5093",431,330,329,1,1,"P.P.",222
47,"47055",212,169,168,3,1,"P.P.",83
30,"30043",24501,19738,19416,230,322,"P.P.",11622
39,"39092",1030,753,747,1,6,"P.P.",347
47,"47110",471,386,378,6,8,"P.P.",200
24,"24016",544,323,322,4,1,"P.P.",229
4,"4094",206,152,152,0,0,"P.P.",122
39,"39014",943,706,700,9,6,"P.P.",352
40,"40028",106,89,88,1,1,"P.P.",59
9,"9093",154,127,125,1,2,"P.P.",72
5,"5190",61,48,48,3,0,"P.P.",34
37,"37352",199,150,142,0,8,"P.P.",90
15,"15031",22951,16018,15696,382,322,"P.P.",6466
9,"9363",1047,798,792,9,6,"P.P.",632
45,"45054",4285,3321,3274,32,47,"P.P.",2081
47,"47139",1080,845,833,11,12,"P.P.",485
4,"4095",777,547,541,8,6,"P.P.",246
9,"9094",49,39,39,0,0,"P.P.",22
46,"46046",922,699,694,2,5,"P.P.",428
24,"24097",244,161,156,4,5,"P.P.",91
46,"46119",856,702,693,0,9,"P.P.",336
21,"21031",1309,903,871,9,32,"P.P.",366
37,"37128",261,211,210,2,1,"P.P.",114
26,"26118",64,58,56,0,2,"P.P.",39
21,"21061",5089,3657,3635,33,22,"P.P.",1308
45,"45018",445,332,322,4,10,"P.P.",183
4,"4096",293,220,219,1,1,"P.P.",97
37,"37354",4828,3589,3522,76,67,"P.P.",2016
42,"42094",520,376,362,14,14,"P.P.",183
41,"41040",9567,7305,7210,93,95,"P.P.",3903
26,"26163",143,118,116,2,2,"P.P.",51
37,"37278",736,538,529,7,9,"P.P.",295
21,"21032",1790,1362,1347,14,15,"P.P.",455
15,"15032",3639,2642,2586,35,56,"P.P.",1755
45,"45166",1734,1460,1429,8,31,"P.P.",685
15,"15033",2581,2094,2079,15,15,"P.P.",1170
41,"41014",2484,1956,1936,13,20,"P.P.",286
16,"16031",62,34,32,4,2,"P.P.",19
29,"29021",153,113,113,0,0,"P.P.",50
19,"19148",56,41,38,1,3,"P.P.",23
46,"46193",8494,6662,6580,73,82,"P.P.",3042
39,"39017",588,424,419,2,5,"P.P.",257
7,"7032",19658,12168,11959,238,209,"P.P.",5509
21,"21063",2624,2109,2097,13,12,"P.P.",503
19,"19318",36,19,19,1,0,"P.P.",7
39,"39095",2292,1824,1801,24,23,"P.P.",849
37,"37168",470,357,353,1,4,"P.P.",214
37,"37244",132,97,95,5,2,"P.P.",60
11,"11021",6838,5102,5049,67,53,"P.P.",2062
47,"47141",148,121,119,1,2,"P.P.",89
9,"9369",460,339,336,4,3,"P.P.",161
9,"9100",56,46,44,0,2,"P.P.",37
46,"46218",1082,964,936,5,28,"P.P.",572
46,"46048",3484,2915,2875,26,40,"P.P.",1426
47,"47194",322,244,233,1,11,"P.P.",106
15,"15090",1267,959,953,4,6,"P.P.",635
7,"7001",3450,2544,2470,36,74,"P.P.",1088
37,"37131",200,150,148,1,2,"P.P.",99
4,"4099",5086,4023,3980,26,43,"P.P.",2270
46,"46194",15267,11622,11491,110,131,"P.P.",6157
45,"45095",742,606,585,2,21,"P.P.",361
29,"29097",4076,3060,3018,40,42,"P.P.",997
26,"26037",150,129,128,1,1,"P.P.",71
47,"47059",108,77,76,1,1,"P.P.",52
21,"21034",1253,875,861,7,14,"P.P.",298
13,"13026",482,387,384,1,3,"P.P.",159
33,"33060",15694,11036,10883,112,153,"P.P.",3123
37,"37170",1571,1122,1107,22,15,"P.P.",787
39,"39071",463,358,358,2,0,"P.P.",187
12,"12138",18762,12489,12231,243,258,"P.P.",6031
9,"9326",156,119,114,2,5,"P.P.",66
47,"47169",70,57,57,0,0,"P.P.",50
7,"7002",6305,4188,4073,80,115,"P.P.",2097
5,"5195",241,168,164,0,4,"P.P.",103
46,"46195",1975,1631,1631,33,0,"P.P.",867
37,"37133",108,79,77,0,2,"P.P.",55
23,"23090",1371,1188,1177,6,11,"P.P.",598
45,"45061",2523,1839,1813,20,26,"P.P.",1024
34,"34053",222,177,172,4,5,"P.P.",105
5,"5196",69,54,54,2,0,"P.P.",21
34,"34011",406,327,327,4,0,"P.P.",196
4,"4101",3927,2827,2804,34,23,"P.P.",1514
39,"39020",23947,15404,15122,267,282,"P.P.",6117
9,"9103",247,201,200,2,1,"P.P.",108
24,"24103",330,180,177,0,3,"P.P.",124
47,"47224",92,77,77,0,0,"P.P.",43
16,"16162",51,36,36,0,0,"P.P.",21
7,"7004",3669,2511,2453,51,58,"P.P.",1062
40,"40132",75,50,50,1,0,"P.P.",34
40,"40037",47,35,35,0,0,"P.P.",23
19,"19187",64,54,54,0,0,"P.P.",38
23,"23091",790,668,664,3,4,"P.P.",349
15,"15065",7570,5710,5628,71,82,"P.P.",3237
21,"21037",491,386,378,1,8,"P.P.",84
47,"47225",89,67,66,0,1,"P.P.",44
39,"39099",2987,2416,2391,28,25,"P.P.",1211
5,"5197",114,98,98,1,0,"P.P.",64
5,"5102",1850,1487,1475,11,12,"P.P.",944
37,"37249",48,36,36,0,0,"P.P.",28
13,"13029",102,90,89,0,1,"P.P.",52
4,"4103",1555,1159,1157,8,2,"P.P.",701
7,"7005",6331,4128,4058,76,70,"P.P.",1996
15,"15038",2363,1643,1610,29,33,"P.P.",951
34,"34015",45,40,40,0,0,"P.P.",32
37,"37136",702,494,485,4,9,"P.P.",234
46,"46197",1902,1559,1554,15,5,"P.P.",681
39,"39100",922,718,712,8,6,"P.P.",466
9,"9239",52,42,42,1,0,"P.P.",34
19,"19287",153,114,113,2,1,"P.P.",78
47,"47226",180,152,148,1,4,"P.P.",68
5,"5135",440,363,360,0,3,"P.P.",239
19,"19288",22,21,21,0,0,"P.P.",14
45,"45027",433,352,349,1,3,"P.P.",198
47,"47090",2511,1907,1880,23,27,"P.P.",1048
45,"45174",343,289,288,0,1,"P.P.",193
5,"5199",48,39,39,0,0,"P.P.",34
37,"37137",114,87,87,3,0,"P.P.",74
47,"47146",236,196,195,4,1,"P.P.",80
4,"4902",42901,28927,28711,338,216,"P.P.",19124
40,"40043",1842,1494,1469,28,25,"P.P.",899
37,"37175",408,319,311,6,8,"P.P.",213
9,"9197",160,129,128,3,1,"P.P.",83
37,"37288",252,194,194,3,0,"P.P.",125
47,"47037",194,160,159,1,1,"P.P.",114
9,"9241",198,159,158,5,1,"P.P.",69
5,"5200",56,43,42,0,1,"P.P.",33
39,"39101",328,251,247,5,4,"P.P.",60
37,"37251",137,98,93,3,5,"P.P.",78
9,"9380",85,71,71,1,0,"P.P.",50
37,"37138",212,174,169,5,5,"P.P.",109
19,"19327",551,459,449,3,10,"P.P.",356
39,"39023",6048,4795,4747,43,48,"P.P.",2195
37,"37139",199,167,163,1,4,"P.P.",114
34,"34141",190,162,160,0,2,"P.P.",99
45,"45066",7334,5602,5536,52,66,"P.P.",3735
5,"5105",349,275,272,12,3,"P.P.",147
39,"39102",2330,1748,1731,13,17,"P.P.",1025
29,"29074",818,631,630,3,1,"P.P.",212
46,"46248",4847,3655,3597,25,58,"P.P.",2151
46,"46200",1915,1625,1595,15,30,"P.P.",853
41,"41022",4281,3087,3066,15,21,"P.P.",593
33,"33019",3262,2283,2244,12,39,"P.P.",889
46,"46151",717,596,589,3,7,"P.P.",301
39,"39024",2065,1616,1601,8,15,"P.P.",664
19,"19257",3595,2593,2543,48,50,"P.P.",1578
26,"26131",44,36,36,0,0,"P.P.",25
21,"21041",114169,74740,73814,1129,926,"P.P.",35137
9,"9199",97,75,74,0,1,"P.P.",55
26,"26176",69,55,54,0,1,"P.P.",50
45,"45177",2295,1898,1857,15,41,"P.P.",958
40,"40046",99,81,78,2,3,"P.P.",38
30,"30002",9802,7628,7553,48,75,"P.P.",4973
19,"19099",337,211,210,6,1,"P.P.",97
45,"45179",608,476,471,3,5,"P.P.",261
16,"16044",51,35,35,0,0,"P.P.",22
47,"47229",235,161,161,1,0,"P.P.",96
39,"39025",8985,7048,6955,70,93,"P.P.",3206
34,"34022",1136,926,908,5,18,"P.P.",481
37,"37141",158,140,139,1,1,"P.P.",64
37,"37255",58,47,47,3,0,"P.P.",36
21,"21042",15246,8640,8572,154,68,"P.P.",4546
40,"40047",47,37,36,0,1,"P.P.",28
9,"9425",561,431,418,3,13,"P.P.",184
23,"23010",14447,10777,10704,109,73,"P.P.",5623
46,"46080",1090,860,849,2,11,"P.P.",416
16,"16045",226,177,176,2,1,"P.P.",93
45,"45032",471,340,333,2,7,"P.P.",195
5,"5140",112,100,99,1,1,"P.P.",76
16,"16172",413,330,318,1,12,"P.P.",198
23,"23101",413,324,321,3,3,"P.P.",124
34,"34149",26,18,18,0,0,"P.P.",15
41,"41024",22383,15333,15160,213,173,"P.P.",5398
45,"45070",1415,1175,1162,11,13,"P.P.",696
33,"33021",4932,3544,3502,45,42,"P.P.",1332
26,"26009",426,318,313,4,5,"P.P.",170
26,"26136",111,90,90,3,0,"P.P.",51
38,"38021",1792,1184,1160,6,24,"P.P.",451
40,"40144",19,17,17,1,0,"P.P.",12
29,"29077",225,157,157,1,0,"P.P.",57
46,"46256",6734,4902,4858,33,44,"P.P.",2844
39,"39027",3213,2506,2473,21,33,"P.P.",1331
37,"37144",398,302,301,3,1,"P.P.",204
47,"47151",32,29,29,0,0,"P.P.",23
46,"46154",836,684,678,7,6,"P.P.",468
16,"16047",249,192,191,5,1,"P.P.",122
5,"5007",126,104,102,0,2,"P.P.",95
34,"34025",54,42,42,0,0,"P.P.",26
9,"9387",121,92,91,3,1,"P.P.",37
33,"33045",4692,3347,3297,42,50,"P.P.",1107
5,"5207",743,595,591,1,4,"P.P.",317
47,"47068",41,28,28,0,0,"P.P.",19
16,"16092",158,132,132,0,0,"P.P.",102
26,"26181",14,12,12,0,0,"P.P.",9
46,"46203",3669,3002,2964,36,38,"P.P.",1457
45,"45183",2189,1537,1514,10,23,"P.P.",932
26,"26139",68,55,55,4,0,"P.P.",36
21,"21045",261,200,200,5,0,"P.P.",47
47,"47017",205,177,176,1,1,"P.P.",148
37,"37259",44,32,32,3,0,"P.P.",23
7,"7047",2161,1447,1407,31,40,"P.P.",656
19,"19091",30,22,22,2,0,"P.P.",15
47,"47232",107,77,75,1,2,"P.P.",45
45,"45073",351,265,261,3,4,"P.P.",155
16,"16049",158,129,129,1,0,"P.P.",58
9,"9119",51,38,38,0,0,"P.P.",17
21,"21046",1715,1354,1343,15,11,"P.P.",667
16,"16231",47,43,43,0,0,"P.P.",30
12,"12089",4277,3009,2946,32,63,"P.P.",1943
40,"40101",770,584,577,16,7,"P.P.",287
16,"16134",4283,3398,3361,59,37,"P.P.",1876
34,"34028",154,128,126,1,2,"P.P.",91
16,"16176",61,45,43,0,2,"P.P.",13
9,"9178",61,48,48,0,0,"P.P.",35
19,"19166",179,123,121,4,2,"P.P.",70
46,"46259",537,426,424,9,2,"P.P.",209
42,"42121",77,56,56,1,0,"P.P.",34
19,"19263",34,27,27,0,0,"P.P.",17
9,"9120",46,35,34,1,1,"P.P.",18
5,"5113",90,74,74,0,0,"P.P.",59
37,"37261",255,191,191,2,0,"P.P.",132
33,"33024",229816,164603,163179,2100,1424,"P.P.",48598
19,"19299",94,75,75,0,0,"P.P.",42
45,"45001",1901,1468,1431,14,37,"P.P.",814
49,"49120",79,58,58,1,0,"P.P.",40
5,"5145",57,41,41,0,0,"P.P.",25
9,"9301",625,510,504,11,6,"P.P.",307
19,"19167",136,112,109,4,3,"P.P.",89
34,"34031",29,26,26,0,0,"P.P.",19
34,"34029",832,696,683,11,13,"P.P.",483
40,"40056",41,34,34,0,0,"P.P.",30
40,"40151",52,42,42,0,0,"P.P.",31
46,"46157",3068,2523,2491,17,32,"P.P.",1569
45,"45002",2500,1771,1756,26,15,"P.P.",1004
24,"24015",2391,1812,1782,20,30,"P.P.",1149
26,"26056",440,345,339,4,6,"P.P.",182
46,"46230",14204,10650,10515,112,135,"P.P.",5249
16,"16237",116,98,98,3,0,"P.P.",62
14,"14036",3774,2928,2909,51,19,"P.P.",820
37,"37149",78,69,69,0,0,"P.P.",52
21,"21049",3468,2327,2283,18,44,"P.P.",733
45,"45187",4187,3581,3512,25,69,"P.P.",1852
7,"7017",800,556,539,14,17,"P.P.",280
46,"46207",6453,5086,5031,52,55,"P.P.",2705
39,"39057",2298,1735,1719,17,16,"P.P.",936
40,"40012",280,215,213,2,2,"P.P.",131
9,"9076",24,15,15,0,0,"P.P.",13
46,"46117",476,377,373,6,4,"P.P.",189
37,"37150",43,36,34,0,2,"P.P.",34
34,"34032",47,36,36,1,0,"P.P.",18
39,"39032",1576,1215,1209,10,6,"P.P.",738
11,"11037",5640,4337,4285,32,52,"P.P.",678
9,"9124",1598,1151,1129,19,22,"P.P.",557
16,"16098",586,480,474,10,6,"P.P.",215
46,"46158",1037,829,822,9,7,"P.P.",422
16,"16186",521,434,429,2,5,"P.P.",257
7,"7019",230,165,164,1,1,"P.P.",119
35,"35025",1941,1345,1328,12,17,"P.P.",841
24,"24004",535,391,390,0,1,"P.P.",243
9,"9125",648,463,460,5,3,"P.P.",322
19,"19170",214,139,138,0,1,"P.P.",83
21,"21051",272,202,201,5,1,"P.P.",65
46,"46208",1141,990,978,6,12,"P.P.",487
45,"45005",267,223,218,4,5,"P.P.",126
9,"9215",426,290,287,1,3,"P.P.",185
5,"5027",290,233,230,2,3,"P.P.",161
16,"16100",764,660,655,3,5,"P.P.",379
37,"37190",235,195,193,1,2,"P.P.",118
9,"9172",129,110,109,2,1,"P.P.",68
33,"33050",653,406,402,0,4,"P.P.",77
9,"9041",27,27,27,0,0,"P.P.",12
19,"19182",38,24,22,0,2,"P.P.",8
26,"26020",506,372,364,10,8,"P.P.",230
45,"45080",3,3,3,0,0,"P.P.",3
39,"39068",663,488,485,4,3,"P.P.",218
5,"5017",87,69,68,1,1,"P.P.",47
16,"16057",109,82,82,1,0,"P.P.",38
33,"33028",1466,812,806,5,6,"P.P.",285
37,"37379",167,128,125,4,3,"P.P.",67
11,"11039",9943,6634,6582,104,52,"P.P.",3443
13,"13046",786,654,644,2,10,"P.P.",314
5,"5152",737,618,609,5,9,"P.P.",419
26,"26061",1552,1119,1099,31,20,"P.P.",545
37,"37267",210,169,165,0,4,"P.P.",82
40,"40158",24,18,17,0,1,"P.P.",16
9,"9128",82,65,63,0,2,"P.P.",38
19,"19269",103,84,83,0,1,"P.P.",32
37,"37155",81,57,57,0,0,"P.P.",20
5,"5018",27,24,24,0,0,"P.P.",11
12,"12095",1027,790,775,15,15,"P.P.",405
47,"47023",2863,2278,2258,38,20,"P.P.",1227
33,"33074",3699,2643,2611,30,32,"P.P.",1326
49,"49171",704,568,561,6,7,"P.P.",323
37,"37268",113,78,77,1,1,"P.P.",53
26,"26150",129,104,104,0,0,"P.P.",65
40,"40205",292,221,220,2,1,"P.P.",141
37,"37156",4319,3280,3233,28,47,"P.P.",2171
42,"42082",9,9,9,0,0,"P.P.",7
40,"40018",102,88,87,2,1,"P.P.",63
39,"39035",10031,7685,7601,74,84,"P.P.",3783
9,"9130",87,72,71,0,1,"P.P.",54
19,"19173",52,42,42,3,0,"P.P.",18
46,"46902",425,333,332,3,1,"P.P.",129
29,"29014",250,152,150,0,2,"P.P.",45
16,"16191",1001,867,864,13,3,"P.P.",475
39,"39061",3458,2673,2644,42,29,"P.P.",1651
46,"46113",2338,1804,1797,14,7,"P.P.",1075
9,"9262",158,139,137,7,2,"P.P.",85
37,"37157",94,65,65,0,0,"P.P.",31
47,"47160",466,368,364,5,4,"P.P.",221
46,"46211",1716,1459,1447,9,12,"P.P.",841
34,"34038",284,228,225,9,3,"P.P.",173
29,"29088",2784,2019,1975,14,44,"P.P.",765
9,"9176",60,47,45,2,2,"P.P.",28
5,"5121",250,181,178,1,3,"P.P.",104
19,"19174",126,88,86,0,2,"P.P.",50
12,"12098",665,552,539,9,13,"P.P.",310
42,"42139",22,18,17,0,1,"P.P.",15
16,"16246",520,417,407,1,10,"P.P.",253
21,"21055",6320,4819,4760,46,59,"P.P.",2782
39,"39089",163,126,126,0,0,"P.P.",81
39,"39037",2061,1609,1586,10,23,"P.P.",935
26,"26153",12,9,8,0,1,"P.P.",2
15,"15055",4780,3247,3181,70,66,"P.P.",1499
46,"46066",1264,1060,1050,5,10,"P.P.",561
16,"16107",161,101,98,1,3,"P.P.",50
21,"21056",2992,2172,2096,29,76,"P.P.",587
47,"47187",101,82,81,1,1,"P.P.",51
47,"47170",40,30,30,0,0,"P.P.",12
12,"12043",620,499,487,2,12,"P.P.",277
19,"19272",86,67,65,1,2,"P.P.",30
40,"40163",62,51,51,5,0,"P.P.",34
39,"39038",1465,1065,1047,8,18,"P.P.",547
19,"19308",67,61,61,0,0,"P.P.",39
47,"47196",43,29,29,0,0,"P.P.",26
26,"26067",22,19,19,1,0,"P.P.",15
21,"21057",1054,699,697,9,2,"P.P.",217
16,"16108",68,56,55,0,1,"P.P.",21
5,"5123",90,69,69,3,0,"P.P.",49
45,"45013",1870,1504,1486,5,18,"P.P.",944
37,"37311",251,210,209,8,1,"P.P.",129
40,"40071",52,45,45,4,0,"P.P.",27
5,"5023",177,160,158,1,2,"P.P.",108
45,"45087",8428,6434,6292,74,142,"P.P.",3873
47,"47162",80,62,62,1,0,"P.P.",45
33,"33032",12060,8627,8491,107,136,"P.P.",2540
9,"9134",237,164,159,7,5,"P.P.",79
7,"7027",20045,12873,12678,204,195,"P.P.",6679
49,"49002",77,59,59,1,0,"P.P.",29
19,"19309",37,32,31,0,1,"P.P.",19
9,"9408",45,36,36,0,0,"P.P.",32
5,"5024",268,205,201,2,4,"P.P.",121
26,"26157",306,268,263,1,5,"P.P.",186
45,"45088",2038,1379,1356,14,23,"P.P.",795
7,"7061",9429,5937,5800,125,137,"P.P.",2674
19,"19325",127,105,102,4,3,"P.P.",68
47,"47189",164,134,134,1,0,"P.P.",89
41,"41063",2678,1869,1853,22,16,"P.P.",493
9,"9315",362,267,265,9,2,"P.P.",150
13,"13019",5254,4038,3978,62,60,"P.P.",1864
46,"46214",15129,11609,11500,116,109,"P.P.",5974
33,"33033",10609,7179,7107,91,72,"P.P.",2235
38,"38005",5327,3316,3270,38,46,"P.P.",1101
26,"26030",12,12,12,0,0,"P.P.",10
37,"37314",79,61,61,3,0,"P.P.",48
5,"5221",398,298,297,10,1,"P.P.",153
19,"19278",30,28,28,0,0,"P.P.",22
40,"40168",36,27,27,0,0,"P.P.",15
45,"45138",1185,998,973,5,25,"P.P.",586
21,"21060",11685,8026,7932,135,94,"P.P.",3995
5,"5026",229,193,192,2,1,"P.P.",134
9,"9181",334,271,271,14,0,"P.P.",184
16,"16198",1451,1126,1105,21,21,"P.P.",488
37,"37164",280,217,213,9,4,"P.P.",114
26,"26031",120,100,100,0,0,"P.P.",58
9,"9137",177,134,134,6,0,"P.P.",79
46,"46215",1451,1185,1169,8,16,"P.P.",423
40,"40170",1383,1091,1072,11,19,"P.P.",668
29,"29093",2299,1767,1732,7,35,"P.P.",707
16,"16199",27,20,19,0,1,"P.P.",16
7,"7030",1576,1150,1135,26,15,"P.P.",606
46,"46216",4806,3857,3825,39,32,"P.P.",2155
19,"19181",69,54,54,5,0,"P.P.",32
47,"47111",1005,804,794,5,10,"P.P.",376
40,"40030",520,432,425,9,7,"P.P.",188
26,"26162",116,94,93,2,1,"P.P.",45
47,"47183",150,125,122,0,3,"P.P.",89
37,"37165",27,20,20,1,0,"P.P.",13
9,"9318",63,38,38,0,0,"P.P.",22
29,"29094",54317,36540,36174,410,366,"P.P.",20044
19,"19280",3415,2521,2490,27,31,"P.P.",1325
16,"16071",25,23,23,0,0,"P.P.",14
33,"33020",13542,9300,9173,135,127,"P.P.",3094
16,"16255",159,123,122,3,1,"P.P.",71
19,"19246",48,38,38,1,0,"P.P.",13
12,"12014",191,139,137,4,2,"P.P.",66
47,"47084",1230,981,968,19,13,"P.P.",515
45,"45092",252,223,221,0,2,"P.P.",150
24,"24191",112,88,88,1,0,"P.P.",49
45,"45203",2535,1883,1829,21,54,"P.P.",953
16,"16072",161,126,123,0,3,"P.P.",69
37,"37279",780,580,571,6,9,"P.P.",359
46,"46241",440,336,314,4,22,"P.P.",149
46,"46168",1828,1461,1449,7,12,"P.P.",728
5,"5226",92,67,67,0,0,"P.P.",60
47,"47006",196,151,146,1,5,"P.P.",69
9,"9230",41,33,33,0,0,"P.P.",31
45,"45057",222,197,189,0,8,"P.P.",119
19,"19282",210,157,157,0,0,"P.P.",118
33,"33036",11674,8695,8605,104,90,"P.P.",3198
45,"45020",1396,1165,1151,15,14,"P.P.",718
45,"45094",441,358,353,6,5,"P.P.",177
49,"49009",430,309,309,0,0,"P.P.",222
40,"40033",61,48,47,3,1,"P.P.",27
5,"5030",43,39,39,0,0,"P.P.",10
40,"40176",418,344,341,8,3,"P.P.",183
9,"9140",136,110,110,1,0,"P.P.",57
19,"19319",4203,3139,3104,28,35,"P.P.",1634
33,"33037",37135,25522,25262,291,260,"P.P.",7851
26,"26036",16873,12341,12167,190,174,"P.P.",7232
45,"45205",6333,4544,4451,58,93,"P.P.",2634
16,"16103",310,263,259,4,4,"P.P.",177
5,"5033",184,159,155,3,4,"P.P.",110
9,"9141",607,503,481,10,22,"P.P.",265
26,"26166",152,139,136,1,3,"P.P.",117
36,"36037",2727,1923,1896,18,27,"P.P.",1203
47,"47222",92,77,77,4,0,"P.P.",45
40,"40129",203,166,162,1,4,"P.P.",122
21,"21065",295,212,211,0,1,"P.P.",121
15,"15063",2849,2022,2001,28,21,"P.P.",1282
40,"40035",146,114,112,3,2,"P.P.",73
14,"14021",259993,183200,181402,2936,1798,"P.P.",96620
19,"19218",60,35,35,0,0,"P.P.",24
49,"49011",236,195,194,5,1,"P.P.",140
12,"12107",358,314,311,4,3,"P.P.",166
34,"34010",560,458,451,7,7,"P.P.",270
9,"9191",45,34,33,1,1,"P.P.",23
33,"33038",2442,1757,1725,14,32,"P.P.",507
49,"49012",73,43,43,0,0,"P.P.",30
39,"39045",410,324,323,5,1,"P.P.",176
47,"47008",26,17,17,0,0,"P.P.",15
37,"37171",437,362,358,4,4,"P.P.",291
40,"40179",634,545,538,4,7,"P.P.",313
5,"5165",386,292,280,7,12,"P.P.",168
49,"49013",300,230,228,6,2,"P.P.",139
26,"26052",181,146,146,0,0,"P.P.",95
15,"15064",2356,1859,1824,35,35,"P.P.",905
9,"9144",61,51,50,0,1,"P.P.",38
13,"13061",5898,4442,4373,56,69,"P.P.",2345
19,"19196",99,80,74,2,6,"P.P.",45
33,"33069",3611,2615,2597,25,18,"P.P.",1044
19,"19286",743,566,554,8,12,"P.P.",310
16,"16081",64,46,45,1,1,"P.P.",22
9,"9279",195,140,140,4,0,"P.P.",96
5,"5067",85,68,68,0,0,"P.P.",47
5,"5186",1670,1306,1287,9,19,"P.P.",885
26,"26170",471,353,348,4,5,"P.P.",226
46,"46250",574266,435877,431619,4626,4258,"P.P.",226404
38,"38014",1446,1018,1007,8,11,"P.P.",447
46,"46002",1166,942,915,7,27,"P.P.",458
9,"9148",95,75,75,2,0,"P.P.",33
49,"49014",134,104,102,1,2,"P.P.",71
16,"16212",286,229,226,3,3,"P.P.",113
33,"33039",1719,1325,1319,14,6,"P.P.",442
5,"5037",296,213,212,0,1,"P.P.",178
46,"46221",350,319,317,3,2,"P.P.",172
9,"9375",42,30,30,1,0,"P.P.",22
45,"45026",269,200,198,2,2,"P.P.",96
47,"47197",932,739,730,15,9,"P.P.",394
14,"14055",18619,13802,13607,192,195,"P.P.",5744
37,"37286",231,166,160,2,6,"P.P.",58
37,"37174",1150,942,922,3,20,"P.P.",565
47,"47010",11275,8800,8701,163,99,"P.P.",4711
33,"33063",467,367,363,4,4,"P.P.",197
47,"47145",658,482,473,7,9,"P.P.",308
46,"46028",424,352,347,5,5,"P.P.",190
9,"9432",212,161,158,1,3,"P.P.",77
46,"46076",651,541,528,2,13,"P.P.",293
13,"13097",2309,1843,1825,20,18,"P.P.",997
40,"40088",303,242,238,0,4,"P.P.",161
33,"33025",9455,6331,6277,84,54,"P.P.",2325
11,"11026",4834,3736,3691,27,45,"P.P.",1821
5,"5038",131,88,84,0,4,"P.P.",68
9,"9196",161,111,110,0,1,"P.P.",50
37,"37363",121,100,99,0,1,"P.P.",52
37,"37212",123,95,92,1,3,"P.P.",54
46,"46198",815,660,654,4,6,"P.P.",251
45,"45028",3696,3059,3024,40,35,"P.P.",1542
41,"41046",3055,2456,2418,23,38,"P.P.",508
7,"7018",389,275,271,0,4,"P.P.",115
9,"9025",150,112,110,0,2,"P.P.",76
37,"37176",136,103,100,1,3,"P.P.",65
9,"9152",273,207,207,1,0,"P.P.",121
16,"16085",151,123,122,2,1,"P.P.",82
24,"24029",840,590,579,11,11,"P.P.",253
29,"29073",1520,1032,1021,10,11,"P.P.",300
26,"26174",154,122,122,2,0,"P.P.",78
47,"47173",862,683,675,5,8,"P.P.",284
42,"42163",53,41,41,0,0,"P.P.",19
40,"40044",160,117,114,4,3,"P.P.",66
37,"37289",265,211,209,0,2,"P.P.",139
37,"37214",134,94,94,4,0,"P.P.",61
16,"16086",935,814,802,14,12,"P.P.",453
16,"16273",328,277,275,2,2,"P.P.",216
37,"37365",172,152,149,2,3,"P.P.",108
7,"7041",2077,1583,1549,27,34,"P.P.",756
40,"40045",123,102,102,0,0,"P.P.",63
37,"37316",792,565,559,7,6,"P.P.",406
34,"34020",63,44,44,0,0,"P.P.",30
33,"33042",4434,3172,3135,43,37,"P.P.",1267
15,"15069",7019,5036,4938,85,98,"P.P.",2314
26,"26046",1617,1237,1219,14,18,"P.P.",691
9,"9243",87,66,64,2,2,"P.P.",36
33,"33012",5341,3816,3777,43,39,"P.P.",1464
19,"19215",206,170,166,0,4,"P.P.",129
21,"21021",11825,7657,7574,108,83,"P.P.",3861
47,"47211",45,38,38,1,0,"P.P.",34
5,"5084",81,70,69,0,1,"P.P.",49
5,"5902",319,262,262,0,0,"P.P.",177
37,"37304",190,144,142,1,2,"P.P.",101
16,"16088",125,103,103,1,0,"P.P.",49
12,"12115",234,184,183,2,1,"P.P.",139
47,"47014",55,47,47,0,0,"P.P.",32
46,"46006",4643,3847,3785,32,62,"P.P.",2190
42,"42166",68,49,48,1,1,"P.P.",27
26,"26177",322,276,274,2,2,"P.P.",169
40,"40002",38,31,31,1,0,"P.P.",16
13,"13035",1043,794,770,10,24,"P.P.",341
39,"39051",73,62,62,2,0,"P.P.",28
26,"26062",94,78,77,1,1,"P.P.",55
37,"37058",68,44,44,0,0,"P.P.",32
26,"26048",29,27,26,1,1,"P.P.",15
37,"37331",234,161,161,3,0,"P.P.",124
42,"42063",69,53,53,4,0,"P.P.",33
47,"47041",166,135,133,2,2,"P.P.",87
9,"9472",58,46,46,0,0,"P.P.",30
39,"39052",17031,13198,13034,187,164,"P.P.",7336
26,"26179",49,39,36,0,3,"P.P.",18
46,"46007",11576,8929,8848,71,81,"P.P.",5188
5,"5903",171,118,118,0,0,"P.P.",63
47,"47204",275,221,219,3,2,"P.P.",116
49,"49249",78,63,63,0,0,"P.P.",50
9,"9451",244,208,202,1,6,"P.P.",82
40,"40065",520,401,393,6,8,"P.P.",264
14,"14031",634,516,514,1,2,"P.P.",183
38,"38022",18671,13075,12890,111,185,"P.P.",6794
26,"26050",114,84,81,1,3,"P.P.",57
12,"12017",183,143,141,6,2,"P.P.",80
47,"47042",63,50,49,3,1,"P.P.",26
37,"37181",301,232,230,2,2,"P.P.",153
47,"47016",94,77,77,1,0,"P.P.",42
46,"46227",923,787,771,4,16,"P.P.",335
7,"7046",13748,8294,8183,183,111,"P.P.",3964
37,"37219",197,121,120,0,1,"P.P.",84
12,"12117",3674,2846,2794,25,52,"P.P.",1627
47,"47133",2382,1861,1841,30,20,"P.P.",934
13,"13048",538,441,433,5,8,"P.P.",225
24,"24050",113,91,90,0,1,"P.P.",56
19,"19333",142,86,84,0,2,"P.P.",44
37,"37334",86,50,49,0,1,"P.P.",38
5,"5143",81,61,61,0,0,"P.P.",42
16,"16093",80,57,57,0,0,"P.P.",40
13,"13005",23052,18002,17700,255,302,"P.P.",8948
26,"26183",65,54,54,0,0,"P.P.",30
45,"45146",117,99,98,0,1,"P.P.",69
11,"11005",4617,3287,3214,26,73,"P.P.",1024
9,"9177",1154,823,815,12,8,"P.P.",523
5,"5208",55,45,45,0,0,"P.P.",23
33,"33046",546,429,421,3,8,"P.P.",103
12,"12119",153,87,87,0,0,"P.P.",66
40,"40083",88,72,72,1,0,"P.P.",52
19,"19230",438,317,309,4,8,"P.P.",153
37,"37372",145,109,109,0,0,"P.P.",59
40,"40007",86,70,69,0,1,"P.P.",54
46,"46904",782,659,650,6,9,"P.P.",288
12,"12078",365,273,267,5,6,"P.P.",152
9,"9223",46,40,40,0,0,"P.P.",32
9,"9298",90,74,74,1,0,"P.P.",62
7,"7048",15296,8559,8439,176,120,"P.P.",3827
46,"46035",6470,5115,5047,38,68,"P.P.",2328
9,"9166",97,87,87,1,0,"P.P.",73
37,"37185",602,452,448,8,4,"P.P.",325
40,"40055",41,32,31,0,1,"P.P.",11
19,"19197",29,19,19,0,0,"P.P.",4
9,"9346",95,83,83,1,0,"P.P.",57
46,"46108",550,446,444,3,2,"P.P.",234
13,"13040",933,755,744,4,11,"P.P.",389
9,"9251",417,292,288,3,4,"P.P.",163
16,"16137",64,41,40,0,1,"P.P.",29
37,"37337",140,122,121,0,1,"P.P.",108
7,"7049",1482,1046,1037,14,9,"P.P.",566
37,"37299",237,167,165,2,2,"P.P.",130
14,"14005",6334,4262,4206,61,56,"P.P.",1461
24,"24080",228,165,164,0,1,"P.P.",112
37,"37186",109,88,88,2,0,"P.P.",61
9,"9302",116,87,87,3,0,"P.P.",58
45,"45052",2793,2247,2212,38,35,"P.P.",1255
36,"36053",5677,4204,4157,51,47,"P.P.",2209
39,"39005",1319,1048,1026,3,22,"P.P.",678
9,"9409",138,105,102,0,3,"P.P.",52
38,"38027",5392,3530,3459,41,71,"P.P.",1574
40,"40105",60,51,51,1,0,"P.P.",27
19,"19300",746,595,585,3,10,"P.P.",342
37,"37339",345,280,279,3,1,"P.P.",165
19,"19199",24,21,21,0,0,"P.P.",7
9,"9303",92,64,64,0,0,"P.P.",50
12,"12058",99,74,74,0,0,"P.P.",59
16,"16140",34,27,27,0,0,"P.P.",14
34,"34001",36,29,29,2,0,"P.P.",15
21,"21019",645,464,458,2,6,"P.P.",157
9,"9316",108,87,84,0,3,"P.P.",63
47,"47182",1371,991,982,12,9,"P.P.",584
5,"5049",440,335,330,8,5,"P.P.",190
45,"45114",608,476,468,3,8,"P.P.",236
7,"7052",4578,2671,2651,46,20,"P.P.",1183
16,"16141",161,132,131,1,1,"P.P.",74
16,"16015",407,311,311,4,0,"P.P.",223
33,"33049",6806,4629,4581,70,48,"P.P.",1789
9,"9304",197,168,165,1,3,"P.P.",120
40,"40059",124,104,104,2,0,"P.P.",62
9,"9437",298,249,247,5,2,"P.P.",146
33,"33072",1737,1171,1159,11,12,"P.P.",385
9,"9170",218,158,157,0,1,"P.P.",113
39,"39058",862,586,584,6,2,"P.P.",234
37,"37189",139,90,90,1,0,"P.P.",55
39,"39085",6722,5198,5134,60,64,"P.P.",2644
5,"5901",289,197,196,4,1,"P.P.",135
7,"7064",5286,3340,3279,53,61,"P.P.",1373
45,"45079",368,278,273,1,5,"P.P.",152
15,"15050",1971,1110,1097,27,13,"P.P.",594
11,"11038",13815,10849,10756,126,93,"P.P.",4875
26,"26033",183,157,156,2,1,"P.P.",67
29,"29029",452,339,336,0,3,"P.P.",169
40,"40092",132,100,100,0,0,"P.P.",69
34,"34004",5790,4354,4262,84,92,"P.P.",2405
40,"40031",515,410,404,7,6,"P.P.",194
5,"5128",361,288,280,3,8,"P.P.",125
45,"45043",827,679,670,3,9,"P.P.",375
26,"26074",128,102,101,0,1,"P.P.",58
26,"26148",189,151,150,0,1,"P.P.",75
7,"7054",19930,11186,11028,196,158,"P.P.",5922
47,"47022",62,54,54,0,0,"P.P.",47
37,"37191",127,86,85,1,1,"P.P.",58
23,"23069",5489,4656,4586,36,70,"P.P.",2022
46,"46160",1976,1591,1570,21,21,"P.P.",664
46,"46234",388,308,307,3,1,"P.P.",145
16,"16018",417,350,342,3,8,"P.P.",248
33,"33051",7576,5379,5335,65,44,"P.P.",2282
38,"38009",3910,2687,2633,31,54,"P.P.",1255
47,"47184",575,447,443,6,4,"P.P.",298
9,"9439",909,720,697,16,23,"P.P.",385
23,"23027",763,619,616,1,3,"P.P.",211
47,"47076",16922,13030,12899,212,131,"P.P.",6079
47,"47158",906,716,710,10,6,"P.P.",305
16,"16158",550,427,423,2,4,"P.P.",258
45,"45008",158,129,127,0,2,"P.P.",76
12,"12126",24420,18431,18136,231,295,"P.P.",9566
45,"45046",2455,1884,1862,11,22,"P.P.",1021
9,"9261",486,342,338,7,4,"P.P.",168
39,"39087",43561,33709,33242,404,467,"P.P.",14748
46,"46056",203,164,160,2,4,"P.P.",74
40,"40112",2346,1848,1798,35,50,"P.P.",994
7,"7056",4701,3164,3090,55,74,"P.P.",1521
46,"46162",1230,1045,1027,6,18,"P.P.",577
5,"5054",1282,979,965,5,14,"P.P.",478
47,"47103",277,218,214,1,4,"P.P.",115
47,"47050",3557,2688,2651,50,37,"P.P.",1367
42,"42154",95,73,73,0,0,"P.P.",43
9,"9175",143,99,98,0,1,"P.P.",81
46,"46016",1097,927,917,12,10,"P.P.",387
9,"9310",14,10,9,2,1,"P.P.",1
39,"39062",1759,1397,1387,9,10,"P.P.",949
15,"15082",15075,11217,11046,187,171,"P.P.",5632
46,"46098",2556,2072,2057,12,15,"P.P.",1081
23,"23044",4897,3943,3893,13,50,"P.P.",1652
46,"46138",338,297,296,1,1,"P.P.",178
47,"47186",251279,193705,191693,2746,2012,"P.P.",98877
19,"19271",53,45,45,1,0,"P.P.",31
36,"36027",4478,3376,3339,29,37,"P.P.",2176
40,"40115",126,98,95,2,3,"P.P.",53
9,"9442",385,295,289,4,6,"P.P.",160
13,"13049",838,654,648,0,6,"P.P.",420
5,"5088",34,26,26,0,0,"P.P.",22
37,"37195",48,32,32,0,0,"P.P.",6
45,"45023",1936,1476,1456,18,20,"P.P.",790
46,"46236",996,853,844,7,9,"P.P.",337
33,"33008",1934,1474,1459,11,15,"P.P.",572
19,"19241",45,37,37,2,0,"P.P.",31
37,"37322",2501,1692,1676,32,16,"P.P.",930
42,"42069",1591,1122,1114,33,8,"P.P.",624
33,"33061",446,260,259,1,1,"P.P.",100
47,"47061",266,227,223,0,4,"P.P.",99
5,"5218",148,123,117,1,6,"P.P.",70
26,"26125",2720,2121,2084,26,37,"P.P.",1192
34,"34041",100,79,78,1,1,"P.P.",53
26,"26040",67,63,62,2,1,"P.P.",45
38,"38002",991,716,708,1,8,"P.P.",200
23,"23032",598,518,515,0,3,"P.P.",127
16,"16150",120,90,90,0,0,"P.P.",52
33,"33054",1780,1272,1263,8,9,"P.P.",497
11,"11901",5576,4433,4398,69,35,"P.P.",1765
9,"9407",31,27,27,0,0,"P.P.",17
5,"5187",1833,1385,1361,16,24,"P.P.",781
46,"46019",8671,7195,7109,70,86,"P.P.",3125
26,"26112",270,201,200,0,1,"P.P.",119
16,"16109",46,34,34,2,0,"P.P.",18
40,"40165",95,72,71,1,1,"P.P.",40
9,"9314",113,89,88,4,1,"P.P.",47
45,"45014",4087,2851,2816,36,35,"P.P.",1261
47,"47217",1812,1395,1377,20,18,"P.P.",702
47,"47028",31,21,20,0,1,"P.P.",19
38,"38037",13166,8509,8332,65,177,"P.P.",4009
46,"46238",13401,10371,10283,96,88,"P.P.",5503
9,"9445",46,31,31,1,0,"P.P.",21
9,"9391",383,290,284,7,6,"P.P.",180
18,"18182",1982,1405,1397,6,8,"P.P.",604
49,"49271",221,178,176,2,2,"P.P.",89
38,"38004",4522,3034,2975,33,59,"P.P.",1490
9,"9419",82,61,61,0,0,"P.P.",55
40,"40073",425,371,367,3,4,"P.P.",230
19,"19212",795,644,632,2,12,"P.P.",410
12,"12001",1098,821,817,8,4,"P.P.",439
16,"16166",277,210,202,0,8,"P.P.",109
12,"12132",524,407,401,4,6,"P.P.",192
5,"5189",478,361,360,3,1,"P.P.",248
40,"40122",551,417,414,9,3,"P.P.",209
12,"12036",668,529,514,6,15,"P.P.",284
24,"24067",700,453,447,4,6,"P.P.",319
24,"24120",379,258,256,3,2,"P.P.",191
46,"46101",868,720,716,8,4,"P.P.",313
45,"45016",3804,2926,2876,52,50,"P.P.",1643
47,"47003",263,224,222,1,2,"P.P.",137
46,"46239",457,331,323,2,8,"P.P.",198
19,"19213",72,60,60,1,0,"P.P.",40
5,"5159",287,216,216,0,0,"P.P.",191
33,"33057",1635,1150,1132,16,18,"P.P.",323
5,"5160",339,290,286,2,4,"P.P.",223
47,"47030",1075,822,801,13,21,"P.P.",449
37,"37315",99,77,75,3,2,"P.P.",59
40,"40076",6641,4958,4862,67,96,"P.P.",2691
16,"16253",340,256,256,4,0,"P.P.",181
9,"9448",225,188,186,1,2,"P.P.",157
16,"16112",1562,1159,1140,12,19,"P.P.",577
9,"9272",319,225,225,5,0,"P.P.",144
34,"34223",233,175,175,2,0,"P.P.",149
9,"9395",164,134,133,1,1,"P.P.",74
26,"26059",1137,887,869,9,18,"P.P.",530
47,"47219",46,36,36,1,0,"P.P.",17
47,"47165",7036,5328,5258,67,70,"P.P.",2873
12,"12082",9741,7555,7408,84,147,"P.P.",4287
45,"45030",486,378,374,4,4,"P.P.",177
37,"37366",46,35,34,0,1,"P.P.",0
38,"38007",1844,1209,1188,5,21,"P.P.",521
42,"42151",38,32,29,0,3,"P.P.",14
24,"24139",2320,1687,1654,16,33,"P.P.",947
46,"46143",4278,3309,3266,46,43,"P.P.",1854
45,"45056",2246,1523,1502,16,21,"P.P.",804
45,"45031",2773,2011,1975,25,36,"P.P.",1133
40,"40001",713,575,562,10,13,"P.P.",353
5,"5062",213,188,184,3,4,"P.P.",140
37,"37317",323,281,278,3,3,"P.P.",186
37,"37203",174,148,148,0,0,"P.P.",90
5,"5192",96,78,77,1,1,"P.P.",51
9,"9321",1760,1338,1327,20,11,"P.P.",682
40,"40127",45,33,33,0,0,"P.P.",26
24,"24222",13915,9939,9751,304,188,"P.P.",4546
40,"40173",148,121,120,3,1,"P.P.",64
9,"9030",135,97,97,2,0,"P.P.",58
13,"13024",938,703,699,3,4,"P.P.",421
7,"7033",25954,14975,14738,328,237,"P.P.",7694
34,"34050",216,170,166,1,4,"P.P.",118
15,"15089",4354,3255,3216,55,39,"P.P.",1943
13,"13091",570,484,478,0,6,"P.P.",273
26,"26091",165,139,139,0,0,"P.P.",109
9,"9325",217,151,148,1,3,"P.P.",107
47,"47032",161,130,129,3,1,"P.P.",99
37,"37205",235,199,195,5,4,"P.P.",88
16,"16073",214,170,170,2,0,"P.P.",101
46,"46097",890,674,662,2,12,"P.P.",388
34,"34091",136,105,103,1,2,"P.P.",67
26,"26165",350,297,294,1,3,"P.P.",164
40,"40903",102,75,75,0,0,"P.P.",64
46,"46243",149,120,117,0,3,"P.P.",63
12,"12137",47,36,35,0,1,"P.P.",8
45,"45021",2399,1834,1804,23,30,"P.P.",1003
33,"33014",9318,6380,6320,66,60,"P.P.",1915
16,"16205",126,94,93,0,1,"P.P.",64
9,"9473",94,81,81,2,0,"P.P.",59
37,"37245",357,273,272,2,1,"P.P.",163
16,"16078",40954,30382,29933,568,449,"P.P.",16352
16,"16118",1454,1221,1211,19,10,"P.P.",746
16,"16206",250,188,188,2,0,"P.P.",111
45,"45096",1021,800,778,5,22,"P.P.",417
46,"46178",4406,3235,3201,22,34,"P.P.",1863
49,"49266",83,69,69,1,0,"P.P.",38
38,"38044",2325,1550,1532,7,18,"P.P.",659
24,"24225",1089,798,784,15,14,"P.P.",485
40,"40178",104,80,79,1,1,"P.P.",65
47,"47195",449,350,346,5,4,"P.P.",157
37,"37321",169,144,144,1,0,"P.P.",85
45,"45060",204,151,148,1,3,"P.P.",43
37,"37246",5430,4363,4315,63,48,"P.P.",2544
42,"42204",64,49,44,4,5,"P.P.",30
26,"26168",5055,3534,3484,47,50,"P.P.",1805
13,"13038",1770,1397,1380,8,17,"P.P.",558
11,"11033",19983,12960,12807,199,153,"P.P.",6152
16,"16121",270,211,207,1,4,"P.P.",94
13,"13094",338,276,275,2,1,"P.P.",182
47,"47069",128,108,108,0,0,"P.P.",64
40,"40118",59,44,43,1,1,"P.P.",26
30,"30006",823,719,711,5,8,"P.P.",461
19,"19262",184,137,136,0,1,"P.P.",87
47,"47044",325,257,252,1,5,"P.P.",125
12,"12088",55,51,51,2,0,"P.P.",35
38,"38013",2823,1856,1843,18,13,"P.P.",793
40,"40022",210,154,151,2,3,"P.P.",75
19,"19252",90,80,78,0,2,"P.P.",47
37,"37360",252,194,194,1,0,"P.P.",123
16,"16266",402,334,325,4,9,"P.P.",219
12,"12044",527,472,463,4,9,"P.P.",204
16,"16122",259,195,190,2,5,"P.P.",100
39,"39073",9275,6984,6903,83,81,"P.P.",3830
47,"47036",257,212,212,1,0,"P.P.",125
9,"9329",117,80,79,1,1,"P.P.",37
45,"45025",1237,919,907,11,12,"P.P.",467
5,"5167",274,230,224,6,6,"P.P.",80
12,"12140",1204,975,954,9,21,"P.P.",437
26,"26126",32,31,31,1,0,"P.P.",25
49,"49105",158,135,133,2,2,"P.P.",103
38,"38048",3884,2615,2587,34,28,"P.P.",1031
13,"13096",7716,5759,5659,70,100,"P.P.",3239
16,"16123",110,74,73,1,1,"P.P.",36
42,"42106",15,14,14,0,0,"P.P.",5
23,"23093",3313,2706,2673,13,33,"P.P.",705
46,"46003",988,864,847,13,17,"P.P.",462
52,"52001",51028,26966,26659,496,307,"P.P.",17791
47,"47163",315,253,250,2,3,"P.P.",97
5,"5188",55,47,47,0,0,"P.P.",42
26,"26083",303,234,234,1,0,"P.P.",130
37,"37312",278,232,229,1,3,"P.P.",154
16,"16110",98,81,81,3,0,"P.P.",70
29,"29072",3258,2484,2447,30,37,"P.P.",973
34,"34017",960,772,760,15,12,"P.P.",439
47,"47209",43,33,33,0,0,"P.P.",16
37,"37327",191,148,148,9,0,"P.P.",79
47,"47227",62,52,52,1,0,"P.P.",28
12,"12080",2051,1692,1650,23,42,"P.P.",669
9,"9332",137,88,85,1,3,"P.P.",55
46,"46012",930,698,684,9,14,"P.P.",398
46,"46125",858,724,710,6,14,"P.P.",330
36,"36021",11798,8742,8574,136,168,"P.P.",4617
5,"5072",91,72,72,1,0,"P.P.",55
34,"34018",229,184,182,3,2,"P.P.",107
45,"45065",317,261,258,0,3,"P.P.",134
9,"9334",52,40,39,1,1,"P.P.",19
45,"45102",3539,2581,2533,23,48,"P.P.",1604
47,"47147",129,96,96,0,0,"P.P.",75
9,"9026",384,296,295,8,1,"P.P.",158
47,"47038",128,91,91,0,0,"P.P.",52
40,"40091",140,111,109,1,2,"P.P.",72
9,"9198",115,85,85,1,0,"P.P.",46
47,"47064",30,21,21,1,0,"P.P.",12
47,"47200",91,73,73,0,0,"P.P.",60
33,"33064",237,175,173,1,2,"P.P.",50
45,"45139",231,198,194,0,4,"P.P.",89
46,"46127",2790,2298,2267,23,31,"P.P.",1247
47,"47056",90,69,69,2,0,"P.P.",51
26,"26117",2152,1682,1655,20,27,"P.P.",920
9,"9228",168,143,143,3,0,"P.P.",89
26,"26006",1853,1456,1430,15,26,"P.P.",790
40,"40156",361,268,264,5,4,"P.P.",187
42,"42149",404,292,286,12,6,"P.P.",146
9,"9206",65,56,55,2,1,"P.P.",40
9,"9424",42,35,34,1,1,"P.P.",30
16,"16170",733,552,543,3,9,"P.P.",299
40,"40125",99,72,71,3,1,"P.P.",48
33,"33035",11413,8105,8035,104,70,"P.P.",3137
9,"9352",134,107,106,0,1,"P.P.",62
9,"9396",152,113,113,0,0,"P.P.",85
13,"13045",744,615,608,6,7,"P.P.",371
37,"37330",338,272,270,3,2,"P.P.",171
5,"5172",147,122,122,0,0,"P.P.",79
9,"9200",54,35,35,2,0,"P.P.",21
16,"16005",275,215,215,2,0,"P.P.",122
21,"21012",331,254,246,2,8,"P.P.",103
46,"46249",9650,7288,7191,125,97,"P.P.",3615
47,"47093",865,658,642,11,16,"P.P.",344
5,"5236",147,101,101,0,0,"P.P.",61
33,"33005",1600,1084,1080,6,4,"P.P.",386
45,"45154",1459,1148,1140,12,8,"P.P.",669
46,"46152",96,70,70,0,0,"P.P.",41
16,"16058",120,103,102,1,1,"P.P.",50
12,"12051",520,382,376,1,6,"P.P.",312
16,"16089",386,310,308,10,2,"P.P.",179
37,"37356",90,66,66,1,0,"P.P.",46
29,"29076",2022,1384,1374,14,10,"P.P.",497
33,"33067",802,650,639,12,11,"P.P.",152
39,"39078",1407,1041,1033,10,8,"P.P.",486
37,"37218",81,51,51,1,0,"P.P.",43
9,"9032",118,68,68,0,0,"P.P.",28
16,"16006",133,117,116,2,1,"P.P.",58
41,"41050",5102,4224,4183,39,41,"P.P.",1668
37,"37089",74,54,54,2,0,"P.P.",40
9,"9354",33,29,29,2,0,"P.P.",17
24,"24088",1103,903,885,4,18,"P.P.",546
45,"45047",2404,1685,1662,7,23,"P.P.",1119
19,"19228",39,30,29,0,1,"P.P.",11
5,"5174",81,71,71,1,0,"P.P.",53
41,"41033",5237,3915,3878,20,37,"P.P.",1378
19,"19010",15,13,13,1,0,"P.P.",8
39,"39079",9035,6959,6897,55,62,"P.P.",3817
11,"11004",87610,53062,52639,828,423,"P.P.",28096
45,"45038",3125,2401,2374,33,27,"P.P.",1534
14,"14062",1114,889,882,9,7,"P.P.",432
40,"40019",43,35,35,0,0,"P.P.",24
24,"24144",781,551,541,13,10,"P.P.",320
40,"40161",38,28,28,0,0,"P.P.",18
41,"41101",5752,4663,4629,25,34,"P.P.",1688
13,"13071",41043,28435,28183,370,252,"P.P.",13392
37,"37258",206,151,149,2,2,"P.P.",96
9,"9249",54,44,42,1,2,"P.P.",27
21,"21015",728,453,447,6,6,"P.P.",95
14,"14032",434,377,375,1,2,"P.P.",179
47,"47206",111,99,99,0,0,"P.P.",53
37,"37371",285,190,190,2,0,"P.P.",129
16,"16193",77,68,67,0,1,"P.P.",24
41,"41009",1272,914,899,8,15,"P.P.",416
7,"7025",457,355,346,3,9,"P.P.",206
47,"47079",67,56,56,1,0,"P.P.",50
34,"34039",66,57,56,0,1,"P.P.",50
9,"9235",179,148,142,1,6,"P.P.",67
16,"16036",143,117,115,1,2,"P.P.",61
23,"23059",5974,4910,4852,37,58,"P.P.",2017
23,"23046",2441,2049,2027,13,22,"P.P.",763
45,"45024",1105,870,856,16,14,"P.P.",586
16,"16055",698,485,481,8,4,"P.P.",290
16,"16211",462,317,313,2,4,"P.P.",175
24,"24131",813,583,580,9,3,"P.P.",404
7,"7059",3011,2077,2012,22,65,"P.P.",1135
47,"47070",33,30,30,1,0,"P.P.",24
5,"5080",75,53,53,1,0,"P.P.",37
47,"47126",49,43,42,1,1,"P.P.",39
5,"5209",104,78,78,0,0,"P.P.",65
26,"26098",99,74,73,2,1,"P.P.",33
37,"37373",793,591,589,4,2,"P.P.",254
45,"45075",205,162,159,4,3,"P.P.",100
7,"7016",2726,1848,1809,34,39,"P.P.",858
16,"16151",66,56,56,0,0,"P.P.",41
11,"11035",13266,8794,8668,115,126,"P.P.",4367
40,"40120",173,145,144,1,1,"P.P.",84
13,"13008",473,362,360,4,2,"P.P.",227
13,"13055",738,585,578,8,7,"P.P.",254
45,"45076",603,420,419,3,1,"P.P.",234
45,"45051",1658,1305,1293,20,12,"P.P.",730
9,"9253",108,95,94,4,1,"P.P.",49
47,"47081",57,44,44,1,0,"P.P.",17
23,"23034",2591,2146,2124,13,22,"P.P.",849
26,"26069",276,211,208,5,3,"P.P.",147
16,"16156",122,91,91,0,0,"P.P.",46
9,"9079",49,44,44,1,0,"P.P.",37
16,"16052",596,469,464,2,5,"P.P.",226
5,"5125",60,52,52,0,0,"P.P.",40
40,"40110",391,303,302,6,1,"P.P.",167
37,"37263",361,277,275,1,2,"P.P.",157
26,"26100",59,51,51,1,0,"P.P.",26
9,"9483",226,173,171,4,2,"P.P.",100
18,"18162",947,726,721,8,5,"P.P.",346
19,"19244",95,82,82,6,0,"P.P.",59
12,"12091",203,153,140,2,13,"P.P.",86
11,"11036",725,484,482,10,2,"P.P.",185
16,"16067",135,97,97,2,0,"P.P.",62
33,"33003",737,475,471,6,4,"P.P.",176
40,"40107",113,93,90,3,3,"P.P.",71
45,"45093",168,133,133,0,0,"P.P.",91
37,"37028",175,130,125,1,5,"P.P.",98
26,"26115",20,20,20,4,0,"P.P.",12
47,"47138",259,198,195,3,3,"P.P.",103
33,"33011",12085,7186,7116,89,70,"P.P.",3274
19,"19266",278,234,231,4,3,"P.P.",165
45,"45041",3617,2672,2635,21,37,"P.P.",1527
21,"21020",398,282,282,3,0,"P.P.",93
40,"40155",3083,2333,2280,73,53,"P.P.",1137
23,"23065",1701,1238,1226,10,12,"P.P.",566
16,"16142",118,93,93,1,0,"P.P.",56
40,"40014",60,39,39,1,0,"P.P.",16
46,"46054",11422,8666,8566,82,100,"P.P.",4133
9,"9381",38,30,30,0,0,"P.P.",22
34,"34033",17,15,15,0,0,"P.P.",13
45,"45091",419,311,309,5,2,"P.P.",151
11,"11019",1871,1449,1425,9,24,"P.P.",617
23,"23072",2063,1661,1643,16,18,"P.P.",752
42,"42036",52,40,39,2,1,"P.P.",14
33,"33075",305,191,190,0,1,"P.P.",74
45,"45067",2385,1923,1878,19,45,"P.P.",1254
21,"21075",375,294,291,12,3,"P.P.",112
34,"34048",72,58,56,3,2,"P.P.",31
47,"47057",237,198,198,3,0,"P.P.",126
40,"40172",34,27,26,0,1,"P.P.",22
24,"24170",2006,1410,1394,14,16,"P.P.",601
46,"46903",5210,4037,4000,40,37,"P.P.",2282
40,"40157",74,51,50,2,1,"P.P.",25
47,"47212",386,327,325,1,2,"P.P.",225
16,"16209",153,129,129,0,0,"P.P.",62
26,"26021",2758,2190,2163,21,27,"P.P.",1341
13,"13903",564,461,454,2,7,"P.P.",327
37,"37343",56,42,40,0,2,"P.P.",25
45,"45117",800,679,668,7,11,"P.P.",314
46,"46079",381,304,299,3,5,"P.P.",199
23,"23084",1046,817,812,4,5,"P.P.",354
16,"16908",227,181,179,1,2,"P.P.",79
16,"16116",104,67,66,1,1,"P.P.",33
40,"40111",72,57,55,0,2,"P.P.",40
42,"42131",53,38,37,0,1,"P.P.",28
7,"7062",7206,4073,4035,72,38,"P.P.",1894
15,"15005",23875,15132,14895,356,237,"P.P.",7374
7,"7055",7000,4471,4379,67,92,"P.P.",2560
19,"19238",42,32,31,1,1,"P.P.",23
13,"13080",418,310,309,1,1,"P.P.",154
26,"26063",131,104,102,2,2,"P.P.",70
38,"38010",4054,2642,2599,17,43,"P.P.",1239
40,"40220",71,57,52,0,5,"P.P.",31
47,"47113",166,136,135,1,1,"P.P.",70
40,"40159",150,111,110,0,1,"P.P.",72
45,"45083",421,353,345,0,8,"P.P.",245
16,"16033",1792,1485,1454,10,31,"P.P.",727
9,"9219",28514,20244,19951,326,293,"P.P.",8536
24,"24089",106265,77385,76124,1666,1261,"P.P.",39698
24,"24224",665,490,484,8,6,"P.P.",302
49,"49010",338,271,265,4,6,"P.P.",120
45,"45168",61519,47265,46528,736,737,"P.P.",26278
47,"47053",125,100,99,1,1,"P.P.",58
11,"11902",3578,2400,2376,21,24,"P.P.",1214
16,"16132",36,31,31,0,0,"P.P.",20
21,"21028",419,320,315,3,5,"P.P.",99
45,"45144",839,701,691,11,10,"P.P.",349
47,"47231",4272,3268,3243,64,25,"P.P.",1613
37,"37309",42,26,25,3,1,"P.P.",13
26,"26078",85,69,69,0,0,"P.P.",40
46,"46184",26507,20314,20010,263,304,"P.P.",9646
9,"9131",412,332,321,6,11,"P.P.",129
9,"9265",44,36,35,2,1,"P.P.",26
39,"39094",927,702,691,0,11,"P.P.",320
9,"9356",57,38,37,1,1,"P.P.",25
7,"7036",25502,17151,16914,294,237,"P.P.",8797
30,"30005",29081,22312,22142,184,170,"P.P.",15006
26,"26025",78,69,69,1,0,"P.P.",33
45,"45011",316,271,268,1,3,"P.P.",158
37,"37247",216,176,173,1,3,"P.P.",137
9,"9297",326,270,266,7,4,"P.P.",192
24,"24116",451,297,294,5,3,"P.P.",168
21,"21005",15205,11006,10909,108,97,"P.P.",4498
41,"41026",4273,3577,3538,15,39,"P.P.",554
26,"26035",22,14,14,0,0,"P.P.",6
12,"12002",135,101,100,1,1,"P.P.",24
26,"26160",684,538,528,5,10,"P.P.",325
45,"45086",491,406,399,3,7,"P.P.",243
37,"37284",334,256,254,1,2,"P.P.",127
9,"9266",87,72,72,0,0,"P.P.",50
34,"34012",368,277,275,9,2,"P.P.",164
9,"9088",77,40,40,0,0,"P.P.",29
9,"9444",81,54,52,1,2,"P.P.",49
45,"45123",2961,2081,2049,30,32,"P.P.",1022
16,"16248",887,733,710,20,23,"P.P.",422
45,"45160",1104,911,896,12,15,"P.P.",571
37,"37349",136,105,104,2,1,"P.P.",84
26,"26155",173,134,134,1,0,"P.P.",66
47,"47171",453,371,368,10,3,"P.P.",218
15,"15028",1485,1130,1118,14,12,"P.P.",452
16,"16039",466,330,326,1,4,"P.P.",187
9,"9365",38,27,27,0,0,"P.P.",19
45,"45059",1758,1465,1437,10,28,"P.P.",1025
11,"11022",48624,26656,26430,345,226,"P.P.",13569
16,"16083",58,30,30,1,0,"P.P.",22
33,"33030",921,682,668,4,14,"P.P.",308
21,"21038",1146,786,767,9,19,"P.P.",352
40,"40040",2677,1990,1966,24,24,"P.P.",1259
24,"24216",782,582,574,3,8,"P.P.",403
26,"26127",236,206,204,1,2,"P.P.",122
26,"26129",1010,794,780,7,14,"P.P.",497
13,"13012",475,322,318,1,4,"P.P.",146
16,"16066",2402,2064,1997,32,67,"P.P.",1290
9,"9416",61,44,44,0,0,"P.P.",17
37,"37242",99,73,72,0,1,"P.P.",50
5,"5211",484,406,405,3,1,"P.P.",282
9,"9135",41,29,29,1,0,"P.P.",19
34,"34045",84,75,74,1,1,"P.P.",52
11,"11017",3219,2403,2388,18,15,"P.P.",723
13,"13031",2384,1908,1874,23,34,"P.P.",1123
40,"40106",232,173,173,3,0,"P.P.",102
40,"40152",750,615,595,4,20,"P.P.",305
45,"45077",554,430,423,7,7,"P.P.",252
26,"26073",100,85,84,1,1,"P.P.",42
45,"45098",2273,1799,1756,11,43,"P.P.",1367
40,"40062",54,44,44,0,0,"P.P.",30
40,"40079",236,174,171,0,3,"P.P.",113
45,"45078",1451,1243,1228,7,15,"P.P.",734
5,"5267",102,78,77,1,1,"P.P.",38
14,"14047",1566,1154,1143,19,11,"P.P.",427
21,"21030",1757,1448,1426,14,22,"P.P.",577
16,"16154",4946,3975,3914,58,61,"P.P.",2187
40,"40124",261,190,183,9,7,"P.P.",106
16,"16155",549,430,426,2,4,"P.P.",276
40,"40171",32,25,25,0,0,"P.P.",24
16,"16029",114,80,80,0,0,"P.P.",47
9,"9071",48,32,32,0,0,"P.P.",22
47,"47129",954,744,731,4,13,"P.P.",426
19,"19302",64,60,60,2,0,"P.P.",29
12,"12003",1058,830,813,15,17,"P.P.",537
33,"33034",11390,7583,7501,85,82,"P.P.",2736
11,"11003",1290,952,940,8,12,"P.P.",388
33,"33062",452,282,281,3,1,"P.P.",99
13,"13074",1000,886,878,15,8,"P.P.",428
46,"46146",1718,1395,1374,10,21,"P.P.",704
5,"5241",3145,2303,2273,27,30,"P.P.",1451
26,"26108",324,245,243,4,2,"P.P.",143
40,"40099",61,52,52,2,0,"P.P.",38
49,"49007",387,289,289,4,0,"P.P.",148
34,"34036",211,159,157,0,2,"P.P.",70
42,"42006",166,110,107,3,3,"P.P.",67
21,"21035",9657,6943,6871,64,72,"P.P.",3277
47,"47220",194,143,142,4,1,"P.P.",93
9,"9382",33,30,30,0,0,"P.P.",24
42,"42119",192,124,123,0,1,"P.P.",103
5,"5225",423,346,342,8,4,"P.P.",255
29,"29040",1934,1344,1332,12,12,"P.P.",680
23,"23041",519,455,448,2,7,"P.P.",220
40,"40218",111,81,80,1,1,"P.P.",60
12,"12031",3748,2751,2687,35,64,"P.P.",1401
40,"40016",63,45,45,0,0,"P.P.",29
9,"9259",239,178,177,2,1,"P.P.",120
7,"7023",3541,2414,2365,88,49,"P.P.",1027
37,"37305",206,153,152,4,1,"P.P.",91
19,"19289",33,28,28,1,0,"P.P.",19
7,"7040",266127,162699,160491,2698,2208,"P.P.",78665
40,"40128",144,116,116,5,0,"P.P.",58
9,"9414",197,159,159,2,0,"P.P.",101
23,"23086",11411,8918,8798,129,120,"P.P.",3719
5,"5163",1762,1400,1380,5,20,"P.P.",847
47,"47123",456,356,353,10,3,"P.P.",201
19,"19335",77,61,61,1,0,"P.P.",32
9,"9104",56,49,49,0,0,"P.P.",41
16,"16038",50,40,40,0,0,"P.P.",27
26,"26093",60,41,41,0,0,"P.P.",18
9,"9482",33,31,30,1,1,"P.P.",24
5,"5130",95,76,76,0,0,"P.P.",19
9,"9275",202,140,139,5,1,"P.P.",93
7,"7012",1880,1437,1405,20,32,"P.P.",586
45,"45071",1896,1592,1575,21,17,"P.P.",692
26,"26028",135,108,106,2,2,"P.P.",71
38,"38040",4697,3007,2962,31,45,"P.P.",1754
5,"5206",29,23,21,2,2,"P.P.",8
16,"16181",73,62,62,1,0,"P.P.",39
26,"26138",4646,3468,3398,46,70,"P.P.",2003
33,"33040",4702,3285,3236,44,49,"P.P.",1169
40,"40135",298,247,242,4,5,"P.P.",141
23,"23001",1058,922,920,6,2,"P.P.",422
9,"9277",130,101,101,1,0,"P.P.",34
42,"42173",28809,20268,19748,632,520,"P.P.",9020
9,"9456",142,110,110,3,0,"P.P.",65
7,"7024",6070,3232,3170,60,62,"P.P.",1365
12,"12008",236,203,199,4,4,"P.P.",115
47,"47066",1114,891,888,10,3,"P.P.",495
16,"16133",4466,3522,3453,51,69,"P.P.",1575
16,"16149",179,140,138,2,2,"P.P.",50
33,"33068",1224,704,703,5,1,"P.P.",206
46,"46206",595,497,495,3,2,"P.P.",246
24,"24090",366,225,224,2,1,"P.P.",159
47,"47091",97,82,80,3,2,"P.P.",50
24,"24184",206,111,111,0,0,"P.P.",71
40,"40134",769,628,620,19,8,"P.P.",330
26,"26001",211,174,168,3,6,"P.P.",90
40,"40017",103,89,88,2,1,"P.P.",53
39,"39086",386,282,280,1,2,"P.P.",151
16,"16167",357,318,315,5,3,"P.P.",144
11,"11024",6811,5241,5202,58,39,"P.P.",1883
9,"9406",242,193,193,2,0,"P.P.",83
23,"23002",17740,14007,13858,171,149,"P.P.",5636
16,"16050",298,245,238,0,7,"P.P.",132
37,"37252",127,92,92,0,0,"P.P.",79
23,"23096",2678,2298,2276,18,22,"P.P.",588
11,"11032",53183,32205,31982,441,223,"P.P.",12745
16,"16174",209,170,167,0,3,"P.P.",89
26,"26016",32,27,27,0,0,"P.P.",14
39,"39031",1227,965,956,4,9,"P.P.",582
24,"24148",1759,1362,1348,29,14,"P.P.",872
41,"41088",542,414,408,1,6,"P.P.",130
45,"45063",504,378,372,3,6,"P.P.",221
12,"12007",747,674,660,9,14,"P.P.",374
40,"40080",68,53,52,0,1,"P.P.",36
40,"40024",920,712,704,7,8,"P.P.",460
24,"24114",3441,2322,2304,42,18,"P.P.",958
24,"24201",1123,790,777,14,13,"P.P.",422
26,"26051",271,219,214,4,5,"P.P.",145
42,"42125",73,65,64,4,1,"P.P.",21
16,"16139",346,279,277,2,2,"P.P.",184
45,"45029",233,207,202,4,5,"P.P.",104
37,"37377",268,209,208,1,1,"P.P.",148
12,"12048",293,208,205,2,3,"P.P.",108
46,"46217",912,758,751,4,7,"P.P.",419
9,"9902",491,363,357,4,6,"P.P.",214
40,"40006",23,20,20,0,0,"P.P.",13
40,"40142",53,43,41,1,2,"P.P.",31
26,"26089",108356,81446,80090,1450,1356,"P.P.",42280
11,"11008",16655,11309,11189,184,120,"P.P.",5486
5,"5266",112,92,89,0,3,"P.P.",78
16,"16048",432,339,337,8,2,"P.P.",210
47,"47009",117,88,88,1,0,"P.P.",51
40,"40008",44,37,36,0,1,"P.P.",26
45,"45010",471,374,372,2,2,"P.P.",163
39,"39003",321,265,261,0,4,"P.P.",144
45,"45007",747,641,632,1,9,"P.P.",255
9,"9413",500,335,331,1,4,"P.P.",212
5,"5212",274,202,197,0,5,"P.P.",136
46,"46064",547,463,458,2,5,"P.P.",253
45,"45143",1302,916,901,6,15,"P.P.",510
16,"16068",143,117,116,6,1,"P.P.",70
29,"29028",1253,887,876,8,11,"P.P.",260
46,"46253",118,105,102,7,3,"P.P.",41
29,"29016",272,180,179,5,1,"P.P.",72
5,"5131",118,86,86,3,0,"P.P.",68
21,"21058",2609,1867,1857,15,10,"P.P.",501
39,"39011",1646,1295,1294,5,1,"P.P.",734
42,"42207",49,37,34,0,3,"P.P.",18
33,"33047",1178,939,931,2,8,"P.P.",518
39,"39015",898,692,688,7,4,"P.P.",425
42,"42001",308,242,237,4,5,"P.P.",118
37,"37017",249,200,199,0,1,"P.P.",167
5,"5124",134,111,109,1,2,"P.P.",82
9,"9224",172,125,125,3,0,"P.P.",94
40,"40097",114,96,94,2,2,"P.P.",39
14,"14045",3093,2662,2642,14,20,"P.P.",769
16,"16104",65,52,52,1,0,"P.P.",24
5,"5115",590,458,450,1,8,"P.P.",310
16,"16279",251,175,172,1,3,"P.P.",103
14,"14037",3500,2662,2616,29,46,"P.P.",1101
16,"16097",196,167,166,2,1,"P.P.",85
13,"13043",251,208,206,1,2,"P.P.",133
26,"26141",132,101,101,2,0,"P.P.",70
41,"41100",1097,894,878,8,16,"P.P.",300
26,"26149",67,50,49,1,1,"P.P.",18
11,"11010",6452,4534,4510,61,24,"P.P.",1535
40,"40020",200,155,149,2,6,"P.P.",97
9,"9476",67,52,52,0,0,"P.P.",32
21,"21001",628,434,428,5,6,"P.P.",91
40,"40093",88,77,72,0,5,"P.P.",50
9,"9136",203,153,146,3,7,"P.P.",87
9,"9054",107,80,80,1,0,"P.P.",48
40,"40177",171,145,145,2,0,"P.P.",100
12,"12020",131,109,107,1,2,"P.P.",92
42,"42064",92,76,76,0,0,"P.P.",40
34,"34047",1814,1435,1413,24,22,"P.P.",1031
21,"21070",6278,4489,4445,42,44,"P.P.",1440
40,"40145",1152,933,920,3,13,"P.P.",452
26,"26145",251,201,199,3,2,"P.P.",123
24,"24203",109,73,73,0,0,"P.P.",46
47,"47230",318,266,259,2,7,"P.P.",133
7,"7011",26954,16786,16595,299,191,"P.P.",8512
40,"40049",52,39,39,1,0,"P.P.",20
34,"34042",299,249,246,5,3,"P.P.",156
47,"47080",45,39,39,1,0,"P.P.",29
14,"14006",1326,1170,1148,12,22,"P.P.",676
9,"9340",72,41,41,0,0,"P.P.",34
45,"45072",690,535,532,7,3,"P.P.",304
9,"9390",645,522,518,9,4,"P.P.",303
9,"9418",79,60,58,0,2,"P.P.",51
49,"49058",341,262,259,4,3,"P.P.",136
9,"9403",98,75,75,0,0,"P.P.",55
16,"16056",495,377,374,11,3,"P.P.",188
9,"9428",124,107,107,1,0,"P.P.",64
5,"5227",409,307,305,2,2,"P.P.",181
16,"16007",1272,1056,1051,7,5,"P.P.",627
45,"45097",1094,934,925,9,9,"P.P.",535
9,"9903",3299,2373,2349,45,24,"P.P.",1428
49,"49005",156,102,101,2,1,"P.P.",65
9,"9143",24,14,14,1,0,"P.P.",11
40,"40075",182,149,146,4,3,"P.P.",84
46,"46105",16708,12164,12040,100,124,"P.P.",7035
37,"37004",31,23,23,0,0,"P.P.",20
40,"40039",257,188,184,2,4,"P.P.",130
46,"46263",333,243,241,2,2,"P.P.",107
26,"26105",2181,1712,1690,24,22,"P.P.",864
45,"45141",981,815,790,6,25,"P.P.",433
26,"26034",678,526,510,3,16,"P.P.",269
40,"40036",531,440,424,10,16,"P.P.",307
45,"45050",508,385,378,0,7,"P.P.",224
26,"26106",78,70,69,0,1,"P.P.",41
47,"47095",41,36,36,3,0,"P.P.",27
5,"5260",114,101,101,1,0,"P.P.",78
47,"47140",132,109,108,1,1,"P.P.",78
40,"40234",441,363,355,3,8,"P.P.",214
29,"29005",4307,2967,2951,18,16,"P.P.",1562
9,"9466",151,111,110,1,1,"P.P.",87
12,"12056",304,259,254,7,5,"P.P.",122
46,"46251",2599,2215,2179,21,36,"P.P.",1140
5,"5169",241,218,218,0,0,"P.P.",181
46,"46072",3711,3006,2932,38,74,"P.P.",1386
7,"7037",3269,1737,1700,37,37,"P.P.",773
34,"34037",345,256,253,4,3,"P.P.",182
47,"47007",3453,2616,2580,42,36,"P.P.",1313
49,"49071",822,558,557,5,1,"P.P.",407
11,"11020",163674,106898,106082,1655,816,"P.P.",52095
9,"9159",57,49,48,0,1,"P.P.",38
7,"7029",4090,2921,2866,44,55,"P.P.",1249
24,"24073",521,385,382,4,3,"P.P.",202
45,"45058",409,334,332,2,2,"P.P.",195
37,"37265",224,192,191,1,1,"P.P.",103
16,"16099",232,180,178,5,2,"P.P.",110
47,"47114",4107,2877,2834,37,43,"P.P.",1699
13,"13081",684,553,527,1,26,"P.P.",251
47,"47086",4062,3162,3120,37,42,"P.P.",1585
9,"9307",119,89,88,1,1,"P.P.",37
13,"13067",380,314,312,3,2,"P.P.",137
9,"9010",35,27,27,1,0,"P.P.",22
16,"16130",633,504,492,5,12,"P.P.",248
26,"26152",38,31,31,0,0,"P.P.",24
16,"16160",76,54,53,1,1,"P.P.",31
14,"14029",4380,3344,3308,35,36,"P.P.",1492
47,"47040",67,51,50,0,1,"P.P.",41
37,"37328",218,155,149,2,6,"P.P.",78
5,"5230",79,73,73,1,0,"P.P.",58
16,"16145",508,421,417,6,4,"P.P.",199
45,"45084",2395,1879,1842,21,37,"P.P.",908
16,"16175",5058,4363,4295,70,68,"P.P.",2197
16,"16032",304,253,244,2,9,"P.P.",112
23,"23037",513,430,424,3,6,"P.P.",158
9,"9117",82,59,59,1,0,"P.P.",41
16,"16203",9839,7520,7342,101,178,"P.P.",4165
45,"45090",396,335,333,0,2,"P.P.",160
26,"26007",551,434,422,3,12,"P.P.",201
16,"16003",147,122,121,0,1,"P.P.",61
9,"9023",993,771,765,22,6,"P.P.",416
16,"16251",1903,1510,1493,18,17,"P.P.",1010
16,"16135",192,127,125,0,2,"P.P.",66
11,"11023",9209,6979,6929,81,50,"P.P.",2154
46,"46023",318,275,267,2,8,"P.P.",150
40,"40095",507,437,425,2,12,"P.P.",333
16,"16280",205,177,175,1,2,"P.P.",103
42,"42216",27,22,22,0,0,"P.P.",11
7,"7034",971,724,708,10,16,"P.P.",352
21,"21054",8024,6159,6072,67,87,"P.P.",3700
42,"42035",847,600,592,4,8,"P.P.",381
9,"9062",52,33,32,1,1,"P.P.",18
16,"16243",451,395,388,3,7,"P.P.",213
45,"45068",164,135,133,1,2,"P.P.",59
40,"40180",319,259,255,3,4,"P.P.",167
16,"16187",78,61,60,3,1,"P.P.",35
5,"5164",34,24,24,0,0,"P.P.",9
19,"19314",46,41,41,0,0,"P.P.",22
21,"21077",1690,1335,1321,8,14,"P.P.",541
33,"33026",9144,6019,5959,87,60,"P.P.",2283
47,"47216",124,99,98,2,1,"P.P.",76
46,"46148",1400,1131,1114,13,17,"P.P.",683
45,"45040",1504,1058,1046,5,12,"P.P.",561
47,"47119",101,78,77,0,1,"P.P.",56
9,"9901",407,319,308,8,11,"P.P.",187
16,"16042",1286,1101,1089,8,12,"P.P.",510
26,"26018",10396,8186,8041,161,145,"P.P.",3788
26,"26130",229,181,177,0,4,"P.P.",123
37,"37277",58,39,38,1,1,"P.P.",30
47,"47024",283,211,210,1,1,"P.P.",126
11,"11028",32224,20706,20482,359,224,"P.P.",5874
16,"16011",39,30,30,0,0,"P.P.",20
25,"25225",603,395,387,7,8,"PP",53
43,"43169",477,377,364,8,13,"PP",27
27,"27055",1494,1120,1107,8,13,"PP",564
43,"43088",1810,1199,1177,29,22,"PP",232
43,"43106",878,600,592,17,8,"PP",103
28,"28107",443,338,333,7,5,"PP",149
25,"25180",245,167,165,3,2,"PP",23
28,"28167",7818,6016,5942,82,74,"PP",2852
43,"43027",177,129,128,6,1,"PP",19
28,"28082",5144,3967,3905,46,62,"PP",2006
25,"25012",2204,1432,1406,29,26,"PP",307
25,"25172",1838,1267,1230,35,37,"PP",197
25,"25234",4572,2707,2648,57,59,"PP",355
25,"25074",178,137,132,3,5,"PP",16
25,"25913",100,78,78,0,0,"PP",4
48,"48090",6153,4682,4571,40,111,"PP",507
25,"25078",1014,730,719,17,11,"PP",103
28,"28114",148,110,110,0,0,"PP",72
43,"43042",2071,1504,1485,28,19,"PP",293
25,"25081",332,212,206,6,6,"PP",31
28,"28095",1358,1092,1077,8,15,"PP",604
28,"28152",14903,11954,11865,125,89,"PP",7457
43,"43055",2002,1404,1374,36,30,"PP",120
28,"28164",2807,2194,2173,10,21,"PP",1308
25,"25210",1164,799,789,13,10,"PP",107
32,"32033",843,595,583,7,12,"PP",379
48,"48083",7021,4722,4656,74,66,"PP",492
32,"32048",1004,687,671,48,16,"PP",290
28,"28017",1120,905,888,8,17,"PP",491
43,"43128",927,636,625,11,11,"PP",73
25,"25086",569,379,370,4,9,"PP",19
25,"25908",250,169,168,4,1,"PP",19
20,"20039",2003,1517,1512,9,5,"PP",31
25,"25232",1480,968,959,38,9,"PP",200
25,"25233",270,207,201,3,6,"PP",40
28,"28052",3799,2753,2719,17,34,"PP",1812
28,"28160",7496,5680,5613,46,67,"PP",3215
25,"25059",796,580,575,9,5,"PP",200
48,"48085",9893,6960,6885,93,75,"PP",667
27,"27022",5093,3535,3486,74,49,"PP",2072
27,"27043",1422,988,962,10,26,"PP",593
20,"20022",832,527,521,9,6,"PP",10
32,"32080",394,311,309,3,2,"PP",241
32,"32001",4938,3715,3667,50,48,"PP",1420
25,"25207",6253,3938,3872,91,66,"PP",467
28,"28151",3025,2237,2185,9,52,"PP",1119
28,"28073",11899,8877,8769,112,108,"PP",4540
28,"28089",3531,2786,2753,25,33,"PP",1645
32,"32037",828,660,654,10,6,"PP",450
25,"25088",100,74,74,0,0,"PP",4
28,"28066",7033,5439,5383,45,56,"PP",3559
32,"32040",1587,1226,1219,7,7,"PP",791
32,"32084",1084,818,805,0,13,"PP",506
25,"25027",1042,691,665,11,26,"PP",98
20,"20080",8104,5497,5454,52,43,"PP",703
25,"25038",1606,1104,1093,19,11,"PP",298
43,"43135",327,243,238,2,5,"PP",25
43,"43056",931,537,515,18,22,"PP",84
32,"32056",1861,1378,1369,8,9,"PP",999
20,"20032",8949,6189,6117,55,72,"PP",669
43,"43076",467,308,300,7,8,"PP",13
20,"20037",100,65,64,2,1,"PP",0
27,"27015",4587,3465,3409,55,56,"PP",2287
43,"43162",4143,2892,2833,59,59,"PP",590
28,"28041",4006,3190,3154,45,36,"PP",1837
48,"48075",1915,1362,1325,15,37,"PP",134
28,"28024",156,132,132,5,0,"PP",74
25,"25048",1684,1120,1095,29,25,"PP",147
48,"48005",93,65,64,0,1,"PP",6
28,"28001",61,46,45,1,1,"PP",38
25,"25910",118,77,76,3,1,"PP",6
28,"28018",3572,2837,2795,20,42,"PP",1619
25,"25243",3408,2280,2252,49,28,"PP",700
48,"48089",2878,2120,2089,19,31,"PP",166
48,"48012",2036,1630,1616,9,14,"PP",60
25,"25185",690,409,404,8,5,"PP",45
25,"25177",379,240,236,2,4,"PP",36
28,"28021",418,334,328,4,6,"PP",175
43,"43145",3968,2781,2742,52,39,"PP",399
20,"20050",293,213,211,3,2,"PP",6
43,"43148",89309,59260,58346,1202,914,"PP",16943
20,"20006",277,177,175,6,2,"PP",1
28,"28007",122891,95200,94139,990,1061,"PP",45333
27,"27902",7198,5074,4976,106,98,"PP",2825
20,"20901",1468,951,947,13,4,"PP",57
43,"43020",2119,1463,1427,26,36,"PP",335
28,"28039",139,103,103,1,0,"PP",54
28,"28084",15408,11489,11355,122,134,"PP",5555
28,"28058",137542,103880,102686,1155,1194,"PP",44055
20,"20002",347,237,237,8,0,"PP",4
27,"27002",1835,1455,1437,16,18,"PP",824
25,"25034",2471,1622,1592,25,30,"PP",254
48,"48001",5842,4040,4020,23,20,"PP",574
28,"28181",20003,16133,15952,159,181,"PP",10232
20,"20062",995,687,667,5,20,"PP",43
28,"28182",219,179,178,2,1,"PP",92
25,"25220",1076,711,702,10,9,"PP",121
20,"20011",1700,1265,1258,11,7,"PP",43
43,"43029",330,202,194,6,8,"PP",14
27,"27041",2644,1946,1915,29,31,"PP",1259
43,"43046",114,80,79,5,1,"PP",6
25,"25076",165,84,83,3,1,"PP",9
25,"25146",227,150,149,0,1,"PP",32
43,"43144",1187,787,772,12,15,"PP",136
43,"43078",841,557,547,7,10,"PP",86
32,"32075",3839,2957,2910,51,47,"PP",1851
25,"25135",1077,739,722,18,17,"PP",98
48,"48071",6097,4307,4224,61,83,"PP",345
25,"25901",315,196,189,3,7,"PP",26
28,"28093",1911,1537,1518,19,19,"PP",917
28,"28901",765,579,567,2,12,"PP",288
48,"48059",397,289,286,0,3,"PP",6
32,"32027",1156,850,836,15,14,"PP",460
25,"25149",1401,1031,1010,17,21,"PP",131
25,"25186",231,168,168,3,0,"PP",28
28,"28101",222,158,158,4,0,"PP",78
43,"43074",1697,1150,1120,25,30,"PP",160
43,"43053",190,149,149,2,0,"PP",11
28,"28045",30286,23148,22879,226,269,"PP",11881
28,"28157",605,452,446,2,6,"PP",287
25,"25907",506,297,292,6,5,"PP",45
28,"28108",3002,2254,2228,31,26,"PP",1169
32,"32077",1234,999,993,23,6,"PP",605
27,"27038",1035,817,809,9,8,"PP",468
28,"28046",4208,3297,3272,31,25,"PP",1726
25,"25222",69,55,54,0,1,"PP",11
28,"28106",72603,53231,52524,681,707,"PP",21993
32,"32054",87289,63027,61875,1263,1152,"PP",29580
28,"28037",1598,1263,1250,10,13,"PP",639
43,"43061",55,31,31,1,0,"PP",0
20,"20003",547,361,359,3,2,"PP",2
28,"28062",311,233,226,0,7,"PP",149
28,"28099",1670,1258,1246,9,12,"PP",809
25,"25100",207,125,115,2,10,"PP",8
32,"32047",2003,1595,1575,10,20,"PP",1102
25,"25119",2297,1554,1513,46,41,"PP",163
20,"20061",4011,2666,2653,23,13,"PP",134
28,"28049",59507,46919,46379,488,540,"PP",19291
25,"25148",232,144,144,5,0,"PP",14
43,"43019",1356,868,837,13,31,"PP",158
25,"25042",211,131,127,0,4,"PP",25
28,"28122",504,367,366,2,1,"PP",203
25,"25023",4446,3079,3020,70,59,"PP",681
32,"32006",1814,1344,1330,20,14,"PP",978
28,"28138",78,48,46,0,2,"PP",26
32,"32022",1591,1219,1207,9,12,"PP",609
43,"43015",104,69,68,2,1,"PP",1
28,"28143",81,71,67,1,4,"PP",40
25,"25109",279,183,183,2,0,"PP",22
28,"28050",3576,2706,2663,21,43,"PP",1611
48,"48074",3384,2441,2397,20,44,"PP",300
48,"48056",849,610,608,3,2,"PP",28
25,"25197",158,102,101,2,1,"PP",6
32,"32031",1079,837,828,5,9,"PP",621
43,"43050",2407,1528,1504,20,24,"PP",464
32,"32069",4573,3624,3580,35,44,"PP",1766
28,"28003",196,154,151,2,3,"PP",67
43,"43903",2368,1504,1492,22,12,"PP",266
28,"28002",2650,2018,1993,24,25,"PP",1162
48,"48092",792,603,600,5,3,"PP",50
28,"28005",132097,100509,99506,1069,1003,"PP",46667
25,"25904",149,107,104,1,3,"PP",9
20,"20902",14148,9874,9798,120,76,"PP",1643
48,"48064",599,490,490,1,0,"PP",16
28,"28048",489,398,389,3,9,"PP",168
25,"25102",733,478,464,15,14,"PP",111
27,"27059",2320,1783,1763,25,20,"PP",1211
20,"20076",6978,4823,4762,38,61,"PP",477
32,"32018",1351,1100,1092,9,8,"PP",499
28,"28123",48429,38681,38187,429,494,"PP",14250
28,"28075",5127,3976,3916,42,60,"PP",2075
28,"28127",60108,48418,48039,568,379,"PP",30089
20,"20010",1392,949,941,8,8,"PP",76
28,"28020",145,102,100,0,2,"PP",40
48,"48047",161,126,126,1,0,"PP",0
28,"28087",3150,2475,2453,26,22,"PP",1451
28,"28013",38226,27886,27547,246,339,"PP",14449
25,"25007",1363,902,885,36,17,"PP",173
25,"25063",97,65,64,2,1,"PP",14
48,"48007",354,254,253,1,1,"PP",7
28,"28171",4148,2972,2929,21,43,"PP",1897
43,"43051",8749,5494,5411,78,83,"PP",1697
48,"48036",23973,16491,16344,179,147,"PP",2236
48,"48003",14142,10268,10167,84,101,"PP",856
25,"25252",536,361,352,13,9,"PP",69
48,"48065",3311,2340,2323,23,17,"PP",225
28,"28031",1981,1524,1500,9,24,"PP",838
43,"43014",14146,9153,8915,204,238,"PP",1392
28,"28136",618,527,516,2,11,"PP",286
43,"43006",712,484,475,10,9,"PP",106
20,"20009",11794,7805,7725,103,80,"PP",1009
43,"43068",573,388,378,5,10,"PP",122
32,"32011",1026,660,650,4,10,"PP",576
48,"48016",5214,3782,3736,46,46,"PP",649
25,"25174",438,289,283,4,6,"PP",52
43,"43140",2393,1612,1583,23,29,"PP",447
25,"25049",166,105,102,1,3,"PP",11
32,"32092",596,367,364,2,3,"PP",224
25,"25064",122,91,88,7,3,"PP",10
25,"25075",122,85,83,0,2,"PP",0
43,"43167",390,284,280,12,4,"PP",48
43,"43077",486,335,328,4,7,"PP",109
32,"32061",1196,976,973,4,3,"PP",535
32,"32073",1415,1111,1100,8,11,"PP",631
48,"48094",3299,2398,2377,15,21,"PP",106
48,"48050",216,173,172,0,1,"PP",3
20,"20068",199,132,129,2,3,"PP",0
27,"27023",2770,2196,2178,30,18,"PP",1442
25,"25139",549,358,357,5,1,"PP",42
43,"43151",119,91,89,0,2,"PP",11
25,"25092",135,100,97,2,3,"PP",10
25,"25111",116,70,70,0,0,"PP",13
48,"48087",463,371,370,4,1,"PP",49
48,"48088",148,110,109,0,1,"PP",8
28,"28092",148714,112174,110838,1215,1336,"PP",52822
27,"27034",1297,871,867,3,4,"PP",470
32,"32083",960,675,672,0,3,"PP",420
28,"28133",5868,4236,4144,23,92,"PP",2288
48,"48025",882,652,644,2,8,"PP",11
28,"28044",5403,4245,4188,27,57,"PP",2242
43,"43022",1559,1097,1074,22,23,"PP",303
20,"20077",5382,3766,3741,42,25,"PP",376
25,"25039",299,189,186,7,3,"PP",12
25,"25181",189,128,123,3,5,"PP",19
20,"20041",279,153,151,5,2,"PP",10
48,"48073",7090,4865,4802,37,63,"PP",263
43,"43052",1001,669,636,12,33,"PP",75
25,"25128",151,83,81,1,2,"PP",9
28,"28169",1244,971,962,8,9,"PP",576
25,"25008",1187,834,818,15,16,"PP",160
28,"28038",4999,3659,3590,32,69,"PP",1683
20,"20066",467,316,316,0,0,"PP",5
20,"20005",1341,890,885,4,5,"PP",52
28,"28117",116,90,90,1,0,"PP",50
25,"25118",378,232,226,4,6,"PP",38
32,"32057",608,475,473,4,2,"PP",204
48,"48904",3510,2682,2665,26,17,"PP",344
27,"27048",2404,1939,1909,36,30,"PP",978
48,"48086",2087,1432,1420,11,12,"PP",145
20,"20030",22191,15262,15148,164,114,"PP",2048
32,"32089",1480,1063,1045,7,18,"PP",718
48,"48053",856,683,680,8,3,"PP",129
25,"25216",250,175,173,5,2,"PP",26
25,"25164",404,270,264,5,6,"PP",25
25,"25070",888,594,582,18,12,"PP",49
43,"43089",272,193,185,1,8,"PP",44
28,"28180",5179,4033,3975,18,58,"PP",2103
48,"48043",4256,3066,3040,33,26,"PP",310
25,"25124",161,110,109,4,1,"PP",19
48,"48901",4370,3156,3124,46,32,"PP",414
48,"48908",242,194,194,1,0,"PP",6
43,"43016",3437,2323,2266,40,57,"PP",427
28,"28035",1314,1058,1046,3,12,"PP",566
20,"20024",400,238,235,0,3,"PP",13
32,"32034",1228,995,990,5,5,"PP",620
48,"48069",12381,8760,8672,66,88,"PP",958
43,"43901",8849,5651,5540,179,111,"PP",1153
20,"20004",254,153,153,5,0,"PP",1
25,"25103",125,82,80,4,2,"PP",12
27,"27060",2938,2063,2028,26,35,"PP",1252
28,"28047",38404,28739,28436,312,303,"PP",13927
28,"28085",3794,2980,2933,18,47,"PP",1490
48,"48022",2396,1524,1504,12,20,"PP",148
28,"28154",5232,3910,3860,40,50,"PP",1991
32,"32019",11469,8297,8180,134,117,"PP",4966
25,"25909",141,82,78,0,4,"PP",8
32,"32076",2358,1835,1823,18,12,"PP",1275
32,"32035",1632,1100,1088,8,12,"PP",801
48,"48019",3741,2613,2595,24,18,"PP",266
27,"27062",681,535,532,7,3,"PP",331
28,"28019",1195,901,888,5,13,"PP",398
43,"43091",142,106,98,5,8,"PP",10
27,"27031",16169,11446,11214,194,232,"PP",5644
25,"25087",65,41,39,0,2,"PP",1
25,"25169",201,134,134,6,0,"PP",18
25,"25205",563,373,362,12,11,"PP",77
28,"28010",9309,7304,7229,71,75,"PP",3898
28,"28086",4603,3286,3248,29,38,"PP",1893
43,"43018",430,350,337,7,13,"PP",31
28,"28170",2503,1744,1727,20,17,"PP",910
43,"43075",102,63,63,1,0,"PP",2
25,"25208",294,174,170,3,4,"PP",11
20,"20047",494,321,319,2,2,"PP",5
48,"48046",12635,9231,9161,61,70,"PP",634
48,"48079",470,391,391,2,0,"PP",11
43,"43178",1262,891,870,24,21,"PP",167
32,"32074",1180,892,876,11,16,"PP",595
25,"25067",768,498,494,14,4,"PP",107
28,"28072",5232,4065,4007,35,58,"PP",2288
43,"43090",1142,644,636,7,8,"PP",202
27,"27065",13035,9432,9254,168,178,"PP",6084
48,"48039",263,217,216,4,1,"PP",10
43,"43005",3559,2191,2147,47,44,"PP",397
32,"32002",2060,1566,1551,13,15,"PP",808
25,"25142",387,265,264,5,1,"PP",40
43,"43139",2166,1319,1270,37,49,"PP",166
25,"25189",2085,1348,1327,38,21,"PP",236
43,"43141",131,71,70,3,1,"PP",11
32,"32058",5253,3872,3821,57,51,"PP",2305
43,"43084",573,383,378,6,5,"PP",35
20,"20036",12731,8519,8431,131,88,"PP",995
27,"27066",12908,9554,9329,171,225,"PP",4640
27,"27019",8247,6146,6022,101,124,"PP",3061
32,"32059",1983,1526,1510,27,16,"PP",950
43,"43904",2918,1779,1732,49,47,"PP",322
28,"28104",11704,9455,9361,119,94,"PP",5177
43,"43158",109,63,61,5,2,"PP",4
48,"48008",600,432,428,3,4,"PP",25
28,"28110",1912,1492,1475,8,17,"PP",795
48,"48081",1938,1449,1435,14,14,"PP",111
48,"48048",547,423,423,5,0,"PP",6
20,"20074",11660,8003,7951,31,52,"PP",481
48,"48037",727,528,519,2,9,"PP",23
32,"32008",7618,5529,5433,83,96,"PP",2867
43,"43173",114,65,64,0,1,"PP",7
27,"27017",1138,789,787,6,2,"PP",503
43,"43058",106,76,76,5,0,"PP",4
27,"27007",3015,2426,2374,42,52,"PP",1692
28,"28179",1385,1039,1027,10,12,"PP",627
25,"25191",353,234,227,5,7,"PP",36
48,"48038",1087,826,821,7,5,"PP",56
43,"43159",89,51,51,2,0,"PP",2
25,"25046",438,299,286,6,13,"PP",51
25,"25121",623,406,400,6,6,"PP",96
43,"43103",897,586,575,21,11,"PP",145
28,"28091",5202,3714,3671,34,43,"PP",1972
27,"27044",3089,2167,2125,31,42,"PP",1232
43,"43122",92,65,61,0,4,"PP",7
25,"25009",690,479,471,9,8,"PP",102
32,"32025",1218,954,941,12,13,"PP",624
25,"25249",207,151,150,4,1,"PP",25
25,"25183",485,336,327,6,9,"PP",26
25,"25004",553,405,400,13,5,"PP",55
25,"25035",428,289,284,5,5,"PP",57
48,"48058",977,706,700,2,6,"PP",51
32,"32043",2679,2006,1985,14,21,"PP",1089
43,"43065",443,278,270,8,8,"PP",45
25,"25030",147,101,95,3,6,"PP",3
28,"28129",7219,5536,5461,71,75,"PP",3004
43,"43079",387,259,255,26,4,"PP",29
25,"25170",271,197,196,4,1,"PP",15
20,"20053",4830,2895,2868,36,27,"PP",239
32,"32039",1424,1084,1069,10,15,"PP",723
28,"28135",928,665,659,6,6,"PP",365
25,"25203",8995,5418,5309,116,109,"PP",985
43,"43123",70216,45627,44828,906,799,"PP",11502
25,"25045",51,33,33,2,0,"PP",3
43,"43166",1521,1002,977,17,25,"PP",255
25,"25069",471,291,289,9,2,"PP",34
43,"43063",588,358,350,13,8,"PP",96
43,"43104",1821,1209,1178,34,31,"PP",78
32,"32064",561,439,437,5,2,"PP",356
27,"27037",1205,857,845,13,12,"PP",557
48,"48082",38551,25768,25482,316,286,"PP",4113
28,"28088",251,174,173,5,1,"PP",78
48,"48063",355,287,287,6,0,"PP",3
48,"48052",1526,1213,1205,7,8,"PP",39
27,"27058",3908,2946,2915,28,31,"PP",1916
28,"28074",136617,106248,105095,1101,1153,"PP",44175
28,"28115",57612,46786,46458,458,328,"PP",30787
43,"43121",636,385,371,6,14,"PP",24
25,"25041",625,432,420,20,12,"PP",76
43,"43154",136,97,96,6,1,"PP",7
43,"43113",454,321,316,10,5,"PP",60
25,"25902",581,411,395,15,16,"PP",108
43,"43152",472,355,351,9,4,"PP",14
27,"27054",1332,1063,1054,12,9,"PP",572
20,"20907",136,94,94,0,0,"PP",3
32,"32090",834,662,657,4,5,"PP",205
43,"43146",45,33,30,1,3,"PP",2
43,"43108",1808,1183,1157,28,26,"PP",206
25,"25242",787,501,490,11,11,"PP",77
25,"25073",662,382,379,11,3,"PP",34
28,"28144",5663,4456,4410,47,46,"PP",2573
48,"48902",19232,12809,12633,182,176,"PP",1728
25,"25015",394,264,264,14,0,"PP",40
28,"28112",168,138,137,0,1,"PP",74
25,"25050",3249,2056,1988,40,68,"PP",273
43,"43064",2063,1420,1391,37,29,"PP",269
32,"32091",1971,1472,1466,12,6,"PP",860
43,"43041",237,177,176,4,1,"PP",54
32,"32079",1448,1103,1094,14,9,"PP",627
25,"25051",1710,1060,1044,23,16,"PP",119
20,"20046",1157,734,729,6,5,"PP",64
25,"25230",1665,1164,1140,36,24,"PP",214
25,"25123",206,140,136,4,4,"PP",11
25,"25204",1313,888,881,21,7,"PP",121
25,"25218",94,75,73,1,2,"PP",5
48,"48078",39866,27311,26995,311,316,"PP",5116
25,"25115",878,542,542,17,0,"PP",44
43,"43033",772,547,533,4,14,"PP",105
28,"28069",51,35,33,1,2,"PP",24
43,"43164",298,233,231,4,2,"PP",68
25,"25151",641,451,444,20,7,"PP",54
43,"43124",532,366,358,3,8,"PP",59
28,"28078",39,23,23,1,0,"PP",19
43,"43099",330,240,236,4,4,"PP",6
28,"28012",830,654,651,6,3,"PP",359
27,"27063",1916,1469,1440,14,29,"PP",805
43,"43066",165,113,112,2,1,"PP",12
25,"25166",177,127,125,3,2,"PP",23
28,"28027",1232,937,919,9,18,"PP",481
25,"25175",221,151,150,0,1,"PP",35
43,"43116",494,328,325,5,3,"PP",19
28,"28067",3893,2996,2950,26,46,"PP",1467
27,"27027",2111,1652,1605,21,47,"PP",916
48,"48031",370,296,296,1,0,"PP",2
25,"25099",1185,720,709,9,11,"PP",104
43,"43083",141,97,97,2,0,"PP",21
20,"20020",143,104,104,1,0,"PP",3
25,"25158",1647,1154,1135,27,19,"PP",165
20,"20064",12380,7568,7464,112,104,"PP",962
25,"25173",1784,1177,1139,20,38,"PP",161
32,"32070",660,457,452,1,5,"PP",321
25,"25206",289,187,184,3,3,"PP",16
48,"48054",23712,16643,16439,215,204,"PP",3003
25,"25053",1085,733,727,10,6,"PP",149
25,"25025",1307,874,859,32,15,"PP",226
43,"43043",3065,1952,1919,39,33,"PP",414
48,"48029",8022,5488,5409,83,79,"PP",1057
25,"25097",102,70,69,3,1,"PP",13
27,"27051",8224,6048,5953,108,95,"PP",3041
20,"20012",149,97,97,0,0,"PP",3
28,"28056",782,604,586,6,18,"PP",316
28,"28004",5761,4098,4044,38,54,"PP",2443
43,"43044",3990,2768,2715,72,53,"PP",862
25,"25120",90759,58761,57778,1325,983,"PP",15159
25,"25156",761,535,529,15,6,"PP",73
27,"27005",2792,2101,2076,21,25,"PP",1280
48,"48093",893,707,695,1,12,"PP",55
27,"27035",194,119,119,0,0,"PP",46
20,"20038",382,281,280,1,1,"PP",7
28,"28120",1259,946,931,11,15,"PP",472
20,"20071",14488,9499,9419,93,80,"PP",769
43,"43142",1155,730,714,20,16,"PP",121
43,"43085",229,178,171,0,7,"PP",20
27,"27021",1936,1295,1271,19,24,"PP",806
20,"20027",2809,1929,1918,25,11,"PP",43
43,"43175",590,419,411,8,8,"PP",96
43,"43045",156,110,109,1,1,"PP",5
43,"43119",739,500,496,5,4,"PP",77
28,"28113",31318,23779,23436,271,343,"PP",10880
28,"28096",16844,12441,12308,117,133,"PP",6877
43,"43086",5269,3275,3196,92,79,"PP",389
48,"48017",13554,9303,9234,64,69,"PP",345
43,"43111",2096,1305,1281,19,24,"PP",362
28,"28161",44185,33371,32966,353,405,"PP",17616
43,"43098",362,251,247,1,4,"PP",31
43,"43067",626,445,431,21,14,"PP",43
28,"28116",666,507,498,5,9,"PP",258
43,"43163",24903,15475,15241,263,234,"PP",4080
43,"43125",1008,706,701,10,5,"PP",122
32,"32086",2874,2026,2003,18,23,"PP",1219
48,"48014",1211,838,834,4,4,"PP",80
28,"28006",74554,57439,56890,586,549,"PP",30216
43,"43907",4122,2759,2712,52,47,"PP",734
25,"25150",185,119,113,4,6,"PP",13
28,"28121",185,153,152,0,1,"PP",81
48,"48044",63869,47453,47085,511,368,"PP",13979
48,"48095",2367,1593,1577,20,16,"PP",252
32,"32088",1749,1232,1217,10,15,"PP",689
25,"25212",233,185,185,8,0,"PP",20
43,"43038",20710,12999,12771,224,228,"PP",3794
43,"43011",1013,745,729,21,16,"PP",127
48,"48033",223,171,171,1,0,"PP",4
20,"20078",1146,885,884,6,1,"PP",29
20,"20029",4283,3014,2998,26,16,"PP",165
25,"25247",142,80,78,3,2,"PP",28
25,"25058",4390,2696,2650,57,46,"PP",345
25,"25020",328,216,209,4,7,"PP",36
25,"25244",350,270,268,9,2,"PP",52
25,"25152",160,92,90,4,2,"PP",11
32,"32004",2071,1145,1142,7,3,"PP",1011
27,"27042",1888,1427,1407,12,20,"PP",986
27,"27026",2605,1785,1751,19,34,"PP",1038
20,"20031",179,114,113,1,1,"PP",1
43,"43072",97,73,70,0,3,"PP",18
25,"25021",2693,1632,1605,40,27,"PP",192
28,"28146",1672,1220,1205,4,15,"PP",704
20,"20079",17229,12010,11927,143,83,"PP",1227
28,"28053",6035,4854,4783,61,71,"PP",2465
20,"20055",17856,11885,11791,91,94,"PP",1117
32,"32029",557,426,424,1,2,"PP",343
32,"32053",1500,1206,1199,19,7,"PP",845
32,"32013",2464,1695,1671,10,24,"PP",1200
28,"28158",632,505,495,4,10,"PP",317
28,"28025",426,336,332,2,4,"PP",225
25,"25176",341,243,240,7,3,"PP",52
48,"48905",2600,1903,1869,14,34,"PP",178
43,"43176",832,575,572,16,3,"PP",70
25,"25003",3853,2367,2340,68,27,"PP",426
43,"43040",350,251,246,18,5,"PP",27
32,"32005",957,760,753,8,7,"PP",526
25,"25912",899,643,640,6,3,"PP",174
43,"43073",90,57,57,1,0,"PP",4
43,"43171",13906,8978,8855,167,123,"PP",2578
43,"43003",307,187,184,10,3,"PP",41
25,"25071",56,37,35,2,2,"PP",2
25,"25196",127,87,86,3,1,"PP",8
48,"48077",3398,2490,2477,33,13,"PP",266
48,"48913",1231,936,922,10,14,"PP",59
28,"28061",19624,15082,14905,162,177,"PP",8114
28,"28071",77,57,55,0,2,"PP",37
48,"48067",1204,895,892,4,3,"PP",17
27,"27047",1851,1293,1273,16,20,"PP",610
48,"48023",601,499,492,4,7,"PP",29
20,"20021",216,122,122,0,0,"PP",3
28,"28131",12664,9454,9342,100,112,"PP",5091
43,"43017",141,98,98,2,0,"PP",6
32,"32068",1631,1187,1174,4,13,"PP",676
28,"28162",2263,1802,1786,32,16,"PP",1058
25,"25072",5921,3743,3637,81,106,"PP",775
43,"43001",706,481,473,12,8,"PP",77
28,"28040",15089,9976,9852,116,124,"PP",4845
48,"48045",5060,3912,3849,31,63,"PP",326
32,"32032",8284,6295,6198,84,97,"PP",3764
28,"28155",529,427,416,2,11,"PP",196
27,"27016",7521,5439,5338,83,101,"PP",3092
25,"25098",266,177,177,0,0,"PP",9
28,"28111",618,486,479,2,7,"PP",274
28,"28149",5276,4132,4063,43,69,"PP",2272
25,"25127",226,134,130,2,4,"PP",3
25,"25044",195,136,134,1,2,"PP",45
28,"28163",395,305,301,7,4,"PP",142
20,"20067",31173,20218,20017,270,201,"PP",2771
43,"43170",880,601,592,9,9,"PP",76
43,"43069",194,131,127,3,4,"PP",22
25,"25032",71,44,42,1,2,"PP",3
48,"48021",1460,1024,1012,13,12,"PP",48
32,"32030",1120,857,846,9,11,"PP",337
48,"48057",5934,4407,4385,27,22,"PP",108
43,"43101",146,94,93,3,1,"PP",6
27,"27003",2064,1531,1516,19,15,"PP",1048
28,"28042",1091,814,808,5,6,"PP",536
43,"43059",264,185,185,4,0,"PP",19
28,"28079",2290453,1721837,1705310,17342,16527,"PP",880723
28,"28166",325,269,268,8,1,"PP",137
28,"28173",507,397,390,2,7,"PP",233
32,"32071",1614,1121,1112,4,9,"PP",682
28,"28063",268,209,203,4,6,"PP",109
27,"27004",1379,981,966,4,15,"PP",639
28,"28178",1017,799,791,11,8,"PP",463
27,"27061",1170,917,906,8,11,"PP",630
48,"48906",796,625,622,5,3,"PP",17
20,"20073",4689,3196,3176,28,20,"PP",195
28,"28028",1615,1204,1173,11,31,"PP",524
32,"32072",3949,2881,2841,32,40,"PP",1514
28,"28150",2985,2363,2345,21,18,"PP",1440
28,"28014",31360,23434,23133,203,301,"PP",12547
28,"28022",30019,24469,24279,292,190,"PP",15899
27,"27006",2789,1949,1911,22,38,"PP",1063
43,"43012",3392,2346,2295,48,51,"PP",523
43,"43905",13621,8120,8011,131,109,"PP",2989
43,"43118",439,318,313,7,5,"PP",34
25,"25110",2662,1649,1602,44,47,"PP",210
43,"43004",6411,4089,4001,92,88,"PP",962
25,"25221",125,76,76,0,0,"PP",17
20,"20026",214,172,172,0,0,"PP",1
43,"43097",379,283,278,6,5,"PP",45
28,"28015",14491,11562,11417,155,145,"PP",6315
43,"43102",517,377,366,2,11,"PP",27
28,"28036",2301,1809,1784,13,25,"PP",917
28,"28165",1689,1310,1295,5,15,"PP",888
43,"43054",2850,1815,1771,37,44,"PP",229
48,"48061",773,585,582,6,3,"PP",42
20,"20051",7033,4843,4779,57,64,"PP",479
43,"43023",244,179,177,8,2,"PP",5
48,"48091",1170,860,851,3,9,"PP",62
48,"48013",81335,54452,53803,771,649,"PP",11032
25,"25228",2907,2043,2021,43,22,"PP",399
25,"25238",231,158,156,1,2,"PP",18
25,"25254",782,533,531,9,2,"PP",101
25,"25047",1048,760,748,24,12,"PP",75
32,"32026",2775,2096,2064,37,32,"PP",961
32,"32087",1935,1609,1591,11,18,"PP",1114
32,"32063",2127,1469,1444,22,25,"PP",782
43,"43138",2719,1775,1730,45,45,"PP",374
48,"48032",5864,4257,4223,32,34,"PP",435
48,"48909",194,163,163,0,0,"PP",1
27,"27008",1458,1130,1115,18,15,"PP",666
43,"43120",454,287,283,1,4,"PP",96
25,"25019",4626,2971,2932,54,39,"PP",638
48,"48080",10161,6901,6815,95,86,"PP",787
28,"28140",2665,2167,2141,26,26,"PP",1268
25,"25171",2305,1496,1469,37,27,"PP",123
32,"32003",950,736,727,3,9,"PP",466
32,"32015",995,697,694,9,3,"PP",496
25,"25068",576,376,364,6,12,"PP",41
25,"25255",468,318,309,9,9,"PP",46
27,"27057",11297,8174,8005,162,169,"PP",4414
25,"25223",951,562,546,14,16,"PP",62
25,"25089",107,66,64,0,2,"PP",1
43,"43031",1509,1016,992,20,24,"PP",142
25,"25182",1075,749,731,30,18,"PP",158
43,"43105",175,119,116,14,3,"PP",6
25,"25132",128,87,85,3,2,"PP",9
27,"27011",2663,1822,1785,23,37,"PP",904
25,"25101",583,391,382,8,9,"PP",27
27,"27053",606,429,426,4,3,"PP",259
25,"25040",10654,6905,6768,144,137,"PP",1297
48,"48911",373,300,296,1,4,"PP",2
43,"43080",254,175,173,7,2,"PP",25
28,"28153",608,422,406,1,16,"PP",164
25,"25141",171,111,107,2,4,"PP",19
28,"28060",1471,1205,1192,8,13,"PP",450
25,"25179",198,141,136,1,5,"PP",11
32,"32017",1333,906,895,10,11,"PP",631
28,"28168",1144,821,810,15,11,"PP",453
20,"20019",10105,6640,6555,73,85,"PP",681
20,"20023",451,260,259,2,1,"PP",23
25,"25133",748,499,483,7,16,"PP",64
48,"48020",276378,191777,190141,2335,1636,"PP",43548
28,"28054",10459,7798,7698,65,100,"PP",4199
27,"27029",1525,1243,1221,18,22,"PP",704
20,"20057",194,122,122,0,0,"PP",2
28,"28902",453,338,329,3,9,"PP",203
25,"25036",190,138,134,5,4,"PP",27
25,"25153",215,165,161,0,4,"PP",60
43,"43032",587,418,413,9,5,"PP",46
43,"43147",528,393,380,7,13,"PP",55
48,"48076",294,226,226,0,0,"PP",11
48,"48070",559,413,407,1,6,"PP",2
28,"28147",910,705,698,5,7,"PP",378
43,"43172",378,268,266,8,2,"PP",36
25,"25134",657,421,416,4,5,"PP",83
43,"43902",2761,1836,1811,25,25,"PP",300
20,"20008",757,499,499,8,0,"PP",18
25,"25013",2274,1344,1321,25,23,"PP",289
32,"32044",939,774,764,8,10,"PP",425
32,"32007",1674,1263,1243,4,20,"PP",792
25,"25239",627,310,310,7,0,"PP",32
43,"43107",378,255,248,18,7,"PP",28
20,"20034",3192,2035,2030,11,5,"PP",160
27,"27001",2582,1687,1669,31,18,"PP",1235
48,"48034",13160,9290,9189,82,101,"PP",2548
28,"28033",3581,2712,2691,14,21,"PP",1690
32,"32016",1021,781,776,2,5,"PP",390
25,"25017",248,160,159,1,1,"PP",12
43,"43037",16656,9986,9812,163,174,"PP",2654
25,"25145",88,67,67,2,0,"PP",6
43,"43034",494,355,344,8,11,"PP",45
32,"32081",2240,1698,1682,13,16,"PP",1007
25,"25043",830,483,467,17,16,"PP",32
28,"28070",139,98,97,0,1,"PP",52
28,"28177",9470,7524,7466,87,58,"PP",4552
43,"43127",778,530,524,6,6,"PP",67
25,"25052",1611,1094,1062,21,32,"PP",113
32,"32046",1375,976,962,3,14,"PP",645
25,"25082",265,156,155,8,1,"PP",17
28,"28126",59,37,37,0,0,"PP",20
25,"25105",146,90,89,1,1,"PP",13
43,"43109",2040,1332,1316,28,16,"PP",428
28,"28119",1911,1527,1514,13,13,"PP",953
43,"43117",150,118,115,1,3,"PP",21
27,"27009",2354,1812,1782,19,30,"PP",1239
48,"48018",905,591,587,8,4,"PP",5
48,"48084",23491,15322,15084,213,238,"PP",2618
20,"20052",1154,849,847,14,2,"PP",46
28,"28145",2125,1643,1620,15,23,"PP",793
32,"32062",963,735,729,10,6,"PP",446
25,"25022",119,83,83,0,0,"PP",2
20,"20049",4081,2741,2723,30,18,"PP",226
25,"25201",119,78,76,3,2,"PP",7
48,"48026",1093,881,875,3,6,"PP",18
20,"20025",1174,814,803,4,11,"PP",4
28,"28064",143,112,110,1,2,"PP",70
25,"25168",510,385,378,19,7,"PP",94
32,"32060",885,650,641,10,9,"PP",300
25,"25002",481,306,302,6,4,"PP",42
32,"32036",1528,1217,1202,13,15,"PP",872
43,"43110",307,216,214,5,2,"PP",28
48,"48015",34932,24209,23966,296,243,"PP",4201
20,"20906",117,89,89,0,0,"PP",1
20,"20905",142,105,103,1,2,"PP",2
28,"28043",5944,4199,4147,56,52,"PP",2538
43,"43132",365,217,214,8,3,"PP",31
28,"28130",27391,21367,21111,235,256,"PP",8808
32,"32052",2126,1690,1673,28,17,"PP",1194
20,"20015",1307,980,979,13,1,"PP",1
28,"28029",538,416,414,4,2,"PP",240
20,"20014",1101,660,654,8,6,"PP",25
25,"25138",605,440,428,13,12,"PP",74
25,"25056",289,168,163,3,5,"PP",20
43,"43013",4369,2795,2747,54,48,"PP",619
43,"43906",2050,1332,1298,28,34,"PP",260
25,"25113",1227,869,856,28,13,"PP",94
27,"27050",3236,2475,2438,11,37,"PP",1678
48,"48915",362,273,271,2,2,"PP",4
32,"32042",1784,1292,1282,13,10,"PP",883
43,"43114",383,238,234,6,4,"PP",14
32,"32049",863,566,563,7,3,"PP",329
28,"28051",1469,1147,1129,7,18,"PP",669
43,"43160",1278,840,812,9,28,"PP",189
25,"25217",10570,6660,6500,191,160,"PP",1033
28,"28032",4469,3412,3369,32,43,"PP",1790
27,"27045",1149,817,812,7,5,"PP",317
43,"43155",22951,14114,13856,326,258,"PP",2418
20,"20007",300,203,202,2,1,"PP",1
32,"32067",1487,1004,995,10,9,"PP",578
25,"25903",261,176,170,9,6,"PP",11
25,"25165",301,202,198,6,4,"PP",23
43,"43057",45,27,27,2,0,"PP",3
43,"43156",4120,2811,2741,66,70,"PP",744
32,"32051",1574,1296,1290,7,6,"PP",983
27,"27025",3005,2414,2377,25,37,"PP",1462
28,"28023",4350,3425,3392,32,33,"PP",1913
43,"43137",1873,1241,1212,27,29,"PP",269
43,"43009",1421,913,897,18,16,"PP",139
48,"48096",6607,5007,4900,54,107,"PP",505
48,"48097",1359,936,915,9,21,"PP",90
25,"25163",237,147,142,2,5,"PP",27
43,"43039",117,85,83,3,2,"PP",13
43,"43161",17199,10765,10547,197,218,"PP",1787
20,"20018",11027,7428,7387,53,41,"PP",372
43,"43094",2209,1558,1524,31,34,"PP",217
20,"20075",4447,2823,2798,32,25,"PP",258
28,"28903",29222,23945,23689,296,256,"PP",11173
43,"43071",975,677,664,14,13,"PP",152
25,"25194",440,292,283,11,9,"PP",56
27,"27012",1519,886,880,6,6,"PP",448
25,"25248",926,615,601,17,14,"PP",60
43,"43007",635,448,441,7,7,"PP",52
48,"48035",379,304,301,0,3,"PP",8
32,"32009",10752,7778,7684,120,94,"PP",4271
48,"48072",1009,796,787,3,9,"PP",39
43,"43048",830,547,530,16,17,"PP",147
43,"43047",4064,2412,2352,50,60,"PP",706
43,"43133",5697,3470,3388,76,82,"PP",656
25,"25136",106,79,79,1,0,"PP",10
43,"43008",333,206,197,3,9,"PP",69
25,"25911",472,306,296,2,10,"PP",31
27,"27028",78862,57097,55890,1246,1207,"PP",28042
32,"32010",457,362,356,0,6,"PP",231
48,"48062",317,263,262,1,1,"PP",9
43,"43149",711,529,516,13,13,"PP",74
32,"32014",1271,939,925,9,14,"PP",461
25,"25001",146,76,76,1,0,"PP",5
25,"25010",206,119,118,7,1,"PP",12
48,"48040",1274,936,921,10,15,"PP",44
43,"43062",298,227,223,7,4,"PP",41
25,"25245",445,312,306,4,6,"PP",48
27,"27020",3807,3204,3161,33,43,"PP",2208
43,"43049",805,555,536,6,19,"PP",28
43,"43115",171,112,110,3,2,"PP",2
28,"28026",5852,4506,4449,40,57,"PP",2668
20,"20058",770,549,547,3,2,"PP",77
25,"25161",361,222,218,1,4,"PP",17
48,"48910",3063,2122,2104,14,18,"PP",308
48,"48055",2620,1954,1934,22,20,"PP",158
28,"28172",7648,6130,6076,65,54,"PP",3605
32,"32020",2958,2300,2283,19,17,"PP",1410
25,"25126",286,192,189,7,3,"PP",22
25,"25104",128,88,86,11,2,"PP",16
32,"32028",1805,1369,1354,16,15,"PP",1076
43,"43129",4525,3032,2956,62,76,"PP",498
20,"20063",7889,5381,5340,48,41,"PP",291
25,"25231",515,402,395,4,7,"PP",65
43,"43165",624,471,459,6,12,"PP",42
28,"28148",79726,60405,59651,724,754,"PP",30028
25,"25130",208,117,112,4,5,"PP",15
43,"43021",381,218,213,3,5,"PP",21
25,"25905",386,264,258,12,6,"PP",58
28,"28094",774,557,551,5,6,"PP",308
27,"27018",3871,2523,2489,32,34,"PP",1126
25,"25155",714,490,485,8,5,"PP",72
28,"28137",1626,1231,1222,9,9,"PP",651
20,"20072",4643,2967,2948,46,19,"PP",382
43,"43093",3924,2507,2445,62,62,"PP",370
20,"20904",98,67,66,0,1,"PP",0
28,"28008",1734,1244,1221,11,23,"PP",752
20,"20069",146828,101992,101225,1287,767,"PP",21610
43,"43070",265,198,196,3,2,"PP",32
43,"43130",196,132,131,7,1,"PP",16
28,"28128",366,280,275,2,5,"PP",137
32,"32038",497,360,358,2,2,"PP",226
20,"20081",7346,4957,4925,35,32,"PP",300
43,"43081",574,415,404,13,11,"PP",47
32,"32050",2663,1991,1974,17,17,"PP",1344
48,"48028",767,623,621,1,2,"PP",13
25,"25016",2203,1375,1357,20,18,"PP",175
25,"25129",175,105,105,3,0,"PP",13
27,"27901",2559,1847,1831,27,16,"PP",1242
25,"25055",187,115,115,3,0,"PP",16
28,"28176",10977,8790,8718,68,72,"PP",5866
25,"25143",86,58,58,1,0,"PP",10
48,"48004",329,240,239,2,1,"PP",1
25,"25215",399,229,226,4,3,"PP",34
32,"32012",912,763,756,8,7,"PP",484
43,"43134",279,208,206,14,2,"PP",32
20,"20001",249,167,167,4,0,"PP",3
25,"25253",175,132,129,1,3,"PP",14
28,"28076",417,325,321,1,4,"PP",176
27,"27052",966,726,718,9,8,"PP",355
48,"48009",767,585,580,4,5,"PP",40
48,"48060",3689,2477,2466,12,11,"PP",76
32,"32024",5054,3668,3609,40,59,"PP",2097
32,"32085",10730,7588,7475,100,113,"PP",4672
25,"25190",271,180,176,12,4,"PP",9
28,"28175",780,641,630,8,11,"PP",387
25,"25227",674,375,372,2,3,"PP",28
27,"27032",3466,2565,2530,40,35,"PP",1520
27,"27024",1759,1346,1324,17,22,"PP",714
27,"27064",1706,1233,1214,14,19,"PP",828
25,"25167",253,176,172,0,4,"PP",29
32,"32082",1403,1055,1047,9,8,"PP",730
20,"20056",3975,2692,2669,17,23,"PP",133
25,"25079",307,242,240,7,2,"PP",39
25,"25029",1766,1145,1118,38,27,"PP",156
27,"27013",3950,3156,3090,39,66,"PP",1545
43,"43100",3062,2058,2021,52,37,"PP",563
28,"28109",1621,1121,1104,9,17,"PP",739
43,"43177",338,242,236,6,6,"PP",37
20,"20016",1526,937,932,4,5,"PP",20
20,"20065",3176,2156,2137,19,19,"PP",291
25,"25140",785,472,460,5,12,"PP",52
43,"43136",10163,6312,6197,121,115,"PP",977
20,"20040",15103,9781,9686,148,95,"PP",942
28,"28183",935,663,649,7,14,"PP",302
28,"28083",8037,6078,6025,66,53,"PP",3052
25,"25131",439,319,314,6,5,"PP",44
25,"25031",57,34,34,1,0,"PP",12
28,"28059",4061,3169,3130,38,39,"PP",1806
32,"32023",1360,1030,1011,6,19,"PP",534
25,"25112",286,202,199,11,3,"PP",32
28,"28016",86,68,67,3,1,"PP",33
25,"25125",450,297,289,10,8,"PP",44
27,"27046",1626,1177,1153,17,24,"PP",554
20,"20042",3354,2131,2117,18,14,"PP",174
28,"28174",1745,1233,1224,11,9,"PP",754
43,"43096",103,81,77,3,4,"PP",2
48,"48907",351,290,290,1,0,"PP",7
25,"25193",771,509,501,8,8,"PP",50
43,"43028",2654,1620,1588,27,32,"PP",377
48,"48041",721,588,585,9,3,"PP",19
32,"32065",720,550,539,3,11,"PP",304
20,"20043",1782,1220,1214,13,6,"PP",52
43,"43030",454,321,307,5,14,"PP",61
43,"43010",302,227,223,7,4,"PP",32
43,"43143",62,51,50,1,1,"PP",3
48,"48042",1401,1116,1099,15,17,"PP",165
43,"43095",2434,1658,1624,27,34,"PP",400
27,"27040",3421,2718,2693,27,25,"PP",1697
25,"25096",988,633,613,12,20,"PP",139
20,"20903",3625,2282,2267,52,15,"PP",207
28,"28118",72,49,47,1,2,"PP",26
25,"25085",153,103,100,2,3,"PP",27
48,"48912",2340,1794,1776,22,18,"PP",150
43,"43035",280,202,198,0,4,"PP",23
28,"28030",1591,1268,1230,12,38,"PP",620
28,"28159",629,482,478,2,4,"PP",305
25,"25226",257,162,158,5,4,"PP",19
48,"48011",9742,6697,6628,82,69,"PP",880
43,"43126",1170,802,783,19,19,"PP",125
48,"48049",564,446,446,2,0,"PP",13
25,"25005",291,194,190,7,4,"PP",22
28,"28097",127,94,92,0,2,"PP",26
43,"43112",294,184,181,2,3,"PP",6
43,"43082",383,282,270,8,12,"PP",38
32,"32055",1412,1056,1037,5,19,"PP",703
20,"20070",1109,817,815,4,2,"PP",22
43,"43131",4495,2842,2814,51,28,"PP",909
28,"28065",118796,93292,92186,919,1106,"PP",39047
27,"27030",3744,2587,2525,32,62,"PP",1387
48,"48051",225,157,156,0,1,"PP",28
32,"32066",634,492,488,0,4,"PP",413
28,"28100",3970,2903,2865,32,38,"PP",1599
27,"27039",4363,3410,3346,63,64,"PP",2180
25,"25192",799,543,527,19,16,"PP",86
25,"25202",110,62,59,3,3,"PP",7
25,"25250",358,237,234,4,3,"PP",36
43,"43025",660,453,446,13,7,"PP",74
20,"20054",476,350,348,1,2,"PP",12
43,"43174",152,104,101,1,3,"PP",4
48,"48027",21610,15409,15274,145,135,"PP",2150
48,"48010",427,303,300,2,3,"PP",3
20,"20044",368,258,257,1,1,"PP",7
25,"25211",701,378,368,5,10,"PP",57
43,"43153",10307,6572,6450,94,122,"PP",1595
27,"27056",1388,1043,1026,16,17,"PP",608
48,"48030",626,487,483,0,4,"PP",8
43,"43157",388,282,270,10,12,"PP",39
43,"43092",7051,4294,4220,45,74,"PP",1416
25,"25062",806,515,497,11,18,"PP",82
32,"32041",884,576,568,2,8,"PP",347
25,"25061",75,45,45,0,0,"PP",6
25,"25114",102,82,78,4,4,"PP",6
43,"43150",1337,994,977,12,17,"PP",148
48,"48066",350,277,277,0,0,"PP",6
25,"25057",198,140,136,2,4,"PP",35
32,"32078",1366,1026,1018,3,8,"PP",765
20,"20059",8816,6335,6293,32,42,"PP",345
20,"20017",8670,5923,5890,27,33,"PP",432
28,"28080",45696,36832,36529,402,303,"PP",23342
28,"28009",13466,10392,10286,102,106,"PP",5761
25,"25137",8404,5264,5167,112,97,"PP",851
28,"28057",1419,1084,1074,12,10,"PP",579
28,"28124",83,55,53,0,2,"PP",26
20,"20045",46542,30907,30536,425,371,"PP",6553
20,"20048",175,102,102,1,0,"PP",0
25,"25011",5241,3127,3080,48,47,"PP",691
25,"25906",235,160,154,3,6,"PP",16
20,"20033",884,650,641,4,9,"PP",21
25,"25060",92,53,52,1,1,"PP",9
25,"25251",670,476,473,1,3,"PP",79
25,"25093",657,465,455,8,10,"PP",66
25,"25033",1125,738,718,17,20,"PP",74
25,"25224",144,93,91,6,2,"PP",3
28,"28034",356,278,276,1,2,"PP",186
25,"25157",183,128,128,4,0,"PP",32
48,"48068",1577,1224,1213,4,11,"PP",23
28,"28068",10502,7857,7778,68,79,"PP",4494
48,"48914",324,278,276,0,2,"PP",2
25,"25219",144,90,86,0,4,"PP",18
25,"25122",1956,1281,1256,33,25,"PP",202
25,"25006",362,231,228,2,3,"PP",51
20,"20035",497,346,344,1,2,"PP",12
25,"25077",474,281,277,5,4,"PP",27
28,"28011",437,318,315,2,3,"PP",196
48,"48024",1026,845,841,3,4,"PP",23
48,"48002",7971,5377,5290,65,87,"PP",493
43,"43036",836,503,494,4,9,"PP",101
25,"25024",370,221,217,8,4,"PP",19
27,"27014",3511,2470,2437,45,33,"PP",1289
43,"43060",3049,2030,1980,62,50,"PP",228
25,"25209",1558,1041,1009,22,32,"PP",121
28,"28090",7899,6216,6131,60,85,"PP",3311
27,"27010",4725,3427,3368,55,59,"PP",2118
25,"25094",154,110,107,1,3,"PP",21
48,"48903",1909,1455,1430,4,25,"PP",220
32,"32045",2640,1999,1980,23,19,"PP",1177
28,"28102",913,700,693,9,7,"PP",321
43,"43026",800,531,522,15,9,"PP",77
25,"25037",396,275,273,9,2,"PP",50
48,"48006",285,246,243,3,3,"PP",5
28,"28134",55921,42676,42221,505,455,"PP",20880
20,"20013",5331,3662,3637,33,25,"PP",271
28,"28132",10987,8066,7943,90,123,"PP",3784
25,"25200",353,225,217,4,8,"PP",20
28,"28125",2808,2077,2055,19,22,"PP",1252
43,"43002",1790,1252,1226,17,26,"PP",313
20,"20060",92,83,82,0,1,"PP",0
32,"32021",1043,793,788,7,5,"PP",340
25,"25240",1398,976,958,17,18,"PP",219
25,"25154",126,77,77,2,0,"PP",15
25,"25014",264,170,164,11,6,"PP",11
27,"27049",1554,1073,1062,6,11,"PP",696
43,"43024",1459,958,937,17,21,"PP",268
28,"28156",958,742,733,12,9,"PP",390
28,"28141",5568,4097,4051,31,46,"PP",2383
27,"27033",723,536,529,10,7,"PP",324
43,"43168",106,70,69,2,1,"PP",12
20,"20028",2204,1400,1379,11,21,"PP",126
28,"28055",932,713,707,5,6,"PP",429
22,"22083",522,437,428,4,9,"PP-PAR",228
22,"22156",256,209,203,5,6,"PP-PAR",84
50,"50122",68,47,45,2,2,"PP-PAR",26
44,"44019",75,38,37,0,1,"PP-PAR",26
50,"50088",337,273,264,4,9,"PP-PAR",120
50,"50034",923,634,617,10,17,"PP-PAR",293
50,"50117",131,101,100,1,1,"PP-PAR",57
50,"50132",697,544,536,11,8,"PP-PAR",302
22,"22907",1444,1034,1018,12,16,"PP-PAR",491
50,"50075",89,74,74,1,0,"PP-PAR",59
22,"22017",917,677,661,8,16,"PP-PAR",355
50,"50024",652,541,531,8,10,"PP-PAR",213
44,"44122",1441,1009,990,21,19,"PP-PAR",506
44,"44037",483,349,344,10,5,"PP-PAR",198
44,"44208",32,23,23,1,0,"PP-PAR",19
44,"44191",806,602,594,6,8,"PP-PAR",239
22,"22084",524,362,354,11,8,"PP-PAR",155
44,"44192",401,324,322,5,2,"PP-PAR",179
44,"44102",30,29,28,0,1,"PP-PAR",21
22,"22116",1571,1127,1114,37,13,"PP-PAR",551
22,"22047",228,200,200,5,0,"PP-PAR",123
44,"44182",216,173,173,4,0,"PP-PAR",110
22,"22173",247,150,150,3,0,"PP-PAR",52
44,"44071",657,453,448,9,5,"PP-PAR",236
22,"22060",1180,909,891,13,18,"PP-PAR",438
22,"22199",7259,4980,4861,128,119,"PP-PAR",2039
44,"44172",345,257,251,3,6,"PP-PAR",151
22,"22023",474,382,380,4,2,"PP-PAR",240
50,"50218",113,92,92,0,0,"PP-PAR",62
44,"44024",24,19,19,0,0,"PP-PAR",16
50,"50271",283,209,207,4,2,"PP-PAR",127
50,"50177",355,268,265,4,3,"PP-PAR",157
44,"44196",152,116,114,2,2,"PP-PAR",53
50,"50106",137,107,106,0,1,"PP-PAR",59
22,"22214",131,101,100,2,1,"PP-PAR",77
44,"44063",82,55,55,2,0,"PP-PAR",17
44,"44238",2475,1718,1692,50,26,"PP-PAR",502
50,"50243",346,277,272,2,5,"PP-PAR",177
44,"44100",200,147,146,0,1,"PP-PAR",55
50,"50030",232,164,160,1,4,"PP-PAR",75
50,"50257",195,154,154,0,0,"PP-PAR",57
50,"50178",325,228,225,4,3,"PP-PAR",101
50,"50183",369,277,274,5,3,"PP-PAR",169
44,"44257",184,132,131,6,1,"PP-PAR",72
50,"50007",61,45,45,0,0,"PP-PAR",25
22,"22086",207,149,147,1,2,"PP-PAR",64
44,"44176",167,131,130,5,1,"PP-PAR",57
44,"44235",103,71,68,0,3,"PP-PAR",43
44,"44265",203,169,158,6,11,"PP-PAR",110
50,"50047",60,34,34,2,0,"PP-PAR",12
50,"50279",111,79,79,1,0,"PP-PAR",20
44,"44229",150,108,107,5,1,"PP-PAR",51
50,"50266",139,95,94,1,1,"PP-PAR",58
50,"50191",505,395,390,4,5,"PP-PAR",207
44,"44010",189,138,138,2,0,"PP-PAR",80
50,"50212",52,48,48,0,0,"PP-PAR",26
22,"22163",431,353,344,5,9,"PP-PAR",168
22,"22227",225,172,168,3,4,"PP-PAR",82
22,"22246",93,63,62,0,1,"PP-PAR",20
44,"44205",757,541,527,12,14,"PP-PAR",267
22,"22127",483,357,353,9,4,"PP-PAR",187
22,"22035",261,179,176,3,3,"PP-PAR",54
22,"22200",271,198,191,3,7,"PP-PAR",96
50,"50018",973,761,755,12,6,"PP-PAR",356
50,"50187",72,45,45,1,0,"PP-PAR",20
44,"44141",147,99,95,0,4,"PP-PAR",55
22,"22106",25,17,17,0,0,"PP-PAR",8
22,"22110",822,602,588,3,14,"PP-PAR",264
44,"44008",1695,1280,1257,11,23,"PP-PAR",543
22,"22142",114,91,91,2,0,"PP-PAR",66
50,"50026",459,360,354,5,6,"PP-PAR",151
50,"50265",63,46,46,1,0,"PP-PAR",24
50,"50081",562,410,400,7,10,"PP-PAR",243
44,"44211",39,32,32,2,0,"PP-PAR",19
50,"50087",31,25,25,0,0,"PP-PAR",13
44,"44130",38,27,27,0,0,"PP-PAR",25
22,"22236",266,213,213,3,0,"PP-PAR",116
44,"44241",575,442,427,4,15,"PP-PAR",247
50,"50036",103,81,80,2,1,"PP-PAR",37
50,"50098",215,150,146,2,4,"PP-PAR",77
50,"50079",281,213,210,2,3,"PP-PAR",115
50,"50154",129,98,97,1,1,"PP-PAR",77
50,"50267",648,450,441,8,9,"PP-PAR",183
50,"50005",245,199,195,1,4,"PP-PAR",130
44,"44028",202,159,156,2,3,"PP-PAR",100
50,"50298",5319,4023,3955,72,68,"PP-PAR",2027
44,"44244",93,56,56,5,0,"PP-PAR",31
44,"44123",117,79,78,2,1,"PP-PAR",46
50,"50013",244,195,195,1,0,"PP-PAR",84
22,"22234",818,609,605,12,4,"PP-PAR",364
44,"44086",485,380,371,5,9,"PP-PAR",177
44,"44032",18,12,12,0,0,"PP-PAR",4
50,"50008",5110,3458,3406,56,52,"PP-PAR",1322
22,"22203",92,79,79,0,0,"PP-PAR",44
44,"44022",550,387,380,6,7,"PP-PAR",173
44,"44115",121,100,100,0,0,"PP-PAR",44
50,"50089",6673,4936,4877,120,59,"PP-PAR",2723
44,"44174",435,310,309,3,1,"PP-PAR",192
50,"50296",417,313,310,6,3,"PP-PAR",72
50,"50107",953,785,780,13,5,"PP-PAR",428
50,"50151",713,536,531,5,5,"PP-PAR",238
44,"44175",138,111,111,4,0,"PP-PAR",60
44,"44218",37,26,26,2,0,"PP-PAR",17
44,"44001",69,48,47,0,1,"PP-PAR",28
44,"44056",577,436,434,7,2,"PP-PAR",268
50,"50275",103,76,76,0,0,"PP-PAR",57
44,"44207",187,147,146,5,1,"PP-PAR",75
44,"44252",78,63,60,0,3,"PP-PAR",52
50,"50201",466,366,363,7,3,"PP-PAR",205
50,"50065",59,37,37,2,0,"PP-PAR",18
50,"50250",58,43,43,4,0,"PP-PAR",17
22,"22087",85,56,55,4,1,"PP-PAR",46
44,"44237",450,352,343,5,9,"PP-PAR",174
44,"44031",124,72,72,0,0,"PP-PAR",43
22,"22036",101,82,82,1,0,"PP-PAR",55
22,"22059",1149,792,764,23,28,"PP-PAR",341
50,"50152",1569,1151,1135,31,16,"PP-PAR",633
50,"50205",98,72,71,2,1,"PP-PAR",24
50,"50084",84,64,64,1,0,"PP-PAR",41
50,"50200",534,436,432,9,4,"PP-PAR",148
44,"44009",805,608,595,18,13,"PP-PAR",263
50,"50001",130,96,96,0,0,"PP-PAR",61
50,"50181",1053,787,760,9,27,"PP-PAR",386
50,"50169",371,275,274,5,1,"PP-PAR",156
50,"50156",234,186,183,2,3,"PP-PAR",82
22,"22051",108,86,84,2,2,"PP-PAR",47
22,"22037",115,87,79,0,8,"PP-PAR",44
44,"44080",294,216,211,3,5,"PP-PAR",90
50,"50175",1088,742,732,10,10,"PP-PAR",262
22,"22080",288,217,217,4,0,"PP-PAR",130
50,"50027",260,209,202,2,7,"PP-PAR",81
50,"50232",176,123,120,5,3,"PP-PAR",54
22,"22019",190,141,138,4,3,"PP-PAR",54
50,"50116",220,154,153,0,1,"PP-PAR",98
44,"44161",487,363,358,9,5,"PP-PAR",219
50,"50010",77,65,64,5,1,"PP-PAR",49
50,"50286",90,73,73,2,0,"PP-PAR",39
22,"22122",62,57,57,3,0,"PP-PAR",27
22,"22067",82,54,49,3,5,"PP-PAR",9
44,"44112",473,353,350,4,3,"PP-PAR",191
50,"50268",59,46,46,3,0,"PP-PAR",31
50,"50029",676,527,517,6,10,"PP-PAR",184
50,"50039",580,450,446,3,4,"PP-PAR",191
50,"50128",36,30,29,0,1,"PP-PAR",13
44,"44133",21,16,16,0,0,"PP-PAR",13
22,"22109",243,178,178,2,0,"PP-PAR",90
22,"22027",351,251,250,8,1,"PP-PAR",122
50,"50258",54,37,37,0,0,"PP-PAR",24
44,"44171",186,127,124,3,3,"PP-PAR",46
22,"22222",510,367,365,6,2,"PP-PAR",187
44,"44085",61,38,38,0,0,"PP-PAR",33
50,"50148",365,256,251,2,5,"PP-PAR",111
22,"22124",229,171,170,2,1,"PP-PAR",85
50,"50287",298,214,211,10,3,"PP-PAR",102
50,"50062",1750,1298,1275,22,23,"PP-PAR",577
50,"50108",50,31,31,0,0,"PP-PAR",14
50,"50206",499,386,384,10,2,"PP-PAR",218
22,"22167",515,417,399,16,18,"PP-PAR",200
44,"44258",75,56,55,0,1,"PP-PAR",36
22,"22195",231,193,189,6,4,"PP-PAR",109
22,"22063",184,142,140,2,2,"PP-PAR",69
22,"22020",110,81,79,3,2,"PP-PAR",41
22,"22007",863,636,621,8,15,"PP-PAR",363
22,"22250",368,261,255,12,6,"PP-PAR",116
50,"50282",88,66,63,3,3,"PP-PAR",41
22,"22003",148,117,116,2,1,"PP-PAR",58
44,"44096",173,139,133,4,6,"PP-PAR",69
50,"50060",187,138,136,1,2,"PP-PAR",78
44,"44247",335,251,243,10,8,"PP-PAR",109
50,"50222",1695,1117,1091,16,26,"PP-PAR",564
44,"44150",30,30,30,0,0,"PP-PAR",11
44,"44126",344,250,236,1,14,"PP-PAR",146
44,"44040",206,167,166,5,1,"PP-PAR",84
50,"50159",728,554,544,4,10,"PP-PAR",309
22,"22157",251,176,175,9,1,"PP-PAR",75
22,"22064",184,139,137,3,2,"PP-PAR",58
22,"22170",622,439,430,13,9,"PP-PAR",218
44,"44256",37,35,35,9,0,"PP-PAR",16
50,"50074",6516,4378,4222,77,156,"PP-PAR",1880
44,"44227",81,59,59,0,0,"PP-PAR",41
44,"44263",332,249,243,10,6,"PP-PAR",120
50,"50023",240,180,180,4,0,"PP-PAR",119
22,"22062",189,126,125,2,1,"PP-PAR",67
44,"44099",724,519,511,4,8,"PP-PAR",184
44,"44012",389,297,293,5,4,"PP-PAR",165
22,"22112",9618,6642,6533,205,109,"PP-PAR",3722
22,"22105",132,104,102,2,2,"PP-PAR",45
44,"44093",86,64,64,3,0,"PP-PAR",26
44,"44076",2338,1839,1797,36,42,"PP-PAR",831
50,"50124",474,375,367,11,8,"PP-PAR",231
50,"50180",111,91,89,3,2,"PP-PAR",52
22,"22099",532,411,408,6,3,"PP-PAR",196
22,"22172",613,463,452,6,11,"PP-PAR",246
22,"22094",109,76,74,5,2,"PP-PAR",38
22,"22232",98,78,75,0,3,"PP-PAR",49
50,"50091",56,39,39,1,0,"PP-PAR",29
44,"44089",57,50,49,0,1,"PP-PAR",41
44,"44184",34,21,21,2,0,"PP-PAR",17
50,"50238",114,82,80,0,2,"PP-PAR",36
50,"50059",790,593,586,12,7,"PP-PAR",288
50,"50141",116,98,98,1,0,"PP-PAR",64
22,"22189",199,140,138,5,2,"PP-PAR",59
22,"22253",71,54,54,1,0,"PP-PAR",27
22,"22206",218,169,167,3,2,"PP-PAR",67
22,"22135",200,152,147,5,5,"PP-PAR",80
50,"50225",1638,1079,1062,7,17,"PP-PAR",654
50,"50051",886,677,671,9,6,"PP-PAR",300
50,"50028",120,86,85,2,1,"PP-PAR",29
44,"44163",119,91,91,0,0,"PP-PAR",41
50,"50245",121,80,80,1,0,"PP-PAR",31
50,"50160",2397,1905,1865,19,40,"PP-PAR",685
50,"50236",124,103,103,2,0,"PP-PAR",64
22,"22011",102,78,78,3,0,"PP-PAR",47
44,"44209",892,666,649,6,17,"PP-PAR",352
50,"50109",101,79,79,2,0,"PP-PAR",42
50,"50016",51,30,30,1,0,"PP-PAR",17
50,"50123",428,335,332,9,3,"PP-PAR",149
50,"50061",228,191,183,3,8,"PP-PAR",104
50,"50284",176,131,130,1,1,"PP-PAR",49
22,"22151",97,71,71,0,0,"PP-PAR",51
50,"50140",172,108,108,1,0,"PP-PAR",57
44,"44108",352,228,225,8,3,"PP-PAR",126
44,"44147",439,320,314,14,6,"PP-PAR",183
50,"50121",297,250,245,6,5,"PP-PAR",135
50,"50277",82,63,63,0,0,"PP-PAR",39
50,"50011",131,113,113,8,0,"PP-PAR",36
22,"22226",823,640,627,11,13,"PP-PAR",280
50,"50186",44,30,29,0,1,"PP-PAR",13
22,"22215",137,90,90,1,0,"PP-PAR",24
44,"44113",79,57,55,0,2,"PP-PAR",7
22,"22176",173,154,149,2,5,"PP-PAR",111
44,"44189",69,57,57,0,0,"PP-PAR",30
50,"50165",1880,1339,1274,49,65,"PP-PAR",611
44,"44117",357,278,275,0,3,"PP-PAR",115
50,"50237",103,76,75,0,1,"PP-PAR",46
50,"50203",1083,814,798,28,16,"PP-PAR",349
44,"44035",122,99,98,3,1,"PP-PAR",72
22,"22001",242,177,173,2,4,"PP-PAR",127
50,"50046",201,155,153,2,2,"PP-PAR",104
50,"50241",634,462,455,2,7,"PP-PAR",278
50,"50221",38,20,20,0,0,"PP-PAR",7
44,"44149",106,79,78,2,1,"PP-PAR",38
22,"22125",38140,26924,26463,676,461,"PP-PAR",12107
50,"50066",2357,1677,1659,42,18,"PP-PAR",975
44,"44097",158,97,95,1,2,"PP-PAR",52
50,"50037",140,110,103,3,7,"PP-PAR",70
44,"44101",60,47,47,1,0,"PP-PAR",27
22,"22129",193,124,123,4,1,"PP-PAR",74
22,"22229",127,93,89,4,4,"PP-PAR",38
50,"50076",113,89,89,0,0,"PP-PAR",41
50,"50280",370,296,291,5,5,"PP-PAR",119
44,"44087",98,87,87,2,0,"PP-PAR",46
22,"22008",194,168,167,11,1,"PP-PAR",95
50,"50025",4569,3319,3271,68,48,"PP-PAR",1768
44,"44111",101,68,68,4,0,"PP-PAR",20
44,"44136",51,39,39,0,0,"PP-PAR",25
44,"44092",89,68,68,0,0,"PP-PAR",47
22,"22901",792,515,508,13,7,"PP-PAR",185
50,"50092",329,273,272,0,1,"PP-PAR",114
44,"44046",58,44,44,1,0,"PP-PAR",16
44,"44151",215,143,140,1,3,"PP-PAR",72
22,"22230",302,234,231,11,3,"PP-PAR",115
22,"22018",357,272,271,4,1,"PP-PAR",114
50,"50114",157,120,120,1,0,"PP-PAR",51
50,"50096",49,35,35,0,0,"PP-PAR",21
50,"50093",113,84,84,2,0,"PP-PAR",42
22,"22139",86,66,63,2,3,"PP-PAR",41
50,"50171",126,90,89,4,1,"PP-PAR",60
44,"44051",2783,2144,2089,38,55,"PP-PAR",1138
50,"50168",34,26,26,1,0,"PP-PAR",14
22,"22248",119,94,92,3,2,"PP-PAR",37
44,"44047",267,162,160,4,2,"PP-PAR",97
22,"22074",311,227,219,5,8,"PP-PAR",110
44,"44026",89,69,69,0,0,"PP-PAR",43
44,"44138",158,109,106,0,3,"PP-PAR",74
22,"22182",271,160,150,4,10,"PP-PAR",68
22,"22006",319,203,197,5,6,"PP-PAR",68
50,"50215",21,20,19,0,1,"PP-PAR",11
22,"22184",203,172,167,2,5,"PP-PAR",96
44,"44153",1882,1273,1246,10,27,"PP-PAR",597
44,"44221",377,305,297,6,8,"PP-PAR",166
50,"50272",12481,8744,8642,176,102,"PP-PAR",3796
50,"50254",179,136,136,0,0,"PP-PAR",74
50,"50139",372,280,278,3,2,"PP-PAR",167
22,"22021",2080,1524,1505,31,19,"PP-PAR",635
22,"22904",908,660,653,14,7,"PP-PAR",325
22,"22178",107,92,92,1,0,"PP-PAR",62
44,"44053",111,77,76,2,1,"PP-PAR",51
44,"44002",62,47,47,1,0,"PP-PAR",23
50,"50136",617,469,462,4,7,"PP-PAR",325
50,"50242",102,82,82,2,0,"PP-PAR",29
22,"22088",171,133,128,5,5,"PP-PAR",40
50,"50216",267,201,194,8,7,"PP-PAR",115
22,"22908",231,167,162,2,5,"PP-PAR",72
50,"50041",21,13,13,0,0,"PP-PAR",2
22,"22022",582,448,438,12,10,"PP-PAR",199
22,"22044",278,195,191,7,4,"PP-PAR",73
50,"50255",219,150,148,1,2,"PP-PAR",23
44,"44029",637,495,490,6,5,"PP-PAR",231
44,"44128",84,56,56,3,0,"PP-PAR",31
22,"22251",391,288,278,4,10,"PP-PAR",183
44,"44231",54,38,36,2,2,"PP-PAR",19
44,"44236",77,48,47,0,1,"PP-PAR",27
50,"50147",845,637,627,12,10,"PP-PAR",230
44,"44018",27,23,23,0,0,"PP-PAR",22
50,"50157",313,253,250,7,3,"PP-PAR",121
22,"22906",190,152,147,3,5,"PP-PAR",55
44,"44121",63,48,48,1,0,"PP-PAR",31
22,"22082",320,231,229,1,2,"PP-PAR",137
22,"22102",194,152,149,4,3,"PP-PAR",69
44,"44070",62,47,47,1,0,"PP-PAR",37
44,"44116",96,68,65,3,3,"PP-PAR",44
22,"22079",126,97,97,4,0,"PP-PAR",38
22,"22115",415,307,304,2,3,"PP-PAR",172
44,"44267",79,63,61,2,2,"PP-PAR",44
50,"50101",922,648,637,8,11,"PP-PAR",294
50,"50111",191,141,138,2,3,"PP-PAR",76
50,"50247",794,572,567,7,5,"PP-PAR",327
44,"44005",59,43,43,1,0,"PP-PAR",25
22,"22053",867,567,554,13,13,"PP-PAR",262
50,"50053",756,570,563,14,7,"PP-PAR",266
22,"22024",222,144,139,3,5,"PP-PAR",66
50,"50006",978,758,749,16,9,"PP-PAR",329
22,"22012",93,74,74,5,0,"PP-PAR",44
50,"50294",77,58,57,0,1,"PP-PAR",34
50,"50129",258,164,164,0,0,"PP-PAR",87
44,"44114",254,194,188,4,6,"PP-PAR",124
22,"22076",331,241,235,3,6,"PP-PAR",97
44,"44230",154,127,127,3,0,"PP-PAR",50
50,"50070",70,42,41,0,1,"PP-PAR",15
22,"22168",22,16,16,0,0,"PP-PAR",8
44,"44222",136,99,99,2,0,"PP-PAR",65
50,"50230",1295,914,903,13,11,"PP-PAR",466
22,"22057",377,283,278,3,5,"PP-PAR",86
44,"44239",29,25,25,1,0,"PP-PAR",23
44,"44045",373,303,301,4,2,"PP-PAR",168
22,"22187",295,222,222,3,0,"PP-PAR",99
22,"22175",211,158,158,9,0,"PP-PAR",82
50,"50164",407,271,268,4,3,"PP-PAR",129
22,"22243",45,27,27,1,0,"PP-PAR",12
44,"44131",26,20,20,0,0,"PP-PAR",7
50,"50080",41,31,31,1,0,"PP-PAR",13
22,"22043",112,72,71,2,1,"PP-PAR",46
50,"50240",1127,799,783,25,16,"PP-PAR",321
44,"44034",150,117,117,1,0,"PP-PAR",69
50,"50045",1289,1011,992,14,19,"PP-PAR",566
22,"22045",104,83,80,2,3,"PP-PAR",43
22,"22165",515,409,403,9,6,"PP-PAR",225
44,"44215",156,100,100,2,0,"PP-PAR",47
22,"22111",180,126,125,3,1,"PP-PAR",69
50,"50104",379,306,303,4,3,"PP-PAR",153
50,"50017",1734,1232,1212,41,20,"PP-PAR",595
50,"50293",492,339,338,6,1,"PP-PAR",139
22,"22028",424,311,310,3,1,"PP-PAR",144
50,"50231",285,231,224,7,7,"PP-PAR",109
44,"44228",121,97,96,2,1,"PP-PAR",58
22,"22902",240,169,169,3,0,"PP-PAR",95
22,"22160",219,166,166,5,0,"PP-PAR",74
22,"22197",504,395,390,7,5,"PP-PAR",206
22,"22903",672,555,547,6,8,"PP-PAR",262
22,"22016",654,476,464,10,12,"PP-PAR",218
50,"50146",211,168,167,4,1,"PP-PAR",76
50,"50288",3252,2412,2380,50,32,"PP-PAR",1334
50,"50166",282,216,210,1,6,"PP-PAR",110
50,"50057",1468,1022,1004,17,18,"PP-PAR",570
22,"22029",130,99,98,6,1,"PP-PAR",47
44,"44177",120,85,85,1,0,"PP-PAR",31
50,"50291",112,75,73,0,2,"PP-PAR",48
50,"50235",2371,1723,1701,36,22,"PP-PAR",908
44,"44142",39,28,28,1,0,"PP-PAR",13
22,"22013",304,239,236,3,3,"PP-PAR",119
22,"22208",168,136,133,2,3,"PP-PAR",47
22,"22220",192,138,136,5,2,"PP-PAR",68
22,"22066",699,479,464,8,15,"PP-PAR",161
22,"22150",491,342,336,9,6,"PP-PAR",164
50,"50292",138,117,115,4,2,"PP-PAR",85
22,"22225",2784,1839,1805,42,34,"PP-PAR",1039
44,"44159",47,43,43,0,0,"PP-PAR",31
50,"50032",330,233,228,3,5,"PP-PAR",118
50,"50196",110,87,86,4,1,"PP-PAR",23
50,"50233",120,89,88,2,1,"PP-PAR",58
22,"22137",1164,850,839,14,11,"PP-PAR",364
50,"50214",31,22,21,1,1,"PP-PAR",15
50,"50067",14124,10049,9870,203,179,"PP-PAR",5246
50,"50058",80,65,64,0,1,"PP-PAR",35
50,"50290",436,334,331,4,3,"PP-PAR",178
22,"22077",421,327,323,14,4,"PP-PAR",139
50,"50144",36,32,32,0,0,"PP-PAR",14
44,"44179",369,245,243,6,2,"PP-PAR",124
22,"22009",704,488,473,15,15,"PP-PAR",178
44,"44194",128,92,89,1,3,"PP-PAR",62
22,"22128",203,164,161,7,3,"PP-PAR",90
50,"50193",635,483,465,3,18,"PP-PAR",209
50,"50253",461,381,375,3,6,"PP-PAR",236
44,"44220",137,97,96,1,1,"PP-PAR",70
44,"44013",11286,7797,7584,242,213,"PP-PAR",3824
50,"50208",1831,1321,1305,24,16,"PP-PAR",522
44,"44125",78,57,57,1,0,"PP-PAR",43
50,"50002",166,130,130,2,0,"PP-PAR",88
50,"50021",42,34,33,1,1,"PP-PAR",29
44,"44216",25877,18461,18057,467,404,"PP-PAR",9906
44,"44052",96,60,59,2,1,"PP-PAR",39
22,"22233",94,69,69,0,0,"PP-PAR",26
44,"44195",103,71,70,0,1,"PP-PAR",38
22,"22249",110,83,81,0,2,"PP-PAR",25
50,"50040",98,77,76,2,1,"PP-PAR",39
50,"50085",205,143,143,3,0,"PP-PAR",84
50,"50019",79,57,55,1,2,"PP-PAR",26
44,"44181",82,63,63,3,0,"PP-PAR",46
44,"44074",435,344,337,5,7,"PP-PAR",180
22,"22218",49,33,33,1,0,"PP-PAR",17
44,"44200",41,30,30,0,0,"PP-PAR",25
50,"50143",608,427,424,5,3,"PP-PAR",207
44,"44119",119,84,84,2,0,"PP-PAR",28
44,"44213",60,48,48,0,0,"PP-PAR",38
44,"44016",541,384,379,5,5,"PP-PAR",205
22,"22909",349,259,252,3,7,"PP-PAR",119
44,"44120",217,126,121,5,5,"PP-PAR",77
50,"50004",613,445,441,6,4,"PP-PAR",179
22,"22096",301,239,237,8,2,"PP-PAR",129
44,"44011",67,47,47,0,0,"PP-PAR",20
50,"50052",100,82,82,0,0,"PP-PAR",69
44,"44155",1162,819,801,24,18,"PP-PAR",270
44,"44156",57,40,38,1,2,"PP-PAR",23
44,"44224",26,15,15,0,0,"PP-PAR",7
50,"50042",16,14,14,0,0,"PP-PAR",9
50,"50223",956,751,745,14,6,"PP-PAR",283
50,"50033",81,64,64,0,0,"PP-PAR",33
50,"50134",134,102,101,3,1,"PP-PAR",65
44,"44198",205,160,160,5,0,"PP-PAR",88
50,"50090",165,117,117,1,0,"PP-PAR",101
22,"22252",130,98,96,5,2,"PP-PAR",48
44,"44043",126,94,94,7,0,"PP-PAR",50
50,"50056",450,329,328,4,1,"PP-PAR",173
44,"44251",271,218,218,5,0,"PP-PAR",170
50,"50202",182,125,122,2,3,"PP-PAR",60
50,"50162",160,108,108,2,0,"PP-PAR",55
44,"44157",62,45,44,0,1,"PP-PAR",22
50,"50285",635,452,445,8,7,"PP-PAR",233
22,"22217",406,314,309,4,5,"PP-PAR",169
50,"50184",132,106,106,1,0,"PP-PAR",69
22,"22042",115,93,91,1,2,"PP-PAR",42
44,"44260",160,117,115,5,2,"PP-PAR",70
44,"44044",103,79,78,0,1,"PP-PAR",52
50,"50015",109,73,73,0,0,"PP-PAR",26
50,"50063",76,67,67,0,0,"PP-PAR",32
50,"50031",167,105,103,0,2,"PP-PAR",45
44,"44243",38,27,26,3,1,"PP-PAR",14
22,"22228",501,382,369,15,13,"PP-PAR",193
50,"50251",8379,6225,6116,110,109,"PP-PAR",3079
44,"44033",307,222,221,5,1,"PP-PAR",121
44,"44014",2603,1965,1912,25,53,"PP-PAR",813
50,"50003",141,108,108,3,0,"PP-PAR",59
44,"44041",67,56,51,1,5,"PP-PAR",14
50,"50150",716,430,427,10,3,"PP-PAR",265
50,"50073",2265,1773,1756,20,17,"PP-PAR",889
22,"22085",119,97,94,0,3,"PP-PAR",40
50,"50207",126,97,95,1,2,"PP-PAR",47
50,"50083",96,72,72,1,0,"PP-PAR",22
50,"50173",175,104,104,2,0,"PP-PAR",78
22,"22205",472,369,363,5,6,"PP-PAR",128
22,"22119",1433,994,981,14,13,"PP-PAR",527
44,"44082",90,67,66,1,1,"PP-PAR",31
22,"22193",318,266,264,7,2,"PP-PAR",127
22,"22158",11978,8404,8279,149,125,"PP-PAR",3919
50,"50055",3592,2520,2473,59,47,"PP-PAR",1280
22,"22209",161,115,115,4,0,"PP-PAR",23
44,"44132",64,57,56,0,1,"PP-PAR",37
50,"50217",496,380,379,0,1,"PP-PAR",181
50,"50118",2312,1737,1718,22,19,"PP-PAR",724
22,"22078",468,302,301,8,1,"PP-PAR",107
50,"50078",278,210,208,2,2,"PP-PAR",86
44,"44148",98,77,77,3,0,"PP-PAR",40
50,"50068",2082,1514,1481,18,33,"PP-PAR",797
50,"50211",277,193,193,1,0,"PP-PAR",119
50,"50281",76,63,63,2,0,"PP-PAR",45
22,"22141",129,103,102,3,1,"PP-PAR",65
50,"50155",119,91,91,1,0,"PP-PAR",52
50,"50278",207,152,149,4,3,"PP-PAR",95
22,"22046",784,618,599,15,19,"PP-PAR",287
44,"44109",123,86,84,2,2,"PP-PAR",36
50,"50269",316,186,185,1,1,"PP-PAR",124
44,"44234",76,63,63,0,0,"PP-PAR",33
44,"44190",81,52,52,0,0,"PP-PAR",31
50,"50125",421,284,280,1,4,"PP-PAR",162
44,"44261",777,600,594,8,6,"PP-PAR",259
50,"50149",48,35,35,0,0,"PP-PAR",30
22,"22177",101,79,75,1,4,"PP-PAR",44
22,"22186",217,173,173,3,0,"PP-PAR",61
44,"44006",293,220,212,3,8,"PP-PAR",123
44,"44075",329,250,240,4,10,"PP-PAR",158
50,"50295",54,42,41,0,1,"PP-PAR",19
50,"50153",1002,757,748,12,9,"PP-PAR",307
44,"44107",233,161,154,3,7,"PP-PAR",74
50,"50120",53,41,41,0,0,"PP-PAR",25
50,"50185",150,109,109,2,0,"PP-PAR",54
22,"22072",209,130,128,2,2,"PP-PAR",44
22,"22114",137,94,94,4,0,"PP-PAR",65
44,"44219",207,159,157,1,2,"PP-PAR",111
50,"50182",3704,2551,2515,44,36,"PP-PAR",1424
22,"22004",146,97,97,2,0,"PP-PAR",44
50,"50227",105,79,79,2,0,"PP-PAR",53
44,"44038",112,94,92,3,2,"PP-PAR",51
22,"22061",6611,4789,4698,110,91,"PP-PAR",2446
22,"22164",46,32,32,0,0,"PP-PAR",14
22,"22133",123,87,85,2,2,"PP-PAR",34
44,"44084",63,51,50,0,1,"PP-PAR",21
44,"44055",85,63,62,2,1,"PP-PAR",39
22,"22041",175,138,138,1,0,"PP-PAR",89
50,"50189",776,588,576,9,12,"PP-PAR",331
50,"50902",97,85,85,1,0,"PP-PAR",55
50,"50234",251,201,191,13,10,"PP-PAR",113
44,"44088",32,31,31,1,0,"PP-PAR",23
44,"44232",408,301,295,5,6,"PP-PAR",173
50,"50012",105,93,90,0,3,"PP-PAR",38
50,"50072",181,128,127,1,1,"PP-PAR",88
50,"50262",1216,916,904,20,12,"PP-PAR",336
50,"50138",49,43,43,2,0,"PP-PAR",27
50,"50263",235,160,160,1,0,"PP-PAR",67
50,"50259",89,53,53,1,0,"PP-PAR",34
22,"22202",146,120,120,1,0,"PP-PAR",54
44,"44110",57,45,45,0,0,"PP-PAR",25
22,"22113",512,357,353,8,4,"PP-PAR",171
44,"44154",271,196,195,7,1,"PP-PAR",128
50,"50022",548,430,416,10,14,"PP-PAR",261
44,"44067",132,89,89,0,0,"PP-PAR",40
22,"22223",92,65,64,3,1,"PP-PAR",19
50,"50244",215,155,155,6,0,"PP-PAR",87
50,"50209",2559,1685,1661,34,24,"PP-PAR",872
22,"22068",79,51,51,2,0,"PP-PAR",26
22,"22055",347,291,289,5,2,"PP-PAR",123
44,"44059",571,446,434,10,12,"PP-PAR",265
50,"50054",63,46,46,0,0,"PP-PAR",26
44,"44118",183,129,127,2,2,"PP-PAR",67
50,"50248",552,421,407,5,14,"PP-PAR",184
44,"44249",58,40,40,1,0,"PP-PAR",16
50,"50099",3136,2333,2297,27,36,"PP-PAR",1172
44,"44226",163,112,112,3,0,"PP-PAR",44
44,"44197",60,37,37,1,0,"PP-PAR",25
22,"22048",12485,9146,9028,237,118,"PP-PAR",4529
50,"50264",184,140,134,0,6,"PP-PAR",50
44,"44021",114,81,77,1,4,"PP-PAR",35
22,"22204",1122,773,756,19,17,"PP-PAR",429
44,"44004",450,334,332,2,2,"PP-PAR",185
44,"44210",754,573,567,3,6,"PP-PAR",274
50,"50064",469,377,373,5,4,"PP-PAR",156
50,"50274",78,45,45,1,0,"PP-PAR",23
44,"44144",326,233,227,7,6,"PP-PAR",82
50,"50228",295,238,236,10,2,"PP-PAR",164
44,"44152",62,50,50,3,0,"PP-PAR",39
44,"44039",255,189,189,5,0,"PP-PAR",141
22,"22188",100,68,66,3,2,"PP-PAR",25
22,"22144",258,203,203,5,0,"PP-PAR",107
44,"44061",89,55,55,1,0,"PP-PAR",36
44,"44193",99,71,67,0,4,"PP-PAR",32
50,"50260",42,35,35,1,0,"PP-PAR",23
44,"44077",80,62,62,1,0,"PP-PAR",18
44,"44268",30,25,25,0,0,"PP-PAR",7
44,"44105",82,63,63,2,0,"PP-PAR",36
44,"44167",41,31,31,1,0,"PP-PAR",13
22,"22244",61,46,44,1,2,"PP-PAR",20
50,"50094",1744,1220,1193,25,27,"PP-PAR",662
50,"50135",100,76,75,2,1,"PP-PAR",34
44,"44135",149,110,109,1,1,"PP-PAR",72
50,"50903",2234,1622,1597,35,25,"PP-PAR",735
44,"44145",1078,723,714,26,9,"PP-PAR",365
44,"44023",13,11,11,0,0,"PP-PAR",7
22,"22054",1602,1040,982,42,58,"PP-PAR",425
44,"44048",77,59,59,0,0,"PP-PAR",32
22,"22095",87,61,61,1,0,"PP-PAR",26
50,"50190",751,576,565,7,11,"PP-PAR",241
22,"22025",1104,790,767,27,23,"PP-PAR",419
22,"22174",520,401,394,11,7,"PP-PAR",236
44,"44173",107,87,77,5,10,"PP-PAR",49
44,"44168",194,154,152,4,2,"PP-PAR",107
50,"50210",39,28,24,0,4,"PP-PAR",14
50,"50239",65,44,44,0,0,"PP-PAR",34
44,"44250",20,11,11,1,0,"PP-PAR",6
44,"44060",42,34,34,0,0,"PP-PAR",25
50,"50179",269,230,229,2,1,"PP-PAR",109
50,"50249",333,280,272,2,8,"PP-PAR",204
50,"50086",193,109,109,0,0,"PP-PAR",31
50,"50137",1119,842,834,12,8,"PP-PAR",411
44,"44164",32,25,25,0,0,"PP-PAR",17
50,"50252",5345,3860,3792,79,68,"PP-PAR",2045
22,"22089",329,246,237,8,9,"PP-PAR",148
22,"22014",265,192,191,1,1,"PP-PAR",90
22,"22181",91,57,55,0,2,"PP-PAR",28
44,"44223",80,55,55,0,0,"PP-PAR",32
22,"22155",89,67,67,2,0,"PP-PAR",48
50,"50256",90,59,59,1,0,"PP-PAR",40
44,"44245",274,189,184,1,5,"PP-PAR",128
50,"50014",169,108,108,1,0,"PP-PAR",55
44,"44065",60,40,40,0,0,"PP-PAR",35
44,"44183",78,49,46,0,3,"PP-PAR",19
50,"50048",43,33,33,1,0,"PP-PAR",8
50,"50224",70,52,49,2,3,"PP-PAR",29
50,"50105",343,263,259,2,4,"PP-PAR",137
50,"50115",3280,2234,2205,32,29,"PP-PAR",1140
44,"44160",473,315,312,8,3,"PP-PAR",224
44,"44094",116,105,103,4,2,"PP-PAR",71
22,"22107",131,81,77,1,4,"PP-PAR",43
50,"50050",109,73,73,1,0,"PP-PAR",26
44,"44264",249,196,193,1,3,"PP-PAR",101
22,"22213",3152,2265,2230,62,35,"PP-PAR",1178
22,"22002",107,85,84,3,1,"PP-PAR",34
22,"22149",321,244,241,5,3,"PP-PAR",98
22,"22212",93,79,79,0,0,"PP-PAR",23
50,"50170",411,316,313,2,3,"PP-PAR",141
50,"50194",102,67,67,2,0,"PP-PAR",49
44,"44204",24,21,21,0,0,"PP-PAR",8
22,"22207",135,86,79,4,7,"PP-PAR",44
50,"50102",918,722,713,12,9,"PP-PAR",346
22,"22190",120,76,73,4,3,"PP-PAR",28
44,"44090",84,71,71,0,0,"PP-PAR",53
22,"22069",436,317,315,5,2,"PP-PAR",159
50,"50095",12558,9029,8910,179,119,"PP-PAR",3402
50,"50133",126,101,100,1,1,"PP-PAR",50
44,"44240",168,135,132,2,3,"PP-PAR",68
44,"44262",141,114,113,2,1,"PP-PAR",60
44,"44103",128,95,95,0,0,"PP-PAR",67
44,"44137",215,165,163,5,2,"PP-PAR",112
44,"44206",156,119,117,3,2,"PP-PAR",60
50,"50901",170,122,121,1,1,"PP-PAR",62
50,"50167",235,191,184,1,7,"PP-PAR",112
50,"50100",355,273,266,3,7,"PP-PAR",121
50,"50142",45,25,24,0,1,"PP-PAR",3
22,"22117",2585,1880,1848,57,32,"PP-PAR",985
44,"44143",382,292,292,5,0,"PP-PAR",149
50,"50246",48,33,33,1,0,"PP-PAR",25
44,"44129",44,34,33,0,1,"PP-PAR",19
44,"44025",6168,4326,4150,68,176,"PP-PAR",1681
44,"44066",121,88,86,0,2,"PP-PAR",35
22,"22201",287,203,198,2,5,"PP-PAR",69
44,"44127",79,62,61,0,1,"PP-PAR",29
22,"22058",194,138,137,5,1,"PP-PAR",64
50,"50195",48,38,38,1,0,"PP-PAR",24
50,"50276",148,116,114,3,2,"PP-PAR",54
44,"44201",526,449,443,9,6,"PP-PAR",155
50,"50176",237,161,160,4,1,"PP-PAR",73
44,"44203",8,8,8,0,0,"PP-PAR",6
44,"44062",38,34,34,0,0,"PP-PAR",21
50,"50119",997,740,720,13,20,"PP-PAR",381
50,"50297",495260,360632,355561,7046,5071,"PP-PAR",162977
44,"44199",52,40,39,0,1,"PP-PAR",28
44,"44169",403,285,278,0,7,"PP-PAR",131
50,"50220",59,43,43,1,0,"PP-PAR",18
22,"22040",155,129,127,3,2,"PP-PAR",74
22,"22247",31,21,20,1,1,"PP-PAR",3
50,"50130",415,288,288,7,0,"PP-PAR",163
50,"50020",868,646,629,5,17,"PP-PAR",312
44,"44050",3183,2208,2154,78,54,"PP-PAR",1287
22,"22126",100,81,80,2,1,"PP-PAR",63
50,"50192",240,188,184,9,4,"PP-PAR",91
44,"44020",23,15,15,0,0,"PP-PAR",12
50,"50035",78,61,56,2,5,"PP-PAR",11
50,"50077",254,189,188,4,1,"PP-PAR",85
44,"44165",182,140,140,1,0,"PP-PAR",78
44,"44036",27,17,17,0,0,"PP-PAR",16
22,"22090",115,82,82,5,0,"PP-PAR",34
50,"50219",3704,2672,2625,39,47,"PP-PAR",1275
50,"50204",2519,1823,1804,24,19,"PP-PAR",569
22,"22032",120,78,73,5,5,"PP-PAR",21
50,"50289",71,59,59,0,0,"PP-PAR",36
50,"50273",36,22,22,0,0,"PP-PAR",18
50,"50163",3427,2448,2413,62,35,"PP-PAR",1228
50,"50161",124,86,86,1,0,"PP-PAR",69
50,"50131",243,185,183,6,2,"PP-PAR",107
44,"44246",1591,1030,997,15,33,"PP-PAR",540
44,"44017",316,232,229,1,3,"PP-PAR",116
22,"22162",135,107,107,3,0,"PP-PAR",63
44,"44187",224,170,163,2,7,"PP-PAR",115
44,"44027",168,140,140,2,0,"PP-PAR",65
22,"22039",920,721,710,12,11,"PP-PAR",340
22,"22143",244,166,161,2,5,"PP-PAR",106
44,"44064",93,63,62,0,1,"PP-PAR",40
50,"50198",46,36,36,2,0,"PP-PAR",20
44,"44178",69,45,44,0,1,"PP-PAR",36
50,"50261",246,199,199,4,0,"PP-PAR",53
22,"22015",336,237,235,11,2,"PP-PAR",117
22,"22075",150,103,101,7,2,"PP-PAR",32
22,"22245",329,261,257,3,4,"PP-PAR",177
50,"50009",122,93,93,0,0,"PP-PAR",64
44,"44042",139,87,87,0,0,"PP-PAR",49
50,"50199",380,263,254,2,9,"PP-PAR",119
44,"44124",88,63,61,3,2,"PP-PAR",23
50,"50188",34,28,27,0,1,"PP-PAR",20
50,"50126",2473,1747,1724,41,23,"PP-PAR",1045
50,"50038",1583,1194,1174,29,20,"PP-PAR",506
44,"44068",690,544,528,6,16,"PP-PAR",297
22,"22905",312,249,247,4,2,"PP-PAR",155
50,"50113",653,528,526,9,2,"PP-PAR",210
22,"22136",908,671,662,11,9,"PP-PAR",329
22,"22242",75,53,52,0,1,"PP-PAR",41
44,"44266",134,107,105,2,2,"PP-PAR",80
22,"22049",88,70,69,5,1,"PP-PAR",47
50,"50197",89,65,65,3,0,"PP-PAR",40
44,"44054",125,97,97,2,0,"PP-PAR",60
44,"44049",886,652,627,6,25,"PP-PAR",318
22,"22235",101,88,87,1,1,"PP-PAR",53
22,"22130",9983,6691,6573,148,118,"PP-PAR",2985
50,"50213",117,83,82,0,1,"PP-PAR",66
50,"50110",424,315,314,6,1,"PP-PAR",155
44,"44158",1159,904,873,15,31,"PP-PAR",424
50,"50229",62,47,46,2,1,"PP-PAR",18
50,"50082",108,73,72,0,1,"PP-PAR",43
44,"44180",71,52,52,1,0,"PP-PAR",33
44,"44146",185,160,159,8,1,"PP-PAR",75
50,"50069",68,32,32,0,0,"PP-PAR",11
44,"44003",19,19,19,0,0,"PP-PAR",13
44,"44212",45,35,35,0,0,"PP-PAR",23
44,"44217",37,28,27,0,1,"PP-PAR",13
22,"22050",100,84,83,0,1,"PP-PAR",46
50,"50270",39,30,29,1,1,"PP-PAR",16
22,"22052",997,776,769,15,7,"PP-PAR",319
50,"50174",107,92,90,0,2,"PP-PAR",65
50,"50043",258,170,166,2,4,"PP-PAR",90
44,"44007",194,152,145,3,7,"PP-PAR",104
50,"50283",73,55,55,1,0,"PP-PAR",39
44,"44225",129,100,98,5,2,"PP-PAR",46
22,"22221",108,70,69,5,1,"PP-PAR",24
50,"50044",259,175,175,0,0,"PP-PAR",69
22,"22131",96,79,77,2,2,"PP-PAR",36
22,"22103",697,532,523,10,9,"PP-PAR",202
22,"22254",1175,868,856,14,12,"PP-PAR",416
44,"44106",173,132,131,8,1,"PP-PAR",49
44,"44185",117,91,90,0,1,"PP-PAR",65
50,"50071",134,97,96,0,1,"PP-PAR",81
22,"22081",268,197,196,4,1,"PP-PAR",126
22,"22239",90,76,76,2,0,"PP-PAR",51
50,"50172",187,140,138,4,2,"PP-PAR",89
6,"6107",1610,1131,1128,6,3,"P.P-E.U.",419
6,"6123",4699,3509,3448,54,61,"P.P-E.U.",1495
6,"6067",2030,1583,1572,16,11,"P.P-E.U.",788
6,"6078",548,457,453,2,4,"P.P-E.U.",291
6,"6036",5228,4075,4028,22,47,"P.P-E.U.",1918
6,"6022",2719,2274,2245,14,29,"P.P-E.U.",1032
6,"6017",292,250,250,0,0,"P.P-E.U.",173
6,"6018",808,608,598,5,10,"P.P-E.U.",209
6,"6102",1045,851,840,7,11,"P.P-E.U.",404
6,"6154",2830,2108,2080,38,28,"P.P-E.U.",1016
6,"6143",3308,2625,2595,24,30,"P.P-E.U.",1005
6,"6108",2355,1773,1746,24,27,"P.P-E.U.",801
6,"6016",3013,2363,2306,31,57,"P.P-E.U.",968
6,"6063",3079,2467,2454,16,13,"P.P-E.U.",1097
6,"6092",592,468,456,5,12,"P.P-E.U.",207
6,"6041",459,406,404,4,2,"P.P-E.U.",185
6,"6061",1116,1000,989,8,11,"P.P-E.U.",429
6,"6030",171,132,131,0,1,"P.P-E.U.",67
6,"6139",600,489,481,5,8,"P.P-E.U.",199
6,"6011",24301,17977,17819,268,158,"P.P-E.U.",10451
6,"6128",4466,3310,3264,50,46,"P.P-E.U.",1606
6,"6062",638,493,492,3,1,"P.P-E.U.",273
6,"6096",254,202,201,0,1,"P.P-E.U.",137
6,"6047",878,686,680,5,6,"P.P-E.U.",313
6,"6142",284,240,235,4,5,"P.P-E.U.",85
6,"6033",1387,1075,1068,6,7,"P.P-E.U.",563
6,"6152",1327,983,967,8,16,"P.P-E.U.",421
6,"6060",5865,4657,4592,67,65,"P.P-E.U.",2045
6,"6025",5083,3898,3851,51,47,"P.P-E.U.",1838
6,"6052",3965,3176,3134,33,42,"P.P-E.U.",1835
6,"6037",1789,1258,1252,6,6,"P.P-E.U.",712
6,"6162",2964,2415,2390,19,25,"P.P-E.U.",1180
6,"6051",1606,1314,1302,10,12,"P.P-E.U.",697
6,"6118",228,181,181,1,0,"P.P-E.U.",68
6,"6091",3854,2961,2906,33,55,"P.P-E.U.",1549
6,"6010",1144,903,898,6,5,"P.P-E.U.",329
6,"6077",373,307,304,4,3,"P.P-E.U.",93
6,"6048",879,758,740,4,18,"P.P-E.U.",297
6,"6045",513,418,412,8,6,"P.P-E.U.",190
6,"6117",1471,1155,1130,8,25,"P.P-E.U.",624
6,"6097",2475,1934,1902,27,32,"P.P-E.U.",903
6,"6073",787,563,552,9,11,"P.P-E.U.",161
6,"6113",2750,2143,2105,26,38,"P.P-E.U.",924
6,"6138",1070,838,829,13,9,"P.P-E.U.",326
6,"6032",76,59,59,1,0,"P.P-E.U.",40
6,"6082",373,315,311,3,4,"P.P-E.U.",133
6,"6122",6620,4904,4797,44,107,"P.P-E.U.",2531
6,"6031",490,387,385,8,2,"P.P-E.U.",215
6,"6009",214,178,178,2,0,"P.P-E.U.",93
6,"6150",860,722,710,2,12,"P.P-E.U.",238
6,"6015",116077,82756,81836,989,920,"P.P-E.U.",48546
6,"6042",1017,824,820,5,4,"P.P-E.U.",290
6,"6144",588,476,464,2,12,"P.P-E.U.",157
6,"6147",390,321,319,3,2,"P.P-E.U.",104
6,"6038",816,621,620,6,1,"P.P-E.U.",286
6,"6021",971,761,747,6,14,"P.P-E.U.",458
6,"6124",1750,1418,1378,17,40,"P.P-E.U.",581
6,"6093",4599,3658,3612,22,46,"P.P-E.U.",1758
6,"6026",865,671,665,4,6,"P.P-E.U.",373
6,"6001",730,546,538,4,8,"P.P-E.U.",298
6,"6024",1215,1015,1006,4,9,"P.P-E.U.",466
6,"6081",1114,870,865,10,5,"P.P-E.U.",317
6,"6053",642,466,454,4,12,"P.P-E.U.",135
6,"6085",3437,2566,2530,32,36,"P.P-E.U.",1002
6,"6137",1035,848,842,2,6,"P.P-E.U.",384
6,"6046",1288,1050,1042,11,8,"P.P-E.U.",544
6,"6072",2370,1907,1885,9,22,"P.P-E.U.",968
6,"6005",1699,1332,1320,19,12,"P.P-E.U.",474
6,"6050",4277,3500,3457,36,43,"P.P-E.U.",1869
6,"6153",20332,15398,15216,239,182,"P.P-E.U.",7942
6,"6158",13094,9945,9753,131,192,"P.P-E.U.",4899
6,"6002",4321,3272,3195,32,77,"P.P-E.U.",1700
6,"6101",489,397,395,5,2,"P.P-E.U.",237
6,"6106",447,335,333,7,2,"P.P-E.U.",150
6,"6160",3190,2343,2314,12,29,"P.P-E.U.",1246
6,"6039",1848,1564,1546,13,18,"P.P-E.U.",554
6,"6084",1105,932,917,5,15,"P.P-E.U.",533
6,"6027",732,655,645,8,10,"P.P-E.U.",358
6,"6088",12879,9362,9222,153,140,"P.P-E.U.",4669
6,"6136",1621,1300,1283,11,17,"P.P-E.U.",500
6,"6057",575,481,474,2,7,"P.P-E.U.",247
6,"6111",502,389,387,8,2,"P.P-E.U.",148
6,"6076",854,639,631,9,8,"P.P-E.U.",248
6,"6129",631,493,490,2,3,"P.P-E.U.",205
6,"6055",2105,1623,1599,13,24,"P.P-E.U.",874
6,"6145",929,746,743,5,3,"P.P-E.U.",364
6,"6114",152,122,122,0,0,"P.P-E.U.",33
6,"6080",1942,1519,1507,9,12,"P.P-E.U.",692
6,"6099",1127,815,805,6,10,"P.P-E.U.",304
6,"6069",3116,2316,2288,46,28,"P.P-E.U.",936
6,"6090",904,724,710,10,14,"P.P-E.U.",333
6,"6105",655,450,448,1,2,"P.P-E.U.",233
6,"6012",3263,2498,2476,31,22,"P.P-E.U.",1140
6,"6020",1852,1476,1462,5,14,"P.P-E.U.",686
6,"6007",1557,1200,1189,4,11,"P.P-E.U.",386
6,"6066",1798,1348,1340,7,8,"P.P-E.U.",495
6,"6134",561,399,398,5,1,"P.P-E.U.",160
6,"6006",4664,3435,3367,50,68,"P.P-E.U.",1280
6,"6115",1261,893,885,7,8,"P.P-E.U.",415
6,"6043",661,542,532,3,10,"P.P-E.U.",266
6,"6127",2922,2306,2279,27,27,"P.P-E.U.",1153
6,"6131",1037,871,865,8,6,"P.P-E.U.",194
6,"6161",335,261,259,2,2,"P.P-E.U.",124
6,"6075",517,433,429,3,4,"P.P-E.U.",155
6,"6040",1032,807,807,11,0,"P.P-E.U.",330
6,"6008",636,561,552,6,9,"P.P-E.U.",233
6,"6133",1744,1343,1328,22,15,"P.P-E.U.",649
6,"6071",257,236,230,1,6,"P.P-E.U.",98
6,"6156",1190,989,978,9,11,"P.P-E.U.",482
6,"6056",487,411,411,1,0,"P.P-E.U.",191
6,"6120",3508,2772,2741,31,31,"P.P-E.U.",1289
6,"6029",1230,884,880,5,4,"P.P-E.U.",293
6,"6035",1048,879,871,5,8,"P.P-E.U.",483
6,"6065",327,262,259,2,3,"P.P-E.U.",181
6,"6054",5468,4305,4185,35,120,"P.P-E.U.",2038
6,"6059",1959,1476,1466,8,10,"P.P-E.U.",686
6,"6121",3436,2700,2662,35,38,"P.P-E.U.",1328
6,"6070",7805,6083,6001,76,82,"P.P-E.U.",2735
6,"6159",2341,1522,1510,8,12,"P.P-E.U.",532
6,"6119",680,539,534,3,5,"P.P-E.U.",280
6,"6098",537,436,435,6,1,"P.P-E.U.",219
6,"6112",411,330,326,0,4,"P.P-E.U.",173
6,"6157",497,350,343,0,7,"P.P-E.U.",194
6,"6902",1688,1325,1313,21,12,"P.P-E.U.",559
6,"6149",10390,8354,8215,111,139,"P.P-E.U.",3893
6,"6104",701,588,584,12,4,"P.P-E.U.",204
6,"6135",1094,898,890,14,8,"P.P-E.U.",548
6,"6086",1270,956,949,2,7,"P.P-E.U.",478
6,"6151",1109,850,846,6,4,"P.P-E.U.",288
6,"6146",1188,951,936,8,15,"P.P-E.U.",329
6,"6100",1000,828,821,3,7,"P.P-E.U.",469
6,"6148",991,826,818,9,8,"P.P-E.U.",284
6,"6068",481,383,378,3,5,"P.P-E.U.",152
6,"6901",2113,1729,1706,26,23,"P.P-E.U.",924
6,"6132",876,656,648,2,8,"P.P-E.U.",203
6,"6028",4366,3881,3809,35,72,"P.P-E.U.",1859
6,"6095",9330,6974,6873,129,101,"P.P-E.U.",2906
6,"6083",45013,31929,31491,527,438,"P.P-E.U.",15898
6,"6103",4777,3702,3671,31,31,"P.P-E.U.",1903
6,"6014",6843,4894,4839,30,55,"P.P-E.U.",3018
6,"6013",283,245,244,1,1,"P.P-E.U.",64
6,"6023",4572,3301,3261,34,40,"P.P-E.U.",1416
6,"6049",1088,847,829,3,18,"P.P-E.U.",413
6,"6116",1680,1331,1317,15,14,"P.P-E.U.",614
6,"6019",2111,1621,1596,24,25,"P.P-E.U.",641
6,"6044",28321,21143,20931,232,212,"P.P-E.U.",11282
6,"6094",1508,1130,1119,6,11,"P.P-E.U.",399
6,"6003",875,705,691,4,14,"P.P-E.U.",290
6,"6058",2048,1595,1574,22,21,"P.P-E.U.",680
6,"6125",1852,1419,1399,11,20,"P.P-E.U.",695
6,"6126",2199,1706,1686,14,20,"P.P-E.U.",644
6,"6089",607,530,529,2,1,"P.P-E.U.",223
6,"6087",2258,1855,1832,24,23,"P.P-E.U.",930
6,"6034",190,134,129,3,5,"P.P-E.U.",76
6,"6141",1803,1419,1397,23,22,"P.P-E.U.",600
6,"6064",900,715,706,2,9,"P.P-E.U.",224
6,"6079",623,525,522,6,3,"P.P-E.U.",217
6,"6155",1911,1384,1363,18,21,"P.P-E.U.",541
6,"6074",4777,3730,3659,41,71,"P.P-E.U.",1634
6,"6110",176,130,124,0,6,"P.P-E.U.",49
6,"6130",216,182,180,0,2,"P.P-E.U.",82
6,"6140",654,533,523,7,10,"P.P-E.U.",352
6,"6004",1607,1317,1309,10,8,"P.P-E.U.",584
6,"6109",4006,3435,3372,21,63,"P.P-E.U.",1473
10,"10105",2599,1869,1835,25,34,"PP-EU",989
10,"10178",797,604,597,5,7,"PP-EU",338
10,"10088",244,168,168,0,0,"PP-EU",124
10,"10159",341,278,277,1,1,"PP-EU",128
10,"10194",557,449,440,0,9,"PP-EU",243
10,"10095",346,290,283,3,7,"PP-EU",135
10,"10169",587,460,450,2,10,"PP-EU",248
10,"10067",10392,7979,7804,111,175,"PP-EU",4203
10,"10181",739,607,598,6,9,"PP-EU",254
10,"10108",231,152,152,0,0,"PP-EU",98
10,"10087",1754,1283,1262,4,21,"PP-EU",650
10,"10063",175,142,142,1,0,"PP-EU",80
10,"10104",5233,3904,3824,30,80,"PP-EU",2065
10,"10031",189,158,158,1,0,"PP-EU",98
10,"10046",216,185,184,1,1,"PP-EU",81
10,"10176",384,300,293,5,7,"PP-EU",115
10,"10044",1520,1120,1103,10,17,"PP-EU",384
10,"10098",412,317,313,5,4,"PP-EU",155
10,"10009",285,223,221,0,2,"PP-EU",156
10,"10145",132,112,111,0,1,"PP-EU",65
10,"10022",442,377,370,1,7,"PP-EU",179
10,"10217",535,423,422,3,1,"PP-EU",238
10,"10103",480,385,380,3,5,"PP-EU",180
10,"10158",367,307,306,3,1,"PP-EU",94
10,"10122",253,197,191,2,6,"PP-EU",89
10,"10016",321,266,262,2,4,"PP-EU",100
10,"10185",587,457,450,1,7,"PP-EU",235
10,"10097",109,97,96,0,1,"PP-EU",62
10,"10163",374,310,308,0,2,"PP-EU",194
10,"10168",318,240,238,1,2,"PP-EU",125
10,"10081",183,143,142,0,1,"PP-EU",88
10,"10126",1660,1221,1201,9,20,"PP-EU",612
10,"10136",289,229,228,0,1,"PP-EU",105
10,"10131",12797,9017,8922,131,95,"PP-EU",5262
10,"10058",994,751,738,13,13,"PP-EU",351
10,"10211",461,341,334,3,7,"PP-EU",171
10,"10089",1399,1043,1032,15,11,"PP-EU",413
10,"10143",169,135,131,1,4,"PP-EU",65
10,"10193",1410,1179,1158,16,21,"PP-EU",734
10,"10179",340,262,257,3,5,"PP-EU",140
10,"10077",719,551,543,3,8,"PP-EU",260
10,"10177",1692,1351,1318,15,33,"PP-EU",644
10,"10070",765,614,613,5,1,"PP-EU",340
10,"10162",616,505,496,1,9,"PP-EU",214
10,"10180",5446,3957,3917,28,40,"PP-EU",2260
10,"10149",434,323,319,1,4,"PP-EU",175
10,"10135",1366,1004,998,3,6,"PP-EU",511
10,"10072",892,663,655,3,8,"PP-EU",238
10,"10216",1549,1247,1235,15,12,"PP-EU",649
10,"10008",1393,1105,1086,10,19,"PP-EU",584
10,"10113",2440,1891,1859,11,32,"PP-EU",845
10,"10091",391,327,324,3,3,"PP-EU",169
10,"10112",1582,1299,1284,5,15,"PP-EU",733
10,"10138",551,451,443,7,8,"PP-EU",143
10,"10056",605,484,476,5,8,"PP-EU",216
10,"10144",999,782,773,7,9,"PP-EU",427
10,"10127",4663,3554,3498,38,56,"PP-EU",1798
10,"10005",551,439,424,4,15,"PP-EU",228
10,"10203",4770,3397,3327,40,70,"PP-EU",1932
10,"10120",168,122,119,1,3,"PP-EU",54
10,"10212",1688,1276,1242,16,34,"PP-EU",527
10,"10146",1439,991,975,11,16,"PP-EU",447
10,"10171",376,287,282,0,5,"PP-EU",131
10,"10076",825,619,610,7,9,"PP-EU",329
10,"10007",680,537,519,5,18,"PP-EU",322
10,"10093",413,339,332,2,7,"PP-EU",113
10,"10035",1941,1517,1492,15,25,"PP-EU",529
10,"10062",421,332,325,3,7,"PP-EU",88
10,"10205",2081,1486,1457,19,29,"PP-EU",601
10,"10019",1414,1054,1037,10,17,"PP-EU",612
10,"10003",616,463,458,3,5,"PP-EU",290
10,"10013",305,242,237,1,5,"PP-EU",147
10,"10148",32554,23348,22955,365,393,"PP-EU",12279
10,"10082",1947,1601,1572,10,29,"PP-EU",763
10,"10202",665,533,523,7,10,"PP-EU",248
10,"10175",1509,1149,1127,4,22,"PP-EU",621
10,"10037",74974,56844,55950,898,894,"PP-EU",31918
10,"10198",1213,1068,1054,12,14,"PP-EU",676
10,"10036",345,262,251,2,11,"PP-EU",103
10,"10151",245,204,202,2,2,"PP-EU",111
10,"10111",1453,1052,1046,13,6,"PP-EU",588
10,"10191",527,421,414,3,7,"PP-EU",241
10,"10014",1907,1507,1488,14,19,"PP-EU",786
10,"10209",297,217,213,3,4,"PP-EU",87
10,"10114",926,670,652,8,18,"PP-EU",209
10,"10147",1263,1003,965,5,38,"PP-EU",389
10,"10119",714,489,482,3,7,"PP-EU",213
10,"10155",1156,829,819,4,10,"PP-EU",419
10,"10051",489,373,373,2,0,"PP-EU",203
10,"10080",385,294,287,0,7,"PP-EU",153
10,"10092",316,263,262,1,1,"PP-EU",117
10,"10133",1247,1045,1028,7,17,"PP-EU",256
10,"10090",552,404,396,3,8,"PP-EU",197
10,"10182",146,112,108,0,4,"PP-EU",60
10,"10134",585,420,412,1,8,"PP-EU",270
10,"10903",813,620,615,3,5,"PP-EU",263
10,"10902",727,608,599,5,9,"PP-EU",321
10,"10040",455,344,334,8,10,"PP-EU",151
10,"10207",499,394,392,1,2,"PP-EU",199
10,"10130",1745,1360,1341,10,19,"PP-EU",510
10,"10106",144,123,123,4,0,"PP-EU",59
10,"10200",499,368,368,0,0,"PP-EU",214
10,"10157",289,218,212,1,6,"PP-EU",123
10,"10065",188,123,123,1,0,"PP-EU",45
10,"10047",978,795,780,9,15,"PP-EU",267
10,"10195",7917,6143,6054,36,89,"PP-EU",3826
10,"10184",771,609,597,7,12,"PP-EU",297
10,"10172",728,531,522,3,9,"PP-EU",277
10,"10154",194,150,145,0,5,"PP-EU",78
10,"10029",447,362,355,1,7,"PP-EU",138
10,"10101",172,134,129,1,5,"PP-EU",63
10,"10032",1768,1438,1415,9,23,"PP-EU",701
10,"10161",76,59,59,1,0,"PP-EU",40
10,"10121",8063,6048,5988,51,60,"PP-EU",3167
10,"10049",3952,3348,3259,36,89,"PP-EU",1599
10,"10115",3622,2872,2800,52,72,"PP-EU",1541
10,"10024",663,490,480,3,10,"PP-EU",277
10,"10117",264,174,174,2,0,"PP-EU",71
10,"10132",420,293,287,1,6,"PP-EU",128
10,"10023",854,688,682,9,6,"PP-EU",268
10,"10170",269,217,215,4,2,"PP-EU",130
10,"10057",166,133,133,0,0,"PP-EU",45
10,"10150",374,331,328,2,3,"PP-EU",99
10,"10027",88,78,78,0,0,"PP-EU",21
10,"10004",733,576,565,6,11,"PP-EU",287
10,"10053",303,253,246,5,7,"PP-EU",144
10,"10128",5805,4456,4336,50,120,"PP-EU",2179
10,"10073",759,589,583,3,6,"PP-EU",303
10,"10160",235,183,183,1,0,"PP-EU",59
10,"10102",534,447,440,4,7,"PP-EU",220
10,"10173",557,436,431,6,5,"PP-EU",227
10,"10020",1671,1386,1374,14,12,"PP-EU",564
10,"10210",599,453,452,3,1,"PP-EU",229
10,"10197",143,96,94,1,2,"PP-EU",59
10,"10164",770,557,547,2,10,"PP-EU",241
10,"10086",342,259,250,5,9,"PP-EU",162
10,"10028",125,88,88,0,0,"PP-EU",47
10,"10078",451,349,341,3,8,"PP-EU",147
10,"10018",1761,1321,1296,17,25,"PP-EU",475
10,"10069",858,680,673,2,7,"PP-EU",328
10,"10061",1765,1305,1290,13,15,"PP-EU",513
10,"10043",866,636,622,1,14,"PP-EU",229
10,"10048",299,232,231,0,1,"PP-EU",180
10,"10006",1306,1081,1070,7,11,"PP-EU",526
10,"10050",1208,1003,983,8,20,"PP-EU",572
10,"10010",2358,1597,1576,18,21,"PP-EU",708
10,"10186",1031,906,896,8,10,"PP-EU",445
10,"10152",499,424,418,4,6,"PP-EU",208
10,"10041",1070,850,846,8,4,"PP-EU",442
10,"10166",351,246,238,2,8,"PP-EU",144
10,"10015",688,539,523,5,16,"PP-EU",267
10,"10167",322,265,264,1,1,"PP-EU",131
10,"10125",925,705,689,3,16,"PP-EU",342
10,"10165",274,231,229,0,2,"PP-EU",138
10,"10199",181,142,140,1,2,"PP-EU",71
10,"10033",440,340,336,4,4,"PP-EU",190
10,"10064",1549,1229,1209,6,20,"PP-EU",617
10,"10187",486,349,345,2,4,"PP-EU",136
10,"10183",1022,818,805,5,13,"PP-EU",381
10,"10196",309,244,244,1,0,"PP-EU",127
10,"10123",601,502,492,0,10,"PP-EU",207
10,"10085",334,244,243,1,1,"PP-EU",146
10,"10192",910,679,670,3,9,"PP-EU",352
10,"10110",2326,1751,1703,11,48,"PP-EU",999
10,"10059",414,352,349,4,3,"PP-EU",164
10,"10201",202,173,171,3,2,"PP-EU",76
10,"10208",141,118,118,1,0,"PP-EU",36
10,"10174",177,145,145,2,0,"PP-EU",82
10,"10038",98,84,83,0,1,"PP-EU",59
10,"10060",1037,758,742,9,16,"PP-EU",356
10,"10124",873,707,707,16,0,"PP-EU",267
10,"10083",105,74,74,0,0,"PP-EU",48
10,"10137",428,373,371,1,2,"PP-EU",166
10,"10001",270,231,229,2,2,"PP-EU",89
10,"10188",553,473,468,2,5,"PP-EU",189
10,"10034",376,283,278,5,5,"PP-EU",123
10,"10066",182,136,133,1,3,"PP-EU",68
10,"10084",1416,994,972,12,22,"PP-EU",488
10,"10026",598,458,447,5,11,"PP-EU",189
10,"10214",226,178,176,2,2,"PP-EU",118
10,"10116",3762,2781,2705,36,76,"PP-EU",1200
10,"10100",792,554,538,1,16,"PP-EU",200
10,"10118",306,262,261,2,1,"PP-EU",105
10,"10096",3384,2581,2533,32,48,"PP-EU",1061
10,"10129",374,279,276,2,3,"PP-EU",126
10,"10068",780,624,595,5,29,"PP-EU",293
10,"10140",1143,941,927,9,14,"PP-EU",577
10,"10213",605,478,477,1,1,"PP-EU",263
10,"10055",709,523,508,13,15,"PP-EU",297
10,"10042",79,63,62,2,1,"PP-EU",22
10,"10075",276,189,189,1,0,"PP-EU",104
10,"10153",331,266,263,1,3,"PP-EU",158
10,"10039",448,352,350,0,2,"PP-EU",193
10,"10141",289,209,209,0,0,"PP-EU",126
10,"10156",116,91,91,0,0,"PP-EU",29
10,"10079",891,711,706,6,5,"PP-EU",454
10,"10045",1119,884,859,5,25,"PP-EU",350
10,"10109",1834,1307,1287,18,20,"PP-EU",715
10,"10011",611,527,519,5,8,"PP-EU",180
10,"10206",237,177,174,0,3,"PP-EU",81
10,"10054",551,435,428,6,7,"PP-EU",205
10,"10030",502,364,362,5,2,"PP-EU",179
10,"10071",179,133,133,1,0,"PP-EU",63
10,"10017",884,681,673,6,8,"PP-EU",369
10,"10190",569,438,435,6,3,"PP-EU",234
10,"10052",186,138,138,0,0,"PP-EU",110
10,"10204",489,364,351,3,13,"PP-EU",196
10,"10107",1062,832,821,7,11,"PP-EU",325
10,"10002",396,317,314,5,3,"PP-EU",135
10,"10021",5421,4189,4099,47,90,"PP-EU",1622
10,"10099",633,458,450,4,8,"PP-EU",222
10,"10901",1148,844,839,18,5,"PP-EU",435
10,"10142",822,635,625,4,10,"PP-EU",237
10,"10215",437,338,333,3,5,"PP-EU",148
10,"10219",1408,984,971,11,13,"PP-EU",458
10,"10012",615,525,520,4,5,"PP-EU",214
10,"10218",1184,896,893,0,3,"PP-EU",355
10,"10094",247,212,211,0,1,"PP-EU",57
10,"10025",408,355,337,4,18,"PP-EU",146
10,"10139",117,98,97,1,1,"PP-EU",58
10,"10189",2728,2108,2063,24,45,"PP-EU",974
39,"39038",1465,1065,1047,8,18,"P.R.C.",139
39,"39012",6666,5148,5061,43,87,"P.R.C.",755
39,"39089",163,126,126,0,0,"P.R.C.",28
39,"39099",2987,2416,2391,28,25,"P.R.C.",296
39,"39048",1616,1326,1308,8,18,"P.R.C.",155
39,"39005",1319,1048,1026,3,22,"P.R.C.",92
39,"39043",1321,1082,1072,8,10,"P.R.C.",158
39,"39064",1339,1072,1066,7,6,"P.R.C.",226
39,"39090",731,577,572,3,5,"P.R.C.",138
39,"39069",1957,1595,1570,18,25,"P.R.C.",500
39,"39072",375,234,234,4,0,"P.R.C.",75
39,"39098",1522,1256,1244,8,12,"P.R.C.",360
39,"39014",943,706,700,9,6,"P.R.C.",136
39,"39081",440,372,369,3,3,"P.R.C.",44
39,"39091",2026,1636,1628,14,8,"P.R.C.",259
39,"39044",3864,2940,2905,44,35,"P.R.C.",357
39,"39101",328,251,247,5,4,"P.R.C.",144
39,"39020",23947,15404,15122,267,282,"P.R.C.",920
39,"39032",1576,1215,1209,10,6,"P.R.C.",180
39,"39029",642,521,517,6,4,"P.R.C.",108
39,"39007",479,348,347,3,1,"P.R.C.",108
39,"39017",588,424,419,2,5,"P.R.C.",107
39,"39046",1442,1071,1050,13,21,"P.R.C.",219
39,"39086",386,282,280,1,2,"P.R.C.",33
39,"39093",351,260,253,2,7,"P.R.C.",29
39,"39003",321,265,261,0,4,"P.R.C.",52
39,"39055",1130,881,869,10,12,"P.R.C.",61
39,"39001",2146,1669,1645,20,24,"P.R.C.",282
39,"39013",561,413,412,2,1,"P.R.C.",49
39,"39073",9275,6984,6903,83,81,"P.R.C.",615
39,"39049",339,244,242,5,2,"P.R.C.",27
39,"39004",1593,1321,1305,9,16,"P.R.C.",281
39,"39102",2330,1748,1731,13,17,"P.R.C.",215
39,"39063",1018,769,762,6,7,"P.R.C.",156
39,"39008",13716,10396,10274,129,122,"P.R.C.",1148
39,"39011",1646,1295,1294,5,1,"P.R.C.",308
39,"39059",8476,6365,6284,73,81,"P.R.C.",1104
39,"39053",251,179,179,1,0,"P.R.C.",72
39,"39006",1732,1381,1373,23,8,"P.R.C.",176
39,"39095",2292,1824,1801,24,23,"P.R.C.",187
39,"39092",1030,753,747,1,6,"P.R.C.",95
39,"39047",1987,1495,1482,9,13,"P.R.C.",359
39,"39042",5928,4680,4634,44,46,"P.R.C.",585
39,"39082",1688,1280,1266,9,14,"P.R.C.",222
39,"39056",2387,1857,1835,22,22,"P.R.C.",332
39,"39067",901,628,623,1,5,"P.R.C.",178
39,"39040",4350,3413,3373,30,40,"P.R.C.",434
39,"39070",152,118,118,0,0,"P.R.C.",28
39,"39027",3213,2506,2473,21,33,"P.R.C.",412
39,"39057",2298,1735,1719,17,16,"P.R.C.",213
39,"39078",1407,1041,1033,10,8,"P.R.C.",296
39,"39079",9035,6959,6897,55,62,"P.R.C.",657
39,"39015",898,692,688,7,4,"P.R.C.",123
39,"39033",604,480,473,3,7,"P.R.C.",163
39,"39021",536,448,444,1,4,"P.R.C.",39
39,"39066",895,710,703,6,7,"P.R.C.",100
39,"39025",8985,7048,6955,70,93,"P.R.C.",1040
39,"39022",985,735,734,5,1,"P.R.C.",68
39,"39039",648,496,493,0,3,"P.R.C.",116
39,"39058",862,586,584,6,2,"P.R.C.",90
39,"39052",17031,13198,13034,187,164,"P.R.C.",1339
39,"39023",6048,4795,4747,43,48,"P.R.C.",767
39,"39085",6722,5198,5134,60,64,"P.R.C.",706
39,"39034",289,209,209,3,0,"P.R.C.",30
39,"39087",43561,33709,33242,404,467,"P.R.C.",4836
39,"39009",3200,2427,2402,24,25,"P.R.C.",376
39,"39061",3458,2673,2644,42,29,"P.R.C.",360
39,"39031",1227,965,956,4,9,"P.R.C.",156
39,"39054",4265,3338,3276,57,62,"P.R.C.",489
39,"39074",6785,5287,5233,50,54,"P.R.C.",717
39,"39016",24213,18549,18362,265,187,"P.R.C.",2041
39,"39100",922,718,712,8,6,"P.R.C.",110
39,"39075",140941,103308,102362,1364,946,"P.R.C.",8718
39,"39096",719,521,518,4,3,"P.R.C.",71
39,"39077",256,196,196,1,0,"P.R.C.",35
39,"39060",6723,5453,5360,56,93,"P.R.C.",904
39,"39041",1775,1432,1414,15,18,"P.R.C.",203
39,"39050",305,207,205,1,2,"P.R.C.",27
39,"39062",1759,1397,1387,9,10,"P.R.C.",152
39,"39036",1023,802,790,5,12,"P.R.C.",97
39,"39071",463,358,358,2,0,"P.R.C.",140
39,"39097",732,476,470,4,6,"P.R.C.",110
39,"39094",927,702,691,0,11,"P.R.C.",201
39,"39065",272,199,197,2,2,"P.R.C.",37
39,"39076",3388,2673,2641,22,32,"P.R.C.",369
39,"39083",1214,785,775,7,10,"P.R.C.",228
39,"39051",73,62,62,2,0,"P.R.C.",14
39,"39084",873,647,642,4,5,"P.R.C.",86
39,"39018",4077,3212,3160,44,52,"P.R.C.",477
39,"39024",2065,1616,1601,8,15,"P.R.C.",414
39,"39037",2061,1609,1586,10,23,"P.R.C.",232
39,"39035",10031,7685,7601,74,84,"P.R.C.",1313
39,"39002",3400,2554,2514,35,40,"P.R.C.",341
39,"39026",1825,1383,1371,12,12,"P.R.C.",262
39,"39019",2009,1556,1536,10,20,"P.R.C.",266
39,"39010",688,533,524,6,9,"P.R.C.",79
39,"39045",410,324,323,5,1,"P.R.C.",51
39,"39030",1971,1397,1379,20,18,"P.R.C.",383
39,"39028",3513,2760,2718,23,42,"P.R.C.",390
39,"39088",70,61,61,1,0,"P.R.C.",11
39,"39068",663,488,485,4,3,"P.R.C.",136
39,"39080",3627,2743,2693,19,50,"P.R.C.",380
37,"37316",792,565,559,7,6,"PREPAL",0
49,"49168",96,78,78,1,0,"PREPAL",0
24,"24058",224,166,163,1,3,"PREPAL",0
49,"49094",276,180,180,2,0,"PREPAL",0
49,"49219",7742,5643,5562,87,81,"PREPAL",18
37,"37134",250,192,189,1,3,"PREPAL",1
24,"24230",450,333,327,4,6,"PREPAL",1
49,"49202",221,158,157,2,1,"PREPAL",0
24,"24060",660,382,382,0,0,"PREPAL",4
37,"37348",114,91,90,1,1,"PREPAL",0
37,"37147",201,153,151,1,2,"PREPAL",0
37,"37199",157,115,113,0,2,"PREPAL",0
37,"37380",57,45,44,1,1,"PREPAL",0
49,"49272",102,87,86,0,1,"PREPAL",0
37,"37229",144,108,108,0,0,"PREPAL",0
49,"49017",264,189,187,1,2,"PREPAL",0
37,"37122",210,175,174,3,1,"PREPAL",0
37,"37378",118,85,85,3,0,"PREPAL",0
49,"49100",322,236,233,1,3,"PREPAL",0
49,"49048",162,119,119,2,0,"PREPAL",0
37,"37189",139,90,90,1,0,"PREPAL",1
37,"37284",334,256,254,1,2,"PREPAL",0
24,"24193",371,254,252,3,2,"PREPAL",1
49,"49268",480,365,362,8,3,"PREPAL",3
24,"24021",1791,1251,1228,14,23,"PREPAL",4
49,"49086",127,108,107,1,1,"PREPAL",2
37,"37137",114,87,87,3,0,"PREPAL",0
49,"49098",242,177,175,4,2,"PREPAL",0
37,"37024",101,80,80,0,0,"PREPAL",0
37,"37167",164,140,132,6,8,"PREPAL",0
49,"49194",380,250,247,4,3,"PREPAL",0
24,"24034",3434,2524,2481,37,43,"PREPAL",0
49,"49096",188,149,146,2,3,"PREPAL",1
49,"49103",435,354,350,6,4,"PREPAL",0
37,"37135",1234,972,961,8,11,"PREPAL",1
24,"24117",493,376,369,2,7,"PREPAL",0
24,"24137",1226,920,904,16,16,"PREPAL",6
24,"24100",760,563,553,14,10,"PREPAL",0
49,"49206",948,706,692,15,14,"PREPAL",2
37,"37160",644,474,464,4,10,"PREPAL",0
37,"37356",90,66,66,1,0,"PREPAL",0
37,"37363",121,100,99,0,1,"PREPAL",0
49,"49232",95,78,78,1,0,"PREPAL",0
49,"49124",279,203,202,2,1,"PREPAL",1
49,"49147",301,243,239,4,4,"PREPAL",0
37,"37241",172,135,134,1,1,"PREPAL",1
37,"37005",92,65,65,0,0,"PREPAL",0
49,"49240",237,190,186,1,4,"PREPAL",0
37,"37375",764,636,627,19,9,"PREPAL",0
37,"37092",1403,1034,1022,12,12,"PREPAL",2
37,"37360",252,194,194,1,0,"PREPAL",1
24,"24059",956,592,585,9,7,"PREPAL",0
49,"49135",687,485,475,3,10,"PREPAL",0
37,"37103",483,354,351,1,3,"PREPAL",0
37,"37368",18,15,15,1,0,"PREPAL",0
24,"24171",417,231,231,2,0,"PREPAL",0
49,"49063",371,291,290,3,1,"PREPAL",0
24,"24018",180,150,149,1,1,"PREPAL",0
49,"49111",144,117,116,10,1,"PREPAL",0
37,"37322",2501,1692,1676,32,16,"PREPAL",5
24,"24043",144,77,77,0,0,"PREPAL",0
49,"49114",51,34,33,1,1,"PREPAL",0
24,"24159",1901,1492,1477,11,15,"PREPAL",8
24,"24139",2320,1687,1654,16,33,"PREPAL",2
37,"37060",229,179,173,2,6,"PREPAL",0
24,"24180",1196,868,862,22,6,"PREPAL",4
37,"37235",226,194,192,0,2,"PREPAL",0
24,"24097",244,161,156,4,5,"PREPAL",0
37,"37232",412,374,373,1,1,"PREPAL",0
37,"37307",177,132,130,0,2,"PREPAL",0
37,"37196",93,74,70,1,4,"PREPAL",0
37,"37251",137,98,93,3,5,"PREPAL",0
37,"37353",142,119,119,2,0,"PREPAL",0
49,"49085",1173,912,908,16,4,"PREPAL",1
49,"49082",400,331,324,2,7,"PREPAL",0
37,"37228",388,339,336,2,3,"PREPAL",0
49,"49210",493,358,356,6,2,"PREPAL",0
37,"37141",158,140,139,1,1,"PREPAL",0
49,"49179",401,285,284,2,1,"PREPAL",3
24,"24150",262,182,182,3,0,"PREPAL",2
24,"24221",850,635,619,6,16,"PREPAL",2
37,"37124",227,181,179,3,2,"PREPAL",0
24,"24183",900,571,567,10,4,"PREPAL",2
49,"49069",414,276,270,1,6,"PREPAL",0
37,"37381",153,114,109,3,5,"PREPAL",0
49,"49234",439,336,332,5,4,"PREPAL",1
37,"37143",410,342,338,3,4,"PREPAL",0
49,"49104",383,281,276,2,5,"PREPAL",0
49,"49067",416,300,300,2,0,"PREPAL",2
49,"49221",266,148,147,6,1,"PREPAL",3
49,"49185",171,140,140,3,0,"PREPAL",0
37,"37260",175,122,122,1,0,"PREPAL",0
37,"37080",242,187,185,1,2,"PREPAL",0
49,"49014",134,104,102,1,2,"PREPAL",0
49,"49190",81,65,64,2,1,"PREPAL",0
24,"24148",1759,1362,1348,29,14,"PREPAL",5
49,"49041",443,337,334,7,3,"PREPAL",1
37,"37099",104,64,62,1,2,"PREPAL",0
49,"49068",523,356,353,5,3,"PREPAL",1
49,"49056",324,251,247,3,4,"PREPAL",0
37,"37061",254,187,185,0,2,"PREPAL",0
37,"37115",135,107,101,2,6,"PREPAL",0
24,"24109",1098,672,663,12,9,"PREPAL",0
24,"24057",1459,1121,1092,16,29,"PREPAL",0
24,"24102",701,536,530,3,6,"PREPAL",0
49,"49102",217,178,176,3,2,"PREPAL",0
49,"49142",264,180,179,2,1,"PREPAL",1
24,"24196",2183,1573,1543,11,30,"PREPAL",1
37,"37282",238,169,168,3,1,"PREPAL",0
37,"37345",179,156,156,2,0,"PREPAL",1
49,"49034",467,363,359,3,4,"PREPAL",1
49,"49189",228,151,150,3,1,"PREPAL",0
37,"37140",731,490,475,0,15,"PREPAL",3
37,"37310",154,115,115,1,0,"PREPAL",0
37,"37309",42,26,25,3,1,"PREPAL",0
37,"37367",218,182,176,0,6,"PREPAL",0
37,"37191",127,86,85,1,1,"PREPAL",1
49,"49193",503,365,357,4,8,"PREPAL",6
49,"49112",131,93,93,2,0,"PREPAL",0
37,"37351",305,261,258,2,3,"PREPAL",0
37,"37175",408,319,311,6,8,"PREPAL",1
37,"37208",92,59,58,0,1,"PREPAL",0
49,"49057",125,98,94,1,4,"PREPAL",0
37,"37069",952,737,723,12,14,"PREPAL",4
37,"37017",249,200,199,0,1,"PREPAL",0
49,"49259",121,88,87,1,1,"PREPAL",0
24,"24083",1165,831,819,17,12,"PREPAL",0
37,"37327",191,148,148,9,0,"PREPAL",0
37,"37347",481,374,371,6,3,"PREPAL",1
24,"24012",291,196,194,2,2,"PREPAL",3
37,"37184",381,295,289,5,6,"PREPAL",1
49,"49005",156,102,101,2,1,"PREPAL",0
37,"37070",538,428,427,12,1,"PREPAL",3
24,"24214",716,518,509,4,9,"PREPAL",1
49,"49137",179,149,147,2,2,"PREPAL",1
37,"37361",91,67,62,0,5,"PREPAL",0
24,"24199",432,280,278,2,2,"PREPAL",0
24,"24146",284,223,221,0,2,"PREPAL",0
24,"24211",291,226,224,3,2,"PREPAL",0
49,"49109",657,534,529,12,5,"PREPAL",0
37,"37218",81,51,51,1,0,"PREPAL",0
37,"37169",196,137,136,1,1,"PREPAL",2
37,"37201",263,196,196,5,0,"PREPAL",0
49,"49203",345,294,292,4,2,"PREPAL",0
37,"37116",75,55,55,1,0,"PREPAL",0
37,"37128",261,211,210,2,1,"PREPAL",0
37,"37090",59,54,50,0,4,"PREPAL",0
37,"37082",869,663,650,3,13,"PREPAL",0
37,"37002",152,90,89,1,1,"PREPAL",1
24,"24106",340,229,228,6,1,"PREPAL",0
37,"37021",86,70,68,2,2,"PREPAL",1
24,"24023",272,196,193,6,3,"PREPAL",3
49,"49024",736,551,544,16,7,"PREPAL",0
49,"49150",169,129,126,0,3,"PREPAL",0
24,"24120",379,258,256,3,2,"PREPAL",3
49,"49164",158,120,114,2,6,"PREPAL",1
37,"37011",131,87,86,2,1,"PREPAL",0
37,"37254",189,168,164,1,4,"PREPAL",0
49,"49030",96,78,77,2,1,"PREPAL",1
49,"49247",507,340,332,6,8,"PREPAL",3
49,"49229",134,99,99,2,0,"PREPAL",0
37,"37263",361,277,275,1,2,"PREPAL",0
37,"37003",134,103,102,0,1,"PREPAL",0
37,"37243",123,89,88,1,1,"PREPAL",0
49,"49062",142,104,104,1,0,"PREPAL",0
24,"24222",13915,9939,9751,304,188,"PREPAL",50
24,"24125",545,374,373,5,1,"PREPAL",1
37,"37343",56,42,40,0,2,"PREPAL",0
24,"24032",134,102,101,1,1,"PREPAL",0
24,"24175",1760,1324,1303,29,21,"PREPAL",4
37,"37130",177,153,153,2,0,"PREPAL",0
37,"37217",60,49,48,1,1,"PREPAL",0
37,"37008",4316,3518,3457,31,61,"PREPAL",3
24,"24073",521,385,382,4,3,"PREPAL",4
37,"37142",613,436,434,7,2,"PREPAL",0
24,"24029",840,590,579,11,11,"PREPAL",0
37,"37056",56,47,47,0,0,"PREPAL",0
49,"49163",235,167,167,0,0,"PREPAL",3
24,"24122",1424,1001,992,9,9,"PREPAL",0
49,"49231",360,256,254,4,2,"PREPAL",2
37,"37240",781,552,540,10,12,"PREPAL",1
24,"24177",477,325,319,3,6,"PREPAL",0
49,"49249",78,63,63,0,0,"PREPAL",1
49,"49216",175,144,142,3,2,"PREPAL",0
49,"49153",183,141,139,1,2,"PREPAL",1
24,"24101",465,274,266,5,8,"PREPAL",0
37,"37312",278,232,229,1,3,"PREPAL",0
24,"24165",400,284,279,4,5,"PREPAL",0
49,"49261",1579,1161,1145,36,16,"PREPAL",5
49,"49116",401,308,305,4,3,"PREPAL",0
37,"37112",162,124,124,3,0,"PREPAL",0
24,"24174",525,393,387,6,6,"PREPAL",1
37,"37027",242,196,192,2,4,"PREPAL",0
24,"24027",1184,853,837,7,16,"PREPAL",3
24,"24207",320,274,272,5,2,"PREPAL",1
37,"37234",376,275,272,2,3,"PREPAL",0
37,"37149",78,69,69,0,0,"PREPAL",0
37,"37270",201,159,158,0,1,"PREPAL",0
37,"37129",247,198,198,4,0,"PREPAL",0
49,"49079",110,93,92,2,1,"PREPAL",1
37,"37300",586,430,421,6,9,"PREPAL",0
24,"24095",293,211,208,1,3,"PREPAL",0
37,"37183",425,321,316,3,5,"PREPAL",0
49,"49160",54,35,34,3,1,"PREPAL",0
49,"49099",127,96,96,1,0,"PREPAL",0
37,"37159",100,77,75,0,2,"PREPAL",0
37,"37035",220,176,173,1,3,"PREPAL",1
49,"49131",312,227,225,7,2,"PREPAL",0
37,"37247",216,176,173,1,3,"PREPAL",0
24,"24155",524,428,420,6,8,"PREPAL",3
37,"37335",432,347,346,0,1,"PREPAL",0
24,"24052",178,113,111,0,2,"PREPAL",0
24,"24131",813,583,580,9,3,"PREPAL",1
24,"24227",1664,1159,1148,16,11,"PREPAL",3
37,"37323",549,427,418,6,9,"PREPAL",2
24,"24078",426,323,316,0,7,"PREPAL",1
24,"24091",704,502,496,8,6,"PREPAL",3
37,"37269",475,383,382,2,1,"PREPAL",2
37,"37157",94,65,65,0,0,"PREPAL",3
24,"24127",327,258,255,1,3,"PREPAL",0
37,"37074",172,136,135,1,1,"PREPAL",0
24,"24089",106265,77385,76124,1666,1261,"PREPAL",389
37,"37086",105,75,72,3,3,"PREPAL",0
49,"49038",114,81,80,0,1,"PREPAL",1
37,"37022",287,237,232,0,5,"PREPAL",1
37,"37366",46,35,34,0,1,"PREPAL",0
37,"37071",90,80,80,1,0,"PREPAL",0
24,"24114",3441,2322,2304,42,18,"PREPAL",12
49,"49129",903,671,661,16,10,"PREPAL",0
49,"49270",156,112,112,6,0,"PREPAL",0
37,"37067",2938,2306,2267,47,39,"PREPAL",6
37,"37350",452,368,364,5,4,"PREPAL",2
24,"24067",700,453,447,4,6,"PREPAL",2
37,"37078",888,728,714,9,14,"PREPAL",0
24,"24010",8550,6242,6111,100,131,"PREPAL",36
37,"37325",102,77,77,0,0,"PREPAL",0
37,"37216",300,270,266,2,4,"PREPAL",0
37,"37286",231,166,160,2,6,"PREPAL",0
49,"49209",568,374,372,1,2,"PREPAL",3
49,"49170",111,87,85,1,2,"PREPAL",1
37,"37291",261,215,214,1,1,"PREPAL",0
24,"24107",316,208,206,1,2,"PREPAL",1
49,"49151",680,494,491,6,3,"PREPAL",0
37,"37054",273,230,229,2,1,"PREPAL",0
49,"49090",207,168,168,4,0,"PREPAL",0
37,"37212",123,95,92,1,3,"PREPAL",0
37,"37155",81,57,57,0,0,"PREPAL",0
37,"37150",43,36,34,0,2,"PREPAL",0
37,"37339",345,280,279,3,1,"PREPAL",1
37,"37133",108,79,77,0,2,"PREPAL",0
37,"37114",92,75,74,1,1,"PREPAL",0
49,"49046",283,240,235,2,5,"PREPAL",0
37,"37314",79,61,61,3,0,"PREPAL",0
37,"37085",4334,3254,3201,69,53,"PREPAL",5
37,"37164",280,217,213,9,4,"PREPAL",0
24,"24108",421,316,314,6,2,"PREPAL",3
37,"37226",167,129,127,1,2,"PREPAL",0
49,"49058",341,262,259,4,3,"PREPAL",0
49,"49256",289,229,224,3,5,"PREPAL",1
24,"24172",491,234,232,2,2,"PREPAL",0
37,"37253",137,115,115,1,0,"PREPAL",0
37,"37328",218,155,149,2,6,"PREPAL",0
37,"37369",143,103,103,0,0,"PREPAL",0
49,"49245",296,218,218,2,0,"PREPAL",0
37,"37277",58,39,38,1,1,"PREPAL",0
49,"49250",1330,998,985,19,13,"PREPAL",2
37,"37010",963,705,690,5,15,"PREPAL",4
37,"37233",59,46,45,1,1,"PREPAL",0
37,"37249",48,36,36,0,0,"PREPAL",0
24,"24084",182,133,132,1,1,"PREPAL",1
49,"49199",266,214,211,1,3,"PREPAL",0
24,"24133",379,279,279,0,0,"PREPAL",1
24,"24182",448,339,333,9,6,"PREPAL",1
24,"24187",881,664,659,14,5,"PREPAL",7
24,"24149",149,120,118,3,2,"PREPAL",1
24,"24123",835,559,555,6,4,"PREPAL",3
49,"49267",101,77,77,1,0,"PREPAL",1
37,"37019",157,114,113,0,1,"PREPAL",0
37,"37044",461,363,360,1,3,"PREPAL",0
49,"49271",221,178,176,2,2,"PREPAL",1
37,"37275",136,98,98,0,0,"PREPAL",1
24,"24020",480,326,324,9,2,"PREPAL",1
37,"37203",174,148,148,0,0,"PREPAL",0
24,"24158",333,223,223,6,0,"PREPAL",3
24,"24003",725,528,520,8,8,"PREPAL",0
24,"24007",798,582,566,2,16,"PREPAL",0
37,"37271",393,324,318,5,6,"PREPAL",1
37,"37231",285,227,225,6,2,"PREPAL",2
37,"37059",132,110,110,2,0,"PREPAL",0
24,"24087",670,513,513,12,0,"PREPAL",3
37,"37020",449,371,365,7,6,"PREPAL",1
37,"37180",69,46,46,0,0,"PREPAL",1
37,"37089",74,54,54,2,0,"PREPAL",0
37,"37104",32,24,23,0,1,"PREPAL",0
37,"37280",84,64,64,0,0,"PREPAL",0
37,"37118",141,115,114,3,1,"PREPAL",0
49,"49053",978,809,796,10,13,"PREPAL",0
37,"37340",155,121,121,0,0,"PREPAL",0
37,"37077",293,262,258,3,4,"PREPAL",0
37,"37127",229,183,182,3,1,"PREPAL",0
49,"49128",617,480,474,10,6,"PREPAL",1
49,"49172",594,389,383,0,6,"PREPAL",1
24,"24069",53,44,44,0,0,"PREPAL",0
37,"37205",235,199,195,5,4,"PREPAL",0
49,"49158",229,174,172,0,2,"PREPAL",0
37,"37214",134,94,94,4,0,"PREPAL",0
24,"24190",183,134,131,1,3,"PREPAL",1
49,"49227",295,238,237,5,1,"PREPAL",0
49,"49020",323,275,272,1,3,"PREPAL",2
37,"37132",398,317,311,3,6,"PREPAL",0
37,"37009",225,189,185,2,4,"PREPAL",0
24,"24144",781,551,541,13,10,"PREPAL",8
49,"49242",503,421,410,5,11,"PREPAL",0
37,"37321",169,144,144,1,0,"PREPAL",0
24,"24225",1089,798,784,15,14,"PREPAL",9
49,"49145",251,154,153,0,1,"PREPAL",1
37,"37186",109,88,88,2,0,"PREPAL",0
49,"49130",218,159,156,3,3,"PREPAL",2
24,"24129",125,88,86,5,2,"PREPAL",1
49,"49097",97,55,55,1,0,"PREPAL",0
37,"37355",187,142,140,2,2,"PREPAL",0
24,"24015",2391,1812,1782,20,30,"PREPAL",11
49,"49044",80,63,63,3,0,"PREPAL",0
37,"37313",581,440,435,7,5,"PREPAL",1
24,"24179",331,219,214,4,5,"PREPAL",0
49,"49205",429,313,309,10,4,"PREPAL",0
49,"49122",701,542,534,7,8,"PREPAL",1
49,"49013",300,230,228,6,2,"PREPAL",0
24,"24103",330,180,177,0,3,"PREPAL",0
37,"37221",465,360,353,0,7,"PREPAL",0
37,"37171",437,362,358,4,4,"PREPAL",0
24,"24063",453,323,322,2,1,"PREPAL",0
37,"37297",441,376,369,1,7,"PREPAL",1
24,"24104",291,198,196,3,2,"PREPAL",1
24,"24025",331,237,237,5,0,"PREPAL",1
49,"49076",333,260,257,10,3,"PREPAL",0
49,"49175",263,215,215,4,0,"PREPAL",0
37,"37352",199,150,142,0,8,"PREPAL",0
37,"37288",252,194,194,3,0,"PREPAL",0
24,"24168",493,397,391,7,6,"PREPAL",2
37,"37209",376,258,253,4,5,"PREPAL",0
49,"49191",305,248,246,2,2,"PREPAL",0
24,"24224",665,490,484,8,6,"PREPAL",0
24,"24902",375,292,289,1,3,"PREPAL",1
37,"37302",337,230,229,5,1,"PREPAL",0
37,"37181",301,232,230,2,2,"PREPAL",0
37,"37257",52,43,43,0,0,"PREPAL",0
37,"37281",36,34,33,0,1,"PREPAL",0
37,"37382",202,172,171,3,1,"PREPAL",0
37,"37026",201,176,176,3,0,"PREPAL",0
37,"37374",1204,1018,1004,9,14,"PREPAL",1
24,"24054",492,359,351,1,8,"PREPAL",4
37,"37014",1198,862,852,8,10,"PREPAL",0
37,"37098",355,267,265,1,2,"PREPAL",0
24,"24119",742,524,510,15,14,"PREPAL",2
24,"24040",494,369,366,6,3,"PREPAL",2
49,"49200",1011,789,771,6,18,"PREPAL",4
49,"49257",277,180,179,0,1,"PREPAL",1
24,"24002",271,213,213,2,0,"PREPAL",0
37,"37162",232,184,182,4,2,"PREPAL",0
24,"24055",747,557,549,11,8,"PREPAL",7
24,"24098",1251,837,819,19,18,"PREPAL",8
24,"24141",101,83,80,6,3,"PREPAL",0
49,"49141",397,289,286,7,3,"PREPAL",1
37,"37062",92,73,73,1,0,"PREPAL",0
37,"37125",243,184,180,3,4,"PREPAL",1
37,"37058",68,44,44,0,0,"PREPAL",0
49,"49201",330,280,278,9,2,"PREPAL",1
24,"24188",3830,2987,2928,51,59,"PREPAL",17
49,"49243",117,85,85,0,0,"PREPAL",0
24,"24041",602,403,396,3,7,"PREPAL",0
37,"37239",235,208,201,2,7,"PREPAL",0
24,"24056",3200,2368,2332,53,36,"PREPAL",19
37,"37138",212,174,169,5,5,"PREPAL",0
37,"37213",97,77,76,0,1,"PREPAL",0
37,"37252",127,92,92,0,0,"PREPAL",0
49,"49166",1294,1003,988,29,15,"PREPAL",1
37,"37192",362,229,221,3,8,"PREPAL",1
24,"24049",1528,1144,1124,22,20,"PREPAL",2
49,"49148",213,144,143,0,1,"PREPAL",0
37,"37289",265,211,209,0,2,"PREPAL",0
49,"49047",120,91,90,1,1,"PREPAL",0
49,"49006",168,124,122,2,2,"PREPAL",2
37,"37131",200,150,148,1,2,"PREPAL",0
37,"37256",245,191,190,2,1,"PREPAL",0
49,"49110",382,236,233,1,3,"PREPAL",2
37,"37265",224,192,191,1,1,"PREPAL",0
37,"37001",224,182,181,0,1,"PREPAL",0
24,"24156",264,187,186,6,1,"PREPAL",0
49,"49101",186,134,129,0,5,"PREPAL",1
37,"37101",185,143,141,1,2,"PREPAL",0
37,"37370",345,261,260,1,1,"PREPAL",0
49,"49192",166,139,139,2,0,"PREPAL",0
37,"37091",181,127,119,0,8,"PREPAL",0
24,"24157",2580,2046,2000,39,46,"PREPAL",16
37,"37304",190,144,142,1,2,"PREPAL",0
37,"37158",262,181,179,0,2,"PREPAL",0
24,"24086",323,245,243,1,2,"PREPAL",2
24,"24031",220,180,176,3,4,"PREPAL",1
49,"49155",105,85,85,0,0,"PREPAL",0
37,"37006",157,108,107,0,1,"PREPAL",0
49,"49258",127,107,104,0,3,"PREPAL",0
49,"49108",512,387,381,9,6,"PREPAL",3
37,"37287",341,247,246,1,1,"PREPAL",0
37,"37015",248,169,168,0,1,"PREPAL",0
37,"37318",225,167,165,0,2,"PREPAL",1
49,"49088",90,67,66,3,1,"PREPAL",0
24,"24170",2006,1410,1394,14,16,"PREPAL",0
49,"49113",188,166,161,2,5,"PREPAL",0
49,"49126",232,175,173,3,2,"PREPAL",2
49,"49127",2227,1617,1587,48,30,"PREPAL",5
24,"24033",214,157,152,3,5,"PREPAL",1
24,"24099",199,164,162,0,2,"PREPAL",1
37,"37073",583,458,455,7,3,"PREPAL",1
49,"49235",486,344,340,6,4,"PREPAL",3
37,"37045",27,21,21,0,0,"PREPAL",0
49,"49009",430,309,309,0,0,"PREPAL",2
37,"37248",160,130,130,1,0,"PREPAL",0
37,"37188",198,164,160,7,4,"PREPAL",6
37,"37193",432,310,309,5,1,"PREPAL",0
37,"37119",115,98,98,0,0,"PREPAL",0
49,"49186",273,205,204,1,1,"PREPAL",0
49,"49037",201,171,171,2,0,"PREPAL",0
49,"49275",53766,37940,37379,774,561,"PREPAL",170
49,"49167",223,173,171,5,2,"PREPAL",0
37,"37319",138,94,94,1,0,"PREPAL",1
24,"24022",364,231,230,2,1,"PREPAL",0
37,"37365",172,152,149,2,3,"PREPAL",0
49,"49133",344,247,243,3,4,"PREPAL",0
49,"49134",203,142,142,4,0,"PREPAL",1
37,"37245",357,273,272,2,1,"PREPAL",2
24,"24228",732,543,529,4,14,"PREPAL",3
49,"49236",86,64,64,0,0,"PREPAL",0
37,"37198",212,176,173,2,3,"PREPAL",1
24,"24229",473,348,344,8,4,"PREPAL",0
37,"37047",178,111,111,0,0,"PREPAL",0
49,"49043",304,256,256,6,0,"PREPAL",0
49,"49055",115,96,95,1,1,"PREPAL",0
37,"37206",100,81,80,1,1,"PREPAL",0
37,"37121",557,458,451,8,7,"PREPAL",0
24,"24145",656,420,420,11,0,"PREPAL",1
49,"49008",535,395,394,7,1,"PREPAL",0
37,"37242",99,73,72,0,1,"PREPAL",0
37,"37179",230,194,191,3,3,"PREPAL",0
49,"49184",190,135,133,1,2,"PREPAL",1
49,"49040",118,102,98,1,4,"PREPAL",0
37,"37174",1150,942,922,3,20,"PREPAL",2
24,"24162",1631,1214,1195,33,19,"PREPAL",8
24,"24213",162,134,133,1,1,"PREPAL",1
49,"49239",723,506,495,12,11,"PREPAL",0
49,"49031",150,128,127,2,1,"PREPAL",1
24,"24218",476,344,340,11,4,"PREPAL",2
37,"37163",44,36,36,0,0,"PREPAL",1
37,"37036",74,54,52,0,2,"PREPAL",0
37,"37146",135,117,117,1,0,"PREPAL",0
49,"49255",455,372,367,1,5,"PREPAL",0
49,"49226",279,235,233,1,2,"PREPAL",0
37,"37276",188,136,135,0,1,"PREPAL",0
24,"24198",644,423,417,7,6,"PREPAL",0
37,"37151",150,125,121,1,4,"PREPAL",0
24,"24189",5410,3630,3572,83,58,"PREPAL",28
24,"24184",206,111,111,0,0,"PREPAL",0
49,"49028",119,103,103,1,0,"PREPAL",0
37,"37106",289,199,196,2,3,"PREPAL",0
24,"24113",404,318,310,3,8,"PREPAL",1
37,"37315",99,77,75,3,2,"PREPAL",0
49,"49181",386,308,307,2,1,"PREPAL",0
49,"49149",422,305,303,6,2,"PREPAL",2
37,"37052",274,213,212,1,1,"PREPAL",0
37,"37357",283,216,214,0,2,"PREPAL",0
24,"24215",169,121,120,1,1,"PREPAL",0
37,"37358",163,143,139,0,4,"PREPAL",0
49,"49120",79,58,58,1,0,"PREPAL",0
37,"37148",451,344,343,3,1,"PREPAL",0
37,"37294",11233,8282,8167,139,115,"PREPAL",13
37,"37274",123032,90819,89629,1506,1190,"PREPAL",214
37,"37190",235,195,193,1,2,"PREPAL",0
49,"49016",272,216,211,1,5,"PREPAL",0
49,"49228",64,56,56,0,0,"PREPAL",0
24,"24094",1466,1023,1006,24,17,"PREPAL",5
49,"49121",382,270,270,1,0,"PREPAL",0
24,"24161",307,231,228,1,3,"PREPAL",0
49,"49027",178,134,127,1,7,"PREPAL",1
37,"37262",81,66,64,2,2,"PREPAL",0
24,"24202",8677,5486,5377,103,109,"PREPAL",10
37,"37113",439,365,365,7,0,"PREPAL",0
37,"37279",780,580,571,6,9,"PREPAL",0
24,"24154",1068,803,795,6,8,"PREPAL",2
49,"49263",69,54,54,2,0,"PREPAL",0
37,"37187",567,449,448,3,1,"PREPAL",0
37,"37031",399,308,307,5,1,"PREPAL",0
37,"37255",58,47,47,3,0,"PREPAL",0
49,"49036",592,410,403,5,7,"PREPAL",1
24,"24203",109,73,73,0,0,"PREPAL",0
37,"37301",78,58,58,0,0,"PREPAL",0
24,"24136",596,465,463,12,2,"PREPAL",9
24,"24163",3706,2760,2714,57,46,"PREPAL",8
49,"49084",306,234,234,8,0,"PREPAL",0
49,"49080",736,571,560,5,11,"PREPAL",0
49,"49054",929,690,687,12,3,"PREPAL",5
49,"49023",1033,736,728,10,8,"PREPAL",2
37,"37377",268,209,208,1,1,"PREPAL",0
37,"37152",474,357,351,2,6,"PREPAL",0
37,"37139",199,167,163,1,4,"PREPAL",0
49,"49197",187,126,126,3,0,"PREPAL",1
49,"49010",338,271,265,4,6,"PREPAL",0
37,"37293",131,108,106,5,2,"PREPAL",2
49,"49081",1457,1166,1141,17,25,"PREPAL",2
49,"49033",761,563,556,9,7,"PREPAL",2
37,"37173",1643,1298,1285,26,13,"PREPAL",0
49,"49223",770,606,601,8,5,"PREPAL",0
37,"37373",793,591,589,4,2,"PREPAL",0
24,"24169",3205,2317,2282,33,35,"PREPAL",3
37,"37219",197,121,120,0,1,"PREPAL",0
37,"37136",702,494,485,4,9,"PREPAL",1
49,"49188",142,101,100,3,1,"PREPAL",0
37,"37170",1571,1122,1107,22,15,"PREPAL",1
49,"49021",14682,10495,10296,194,199,"PREPAL",56
37,"37290",143,111,110,1,1,"PREPAL",0
49,"49083",67,48,48,1,0,"PREPAL",0
37,"37354",4828,3589,3522,76,67,"PREPAL",4
49,"49125",1344,956,939,21,17,"PREPAL",3
49,"49093",308,248,245,5,3,"PREPAL",0
24,"24019",367,293,287,5,6,"PREPAL",0
49,"49252",370,310,305,6,5,"PREPAL",2
49,"49156",265,217,214,6,3,"PREPAL",0
49,"49146",330,268,265,6,3,"PREPAL",0
49,"49225",172,130,129,0,1,"PREPAL",0
37,"37246",5430,4363,4315,63,48,"PREPAL",8
24,"24166",1521,1137,1112,27,25,"PREPAL",7
37,"37195",48,32,32,0,0,"PREPAL",0
49,"49165",72,63,63,0,0,"PREPAL",0
24,"24209",3016,2006,1984,20,22,"PREPAL",1
37,"37292",101,84,84,2,0,"PREPAL",0
37,"37204",286,216,214,0,2,"PREPAL",0
24,"24223",2793,2121,2113,63,8,"PREPAL",0
37,"37032",530,410,409,4,1,"PREPAL",0
37,"37012",155,124,120,1,4,"PREPAL",0
24,"24142",24843,17695,17371,409,324,"PREPAL",112
37,"37364",893,653,644,10,9,"PREPAL",1
37,"37126",36,26,26,0,0,"PREPAL",0
49,"49248",224,183,180,4,3,"PREPAL",1
49,"49157",177,140,140,0,0,"PREPAL",1
24,"24194",327,237,236,5,1,"PREPAL",1
37,"37268",113,78,77,1,1,"PREPAL",0
49,"49064",566,372,368,8,4,"PREPAL",0
24,"24173",1023,757,747,4,10,"PREPAL",6
24,"24074",107,87,87,0,0,"PREPAL",0
37,"37237",330,250,242,1,8,"PREPAL",0
49,"49015",259,213,208,2,5,"PREPAL",0
24,"24066",561,440,437,5,3,"PREPAL",1
37,"37244",132,97,95,5,2,"PREPAL",0
37,"37337",140,122,121,0,1,"PREPAL",0
37,"37161",157,118,116,1,2,"PREPAL",0
49,"49143",243,161,157,0,4,"PREPAL",0
37,"37211",223,169,169,1,0,"PREPAL",0
49,"49061",141,106,105,1,1,"PREPAL",1
24,"24076",1210,917,907,26,10,"PREPAL",8
49,"49187",1317,967,954,31,13,"PREPAL",3
37,"37324",415,338,334,2,4,"PREPAL",0
49,"49039",333,243,240,6,3,"PREPAL",3
24,"24090",366,225,224,2,1,"PREPAL",0
49,"49233",119,78,78,2,0,"PREPAL",0
37,"37049",163,119,119,0,0,"PREPAL",1
49,"49178",679,469,461,9,8,"PREPAL",3
37,"37222",124,92,92,2,0,"PREPAL",0
24,"24217",144,108,107,2,1,"PREPAL",0
24,"24071",1060,808,797,6,11,"PREPAL",0
49,"49052",200,149,144,1,5,"PREPAL",0
49,"49174",131,97,97,1,0,"PREPAL",0
49,"49035",260,231,229,4,2,"PREPAL",0
37,"37117",1320,948,937,16,11,"PREPAL",0
37,"37342",252,216,211,3,5,"PREPAL",1
37,"37267",210,169,165,0,4,"PREPAL",1
49,"49162",217,157,155,2,2,"PREPAL",0
24,"24011",244,131,129,0,2,"PREPAL",0
49,"49132",338,245,238,0,7,"PREPAL",2
24,"24134",3682,2636,2588,44,48,"PREPAL",18
49,"49118",215,174,173,2,1,"PREPAL",1
24,"24901",994,698,686,8,12,"PREPAL",1
24,"24205",995,719,712,9,7,"PREPAL",3
49,"49260",814,653,644,6,9,"PREPAL",0
49,"49273",217,144,144,0,0,"PREPAL",2
37,"37272",162,121,120,1,1,"PREPAL",1
49,"49042",271,216,216,1,0,"PREPAL",0
37,"37156",4319,3280,3233,28,47,"PREPAL",6
24,"24030",4397,3272,3229,54,43,"PREPAL",4
24,"24026",1304,1015,1001,17,14,"PREPAL",9
24,"24017",630,476,468,11,8,"PREPAL",2
24,"24206",1831,1362,1341,13,21,"PREPAL",0
37,"37046",11929,8847,8683,146,164,"PREPAL",9
49,"49177",298,199,196,6,3,"PREPAL",3
37,"37037",130,100,99,0,1,"PREPAL",0
24,"24062",151,107,107,0,0,"PREPAL",3
24,"24014",7677,5352,5289,75,63,"PREPAL",15
49,"49266",83,69,69,1,0,"PREPAL",0
49,"49025",187,143,142,3,1,"PREPAL",1
24,"24185",512,414,402,3,12,"PREPAL",2
37,"37068",386,291,287,6,4,"PREPAL",0
49,"49220",161,122,118,5,4,"PREPAL",1
37,"37338",82,69,67,0,2,"PREPAL",0
37,"37178",107,88,87,0,1,"PREPAL",0
37,"37238",102,77,76,0,1,"PREPAL",0
37,"37039",325,241,236,0,5,"PREPAL",0
37,"37283",130,104,104,1,0,"PREPAL",0
37,"37250",405,277,274,1,3,"PREPAL",0
37,"37330",338,272,270,3,2,"PREPAL",3
24,"24077",237,205,199,2,6,"PREPAL",1
37,"37359",194,155,152,1,3,"PREPAL",0
49,"49139",195,146,146,0,0,"PREPAL",1
37,"37050",71,48,48,1,0,"PREPAL",0
24,"24024",717,501,498,10,3,"PREPAL",4
37,"37145",276,217,214,0,3,"PREPAL",0
24,"24124",419,286,282,0,4,"PREPAL",3
24,"24016",544,323,322,4,1,"PREPAL",0
37,"37004",31,23,23,0,0,"PREPAL",0
49,"49032",369,295,291,0,4,"PREPAL",2
37,"37088",208,173,172,4,1,"PREPAL",0
24,"24068",500,357,349,3,8,"PREPAL",0
37,"37079",77,64,63,1,1,"PREPAL",0
37,"37063",94,77,76,3,1,"PREPAL",0
37,"37016",539,424,420,8,4,"PREPAL",0
24,"24047",856,623,612,5,11,"PREPAL",10
37,"37200",192,142,142,0,0,"PREPAL",0
37,"37029",226,181,178,4,3,"PREPAL",0
49,"49123",557,421,415,5,6,"PREPAL",1
49,"49115",191,151,149,3,2,"PREPAL",0
37,"37298",206,144,140,1,4,"PREPAL",1
24,"24160",741,545,539,17,6,"PREPAL",3
49,"49241",275,225,221,2,4,"PREPAL",0
24,"24093",388,262,258,1,4,"PREPAL",1
49,"49105",158,135,133,2,2,"PREPAL",0
37,"37168",470,357,353,1,4,"PREPAL",0
24,"24132",683,440,435,5,5,"PREPAL",0
37,"37320",96,70,70,0,0,"PREPAL",0
24,"24105",1460,1095,1075,27,20,"PREPAL",8
37,"37362",4333,3276,3238,65,38,"PREPAL",9
37,"37154",156,130,125,1,5,"PREPAL",0
37,"37230",221,173,171,0,2,"PREPAL",0
37,"37182",92,72,72,2,0,"PREPAL",0
37,"37057",223,190,190,0,0,"PREPAL",1
37,"37299",237,167,165,2,2,"PREPAL",1
49,"49050",558,382,375,3,7,"PREPAL",0
37,"37207",287,211,208,2,3,"PREPAL",0
37,"37225",119,101,95,3,6,"PREPAL",0
24,"24116",451,297,294,5,3,"PREPAL",0
37,"37259",44,32,32,3,0,"PREPAL",0
24,"24028",426,350,331,3,19,"PREPAL",1
24,"24178",83,67,67,2,0,"PREPAL",0
37,"37296",385,311,308,3,3,"PREPAL",0
37,"37072",184,157,155,5,2,"PREPAL",0
37,"37317",323,281,278,3,3,"PREPAL",2
37,"37334",86,50,49,0,1,"PREPAL",0
24,"24036",321,190,188,0,2,"PREPAL",0
24,"24112",323,230,228,0,2,"PREPAL",1
37,"37331",234,161,161,3,0,"PREPAL",0
37,"37109",191,142,141,1,1,"PREPAL",0
24,"24038",3206,2439,2399,37,40,"PREPAL",1
37,"37372",145,109,109,0,0,"PREPAL",0
24,"24053",503,338,332,3,6,"PREPAL",0
37,"37224",216,190,186,5,4,"PREPAL",0
49,"49180",169,113,107,2,6,"PREPAL",1
49,"49244",48,30,30,1,0,"PREPAL",0
49,"49265",143,105,105,1,0,"PREPAL",0
37,"37033",86,64,63,1,1,"PREPAL",0
37,"37332",78,52,49,0,3,"PREPAL",0
37,"37041",80,53,53,1,0,"PREPAL",0
37,"37028",175,130,125,1,5,"PREPAL",0
37,"37236",163,123,119,4,4,"PREPAL",0
49,"49176",757,502,501,5,1,"PREPAL",1
49,"49208",428,266,261,1,5,"PREPAL",2
49,"49002",77,59,59,1,0,"PREPAL",0
49,"49012",73,43,43,0,0,"PREPAL",0
24,"24216",782,582,574,3,8,"PREPAL",5
24,"24080",228,165,164,0,1,"PREPAL",1
49,"49011",236,195,194,5,1,"PREPAL",1
37,"37185",602,452,448,8,4,"PREPAL",1
24,"24212",1105,856,846,14,10,"PREPAL",3
37,"37107",11407,8234,8116,123,118,"PREPAL",9
49,"49003",896,650,647,11,3,"PREPAL",6
24,"24081",143,111,110,1,1,"PREPAL",0
37,"37379",167,128,125,4,3,"PREPAL",0
37,"37120",107,88,87,0,1,"PREPAL",0
37,"37266",83,54,54,1,0,"PREPAL",0
24,"24009",362,188,184,0,4,"PREPAL",0
37,"37083",190,165,165,3,0,"PREPAL",0
49,"49029",675,553,542,6,11,"PREPAL",1
49,"49169",42,34,33,1,1,"PREPAL",0
24,"24051",484,375,368,2,7,"PREPAL",0
24,"24046",1002,704,696,20,8,"PREPAL",4
37,"37371",285,190,190,2,0,"PREPAL",0
24,"24130",468,343,337,6,6,"PREPAL",1
37,"37023",1040,819,811,11,8,"PREPAL",2
37,"37177",310,242,241,1,1,"PREPAL",1
24,"24210",532,329,328,2,1,"PREPAL",0
37,"37040",431,362,362,4,0,"PREPAL",0
24,"24082",877,698,690,13,8,"PREPAL",6
49,"49136",347,249,247,6,2,"PREPAL",4
37,"37013",133,93,85,5,8,"PREPAL",0
49,"49071",822,558,557,5,1,"PREPAL",1
37,"37038",808,671,664,6,7,"PREPAL",0
24,"24181",1652,1303,1288,12,15,"PREPAL",5
49,"49107",160,113,111,2,2,"PREPAL",1
49,"49019",256,206,205,5,1,"PREPAL",0
37,"37096",235,199,197,3,2,"PREPAL",1
24,"24064",1532,1128,1107,17,21,"PREPAL",1
24,"24070",4434,3199,3136,34,63,"PREPAL",3
37,"37278",736,538,529,7,9,"PREPAL",0
24,"24096",145,96,93,0,3,"PREPAL",1
37,"37172",857,584,580,5,4,"PREPAL",5
24,"24004",535,391,390,0,1,"PREPAL",0
37,"37303",207,158,152,3,6,"PREPAL",1
37,"37311",251,210,209,8,1,"PREPAL",1
24,"24226",223,154,153,1,1,"PREPAL",0
24,"24037",429,282,277,4,5,"PREPAL",0
49,"49117",505,376,369,5,7,"PREPAL",0
24,"24143",515,376,373,6,3,"PREPAL",2
24,"24005",437,308,305,3,3,"PREPAL",1
24,"24006",521,384,378,4,6,"PREPAL",4
24,"24042",79,68,68,0,0,"PREPAL",0
37,"37344",259,212,211,5,1,"PREPAL",0
49,"49078",209,173,172,1,1,"PREPAL",1
37,"37030",90,71,70,4,1,"PREPAL",0
49,"49224",161,114,112,2,2,"PREPAL",0
49,"49075",153,128,122,0,6,"PREPAL",0
49,"49262",401,317,313,1,4,"PREPAL",0
24,"24065",2104,1512,1488,27,24,"PREPAL",11
37,"37285",457,349,347,2,2,"PREPAL",1
37,"37223",127,102,101,1,1,"PREPAL",1
49,"49026",236,189,184,3,5,"PREPAL",0
24,"24197",784,570,564,7,6,"PREPAL",2
49,"49251",191,157,154,7,3,"PREPAL",0
49,"49159",289,225,225,2,0,"PREPAL",0
49,"49087",581,358,356,3,2,"PREPAL",2
49,"49091",278,197,197,4,0,"PREPAL",0
37,"37051",90,72,72,0,0,"PREPAL",0
49,"49095",318,232,232,5,0,"PREPAL",0
49,"49092",160,123,123,2,0,"PREPAL",0
49,"49004",137,105,105,3,0,"PREPAL",2
49,"49183",111,87,87,2,0,"PREPAL",0
49,"49204",85,64,64,0,0,"PREPAL",0
49,"49237",157,110,110,0,0,"PREPAL",0
24,"24061",1713,1223,1210,34,13,"PREPAL",6
49,"49171",704,568,561,6,7,"PREPAL",1
37,"37176",136,103,100,1,3,"PREPAL",0
37,"37258",206,151,149,2,2,"PREPAL",0
37,"37306",316,194,192,1,2,"PREPAL",0
37,"37346",264,211,210,1,1,"PREPAL",0
24,"24153",253,201,199,4,2,"PREPAL",0
37,"37165",27,20,20,1,0,"PREPAL",0
37,"37166",206,172,171,3,1,"PREPAL",0
37,"37065",346,269,267,0,2,"PREPAL",1
49,"49007",387,289,289,4,0,"PREPAL",0
37,"37025",264,217,216,1,1,"PREPAL",0
37,"37349",136,105,104,2,1,"PREPAL",4
24,"24115",54654,38629,38010,716,619,"PREPAL",23
37,"37110",112,89,88,1,1,"PREPAL",1
24,"24001",241,148,147,3,1,"PREPAL",3
24,"24088",1103,903,885,4,18,"PREPAL",3
49,"49154",147,104,102,1,2,"PREPAL",0
24,"24039",2157,1738,1727,30,11,"PREPAL",13
37,"37100",89,77,76,4,1,"PREPAL",1
24,"24121",645,511,502,10,9,"PREPAL",0
37,"37055",132,112,107,2,5,"PREPAL",0
24,"24191",112,88,88,1,0,"PREPAL",1
49,"49018",341,281,279,5,2,"PREPAL",3
49,"49246",248,212,210,1,2,"PREPAL",0
37,"37034",91,72,72,0,0,"PREPAL",0
37,"37261",255,191,191,2,0,"PREPAL",0
49,"49022",319,266,261,3,5,"PREPAL",1
37,"37007",467,368,363,6,5,"PREPAL",0
49,"49119",245,194,191,2,3,"PREPAL",0
24,"24164",397,215,213,2,2,"PREPAL",0
49,"49066",531,392,386,2,6,"PREPAL",0
37,"37042",45,35,35,1,0,"PREPAL",0
37,"37333",247,160,154,2,6,"PREPAL",0
37,"37202",938,742,726,25,16,"PREPAL",2
49,"49173",430,272,272,5,0,"PREPAL",0
37,"37102",430,323,322,1,1,"PREPAL",0
37,"37341",52,32,32,0,0,"PREPAL",0
37,"37018",128,89,87,0,2,"PREPAL",0
24,"24110",1291,914,904,16,10,"PREPAL",1
49,"49059",111,83,82,2,1,"PREPAL",0
37,"37376",2373,1720,1700,23,20,"PREPAL",0
37,"37108",108,95,95,1,0,"PREPAL",0
49,"49207",279,206,204,2,2,"PREPAL",2
49,"49214",720,560,558,6,2,"PREPAL",1
24,"24219",580,435,431,10,4,"PREPAL",4
24,"24167",813,509,509,8,0,"PREPAL",2
37,"37264",78,52,52,0,0,"PREPAL",0
24,"24050",113,91,90,0,1,"PREPAL",0
37,"37215",156,106,106,1,0,"PREPAL",0
24,"24079",1045,721,710,15,11,"PREPAL",3
37,"37336",54,49,47,0,2,"PREPAL",0
37,"37273",115,83,83,1,0,"PREPAL",0
24,"24201",1123,790,777,14,13,"PREPAL",3
37,"37194",271,206,204,0,2,"PREPAL",0
37,"37144",398,302,301,3,1,"PREPAL",1
37,"37097",47,39,39,1,0,"PREPAL",0
24,"24008",9789,7277,7179,110,98,"PREPAL",49
37,"37087",779,590,586,18,4,"PREPAL",2
49,"49238",289,233,231,3,2,"PREPAL",0
49,"49065",1212,939,926,3,13,"PREPAL",1
37,"37305",206,153,152,4,1,"PREPAL",1
37,"37329",40,36,36,2,0,"PREPAL",0
49,"49222",404,297,294,4,3,"PREPAL",1
49,"49269",241,171,170,5,1,"PREPAL",0
49,"49138",269,190,189,0,1,"PREPAL",0
24,"24118",132,96,96,2,0,"PREPAL",0
49,"49152",572,401,395,6,6,"PREPAL",1
49,"49264",652,439,435,2,4,"PREPAL",1
24,"24151",514,391,387,6,4,"PREPAL",0
24,"24044",176,138,136,2,2,"PREPAL",0
37,"37197",101,72,70,1,2,"PREPAL",0
37,"37081",1000,807,800,5,7,"PREPAL",1
24,"24092",883,707,702,6,5,"PREPAL",1
24,"24176",336,267,261,3,6,"PREPAL",2
24,"24152",481,326,322,5,4,"PREPAL",0
49,"49230",122,98,95,1,3,"PREPAL",0
49,"49077",210,146,144,1,2,"PREPAL",1
37,"37123",206,166,165,1,1,"PREPAL",0
4,"4089",805,607,597,1,10,"PRAO",0
18,"18123",307,239,238,1,1,"PRAO",1
4,"4095",777,547,541,8,6,"PRAO",0
18,"18909",668,536,534,2,2,"PRAO",0
4,"4902",42901,28927,28711,338,216,"PRAO",27
18,"18006",4116,2862,2831,25,31,"PRAO",4
18,"18005",366,279,277,3,2,"PRAO",0
18,"18174",470,368,363,1,5,"PRAO",0
18,"18045",1211,892,885,4,7,"PRAO",8
18,"18119",1778,1401,1391,14,10,"PRAO",2
18,"18071",5589,4268,4205,44,63,"PRAO",17
18,"18010",576,464,458,4,6,"PRAO",0
4,"4100",7918,5465,5425,52,40,"PRAO",2
23,"23030",1270,1052,1045,3,7,"PRAO",0
4,"4004",458,367,364,6,3,"PRAO",0
18,"18906",955,736,731,5,5,"PRAO",0
18,"18151",276,191,188,0,3,"PRAO",0
23,"23037",513,430,424,3,6,"PRAO",0
23,"23064",1680,1483,1478,8,5,"PRAO",0
4,"4060",486,373,372,0,1,"PRAO",0
4,"4045",1877,1512,1497,23,15,"PRAO",2
18,"18192",1581,1331,1318,6,13,"PRAO",0
18,"18069",506,375,371,4,4,"PRAO",1
4,"4101",3927,2827,2804,34,23,"PRAO",1
23,"23015",1476,1189,1179,10,10,"PRAO",1
23,"23014",2529,2058,2039,13,19,"PRAO",0
23,"23057",823,717,711,4,6,"PRAO",5
23,"23050",91354,68649,67925,990,724,"PRAO",473
18,"18148",874,714,706,6,8,"PRAO",0
4,"4061",668,541,536,7,5,"PRAO",0
23,"23067",2523,2004,1974,16,30,"PRAO",1
4,"4046",826,645,634,4,11,"PRAO",0
18,"18162",947,726,721,8,5,"PRAO",0
4,"4063",1199,871,862,6,9,"PRAO",0
18,"18180",655,450,447,1,3,"PRAO",0
18,"18082",912,691,683,8,8,"PRAO",0
18,"18171",2093,1719,1704,10,15,"PRAO",0
4,"4052",11567,8189,8124,158,65,"PRAO",7
4,"4001",1139,890,884,6,6,"PRAO",0
4,"4010",602,492,491,10,1,"PRAO",0
18,"18141",484,326,325,1,1,"PRAO",0
18,"18128",361,284,283,5,1,"PRAO",0
23,"23016",442,355,354,5,1,"PRAO",0
18,"18013",4392,3268,3223,23,45,"PRAO",3
23,"23009",12876,10335,10231,109,104,"PRAO",10
4,"4023",144,116,116,2,0,"PRAO",0
23,"23075",3404,2800,2782,24,18,"PRAO",4
4,"4015",149,115,115,0,0,"PRAO",0
4,"4027",260,186,186,0,0,"PRAO",0
4,"4090",435,338,335,3,3,"PRAO",0
18,"18027",2575,1913,1899,15,14,"PRAO",0
23,"23034",2591,2146,2124,13,22,"PRAO",0
18,"18039",3733,2901,2878,18,23,"PRAO",1
18,"18034",510,377,375,2,2,"PRAO",0
18,"18111",2647,1957,1941,24,16,"PRAO",3
18,"18134",5528,3751,3679,57,72,"PRAO",7
18,"18121",135,109,109,0,0,"PRAO",0
23,"23005",30698,23126,22916,310,210,"PRAO",28
18,"18033",282,227,226,0,1,"PRAO",0
4,"4038",3140,2258,2231,44,27,"PRAO",0
23,"23046",2441,2049,2027,13,22,"PRAO",1
23,"23031",771,649,646,6,3,"PRAO",0
18,"18157",1062,793,783,9,10,"PRAO",2
4,"4097",299,229,227,0,2,"PRAO",0
18,"18048",2277,1705,1688,19,17,"PRAO",1
23,"23094",3917,3200,3166,32,34,"PRAO",1
18,"18911",6796,4923,4867,74,56,"PRAO",7
18,"18194",2258,1656,1652,11,4,"PRAO",1
18,"18061",1109,882,869,1,13,"PRAO",0
4,"4078",1069,837,832,6,5,"PRAO",0
18,"18099",1551,1217,1205,11,12,"PRAO",0
4,"4005",631,531,524,6,7,"PRAO",0
18,"18102",8556,6358,6272,42,86,"PRAO",0
18,"18042",425,344,342,2,2,"PRAO",0
23,"23073",4671,3778,3735,19,43,"PRAO",6
4,"4020",361,265,263,1,2,"PRAO",1
23,"23074",3039,2491,2451,29,40,"PRAO",3
18,"18049",632,476,474,5,2,"PRAO",0
4,"4049",4981,3652,3630,34,22,"PRAO",1
18,"18096",348,289,287,1,2,"PRAO",0
4,"4028",239,212,207,0,5,"PRAO",0
23,"23041",519,455,448,2,7,"PRAO",0
18,"18124",387,270,267,0,3,"PRAO",0
4,"4035",8213,6218,6171,51,47,"PRAO",2
4,"4056",144,118,118,0,0,"PRAO",0
18,"18161",220,180,178,0,2,"PRAO",0
4,"4032",5476,3666,3643,34,23,"PRAO",6
18,"18025",326,242,238,0,4,"PRAO",0
18,"18015",465,381,379,1,2,"PRAO",0
4,"4077",343,313,313,1,0,"PRAO",0
4,"4064",2585,1817,1803,18,14,"PRAO",0
23,"23060",19107,14365,14264,130,101,"PRAO",13
23,"23020",1623,1414,1400,16,14,"PRAO",1
23,"23096",2678,2298,2276,18,22,"PRAO",2
18,"18016",339,254,253,2,1,"PRAO",0
23,"23058",8497,6642,6591,44,51,"PRAO",9
18,"18185",608,484,479,2,5,"PRAO",0
23,"23098",923,808,807,6,1,"PRAO",2
4,"4071",452,364,363,1,1,"PRAO",0
4,"4085",453,384,383,0,1,"PRAO",0
4,"4019",269,210,209,3,1,"PRAO",1
18,"18158",10328,7336,7254,69,82,"PRAO",3
18,"18103",803,653,647,5,6,"PRAO",0
18,"18024",882,696,688,12,8,"PRAO",0
23,"23095",8882,6668,6628,31,40,"PRAO",2
18,"18085",818,538,532,4,6,"PRAO",0
23,"23084",1046,817,812,4,5,"PRAO",0
18,"18147",3742,2419,2386,20,33,"PRAO",4
18,"18145",10083,7592,7499,78,93,"PRAO",14
23,"23079",3750,3084,3063,19,21,"PRAO",2
4,"4012",230,195,195,2,0,"PRAO",0
4,"4070",1649,1267,1255,9,12,"PRAO",1
18,"18183",685,502,500,3,2,"PRAO",0
18,"18056",3695,2961,2940,25,21,"PRAO",0
18,"18182",1982,1405,1397,6,8,"PRAO",1
18,"18150",6452,4666,4625,56,41,"PRAO",53
4,"4098",1616,1255,1249,7,6,"PRAO",0
23,"23088",6177,4955,4872,94,83,"PRAO",9
18,"18003",13486,10245,10100,145,145,"PRAO",9
18,"18122",16253,12271,12109,132,162,"PRAO",7
23,"23086",11411,8918,8798,129,120,"PRAO",4
23,"23097",6510,4687,4639,36,48,"PRAO",10
4,"4093",1869,1341,1334,10,7,"PRAO",0
18,"18127",15897,11597,11483,133,114,"PRAO",22
18,"18018",658,520,514,4,6,"PRAO",0
23,"23093",3313,2706,2673,13,33,"PRAO",2
18,"18902",950,769,762,6,7,"PRAO",0
18,"18036",3553,2762,2741,20,21,"PRAO",4
23,"23904",3070,2047,2033,19,14,"PRAO",0
18,"18084",3954,3039,3015,50,24,"PRAO",2
18,"18154",1062,770,769,0,1,"PRAO",0
18,"18137",1057,875,868,8,7,"PRAO",0
18,"18001",288,212,212,1,0,"PRAO",1
4,"4008",530,423,418,4,5,"PRAO",0
23,"23040",1538,1319,1311,3,8,"PRAO",1
4,"4903",4331,3183,3164,31,19,"PRAO",1
23,"23063",3960,3073,3037,21,36,"PRAO",0
23,"23017",1668,1392,1377,10,15,"PRAO",0
23,"23006",4644,3913,3871,36,42,"PRAO",4
4,"4079",45851,31893,31644,430,249,"PRAO",29
18,"18012",2693,1841,1831,11,10,"PRAO",1
4,"4096",293,220,219,1,1,"PRAO",0
4,"4057",1454,1081,1071,1,10,"PRAO",0
18,"18136",1973,1679,1668,5,11,"PRAO",0
18,"18028",992,826,821,4,5,"PRAO",0
23,"23903",3537,2892,2877,12,15,"PRAO",1
23,"23054",393,288,286,1,2,"PRAO",0
18,"18903",960,761,753,1,8,"PRAO",0
18,"18184",2140,1663,1645,18,18,"PRAO",0
18,"18146",1059,791,776,2,15,"PRAO",1
4,"4048",1459,1110,1100,11,10,"PRAO",0
18,"18095",1916,1428,1306,21,122,"PRAO",5
23,"23053",9431,7160,7128,42,32,"PRAO",0
18,"18007",808,602,591,5,11,"PRAO",0
18,"18115",2380,1843,1823,14,20,"PRAO",1
4,"4074",2731,1959,1936,26,23,"PRAO",1
18,"18107",988,769,760,3,9,"PRAO",0
18,"18002",625,505,504,2,1,"PRAO",0
18,"18076",880,676,676,3,0,"PRAO",0
18,"18108",892,674,673,2,1,"PRAO",0
23,"23049",1942,1514,1486,16,28,"PRAO",2
4,"4901",576,427,426,5,1,"PRAO",0
18,"18043",140,89,87,1,2,"PRAO",0
4,"4002",1146,891,884,1,7,"PRAO",0
4,"4084",370,290,285,6,5,"PRAO",1
4,"4082",309,216,214,3,2,"PRAO",0
18,"18117",535,444,440,2,4,"PRAO",1
23,"23004",478,416,415,1,1,"PRAO",0
18,"18068",1456,1105,1088,13,17,"PRAO",3
23,"23029",924,730,727,2,3,"PRAO",0
4,"4022",375,296,295,0,1,"PRAO",1
18,"18097",1022,758,752,4,6,"PRAO",1
23,"23072",2063,1661,1643,16,18,"PRAO",2
23,"23099",4649,3638,3594,39,44,"PRAO",3
18,"18167",1927,1397,1380,13,17,"PRAO",1
18,"18173",8858,6238,6187,64,51,"PRAO",4
18,"18079",3497,2729,2706,15,23,"PRAO",0
18,"18063",1189,795,789,7,6,"PRAO",0
23,"23076",831,681,671,5,10,"PRAO",0
18,"18908",827,669,660,7,9,"PRAO",0
18,"18105",5222,3866,3839,32,27,"PRAO",1
18,"18905",12975,9260,9209,155,51,"PRAO",9
4,"4009",165,124,122,2,2,"PRAO",0
18,"18189",723,547,541,6,6,"PRAO",0
23,"23044",4897,3943,3893,13,50,"PRAO",5
4,"4068",187,137,137,1,0,"PRAO",0
4,"4062",4604,3711,3654,22,57,"PRAO",3
4,"4003",17244,11933,11840,94,93,"PRAO",2
23,"23027",763,619,616,1,3,"PRAO",2
18,"18187",587,432,432,0,0,"PRAO",0
4,"4075",4783,3731,3700,33,31,"PRAO",1
4,"4059",1231,837,830,8,7,"PRAO",0
4,"4034",152,106,105,1,1,"PRAO",0
18,"18059",4055,3232,3191,37,41,"PRAO",3
18,"18177",463,285,281,4,4,"PRAO",0
4,"4067",657,526,524,1,2,"PRAO",0
18,"18133",2256,1783,1773,12,10,"PRAO",0
23,"23059",5974,4910,4852,37,58,"PRAO",1
23,"23039",2239,1799,1764,9,35,"PRAO",1
18,"18011",4246,3195,3172,23,23,"PRAO",0
23,"23028",6428,4855,4802,26,53,"PRAO",4
18,"18050",1657,1209,1196,5,13,"PRAO",2
23,"23052",1186,1012,997,1,15,"PRAO",0
4,"4080",194,169,168,1,1,"PRAO",0
4,"4094",206,152,152,0,0,"PRAO",0
23,"23021",541,464,453,0,11,"PRAO",0
23,"23035",1066,919,912,3,7,"PRAO",0
23,"23007",3116,2483,2458,15,25,"PRAO",1
23,"23090",1371,1188,1177,6,11,"PRAO",0
23,"23045",2180,1671,1667,3,4,"PRAO",0
18,"18067",704,526,521,1,5,"PRAO",0
18,"18054",879,646,644,4,2,"PRAO",0
18,"18098",6440,4743,4679,44,64,"PRAO",5
4,"4086",1903,1376,1371,11,5,"PRAO",2
4,"4031",2495,1942,1931,13,11,"PRAO",0
18,"18165",3942,2819,2776,27,43,"PRAO",12
4,"4053",12062,9283,9180,119,103,"PRAO",6
4,"4007",791,599,599,5,0,"PRAO",0
23,"23019",1590,1355,1339,7,16,"PRAO",0
23,"23024",12634,9916,9673,116,243,"PRAO",5
4,"4081",367,312,309,0,3,"PRAO",0
18,"18193",13680,9874,9764,130,110,"PRAO",9
18,"18087",187449,138136,136783,1548,1353,"PRAO",239
18,"18064",419,347,345,3,2,"PRAO",0
18,"18093",2580,1837,1820,8,17,"PRAO",4
18,"18035",1254,991,982,7,9,"PRAO",0
4,"4051",476,406,400,3,6,"PRAO",0
18,"18120",274,238,237,2,1,"PRAO",0
18,"18032",248,166,166,2,0,"PRAO",0
23,"23043",554,411,407,6,4,"PRAO",1
4,"4041",334,247,245,0,2,"PRAO",0
18,"18029",1892,1355,1347,6,8,"PRAO",2
18,"18109",607,461,456,1,5,"PRAO",0
18,"18140",42971,28391,28126,335,265,"PRAO",20
18,"18170",377,238,237,0,1,"PRAO",0
23,"23001",1058,922,920,6,2,"PRAO",2
18,"18074",297,245,245,5,0,"PRAO",0
18,"18901",583,374,368,3,6,"PRAO",0
18,"18047",5603,3833,3805,67,28,"PRAO",6
4,"4030",1222,930,924,5,6,"PRAO",0
23,"23092",27970,20921,20651,284,270,"PRAO",18
4,"4055",418,368,367,5,1,"PRAO",0
23,"23069",5489,4656,4586,36,70,"PRAO",6
4,"4006",7156,5175,5106,51,69,"PRAO",3
18,"18038",1097,906,900,3,6,"PRAO",0
18,"18020",1473,1111,1106,7,5,"PRAO",1
4,"4050",818,611,602,5,9,"PRAO",2
4,"4011",2814,2283,2263,25,20,"PRAO",2
18,"18051",1196,857,852,4,5,"PRAO",0
18,"18004",818,601,594,2,7,"PRAO",0
18,"18086",397,321,321,3,0,"PRAO",0
23,"23047",1658,1342,1339,6,3,"PRAO",2
23,"23066",4348,3687,3654,21,33,"PRAO",1
4,"4091",380,322,318,3,4,"PRAO",0
18,"18176",265,183,181,0,2,"PRAO",0
18,"18030",612,457,456,0,1,"PRAO",0
18,"18053",1836,1345,1340,11,5,"PRAO",0
18,"18153",8348,6170,6118,88,52,"PRAO",5
18,"18089",15803,10794,10712,95,82,"PRAO",4
23,"23902",2495,2081,2067,4,14,"PRAO",1
23,"23008",1552,1280,1266,9,14,"PRAO",0
18,"18179",583,417,409,7,8,"PRAO",0
18,"18164",1881,1351,1342,16,9,"PRAO",0
18,"18910",832,601,594,6,7,"PRAO",0
4,"4103",1555,1159,1157,8,2,"PRAO",1
23,"23038",3273,2658,2638,29,20,"PRAO",3
4,"4033",161,120,119,1,1,"PRAO",0
4,"4014",162,136,136,0,0,"PRAO",2
4,"4047",2290,1956,1937,9,19,"PRAO",1
23,"23018",2415,1791,1781,9,10,"PRAO",2
23,"23048",884,691,679,6,12,"PRAO",1
23,"23085",2350,1963,1956,8,7,"PRAO",0
23,"23011",2227,1644,1620,25,24,"PRAO",0
23,"23010",14447,10777,10704,109,73,"PRAO",7
18,"18132",3461,2797,2772,19,25,"PRAO",0
18,"18021",16026,11376,11219,186,157,"PRAO",11
4,"4044",1517,1232,1224,8,8,"PRAO",1
18,"18083",296,242,242,1,0,"PRAO",0
18,"18040",246,147,146,0,1,"PRAO",1
4,"4021",188,157,157,2,0,"PRAO",0
23,"23065",1701,1238,1226,10,12,"PRAO",0
18,"18037",488,408,404,0,4,"PRAO",0
4,"4073",389,289,286,4,3,"PRAO",0
18,"18022",12448,8777,8659,111,118,"PRAO",9
4,"4099",5086,4023,3980,26,43,"PRAO",2
18,"18070",287,240,239,2,1,"PRAO",1
23,"23077",668,523,518,2,5,"PRAO",1
23,"23025",2845,2292,2271,17,21,"PRAO",1
4,"4036",246,205,204,1,1,"PRAO",0
18,"18163",327,246,238,0,8,"PRAO",0
18,"18178",834,685,683,3,2,"PRAO",1
23,"23012",4250,3235,3216,19,19,"PRAO",3
23,"23055",48167,33913,33612,400,301,"PRAO",185
23,"23101",413,324,321,3,3,"PRAO",0
4,"4102",12940,9247,9152,90,95,"PRAO",6
23,"23082",1985,1464,1451,9,13,"PRAO",0
18,"18114",678,508,508,6,0,"PRAO",1
23,"23026",3872,3051,2994,23,57,"PRAO",2
4,"4016",2184,1699,1677,15,22,"PRAO",2
18,"18135",4752,3252,3212,34,40,"PRAO",2
23,"23087",11474,9197,9123,90,74,"PRAO",7
18,"18188",1659,1329,1308,9,21,"PRAO",0
4,"4088",2516,1849,1832,7,17,"PRAO",2
23,"23062",1476,1274,1264,2,10,"PRAO",0
4,"4013",137455,94867,94142,1203,725,"PRAO",98
23,"23042",359,278,277,0,1,"PRAO",0
18,"18066",2072,1558,1552,8,6,"PRAO",1
18,"18181",253,183,182,0,1,"PRAO",0
23,"23080",1832,1425,1414,3,11,"PRAO",2
23,"23901",1194,1048,1045,8,3,"PRAO",1
4,"4029",10682,7542,7474,63,68,"PRAO",7
23,"23061",7309,5637,5584,60,53,"PRAO",4
23,"23056",3182,2539,2523,20,16,"PRAO",1
23,"23003",8778,6945,6877,51,68,"PRAO",7
4,"4058",402,324,322,5,2,"PRAO",0
4,"4092",2897,2351,2325,13,26,"PRAO",2
18,"18072",710,507,499,2,8,"PRAO",0
4,"4066",13570,9018,8963,97,55,"PRAO",10
18,"18912",1576,1193,1185,7,8,"PRAO",1
4,"4069",4729,3740,3706,52,34,"PRAO",3
4,"4083",1933,1511,1497,16,14,"PRAO",0
4,"4024",3049,2396,2361,19,35,"PRAO",2
18,"18116",2972,2237,2213,19,24,"PRAO",3
18,"18100",7304,5807,5737,62,70,"PRAO",4
18,"18126",1461,1129,1121,15,8,"PRAO",1
18,"18112",132,90,90,1,0,"PRAO",0
18,"18023",16072,11594,11488,131,106,"PRAO",4
18,"18017",17990,12070,11962,80,108,"PRAO",9
18,"18078",768,638,637,1,1,"PRAO",0
23,"23905",1884,1447,1438,4,9,"PRAO",1
18,"18149",5096,3949,3900,36,49,"PRAO",5
18,"18094",2398,1882,1868,16,14,"PRAO",0
18,"18907",1997,1627,1612,5,15,"PRAO",1
4,"4072",339,272,271,0,1,"PRAO",0
18,"18062",9418,6916,6835,62,81,"PRAO",17
23,"23071",1811,1444,1431,13,13,"PRAO",2
18,"18138",2460,1751,1741,1,10,"PRAO",3
18,"18159",1051,873,869,4,4,"PRAO",0
18,"18904",858,620,612,3,8,"PRAO",0
18,"18101",8990,6659,6556,96,103,"PRAO",3
18,"18044",208,132,132,4,0,"PRAO",0
18,"18152",1037,822,818,9,4,"PRAO",0
23,"23091",790,668,664,3,4,"PRAO",0
23,"23002",17740,14007,13858,171,149,"PRAO",23
23,"23032",598,518,515,0,3,"PRAO",0
4,"4026",75,58,58,0,0,"PRAO",0
18,"18144",779,592,590,3,2,"PRAO",0
18,"18168",864,613,605,4,8,"PRAO",1
23,"23081",1643,1245,1234,12,11,"PRAO",2
4,"4054",384,328,325,0,3,"PRAO",0
23,"23070",4142,2877,2846,20,31,"PRAO",2
4,"4087",198,162,159,2,3,"PRAO",0
18,"18057",5045,3755,3721,44,34,"PRAO",2
23,"23033",1382,1166,1152,7,14,"PRAO",1
18,"18175",11534,8772,8698,68,74,"PRAO",6
18,"18088",1576,1258,1253,2,5,"PRAO",0
18,"18046",1960,1327,1312,5,15,"PRAO",0
18,"18014",5667,4132,4085,43,47,"PRAO",6
23,"23051",2805,2312,2290,8,22,"PRAO",0
18,"18143",949,722,704,2,18,"PRAO",5
4,"4017",1337,965,960,7,5,"PRAO",1
4,"4043",520,439,435,3,4,"PRAO",0
4,"4037",1393,1090,1079,8,11,"PRAO",1
18,"18913",827,653,646,2,7,"PRAO",0
4,"4018",293,250,245,2,5,"PRAO",0
4,"4076",1325,1050,1041,7,9,"PRAO",0
4,"4065",387,320,318,1,2,"PRAO",0
20,"20001",249,167,167,4,0,"PSE-EE (PSOE)",5
1,"1033",679,537,532,2,5,"PSE-EE (PSOE)",88
48,"48031",370,296,296,1,0,"PSE-EE (PSOE)",4
48,"48012",2036,1630,1616,9,14,"PSE-EE (PSOE)",73
48,"48049",564,446,446,2,0,"PSE-EE (PSOE)",5
48,"48023",601,499,492,4,7,"PSE-EE (PSOE)",18
20,"20018",11027,7428,7387,53,41,"PSE-EE (PSOE)",459
1,"1049",147,115,115,1,0,"PSE-EE (PSOE)",16
20,"20022",832,527,521,9,6,"PSE-EE (PSOE)",24
48,"48027",21610,15409,15274,145,135,"PSE-EE (PSOE)",2513
48,"48904",3510,2682,2665,26,17,"PSE-EE (PSOE)",336
48,"48002",7971,5377,5290,65,87,"PSE-EE (PSOE)",1448
48,"48035",379,304,301,0,3,"PSE-EE (PSOE)",8
48,"48003",14142,10268,10167,84,101,"PSE-EE (PSOE)",1655
48,"48908",242,194,194,1,0,"PSE-EE (PSOE)",4
48,"48019",3741,2613,2595,24,18,"PSE-EE (PSOE)",446
1,"1016",461,241,237,2,4,"PSE-EE (PSOE)",28
1,"1006",181,133,127,2,6,"PSE-EE (PSOE)",23
48,"48001",5842,4040,4020,23,20,"PSE-EE (PSOE)",788
48,"48915",362,273,271,2,2,"PSE-EE (PSOE)",4
20,"20054",476,350,348,1,2,"PSE-EE (PSOE)",1
20,"20031",179,114,113,1,1,"PSE-EE (PSOE)",3
20,"20039",2003,1517,1512,9,5,"PSE-EE (PSOE)",64
48,"48056",849,610,608,3,2,"PSE-EE (PSOE)",20
48,"48083",7021,4722,4656,74,66,"PSE-EE (PSOE)",1460
48,"48006",285,246,243,3,3,"PSE-EE (PSOE)",11
48,"48046",12635,9231,9161,61,70,"PSE-EE (PSOE)",898
20,"20044",368,258,257,1,1,"PSE-EE (PSOE)",18
1,"1037",625,403,398,6,5,"PSE-EE (PSOE)",36
20,"20026",214,172,172,0,0,"PSE-EE (PSOE)",1
1,"1032",536,412,400,0,12,"PSE-EE (PSOE)",85
20,"20051",7033,4843,4779,57,64,"PSE-EE (PSOE)",974
1,"1046",629,428,421,5,7,"PSE-EE (PSOE)",59
48,"48091",1170,860,851,3,9,"PSE-EE (PSOE)",82
20,"20007",300,203,202,2,1,"PSE-EE (PSOE)",3
20,"20006",277,177,175,6,2,"PSE-EE (PSOE)",1
48,"48043",4256,3066,3040,33,26,"PSE-EE (PSOE)",307
20,"20080",8104,5497,5454,52,43,"PSE-EE (PSOE)",1838
48,"48017",13554,9303,9234,64,69,"PSE-EE (PSOE)",557
20,"20064",12380,7568,7464,112,104,"PSE-EE (PSOE)",1782
20,"20047",494,321,319,2,2,"PSE-EE (PSOE)",22
20,"20059",8816,6335,6293,32,42,"PSE-EE (PSOE)",556
48,"48094",3299,2398,2377,15,21,"PSE-EE (PSOE)",147
48,"48071",6097,4307,4224,61,83,"PSE-EE (PSOE)",1041
48,"48033",223,171,171,1,0,"PSE-EE (PSOE)",2
20,"20004",254,153,153,5,0,"PSE-EE (PSOE)",9
48,"48079",470,391,391,2,0,"PSE-EE (PSOE)",4
48,"48912",2340,1794,1776,22,18,"PSE-EE (PSOE)",286
20,"20043",1782,1220,1214,13,6,"PSE-EE (PSOE)",43
48,"48076",294,226,226,0,0,"PSE-EE (PSOE)",3
48,"48009",767,585,580,4,5,"PSE-EE (PSOE)",16
20,"20907",136,94,94,0,0,"PSE-EE (PSOE)",3
48,"48024",1026,845,841,3,4,"PSE-EE (PSOE)",16
20,"20063",7889,5381,5340,48,41,"PSE-EE (PSOE)",351
48,"48072",1009,796,787,3,9,"PSE-EE (PSOE)",40
48,"48086",2087,1432,1420,11,12,"PSE-EE (PSOE)",207
48,"48026",1093,881,875,3,6,"PSE-EE (PSOE)",9
48,"48061",773,585,582,6,3,"PSE-EE (PSOE)",39
48,"48005",93,65,64,0,1,"PSE-EE (PSOE)",4
20,"20903",3625,2282,2267,52,15,"PSE-EE (PSOE)",287
1,"1018",1395,952,943,7,9,"PSE-EE (PSOE)",140
20,"20068",199,132,129,2,3,"PSE-EE (PSOE)",1
20,"20020",143,104,104,1,0,"PSE-EE (PSOE)",0
48,"48053",856,683,680,8,3,"PSE-EE (PSOE)",41
48,"48020",276378,191777,190141,2335,1636,"PSE-EE (PSOE)",41678
1,"1027",430,283,276,4,7,"PSE-EE (PSOE)",28
48,"48090",6153,4682,4571,40,111,"PSE-EE (PSOE)",1067
20,"20055",17856,11885,11791,91,94,"PSE-EE (PSOE)",2607
20,"20015",1307,980,979,13,1,"PSE-EE (PSOE)",25
48,"48085",9893,6960,6885,93,75,"PSE-EE (PSOE)",1052
48,"48093",893,707,695,1,12,"PSE-EE (PSOE)",46
20,"20072",4643,2967,2948,46,19,"PSE-EE (PSOE)",757
20,"20027",2809,1929,1918,25,11,"PSE-EE (PSOE)",113
48,"48907",351,290,290,1,0,"PSE-EE (PSOE)",6
48,"48036",23973,16491,16344,179,147,"PSE-EE (PSOE)",3171
1,"1044",242,174,173,1,1,"PSE-EE (PSOE)",30
20,"20019",10105,6640,6555,73,85,"PSE-EE (PSOE)",1335
20,"20056",3975,2692,2669,17,23,"PSE-EE (PSOE)",154
48,"48075",1915,1362,1325,15,37,"PSE-EE (PSOE)",54
48,"48050",216,173,172,0,1,"PSE-EE (PSOE)",5
1,"1010",2276,1649,1618,27,31,"PSE-EE (PSOE)",167
20,"20902",14148,9874,9798,120,76,"PSE-EE (PSOE)",3309
20,"20014",1101,660,654,8,6,"PSE-EE (PSOE)",37
1,"1055",906,632,623,7,9,"PSE-EE (PSOE)",80
48,"48008",600,432,428,3,4,"PSE-EE (PSOE)",22
20,"20071",14488,9499,9419,93,80,"PSE-EE (PSOE)",1259
20,"20040",15103,9781,9686,148,95,"PSE-EE (PSOE)",1755
48,"48087",463,371,370,4,1,"PSE-EE (PSOE)",37
20,"20012",149,97,97,0,0,"PSE-EE (PSOE)",4
48,"48039",263,217,216,4,1,"PSE-EE (PSOE)",4
1,"1028",1106,773,760,8,13,"PSE-EE (PSOE)",141
1,"1002",8057,5854,5757,48,97,"PSE-EE (PSOE)",1042
20,"20038",382,281,280,1,1,"PSE-EE (PSOE)",7
20,"20073",4689,3196,3176,28,20,"PSE-EE (PSOE)",388
1,"1020",317,222,220,0,2,"PSE-EE (PSOE)",12
1,"1023",290,236,235,1,1,"PSE-EE (PSOE)",35
1,"1014",385,281,274,6,7,"PSE-EE (PSOE)",36
48,"48082",38551,25768,25482,316,286,"PSE-EE (PSOE)",7640
20,"20046",1157,734,729,6,5,"PSE-EE (PSOE)",82
48,"48905",2600,1903,1869,14,34,"PSE-EE (PSOE)",251
48,"48073",7090,4865,4802,37,63,"PSE-EE (PSOE)",195
20,"20075",4447,2823,2798,32,25,"PSE-EE (PSOE)",383
20,"20002",347,237,237,8,0,"PSE-EE (PSOE)",5
20,"20036",12731,8519,8431,131,88,"PSE-EE (PSOE)",1290
48,"48004",329,240,239,2,1,"PSE-EE (PSOE)",2
20,"20061",4011,2666,2653,23,13,"PSE-EE (PSOE)",286
48,"48067",1204,895,892,4,3,"PSE-EE (PSOE)",31
1,"1004",1427,1021,996,15,25,"PSE-EE (PSOE)",118
48,"48016",5214,3782,3736,46,46,"PSE-EE (PSOE)",578
1,"1039",211,164,158,1,6,"PSE-EE (PSOE)",44
48,"48060",3689,2477,2466,12,11,"PSE-EE (PSOE)",80
20,"20906",117,89,89,0,0,"PSE-EE (PSOE)",1
1,"1051",3662,2242,2210,26,32,"PSE-EE (PSOE)",340
1,"1011",245,189,185,7,4,"PSE-EE (PSOE)",21
48,"48054",23712,16643,16439,215,204,"PSE-EE (PSOE)",3557
48,"48013",81335,54452,53803,771,649,"PSE-EE (PSOE)",17707
48,"48070",559,413,407,1,6,"PSE-EE (PSOE)",0
20,"20030",22191,15262,15148,164,114,"PSE-EE (PSOE)",4310
48,"48911",373,300,296,1,4,"PSE-EE (PSOE)",2
20,"20079",17229,12010,11927,143,83,"PSE-EE (PSOE)",1904
20,"20067",31173,20218,20017,270,201,"PSE-EE (PSOE)",5930
1,"1058",1342,877,872,8,5,"PSE-EE (PSOE)",118
48,"48045",5060,3912,3849,31,63,"PSE-EE (PSOE)",590
1,"1021",473,332,324,3,8,"PSE-EE (PSOE)",39
1,"1043",2322,1623,1595,12,28,"PSE-EE (PSOE)",373
20,"20066",467,316,316,0,0,"PSE-EE (PSOE)",4
20,"20032",8949,6189,6117,55,72,"PSE-EE (PSOE)",1156
48,"48038",1087,826,821,7,5,"PSE-EE (PSOE)",37
20,"20076",6978,4823,4762,38,61,"PSE-EE (PSOE)",865
1,"1059",183468,127839,125801,1422,2038,"PSE-EE (PSOE)",32201
1,"1041",159,116,113,1,3,"PSE-EE (PSOE)",8
48,"48058",977,706,700,2,6,"PSE-EE (PSOE)",74
1,"1008",781,566,546,7,20,"PSE-EE (PSOE)",78
20,"20037",100,65,64,2,1,"PSE-EE (PSOE)",1
48,"48074",3384,2441,2397,20,44,"PSE-EE (PSOE)",247
48,"48042",1401,1116,1099,15,17,"PSE-EE (PSOE)",96
1,"1054",959,680,675,8,5,"PSE-EE (PSOE)",74
48,"48041",721,588,585,9,3,"PSE-EE (PSOE)",31
20,"20033",884,650,641,4,9,"PSE-EE (PSOE)",36
48,"48028",767,623,621,1,2,"PSE-EE (PSOE)",5
20,"20060",92,83,82,0,1,"PSE-EE (PSOE)",0
48,"48063",355,287,287,6,0,"PSE-EE (PSOE)",5
1,"1034",177,140,137,1,3,"PSE-EE (PSOE)",33
1,"1003",1199,863,848,2,15,"PSE-EE (PSOE)",33
48,"48059",397,289,286,0,3,"PSE-EE (PSOE)",9
20,"20074",11660,8003,7951,31,52,"PSE-EE (PSOE)",1066
1,"1019",155,124,124,0,0,"PSE-EE (PSOE)",6
20,"20034",3192,2035,2030,11,5,"PSE-EE (PSOE)",462
48,"48025",882,652,644,2,8,"PSE-EE (PSOE)",19
48,"48030",626,487,483,0,4,"PSE-EE (PSOE)",10
1,"1901",2254,1561,1528,24,33,"PSE-EE (PSOE)",413
48,"48903",1909,1455,1430,4,25,"PSE-EE (PSOE)",96
48,"48078",39866,27311,26995,311,316,"PSE-EE (PSOE)",8872
20,"20023",451,260,259,2,1,"PSE-EE (PSOE)",17
1,"1057",266,212,212,2,0,"PSE-EE (PSOE)",9
48,"48057",5934,4407,4385,27,22,"PSE-EE (PSOE)",140
20,"20905",142,105,103,1,2,"PSE-EE (PSOE)",0
1,"1001",2010,1362,1336,26,26,"PSE-EE (PSOE)",280
48,"48064",599,490,490,1,0,"PSE-EE (PSOE)",17
1,"1052",240,191,191,1,0,"PSE-EE (PSOE)",47
48,"48014",1211,838,834,4,4,"PSE-EE (PSOE)",89
1,"1902",776,532,526,6,6,"PSE-EE (PSOE)",87
20,"20024",400,238,235,0,3,"PSE-EE (PSOE)",4
20,"20009",11794,7805,7725,103,80,"PSE-EE (PSOE)",2051
48,"48069",12381,8760,8672,66,88,"PSE-EE (PSOE)",921
20,"20042",3354,2131,2117,18,14,"PSE-EE (PSOE)",343
20,"20029",4283,3014,2998,26,16,"PSE-EE (PSOE)",288
48,"48018",905,591,587,8,4,"PSE-EE (PSOE)",12
48,"48010",427,303,300,2,3,"PSE-EE (PSOE)",9
20,"20035",497,346,344,1,2,"PSE-EE (PSOE)",16
1,"1042",915,678,661,1,17,"PSE-EE (PSOE)",41
48,"48051",225,157,156,0,1,"PSE-EE (PSOE)",34
48,"48092",792,603,600,5,3,"PSE-EE (PSOE)",51
1,"1062",333,236,232,5,4,"PSE-EE (PSOE)",42
48,"48029",8022,5488,5409,83,79,"PSE-EE (PSOE)",1614
48,"48034",13160,9290,9189,82,101,"PSE-EE (PSOE)",2970
48,"48062",317,263,262,1,1,"PSE-EE (PSOE)",1
48,"48914",324,278,276,0,2,"PSE-EE (PSOE)",3
20,"20078",1146,885,884,6,1,"PSE-EE (PSOE)",42
1,"1031",1229,916,899,13,17,"PSE-EE (PSOE)",144
48,"48022",2396,1524,1504,12,20,"PSE-EE (PSOE)",196
20,"20053",4830,2895,2868,36,27,"PSE-EE (PSOE)",489
20,"20904",98,67,66,0,1,"PSE-EE (PSOE)",1
1,"1061",155,122,122,2,0,"PSE-EE (PSOE)",13
20,"20049",4081,2741,2723,30,18,"PSE-EE (PSOE)",467
48,"48068",1577,1224,1213,4,11,"PSE-EE (PSOE)",37
1,"1056",256,183,181,1,2,"PSE-EE (PSOE)",16
48,"48037",727,528,519,2,9,"PSE-EE (PSOE)",54
20,"20052",1154,849,847,14,2,"PSE-EE (PSOE)",109
20,"20901",1468,951,947,13,4,"PSE-EE (PSOE)",147
48,"48901",4370,3156,3124,46,32,"PSE-EE (PSOE)",770
48,"48095",2367,1593,1577,20,16,"PSE-EE (PSOE)",335
20,"20010",1392,949,941,8,8,"PSE-EE (PSOE)",126
48,"48910",3063,2122,2104,14,18,"PSE-EE (PSOE)",447
48,"48088",148,110,109,0,1,"PSE-EE (PSOE)",0
1,"1022",826,615,602,6,13,"PSE-EE (PSOE)",166
48,"48077",3398,2490,2477,33,13,"PSE-EE (PSOE)",214
1,"1017",910,629,621,17,8,"PSE-EE (PSOE)",82
20,"20062",995,687,667,5,20,"PSE-EE (PSOE)",13
48,"48096",6607,5007,4900,54,107,"PSE-EE (PSOE)",895
20,"20011",1700,1265,1258,11,7,"PSE-EE (PSOE)",174
1,"1063",1803,1290,1284,18,6,"PSE-EE (PSOE)",168
1,"1036",15236,10511,10372,141,139,"PSE-EE (PSOE)",2189
48,"48007",354,254,253,1,1,"PSE-EE (PSOE)",2
48,"48044",63869,47453,47085,511,368,"PSE-EE (PSOE)",6509
48,"48909",194,163,163,0,0,"PSE-EE (PSOE)",0
1,"1009",1296,876,863,9,13,"PSE-EE (PSOE)",128
20,"20017",8670,5923,5890,27,33,"PSE-EE (PSOE)",804
20,"20005",1341,890,885,4,5,"PSE-EE (PSOE)",58
20,"20021",216,122,122,0,0,"PSE-EE (PSOE)",5
20,"20013",5331,3662,3637,33,25,"PSE-EE (PSOE)",539
48,"48015",34932,24209,23966,296,243,"PSE-EE (PSOE)",7256
48,"48081",1938,1449,1435,14,14,"PSE-EE (PSOE)",112
1,"1047",942,674,655,4,19,"PSE-EE (PSOE)",161
20,"20050",293,213,211,3,2,"PSE-EE (PSOE)",0
20,"20025",1174,814,803,4,11,"PSE-EE (PSOE)",21
48,"48080",10161,6901,6815,95,86,"PSE-EE (PSOE)",2200
48,"48089",2878,2120,2089,19,31,"PSE-EE (PSOE)",265
20,"20070",1109,817,815,4,2,"PSE-EE (PSOE)",15
1,"1053",590,341,333,4,8,"PSE-EE (PSOE)",22
20,"20065",3176,2156,2137,19,19,"PSE-EE (PSOE)",407
48,"48011",9742,6697,6628,82,69,"PSE-EE (PSOE)",1365
48,"48913",1231,936,922,10,14,"PSE-EE (PSOE)",100
48,"48055",2620,1954,1934,22,20,"PSE-EE (PSOE)",189
1,"1030",170,123,120,1,3,"PSE-EE (PSOE)",18
48,"48047",161,126,126,1,0,"PSE-EE (PSOE)",0
48,"48906",796,625,622,5,3,"PSE-EE (PSOE)",30
48,"48048",547,423,423,5,0,"PSE-EE (PSOE)",20
20,"20008",757,499,499,8,0,"PSE-EE (PSOE)",4
20,"20058",770,549,547,3,2,"PSE-EE (PSOE)",134
48,"48084",23491,15322,15084,213,238,"PSE-EE (PSOE)",5361
20,"20003",547,361,359,3,2,"PSE-EE (PSOE)",13
48,"48052",1526,1213,1205,7,8,"PSE-EE (PSOE)",30
1,"1013",711,477,474,1,3,"PSE-EE (PSOE)",37
20,"20057",194,122,122,0,0,"PSE-EE (PSOE)",2
48,"48040",1274,936,921,10,15,"PSE-EE (PSOE)",60
48,"48032",5864,4257,4223,32,34,"PSE-EE (PSOE)",576
20,"20069",146828,101992,101225,1287,767,"PSE-EE (PSOE)",24184
20,"20048",175,102,102,1,0,"PSE-EE (PSOE)",7
20,"20081",7346,4957,4925,35,32,"PSE-EE (PSOE)",869
48,"48065",3311,2340,2323,23,17,"PSE-EE (PSOE)",335
20,"20045",46542,30907,30536,425,371,"PSE-EE (PSOE)",9671
48,"48066",350,277,277,0,0,"PSE-EE (PSOE)",2
48,"48097",1359,936,915,9,21,"PSE-EE (PSOE)",166
48,"48021",1460,1024,1012,13,12,"PSE-EE (PSOE)",97
20,"20041",279,153,151,5,2,"PSE-EE (PSOE)",4
48,"48902",19232,12809,12633,182,176,"PSE-EE (PSOE)",3139
1,"1060",223,181,178,1,3,"PSE-EE (PSOE)",10
20,"20077",5382,3766,3741,42,25,"PSE-EE (PSOE)",850
20,"20028",2204,1400,1379,11,21,"PSE-EE (PSOE)",198
20,"20016",1526,937,932,4,5,"PSE-EE (PSOE)",20
31,"31008",97,64,63,1,1,"P.S.O.E.",10
9,"9123",31,27,27,0,0,"P.S.O.E.",6
9,"9108",399,287,283,5,4,"P.S.O.E.",88
50,"50193",635,483,465,3,18,"P.S.O.E.",149
5,"5049",440,335,330,8,5,"P.S.O.E.",57
18,"18121",135,109,109,0,0,"P.S.O.E.",52
24,"24029",840,590,579,11,11,"P.S.O.E.",261
37,"37178",107,88,87,0,1,"P.S.O.E.",21
34,"34146",60,42,40,1,2,"P.S.O.E.",6
44,"44137",215,165,163,5,2,"P.S.O.E.",33
39,"39031",1227,965,956,4,9,"P.S.O.E.",158
9,"9274",1160,924,914,14,10,"P.S.O.E.",288
26,"26129",1010,794,780,7,14,"P.S.O.E.",239
35,"35021",14982,9948,9749,138,199,"P.S.O.E.",2365
41,"41023",7901,6050,5972,45,78,"P.S.O.E.",2954
24,"24095",293,211,208,1,3,"P.S.O.E.",37
37,"37242",99,73,72,0,1,"P.S.O.E.",21
40,"40001",713,575,562,10,13,"P.S.O.E.",146
9,"9273",55,47,47,0,0,"P.S.O.E.",10
31,"31027",824,611,609,2,2,"P.S.O.E.",13
26,"26101",46,35,34,0,1,"P.S.O.E.",15
50,"50221",38,20,20,0,0,"P.S.O.E.",10
44,"44193",99,71,67,0,4,"P.S.O.E.",26
9,"9139",104,84,80,3,4,"P.S.O.E.",32
12,"12005",8066,5835,5441,116,394,"P.S.O.E.",1637
12,"12083",106,89,88,0,1,"P.S.O.E.",43
19,"19160",944,600,593,6,7,"P.S.O.E.",134
26,"26174",154,122,122,2,0,"P.S.O.E.",29
24,"24011",244,131,129,0,2,"P.S.O.E.",105
9,"9192",74,55,53,0,2,"P.S.O.E.",13
46,"46260",2576,2140,2106,24,34,"P.S.O.E.",617
46,"46204",6906,5426,5357,62,69,"P.S.O.E.",1754
19,"19018",189,145,138,2,7,"P.S.O.E.",26
7,"7047",2161,1447,1407,31,40,"P.S.O.E.",358
45,"45154",1459,1148,1140,12,8,"P.S.O.E.",297
46,"46200",1915,1625,1595,15,30,"P.S.O.E.",536
31,"31052",89,62,58,1,4,"P.S.O.E.",8
37,"37072",184,157,155,5,2,"P.S.O.E.",29
47,"47199",84,61,60,1,1,"P.S.O.E.",14
9,"9350",502,384,376,7,8,"P.S.O.E.",52
47,"47175",6562,5041,4957,62,84,"P.S.O.E.",1690
39,"39023",6048,4795,4747,43,48,"P.S.O.E.",1422
26,"26016",32,27,27,0,0,"P.S.O.E.",10
18,"18115",2380,1843,1823,14,20,"P.S.O.E.",896
3,"3016",91,67,66,1,1,"P.S.O.E.",11
37,"37138",212,174,169,5,5,"P.S.O.E.",41
9,"9388",32,25,24,2,1,"P.S.O.E.",11
6,"6052",3965,3176,3134,33,42,"P.S.O.E.",1026
47,"47218",983,776,767,7,9,"P.S.O.E.",300
26,"26044",60,48,46,1,2,"P.S.O.E.",15
33,"33018",2971,2139,2121,32,18,"P.S.O.E.",567
46,"46192",755,564,554,9,10,"P.S.O.E.",163
6,"6076",854,639,631,9,8,"P.S.O.E.",266
6,"6035",1048,879,871,5,8,"P.S.O.E.",351
22,"22165",515,409,403,9,6,"P.S.O.E.",132
16,"16111",171,130,128,0,2,"P.S.O.E.",55
49,"49030",96,78,77,2,1,"P.S.O.E.",5
37,"37216",300,270,266,2,4,"P.S.O.E.",53
9,"9239",52,42,42,1,0,"P.S.O.E.",6
6,"6136",1621,1300,1283,11,17,"P.S.O.E.",585
45,"45117",800,679,668,7,11,"P.S.O.E.",321
3,"3010",330,269,266,3,3,"P.S.O.E.",78
19,"19250",25,23,22,0,1,"P.S.O.E.",6
39,"39005",1319,1048,1026,3,22,"P.S.O.E.",192
9,"9197",160,129,128,3,1,"P.S.O.E.",25
26,"26132",130,98,96,2,2,"P.S.O.E.",33
37,"37018",128,89,87,0,2,"P.S.O.E.",15
24,"24173",1023,757,747,4,10,"P.S.O.E.",187
10,"10129",374,279,276,2,3,"P.S.O.E.",131
37,"37251",137,98,93,3,5,"P.S.O.E.",4
49,"49273",217,144,144,0,0,"P.S.O.E.",30
46,"46010",927,706,699,3,7,"P.S.O.E.",152
10,"10034",376,283,278,5,5,"P.S.O.E.",138
2,"2028",139,115,115,1,0,"P.S.O.E.",58
6,"6056",487,411,411,1,0,"P.S.O.E.",205
22,"22082",320,231,229,1,2,"P.S.O.E.",71
12,"12108",495,394,389,4,5,"P.S.O.E.",131
46,"46219",143,127,126,1,1,"P.S.O.E.",29
47,"47147",129,96,96,0,0,"P.S.O.E.",20
24,"24068",500,357,349,3,8,"P.S.O.E.",192
19,"19244",95,82,82,6,0,"P.S.O.E.",12
47,"47227",62,52,52,1,0,"P.S.O.E.",19
46,"46157",3068,2523,2491,17,32,"P.S.O.E.",620
23,"23088",6177,4955,4872,94,83,"P.S.O.E.",2366
22,"22061",6611,4789,4698,110,91,"P.S.O.E.",1535
37,"37203",174,148,148,0,0,"P.S.O.E.",41
31,"31062",1103,849,832,7,17,"P.S.O.E.",373
33,"33058",1863,1307,1286,11,21,"P.S.O.E.",481
10,"10134",585,420,412,1,8,"P.S.O.E.",134
34,"34161",23,20,20,0,0,"P.S.O.E.",3
37,"37226",167,129,127,1,2,"P.S.O.E.",18
22,"22027",351,251,250,8,1,"P.S.O.E.",95
50,"50210",39,28,24,0,4,"P.S.O.E.",8
19,"19057",79,56,56,0,0,"P.S.O.E.",30
31,"31051",270,182,181,8,1,"P.S.O.E.",53
40,"40012",280,215,213,2,2,"P.S.O.E.",71
22,"22244",61,46,44,1,2,"P.S.O.E.",21
50,"50250",58,43,43,4,0,"P.S.O.E.",12
31,"31102",162,80,78,0,2,"P.S.O.E.",5
22,"22151",97,71,71,0,0,"P.S.O.E.",12
37,"37204",286,216,214,0,2,"P.S.O.E.",41
40,"40082",131,111,110,5,1,"P.S.O.E.",16
3,"3057",232,179,178,0,1,"P.S.O.E.",49
5,"5058",81,61,59,0,2,"P.S.O.E.",12
22,"22058",194,138,137,5,1,"P.S.O.E.",51
2,"2025",7496,6153,5985,69,168,"P.S.O.E.",1492
44,"44094",116,105,103,4,2,"P.S.O.E.",24
10,"10017",884,681,673,6,8,"P.S.O.E.",271
37,"37133",108,79,77,0,2,"P.S.O.E.",19
9,"9366",99,67,65,1,2,"P.S.O.E.",19
18,"18048",2277,1705,1688,19,17,"P.S.O.E.",749
12,"12071",1355,1069,1050,3,19,"P.S.O.E.",358
11,"11033",19983,12960,12807,199,153,"P.S.O.E.",4469
46,"46025",2495,1962,1941,24,21,"P.S.O.E.",516
41,"41065",23028,15133,14958,191,175,"P.S.O.E.",8562
3,"3002",3559,2747,2707,16,40,"P.S.O.E.",699
46,"46228",2434,1881,1859,30,22,"P.S.O.E.",459
34,"34220",145,125,123,0,2,"P.S.O.E.",38
45,"45190",502,425,414,6,11,"P.S.O.E.",166
37,"37270",201,159,158,0,1,"P.S.O.E.",20
16,"16160",76,54,53,1,1,"P.S.O.E.",21
9,"9394",805,594,588,13,6,"P.S.O.E.",190
10,"10043",866,636,622,1,14,"P.S.O.E.",351
37,"37276",188,136,135,0,1,"P.S.O.E.",29
19,"19195",41,30,30,1,0,"P.S.O.E.",13
2,"2033",1955,1565,1536,15,29,"P.S.O.E.",552
31,"31908",997,692,683,9,9,"P.S.O.E.",73
19,"19152",674,505,498,2,7,"P.S.O.E.",175
9,"9173",135,116,116,1,0,"P.S.O.E.",21
5,"5228",193,146,145,1,1,"P.S.O.E.",8
31,"31001",88,58,58,1,0,"P.S.O.E.",9
19,"19145",64,49,48,2,1,"P.S.O.E.",4
44,"44077",80,62,62,1,0,"P.S.O.E.",41
41,"41035",1171,898,889,12,9,"P.S.O.E.",492
45,"45088",2038,1379,1356,14,23,"P.S.O.E.",374
16,"16109",46,34,34,2,0,"P.S.O.E.",12
46,"46198",815,660,654,4,6,"P.S.O.E.",178
41,"41012",3115,2314,2271,29,43,"P.S.O.E.",1130
39,"39097",732,476,470,4,6,"P.S.O.E.",61
6,"6096",254,202,201,0,1,"P.S.O.E.",41
19,"19298",75,53,52,2,1,"P.S.O.E.",19
22,"22023",474,382,380,4,2,"P.S.O.E.",115
16,"16265",27,26,26,0,0,"P.S.O.E.",11
19,"19147",58,45,40,0,5,"P.S.O.E.",18
10,"10128",5805,4456,4336,50,120,"P.S.O.E.",1728
10,"10133",1247,1045,1028,7,17,"P.S.O.E.",691
10,"10028",125,88,88,0,0,"P.S.O.E.",35
49,"49214",720,560,558,6,2,"P.S.O.E.",145
5,"5115",590,458,450,1,8,"P.S.O.E.",86
37,"37275",136,98,98,0,0,"P.S.O.E.",47
6,"6085",3437,2566,2530,32,36,"P.S.O.E.",1227
38,"38016",1250,664,646,3,18,"P.S.O.E.",249
44,"44070",62,47,47,1,0,"P.S.O.E.",9
50,"50185",150,109,109,2,0,"P.S.O.E.",22
24,"24039",2157,1738,1727,30,11,"P.S.O.E.",506
6,"6152",1327,983,967,8,16,"P.S.O.E.",420
16,"16116",104,67,66,1,1,"P.S.O.E.",27
49,"49008",535,395,394,7,1,"P.S.O.E.",109
16,"16107",161,101,98,1,3,"P.S.O.E.",35
19,"19256",48,44,43,0,1,"P.S.O.E.",12
5,"5016",6231,4831,4763,56,68,"P.S.O.E.",1086
12,"12072",1191,1007,977,17,30,"P.S.O.E.",403
37,"37354",4828,3589,3522,76,67,"P.S.O.E.",860
2,"2022",431,346,343,1,3,"P.S.O.E.",69
34,"34156",56,48,48,2,0,"P.S.O.E.",8
22,"22003",148,117,116,2,1,"P.S.O.E.",25
45,"45004",603,497,494,6,3,"P.S.O.E.",153
19,"19258",103,81,81,0,0,"P.S.O.E.",18
18,"18051",1196,857,852,4,5,"P.S.O.E.",477
7,"7028",876,607,595,6,12,"P.S.O.E.",151
19,"19270",17,16,16,0,0,"P.S.O.E.",4
6,"6140",654,533,523,7,10,"P.S.O.E.",146
37,"37136",702,494,485,4,9,"P.S.O.E.",228
40,"40173",148,121,120,3,1,"P.S.O.E.",23
22,"22078",468,302,301,8,1,"P.S.O.E.",110
31,"31049",733,479,479,4,0,"P.S.O.E.",21
44,"44205",757,541,527,12,14,"P.S.O.E.",205
29,"29902",2577,1689,1665,20,24,"P.S.O.E.",920
16,"16211",462,317,313,2,4,"P.S.O.E.",113
47,"47043",330,267,264,1,3,"P.S.O.E.",102
9,"9421",269,189,189,5,0,"P.S.O.E.",40
37,"37055",132,112,107,2,5,"P.S.O.E.",27
41,"41099",4141,2818,2799,37,19,"P.S.O.E.",1374
9,"9085",486,348,339,8,9,"P.S.O.E.",114
5,"5107",74,54,53,0,1,"P.S.O.E.",11
16,"16088",125,103,103,1,0,"P.S.O.E.",44
37,"37228",388,339,336,2,3,"P.S.O.E.",143
9,"9175",143,99,98,0,1,"P.S.O.E.",8
37,"37170",1571,1122,1107,22,15,"P.S.O.E.",220
26,"26154",12,12,12,3,0,"P.S.O.E.",1
24,"24054",492,359,351,1,8,"P.S.O.E.",103
46,"46254",1085,847,834,12,13,"P.S.O.E.",277
6,"6097",2475,1934,1902,27,32,"P.S.O.E.",803
34,"34135",429,334,329,6,5,"P.S.O.E.",72
12,"12087",22,20,20,0,0,"P.S.O.E.",0
22,"22906",190,152,147,3,5,"P.S.O.E.",51
46,"46038",368,264,260,1,4,"P.S.O.E.",84
50,"50170",411,316,313,2,3,"P.S.O.E.",139
47,"47057",237,198,198,3,0,"P.S.O.E.",42
47,"47206",111,99,99,0,0,"P.S.O.E.",39
50,"50243",346,277,272,2,5,"P.S.O.E.",87
5,"5122",156,124,124,0,0,"P.S.O.E.",35
47,"47214",1517,1215,1191,34,24,"P.S.O.E.",399
34,"34059",462,377,375,5,2,"P.S.O.E.",146
40,"40199",110,88,86,3,2,"P.S.O.E.",16
9,"9268",108,78,78,0,0,"P.S.O.E.",31
6,"6153",20332,15398,15216,239,182,"P.S.O.E.",5509
49,"49031",150,128,127,2,1,"P.S.O.E.",19
9,"9429",64,44,44,2,0,"P.S.O.E.",7
37,"37195",48,32,32,0,0,"P.S.O.E.",17
10,"10143",169,135,131,1,4,"P.S.O.E.",60
44,"44144",326,233,227,7,6,"P.S.O.E.",125
12,"12107",358,314,311,4,3,"P.S.O.E.",105
49,"49266",83,69,69,1,0,"P.S.O.E.",24
10,"10069",858,680,673,2,7,"P.S.O.E.",304
34,"34039",66,57,56,0,1,"P.S.O.E.",6
31,"31095",83,70,70,1,0,"P.S.O.E.",25
19,"19004",67,56,56,0,0,"P.S.O.E.",5
3,"3062",206,175,175,0,0,"P.S.O.E.",54
39,"39074",6785,5287,5233,50,54,"P.S.O.E.",953
3,"3064",4976,4098,4058,26,40,"P.S.O.E.",988
2,"2071",1053,899,895,5,4,"P.S.O.E.",354
3,"3006",479,380,369,2,11,"P.S.O.E.",95
44,"44203",8,8,8,0,0,"P.S.O.E.",2
9,"9095",88,75,73,2,2,"P.S.O.E.",13
26,"26177",322,276,274,2,2,"P.S.O.E.",83
18,"18099",1551,1217,1205,11,12,"P.S.O.E.",477
12,"12018",326,274,265,1,9,"P.S.O.E.",102
31,"31058",240,184,179,0,5,"P.S.O.E.",15
46,"46239",457,331,323,2,8,"P.S.O.E.",85
50,"50087",31,25,25,0,0,"P.S.O.E.",3
31,"31046",58,41,41,3,0,"P.S.O.E.",7
42,"42089",54,44,44,3,0,"P.S.O.E.",20
9,"9316",108,87,84,0,3,"P.S.O.E.",17
10,"10042",79,63,62,2,1,"P.S.O.E.",36
47,"47064",30,21,21,1,0,"P.S.O.E.",3
24,"24071",1060,808,797,6,11,"P.S.O.E.",271
37,"37207",287,211,208,2,3,"P.S.O.E.",25
37,"37234",376,275,272,2,3,"P.S.O.E.",107
31,"31050",6253,4045,3987,74,58,"P.S.O.E.",383
37,"37374",1204,1018,1004,9,14,"P.S.O.E.",321
24,"24083",1165,831,819,17,12,"P.S.O.E.",403
16,"16250",94,71,71,0,0,"P.S.O.E.",19
29,"29039",2822,2091,2074,8,17,"P.S.O.E.",581
22,"22077",421,327,323,14,4,"P.S.O.E.",151
45,"45179",608,476,471,3,5,"P.S.O.E.",180
16,"16188",106,76,76,0,0,"P.S.O.E.",40
29,"29025",34637,22545,22354,268,191,"P.S.O.E.",6393
37,"37026",201,176,176,3,0,"P.S.O.E.",66
34,"34206",952,796,780,9,16,"P.S.O.E.",316
7,"7048",15296,8559,8439,176,120,"P.S.O.E.",3133
47,"47149",44,22,20,0,2,"P.S.O.E.",1
26,"26124",860,705,694,3,11,"P.S.O.E.",233
19,"19138",298,223,219,3,4,"P.S.O.E.",86
5,"5258",123,105,104,1,1,"P.S.O.E.",23
23,"23095",8882,6668,6628,31,40,"P.S.O.E.",2926
2,"2077",51,46,45,0,1,"P.S.O.E.",16
46,"46074",2656,2071,2053,22,18,"P.S.O.E.",519
9,"9181",334,271,271,14,0,"P.S.O.E.",36
34,"34049",421,313,311,4,2,"P.S.O.E.",90
31,"31232",24440,17810,17436,420,374,"P.S.O.E.",4719
6,"6002",4321,3272,3195,32,77,"P.S.O.E.",1051
3,"3046",1530,1136,1121,11,15,"P.S.O.E.",243
16,"16216",358,300,296,2,4,"P.S.O.E.",125
39,"39041",1775,1432,1414,15,18,"P.S.O.E.",387
37,"37200",192,142,142,0,0,"P.S.O.E.",42
42,"42080",168,115,114,0,1,"P.S.O.E.",27
10,"10088",244,168,168,0,0,"P.S.O.E.",39
37,"37147",201,153,151,1,2,"P.S.O.E.",43
6,"6079",623,525,522,6,3,"P.S.O.E.",271
44,"44101",60,47,47,1,0,"P.S.O.E.",11
26,"26126",32,31,31,1,0,"P.S.O.E.",5
39,"39017",588,424,419,2,5,"P.S.O.E.",42
44,"44164",32,25,25,0,0,"P.S.O.E.",4
37,"37254",189,168,164,1,4,"P.S.O.E.",47
6,"6040",1032,807,807,11,0,"P.S.O.E.",414
19,"19136",22,15,15,0,0,"P.S.O.E.",6
12,"12056",304,259,254,7,5,"P.S.O.E.",84
2,"2007",1139,923,916,0,7,"P.S.O.E.",518
29,"29011",3013,1893,1876,7,17,"P.S.O.E.",973
41,"41058",16497,12415,12248,181,167,"P.S.O.E.",4753
40,"40221",50,41,41,0,0,"P.S.O.E.",6
12,"12127",92,64,61,0,3,"P.S.O.E.",21
6,"6029",1230,884,880,5,4,"P.S.O.E.",453
40,"40178",104,80,79,1,1,"P.S.O.E.",7
18,"18025",326,242,238,0,4,"P.S.O.E.",131
37,"37199",157,115,113,0,2,"P.S.O.E.",45
22,"22041",175,138,138,1,0,"P.S.O.E.",42
9,"9169",96,80,80,1,0,"P.S.O.E.",24
3,"3072",331,284,277,2,7,"P.S.O.E.",93
16,"16227",128,95,94,0,1,"P.S.O.E.",34
41,"41032",4059,3122,3062,22,60,"P.S.O.E.",1633
11,"11039",9943,6634,6582,104,52,"P.S.O.E.",2256
10,"10010",2358,1597,1576,18,21,"P.S.O.E.",762
46,"46163",1811,1487,1463,12,24,"P.S.O.E.",339
37,"37371",285,190,190,2,0,"P.S.O.E.",58
16,"16053",414,334,326,2,8,"P.S.O.E.",136
9,"9057",155,125,124,0,1,"P.S.O.E.",30
42,"42100",31,31,31,0,0,"P.S.O.E.",4
29,"29061",1045,861,855,7,6,"P.S.O.E.",205
16,"16228",202,146,144,2,2,"P.S.O.E.",34
31,"31248",318,190,187,2,3,"P.S.O.E.",28
10,"10013",305,242,237,1,5,"P.S.O.E.",77
39,"39003",321,265,261,0,4,"P.S.O.E.",58
44,"44135",149,110,109,1,1,"P.S.O.E.",32
33,"33047",1178,939,931,2,8,"P.S.O.E.",276
18,"18068",1456,1105,1088,13,17,"P.S.O.E.",384
9,"9104",56,49,49,0,0,"P.S.O.E.",3
12,"12090",127,109,107,2,2,"P.S.O.E.",19
16,"16082",318,226,226,1,0,"P.S.O.E.",91
2,"2035",1988,1601,1586,19,15,"P.S.O.E.",541
12,"12100",1380,1124,1109,11,15,"P.S.O.E.",423
37,"37159",100,77,75,0,2,"P.S.O.E.",15
12,"12009",17124,12273,12098,150,175,"P.S.O.E.",3380
44,"44160",473,315,312,8,3,"P.S.O.E.",52
37,"37141",158,140,139,1,1,"P.S.O.E.",59
47,"47220",194,143,142,4,1,"P.S.O.E.",35
11,"11010",6452,4534,4510,61,24,"P.S.O.E.",2062
22,"22084",524,362,354,11,8,"P.S.O.E.",112
47,"47087",376,320,315,7,5,"P.S.O.E.",101
46,"46108",550,446,444,3,2,"P.S.O.E.",174
10,"10015",688,539,523,5,16,"P.S.O.E.",214
42,"42013",45,35,34,1,1,"P.S.O.E.",10
3,"3009",47547,35945,35298,603,647,"P.S.O.E.",11458
37,"37198",212,176,173,2,3,"P.S.O.E.",55
34,"34184",54,37,36,0,1,"P.S.O.E.",7
16,"16196",658,578,568,6,10,"P.S.O.E.",277
22,"22225",2784,1839,1805,42,34,"P.S.O.E.",495
24,"24229",473,348,344,8,4,"P.S.O.E.",86
46,"46028",424,352,347,5,5,"P.S.O.E.",112
26,"26128",116,94,93,0,1,"P.S.O.E.",38
44,"44183",78,49,46,0,3,"P.S.O.E.",25
2,"2008",1332,985,966,12,19,"P.S.O.E.",348
37,"37317",323,281,278,3,3,"P.S.O.E.",68
10,"10130",1745,1360,1341,10,19,"P.S.O.E.",732
10,"10126",1660,1221,1201,9,20,"P.S.O.E.",478
31,"31245",87,59,58,5,1,"P.S.O.E.",2
39,"39028",3513,2760,2718,23,42,"P.S.O.E.",443
29,"29073",1520,1032,1021,10,11,"P.S.O.E.",473
10,"10180",5446,3957,3917,28,40,"P.S.O.E.",1361
5,"5104",35,29,29,0,0,"P.S.O.E.",1
31,"31086",11499,8520,8389,214,131,"P.S.O.E.",1266
37,"37163",44,36,36,0,0,"P.S.O.E.",3
50,"50174",107,92,90,0,2,"P.S.O.E.",22
34,"34154",78,62,62,0,0,"P.S.O.E.",12
40,"40123",168,130,126,3,4,"P.S.O.E.",35
5,"5046",44,39,38,1,1,"P.S.O.E.",8
18,"18159",1051,873,869,4,4,"P.S.O.E.",389
41,"41027",4061,2783,2752,28,31,"P.S.O.E.",1080
9,"9100",56,46,44,0,2,"P.S.O.E.",3
46,"46056",203,164,160,2,4,"P.S.O.E.",55
12,"12096",854,663,653,17,10,"P.S.O.E.",287
34,"34204",53,45,44,0,1,"P.S.O.E.",10
2,"2056",1816,1518,1506,15,12,"P.S.O.E.",663
49,"49102",217,178,176,3,2,"P.S.O.E.",63
3,"3038",338,294,291,2,3,"P.S.O.E.",89
35,"35012",9662,5511,5446,45,65,"P.S.O.E.",1201
49,"49237",157,110,110,0,0,"P.S.O.E.",40
41,"41083",1176,915,908,8,7,"P.S.O.E.",575
18,"18047",5603,3833,3805,67,28,"P.S.O.E.",1229
37,"37152",474,357,351,2,6,"P.S.O.E.",77
50,"50195",48,38,38,1,0,"P.S.O.E.",11
34,"34159",375,275,264,8,11,"P.S.O.E.",99
5,"5095",301,253,250,2,3,"P.S.O.E.",62
31,"31234",148,107,105,6,2,"P.S.O.E.",21
30,"30010",6804,5691,5647,36,44,"P.S.O.E.",1283
12,"12104",6981,5464,5357,54,107,"P.S.O.E.",1562
41,"41048",2296,1749,1726,21,23,"P.S.O.E.",876
37,"37330",338,272,270,3,2,"P.S.O.E.",76
31,"31061",67,47,47,2,0,"P.S.O.E.",11
19,"19036",279,238,236,1,2,"P.S.O.E.",75
47,"47184",575,447,443,6,4,"P.S.O.E.",88
49,"49247",507,340,332,6,8,"P.S.O.E.",78
29,"29052",245,151,151,0,0,"P.S.O.E.",70
10,"10011",611,527,519,5,8,"P.S.O.E.",297
12,"12073",168,135,135,1,0,"P.S.O.E.",40
42,"42037",38,23,20,3,3,"P.S.O.E.",4
24,"24134",3682,2636,2588,44,48,"P.S.O.E.",1113
9,"9338",220,173,168,5,5,"P.S.O.E.",54
40,"40078",180,143,143,1,0,"P.S.O.E.",43
50,"50148",365,256,251,2,5,"P.S.O.E.",111
6,"6036",5228,4075,4028,22,47,"P.S.O.E.",1645
22,"22252",130,98,96,5,2,"P.S.O.E.",27
34,"34124",70,55,55,1,0,"P.S.O.E.",14
22,"22903",672,555,547,6,8,"P.S.O.E.",238
26,"26125",2720,2121,2084,26,37,"P.S.O.E.",717
7,"7007",454,304,300,4,4,"P.S.O.E.",89
37,"37131",200,150,148,1,2,"P.S.O.E.",36
37,"37032",530,410,409,4,1,"P.S.O.E.",82
40,"40084",65,53,53,2,0,"P.S.O.E.",8
44,"44145",1078,723,714,26,9,"P.S.O.E.",247
9,"9010",35,27,27,1,0,"P.S.O.E.",4
22,"22064",184,139,137,3,2,"P.S.O.E.",59
31,"31067",1982,1400,1363,28,37,"P.S.O.E.",540
45,"45096",1021,800,778,5,22,"P.S.O.E.",186
2,"2044",1207,908,893,5,15,"P.S.O.E.",388
6,"6100",1000,828,821,3,7,"P.S.O.E.",326
39,"39030",1971,1397,1379,20,18,"P.S.O.E.",297
19,"19060",165,127,121,3,6,"P.S.O.E.",35
9,"9257",93,73,72,2,1,"P.S.O.E.",1
44,"44115",121,100,100,0,0,"P.S.O.E.",44
50,"50273",36,22,22,0,0,"P.S.O.E.",2
47,"47205",414,307,298,5,9,"P.S.O.E.",57
10,"10051",489,373,373,2,0,"P.S.O.E.",161
6,"6105",655,450,448,1,2,"P.S.O.E.",186
33,"33030",921,682,668,4,14,"P.S.O.E.",124
49,"49145",251,154,153,0,1,"P.S.O.E.",31
2,"2020",519,433,430,0,3,"P.S.O.E.",191
44,"44128",84,56,56,3,0,"P.S.O.E.",18
31,"31135",116,87,86,9,1,"P.S.O.E.",16
24,"24036",321,190,188,0,2,"P.S.O.E.",93
9,"9143",24,14,14,1,0,"P.S.O.E.",0
46,"46195",1975,1631,1631,33,0,"P.S.O.E.",508
9,"9029",186,138,137,4,1,"P.S.O.E.",34
16,"16171",1930,1616,1584,25,32,"P.S.O.E.",607
50,"50208",1831,1321,1305,24,16,"P.S.O.E.",530
45,"45200",4633,3768,3672,37,96,"P.S.O.E.",1404
26,"26048",29,27,26,1,1,"P.S.O.E.",6
18,"18102",8556,6358,6272,42,86,"P.S.O.E.",3092
47,"47069",128,108,108,0,0,"P.S.O.E.",37
31,"31116",71,48,48,2,0,"P.S.O.E.",9
31,"31106",676,534,518,10,16,"P.S.O.E.",198
38,"38049",2794,1721,1694,12,27,"P.S.O.E.",602
46,"46247",1059,829,823,6,6,"P.S.O.E.",158
30,"30041",12957,9360,9288,89,72,"P.S.O.E.",2022
10,"10902",727,608,599,5,9,"P.S.O.E.",256
49,"49076",333,260,257,10,3,"P.S.O.E.",51
46,"46091",126,108,108,0,0,"P.S.O.E.",12
46,"46002",1166,942,915,7,27,"P.S.O.E.",221
44,"44085",61,38,38,0,0,"P.S.O.E.",3
24,"24033",214,157,152,3,5,"P.S.O.E.",46
31,"31236",1333,887,874,15,13,"P.S.O.E.",52
19,"19116",16,10,10,0,0,"P.S.O.E.",3
2,"2023",636,534,533,6,1,"P.S.O.E.",217
10,"10123",601,502,492,0,10,"P.S.O.E.",269
16,"16035",287,216,213,2,3,"P.S.O.E.",99
37,"37049",163,119,119,0,0,"P.S.O.E.",37
10,"10075",276,189,189,1,0,"P.S.O.E.",66
6,"6004",1607,1317,1309,10,8,"P.S.O.E.",659
26,"26108",324,245,243,4,2,"P.S.O.E.",68
37,"37249",48,36,36,0,0,"P.S.O.E.",8
47,"47197",932,739,730,15,9,"P.S.O.E.",283
31,"31108",1969,1474,1452,23,22,"P.S.O.E.",462
16,"16901",793,590,582,2,8,"P.S.O.E.",178
44,"44185",117,91,90,0,1,"P.S.O.E.",18
49,"49150",169,129,126,0,3,"P.S.O.E.",37
18,"18028",992,826,821,4,5,"P.S.O.E.",357
18,"18117",535,444,440,2,4,"P.S.O.E.",222
18,"18161",220,180,178,0,2,"P.S.O.E.",86
14,"14066",5911,4515,4473,54,42,"P.S.O.E.",1604
37,"37112",162,124,124,3,0,"P.S.O.E.",32
38,"38026",32174,24822,24431,283,391,"P.S.O.E.",4594
47,"47181",170,128,128,1,0,"P.S.O.E.",40
47,"47195",449,350,346,5,4,"P.S.O.E.",147
49,"49159",289,225,225,2,0,"P.S.O.E.",86
14,"14029",4380,3344,3308,35,36,"P.S.O.E.",1476
29,"29076",2022,1384,1374,14,10,"P.S.O.E.",551
22,"22188",100,68,66,3,2,"P.S.O.E.",28
46,"46215",1451,1185,1169,8,16,"P.S.O.E.",427
31,"31907",9914,7394,7282,198,112,"P.S.O.E.",1289
12,"12122",835,674,658,14,16,"P.S.O.E.",216
19,"19266",278,234,231,4,3,"P.S.O.E.",47
5,"5101",297,224,222,4,2,"P.S.O.E.",23
46,"46050",161,126,123,1,3,"P.S.O.E.",57
31,"31252",91,60,58,0,2,"P.S.O.E.",1
39,"39020",23947,15404,15122,267,282,"P.S.O.E.",5633
18,"18119",1778,1401,1391,14,10,"P.S.O.E.",604
5,"5060",127,108,105,1,3,"P.S.O.E.",20
16,"16061",1035,861,848,15,13,"P.S.O.E.",323
31,"31016",7377,5149,5072,101,77,"P.S.O.E.",1429
50,"50200",534,436,432,9,4,"P.S.O.E.",225
31,"31093",305,207,203,2,4,"P.S.O.E.",43
46,"46075",166,148,145,3,3,"P.S.O.E.",37
11,"11034",2381,1807,1784,19,23,"P.S.O.E.",987
23,"23093",3313,2706,2673,13,33,"P.S.O.E.",1724
44,"44230",154,127,127,3,0,"P.S.O.E.",56
39,"39059",8476,6365,6284,73,81,"P.S.O.E.",1490
34,"34232",802,632,623,9,9,"P.S.O.E.",242
9,"9110",95,68,68,1,0,"P.S.O.E.",12
18,"18109",607,461,456,1,5,"P.S.O.E.",165
9,"9449",94,80,80,2,0,"P.S.O.E.",8
5,"5161",638,525,522,0,3,"P.S.O.E.",143
18,"18098",6440,4743,4679,44,64,"P.S.O.E.",2099
34,"34087",108,88,87,1,1,"P.S.O.E.",16
47,"47030",1075,822,801,13,21,"P.S.O.E.",210
31,"31071",17,15,15,0,0,"P.S.O.E.",6
10,"10196",309,244,244,1,0,"P.S.O.E.",99
37,"37190",235,195,193,1,2,"P.S.O.E.",69
49,"49065",1212,939,926,3,13,"P.S.O.E.",220
31,"31041",1397,938,913,26,25,"P.S.O.E.",141
10,"10021",5421,4189,4099,47,90,"P.S.O.E.",1918
47,"47158",906,716,710,10,6,"P.S.O.E.",316
18,"18064",419,347,345,3,2,"P.S.O.E.",166
47,"47152",94,65,65,0,0,"P.S.O.E.",31
22,"22235",101,88,87,1,1,"P.S.O.E.",30
44,"44121",63,48,48,1,0,"P.S.O.E.",12
37,"37117",1320,948,937,16,11,"P.S.O.E.",225
6,"6010",1144,903,898,6,5,"P.S.O.E.",372
46,"46242",361,288,280,4,8,"P.S.O.E.",70
18,"18061",1109,882,869,1,13,"P.S.O.E.",334
22,"22087",85,56,55,4,1,"P.S.O.E.",5
24,"24103",330,180,177,0,3,"P.S.O.E.",48
6,"6006",4664,3435,3367,50,68,"P.S.O.E.",1755
41,"41026",4273,3577,3538,15,39,"P.S.O.E.",1778
16,"16010",184,135,133,1,2,"P.S.O.E.",21
44,"44161",487,363,358,9,5,"P.S.O.E.",99
37,"37244",132,97,95,5,2,"P.S.O.E.",15
42,"42148",14,14,14,0,0,"P.S.O.E.",5
50,"50197",89,65,65,3,0,"P.S.O.E.",18
16,"16122",259,195,190,2,5,"P.S.O.E.",79
39,"39053",251,179,179,1,0,"P.S.O.E.",22
39,"39087",43561,33709,33242,404,467,"P.S.O.E.",10392
14,"14034",367,301,292,1,9,"P.S.O.E.",124
45,"45153",1704,1376,1353,9,23,"P.S.O.E.",365
49,"49125",1344,956,939,21,17,"P.S.O.E.",330
22,"22055",347,291,289,5,2,"P.S.O.E.",132
9,"9127",54,39,39,0,0,"P.S.O.E.",3
37,"37157",94,65,65,0,0,"P.S.O.E.",30
37,"37206",100,81,80,1,1,"P.S.O.E.",27
45,"45194",57,41,41,0,0,"P.S.O.E.",17
24,"24168",493,397,391,7,6,"P.S.O.E.",125
9,"9905",432,313,309,1,4,"P.S.O.E.",69
18,"18147",3742,2419,2386,20,33,"P.S.O.E.",1077
22,"22908",231,167,162,2,5,"P.S.O.E.",57
44,"44003",19,19,19,0,0,"P.S.O.E.",4
45,"45169",239,183,183,1,0,"P.S.O.E.",59
9,"9416",61,44,44,0,0,"P.S.O.E.",15
37,"37346",264,211,210,1,1,"P.S.O.E.",48
18,"18035",1254,991,982,7,9,"P.S.O.E.",404
46,"46033",220,183,181,0,2,"P.S.O.E.",44
3,"3118",2368,1746,1718,16,28,"P.S.O.E.",363
12,"12053",2121,1745,1719,11,26,"P.S.O.E.",563
37,"37191",127,86,85,1,1,"P.S.O.E.",23
33,"33028",1466,812,806,5,6,"P.S.O.E.",275
22,"22090",115,82,82,5,0,"P.S.O.E.",35
9,"9906",1199,912,903,12,9,"P.S.O.E.",199
39,"39054",4265,3338,3276,57,62,"P.S.O.E.",895
40,"40208",828,650,638,7,12,"P.S.O.E.",167
45,"45196",1363,1092,1076,3,16,"P.S.O.E.",347
7,"7025",457,355,346,3,9,"P.S.O.E.",70
45,"45085",1511,1111,1100,10,11,"P.S.O.E.",178
41,"41003",2196,1803,1782,21,21,"P.S.O.E.",834
5,"5079",68,52,50,1,2,"P.S.O.E.",4
45,"45150",471,388,382,1,6,"P.S.O.E.",195
19,"19233",108,93,90,2,3,"P.S.O.E.",26
46,"46083",15427,12079,11941,109,138,"P.S.O.E.",2307
45,"45197",1972,1570,1538,8,32,"P.S.O.E.",656
47,"47150",338,273,271,2,2,"P.S.O.E.",81
50,"50275",103,76,76,0,0,"P.S.O.E.",16
39,"39070",152,118,118,0,0,"P.S.O.E.",21
12,"12120",218,180,177,0,3,"P.S.O.E.",61
50,"50163",3427,2448,2413,62,35,"P.S.O.E.",506
6,"6145",929,746,743,5,3,"P.S.O.E.",332
26,"26112",270,201,200,0,1,"P.S.O.E.",66
5,"5103",84,68,68,3,0,"P.S.O.E.",8
6,"6039",1848,1564,1546,13,18,"P.S.O.E.",846
50,"50255",219,150,148,1,2,"P.S.O.E.",111
46,"46189",490,400,396,3,4,"P.S.O.E.",121
29,"29016",272,180,179,5,1,"P.S.O.E.",80
2,"2011",730,612,610,3,2,"P.S.O.E.",286
44,"44240",168,135,132,2,3,"P.S.O.E.",50
41,"41089",6394,4593,4526,57,67,"P.S.O.E.",2055
18,"18105",5222,3866,3839,32,27,"P.S.O.E.",1878
10,"10084",1416,994,972,12,22,"P.S.O.E.",406
23,"23076",831,681,671,5,10,"P.S.O.E.",249
7,"7060",2534,1724,1697,30,27,"P.S.O.E.",372
23,"23034",2591,2146,2124,13,22,"P.S.O.E.",1126
50,"50201",466,366,363,7,3,"P.S.O.E.",124
31,"31149",2381,1626,1607,7,19,"P.S.O.E.",75
9,"9135",41,29,29,1,0,"P.S.O.E.",4
37,"37149",78,69,69,0,0,"P.S.O.E.",8
10,"10112",1582,1299,1284,5,15,"P.S.O.E.",455
44,"44116",96,68,65,3,3,"P.S.O.E.",9
19,"19209",50,40,39,0,1,"P.S.O.E.",12
49,"49174",131,97,97,1,0,"P.S.O.E.",18
45,"45175",698,587,579,5,8,"P.S.O.E.",224
6,"6021",971,761,747,6,14,"P.S.O.E.",246
50,"50183",369,277,274,5,3,"P.S.O.E.",83
33,"33033",10609,7179,7107,91,72,"P.S.O.E.",2326
26,"26160",684,538,528,5,10,"P.S.O.E.",152
41,"41090",3488,2792,2751,22,41,"P.S.O.E.",1397
19,"19272",86,67,65,1,2,"P.S.O.E.",29
22,"22059",1149,792,764,23,28,"P.S.O.E.",286
34,"34243",352,274,273,5,1,"P.S.O.E.",65
12,"12067",563,458,439,8,19,"P.S.O.E.",159
49,"49194",380,250,247,4,3,"P.S.O.E.",71
45,"45090",396,335,333,0,2,"P.S.O.E.",164
31,"31137",215,108,106,1,2,"P.S.O.E.",7
22,"22076",331,241,235,3,6,"P.S.O.E.",94
10,"10190",569,438,435,6,3,"P.S.O.E.",165
22,"22037",115,87,79,0,8,"P.S.O.E.",12
9,"9219",28514,20244,19951,326,293,"P.S.O.E.",7808
47,"47009",117,88,88,1,0,"P.S.O.E.",24
6,"6146",1188,951,936,8,15,"P.S.O.E.",492
26,"26146",141,98,96,0,2,"P.S.O.E.",26
16,"16269",494,412,407,5,5,"P.S.O.E.",119
10,"10097",109,97,96,0,1,"P.S.O.E.",27
26,"26176",69,55,54,0,1,"P.S.O.E.",2
50,"50167",235,191,184,1,7,"P.S.O.E.",47
29,"29029",452,339,336,0,3,"P.S.O.E.",138
41,"41074",3079,2406,2386,14,20,"P.S.O.E.",1216
9,"9215",426,290,287,1,3,"P.S.O.E.",70
18,"18144",779,592,590,3,2,"P.S.O.E.",167
5,"5235",136,120,119,2,1,"P.S.O.E.",47
49,"49219",7742,5643,5562,87,81,"P.S.O.E.",1770
19,"19034",23,23,23,1,0,"P.S.O.E.",9
23,"23082",1985,1464,1451,9,13,"P.S.O.E.",652
49,"49097",97,55,55,1,0,"P.S.O.E.",18
2,"2016",600,471,468,5,3,"P.S.O.E.",124
5,"5041",1051,840,827,13,13,"P.S.O.E.",129
34,"34237",645,506,498,6,8,"P.S.O.E.",143
31,"31092",676,447,446,6,1,"P.S.O.E.",46
23,"23084",1046,817,812,4,5,"P.S.O.E.",423
2,"2017",895,685,682,4,3,"P.S.O.E.",317
19,"19247",171,125,118,6,7,"P.S.O.E.",45
50,"50290",436,334,331,4,3,"P.S.O.E.",127
22,"22062",189,126,125,2,1,"P.S.O.E.",33
50,"50234",251,201,191,13,10,"P.S.O.E.",37
34,"34005",899,707,698,8,9,"P.S.O.E.",221
23,"23085",2350,1963,1956,8,7,"P.S.O.E.",1119
50,"50231",285,231,224,7,7,"P.S.O.E.",81
47,"47094",154,129,127,0,2,"P.S.O.E.",33
50,"50056",450,329,328,4,1,"P.S.O.E.",96
39,"39014",943,706,700,9,6,"P.S.O.E.",165
9,"9908",509,328,321,5,7,"P.S.O.E.",85
19,"19015",104,88,87,0,1,"P.S.O.E.",31
37,"37176",136,103,100,1,3,"P.S.O.E.",30
33,"33029",420,243,241,3,2,"P.S.O.E.",95
37,"37357",283,216,214,0,2,"P.S.O.E.",82
50,"50101",922,648,637,8,11,"P.S.O.E.",258
19,"19308",67,61,61,0,0,"P.S.O.E.",17
9,"9247",28,21,20,0,1,"P.S.O.E.",1
46,"46251",2599,2215,2179,21,36,"P.S.O.E.",682
31,"31077",5349,4025,3917,103,108,"P.S.O.E.",1242
24,"24018",180,150,149,1,1,"P.S.O.E.",26
18,"18164",1881,1351,1342,16,9,"P.S.O.E.",538
16,"16062",30,27,27,0,0,"P.S.O.E.",11
6,"6044",28321,21143,20931,232,212,"P.S.O.E.",7293
19,"19204",168,129,126,2,3,"P.S.O.E.",45
5,"5100",307,245,245,2,0,"P.S.O.E.",68
41,"41068",13809,10171,10072,100,99,"P.S.O.E.",5721
34,"34134",61,49,47,0,2,"P.S.O.E.",11
49,"49087",581,358,356,3,2,"P.S.O.E.",66
23,"23072",2063,1661,1643,16,18,"P.S.O.E.",771
19,"19151",1126,849,830,3,19,"P.S.O.E.",265
31,"31903",6058,3985,3919,67,66,"P.S.O.E.",1042
33,"33076",12662,8733,8670,120,63,"P.S.O.E.",2005
6,"6030",171,132,131,0,1,"P.S.O.E.",63
39,"39019",2009,1556,1536,10,20,"P.S.O.E.",307
9,"9327",34,34,34,0,0,"P.S.O.E.",6
12,"12042",664,549,530,5,19,"P.S.O.E.",105
34,"34093",101,74,74,1,0,"P.S.O.E.",4
47,"47008",26,17,17,0,0,"P.S.O.E.",0
41,"41017",13878,10053,9926,130,127,"P.S.O.E.",3394
34,"34229",75,60,60,2,0,"P.S.O.E.",10
24,"24226",223,154,153,1,1,"P.S.O.E.",26
18,"18137",1057,875,868,8,7,"P.S.O.E.",340
9,"9235",179,148,142,1,6,"P.S.O.E.",59
34,"34181",471,350,346,7,4,"P.S.O.E.",169
2,"2057",2138,1736,1712,30,24,"P.S.O.E.",776
45,"45170",257,186,183,0,3,"P.S.O.E.",59
29,"29099",958,739,730,5,9,"P.S.O.E.",385
41,"41009",1272,914,899,8,15,"P.S.O.E.",427
46,"46212",1598,1233,1218,5,15,"P.S.O.E.",331
16,"16253",340,256,256,4,0,"P.S.O.E.",61
34,"34086",105,89,89,1,0,"P.S.O.E.",24
18,"18046",1960,1327,1312,5,15,"P.S.O.E.",539
9,"9312",113,94,91,0,3,"P.S.O.E.",13
19,"19176",280,216,216,0,0,"P.S.O.E.",41
19,"19227",95,64,63,1,1,"P.S.O.E.",20
9,"9218",384,285,279,8,6,"P.S.O.E.",85
45,"45041",3617,2672,2635,21,37,"P.S.O.E.",716
34,"34130",228,187,186,6,1,"P.S.O.E.",78
50,"50139",372,280,278,3,2,"P.S.O.E.",88
46,"46181",17153,13332,13184,108,148,"P.S.O.E.",3205
46,"46067",1798,1487,1472,10,15,"P.S.O.E.",402
44,"44212",45,35,35,0,0,"P.S.O.E.",7
5,"5264",68,48,48,1,0,"P.S.O.E.",9
49,"49191",305,248,246,2,2,"P.S.O.E.",114
41,"41019",4528,3194,3168,41,26,"P.S.O.E.",1381
6,"6125",1852,1419,1399,11,20,"P.S.O.E.",618
23,"23048",884,691,679,6,12,"P.S.O.E.",261
40,"40135",298,247,242,4,5,"P.S.O.E.",84
33,"33063",467,367,363,4,4,"P.S.O.E.",115
16,"16040",97,76,75,1,1,"P.S.O.E.",9
42,"42207",49,37,34,0,3,"P.S.O.E.",5
5,"5265",87,68,66,2,2,"P.S.O.E.",6
24,"24149",149,120,118,3,2,"P.S.O.E.",25
6,"6034",190,134,129,3,5,"P.S.O.E.",36
39,"39100",922,718,712,8,6,"P.S.O.E.",103
39,"39057",2298,1735,1719,17,16,"P.S.O.E.",435
26,"26056",440,345,339,4,6,"P.S.O.E.",142
49,"49122",701,542,534,7,8,"P.S.O.E.",164
46,"46207",6453,5086,5031,52,55,"P.S.O.E.",1248
37,"37027",242,196,192,2,4,"P.S.O.E.",45
33,"33041",7488,5356,5309,65,47,"P.S.O.E.",1719
46,"46206",595,497,495,3,2,"P.S.O.E.",180
22,"22028",424,311,310,3,1,"P.S.O.E.",119
24,"24028",426,350,331,3,19,"P.S.O.E.",144
46,"46199",5661,4328,4280,38,48,"P.S.O.E.",1044
2,"2062",456,348,344,2,4,"P.S.O.E.",128
37,"37363",121,100,99,0,1,"P.S.O.E.",41
34,"34018",229,184,182,3,2,"P.S.O.E.",49
24,"24024",717,501,498,10,3,"P.S.O.E.",109
37,"37050",71,48,48,1,0,"P.S.O.E.",12
31,"31039",94,65,61,0,4,"P.S.O.E.",18
34,"34001",36,29,29,2,0,"P.S.O.E.",6
49,"49180",169,113,107,2,6,"P.S.O.E.",24
5,"5057",2593,2172,2152,16,20,"P.S.O.E.",735
46,"46164",11634,8843,8724,90,119,"P.S.O.E.",2547
7,"7901",642,483,470,5,13,"P.S.O.E.",93
10,"10109",1834,1307,1287,18,20,"P.S.O.E.",424
5,"5087",144,87,87,0,0,"P.S.O.E.",3
24,"24184",206,111,111,0,0,"P.S.O.E.",31
16,"16003",147,122,121,0,1,"P.S.O.E.",52
5,"5083",155,120,113,1,7,"P.S.O.E.",16
12,"12060",467,367,353,2,14,"P.S.O.E.",90
49,"49197",187,126,126,3,0,"P.S.O.E.",41
16,"16016",258,178,178,1,0,"P.S.O.E.",44
46,"46233",3911,3025,2988,10,37,"P.S.O.E.",750
6,"6024",1215,1015,1006,4,9,"P.S.O.E.",407
42,"42213",31,24,24,2,0,"P.S.O.E.",3
45,"45128",2558,1831,1806,20,25,"P.S.O.E.",609
14,"14008",2905,2226,2200,18,26,"P.S.O.E.",835
39,"39093",351,260,253,2,7,"P.S.O.E.",54
50,"50067",14124,10049,9870,203,179,"P.S.O.E.",3068
10,"10019",1414,1054,1037,10,17,"P.S.O.E.",306
19,"19159",108,91,88,1,3,"P.S.O.E.",17
5,"5106",39,26,26,0,0,"P.S.O.E.",1
30,"30902",7463,5291,5228,38,63,"P.S.O.E.",1150
9,"9229",213,163,163,1,0,"P.S.O.E.",66
10,"10142",822,635,625,4,10,"P.S.O.E.",312
40,"40002",38,31,31,1,0,"P.S.O.E.",8
40,"40188",120,82,81,0,1,"P.S.O.E.",17
16,"16219",106,83,82,0,1,"P.S.O.E.",48
41,"41049",8898,6881,6812,95,69,"P.S.O.E.",3065
49,"49201",330,280,278,9,2,"P.S.O.E.",117
7,"7010",4668,3229,3174,58,55,"P.S.O.E.",772
49,"49113",188,166,161,2,5,"P.S.O.E.",26
41,"41067",7055,5368,5295,64,73,"P.S.O.E.",2413
49,"49052",200,149,144,1,5,"P.S.O.E.",43
47,"47221",115,102,102,0,0,"P.S.O.E.",22
34,"34240",102,84,83,1,1,"P.S.O.E.",20
34,"34140",113,84,84,2,0,"P.S.O.E.",13
37,"37016",539,424,420,8,4,"P.S.O.E.",101
19,"19259",37,32,32,0,0,"P.S.O.E.",14
22,"22050",100,84,83,0,1,"P.S.O.E.",34
22,"22233",94,69,69,0,0,"P.S.O.E.",37
10,"10104",5233,3904,3824,30,80,"P.S.O.E.",1367
16,"16909",737,590,585,9,5,"P.S.O.E.",280
49,"49190",81,65,64,2,1,"P.S.O.E.",24
5,"5099",555,472,466,4,6,"P.S.O.E.",184
31,"31158",264,174,173,1,1,"P.S.O.E.",14
16,"16142",118,93,93,1,0,"P.S.O.E.",30
19,"19048",18,12,11,1,1,"P.S.O.E.",3
10,"10024",663,490,480,3,10,"P.S.O.E.",167
19,"19173",52,42,42,3,0,"P.S.O.E.",18
49,"49129",903,671,661,16,10,"P.S.O.E.",275
50,"50245",121,80,80,1,0,"P.S.O.E.",31
47,"47133",2382,1861,1841,30,20,"P.S.O.E.",506
45,"45182",1077,873,856,11,17,"P.S.O.E.",330
41,"41092",7649,5816,5738,39,78,"P.S.O.E.",3328
33,"33060",15694,11036,10883,112,153,"P.S.O.E.",4094
7,"7035",1542,1190,1161,19,29,"P.S.O.E.",337
46,"46187",1339,1096,1083,13,13,"P.S.O.E.",300
9,"9232",182,146,146,1,0,"P.S.O.E.",51
46,"46146",1718,1395,1374,10,21,"P.S.O.E.",283
6,"6091",3854,2961,2906,33,55,"P.S.O.E.",1138
49,"49025",187,143,142,3,1,"P.S.O.E.",51
44,"44102",30,29,28,0,1,"P.S.O.E.",4
24,"24115",54654,38629,38010,716,619,"P.S.O.E.",13628
46,"46203",3669,3002,2964,36,38,"P.S.O.E.",948
19,"19333",142,86,84,0,2,"P.S.O.E.",32
5,"5078",128,112,111,2,1,"P.S.O.E.",21
42,"42172",31,28,28,3,0,"P.S.O.E.",2
34,"34201",212,178,172,1,6,"P.S.O.E.",42
45,"45183",2189,1537,1514,10,23,"P.S.O.E.",335
37,"37023",1040,819,811,11,8,"P.S.O.E.",176
44,"44017",316,232,229,1,3,"P.S.O.E.",84
10,"10148",32554,23348,22955,365,393,"P.S.O.E.",7225
26,"26140",268,213,207,2,6,"P.S.O.E.",59
26,"26013",350,267,264,5,3,"P.S.O.E.",101
2,"2058",390,290,285,0,5,"P.S.O.E.",139
9,"9417",43,38,38,0,0,"P.S.O.E.",1
46,"46180",715,585,581,4,4,"P.S.O.E.",194
45,"45146",117,99,98,0,1,"P.S.O.E.",28
29,"29006",721,516,508,5,8,"P.S.O.E.",218
37,"37184",381,295,289,5,6,"P.S.O.E.",89
49,"49207",279,206,204,2,2,"P.S.O.E.",61
19,"19126",1552,1140,1119,16,21,"P.S.O.E.",245
33,"33014",9318,6380,6320,66,60,"P.S.O.E.",2023
47,"47061",266,227,223,0,4,"P.S.O.E.",95
45,"45152",653,503,497,2,6,"P.S.O.E.",202
10,"10022",442,377,370,1,7,"P.S.O.E.",173
19,"19052",37,32,31,1,1,"P.S.O.E.",15
24,"24105",1460,1095,1075,27,20,"P.S.O.E.",388
39,"39021",536,448,444,1,4,"P.S.O.E.",147
6,"6110",176,130,124,0,6,"P.S.O.E.",65
34,"34246",78,64,64,0,0,"P.S.O.E.",15
9,"9482",33,31,30,1,1,"P.S.O.E.",2
41,"41080",1289,1010,997,13,13,"P.S.O.E.",480
37,"37186",109,88,88,2,0,"P.S.O.E.",18
7,"7016",2726,1848,1809,34,39,"P.S.O.E.",573
41,"41095",40097,27969,27731,354,238,"P.S.O.E.",12588
47,"47045",839,636,632,3,4,"P.S.O.E.",273
16,"16181",73,62,62,1,0,"P.S.O.E.",20
19,"19167",136,112,109,4,3,"P.S.O.E.",9
40,"40010",140,117,117,0,0,"P.S.O.E.",14
18,"18127",15897,11597,11483,133,114,"P.S.O.E.",4347
3,"3053",7082,5754,5664,60,90,"P.S.O.E.",1124
10,"10029",447,362,355,1,7,"P.S.O.E.",193
50,"50154",129,98,97,1,1,"P.S.O.E.",8
12,"12111",423,375,363,6,12,"P.S.O.E.",134
9,"9391",383,290,284,7,6,"P.S.O.E.",77
37,"37187",567,449,448,3,1,"P.S.O.E.",145
44,"44076",2338,1839,1797,36,42,"P.S.O.E.",800
9,"9303",92,64,64,0,0,"P.S.O.E.",9
31,"31180",240,174,170,5,4,"P.S.O.E.",31
22,"22195",231,193,189,6,4,"P.S.O.E.",29
31,"31018",422,303,299,8,4,"P.S.O.E.",65
46,"46158",1037,829,822,9,7,"P.S.O.E.",291
10,"10193",1410,1179,1158,16,21,"P.S.O.E.",319
44,"44022",550,387,380,6,7,"P.S.O.E.",158
37,"37263",361,277,275,1,2,"P.S.O.E.",94
26,"26017",380,277,276,3,1,"P.S.O.E.",126
33,"33025",9455,6331,6277,84,54,"P.S.O.E.",1901
34,"34158",336,202,200,0,2,"P.S.O.E.",64
35,"35016",291589,181013,177964,2856,3049,"P.S.O.E.",51144
12,"12901",3383,2664,2632,34,32,"P.S.O.E.",895
10,"10086",342,259,250,5,9,"P.S.O.E.",66
37,"37065",346,269,267,0,2,"P.S.O.E.",55
5,"5108",64,41,41,0,0,"P.S.O.E.",14
44,"44181",82,63,63,3,0,"P.S.O.E.",8
47,"47018",33,30,28,2,2,"P.S.O.E.",2
5,"5224",104,90,90,0,0,"P.S.O.E.",8
18,"18062",9418,6916,6835,62,81,"P.S.O.E.",2274
19,"19146",51,40,38,0,2,"P.S.O.E.",17
49,"49199",266,214,211,1,3,"P.S.O.E.",79
3,"3124",482,420,415,7,5,"P.S.O.E.",125
42,"42017",154,134,130,2,4,"P.S.O.E.",62
50,"50147",845,637,627,12,10,"P.S.O.E.",283
23,"23097",6510,4687,4639,36,48,"P.S.O.E.",2059
47,"47074",155,125,124,0,1,"P.S.O.E.",62
9,"9351",63,46,44,0,2,"P.S.O.E.",3
37,"37128",261,211,210,2,1,"P.S.O.E.",82
19,"19225",879,625,618,9,7,"P.S.O.E.",201
44,"44150",30,30,30,0,0,"P.S.O.E.",9
37,"37266",83,54,54,1,0,"P.S.O.E.",12
33,"33027",929,617,613,5,4,"P.S.O.E.",264
12,"12026",946,728,702,16,26,"P.S.O.E.",202
31,"31010",5788,3716,3637,48,79,"P.S.O.E.",771
9,"9467",65,49,49,0,0,"P.S.O.E.",11
23,"23067",2523,2004,1974,16,30,"P.S.O.E.",708
31,"31265",81,52,50,0,2,"P.S.O.E.",7
19,"19237",53,40,39,2,1,"P.S.O.E.",18
16,"16101",160,142,142,0,0,"P.S.O.E.",67
22,"22004",146,97,97,2,0,"P.S.O.E.",33
14,"14039",2705,2204,2189,12,15,"P.S.O.E.",1087
24,"24123",835,559,555,6,4,"P.S.O.E.",223
45,"45191",601,506,498,1,8,"P.S.O.E.",232
5,"5192",96,78,77,1,1,"P.S.O.E.",18
18,"18043",140,89,87,1,2,"P.S.O.E.",14
22,"22217",406,314,309,4,5,"P.S.O.E.",112
19,"19037",153,128,128,0,0,"P.S.O.E.",35
40,"40018",102,88,87,2,1,"P.S.O.E.",16
9,"9174",859,645,639,11,6,"P.S.O.E.",213
46,"46064",547,463,458,2,5,"P.S.O.E.",130
45,"45082",1333,1143,1123,14,20,"P.S.O.E.",466
47,"47185",97,76,75,1,1,"P.S.O.E.",17
22,"22249",110,83,81,0,2,"P.S.O.E.",40
50,"50149",48,35,35,0,0,"P.S.O.E.",5
41,"41001",1642,1314,1302,10,12,"P.S.O.E.",652
12,"12089",4277,3009,2946,32,63,"P.S.O.E.",588
49,"49082",400,331,324,2,7,"P.S.O.E.",150
34,"34121",208,153,152,0,1,"P.S.O.E.",17
34,"34163",61,56,56,1,0,"P.S.O.E.",18
46,"46202",15578,11811,11676,110,135,"P.S.O.E.",2481
5,"5007",126,104,102,0,2,"P.S.O.E.",4
5,"5904",149,99,97,0,2,"P.S.O.E.",12
18,"18067",704,526,521,1,5,"P.S.O.E.",265
49,"49187",1317,967,954,31,13,"P.S.O.E.",276
6,"6059",1959,1476,1466,8,10,"P.S.O.E.",640
18,"18136",1973,1679,1668,5,11,"P.S.O.E.",1040
29,"29014",250,152,150,0,2,"P.S.O.E.",68
2,"2043",1335,1120,1108,10,12,"P.S.O.E.",435
9,"9101",79,66,66,2,0,"P.S.O.E.",9
26,"26152",38,31,31,0,0,"P.S.O.E.",6
9,"9220",82,60,60,2,0,"P.S.O.E.",19
45,"45157",2097,1519,1499,15,20,"P.S.O.E.",318
45,"45048",388,310,308,2,2,"P.S.O.E.",124
31,"31206",2079,1517,1475,33,42,"P.S.O.E.",245
44,"44155",1162,819,801,24,18,"P.S.O.E.",380
16,"16022",102,76,76,2,0,"P.S.O.E.",23
10,"10080",385,294,287,0,7,"P.S.O.E.",120
24,"24090",366,225,224,2,1,"P.S.O.E.",40
22,"22052",997,776,769,15,7,"P.S.O.E.",361
39,"39037",2061,1609,1586,10,23,"P.S.O.E.",326
10,"10039",448,352,350,0,2,"P.S.O.E.",140
6,"6016",3013,2363,2306,31,57,"P.S.O.E.",1161
22,"22205",472,369,363,5,6,"P.S.O.E.",213
7,"7058",2803,2100,2046,38,54,"P.S.O.E.",533
44,"44117",357,278,275,0,3,"P.S.O.E.",128
22,"22053",867,567,554,13,13,"P.S.O.E.",211
29,"29080",6598,4703,4663,31,40,"P.S.O.E.",1688
47,"47215",60,52,52,2,0,"P.S.O.E.",13
34,"34168",60,56,56,0,0,"P.S.O.E.",17
47,"47134",186,155,149,2,6,"P.S.O.E.",39
9,"9345",134,102,102,1,0,"P.S.O.E.",41
47,"47188",125,112,109,3,3,"P.S.O.E.",35
44,"44157",62,45,44,0,1,"P.S.O.E.",19
37,"37256",245,191,190,2,1,"P.S.O.E.",65
40,"40159",150,111,110,0,1,"P.S.O.E.",30
5,"5119",41,31,31,0,0,"P.S.O.E.",7
2,"2046",1165,954,941,16,13,"P.S.O.E.",295
50,"50172",187,140,138,4,2,"P.S.O.E.",36
39,"39029",642,521,517,6,4,"P.S.O.E.",86
10,"10014",1907,1507,1488,14,19,"P.S.O.E.",622
9,"9195",64,40,40,1,0,"P.S.O.E.",12
16,"16024",134,92,91,1,1,"P.S.O.E.",32
49,"49091",278,197,197,4,0,"P.S.O.E.",61
34,"34125",99,77,75,1,2,"P.S.O.E.",14
31,"31087",163,122,121,3,1,"P.S.O.E.",12
50,"50173",175,104,104,2,0,"P.S.O.E.",11
9,"9090",61,50,50,0,0,"P.S.O.E.",7
49,"49270",156,112,112,6,0,"P.S.O.E.",36
37,"37038",808,671,664,6,7,"P.S.O.E.",221
50,"50230",1295,914,903,13,11,"P.S.O.E.",358
50,"50143",608,427,424,5,3,"P.S.O.E.",107
18,"18070",287,240,239,2,1,"P.S.O.E.",94
49,"49134",203,142,142,4,0,"P.S.O.E.",45
9,"9012",105,77,74,3,3,"P.S.O.E.",22
46,"46230",14204,10650,10515,112,135,"P.S.O.E.",3001
42,"42124",71,50,50,0,0,"P.S.O.E.",14
3,"3032",112,90,88,0,2,"P.S.O.E.",22
46,"46012",930,698,684,9,14,"P.S.O.E.",193
16,"16013",24,23,23,0,0,"P.S.O.E.",5
34,"34112",50,39,38,2,1,"P.S.O.E.",6
35,"35007",569,392,391,2,1,"P.S.O.E.",62
9,"9052",40,31,31,1,0,"P.S.O.E.",0
49,"49094",276,180,180,2,0,"P.S.O.E.",61
9,"9136",203,153,146,3,7,"P.S.O.E.",41
10,"10044",1520,1120,1103,10,17,"P.S.O.E.",623
31,"31119",49,28,28,0,0,"P.S.O.E.",4
16,"16067",135,97,97,2,0,"P.S.O.E.",29
7,"7029",4090,2921,2866,44,55,"P.S.O.E.",1039
30,"30901",10113,8265,8194,70,71,"P.S.O.E.",1979
5,"5093",431,330,329,1,1,"P.S.O.E.",50
9,"9014",190,113,113,3,0,"P.S.O.E.",24
37,"37364",893,653,644,10,9,"P.S.O.E.",172
30,"30015",18792,14453,14336,120,117,"P.S.O.E.",3543
46,"46116",12587,9821,9724,120,97,"P.S.O.E.",2462
26,"26111",266,203,200,4,3,"P.S.O.E.",84
24,"24084",182,133,132,1,1,"P.S.O.E.",47
47,"47210",396,324,321,5,3,"P.S.O.E.",111
22,"22109",243,178,178,2,0,"P.S.O.E.",58
39,"39024",2065,1616,1601,8,15,"P.S.O.E.",403
10,"10032",1768,1438,1415,9,23,"P.S.O.E.",522
39,"39015",898,692,688,7,4,"P.S.O.E.",114
9,"9078",41,37,35,0,2,"P.S.O.E.",14
9,"9243",87,66,64,2,2,"P.S.O.E.",10
44,"44191",806,602,594,6,8,"P.S.O.E.",213
46,"46240",226,188,185,3,3,"P.S.O.E.",23
49,"49048",162,119,119,2,0,"P.S.O.E.",13
50,"50252",5345,3860,3792,79,68,"P.S.O.E.",1269
47,"47101",1740,1458,1444,12,14,"P.S.O.E.",595
19,"19181",69,54,54,5,0,"P.S.O.E.",13
37,"37278",736,538,529,7,9,"P.S.O.E.",131
29,"29020",3188,2448,2424,30,24,"P.S.O.E.",755
5,"5027",290,233,230,2,3,"P.S.O.E.",39
47,"47166",276,226,223,0,3,"P.S.O.E.",69
46,"46217",912,758,751,4,7,"P.S.O.E.",214
19,"19071",7346,5380,5294,76,86,"P.S.O.E.",1176
37,"37129",247,198,198,4,0,"P.S.O.E.",61
5,"5096",74,56,56,0,0,"P.S.O.E.",30
6,"6162",2964,2415,2390,19,25,"P.S.O.E.",1071
26,"26119",223,186,185,2,1,"P.S.O.E.",101
47,"47140",132,109,108,1,1,"P.S.O.E.",21
9,"9018",24688,17880,17508,345,372,"P.S.O.E.",5529
37,"37166",206,172,171,3,1,"P.S.O.E.",49
42,"42006",166,110,107,3,3,"P.S.O.E.",28
50,"50002",166,130,130,2,0,"P.S.O.E.",36
10,"10170",269,217,215,4,2,"P.S.O.E.",70
9,"9030",135,97,97,2,0,"P.S.O.E.",24
50,"50098",215,150,146,2,4,"P.S.O.E.",50
44,"44013",11286,7797,7584,242,213,"P.S.O.E.",2239
22,"22094",109,76,74,5,2,"P.S.O.E.",24
16,"16006",133,117,116,2,1,"P.S.O.E.",47
47,"47058",199,157,157,3,0,"P.S.O.E.",55
16,"16259",30,26,26,1,0,"P.S.O.E.",9
3,"3047",8867,6219,6113,76,106,"P.S.O.E.",1846
39,"39035",10031,7685,7601,74,84,"P.S.O.E.",1893
44,"44040",206,167,166,5,1,"P.S.O.E.",58
31,"31185",541,377,374,2,3,"P.S.O.E.",33
16,"16033",1792,1485,1454,10,31,"P.S.O.E.",540
39,"39018",4077,3212,3160,44,52,"P.S.O.E.",1006
5,"5120",38,28,28,1,0,"P.S.O.E.",8
9,"9084",200,147,147,4,0,"P.S.O.E.",36
40,"40144",19,17,17,1,0,"P.S.O.E.",2
46,"46256",6734,4902,4858,33,44,"P.S.O.E.",1175
37,"37021",86,70,68,2,2,"P.S.O.E.",20
24,"24101",465,274,266,5,8,"P.S.O.E.",127
12,"12137",47,36,35,0,1,"P.S.O.E.",22
22,"22021",2080,1524,1505,31,19,"P.S.O.E.",641
24,"24224",665,490,484,8,6,"P.S.O.E.",146
34,"34037",345,256,253,4,3,"P.S.O.E.",48
31,"31125",269,172,169,6,3,"P.S.O.E.",26
19,"19249",38,32,32,0,0,"P.S.O.E.",9
47,"47223",172,147,147,6,0,"P.S.O.E.",57
6,"6075",517,433,429,3,4,"P.S.O.E.",253
18,"18079",3497,2729,2706,15,23,"P.S.O.E.",1530
31,"31003",131,101,101,1,0,"P.S.O.E.",20
31,"31004",36,21,20,0,1,"P.S.O.E.",1
12,"12076",105,79,79,0,0,"P.S.O.E.",32
18,"18015",465,381,379,1,2,"P.S.O.E.",187
26,"26038",93,71,69,1,2,"P.S.O.E.",22
9,"9102",44,36,36,0,0,"P.S.O.E.",8
24,"24063",453,323,322,2,1,"P.S.O.E.",94
10,"10094",247,212,211,0,1,"P.S.O.E.",139
46,"46244",57805,41885,41595,415,290,"P.S.O.E.",10761
37,"37322",2501,1692,1676,32,16,"P.S.O.E.",456
18,"18045",1211,892,885,4,7,"P.S.O.E.",469
26,"26169",83,73,72,0,1,"P.S.O.E.",27
31,"31005",312,209,206,4,3,"P.S.O.E.",35
42,"42139",22,18,17,0,1,"P.S.O.E.",0
35,"35013",6779,5059,4961,105,98,"P.S.O.E.",983
5,"5196",69,54,54,2,0,"P.S.O.E.",26
37,"37134",250,192,189,1,3,"P.S.O.E.",73
46,"46123",1808,1440,1410,7,30,"P.S.O.E.",293
39,"39046",1442,1071,1050,13,21,"P.S.O.E.",356
47,"47144",85,65,65,2,0,"P.S.O.E.",16
24,"24025",331,237,237,5,0,"P.S.O.E.",44
37,"37209",376,258,253,4,5,"P.S.O.E.",99
44,"44089",57,50,49,0,1,"P.S.O.E.",3
6,"6078",548,457,453,2,4,"P.S.O.E.",132
50,"50181",1053,787,760,9,27,"P.S.O.E.",230
50,"50266",139,95,94,1,1,"P.S.O.E.",29
26,"26141",132,101,101,2,0,"P.S.O.E.",24
40,"40008",44,37,36,0,1,"P.S.O.E.",9
24,"24104",291,198,196,3,2,"P.S.O.E.",55
5,"5102",1850,1487,1475,11,12,"P.S.O.E.",436
29,"29071",915,601,598,4,3,"P.S.O.E.",254
10,"10096",3384,2581,2533,32,48,"P.S.O.E.",1123
46,"46051",8122,6432,6378,57,54,"P.S.O.E.",1425
3,"3041",5811,4325,4269,33,56,"P.S.O.E.",1146
10,"10055",709,523,508,13,15,"P.S.O.E.",156
3,"3074",1752,1479,1466,5,13,"P.S.O.E.",346
37,"37174",1150,942,922,3,20,"P.S.O.E.",298
5,"5037",296,213,212,0,1,"P.S.O.E.",26
18,"18084",3954,3039,3015,50,24,"P.S.O.E.",856
46,"46173",1393,1156,1137,10,19,"P.S.O.E.",319
44,"44132",64,57,56,0,1,"P.S.O.E.",17
9,"9105",111,85,81,2,4,"P.S.O.E.",22
19,"19043",92,82,82,1,0,"P.S.O.E.",21
44,"44092",89,68,68,0,0,"P.S.O.E.",16
33,"33002",10837,7667,7588,77,79,"P.S.O.E.",2527
47,"47209",43,33,33,0,0,"P.S.O.E.",7
10,"10070",765,614,613,5,1,"P.S.O.E.",231
18,"18071",5589,4268,4205,44,63,"P.S.O.E.",1744
16,"16001",79,66,66,1,0,"P.S.O.E.",23
37,"37175",408,319,311,6,8,"P.S.O.E.",74
47,"47090",2511,1907,1880,23,27,"P.S.O.E.",593
49,"49018",341,281,279,5,2,"P.S.O.E.",90
37,"37015",248,169,168,0,1,"P.S.O.E.",61
40,"40043",1842,1494,1469,28,25,"P.S.O.E.",406
12,"12112",104,90,90,0,0,"P.S.O.E.",35
10,"10057",166,133,133,0,0,"P.S.O.E.",78
6,"6082",373,315,311,3,4,"P.S.O.E.",141
34,"34100",141,105,105,1,0,"P.S.O.E.",21
39,"39049",339,244,242,5,2,"P.S.O.E.",69
22,"22212",93,79,79,0,0,"P.S.O.E.",27
9,"9270",180,147,143,2,4,"P.S.O.E.",28
10,"10113",2440,1891,1859,11,32,"P.S.O.E.",747
44,"44110",57,45,45,0,0,"P.S.O.E.",13
24,"24043",144,77,77,0,0,"P.S.O.E.",39
41,"41013",4762,3359,3327,9,32,"P.S.O.E.",1892
50,"50076",113,89,89,0,0,"P.S.O.E.",40
19,"19132",105,79,79,0,0,"P.S.O.E.",12
26,"26032",58,52,52,1,0,"P.S.O.E.",25
45,"45176",3570,2619,2583,45,36,"P.S.O.E.",585
7,"7008",5422,3782,3705,61,77,"P.S.O.E.",1033
6,"6054",5468,4305,4185,35,120,"P.S.O.E.",1773
50,"50117",131,101,100,1,1,"P.S.O.E.",30
31,"31040",197,137,135,2,2,"P.S.O.E.",24
47,"47174",302,236,234,3,2,"P.S.O.E.",70
34,"34004",5790,4354,4262,84,92,"P.S.O.E.",1254
18,"18176",265,183,181,0,2,"P.S.O.E.",120
42,"42164",1699,1244,1209,13,35,"P.S.O.E.",302
37,"37177",310,242,241,1,1,"P.S.O.E.",53
19,"19086",1655,1310,1295,10,15,"P.S.O.E.",507
18,"18086",397,321,321,3,0,"P.S.O.E.",238
26,"26047",2076,1702,1682,17,20,"P.S.O.E.",616
9,"9289",1540,1127,1117,16,10,"P.S.O.E.",341
5,"5001",210,180,176,2,4,"P.S.O.E.",36
6,"6086",1270,956,949,2,7,"P.S.O.E.",427
24,"24110",1291,914,904,16,10,"P.S.O.E.",416
45,"45069",1791,1409,1389,8,20,"P.S.O.E.",453
47,"47229",235,161,161,1,0,"P.S.O.E.",55
16,"16044",51,35,35,0,0,"P.S.O.E.",9
23,"23098",923,808,807,6,1,"P.S.O.E.",405
29,"29030",839,669,668,5,1,"P.S.O.E.",418
2,"2065",517,450,449,4,1,"P.S.O.E.",154
10,"10144",999,782,773,7,9,"P.S.O.E.",300
26,"26120",1515,1215,1198,20,17,"P.S.O.E.",431
50,"50177",355,268,265,4,3,"P.S.O.E.",82
5,"5172",147,122,122,0,0,"P.S.O.E.",37
9,"9032",118,68,68,0,0,"P.S.O.E.",35
18,"18167",1927,1397,1380,13,17,"P.S.O.E.",724
39,"39026",1825,1383,1371,12,12,"P.S.O.E.",268
50,"50187",72,45,45,1,0,"P.S.O.E.",16
5,"5053",94,73,71,0,2,"P.S.O.E.",7
5,"5163",1762,1400,1380,5,20,"P.S.O.E.",395
50,"50272",12481,8744,8642,176,102,"P.S.O.E.",2585
44,"44264",249,196,193,1,3,"P.S.O.E.",75
19,"19161",243,171,166,2,5,"P.S.O.E.",56
46,"46008",2727,2249,2233,17,16,"P.S.O.E.",599
26,"26009",426,318,313,4,5,"P.S.O.E.",109
26,"26136",111,90,90,3,0,"P.S.O.E.",22
10,"10200",499,368,368,0,0,"P.S.O.E.",147
29,"29042",14047,9845,9735,118,110,"P.S.O.E.",2525
18,"18905",12975,9260,9209,155,51,"P.S.O.E.",3185
50,"50188",34,28,27,0,1,"P.S.O.E.",7
47,"47068",41,28,28,0,0,"P.S.O.E.",6
24,"24034",3434,2524,2481,37,43,"P.S.O.E.",1056
19,"19194",113,80,76,1,4,"P.S.O.E.",25
44,"44209",892,666,649,6,17,"P.S.O.E.",238
41,"41101",5752,4663,4629,25,34,"P.S.O.E.",2175
9,"9117",82,59,59,1,0,"P.S.O.E.",13
37,"37258",206,151,149,2,2,"P.S.O.E.",46
14,"14032",434,377,375,1,2,"P.S.O.E.",182
37,"37370",345,261,260,1,1,"P.S.O.E.",45
37,"37182",92,72,72,2,0,"P.S.O.E.",7
7,"7046",13748,8294,8183,183,111,"P.S.O.E.",3107
46,"46009",3140,2521,2498,15,23,"P.S.O.E.",667
9,"9428",124,107,107,1,0,"P.S.O.E.",32
16,"16009",79,63,62,0,1,"P.S.O.E.",10
39,"39002",3400,2554,2514,35,40,"P.S.O.E.",742
9,"9206",65,56,55,2,1,"P.S.O.E.",7
47,"47017",205,177,176,1,1,"P.S.O.E.",18
26,"26181",14,12,12,0,0,"P.S.O.E.",3
24,"24116",451,297,294,5,3,"P.S.O.E.",94
34,"34152",142,114,109,1,5,"P.S.O.E.",33
10,"10025",408,355,337,4,18,"P.S.O.E.",164
9,"9073",889,672,663,12,9,"P.S.O.E.",170
6,"6031",490,387,385,8,2,"P.S.O.E.",149
24,"24078",426,323,316,0,7,"P.S.O.E.",129
10,"10026",598,458,447,5,11,"P.S.O.E.",182
34,"34068",32,23,23,0,0,"P.S.O.E.",2
40,"40194",40248,30946,30365,525,581,"P.S.O.E.",8698
22,"22083",522,437,428,4,9,"P.S.O.E.",153
19,"19230",438,317,309,4,8,"P.S.O.E.",69
2,"2070",439,372,366,4,6,"P.S.O.E.",259
9,"9298",90,74,74,1,0,"P.S.O.E.",3
40,"40054",145,103,102,1,1,"P.S.O.E.",25
42,"42025",1305,964,945,15,19,"P.S.O.E.",371
37,"37372",145,109,109,0,0,"P.S.O.E.",43
22,"22133",123,87,85,2,2,"P.S.O.E.",38
18,"18149",5096,3949,3900,36,49,"P.S.O.E.",1131
37,"37361",91,67,62,0,5,"P.S.O.E.",13
18,"18094",2398,1882,1868,16,14,"P.S.O.E.",710
34,"34155",142,118,117,3,1,"P.S.O.E.",42
22,"22043",112,72,71,2,1,"P.S.O.E.",18
50,"50219",3704,2672,2625,39,47,"P.S.O.E.",727
33,"33070",3481,2557,2521,33,36,"P.S.O.E.",811
19,"19198",22,19,19,0,0,"P.S.O.E.",9
49,"49163",235,167,167,0,0,"P.S.O.E.",41
46,"46059",1310,1076,1058,2,18,"P.S.O.E.",325
39,"39056",2387,1857,1835,22,22,"P.S.O.E.",386
18,"18095",1916,1428,1306,21,122,"P.S.O.E.",500
35,"35024",12420,6978,6819,131,159,"P.S.O.E.",1926
2,"2036",104,78,78,0,0,"P.S.O.E.",28
16,"16237",116,98,98,3,0,"P.S.O.E.",28
5,"5242",692,556,553,18,3,"P.S.O.E.",64
24,"24001",241,148,147,3,1,"P.S.O.E.",48
19,"19095",14,9,8,0,1,"P.S.O.E.",2
45,"45113",2094,1589,1555,6,34,"P.S.O.E.",462
6,"6050",4277,3500,3457,36,43,"P.S.O.E.",1275
2,"2012",1834,1632,1622,12,10,"P.S.O.E.",713
34,"34185",72,48,45,0,3,"P.S.O.E.",14
44,"44108",352,228,225,8,3,"P.S.O.E.",66
2,"2037",22380,15942,15724,203,218,"P.S.O.E.",5238
29,"29083",2212,1679,1652,15,27,"P.S.O.E.",774
47,"47182",1371,991,982,12,9,"P.S.O.E.",342
49,"49166",1294,1003,988,29,15,"P.S.O.E.",329
49,"49259",121,88,87,1,1,"P.S.O.E.",15
41,"41055",15121,11082,10997,98,85,"P.S.O.E.",5379
42,"42177",78,64,62,4,2,"P.S.O.E.",16
40,"40058",368,306,304,1,2,"P.S.O.E.",60
9,"9039",58,50,49,0,1,"P.S.O.E.",2
41,"41081",28121,20027,19785,275,242,"P.S.O.E.",10090
18,"18085",818,538,532,4,6,"P.S.O.E.",282
37,"37164",280,217,213,9,4,"P.S.O.E.",67
19,"19055",54,41,37,1,4,"P.S.O.E.",10
46,"46232",920,730,722,6,8,"P.S.O.E.",320
12,"12103",85,65,65,4,0,"P.S.O.E.",2
11,"11037",5640,4337,4285,32,52,"P.S.O.E.",1221
22,"22060",1180,909,891,13,18,"P.S.O.E.",358
44,"44204",24,21,21,0,0,"P.S.O.E.",10
10,"10141",289,209,209,0,0,"P.S.O.E.",75
34,"34210",103,93,91,2,2,"P.S.O.E.",21
24,"24004",535,391,390,0,1,"P.S.O.E.",125
49,"49153",183,141,139,1,2,"P.S.O.E.",37
18,"18184",2140,1663,1645,18,18,"P.S.O.E.",701
19,"19267",22,15,15,0,0,"P.S.O.E.",4
34,"34211",202,175,170,1,5,"P.S.O.E.",31
18,"18063",1189,795,789,7,6,"P.S.O.E.",417
12,"12124",1902,1532,1499,15,33,"P.S.O.E.",326
39,"39084",873,647,642,4,5,"P.S.O.E.",103
40,"40108",120,83,82,1,1,"P.S.O.E.",18
37,"37189",139,90,90,1,0,"P.S.O.E.",27
45,"45116",682,576,565,0,11,"P.S.O.E.",133
2,"2040",631,569,566,3,3,"P.S.O.E.",240
26,"26148",189,151,150,0,1,"P.S.O.E.",56
9,"9128",82,65,63,0,2,"P.S.O.E.",18
37,"37154",156,130,125,1,5,"P.S.O.E.",17
5,"5118",91,66,66,0,0,"P.S.O.E.",12
24,"24006",521,384,378,4,6,"P.S.O.E.",123
9,"9082",49,41,41,0,0,"P.S.O.E.",1
47,"47212",386,327,325,1,2,"P.S.O.E.",75
5,"5152",737,618,609,5,9,"P.S.O.E.",100
45,"45007",747,641,632,1,9,"P.S.O.E.",322
31,"31143",105,62,58,2,4,"P.S.O.E.",2
6,"6102",1045,851,840,7,11,"P.S.O.E.",400
46,"46185",422,360,359,7,1,"P.S.O.E.",169
7,"7032",19658,12168,11959,238,209,"P.S.O.E.",3929
44,"44180",71,52,52,1,0,"P.S.O.E.",17
41,"41015",5263,3820,3752,34,68,"P.S.O.E.",1924
24,"24194",327,237,236,5,1,"P.S.O.E.",165
44,"44153",1882,1273,1246,10,27,"P.S.O.E.",465
24,"24047",856,623,612,5,11,"P.S.O.E.",155
6,"6058",2048,1595,1574,22,21,"P.S.O.E.",727
26,"26121",33,28,28,0,0,"P.S.O.E.",11
46,"46007",11576,8929,8848,71,81,"P.S.O.E.",2025
2,"2078",967,770,756,9,14,"P.S.O.E.",288
41,"41059",31676,23199,22889,330,310,"P.S.O.E.",7782
45,"45118",1980,1412,1390,13,22,"P.S.O.E.",422
37,"37268",113,78,77,1,1,"P.S.O.E.",10
14,"14041",3215,2492,2439,45,53,"P.S.O.E.",754
39,"39009",3200,2427,2402,24,25,"P.S.O.E.",507
47,"47213",122,99,99,1,0,"P.S.O.E.",48
6,"6089",607,530,529,2,1,"P.S.O.E.",273
10,"10063",175,142,142,1,0,"P.S.O.E.",48
24,"24089",106265,77385,76124,1666,1261,"P.S.O.E.",24115
40,"40065",520,401,393,6,8,"P.S.O.E.",78
40,"40019",43,35,35,0,0,"P.S.O.E.",7
49,"49037",201,171,171,2,0,"P.S.O.E.",40
19,"19208",55,41,41,1,0,"P.S.O.E.",11
19,"19184",88,63,62,1,1,"P.S.O.E.",12
49,"49173",430,272,272,5,0,"P.S.O.E.",73
41,"41034",22561,16014,15840,270,174,"P.S.O.E.",7729
12,"12097",78,59,59,4,0,"P.S.O.E.",10
44,"44068",690,544,528,6,16,"P.S.O.E.",177
40,"40161",38,28,28,0,0,"P.S.O.E.",2
40,"40115",126,98,95,2,3,"P.S.O.E.",25
42,"42084",27,21,21,0,0,"P.S.O.E.",2
12,"12031",3748,2751,2687,35,64,"P.S.O.E.",747
33,"33007",1680,1186,1179,10,7,"P.S.O.E.",444
24,"24010",8550,6242,6111,100,131,"P.S.O.E.",1792
49,"49130",218,159,156,3,3,"P.S.O.E.",41
9,"9311",70,51,51,0,0,"P.S.O.E.",22
50,"50284",176,131,130,1,1,"P.S.O.E.",68
40,"40069",87,76,75,0,1,"P.S.O.E.",9
9,"9177",1154,823,815,12,8,"P.S.O.E.",175
24,"24091",704,502,496,8,6,"P.S.O.E.",142
5,"5022",1649,1335,1328,7,7,"P.S.O.E.",218
9,"9132",174,129,127,3,2,"P.S.O.E.",31
30,"30014",1686,1400,1387,10,13,"P.S.O.E.",457
12,"12098",665,552,539,9,13,"P.S.O.E.",161
2,"2082",121,107,107,1,0,"P.S.O.E.",43
10,"10121",8063,6048,5988,51,60,"P.S.O.E.",2189
9,"9086",629,467,461,5,6,"P.S.O.E.",97
31,"31117",670,471,467,3,4,"P.S.O.E.",5
31,"31905",2707,1913,1881,32,32,"P.S.O.E.",597
16,"16064",699,588,580,4,8,"P.S.O.E.",188
19,"19274",881,652,644,8,8,"P.S.O.E.",212
44,"44031",124,72,72,0,0,"P.S.O.E.",28
49,"49176",757,502,501,5,1,"P.S.O.E.",74
2,"2083",246,215,215,0,0,"P.S.O.E.",109
5,"5144",92,66,66,4,0,"P.S.O.E.",13
10,"10068",780,624,595,5,29,"P.S.O.E.",239
35,"35006",29515,20731,20286,362,445,"P.S.O.E.",6142
46,"46019",8671,7195,7109,70,86,"P.S.O.E.",2911
44,"44119",119,84,84,2,0,"P.S.O.E.",43
41,"41901",2626,2190,2167,24,23,"P.S.O.E.",1659
42,"42191",187,143,141,5,2,"P.S.O.E.",47
44,"44075",329,250,240,4,10,"P.S.O.E.",63
50,"50258",54,37,37,0,0,"P.S.O.E.",5
5,"5059",112,91,88,1,3,"P.S.O.E.",31
10,"10205",2081,1486,1457,19,29,"P.S.O.E.",686
45,"45198",1950,1661,1641,9,20,"P.S.O.E.",548
11,"11902",3578,2400,2376,21,24,"P.S.O.E.",962
49,"49177",298,199,196,6,3,"P.S.O.E.",66
45,"45014",4087,2851,2816,36,35,"P.S.O.E.",1091
22,"22013",304,239,236,3,3,"P.S.O.E.",90
40,"40025",158,124,124,0,0,"P.S.O.E.",10
6,"6157",497,350,343,0,7,"P.S.O.E.",140
41,"41011",15274,11359,11207,145,152,"P.S.O.E.",6520
10,"10003",616,463,458,3,5,"P.S.O.E.",138
9,"9076",24,15,15,0,0,"P.S.O.E.",2
37,"37225",119,101,95,3,6,"P.S.O.E.",13
19,"19310",13,9,8,0,1,"P.S.O.E.",6
38,"38038",161890,99555,97980,1101,1575,"P.S.O.E.",22490
23,"23079",3750,3084,3063,19,21,"P.S.O.E.",1500
12,"12001",1098,821,817,8,4,"P.S.O.E.",271
23,"23035",1066,919,912,3,7,"P.S.O.E.",468
16,"16110",98,81,81,3,0,"P.S.O.E.",5
22,"22015",336,237,235,11,2,"P.S.O.E.",72
46,"46093",2082,1722,1716,9,6,"P.S.O.E.",524
2,"2086",2856,2019,2005,9,14,"P.S.O.E.",846
49,"49272",102,87,86,0,1,"P.S.O.E.",16
31,"31029",987,693,680,16,13,"P.S.O.E.",157
12,"12133",64,47,47,0,0,"P.S.O.E.",6
47,"47012",134,105,105,0,0,"P.S.O.E.",29
5,"5160",339,290,286,2,4,"P.S.O.E.",47
47,"47139",1080,845,833,11,12,"P.S.O.E.",262
31,"31080",544,428,426,7,2,"P.S.O.E.",94
50,"50028",120,86,85,2,1,"P.S.O.E.",39
39,"39032",1576,1215,1209,10,6,"P.S.O.E.",232
7,"7051",4925,2993,2947,66,46,"P.S.O.E.",751
50,"50166",282,216,210,1,6,"P.S.O.E.",60
45,"45164",191,160,158,0,2,"P.S.O.E.",31
45,"45091",419,311,309,5,2,"P.S.O.E.",121
2,"2039",1050,862,848,16,14,"P.S.O.E.",300
22,"22047",228,200,200,5,0,"P.S.O.E.",34
10,"10006",1306,1081,1070,7,11,"P.S.O.E.",497
9,"9365",38,27,27,0,0,"P.S.O.E.",6
26,"26118",64,58,56,0,2,"P.S.O.E.",10
7,"7064",5286,3340,3279,53,61,"P.S.O.E.",1117
37,"37086",105,75,72,3,3,"P.S.O.E.",18
5,"5257",153,105,104,0,1,"P.S.O.E.",22
31,"31243",313,227,223,5,4,"P.S.O.E.",30
6,"6115",1261,893,885,7,8,"P.S.O.E.",358
39,"39068",663,488,485,4,3,"P.S.O.E.",91
3,"3001",359,296,292,2,4,"P.S.O.E.",47
46,"46022",15090,10922,10840,99,82,"P.S.O.E.",3130
19,"19215",206,170,166,0,4,"P.S.O.E.",32
16,"16031",62,34,32,4,2,"P.S.O.E.",8
31,"31031",234,144,143,1,1,"P.S.O.E.",10
19,"19073",24,20,19,0,1,"P.S.O.E.",8
10,"10048",299,232,231,0,1,"P.S.O.E.",47
45,"45129",145,121,120,0,1,"P.S.O.E.",40
19,"19318",36,19,19,1,0,"P.S.O.E.",9
18,"18111",2647,1957,1941,24,16,"P.S.O.E.",773
12,"12135",35189,25691,25345,380,346,"P.S.O.E.",7125
6,"6117",1471,1155,1130,8,25,"P.S.O.E.",438
19,"19183",108,87,86,1,1,"P.S.O.E.",42
22,"22036",101,82,82,1,0,"P.S.O.E.",18
10,"10007",680,537,519,5,18,"P.S.O.E.",172
24,"24113",404,318,310,3,8,"P.S.O.E.",80
18,"18154",1062,770,769,0,1,"P.S.O.E.",325
45,"45020",1396,1165,1151,15,14,"P.S.O.E.",347
29,"29031",1652,1123,1118,11,5,"P.S.O.E.",673
10,"10035",1941,1517,1492,15,25,"P.S.O.E.",817
49,"49185",171,140,140,3,0,"P.S.O.E.",37
19,"19150",128,112,108,0,4,"P.S.O.E.",34
26,"26076",144,124,123,3,1,"P.S.O.E.",35
24,"24223",2793,2121,2113,63,8,"P.S.O.E.",730
6,"6028",4366,3881,3809,35,72,"P.S.O.E.",1685
7,"7001",3450,2544,2470,36,74,"P.S.O.E.",885
44,"44208",32,23,23,1,0,"P.S.O.E.",3
46,"46113",2338,1804,1797,14,7,"P.S.O.E.",380
3,"3026",1210,1004,989,11,15,"P.S.O.E.",306
34,"34009",34,31,31,3,0,"P.S.O.E.",0
10,"10092",316,263,262,1,1,"P.S.O.E.",125
9,"9372",207,169,165,1,4,"P.S.O.E.",42
26,"26122",109,94,92,2,2,"P.S.O.E.",19
19,"19185",40,21,19,0,2,"P.S.O.E.",5
46,"46017",32928,24879,24672,267,207,"P.S.O.E.",5114
47,"47114",4107,2877,2834,37,43,"P.S.O.E.",788
45,"45901",811,595,591,2,4,"P.S.O.E.",189
12,"12007",747,674,660,9,14,"P.S.O.E.",154
19,"19039",73,57,57,0,0,"P.S.O.E.",18
46,"46049",292,249,245,0,4,"P.S.O.E.",52
26,"26037",150,129,128,1,1,"P.S.O.E.",47
41,"41043",647,457,454,5,3,"P.S.O.E.",271
19,"19284",11,11,11,0,0,"P.S.O.E.",8
26,"26123",129,113,113,1,0,"P.S.O.E.",32
31,"31065",1927,1391,1362,39,29,"P.S.O.E.",473
41,"41069",28331,21065,20877,252,188,"P.S.O.E.",6785
7,"7002",6305,4188,4073,80,115,"P.S.O.E.",1198
47,"47143",146,108,107,0,1,"P.S.O.E.",12
19,"19219",18,12,12,0,0,"P.S.O.E.",10
46,"46250",574266,435877,431619,4626,4258,"P.S.O.E.",103103
6,"6077",373,307,304,4,3,"P.S.O.E.",166
50,"50293",492,339,338,6,1,"P.S.O.E.",151
19,"19186",93,77,77,0,0,"P.S.O.E.",36
5,"5132",1040,770,753,2,17,"P.S.O.E.",259
40,"40179",634,545,538,4,7,"P.S.O.E.",164
46,"46220",48981,34657,34242,450,415,"P.S.O.E.",9271
23,"23001",1058,922,920,6,2,"P.S.O.E.",453
12,"12109",700,564,555,7,9,"P.S.O.E.",196
19,"19153",25,17,17,0,0,"P.S.O.E.",8
45,"45098",2273,1799,1756,11,43,"P.S.O.E.",280
24,"24064",1532,1128,1107,17,21,"P.S.O.E.",514
33,"33016",19516,14345,14210,198,135,"P.S.O.E.",3551
39,"39047",1987,1495,1482,9,13,"P.S.O.E.",256
47,"47035",956,778,768,5,10,"P.S.O.E.",259
46,"46245",478,357,354,1,3,"P.S.O.E.",95
33,"33062",452,282,281,3,1,"P.S.O.E.",93
39,"39090",731,577,572,3,5,"P.S.O.E.",110
42,"42206",10,9,9,1,0,"P.S.O.E.",0
34,"34096",56,41,39,1,2,"P.S.O.E.",8
19,"19117",1526,1155,1132,26,23,"P.S.O.E.",407
46,"46148",1400,1131,1114,13,17,"P.S.O.E.",273
31,"31006",1988,1434,1395,22,39,"P.S.O.E.",554
3,"3109",2745,2332,2302,18,30,"P.S.O.E.",808
9,"9023",993,771,765,22,6,"P.S.O.E.",176
12,"12140",1204,975,954,9,21,"P.S.O.E.",373
19,"19324",199,151,151,2,0,"P.S.O.E.",57
16,"16123",110,74,73,1,1,"P.S.O.E.",24
39,"39073",9275,6984,6903,83,81,"P.S.O.E.",1578
3,"3008",176,142,140,1,2,"P.S.O.E.",46
50,"50153",1002,757,748,12,9,"P.S.O.E.",347
46,"46246",1081,917,904,5,13,"P.S.O.E.",225
37,"37098",355,267,265,1,2,"P.S.O.E.",106
50,"50267",648,450,441,8,9,"P.S.O.E.",179
47,"47172",149,125,124,3,1,"P.S.O.E.",23
47,"47146",236,196,195,4,1,"P.S.O.E.",72
46,"46045",1288,1065,1044,2,21,"P.S.O.E.",215
29,"29046",2777,2032,2013,10,19,"P.S.O.E.",1015
40,"40229",45,37,37,0,0,"P.S.O.E.",8
9,"9151",509,389,383,5,6,"P.S.O.E.",154
34,"34099",56,49,47,1,2,"P.S.O.E.",8
22,"22176",173,154,149,2,5,"P.S.O.E.",26
49,"49151",680,494,491,6,3,"P.S.O.E.",180
5,"5135",440,363,360,0,3,"P.S.O.E.",81
29,"29056",1177,807,794,3,13,"P.S.O.E.",337
16,"16002",195,175,172,0,3,"P.S.O.E.",48
44,"44047",267,162,160,4,2,"P.S.O.E.",35
39,"39075",140941,103308,102362,1364,946,"P.S.O.E.",24425
16,"16166",277,210,202,0,8,"P.S.O.E.",82
5,"5169",241,218,218,0,0,"P.S.O.E.",32
18,"18107",988,769,760,3,9,"P.S.O.E.",433
26,"26071",8475,6088,5964,92,124,"P.S.O.E.",1947
46,"46216",4806,3857,3825,39,32,"P.S.O.E.",786
26,"26161",9,8,8,0,0,"P.S.O.E.",0
3,"3044",4459,3798,3753,21,45,"P.S.O.E.",898
41,"41039",31429,23337,23138,294,199,"P.S.O.E.",8462
34,"34048",72,58,56,3,2,"P.S.O.E.",13
31,"31030",155,113,112,3,1,"P.S.O.E.",18
50,"50184",132,106,106,1,0,"P.S.O.E.",31
9,"9199",97,75,74,0,1,"P.S.O.E.",8
39,"39050",305,207,205,1,2,"P.S.O.E.",26
42,"42060",33,22,22,0,0,"P.S.O.E.",0
3,"3011",7341,5277,5218,72,59,"P.S.O.E.",1503
19,"19224",119,95,94,0,1,"P.S.O.E.",10
6,"6130",216,182,180,0,2,"P.S.O.E.",85
46,"46152",96,70,70,0,0,"P.S.O.E.",24
34,"34190",59,42,42,4,0,"P.S.O.E.",2
10,"10101",172,134,129,1,5,"P.S.O.E.",58
47,"47121",590,495,490,4,5,"P.S.O.E.",232
40,"40234",441,363,355,3,8,"P.S.O.E.",114
11,"11001",4389,3110,3072,13,38,"P.S.O.E.",1469
9,"9337",126,88,87,1,1,"P.S.O.E.",36
38,"38052",1344,886,872,5,14,"P.S.O.E.",188
12,"12114",228,178,173,2,5,"P.S.O.E.",59
46,"46249",9650,7288,7191,125,97,"P.S.O.E.",2390
37,"37102",430,323,322,1,1,"P.S.O.E.",80
5,"5074",755,639,638,5,1,"P.S.O.E.",158
44,"44262",141,114,113,2,1,"P.S.O.E.",37
40,"40047",47,37,36,0,1,"P.S.O.E.",6
50,"50271",283,209,207,4,2,"P.S.O.E.",56
5,"5171",84,74,73,0,1,"P.S.O.E.",10
38,"38053",3752,2459,2397,28,62,"P.S.O.E.",562
9,"9200",54,35,35,2,0,"P.S.O.E.",10
18,"18022",12448,8777,8659,111,118,"P.S.O.E.",3591
10,"10211",461,341,334,3,7,"P.S.O.E.",156
9,"9184",4,4,4,0,0,"P.S.O.E.",0
37,"37255",58,47,47,3,0,"P.S.O.E.",7
12,"12074",783,679,676,3,3,"P.S.O.E.",273
18,"18066",2072,1558,1552,8,6,"P.S.O.E.",938
10,"10184",771,609,597,7,12,"P.S.O.E.",248
16,"16102",1320,1016,1007,15,9,"P.S.O.E.",284
37,"37356",90,66,66,1,0,"P.S.O.E.",16
5,"5076",477,397,385,4,12,"P.S.O.E.",63
50,"50129",258,164,164,0,0,"P.S.O.E.",54
41,"41076",2227,1507,1492,5,15,"P.S.O.E.",722
24,"24074",107,87,87,0,0,"P.S.O.E.",29
9,"9294",123,96,93,1,3,"P.S.O.E.",38
49,"49202",221,158,157,2,1,"P.S.O.E.",41
10,"10145",132,112,111,0,1,"P.S.O.E.",45
31,"31164",604,462,448,9,14,"P.S.O.E.",188
22,"22186",217,173,173,3,0,"P.S.O.E.",92
34,"34241",20,12,11,0,1,"P.S.O.E.",1
18,"18188",1659,1329,1308,9,21,"P.S.O.E.",699
37,"37219",197,121,120,0,1,"P.S.O.E.",24
23,"23057",823,717,711,4,6,"P.S.O.E.",315
42,"42009",97,69,67,2,2,"P.S.O.E.",7
26,"26138",4646,3468,3398,46,70,"P.S.O.E.",999
46,"46130",934,745,734,6,11,"P.S.O.E.",229
5,"5008",244,200,196,1,4,"P.S.O.E.",46
6,"6045",513,418,412,8,6,"P.S.O.E.",195
31,"31044",276,224,223,0,1,"P.S.O.E.",7
42,"42068",99,74,74,5,0,"P.S.O.E.",8
14,"14002",10991,8444,8358,106,86,"P.S.O.E.",4310
22,"22187",295,222,222,3,0,"P.S.O.E.",81
9,"9476",67,52,52,0,0,"P.S.O.E.",14
40,"40052",95,69,69,0,0,"P.S.O.E.",19
50,"50042",16,14,14,0,0,"P.S.O.E.",3
31,"31014",280,197,196,2,1,"P.S.O.E.",23
24,"24077",237,205,199,2,6,"P.S.O.E.",76
9,"9208",252,192,192,6,0,"P.S.O.E.",43
37,"37062",92,73,73,1,0,"P.S.O.E.",5
50,"50014",169,108,108,1,0,"P.S.O.E.",28
49,"49160",54,35,34,3,1,"P.S.O.E.",17
12,"12088",55,51,51,2,0,"P.S.O.E.",10
9,"9119",51,38,38,0,0,"P.S.O.E.",13
45,"45073",351,265,261,3,4,"P.S.O.E.",83
9,"9164",179,130,130,1,0,"P.S.O.E.",30
31,"31167",859,600,593,11,7,"P.S.O.E.",111
10,"10108",231,152,152,0,0,"P.S.O.E.",45
23,"23060",19107,14365,14264,130,101,"P.S.O.E.",6380
34,"34108",561,477,465,6,12,"P.S.O.E.",204
5,"5176",237,193,190,4,3,"P.S.O.E.",42
47,"47044",325,257,252,1,5,"P.S.O.E.",90
37,"37109",191,142,141,1,1,"P.S.O.E.",18
44,"44018",27,23,23,0,0,"P.S.O.E.",1
9,"9430",18,15,15,0,0,"P.S.O.E.",5
31,"31168",247,165,163,0,2,"P.S.O.E.",16
26,"26170",471,353,348,4,5,"P.S.O.E.",104
9,"9209",4617,3269,3234,44,35,"P.S.O.E.",668
46,"46035",6470,5115,5047,38,68,"P.S.O.E.",1563
31,"31260",1263,788,780,11,8,"P.S.O.E.",104
19,"19127",97,66,66,1,0,"P.S.O.E.",13
40,"40009",49,41,41,0,0,"P.S.O.E.",13
19,"19166",179,123,121,4,2,"P.S.O.E.",28
9,"9075",126,102,101,1,1,"P.S.O.E.",22
37,"37224",216,190,186,5,4,"P.S.O.E.",25
26,"26015",205,167,165,1,2,"P.S.O.E.",28
49,"49077",210,146,144,1,2,"P.S.O.E.",37
12,"12021",4433,3368,3292,42,76,"P.S.O.E.",1085
46,"46011",7727,5874,5777,75,97,"P.S.O.E.",1306
29,"29064",584,428,422,4,6,"P.S.O.E.",151
10,"10111",1453,1052,1046,13,6,"P.S.O.E.",350
49,"49164",158,120,114,2,6,"P.S.O.E.",50
3,"3020",108,87,86,1,1,"P.S.O.E.",34
50,"50220",59,43,43,1,0,"P.S.O.E.",20
24,"24040",494,369,366,6,3,"P.S.O.E.",109
49,"49210",493,358,356,6,2,"P.S.O.E.",152
24,"24202",8677,5486,5377,103,109,"P.S.O.E.",2189
49,"49165",72,63,63,0,0,"P.S.O.E.",15
18,"18096",348,289,287,1,2,"P.S.O.E.",169
24,"24041",602,403,396,3,7,"P.S.O.E.",128
12,"12091",203,153,140,2,13,"P.S.O.E.",29
46,"46109",6143,4731,4637,40,94,"P.S.O.E.",1454
22,"22139",86,66,63,2,3,"P.S.O.E.",10
37,"37339",345,280,279,3,1,"P.S.O.E.",98
18,"18128",361,284,283,5,1,"P.S.O.E.",85
3,"3021",5594,4630,4517,46,113,"P.S.O.E.",1240
22,"22197",504,395,390,7,5,"P.S.O.E.",132
49,"49062",142,104,104,1,0,"P.S.O.E.",26
31,"31069",860,660,647,2,13,"P.S.O.E.",168
14,"14047",1566,1154,1143,19,11,"P.S.O.E.",538
50,"50194",102,67,67,2,0,"P.S.O.E.",14
46,"46261",1706,1388,1366,13,22,"P.S.O.E.",362
39,"39058",862,586,584,6,2,"P.S.O.E.",198
50,"50279",111,79,79,1,0,"P.S.O.E.",50
40,"40045",123,102,102,0,0,"P.S.O.E.",15
18,"18030",612,457,456,0,1,"P.S.O.E.",212
37,"37340",155,121,121,0,0,"P.S.O.E.",16
5,"5180",109,92,91,1,1,"P.S.O.E.",3
3,"3022",160,133,131,1,2,"P.S.O.E.",26
26,"26103",796,616,611,11,5,"P.S.O.E.",233
37,"37378",118,85,85,3,0,"P.S.O.E.",32
34,"34904",355,247,241,3,6,"P.S.O.E.",90
19,"19201",70,52,52,2,0,"P.S.O.E.",8
45,"45042",184,154,151,3,3,"P.S.O.E.",36
31,"31111",100,75,75,1,0,"P.S.O.E.",11
9,"9172",129,110,109,2,1,"P.S.O.E.",16
33,"33072",1737,1171,1159,11,12,"P.S.O.E.",386
19,"19235",121,92,87,0,5,"P.S.O.E.",48
44,"44151",215,143,140,1,3,"P.S.O.E.",55
42,"42182",62,53,53,2,0,"P.S.O.E.",1
19,"19133",103,89,88,2,1,"P.S.O.E.",44
24,"24086",323,245,243,1,2,"P.S.O.E.",64
44,"44064",93,63,62,0,1,"P.S.O.E.",16
31,"31021",75,52,52,0,0,"P.S.O.E.",10
47,"47157",544,462,458,9,4,"P.S.O.E.",149
9,"9396",152,113,113,0,0,"P.S.O.E.",16
18,"18134",5528,3751,3679,57,72,"P.S.O.E.",1118
35,"35001",4663,3639,3569,39,70,"P.S.O.E.",1104
37,"37230",221,173,171,0,2,"P.S.O.E.",63
45,"45043",827,679,670,3,9,"P.S.O.E.",244
6,"6147",390,321,319,3,2,"P.S.O.E.",172
34,"34147",192,139,137,1,2,"P.S.O.E.",22
18,"18122",16253,12271,12109,132,162,"P.S.O.E.",5253
6,"6118",228,181,181,1,0,"P.S.O.E.",103
42,"42020",4385,3055,2957,74,98,"P.S.O.E.",895
37,"37179",230,194,191,3,3,"P.S.O.E.",47
46,"46016",1097,927,917,12,10,"P.S.O.E.",382
2,"2018",922,759,754,7,5,"P.S.O.E.",272
39,"39078",1407,1041,1033,10,8,"P.S.O.E.",198
6,"6103",4777,3702,3671,31,31,"P.S.O.E.",1405
50,"50224",70,52,49,2,3,"P.S.O.E.",9
44,"44066",121,88,86,0,2,"P.S.O.E.",44
10,"10118",306,262,261,2,1,"P.S.O.E.",127
31,"31083",50,37,37,0,0,"P.S.O.E.",0
31,"31114",384,320,318,37,2,"P.S.O.E.",78
41,"41033",5237,3915,3878,20,37,"P.S.O.E.",2000
24,"24088",1103,903,885,4,18,"P.S.O.E.",296
5,"5055",649,525,518,3,7,"P.S.O.E.",155
39,"39061",3458,2673,2644,42,29,"P.S.O.E.",377
26,"26107",97,79,79,1,0,"P.S.O.E.",30
16,"16104",65,52,52,1,0,"P.S.O.E.",22
37,"37233",59,46,45,1,1,"P.S.O.E.",16
6,"6150",860,722,710,2,12,"P.S.O.E.",310
39,"39010",688,533,524,6,9,"P.S.O.E.",181
6,"6014",6843,4894,4839,30,55,"P.S.O.E.",1411
10,"10119",714,489,482,3,7,"P.S.O.E.",235
44,"44196",152,116,114,2,2,"P.S.O.E.",54
47,"47186",251279,193705,191693,2746,2012,"P.S.O.E.",54557
50,"50227",105,79,79,2,0,"P.S.O.E.",10
34,"34122",80,65,62,2,3,"P.S.O.E.",16
24,"24129",125,88,86,5,2,"P.S.O.E.",23
50,"50228",295,238,236,10,2,"P.S.O.E.",45
39,"39062",1759,1397,1387,9,10,"P.S.O.E.",208
3,"3095",4498,3558,3517,29,41,"P.S.O.E.",1022
2,"2081",18319,14324,14096,225,228,"P.S.O.E.",4531
19,"19240",64,47,46,1,1,"P.S.O.E.",12
9,"9221",446,343,340,7,3,"P.S.O.E.",90
50,"50140",172,108,108,1,0,"P.S.O.E.",37
31,"31146",46,34,34,1,0,"P.S.O.E.",5
9,"9442",385,295,289,4,6,"P.S.O.E.",85
49,"49040",118,102,98,1,4,"P.S.O.E.",50
16,"16023",468,332,327,3,5,"P.S.O.E.",110
40,"40118",59,44,43,1,1,"P.S.O.E.",9
37,"37121",557,458,451,8,7,"P.S.O.E.",150
46,"46188",660,579,576,4,3,"P.S.O.E.",117
3,"3061",1052,842,836,6,6,"P.S.O.E.",152
42,"42085",219,167,167,2,0,"P.S.O.E.",26
39,"39089",163,126,126,0,0,"P.S.O.E.",13
31,"31026",154,125,122,1,3,"P.S.O.E.",40
31,"31147",103,81,80,3,1,"P.S.O.E.",11
37,"37310",154,115,115,1,0,"P.S.O.E.",43
50,"50229",62,47,46,2,1,"P.S.O.E.",20
37,"37236",163,123,119,4,4,"P.S.O.E.",21
6,"6017",292,250,250,0,0,"P.S.O.E.",70
33,"33069",3611,2615,2597,25,18,"P.S.O.E.",936
19,"19142",259,191,190,0,1,"P.S.O.E.",72
37,"37123",206,166,165,1,1,"P.S.O.E.",15
41,"41010",4338,2990,2958,48,32,"P.S.O.E.",1099
10,"10082",1947,1601,1572,10,29,"P.S.O.E.",666
31,"31057",1863,1450,1409,32,41,"P.S.O.E.",514
6,"6155",1911,1384,1363,18,21,"P.S.O.E.",582
16,"16025",31,23,23,0,0,"P.S.O.E.",4
31,"31906",2493,1796,1770,57,26,"P.S.O.E.",402
24,"24093",388,262,258,1,4,"P.S.O.E.",92
37,"37237",330,250,242,1,8,"P.S.O.E.",96
3,"3098",526,410,400,6,10,"P.S.O.E.",144
44,"44158",1159,904,873,15,31,"P.S.O.E.",327
9,"9224",172,125,125,3,0,"P.S.O.E.",19
45,"45161",11339,7989,7869,95,120,"P.S.O.E.",1720
49,"49092",160,123,123,2,0,"P.S.O.E.",41
39,"39065",272,199,197,2,2,"P.S.O.E.",47
9,"9091",746,556,550,8,6,"P.S.O.E.",119
12,"12070",576,473,463,5,10,"P.S.O.E.",167
37,"37125",243,184,180,3,4,"P.S.O.E.",38
24,"24094",1466,1023,1006,24,17,"P.S.O.E.",290
44,"44201",526,449,443,9,6,"P.S.O.E.",223
45,"45162",773,599,594,3,5,"P.S.O.E.",227
14,"14016",1406,1123,1115,9,8,"P.S.O.E.",518
33,"33056",5278,3576,3540,41,36,"P.S.O.E.",1068
34,"34084",142,124,122,3,2,"P.S.O.E.",21
50,"50055",3592,2520,2473,59,47,"P.S.O.E.",716
37,"37003",134,103,102,0,1,"P.S.O.E.",28
24,"24217",144,108,107,2,1,"P.S.O.E.",29
22,"22209",161,115,115,4,0,"P.S.O.E.",60
47,"47138",259,198,195,3,3,"P.S.O.E.",74
49,"49230",122,98,95,1,3,"P.S.O.E.",36
41,"41064",5629,4041,4006,28,35,"P.S.O.E.",2288
45,"45054",4285,3321,3274,32,47,"P.S.O.E.",904
9,"9093",154,127,125,1,2,"P.S.O.E.",36
50,"50155",119,91,91,1,0,"P.S.O.E.",31
9,"9410",3181,2079,2049,48,30,"P.S.O.E.",857
44,"44035",122,99,98,3,1,"P.S.O.E.",12
26,"26115",20,20,20,4,0,"P.S.O.E.",4
24,"24017",630,476,468,11,8,"P.S.O.E.",149
37,"37115",135,107,101,2,6,"P.S.O.E.",15
23,"23081",1643,1245,1234,12,11,"P.S.O.E.",693
38,"38007",1844,1209,1188,5,21,"P.S.O.E.",352
46,"46046",922,699,694,2,5,"P.S.O.E.",134
26,"26117",2152,1682,1655,20,27,"P.S.O.E.",609
23,"23039",2239,1799,1764,9,35,"P.S.O.E.",827
34,"34224",53,42,41,0,1,"P.S.O.E.",14
40,"40076",6641,4958,4862,67,96,"P.S.O.E.",1272
49,"49275",53766,37940,37379,774,561,"P.S.O.E.",10682
50,"50233",120,89,88,2,1,"P.S.O.E.",16
37,"37241",172,135,134,1,1,"P.S.O.E.",24
9,"9094",49,39,39,0,0,"P.S.O.E.",10
44,"44080",294,216,211,3,5,"P.S.O.E.",102
40,"40125",99,72,71,3,1,"P.S.O.E.",15
35,"35009",19678,13799,13442,155,357,"P.S.O.E.",3547
33,"33012",5341,3816,3777,43,39,"P.S.O.E.",1223
6,"6161",335,261,259,2,2,"P.S.O.E.",109
9,"9228",168,143,143,3,0,"P.S.O.E.",29
18,"18042",425,344,342,2,2,"P.S.O.E.",156
47,"47112",2671,2231,2198,28,33,"P.S.O.E.",543
44,"44206",156,119,117,3,2,"P.S.O.E.",38
16,"16156",122,91,91,0,0,"P.S.O.E.",40
30,"30020",5989,4533,4487,14,46,"P.S.O.E.",866
18,"18145",10083,7592,7499,78,93,"P.S.O.E.",2171
6,"6025",5083,3898,3851,51,47,"P.S.O.E.",1435
37,"37007",467,368,363,6,5,"P.S.O.E.",125
46,"46120",1133,889,870,2,19,"P.S.O.E.",275
45,"45166",1734,1460,1429,8,31,"P.S.O.E.",624
35,"35010",3565,2178,2135,26,43,"P.S.O.E.",538
7,"7011",26954,16786,16595,299,191,"P.S.O.E.",5318
31,"31032",1785,1330,1305,24,25,"P.S.O.E.",624
49,"49171",704,568,561,6,7,"P.S.O.E.",199
3,"3115",267,242,242,2,0,"P.S.O.E.",74
35,"35027",10510,7523,7375,88,148,"P.S.O.E.",2053
24,"24142",24843,17695,17371,409,324,"P.S.O.E.",6625
33,"33013",466,349,345,4,4,"P.S.O.E.",89
40,"40220",71,57,52,0,5,"P.S.O.E.",11
10,"10008",1393,1105,1086,10,19,"P.S.O.E.",404
50,"50291",112,75,73,0,2,"P.S.O.E.",22
37,"37130",177,153,153,2,0,"P.S.O.E.",10
40,"40129",203,166,162,1,4,"P.S.O.E.",35
34,"34133",108,90,90,0,0,"P.S.O.E.",5
3,"3037",354,293,289,1,4,"P.S.O.E.",103
11,"11022",48624,26656,26430,345,226,"P.S.O.E.",8494
6,"6120",3508,2772,2741,31,31,"P.S.O.E.",1162
46,"46194",15267,11622,11491,110,131,"P.S.O.E.",3114
44,"44168",194,154,152,4,2,"P.S.O.E.",28
34,"34228",93,80,80,0,0,"P.S.O.E.",28
50,"50120",53,41,41,0,0,"P.S.O.E.",14
26,"26078",85,69,69,0,0,"P.S.O.E.",21
37,"37132",398,317,311,3,6,"P.S.O.E.",117
16,"16034",207,174,173,0,1,"P.S.O.E.",64
49,"49101",186,134,129,0,5,"P.S.O.E.",23
37,"37358",163,143,139,0,4,"P.S.O.E.",33
22,"22909",349,259,252,3,7,"P.S.O.E.",110
34,"34010",560,458,451,7,7,"P.S.O.E.",133
9,"9191",45,34,33,1,1,"P.S.O.E.",7
16,"16264",505,440,438,6,2,"P.S.O.E.",158
49,"49055",115,96,95,1,1,"P.S.O.E.",26
33,"33015",1695,1177,1161,12,16,"P.S.O.E.",338
3,"3039",92,70,66,1,4,"P.S.O.E.",27
3,"3106",642,542,535,3,7,"P.S.O.E.",191
19,"19002",99,77,76,0,1,"P.S.O.E.",36
49,"49238",289,233,231,3,2,"P.S.O.E.",76
31,"31035",60,47,47,0,0,"P.S.O.E.",12
44,"44171",186,127,124,3,3,"P.S.O.E.",37
16,"16036",143,117,115,1,2,"P.S.O.E.",47
47,"47060",262,220,218,1,2,"P.S.O.E.",66
9,"9456",142,110,110,3,0,"P.S.O.E.",39
31,"31096",127,112,110,2,2,"P.S.O.E.",26
34,"34011",406,327,327,4,0,"P.S.O.E.",110
6,"6032",76,59,59,1,0,"P.S.O.E.",11
40,"40132",75,50,50,1,0,"P.S.O.E.",10
23,"23002",17740,14007,13858,171,149,"P.S.O.E.",6297
10,"10216",1549,1247,1235,15,12,"P.S.O.E.",494
45,"45171",1359,1114,1093,13,21,"P.S.O.E.",401
50,"50152",1569,1151,1135,31,16,"P.S.O.E.",406
46,"46196",159,145,144,1,1,"P.S.O.E.",38
34,"34137",31,24,24,3,0,"P.S.O.E.",13
22,"22068",79,51,51,2,0,"P.S.O.E.",10
49,"49105",158,135,133,2,2,"P.S.O.E.",22
3,"3007",160,131,127,0,4,"P.S.O.E.",28
9,"9375",42,30,30,1,0,"P.S.O.E.",6
33,"33017",3289,2378,2350,35,28,"P.S.O.E.",839
44,"44090",84,71,71,0,0,"P.S.O.E.",14
23,"23047",1658,1342,1339,6,3,"P.S.O.E.",728
24,"24066",561,440,437,5,3,"P.S.O.E.",89
34,"34015",45,40,40,0,0,"P.S.O.E.",7
19,"19221",56,41,41,2,0,"P.S.O.E.",14
47,"47145",658,482,473,7,9,"P.S.O.E.",96
37,"37135",1234,972,961,8,11,"P.S.O.E.",281
23,"23092",27970,20921,20651,284,270,"P.S.O.E.",7341
24,"24106",340,229,228,6,1,"P.S.O.E.",51
10,"10138",551,451,443,7,8,"P.S.O.E.",258
41,"41071",5603,3999,3932,28,67,"P.S.O.E.",1880
34,"34017",960,772,760,15,12,"P.S.O.E.",245
22,"22072",209,130,128,2,2,"P.S.O.E.",54
37,"37362",4333,3276,3238,65,38,"P.S.O.E.",652
3,"3904",1416,1104,1096,11,8,"P.S.O.E.",387
19,"19188",72,48,48,1,0,"P.S.O.E.",11
10,"10098",412,317,313,5,4,"P.S.O.E.",135
31,"31038",1372,982,968,17,14,"P.S.O.E.",244
23,"23005",30698,23126,22916,310,210,"P.S.O.E.",8256
6,"6126",2199,1706,1686,14,20,"P.S.O.E.",900
35,"35015",9065,4859,4770,64,89,"P.S.O.E.",1491
24,"24107",316,208,206,1,2,"P.S.O.E.",78
24,"24230",450,333,327,4,6,"P.S.O.E.",92
18,"18049",632,476,474,5,2,"P.S.O.E.",202
9,"9241",198,159,158,5,1,"P.S.O.E.",35
6,"6037",1789,1258,1252,6,6,"P.S.O.E.",477
49,"49109",657,534,529,12,5,"P.S.O.E.",162
19,"19255",95,68,68,0,0,"P.S.O.E.",31
29,"29028",1253,887,876,8,11,"P.S.O.E.",467
19,"19190",2499,1829,1785,32,44,"P.S.O.E.",638
34,"34141",190,162,160,0,2,"P.S.O.E.",53
16,"16027",779,619,612,5,7,"P.S.O.E.",251
9,"9242",93,82,82,2,0,"P.S.O.E.",19
40,"40139",302,243,238,5,5,"P.S.O.E.",71
29,"29001",4176,3339,3303,23,36,"P.S.O.E.",1839
5,"5105",349,275,272,12,3,"P.S.O.E.",56
6,"6068",481,383,378,3,5,"P.S.O.E.",206
34,"34019",139,108,108,5,0,"P.S.O.E.",30
31,"31009",717,510,497,14,13,"P.S.O.E.",126
3,"3045",233,204,203,2,1,"P.S.O.E.",68
19,"19327",551,459,449,3,10,"P.S.O.E.",74
2,"2027",347,301,301,2,0,"P.S.O.E.",100
6,"6038",816,621,620,6,1,"P.S.O.E.",309
50,"50242",102,82,82,2,0,"P.S.O.E.",23
49,"49245",296,218,218,2,0,"P.S.O.E.",63
12,"12902",2056,1454,1411,14,43,"P.S.O.E.",399
44,"44178",69,45,44,0,1,"P.S.O.E.",6
45,"45067",2385,1923,1878,19,45,"P.S.O.E.",468
42,"42113",553,412,404,7,8,"P.S.O.E.",86
16,"16043",105,86,86,1,0,"P.S.O.E.",16
9,"9112",115,80,80,4,0,"P.S.O.E.",23
33,"33020",13542,9300,9173,135,127,"P.S.O.E.",2886
26,"26006",1853,1456,1430,15,26,"P.S.O.E.",478
37,"37253",137,115,115,1,0,"P.S.O.E.",37
49,"49246",248,212,210,1,2,"P.S.O.E.",39
39,"39025",8985,7048,6955,70,93,"P.S.O.E.",2181
49,"49112",131,93,93,2,0,"P.S.O.E.",37
9,"9244",53,44,44,0,0,"P.S.O.E.",10
50,"50214",31,22,21,1,1,"P.S.O.E.",3
19,"19226",40,31,30,0,1,"P.S.O.E.",6
47,"47066",1114,891,888,10,3,"P.S.O.E.",255
37,"37019",157,114,113,0,1,"P.S.O.E.",5
18,"18153",8348,6170,6118,88,52,"P.S.O.E.",1859
22,"22230",302,234,231,11,3,"P.S.O.E.",67
37,"37103",483,354,351,1,3,"P.S.O.E.",108
44,"44207",187,147,146,5,1,"P.S.O.E.",58
23,"23011",2227,1644,1620,25,24,"P.S.O.E.",788
41,"41041",9646,7901,7791,58,110,"P.S.O.E.",3063
47,"47159",862,704,695,20,9,"P.S.O.E.",258
6,"6148",991,826,818,9,8,"P.S.O.E.",388
42,"42007",143,110,110,2,0,"P.S.O.E.",34
37,"37142",613,436,434,7,2,"P.S.O.E.",116
50,"50159",728,554,544,4,10,"P.S.O.E.",198
44,"44100",200,147,146,0,1,"P.S.O.E.",65
41,"41091",545464,388043,383816,5325,4227,"P.S.O.E.",139519
45,"45070",1415,1175,1162,11,13,"P.S.O.E.",353
33,"33021",4932,3544,3502,45,42,"P.S.O.E.",1304
6,"6043",661,542,532,3,10,"P.S.O.E.",217
31,"31013",668,382,375,12,7,"P.S.O.E.",45
3,"3116",1167,912,904,12,8,"P.S.O.E.",173
12,"12085",4941,3183,3125,32,58,"P.S.O.E.",838
2,"2030",3180,2499,2456,13,43,"P.S.O.E.",1051
46,"46129",553,430,423,4,7,"P.S.O.E.",138
45,"45181",2276,1788,1764,10,24,"P.S.O.E.",560
14,"14031",634,516,514,1,2,"P.S.O.E.",269
23,"23901",1194,1048,1045,8,3,"P.S.O.E.",544
37,"37143",410,342,338,3,4,"P.S.O.E.",104
2,"2031",626,507,502,3,5,"P.S.O.E.",180
46,"46057",483,357,349,9,8,"P.S.O.E.",77
18,"18054",879,646,644,4,2,"P.S.O.E.",212
47,"47178",190,162,161,1,1,"P.S.O.E.",41
47,"47151",32,29,29,0,0,"P.S.O.E.",4
39,"39027",3213,2506,2473,21,33,"P.S.O.E.",502
16,"16048",432,339,337,8,2,"P.S.O.E.",100
19,"19049",19,11,11,0,0,"P.S.O.E.",5
31,"31105",1619,1306,1284,30,22,"P.S.O.E.",446
19,"19332",106,76,72,4,4,"P.S.O.E.",16
44,"44103",128,95,95,0,0,"P.S.O.E.",24
24,"24197",784,570,564,7,6,"P.S.O.E.",212
19,"19050",21,19,19,0,0,"P.S.O.E.",9
33,"33023",3410,2501,2485,40,16,"P.S.O.E.",813
49,"49251",191,157,154,7,3,"P.S.O.E.",57
40,"40146",270,222,222,0,0,"P.S.O.E.",65
6,"6137",1035,848,842,2,6,"P.S.O.E.",408
37,"37221",465,360,353,0,7,"P.S.O.E.",136
37,"37222",124,92,92,2,0,"P.S.O.E.",20
26,"26053",221,177,173,5,4,"P.S.O.E.",64
22,"22189",199,140,138,5,2,"P.S.O.E.",50
40,"40007",86,70,69,0,1,"P.S.O.E.",13
50,"50247",794,572,567,7,5,"P.S.O.E.",148
47,"47153",135,94,93,1,1,"P.S.O.E.",24
37,"37024",101,80,80,0,0,"P.S.O.E.",22
46,"46058",1787,1460,1441,10,19,"P.S.O.E.",553
45,"45184",219,150,148,3,2,"P.S.O.E.",68
37,"37146",135,117,117,1,0,"P.S.O.E.",14
50,"50218",113,92,92,0,0,"P.S.O.E.",19
10,"10027",88,78,78,0,0,"P.S.O.E.",52
49,"49119",245,194,191,2,3,"P.S.O.E.",81
23,"23905",1884,1447,1438,4,9,"P.S.O.E.",682
37,"37260",175,122,122,1,0,"P.S.O.E.",45
35,"35023",11640,8412,8178,97,234,"P.S.O.E.",1733
16,"16050",298,245,238,0,7,"P.S.O.E.",94
33,"33024",229816,164603,163179,2100,1424,"P.S.O.E.",48615
22,"22190",120,76,73,4,3,"P.S.O.E.",30
39,"39082",1688,1280,1266,9,14,"P.S.O.E.",195
41,"41028",1880,1479,1458,28,21,"P.S.O.E.",496
9,"9251",417,292,288,3,4,"P.S.O.E.",72
41,"41054",671,556,550,0,6,"P.S.O.E.",290
34,"34029",832,696,683,11,13,"P.S.O.E.",150
46,"46132",2124,1845,1817,14,28,"P.S.O.E.",489
31,"31261",271,202,201,4,1,"P.S.O.E.",57
49,"49209",568,374,372,1,2,"P.S.O.E.",105
19,"19053",2172,1602,1587,14,15,"P.S.O.E.",482
26,"26143",187,154,151,4,3,"P.S.O.E.",47
45,"45186",3217,2573,2527,24,46,"P.S.O.E.",610
24,"24119",742,524,510,15,14,"P.S.O.E.",176
31,"31017",358,220,219,12,1,"P.S.O.E.",13
14,"14036",3774,2928,2909,51,19,"P.S.O.E.",1573
46,"46060",9510,7506,7408,52,98,"P.S.O.E.",1893
50,"50249",333,280,272,2,8,"P.S.O.E.",41
23,"23063",3960,3073,3037,21,36,"P.S.O.E.",1555
39,"39083",1214,785,775,7,10,"P.S.O.E.",168
9,"9214",724,477,467,4,10,"P.S.O.E.",168
6,"6051",1606,1314,1302,10,12,"P.S.O.E.",557
26,"26144",196,163,162,2,1,"P.S.O.E.",34
34,"34157",2471,1936,1912,26,24,"P.S.O.E.",538
42,"42127",47,35,35,0,0,"P.S.O.E.",6
37,"37375",764,636,627,19,9,"P.S.O.E.",286
3,"3054",371,321,315,2,6,"P.S.O.E.",87
19,"19265",157,102,101,0,1,"P.S.O.E.",14
31,"31201",144714,104019,102644,2027,1375,"P.S.O.E.",18724
46,"46231",2496,1831,1817,16,14,"P.S.O.E.",521
41,"41021",20767,14040,13822,240,218,"P.S.O.E.",6390
38,"38039",10198,7548,7429,78,119,"P.S.O.E.",1100
9,"9125",648,463,460,5,3,"P.S.O.E.",86
40,"40155",3083,2333,2280,73,53,"P.S.O.E.",590
42,"42076",237,185,179,6,6,"P.S.O.E.",65
46,"46037",1146,1007,1003,5,4,"P.S.O.E.",265
44,"44229",150,108,107,5,1,"P.S.O.E.",33
16,"16056",495,377,374,11,3,"P.S.O.E.",158
26,"26018",10396,8186,8041,161,145,"P.S.O.E.",3158
45,"45079",368,278,273,1,5,"P.S.O.E.",101
24,"24122",1424,1001,992,9,9,"P.S.O.E.",266
16,"16015",407,311,311,4,0,"P.S.O.E.",57
30,"30036",13978,10244,10141,94,103,"P.S.O.E.",1847
44,"44111",101,68,68,4,0,"P.S.O.E.",31
47,"47130",105,86,85,2,1,"P.S.O.E.",20
40,"40014",60,39,39,1,0,"P.S.O.E.",14
18,"18902",950,769,762,6,7,"P.S.O.E.",395
22,"22199",7259,4980,4861,128,119,"P.S.O.E.",1841
16,"16100",764,660,655,3,5,"P.S.O.E.",207
23,"23025",2845,2292,2271,17,21,"P.S.O.E.",1102
22,"22246",93,63,62,0,1,"P.S.O.E.",23
46,"46063",1764,1441,1423,15,18,"P.S.O.E.",448
49,"49126",232,175,173,3,2,"P.S.O.E.",64
40,"40015",33,30,30,1,0,"P.S.O.E.",4
41,"41031",1319,879,875,6,4,"P.S.O.E.",536
9,"9903",3299,2373,2349,45,24,"P.S.O.E.",577
24,"24166",1521,1137,1112,27,25,"P.S.O.E.",379
45,"45080",3,3,3,0,0,"P.S.O.E.",0
10,"10156",116,91,91,0,0,"P.S.O.E.",55
29,"29012",9817,7063,6991,51,72,"P.S.O.E.",3083
49,"49262",401,317,313,1,4,"P.S.O.E.",100
46,"46209",1984,1606,1594,11,12,"P.S.O.E.",479
3,"3025",1252,1054,1044,4,10,"P.S.O.E.",288
16,"16045",226,177,176,2,1,"P.S.O.E.",75
16,"16032",304,253,244,2,9,"P.S.O.E.",120
34,"34238",348,289,287,4,2,"P.S.O.E.",139
47,"47193",1538,1229,1211,23,18,"P.S.O.E.",354
49,"49234",439,336,332,5,4,"P.S.O.E.",123
19,"19047",87,71,70,2,1,"P.S.O.E.",15
34,"34214",176,144,143,3,1,"P.S.O.E.",37
50,"50050",109,73,73,1,0,"P.S.O.E.",35
9,"9259",239,178,177,2,1,"P.S.O.E.",44
24,"24125",545,374,373,5,1,"P.S.O.E.",115
11,"11040",411,317,309,0,8,"P.S.O.E.",179
50,"50078",278,210,208,2,2,"P.S.O.E.",105
35,"35028",8810,4687,4603,71,84,"P.S.O.E.",1265
19,"19022",673,501,496,4,5,"P.S.O.E.",102
42,"42082",9,9,9,0,0,"P.S.O.E.",1
16,"16019",252,210,207,2,3,"P.S.O.E.",57
46,"46040",1227,1028,1021,13,7,"P.S.O.E.",332
9,"9355",117,88,87,1,1,"P.S.O.E.",3
24,"24169",3205,2317,2282,33,35,"P.S.O.E.",1059
49,"49222",404,297,294,4,3,"P.S.O.E.",173
40,"40160",120,94,92,2,2,"P.S.O.E.",6
49,"49265",143,105,105,1,0,"P.S.O.E.",37
35,"35029",3981,2341,2315,43,26,"P.S.O.E.",548
22,"22095",87,61,61,1,0,"P.S.O.E.",28
42,"42135",89,59,59,1,0,"P.S.O.E.",17
44,"44235",103,71,68,0,3,"P.S.O.E.",15
19,"19174",126,88,86,0,2,"P.S.O.E.",25
19,"19271",53,45,45,1,0,"P.S.O.E.",13
5,"5185",109,89,89,1,0,"P.S.O.E.",15
35,"35004",35462,18498,18196,325,302,"P.S.O.E.",6007
22,"22204",1122,773,756,19,17,"P.S.O.E.",196
10,"10120",168,122,119,1,3,"P.S.O.E.",51
6,"6151",1109,850,846,6,4,"P.S.O.E.",483
9,"9131",412,332,321,6,11,"P.S.O.E.",143
19,"19061",76,57,55,3,2,"P.S.O.E.",13
2,"2045",3763,3086,3035,42,51,"P.S.O.E.",815
31,"31085",451,334,327,3,7,"P.S.O.E.",42
37,"37158",262,181,179,0,2,"P.S.O.E.",54
46,"46115",515,364,354,1,10,"P.S.O.E.",95
9,"9265",44,36,35,2,1,"P.S.O.E.",3
6,"6062",638,493,492,3,1,"P.S.O.E.",195
47,"47161",3886,3133,3105,45,28,"P.S.O.E.",594
26,"26153",12,9,8,0,1,"P.S.O.E.",6
18,"18103",803,653,647,5,6,"P.S.O.E.",315
47,"47187",101,82,81,1,1,"P.S.O.E.",25
9,"9223",46,40,40,0,0,"P.S.O.E.",2
22,"22054",1602,1040,982,42,58,"P.S.O.E.",239
46,"46042",3376,2873,2819,17,54,"P.S.O.E.",897
10,"10040",455,344,334,8,10,"P.S.O.E.",158
5,"5023",177,160,158,1,2,"P.S.O.E.",47
10,"10041",1070,850,846,8,4,"P.S.O.E.",359
9,"9407",31,27,27,0,0,"P.S.O.E.",6
11,"11901",5576,4433,4398,69,35,"P.S.O.E.",2176
44,"44118",183,129,127,2,2,"P.S.O.E.",47
24,"24053",503,338,332,3,6,"P.S.O.E.",87
40,"40164",188,145,142,0,3,"P.S.O.E.",26
47,"47135",93,77,76,0,1,"P.S.O.E.",23
50,"50142",45,25,24,0,1,"P.S.O.E.",10
49,"49133",344,247,243,3,4,"P.S.O.E.",85
49,"49227",295,238,237,5,1,"P.S.O.E.",69
12,"12069",53,48,47,0,1,"P.S.O.E.",8
47,"47163",315,253,250,2,3,"P.S.O.E.",112
18,"18173",8858,6238,6187,64,51,"P.S.O.E.",2762
40,"40121",325,266,262,3,4,"P.S.O.E.",66
16,"16151",66,56,56,0,0,"P.S.O.E.",12
5,"5024",268,205,201,2,4,"P.S.O.E.",63
37,"37274",123032,90819,89629,1506,1190,"P.S.O.E.",22791
31,"31118",182,114,114,6,0,"P.S.O.E.",15
22,"22105",132,104,102,2,2,"P.S.O.E.",45
2,"2048",1320,1076,1061,11,15,"P.S.O.E.",398
19,"19243",53,39,39,0,0,"P.S.O.E.",12
19,"19032",202,11,11,0,0,"P.S.O.E.",2
47,"47054",673,545,541,8,4,"P.S.O.E.",132
6,"6020",1852,1476,1462,5,14,"P.S.O.E.",635
2,"2049",937,717,708,2,9,"P.S.O.E.",323
46,"46214",15129,11609,11500,116,109,"P.S.O.E.",3080
31,"31179",558,384,384,3,0,"P.S.O.E.",131
5,"5189",478,361,360,3,1,"P.S.O.E.",70
31,"31028",217,129,128,1,1,"P.S.O.E.",13
29,"29092",596,457,454,10,3,"P.S.O.E.",175
19,"19278",30,28,28,0,0,"P.S.O.E.",5
42,"42145",140,111,111,2,0,"P.S.O.E.",27
3,"3065",164772,124457,123236,1556,1221,"P.S.O.E.",35676
38,"38005",5327,3316,3270,38,46,"P.S.O.E.",994
2,"2013",158,123,121,1,2,"P.S.O.E.",40
18,"18174",470,368,363,1,5,"P.S.O.E.",175
12,"12102",547,474,466,2,8,"P.S.O.E.",194
42,"42110",82,58,58,2,0,"P.S.O.E.",11
44,"44243",38,27,26,3,1,"P.S.O.E.",8
40,"40028",106,89,88,1,1,"P.S.O.E.",21
31,"31120",408,267,265,8,2,"P.S.O.E.",24
37,"37040",431,362,362,4,0,"P.S.O.E.",116
2,"2015",1508,1230,1211,7,19,"P.S.O.E.",379
33,"33034",11390,7583,7501,85,82,"P.S.O.E.",2275
49,"49231",360,256,254,4,2,"P.S.O.E.",66
5,"5126",78,70,70,0,0,"P.S.O.E.",14
24,"24137",1226,920,904,16,16,"P.S.O.E.",428
34,"34131",67,57,56,0,1,"P.S.O.E.",4
10,"10046",216,185,184,1,1,"P.S.O.E.",85
44,"44244",93,56,56,5,0,"P.S.O.E.",13
47,"47111",1005,804,794,5,10,"P.S.O.E.",338
10,"10168",318,240,238,1,2,"P.S.O.E.",104
42,"42149",404,292,286,12,6,"P.S.O.E.",91
34,"34176",146,120,118,2,2,"P.S.O.E.",8
16,"16071",25,23,23,0,0,"P.S.O.E.",7
29,"29094",54317,36540,36174,410,366,"P.S.O.E.",11005
46,"46144",699,547,536,2,11,"P.S.O.E.",131
7,"7031",23371,14443,14213,285,230,"P.S.O.E.",3972
9,"9272",319,225,225,5,0,"P.S.O.E.",55
6,"6070",7805,6083,6001,76,82,"P.S.O.E.",2680
24,"24019",367,293,287,5,6,"P.S.O.E.",131
3,"3137",719,536,530,3,6,"P.S.O.E.",155
39,"39094",927,702,691,0,11,"P.S.O.E.",134
39,"39042",5928,4680,4634,44,46,"P.S.O.E.",989
37,"37006",157,108,107,0,1,"P.S.O.E.",22
42,"42152",96,71,69,1,2,"P.S.O.E.",9
41,"41040",9567,7305,7210,93,95,"P.S.O.E.",1870
40,"40031",515,410,404,7,6,"P.S.O.E.",120
22,"22111",180,126,125,3,1,"P.S.O.E.",37
14,"14050",2418,1983,1966,23,17,"P.S.O.E.",601
42,"42198",24,17,17,0,0,"P.S.O.E.",4
6,"6133",1744,1343,1328,22,15,"P.S.O.E.",592
5,"5193",224,197,197,2,0,"P.S.O.E.",53
42,"42116",63,50,48,3,2,"P.S.O.E.",13
16,"16172",413,330,318,1,12,"P.S.O.E.",110
49,"49264",652,439,435,2,4,"P.S.O.E.",96
3,"3138",3218,2403,2388,22,15,"P.S.O.E.",565
49,"49099",127,96,96,1,0,"P.S.O.E.",40
22,"22020",110,81,79,3,2,"P.S.O.E.",28
31,"31002",421,292,284,5,8,"P.S.O.E.",33
34,"34178",106,93,93,1,0,"P.S.O.E.",7
10,"10009",285,223,221,0,2,"P.S.O.E.",52
49,"49100",322,236,233,1,3,"P.S.O.E.",95
3,"3139",21796,15501,15320,160,181,"P.S.O.E.",3720
44,"44086",485,380,371,5,9,"P.S.O.E.",157
46,"46048",3484,2915,2875,26,40,"P.S.O.E.",867
47,"47059",108,77,76,1,1,"P.S.O.E.",15
39,"39096",719,521,518,4,3,"P.S.O.E.",112
37,"37169",196,137,136,1,1,"P.S.O.E.",41
50,"50060",187,138,136,1,2,"P.S.O.E.",30
9,"9231",77,42,42,0,0,"P.S.O.E.",15
47,"47222",92,77,77,4,0,"P.S.O.E.",23
9,"9415",290,192,192,4,0,"P.S.O.E.",18
16,"16078",40954,30382,29933,568,449,"P.S.O.E.",8518
22,"22114",137,94,94,4,0,"P.S.O.E.",20
50,"50179",269,230,229,2,1,"P.S.O.E.",105
22,"22220",192,138,136,5,2,"P.S.O.E.",44
14,"14052",9720,6444,6384,58,60,"P.S.O.E.",2432
5,"5195",241,168,164,0,4,"P.S.O.E.",35
50,"50061",228,191,183,3,8,"P.S.O.E.",71
46,"46001",863,647,641,5,6,"P.S.O.E.",235
24,"24023",272,196,193,6,3,"P.S.O.E.",34
16,"16206",250,188,188,2,0,"P.S.O.E.",71
16,"16161",84,73,72,4,1,"P.S.O.E.",11
6,"6122",6620,4904,4797,44,107,"P.S.O.E.",1664
46,"46026",1217,1043,1035,2,8,"P.S.O.E.",287
45,"45060",204,151,148,1,3,"P.S.O.E.",91
9,"9021",62,33,33,1,0,"P.S.O.E.",7
18,"18180",655,450,447,1,3,"P.S.O.E.",208
41,"41018",9457,6940,6867,66,73,"P.S.O.E.",4215
42,"42157",18,16,15,0,1,"P.S.O.E.",0
49,"49147",301,243,239,4,4,"P.S.O.E.",53
24,"24146",284,223,221,0,2,"P.S.O.E.",57
47,"47170",40,30,30,0,0,"P.S.O.E.",6
23,"23091",790,668,664,3,4,"P.S.O.E.",296
50,"50151",713,536,531,5,5,"P.S.O.E.",228
41,"41044",6838,5064,5005,67,59,"P.S.O.E.",1711
44,"44129",44,34,33,0,1,"P.S.O.E.",12
5,"5133",62,49,49,0,0,"P.S.O.E.",12
31,"31036",957,631,616,22,15,"P.S.O.E.",158
44,"44252",78,63,60,0,3,"P.S.O.E.",6
19,"19187",64,54,54,0,0,"P.S.O.E.",12
40,"40180",319,259,255,3,4,"P.S.O.E.",64
19,"19079",7,7,7,0,0,"P.S.O.E.",0
44,"44130",38,27,27,0,0,"P.S.O.E.",0
24,"24026",1304,1015,1001,17,14,"P.S.O.E.",205
3,"3903",2431,1991,1960,18,31,"P.S.O.E.",563
22,"22069",436,317,315,5,2,"P.S.O.E.",105
41,"41045",5505,3946,3889,68,57,"P.S.O.E.",1647
16,"16039",466,330,326,1,4,"P.S.O.E.",114
47,"47171",453,371,368,10,3,"P.S.O.E.",103
37,"37286",231,166,160,2,6,"P.S.O.E.",72
47,"47010",11275,8800,8701,163,99,"P.S.O.E.",2012
50,"50007",61,45,45,0,0,"P.S.O.E.",11
46,"46076",651,541,528,2,13,"P.S.O.E.",181
31,"31037",94,68,68,0,0,"P.S.O.E.",2
50,"50182",3704,2551,2515,44,36,"P.S.O.E.",460
5,"5231",172,142,141,0,1,"P.S.O.E.",52
6,"6081",1114,870,865,10,5,"P.S.O.E.",482
49,"49016",272,216,211,1,5,"P.S.O.E.",70
45,"45174",343,289,288,0,1,"P.S.O.E.",79
37,"37137",114,87,87,3,0,"P.S.O.E.",8
40,"40087",112,85,83,0,2,"P.S.O.E.",7
34,"34233",158,128,128,3,0,"P.S.O.E.",16
37,"37054",273,230,229,2,1,"P.S.O.E.",83
5,"5232",106,84,80,1,4,"P.S.O.E.",14
26,"26043",397,313,306,6,7,"P.S.O.E.",129
39,"39048",1616,1326,1308,8,18,"P.S.O.E.",267
3,"3076",8373,6319,6222,68,97,"P.S.O.E.",1734
10,"10179",340,262,257,3,5,"P.S.O.E.",89
42,"42161",158,119,119,0,0,"P.S.O.E.",29
44,"44133",21,16,16,0,0,"P.S.O.E.",1
12,"12012",2747,2196,2135,24,61,"P.S.O.E.",776
24,"24188",3830,2987,2928,51,59,"P.S.O.E.",986
37,"37327",191,148,148,9,0,"P.S.O.E.",38
50,"50009",122,93,93,0,0,"P.S.O.E.",17
40,"40029",50,43,42,0,1,"P.S.O.E.",17
23,"23006",4644,3913,3871,36,42,"P.S.O.E.",2315
6,"6083",45013,31929,31491,527,438,"P.S.O.E.",10581
46,"46223",7685,6040,5996,62,44,"P.S.O.E.",1524
39,"39101",328,251,247,5,4,"P.S.O.E.",22
31,"31101",1305,892,874,15,18,"P.S.O.E.",119
49,"49152",572,401,395,6,6,"P.S.O.E.",92
33,"33042",4434,3172,3135,43,37,"P.S.O.E.",859
16,"16042",1286,1101,1089,8,12,"P.S.O.E.",505
46,"46005",22815,17016,16838,185,178,"P.S.O.E.",4923
12,"12113",100,72,72,0,0,"P.S.O.E.",16
23,"23008",1552,1280,1266,9,14,"P.S.O.E.",707
40,"40186",50,33,33,0,0,"P.S.O.E.",8
3,"3078",528,424,423,2,1,"P.S.O.E.",79
34,"34143",181,142,140,3,2,"P.S.O.E.",33
38,"38019",12624,8174,8099,65,75,"P.S.O.E.",2305
2,"2064",413,350,348,7,2,"P.S.O.E.",144
18,"18185",608,484,479,2,5,"P.S.O.E.",192
46,"46225",360,319,310,5,9,"P.S.O.E.",82
33,"33043",710,529,528,1,1,"P.S.O.E.",249
19,"19191",19,15,15,0,0,"P.S.O.E.",7
10,"10060",1037,758,742,9,16,"P.S.O.E.",349
24,"24031",220,180,176,3,4,"P.S.O.E.",63
19,"19192",1743,1370,1359,10,11,"P.S.O.E.",352
10,"10061",1765,1305,1290,13,15,"P.S.O.E.",683
10,"10183",1022,818,805,5,13,"P.S.O.E.",363
34,"34022",1136,926,908,5,18,"P.S.O.E.",379
44,"44219",207,159,157,1,2,"P.S.O.E.",37
31,"31224",980,691,681,9,10,"P.S.O.E.",216
14,"14059",713,572,567,5,5,"P.S.O.E.",228
23,"23010",14447,10777,10704,109,73,"P.S.O.E.",3959
6,"6087",2258,1855,1832,24,23,"P.S.O.E.",794
45,"45180",2714,2018,1980,19,38,"P.S.O.E.",476
49,"49141",397,289,286,7,3,"P.S.O.E.",81
26,"26091",165,139,139,0,0,"P.S.O.E.",24
2,"2054",421,346,343,2,3,"P.S.O.E.",122
44,"44065",60,40,40,0,0,"P.S.O.E.",2
47,"47167",258,230,229,3,1,"P.S.O.E.",78
44,"44263",332,249,243,10,6,"P.S.O.E.",77
49,"49022",319,266,261,3,5,"P.S.O.E.",121
9,"9427",1561,1090,1078,18,12,"P.S.O.E.",157
5,"5140",112,100,99,1,1,"P.S.O.E.",17
2,"2066",258,219,217,2,2,"P.S.O.E.",99
12,"12116",56,45,45,0,0,"P.S.O.E.",9
39,"39052",17031,13198,13034,187,164,"P.S.O.E.",2748
47,"47176",229,157,157,0,0,"P.S.O.E.",46
2,"2067",1197,938,924,6,14,"P.S.O.E.",316
45,"45071",1896,1592,1575,21,17,"P.S.O.E.",577
5,"5043",86,68,68,0,0,"P.S.O.E.",23
5,"5141",99,90,89,0,1,"P.S.O.E.",17
12,"12117",3674,2846,2794,25,52,"P.S.O.E.",796
34,"34196",94,74,73,1,1,"P.S.O.E.",12
46,"46081",10254,8188,8101,52,87,"P.S.O.E.",2041
23,"23012",4250,3235,3216,19,19,"P.S.O.E.",1622
37,"37181",301,232,230,2,2,"P.S.O.E.",68
44,"44265",203,169,158,6,11,"P.S.O.E.",38
10,"10146",1439,991,975,11,16,"P.S.O.E.",430
3,"3049",12150,10039,9892,88,147,"P.S.O.E.",2272
29,"29005",4307,2967,2951,18,16,"P.S.O.E.",1001
12,"12118",83,63,62,0,1,"P.S.O.E.",8
41,"41052",2967,2305,2288,7,17,"P.S.O.E.",1311
5,"5238",815,649,641,6,8,"P.S.O.E.",215
14,"14062",1114,889,882,9,7,"P.S.O.E.",409
50,"50274",78,45,45,1,0,"P.S.O.E.",18
2,"2068",379,290,284,3,6,"P.S.O.E.",133
44,"44143",382,292,292,5,0,"P.S.O.E.",121
3,"3083",5708,4267,4196,66,71,"P.S.O.E.",1488
29,"29033",1385,878,868,4,10,"P.S.O.E.",451
44,"44267",79,63,61,2,2,"P.S.O.E.",13
18,"18189",723,547,541,6,6,"P.S.O.E.",199
9,"9297",326,270,266,7,4,"P.S.O.E.",38
50,"50246",48,33,33,1,0,"P.S.O.E.",7
18,"18158",10328,7336,7254,69,82,"P.S.O.E.",4180
49,"49252",370,310,305,6,5,"P.S.O.E.",110
3,"3050",17818,12860,12706,160,154,"P.S.O.E.",3035
5,"5112",125,88,87,0,1,"P.S.O.E.",12
37,"37297",441,376,369,1,7,"P.S.O.E.",107
12,"12119",153,87,87,0,0,"P.S.O.E.",12
44,"44268",30,25,25,0,0,"P.S.O.E.",16
50,"50190",751,576,565,7,11,"P.S.O.E.",263
39,"39055",1130,881,869,10,12,"P.S.O.E.",169
10,"10067",10392,7979,7804,111,175,"P.S.O.E.",2706
49,"49162",217,157,155,2,2,"P.S.O.E.",47
45,"45110",1918,1585,1570,10,15,"P.S.O.E.",612
29,"29034",462,360,357,0,3,"P.S.O.E.",101
37,"37063",94,77,76,3,1,"P.S.O.E.",15
33,"33001",1772,984,971,14,13,"P.S.O.E.",302
49,"49028",119,103,103,1,0,"P.S.O.E.",12
41,"41053",20729,16178,15971,142,207,"P.S.O.E.",7889
18,"18192",1581,1331,1318,6,13,"P.S.O.E.",630
6,"6094",1508,1130,1119,6,11,"P.S.O.E.",674
9,"9122",93,71,71,4,0,"P.S.O.E.",12
26,"26142",804,661,648,1,13,"P.S.O.E.",228
31,"31047",283,208,204,3,4,"P.S.O.E.",52
37,"37185",602,452,448,8,4,"P.S.O.E.",84
26,"26098",99,74,73,2,1,"P.S.O.E.",27
6,"6095",9330,6974,6873,129,101,"P.S.O.E.",2802
50,"50102",918,722,713,12,9,"P.S.O.E.",317
44,"44146",185,160,159,8,1,"P.S.O.E.",59
49,"49121",382,270,270,1,0,"P.S.O.E.",73
7,"7049",1482,1046,1037,14,9,"P.S.O.E.",191
47,"47019",93,69,68,0,1,"P.S.O.E.",17
5,"5145",57,41,41,0,0,"P.S.O.E.",14
45,"45002",2500,1771,1756,26,15,"P.S.O.E.",527
2,"2072",1598,1220,1198,5,22,"P.S.O.E.",422
5,"5047",4267,3345,3275,34,70,"P.S.O.E.",1037
24,"24161",307,231,228,1,3,"P.S.O.E.",52
12,"12022",367,282,279,4,3,"P.S.O.E.",87
45,"45077",554,430,423,7,7,"P.S.O.E.",135
49,"49258",127,107,104,0,3,"P.S.O.E.",35
44,"44227",81,59,59,0,0,"P.S.O.E.",17
44,"44148",98,77,77,3,0,"P.S.O.E.",23
10,"10192",910,679,670,3,9,"P.S.O.E.",278
50,"50017",1734,1232,1212,41,20,"P.S.O.E.",314
45,"45114",608,476,468,3,8,"P.S.O.E.",200
3,"3088",5381,4056,3988,47,68,"P.S.O.E.",989
37,"37300",586,430,421,6,9,"P.S.O.E.",123
9,"9038",123,92,92,0,0,"P.S.O.E.",28
31,"31231",127,93,91,1,2,"P.S.O.E.",23
44,"44061",89,55,55,1,0,"P.S.O.E.",13
5,"5136",110,75,75,3,0,"P.S.O.E.",17
12,"12092",143,98,98,0,0,"P.S.O.E.",31
9,"9256",369,254,252,2,2,"P.S.O.E.",56
6,"6144",588,476,464,2,12,"P.S.O.E.",244
49,"49123",557,421,415,5,6,"P.S.O.E.",166
37,"37151",150,125,121,1,4,"P.S.O.E.",10
22,"22002",107,85,84,3,1,"P.S.O.E.",33
5,"5149",128,97,97,1,0,"P.S.O.E.",22
18,"18097",1022,758,752,4,6,"P.S.O.E.",285
19,"19200",150,105,105,1,0,"P.S.O.E.",35
49,"49167",223,173,171,5,2,"P.S.O.E.",40
31,"31019",1858,1288,1266,25,22,"P.S.O.E.",214
24,"24005",437,308,305,3,3,"P.S.O.E.",83
34,"34114",240,171,171,0,0,"P.S.O.E.",17
37,"37265",224,192,191,1,1,"P.S.O.E.",80
41,"41057",299,191,189,0,2,"P.S.O.E.",93
9,"9901",407,319,308,8,11,"P.S.O.E.",65
49,"49260",814,653,644,6,9,"P.S.O.E.",206
14,"14069",7733,5910,5824,68,86,"P.S.O.E.",3091
16,"16240",134,100,98,0,2,"P.S.O.E.",23
5,"5244",66,45,45,0,0,"P.S.O.E.",3
40,"40202",79,59,58,0,1,"P.S.O.E.",13
19,"19170",214,139,138,0,1,"P.S.O.E.",41
37,"37303",207,158,152,3,6,"P.S.O.E.",42
49,"49034",467,363,359,3,4,"P.S.O.E.",117
42,"42130",70,55,54,2,1,"P.S.O.E.",6
19,"19171",4352,3299,3221,35,78,"P.S.O.E.",1209
49,"49220",161,122,118,5,4,"P.S.O.E.",52
9,"9438",547,440,433,9,7,"P.S.O.E.",118
37,"37304",190,144,142,1,2,"P.S.O.E.",37
44,"44152",62,50,50,3,0,"P.S.O.E.",4
18,"18002",625,505,504,2,1,"P.S.O.E.",334
19,"19202",16,14,14,0,0,"P.S.O.E.",5
40,"40203",814,643,631,14,12,"P.S.O.E.",162
23,"23099",4649,3638,3594,39,44,"P.S.O.E.",1379
40,"40174",402,292,290,5,2,"P.S.O.E.",33
9,"9113",503,397,390,7,7,"P.S.O.E.",108
46,"46047",551,479,469,10,10,"P.S.O.E.",193
16,"16224",96,69,69,0,0,"P.S.O.E.",13
42,"42081",158,131,131,3,0,"P.S.O.E.",40
9,"9353",62,51,51,2,0,"P.S.O.E.",7
37,"37380",57,45,44,1,1,"P.S.O.E.",12
9,"9308",70,51,51,0,0,"P.S.O.E.",5
10,"10198",1213,1068,1054,12,14,"P.S.O.E.",334
18,"18100",7304,5807,5737,62,70,"P.S.O.E.",2879
33,"33051",7576,5379,5335,65,44,"P.S.O.E.",1565
42,"42034",40,29,29,0,0,"P.S.O.E.",11
10,"10158",367,307,306,3,1,"P.S.O.E.",202
31,"31023",5338,3986,3920,120,66,"P.S.O.E.",626
24,"24127",327,258,255,1,3,"P.S.O.E.",57
41,"41085",3918,3173,3128,42,45,"P.S.O.E.",1264
22,"22007",863,636,621,8,15,"P.S.O.E.",194
16,"16147",78,63,62,1,1,"P.S.O.E.",17
6,"6060",5865,4657,4592,67,65,"P.S.O.E.",2046
37,"37077",293,262,258,3,4,"P.S.O.E.",110
10,"10199",181,142,140,1,2,"P.S.O.E.",49
47,"47024",283,211,210,1,1,"P.S.O.E.",56
49,"49172",594,389,383,0,6,"P.S.O.E.",93
9,"9310",14,10,9,2,1,"P.S.O.E.",1
2,"2080",580,450,443,4,7,"P.S.O.E.",162
10,"10037",74974,56844,55950,898,894,"P.S.O.E.",14752
14,"14072",1169,925,922,5,3,"P.S.O.E.",469
12,"12128",1448,1114,1092,16,22,"P.S.O.E.",405
46,"46903",5210,4037,4000,40,37,"P.S.O.E.",793
16,"16020",20,15,15,0,0,"P.S.O.E.",5
3,"3060",124,100,98,0,2,"P.S.O.E.",46
24,"24170",2006,1410,1394,14,16,"P.S.O.E.",662
34,"34167",124,105,105,0,0,"P.S.O.E.",29
46,"46090",1668,1488,1452,9,36,"P.S.O.E.",512
29,"29043",2596,1670,1647,24,23,"P.S.O.E.",645
37,"37309",42,26,25,3,1,"P.S.O.E.",8
19,"19105",2235,1709,1686,23,23,"P.S.O.E.",380
42,"42189",75,58,58,2,0,"P.S.O.E.",11
10,"10201",202,173,171,3,2,"P.S.O.E.",87
40,"40021",33,32,32,0,0,"P.S.O.E.",5
34,"34217",1089,866,849,19,17,"P.S.O.E.",241
5,"5056",94,78,73,1,5,"P.S.O.E.",11
49,"49175",263,215,215,4,0,"P.S.O.E.",61
3,"3029",260,191,186,0,5,"P.S.O.E.",75
31,"31904",1590,1054,1031,19,23,"P.S.O.E.",158
49,"49132",338,245,238,0,7,"P.S.O.E.",42
44,"44238",2475,1718,1692,50,26,"P.S.O.E.",995
35,"35031",6968,4927,4862,71,65,"P.S.O.E.",800
12,"12032",23406,16895,16721,227,174,"P.S.O.E.",4589
45,"45122",4828,3816,3746,48,70,"P.S.O.E.",933
24,"24171",417,231,231,2,0,"P.S.O.E.",48
16,"16108",68,56,55,0,1,"P.S.O.E.",28
24,"24172",491,234,232,2,2,"P.S.O.E.",55
44,"44032",18,12,12,0,0,"P.S.O.E.",5
18,"18037",488,408,404,0,4,"P.S.O.E.",145
42,"42039",270,172,169,2,3,"P.S.O.E.",73
22,"22012",93,74,74,5,0,"P.S.O.E.",17
41,"41036",4053,2930,2899,29,31,"P.S.O.E.",1253
12,"12130",425,348,344,2,4,"P.S.O.E.",33
19,"19309",37,32,31,0,1,"P.S.O.E.",6
10,"10001",270,231,229,2,2,"P.S.O.E.",126
18,"18140",42971,28391,28126,335,265,"P.S.O.E.",10134
37,"37081",1000,807,800,5,7,"P.S.O.E.",294
26,"26028",135,108,106,2,2,"P.S.O.E.",21
24,"24132",683,440,435,5,5,"P.S.O.E.",139
42,"42041",36,25,25,4,0,"P.S.O.E.",9
47,"47028",31,21,20,0,1,"P.S.O.E.",1
50,"50114",157,120,120,1,0,"P.S.O.E.",55
33,"33055",1589,1212,1192,16,20,"P.S.O.E.",432
45,"45199",2712,1817,1796,17,21,"P.S.O.E.",437
10,"10165",274,231,229,0,2,"P.S.O.E.",80
46,"46068",326,292,285,3,7,"P.S.O.E.",94
9,"9225",95,61,61,3,0,"P.S.O.E.",25
9,"9362",219,185,184,2,1,"P.S.O.E.",56
10,"10125",925,705,689,3,16,"P.S.O.E.",291
2,"2085",345,288,284,2,4,"P.S.O.E.",117
29,"29018",2088,1565,1540,9,25,"P.S.O.E.",586
41,"41038",96442,66696,65945,1021,751,"P.S.O.E.",27066
42,"42193",17,10,10,0,0,"P.S.O.E.",0
46,"46020",3793,3084,3046,21,38,"P.S.O.E.",917
26,"26114",87,74,72,0,2,"P.S.O.E.",21
50,"50027",260,209,202,2,7,"P.S.O.E.",84
49,"49179",401,285,284,2,1,"P.S.O.E.",55
40,"40074",271,221,218,3,3,"P.S.O.E.",36
22,"22902",240,169,169,3,0,"P.S.O.E.",40
39,"39066",895,710,703,6,7,"P.S.O.E.",229
24,"24056",3200,2368,2332,53,36,"P.S.O.E.",931
29,"29047",1165,973,969,0,4,"P.S.O.E.",494
31,"31059",204,140,139,3,1,"P.S.O.E.",37
47,"47110",471,386,378,6,8,"P.S.O.E.",141
50,"50288",3252,2412,2380,50,32,"P.S.O.E.",574
37,"37314",79,61,61,3,0,"P.S.O.E.",6
47,"47003",263,224,222,1,2,"P.S.O.E.",75
6,"6160",3190,2343,2314,12,29,"P.S.O.E.",893
9,"9137",177,134,134,6,0,"P.S.O.E.",28
18,"18143",949,722,704,2,18,"P.S.O.E.",326
14,"14017",10755,8220,8149,101,71,"P.S.O.E.",4083
19,"19070",100,74,74,0,0,"P.S.O.E.",18
50,"50057",1468,1022,1004,17,18,"P.S.O.E.",298
47,"47219",46,36,36,1,0,"P.S.O.E.",14
50,"50261",246,199,199,4,0,"P.S.O.E.",122
10,"10209",297,217,213,3,4,"P.S.O.E.",108
42,"42196",14,11,11,0,0,"P.S.O.E.",2
9,"9318",63,38,38,0,0,"P.S.O.E.",11
19,"19110",73,59,57,4,2,"P.S.O.E.",8
49,"49232",95,78,78,1,0,"P.S.O.E.",22
29,"29048",1508,1254,1245,6,9,"P.S.O.E.",648
49,"49183",111,87,87,2,0,"P.S.O.E.",9
22,"22163",431,353,344,5,9,"P.S.O.E.",99
9,"9183",58,47,46,1,1,"P.S.O.E.",13
37,"37202",938,742,726,25,16,"P.S.O.E.",166
40,"40218",111,81,80,1,1,"P.S.O.E.",9
16,"16255",159,123,122,3,1,"P.S.O.E.",41
10,"10089",1399,1043,1032,15,11,"P.S.O.E.",537
49,"49139",195,146,146,0,0,"P.S.O.E.",54
49,"49184",190,135,133,1,2,"P.S.O.E.",15
41,"41066",1417,1121,1113,9,8,"P.S.O.E.",640
19,"19111",180,147,146,0,1,"P.S.O.E.",46
18,"18912",1576,1193,1185,7,8,"P.S.O.E.",653
45,"45019",7033,5207,5110,89,97,"P.S.O.E.",1736
24,"24099",199,164,162,0,2,"P.S.O.E.",68
2,"2029",3210,2512,2481,37,31,"P.S.O.E.",760
3,"3103",288,248,243,2,5,"P.S.O.E.",77
31,"31042",2719,2100,2057,27,43,"P.S.O.E.",952
6,"6057",575,481,474,2,7,"P.S.O.E.",212
5,"5063",48,39,39,2,0,"P.S.O.E.",4
29,"29022",202,142,141,2,1,"P.S.O.E.",73
16,"16073",214,170,170,2,0,"P.S.O.E.",60
6,"6027",732,655,645,8,10,"P.S.O.E.",234
3,"3069",2830,2009,1979,22,30,"P.S.O.E.",518
39,"39069",1957,1595,1570,18,25,"P.S.O.E.",355
19,"19216",143,112,105,2,7,"P.S.O.E.",34
34,"34091",136,105,103,1,2,"P.S.O.E.",25
5,"5064",117,94,93,4,1,"P.S.O.E.",10
49,"49010",338,271,265,4,6,"P.S.O.E.",95
18,"18178",834,685,683,3,2,"P.S.O.E.",331
49,"49143",243,161,157,0,4,"P.S.O.E.",31
24,"24061",1713,1223,1210,34,13,"P.S.O.E.",387
6,"6119",680,539,534,3,5,"P.S.O.E.",212
22,"22168",22,16,16,0,0,"P.S.O.E.",5
44,"44126",344,250,236,1,14,"P.S.O.E.",66
19,"19113",519,396,395,4,1,"P.S.O.E.",151
34,"34052",187,147,147,1,0,"P.S.O.E.",27
50,"50207",126,97,95,1,2,"P.S.O.E.",36
19,"19319",4203,3139,3104,28,35,"P.S.O.E.",788
45,"45022",427,317,314,8,3,"P.S.O.E.",93
3,"3140",26223,19998,19552,338,446,"P.S.O.E.",5519
45,"45059",1758,1465,1437,10,28,"P.S.O.E.",312
31,"31064",1500,1137,1120,12,17,"P.S.O.E.",425
37,"37047",178,111,111,0,0,"P.S.O.E.",20
47,"47169",70,57,57,0,0,"P.S.O.E.",3
10,"10214",226,178,176,2,2,"P.S.O.E.",45
42,"42202",33,15,14,1,1,"P.S.O.E.",3
50,"50032",330,233,228,3,5,"P.S.O.E.",75
22,"22022",582,448,438,12,10,"P.S.O.E.",172
44,"44169",403,285,278,0,7,"P.S.O.E.",130
37,"37011",131,87,86,2,1,"P.S.O.E.",24
50,"50090",165,117,117,1,0,"P.S.O.E.",8
19,"19115",41,26,26,1,0,"P.S.O.E.",2
19,"19322",35,28,27,1,1,"P.S.O.E.",12
44,"44251",271,218,218,5,0,"P.S.O.E.",39
5,"5066",480,397,392,5,5,"P.S.O.E.",146
9,"9328",81,56,56,2,0,"P.S.O.E.",15
44,"44172",345,257,251,3,6,"P.S.O.E.",85
34,"34231",273,209,206,2,3,"P.S.O.E.",42
19,"19078",58,49,48,0,1,"P.S.O.E.",31
10,"10176",384,300,293,5,7,"P.S.O.E.",147
40,"40224",34,25,25,0,0,"P.S.O.E.",1
9,"9061",187,146,144,1,2,"P.S.O.E.",8
5,"5263",175,133,131,0,2,"P.S.O.E.",23
42,"42054",20,14,14,0,0,"P.S.O.E.",8
41,"41070",5598,4101,4039,79,62,"P.S.O.E.",1288
37,"37323",549,427,418,6,9,"P.S.O.E.",95
23,"23046",2441,2049,2027,13,22,"P.S.O.E.",1042
38,"38047",1819,1269,1239,12,30,"P.S.O.E.",287
31,"31250",2887,1827,1802,20,25,"P.S.O.E.",240
44,"44044",103,79,78,0,1,"P.S.O.E.",16
22,"22025",1104,790,767,27,23,"P.S.O.E.",261
49,"49149",422,305,303,6,2,"P.S.O.E.",63
49,"49058",341,262,259,4,3,"P.S.O.E.",101
44,"44045",373,303,301,4,2,"P.S.O.E.",85
24,"24065",2104,1512,1488,27,24,"P.S.O.E.",499
29,"29054",39904,27540,27307,240,233,"P.S.O.E.",7039
47,"47117",306,231,228,4,3,"P.S.O.E.",43
37,"37324",415,338,334,2,4,"P.S.O.E.",94
46,"46100",307,264,255,0,9,"P.S.O.E.",98
50,"50295",54,42,41,0,1,"P.S.O.E.",15
45,"45026",269,200,198,2,2,"P.S.O.E.",84
31,"31159",1158,864,846,17,18,"P.S.O.E.",105
37,"37211",223,169,169,1,0,"P.S.O.E.",30
24,"24067",700,453,447,4,6,"P.S.O.E.",100
5,"5134",47,37,37,0,0,"P.S.O.E.",4
49,"49108",512,387,381,9,6,"P.S.O.E.",121
3,"3042",1337,1028,1019,8,9,"P.S.O.E.",254
39,"39022",985,735,734,5,1,"P.S.O.E.",138
40,"40088",303,242,238,0,4,"P.S.O.E.",51
45,"45137",1610,1057,1047,11,10,"P.S.O.E.",464
44,"44046",58,44,44,1,0,"P.S.O.E.",26
19,"19222",120,90,89,3,1,"P.S.O.E.",29
40,"40089",248,183,177,3,6,"P.S.O.E.",25
46,"46101",868,720,716,8,4,"P.S.O.E.",275
23,"23050",91354,68649,67925,990,724,"P.S.O.E.",20531
31,"31160",111,93,93,7,0,"P.S.O.E.",12
19,"19223",129,94,90,1,4,"P.S.O.E.",21
46,"46126",5471,4454,4392,53,62,"P.S.O.E.",1253
9,"9025",150,112,110,0,2,"P.S.O.E.",24
42,"42058",129,103,101,1,2,"P.S.O.E.",19
34,"34234",72,56,55,1,1,"P.S.O.E.",13
37,"37213",97,77,76,0,1,"P.S.O.E.",11
22,"22029",130,99,98,6,1,"P.S.O.E.",39
6,"6129",631,493,490,2,3,"P.S.O.E.",228
5,"5039",58,48,48,0,0,"P.S.O.E.",3
9,"9154",150,107,107,3,0,"P.S.O.E.",19
10,"10181",739,607,598,6,9,"P.S.O.E.",298
5,"5073",319,258,254,7,4,"P.S.O.E.",44
22,"22125",38140,26924,26463,676,461,"P.S.O.E.",8430
31,"31131",841,610,594,12,16,"P.S.O.E.",60
44,"44177",120,85,85,1,0,"P.S.O.E.",37
46,"46248",4847,3655,3597,25,58,"P.S.O.E.",981
47,"47039",196,163,163,1,0,"P.S.O.E.",72
10,"10903",813,620,615,3,5,"P.S.O.E.",304
24,"24190",183,134,131,1,3,"P.S.O.E.",35
37,"37329",40,36,36,2,0,"P.S.O.E.",3
37,"37101",185,143,141,1,2,"P.S.O.E.",29
5,"5901",289,197,196,4,1,"P.S.O.E.",24
40,"40092",132,100,100,0,0,"P.S.O.E.",22
23,"23053",9431,7160,7128,42,32,"P.S.O.E.",3483
22,"22032",120,78,73,5,5,"P.S.O.E.",32
9,"9335",62,52,51,1,1,"P.S.O.E.",14
42,"42061",297,190,188,4,2,"P.S.O.E.",62
46,"46176",1965,1423,1405,12,18,"P.S.O.E.",374
50,"50038",1583,1194,1174,29,20,"P.S.O.E.",473
10,"10102",534,447,440,4,7,"P.S.O.E.",200
3,"3012",1021,870,862,3,8,"P.S.O.E.",263
45,"45104",457,375,370,2,5,"P.S.O.E.",179
23,"23009",12876,10335,10231,109,104,"P.S.O.E.",3889
5,"5075",100,76,76,1,0,"P.S.O.E.",16
41,"41075",9987,7904,7809,71,95,"P.S.O.E.",3686
19,"19121",277,219,217,0,2,"P.S.O.E.",98
34,"34102",226,187,185,3,2,"P.S.O.E.",48
16,"16130",633,504,492,5,12,"P.S.O.E.",218
44,"44165",182,140,140,1,0,"P.S.O.E.",46
46,"46031",10580,7900,7809,87,91,"P.S.O.E.",2231
18,"18013",4392,3268,3223,23,45,"P.S.O.E.",1268
33,"33036",11674,8695,8605,104,90,"P.S.O.E.",3273
40,"40094",375,286,284,4,2,"P.S.O.E.",74
19,"19122",96,65,65,0,0,"P.S.O.E.",15
19,"19009",253,187,184,0,3,"P.S.O.E.",73
50,"50040",98,77,76,2,1,"P.S.O.E.",28
9,"9070",38,27,27,3,0,"P.S.O.E.",11
9,"9201",33,22,22,2,0,"P.S.O.E.",7
30,"30029",11533,8854,8768,73,86,"P.S.O.E.",2263
49,"49067",416,300,300,2,0,"P.S.O.E.",100
6,"6134",561,399,398,5,1,"P.S.O.E.",201
37,"37218",81,51,51,1,0,"P.S.O.E.",5
47,"47041",166,135,133,2,2,"P.S.O.E.",32
46,"46105",16708,12164,12040,100,124,"P.S.O.E.",3248
16,"16277",128,100,100,3,0,"P.S.O.E.",15
16,"16007",1272,1056,1051,7,5,"P.S.O.E.",380
29,"29060",775,573,572,1,1,"P.S.O.E.",202
40,"40097",114,96,94,2,2,"P.S.O.E.",42
26,"26093",60,41,41,0,0,"P.S.O.E.",19
49,"49069",414,276,270,1,6,"P.S.O.E.",38
3,"3015",12241,9734,9636,88,98,"P.S.O.E.",2280
31,"31074",430,304,303,10,1,"P.S.O.E.",27
47,"47177",112,83,79,1,4,"P.S.O.E.",19
6,"6090",904,724,710,10,14,"P.S.O.E.",316
35,"35020",6142,4227,4192,24,35,"P.S.O.E.",1284
5,"5905",253,200,198,1,2,"P.S.O.E.",18
40,"40905",143,103,103,1,0,"P.S.O.E.",11
16,"16278",91,69,69,2,0,"P.S.O.E.",30
50,"50217",496,380,379,0,1,"P.S.O.E.",183
45,"45035",307,236,236,3,0,"P.S.O.E.",89
41,"41078",2587,1979,1970,15,9,"P.S.O.E.",1074
30,"30031",560,471,469,3,2,"P.S.O.E.",64
5,"5175",190,149,149,2,0,"P.S.O.E.",28
37,"37334",86,50,49,0,1,"P.S.O.E.",11
10,"10107",1062,832,821,7,11,"P.S.O.E.",441
49,"49026",236,189,184,3,5,"P.S.O.E.",50
31,"31228",540,376,364,13,12,"P.S.O.E.",79
34,"34107",91,67,67,4,0,"P.S.O.E.",6
47,"47125",55,46,46,0,0,"P.S.O.E.",7
10,"10066",182,136,133,1,3,"P.S.O.E.",48
50,"50132",697,544,536,11,8,"P.S.O.E.",138
40,"40906",1793,1428,1405,32,23,"P.S.O.E.",407
19,"19013",143,110,108,1,2,"P.S.O.E.",50
49,"49206",948,706,692,15,14,"P.S.O.E.",224
44,"44184",34,21,21,2,0,"P.S.O.E.",2
9,"9478",53,41,41,1,0,"P.S.O.E.",16
18,"18027",2575,1913,1899,15,14,"P.S.O.E.",891
44,"44055",85,63,62,2,1,"P.S.O.E.",19
9,"9480",106,87,87,0,0,"P.S.O.E.",18
9,"9074",735,558,547,7,11,"P.S.O.E.",149
46,"46258",2792,2196,2164,14,32,"P.S.O.E.",660
42,"42070",45,29,28,0,1,"P.S.O.E.",15
11,"11006",24221,16564,16470,197,94,"P.S.O.E.",7149
37,"37223",127,102,101,1,1,"P.S.O.E.",36
18,"18126",1461,1129,1121,15,8,"P.S.O.E.",450
16,"16137",64,41,40,0,1,"P.S.O.E.",11
50,"50133",126,101,100,1,1,"P.S.O.E.",40
3,"3120",2329,1810,1785,16,25,"P.S.O.E.",481
5,"5080",75,53,53,1,0,"P.S.O.E.",9
44,"44106",173,132,131,8,1,"P.S.O.E.",47
31,"31199",161,103,103,1,0,"P.S.O.E.",9
31,"31198",38,33,33,0,0,"P.S.O.E.",3
11,"11007",17997,10781,10676,184,105,"P.S.O.E.",3404
10,"10191",527,421,414,3,7,"P.S.O.E.",114
9,"9213",370,260,260,5,0,"P.S.O.E.",85
5,"5178",392,310,304,2,6,"P.S.O.E.",68
41,"41002",1510,1161,1140,4,21,"P.S.O.E.",536
44,"44060",42,34,34,0,0,"P.S.O.E.",5
16,"16902",165,128,126,1,2,"P.S.O.E.",59
45,"45039",236,197,190,2,7,"P.S.O.E.",52
26,"26100",59,51,51,1,0,"P.S.O.E.",21
6,"6005",1699,1332,1320,19,12,"P.S.O.E.",718
9,"9168",329,254,254,2,0,"P.S.O.E.",131
19,"19300",746,595,585,3,10,"P.S.O.E.",119
50,"50134",134,102,101,3,1,"P.S.O.E.",24
47,"47046",124,105,103,0,2,"P.S.O.E.",39
24,"24081",143,111,110,1,1,"P.S.O.E.",14
24,"24082",877,698,690,13,8,"P.S.O.E.",336
5,"5082",569,467,462,1,5,"P.S.O.E.",130
50,"50046",201,155,153,2,2,"P.S.O.E.",35
9,"9485",62,56,56,0,0,"P.S.O.E.",2
33,"33071",671,528,523,4,5,"P.S.O.E.",261
10,"10153",331,266,263,1,3,"P.S.O.E.",86
10,"10030",502,364,362,5,2,"P.S.O.E.",154
41,"41082",3448,2827,2796,15,31,"P.S.O.E.",1556
46,"46183",5946,4718,4656,35,62,"P.S.O.E.",917
10,"10072",892,663,655,3,8,"P.S.O.E.",384
24,"24042",79,68,68,0,0,"P.S.O.E.",19
40,"40059",124,104,104,2,0,"P.S.O.E.",23
31,"31171",738,521,495,7,26,"P.S.O.E.",189
22,"22046",784,618,599,15,19,"P.S.O.E.",247
19,"19234",63,48,48,0,0,"P.S.O.E.",18
16,"16905",1017,811,806,14,5,"P.S.O.E.",263
26,"26102",6158,4794,4716,60,78,"P.S.O.E.",1508
42,"42078",1110,829,817,15,12,"P.S.O.E.",242
18,"18032",248,166,166,2,0,"P.S.O.E.",37
11,"11038",13815,10849,10756,126,93,"P.S.O.E.",3912
41,"41004",55127,37662,37179,622,483,"P.S.O.E.",14569
44,"44192",401,324,322,5,2,"P.S.O.E.",105
9,"9395",164,134,133,1,1,"P.S.O.E.",29
9,"9437",298,249,247,5,2,"P.S.O.E.",78
19,"19019",23,18,18,0,0,"P.S.O.E.",7
6,"6099",1127,815,805,6,10,"P.S.O.E.",423
10,"10115",3622,2872,2800,52,72,"P.S.O.E.",918
18,"18133",2256,1783,1773,12,10,"P.S.O.E.",683
22,"22142",114,91,91,2,0,"P.S.O.E.",11
9,"9079",49,44,44,1,0,"P.S.O.E.",2
37,"37116",75,55,55,1,0,"P.S.O.E.",11
16,"16906",104,83,82,0,1,"P.S.O.E.",32
12,"12061",431,324,316,6,8,"P.S.O.E.",147
40,"40016",63,45,45,0,0,"P.S.O.E.",5
39,"39007",479,348,347,3,1,"P.S.O.E.",61
47,"47131",189,145,145,4,0,"P.S.O.E.",52
49,"49083",67,48,48,1,0,"P.S.O.E.",9
9,"9352",134,107,106,0,1,"P.S.O.E.",37
18,"18033",282,227,226,0,1,"P.S.O.E.",107
22,"22201",287,203,198,2,5,"P.S.O.E.",113
49,"49066",531,392,386,2,6,"P.S.O.E.",82
24,"24087",670,513,513,12,0,"P.S.O.E.",98
40,"40902",137,118,118,3,0,"P.S.O.E.",12
31,"31072",5098,3764,3698,75,66,"P.S.O.E.",1292
24,"24007",798,582,566,2,16,"P.S.O.E.",251
31,"31113",147,87,85,2,2,"P.S.O.E.",22
5,"5018",27,24,24,0,0,"P.S.O.E.",8
50,"50196",110,87,86,4,1,"P.S.O.E.",46
40,"40111",72,57,55,0,2,"P.S.O.E.",4
5,"5086",96,81,81,2,0,"P.S.O.E.",10
33,"33074",3699,2643,2611,30,32,"P.S.O.E.",889
37,"37344",259,212,211,5,1,"P.S.O.E.",72
6,"6104",701,588,584,12,4,"P.S.O.E.",335
31,"31902",3722,2670,2632,77,38,"P.S.O.E.",447
50,"50169",371,275,274,5,1,"P.S.O.E.",90
6,"6149",10390,8354,8215,111,139,"P.S.O.E.",3503
16,"16245",430,338,329,2,9,"P.S.O.E.",88
5,"5054",1282,979,965,5,14,"P.S.O.E.",356
45,"45047",2404,1685,1662,7,23,"P.S.O.E.",306
6,"6013",283,245,244,1,1,"P.S.O.E.",150
22,"22203",92,79,79,0,0,"P.S.O.E.",26
39,"39088",70,61,61,1,0,"P.S.O.E.",32
46,"46186",18444,14173,14029,135,144,"P.S.O.E.",3755
49,"49223",770,606,601,8,5,"P.S.O.E.",113
44,"44195",103,71,70,0,1,"P.S.O.E.",22
22,"22051",108,86,84,2,2,"P.S.O.E.",29
30,"30039",18615,14213,14068,134,145,"P.S.O.E.",2813
19,"19239",99,74,73,1,1,"P.S.O.E.",13
45,"45084",2395,1879,1842,21,37,"P.S.O.E.",762
11,"11013",2284,1691,1670,15,21,"P.S.O.E.",678
46,"46041",369,255,255,1,0,"P.S.O.E.",83
18,"18004",818,601,594,2,7,"P.S.O.E.",245
12,"12065",181,155,155,0,0,"P.S.O.E.",42
19,"19024",7736,5738,5646,82,92,"P.S.O.E.",1463
26,"26109",105,87,84,0,3,"P.S.O.E.",38
24,"24212",1105,856,846,14,10,"P.S.O.E.",300
6,"6015",116077,82756,81836,989,920,"P.S.O.E.",21200
49,"49088",90,67,66,3,1,"P.S.O.E.",14
45,"45121",6553,4720,4653,43,67,"P.S.O.E.",1046
23,"23074",3039,2491,2451,29,40,"P.S.O.E.",1149
30,"30040",733,640,635,2,5,"P.S.O.E.",189
49,"49131",312,227,225,7,2,"P.S.O.E.",54
6,"6061",1116,1000,989,8,11,"P.S.O.E.",512
33,"33008",1934,1474,1459,11,15,"P.S.O.E.",536
26,"26110",178,149,147,3,2,"P.S.O.E.",40
2,"2009",19661,14804,14570,259,234,"P.S.O.E.",5079
39,"39011",1646,1295,1294,5,1,"P.S.O.E.",182
49,"49090",207,168,168,4,0,"P.S.O.E.",50
9,"9358",261,200,199,3,1,"P.S.O.E.",38
22,"22206",218,169,167,3,2,"P.S.O.E.",75
24,"24214",716,518,509,4,9,"P.S.O.E.",186
6,"6154",2830,2108,2080,38,28,"P.S.O.E.",880
45,"45160",1104,911,896,12,15,"P.S.O.E.",214
3,"3030",522,464,453,6,11,"P.S.O.E.",184
39,"39012",6666,5148,5061,43,87,"P.S.O.E.",1396
6,"6109",4006,3435,3372,21,63,"P.S.O.E.",1604
44,"44199",52,40,39,0,1,"P.S.O.E.",3
24,"24215",169,121,120,1,1,"P.S.O.E.",17
41,"41088",542,414,408,1,6,"P.S.O.E.",228
42,"42087",48,38,37,1,1,"P.S.O.E.",9
44,"44074",435,344,337,5,7,"P.S.O.E.",131
9,"9179",45,37,37,0,0,"P.S.O.E.",7
34,"34083",1888,1355,1338,15,17,"P.S.O.E.",320
19,"19177",82,67,66,0,1,"P.S.O.E.",32
10,"10124",873,707,707,16,0,"P.S.O.E.",383
45,"45051",1658,1305,1293,20,12,"P.S.O.E.",459
51,"51001",58533,32223,31745,498,478,"P.S.O.E.",6418
22,"22158",11978,8404,8279,149,125,"P.S.O.E.",2884
45,"45125",2407,1977,1949,22,28,"P.S.O.E.",719
35,"35032",3432,2605,2548,37,57,"P.S.O.E.",595
22,"22901",792,515,508,13,7,"P.S.O.E.",211
26,"26030",12,12,12,0,0,"P.S.O.E.",2
37,"37162",232,184,182,4,2,"P.S.O.E.",38
3,"3031",39966,27099,26802,291,297,"P.S.O.E.",7933
26,"26070",203,179,177,3,2,"P.S.O.E.",53
9,"9446",13,9,9,0,0,"P.S.O.E.",4
18,"18039",3733,2901,2878,18,23,"P.S.O.E.",1447
49,"49093",308,248,245,5,3,"P.S.O.E.",100
22,"22106",25,17,17,0,0,"P.S.O.E.",5
46,"46044",4301,3284,3169,50,115,"P.S.O.E.",1139
49,"49229",134,99,99,2,0,"P.S.O.E.",33
42,"42090",96,75,74,3,1,"P.S.O.E.",16
16,"16153",1006,856,843,8,13,"P.S.O.E.",344
39,"39092",1030,753,747,1,6,"P.S.O.E.",249
45,"45163",8239,6203,6073,103,130,"P.S.O.E.",1669
46,"46118",3883,3141,3105,28,36,"P.S.O.E.",1169
19,"19033",79,55,55,0,0,"P.S.O.E.",8
49,"49095",318,232,232,5,0,"P.S.O.E.",61
34,"34129",191,144,142,0,2,"P.S.O.E.",24
5,"5190",61,48,48,3,0,"P.S.O.E.",5
34,"34175",101,80,80,2,0,"P.S.O.E.",13
33,"33011",12085,7186,7116,89,70,"P.S.O.E.",1464
31,"31121",79,53,52,2,1,"P.S.O.E.",3
3,"3066",42697,31279,30833,566,446,"P.S.O.E.",9413
37,"37005",92,65,65,0,0,"P.S.O.E.",8
6,"6069",3116,2316,2288,46,28,"P.S.O.E.",1160
34,"34003",167,132,130,7,2,"P.S.O.E.",21
46,"46119",856,702,693,0,9,"P.S.O.E.",239
47,"47056",90,69,69,2,0,"P.S.O.E.",9
42,"42093",56,39,38,0,1,"P.S.O.E.",6
16,"16030",28,24,24,0,0,"P.S.O.E.",7
45,"45202",3876,3037,2984,13,53,"P.S.O.E.",868
37,"37165",27,20,20,1,0,"P.S.O.E.",1
3,"3136",484,393,386,1,7,"P.S.O.E.",121
5,"5191",124,98,98,2,0,"P.S.O.E.",31
50,"50058",80,65,64,0,1,"P.S.O.E.",18
31,"31183",667,516,508,8,8,"P.S.O.E.",85
19,"19246",48,38,38,1,0,"P.S.O.E.",22
45,"45165",62818,47242,46629,549,613,"P.S.O.E.",12613
31,"31091",365,227,224,3,3,"P.S.O.E.",15
49,"49233",119,78,78,2,0,"P.S.O.E.",32
49,"49098",242,177,175,4,2,"P.S.O.E.",41
31,"31122",4506,3333,3281,76,52,"P.S.O.E.",551
39,"39016",24213,18549,18362,265,187,"P.S.O.E.",4779
16,"16157",229,187,182,2,5,"P.S.O.E.",55
19,"19281",25,24,22,3,2,"P.S.O.E.",10
37,"37355",187,142,140,2,2,"P.S.O.E.",36
9,"9098",553,416,410,11,6,"P.S.O.E.",115
19,"19148",56,41,38,1,3,"P.S.O.E.",9
6,"6026",865,671,665,4,6,"P.S.O.E.",267
45,"45167",1552,1296,1278,14,18,"P.S.O.E.",423
46,"46193",8494,6662,6580,73,82,"P.S.O.E.",2016
24,"24021",1791,1251,1228,14,23,"P.S.O.E.",479
38,"38043",18628,12966,12763,134,203,"P.S.O.E.",2393
6,"6901",2113,1729,1706,26,23,"P.S.O.E.",651
50,"50235",2371,1723,1701,36,22,"P.S.O.E.",482
22,"22063",184,142,140,2,2,"P.S.O.E.",30
5,"5097",525,378,373,4,5,"P.S.O.E.",94
42,"42096",316,218,215,9,3,"P.S.O.E.",39
6,"6902",1688,1325,1313,21,12,"P.S.O.E.",620
23,"23086",11411,8918,8798,129,120,"P.S.O.E.",3551
49,"49235",486,344,340,6,4,"P.S.O.E.",120
18,"18146",1059,791,776,2,15,"P.S.O.E.",368
49,"49236",86,64,64,0,0,"P.S.O.E.",19
47,"47194",322,244,233,1,11,"P.S.O.E.",54
14,"14021",259993,183200,181402,2936,1798,"P.S.O.E.",48739
9,"9190",97,73,72,0,1,"P.S.O.E.",14
37,"37009",225,189,185,2,4,"P.S.O.E.",54
22,"22218",49,33,33,1,0,"P.S.O.E.",7
18,"18044",208,132,132,4,0,"P.S.O.E.",62
5,"5227",409,307,305,2,2,"P.S.O.E.",84
44,"44002",62,47,47,1,0,"P.S.O.E.",17
29,"29068",6209,4025,3983,41,42,"P.S.O.E.",1243
40,"40130",139,106,106,4,0,"P.S.O.E.",25
49,"49188",142,101,100,3,1,"P.S.O.E.",25
42,"42052",17,10,10,0,0,"P.S.O.E.",0
24,"24144",781,551,541,13,10,"P.S.O.E.",158
3,"3071",3993,3180,3128,40,52,"P.S.O.E.",737
37,"37282",238,169,168,3,1,"P.S.O.E.",44
44,"44087",98,87,87,2,0,"P.S.O.E.",30
47,"47034",90,65,63,0,2,"P.S.O.E.",15
45,"45133",2803,2241,2199,18,42,"P.S.O.E.",749
39,"39071",463,358,358,2,0,"P.S.O.E.",16
19,"19040",73,42,42,1,0,"P.S.O.E.",12
9,"9373",485,332,331,5,1,"P.S.O.E.",28
46,"46122",2737,2154,2131,18,23,"P.S.O.E.",835
10,"10135",1366,1004,998,3,6,"P.S.O.E.",455
23,"23090",1371,1188,1177,6,11,"P.S.O.E.",531
12,"12077",4683,3476,3414,41,62,"P.S.O.E.",1133
18,"18148",874,714,706,6,8,"P.S.O.E.",267
16,"16162",51,36,36,0,0,"P.S.O.E.",15
31,"31066",915,660,647,19,13,"P.S.O.E.",218
29,"29070",35228,23374,23146,258,228,"P.S.O.E.",6685
31,"31188",185,139,137,2,2,"P.S.O.E.",27
19,"19251",41,35,34,0,1,"P.S.O.E.",11
47,"47225",89,67,66,0,1,"P.S.O.E.",17
10,"10136",289,229,228,0,1,"P.S.O.E.",104
7,"7004",3669,2511,2453,51,58,"P.S.O.E.",776
45,"45172",757,597,594,7,3,"P.S.O.E.",162
11,"11025",4371,3260,3226,34,34,"P.S.O.E.",1805
22,"22223",92,65,64,3,1,"P.S.O.E.",37
39,"39099",2987,2416,2391,28,25,"P.S.O.E.",680
50,"50209",2559,1685,1661,34,24,"P.S.O.E.",447
49,"49240",237,190,186,1,4,"P.S.O.E.",40
24,"24228",732,543,529,4,14,"P.S.O.E.",102
16,"16163",75,57,57,0,0,"P.S.O.E.",29
12,"12079",450,360,353,3,7,"P.S.O.E.",86
26,"26001",211,174,168,3,6,"P.S.O.E.",64
14,"14055",18619,13802,13607,192,195,"P.S.O.E.",4593
10,"10137",428,373,371,1,2,"P.S.O.E.",189
49,"49241",275,225,221,2,4,"P.S.O.E.",38
44,"44213",60,48,48,0,0,"P.S.O.E.",7
19,"19155",61,52,50,1,2,"P.S.O.E.",17
5,"5198",80,65,65,1,0,"P.S.O.E.",8
16,"16083",58,30,30,1,0,"P.S.O.E.",5
22,"22119",1433,994,981,14,13,"P.S.O.E.",345
46,"46222",378,321,310,1,11,"P.S.O.E.",117
10,"10056",605,484,476,5,8,"P.S.O.E.",229
41,"41072",4083,3073,3046,12,27,"P.S.O.E.",1467
19,"19254",57,50,50,0,0,"P.S.O.E.",12
46,"46052",532,471,463,2,8,"P.S.O.E.",172
40,"40136",130,106,106,1,0,"P.S.O.E.",16
41,"41020",12710,8954,8882,91,72,"P.S.O.E.",4950
50,"50240",1127,799,783,25,16,"P.S.O.E.",352
22,"22227",225,172,168,3,4,"P.S.O.E.",68
9,"9109",1181,664,631,16,33,"P.S.O.E.",152
47,"47063",107,87,87,2,0,"P.S.O.E.",17
3,"3043",2933,2494,2447,27,47,"P.S.O.E.",882
40,"40184",269,227,224,4,3,"P.S.O.E.",33
37,"37099",104,64,62,1,2,"P.S.O.E.",11
44,"44258",75,56,55,0,1,"P.S.O.E.",14
22,"22075",150,103,101,7,2,"P.S.O.E.",56
34,"34186",61,53,53,0,0,"P.S.O.E.",12
11,"11027",67042,43386,43065,557,321,"P.S.O.E.",10624
49,"49244",48,30,30,1,0,"P.S.O.E.",10
26,"26130",229,181,177,0,4,"P.S.O.E.",43
24,"24902",375,292,289,1,3,"P.S.O.E.",112
46,"46029",20887,16124,15988,144,136,"P.S.O.E.",3392
50,"50241",634,462,455,2,7,"P.S.O.E.",127
11,"11028",32224,20706,20482,359,224,"P.S.O.E.",9380
50,"50066",2357,1677,1659,42,18,"P.S.O.E.",346
37,"37252",127,92,92,0,0,"P.S.O.E.",8
18,"18152",1037,822,818,9,4,"P.S.O.E.",554
24,"24109",1098,672,663,12,9,"P.S.O.E.",272
31,"31100",298,193,193,2,0,"P.S.O.E.",22
35,"35017",22331,13463,13144,217,319,"P.S.O.E.",2649
26,"26131",44,36,36,0,0,"P.S.O.E.",11
37,"37140",731,490,475,0,15,"P.S.O.E.",78
49,"49111",144,117,116,10,1,"P.S.O.E.",34
44,"44097",158,97,95,1,2,"P.S.O.E.",28
40,"40141",881,658,647,9,11,"P.S.O.E.",151
44,"44218",37,26,26,2,0,"P.S.O.E.",7
9,"9381",38,30,30,0,0,"P.S.O.E.",6
45,"45177",2295,1898,1857,15,41,"P.S.O.E.",703
22,"22229",127,93,89,4,4,"P.S.O.E.",31
14,"14028",333,279,277,1,2,"P.S.O.E.",155
46,"46055",1286,1083,1067,11,16,"P.S.O.E.",279
35,"35018",11652,6488,6367,107,121,"P.S.O.E.",1934
7,"7009",744,593,576,11,17,"P.S.O.E.",131
47,"47203",69,57,56,0,1,"P.S.O.E.",5
26,"26007",551,434,422,3,12,"P.S.O.E.",161
7,"7043",3522,2384,2345,35,39,"P.S.O.E.",476
40,"40142",53,43,41,1,2,"P.S.O.E.",5
45,"45068",164,135,133,1,2,"P.S.O.E.",57
26,"26134",102,82,80,2,2,"P.S.O.E.",15
50,"50068",2082,1514,1481,18,33,"P.S.O.E.",537
31,"31011",688,437,432,17,5,"P.S.O.E.",52
46,"46201",83,50,49,0,1,"P.S.O.E.",29
5,"5002",1996,1497,1476,15,21,"P.S.O.E.",415
11,"11030",22528,14741,14557,195,184,"P.S.O.E.",3918
49,"49248",224,183,180,4,3,"P.S.O.E.",55
50,"50157",313,253,250,7,3,"P.S.O.E.",102
47,"47067",198,159,156,5,3,"P.S.O.E.",23
31,"31103",51,40,40,3,0,"P.S.O.E.",5
50,"50244",215,155,155,6,0,"P.S.O.E.",48
37,"37020",449,371,365,7,6,"P.S.O.E.",116
40,"40003",144,123,120,1,3,"P.S.O.E.",9
42,"42117",146,115,111,1,4,"P.S.O.E.",22
22,"22079",126,97,97,4,0,"P.S.O.E.",44
18,"18053",1836,1345,1340,11,5,"P.S.O.E.",648
10,"10023",854,688,682,9,6,"P.S.O.E.",360
23,"23101",413,324,321,3,3,"P.S.O.E.",179
31,"31104",1990,1374,1355,20,19,"P.S.O.E.",510
41,"41024",22383,15333,15160,213,173,"P.S.O.E.",7294
3,"3048",4747,3878,3817,16,61,"P.S.O.E.",671
49,"49115",191,151,149,3,2,"P.S.O.E.",49
50,"50069",68,32,32,0,0,"P.S.O.E.",16
49,"49250",1330,998,985,19,13,"P.S.O.E.",308
5,"5109",438,359,351,5,8,"P.S.O.E.",83
7,"7012",1880,1437,1405,20,32,"P.S.O.E.",321
49,"49116",401,308,305,4,3,"P.S.O.E.",96
46,"46227",923,787,771,4,16,"P.S.O.E.",259
37,"37144",398,302,301,3,1,"P.S.O.E.",79
41,"41025",1999,1502,1476,13,26,"P.S.O.E.",561
16,"16174",209,170,167,0,3,"P.S.O.E.",65
37,"37022",287,237,232,0,5,"P.S.O.E.",66
5,"5110",710,584,581,1,3,"P.S.O.E.",119
40,"40005",34,32,31,1,1,"P.S.O.E.",6
19,"19261",42,31,31,1,0,"P.S.O.E.",3
26,"26012",17,15,15,1,0,"P.S.O.E.",6
10,"10147",1263,1003,965,5,38,"P.S.O.E.",490
42,"42119",192,124,123,0,1,"P.S.O.E.",17
31,"31196",40,35,35,1,0,"P.S.O.E.",4
37,"37145",276,217,214,0,3,"P.S.O.E.",91
46,"46034",1791,1477,1468,8,9,"P.S.O.E.",335
26,"26139",68,55,55,4,0,"P.S.O.E.",12
31,"31045",501,384,377,16,7,"P.S.O.E.",104
6,"6046",1288,1050,1042,11,8,"P.S.O.E.",454
5,"5208",55,45,45,0,0,"P.S.O.E.",14
16,"16175",5058,4363,4295,70,68,"P.S.O.E.",1797
44,"44224",26,15,15,0,0,"P.S.O.E.",8
7,"7014",6697,3818,3757,38,61,"P.S.O.E.",1525
23,"23904",3070,2047,2033,19,14,"P.S.O.E.",993
46,"46131",49087,37846,37477,422,369,"P.S.O.E.",9266
45,"45074",428,349,343,3,6,"P.S.O.E.",108
3,"3051",356,314,311,2,3,"P.S.O.E.",118
6,"6048",879,758,740,4,18,"P.S.O.E.",405
49,"49255",455,372,367,1,5,"P.S.O.E.",92
16,"16094",142,112,111,1,1,"P.S.O.E.",21
7,"7015",20783,12244,12016,381,228,"P.S.O.E.",3276
47,"47070",33,30,30,1,0,"P.S.O.E.",2
40,"40149",563,446,434,9,12,"P.S.O.E.",88
38,"38025",6649,4858,4778,52,80,"P.S.O.E.",1296
50,"50073",2265,1773,1756,20,17,"P.S.O.E.",630
5,"5012",156,134,132,1,2,"P.S.O.E.",26
29,"29007",25572,17726,17564,227,162,"P.S.O.E.",4771
44,"44226",163,112,112,3,0,"P.S.O.E.",54
14,"14065",1846,1509,1492,14,17,"P.S.O.E.",701
47,"47180",96,82,81,0,1,"P.S.O.E.",16
46,"46229",1065,840,831,8,9,"P.S.O.E.",260
9,"9390",645,522,518,9,4,"P.S.O.E.",158
31,"31169",2285,1621,1590,43,31,"P.S.O.E.",678
40,"40151",52,42,42,0,0,"P.S.O.E.",6
49,"49257",277,180,179,0,1,"P.S.O.E.",70
45,"45076",603,420,419,3,1,"P.S.O.E.",142
29,"29082",29311,20220,20051,223,169,"P.S.O.E.",5123
24,"24002",271,213,213,2,0,"P.S.O.E.",109
49,"49120",79,58,58,1,0,"P.S.O.E.",15
9,"9302",116,87,87,3,0,"P.S.O.E.",18
46,"46133",686,572,565,1,7,"P.S.O.E.",269
16,"16052",596,469,464,2,5,"P.S.O.E.",190
34,"34110",96,83,81,2,2,"P.S.O.E.",31
40,"40105",60,51,51,1,0,"P.S.O.E.",18
31,"31200",763,527,514,17,13,"P.S.O.E.",134
16,"16185",63,45,44,0,1,"P.S.O.E.",21
34,"34032",47,36,36,1,0,"P.S.O.E.",6
5,"5211",484,406,405,3,1,"P.S.O.E.",94
9,"9392",51,42,42,1,0,"P.S.O.E.",12
40,"40152",750,615,595,4,20,"P.S.O.E.",176
44,"44228",121,97,96,2,1,"P.S.O.E.",29
22,"22086",207,149,147,1,2,"P.S.O.E.",44
47,"47099",174,153,153,4,0,"P.S.O.E.",37
38,"38027",5392,3530,3459,41,71,"P.S.O.E.",832
18,"18029",1892,1355,1347,6,8,"P.S.O.E.",780
9,"9077",38,26,25,0,1,"P.S.O.E.",5
23,"23065",1701,1238,1226,10,12,"P.S.O.E.",591
44,"44062",38,34,34,0,0,"P.S.O.E.",13
31,"31263",241,135,132,0,3,"P.S.O.E.",9
3,"3055",5128,4121,4076,43,45,"P.S.O.E.",820
16,"16186",521,434,429,2,5,"P.S.O.E.",149
37,"37377",268,209,208,1,1,"P.S.O.E.",53
5,"5116",131,114,109,0,5,"P.S.O.E.",12
16,"16055",698,485,481,8,4,"P.S.O.E.",141
37,"37029",226,181,178,4,3,"P.S.O.E.",55
37,"37341",52,32,32,0,0,"P.S.O.E.",7
46,"46086",80,71,71,3,0,"P.S.O.E.",42
22,"22088",171,133,128,5,5,"P.S.O.E.",60
40,"40156",361,268,264,5,4,"P.S.O.E.",41
40,"40060",86,65,64,3,1,"P.S.O.E.",11
50,"50047",60,34,34,2,0,"P.S.O.E.",14
10,"10073",759,589,583,3,6,"P.S.O.E.",237
37,"37302",337,230,229,5,1,"P.S.O.E.",62
44,"44024",24,19,19,0,0,"P.S.O.E.",2
34,"34160",154,119,116,0,3,"P.S.O.E.",64
49,"49261",1579,1161,1145,36,16,"P.S.O.E.",396
24,"24044",176,138,136,2,2,"P.S.O.E.",40
9,"9258",190,159,159,5,0,"P.S.O.E.",34
50,"50077",254,189,188,4,1,"P.S.O.E.",78
7,"7021",255,197,193,1,4,"P.S.O.E.",44
3,"3024",3908,3324,3271,34,53,"P.S.O.E.",1054
37,"37379",167,128,125,4,3,"P.S.O.E.",38
31,"31203",30,25,25,0,0,"P.S.O.E.",11
22,"22247",31,21,20,1,1,"P.S.O.E.",14
34,"34035",122,98,96,0,2,"P.S.O.E.",42
40,"40158",24,18,17,0,1,"P.S.O.E.",0
10,"10197",143,96,94,1,2,"P.S.O.E.",20
50,"50138",49,43,43,2,0,"P.S.O.E.",5
33,"33005",1600,1084,1080,6,4,"P.S.O.E.",415
24,"24049",1528,1144,1124,22,20,"P.S.O.E.",402
22,"22006",319,203,197,5,6,"P.S.O.E.",72
47,"47102",302,250,248,3,2,"P.S.O.E.",89
40,"40063",7290,5366,5171,68,195,"P.S.O.E.",1360
49,"49084",306,234,234,8,0,"P.S.O.E.",66
46,"46112",582,475,463,4,12,"P.S.O.E.",161
19,"19269",103,84,83,0,1,"P.S.O.E.",27
49,"49127",2227,1617,1587,48,30,"P.S.O.E.",446
34,"34036",211,159,157,0,2,"P.S.O.E.",72
49,"49036",592,410,403,5,7,"P.S.O.E.",134
3,"3058",4798,4126,4103,26,23,"P.S.O.E.",803
9,"9006",68,40,39,1,1,"P.S.O.E.",6
12,"12064",118,91,89,1,2,"P.S.O.E.",41
44,"44234",76,63,63,0,0,"P.S.O.E.",20
3,"3128",3944,2847,2812,16,35,"P.S.O.E.",715
16,"16146",96,74,70,0,4,"P.S.O.E.",11
31,"31174",115,72,70,1,2,"P.S.O.E.",14
5,"5183",165,142,140,0,2,"P.S.O.E.",14
18,"18168",864,613,605,4,8,"P.S.O.E.",214
50,"50254",179,136,136,0,0,"P.S.O.E.",53
29,"29088",2784,2019,1975,14,44,"P.S.O.E.",985
34,"34038",284,228,225,9,3,"P.S.O.E.",26
37,"37382",202,172,171,3,1,"P.S.O.E.",65
50,"50198",46,36,36,2,0,"P.S.O.E.",7
5,"5217",69,54,54,0,0,"P.S.O.E.",10
10,"10160",235,183,183,1,0,"P.S.O.E.",113
26,"26064",2341,1770,1749,26,21,"P.S.O.E.",565
50,"50080",41,31,31,1,0,"P.S.O.E.",5
3,"3129",1188,936,918,10,18,"P.S.O.E.",164
31,"31115",171,112,109,2,3,"P.S.O.E.",5
16,"16192",54,37,37,1,0,"P.S.O.E.",22
3,"3027",150,131,130,1,1,"P.S.O.E.",42
9,"9405",143,106,105,2,1,"P.S.O.E.",18
40,"40020",200,155,149,2,6,"P.S.O.E.",32
46,"46211",1716,1459,1447,9,12,"P.S.O.E.",376
40,"40162",420,320,314,1,6,"P.S.O.E.",44
16,"16193",77,68,67,0,1,"P.S.O.E.",40
29,"29015",31805,22566,22347,272,219,"P.S.O.E.",7888
24,"24213",162,134,133,1,1,"P.S.O.E.",38
42,"42140",17,10,10,0,0,"P.S.O.E.",0
46,"46066",1264,1060,1050,5,10,"P.S.O.E.",286
18,"18170",377,238,237,0,1,"P.S.O.E.",125
37,"37196",93,74,70,1,4,"P.S.O.E.",25
31,"31055",264,194,193,0,1,"P.S.O.E.",17
44,"44156",57,40,38,1,2,"P.S.O.E.",8
24,"24131",813,583,580,9,3,"P.S.O.E.",145
6,"6063",3079,2467,2454,16,13,"P.S.O.E.",1240
22,"22102",194,152,149,4,3,"P.S.O.E.",56
33,"33031",38090,25034,24730,380,304,"P.S.O.E.",7620
40,"40022",210,154,151,2,3,"P.S.O.E.",49
46,"46904",782,659,650,6,9,"P.S.O.E.",142
38,"38002",991,716,708,1,8,"P.S.O.E.",358
31,"31208",2574,2003,1966,32,37,"P.S.O.E.",859
9,"9133",39,33,33,1,0,"P.S.O.E.",9
18,"18069",506,375,371,4,4,"P.S.O.E.",156
49,"49269",241,171,170,5,1,"P.S.O.E.",39
12,"12068",57,45,44,0,1,"P.S.O.E.",11
42,"42141",124,90,87,1,3,"P.S.O.E.",28
29,"29017",6766,5162,5114,48,48,"P.S.O.E.",2400
33,"33032",12060,8627,8491,107,136,"P.S.O.E.",2756
19,"19066",78,63,62,0,1,"P.S.O.E.",6
37,"37124",227,181,179,3,2,"P.S.O.E.",55
40,"40120",173,145,144,1,1,"P.S.O.E.",43
37,"37197",101,72,70,1,2,"P.S.O.E.",11
16,"16065",454,380,374,4,6,"P.S.O.E.",109
22,"22254",1175,868,856,14,12,"P.S.O.E.",391
34,"34042",299,249,246,5,3,"P.S.O.E.",67
2,"2084",362,276,270,2,6,"P.S.O.E.",76
24,"24015",2391,1812,1782,20,30,"P.S.O.E.",490
24,"24216",782,582,574,3,8,"P.S.O.E.",143
31,"31088",5358,3655,3592,97,63,"P.S.O.E.",788
16,"16152",42,38,37,3,1,"P.S.O.E.",3
46,"46190",48324,34747,34424,431,323,"P.S.O.E.",8543
34,"34171",1071,762,753,16,9,"P.S.O.E.",153
37,"37002",152,90,89,1,1,"P.S.O.E.",30
5,"5221",398,298,297,10,1,"P.S.O.E.",92
6,"6066",1798,1348,1340,7,8,"P.S.O.E.",812
41,"41903",6653,5134,5070,61,64,"P.S.O.E.",2636
40,"40213",99,75,74,1,1,"P.S.O.E.",20
34,"34046",45,35,34,0,1,"P.S.O.E.",11
49,"49135",687,485,475,3,10,"P.S.O.E.",134
9,"9409",138,105,102,0,3,"P.S.O.E.",35
19,"19067",91,59,59,0,0,"P.S.O.E.",27
35,"35033",6415,4394,4302,51,92,"P.S.O.E.",1014
16,"16068",143,117,116,6,1,"P.S.O.E.",34
5,"5125",60,52,52,0,0,"P.S.O.E.",10
50,"50175",1088,742,732,10,10,"P.S.O.E.",338
12,"12002",135,101,100,1,1,"P.S.O.E.",38
46,"46142",870,682,673,7,9,"P.S.O.E.",212
29,"29093",2299,1767,1732,7,35,"P.S.O.E.",850
18,"18072",710,507,499,2,8,"P.S.O.E.",248
9,"9054",107,80,80,1,0,"P.S.O.E.",16
46,"46070",15946,11979,11874,113,105,"P.S.O.E.",2478
24,"24096",145,96,93,0,3,"P.S.O.E.",26
3,"3135",228,185,181,0,4,"P.S.O.E.",93
34,"34047",1814,1435,1413,24,22,"P.S.O.E.",277
49,"49005",156,102,101,2,1,"P.S.O.E.",28
31,"31060",12916,8830,8687,158,143,"P.S.O.E.",2022
31,"31212",173,117,117,3,0,"P.S.O.E.",19
50,"50260",42,35,35,1,0,"P.S.O.E.",5
42,"42001",308,242,237,4,5,"P.S.O.E.",100
19,"19280",3415,2521,2490,27,31,"P.S.O.E.",580
42,"42003",76,54,51,0,3,"P.S.O.E.",6
18,"18011",4246,3195,3172,23,23,"P.S.O.E.",1232
31,"31182",45,28,28,2,0,"P.S.O.E.",2
37,"37277",58,39,38,1,1,"P.S.O.E.",4
37,"37042",45,35,35,1,0,"P.S.O.E.",2
50,"50086",193,109,109,0,0,"P.S.O.E.",63
22,"22905",312,249,247,4,2,"P.S.O.E.",60
9,"9017",96,76,74,0,2,"P.S.O.E.",31
5,"5225",423,346,342,8,4,"P.S.O.E.",46
6,"6071",257,236,230,1,6,"P.S.O.E.",114
26,"26164",70,42,42,1,0,"P.S.O.E.",13
9,"9412",846,568,563,4,5,"P.S.O.E.",121
26,"26163",143,118,116,2,2,"P.S.O.E.",51
42,"42048",78,63,62,3,1,"P.S.O.E.",13
26,"26034",678,526,510,3,16,"P.S.O.E.",199
45,"45093",168,133,133,0,0,"P.S.O.E.",32
49,"49050",558,382,375,3,7,"P.S.O.E.",85
23,"23040",1538,1319,1311,3,8,"P.S.O.E.",554
29,"29021",153,113,113,0,0,"P.S.O.E.",56
31,"31214",95,64,64,1,0,"P.S.O.E.",3
46,"46072",3711,3006,2932,38,74,"P.S.O.E.",859
47,"47085",16967,12618,12472,208,146,"P.S.O.E.",3968
24,"24020",480,326,324,9,2,"P.S.O.E.",113
37,"37168",470,357,353,1,4,"P.S.O.E.",126
29,"29067",420165,273593,271376,3342,2217,"P.S.O.E.",78790
3,"3036",84,72,72,0,0,"P.S.O.E.",15
49,"49142",264,180,179,2,1,"P.S.O.E.",55
5,"5030",43,39,39,0,0,"P.S.O.E.",15
10,"10049",3952,3348,3259,36,89,"P.S.O.E.",1350
45,"45205",6333,4544,4451,58,93,"P.S.O.E.",1058
47,"47168",32,29,28,1,1,"P.S.O.E.",1
18,"18078",768,638,637,1,1,"P.S.O.E.",334
9,"9140",136,110,110,1,0,"P.S.O.E.",43
26,"26036",16873,12341,12167,190,174,"P.S.O.E.",3345
10,"10172",728,531,522,3,9,"P.S.O.E.",192
22,"22907",1444,1034,1018,12,16,"P.S.O.E.",311
10,"10132",420,293,287,1,6,"P.S.O.E.",142
9,"9275",202,140,139,5,1,"P.S.O.E.",30
16,"16159",299,204,202,5,2,"P.S.O.E.",72
19,"19075",81,53,50,4,3,"P.S.O.E.",7
29,"29097",4076,3060,3018,40,42,"P.S.O.E.",1414
42,"42155",188,121,120,0,1,"P.S.O.E.",25
7,"7902",1071,734,712,22,22,"P.S.O.E.",255
16,"16118",1454,1221,1211,19,10,"P.S.O.E.",355
24,"24062",151,107,107,0,0,"P.S.O.E.",55
49,"49011",236,195,194,5,1,"P.S.O.E.",31
31,"31186",299,205,200,3,5,"P.S.O.E.",18
9,"9326",156,119,114,2,5,"P.S.O.E.",22
6,"6121",3436,2700,2662,35,38,"P.S.O.E.",1070
12,"12138",18762,12489,12231,243,258,"P.S.O.E.",4070
9,"9454",46,31,30,1,1,"P.S.O.E.",10
5,"5131",118,86,86,3,0,"P.S.O.E.",6
44,"44088",32,31,31,1,0,"P.S.O.E.",7
37,"37246",5430,4363,4315,63,48,"P.S.O.E.",1293
44,"44210",754,573,567,3,6,"P.S.O.E.",224
22,"22115",415,307,304,2,3,"P.S.O.E.",101
26,"26168",5055,3534,3484,47,50,"P.S.O.E.",1024
19,"19076",36,29,29,0,0,"P.S.O.E.",9
9,"9144",61,51,50,0,1,"P.S.O.E.",9
42,"42010",19,15,15,1,0,"P.S.O.E.",0
38,"38013",2823,1856,1843,18,13,"P.S.O.E.",428
46,"46147",16527,11836,11716,105,120,"P.S.O.E.",2915
50,"50005",245,199,195,1,4,"P.S.O.E.",45
24,"24227",1664,1159,1148,16,11,"P.S.O.E.",338
9,"9022",83,58,58,2,0,"P.S.O.E.",10
42,"42158",112,79,79,6,0,"P.S.O.E.",26
42,"42011",22,14,14,1,0,"P.S.O.E.",0
10,"10053",303,253,246,5,7,"P.S.O.E.",87
19,"19286",743,566,554,8,12,"P.S.O.E.",137
44,"44006",293,220,212,3,8,"P.S.O.E.",75
7,"7037",3269,1737,1700,37,37,"P.S.O.E.",529
47,"47088",121,100,100,0,0,"P.S.O.E.",33
40,"40039",257,188,184,2,4,"P.S.O.E.",30
50,"50006",978,758,749,16,9,"P.S.O.E.",304
9,"9280",34,23,23,0,0,"P.S.O.E.",6
19,"19154",79,68,67,0,1,"P.S.O.E.",8
34,"34182",860,657,649,8,8,"P.S.O.E.",245
31,"31220",771,584,572,9,12,"P.S.O.E.",195
37,"37173",1643,1298,1285,26,13,"P.S.O.E.",429
49,"49148",213,144,143,0,1,"P.S.O.E.",49
16,"16213",39,32,32,1,0,"P.S.O.E.",13
46,"46221",350,319,317,3,2,"P.S.O.E.",98
44,"44131",26,20,20,0,0,"P.S.O.E.",10
26,"26171",212,171,170,6,1,"P.S.O.E.",36
40,"40040",2677,1990,1966,24,24,"P.S.O.E.",483
38,"38015",4326,3132,3099,21,33,"P.S.O.E.",553
33,"33040",4702,3285,3236,44,49,"P.S.O.E.",901
49,"49192",166,139,139,2,0,"P.S.O.E.",54
31,"31251",3147,2274,2225,39,49,"P.S.O.E.",653
50,"50064",469,377,373,5,4,"P.S.O.E.",178
2,"2024",3424,2765,2726,32,39,"P.S.O.E.",978
49,"49107",160,113,111,2,2,"P.S.O.E.",51
42,"42014",83,55,55,1,0,"P.S.O.E.",13
9,"9281",159,134,132,5,2,"P.S.O.E.",34
19,"19189",136,99,97,0,2,"P.S.O.E.",21
5,"5038",131,88,84,0,4,"P.S.O.E.",11
34,"34058",212,179,178,0,1,"P.S.O.E.",64
49,"49017",264,189,187,1,2,"P.S.O.E.",36
22,"22122",62,57,57,3,0,"P.S.O.E.",20
19,"19081",43,33,33,0,0,"P.S.O.E.",6
7,"7040",266127,162699,160491,2698,2208,"P.S.O.E.",45673
19,"19326",1125,800,786,10,14,"P.S.O.E.",156
12,"12080",2051,1692,1650,23,42,"P.S.O.E.",791
19,"19044",319,248,245,0,3,"P.S.O.E.",55
2,"2061",715,570,565,4,5,"P.S.O.E.",180
10,"10901",1148,844,839,18,5,"P.S.O.E.",328
26,"26173",10,10,10,1,0,"P.S.O.E.",2
46,"46077",7637,5979,5845,64,134,"P.S.O.E.",1732
18,"18183",685,502,500,3,2,"P.S.O.E.",249
47,"47173",862,683,675,5,8,"P.S.O.E.",294
50,"50269",316,186,185,1,1,"P.S.O.E.",57
45,"45103",457,400,394,0,6,"P.S.O.E.",161
37,"37056",56,47,47,0,0,"P.S.O.E.",14
23,"23007",3116,2483,2458,15,25,"P.S.O.E.",1273
38,"38017",24438,13769,13576,176,193,"P.S.O.E.",3325
9,"9423",34,28,28,1,0,"P.S.O.E.",4
24,"24152",481,326,322,5,4,"P.S.O.E.",61
37,"37289",265,211,209,0,2,"P.S.O.E.",56
16,"16086",935,814,802,14,12,"P.S.O.E.",293
26,"26046",1617,1237,1219,14,18,"P.S.O.E.",407
10,"10059",414,352,349,4,3,"P.S.O.E.",178
5,"5040",77,59,59,1,0,"P.S.O.E.",9
24,"24030",4397,3272,3229,54,43,"P.S.O.E.",1214
5,"5138",326,278,275,2,3,"P.S.O.E.",50
46,"46151",717,596,589,3,7,"P.S.O.E.",194
44,"44011",67,47,47,0,0,"P.S.O.E.",20
37,"37290",143,111,110,1,1,"P.S.O.E.",36
7,"7042",10393,6536,6421,96,115,"P.S.O.E.",2290
31,"31132",160,124,124,6,0,"P.S.O.E.",8
16,"16087",229,193,187,4,6,"P.S.O.E.",63
46,"46006",4643,3847,3785,32,62,"P.S.O.E.",849
47,"47014",55,47,47,0,0,"P.S.O.E.",13
45,"45105",426,326,322,2,4,"P.S.O.E.",92
10,"10103",480,385,380,3,5,"P.S.O.E.",168
24,"24154",1068,803,795,6,8,"P.S.O.E.",274
5,"5139",74,62,59,2,3,"P.S.O.E.",2
37,"37291",261,215,214,1,1,"P.S.O.E.",76
12,"12115",234,184,183,2,1,"P.S.O.E.",29
18,"18088",1576,1258,1253,2,5,"P.S.O.E.",598
5,"5042",156,126,126,0,0,"P.S.O.E.",26
16,"16089",386,310,308,10,2,"P.S.O.E.",100
22,"22128",203,164,161,7,3,"P.S.O.E.",54
50,"50186",44,30,29,0,1,"P.S.O.E.",10
9,"9292",98,73,71,3,2,"P.S.O.E.",20
14,"14030",8519,6832,6753,64,79,"P.S.O.E.",3425
31,"31225",40,32,32,0,0,"P.S.O.E.",7
49,"49156",265,217,214,6,3,"P.S.O.E.",56
19,"19193",30,29,29,1,0,"P.S.O.E.",18
40,"40049",52,39,39,1,0,"P.S.O.E.",17
47,"47015",229,172,170,1,2,"P.S.O.E.",45
10,"10185",587,457,450,1,7,"P.S.O.E.",191
46,"46226",34,34,33,0,1,"P.S.O.E.",18
10,"10186",1031,906,896,8,10,"P.S.O.E.",386
3,"3081",1409,1102,1087,14,15,"P.S.O.E.",284
40,"40191",265,191,190,1,1,"P.S.O.E.",20
42,"42021",101,70,70,1,0,"P.S.O.E.",4
47,"47016",94,77,77,1,0,"P.S.O.E.",21
14,"14061",841,700,693,3,7,"P.S.O.E.",350
29,"29032",6673,5204,5140,43,64,"P.S.O.E.",2316
40,"40051",54,41,40,0,1,"P.S.O.E.",9
10,"10064",1549,1229,1209,6,20,"P.S.O.E.",553
19,"19089",33,22,22,1,0,"P.S.O.E.",13
5,"5142",113,97,96,0,1,"P.S.O.E.",21
9,"9248",63,52,52,0,0,"P.S.O.E.",14
18,"18089",15803,10794,10712,95,82,"P.S.O.E.",4163
50,"50099",3136,2333,2297,27,36,"P.S.O.E.",861
2,"2069",11624,9091,8907,119,184,"P.S.O.E.",1908
10,"10065",188,123,123,1,0,"P.S.O.E.",64
38,"38022",18671,13075,12890,111,185,"P.S.O.E.",2597
10,"10187",486,349,345,2,4,"P.S.O.E.",176
3,"3082",11741,8208,8102,80,106,"P.S.O.E.",2150
42,"42023",78,58,58,1,0,"P.S.O.E.",9
40,"40193",231,188,185,6,3,"P.S.O.E.",58
19,"19090",107,87,86,0,1,"P.S.O.E.",39
26,"26052",181,146,146,0,0,"P.S.O.E.",34
47,"47096",139,109,107,0,2,"P.S.O.E.",27
9,"9249",54,44,42,1,2,"P.S.O.E.",11
3,"3017",380,331,324,7,7,"P.S.O.E.",115
18,"18124",387,270,267,0,3,"P.S.O.E.",89
47,"47179",408,315,306,6,9,"P.S.O.E.",83
33,"33046",546,429,421,3,8,"P.S.O.E.",99
46,"46155",1072,861,849,4,12,"P.S.O.E.",291
3,"3084",593,518,513,2,5,"P.S.O.E.",190
12,"12020",131,109,107,1,2,"P.S.O.E.",9
30,"30006",823,719,711,5,8,"P.S.O.E.",198
24,"24038",3206,2439,2399,37,40,"P.S.O.E.",1046
10,"10189",2728,2108,2063,24,45,"P.S.O.E.",916
5,"5143",81,61,61,0,0,"P.S.O.E.",17
42,"42173",28809,20268,19748,632,520,"P.S.O.E.",7393
47,"47097",345,291,289,7,2,"P.S.O.E.",123
10,"10149",434,323,319,1,4,"P.S.O.E.",119
24,"24199",432,280,278,2,2,"P.S.O.E.",90
29,"29063",358,272,271,2,1,"P.S.O.E.",88
22,"22135",200,152,147,5,5,"P.S.O.E.",45
14,"14004",2016,1560,1543,8,17,"P.S.O.E.",756
26,"26054",381,298,292,2,6,"P.S.O.E.",118
14,"14064",352,265,261,3,4,"P.S.O.E.",121
50,"50191",505,395,390,4,5,"P.S.O.E.",142
49,"49029",675,553,542,6,11,"P.S.O.E.",105
37,"37336",54,49,47,0,2,"P.S.O.E.",11
5,"5177",164,134,133,0,1,"P.S.O.E.",46
26,"26014",472,358,353,6,5,"P.S.O.E.",161
30,"30007",6115,4651,4603,29,48,"P.S.O.E.",949
50,"50277",82,63,63,0,0,"P.S.O.E.",6
16,"16096",279,231,229,7,2,"P.S.O.E.",93
9,"9037",122,91,90,2,1,"P.S.O.E.",42
47,"47098",607,496,492,9,4,"P.S.O.E.",138
40,"40198",30,21,20,0,1,"P.S.O.E.",1
22,"22136",908,671,662,11,9,"P.S.O.E.",261
34,"34205",70,55,55,1,0,"P.S.O.E.",16
19,"19232",89,68,67,0,1,"P.S.O.E.",26
16,"16012",102,81,80,0,1,"P.S.O.E.",37
16,"16139",346,279,277,2,2,"P.S.O.E.",80
50,"50164",407,271,268,4,3,"P.S.O.E.",90
42,"42125",73,65,64,4,1,"P.S.O.E.",32
12,"12121",1197,1050,1020,4,30,"P.S.O.E.",439
7,"7050",3099,2008,1979,45,29,"P.S.O.E.",349
40,"40057",1522,1272,1260,19,12,"P.S.O.E.",485
2,"2073",4924,3923,3847,76,76,"P.S.O.E.",1304
19,"19199",24,21,21,0,0,"P.S.O.E.",12
14,"14067",3821,3105,3082,38,23,"P.S.O.E.",1112
34,"34071",186,160,160,1,0,"P.S.O.E.",30
23,"23020",1623,1414,1400,16,14,"P.S.O.E.",496
2,"2001",731,601,584,6,17,"P.S.O.E.",203
50,"50045",1289,1011,992,14,19,"P.S.O.E.",317
10,"10071",179,133,133,1,0,"P.S.O.E.",65
45,"45188",2883,2180,2151,30,29,"P.S.O.E.",791
42,"42030",115,88,86,2,2,"P.S.O.E.",8
34,"34072",189,169,166,2,3,"P.S.O.E.",33
31,"31110",97,53,53,3,0,"P.S.O.E.",14
9,"9170",218,158,157,0,1,"P.S.O.E.",29
5,"5148",34,27,27,0,0,"P.S.O.E.",5
34,"34208",62,52,52,2,0,"P.S.O.E.",3
18,"18901",583,374,368,3,6,"P.S.O.E.",134
19,"19302",64,60,60,2,0,"P.S.O.E.",27
12,"12123",70,50,48,2,2,"P.S.O.E.",12
31,"31202",4247,3014,2957,69,57,"P.S.O.E.",757
18,"18132",3461,2797,2772,19,25,"P.S.O.E.",1652
37,"37071",90,80,80,1,0,"P.S.O.E.",41
47,"47021",84,61,61,2,0,"P.S.O.E.",10
31,"31264",173,110,108,1,2,"P.S.O.E.",9
12,"12093",254,190,187,0,3,"P.S.O.E.",56
7,"7019",230,165,164,1,1,"P.S.O.E.",10
5,"5213",117,94,88,0,6,"P.S.O.E.",17
34,"34073",184,153,152,7,1,"P.S.O.E.",42
24,"24206",1831,1362,1341,13,21,"P.S.O.E.",616
42,"42031",31,19,19,0,0,"P.S.O.E.",2
41,"41098",4650,3665,3603,43,62,"P.S.O.E.",1407
5,"5245",344,285,284,5,1,"P.S.O.E.",58
5,"5151",100,86,82,1,4,"P.S.O.E.",12
9,"9043",215,151,151,1,0,"P.S.O.E.",34
16,"16189",263,213,211,2,2,"P.S.O.E.",41
5,"5052",102,91,91,0,0,"P.S.O.E.",5
46,"46087",137,105,105,1,0,"P.S.O.E.",58
9,"9307",119,89,88,1,1,"P.S.O.E.",43
47,"47022",62,54,54,0,0,"P.S.O.E.",3
6,"6101",489,397,395,5,2,"P.S.O.E.",144
11,"11011",1685,1231,1216,8,15,"P.S.O.E.",439
42,"42032",186,143,141,2,2,"P.S.O.E.",41
34,"34213",67,50,50,0,0,"P.S.O.E.",8
37,"37118",141,115,114,3,1,"P.S.O.E.",29
11,"11012",103946,68124,67375,856,749,"P.S.O.E.",19684
12,"12063",59,42,41,0,1,"P.S.O.E.",21
10,"10117",264,174,174,2,0,"P.S.O.E.",93
26,"26022",232,191,190,1,1,"P.S.O.E.",21
44,"44232",408,301,295,5,6,"P.S.O.E.",96
37,"37192",362,229,221,3,8,"P.S.O.E.",44
19,"19102",122,101,100,0,1,"P.S.O.E.",31
34,"34076",632,524,520,13,4,"P.S.O.E.",127
47,"47049",94,71,71,1,0,"P.S.O.E.",16
18,"18034",510,377,375,2,2,"P.S.O.E.",165
23,"23027",763,619,616,1,3,"P.S.O.E.",383
31,"31205",465,335,325,9,10,"P.S.O.E.",144
18,"18904",858,620,612,3,8,"P.S.O.E.",299
42,"42134",2626,1945,1896,36,49,"P.S.O.E.",656
16,"16060",841,714,704,11,10,"P.S.O.E.",316
9,"9130",87,72,71,0,1,"P.S.O.E.",6
26,"26063",131,104,102,2,2,"P.S.O.E.",24
5,"5247",267,164,164,0,0,"P.S.O.E.",35
31,"31144",840,509,508,7,1,"P.S.O.E.",23
31,"31237",198,137,136,7,1,"P.S.O.E.",23
5,"5153",112,89,89,5,0,"P.S.O.E.",16
49,"49038",114,81,80,0,1,"P.S.O.E.",28
37,"37119",115,98,98,0,0,"P.S.O.E.",44
24,"24050",113,91,90,0,1,"P.S.O.E.",26
22,"22008",194,168,167,11,1,"P.S.O.E.",36
41,"41086",15877,10246,10150,146,96,"P.S.O.E.",4734
19,"19104",16,12,12,1,0,"P.S.O.E.",3
46,"46138",338,297,296,1,1,"P.S.O.E.",75
6,"6106",447,335,333,7,2,"P.S.O.E.",141
34,"34216",65,50,50,1,0,"P.S.O.E.",4
33,"33053",1206,817,811,6,6,"P.S.O.E.",360
37,"37194",271,206,204,0,2,"P.S.O.E.",76
49,"49039",333,243,240,6,3,"P.S.O.E.",74
31,"31054",498,310,308,1,2,"P.S.O.E.",39
49,"49224",161,114,112,2,2,"P.S.O.E.",22
16,"16106",2839,2351,2331,10,20,"P.S.O.E.",851
23,"23030",1270,1052,1045,3,7,"P.S.O.E.",668
9,"9047",62,48,45,0,3,"P.S.O.E.",9
42,"42188",64,51,51,0,0,"P.S.O.E.",19
16,"16246",520,417,407,1,10,"P.S.O.E.",144
19,"19307",30,27,27,0,0,"P.S.O.E.",9
5,"5088",34,26,26,0,0,"P.S.O.E.",3
18,"18036",3553,2762,2741,20,21,"P.S.O.E.",685
50,"50171",126,90,89,4,1,"P.S.O.E.",17
6,"6108",2355,1773,1746,24,27,"P.S.O.E.",763
39,"39064",1339,1072,1066,7,6,"P.S.O.E.",177
22,"22011",102,78,78,3,0,"P.S.O.E.",19
47,"47026",59,46,46,1,0,"P.S.O.E.",5
29,"29044",866,631,627,3,4,"P.S.O.E.",245
34,"34081",53,42,41,0,1,"P.S.O.E.",8
42,"42190",102,71,71,3,0,"P.S.O.E.",24
31,"31056",183,123,122,4,1,"P.S.O.E.",8
9,"9178",61,48,48,0,0,"P.S.O.E.",7
37,"37080",242,187,185,1,2,"P.S.O.E.",50
31,"31240",553,360,359,3,1,"P.S.O.E.",29
22,"22156",256,209,203,5,6,"P.S.O.E.",74
31,"31148",99,69,66,2,3,"P.S.O.E.",16
10,"10204",489,364,351,3,13,"P.S.O.E.",101
50,"50025",4569,3319,3271,68,48,"P.S.O.E.",923
10,"10083",105,74,74,0,0,"P.S.O.E.",20
47,"47189",164,134,134,1,0,"P.S.O.E.",40
9,"9011",86,56,56,1,0,"P.S.O.E.",8
46,"46213",15621,11361,11164,214,197,"P.S.O.E.",3152
44,"44239",29,25,25,1,0,"P.S.O.E.",0
9,"9051",181,136,133,2,3,"P.S.O.E.",19
5,"5253",95,75,74,0,1,"P.S.O.E.",13
9,"9315",362,267,265,9,2,"P.S.O.E.",53
33,"33009",951,673,663,7,10,"P.S.O.E.",208
40,"40212",29,22,20,0,2,"P.S.O.E.",4
40,"40166",275,247,246,2,1,"P.S.O.E.",40
31,"31210",219,169,167,3,2,"P.S.O.E.",28
42,"42144",464,343,331,3,12,"P.S.O.E.",144
26,"26029",33,25,24,1,1,"P.S.O.E.",5
37,"37350",452,368,364,5,4,"P.S.O.E.",44
39,"39039",648,496,493,0,3,"P.S.O.E.",93
31,"31241",164,117,116,4,1,"P.S.O.E.",14
45,"45015",624,485,480,2,5,"P.S.O.E.",145
37,"37313",581,440,435,7,5,"P.S.O.E.",121
40,"40122",551,417,414,9,3,"P.S.O.E.",109
47,"47082",816,664,661,10,3,"P.S.O.E.",167
49,"49044",80,63,63,3,0,"P.S.O.E.",22
46,"46166",8260,6422,6324,60,98,"P.S.O.E.",1498
50,"50202",182,125,122,2,3,"P.S.O.E.",55
10,"10085",334,244,243,1,1,"P.S.O.E.",85
40,"40214",243,204,199,0,5,"P.S.O.E.",45
49,"49046",283,240,235,2,5,"P.S.O.E.",67
30,"30018",7493,6003,5922,52,81,"P.S.O.E.",1628
22,"22160",219,166,166,5,0,"P.S.O.E.",54
9,"9447",36,33,33,0,0,"P.S.O.E.",15
18,"18909",668,536,534,2,2,"P.S.O.E.",236
37,"37127",229,183,182,3,1,"P.S.O.E.",65
37,"37041",80,53,53,1,0,"P.S.O.E.",4
6,"6114",152,122,122,0,0,"P.S.O.E.",81
46,"46143",4278,3309,3266,46,43,"P.S.O.E.",732
10,"10167",322,265,264,1,1,"P.S.O.E.",128
46,"46191",1952,1554,1528,9,26,"P.S.O.E.",475
24,"24219",580,435,431,10,4,"P.S.O.E.",138
2,"2014",390,333,326,5,7,"P.S.O.E.",120
50,"50203",1083,814,798,28,16,"P.S.O.E.",267
24,"24058",224,166,163,1,3,"P.S.O.E.",47
38,"38040",4697,3007,2962,31,45,"P.S.O.E.",416
45,"45017",268,215,212,1,3,"P.S.O.E.",103
16,"16254",213,166,165,2,1,"P.S.O.E.",51
11,"11019",1871,1449,1425,9,24,"P.S.O.E.",485
49,"49007",387,289,289,4,0,"P.S.O.E.",123
40,"40216",753,621,611,15,10,"P.S.O.E.",136
44,"44037",483,349,344,10,5,"P.S.O.E.",96
18,"18012",2693,1841,1831,11,10,"P.S.O.E.",869
42,"42046",55,35,35,0,0,"P.S.O.E.",12
37,"37087",779,590,586,18,4,"P.S.O.E.",86
42,"42197",90,71,71,0,0,"P.S.O.E.",16
45,"45018",445,332,322,4,10,"P.S.O.E.",67
24,"24059",956,592,585,9,7,"P.S.O.E.",272
6,"6116",1680,1331,1317,15,14,"P.S.O.E.",579
47,"47192",99,84,84,0,0,"P.S.O.E.",15
40,"40126",96,80,78,0,2,"P.S.O.E.",10
22,"22018",357,272,271,4,1,"P.S.O.E.",123
37,"37088",208,173,172,4,1,"P.S.O.E.",54
47,"47005",578,467,455,5,12,"P.S.O.E.",117
9,"9368",26,18,18,0,0,"P.S.O.E.",0
34,"34225",4837,3650,3580,73,70,"P.S.O.E.",1337
46,"46241",440,336,314,4,22,"P.S.O.E.",88
44,"44084",63,51,50,0,1,"P.S.O.E.",28
34,"34089",173,128,125,5,3,"P.S.O.E.",22
10,"10090",552,404,396,3,8,"P.S.O.E.",174
22,"22019",190,141,138,4,3,"P.S.O.E.",56
44,"44125",78,57,57,1,0,"P.S.O.E.",9
22,"22112",9618,6642,6533,205,109,"P.S.O.E.",1909
3,"3003",460,382,370,1,12,"P.S.O.E.",75
9,"9451",244,208,202,1,6,"P.S.O.E.",87
50,"50031",167,105,103,0,2,"P.S.O.E.",46
22,"22167",515,417,399,16,18,"P.S.O.E.",148
47,"47113",166,136,135,1,1,"P.S.O.E.",59
46,"46243",149,120,117,0,3,"P.S.O.E.",37
18,"18112",132,90,90,1,0,"P.S.O.E.",31
49,"49054",929,690,687,12,3,"P.S.O.E.",218
49,"49186",273,205,204,1,1,"P.S.O.E.",34
18,"18913",827,653,646,2,7,"P.S.O.E.",198
12,"12041",115,98,98,2,0,"P.S.O.E.",15
37,"37090",59,54,50,0,4,"P.S.O.E.",6
37,"37205",235,199,195,5,4,"P.S.O.E.",73
46,"46024",448,365,358,1,7,"P.S.O.E.",111
19,"19321",46,29,29,0,0,"P.S.O.E.",16
42,"42051",23,12,11,0,1,"P.S.O.E.",0
50,"50236",124,103,103,2,0,"P.S.O.E.",36
6,"6074",4777,3730,3659,41,71,"P.S.O.E.",1491
40,"40034",85,73,73,1,0,"P.S.O.E.",18
31,"31155",264,187,183,7,4,"P.S.O.E.",68
42,"42098",14,8,8,0,0,"P.S.O.E.",2
31,"31033",55,34,34,0,0,"P.S.O.E.",2
9,"9060",171,142,142,0,0,"P.S.O.E.",35
24,"24182",448,339,333,9,6,"P.S.O.E.",105
50,"50089",6673,4936,4877,120,59,"P.S.O.E.",996
10,"10174",177,145,145,2,0,"P.S.O.E.",47
29,"29069",80337,50235,49723,690,512,"P.S.O.E.",15211
10,"10093",413,339,332,2,7,"P.S.O.E.",193
9,"9277",130,101,101,1,0,"P.S.O.E.",48
19,"19001",64,56,56,1,0,"P.S.O.E.",5
16,"16119",181,130,130,0,0,"P.S.O.E.",48
42,"42204",64,49,44,4,5,"P.S.O.E.",4
37,"37321",169,144,144,1,0,"P.S.O.E.",48
50,"50121",297,250,245,6,5,"P.S.O.E.",87
44,"44043",126,94,94,7,0,"P.S.O.E.",24
12,"12139",344,219,216,0,3,"P.S.O.E.",59
49,"49189",228,151,150,3,1,"P.S.O.E.",17
5,"5035",105,87,87,2,0,"P.S.O.E.",28
37,"37208",92,59,58,0,1,"P.S.O.E.",9
10,"10095",346,290,283,3,7,"P.S.O.E.",123
45,"45024",1105,870,856,16,14,"P.S.O.E.",207
31,"31249",1926,1376,1361,30,15,"P.S.O.E.",625
22,"22024",222,144,139,3,5,"P.S.O.E.",48
34,"34094",64,47,44,1,3,"P.S.O.E.",3
16,"16266",402,334,325,4,9,"P.S.O.E.",85
22,"22173",247,150,150,3,0,"P.S.O.E.",65
50,"50294",77,58,57,0,1,"P.S.O.E.",16
39,"39072",375,234,234,4,0,"P.S.O.E.",20
44,"44173",107,87,77,5,10,"P.S.O.E.",18
40,"40225",1152,931,918,10,13,"P.S.O.E.",240
9,"9458",422,325,316,5,9,"P.S.O.E.",72
46,"46027",997,869,855,4,14,"P.S.O.E.",255
18,"18116",2972,2237,2213,19,24,"P.S.O.E.",872
40,"40228",539,446,437,2,9,"P.S.O.E.",114
40,"40086",738,628,619,12,9,"P.S.O.E.",188
42,"42159",40,31,31,1,0,"P.S.O.E.",8
30,"30025",4780,3901,3874,18,27,"P.S.O.E.",1241
9,"9063",223,191,189,1,2,"P.S.O.E.",18
37,"37097",47,39,39,1,0,"P.S.O.E.",9
38,"38048",3884,2615,2587,34,28,"P.S.O.E.",654
18,"18018",658,520,514,4,6,"P.S.O.E.",248
45,"45173",9133,7147,7035,78,112,"P.S.O.E.",1723
46,"46003",988,864,847,13,17,"P.S.O.E.",270
50,"50092",329,273,272,0,1,"P.S.O.E.",138
9,"9024",159,124,123,2,1,"P.S.O.E.",27
2,"2060",1232,974,964,10,10,"P.S.O.E.",288
16,"16124",1909,1573,1555,14,18,"P.S.O.E.",520
19,"19118",17,13,13,0,0,"P.S.O.E.",7
5,"5070",41,33,33,0,0,"P.S.O.E.",14
45,"45027",433,352,349,1,3,"P.S.O.E.",127
47,"47037",194,160,159,1,1,"P.S.O.E.",37
47,"47198",71,56,56,2,0,"P.S.O.E.",10
19,"19005",92,80,79,0,1,"P.S.O.E.",23
9,"9332",137,88,85,1,3,"P.S.O.E.",10
46,"46174",1003,854,847,6,7,"P.S.O.E.",357
45,"45065",317,261,258,0,3,"P.S.O.E.",115
45,"45101",3761,3212,3181,19,31,"P.S.O.E.",746
44,"44093",86,64,64,3,0,"P.S.O.E.",19
42,"42209",155,114,110,2,4,"P.S.O.E.",35
42,"42015",34,24,24,5,0,"P.S.O.E.",0
40,"40230",117,92,90,1,2,"P.S.O.E.",33
5,"5072",91,72,72,1,0,"P.S.O.E.",9
26,"26086",18,17,17,0,0,"P.S.O.E.",1
41,"41073",1789,1292,1272,5,20,"P.S.O.E.",555
44,"44176",167,131,130,5,1,"P.S.O.E.",57
42,"42212",75,45,45,2,0,"P.S.O.E.",6
10,"10100",792,554,538,1,16,"P.S.O.E.",284
33,"33065",1150,791,784,16,7,"P.S.O.E.",174
42,"42059",23,19,19,1,0,"P.S.O.E.",7
40,"40091",140,111,109,1,2,"P.S.O.E.",21
30,"30027",45194,35272,34973,366,299,"P.S.O.E.",6834
23,"23052",1186,1012,997,1,15,"P.S.O.E.",561
18,"18120",274,238,237,2,1,"P.S.O.E.",152
45,"45030",486,378,374,4,4,"P.S.O.E.",143
31,"31070",2706,1949,1912,34,37,"P.S.O.E.",688
46,"46175",469,406,401,5,5,"P.S.O.E.",135
26,"26087",222,180,178,5,2,"P.S.O.E.",44
16,"16128",70,64,64,2,0,"P.S.O.E.",24
44,"44049",886,652,627,6,25,"P.S.O.E.",252
37,"37017",249,200,199,0,1,"P.S.O.E.",19
37,"37215",156,106,106,1,0,"P.S.O.E.",38
30,"30028",6810,5333,5251,44,82,"P.S.O.E.",1848
12,"12050",1418,1183,1156,8,27,"P.S.O.E.",518
16,"16004",325,247,246,0,1,"P.S.O.E.",78
24,"24070",4434,3199,3136,34,63,"P.S.O.E.",1484
22,"22126",100,81,80,2,1,"P.S.O.E.",13
6,"6131",1037,871,865,8,6,"P.S.O.E.",527
3,"3079",18028,14580,14317,189,263,"P.S.O.E.",3528
40,"40093",88,77,72,0,5,"P.S.O.E.",9
16,"16005",275,215,215,2,0,"P.S.O.E.",66
40,"40901",379,292,288,11,4,"P.S.O.E.",68
47,"47122",2078,1697,1665,21,32,"P.S.O.E.",496
22,"22182",271,160,150,4,10,"P.S.O.E.",42
39,"39077",256,196,196,1,0,"P.S.O.E.",45
44,"44179",369,245,243,6,2,"P.S.O.E.",76
44,"44051",2783,2144,2089,38,55,"P.S.O.E.",738
34,"34103",105,92,92,5,0,"P.S.O.E.",12
37,"37217",60,49,48,1,1,"P.S.O.E.",14
12,"12015",96,83,82,3,1,"P.S.O.E.",21
29,"29059",2551,1986,1964,11,22,"P.S.O.E.",852
3,"3014",234288,168004,166418,1795,1586,"P.S.O.E.",43296
24,"24193",371,254,252,3,2,"P.S.O.E.",101
50,"50215",21,20,19,0,1,"P.S.O.E.",2
16,"16276",32,23,22,1,1,"P.S.O.E.",7
5,"5173",62,55,55,1,0,"P.S.O.E.",2
47,"47204",275,221,219,3,2,"P.S.O.E.",92
42,"42217",38,32,32,0,0,"P.S.O.E.",16
37,"37104",32,24,23,0,1,"P.S.O.E.",3
37,"37332",78,52,49,0,3,"P.S.O.E.",6
9,"9339",139,105,104,1,1,"P.S.O.E.",35
19,"19123",40,34,34,0,0,"P.S.O.E.",10
49,"49068",523,356,353,5,3,"P.S.O.E.",92
37,"37333",247,160,154,2,6,"P.S.O.E.",40
31,"31165",2868,2094,2046,43,48,"P.S.O.E.",749
50,"50130",415,288,288,7,0,"P.S.O.E.",93
44,"44053",111,77,76,2,1,"P.S.O.E.",16
18,"18123",307,239,238,1,1,"P.S.O.E.",138
37,"37061",254,187,185,0,2,"P.S.O.E.",60
41,"41077",8817,6520,6375,53,145,"P.S.O.E.",3010
10,"10106",144,123,123,4,0,"P.S.O.E.",50
34,"34242",97,81,79,6,2,"P.S.O.E.",12
19,"19228",39,30,29,0,1,"P.S.O.E.",16
37,"37107",11407,8234,8116,123,118,"P.S.O.E.",2104
18,"18024",882,696,688,12,8,"P.S.O.E.",281
47,"47042",63,50,49,3,1,"P.S.O.E.",17
44,"44054",125,97,97,2,0,"P.S.O.E.",23
23,"23058",8497,6642,6591,44,51,"P.S.O.E.",2835
26,"26094",97,86,85,0,1,"P.S.O.E.",21
33,"33068",1224,704,703,5,1,"P.S.O.E.",303
5,"5239",215,171,170,2,1,"P.S.O.E.",39
34,"34027",1224,875,861,14,14,"P.S.O.E.",342
19,"19125",54,42,42,2,0,"P.S.O.E.",11
31,"31259",503,341,336,6,5,"P.S.O.E.",44
16,"16134",4283,3398,3361,59,37,"P.S.O.E.",940
37,"37335",432,347,346,0,1,"P.S.O.E.",81
6,"6001",730,546,538,4,8,"P.S.O.E.",167
26,"26096",244,204,201,2,3,"P.S.O.E.",72
12,"12055",112,79,78,3,1,"P.S.O.E.",19
40,"40101",770,584,577,16,7,"P.S.O.E.",165
30,"30032",2839,2361,2337,21,24,"P.S.O.E.",699
16,"16280",205,177,175,1,2,"P.S.O.E.",65
31,"31107",1706,1321,1311,17,10,"P.S.O.E.",270
23,"23016",442,355,354,5,1,"P.S.O.E.",201
45,"45185",7912,6321,6180,68,141,"P.S.O.E.",2121
50,"50162",160,108,108,2,0,"P.S.O.E.",41
24,"24117",493,376,369,2,7,"P.S.O.E.",60
18,"18057",5045,3755,3721,44,34,"P.S.O.E.",1176
19,"19231",16,14,14,0,0,"P.S.O.E.",1
39,"39004",1593,1321,1305,9,16,"P.S.O.E.",365
37,"37337",140,122,121,0,1,"P.S.O.E.",2
34,"34109",62,47,46,0,1,"P.S.O.E.",4
40,"40150",76,62,62,1,0,"P.S.O.E.",18
50,"50248",552,421,407,5,14,"P.S.O.E.",155
9,"9431",124,102,100,2,2,"P.S.O.E.",16
22,"22242",75,53,52,0,1,"P.S.O.E.",9
40,"40196",44,34,34,3,0,"P.S.O.E.",7
44,"44059",571,446,434,10,12,"P.S.O.E.",110
50,"50044",259,175,175,0,0,"P.S.O.E.",72
23,"23062",1476,1274,1264,2,10,"P.S.O.E.",695
31,"31078",2502,1880,1852,33,28,"P.S.O.E.",757
12,"12057",650,530,515,6,15,"P.S.O.E.",195
34,"34901",1233,955,946,14,9,"P.S.O.E.",208
37,"37262",81,66,64,2,2,"P.S.O.E.",2
9,"9432",212,161,158,1,3,"P.S.O.E.",71
5,"5210",105,83,82,2,1,"P.S.O.E.",8
49,"49078",209,173,172,1,1,"P.S.O.E.",51
24,"24162",1631,1214,1195,33,19,"P.S.O.E.",410
10,"10152",499,424,418,4,6,"P.S.O.E.",193
22,"22044",278,195,191,7,4,"P.S.O.E.",79
22,"22045",104,83,80,2,3,"P.S.O.E.",26
42,"42075",91,71,70,1,1,"P.S.O.E.",25
30,"30034",1182,956,943,3,13,"P.S.O.E.",323
37,"37113",439,365,365,7,0,"P.S.O.E.",143
33,"33003",737,475,471,6,4,"P.S.O.E.",154
44,"44189",69,57,57,0,0,"P.S.O.E.",19
24,"24120",379,258,256,3,2,"P.S.O.E.",45
18,"18162",947,726,721,8,5,"P.S.O.E.",325
7,"7018",389,275,271,0,4,"P.S.O.E.",70
40,"40013",67,56,54,1,2,"P.S.O.E.",2
50,"50135",100,76,75,2,1,"P.S.O.E.",28
16,"16014",659,534,528,8,6,"P.S.O.E.",230
24,"24164",397,215,213,2,2,"P.S.O.E.",59
49,"49080",736,571,560,5,11,"P.S.O.E.",235
11,"11009",636,430,424,2,6,"P.S.O.E.",146
50,"50222",1695,1117,1091,16,26,"P.S.O.E.",387
46,"46110",21420,15810,15671,134,139,"P.S.O.E.",4544
3,"3123",7435,5860,5744,63,116,"P.S.O.E.",1790
6,"6008",636,561,552,6,9,"P.S.O.E.",293
49,"49216",175,144,142,3,2,"P.S.O.E.",65
39,"39006",1732,1381,1373,23,8,"P.S.O.E.",220
5,"5117",213,183,180,0,3,"P.S.O.E.",31
49,"49168",96,78,78,1,0,"P.S.O.E.",14
3,"3090",16226,12224,12116,139,108,"P.S.O.E.",3136
42,"42181",453,357,347,7,10,"P.S.O.E.",172
2,"2075",1689,1386,1372,10,14,"P.S.O.E.",476
24,"24165",400,284,279,4,5,"P.S.O.E.",81
23,"23066",4348,3687,3654,21,33,"P.S.O.E.",1487
37,"37030",90,71,70,4,1,"P.S.O.E.",19
37,"37342",252,216,211,3,5,"P.S.O.E.",43
22,"22200",271,198,191,3,7,"P.S.O.E.",65
50,"50223",956,751,745,14,6,"P.S.O.E.",390
47,"47048",204,168,167,2,1,"P.S.O.E.",27
31,"31081",335,249,243,8,6,"P.S.O.E.",15
5,"5084",81,70,69,0,1,"P.S.O.E.",15
10,"10116",3762,2781,2705,36,76,"P.S.O.E.",1096
50,"50048",43,33,33,1,0,"P.S.O.E.",19
9,"9902",491,363,357,4,6,"P.S.O.E.",76
16,"16057",109,82,82,1,0,"P.S.O.E.",40
12,"12125",235,203,201,1,2,"P.S.O.E.",67
2,"2004",654,554,544,7,10,"P.S.O.E.",210
23,"23069",5489,4656,4586,36,70,"P.S.O.E.",2096
22,"22049",88,70,69,5,1,"P.S.O.E.",14
5,"5215",186,138,136,1,2,"P.S.O.E.",29
50,"50168",34,26,26,1,0,"P.S.O.E.",8
9,"9439",909,720,697,16,23,"P.S.O.E.",152
38,"38031",28391,21797,21431,234,366,"P.S.O.E.",4844
14,"14009",2864,2021,2003,8,18,"P.S.O.E.",896
3,"3127",399,336,322,3,14,"P.S.O.E.",114
49,"49085",1173,912,908,16,4,"P.S.O.E.",259
10,"10077",719,551,543,3,8,"P.S.O.E.",229
24,"24167",813,509,509,8,0,"P.S.O.E.",135
33,"33006",1674,1130,1120,10,10,"P.S.O.E.",384
2,"2006",612,540,534,1,6,"P.S.O.E.",207
49,"49221",266,148,147,6,1,"P.S.O.E.",40
45,"45046",2455,1884,1862,11,22,"P.S.O.E.",717
9,"9083",27,21,21,0,0,"P.S.O.E.",2
31,"31901",15574,11165,10974,201,191,"P.S.O.E.",2392
14,"14010",4087,3144,3121,15,23,"P.S.O.E.",1751
24,"24008",9789,7277,7179,110,98,"P.S.O.E.",1845
45,"45156",3528,2985,2924,19,61,"P.S.O.E.",973
35,"35002",21673,14480,14253,172,227,"P.S.O.E.",3397
44,"44067",132,89,89,0,0,"P.S.O.E.",27
41,"41007",12177,8150,8016,126,134,"P.S.O.E.",3638
26,"26151",455,384,382,1,2,"P.S.O.E.",153
16,"16910",104,69,69,1,0,"P.S.O.E.",26
26,"26024",273,220,219,2,1,"P.S.O.E.",92
9,"9403",98,75,75,0,0,"P.S.O.E.",15
47,"47051",351,269,256,5,13,"P.S.O.E.",63
16,"16148",634,553,547,5,6,"P.S.O.E.",155
40,"40113",438,330,322,4,8,"P.S.O.E.",124
50,"50901",170,122,121,1,1,"P.S.O.E.",33
33,"33075",305,191,190,0,1,"P.S.O.E.",76
26,"26025",78,69,69,1,0,"P.S.O.E.",29
39,"39036",1023,802,790,5,12,"P.S.O.E.",172
41,"41008",1073,884,875,0,9,"P.S.O.E.",639
22,"22251",391,288,278,4,10,"P.S.O.E.",67
37,"37120",107,88,87,0,1,"P.S.O.E.",21
14,"14012",6305,4749,4690,44,59,"P.S.O.E.",2425
44,"44197",60,37,37,1,0,"P.S.O.E.",7
19,"19175",39,31,31,0,0,"P.S.O.E.",2
3,"3028",1049,903,895,6,8,"P.S.O.E.",261
37,"37235",226,194,192,0,2,"P.S.O.E.",57
9,"9406",242,193,193,2,0,"P.S.O.E.",59
22,"22099",532,411,408,6,3,"P.S.O.E.",168
14,"14073",3009,2246,2224,32,22,"P.S.O.E.",1204
12,"12129",1936,1372,1326,29,46,"P.S.O.E.",539
9,"9907",1385,1053,1041,31,12,"P.S.O.E.",262
19,"19027",185,140,138,1,2,"P.S.O.E.",44
18,"18138",2460,1751,1741,1,10,"P.S.O.E.",819
35,"35005",1170,864,853,7,11,"P.S.O.E.",215
47,"47052",6207,4812,4761,79,51,"P.S.O.E.",1394
49,"49226",279,235,233,1,2,"P.S.O.E.",78
19,"19139",32,23,23,0,0,"P.S.O.E.",7
46,"46043",149,139,139,0,0,"P.S.O.E.",31
19,"19242",112,93,92,1,1,"P.S.O.E.",10
6,"6018",808,608,598,5,10,"P.S.O.E.",308
2,"2010",1877,1557,1519,15,38,"P.S.O.E.",576
45,"45159",100,84,84,1,0,"P.S.O.E.",29
14,"14014",2610,2160,2125,19,35,"P.S.O.E.",1170
47,"47216",124,99,98,2,1,"P.S.O.E.",5
22,"22207",135,86,79,4,7,"P.S.O.E.",19
34,"34082",96,79,75,0,4,"P.S.O.E.",26
14,"14045",3093,2662,2642,14,20,"P.S.O.E.",1462
37,"37082",869,663,650,3,13,"P.S.O.E.",222
37,"37312",278,232,229,1,3,"P.S.O.E.",66
19,"19277",22,17,17,0,0,"P.S.O.E.",8
3,"3132",571,464,461,8,3,"P.S.O.E.",141
39,"39091",2026,1636,1628,14,8,"P.S.O.E.",338
41,"41037",3228,2510,2483,27,27,"P.S.O.E.",1299
47,"47137",27,22,22,2,0,"P.S.O.E.",2
46,"46238",13401,10371,10283,96,88,"P.S.O.E.",2104
39,"39013",561,413,412,2,1,"P.S.O.E.",72
33,"33078",159,108,106,1,2,"P.S.O.E.",22
19,"19212",795,644,632,2,12,"P.S.O.E.",162
34,"34045",84,75,74,1,1,"P.S.O.E.",19
19,"19143",1610,1287,1268,9,19,"P.S.O.E.",362
16,"16026",104,79,79,1,0,"P.S.O.E.",18
5,"5025",108,86,86,2,0,"P.S.O.E.",8
37,"37351",305,261,258,2,3,"P.S.O.E.",73
9,"9269",39,33,33,0,0,"P.S.O.E.",5
5,"5254",212,186,185,2,1,"P.S.O.E.",57
34,"34127",118,77,74,1,3,"P.S.O.E.",16
45,"45089",1615,1238,1221,16,17,"P.S.O.E.",531
37,"37239",235,208,201,2,7,"P.S.O.E.",42
30,"30043",24501,19738,19416,230,322,"P.S.O.E.",4283
46,"46117",476,377,373,6,4,"P.S.O.E.",104
50,"50144",36,32,32,0,0,"P.S.O.E.",11
33,"33010",1922,1284,1277,14,7,"P.S.O.E.",454
45,"45053",8208,6763,6663,103,100,"P.S.O.E.",2479
9,"9363",1047,798,792,9,6,"P.S.O.E.",81
23,"23080",1832,1425,1414,3,11,"P.S.O.E.",789
39,"39040",4350,3413,3373,30,40,"P.S.O.E.",758
16,"16029",114,80,80,0,0,"P.S.O.E.",26
24,"24218",476,344,340,11,4,"P.S.O.E.",107
16,"16154",4946,3975,3914,58,61,"P.S.O.E.",1294
9,"9227",131,100,100,1,0,"P.S.O.E.",34
5,"5222",155,132,132,1,0,"P.S.O.E.",22
29,"29019",908,720,714,0,6,"P.S.O.E.",189
10,"10005",551,439,424,4,15,"P.S.O.E.",163
10,"10127",4663,3554,3498,38,56,"P.S.O.E.",1164
49,"49096",188,149,146,2,3,"P.S.O.E.",56
6,"6022",2719,2274,2245,14,29,"P.S.O.E.",1060
37,"37353",142,119,119,2,0,"P.S.O.E.",49
24,"24097",244,161,156,4,5,"P.S.O.E.",45
12,"12003",1058,830,813,15,17,"P.S.O.E.",165
44,"44036",27,17,17,0,0,"P.S.O.E.",0
40,"40030",520,432,425,9,7,"P.S.O.E.",161
45,"45055",1052,886,870,10,16,"P.S.O.E.",316
42,"42151",38,32,29,0,3,"P.S.O.E.",10
22,"22214",131,101,100,2,1,"P.S.O.E.",19
24,"24221",850,635,619,6,16,"P.S.O.E.",187
45,"45056",2246,1523,1502,16,21,"P.S.O.E.",497
47,"47084",1230,981,968,19,13,"P.S.O.E.",357
45,"45203",2535,1883,1829,21,54,"P.S.O.E.",563
41,"41014",2484,1956,1936,13,20,"P.S.O.E.",972
14,"14018",3795,3004,2970,24,34,"P.S.O.E.",902
5,"5128",361,288,280,3,8,"P.S.O.E.",103
16,"16203",9839,7520,7342,101,178,"P.S.O.E.",2282
18,"18177",463,285,281,4,4,"P.S.O.E.",110
3,"3102",7346,5827,5751,39,76,"P.S.O.E.",1678
24,"24141",101,83,80,6,3,"P.S.O.E.",31
42,"42095",1575,1136,1106,40,30,"P.S.O.E.",388
39,"39095",2292,1824,1801,24,23,"P.S.O.E.",627
44,"44124",88,63,61,3,2,"P.S.O.E.",25
37,"37243",123,89,88,1,1,"P.S.O.E.",10
44,"44246",1591,1030,997,15,33,"P.S.O.E.",296
47,"47006",196,151,146,1,5,"P.S.O.E.",46
12,"12105",866,679,673,6,6,"P.S.O.E.",140
10,"10091",391,327,324,3,3,"P.S.O.E.",111
9,"9230",41,33,33,0,0,"P.S.O.E.",0
34,"34006",82,72,72,1,0,"P.S.O.E.",9
46,"46145",21751,16601,16397,155,204,"P.S.O.E.",4409
45,"45058",409,334,332,2,2,"P.S.O.E.",108
40,"40128",144,116,116,5,0,"P.S.O.E.",31
47,"47007",3453,2616,2580,42,36,"P.S.O.E.",728
31,"31184",66,60,59,0,1,"P.S.O.E.",2
19,"19248",64,53,53,0,0,"P.S.O.E.",9
46,"46218",1082,964,936,5,28,"P.S.O.E.",172
50,"50178",325,228,225,4,3,"P.S.O.E.",105
26,"26166",152,139,136,1,3,"P.S.O.E.",15
5,"5194",147,131,130,4,1,"P.S.O.E.",26
12,"12075",139,106,102,0,4,"P.S.O.E.",33
19,"19038",48,33,33,0,0,"P.S.O.E.",7
50,"50150",716,430,427,10,3,"P.S.O.E.",109
23,"23087",11474,9197,9123,90,74,"P.S.O.E.",2534
31,"31034",43,29,29,0,0,"P.S.O.E.",1
29,"29051",37991,24498,24095,381,403,"P.S.O.E.",6839
42,"42201",27,24,24,2,0,"P.S.O.E.",10
30,"30022",16489,12207,12042,152,165,"P.S.O.E.",2978
5,"5065",498,424,422,7,2,"P.S.O.E.",80
5,"5130",95,76,76,0,0,"P.S.O.E.",39
40,"40081",151,109,107,2,2,"P.S.O.E.",22
19,"19218",60,35,35,0,0,"P.S.O.E.",9
5,"5164",34,24,24,0,0,"P.S.O.E.",15
23,"23044",4897,3943,3893,13,50,"P.S.O.E.",1427
18,"18179",583,417,409,7,8,"P.S.O.E.",172
50,"50237",103,76,75,0,1,"P.S.O.E.",19
5,"5165",386,292,280,7,12,"P.S.O.E.",61
31,"31187",122,68,68,2,0,"P.S.O.E.",4
14,"14022",4077,3147,3102,20,45,"P.S.O.E.",1637
22,"22221",108,70,69,5,1,"P.S.O.E.",22
31,"31217",382,256,244,5,12,"P.S.O.E.",53
9,"9374",96,85,81,3,4,"P.S.O.E.",12
37,"37359",194,155,152,1,3,"P.S.O.E.",27
22,"22067",82,54,49,3,5,"P.S.O.E.",27
47,"47224",92,77,77,0,0,"P.S.O.E.",28
49,"49239",723,506,495,12,11,"P.S.O.E.",214
10,"10012",615,525,520,4,5,"P.S.O.E.",279
2,"2021",1114,872,860,7,12,"P.S.O.E.",276
37,"37247",216,176,173,1,3,"P.S.O.E.",31
42,"42103",626,487,481,3,6,"P.S.O.E.",135
3,"3902",9578,7085,7007,65,78,"P.S.O.E.",1253
7,"7003",10671,6262,6149,79,113,"P.S.O.E.",1818
34,"34055",288,215,212,4,3,"P.S.O.E.",63
40,"40037",47,35,35,0,0,"P.S.O.E.",12
12,"12078",365,273,267,5,6,"P.S.O.E.",92
46,"46197",1902,1559,1554,15,5,"P.S.O.E.",313
49,"49104",383,281,276,2,5,"P.S.O.E.",52
45,"45062",1161,959,928,8,31,"P.S.O.E.",180
35,"35014",9943,5438,5316,95,122,"P.S.O.E.",1103
34,"34012",368,277,275,9,2,"P.S.O.E.",73
3,"3040",260,224,220,0,4,"P.S.O.E.",42
37,"37013",133,93,85,5,8,"P.S.O.E.",15
31,"31097",10461,7152,7029,129,123,"P.S.O.E.",1265
12,"12044",527,472,463,4,9,"P.S.O.E.",242
9,"9149",37,25,25,0,0,"P.S.O.E.",4
37,"37014",1198,862,852,8,10,"P.S.O.E.",278
18,"18150",6452,4666,4625,56,41,"P.S.O.E.",1784
47,"47226",180,152,148,1,4,"P.S.O.E.",65
50,"50239",65,44,44,0,0,"P.S.O.E.",7
42,"42160",288,222,221,2,1,"P.S.O.E.",70
34,"34098",756,544,540,10,4,"P.S.O.E.",157
23,"23004",478,416,415,1,1,"P.S.O.E.",146
18,"18182",1982,1405,1397,6,8,"P.S.O.E.",692
50,"50211",277,193,193,1,0,"P.S.O.E.",57
31,"31007",137,96,90,2,6,"P.S.O.E.",14
49,"49242",503,421,410,5,11,"P.S.O.E.",107
42,"42107",86,60,59,2,1,"P.S.O.E.",10
11,"11026",4834,3736,3691,27,45,"P.S.O.E.",1366
37,"37250",405,277,274,1,3,"P.S.O.E.",89
49,"49243",117,85,85,0,0,"P.S.O.E.",21
42,"42108",13,10,10,1,0,"P.S.O.E.",1
31,"31099",68,50,50,0,0,"P.S.O.E.",9
19,"19156",1032,782,762,4,20,"P.S.O.E.",219
41,"41046",3055,2456,2418,23,38,"P.S.O.E.",1185
45,"45138",1185,998,973,5,25,"P.S.O.E.",341
24,"24150",262,182,182,3,0,"P.S.O.E.",43
14,"14057",6115,5040,4975,71,65,"P.S.O.E.",1801
10,"10099",633,458,450,4,8,"P.S.O.E.",197
22,"22124",229,171,170,2,1,"P.S.O.E.",60
42,"42016",25,13,13,0,0,"P.S.O.E.",2
9,"9380",85,71,71,1,0,"P.S.O.E.",14
31,"31191",2930,2194,2148,43,46,"P.S.O.E.",710
46,"46053",584,484,461,2,23,"P.S.O.E.",194
46,"46253",118,105,102,7,3,"P.S.O.E.",38
18,"18151",276,191,188,0,3,"P.S.O.E.",111
19,"19045",180,145,145,1,0,"P.S.O.E.",28
47,"47148",475,389,384,2,5,"P.S.O.E.",104
49,"49110",382,236,233,1,3,"P.S.O.E.",86
2,"2026",845,723,716,5,7,"P.S.O.E.",294
37,"37139",199,167,163,1,4,"P.S.O.E.",25
22,"22228",501,382,369,15,13,"P.S.O.E.",90
31,"31192",148,107,104,1,3,"P.S.O.E.",10
12,"12082",9741,7555,7408,84,147,"P.S.O.E.",2006
39,"39102",2330,1748,1731,13,17,"P.S.O.E.",381
5,"5201",557,444,437,2,7,"P.S.O.E.",113
41,"41022",4281,3087,3066,15,21,"P.S.O.E.",1620
29,"29075",12666,8284,8218,62,66,"P.S.O.E.",2513
50,"50095",12558,9029,8910,179,119,"P.S.O.E.",4008
46,"46079",381,304,299,3,5,"P.S.O.E.",67
47,"47065",898,762,752,9,10,"P.S.O.E.",268
19,"19257",3595,2593,2543,48,50,"P.S.O.E.",636
11,"11029",5360,3445,3423,27,22,"P.S.O.E.",1441
29,"29002",1246,896,893,11,3,"P.S.O.E.",389
10,"10020",1671,1386,1374,14,12,"P.S.O.E.",683
37,"37366",46,35,34,0,1,"P.S.O.E.",8
16,"16129",112,79,74,0,5,"P.S.O.E.",15
49,"49021",14682,10495,10296,194,199,"P.S.O.E.",3295
9,"9067",460,335,328,5,7,"P.S.O.E.",69
9,"9424",42,35,34,1,1,"P.S.O.E.",3
47,"47093",865,658,642,11,16,"P.S.O.E.",211
12,"12084",17219,12059,11911,165,148,"P.S.O.E.",3446
9,"9384",310,223,218,3,5,"P.S.O.E.",41
24,"24112",323,230,228,0,2,"P.S.O.E.",140
26,"26008",1909,1544,1527,19,17,"P.S.O.E.",623
9,"9246",662,469,457,3,12,"P.S.O.E.",106
5,"5204",654,521,516,7,5,"P.S.O.E.",130
33,"33066",42885,29326,29013,460,313,"P.S.O.E.",8175
46,"46128",1649,1322,1292,14,30,"P.S.O.E.",371
49,"49114",51,34,33,1,1,"P.S.O.E.",8
5,"5005",199,170,169,1,1,"P.S.O.E.",32
34,"34149",26,18,18,0,0,"P.S.O.E.",1
46,"46255",3135,2530,2508,11,22,"P.S.O.E.",569
40,"40143",97,72,72,0,0,"P.S.O.E.",10
35,"35019",30279,17607,17380,158,227,"P.S.O.E.",4513
5,"5205",78,59,58,0,1,"P.S.O.E.",9
37,"37368",18,15,15,1,0,"P.S.O.E.",0
44,"44141",147,99,95,0,4,"P.S.O.E.",33
16,"16046",262,191,191,1,0,"P.S.O.E.",68
47,"47230",318,266,259,2,7,"P.S.O.E.",94
37,"37257",52,43,43,0,0,"P.S.O.E.",8
16,"16047",249,192,191,5,1,"P.S.O.E.",51
44,"44221",377,305,297,6,8,"P.S.O.E.",101
34,"34151",184,125,123,1,2,"P.S.O.E.",16
29,"29004",343,281,281,0,0,"P.S.O.E.",127
50,"50070",70,42,41,0,1,"P.S.O.E.",24
47,"47231",4272,3268,3243,64,25,"P.S.O.E.",908
50,"50160",2397,1905,1865,19,40,"P.S.O.E.",1019
22,"22081",268,197,196,4,1,"P.S.O.E.",23
5,"5207",743,595,591,1,4,"P.S.O.E.",232
23,"23902",2495,2081,2067,4,14,"P.S.O.E.",1230
9,"9115",96,71,70,4,1,"P.S.O.E.",9
29,"29079",2500,2016,2000,23,16,"P.S.O.E.",1017
44,"44223",80,55,55,0,0,"P.S.O.E.",12
2,"2032",323,261,259,1,2,"P.S.O.E.",102
26,"26011",7455,5452,5353,93,99,"P.S.O.E.",1804
49,"49117",505,376,369,5,7,"P.S.O.E.",121
50,"50161",124,86,86,1,0,"P.S.O.E.",13
24,"24158",333,223,223,6,0,"P.S.O.E.",57
50,"50071",134,97,96,0,1,"P.S.O.E.",11
9,"9034",301,250,250,3,0,"P.S.O.E.",60
19,"19163",73,59,59,0,0,"P.S.O.E.",13
24,"24037",429,282,277,4,5,"P.S.O.E.",78
16,"16049",158,129,129,1,0,"P.S.O.E.",67
18,"18056",3695,2961,2940,25,21,"P.S.O.E.",1403
19,"19262",184,137,136,0,1,"P.S.O.E.",31
26,"26183",65,54,54,0,0,"P.S.O.E.",15
44,"44105",82,63,63,2,0,"P.S.O.E.",19
40,"40006",23,20,20,0,0,"P.S.O.E.",3
49,"49118",215,174,173,2,1,"P.S.O.E.",45
14,"14033",1289,974,958,18,16,"P.S.O.E.",469
5,"5010",173,141,134,2,7,"P.S.O.E.",27
16,"16176",61,45,43,0,2,"P.S.O.E.",30
19,"19165",51,43,42,0,1,"P.S.O.E.",19
9,"9250",295,234,230,5,4,"P.S.O.E.",85
50,"50072",181,128,127,1,1,"P.S.O.E.",30
9,"9120",46,35,34,1,1,"P.S.O.E.",8
2,"2034",1419,1153,1146,18,7,"P.S.O.E.",478
42,"42174",188,142,138,5,4,"P.S.O.E.",53
41,"41094",6089,4757,4680,47,77,"P.S.O.E.",2140
16,"16051",166,140,140,1,0,"P.S.O.E.",57
37,"37148",451,344,343,3,1,"P.S.O.E.",84
16,"16095",98,68,68,0,0,"P.S.O.E.",12
50,"50016",51,30,30,1,0,"P.S.O.E.",5
6,"6003",875,705,691,4,14,"P.S.O.E.",334
42,"42026",25,16,16,0,0,"P.S.O.E.",3
46,"46259",537,426,424,9,2,"P.S.O.E.",146
45,"45075",205,162,159,4,3,"P.S.O.E.",38
47,"47154",168,144,144,7,0,"P.S.O.E.",34
44,"44107",233,161,154,3,7,"P.S.O.E.",67
9,"9253",108,95,94,4,1,"P.S.O.E.",27
18,"18059",4055,3232,3191,37,41,"P.S.O.E.",1411
29,"29008",14069,9934,9859,118,75,"P.S.O.E.",2912
18,"18193",13680,9874,9764,130,110,"P.S.O.E.",2947
26,"26099",1281,1050,1025,19,25,"P.S.O.E.",378
19,"19901",43,34,34,0,0,"P.S.O.E.",9
37,"37338",82,69,67,0,2,"P.S.O.E.",8
19,"19017",87,70,70,0,0,"P.S.O.E.",21
19,"19096",99,79,78,1,1,"P.S.O.E.",30
47,"47155",3043,2246,2225,35,21,"P.S.O.E.",633
31,"31048",154,118,117,0,1,"P.S.O.E.",13
29,"29009",1525,1126,1109,9,17,"P.S.O.E.",581
45,"45003",607,515,511,3,4,"P.S.O.E.",138
45,"45187",4187,3581,3512,25,69,"P.S.O.E.",1373
31,"31140",117,91,89,3,2,"P.S.O.E.",7
22,"22243",45,27,27,1,0,"P.S.O.E.",14
50,"50104",379,306,303,4,3,"P.S.O.E.",117
37,"37068",386,291,287,6,4,"P.S.O.E.",67
26,"26057",52,42,42,0,0,"P.S.O.E.",11
22,"22001",242,177,173,2,4,"P.S.O.E.",25
9,"9124",1598,1151,1129,19,22,"P.S.O.E.",463
46,"46062",4589,3794,3752,46,42,"P.S.O.E.",967
44,"44190",81,52,52,0,0,"P.S.O.E.",13
40,"40154",23,21,21,1,0,"P.S.O.E.",8
5,"5212",274,202,197,0,5,"P.S.O.E.",50
2,"2038",296,254,254,1,0,"P.S.O.E.",71
50,"50075",89,74,74,1,0,"P.S.O.E.",14
34,"34033",17,15,15,0,0,"P.S.O.E.",0
42,"42128",43,38,38,2,0,"P.S.O.E.",8
47,"47156",182,155,148,0,7,"P.S.O.E.",43
46,"46208",1141,990,978,6,12,"P.S.O.E.",309
46,"46135",9634,7671,7586,64,85,"P.S.O.E.",1811
22,"22245",329,261,257,3,4,"P.S.O.E.",64
2,"2076",371,292,287,3,5,"P.S.O.E.",99
2,"2002",479,411,407,3,4,"P.S.O.E.",164
42,"42129",706,523,509,14,14,"P.S.O.E.",153
45,"45005",267,223,218,4,5,"P.S.O.E.",71
18,"18001",288,212,212,1,0,"P.S.O.E.",107
50,"50019",79,57,55,1,2,"P.S.O.E.",23
22,"22089",329,246,237,8,9,"P.S.O.E.",67
24,"24207",320,274,272,5,2,"P.S.O.E.",91
31,"31112",106,79,78,0,1,"P.S.O.E.",11
26,"26147",34,29,29,2,0,"P.S.O.E.",10
31,"31020",488,247,246,0,1,"P.S.O.E.",7
10,"10033",440,340,336,4,4,"P.S.O.E.",137
44,"44231",54,38,36,2,2,"P.S.O.E.",5
26,"26020",506,372,364,10,8,"P.S.O.E.",99
42,"42183",131,95,94,7,1,"P.S.O.E.",9
46,"46136",2476,1890,1865,16,25,"P.S.O.E.",645
38,"38030",1875,1320,1301,11,19,"P.S.O.E.",415
19,"19303",56,48,47,1,1,"P.S.O.E.",6
45,"45006",1524,1128,1110,13,18,"P.S.O.E.",423
45,"45192",2549,2178,2155,39,23,"P.S.O.E.",812
5,"5182",862,673,668,2,5,"P.S.O.E.",137
6,"6011",24301,17977,17819,268,158,"P.S.O.E.",5071
46,"46039",2200,1849,1820,12,29,"P.S.O.E.",541
5,"5085",35,34,34,0,0,"P.S.O.E.",0
19,"19134",22,14,14,0,0,"P.S.O.E.",4
34,"34120",65774,49378,48608,830,770,"P.S.O.E.",16256
39,"39034",289,209,209,3,0,"P.S.O.E.",42
9,"9398",92,68,68,2,0,"P.S.O.E.",26
16,"16190",5151,4229,4144,52,85,"P.S.O.E.",1278
50,"50297",495260,360632,355561,7046,5071,"P.S.O.E.",104287
44,"44194",128,92,89,1,3,"P.S.O.E.",17
42,"42132",159,132,127,4,5,"P.S.O.E.",34
40,"40017",103,89,88,2,1,"P.S.O.E.",19
44,"44027",168,140,140,2,0,"P.S.O.E.",64
5,"5216",237,195,192,0,3,"P.S.O.E.",27
19,"19172",76,65,64,1,1,"P.S.O.E.",24
41,"41100",1097,894,878,8,16,"P.S.O.E.",498
10,"10036",345,262,251,2,11,"P.S.O.E.",128
42,"42035",847,600,592,4,8,"P.S.O.E.",172
9,"9261",486,342,338,7,4,"P.S.O.E.",127
11,"11041",9805,7136,7067,87,69,"P.S.O.E.",2590
47,"47160",466,368,364,5,4,"P.S.O.E.",102
24,"24009",362,188,184,0,4,"P.S.O.E.",34
18,"18101",8990,6659,6556,96,103,"P.S.O.E.",1882
40,"40206",179,136,134,0,2,"P.S.O.E.",25
42,"42036",52,40,39,2,1,"P.S.O.E.",20
44,"44154",271,196,195,7,1,"P.S.O.E.",36
38,"38033",3987,2696,2656,23,40,"P.S.O.E.",884
7,"7024",6070,3232,3170,60,62,"P.S.O.E.",1193
22,"22096",301,239,237,8,2,"P.S.O.E.",56
22,"22250",368,261,255,12,6,"P.S.O.E.",80
9,"9007",66,50,50,0,0,"P.S.O.E.",8
5,"5251",80,58,58,0,0,"P.S.O.E.",14
34,"34079",1391,1088,1077,17,11,"P.S.O.E.",346
10,"10038",98,84,83,0,1,"P.S.O.E.",21
50,"50023",240,180,180,4,0,"P.S.O.E.",52
14,"14042",18991,14726,14495,290,231,"P.S.O.E.",5140
47,"47078",178,159,154,7,5,"P.S.O.E.",44
37,"37271",393,324,318,5,6,"P.S.O.E.",82
37,"37078",888,728,714,9,14,"P.S.O.E.",208
50,"50256",90,59,59,1,0,"P.S.O.E.",9
37,"37035",220,176,173,1,3,"P.S.O.E.",48
46,"46236",996,853,844,7,9,"P.S.O.E.",318
47,"47105",210,181,179,1,2,"P.S.O.E.",58
45,"45158",2577,1948,1909,18,39,"P.S.O.E.",606
24,"24051",484,375,368,2,7,"P.S.O.E.",109
50,"50199",380,263,254,2,9,"P.S.O.E.",88
9,"9266",87,72,72,0,0,"P.S.O.E.",13
12,"12099",583,485,465,3,20,"P.S.O.E.",109
14,"14044",1585,1279,1265,12,14,"P.S.O.E.",743
49,"49268",480,365,362,8,3,"P.S.O.E.",55
47,"47079",67,56,56,1,0,"P.S.O.E.",1
46,"46139",4594,3794,3734,28,60,"P.S.O.E.",995
37,"37036",74,54,52,0,2,"P.S.O.E.",9
40,"40163",62,51,51,5,0,"P.S.O.E.",4
50,"50082",108,73,72,0,1,"P.S.O.E.",23
47,"47162",80,62,62,1,0,"P.S.O.E.",9
5,"5219",45,33,33,0,0,"P.S.O.E.",5
45,"45087",8428,6434,6292,74,142,"P.S.O.E.",1784
37,"37161",157,118,116,1,2,"P.S.O.E.",25
24,"24014",7677,5352,5289,75,63,"P.S.O.E.",1888
37,"37273",115,83,83,1,0,"P.S.O.E.",16
16,"16249",2076,1728,1700,11,28,"P.S.O.E.",669
14,"14015",2198,1776,1755,16,21,"P.S.O.E.",679
49,"49002",77,59,59,1,0,"P.S.O.E.",21
42,"42192",43,36,36,2,0,"P.S.O.E.",15
7,"7027",20045,12873,12678,204,195,"P.S.O.E.",3361
26,"26157",306,268,263,1,5,"P.S.O.E.",60
44,"44033",307,222,221,5,1,"P.S.O.E.",79
49,"49043",304,256,256,6,0,"P.S.O.E.",109
16,"16066",2402,2064,1997,32,67,"P.S.O.E.",523
6,"6065",327,262,259,2,3,"P.S.O.E.",72
5,"5220",386,316,312,0,4,"P.S.O.E.",67
30,"30042",1841,1531,1519,10,12,"P.S.O.E.",348
5,"5092",172,142,139,0,3,"P.S.O.E.",15
24,"24133",379,279,279,0,0,"P.S.O.E.",94
37,"37039",325,241,236,0,5,"P.S.O.E.",97
5,"5158",410,333,331,2,2,"P.S.O.E.",54
50,"50084",84,64,64,1,0,"P.S.O.E.",19
44,"44120",217,126,121,5,5,"P.S.O.E.",20
23,"23077",668,523,518,2,5,"P.S.O.E.",251
19,"19178",45,34,34,0,0,"P.S.O.E.",11
3,"3099",41561,32556,32248,288,308,"P.S.O.E.",7000
50,"50083",96,72,72,1,0,"P.S.O.E.",31
44,"44241",575,442,427,4,15,"P.S.O.E.",141
42,"42043",3905,2931,2875,48,56,"P.S.O.E.",596
16,"16251",1903,1510,1493,18,17,"P.S.O.E.",371
16,"16198",1451,1126,1105,21,21,"P.S.O.E.",494
40,"40168",36,27,27,0,0,"P.S.O.E.",6
2,"2050",121,95,95,1,0,"P.S.O.E.",40
6,"6067",2030,1583,1572,16,11,"P.S.O.E.",676
24,"24016",544,323,322,4,1,"P.S.O.E.",77
46,"46069",166,149,148,1,1,"P.S.O.E.",56
45,"45201",3439,2353,2317,31,36,"P.S.O.E.",565
19,"19179",109,77,75,3,2,"P.S.O.E.",27
49,"49137",179,149,147,2,2,"P.S.O.E.",40
6,"6023",4572,3301,3261,34,40,"P.S.O.E.",1583
37,"37201",263,196,196,5,0,"P.S.O.E.",45
47,"47083",80,61,59,3,2,"P.S.O.E.",5
18,"18108",892,674,673,2,1,"P.S.O.E.",338
26,"26031",120,100,100,0,0,"P.S.O.E.",40
7,"7030",1576,1150,1135,26,15,"P.S.O.E.",198
3,"3067",94,81,79,1,2,"P.S.O.E.",18
5,"5127",715,601,596,4,5,"P.S.O.E.",176
9,"9055",55,46,44,0,2,"P.S.O.E.",11
3,"3034",1343,1140,1126,5,14,"P.S.O.E.",329
22,"22213",3152,2265,2230,62,35,"P.S.O.E.",699
45,"45092",252,223,221,0,2,"P.S.O.E.",68
37,"37316",792,565,559,7,6,"P.S.O.E.",106
44,"44123",117,79,78,2,1,"P.S.O.E.",27
49,"49138",269,190,189,0,1,"P.S.O.E.",40
22,"22110",822,602,588,3,14,"P.S.O.E.",238
22,"22017",917,677,661,8,16,"P.S.O.E.",221
50,"50204",2519,1823,1804,24,19,"P.S.O.E.",977
19,"19182",38,24,22,0,2,"P.S.O.E.",7
9,"9138",92,77,74,0,3,"P.S.O.E.",17
31,"31153",2246,1504,1487,13,17,"P.S.O.E.",185
26,"26075",377,297,289,4,8,"P.S.O.E.",103
47,"47031",203,149,149,0,0,"P.S.O.E.",37
38,"38008",5430,3844,3772,46,72,"P.S.O.E.",1022
7,"7065",2061,1376,1345,29,31,"P.S.O.E.",257
22,"22215",137,90,90,1,0,"P.S.O.E.",46
24,"24222",13915,9939,9751,304,188,"P.S.O.E.",3234
5,"5259",132,115,114,1,1,"P.S.O.E.",21
38,"38009",3910,2687,2633,31,54,"P.S.O.E.",515
39,"39043",1321,1082,1072,8,10,"P.S.O.E.",117
24,"24179",331,219,214,4,5,"P.S.O.E.",76
47,"47032",161,130,129,3,1,"P.S.O.E.",16
16,"16158",550,427,423,2,4,"P.S.O.E.",130
29,"29096",2880,2012,1971,28,41,"P.S.O.E.",1018
10,"10171",376,287,282,0,5,"P.S.O.E.",143
37,"37318",225,167,165,0,2,"P.S.O.E.",39
50,"50263",235,160,160,1,0,"P.S.O.E.",77
26,"26165",350,297,294,1,3,"P.S.O.E.",103
42,"42049",141,83,81,1,2,"P.S.O.E.",14
6,"6073",787,563,552,9,11,"P.S.O.E.",187
37,"37281",36,34,33,0,1,"P.S.O.E.",18
31,"31063",96,77,75,0,2,"P.S.O.E.",10
18,"18014",5667,4132,4085,43,47,"P.S.O.E.",1328
3,"3004",624,497,486,7,11,"P.S.O.E.",123
12,"12106",1207,992,969,7,23,"P.S.O.E.",466
24,"24022",364,231,230,2,1,"P.S.O.E.",72
9,"9276",420,275,245,5,30,"P.S.O.E.",86
5,"5033",184,159,155,3,4,"P.S.O.E.",32
10,"10050",1208,1003,983,8,20,"P.S.O.E.",372
37,"37320",96,70,70,0,0,"P.S.O.E.",19
40,"40035",146,114,112,3,2,"P.S.O.E.",13
29,"29023",1661,1080,1074,15,6,"P.S.O.E.",243
45,"45095",742,606,585,2,21,"P.S.O.E.",189
16,"16074",53,42,42,1,0,"P.S.O.E.",18
40,"40192",179,151,150,1,1,"P.S.O.E.",44
34,"34092",331,272,267,6,5,"P.S.O.E.",73
19,"19114",40,34,34,0,0,"P.S.O.E.",13
3,"3005",7482,6191,6146,49,45,"P.S.O.E.",1363
37,"37091",181,127,119,0,8,"P.S.O.E.",31
18,"18114",678,508,508,6,0,"P.S.O.E.",294
24,"24145",656,420,420,11,0,"P.S.O.E.",194
37,"37010",963,705,690,5,15,"P.S.O.E.",228
5,"5229",90,79,77,2,2,"P.S.O.E.",6
37,"37283",130,104,104,1,0,"P.S.O.E.",36
50,"50265",63,46,46,1,0,"P.S.O.E.",11
3,"3901",1070,826,818,14,8,"P.S.O.E.",241
45,"45097",1094,934,925,9,9,"P.S.O.E.",323
49,"49146",330,268,265,6,3,"P.S.O.E.",108
33,"33038",2442,1757,1725,14,32,"P.S.O.E.",590
7,"7036",25502,17151,16914,294,237,"P.S.O.E.",4298
44,"44005",59,43,43,1,0,"P.S.O.E.",13
6,"6123",4699,3509,3448,54,61,"P.S.O.E.",1478
19,"19323",50,41,39,0,2,"P.S.O.E.",12
18,"18082",912,691,683,8,8,"P.S.O.E.",297
29,"29053",1715,1239,1221,7,18,"P.S.O.E.",356
46,"46099",987,764,754,2,10,"P.S.O.E.",269
26,"26040",67,63,62,2,1,"P.S.O.E.",11
19,"19220",2225,1482,1456,7,26,"P.S.O.E.",371
5,"5067",85,68,68,0,0,"P.S.O.E.",16
5,"5230",79,73,73,1,0,"P.S.O.E.",4
9,"9418",79,60,58,0,2,"P.S.O.E.",6
45,"45099",3449,2451,2405,22,46,"P.S.O.E.",669
3,"3073",219,199,199,0,0,"P.S.O.E.",76
12,"12110",253,199,195,3,4,"P.S.O.E.",86
9,"9148",95,75,75,2,0,"P.S.O.E.",21
10,"10054",551,435,428,6,7,"P.S.O.E.",188
26,"26041",152,106,104,0,2,"P.S.O.E.",24
44,"44256",37,35,35,9,0,"P.S.O.E.",8
42,"42012",43,29,29,1,0,"P.S.O.E.",9
10,"10177",1692,1351,1318,15,33,"P.S.O.E.",479
47,"47089",184,139,138,1,1,"P.S.O.E.",16
29,"29026",1130,815,799,7,16,"P.S.O.E.",356
6,"6080",1942,1519,1507,9,12,"P.S.O.E.",666
45,"45100",205,169,169,0,0,"P.S.O.E.",76
44,"44174",435,310,309,3,1,"P.S.O.E.",94
9,"9377",658,509,505,11,4,"P.S.O.E.",88
12,"12010",280,232,229,3,3,"P.S.O.E.",82
12,"12141",116,97,97,0,0,"P.S.O.E.",17
31,"31098",1762,1285,1262,34,23,"P.S.O.E.",170
40,"40041",1035,819,799,14,20,"P.S.O.E.",223
50,"50093",113,84,84,2,0,"P.S.O.E.",27
12,"12011",4663,3578,3525,28,53,"P.S.O.E.",1362
16,"16215",285,192,186,2,6,"P.S.O.E.",87
31,"31221",1182,774,767,12,7,"P.S.O.E.",92
50,"50008",5110,3458,3406,56,52,"P.S.O.E.",1277
50,"50268",59,46,46,3,0,"P.S.O.E.",9
31,"31129",405,285,281,1,4,"P.S.O.E.",16
19,"19288",22,21,21,0,0,"P.S.O.E.",2
30,"30026",15165,10524,10369,80,155,"P.S.O.E.",2551
23,"23094",3917,3200,3166,32,34,"P.S.O.E.",1703
42,"42057",197,133,133,6,0,"P.S.O.E.",19
10,"10016",321,266,262,2,4,"P.S.O.E.",125
12,"12058",99,74,74,0,0,"P.S.O.E.",7
46,"46004",1933,1563,1541,8,22,"P.S.O.E.",376
6,"6128",4466,3310,3264,50,46,"P.S.O.E.",1279
46,"46150",1898,1555,1541,8,14,"P.S.O.E.",375
19,"19082",91,68,67,1,1,"P.S.O.E.",27
37,"37288",252,194,194,3,0,"P.S.O.E.",47
41,"41047",9810,7427,7321,99,106,"P.S.O.E.",2383
44,"44260",160,117,115,5,2,"P.S.O.E.",28
9,"9152",273,207,207,1,0,"P.S.O.E.",67
10,"10058",994,751,738,13,13,"P.S.O.E.",334
46,"46224",179,131,128,0,3,"P.S.O.E.",35
7,"7041",2077,1583,1549,27,34,"P.S.O.E.",254
49,"49019",256,206,205,5,1,"P.S.O.E.",60
14,"14058",8116,6274,6215,76,59,"P.S.O.E.",2385
30,"30001",4763,3992,3956,26,36,"P.S.O.E.",1020
40,"40185",977,725,712,13,13,"P.S.O.E.",192
34,"34060",150,123,123,2,0,"P.S.O.E.",32
9,"9027",54,48,43,0,5,"P.S.O.E.",21
2,"2063",1537,1252,1242,11,10,"P.S.O.E.",527
34,"34189",59,47,47,3,0,"P.S.O.E.",9
9,"9155",27,17,17,0,0,"P.S.O.E.",3
40,"40140",100,74,73,1,1,"P.S.O.E.",20
18,"18050",1657,1209,1196,5,13,"P.S.O.E.",461
19,"19007",460,351,345,5,6,"P.S.O.E.",116
24,"24153",253,201,199,4,2,"P.S.O.E.",71
50,"50270",39,30,29,1,1,"P.S.O.E.",4
49,"49154",147,104,102,1,2,"P.S.O.E.",59
45,"45031",2773,2011,1975,25,36,"P.S.O.E.",583
19,"19087",22,16,16,0,0,"P.S.O.E.",0
50,"50156",234,186,183,2,3,"P.S.O.E.",75
50,"50011",131,113,113,8,0,"P.S.O.E.",60
50,"50039",580,450,446,3,4,"P.S.O.E.",178
19,"19008",34,25,25,1,0,"P.S.O.E.",1
39,"39051",73,62,62,2,0,"P.S.O.E.",7
37,"37059",132,110,110,2,0,"P.S.O.E.",43
46,"46080",1090,860,849,2,11,"P.S.O.E.",284
9,"9160",104,75,74,0,1,"P.S.O.E.",15
34,"34192",103,75,74,1,1,"P.S.O.E.",11
7,"7044",8326,6044,5846,99,198,"P.S.O.E.",1181
24,"24032",134,102,101,1,1,"P.S.O.E.",41
22,"22232",98,78,75,0,3,"P.S.O.E.",14
42,"42216",27,22,22,0,0,"P.S.O.E.",8
22,"22184",203,172,167,2,5,"P.S.O.E.",44
37,"37180",69,46,46,0,0,"P.S.O.E.",7
38,"38021",1792,1184,1160,6,24,"P.S.O.E.",387
37,"37292",101,84,84,2,0,"P.S.O.E.",14
40,"40048",40,30,30,0,0,"P.S.O.E.",11
26,"26179",49,39,36,0,3,"P.S.O.E.",17
41,"41050",5102,4224,4183,39,41,"P.S.O.E.",1810
44,"44052",96,60,59,2,1,"P.S.O.E.",15
24,"24156",264,187,186,6,1,"P.S.O.E.",52
18,"18187",587,432,432,0,0,"P.S.O.E.",254
31,"31043",42,30,30,1,0,"P.S.O.E.",8
50,"50012",105,93,90,0,3,"P.S.O.E.",42
50,"50013",244,195,195,1,0,"P.S.O.E.",86
31,"31227",8257,5987,5884,125,103,"P.S.O.E.",1652
41,"41051",2103,1705,1686,7,19,"P.S.O.E.",952
37,"37294",11233,8282,8167,139,115,"P.S.O.E.",2073
44,"44016",541,384,379,5,5,"P.S.O.E.",132
37,"37293",131,108,106,5,2,"P.S.O.E.",25
26,"26180",243,185,181,4,4,"P.S.O.E.",32
49,"49158",229,174,172,0,2,"P.S.O.E.",76
47,"47104",2917,2391,2357,31,34,"P.S.O.E.",589
12,"12017",183,143,141,6,2,"P.S.O.E.",44
42,"42022",253,177,171,2,6,"P.S.O.E.",22
16,"16092",158,132,132,0,0,"P.S.O.E.",26
42,"42218",86,59,59,0,0,"P.S.O.E.",12
46,"46106",1616,1196,1188,6,8,"P.S.O.E.",341
50,"50189",776,588,576,9,12,"P.S.O.E.",191
30,"30005",29081,22312,22142,184,170,"P.S.O.E.",3989
31,"31075",96,61,61,0,0,"P.S.O.E.",4
19,"19196",99,80,74,2,6,"P.S.O.E.",20
37,"37108",108,95,95,1,0,"P.S.O.E.",28
5,"5044",301,217,217,3,0,"P.S.O.E.",48
22,"22040",155,129,127,3,2,"P.S.O.E.",41
6,"6092",592,468,456,5,12,"P.S.O.E.",224
19,"19091",30,22,22,2,0,"P.S.O.E.",5
37,"37296",385,311,308,3,3,"P.S.O.E.",143
29,"29062",647,573,571,1,2,"P.S.O.E.",289
37,"37183",425,321,316,3,5,"P.S.O.E.",118
18,"18093",2580,1837,1820,8,17,"P.S.O.E.",801
9,"9166",97,87,87,1,0,"P.S.O.E.",6
19,"19197",29,19,19,0,0,"P.S.O.E.",9
31,"31229",46,38,37,0,1,"P.S.O.E.",1
5,"5045",104,82,82,0,0,"P.S.O.E.",8
9,"9389",77,66,66,0,0,"P.S.O.E.",20
50,"50015",109,73,73,0,0,"P.S.O.E.",43
6,"6047",878,686,680,5,6,"P.S.O.E.",333
5,"5209",104,78,78,0,0,"P.S.O.E.",11
42,"42121",77,56,56,1,0,"P.S.O.E.",18
47,"47207",325,265,263,4,2,"P.S.O.E.",66
50,"50276",148,116,114,3,2,"P.S.O.E.",42
9,"9036",32,27,27,2,0,"P.S.O.E.",1
34,"34069",2330,1769,1749,25,20,"P.S.O.E.",688
40,"40103",157,121,120,0,1,"P.S.O.E.",38
16,"16135",192,127,125,0,2,"P.S.O.E.",55
29,"29081",290,226,226,3,0,"P.S.O.E.",109
35,"35022",43892,27289,26876,326,413,"P.S.O.E.",5818
31,"31230",118,88,85,1,3,"P.S.O.E.",13
42,"42027",87,61,61,4,0,"P.S.O.E.",15
37,"37299",237,167,165,2,2,"P.S.O.E.",28
42,"42175",28,19,19,0,0,"P.S.O.E.",1
26,"26055",38,32,30,0,2,"P.S.O.E.",5
40,"40056",41,34,34,0,0,"P.S.O.E.",4
45,"45112",2022,1470,1423,12,47,"P.S.O.E.",550
19,"19129",48,33,31,0,2,"P.S.O.E.",8
24,"24080",228,165,164,0,1,"P.S.O.E.",42
50,"50192",240,188,184,9,4,"P.S.O.E.",63
44,"44187",224,170,163,2,7,"P.S.O.E.",38
41,"41029",13231,9756,9610,128,146,"P.S.O.E.",4111
5,"5114",1418,1195,1182,9,13,"P.S.O.E.",494
5,"5048",131,112,111,0,1,"P.S.O.E.",27
42,"42073",84,53,53,0,0,"P.S.O.E.",8
18,"18194",2258,1656,1652,11,4,"P.S.O.E.",1027
9,"9348",150,122,122,2,0,"P.S.O.E.",40
33,"33048",169,120,120,1,0,"P.S.O.E.",52
9,"9483",226,173,171,4,2,"P.S.O.E.",54
16,"16097",196,167,166,2,1,"P.S.O.E.",66
40,"40106",232,173,173,3,0,"P.S.O.E.",55
19,"19130",58473,45114,44362,688,752,"P.S.O.E.",11531
31,"31089",246,198,195,4,3,"P.S.O.E.",23
14,"14006",1326,1170,1148,12,22,"P.S.O.E.",366
9,"9434",1167,916,902,24,14,"P.S.O.E.",241
37,"37070",538,428,427,12,1,"P.S.O.E.",124
50,"50018",973,761,755,12,6,"P.S.O.E.",348
23,"23021",541,464,453,0,11,"P.S.O.E.",251
16,"16098",586,480,474,10,6,"P.S.O.E.",199
6,"6098",537,436,435,6,1,"P.S.O.E.",201
33,"33049",6806,4629,4581,70,48,"P.S.O.E.",1545
44,"44149",106,79,78,2,1,"P.S.O.E.",25
14,"14068",581,460,457,7,3,"P.S.O.E.",264
50,"50106",137,107,106,0,1,"P.S.O.E.",43
41,"41056",3697,3041,3008,25,33,"P.S.O.E.",1997
45,"45115",2600,2140,2105,14,35,"P.S.O.E.",669
46,"46013",16111,12469,12328,145,141,"P.S.O.E.",2943
29,"29066",363,263,260,1,3,"P.S.O.E.",80
26,"26019",365,296,295,6,1,"P.S.O.E.",99
23,"23024",12634,9916,9673,116,243,"P.S.O.E.",3293
10,"10195",7917,6143,6054,36,89,"P.S.O.E.",1640
50,"50251",8379,6225,6116,110,109,"P.S.O.E.",1871
7,"7052",4578,2671,2651,46,20,"P.S.O.E.",869
40,"40201",48,48,48,2,0,"P.S.O.E.",4
2,"2051",1729,1318,1303,10,15,"P.S.O.E.",319
22,"22048",12485,9146,9028,237,118,"P.S.O.E.",2897
26,"26060",100,71,71,3,0,"P.S.O.E.",15
19,"19098",22,18,18,0,0,"P.S.O.E.",9
31,"31142",1443,906,899,16,7,"P.S.O.E.",242
47,"47183",150,125,122,0,3,"P.S.O.E.",28
44,"44025",6168,4326,4150,68,176,"P.S.O.E.",1524
39,"39085",6722,5198,5134,60,64,"P.S.O.E.",1325
7,"7053",1133,863,839,16,24,"P.S.O.E.",170
3,"3125",340,276,275,2,1,"P.S.O.E.",60
3,"3091",256,220,219,1,1,"P.S.O.E.",64
9,"9450",31,26,26,1,0,"P.S.O.E.",9
29,"29095",3431,2660,2607,23,53,"P.S.O.E.",1162
49,"49035",260,231,229,4,2,"P.S.O.E.",90
22,"22248",119,94,92,3,2,"P.S.O.E.",45
18,"18903",960,761,753,1,8,"P.S.O.E.",359
42,"42131",53,38,37,0,1,"P.S.O.E.",9
50,"50253",461,381,375,3,6,"P.S.O.E.",114
31,"31022",544,378,369,1,9,"P.S.O.E.",17
3,"3092",6780,5364,5269,96,95,"P.S.O.E.",1252
40,"40062",54,44,44,0,0,"P.S.O.E.",4
10,"10076",825,619,610,7,9,"P.S.O.E.",233
12,"12027",16914,11657,11452,188,205,"P.S.O.E.",3251
45,"45008",158,129,127,0,2,"P.S.O.E.",45
16,"16018",417,350,342,3,8,"P.S.O.E.",73
19,"19304",235,169,166,1,3,"P.S.O.E.",58
37,"37232",412,374,373,1,1,"P.S.O.E.",85
50,"50282",88,66,63,3,3,"P.S.O.E.",17
31,"31053",595,430,418,6,12,"P.S.O.E.",119
46,"46162",1230,1045,1027,6,18,"P.S.O.E.",366
9,"9045",283,196,196,4,0,"P.S.O.E.",39
29,"29087",409,306,305,3,1,"P.S.O.E.",143
2,"2079",2936,2305,2235,29,70,"P.S.O.E.",756
34,"34215",166,146,145,1,1,"P.S.O.E.",56
50,"50298",5319,4023,3955,72,68,"P.S.O.E.",1304
23,"23071",1811,1444,1431,13,13,"P.S.O.E.",641
35,"35003",4764,2733,2680,34,53,"P.S.O.E.",571
31,"31084",1949,1369,1361,11,8,"P.S.O.E.",61
47,"47132",45,40,40,0,0,"P.S.O.E.",3
12,"12029",760,619,601,7,18,"P.S.O.E.",273
14,"14011",595,498,497,4,1,"P.S.O.E.",211
26,"26167",66,51,51,2,0,"P.S.O.E.",10
41,"41060",15176,10797,10693,114,104,"P.S.O.E.",4925
44,"44029",637,495,490,6,5,"P.S.O.E.",192
50,"50110",424,315,314,6,1,"P.S.O.E.",129
31,"31175",78,55,54,0,1,"P.S.O.E.",11
7,"7057",7102,4702,4611,85,91,"P.S.O.E.",1330
44,"44028",202,159,156,2,3,"P.S.O.E.",46
34,"34123",1798,1479,1436,18,43,"P.S.O.E.",449
3,"3130",43,30,29,0,1,"P.S.O.E.",1
23,"23073",4671,3778,3735,19,43,"P.S.O.E.",1809
18,"18906",955,736,731,5,5,"P.S.O.E.",306
37,"37347",481,374,371,6,3,"P.S.O.E.",90
38,"38034",4092,3034,2983,30,51,"P.S.O.E.",678
50,"50052",100,82,82,0,0,"P.S.O.E.",12
31,"31176",2777,1999,1955,57,44,"P.S.O.E.",711
37,"37122",210,175,174,3,1,"P.S.O.E.",75
31,"31207",280,198,195,7,3,"P.S.O.E.",28
45,"45011",316,271,268,1,3,"P.S.O.E.",98
34,"34080",6066,4238,4169,57,69,"P.S.O.E.",1327
24,"24052",178,113,111,0,2,"P.S.O.E.",51
16,"16247",87,65,62,1,3,"P.S.O.E.",28
23,"23032",598,518,515,0,3,"P.S.O.E.",356
37,"37079",77,64,63,1,1,"P.S.O.E.",8
45,"45012",683,572,566,10,6,"P.S.O.E.",176
3,"3096",5863,4550,4457,57,93,"P.S.O.E.",1121
9,"9048",1565,1166,1148,20,18,"P.S.O.E.",312
38,"38036",6477,4514,4422,40,92,"P.S.O.E.",1892
45,"45123",2961,2081,2049,30,32,"P.S.O.E.",590
34,"34218",486,366,365,3,1,"P.S.O.E.",62
23,"23033",1382,1166,1152,7,14,"P.S.O.E.",557
46,"46237",7261,5405,5350,54,55,"P.S.O.E.",1481
19,"19210",34,29,29,1,0,"P.S.O.E.",5
31,"31178",540,395,392,4,3,"P.S.O.E.",191
16,"16150",120,90,90,0,0,"P.S.O.E.",31
42,"42142",55,41,38,2,3,"P.S.O.E.",7
41,"41902",4682,3136,3101,34,35,"P.S.O.E.",1645
19,"19211",450,340,334,0,6,"P.S.O.E.",109
29,"29091",8777,6226,6126,64,100,"P.S.O.E.",1961
18,"18908",827,669,660,7,9,"P.S.O.E.",341
47,"47106",63,52,52,0,0,"P.S.O.E.",11
22,"22103",697,532,523,10,9,"P.S.O.E.",224
9,"9361",134,99,98,0,1,"P.S.O.E.",12
9,"9445",46,31,31,1,0,"P.S.O.E.",6
46,"46092",304,206,201,1,5,"P.S.O.E.",56
38,"38037",13166,8509,8332,65,177,"P.S.O.E.",2280
38,"38004",4522,3034,2975,33,59,"P.S.O.E.",691
5,"5124",134,111,109,1,2,"P.S.O.E.",26
44,"44159",47,43,43,0,0,"P.S.O.E.",6
5,"5188",55,47,47,0,0,"P.S.O.E.",5
52,"52001",51028,26966,26659,496,307,"P.S.O.E.",6745
7,"7061",9429,5937,5800,125,137,"P.S.O.E.",1624
26,"26069",276,211,208,5,3,"P.S.O.E.",47
16,"16197",73,50,50,1,0,"P.S.O.E.",18
26,"26158",296,238,237,7,1,"P.S.O.E.",58
40,"40026",114,98,97,2,1,"P.S.O.E.",30
10,"10206",237,177,174,0,3,"P.S.O.E.",56
31,"31150",234,163,162,5,1,"P.S.O.E.",20
11,"11017",3219,2403,2388,18,15,"P.S.O.E.",1066
46,"46125",858,724,710,6,14,"P.S.O.E.",284
12,"12132",524,407,401,4,6,"P.S.O.E.",152
34,"34222",122,94,94,2,0,"P.S.O.E.",9
12,"12036",668,529,514,6,15,"P.S.O.E.",185
3,"3100",540,448,443,2,5,"P.S.O.E.",151
7,"7062",7206,4073,4035,72,38,"P.S.O.E.",1477
37,"37126",36,26,26,0,0,"P.S.O.E.",1
45,"45016",3804,2926,2876,52,50,"P.S.O.E.",745
42,"42044",62,47,46,0,1,"P.S.O.E.",2
10,"10087",1754,1283,1262,4,21,"P.S.O.E.",524
16,"16199",27,20,19,0,1,"P.S.O.E.",3
6,"6159",2341,1522,1510,8,12,"P.S.O.E.",827
12,"12134",147,107,107,3,0,"P.S.O.E.",42
50,"50146",211,168,167,4,1,"P.S.O.E.",78
47,"47191",113,81,80,1,1,"P.S.O.E.",15
34,"34223",233,175,175,2,0,"P.S.O.E.",14
18,"18910",832,601,594,6,7,"P.S.O.E.",230
12,"12037",20,15,14,1,1,"P.S.O.E.",5
47,"47004",1261,1047,1031,11,16,"P.S.O.E.",445
40,"40171",32,25,25,0,0,"P.S.O.E.",0
26,"26162",116,94,93,2,1,"P.S.O.E.",35
19,"19290",872,622,613,7,9,"P.S.O.E.",147
31,"31213",114,58,58,0,0,"P.S.O.E.",10
24,"24177",477,325,319,3,6,"P.S.O.E.",85
31,"31244",153,97,97,3,0,"P.S.O.E.",6
16,"16202",908,753,744,10,9,"P.S.O.E.",265
10,"10047",978,795,780,9,15,"P.S.O.E.",421
9,"9056",4957,3607,3557,70,50,"P.S.O.E.",779
46,"46095",632,505,495,1,10,"P.S.O.E.",138
44,"44082",90,67,66,1,1,"P.S.O.E.",27
34,"34132",128,103,102,2,1,"P.S.O.E.",24
42,"42004",2383,1776,1740,30,36,"P.S.O.E.",452
46,"46103",1244,998,972,12,26,"P.S.O.E.",268
3,"3114",1620,1320,1305,10,15,"P.S.O.E.",276
50,"50118",2312,1737,1718,22,19,"P.S.O.E.",686
24,"24178",83,67,67,2,0,"P.S.O.E.",15
42,"42094",520,376,362,14,14,"P.S.O.E.",112
3,"3035",672,560,550,0,10,"P.S.O.E.",200
14,"14019",6486,5288,5243,65,45,"P.S.O.E.",2418
34,"34050",216,170,166,1,4,"P.S.O.E.",42
49,"49009",430,309,309,0,0,"P.S.O.E.",72
37,"37280",84,64,64,0,0,"P.S.O.E.",8
12,"12136",2663,2325,2284,33,41,"P.S.O.E.",546
9,"9189",146,101,99,2,2,"P.S.O.E.",20
14,"14020",415,323,319,3,4,"P.S.O.E.",174
19,"19112",68,50,50,0,0,"P.S.O.E.",12
30,"30021",8550,6423,6349,44,74,"P.S.O.E.",1264
47,"47141",148,121,119,1,2,"P.S.O.E.",21
31,"31246",148,101,100,3,1,"P.S.O.E.",24
10,"10212",1688,1276,1242,16,34,"P.S.O.E.",466
11,"11021",6838,5102,5049,67,53,"P.S.O.E.",2053
7,"7033",25954,14975,14738,328,237,"P.S.O.E.",3532
50,"50206",499,386,384,10,2,"P.S.O.E.",98
31,"31154",229,133,133,4,0,"P.S.O.E.",13
24,"24180",1196,868,862,22,6,"P.S.O.E.",226
31,"31247",171,121,121,1,0,"P.S.O.E.",5
5,"5261",48,32,31,0,1,"P.S.O.E.",6
24,"24181",1652,1303,1288,12,15,"P.S.O.E.",512
42,"42097",19,16,16,0,0,"P.S.O.E.",8
38,"38011",19299,12565,12313,152,252,"P.S.O.E.",3197
40,"40177",171,145,145,2,0,"P.S.O.E.",32
5,"5077",205,164,160,2,4,"P.S.O.E.",42
24,"24196",2183,1573,1543,11,30,"P.S.O.E.",672
50,"50088",337,273,264,4,9,"P.S.O.E.",122
34,"34051",112,92,91,7,1,"P.S.O.E.",14
46,"46098",2556,2072,2057,12,15,"P.S.O.E.",403
46,"46171",16753,12565,12399,122,166,"P.S.O.E.",3390
40,"40222",190,157,156,1,1,"P.S.O.E.",46
38,"38044",2325,1550,1532,7,18,"P.S.O.E.",266
22,"22066",699,479,464,8,15,"P.S.O.E.",189
24,"24102",701,536,530,3,6,"P.S.O.E.",223
5,"5262",378,308,307,2,1,"P.S.O.E.",120
34,"34180",84,68,68,0,0,"P.S.O.E.",11
14,"14053",6040,4455,4376,78,79,"P.S.O.E.",1845
45,"45023",1936,1476,1456,18,20,"P.S.O.E.",403
38,"38045",4181,2176,2140,13,36,"P.S.O.E.",622
31,"31156",268,202,201,5,1,"P.S.O.E.",33
34,"34230",12,8,8,0,0,"P.S.O.E.",0
40,"40083",88,72,72,1,0,"P.S.O.E.",12
40,"40223",241,190,190,2,0,"P.S.O.E.",61
22,"22222",510,367,365,6,2,"P.S.O.E.",104
42,"42053",27,26,25,1,1,"P.S.O.E.",0
50,"50062",1750,1298,1275,22,23,"P.S.O.E.",426
12,"12043",620,499,487,2,12,"P.S.O.E.",140
16,"16121",270,211,207,1,4,"P.S.O.E.",95
37,"37360",252,194,194,1,0,"P.S.O.E.",50
9,"9279",195,140,140,4,0,"P.S.O.E.",30
37,"37096",235,199,197,3,2,"P.S.O.E.",45
31,"31157",3567,2435,2393,32,42,"P.S.O.E.",733
47,"47116",426,363,358,0,5,"P.S.O.E.",100
46,"46172",4838,3492,3445,24,47,"P.S.O.E.",876
50,"50122",68,47,45,2,2,"P.S.O.E.",14
5,"5069",91,79,78,1,1,"P.S.O.E.",6
6,"6124",1750,1418,1378,17,40,"P.S.O.E.",708
10,"10218",1184,896,893,0,3,"P.S.O.E.",509
47,"47036",257,212,212,1,0,"P.S.O.E.",73
40,"40181",4413,3439,3361,43,78,"P.S.O.E.",1176
10,"10217",535,423,422,3,1,"P.S.O.E.",167
37,"37285",457,349,347,2,2,"P.S.O.E.",112
5,"5167",274,230,224,6,6,"P.S.O.E.",130
49,"49059",111,83,82,2,1,"P.S.O.E.",18
22,"22174",520,401,394,11,7,"P.S.O.E.",132
42,"42106",15,14,14,0,0,"P.S.O.E.",7
42,"42056",26,23,22,1,1,"P.S.O.E.",4
45,"45063",504,378,372,3,6,"P.S.O.E.",123
7,"7039",4920,3488,3377,54,111,"P.S.O.E.",719
26,"26042",852,660,651,11,9,"P.S.O.E.",259
31,"31068",3004,2258,2207,43,51,"P.S.O.E.",886
49,"49061",141,106,105,1,1,"P.S.O.E.",28
10,"10219",1408,984,971,11,13,"P.S.O.E.",433
26,"26084",5999,4440,4399,56,41,"P.S.O.E.",1079
50,"50124",474,375,367,11,8,"P.S.O.E.",82
16,"16271",659,568,566,4,2,"P.S.O.E.",196
3,"3111",5244,4184,4146,39,38,"P.S.O.E.",1007
37,"37212",123,95,92,1,3,"P.S.O.E.",16
47,"47118",159,122,122,2,0,"P.S.O.E.",34
22,"22074",311,227,219,5,8,"P.S.O.E.",70
44,"44008",1695,1280,1257,11,23,"P.S.O.E.",585
22,"22226",823,640,627,11,13,"P.S.O.E.",263
16,"16238",560,484,479,3,5,"P.S.O.E.",215
9,"9255",90,68,68,0,0,"P.S.O.E.",16
16,"16903",1097,855,828,9,27,"P.S.O.E.",179
47,"47128",57,52,48,1,4,"P.S.O.E.",3
45,"45028",3696,3059,3024,40,35,"P.S.O.E.",1170
5,"5267",102,78,77,1,1,"P.S.O.E.",22
38,"38050",2516,1765,1734,9,31,"P.S.O.E.",832
29,"29057",413,311,308,2,3,"P.S.O.E.",157
37,"37328",218,155,149,2,6,"P.S.O.E.",55
47,"47200",91,73,73,0,0,"P.S.O.E.",3
49,"49063",371,291,290,3,1,"P.S.O.E.",91
39,"39076",3388,2673,2641,22,32,"P.S.O.E.",764
49,"49064",566,372,368,8,4,"P.S.O.E.",98
19,"19006",873,634,620,1,14,"P.S.O.E.",251
34,"34236",176,134,134,1,0,"P.S.O.E.",16
33,"33064",237,175,173,1,2,"P.S.O.E.",75
3,"3113",4154,3295,3251,24,44,"P.S.O.E.",1154
22,"22178",107,92,92,1,0,"P.S.O.E.",22
31,"31161",321,251,246,5,5,"P.S.O.E.",50
34,"34020",63,44,44,0,0,"P.S.O.E.",10
40,"40233",457,350,348,1,2,"P.S.O.E.",117
16,"16273",328,277,275,2,2,"P.S.O.E.",46
38,"38029",1456,732,715,4,17,"P.S.O.E.",211
46,"46078",28197,20643,20415,205,228,"P.S.O.E.",5896
16,"16218",207,170,169,4,1,"P.S.O.E.",69
19,"19329",62,52,50,0,2,"P.S.O.E.",18
46,"46030",800,677,662,6,15,"P.S.O.E.",247
31,"31254",1956,1495,1476,16,19,"P.S.O.E.",577
12,"12014",191,139,137,4,2,"P.S.O.E.",48
49,"49200",1011,789,771,6,18,"P.S.O.E.",281
45,"45141",981,815,790,6,25,"P.S.O.E.",262
42,"42165",424,291,280,6,11,"P.S.O.E.",92
31,"31255",100,78,78,1,0,"P.S.O.E.",17
33,"33050",653,406,402,0,4,"P.S.O.E.",119
2,"2052",493,417,412,9,5,"P.S.O.E.",164
44,"44050",3183,2208,2154,78,54,"P.S.O.E.",518
37,"37367",218,182,176,0,6,"P.S.O.E.",24
16,"16275",15,12,12,0,0,"P.S.O.E.",6
50,"50128",36,30,29,0,1,"P.S.O.E.",11
6,"6132",876,656,648,2,8,"P.S.O.E.",309
45,"45032",471,340,333,2,7,"P.S.O.E.",102
23,"23054",393,288,286,1,2,"P.S.O.E.",175
18,"18087",187449,138136,136783,1548,1353,"P.S.O.E.",36592
19,"19088",98,67,66,0,1,"P.S.O.E.",17
31,"31194",308,212,210,6,2,"P.S.O.E.",19
45,"45143",1302,916,901,6,15,"P.S.O.E.",253
23,"23055",48167,33913,33612,400,301,"P.S.O.E.",12658
9,"9114",88,75,73,0,2,"P.S.O.E.",14
5,"5903",171,118,118,0,0,"P.S.O.E.",45
16,"16131",154,116,115,0,1,"P.S.O.E.",36
40,"40095",507,437,425,2,12,"P.S.O.E.",58
31,"31012",839,577,570,10,7,"P.S.O.E.",181
23,"23056",3182,2539,2523,20,16,"P.S.O.E.",1097
11,"11003",1290,952,940,8,12,"P.S.O.E.",450
31,"31257",827,598,585,16,13,"P.S.O.E.",116
12,"12052",627,510,491,9,19,"P.S.O.E.",132
9,"9340",72,41,41,0,0,"P.S.O.E.",5
39,"39079",9035,6959,6897,55,62,"P.S.O.E.",2001
19,"19124",420,293,291,3,2,"P.S.O.E.",95
9,"9202",26,24,24,1,0,"P.S.O.E.",2
30,"30030",305669,236235,234391,2112,1844,"P.S.O.E.",41708
24,"24076",1210,917,907,26,10,"P.S.O.E.",306
50,"50216",267,201,194,8,7,"P.S.O.E.",61
46,"46235",21966,16641,16465,167,176,"P.S.O.E.",4082
10,"10079",891,711,706,6,5,"P.S.O.E.",200
16,"16133",4466,3522,3453,51,69,"P.S.O.E.",1190
22,"22039",920,721,710,12,11,"P.S.O.E.",236
14,"14001",3633,3095,3064,25,31,"P.S.O.E.",1228
11,"11032",53183,32205,31982,441,223,"P.S.O.E.",12884
41,"41093",17665,13712,13526,179,186,"P.S.O.E.",3608
50,"50041",21,13,13,0,0,"P.S.O.E.",10
50,"50131",243,185,183,6,2,"P.S.O.E.",59
45,"45072",690,535,532,7,3,"P.S.O.E.",173
38,"38023",118865,76393,75039,928,1354,"P.S.O.E.",16758
34,"34067",142,88,88,3,0,"P.S.O.E.",30
11,"11042",1232,933,922,4,11,"P.S.O.E.",452
42,"42219",45,33,33,1,0,"P.S.O.E.",8
49,"49205",429,313,309,10,4,"P.S.O.E.",36
23,"23059",5974,4910,4852,37,58,"P.S.O.E.",2154
31,"31015",1989,1404,1380,29,24,"P.S.O.E.",414
42,"42120",148,91,91,4,0,"P.S.O.E.",30
45,"45036",704,559,537,4,22,"P.S.O.E.",149
3,"3018",11899,8855,8720,119,135,"P.S.O.E.",2503
31,"31076",2314,1843,1823,39,20,"P.S.O.E.",208
39,"39081",440,372,369,3,3,"P.S.O.E.",37
6,"6138",1070,838,829,13,9,"P.S.O.E.",428
11,"11005",4617,3287,3214,26,73,"P.S.O.E.",1724
49,"49027",178,134,127,1,7,"P.S.O.E.",28
22,"22236",266,213,213,3,0,"P.S.O.E.",80
42,"42086",40,25,25,1,0,"P.S.O.E.",5
34,"34028",154,128,126,1,2,"P.S.O.E.",18
31,"31197",69,58,57,1,1,"P.S.O.E.",28
22,"22239",90,76,76,2,0,"P.S.O.E.",18
3,"3019",14914,12087,11927,137,160,"P.S.O.E.",3315
16,"16011",39,30,30,0,0,"P.S.O.E.",5
23,"23061",7309,5637,5584,60,53,"P.S.O.E.",2673
49,"49256",289,229,224,3,5,"P.S.O.E.",59
6,"6049",1088,847,829,3,18,"P.S.O.E.",369
16,"16236",964,762,758,10,4,"P.S.O.E.",181
31,"31138",939,648,646,14,2,"P.S.O.E.",64
37,"37373",793,591,589,4,2,"P.S.O.E.",275
9,"9167",60,49,49,2,0,"P.S.O.E.",6
45,"45038",3125,2401,2374,33,27,"P.S.O.E.",467
30,"30033",9940,7794,7700,79,94,"P.S.O.E.",1766
40,"40104",261,179,178,1,1,"P.S.O.E.",48
22,"22193",318,266,264,7,2,"P.S.O.E.",99
46,"46036",675,440,431,11,9,"P.S.O.E.",94
49,"49208",428,266,261,1,5,"P.S.O.E.",29
19,"19016",74,50,49,0,1,"P.S.O.E.",21
6,"6141",1803,1419,1397,23,22,"P.S.O.E.",717
44,"44147",439,320,314,14,6,"P.S.O.E.",89
45,"45149",638,542,533,2,9,"P.S.O.E.",186
11,"11036",725,484,482,10,2,"P.S.O.E.",220
41,"41096",6079,4673,4595,47,78,"P.S.O.E.",1509
24,"24203",109,73,73,0,0,"P.S.O.E.",20
14,"14005",6334,4262,4206,61,56,"P.S.O.E.",1687
29,"29065",207,151,149,1,2,"P.S.O.E.",65
19,"19054",184,156,151,2,5,"P.S.O.E.",47
31,"31262",219,158,157,4,1,"P.S.O.E.",16
50,"50074",6516,4378,4222,77,156,"P.S.O.E.",1524
18,"18010",576,464,458,4,6,"P.S.O.E.",284
50,"50287",298,214,211,10,3,"P.S.O.E.",71
50,"50259",89,53,53,1,0,"P.S.O.E.",14
5,"5179",231,206,204,2,2,"P.S.O.E.",15
23,"23064",1680,1483,1478,8,5,"P.S.O.E.",677
30,"30035",17849,12871,12744,133,127,"P.S.O.E.",2238
34,"34902",146,121,121,1,0,"P.S.O.E.",34
24,"24205",995,719,712,9,7,"P.S.O.E.",196
33,"33004",69056,49228,48730,726,498,"P.S.O.E.",14750
12,"12059",276,227,227,1,0,"P.S.O.E.",93
6,"6007",1557,1200,1189,4,11,"P.S.O.E.",707
49,"49081",1457,1166,1141,17,25,"P.S.O.E.",400
47,"47129",954,744,731,4,13,"P.S.O.E.",241
50,"50136",617,469,462,4,7,"P.S.O.E.",109
10,"10114",926,670,652,8,18,"P.S.O.E.",317
3,"3056",8929,6927,6776,74,151,"P.S.O.E.",2136
9,"9306",127,94,94,0,0,"P.S.O.E.",17
9,"9041",27,27,27,0,0,"P.S.O.E.",14
35,"35034",6372,2951,2921,33,30,"P.S.O.E.",716
5,"5051",194,165,154,0,11,"P.S.O.E.",40
29,"29084",28386,19450,19202,296,248,"P.S.O.E.",6388
19,"19245",1222,954,943,10,11,"P.S.O.E.",325
50,"50085",205,143,143,3,0,"P.S.O.E.",40
16,"16070",35,29,29,0,0,"P.S.O.E.",17
46,"46184",26507,20314,20010,263,304,"P.S.O.E.",5652
5,"5181",39,26,26,0,0,"P.S.O.E.",3
9,"9216",390,278,272,2,6,"P.S.O.E.",62
50,"50137",1119,842,834,12,8,"P.S.O.E.",345
42,"42079",32,25,25,0,0,"P.S.O.E.",0
5,"5017",87,69,68,1,1,"P.S.O.E.",12
37,"37229",144,108,108,0,0,"P.S.O.E.",13
26,"26061",1552,1119,1099,31,20,"P.S.O.E.",418
29,"29049",3137,2365,2352,19,13,"P.S.O.E.",1259
22,"22035",261,179,176,3,3,"P.S.O.E.",93
44,"44038",112,94,92,3,2,"P.S.O.E.",27
3,"3068",48,45,45,1,0,"P.S.O.E.",4
16,"16145",508,421,417,6,4,"P.S.O.E.",182
37,"37231",285,227,225,6,2,"P.S.O.E.",58
9,"9217",389,273,270,8,3,"P.S.O.E.",50
39,"39008",13716,10396,10274,129,122,"P.S.O.E.",2877
39,"39060",6723,5453,5360,56,93,"P.S.O.E.",1420
24,"24209",3016,2006,1984,20,22,"P.S.O.E.",773
37,"37343",56,42,40,0,2,"P.S.O.E.",10
12,"12095",1027,790,775,15,15,"P.S.O.E.",294
44,"44113",79,57,55,0,2,"P.S.O.E.",26
40,"40204",187,139,134,4,5,"P.S.O.E.",22
37,"37073",583,458,455,7,3,"P.S.O.E.",111
30,"30038",15057,11640,11555,82,85,"P.S.O.E.",2309
19,"19238",42,32,31,1,1,"P.S.O.E.",2
6,"6012",3263,2498,2476,31,22,"P.S.O.E.",996
19,"19135",120,102,100,2,2,"P.S.O.E.",23
45,"45155",481,382,375,3,7,"P.S.O.E.",154
47,"47077",291,232,232,1,0,"P.S.O.E.",31
40,"40205",292,221,220,2,1,"P.S.O.E.",55
26,"26023",505,386,380,6,6,"P.S.O.E.",125
24,"24211",291,226,224,3,2,"P.S.O.E.",65
5,"5019",44095,34409,33934,505,475,"P.S.O.E.",6536
10,"10159",341,278,277,1,1,"P.S.O.E.",143
3,"3059",20261,15951,15825,82,126,"P.S.O.E.",3020
49,"49086",127,108,107,1,1,"P.S.O.E.",25
50,"50051",886,677,671,9,6,"P.S.O.E.",322
50,"50225",1638,1079,1062,7,17,"P.S.O.E.",281
9,"9141",607,503,481,10,22,"P.S.O.E.",146
38,"38010",4054,2642,2599,17,43,"P.S.O.E.",714
5,"5184",288,225,224,0,1,"P.S.O.E.",77
42,"42083",28,25,25,0,0,"P.S.O.E.",1
46,"46114",565,501,495,3,6,"P.S.O.E.",145
9,"9262",158,139,137,7,2,"P.S.O.E.",37
40,"40207",724,551,540,9,11,"P.S.O.E.",146
5,"5021",2044,1592,1557,37,35,"P.S.O.E.",343
45,"45195",2229,1806,1784,11,22,"P.S.O.E.",755
31,"31024",116,56,56,2,0,"P.S.O.E.",1
3,"3094",8442,6105,6053,70,52,"P.S.O.E.",1365
11,"11023",9209,6979,6929,81,50,"P.S.O.E.",3320
22,"22170",622,439,430,13,9,"P.S.O.E.",130
44,"44236",77,48,47,0,1,"P.S.O.E.",16
14,"14043",7664,5935,5874,53,61,"P.S.O.E.",2905
31,"31025",751,501,495,12,6,"P.S.O.E.",38
16,"16149",179,140,138,2,2,"P.S.O.E.",49
46,"46018",689,597,592,12,5,"P.S.O.E.",225
11,"11014",16318,11093,11031,144,62,"P.S.O.E.",3521
18,"18005",366,279,277,3,2,"P.S.O.E.",157
31,"31177",264,162,158,3,4,"P.S.O.E.",21
14,"14013",17006,13114,12958,166,156,"P.S.O.E.",4618
41,"41087",9827,7300,7150,51,150,"P.S.O.E.",2884
50,"50141",116,98,98,1,0,"P.S.O.E.",21
37,"37348",114,91,90,1,1,"P.S.O.E.",10
40,"40119",182,149,145,2,4,"P.S.O.E.",21
3,"3107",2288,1670,1647,15,23,"P.S.O.E.",438
50,"50053",756,570,563,14,7,"P.S.O.E.",239
5,"5089",500,390,375,3,15,"P.S.O.E.",82
5,"5090",72,64,63,1,1,"P.S.O.E.",23
24,"24092",883,707,702,6,5,"P.S.O.E.",251
19,"19241",45,37,37,2,0,"P.S.O.E.",2
50,"50054",63,46,46,0,0,"P.S.O.E.",11
16,"16195",545,436,433,6,3,"P.S.O.E.",229
47,"47001",51,44,42,2,2,"P.S.O.E.",5
37,"37311",251,210,209,8,1,"P.S.O.E.",62
40,"40165",95,72,71,1,1,"P.S.O.E.",27
10,"10164",770,557,547,2,10,"P.S.O.E.",266
22,"22157",251,176,175,9,1,"P.S.O.E.",72
34,"34170",72,56,56,1,0,"P.S.O.E.",8
19,"19065",126,100,100,3,0,"P.S.O.E.",38
50,"50286",90,73,73,2,0,"P.S.O.E.",23
26,"26068",83,65,64,0,1,"P.S.O.E.",26
11,"11016",14611,9848,9774,114,74,"P.S.O.E.",2938
6,"6019",2111,1621,1596,24,25,"P.S.O.E.",762
47,"47217",1812,1395,1377,20,18,"P.S.O.E.",374
10,"10002",396,317,314,5,3,"P.S.O.E.",150
24,"24055",747,557,549,11,8,"P.S.O.E.",162
42,"42088",69,56,56,1,0,"P.S.O.E.",9
47,"47109",183,151,151,4,0,"P.S.O.E.",66
12,"12101",385,309,296,3,13,"P.S.O.E.",89
49,"49271",221,178,176,2,2,"P.S.O.E.",75
46,"46141",424,338,336,2,2,"P.S.O.E.",91
18,"18007",808,602,591,5,11,"P.S.O.E.",353
42,"42042",46,35,33,1,2,"P.S.O.E.",2
47,"47002",30,27,27,1,0,"P.S.O.E.",2
14,"14046",4587,3671,3641,35,30,"P.S.O.E.",1399
18,"18141",484,326,325,1,1,"P.S.O.E.",62
37,"37325",102,77,77,0,0,"P.S.O.E.",29
12,"12046",236,177,176,4,1,"P.S.O.E.",62
31,"31079",99,64,63,0,1,"P.S.O.E.",14
50,"50115",3280,2234,2205,32,29,"P.S.O.E.",789
9,"9226",74,57,57,0,0,"P.S.O.E.",14
19,"19279",66,56,56,0,0,"P.S.O.E.",12
31,"31211",25,14,14,2,0,"P.S.O.E.",0
6,"6112",411,330,326,0,4,"P.S.O.E.",138
47,"47164",391,326,320,3,6,"P.S.O.E.",106
3,"3033",127,102,97,2,5,"P.S.O.E.",23
40,"40124",261,190,183,9,7,"P.S.O.E.",54
37,"37004",31,23,23,0,0,"P.S.O.E.",3
35,"35008",6151,4514,4419,59,95,"P.S.O.E.",1037
18,"18040",246,147,146,0,1,"P.S.O.E.",69
46,"46021",23273,17264,17091,163,173,"P.S.O.E.",5045
19,"19214",94,78,78,2,0,"P.S.O.E.",18
3,"3101",4648,3694,3607,29,87,"P.S.O.E.",1115
9,"9182",104,81,81,1,0,"P.S.O.E.",10
18,"18175",11534,8772,8698,68,74,"P.S.O.E.",3602
33,"33019",3262,2283,2244,12,39,"P.S.O.E.",714
46,"46167",411,312,309,0,3,"P.S.O.E.",100
16,"16155",549,430,426,2,4,"P.S.O.E.",126
19,"19046",20318,15118,14892,219,226,"P.S.O.E.",4400
47,"47228",481,385,383,3,2,"P.S.O.E.",99
9,"9288",98,80,80,1,0,"P.S.O.E.",12
9,"9016",87,55,54,1,1,"P.S.O.E.",28
24,"24139",2320,1687,1654,16,33,"P.S.O.E.",534
14,"14049",16358,12577,12478,137,99,"P.S.O.E.",5458
26,"26074",128,102,101,0,1,"P.S.O.E.",27
10,"10169",587,460,450,2,10,"P.S.O.E.",179
24,"24098",1251,837,819,19,18,"P.S.O.E.",337
12,"12004",4354,3145,3083,50,62,"P.S.O.E.",986
31,"31152",1406,1003,975,23,28,"P.S.O.E.",255
42,"42018",178,129,124,0,5,"P.S.O.E.",22
50,"50107",953,785,780,13,5,"P.S.O.E.",242
26,"26089",108356,81446,80090,1450,1356,"P.S.O.E.",23843
22,"22127",483,357,353,9,4,"P.S.O.E.",90
40,"40077",713,526,519,12,7,"P.S.O.E.",140
46,"46168",1828,1461,1449,7,12,"P.S.O.E.",491
45,"45057",222,197,189,0,8,"P.S.O.E.",61
40,"40127",45,33,33,0,0,"P.S.O.E.",4
2,"2053",3053,2550,2517,33,33,"P.S.O.E.",1058
38,"38042",3876,2850,2809,24,41,"P.S.O.E.",945
45,"45204",621,500,497,1,3,"P.S.O.E.",154
50,"50059",790,593,586,12,7,"P.S.O.E.",233
37,"37008",4316,3518,3457,31,61,"P.S.O.E.",804
26,"26035",22,14,14,0,0,"P.S.O.E.",6
31,"31123",652,379,373,8,6,"P.S.O.E.",38
50,"50262",1216,916,904,20,12,"P.S.O.E.",361
5,"5226",92,67,67,0,0,"P.S.O.E.",7
42,"42154",95,73,73,0,0,"P.S.O.E.",23
44,"44247",335,251,243,10,8,"P.S.O.E.",102
45,"45094",441,358,353,6,5,"P.S.O.E.",137
23,"23043",554,411,407,6,4,"P.S.O.E.",178
40,"40033",61,48,47,3,1,"P.S.O.E.",5
50,"50003",141,108,108,3,0,"P.S.O.E.",34
41,"41016",6950,5194,5120,45,74,"P.S.O.E.",1743
35,"35011",23140,15550,15320,199,230,"P.S.O.E.",3683
24,"24100",760,563,553,14,10,"P.S.O.E.",160
37,"37245",357,273,272,2,1,"P.S.O.E.",100
2,"2055",1267,900,884,6,16,"P.S.O.E.",320
19,"19283",40,33,33,0,0,"P.S.O.E.",16
31,"31094",123,100,97,3,3,"P.S.O.E.",26
24,"24114",3441,2322,2304,42,18,"P.S.O.E.",1024
5,"5206",29,23,21,2,2,"P.S.O.E.",7
18,"18157",1062,793,783,9,10,"P.S.O.E.",262
31,"31124",209,139,138,1,1,"P.S.O.E.",11
47,"47086",4062,3162,3120,37,42,"P.S.O.E.",1212
34,"34066",66,55,54,0,1,"P.S.O.E.",3
9,"9059",137122,103909,102353,2008,1556,"P.S.O.E.",27471
46,"46179",2186,1849,1804,17,45,"P.S.O.E.",621
23,"23903",3537,2892,2877,12,15,"P.S.O.E.",1142
44,"44250",20,11,11,1,0,"P.S.O.E.",4
5,"5034",17,13,13,0,0,"P.S.O.E.",3
19,"19011",286,219,218,3,1,"P.S.O.E.",85
37,"37171",437,362,358,4,4,"P.S.O.E.",47
49,"49012",73,43,43,0,0,"P.S.O.E.",8
39,"39045",410,324,323,5,1,"P.S.O.E.",76
24,"24225",1089,798,784,15,14,"P.S.O.E.",206
34,"34136",192,122,122,1,0,"P.S.O.E.",19
49,"49013",300,230,228,6,2,"P.S.O.E.",71
49,"49103",435,354,350,6,4,"P.S.O.E.",67
39,"39098",1522,1256,1244,8,12,"P.S.O.E.",152
9,"9194",2033,1557,1535,28,22,"P.S.O.E.",371
44,"44211",39,32,32,2,0,"P.S.O.E.",9
19,"19285",26,20,20,2,0,"P.S.O.E.",10
45,"45134",1606,1260,1242,10,18,"P.S.O.E.",390
19,"19041",166,127,127,3,0,"P.S.O.E.",52
26,"26080",529,427,425,2,2,"P.S.O.E.",100
34,"34202",28,21,21,0,0,"P.S.O.E.",1
49,"49014",134,104,102,1,2,"P.S.O.E.",19
50,"50238",114,82,80,0,2,"P.S.O.E.",28
19,"19252",90,80,78,0,2,"P.S.O.E.",27
16,"16038",50,40,40,0,0,"P.S.O.E.",9
9,"9238",1026,612,601,6,11,"P.S.O.E.",206
9,"9236",41,38,37,0,1,"P.S.O.E.",1
33,"33039",1719,1325,1319,14,6,"P.S.O.E.",486
37,"37248",160,130,130,1,0,"P.S.O.E.",23
18,"18083",296,242,242,1,0,"P.S.O.E.",105
44,"44056",577,436,434,7,2,"P.S.O.E.",120
2,"2059",336,262,258,3,4,"P.S.O.E.",146
24,"24148",1759,1362,1348,29,14,"P.S.O.E.",322
7,"7038",1962,1504,1480,20,24,"P.S.O.E.",355
18,"18017",17990,12070,11962,80,108,"P.S.O.E.",3271
26,"26127",236,206,204,1,2,"P.S.O.E.",78
9,"9460",187,144,142,2,2,"P.S.O.E.",30
47,"47062",185,153,153,5,0,"P.S.O.E.",11
45,"45136",5891,4414,4368,55,46,"P.S.O.E.",1117
26,"26082",121,95,95,0,0,"P.S.O.E.",31
9,"9419",82,61,61,0,0,"P.S.O.E.",2
19,"19287",153,114,113,2,1,"P.S.O.E.",26
26,"26172",35,29,29,0,0,"P.S.O.E.",14
44,"44215",156,100,100,2,0,"P.S.O.E.",41
46,"46252",142,108,107,1,1,"P.S.O.E.",34
14,"14026",2043,1434,1421,10,13,"P.S.O.E.",675
26,"26003",446,388,387,8,1,"P.S.O.E.",99
7,"7006",4964,3234,3157,51,77,"P.S.O.E.",1098
31,"31190",48,34,34,1,0,"P.S.O.E.",7
6,"6127",2922,2306,2279,27,27,"P.S.O.E.",962
44,"44175",138,111,111,4,0,"P.S.O.E.",33
9,"9433",67,46,45,2,1,"P.S.O.E.",17
46,"46182",1190,864,855,11,9,"P.S.O.E.",213
7,"7017",800,556,539,14,17,"P.S.O.E.",102
6,"6142",284,240,235,4,5,"P.S.O.E.",136
5,"5159",287,216,216,0,0,"P.S.O.E.",17
16,"16085",151,123,122,2,1,"P.S.O.E.",27
9,"9283",63,36,36,0,0,"P.S.O.E.",3
45,"45066",7334,5602,5536,52,66,"P.S.O.E.",1116
14,"14027",7948,5944,5871,92,73,"P.S.O.E.",2362
10,"10140",1143,941,927,9,14,"P.S.O.E.",291
26,"26004",82,64,64,1,0,"P.S.O.E.",8
12,"12081",654,519,515,2,4,"P.S.O.E.",161
24,"24901",994,698,686,8,12,"P.S.O.E.",273
24,"24108",421,316,314,6,2,"P.S.O.E.",87
46,"46054",11422,8666,8566,82,100,"P.S.O.E.",2391
29,"29074",818,631,630,3,1,"P.S.O.E.",370
23,"23096",2678,2298,2276,18,22,"P.S.O.E.",1445
42,"42111",310,228,222,2,6,"P.S.O.E.",62
46,"46127",2790,2298,2267,23,31,"P.S.O.E.",644
7,"7063",1414,1050,1030,25,20,"P.S.O.E.",175
5,"5234",58,49,49,0,0,"P.S.O.E.",5
50,"50010",77,65,64,5,1,"P.S.O.E.",5
47,"47100",169,146,144,1,2,"P.S.O.E.",48
18,"18163",327,246,238,0,8,"P.S.O.E.",100
44,"44136",51,39,39,0,0,"P.S.O.E.",13
26,"26175",57,46,45,1,1,"P.S.O.E.",17
37,"37057",223,190,190,0,0,"P.S.O.E.",30
16,"16170",733,552,543,3,9,"P.S.O.E.",201
12,"12049",471,366,344,10,22,"P.S.O.E.",157
50,"50213",117,83,82,0,1,"P.S.O.E.",12
9,"9382",33,30,30,0,0,"P.S.O.E.",2
26,"26088",48,41,41,0,0,"P.S.O.E.",16
3,"3013",1144,941,926,5,15,"P.S.O.E.",252
40,"40061",66,53,52,1,1,"P.S.O.E.",6
22,"22164",46,32,32,0,0,"P.S.O.E.",15
16,"16115",60,45,45,0,0,"P.S.O.E.",17
50,"50001",130,96,96,0,0,"P.S.O.E.",29
19,"19291",1271,925,902,3,23,"P.S.O.E.",275
40,"40189",560,455,438,6,17,"P.S.O.E.",179
6,"6041",459,406,404,4,2,"P.S.O.E.",161
44,"44099",724,519,511,4,8,"P.S.O.E.",225
42,"42115",72,48,48,0,0,"P.S.O.E.",5
19,"19293",1860,1407,1373,16,34,"P.S.O.E.",329
42,"42062",36,23,22,0,1,"P.S.O.E.",11
46,"46153",445,374,366,7,8,"P.S.O.E.",109
38,"38020",14520,9396,9202,121,194,"P.S.O.E.",2110
9,"9386",61,45,45,0,0,"P.S.O.E.",1
24,"24155",524,428,420,6,8,"P.S.O.E.",171
30,"30003",23570,16482,16354,169,128,"P.S.O.E.",4276
6,"6042",1017,824,820,5,4,"P.S.O.E.",373
11,"11031",76347,49071,48616,681,455,"P.S.O.E.",14453
49,"49023",1033,736,728,10,8,"P.S.O.E.",159
49,"49157",177,140,140,0,0,"P.S.O.E.",50
42,"42167",305,223,222,3,1,"P.S.O.E.",66
12,"12016",1589,1309,1293,15,16,"P.S.O.E.",419
37,"37060",229,179,173,2,6,"P.S.O.E.",50
29,"29077",225,157,157,1,0,"P.S.O.E.",81
34,"34024",27,18,17,1,1,"P.S.O.E.",1
26,"26050",114,84,81,1,3,"P.S.O.E.",20
19,"19294",27,26,26,1,0,"P.S.O.E.",7
34,"34063",102,92,91,2,1,"P.S.O.E.",38
49,"49249",78,63,63,0,0,"P.S.O.E.",9
22,"22080",288,217,217,4,0,"P.S.O.E.",67
26,"26150",129,104,104,0,0,"P.S.O.E.",38
45,"45168",61519,47265,46528,736,737,"P.S.O.E.",11916
19,"19296",43,31,30,1,1,"P.S.O.E.",1
19,"19162",71,52,51,0,1,"P.S.O.E.",20
40,"40145",1152,933,920,3,13,"P.S.O.E.",260
46,"46065",1606,1250,1234,15,16,"P.S.O.E.",309
49,"49071",822,558,557,5,1,"P.S.O.E.",117
24,"24157",2580,2046,2000,39,46,"P.S.O.E.",603
47,"47025",127,103,103,0,0,"P.S.O.E.",25
46,"46257",5579,4546,4512,32,34,"P.S.O.E.",1286
22,"22150",491,342,336,9,6,"P.S.O.E.",106
50,"50283",73,55,55,1,0,"P.S.O.E.",13
47,"47232",107,77,75,1,2,"P.S.O.E.",24
31,"31238",125,99,98,3,1,"P.S.O.E.",14
35,"35030",8295,5433,5315,54,118,"P.S.O.E.",1166
31,"31166",274,183,182,2,1,"P.S.O.E.",23
14,"14063",1121,875,866,9,9,"P.S.O.E.",424
16,"16093",80,57,57,0,0,"P.S.O.E.",14
46,"46082",4661,3447,3401,46,46,"P.S.O.E.",834
19,"19297",34,29,29,0,0,"P.S.O.E.",6
37,"37259",44,32,32,3,0,"P.S.O.E.",5
24,"24159",1901,1492,1477,11,15,"P.S.O.E.",359
9,"9035",336,255,251,3,4,"P.S.O.E.",88
40,"40148",259,213,212,3,1,"P.S.O.E.",70
24,"24198",644,423,417,7,6,"P.S.O.E.",245
34,"34041",100,79,78,1,1,"P.S.O.E.",19
37,"37272",162,121,120,1,1,"P.S.O.E.",41
45,"45049",394,315,315,6,0,"P.S.O.E.",77
22,"22253",71,54,54,1,0,"P.S.O.E.",22
45,"45086",491,406,399,3,7,"P.S.O.E.",129
19,"19051",94,83,83,1,0,"P.S.O.E.",28
50,"50043",258,170,166,2,4,"P.S.O.E.",53
46,"46156",2065,1746,1721,14,25,"P.S.O.E.",570
16,"16177",86,68,68,0,0,"P.S.O.E.",24
40,"40195",946,722,707,13,15,"P.S.O.E.",156
16,"16234",52,38,36,0,2,"P.S.O.E.",15
26,"26027",169,126,126,1,0,"P.S.O.E.",34
45,"45147",598,484,478,9,6,"P.S.O.E.",181
42,"42123",172,128,128,3,0,"P.S.O.E.",24
45,"45001",1901,1468,1431,14,37,"P.S.O.E.",473
5,"5241",3145,2303,2273,27,30,"P.S.O.E.",503
11,"11035",13266,8794,8668,115,126,"P.S.O.E.",2854
19,"19264",45,39,39,0,0,"P.S.O.E.",12
22,"22085",119,97,94,0,3,"P.S.O.E.",42
10,"10151",245,204,202,2,2,"P.S.O.E.",79
5,"5013",890,746,739,4,7,"P.S.O.E.",285
9,"9408",45,36,36,0,0,"P.S.O.E.",2
47,"47127",150,110,108,0,2,"P.S.O.E.",22
47,"47208",56,45,43,1,2,"P.S.O.E.",5
24,"24201",1123,790,777,14,13,"P.S.O.E.",261
34,"34126",284,226,224,3,2,"P.S.O.E.",46
42,"42176",30,22,22,0,0,"P.S.O.E.",1
5,"5147",174,141,135,4,6,"P.S.O.E.",15
42,"42028",62,45,43,2,2,"P.S.O.E.",10
30,"30008",13289,9992,9849,86,143,"P.S.O.E.",1967
47,"47020",283,237,232,5,5,"P.S.O.E.",42
50,"50278",207,152,149,4,3,"P.S.O.E.",42
5,"5243",101,69,68,0,1,"P.S.O.E.",17
9,"9013",48,41,41,1,0,"P.S.O.E.",11
6,"6143",3308,2625,2595,24,30,"P.S.O.E.",1250
9,"9378",42,26,26,0,0,"P.S.O.E.",5
44,"44021",114,81,77,1,4,"P.S.O.E.",32
47,"47055",212,169,168,3,1,"P.S.O.E.",65
41,"41097",3096,2489,2451,21,38,"P.S.O.E.",1443
41,"41030",527,436,429,6,7,"P.S.O.E.",214
29,"29010",1703,1411,1377,7,34,"P.S.O.E.",823
46,"46061",331,276,273,3,3,"P.S.O.E.",66
37,"37150",43,36,34,0,2,"P.S.O.E.",0
10,"10154",194,150,145,0,5,"P.S.O.E.",58
37,"37264",78,52,52,0,0,"P.S.O.E.",14
5,"5015",100,78,78,0,0,"P.S.O.E.",41
6,"6053",642,466,454,4,12,"P.S.O.E.",266
33,"33026",9144,6019,5959,87,60,"P.S.O.E.",1786
35,"35025",1941,1345,1328,12,17,"P.S.O.E.",254
16,"16099",232,180,178,5,2,"P.S.O.E.",51
31,"31141",132,100,98,1,2,"P.S.O.E.",8
46,"46159",23111,17258,17086,141,172,"P.S.O.E.",4704
3,"3077",1411,1146,1130,14,16,"P.S.O.E.",317
9,"9448",225,188,186,1,2,"P.S.O.E.",14
49,"49033",761,563,556,9,7,"P.S.O.E.",147
9,"9317",17,15,15,0,0,"P.S.O.E.",6
42,"42195",112,74,72,1,2,"P.S.O.E.",15
31,"31223",1043,783,771,14,12,"P.S.O.E.",243
10,"10182",146,112,108,0,4,"P.S.O.E.",39
46,"46262",228,161,158,0,3,"P.S.O.E.",36
35,"35026",78933,49860,48955,780,905,"P.S.O.E.",10300
39,"39033",604,480,473,3,7,"P.S.O.E.",92
40,"40157",74,51,50,2,1,"P.S.O.E.",14
9,"9001",29,25,25,0,0,"P.S.O.E.",11
46,"46014",3092,2449,2420,26,29,"P.S.O.E.",640
49,"49169",42,34,33,1,1,"P.S.O.E.",13
33,"33035",11413,8105,8035,104,70,"P.S.O.E.",2199
16,"16274",147,125,125,1,0,"P.S.O.E.",59
34,"34061",116,78,78,2,0,"P.S.O.E.",2
29,"29058",1560,1103,1096,5,7,"P.S.O.E.",572
12,"12039",870,743,736,4,7,"P.S.O.E.",254
2,"2041",399,311,304,1,7,"P.S.O.E.",70
44,"44112",473,353,350,4,3,"P.S.O.E.",119
37,"37267",210,169,165,0,4,"P.S.O.E.",69
24,"24124",419,286,282,0,4,"P.S.O.E.",82
26,"26106",78,70,69,0,1,"P.S.O.E.",20
10,"10157",289,218,212,1,6,"P.S.O.E.",61
14,"14040",3821,2986,2949,40,37,"P.S.O.E.",934
26,"26062",94,78,77,1,1,"P.S.O.E.",12
31,"31235",189,111,110,0,1,"P.S.O.E.",29
50,"50021",42,34,33,1,1,"P.S.O.E.",1
19,"19021",1129,818,800,10,18,"P.S.O.E.",243
9,"9003",205,156,154,4,2,"P.S.O.E.",53
29,"29041",2796,1950,1921,24,29,"P.S.O.E.",663
18,"18003",13486,10245,10100,145,145,"P.S.O.E.",3234
16,"16244",735,615,606,3,9,"P.S.O.E.",158
37,"37033",86,64,63,1,1,"P.S.O.E.",11
37,"37193",432,310,309,5,1,"P.S.O.E.",137
44,"44114",254,194,188,4,6,"P.S.O.E.",39
50,"50109",101,79,79,2,0,"P.S.O.E.",20
37,"37156",4319,3280,3233,28,47,"P.S.O.E.",756
33,"33052",758,526,518,2,8,"P.S.O.E.",219
24,"24210",532,329,328,2,1,"P.S.O.E.",122
40,"40112",2346,1848,1798,35,50,"P.S.O.E.",449
34,"34165",86,67,67,0,0,"P.S.O.E.",2
9,"9400",340,253,249,4,4,"P.S.O.E.",101
50,"50264",184,140,134,0,6,"P.S.O.E.",65
49,"49024",736,551,544,16,7,"P.S.O.E.",173
9,"9020",276,222,222,6,0,"P.S.O.E.",57
47,"47103",277,218,214,1,4,"P.S.O.E.",76
37,"37034",91,72,72,0,0,"P.S.O.E.",37
42,"42171",158,99,94,3,5,"P.S.O.E.",15
9,"9176",60,47,45,2,2,"P.S.O.E.",10
37,"37345",179,156,156,2,0,"P.S.O.E.",48
45,"45034",1375,1108,1079,18,29,"P.S.O.E.",403
31,"31145",173,129,127,2,2,"P.S.O.E.",27
45,"45132",1916,1487,1473,9,14,"P.S.O.E.",260
45,"45010",471,374,372,2,2,"P.S.O.E.",175
5,"5154",46,35,35,0,0,"P.S.O.E.",6
50,"50004",613,445,441,6,4,"P.S.O.E.",183
31,"31216",3911,2699,2653,82,46,"P.S.O.E.",666
16,"16063",97,81,81,0,0,"P.S.O.E.",22
9,"9356",57,38,37,1,1,"P.S.O.E.",8
38,"38001",17632,9601,9475,121,126,"P.S.O.E.",2998
49,"49225",172,130,129,0,1,"P.S.O.E.",29
5,"5121",250,181,178,1,3,"P.S.O.E.",49
41,"41061",2205,1798,1770,2,28,"P.S.O.E.",322
5,"5155",60,44,44,1,0,"P.S.O.E.",14
10,"10162",616,505,496,1,9,"P.S.O.E.",250
50,"50081",562,410,400,7,10,"P.S.O.E.",124
18,"18171",2093,1719,1704,10,15,"P.S.O.E.",736
42,"42205",99,70,70,0,0,"P.S.O.E.",20
40,"40070",137,91,91,0,0,"P.S.O.E.",19
11,"11024",6811,5241,5202,58,39,"P.S.O.E.",2422
50,"50034",923,634,617,10,17,"P.S.O.E.",259
37,"37284",334,256,254,1,2,"P.S.O.E.",92
39,"39038",1465,1065,1047,8,18,"P.S.O.E.",254
37,"37160",644,474,464,4,10,"P.S.O.E.",173
7,"7026",30036,16912,16661,294,251,"P.S.O.E.",6184
5,"5123",90,69,69,3,0,"P.S.O.E.",7
7,"7059",3011,2077,2012,22,65,"P.S.O.E.",526
40,"40210",110,71,67,1,4,"P.S.O.E.",10
9,"9329",117,80,79,1,1,"P.S.O.E.",27
50,"50285",635,452,445,8,7,"P.S.O.E.",137
24,"24012",291,196,194,2,2,"P.S.O.E.",46
46,"46140",379,314,313,0,1,"P.S.O.E.",54
40,"40072",170,134,132,1,2,"P.S.O.E.",40
30,"30016",149046,103847,102890,1031,957,"P.S.O.E.",20980
29,"29045",1750,1246,1239,6,7,"P.S.O.E.",408
9,"9267",135,118,118,3,0,"P.S.O.E.",14
3,"3097",973,791,779,6,12,"P.S.O.E.",221
49,"49042",271,216,216,1,0,"P.S.O.E.",54
34,"34070",182,138,137,1,1,"P.S.O.E.",51
49,"49178",679,469,461,9,8,"P.S.O.E.",114
37,"37238",102,77,76,0,1,"P.S.O.E.",25
47,"47081",57,44,44,1,0,"P.S.O.E.",24
24,"24027",1184,853,837,7,16,"P.S.O.E.",323
41,"41063",2678,1869,1853,22,16,"P.S.O.E.",994
12,"12131",92,78,78,1,0,"P.S.O.E.",13
40,"40073",425,371,367,3,4,"P.S.O.E.",104
34,"34057",483,365,357,2,8,"P.S.O.E.",99
29,"29027",2416,1907,1893,15,14,"P.S.O.E.",645
16,"16125",1734,1367,1350,12,17,"P.S.O.E.",395
49,"49003",896,650,647,11,3,"P.S.O.E.",174
40,"40138",2195,1758,1725,18,33,"P.S.O.E.",520
50,"50036",103,81,80,2,1,"P.S.O.E.",31
14,"14025",3061,2547,2517,13,30,"P.S.O.E.",969
29,"29072",3258,2484,2447,30,37,"P.S.O.E.",1083
49,"49079",110,93,92,2,1,"P.S.O.E.",21
34,"34174",213,179,178,4,1,"P.S.O.E.",36
6,"6113",2750,2143,2105,26,38,"P.S.O.E.",914
31,"31242",235,157,157,2,0,"P.S.O.E.",14
19,"19289",33,28,28,1,0,"P.S.O.E.",2
40,"40075",182,149,146,4,3,"P.S.O.E.",40
10,"10045",1119,884,859,5,25,"P.S.O.E.",458
38,"38006",35862,18726,18500,209,226,"P.S.O.E.",4391
24,"24136",596,465,463,12,2,"P.S.O.E.",125
44,"44122",1441,1009,990,21,19,"P.S.O.E.",368
24,"24057",1459,1121,1092,16,29,"P.S.O.E.",402
50,"50232",176,123,120,5,3,"P.S.O.E.",34
2,"2901",2223,1678,1667,19,11,"P.S.O.E.",585
49,"49181",386,308,307,2,1,"P.S.O.E.",45
45,"45189",655,510,502,3,8,"P.S.O.E.",153
34,"34101",54,44,44,0,0,"P.S.O.E.",14
42,"42092",89,60,60,0,0,"P.S.O.E.",12
37,"37365",172,152,149,2,3,"P.S.O.E.",32
40,"40046",99,81,78,2,3,"P.S.O.E.",28
5,"5061",264,222,214,5,8,"P.S.O.E.",59
10,"10208",141,118,118,1,0,"P.S.O.E.",79
40,"40172",34,27,26,0,1,"P.S.O.E.",3
26,"26033",183,157,156,2,1,"P.S.O.E.",70
9,"9411",174,104,103,1,1,"P.S.O.E.",29
18,"18074",297,245,245,5,0,"P.S.O.E.",126
9,"9321",1760,1338,1327,20,11,"P.S.O.E.",487
5,"5029",132,102,102,0,0,"P.S.O.E.",19
5,"5062",213,188,184,3,4,"P.S.O.E.",26
31,"31193",1312,969,948,33,21,"P.S.O.E.",92
7,"7054",19930,11186,11028,196,158,"P.S.O.E.",3313
46,"46071",488,418,402,10,16,"P.S.O.E.",137
34,"34088",219,179,177,4,2,"P.S.O.E.",50
31,"31162",53,35,34,1,1,"P.S.O.E.",6
24,"24191",112,88,88,1,0,"P.S.O.E.",26
37,"37058",68,44,44,0,0,"P.S.O.E.",8
50,"50096",49,35,35,0,0,"P.S.O.E.",13
10,"10062",421,332,325,3,7,"P.S.O.E.",187
11,"11020",163674,106898,106082,1655,816,"P.S.O.E.",32156
18,"18076",880,676,676,3,0,"P.S.O.E.",436
34,"34227",84,69,67,3,2,"P.S.O.E.",3
40,"40032",394,293,288,6,5,"P.S.O.E.",54
37,"37045",27,21,21,0,0,"P.S.O.E.",0
46,"46096",320,267,267,0,0,"P.S.O.E.",69
42,"42200",98,70,67,1,3,"P.S.O.E.",13
16,"16258",288,215,213,1,2,"P.S.O.E.",54
50,"50030",232,164,160,1,4,"P.S.O.E.",54
9,"9323",71,44,44,2,0,"P.S.O.E.",10
45,"45131",327,262,258,1,4,"P.S.O.E.",85
46,"46169",31753,24041,23802,270,239,"P.S.O.E.",7276
19,"19331",2497,1898,1847,19,51,"P.S.O.E.",599
19,"19217",85,57,54,2,3,"P.S.O.E.",24
50,"50292",138,117,115,4,2,"P.S.O.E.",16
42,"42008",69,50,50,0,0,"P.S.O.E.",9
22,"22113",512,357,353,8,4,"P.S.O.E.",122
34,"34179",32,21,21,0,0,"P.S.O.E.",0
44,"44249",58,40,40,1,0,"P.S.O.E.",18
16,"16263",936,730,719,8,11,"P.S.O.E.",279
46,"46097",890,674,662,2,12,"P.S.O.E.",170
22,"22130",9983,6691,6573,148,118,"P.S.O.E.",2193
46,"46073",1119,931,915,14,16,"P.S.O.E.",367
49,"49204",85,64,64,0,0,"P.S.O.E.",14
9,"9163",642,526,518,3,8,"P.S.O.E.",179
23,"23014",2529,2058,2039,13,19,"P.S.O.E.",929
26,"26065",57,43,43,0,0,"P.S.O.E.",6
40,"40099",61,52,52,2,0,"P.S.O.E.",9
9,"9295",78,54,53,0,1,"P.S.O.E.",3
9,"9046",41,30,30,0,0,"P.S.O.E.",6
5,"5174",81,71,71,1,0,"P.S.O.E.",9
45,"45109",3030,2507,2417,30,90,"P.S.O.E.",640
7,"7013",6525,4528,4409,78,119,"P.S.O.E.",753
45,"45145",2430,1866,1821,13,45,"P.S.O.E.",457
40,"40036",531,440,424,10,16,"P.S.O.E.",71
5,"5081",44,36,36,0,0,"P.S.O.E.",2
10,"10052",186,138,138,0,0,"P.S.O.E.",19
38,"38012",2535,1735,1716,11,19,"P.S.O.E.",540
44,"44004",450,334,332,2,2,"P.S.O.E.",113
47,"47115",306,248,248,2,0,"P.S.O.E.",63
29,"29024",414,271,261,6,10,"P.S.O.E.",108
44,"44042",139,87,87,0,0,"P.S.O.E.",32
50,"50100",355,273,266,3,7,"P.S.O.E.",115
24,"24183",900,571,567,10,4,"P.S.O.E.",184
22,"22172",613,463,452,6,11,"P.S.O.E.",89
9,"9103",247,201,200,2,1,"P.S.O.E.",74
18,"18907",1997,1627,1612,5,15,"P.S.O.E.",768
5,"5166",235,181,178,1,3,"P.S.O.E.",28
22,"22155",89,67,67,2,0,"P.S.O.E.",7
19,"19064",97,84,83,1,1,"P.S.O.E.",17
33,"33077",1351,938,931,7,7,"P.S.O.E.",214
37,"37051",90,72,72,0,0,"P.S.O.E.",30
18,"18181",253,183,182,0,1,"P.S.O.E.",26
16,"16212",286,229,226,3,3,"P.S.O.E.",97
5,"5036",136,107,106,0,1,"P.S.O.E.",11
45,"45025",1237,919,907,11,12,"P.S.O.E.",326
34,"34056",2147,1557,1535,21,22,"P.S.O.E.",401
47,"47126",49,43,42,1,1,"P.S.O.E.",1
19,"19263",34,27,27,0,0,"P.S.O.E.",10
10,"10150",374,331,328,2,3,"P.S.O.E.",203
49,"49015",259,213,208,2,5,"P.S.O.E.",67
29,"29100",2442,1834,1824,14,10,"P.S.O.E.",957
38,"38014",1446,1018,1007,8,11,"P.S.O.E.",181
50,"50123",428,335,332,9,3,"P.S.O.E.",130
7,"7005",6331,4128,4058,76,70,"P.S.O.E.",1310
30,"30024",57868,41894,41513,393,381,"P.S.O.E.",10042
31,"31189",1229,745,740,5,5,"P.S.O.E.",148
45,"45013",1870,1504,1486,5,18,"P.S.O.E.",442
42,"42208",23,15,15,1,0,"P.S.O.E.",0
9,"9196",161,111,110,0,1,"P.S.O.E.",50
19,"19325",127,105,102,4,3,"P.S.O.E.",20
34,"34221",190,143,143,3,0,"P.S.O.E.",52
40,"40183",148,127,127,0,0,"P.S.O.E.",3
29,"29901",41445,27372,27158,295,214,"P.S.O.E.",7051
16,"16084",49,36,35,0,1,"P.S.O.E.",16
10,"10210",599,453,452,3,1,"P.S.O.E.",195
31,"31109",1365,946,934,11,12,"P.S.O.E.",140
11,"11008",16655,11309,11189,184,120,"P.S.O.E.",3134
16,"16041",395,289,287,6,2,"P.S.O.E.",79
47,"47073",141,118,116,1,2,"P.S.O.E.",26
22,"22137",1164,850,839,14,11,"P.S.O.E.",367
3,"3080",1288,1116,1103,6,13,"P.S.O.E.",196
9,"9471",171,127,125,1,2,"P.S.O.E.",33
3,"3122",40476,29591,29265,341,326,"P.S.O.E.",7722
6,"6158",13094,9945,9753,131,192,"P.S.O.E.",3288
47,"47190",103,87,87,7,0,"P.S.O.E.",14
49,"49004",137,105,105,3,0,"P.S.O.E.",35
16,"16239",158,114,112,2,2,"P.S.O.E.",58
26,"26045",13,13,13,0,0,"P.S.O.E.",7
40,"40044",160,117,114,4,3,"P.S.O.E.",30
5,"5233",246,212,212,2,0,"P.S.O.E.",55
31,"31222",67,46,44,3,2,"P.S.O.E.",13
42,"42163",53,41,41,0,0,"P.S.O.E.",9
12,"12013",180,131,130,0,1,"P.S.O.E.",42
47,"47091",97,82,80,3,2,"P.S.O.E.",25
44,"44261",777,600,594,8,6,"P.S.O.E.",272
45,"45029",233,207,202,4,5,"P.S.O.E.",80
9,"9466",151,111,110,1,1,"P.S.O.E.",13
19,"19314",46,41,41,0,0,"P.S.O.E.",15
46,"46094",20341,15367,15222,152,145,"P.S.O.E.",3438
45,"45140",1087,885,867,6,18,"P.S.O.E.",391
44,"44023",13,11,11,0,0,"P.S.O.E.",2
31,"31151",77,49,49,2,0,"P.S.O.E.",10
19,"19213",72,60,60,1,0,"P.S.O.E.",16
24,"24143",515,376,373,6,3,"P.S.O.E.",156
49,"49020",323,275,272,1,3,"P.S.O.E.",86
47,"47013",118,97,97,2,0,"P.S.O.E.",51
47,"47092",123,100,99,2,1,"P.S.O.E.",23
50,"50280",370,296,291,5,5,"P.S.O.E.",115
16,"16143",20,14,13,1,1,"P.S.O.E.",2
18,"18021",16026,11376,11219,186,157,"P.S.O.E.",3542
29,"29085",156,116,113,0,3,"P.S.O.E.",53
5,"5214",46,23,23,1,0,"P.S.O.E.",4
38,"38041",6780,4905,4813,57,92,"P.S.O.E.",698
33,"33073",9341,5825,5773,69,52,"P.S.O.E.",1709
3,"3086",145,119,118,1,1,"P.S.O.E.",32
50,"50029",676,527,517,6,10,"P.S.O.E.",283
50,"50289",71,59,59,0,0,"P.S.O.E.",16
34,"34074",764,610,597,11,13,"P.S.O.E.",203
42,"42033",54,48,48,0,0,"P.S.O.E.",15
46,"46088",196,146,140,0,6,"P.S.O.E.",46
22,"22131",96,79,77,2,2,"P.S.O.E.",25
23,"23015",1476,1189,1179,10,10,"P.S.O.E.",631
42,"42019",562,392,383,9,9,"P.S.O.E.",108
31,"31163",2008,1458,1434,22,24,"P.S.O.E.",482
42,"42166",68,49,48,1,1,"P.S.O.E.",16
46,"46104",2012,1691,1676,9,15,"P.S.O.E.",454
46,"46177",4594,3576,3523,29,53,"P.S.O.E.",1154
24,"24073",521,385,382,4,3,"P.S.O.E.",138
6,"6088",12879,9362,9222,153,140,"P.S.O.E.",3363
16,"16225",89,69,68,1,1,"P.S.O.E.",13
34,"34104",274,224,224,4,0,"P.S.O.E.",52
42,"42063",69,53,53,4,0,"P.S.O.E.",14
19,"19305",166,130,130,0,0,"P.S.O.E.",40
9,"9472",58,46,46,0,0,"P.S.O.E.",11
40,"40903",102,75,75,0,0,"P.S.O.E.",8
33,"33044",180964,129466,128346,1888,1120,"P.S.O.E.",31185
44,"44014",2603,1965,1912,25,53,"P.S.O.E.",702
42,"42064",92,76,76,0,0,"P.S.O.E.",27
31,"31073",332,228,226,1,2,"P.S.O.E.",26
34,"34199",1354,1004,978,27,26,"P.S.O.E.",304
37,"37381",153,114,109,3,5,"P.S.O.E.",24
16,"16008",131,89,88,2,1,"P.S.O.E.",36
3,"3085",275,218,215,2,3,"P.S.O.E.",50
3,"3117",381,321,317,4,4,"P.S.O.E.",79
37,"37307",177,132,130,0,2,"P.S.O.E.",35
6,"6135",1094,898,890,14,8,"P.S.O.E.",291
30,"30013",7369,5780,5731,53,49,"P.S.O.E.",2227
7,"7023",3541,2414,2365,88,49,"P.S.O.E.",733
11,"11004",87610,53062,52639,828,423,"P.S.O.E.",14948
5,"5249",101,73,71,1,2,"P.S.O.E.",18
19,"19306",42,31,31,1,0,"P.S.O.E.",6
23,"23029",924,730,727,2,3,"P.S.O.E.",357
9,"9347",136,113,109,5,4,"P.S.O.E.",17
47,"47211",45,38,38,1,0,"P.S.O.E.",3
30,"30017",11683,9332,9233,95,99,"P.S.O.E.",2190
26,"26002",805,617,605,6,12,"P.S.O.E.",207
9,"9072",272,210,209,4,1,"P.S.O.E.",79
26,"26095",126,102,102,0,0,"P.S.O.E.",60
19,"19229",83,71,68,0,3,"P.S.O.E.",16
50,"50065",59,37,37,2,0,"P.S.O.E.",11
12,"12126",24420,18431,18136,231,295,"P.S.O.E.",5302
49,"49056",324,251,247,3,4,"P.S.O.E.",88
49,"49075",153,128,122,0,6,"P.S.O.E.",33
14,"14003",1289,1046,1026,12,20,"P.S.O.E.",491
6,"6093",4599,3658,3612,22,46,"P.S.O.E.",1540
3,"3119",15887,12128,11988,122,140,"P.S.O.E.",3101
3,"3131",181,161,157,1,4,"P.S.O.E.",43
44,"44198",205,160,160,5,0,"P.S.O.E.",53
29,"29090",1805,1265,1260,5,5,"P.S.O.E.",357
45,"45135",4437,3621,3550,44,71,"P.S.O.E.",1115
5,"5187",1833,1385,1361,16,24,"P.S.O.E.",400
10,"10122",253,197,191,2,6,"P.S.O.E.",80
33,"33054",1780,1272,1263,8,9,"P.S.O.E.",430
45,"45111",65,47,44,1,3,"P.S.O.E.",12
24,"24079",1045,721,710,15,11,"P.S.O.E.",209
5,"5252",70,52,51,0,1,"P.S.O.E.",5
37,"37172",857,584,580,5,4,"P.S.O.E.",114
3,"3063",25410,18205,17989,208,216,"P.S.O.E.",5557
37,"37110",112,89,88,1,1,"P.S.O.E.",24
5,"5113",90,74,74,0,0,"P.S.O.E.",10
29,"29035",1717,1280,1270,14,10,"P.S.O.E.",708
40,"40231",128,102,100,3,2,"P.S.O.E.",32
19,"19299",94,75,75,0,0,"P.S.O.E.",24
44,"44020",23,15,15,0,0,"P.S.O.E.",0
37,"37067",2938,2306,2267,47,39,"P.S.O.E.",538
42,"42071",186,104,103,3,1,"P.S.O.E.",28
45,"45052",2793,2247,2212,38,35,"P.S.O.E.",526
3,"3133",40056,25746,25554,231,192,"P.S.O.E.",6973
10,"10110",2326,1751,1703,11,48,"P.S.O.E.",554
44,"44257",184,132,131,6,1,"P.S.O.E.",49
19,"19108",117,97,95,0,2,"P.S.O.E.",33
16,"16242",367,315,313,4,2,"P.S.O.E.",72
44,"44200",41,30,30,0,0,"P.S.O.E.",3
2,"2003",129078,98135,97009,1430,1126,"P.S.O.E.",23069
14,"14038",31501,23683,23394,336,289,"P.S.O.E.",7420
9,"9463",261,205,205,1,0,"P.S.O.E.",60
3,"3121",20518,14464,14315,137,149,"P.S.O.E.",3504
16,"16270",192,156,155,0,1,"P.S.O.E.",36
42,"42215",821,561,545,19,16,"P.S.O.E.",201
10,"10161",76,59,59,1,0,"P.S.O.E.",14
29,"29086",814,538,536,9,2,"P.S.O.E.",215
9,"9044",54,45,45,1,0,"P.S.O.E.",9
14,"14070",1385,1131,1111,4,20,"P.S.O.E.",405
16,"16908",227,181,179,1,2,"P.S.O.E.",81
22,"22107",131,81,77,1,4,"P.S.O.E.",12
10,"10166",351,246,238,2,8,"P.S.O.E.",86
19,"19301",47,38,38,0,0,"P.S.O.E.",2
30,"30009",11961,9992,9880,92,112,"P.S.O.E.",2546
22,"22141",129,103,102,3,1,"P.S.O.E.",24
12,"12025",146,106,105,0,1,"P.S.O.E.",26
3,"3089",9696,7447,7302,83,145,"P.S.O.E.",2048
10,"10194",557,449,440,0,9,"P.S.O.E.",145
40,"40200",47,41,39,0,2,"P.S.O.E.",11
26,"26059",1137,887,869,9,18,"P.S.O.E.",263
16,"16187",78,61,60,3,1,"P.S.O.E.",17
44,"44063",82,55,55,2,0,"P.S.O.E.",25
26,"26005",2251,1602,1580,18,22,"P.S.O.E.",455
9,"9066",62,44,42,0,2,"P.S.O.E.",16
26,"26073",100,85,84,1,1,"P.S.O.E.",35
40,"40215",109,94,91,0,3,"P.S.O.E.",9
24,"24176",336,267,261,3,6,"P.S.O.E.",53
45,"45083",421,353,345,0,8,"P.S.O.E.",75
30,"30004",1164,958,952,1,6,"P.S.O.E.",326
40,"40176",418,344,341,8,3,"P.S.O.E.",120
40,"40109",84,70,67,0,3,"P.S.O.E.",6
34,"34034",129,104,104,1,0,"P.S.O.E.",41
50,"50176",237,161,160,4,1,"P.S.O.E.",70
50,"50020",868,646,629,5,17,"P.S.O.E.",205
30,"30019",25722,18740,18553,164,187,"P.S.O.E.",4132
18,"18911",6796,4923,4867,74,56,"P.S.O.E.",1704
37,"37106",289,199,196,2,3,"P.S.O.E.",46
46,"46111",10589,7823,7710,94,113,"P.S.O.E.",2116
26,"26113",35,31,31,1,0,"P.S.O.E.",3
26,"26083",303,234,234,1,0,"P.S.O.E.",92
22,"22181",91,57,55,0,2,"P.S.O.E.",17
19,"19317",150,122,121,2,1,"P.S.O.E.",40
16,"16113",3075,2363,2338,36,25,"P.S.O.E.",766
9,"9009",167,129,128,8,1,"P.S.O.E.",24
16,"16165",84,70,70,0,0,"P.S.O.E.",35
37,"37092",1403,1034,1022,12,12,"P.S.O.E.",210
50,"50033",81,64,64,0,0,"P.S.O.E.",18
10,"10081",183,143,142,0,1,"P.S.O.E.",48
26,"26067",22,19,19,1,0,"P.S.O.E.",2
47,"47023",2863,2278,2258,38,20,"P.S.O.E.",574
29,"29040",1934,1344,1332,12,12,"P.S.O.E.",474
30,"30012",9037,7242,7142,62,100,"P.S.O.E.",2468
9,"9354",33,29,29,2,0,"P.S.O.E.",6
45,"45130",354,287,283,2,4,"P.S.O.E.",99
22,"22202",146,120,120,1,0,"P.S.O.E.",57
18,"18135",4752,3252,3212,34,40,"P.S.O.E.",1714
37,"37046",11929,8847,8683,146,164,"P.S.O.E.",2392
2,"2042",897,712,709,6,3,"P.S.O.E.",299
23,"23028",6428,4855,4802,26,53,"P.S.O.E.",2086
7,"7022",11700,7512,7371,128,141,"P.S.O.E.",1964
45,"45009",588,430,422,2,8,"P.S.O.E.",121
50,"50079",281,213,210,2,3,"P.S.O.E.",73
29,"29013",1718,1302,1283,4,19,"P.S.O.E.",605
16,"16191",1001,867,864,13,3,"P.S.O.E.",330
47,"47050",3557,2688,2651,50,37,"P.S.O.E.",823
39,"39044",3864,2940,2905,44,35,"P.S.O.E.",731
31,"31209",155,105,104,1,1,"P.S.O.E.",14
47,"47080",45,39,39,1,0,"P.S.O.E.",3
26,"26155",173,134,134,1,0,"P.S.O.E.",65
16,"16132",36,31,31,0,0,"P.S.O.E.",11
19,"19260",44,41,41,1,0,"P.S.O.E.",23
44,"44182",216,173,173,4,0,"P.S.O.E.",50
44,"44142",39,28,28,1,0,"P.S.O.E.",9
45,"45120",159,125,122,0,3,"P.S.O.E.",41
45,"45108",564,461,456,2,5,"P.S.O.E.",169
22,"22234",818,609,605,12,4,"P.S.O.E.",209
5,"5168",3682,2846,2801,43,45,"P.S.O.E.",562
37,"37369",143,103,103,0,0,"P.S.O.E.",27
19,"19020",52,39,39,3,0,"P.S.O.E.",5
22,"22175",211,158,158,9,0,"P.S.O.E.",50
34,"34031",29,26,26,0,0,"P.S.O.E.",4
50,"50180",111,91,89,3,2,"P.S.O.E.",17
49,"49267",101,77,77,1,0,"P.S.O.E.",24
37,"37287",341,247,246,1,1,"P.S.O.E.",51
19,"19268",34,26,25,0,1,"P.S.O.E.",11
5,"5902",319,262,262,0,0,"P.S.O.E.",63
37,"37331",234,161,161,3,0,"P.S.O.E.",30
44,"44220",137,97,96,1,1,"P.S.O.E.",19
34,"34177",170,147,143,2,4,"P.S.O.E.",45
50,"50111",191,141,138,2,3,"P.S.O.E.",50
39,"39063",1018,769,762,6,7,"P.S.O.E.",194
9,"9343",94,77,76,0,1,"P.S.O.E.",8
49,"49057",125,98,94,1,4,"P.S.O.E.",24
26,"26026",1344,1108,1096,14,12,"P.S.O.E.",378
44,"44237",450,352,343,5,9,"P.S.O.E.",144
47,"47196",43,29,29,0,0,"P.S.O.E.",1
50,"50063",76,67,67,0,0,"P.S.O.E.",32
40,"40134",769,628,620,19,8,"P.S.O.E.",207
9,"9314",113,89,88,4,1,"P.S.O.E.",22
5,"5156",260,188,185,0,3,"P.S.O.E.",25
9,"9088",77,40,40,0,0,"P.S.O.E.",10
42,"42055",183,128,127,4,1,"P.S.O.E.",46
3,"3052",984,837,820,10,17,"P.S.O.E.",180
23,"23017",1668,1392,1377,10,15,"P.S.O.E.",797
9,"9301",625,510,504,11,6,"P.S.O.E.",106
41,"41062",2252,1719,1698,12,21,"P.S.O.E.",1018
37,"37100",89,77,76,4,1,"P.S.O.E.",2
19,"19120",107,95,95,1,0,"P.S.O.E.",22
19,"19103",303,247,244,3,3,"P.S.O.E.",111
9,"9050",77,52,52,0,0,"P.S.O.E.",10
45,"45124",2183,1868,1823,20,45,"P.S.O.E.",638
5,"5157",256,187,183,0,4,"P.S.O.E.",61
24,"24118",132,96,96,2,0,"P.S.O.E.",59
44,"44007",194,152,145,3,7,"P.S.O.E.",35
18,"18038",1097,906,900,3,6,"P.S.O.E.",407
49,"49228",64,56,56,0,0,"P.S.O.E.",9
3,"3023",1425,1259,1233,11,26,"P.S.O.E.",454
3,"3134",159,129,126,0,3,"P.S.O.E.",34
9,"9064",353,277,277,6,0,"P.S.O.E.",37
12,"12094",807,612,604,14,8,"P.S.O.E.",254
24,"24174",525,393,387,6,6,"P.S.O.E.",153
31,"31139",172,97,97,1,0,"P.S.O.E.",10
10,"10139",117,98,97,1,1,"P.S.O.E.",36
26,"26079",690,568,562,5,6,"P.S.O.E.",124
33,"33061",446,260,259,1,1,"P.S.O.E.",100
40,"40131",48,41,41,0,0,"P.S.O.E.",9
31,"31258",7679,5561,5475,92,86,"P.S.O.E.",970
16,"16209",153,129,129,0,0,"P.S.O.E.",50
42,"42069",1591,1122,1114,33,8,"P.S.O.E.",356
50,"50205",98,72,71,2,1,"P.S.O.E.",33
46,"46023",318,275,267,2,8,"P.S.O.E.",74
5,"5256",119,101,100,0,1,"P.S.O.E.",26
31,"31130",319,213,209,1,4,"P.S.O.E.",17
23,"23051",2805,2312,2290,8,22,"P.S.O.E.",1003
19,"19311",87,60,60,0,0,"P.S.O.E.",13
24,"24175",1760,1324,1303,29,21,"P.S.O.E.",396
50,"50116",220,154,153,0,1,"P.S.O.E.",42
10,"10004",733,576,565,6,11,"P.S.O.E.",246
37,"37352",199,150,142,0,8,"P.S.O.E.",42
37,"37085",4334,3254,3201,69,53,"P.S.O.E.",629
44,"44163",119,91,91,0,0,"P.S.O.E.",43
22,"22162",135,107,107,3,0,"P.S.O.E.",24
42,"42178",144,105,104,3,1,"P.S.O.E.",15
39,"39067",901,628,623,1,5,"P.S.O.E.",158
38,"38018",4397,3216,3163,27,53,"P.S.O.E.",555
42,"42211",92,69,68,0,1,"P.S.O.E.",7
9,"9071",48,32,32,0,0,"P.S.O.E.",2
40,"40080",68,53,52,0,1,"P.S.O.E.",13
31,"31128",406,261,261,4,0,"P.S.O.E.",43
34,"34025",54,42,42,0,0,"P.S.O.E.",8
42,"42118",26,20,20,0,0,"P.S.O.E.",0
49,"49006",168,124,122,2,2,"P.S.O.E.",37
19,"19023",121,95,94,5,1,"P.S.O.E.",20
41,"41005",8792,6642,6585,71,57,"P.S.O.E.",3093
37,"37044",461,363,360,1,3,"P.S.O.E.",79
50,"50126",2473,1747,1724,41,23,"P.S.O.E.",470
40,"40068",39,32,32,0,0,"P.S.O.E.",1
22,"22904",908,660,653,14,7,"P.S.O.E.",236
12,"12038",195,135,134,8,1,"P.S.O.E.",26
19,"19107",349,289,288,1,1,"P.S.O.E.",89
9,"9180",132,97,95,8,2,"P.S.O.E.",24
44,"44245",274,189,184,1,5,"P.S.O.E.",48
37,"37052",274,213,212,1,1,"P.S.O.E.",92
46,"46084",1587,1363,1332,7,31,"P.S.O.E.",413
29,"29036",670,504,499,4,5,"P.S.O.E.",218
5,"5199",48,39,39,0,0,"P.S.O.E.",3
41,"41084",2875,2362,2335,9,27,"P.S.O.E.",1319
31,"31173",881,754,733,12,21,"P.S.O.E.",293
16,"16017",406,337,334,1,3,"P.S.O.E.",135
10,"10188",553,473,468,2,5,"P.S.O.E.",257
45,"45061",2523,1839,1813,20,26,"P.S.O.E.",623
5,"5129",153,98,95,0,3,"P.S.O.E.",2
44,"44001",69,48,47,0,1,"P.S.O.E.",10
16,"16072",161,126,123,0,3,"P.S.O.E.",45
45,"45142",7974,6294,6178,89,116,"P.S.O.E.",1721
10,"10131",12797,9017,8922,131,95,"P.S.O.E.",2502
9,"9413",500,335,331,1,4,"P.S.O.E.",75
40,"40190",50,41,40,1,1,"P.S.O.E.",5
31,"31195",186,127,126,1,1,"P.S.O.E.",6
45,"45106",7666,6045,5945,92,100,"P.S.O.E.",1974
37,"37089",74,54,54,2,0,"P.S.O.E.",7
5,"5260",114,101,101,1,0,"P.S.O.E.",15
3,"3104",26809,20511,20193,317,318,"P.S.O.E.",5938
44,"44041",67,56,51,1,5,"P.S.O.E.",23
3,"3105",5322,4218,4124,34,94,"P.S.O.E.",920
2,"2019",2455,2107,2077,16,30,"P.S.O.E.",938
9,"9346",95,83,83,1,0,"P.S.O.E.",16
34,"34245",322,240,236,3,4,"P.S.O.E.",57
22,"22129",193,124,123,4,1,"P.S.O.E.",40
23,"23018",2415,1791,1781,9,10,"P.S.O.E.",1055
24,"24185",512,414,402,3,12,"P.S.O.E.",126
10,"10105",2599,1869,1835,25,34,"P.S.O.E.",670
40,"40055",41,32,31,0,1,"P.S.O.E.",15
9,"9441",70,59,59,2,0,"P.S.O.E.",5
42,"42065",28,24,24,0,0,"P.S.O.E.",5
42,"42187",65,51,51,0,0,"P.S.O.E.",9
26,"26104",18,16,16,0,0,"P.S.O.E.",4
47,"47095",41,36,36,3,0,"P.S.O.E.",1
9,"9473",94,81,81,2,0,"P.S.O.E.",16
6,"6009",214,178,178,2,0,"P.S.O.E.",71
14,"14056",23507,17245,17071,259,174,"P.S.O.E.",7883
12,"12034",1509,1125,1097,10,28,"P.S.O.E.",420
46,"46149",398,307,305,1,2,"P.S.O.E.",80
23,"23019",1590,1355,1339,7,16,"P.S.O.E.",502
45,"45064",3801,2987,2953,38,34,"P.S.O.E.",738
39,"39080",3627,2743,2693,19,50,"P.S.O.E.",685
42,"42024",95,80,73,1,7,"P.S.O.E.",16
30,"30023",3572,2859,2811,22,48,"P.S.O.E.",754
26,"26039",44,38,36,1,2,"P.S.O.E.",8
11,"11002",4291,3388,3374,19,14,"P.S.O.E.",1605
9,"9159",57,49,48,0,1,"P.S.O.E.",5
31,"31136",438,283,283,10,0,"P.S.O.E.",32
26,"26066",277,229,228,9,1,"P.S.O.E.",59
41,"41102",14343,11050,10837,206,213,"P.S.O.E.",4462
14,"14023",2084,1809,1787,13,22,"P.S.O.E.",712
9,"9443",197,160,154,5,6,"P.S.O.E.",26
5,"5186",1670,1306,1287,9,19,"P.S.O.E.",243
5,"5218",148,123,117,1,6,"P.S.O.E.",27
50,"50902",97,85,85,1,0,"P.S.O.E.",17
42,"42105",54,45,45,0,0,"P.S.O.E.",1
19,"19042",41,32,32,0,0,"P.S.O.E.",12
5,"5197",114,98,98,1,0,"P.S.O.E.",16
44,"44225",129,100,98,5,2,"P.S.O.E.",41
23,"23003",8778,6945,6877,51,68,"P.S.O.E.",3327
14,"14054",13632,10857,10652,194,205,"P.S.O.E.",4299
10,"10163",374,310,308,0,2,"P.S.O.E.",106
37,"37315",99,77,75,3,2,"P.S.O.E.",9
19,"19109",53,40,40,1,0,"P.S.O.E.",3
6,"6064",900,715,706,2,9,"P.S.O.E.",330
14,"14051",1392,1148,1130,11,18,"P.S.O.E.",536
47,"47124",435,364,358,5,6,"P.S.O.E.",104
46,"46124",768,641,632,10,9,"P.S.O.E.",181
6,"6084",1105,932,917,5,15,"P.S.O.E.",342
46,"46205",14277,10882,10764,115,118,"P.S.O.E.",3065
37,"37025",264,217,216,1,1,"P.S.O.E.",62
10,"10178",797,604,597,5,7,"P.S.O.E.",215
44,"44266",134,107,105,2,2,"P.S.O.E.",15
14,"14048",1244,975,970,5,5,"P.S.O.E.",473
12,"12142",158,122,121,1,1,"P.S.O.E.",26
26,"26010",98,82,79,1,3,"P.S.O.E.",15
33,"33045",4692,3347,3297,42,50,"P.S.O.E.",1198
3,"3110",294,239,238,0,1,"P.S.O.E.",61
22,"22057",377,283,278,3,5,"P.S.O.E.",149
22,"22014",265,192,191,1,1,"P.S.O.E.",86
44,"44034",150,117,117,1,0,"P.S.O.E.",36
47,"47011",600,493,489,4,4,"P.S.O.E.",135
16,"16079",33,21,21,0,0,"P.S.O.E.",9
42,"42156",30,21,21,0,0,"P.S.O.E.",1
44,"44138",158,109,106,0,3,"P.S.O.E.",22
9,"9455",48,39,39,0,0,"P.S.O.E.",9
6,"6107",1610,1131,1128,6,3,"P.S.O.E.",626
26,"26149",67,50,49,1,1,"P.S.O.E.",27
45,"45126",278,188,187,0,1,"P.S.O.E.",69
37,"37114",92,75,74,1,1,"P.S.O.E.",28
16,"16904",508,413,407,10,6,"P.S.O.E.",133
19,"19119",93,80,79,2,1,"P.S.O.E.",20
9,"9464",44,28,28,0,0,"P.S.O.E.",1
50,"50125",421,284,280,1,4,"P.S.O.E.",99
24,"24069",53,44,44,0,0,"P.S.O.E.",7
50,"50212",52,48,48,0,0,"P.S.O.E.",21
24,"24189",5410,3630,3572,83,58,"P.S.O.E.",1090
44,"44048",77,59,59,0,0,"P.S.O.E.",25
44,"44096",173,139,133,4,6,"P.S.O.E.",46
49,"49047",120,91,90,1,1,"P.S.O.E.",21
12,"12048",293,208,205,2,3,"P.S.O.E.",69
42,"42045",345,238,234,2,4,"P.S.O.E.",69
16,"16091",86,66,66,1,0,"P.S.O.E.",31
37,"37269",475,383,382,2,1,"P.S.O.E.",144
45,"45139",231,198,194,0,4,"P.S.O.E.",98
9,"9444",81,54,52,1,2,"P.S.O.E.",2
12,"12033",1970,1547,1509,8,38,"P.S.O.E.",429
9,"9162",122,94,93,1,1,"P.S.O.E.",31
40,"40904",332,271,268,5,3,"P.S.O.E.",46
16,"16173",249,189,188,0,1,"P.S.O.E.",77
9,"9033",104,82,80,1,2,"P.S.O.E.",11
10,"10155",1156,829,819,4,10,"P.S.O.E.",350
37,"37349",136,105,104,2,1,"P.S.O.E.",6
44,"44222",136,99,99,2,0,"P.S.O.E.",24
6,"6055",2105,1623,1599,13,24,"P.S.O.E.",604
37,"37001",224,182,181,0,1,"P.S.O.E.",60
26,"26135",181,139,137,1,2,"P.S.O.E.",39
34,"34139",179,143,143,1,0,"P.S.O.E.",36
22,"22208",168,136,133,2,3,"P.S.O.E.",43
19,"19080",90,64,64,0,0,"P.S.O.E.",14
23,"23049",1942,1514,1486,16,28,"P.S.O.E.",701
50,"50035",78,61,56,2,5,"P.S.O.E.",10
24,"24187",881,664,659,14,5,"P.S.O.E.",167
50,"50026",459,360,354,5,6,"P.S.O.E.",160
16,"16279",251,175,172,1,3,"P.S.O.E.",55
29,"29003",1133,902,900,5,2,"P.S.O.E.",466
31,"31082",634,402,398,10,4,"P.S.O.E.",25
46,"46107",1998,1650,1623,8,27,"P.S.O.E.",555
30,"30002",9802,7628,7553,48,75,"P.S.O.E.",1847
45,"45148",340,256,256,1,0,"P.S.O.E.",88
26,"26178",88,74,73,1,1,"P.S.O.E.",28
46,"46015",7042,5644,5581,53,63,"P.S.O.E.",1567
42,"42153",19,16,16,0,0,"P.S.O.E.",2
45,"45045",1313,992,979,12,13,"P.S.O.E.",315
23,"23070",4142,2877,2846,20,31,"P.S.O.E.",1155
37,"37306",316,194,192,1,2,"P.S.O.E.",41
38,"38032",13032,8487,8357,101,130,"P.S.O.E.",2109
9,"9309",343,252,246,7,6,"P.S.O.E.",57
46,"46178",4406,3235,3201,22,34,"P.S.O.E.",583
26,"26092",112,89,88,2,1,"P.S.O.E.",23
40,"40004",534,428,420,3,8,"P.S.O.E.",130
47,"47123",456,356,353,10,3,"P.S.O.E.",97
7,"7020",3455,2491,2453,46,38,"P.S.O.E.",457
19,"19335",77,61,61,1,0,"P.S.O.E.",24
44,"44127",79,62,61,0,1,"P.S.O.E.",27
46,"46210",346,300,295,4,5,"P.S.O.E.",87
19,"19010",15,13,13,1,0,"P.S.O.E.",3
14,"14035",6153,4715,4656,51,59,"P.S.O.E.",1853
47,"47071",406,333,329,6,4,"P.S.O.E.",65
19,"19106",95,68,66,0,2,"P.S.O.E.",30
47,"47027",2680,2059,2024,23,35,"P.S.O.E.",660
45,"45144",839,701,691,11,10,"P.S.O.E.",281
47,"47075",4999,4020,3957,39,63,"P.S.O.E.",868
37,"37298",206,144,140,1,4,"P.S.O.E.",49
34,"34106",121,100,99,2,1,"P.S.O.E.",12
38,"38035",8172,4990,4919,62,71,"P.S.O.E.",1080
26,"26021",2758,2190,2163,21,27,"P.S.O.E.",656
46,"46165",6962,5390,5322,53,68,"P.S.O.E.",1262
3,"3075",160,139,136,2,3,"P.S.O.E.",27
49,"49193",503,365,357,4,8,"P.S.O.E.",83
12,"12045",388,301,286,2,15,"P.S.O.E.",135
9,"9330",1562,1212,1176,10,36,"P.S.O.E.",310
47,"47053",125,100,99,1,1,"P.S.O.E.",25
10,"10175",1509,1149,1127,4,22,"P.S.O.E.",421
18,"18165",3942,2819,2776,27,43,"P.S.O.E.",1175
10,"10215",437,338,333,3,5,"P.S.O.E.",166
30,"30037",17942,13830,13734,90,96,"P.S.O.E.",2333
44,"44019",75,38,37,0,1,"P.S.O.E.",10
38,"38051",7081,5298,5229,64,69,"P.S.O.E.",860
19,"19334",50,37,37,0,0,"P.S.O.E.",14
42,"42038",42,32,31,3,1,"P.S.O.E.",0
14,"14074",2387,2002,1995,26,7,"P.S.O.E.",1073
45,"45050",508,385,378,0,7,"P.S.O.E.",111
31,"31127",145,89,89,2,0,"P.S.O.E.",2
19,"19003",50,36,35,1,1,"P.S.O.E.",20
9,"9360",37,29,29,0,0,"P.S.O.E.",6
11,"11015",59476,38207,37898,501,309,"P.S.O.E.",11065
22,"22042",115,93,91,1,2,"P.S.O.E.",33
50,"50257",195,154,154,0,0,"P.S.O.E.",71
6,"6139",600,489,481,5,8,"P.S.O.E.",253
31,"31172",375,295,288,11,7,"P.S.O.E.",38
31,"31134",195,134,132,3,2,"P.S.O.E.",22
47,"47119",101,78,77,0,1,"P.S.O.E.",16
5,"5240",3351,2472,2428,22,44,"P.S.O.E.",593
37,"37261",255,191,191,2,0,"P.S.O.E.",46
40,"40024",920,712,704,7,8,"P.S.O.E.",163
10,"10213",605,478,477,1,1,"P.S.O.E.",199
42,"42168",128,82,81,4,1,"P.S.O.E.",27
45,"45033",407,302,295,3,7,"P.S.O.E.",106
26,"26051",271,219,214,4,5,"P.S.O.E.",46
33,"33067",802,650,639,12,11,"P.S.O.E.",266
33,"33022",992,709,696,12,13,"P.S.O.E.",278
47,"47076",16922,13030,12899,212,131,"P.S.O.E.",3945
16,"16231",47,43,43,0,0,"P.S.O.E.",10
9,"9425",561,431,418,3,13,"P.S.O.E.",164
40,"40053",116,92,90,1,2,"P.S.O.E.",24
37,"37083",190,165,165,3,0,"P.S.O.E.",63
26,"26145",251,201,199,3,2,"P.S.O.E.",59
45,"45151",631,474,470,1,4,"P.S.O.E.",178
6,"6156",1190,989,978,9,11,"P.S.O.E.",410
6,"6111",502,389,387,8,2,"P.S.O.E.",187
19,"19031",18,11,11,0,0,"P.S.O.E.",2
50,"50105",343,263,259,2,4,"P.S.O.E.",103
50,"50296",417,313,310,6,3,"P.S.O.E.",192
23,"23045",2180,1671,1667,3,4,"P.S.O.E.",674
31,"31233",103,87,82,2,5,"P.S.O.E.",20
16,"16217",113,95,92,0,3,"P.S.O.E.",15
24,"24121",645,511,502,10,9,"P.S.O.E.",158
3,"3093",19646,15399,15159,173,240,"P.S.O.E.",4076
49,"49128",617,480,474,10,6,"P.S.O.E.",180
23,"23038",3273,2658,2638,29,20,"P.S.O.E.",891
34,"34113",35,28,27,0,1,"P.S.O.E.",7
40,"40107",113,93,90,3,3,"P.S.O.E.",7
34,"34903",240,161,160,2,1,"P.S.O.E.",42
14,"14075",624,508,500,8,8,"P.S.O.E.",285
14,"14037",3500,2662,2616,29,46,"P.S.O.E.",1218
46,"46134",2326,1691,1664,20,27,"P.S.O.E.",486
7,"7045",1189,843,823,23,20,"P.S.O.E.",272
31,"31126",372,247,244,6,3,"P.S.O.E.",22
9,"9387",121,92,91,3,1,"P.S.O.E.",31
34,"34116",76,50,49,1,1,"P.S.O.E.",8
46,"46263",333,243,241,2,2,"P.S.O.E.",121
12,"12040",116573,84142,83078,1257,1064,"P.S.O.E.",23512
46,"46161",1454,1192,1179,8,13,"P.S.O.E.",380
26,"26077",15,15,15,1,0,"P.S.O.E.",2
9,"9134",237,164,159,7,5,"P.S.O.E.",47
40,"40211",72,65,65,1,0,"P.S.O.E.",17
29,"29055",1837,1478,1454,12,24,"P.S.O.E.",675
34,"34169",431,331,329,5,2,"P.S.O.E.",67
45,"45107",3006,2344,2299,32,45,"P.S.O.E.",580
34,"34023",5318,3947,3891,64,56,"P.S.O.E.",1392
10,"10078",451,349,341,3,8,"P.S.O.E.",147
44,"44012",389,297,293,5,4,"P.S.O.E.",97
23,"23031",771,649,646,6,3,"P.S.O.E.",418
18,"18016",339,254,253,2,1,"P.S.O.E.",123
45,"45037",1730,1325,1304,15,21,"P.S.O.E.",494
10,"10173",557,436,431,6,5,"P.S.O.E.",170
24,"24060",660,382,382,0,0,"P.S.O.E.",130
9,"9904",548,412,407,7,5,"P.S.O.E.",101
12,"12006",185,160,153,0,7,"P.S.O.E.",62
23,"23041",519,455,448,2,7,"P.S.O.E.",203
18,"18023",16072,11594,11488,131,106,"P.S.O.E.",4305
40,"40182",207,155,155,6,0,"P.S.O.E.",42
38,"38003",1446,1053,1044,4,9,"P.S.O.E.",388
50,"50113",653,528,526,9,2,"P.S.O.E.",232
46,"46902",425,333,332,3,1,"P.S.O.E.",165
45,"45119",3274,2279,2236,37,43,"P.S.O.E.",500
49,"49203",345,294,292,4,2,"P.S.O.E.",93
40,"40100",303,241,231,5,10,"P.S.O.E.",41
19,"19074",81,69,69,0,0,"P.S.O.E.",28
39,"39001",2146,1669,1645,20,24,"P.S.O.E.",340
9,"9440",105,80,80,0,0,"P.S.O.E.",24
50,"50022",548,430,416,10,14,"P.S.O.E.",118
46,"46154",836,684,678,7,6,"P.S.O.E.",142
46,"46032",5583,4342,4287,39,55,"P.S.O.E.",1157
26,"26049",189,141,137,1,4,"P.S.O.E.",25
16,"16081",64,46,45,1,1,"P.S.O.E.",12
50,"50091",56,39,39,1,0,"P.S.O.E.",6
49,"49041",443,337,334,7,3,"P.S.O.E.",145
34,"34053",222,177,172,4,5,"P.S.O.E.",54
6,"6072",2370,1907,1885,9,22,"P.S.O.E.",785
47,"47038",128,91,91,0,0,"P.S.O.E.",27
45,"45127",739,550,538,5,12,"P.S.O.E.",105
42,"42194",200,165,163,4,2,"P.S.O.E.",52
44,"44167",41,31,31,1,0,"P.S.O.E.",13
50,"50024",652,541,531,8,10,"P.S.O.E.",264
29,"29089",3343,2514,2489,14,25,"P.S.O.E.",1040
16,"16194",298,238,238,1,0,"P.S.O.E.",121
31,"31215",4618,3384,3315,54,69,"P.S.O.E.",1190
24,"24160",741,545,539,17,6,"P.S.O.E.",128
37,"37037",130,100,99,0,1,"P.S.O.E.",19
42,"42185",29,23,23,1,0,"P.S.O.E.",6
22,"22117",2585,1880,1848,57,32,"P.S.O.E.",564
10,"10203",4770,3397,3327,40,70,"P.S.O.E.",1039
12,"12008",236,203,199,4,4,"P.S.O.E.",64
14,"14060",4843,3857,3787,47,70,"P.S.O.E.",1936
18,"18020",1473,1111,1106,7,5,"P.S.O.E.",593
41,"41079",9349,7095,7001,71,94,"P.S.O.E.",3728
31,"31253",123,102,97,0,5,"P.S.O.E.",11
9,"9211",1489,1137,1121,28,16,"P.S.O.E.",271
38,"38024",14851,9589,9399,93,190,"P.S.O.E.",1918
50,"50903",2234,1622,1597,35,25,"P.S.O.E.",454
5,"5094",158,124,124,3,0,"P.S.O.E.",6
40,"40170",1383,1091,1072,11,19,"P.S.O.E.",257
47,"47165",7036,5328,5258,67,70,"P.S.O.E.",1716
31,"31090",156,77,77,0,0,"P.S.O.E.",1
5,"5246",68,57,56,1,1,"P.S.O.E.",13
49,"49124",279,203,202,2,1,"P.S.O.E.",55
9,"9019",153,104,104,1,0,"P.S.O.E.",26
47,"47040",67,51,50,0,1,"P.S.O.E.",7
30,"30011",4687,3776,3726,20,50,"P.S.O.E.",934
5,"5162",107,71,71,0,0,"P.S.O.E.",21
5,"5014",5559,4197,4101,53,96,"P.S.O.E.",1242
23,"23037",513,430,424,3,6,"P.S.O.E.",240
2,"2047",109,94,94,0,0,"P.S.O.E.",10
45,"45021",2399,1834,1804,23,30,"P.S.O.E.",530
9,"9369",460,339,336,4,3,"P.S.O.E.",121
33,"33037",37135,25522,25262,291,260,"P.S.O.E.",7591
24,"24003",725,528,520,8,8,"P.S.O.E.",185
33,"33057",1635,1150,1132,16,18,"P.S.O.E.",416
33,"33059",5049,3480,3447,37,33,"P.S.O.E.",883
31,"31204",45,35,34,0,1,"P.S.O.E.",5
46,"46121",116,103,101,0,2,"P.S.O.E.",40
5,"5237",198,157,155,3,2,"P.S.O.E.",17
46,"46102",19880,15358,15179,122,179,"P.S.O.E.",5352
16,"16205",126,94,93,0,1,"P.S.O.E.",19
14,"14071",1025,739,733,8,6,"P.S.O.E.",386
16,"16167",357,318,315,5,3,"P.S.O.E.",151
19,"19203",35,27,27,0,0,"P.S.O.E.",10
19,"19099",337,211,210,6,1,"P.S.O.E.",79
16,"16243",451,395,388,3,7,"P.S.O.E.",131
2,"2005",602,490,488,2,2,"P.S.O.E.",174
38,"38901",1389,917,907,16,10,"P.S.O.E.",277
26,"26081",23,17,17,0,0,"P.S.O.E.",0
9,"9414",197,159,159,2,0,"P.S.O.E.",43
31,"31133",48,34,34,3,0,"P.S.O.E.",6
37,"37155",81,57,57,0,0,"P.S.O.E.",31
49,"49170",111,87,85,1,2,"P.S.O.E.",32
46,"46234",388,308,307,3,1,"P.S.O.E.",109
9,"9068",25,19,19,2,0,"P.S.O.E.",6
3,"3070",1962,1582,1552,8,30,"P.S.O.E.",440
47,"47142",172,132,131,2,1,"P.S.O.E.",25
7,"7034",971,724,708,10,16,"P.S.O.E.",178
18,"18006",4116,2862,2831,25,31,"P.S.O.E.",980
9,"9058",357,278,276,4,2,"P.S.O.E.",65
38,"38046",8848,6410,6301,75,109,"P.S.O.E.",1202
45,"45102",3539,2581,2533,23,48,"P.S.O.E.",626
31,"31219",93,75,73,1,2,"P.S.O.E.",26
14,"14024",1926,1557,1527,14,30,"P.S.O.E.",699
40,"40071",52,45,45,4,0,"P.S.O.E.",4
37,"37012",155,124,120,1,4,"P.S.O.E.",24
45,"45193",661,557,548,1,9,"P.S.O.E.",169
9,"9198",115,85,85,1,0,"P.S.O.E.",23
37,"37279",780,580,571,6,9,"P.S.O.E.",165
46,"46160",1976,1591,1570,21,21,"P.S.O.E.",568
9,"9334",52,40,39,1,1,"P.S.O.E.",15
10,"10202",665,533,523,7,10,"P.S.O.E.",232
9,"9062",52,33,32,1,1,"P.S.O.E.",12
46,"46170",3464,2944,2908,24,36,"P.S.O.E.",998
12,"12024",146,129,128,1,1,"P.S.O.E.",50
19,"19157",66,56,56,4,0,"P.S.O.E.",17
29,"29098",1312,1043,1036,22,7,"P.S.O.E.",562
11,"11018",1528,1194,1178,9,16,"P.S.O.E.",427
22,"22143",244,166,161,2,5,"P.S.O.E.",43
24,"24046",1002,704,696,20,8,"P.S.O.E.",287
41,"41006",2743,1972,1957,13,15,"P.S.O.E.",1226
42,"42050",29,20,20,1,0,"P.S.O.E.",2
50,"50094",1744,1220,1193,25,27,"P.S.O.E.",370
7,"7056",4701,3164,3090,55,74,"P.S.O.E.",684
46,"46089",2116,1653,1627,9,26,"P.S.O.E.",407
37,"37319",138,94,94,1,0,"P.S.O.E.",24
44,"44216",25877,18461,18057,467,404,"P.S.O.E.",4737
19,"19282",210,157,157,0,0,"P.S.O.E.",32
40,"40219",635,519,505,7,14,"P.S.O.E.",14
19,"19092",437,331,326,4,5,"P.S.O.E.",87
16,"16169",75,44,44,0,0,"P.S.O.E.",17
37,"37214",134,94,94,4,0,"P.S.O.E.",16
16,"16126",811,701,692,13,9,"P.S.O.E.",249
10,"10018",1761,1321,1296,17,25,"P.S.O.E.",697
12,"12051",520,382,376,1,6,"P.S.O.E.",45
16,"16058",120,103,102,1,1,"P.S.O.E.",46
37,"37167",164,140,132,6,8,"P.S.O.E.",58
40,"40079",236,174,171,0,3,"P.S.O.E.",41
45,"45078",1451,1243,1228,7,15,"P.S.O.E.",434
44,"44026",89,69,69,0,0,"P.S.O.E.",18
41,"41042",5902,4572,4509,37,63,"P.S.O.E.",2711
22,"22009",704,488,473,15,15,"P.S.O.E.",212
5,"5200",56,43,42,0,1,"P.S.O.E.",5
47,"47047",217,171,170,5,1,"P.S.O.E.",21
31,"31256",113,64,64,0,0,"P.S.O.E.",4
31,"31226",597,339,335,2,4,"P.S.O.E.",32
5,"5236",147,101,101,0,0,"P.S.O.E.",27
16,"16117",1130,871,857,8,14,"P.S.O.E.",342
22,"22149",321,244,241,5,3,"P.S.O.E.",105
37,"37074",172,136,135,1,1,"P.S.O.E.",64
50,"50037",140,110,103,3,7,"P.S.O.E.",22
9,"9325",217,151,148,1,3,"P.S.O.E.",32
44,"44039",255,189,189,5,0,"P.S.O.E.",32
37,"37028",175,130,125,1,5,"P.S.O.E.",19
12,"12028",12115,9084,8992,137,92,"P.S.O.E.",2150
24,"24130",468,343,337,6,6,"P.S.O.E.",95
37,"37188",198,164,160,7,4,"P.S.O.E.",34
16,"16248",887,733,710,20,23,"P.S.O.E.",222
23,"23075",3404,2800,2782,24,18,"P.S.O.E.",1372
16,"16103",310,263,259,4,4,"P.S.O.E.",68
37,"37305",206,153,152,4,1,"P.S.O.E.",34
22,"22177",101,79,75,1,4,"P.S.O.E.",15
49,"49155",105,85,85,0,0,"P.S.O.E.",15
26,"26105",2181,1712,1690,24,22,"P.S.O.E.",616
16,"16204",306,235,235,5,0,"P.S.O.E.",53
34,"34077",283,219,216,3,3,"P.S.O.E.",85
19,"19168",324,233,231,6,2,"P.S.O.E.",84
19,"19058",6455,5028,4933,63,95,"P.S.O.E.",1258
50,"50165",1880,1339,1274,49,65,"P.S.O.E.",426
31,"31170",46,40,39,3,1,"P.S.O.E.",5
5,"5026",229,193,192,2,1,"P.S.O.E.",33
37,"37301",78,58,58,0,0,"P.S.O.E.",13
31,"31239",302,229,224,7,5,"P.S.O.E.",21
19,"19059",84,60,60,0,0,"P.S.O.E.",11
26,"26058",151,114,109,1,5,"P.S.O.E.",20
24,"24163",3706,2760,2714,57,46,"P.S.O.E.",758
46,"46137",273,232,229,1,3,"P.S.O.E.",92
50,"50119",997,740,720,13,20,"P.S.O.E.",247
42,"42184",76,50,49,0,1,"P.S.O.E.",12
23,"23026",3872,3051,2994,23,57,"P.S.O.E.",1291
49,"49136",347,249,247,6,2,"P.S.O.E.",38
37,"37069",952,737,723,12,14,"P.S.O.E.",207
50,"50108",50,31,31,0,0,"P.S.O.E.",9
9,"9287",201,159,158,4,1,"P.S.O.E.",50
42,"42029",164,114,113,1,1,"P.S.O.E.",24
10,"10031",189,158,158,1,0,"P.S.O.E.",42
37,"37031",399,308,307,5,1,"P.S.O.E.",82
9,"9129",112,93,93,0,0,"P.S.O.E.",52
23,"23042",359,278,277,0,1,"P.S.O.E.",104
34,"34062",175,126,124,3,2,"P.S.O.E.",19
50,"50281",76,63,63,2,0,"P.S.O.E.",8
47,"47033",209,170,168,3,2,"P.S.O.E.",42
10,"10207",499,394,392,1,2,"P.S.O.E.",173
9,"9304",197,168,165,1,3,"P.S.O.E.",25
49,"49053",978,809,796,10,13,"P.S.O.E.",253
29,"29037",227,170,170,0,0,"P.S.O.E.",65
22,"22144",258,203,203,5,0,"P.S.O.E.",68
39,"39086",386,282,280,1,2,"P.S.O.E.",85
22,"22016",654,476,464,10,12,"P.S.O.E.",196
22,"22116",1571,1127,1114,37,13,"P.S.O.E.",405
5,"5170",63,50,50,0,0,"P.S.O.E.",9
44,"44071",657,453,448,9,5,"P.S.O.E.",159
37,"37240",781,552,540,10,12,"P.S.O.E.",112
9,"9422",24,18,16,0,2,"P.S.O.E.",1
45,"45081",16099,12232,12079,154,153,"P.S.O.E.",3036
40,"40110",391,303,302,6,1,"P.S.O.E.",99
46,"46085",11344,8526,8426,87,100,"P.S.O.E.",2262
29,"29050",483,341,340,1,1,"P.S.O.E.",160
7,"7055",7000,4471,4379,67,92,"P.S.O.E.",1174
38,"38028",22003,14876,14589,158,287,"P.S.O.E.",4297
6,"6033",1387,1075,1068,6,7,"P.S.O.E.",433
49,"49263",69,54,54,2,0,"P.S.O.E.",6
42,"42162",2482,1871,1850,23,21,"P.S.O.E.",411
16,"16140",34,27,27,0,0,"P.S.O.E.",13
2,"2074",6093,4630,4548,57,82,"P.S.O.E.",1709
9,"9065",152,137,137,1,0,"P.S.O.E.",49
19,"19330",93,81,81,2,0,"P.S.O.E.",34
16,"16272",273,215,215,2,0,"P.S.O.E.",50
19,"19169",51,35,35,0,0,"P.S.O.E.",23
37,"37376",2373,1720,1700,23,20,"P.S.O.E.",374
45,"45040",1504,1058,1046,5,12,"P.S.O.E.",288
19,"19097",28,27,27,0,0,"P.S.O.E.",3
49,"49032",369,295,291,0,4,"P.S.O.E.",80
44,"44010",189,138,138,2,0,"P.S.O.E.",42
47,"47029",61,54,53,0,1,"P.S.O.E.",7
44,"44009",805,608,595,18,13,"P.S.O.E.",256
44,"44217",37,28,27,0,1,"P.S.O.E.",11
44,"44109",123,86,84,2,2,"P.S.O.E.",44
24,"24151",514,391,387,6,4,"P.S.O.E.",126
14,"14007",15871,11609,11477,121,132,"P.S.O.E.",5228
31,"31181",168,121,119,3,2,"P.S.O.E.",19
16,"16112",1562,1159,1140,12,19,"P.S.O.E.",495
5,"5266",112,92,89,0,3,"P.S.O.E.",9
29,"29038",16309,10579,10494,152,85,"P.S.O.E.",3791
9,"9026",384,296,295,8,1,"P.S.O.E.",85
26,"26072",310,270,264,4,6,"P.S.O.E.",112
3,"3112",684,566,561,4,5,"P.S.O.E.",158
16,"16141",161,132,131,1,1,"P.S.O.E.",50
21,"21040",3096,2370,2351,28,19,"PSOE",1145
21,"21039",313,233,232,2,1,"PSOE",141
28,"28010",9309,7304,7229,71,75,"PSOE",1464
28,"28064",143,112,110,1,2,"PSOE",15
4,"4027",260,186,186,0,0,"PSOE",52
13,"13098",2265,1805,1759,19,46,"PSOE",578
13,"13006",641,529,519,4,10,"PSOE",227
4,"4085",453,384,383,0,1,"PSOE",140
13,"13050",533,427,421,3,6,"PSOE",141
4,"4009",165,124,122,2,2,"PSOE",41
13,"13053",14718,10958,10766,159,192,"PSOE",3413
4,"4057",1454,1081,1071,1,10,"PSOE",494
4,"4094",206,152,152,0,0,"PSOE",21
4,"4045",1877,1512,1497,23,15,"PSOE",855
13,"13023",8731,6818,6732,94,86,"PSOE",1171
28,"28092",148714,112174,110838,1215,1336,"PSOE",32579
28,"28041",4006,3190,3154,45,36,"PSOE",612
13,"13021",459,358,355,5,3,"PSOE",134
21,"21016",1076,823,790,11,33,"PSOE",464
4,"4049",4981,3652,3630,34,22,"PSOE",1134
21,"21008",2717,1994,1978,11,16,"PSOE",1265
13,"13014",565,457,452,3,5,"PSOE",203
28,"28027",1232,937,919,9,18,"PSOE",228
28,"28005",132097,100509,99506,1069,1003,"PSOE",28604
13,"13084",973,800,793,6,7,"PSOE",370
4,"4902",42901,28927,28711,338,216,"PSOE",5890
13,"13078",9291,7062,6993,92,69,"PSOE",2411
21,"21035",9657,6943,6871,64,72,"PSOE",2871
13,"13010",910,729,726,8,3,"PSOE",304
21,"21076",2108,1647,1628,22,19,"PSOE",955
4,"4046",826,645,634,4,11,"PSOE",255
21,"21029",1633,1276,1259,15,17,"PSOE",571
21,"21026",255,181,169,2,12,"PSOE",93
13,"13087",22953,16674,16376,298,298,"PSOE",4847
21,"21060",11685,8026,7932,135,94,"PSOE",2894
13,"13039",14349,10928,10776,149,152,"PSOE",3158
21,"21056",2992,2172,2096,29,76,"PSOE",1232
4,"4020",361,265,263,1,2,"PSOE",109
4,"4072",339,272,271,0,1,"PSOE",98
13,"13066",2444,2094,2065,15,29,"PSOE",893
28,"28117",116,90,90,1,0,"PSOE",18
28,"28180",5179,4033,3975,18,58,"PSOE",1378
4,"4074",2731,1959,1936,26,23,"PSOE",647
28,"28043",5944,4199,4147,56,52,"PSOE",994
4,"4023",144,116,116,2,0,"PSOE",38
28,"28034",356,278,276,1,2,"PSOE",60
28,"28012",830,654,651,6,3,"PSOE",191
4,"4061",668,541,536,7,5,"PSOE",286
28,"28169",1244,971,962,8,9,"PSOE",199
21,"21021",11825,7657,7574,108,83,"PSOE",2496
28,"28109",1621,1121,1104,9,17,"PSOE",197
21,"21005",15205,11006,10909,108,97,"PSOE",4819
28,"28147",910,705,698,5,7,"PSOE",228
28,"28093",1911,1537,1518,19,19,"PSOE",350
4,"4053",12062,9283,9180,119,103,"PSOE",2723
28,"28127",60108,48418,48039,568,379,"PSOE",8065
28,"28007",122891,95200,94139,990,1061,"PSOE",27001
4,"4082",309,216,214,3,2,"PSOE",64
13,"13017",307,230,226,0,4,"PSOE",82
28,"28134",55921,42676,42221,505,455,"PSOE",11253
4,"4071",452,364,363,1,1,"PSOE",207
4,"4002",1146,891,884,1,7,"PSOE",454
4,"4068",187,137,137,1,0,"PSOE",50
4,"4010",602,492,491,10,1,"PSOE",268
28,"28128",366,280,275,2,5,"PSOE",88
28,"28162",2263,1802,1786,32,16,"PSOE",341
28,"28030",1591,1268,1230,12,38,"PSOE",324
28,"28018",3572,2837,2795,20,42,"PSOE",601
13,"13065",3011,2105,2088,24,17,"PSOE",612
13,"13042",953,704,693,5,11,"PSOE",255
13,"13031",2384,1908,1874,23,34,"PSOE",607
4,"4012",230,195,195,2,0,"PSOE",77
4,"4001",1139,890,884,6,6,"PSOE",373
28,"28071",77,57,55,0,2,"PSOE",7
28,"28179",1385,1039,1027,10,12,"PSOE",199
21,"21011",3531,2672,2639,15,33,"PSOE",1449
28,"28097",127,94,92,0,2,"PSOE",44
21,"21063",2624,2109,2097,13,12,"PSOE",1432
13,"13034",56981,42819,42306,742,513,"PSOE",9767
13,"13061",5898,4442,4373,56,69,"PSOE",1543
28,"28155",529,427,416,2,11,"PSOE",165
21,"21045",261,200,200,5,0,"PSOE",119
4,"4087",198,162,159,2,3,"PSOE",56
28,"28090",7899,6216,6131,60,85,"PSOE",1310
4,"4060",486,373,372,0,1,"PSOE",118
4,"4035",8213,6218,6171,51,47,"PSOE",1973
13,"13076",514,436,428,0,8,"PSOE",182
13,"13083",2529,1837,1795,26,42,"PSOE",485
28,"28022",30019,24469,24279,292,190,"PSOE",3678
4,"4093",1869,1341,1334,10,7,"PSOE",404
13,"13035",1043,794,770,10,24,"PSOE",357
21,"21046",1715,1354,1343,15,11,"PSOE",586
28,"28083",8037,6078,6025,66,53,"PSOE",1481
4,"4056",144,118,118,0,0,"PSOE",40
4,"4098",1616,1255,1249,7,6,"PSOE",580
28,"28181",20003,16133,15952,159,181,"PSOE",2712
28,"28165",1689,1310,1295,5,15,"PSOE",277
28,"28055",932,713,707,5,6,"PSOE",238
13,"13020",4805,3475,3434,40,41,"PSOE",1255
28,"28095",1358,1092,1077,8,15,"PSOE",224
28,"28028",1615,1204,1173,11,31,"PSOE",285
28,"28052",3799,2753,2719,17,34,"PSOE",558
13,"13001",1372,1087,1067,8,20,"PSOE",560
4,"4079",45851,31893,31644,430,249,"PSOE",7192
4,"4052",11567,8189,8124,158,65,"PSOE",2254
21,"21059",203,166,162,1,4,"PSOE",124
4,"4032",5476,3666,3643,34,23,"PSOE",1161
21,"21031",1309,903,871,9,32,"PSOE",422
28,"28074",136617,106248,105095,1101,1153,"PSOE",35250
28,"28100",3970,2903,2865,32,38,"PSOE",616
28,"28104",11704,9455,9361,119,94,"PSOE",1872
28,"28120",1259,946,931,11,15,"PSOE",303
13,"13043",251,208,206,1,2,"PSOE",66
13,"13064",1465,1127,1110,21,17,"PSOE",340
28,"28045",30286,23148,22879,226,269,"PSOE",5463
13,"13903",564,461,454,2,7,"PSOE",106
28,"28124",83,55,53,0,2,"PSOE",9
21,"21055",6320,4819,4760,46,59,"PSOE",1510
13,"13030",153,123,123,1,0,"PSOE",56
21,"21036",213,172,167,1,5,"PSOE",79
13,"13075",212,161,159,1,2,"PSOE",42
4,"4029",10682,7542,7474,63,68,"PSOE",2701
21,"21043",1898,1382,1350,9,32,"PSOE",754
4,"4063",1199,871,862,6,9,"PSOE",329
28,"28160",7496,5680,5613,46,67,"PSOE",1217
28,"28172",7648,6130,6076,65,54,"PSOE",1173
28,"28157",605,452,446,2,6,"PSOE",104
4,"4011",2814,2283,2263,25,20,"PSOE",1049
13,"13049",838,654,648,0,6,"PSOE",195
28,"28122",504,367,366,2,1,"PSOE",103
28,"28076",417,325,321,1,4,"PSOE",89
13,"13072",803,638,633,13,5,"PSOE",204
13,"13067",380,314,312,3,2,"PSOE",146
28,"28108",3002,2254,2228,31,26,"PSOE",499
28,"28069",51,35,33,1,2,"PSOE",4
28,"28136",618,527,516,2,11,"PSOE",135
4,"4017",1337,965,960,7,5,"PSOE",361
4,"4064",2585,1817,1803,18,14,"PSOE",507
13,"13057",1214,1018,998,9,20,"PSOE",351
21,"21070",6278,4489,4445,42,44,"PSOE",2121
13,"13085",2455,2146,2118,21,28,"PSOE",912
28,"28088",251,174,173,5,1,"PSOE",52
28,"28021",418,334,328,4,6,"PSOE",74
4,"4019",269,210,209,3,1,"PSOE",117
4,"4048",1459,1110,1100,11,10,"PSOE",443
21,"21077",1690,1335,1321,8,14,"PSOE",701
13,"13027",3582,2770,2715,25,55,"PSOE",974
13,"13068",1058,801,793,4,8,"PSOE",295
28,"28004",5761,4098,4044,38,54,"PSOE",965
4,"4008",530,423,418,4,5,"PSOE",120
28,"28065",118796,93292,92186,919,1106,"PSOE",29410
21,"21015",728,453,447,6,6,"PSOE",276
13,"13079",12220,9665,9502,177,163,"PSOE",3709
28,"28138",78,48,46,0,2,"PSOE",10
28,"28087",3150,2475,2453,26,22,"PSOE",554
4,"4005",631,531,524,6,7,"PSOE",205
21,"21001",628,434,428,5,6,"PSOE",260
4,"4004",458,367,364,6,3,"PSOE",202
28,"28033",3581,2712,2691,14,21,"PSOE",547
4,"4901",576,427,426,5,1,"PSOE",185
4,"4100",7918,5465,5425,52,40,"PSOE",1267
28,"28047",38404,28739,28436,312,303,"PSOE",7193
28,"28017",1120,905,888,8,17,"PSOE",186
21,"21072",10233,7829,7666,124,163,"PSOE",3402
13,"13024",938,703,699,3,4,"PSOE",228
21,"21032",1790,1362,1347,14,15,"PSOE",677
21,"21069",1778,1245,1242,11,3,"PSOE",706
28,"28044",5403,4245,4188,27,57,"PSOE",1002
4,"4038",3140,2258,2231,44,27,"PSOE",890
21,"21042",15246,8640,8572,154,68,"PSOE",2618
13,"13028",10536,8503,8331,140,172,"PSOE",2490
13,"13082",25643,17973,17798,257,175,"PSOE",4047
28,"28101",222,158,158,4,0,"PSOE",42
4,"4059",1231,837,830,8,7,"PSOE",456
28,"28014",31360,23434,23133,203,301,"PSOE",5674
13,"13025",321,257,254,1,3,"PSOE",99
21,"21018",1821,1283,1273,19,10,"PSOE",711
21,"21033",508,385,382,7,3,"PSOE",216
28,"28903",29222,23945,23689,296,256,"PSOE",5638
28,"28066",7033,5439,5383,45,56,"PSOE",879
28,"28110",1912,1492,1475,8,17,"PSOE",471
28,"28009",13466,10392,10286,102,106,"PSOE",2334
28,"28086",4603,3286,3248,29,38,"PSOE",729
13,"13008",473,362,360,4,2,"PSOE",115
13,"13045",744,615,608,6,7,"PSOE",192
13,"13094",338,276,275,2,1,"PSOE",79
28,"28026",5852,4506,4449,40,57,"PSOE",837
28,"28112",168,138,137,0,1,"PSOE",47
28,"28067",3893,2996,2950,26,46,"PSOE",894
28,"28042",1091,814,808,5,6,"PSOE",132
28,"28163",395,305,301,7,4,"PSOE",81
13,"13026",482,387,384,1,3,"PSOE",152
28,"28063",268,209,203,4,6,"PSOE",40
13,"13041",298,225,225,1,0,"PSOE",115
4,"4090",435,338,335,3,3,"PSOE",146
28,"28154",5232,3910,3860,40,50,"PSOE",1141
4,"4075",4783,3731,3700,33,31,"PSOE",1237
28,"28025",426,336,332,2,4,"PSOE",80
28,"28145",2125,1643,1620,15,23,"PSOE",492
28,"28040",15089,9976,9852,116,124,"PSOE",2636
21,"21028",419,320,315,3,5,"PSOE",181
21,"21049",3468,2327,2283,18,44,"PSOE",1138
13,"13005",23052,18002,17700,255,302,"PSOE",6097
28,"28059",4061,3169,3130,38,39,"PSOE",735
28,"28079",2290453,1721837,1705310,17342,16527,"PSOE",438654
28,"28143",81,71,67,1,4,"PSOE",13
21,"21079",749,556,553,6,3,"PSOE",303
21,"21067",418,318,312,5,6,"PSOE",204
21,"21007",6088,4174,4123,57,51,"PSOE",1792
13,"13012",475,322,318,1,4,"PSOE",152
21,"21062",1444,1003,991,7,12,"PSOE",482
28,"28019",1195,901,888,5,13,"PSOE",312
13,"13071",41043,28435,28183,370,252,"PSOE",10354
4,"4034",152,106,105,1,1,"PSOE",28
4,"4041",334,247,245,0,2,"PSOE",79
21,"21053",3278,2363,2325,20,38,"PSOE",1068
4,"4097",299,229,227,0,2,"PSOE",101
4,"4013",137455,94867,94142,1203,725,"PSOE",26202
28,"28131",12664,9454,9342,100,112,"PSOE",2018
28,"28148",79726,60405,59651,724,754,"PSOE",16269
13,"13038",1770,1397,1380,8,17,"PSOE",690
28,"28151",3025,2237,2185,9,52,"PSOE",680
28,"28158",632,505,495,4,10,"PSOE",89
4,"4078",1069,837,832,6,5,"PSOE",275
28,"28140",2665,2167,2141,26,26,"PSOE",446
13,"13059",232,186,184,0,2,"PSOE",80
13,"13092",1924,1655,1635,4,20,"PSOE",637
28,"28046",4208,3297,3272,31,25,"PSOE",760
4,"4092",2897,2351,2325,13,26,"PSOE",843
28,"28011",437,318,315,2,3,"PSOE",56
4,"4070",1649,1267,1255,9,12,"PSOE",490
4,"4028",239,212,207,0,5,"PSOE",127
28,"28141",5568,4097,4051,31,46,"PSOE",773
13,"13077",3654,2535,2480,31,55,"PSOE",956
4,"4055",418,368,367,5,1,"PSOE",184
13,"13097",2309,1843,1825,20,18,"PSOE",705
28,"28085",3794,2980,2933,18,47,"PSOE",911
4,"4044",1517,1232,1224,8,8,"PSOE",395
28,"28168",1144,821,810,15,11,"PSOE",226
4,"4022",375,296,295,0,1,"PSOE",144
28,"28057",1419,1084,1074,12,10,"PSOE",232
4,"4089",805,607,597,1,10,"PSOE",208
28,"28150",2985,2363,2345,21,18,"PSOE",461
28,"28006",74554,57439,56890,586,549,"PSOE",14051
28,"28129",7219,5536,5461,71,75,"PSOE",1206
21,"21025",3969,2731,2686,33,45,"PSOE",1244
4,"4015",149,115,115,0,0,"PSOE",48
28,"28023",4350,3425,3392,32,33,"PSOE",681
28,"28176",10977,8790,8718,68,72,"PSOE",1201
21,"21066",522,440,431,4,9,"PSOE",288
13,"13901",945,734,719,6,15,"PSOE",285
4,"4088",2516,1849,1832,7,17,"PSOE",796
28,"28183",935,663,649,7,14,"PSOE",157
21,"21073",1840,1249,1236,13,13,"PSOE",519
28,"28060",1471,1205,1192,8,13,"PSOE",499
13,"13013",7141,5682,5564,60,118,"PSOE",1559
28,"28137",1626,1231,1222,9,9,"PSOE",354
13,"13019",5254,4038,3978,62,60,"PSOE",899
28,"28058",137542,103880,102686,1155,1194,"PSOE",32526
28,"28038",4999,3659,3590,32,69,"PSOE",1026
28,"28089",3531,2786,2753,25,33,"PSOE",570
28,"28114",148,110,110,0,0,"PSOE",11
28,"28029",538,416,414,4,2,"PSOE",94
13,"13063",3839,2801,2771,31,30,"PSOE",878
28,"28107",443,338,333,7,5,"PSOE",111
28,"28003",196,154,151,2,3,"PSOE",45
28,"28170",2503,1744,1727,20,17,"PSOE",444
4,"4080",194,169,168,1,1,"PSOE",48
13,"13004",1130,937,923,6,14,"PSOE",408
13,"13052",6580,4869,4786,76,83,"PSOE",1398
13,"13074",1000,886,878,15,8,"PSOE",346
13,"13033",1719,1436,1419,6,17,"PSOE",790
21,"21004",1530,1059,1042,9,17,"PSOE",617
28,"28002",2650,2018,1993,24,25,"PSOE",454
28,"28166",325,269,268,8,1,"PSOE",90
28,"28106",72603,53231,52524,681,707,"PSOE",16172
28,"28072",5232,4065,4007,35,58,"PSOE",763
21,"21052",4741,2897,2839,21,58,"PSOE",1580
4,"4003",17244,11933,11840,94,93,"PSOE",3251
28,"28035",1314,1058,1046,3,12,"PSOE",311
13,"13089",1906,1610,1553,12,57,"PSOE",675
13,"13086",209,167,166,0,1,"PSOE",53
28,"28902",453,338,329,3,9,"PSOE",41
21,"21030",1757,1448,1426,14,22,"PSOE",758
4,"4026",75,58,58,0,0,"PSOE",9
28,"28054",10459,7798,7698,65,100,"PSOE",1731
13,"13060",291,235,229,0,6,"PSOE",89
21,"21051",272,202,201,5,1,"PSOE",112
28,"28032",4469,3412,3369,32,43,"PSOE",834
28,"28173",507,397,390,2,7,"PSOE",116
21,"21037",491,386,378,1,8,"PSOE",257
4,"4033",161,120,119,1,1,"PSOE",52
4,"4031",2495,1942,1931,13,11,"PSOE",893
28,"28167",7818,6016,5942,82,74,"PSOE",1599
28,"28031",1981,1524,1500,9,24,"PSOE",499
4,"4050",818,611,602,5,9,"PSOE",231
21,"21075",375,294,291,12,3,"PSOE",157
4,"4081",367,312,309,0,3,"PSOE",147
28,"28036",2301,1809,1784,13,25,"PSOE",340
13,"13011",5166,3555,3500,31,55,"PSOE",1244
13,"13016",708,555,553,2,2,"PSOE",177
4,"4095",777,547,541,8,6,"PSOE",221
28,"28084",15408,11489,11355,122,134,"PSOE",2997
28,"28061",19624,15082,14905,162,177,"PSOE",3213
21,"21013",10601,7384,7231,110,153,"PSOE",2795
21,"21003",691,540,536,7,4,"PSOE",396
28,"28056",782,604,586,6,18,"PSOE",115
28,"28068",10502,7857,7778,68,79,"PSOE",1737
28,"28115",57612,46786,46458,458,328,"PSOE",7315
4,"4036",246,205,204,1,1,"PSOE",80
28,"28164",2807,2194,2173,10,21,"PSOE",493
28,"28135",928,665,659,6,6,"PSOE",151
13,"13056",10945,8173,8070,111,103,"PSOE",2514
28,"28073",11899,8877,8769,112,108,"PSOE",2290
4,"4096",293,220,219,1,1,"PSOE",98
28,"28113",31318,23779,23436,271,343,"PSOE",6553
21,"21061",5089,3657,3635,33,22,"PSOE",1898
13,"13015",5755,4334,4293,40,41,"PSOE",1607
28,"28050",3576,2706,2663,21,43,"PSOE",499
28,"28016",86,68,67,3,1,"PSOE",21
21,"21057",1054,699,697,9,2,"PSOE",440
21,"21058",2609,1867,1857,15,10,"PSOE",1166
13,"13055",738,585,578,8,7,"PSOE",268
28,"28174",1745,1233,1224,11,9,"PSOE",297
21,"21020",398,282,282,3,0,"PSOE",162
28,"28132",10987,8066,7943,90,123,"PSOE",2370
4,"4062",4604,3711,3654,22,57,"PSOE",1503
13,"13070",769,653,640,1,13,"PSOE",245
28,"28049",59507,46919,46379,488,540,"PSOE",14555
13,"13047",5822,4735,4650,52,85,"PSOE",1698
13,"13029",102,90,89,0,1,"PSOE",25
28,"28171",4148,2972,2929,21,43,"PSOE",661
28,"28091",5202,3714,3671,34,43,"PSOE",1037
28,"28126",59,37,37,0,0,"PSOE",16
21,"21012",331,254,246,2,8,"PSOE",108
28,"28020",145,102,100,0,2,"PSOE",27
28,"28037",1598,1263,1250,10,13,"PSOE",508
13,"13093",4333,3281,3229,43,52,"PSOE",1007
21,"21068",1009,726,721,10,5,"PSOE",375
4,"4067",657,526,524,1,2,"PSOE",301
13,"13095",94,70,70,1,0,"PSOE",10
13,"13022",403,314,314,2,0,"PSOE",127
28,"28175",780,641,630,8,11,"PSOE",113
28,"28118",72,49,47,1,2,"PSOE",11
13,"13081",684,553,527,1,26,"PSOE",258
13,"13009",1573,1265,1255,6,10,"PSOE",369
28,"28119",1911,1527,1514,13,13,"PSOE",273
21,"21064",6331,4390,4352,46,38,"PSOE",1917
4,"4006",7156,5175,5106,51,69,"PSOE",1850
4,"4103",1555,1159,1157,8,2,"PSOE",380
4,"4101",3927,2827,2804,34,23,"PSOE",978
4,"4051",476,406,400,3,6,"PSOE",160
4,"4076",1325,1050,1041,7,9,"PSOE",496
4,"4030",1222,930,924,5,6,"PSOE",420
21,"21010",14308,8960,8861,154,99,"PSOE",3568
13,"13032",1218,926,922,9,4,"PSOE",417
28,"28051",1469,1147,1129,7,18,"PSOE",228
21,"21009",916,622,608,6,14,"PSOE",306
4,"4054",384,328,325,0,3,"PSOE",107
28,"28130",27391,21367,21111,235,256,"PSOE",6243
28,"28116",666,507,498,5,9,"PSOE",131
28,"28075",5127,3976,3916,42,60,"PSOE",936
4,"4084",370,290,285,6,5,"PSOE",116
13,"13088",649,531,526,3,5,"PSOE",216
28,"28161",44185,33371,32966,353,405,"PSOE",7354
28,"28133",5868,4236,4144,23,92,"PSOE",1267
4,"4091",380,322,318,3,4,"PSOE",191
28,"28015",14491,11562,11417,155,145,"PSOE",2343
28,"28159",629,482,478,2,4,"PSOE",106
13,"13048",538,441,433,5,8,"PSOE",138
28,"28149",5276,4132,4063,43,69,"PSOE",974
21,"21047",1965,1355,1325,17,30,"PSOE",527
28,"28177",9470,7524,7466,87,58,"PSOE",1392
4,"4099",5086,4023,3980,26,43,"PSOE",1323
21,"21022",173,123,123,1,0,"PSOE",69
13,"13902",497,396,394,3,2,"PSOE",146
21,"21017",3581,2416,2389,27,27,"PSOE",1345
28,"28153",608,422,406,1,16,"PSOE",109
28,"28152",14903,11954,11865,125,89,"PSOE",2008
28,"28082",5144,3967,3905,46,62,"PSOE",838
21,"21054",8024,6159,6072,67,87,"PSOE",1780
21,"21024",502,363,358,10,5,"PSOE",171
21,"21041",114169,74740,73814,1129,926,"PSOE",24734
13,"13080",418,310,309,1,1,"PSOE",139
4,"4021",188,157,157,2,0,"PSOE",75
28,"28111",618,486,479,2,7,"PSOE",114
13,"13007",1319,1069,1051,18,18,"PSOE",430
4,"4086",1903,1376,1371,11,5,"PSOE",455
21,"21019",645,464,458,2,6,"PSOE",231
13,"13046",786,654,644,2,10,"PSOE",312
21,"21038",1146,786,767,9,19,"PSOE",295
28,"28062",311,233,226,0,7,"PSOE",30
4,"4014",162,136,136,0,0,"PSOE",86
13,"13037",901,752,745,2,7,"PSOE",339
13,"13051",358,291,289,5,2,"PSOE",117
4,"4024",3049,2396,2361,19,35,"PSOE",806
28,"28096",16844,12441,12308,117,133,"PSOE",2825
4,"4073",389,289,286,4,3,"PSOE",98
28,"28048",489,398,389,3,9,"PSOE",141
28,"28013",38226,27886,27547,246,339,"PSOE",7778
4,"4007",791,599,599,5,0,"PSOE",272
21,"21014",4063,3424,3408,27,16,"PSOE",1761
4,"4077",343,313,313,1,0,"PSOE",119
28,"28121",185,153,152,0,1,"PSOE",39
21,"21048",327,226,226,5,0,"PSOE",143
28,"28125",2808,2077,2055,19,22,"PSOE",448
21,"21071",216,169,169,5,0,"PSOE",90
28,"28039",139,103,103,1,0,"PSOE",31
4,"4066",13570,9018,8963,97,55,"PSOE",2202
28,"28001",61,46,45,1,1,"PSOE",2
21,"21002",14281,10297,10173,141,124,"PSOE",2940
13,"13018",860,740,727,2,13,"PSOE",390
21,"21034",1253,875,861,7,14,"PSOE",449
4,"4016",2184,1699,1677,15,22,"PSOE",492
4,"4069",4729,3740,3706,52,34,"PSOE",1327
28,"28078",39,23,23,1,0,"PSOE",1
4,"4083",1933,1511,1497,16,14,"PSOE",694
4,"4903",4331,3183,3164,31,19,"PSOE",740
28,"28053",6035,4854,4783,61,71,"PSOE",1140
13,"13062",595,490,480,4,10,"PSOE",186
28,"28156",958,742,733,12,9,"PSOE",191
13,"13058",4155,3320,3285,24,35,"PSOE",1204
4,"4018",293,250,245,2,5,"PSOE",129
13,"13054",5032,3901,3824,70,77,"PSOE",1143
4,"4102",12940,9247,9152,90,95,"PSOE",2489
13,"13040",933,755,744,4,11,"PSOE",283
13,"13091",570,484,478,0,6,"PSOE",191
28,"28070",139,98,97,0,1,"PSOE",17
21,"21074",2752,1981,1968,15,13,"PSOE",1027
13,"13069",704,605,590,2,15,"PSOE",277
28,"28144",5663,4456,4410,47,46,"PSOE",916
21,"21065",295,212,211,0,1,"PSOE",78
4,"4037",1393,1090,1079,8,11,"PSOE",532
28,"28178",1017,799,791,11,8,"PSOE",182
4,"4065",387,320,318,1,2,"PSOE",152
28,"28182",219,179,178,2,1,"PSOE",42
21,"21023",2106,1471,1456,7,15,"PSOE",850
13,"13073",565,459,456,2,3,"PSOE",169
21,"21050",12322,8772,8679,99,93,"PSOE",3812
21,"21027",67,52,52,0,0,"PSOE",23
13,"13036",837,671,666,3,5,"PSOE",250
21,"21006",3565,2477,2441,29,36,"PSOE",1497
13,"13003",503,390,387,2,3,"PSOE",115
28,"28123",48429,38681,38187,429,494,"PSOE",10986
13,"13044",2747,1996,1950,20,46,"PSOE",692
4,"4047",2290,1956,1937,9,19,"PSOE",708
13,"13090",1202,994,972,4,22,"PSOE",455
13,"13002",1576,1143,1134,4,9,"PSOE",428
28,"28024",156,132,132,5,0,"PSOE",19
13,"13096",7716,5759,5659,70,100,"PSOE",1960
28,"28094",774,557,551,5,6,"PSOE",104
4,"4058",402,324,322,5,2,"PSOE",159
28,"28901",765,579,567,2,12,"PSOE",169
28,"28146",1672,1220,1205,4,15,"PSOE",387
13,"13904",556,448,441,14,7,"PSOE",171
21,"21078",2865,2085,2066,21,19,"PSOE",1044
28,"28102",913,700,693,9,7,"PSOE",270
28,"28099",1670,1258,1246,9,12,"PSOE",229
4,"4043",520,439,435,3,4,"PSOE",157
28,"28008",1734,1244,1221,11,23,"PSOE",303
28,"28080",45696,36832,36529,402,303,"PSOE",6051
21,"21044",17018,11390,11290,132,100,"PSOE",2921
17,"17022",6771,4247,4169,76,78,"PACMA",30
17,"17092",3520,2273,2228,42,45,"PACMA",21
8,"8278",4668,3033,2949,67,84,"PACMA",10
8,"8012",1694,1155,1136,32,19,"PACMA",2
8,"8308",145,116,115,1,1,"PACMA",0
17,"17073",1753,1320,1298,18,22,"PACMA",5
17,"17114",22610,14079,13811,263,268,"PACMA",61
17,"17158",404,266,264,3,2,"PACMA",2
8,"8135",6647,4753,4678,79,75,"PACMA",29
43,"43026",800,531,522,15,9,"PACMA",3
43,"43173",114,65,64,0,1,"PACMA",0
17,"17202",3799,2398,2366,44,32,"PACMA",23
43,"43108",1808,1183,1157,28,26,"PACMA",6
17,"17112",215,141,138,4,3,"PACMA",2
43,"43902",2761,1836,1811,25,25,"PACMA",3
8,"8120",6342,4801,4746,63,55,"PACMA",28
43,"43103",897,586,575,21,11,"PACMA",7
8,"8170",458,300,288,13,12,"PACMA",0
8,"8275",242,188,186,4,2,"PACMA",2
17,"17026",542,404,398,3,6,"PACMA",3
43,"43116",494,328,325,5,3,"PACMA",1
17,"17203",171,97,94,3,3,"PACMA",1
8,"8304",822,587,578,16,9,"PACMA",0
8,"8118",17077,11817,11598,203,219,"PACMA",104
17,"17078",346,231,226,3,5,"PACMA",2
43,"43049",805,555,536,6,19,"PACMA",1
17,"17002",567,413,401,4,12,"PACMA",2
8,"8094",1500,1102,1071,21,31,"PACMA",10
43,"43153",10307,6572,6450,94,122,"PACMA",49
17,"17105",257,152,146,4,6,"PACMA",0
8,"8302",9271,5981,5892,82,89,"PACMA",46
17,"17020",3446,2322,2268,45,54,"PACMA",18
43,"43048",830,547,530,16,17,"PACMA",0
17,"17184",1281,803,787,21,16,"PACMA",2
17,"17234",183,131,128,2,3,"PACMA",0
43,"43159",89,51,51,2,0,"PACMA",0
43,"43070",265,198,196,3,2,"PACMA",2
8,"8020",4542,3352,3298,77,54,"PACMA",16
8,"8073",60247,41448,40843,770,605,"PACMA",298
8,"8181",7722,5280,5188,112,92,"PACMA",38
8,"8288",1735,985,957,13,28,"PACMA",13
43,"43061",55,31,31,1,0,"PACMA",0
8,"8154",677,499,488,2,11,"PACMA",6
17,"17075",304,216,210,5,6,"PACMA",3
17,"17200",616,406,393,12,13,"PACMA",4
43,"43058",106,76,76,5,0,"PACMA",0
43,"43903",2368,1504,1492,22,12,"PACMA",3
43,"43042",2071,1504,1485,28,19,"PACMA",11
8,"8036",172,124,124,4,0,"PACMA",0
8,"8197",7316,4983,4926,69,57,"PACMA",36
43,"43034",494,355,344,8,11,"PACMA",4
8,"8140",4665,3160,3103,55,57,"PACMA",16
43,"43085",229,178,171,0,7,"PACMA",1
43,"43025",660,453,446,13,7,"PACMA",0
43,"43907",4122,2759,2712,52,47,"PACMA",25
43,"43172",378,268,266,8,2,"PACMA",1
43,"43906",2050,1332,1298,28,34,"PACMA",4
17,"17015",12254,7759,7553,143,206,"PACMA",47
17,"17225",208,138,134,1,4,"PACMA",1
17,"17060",378,240,233,1,7,"PACMA",1
43,"43050",2407,1528,1504,20,24,"PACMA",5
8,"8210",4176,2661,2579,54,82,"PACMA",19
43,"43017",141,98,98,2,0,"PACMA",0
43,"43027",177,129,128,6,1,"PACMA",0
17,"17128",309,232,224,5,8,"PACMA",1
8,"8129",444,278,271,2,7,"PACMA",6
8,"8224",771,538,528,26,10,"PACMA",0
8,"8155",6573,4411,4334,85,77,"PACMA",57
8,"8080",42,33,33,2,0,"PACMA",0
43,"43094",2209,1558,1524,31,34,"PACMA",4
17,"17069",395,276,267,2,9,"PACMA",1
8,"8281",4735,3239,3193,57,46,"PACMA",19
8,"8037",1830,1247,1209,40,38,"PACMA",11
17,"17052",134,84,83,2,1,"PACMA",1
43,"43089",272,193,185,1,8,"PACMA",0
17,"17210",527,358,349,9,9,"PACMA",3
43,"43118",439,318,313,7,5,"PACMA",1
43,"43169",477,377,364,8,13,"PACMA",3
43,"43082",383,282,270,8,12,"PACMA",1
8,"8035",12099,7838,7735,123,103,"PACMA",86
43,"43127",778,530,524,6,6,"PACMA",4
8,"8164",873,606,584,13,22,"PACMA",6
17,"17215",1918,1350,1321,40,29,"PACMA",13
8,"8042",2172,1459,1448,30,11,"PACMA",11
8,"8077",33925,23896,23548,381,348,"PACMA",166
8,"8117",2424,1685,1661,45,24,"PACMA",7
43,"43021",381,218,213,3,5,"PACMA",1
17,"17028",327,220,217,4,3,"PACMA",1
8,"8008",193,119,114,5,5,"PACMA",1
17,"17058",177,115,114,2,1,"PACMA",0
17,"17051",201,146,142,4,4,"PACMA",1
43,"43019",1356,868,837,13,31,"PACMA",7
8,"8033",12476,8513,8378,180,135,"PACMA",56
17,"17097",185,136,136,4,0,"PACMA",1
17,"17138",1010,677,662,3,15,"PACMA",6
17,"17198",404,264,259,9,5,"PACMA",2
8,"8030",4849,3466,3422,50,44,"PACMA",22
17,"17082",443,285,280,1,5,"PACMA",2
8,"8168",418,268,266,0,2,"PACMA",3
43,"43132",365,217,214,8,3,"PACMA",1
8,"8258",845,577,555,23,22,"PACMA",5
8,"8003",6983,5061,4993,53,68,"PACMA",43
8,"8046",12603,8826,8663,190,163,"PACMA",49
8,"8253",134,91,91,2,0,"PACMA",2
43,"43012",3392,2346,2295,48,51,"PACMA",21
17,"17043",159,101,100,2,1,"PACMA",1
8,"8201",458,305,298,12,7,"PACMA",0
43,"43135",327,243,238,2,5,"PACMA",1
17,"17063",169,113,111,5,2,"PACMA",1
8,"8160",313,227,222,8,5,"PACMA",3
17,"17177",563,398,388,7,10,"PACMA",1
8,"8251",4771,3214,3140,57,74,"PACMA",32
8,"8306",509,330,324,6,6,"PACMA",6
8,"8172",19889,13537,13333,267,204,"PACMA",106
17,"17046",738,510,498,15,12,"PACMA",1
8,"8102",27850,18716,18470,373,246,"PACMA",100
8,"8298",25338,16982,16690,353,292,"PACMA",89
17,"17132",1296,913,900,15,13,"PACMA",4
8,"8097",985,676,657,3,19,"PACMA",15
8,"8232",1793,1239,1220,20,19,"PACMA",5
8,"8902",3600,2518,2496,57,22,"PACMA",24
8,"8085",1033,731,720,10,11,"PACMA",5
43,"43131",4495,2842,2814,51,28,"PACMA",6
17,"17016",725,491,481,8,10,"PACMA",9
43,"43007",635,448,441,7,7,"PACMA",1
17,"17085",295,212,208,12,4,"PACMA",1
43,"43167",390,284,280,12,4,"PACMA",1
43,"43144",1187,787,772,12,15,"PACMA",12
43,"43030",454,321,307,5,14,"PACMA",3
8,"8177",52,31,31,1,0,"PACMA",0
43,"43117",150,118,115,1,3,"PACMA",0
8,"8089",33316,22369,22107,437,262,"PACMA",177
8,"8223",1855,1178,1155,19,23,"PACMA",7
43,"43140",2393,1612,1583,23,29,"PACMA",4
17,"17032",1613,933,918,11,15,"PACMA",7
8,"8261",2273,1547,1525,30,22,"PACMA",6
8,"8104",713,454,441,9,13,"PACMA",1
8,"8069",3028,2071,2029,36,42,"PACMA",19
8,"8171",2158,1385,1359,27,26,"PACMA",1
43,"43029",330,202,194,6,8,"PACMA",3
8,"8179",591,415,405,6,10,"PACMA",1
17,"17147",8385,5401,5325,105,76,"PACMA",51
17,"17042",415,297,292,2,5,"PACMA",4
43,"43036",836,503,494,4,9,"PACMA",13
17,"17164",4092,2409,2346,60,63,"PACMA",11
43,"43164",298,233,231,4,2,"PACMA",3
8,"8169",47505,31997,31566,555,431,"PACMA",275
8,"8048",622,461,454,9,7,"PACMA",2
8,"8159",13482,9173,9040,239,133,"PACMA",56
43,"43005",3559,2191,2147,47,44,"PACMA",17
8,"8194",24757,15009,14799,245,210,"PACMA",101
17,"17111",789,584,574,15,10,"PACMA",4
43,"43020",2119,1463,1427,26,36,"PACMA",10
17,"17145",1593,1090,1068,10,22,"PACMA",13
8,"8245",78826,51185,50445,962,740,"PACMA",337
43,"43110",307,216,214,5,2,"PACMA",0
17,"17168",393,285,281,8,4,"PACMA",1
17,"17139",1346,899,869,21,30,"PACMA",5
43,"43174",152,104,101,1,3,"PACMA",1
8,"8119",6039,3991,3884,74,107,"PACMA",32
17,"17140",684,476,470,10,6,"PACMA",4
8,"8099",808,533,519,11,14,"PACMA",1
17,"17211",864,628,612,12,16,"PACMA",4
17,"17098",311,208,202,4,6,"PACMA",0
8,"8203",2442,1526,1498,34,28,"PACMA",13
17,"17116",369,230,227,3,3,"PACMA",2
43,"43142",1155,730,714,20,16,"PACMA",2
8,"8180",26210,17504,17214,366,290,"PACMA",144
8,"8116",600,401,393,9,8,"PACMA",3
43,"43166",1521,1002,977,17,25,"PACMA",7
43,"43043",3065,1952,1919,39,33,"PACMA",17
8,"8137",255,190,190,3,0,"PACMA",0
43,"43126",1170,802,783,19,19,"PACMA",7
8,"8207",1718,1296,1256,28,40,"PACMA",8
8,"8093",32,21,20,0,1,"PACMA",0
43,"43001",706,481,473,12,8,"PACMA",8
43,"43098",362,251,247,1,4,"PACMA",5
8,"8183",4497,2914,2865,43,49,"PACMA",16
17,"17167",2818,1886,1858,52,28,"PACMA",11
8,"8209",6596,4415,4351,69,64,"PACMA",31
8,"8903",217,178,176,10,2,"PACMA",2
17,"17005",404,258,254,12,4,"PACMA",1
8,"8190",281,201,197,3,4,"PACMA",2
43,"43032",587,418,413,9,5,"PACMA",0
43,"43111",2096,1305,1281,19,24,"PACMA",11
8,"8109",200,155,153,1,2,"PACMA",0
17,"17086",1687,1148,1129,14,19,"PACMA",7
8,"8043",3067,2044,2023,29,21,"PACMA",6
8,"8040",10538,6916,6804,99,112,"PACMA",43
17,"17044",6619,4293,4187,69,106,"PACMA",29
43,"43028",2654,1620,1588,27,32,"PACMA",16
8,"8220",2277,1641,1604,44,37,"PACMA",3
43,"43121",636,385,371,6,14,"PACMA",1
43,"43137",1873,1241,1212,27,29,"PACMA",7
8,"8010",4124,2674,2611,44,63,"PACMA",9
43,"43046",114,80,79,5,1,"PACMA",3
17,"17027",2865,1955,1892,34,63,"PACMA",24
43,"43154",136,97,96,6,1,"PACMA",0
43,"43009",1421,913,897,18,16,"PACMA",10
8,"8256",669,498,496,16,2,"PACMA",6
8,"8260",17869,11898,11686,215,212,"PACMA",76
17,"17153",172,127,123,1,4,"PACMA",0
8,"8244",5746,4044,3940,102,104,"PACMA",33
43,"43084",573,383,378,6,5,"PACMA",3
8,"8061",1467,960,952,10,8,"PACMA",2
8,"8206",717,557,547,7,10,"PACMA",3
8,"8126",8299,5599,5508,103,91,"PACMA",53
17,"17901",964,628,621,16,7,"PACMA",7
17,"17135",380,273,269,9,4,"PACMA",1
8,"8217",24130,17554,17319,383,235,"PACMA",124
8,"8114",17629,11781,11579,189,202,"PACMA",81
17,"17173",174,121,119,1,2,"PACMA",0
43,"43178",1262,891,870,24,21,"PACMA",8
17,"17119",89,65,64,3,1,"PACMA",0
8,"8234",3143,2040,2008,45,32,"PACMA",25
8,"8277",134,90,90,4,0,"PACMA",1
8,"8200",61189,40677,40069,736,608,"PACMA",307
17,"17169",2460,1690,1651,34,39,"PACMA",21
17,"17196",209,139,138,6,1,"PACMA",3
17,"17176",141,96,95,3,1,"PACMA",1
17,"17193",3978,2365,2305,38,60,"PACMA",12
8,"8269",2613,1840,1814,32,26,"PACMA",10
8,"8255",132,83,82,1,1,"PACMA",1
8,"8041",10032,6880,6761,112,119,"PACMA",46
17,"17209",605,469,463,21,6,"PACMA",2
17,"17159",639,408,397,3,11,"PACMA",4
17,"17151",174,131,131,6,0,"PACMA",1
8,"8191",5520,3601,3536,64,65,"PACMA",19
17,"17228",280,172,170,4,2,"PACMA",1
17,"17062",5994,3686,3614,69,72,"PACMA",27
43,"43102",517,377,366,2,11,"PACMA",0
8,"8057",61,41,40,1,1,"PACMA",0
8,"8138",4014,2735,2679,46,56,"PACMA",10
43,"43002",1790,1252,1226,17,26,"PACMA",5
8,"8266",42860,30047,29521,536,526,"PACMA",252
43,"43059",264,185,185,4,0,"PACMA",1
43,"43003",307,187,184,10,3,"PACMA",1
17,"17074",490,345,342,5,3,"PACMA",5
17,"17204",539,349,347,10,2,"PACMA",0
43,"43152",472,355,351,9,4,"PACMA",0
17,"17106",140,105,104,0,1,"PACMA",2
17,"17183",261,178,176,2,2,"PACMA",2
43,"43113",454,321,316,10,5,"PACMA",2
8,"8285",10168,6582,6423,152,159,"PACMA",33
8,"8300",5621,4021,3933,94,88,"PACMA",34
43,"43101",146,94,93,3,1,"PACMA",0
17,"17115",281,209,207,5,2,"PACMA",4
17,"17094",1161,694,683,11,11,"PACMA",9
8,"8301",47343,32098,31664,672,434,"PACMA",203
17,"17186",3593,2358,2317,33,41,"PACMA",8
43,"43123",70216,45627,44828,906,799,"PACMA",285
8,"8230",7452,5349,5286,94,63,"PACMA",26
43,"43066",165,113,112,2,1,"PACMA",2
8,"8187",149633,104021,102629,1794,1392,"PACMA",779
43,"43065",443,278,270,8,8,"PACMA",0
17,"17061",175,123,123,4,0,"PACMA",0
8,"8039",365,264,260,5,4,"PACMA",4
17,"17205",198,146,138,3,8,"PACMA",0
8,"8006",10984,7255,7092,104,163,"PACMA",41
8,"8294",1870,1205,1171,22,34,"PACMA",19
17,"17206",167,108,107,2,1,"PACMA",1
8,"8221",11348,8413,8306,109,107,"PACMA",51
8,"8027",673,527,515,9,12,"PACMA",5
8,"8079",335,255,243,14,12,"PACMA",0
8,"8208",5471,3859,3792,82,67,"PACMA",34
8,"8293",246,145,145,4,0,"PACMA",0
8,"8078",224,154,151,2,3,"PACMA",0
43,"43160",1278,840,812,9,28,"PACMA",6
8,"8002",202,143,140,4,3,"PACMA",1
8,"8131",696,483,469,7,14,"PACMA",4
17,"17048",6176,3818,3773,52,45,"PACMA",23
17,"17141",5689,3485,3428,50,57,"PACMA",31
43,"43015",104,69,68,2,1,"PACMA",1
8,"8011",1754,1116,1085,29,31,"PACMA",4
43,"43133",5697,3470,3388,76,82,"PACMA",11
8,"8274",4887,3326,3279,36,47,"PACMA",9
17,"17208",1012,642,622,12,20,"PACMA",2
43,"43145",3968,2781,2742,52,39,"PACMA",19
17,"17149",366,254,251,4,3,"PACMA",1
17,"17011",625,472,467,5,5,"PACMA",1
43,"43156",4120,2811,2741,66,70,"PACMA",12
8,"8058",1699,1089,1061,25,28,"PACMA",8
43,"43011",1013,745,729,21,16,"PACMA",8
8,"8287",1053,738,730,26,8,"PACMA",10
17,"17100",201,140,135,1,5,"PACMA",1
8,"8113",52352,33606,33123,590,483,"PACMA",162
17,"17233",2192,1470,1434,33,36,"PACMA",9
8,"8049",1340,839,816,10,23,"PACMA",0
17,"17014",64,39,37,0,2,"PACMA",0
17,"17101",567,349,339,4,10,"PACMA",2
8,"8291",4516,2895,2855,56,40,"PACMA",31
43,"43099",330,240,236,4,4,"PACMA",0
43,"43091",142,106,98,5,8,"PACMA",2
17,"17038",343,261,256,2,5,"PACMA",1
8,"8161",10991,6841,6709,114,132,"PACMA",66
8,"8050",149,112,108,4,4,"PACMA",0
8,"8204",2991,2076,2040,45,36,"PACMA",13
17,"17050",645,438,425,15,13,"PACMA",3
8,"8087",158,133,132,6,1,"PACMA",1
8,"8282",6092,4478,4405,79,73,"PACMA",25
17,"17089",5486,3328,3288,43,40,"PACMA",27
8,"8060",167,102,101,0,1,"PACMA",0
8,"8034",741,542,529,4,13,"PACMA",5
43,"43170",880,601,592,9,9,"PACMA",4
8,"8202",12206,8265,8129,183,136,"PACMA",39
8,"8225",92,68,68,2,0,"PACMA",0
43,"43106",878,600,592,17,8,"PACMA",0
17,"17096",182,96,94,2,2,"PACMA",0
17,"17117",14022,8705,8595,129,110,"PACMA",50
8,"8222",1827,1343,1317,21,26,"PACMA",15
43,"43088",1810,1199,1177,29,22,"PACMA",10
43,"43069",194,131,127,3,4,"PACMA",0
43,"43904",2918,1779,1732,49,47,"PACMA",0
8,"8045",70,42,42,2,0,"PACMA",0
8,"8215",2594,1763,1728,51,35,"PACMA",6
43,"43122",92,65,61,0,4,"PACMA",0
43,"43139",2166,1319,1270,37,49,"PACMA",5
43,"43115",171,112,110,3,2,"PACMA",1
17,"17182",257,177,175,2,2,"PACMA",0
8,"8025",1460,990,963,14,27,"PACMA",11
8,"8273",2287,1594,1547,18,47,"PACMA",9
17,"17001",557,370,365,7,5,"PACMA",1
17,"17172",426,286,283,3,3,"PACMA",3
8,"8257",116,84,81,0,3,"PACMA",0
8,"8267",6215,4100,4011,82,89,"PACMA",31
17,"17031",172,94,93,1,1,"PACMA",1
8,"8250",7083,4485,4426,72,59,"PACMA",36
17,"17081",236,165,162,2,3,"PACMA",1
8,"8103",636,453,446,16,7,"PACMA",3
17,"17175",569,375,369,6,6,"PACMA",2
8,"8013",1234,834,820,23,14,"PACMA",6
17,"17134",235,149,148,3,1,"PACMA",0
8,"8185",189,131,126,1,5,"PACMA",0
8,"8022",12437,7598,7445,169,153,"PACMA",34
8,"8175",3477,2303,2270,39,33,"PACMA",6
43,"43162",4143,2892,2833,59,59,"PACMA",11
43,"43047",4064,2412,2352,50,60,"PACMA",13
43,"43063",588,358,350,13,8,"PACMA",0
17,"17019",1783,1264,1234,42,30,"PACMA",2
8,"8016",1984,1319,1289,26,30,"PACMA",7
8,"8044",4247,2763,2712,50,51,"PACMA",18
17,"17197",144,103,102,3,1,"PACMA",0
17,"17102",571,354,350,7,4,"PACMA",1
43,"43056",931,537,515,18,22,"PACMA",3
43,"43010",302,227,223,7,4,"PACMA",1
17,"17003",101,67,64,2,3,"PACMA",0
8,"8235",3627,2506,2467,35,39,"PACMA",11
8,"8038",1406,911,895,24,16,"PACMA",5
17,"17066",25667,15429,15157,244,272,"PACMA",106
43,"43031",1509,1016,992,20,24,"PACMA",6
8,"8068",6554,4323,4255,87,68,"PACMA",36
43,"43062",298,227,223,7,4,"PACMA",3
8,"8283",5862,3712,3618,72,94,"PACMA",25
8,"8219",14647,10347,10169,193,178,"PACMA",65
17,"17054",395,250,247,3,3,"PACMA",1
43,"43068",573,388,378,5,10,"PACMA",1
17,"17185",2273,1416,1379,32,37,"PACMA",6
43,"43125",1008,706,701,10,5,"PACMA",2
43,"43112",294,184,181,2,3,"PACMA",3
8,"8246",1714,1175,1153,27,22,"PACMA",6
17,"17077",580,374,372,5,2,"PACMA",2
8,"8149",985,683,671,11,12,"PACMA",7
17,"17192",145,107,105,4,2,"PACMA",0
8,"8032",1955,1330,1294,18,36,"PACMA",11
43,"43022",1559,1097,1074,22,23,"PACMA",0
8,"8271",74,45,44,3,1,"PACMA",0
8,"8086",13267,8791,8669,200,122,"PACMA",45
17,"17041",237,153,153,1,0,"PACMA",1
17,"17214",695,470,461,10,9,"PACMA",1
17,"17224",355,246,241,10,5,"PACMA",0
8,"8237",1692,1155,1127,22,28,"PACMA",2
17,"17040",506,320,316,7,4,"PACMA",2
43,"43074",1697,1150,1120,25,30,"PACMA",11
17,"17222",108,86,86,1,0,"PACMA",0
17,"17221",4135,2789,2723,49,66,"PACMA",18
8,"8295",10579,6896,6769,137,127,"PACMA",62
43,"43014",14146,9153,8915,204,238,"PACMA",26
8,"8158",2996,2012,1986,19,26,"PACMA",15
43,"43072",97,73,70,0,3,"PACMA",0
17,"17187",574,414,402,1,12,"PACMA",1
43,"43080",254,175,173,7,2,"PACMA",3
43,"43168",106,70,69,2,1,"PACMA",0
8,"8211",32035,23059,22687,453,372,"PACMA",175
8,"8108",4879,3475,3437,64,38,"PACMA",28
43,"43086",5269,3275,3196,92,79,"PACMA",23
43,"43136",10163,6312,6197,121,115,"PACMA",15
17,"17188",167,124,122,9,2,"PACMA",0
8,"8262",6835,4086,3993,94,93,"PACMA",36
43,"43163",24903,15475,15241,263,234,"PACMA",120
8,"8184",52133,33696,33220,656,476,"PACMA",293
8,"8174",409,294,292,10,2,"PACMA",0
8,"8297",138,99,99,2,0,"PACMA",1
17,"17007",1778,1137,1113,16,24,"PACMA",6
17,"17057",1010,640,634,19,6,"PACMA",8
17,"17107",301,203,200,8,3,"PACMA",1
43,"43096",103,81,77,3,4,"PACMA",0
43,"43078",841,557,547,7,10,"PACMA",2
43,"43155",22951,14114,13856,326,258,"PACMA",59
17,"17024",301,207,204,4,3,"PACMA",0
8,"8132",381,247,241,6,6,"PACMA",0
8,"8092",3928,2511,2473,33,38,"PACMA",12
8,"8167",5703,3896,3831,82,65,"PACMA",22
17,"17030",624,414,409,8,5,"PACMA",2
43,"43033",772,547,533,4,14,"PACMA",7
8,"8052",148,103,98,1,5,"PACMA",1
8,"8264",3983,2773,2744,30,29,"PACMA",25
17,"17018",478,337,332,8,5,"PACMA",4
17,"17025",1127,775,760,11,15,"PACMA",5
17,"17144",217,145,143,4,2,"PACMA",0
8,"8124",36292,24541,24210,471,331,"PACMA",183
17,"17084",269,177,175,4,2,"PACMA",1
8,"8247",903,627,608,10,19,"PACMA",4
17,"17130",333,236,233,5,3,"PACMA",1
8,"8150",245,181,178,11,3,"PACMA",2
17,"17178",1075,683,679,15,4,"PACMA",3
43,"43039",117,85,83,3,2,"PACMA",1
17,"17088",551,374,363,4,11,"PACMA",1
8,"8130",95,63,62,3,1,"PACMA",0
17,"17095",19245,11212,11067,160,145,"PACMA",99
8,"8081",332,232,225,2,7,"PACMA",2
8,"8084",1134,789,760,14,29,"PACMA",10
8,"8268",1110,768,755,17,13,"PACMA",8
43,"43067",626,445,431,21,14,"PACMA",0
17,"17012",1093,689,679,11,10,"PACMA",6
8,"8166",1138,726,706,10,20,"PACMA",1
43,"43901",8849,5651,5540,179,111,"PACMA",15
43,"43105",175,119,116,14,3,"PACMA",2
8,"8286",2865,1843,1796,30,47,"PACMA",22
8,"8192",5450,3688,3634,79,54,"PACMA",26
17,"17148",1546,980,957,24,23,"PACMA",6
17,"17213",5282,3097,3041,42,56,"PACMA",17
8,"8156",10672,7359,7225,121,134,"PACMA",67
17,"17049",3056,1986,1944,43,42,"PACMA",8
8,"8071",248,172,167,2,5,"PACMA",1
8,"8082",1143,733,723,17,10,"PACMA",9
17,"17163",2478,1729,1681,41,48,"PACMA",11
8,"8001",8538,5929,5838,120,91,"PACMA",38
17,"17195",324,220,214,6,6,"PACMA",3
43,"43054",2850,1815,1771,37,44,"PACMA",2
8,"8004",228,176,172,2,4,"PACMA",0
8,"8007",6338,4165,4050,89,115,"PACMA",43
43,"43107",378,255,248,18,7,"PACMA",0
43,"43076",467,308,300,7,8,"PACMA",4
8,"8263",20729,13742,13563,232,179,"PACMA",89
17,"17189",1536,1061,1025,7,36,"PACMA",14
8,"8063",434,336,333,8,3,"PACMA",6
8,"8153",502,357,350,7,7,"PACMA",0
17,"17071",1064,719,698,33,21,"PACMA",5
8,"8056",39345,26705,26396,449,309,"PACMA",229
17,"17068",252,156,156,4,0,"PACMA",1
17,"17103",4988,2788,2724,51,64,"PACMA",19
8,"8134",776,528,513,15,15,"PACMA",4
8,"8083",1626,1199,1178,23,21,"PACMA",6
8,"8189",141,113,111,4,2,"PACMA",0
43,"43177",338,242,236,6,6,"PACMA",6
17,"17218",568,361,350,11,11,"PACMA",2
17,"17008",3745,2262,2195,34,67,"PACMA",8
8,"8070",275,192,191,5,1,"PACMA",0
8,"8026",180,144,143,0,1,"PACMA",0
43,"43045",156,110,109,1,1,"PACMA",0
8,"8128",557,377,374,16,3,"PACMA",5
43,"43905",13621,8120,8011,131,109,"PACMA",79
8,"8241",80,61,61,1,0,"PACMA",0
17,"17216",158,100,97,1,3,"PACMA",1
8,"8115",3870,2693,2644,60,49,"PACMA",29
8,"8105",9642,6571,6483,110,88,"PACMA",45
17,"17154",93,54,49,1,5,"PACMA",1
17,"17056",1704,1171,1158,21,13,"PACMA",5
8,"8021",76,49,47,1,2,"PACMA",0
8,"8017",2740,1800,1768,38,32,"PACMA",16
43,"43176",832,575,572,16,3,"PACMA",6
8,"8136",11117,7602,7478,174,124,"PACMA",58
17,"17033",5157,3142,3095,44,47,"PACMA",26
8,"8075",3906,2442,2414,31,28,"PACMA",17
8,"8280",116,74,72,3,2,"PACMA",1
17,"17165",608,414,400,9,14,"PACMA",2
8,"8243",160,112,110,3,2,"PACMA",0
8,"8239",471,338,333,6,5,"PACMA",0
43,"43119",739,500,496,5,4,"PACMA",8
8,"8072",9910,6326,6235,140,91,"PACMA",51
8,"8133",157,100,97,2,3,"PACMA",0
43,"43073",90,57,57,1,0,"PACMA",0
8,"8062",863,595,583,8,12,"PACMA",3
8,"8005",5884,4114,4041,68,73,"PACMA",18
43,"43077",486,335,328,4,7,"PACMA",0
43,"43150",1337,994,977,12,17,"PACMA",2
43,"43161",17199,10765,10547,197,218,"PACMA",63
8,"8233",1867,1179,1169,29,10,"PACMA",6
17,"17047",4803,2866,2803,30,63,"PACMA",16
8,"8284",11920,7059,6942,139,117,"PACMA",64
8,"8193",928,565,554,15,11,"PACMA",4
8,"8157",8256,5729,5624,119,105,"PACMA",45
8,"8144",769,494,481,16,13,"PACMA",3
43,"43097",379,283,278,6,5,"PACMA",1
17,"17190",811,548,532,7,16,"PACMA",0
17,"17109",759,428,414,10,14,"PACMA",5
8,"8101",169663,112624,111107,1841,1517,"PACMA",727
8,"8091",5106,3379,3312,59,67,"PACMA",33
17,"17181",3228,2116,2081,19,35,"PACMA",13
43,"43071",975,677,664,14,13,"PACMA",1
8,"8064",1847,1277,1246,14,31,"PACMA",11
8,"8023",6546,4261,4194,86,67,"PACMA",35
8,"8047",4141,2610,2580,49,30,"PACMA",13
17,"17129",126,91,90,3,1,"PACMA",1
8,"8905",2268,1692,1657,28,35,"PACMA",20
17,"17207",2357,1636,1584,40,52,"PACMA",7
43,"43151",119,91,89,0,2,"PACMA",1
17,"17220",780,550,545,13,5,"PACMA",4
43,"43171",13906,8978,8855,167,123,"PACMA",51
43,"43143",62,51,50,1,1,"PACMA",0
8,"8088",11250,8019,7861,144,158,"PACMA",45
17,"17118",12541,7817,7681,130,136,"PACMA",74
17,"17227",107,82,82,1,0,"PACMA",1
8,"8029",3389,2542,2514,45,28,"PACMA",19
17,"17070",116,78,78,3,0,"PACMA",0
17,"17087",230,170,161,6,9,"PACMA",0
43,"43095",2434,1658,1624,27,34,"PACMA",17
43,"43120",454,287,283,1,4,"PACMA",0
43,"43057",45,27,27,2,0,"PACMA",0
8,"8196",18989,12658,12490,253,168,"PACMA",94
17,"17123",365,274,266,8,8,"PACMA",0
8,"8226",886,667,656,13,11,"PACMA",3
43,"43041",237,177,176,4,1,"PACMA",0
8,"8213",6188,4031,3970,113,61,"PACMA",23
43,"43128",927,636,625,11,11,"PACMA",3
17,"17021",108,86,79,0,7,"PACMA",0
8,"8227",2372,1591,1549,38,42,"PACMA",8
8,"8096",40650,28247,27784,527,463,"PACMA",176
8,"8053",2850,1788,1772,21,16,"PACMA",7
8,"8015",155673,101652,100264,1628,1388,"PACMA",779
17,"17126",309,231,229,9,2,"PACMA",2
8,"8265",1575,1065,1026,38,39,"PACMA",5
8,"8143",2679,1772,1756,35,16,"PACMA",7
8,"8059",323,189,186,9,3,"PACMA",2
8,"8009",8932,6188,6088,103,100,"PACMA",28
8,"8254",1721,1189,1174,26,15,"PACMA",2
43,"43129",4525,3032,2956,62,76,"PACMA",10
8,"8305",26208,17810,17506,296,304,"PACMA",128
17,"17161",978,693,687,21,6,"PACMA",4
17,"17199",6630,4242,4162,80,80,"PACMA",26
8,"8148",2240,1246,1223,22,23,"PACMA",15
17,"17223",787,523,514,8,9,"PACMA",4
8,"8176",166,111,109,0,2,"PACMA",0
8,"8162",1955,1306,1271,28,35,"PACMA",13
8,"8139",184,130,128,1,2,"PACMA",1
8,"8242",243,174,172,5,2,"PACMA",4
8,"8236",1507,1027,1002,18,25,"PACMA",4
17,"17903",893,565,556,14,9,"PACMA",3
43,"43109",2040,1332,1316,28,16,"PACMA",15
43,"43024",1459,958,937,17,21,"PACMA",3
43,"43146",45,33,30,1,3,"PACMA",0
8,"8276",249,188,187,9,1,"PACMA",1
17,"17142",2440,1713,1681,39,32,"PACMA",7
8,"8178",450,311,304,3,7,"PACMA",3
8,"8066",1315,985,965,16,20,"PACMA",8
43,"43081",574,415,404,13,11,"PACMA",1
43,"43100",3062,2058,2021,52,37,"PACMA",22
43,"43052",1001,669,636,12,33,"PACMA",7
8,"8289",4123,2802,2768,54,34,"PACMA",32
43,"43130",196,132,131,7,1,"PACMA",1
17,"17157",127,99,98,3,1,"PACMA",0
17,"17902",1330,898,874,11,24,"PACMA",5
43,"43004",6411,4089,4001,92,88,"PACMA",13
17,"17232",159,107,104,0,3,"PACMA",1
17,"17076",126,77,76,5,1,"PACMA",1
8,"8076",15925,10435,10242,179,193,"PACMA",87
17,"17137",3331,2163,2110,39,53,"PACMA",8
17,"17180",8076,4868,4767,81,101,"PACMA",29
8,"8270",17464,11828,11677,212,151,"PACMA",102
8,"8240",9104,6355,6262,101,93,"PACMA",23
17,"17093",859,561,552,16,9,"PACMA",5
8,"8098",2374,1552,1535,28,17,"PACMA",4
17,"17064",341,253,250,4,3,"PACMA",1
17,"17004",504,340,337,6,3,"PACMA",0
8,"8110",13366,8493,8329,144,164,"PACMA",58
8,"8090",120,86,86,2,0,"PACMA",0
17,"17170",192,135,134,1,1,"PACMA",1
17,"17150",1428,1018,996,24,22,"PACMA",12
8,"8151",504,345,338,6,7,"PACMA",4
43,"43141",131,71,70,3,1,"PACMA",1
17,"17226",852,539,535,0,4,"PACMA",3
17,"17217",347,267,251,5,16,"PACMA",3
8,"8299",444,277,267,5,10,"PACMA",3
43,"43075",102,63,63,1,0,"PACMA",0
8,"8249",273,218,214,4,4,"PACMA",0
43,"43013",4369,2795,2747,54,48,"PACMA",14
8,"8212",508,366,363,1,3,"PACMA",2
43,"43138",2719,1775,1730,45,45,"PACMA",5
8,"8252",24033,16704,16402,368,302,"PACMA",120
17,"17146",2952,1895,1864,49,31,"PACMA",20
8,"8218",7968,5014,4932,129,82,"PACMA",21
8,"8146",1321,876,862,18,14,"PACMA",7
17,"17037",105,66,66,2,0,"PACMA",0
43,"43006",712,484,475,10,9,"PACMA",2
8,"8127",2274,1371,1338,23,33,"PACMA",12
17,"17136",173,124,120,0,4,"PACMA",1
8,"8028",1049,667,657,15,10,"PACMA",5
8,"8229",561,404,398,12,6,"PACMA",3
17,"17174",183,120,117,5,3,"PACMA",0
17,"17036",2822,1844,1806,36,38,"PACMA",15
8,"8216",21,14,14,0,0,"PACMA",0
43,"43147",528,393,380,7,13,"PACMA",4
8,"8307",47176,31341,30846,536,495,"PACMA",234
43,"43053",190,149,149,2,0,"PACMA",0
8,"8018",2664,1707,1669,29,38,"PACMA",11
8,"8100",1934,1437,1401,40,36,"PACMA",4
8,"8303",279,202,201,11,1,"PACMA",0
8,"8122",1755,1063,1034,17,29,"PACMA",11
43,"43158",109,63,61,5,2,"PACMA",0
8,"8106",6858,4675,4559,113,116,"PACMA",33
43,"43149",711,529,516,13,13,"PACMA",3
43,"43148",89309,59260,58346,1202,914,"PACMA",422
17,"17029",198,136,133,1,3,"PACMA",0
43,"43104",1821,1209,1178,34,31,"PACMA",1
43,"43055",2002,1404,1374,36,30,"PACMA",10
43,"43079",387,259,255,26,4,"PACMA",4
8,"8214",6754,4659,4555,83,104,"PACMA",25
8,"8272",148,97,96,6,1,"PACMA",0
8,"8107",10955,7236,7130,151,106,"PACMA",54
43,"43044",3990,2768,2715,72,53,"PACMA",7
43,"43093",3924,2507,2445,62,62,"PACMA",20
8,"8188",106,87,86,4,1,"PACMA",0
43,"43157",388,282,270,10,12,"PACMA",0
8,"8901",249,180,180,2,0,"PACMA",1
17,"17083",2886,1825,1801,39,24,"PACMA",23
17,"17120",779,501,485,9,16,"PACMA",2
8,"8112",12946,8533,8390,227,143,"PACMA",49
17,"17110",1359,930,917,12,13,"PACMA",5
43,"43016",3437,2323,2266,40,57,"PACMA",18
17,"17121",230,159,158,7,1,"PACMA",1
8,"8904",10608,6654,6561,140,93,"PACMA",64
8,"8019",1143222,778246,767530,12386,10716,"PACMA",5272
17,"17171",148,111,109,5,2,"PACMA",2
8,"8199",712,507,499,15,8,"PACMA",5
43,"43124",532,366,358,3,8,"PACMA",0
17,"17166",503,361,342,10,19,"PACMA",0
43,"43040",350,251,246,18,5,"PACMA",1
17,"17230",456,326,320,10,6,"PACMA",3
8,"8231",19810,12359,12196,244,163,"PACMA",113
17,"17090",548,412,404,7,8,"PACMA",1
8,"8290",1446,1075,1056,12,19,"PACMA",4
17,"17034",6723,4131,4064,77,67,"PACMA",32
8,"8123",18751,13394,13154,238,240,"PACMA",87
17,"17079",62633,40844,40101,670,743,"PACMA",314
8,"8152",129,94,93,0,1,"PACMA",0
43,"43038",20710,12999,12771,224,228,"PACMA",80
8,"8065",1224,796,778,13,18,"PACMA",8
8,"8147",17023,11177,10961,184,216,"PACMA",88
8,"8031",2289,1619,1599,34,20,"PACMA",7
8,"8228",303,230,227,5,3,"PACMA",0
8,"8054",8733,6215,6077,123,138,"PACMA",84
43,"43064",2063,1420,1391,37,29,"PACMA",1
8,"8024",409,266,260,4,6,"PACMA",0
8,"8238",13892,10237,10094,206,143,"PACMA",72
8,"8141",4666,3124,3066,57,58,"PACMA",5
17,"17009",4089,2573,2490,59,83,"PACMA",9
17,"17125",132,90,89,1,1,"PACMA",0
17,"17065",316,211,205,6,6,"PACMA",0
43,"43035",280,202,198,0,4,"PACMA",0
17,"17160",14852,9257,9128,145,129,"PACMA",78
8,"8014",1906,1338,1313,37,25,"PACMA",6
17,"17133",1336,889,866,14,23,"PACMA",5
8,"8279",149233,101676,100363,1965,1313,"PACMA",684
17,"17099",74,52,50,1,2,"PACMA",0
8,"8125",24559,16065,15798,293,267,"PACMA",117
43,"43083",141,97,97,2,0,"PACMA",1
8,"8195",88,64,64,2,0,"PACMA",0
17,"17006",1203,759,754,17,5,"PACMA",9
8,"8259",6362,4482,4420,97,62,"PACMA",23
43,"43060",3049,2030,1980,62,50,"PACMA",10
17,"17201",131,89,89,2,0,"PACMA",0
8,"8145",2597,1823,1784,23,39,"PACMA",16
43,"43051",8749,5494,5411,78,83,"PACMA",41
43,"43134",279,208,206,14,2,"PACMA",3
8,"8051",17397,12178,12002,240,176,"PACMA",83
43,"43092",7051,4294,4220,45,74,"PACMA",28
17,"17191",153,116,114,0,2,"PACMA",0
43,"43018",430,350,337,7,13,"PACMA",2
17,"17023",26941,17098,16799,344,299,"PACMA",128
8,"8292",1083,775,764,21,11,"PACMA",11
17,"17091",433,288,277,16,11,"PACMA",1
17,"17152",10378,6239,6156,100,83,"PACMA",39
43,"43023",244,179,177,8,2,"PACMA",1
17,"17143",134,89,87,2,2,"PACMA",1
17,"17010",327,216,214,6,2,"PACMA",1
17,"17055",158,121,121,4,0,"PACMA",0
17,"17194",93,55,55,1,0,"PACMA",1
8,"8095",75,56,55,1,1,"PACMA",2
17,"17067",732,483,470,16,13,"PACMA",4
43,"43090",1142,644,636,7,8,"PACMA",11
17,"17212",129,100,98,4,2,"PACMA",0
43,"43114",383,238,234,6,4,"PACMA",1
8,"8198",4112,2766,2661,49,105,"PACMA",26
8,"8121",85069,58372,57620,923,752,"PACMA",400
8,"8182",2802,1871,1852,35,19,"PACMA",11
8,"8074",10224,6571,6479,116,92,"PACMA",70
8,"8296",1683,1227,1203,29,24,"PACMA",11
8,"8248",5239,3513,3443,71,70,"PACMA",34
17,"17162",137,80,78,2,2,"PACMA",0
8,"8055",476,312,304,11,8,"PACMA",3
8,"8163",17986,11683,11548,159,135,"PACMA",81
17,"17124",1670,1087,1056,18,31,"PACMA",6
17,"17080",165,115,114,1,1,"PACMA",0
8,"8205",54870,41064,40491,682,573,"PACMA",312
8,"8111",220,188,188,4,0,"PACMA",1
17,"17013",2774,1884,1859,21,25,"PACMA",8
17,"17039",1850,1299,1275,31,24,"PACMA",6
43,"43008",333,206,197,3,9,"PACMA",1
8,"8142",127,83,83,4,0,"PACMA",0
8,"8067",5657,3772,3671,75,101,"PACMA",24
43,"43165",624,471,459,6,12,"PACMA",1
43,"43037",16656,9986,9812,163,174,"PACMA",62
43,"43175",590,419,411,8,8,"PACMA",5
17,"17155",14284,8528,8391,143,137,"PACMA",68
17,"17035",548,385,379,7,6,"PACMA",0
8,"8165",1689,1091,1070,18,21,"PACMA",12
25,"25194",440,292,283,11,9,"PCPC",0
17,"17029",198,136,133,1,3,"PCPC",0
25,"25190",271,180,176,12,4,"PCPC",0
25,"25037",396,275,273,9,2,"PCPC",0
17,"17073",1753,1320,1298,18,22,"PCPC",1
17,"17209",605,469,463,21,6,"PCPC",1
25,"25243",3408,2280,2252,49,28,"PCPC",3
17,"17098",311,208,202,4,6,"PCPC",0
43,"43020",2119,1463,1427,26,36,"PCPC",3
43,"43120",454,287,283,1,4,"PCPC",0
17,"17166",503,361,342,10,19,"PCPC",0
43,"43086",5269,3275,3196,92,79,"PCPC",8
25,"25041",625,432,420,20,12,"PCPC",1
17,"17141",5689,3485,3428,50,57,"PCPC",8
25,"25122",1956,1281,1256,33,25,"PCPC",4
17,"17055",158,121,121,4,0,"PCPC",1
17,"17171",148,111,109,5,2,"PCPC",0
25,"25076",165,84,83,3,1,"PCPC",0
25,"25224",144,93,91,6,2,"PCPC",2
25,"25011",5241,3127,3080,48,47,"PCPC",8
17,"17028",327,220,217,4,3,"PCPC",0
17,"17116",369,230,227,3,3,"PCPC",0
43,"43142",1155,730,714,20,16,"PCPC",1
43,"43906",2050,1332,1298,28,34,"PCPC",3
25,"25055",187,115,115,3,0,"PCPC",0
17,"17129",126,91,90,3,1,"PCPC",0
17,"17024",301,207,204,4,3,"PCPC",0
17,"17184",1281,803,787,21,16,"PCPC",0
43,"43115",171,112,110,3,2,"PCPC",0
43,"43094",2209,1558,1524,31,34,"PCPC",2
25,"25225",603,395,387,7,8,"PCPC",0
25,"25908",250,169,168,4,1,"PCPC",0
25,"25109",279,183,183,2,0,"PCPC",0
43,"43153",10307,6572,6450,94,122,"PCPC",14
17,"17097",185,136,136,4,0,"PCPC",0
25,"25130",208,117,112,4,5,"PCPC",0
25,"25042",211,131,127,0,4,"PCPC",0
43,"43151",119,91,89,0,2,"PCPC",0
43,"43161",17199,10765,10547,197,218,"PCPC",23
43,"43079",387,259,255,26,4,"PCPC",3
25,"25101",583,391,382,8,9,"PCPC",1
25,"25164",404,270,264,5,6,"PCPC",0
43,"43134",279,208,206,14,2,"PCPC",0
25,"25232",1480,968,959,38,9,"PCPC",3
17,"17193",3978,2365,2305,38,60,"PCPC",6
25,"25158",1647,1154,1135,27,19,"PCPC",0
25,"25163",237,147,142,2,5,"PCPC",1
17,"17086",1687,1148,1129,14,19,"PCPC",3
17,"17036",2822,1844,1806,36,38,"PCPC",1
43,"43119",739,500,496,5,4,"PCPC",1
43,"43117",150,118,115,1,3,"PCPC",0
17,"17043",159,101,100,2,1,"PCPC",0
17,"17034",6723,4131,4064,77,67,"PCPC",7
43,"43130",196,132,131,7,1,"PCPC",0
17,"17038",343,261,256,2,5,"PCPC",0
43,"43148",89309,59260,58346,1202,914,"PCPC",128
17,"17052",134,84,83,2,1,"PCPC",0
25,"25102",733,478,464,15,14,"PCPC",2
17,"17012",1093,689,679,11,10,"PCPC",0
25,"25203",8995,5418,5309,116,109,"PCPC",9
17,"17106",140,105,104,0,1,"PCPC",0
17,"17195",324,220,214,6,6,"PCPC",0
25,"25086",569,379,370,4,9,"PCPC",3
17,"17159",639,408,397,3,11,"PCPC",0
17,"17016",725,491,481,8,10,"PCPC",1
25,"25192",799,543,527,19,16,"PCPC",1
43,"43088",1810,1199,1177,29,22,"PCPC",0
17,"17080",165,115,114,1,1,"PCPC",0
17,"17217",347,267,251,5,16,"PCPC",1
17,"17105",257,152,146,4,6,"PCPC",0
25,"25045",51,33,33,2,0,"PCPC",0
43,"43105",175,119,116,14,3,"PCPC",0
17,"17902",1330,898,874,11,24,"PCPC",1
25,"25175",221,151,150,0,1,"PCPC",0
43,"43076",467,308,300,7,8,"PCPC",0
43,"43066",165,113,112,2,1,"PCPC",0
25,"25097",102,70,69,3,1,"PCPC",0
17,"17227",107,82,82,1,0,"PCPC",0
43,"43026",800,531,522,15,9,"PCPC",1
25,"25133",748,499,483,7,16,"PCPC",0
17,"17186",3593,2358,2317,33,41,"PCPC",2
17,"17203",171,97,94,3,3,"PCPC",0
25,"25169",201,134,134,6,0,"PCPC",0
25,"25046",438,299,286,6,13,"PCPC",1
43,"43003",307,187,184,10,3,"PCPC",0
17,"17148",1546,980,957,24,23,"PCPC",2
17,"17089",5486,3328,3288,43,40,"PCPC",4
17,"17177",563,398,388,7,10,"PCPC",0
25,"25170",271,197,196,4,1,"PCPC",0
43,"43176",832,575,572,16,3,"PCPC",0
25,"25014",264,170,164,11,6,"PCPC",2
17,"17010",327,216,214,6,2,"PCPC",0
25,"25909",141,82,78,0,4,"PCPC",0
25,"25059",796,580,575,9,5,"PCPC",1
43,"43019",1356,868,837,13,31,"PCPC",1
17,"17205",198,146,138,3,8,"PCPC",0
25,"25140",785,472,460,5,12,"PCPC",1
25,"25021",2693,1632,1605,40,27,"PCPC",1
25,"25901",315,196,189,3,7,"PCPC",0
17,"17119",89,65,64,3,1,"PCPC",0
17,"17115",281,209,207,5,2,"PCPC",0
17,"17165",608,414,400,9,14,"PCPC",0
25,"25134",657,421,416,4,5,"PCPC",1
43,"43160",1278,840,812,9,28,"PCPC",3
25,"25115",878,542,542,17,0,"PCPC",0
43,"43163",24903,15475,15241,263,234,"PCPC",31
17,"17123",365,274,266,8,8,"PCPC",0
43,"43015",104,69,68,2,1,"PCPC",0
43,"43061",55,31,31,1,0,"PCPC",0
17,"17069",395,276,267,2,9,"PCPC",1
43,"43006",712,484,475,10,9,"PCPC",0
25,"25132",128,87,85,3,2,"PCPC",0
25,"25248",926,615,601,17,14,"PCPC",3
43,"43033",772,547,533,4,14,"PCPC",1
43,"43164",298,233,231,4,2,"PCPC",0
43,"43140",2393,1612,1583,23,29,"PCPC",7
43,"43096",103,81,77,3,4,"PCPC",0
25,"25218",94,75,73,1,2,"PCPC",0
17,"17082",443,285,280,1,5,"PCPC",0
25,"25902",581,411,395,15,16,"PCPC",0
25,"25077",474,281,277,5,4,"PCPC",1
17,"17087",230,170,161,6,9,"PCPC",0
43,"43063",588,358,350,13,8,"PCPC",0
25,"25113",1227,869,856,28,13,"PCPC",1
25,"25227",674,375,372,2,3,"PCPC",0
25,"25025",1307,874,859,32,15,"PCPC",1
17,"17185",2273,1416,1379,32,37,"PCPC",2
25,"25234",4572,2707,2648,57,59,"PCPC",4
25,"25149",1401,1031,1010,17,21,"PCPC",0
17,"17210",527,358,349,9,9,"PCPC",0
17,"17197",144,103,102,3,1,"PCPC",0
43,"43143",62,51,50,1,1,"PCPC",0
17,"17216",158,100,97,1,3,"PCPC",0
43,"43001",706,481,473,12,8,"PCPC",1
25,"25219",144,90,86,0,4,"PCPC",0
43,"43113",454,321,316,10,5,"PCPC",0
25,"25148",232,144,144,5,0,"PCPC",0
25,"25052",1611,1094,1062,21,32,"PCPC",1
17,"17135",380,273,269,9,4,"PCPC",0
17,"17075",304,216,210,5,6,"PCPC",0
25,"25252",536,361,352,13,9,"PCPC",1
17,"17149",366,254,251,4,3,"PCPC",0
43,"43125",1008,706,701,10,5,"PCPC",1
25,"25063",97,65,64,2,1,"PCPC",0
17,"17204",539,349,347,10,2,"PCPC",1
43,"43158",109,63,61,5,2,"PCPC",0
43,"43101",146,94,93,3,1,"PCPC",0
17,"17093",859,561,552,16,9,"PCPC",2
17,"17065",316,211,205,6,6,"PCPC",0
43,"43042",2071,1504,1485,28,19,"PCPC",0
25,"25181",189,128,123,3,5,"PCPC",2
43,"43083",141,97,97,2,0,"PCPC",0
43,"43011",1013,745,729,21,16,"PCPC",0
17,"17130",333,236,233,5,3,"PCPC",0
25,"25016",2203,1375,1357,20,18,"PCPC",2
43,"43905",13621,8120,8011,131,109,"PCPC",20
17,"17032",1613,933,918,11,15,"PCPC",2
25,"25185",690,409,404,8,5,"PCPC",1
17,"17063",169,113,111,5,2,"PCPC",0
43,"43034",494,355,344,8,11,"PCPC",0
43,"43150",1337,994,977,12,17,"PCPC",0
43,"43089",272,193,185,1,8,"PCPC",0
17,"17005",404,258,254,12,4,"PCPC",1
43,"43103",897,586,575,21,11,"PCPC",0
25,"25129",175,105,105,3,0,"PCPC",0
25,"25029",1766,1145,1118,38,27,"PCPC",5
25,"25907",506,297,292,6,5,"PCPC",1
43,"43013",4369,2795,2747,54,48,"PCPC",7
17,"17142",2440,1713,1681,39,32,"PCPC",1
17,"17067",732,483,470,16,13,"PCPC",0
43,"43178",1262,891,870,24,21,"PCPC",1
43,"43171",13906,8978,8855,167,123,"PCPC",20
25,"25067",768,498,494,14,4,"PCPC",1
43,"43082",383,282,270,8,12,"PCPC",0
17,"17039",1850,1299,1275,31,24,"PCPC",2
17,"17091",433,288,277,16,11,"PCPC",0
25,"25206",289,187,184,3,3,"PCPC",1
43,"43077",486,335,328,4,7,"PCPC",0
17,"17103",4988,2788,2724,51,64,"PCPC",6
25,"25036",190,138,134,5,4,"PCPC",0
25,"25210",1164,799,789,13,10,"PCPC",2
25,"25238",231,158,156,1,2,"PCPC",0
43,"43149",711,529,516,13,13,"PCPC",0
17,"17047",4803,2866,2803,30,63,"PCPC",8
25,"25039",299,189,186,7,3,"PCPC",0
43,"43005",3559,2191,2147,47,44,"PCPC",1
43,"43046",114,80,79,5,1,"PCPC",0
17,"17178",1075,683,679,15,4,"PCPC",0
17,"17198",404,264,259,9,5,"PCPC",0
43,"43014",14146,9153,8915,204,238,"PCPC",24
43,"43012",3392,2346,2295,48,51,"PCPC",3
25,"25100",207,125,115,2,10,"PCPC",0
43,"43177",338,242,236,6,6,"PCPC",1
25,"25165",301,202,198,6,4,"PCPC",0
17,"17170",192,135,134,1,1,"PCPC",0
17,"17208",1012,642,622,12,20,"PCPC",0
17,"17002",567,413,401,4,12,"PCPC",1
17,"17112",215,141,138,4,3,"PCPC",0
17,"17056",1704,1171,1158,21,13,"PCPC",1
25,"25005",291,194,190,7,4,"PCPC",0
17,"17190",811,548,532,7,16,"PCPC",0
25,"25104",128,88,86,11,2,"PCPC",1
25,"25172",1838,1267,1230,35,37,"PCPC",4
43,"43047",4064,2412,2352,50,60,"PCPC",8
25,"25124",161,110,109,4,1,"PCPC",0
43,"43121",636,385,371,6,14,"PCPC",1
43,"43137",1873,1241,1212,27,29,"PCPC",21
43,"43055",2002,1404,1374,36,30,"PCPC",2
17,"17007",1778,1137,1113,16,24,"PCPC",1
43,"43080",254,175,173,7,2,"PCPC",0
43,"43135",327,243,238,2,5,"PCPC",2
25,"25099",1185,720,709,9,11,"PCPC",1
43,"43098",362,251,247,1,4,"PCPC",1
43,"43016",3437,2323,2266,40,57,"PCPC",8
25,"25201",119,78,76,3,2,"PCPC",1
25,"25079",307,242,240,7,2,"PCPC",1
43,"43059",264,185,185,4,0,"PCPC",0
25,"25007",1363,902,885,36,17,"PCPC",1
17,"17084",269,177,175,4,2,"PCPC",0
25,"25167",253,176,172,0,4,"PCPC",0
43,"43084",573,383,378,6,5,"PCPC",0
17,"17175",569,375,369,6,6,"PCPC",4
25,"25088",100,74,74,0,0,"PCPC",0
17,"17100",201,140,135,1,5,"PCPC",0
17,"17211",864,628,612,12,16,"PCPC",0
25,"25226",257,162,158,5,4,"PCPC",0
43,"43032",587,418,413,9,5,"PCPC",0
17,"17192",145,107,105,4,2,"PCPC",0
43,"43131",4495,2842,2814,51,28,"PCPC",3
43,"43147",528,393,380,7,13,"PCPC",2
17,"17150",1428,1018,996,24,22,"PCPC",2
17,"17094",1161,694,683,11,11,"PCPC",0
25,"25197",158,102,101,2,1,"PCPC",0
43,"43052",1001,669,636,12,33,"PCPC",2
17,"17183",261,178,176,2,2,"PCPC",0
17,"17051",201,146,142,4,4,"PCPC",2
43,"43017",141,98,98,2,0,"PCPC",1
17,"17109",759,428,414,10,14,"PCPC",3
25,"25135",1077,739,722,18,17,"PCPC",0
43,"43172",378,268,266,8,2,"PCPC",0
43,"43132",365,217,214,8,3,"PCPC",2
43,"43162",4143,2892,2833,59,59,"PCPC",6
17,"17022",6771,4247,4169,76,78,"PCPC",8
43,"43156",4120,2811,2741,66,70,"PCPC",14
17,"17114",22610,14079,13811,263,268,"PCPC",20
43,"43116",494,328,325,5,3,"PCPC",0
17,"17124",1670,1087,1056,18,31,"PCPC",1
17,"17041",237,153,153,1,0,"PCPC",0
17,"17151",174,131,131,6,0,"PCPC",0
43,"43157",388,282,270,10,12,"PCPC",1
25,"25141",171,111,107,2,4,"PCPC",0
17,"17200",616,406,393,12,13,"PCPC",1
17,"17026",542,404,398,3,6,"PCPC",0
25,"25179",198,141,136,1,5,"PCPC",0
43,"43090",1142,644,636,7,8,"PCPC",0
25,"25044",195,136,134,1,2,"PCPC",0
25,"25191",353,234,227,5,7,"PCPC",0
43,"43168",106,70,69,2,1,"PCPC",0
17,"17221",4135,2789,2723,49,66,"PCPC",3
17,"17040",506,320,316,7,4,"PCPC",1
17,"17163",2478,1729,1681,41,48,"PCPC",0
43,"43065",443,278,270,8,8,"PCPC",0
17,"17081",236,165,162,2,3,"PCPC",0
17,"17136",173,124,120,0,4,"PCPC",0
25,"25220",1076,711,702,10,9,"PCPC",2
43,"43169",477,377,364,8,13,"PCPC",0
17,"17140",684,476,470,10,6,"PCPC",1
43,"43068",573,388,378,5,10,"PCPC",1
17,"17157",127,99,98,3,1,"PCPC",0
25,"25156",761,535,529,15,6,"PCPC",0
17,"17137",3331,2163,2110,39,53,"PCPC",2
25,"25123",206,140,136,4,4,"PCPC",1
43,"43166",1521,1002,977,17,25,"PCPC",2
17,"17189",1536,1061,1025,7,36,"PCPC",0
25,"25068",576,376,364,6,12,"PCPC",0
43,"43028",2654,1620,1588,27,32,"PCPC",4
17,"17025",1127,775,760,11,15,"PCPC",0
17,"17222",108,86,86,1,0,"PCPC",0
43,"43039",117,85,83,3,2,"PCPC",0
17,"17006",1203,759,754,17,5,"PCPC",0
43,"43058",106,76,76,5,0,"PCPC",0
25,"25061",75,45,45,0,0,"PCPC",0
43,"43053",190,149,149,2,0,"PCPC",0
25,"25139",549,358,357,5,1,"PCPC",1
17,"17138",1010,677,662,3,15,"PCPC",2
25,"25017",248,160,159,1,1,"PCPC",1
25,"25098",266,177,177,0,0,"PCPC",0
17,"17225",208,138,134,1,4,"PCPC",0
25,"25121",623,406,400,6,6,"PCPC",1
17,"17188",167,124,122,9,2,"PCPC",0
17,"17128",309,232,224,5,8,"PCPC",0
25,"25038",1606,1104,1093,19,11,"PCPC",0
17,"17020",3446,2322,2268,45,54,"PCPC",0
25,"25093",657,465,455,8,10,"PCPC",0
25,"25222",69,55,54,0,1,"PCPC",0
25,"25003",3853,2367,2340,68,27,"PCPC",7
25,"25911",472,306,296,2,10,"PCPC",0
17,"17099",74,52,50,1,2,"PCPC",0
25,"25251",670,476,473,1,3,"PCPC",0
17,"17033",5157,3142,3095,44,47,"PCPC",3
25,"25015",394,264,264,14,0,"PCPC",0
25,"25209",1558,1041,1009,22,32,"PCPC",2
43,"43067",626,445,431,21,14,"PCPC",1
17,"17058",177,115,114,2,1,"PCPC",0
17,"17027",2865,1955,1892,34,63,"PCPC",1
25,"25153",215,165,161,0,4,"PCPC",0
25,"25143",86,58,58,1,0,"PCPC",0
25,"25047",1048,760,748,24,12,"PCPC",0
25,"25171",2305,1496,1469,37,27,"PCPC",1
25,"25204",1313,888,881,21,7,"PCPC",4
17,"17207",2357,1636,1584,40,52,"PCPC",0
25,"25120",90759,58761,57778,1325,983,"PCPC",142
17,"17031",172,94,93,1,1,"PCPC",1
25,"25904",149,107,104,1,3,"PCPC",2
17,"17011",625,472,467,5,5,"PCPC",1
43,"43104",1821,1209,1178,34,31,"PCPC",1
25,"25048",1684,1120,1095,29,25,"PCPC",1
43,"43057",45,27,27,2,0,"PCPC",0
25,"25023",4446,3079,3020,70,59,"PCPC",2
43,"43025",660,453,446,13,7,"PCPC",0
25,"25231",515,402,395,4,7,"PCPC",0
25,"25254",782,533,531,9,2,"PCPC",1
25,"25182",1075,749,731,30,18,"PCPC",0
43,"43170",880,601,592,9,9,"PCPC",1
17,"17060",378,240,233,1,7,"PCPC",0
17,"17009",4089,2573,2490,59,83,"PCPC",2
43,"43007",635,448,441,7,7,"PCPC",1
43,"43092",7051,4294,4220,45,74,"PCPC",7
43,"43154",136,97,96,6,1,"PCPC",0
17,"17181",3228,2116,2081,19,35,"PCPC",0
25,"25905",386,264,258,12,6,"PCPC",0
25,"25078",1014,730,719,17,11,"PCPC",1
43,"43029",330,202,194,6,8,"PCPC",1
43,"43069",194,131,127,3,4,"PCPC",2
25,"25032",71,44,42,1,2,"PCPC",0
43,"43109",2040,1332,1316,28,16,"PCPC",5
17,"17013",2774,1884,1859,21,25,"PCPC",1
17,"17125",132,90,89,1,1,"PCPC",0
17,"17191",153,116,114,0,2,"PCPC",0
17,"17133",1336,889,866,14,23,"PCPC",2
25,"25114",102,82,78,4,4,"PCPC",0
25,"25050",3249,2056,1988,40,68,"PCPC",2
43,"43073",90,57,57,1,0,"PCPC",0
17,"17090",548,412,404,7,8,"PCPC",0
43,"43008",333,206,197,3,9,"PCPC",1
43,"43174",152,104,101,1,3,"PCPC",1
43,"43128",927,636,625,11,11,"PCPC",1
25,"25103",125,82,80,4,2,"PCPC",0
25,"25173",1784,1177,1139,20,38,"PCPC",4
17,"17153",172,127,123,1,4,"PCPC",0
25,"25207",6253,3938,3872,91,66,"PCPC",5
43,"43038",20710,12999,12771,224,228,"PCPC",15
25,"25137",8404,5264,5167,112,97,"PCPC",5
25,"25074",178,137,132,3,5,"PCPC",0
25,"25177",379,240,236,2,4,"PCPC",0
43,"43091",142,106,98,5,8,"PCPC",0
17,"17062",5994,3686,3614,69,72,"PCPC",5
25,"25051",1710,1060,1044,23,16,"PCPC",4
17,"17050",645,438,425,15,13,"PCPC",0
17,"17035",548,385,379,7,6,"PCPC",0
17,"17144",217,145,143,4,2,"PCPC",0
25,"25250",358,237,234,4,3,"PCPC",0
43,"43050",2407,1528,1504,20,24,"PCPC",1
25,"25110",2662,1649,1602,44,47,"PCPC",4
17,"17101",567,349,339,4,10,"PCPC",0
17,"17173",174,121,119,1,2,"PCPC",3
43,"43018",430,350,337,7,13,"PCPC",0
17,"17015",12254,7759,7553,143,206,"PCPC",9
25,"25208",294,174,170,3,4,"PCPC",0
17,"17154",93,54,49,1,5,"PCPC",0
25,"25244",350,270,268,9,2,"PCPC",0
17,"17092",3520,2273,2228,42,45,"PCPC",4
43,"43106",878,600,592,17,8,"PCPC",1
17,"17110",1359,930,917,12,13,"PCPC",0
25,"25009",690,479,471,9,8,"PCPC",0
25,"25216",250,175,173,5,2,"PCPC",0
25,"25022",119,83,83,0,0,"PCPC",0
43,"43152",472,355,351,9,4,"PCPC",0
17,"17004",504,340,337,6,3,"PCPC",1
25,"25186",231,168,168,3,0,"PCPC",0
17,"17901",964,628,621,16,7,"PCPC",1
43,"43093",3924,2507,2445,62,62,"PCPC",7
17,"17213",5282,3097,3041,42,56,"PCPC",5
17,"17074",490,345,342,5,3,"PCPC",0
43,"43027",177,129,128,6,1,"PCPC",0
43,"43078",841,557,547,7,10,"PCPC",1
25,"25196",127,87,86,3,1,"PCPC",0
25,"25131",439,319,314,6,5,"PCPC",0
25,"25136",106,79,79,1,0,"PCPC",0
17,"17214",695,470,461,10,9,"PCPC",0
25,"25168",510,385,378,19,7,"PCPC",0
43,"43110",307,216,214,5,2,"PCPC",0
25,"25154",126,77,77,2,0,"PCPC",0
25,"25166",177,127,125,3,2,"PCPC",0
25,"25034",2471,1622,1592,25,30,"PCPC",0
17,"17008",3745,2262,2195,34,67,"PCPC",3
25,"25010",206,119,118,7,1,"PCPC",0
43,"43112",294,184,181,2,3,"PCPC",0
25,"25174",438,289,283,4,6,"PCPC",0
17,"17019",1783,1264,1234,42,30,"PCPC",2
43,"43060",3049,2030,1980,62,50,"PCPC",7
25,"25027",1042,691,665,11,26,"PCPC",0
25,"25064",122,91,88,7,3,"PCPC",0
25,"25092",135,100,97,2,3,"PCPC",0
17,"17117",14022,8705,8595,129,110,"PCPC",15
17,"17206",167,108,107,2,1,"PCPC",0
43,"43045",156,110,109,1,1,"PCPC",0
17,"17218",568,361,350,11,11,"PCPC",0
17,"17066",25667,15429,15157,244,272,"PCPC",28
25,"25211",701,378,368,5,10,"PCPC",2
43,"43129",4525,3032,2956,62,76,"PCPC",2
17,"17096",182,96,94,2,2,"PCPC",0
43,"43141",131,71,70,3,1,"PCPC",0
25,"25205",563,373,362,12,11,"PCPC",0
43,"43023",244,179,177,8,2,"PCPC",0
43,"43072",97,73,70,0,3,"PCPC",1
25,"25242",787,501,490,11,11,"PCPC",0
17,"17121",230,159,158,7,1,"PCPC",1
17,"17070",116,78,78,3,0,"PCPC",0
25,"25006",362,231,228,2,3,"PCPC",2
17,"17169",2460,1690,1651,34,39,"PCPC",3
43,"43054",2850,1815,1771,37,44,"PCPC",1
17,"17118",12541,7817,7681,130,136,"PCPC",14
25,"25223",951,562,546,14,16,"PCPC",1
43,"43070",265,198,196,3,2,"PCPC",0
17,"17172",426,286,283,3,3,"PCPC",0
17,"17018",478,337,332,8,5,"PCPC",0
17,"17030",624,414,409,8,5,"PCPC",1
17,"17057",1010,640,634,19,6,"PCPC",0
17,"17152",10378,6239,6156,100,83,"PCPC",12
43,"43041",237,177,176,4,1,"PCPC",0
25,"25233",270,207,201,3,6,"PCPC",0
25,"25230",1665,1164,1140,36,24,"PCPC",1
17,"17196",209,139,138,6,1,"PCPC",0
43,"43118",439,318,313,7,5,"PCPC",0
43,"43074",1697,1150,1120,25,30,"PCPC",4
25,"25912",899,643,640,6,3,"PCPC",0
25,"25094",154,110,107,1,3,"PCPC",0
25,"25004",553,405,400,13,5,"PCPC",0
17,"17021",108,86,79,0,7,"PCPC",0
25,"25089",107,66,64,0,2,"PCPC",0
25,"25151",641,451,444,20,7,"PCPC",0
25,"25049",166,105,102,1,3,"PCPC",0
43,"43036",836,503,494,4,9,"PCPC",2
17,"17048",6176,3818,3773,52,45,"PCPC",4
25,"25910",118,77,76,3,1,"PCPC",0
25,"25215",399,229,226,4,3,"PCPC",2
43,"43102",517,377,366,2,11,"PCPC",0
25,"25075",122,85,83,0,2,"PCPC",0
17,"17044",6619,4293,4187,69,106,"PCPC",10
17,"17194",93,55,55,1,0,"PCPC",0
25,"25913",100,78,78,0,0,"PCPC",0
43,"43021",381,218,213,3,5,"PCPC",0
17,"17145",1593,1090,1068,10,22,"PCPC",1
25,"25152",160,92,90,4,2,"PCPC",1
25,"25127",226,134,130,2,4,"PCPC",0
17,"17230",456,326,320,10,6,"PCPC",0
17,"17054",395,250,247,3,3,"PCPC",0
43,"43165",624,471,459,6,12,"PCPC",0
17,"17023",26941,17098,16799,344,299,"PCPC",38
17,"17049",3056,1986,1944,43,42,"PCPC",3
43,"43138",2719,1775,1730,45,45,"PCPC",6
17,"17162",137,80,78,2,2,"PCPC",0
43,"43107",378,255,248,18,7,"PCPC",0
17,"17220",780,550,545,13,5,"PCPC",0
17,"17042",415,297,292,2,5,"PCPC",0
43,"43155",22951,14114,13856,326,258,"PCPC",26
43,"43136",10163,6312,6197,121,115,"PCPC",9
25,"25081",332,212,206,6,6,"PCPC",0
17,"17160",14852,9257,9128,145,129,"PCPC",15
17,"17071",1064,719,698,33,21,"PCPC",2
43,"43902",2761,1836,1811,25,25,"PCPC",2
43,"43901",8849,5651,5540,179,111,"PCPC",8
25,"25072",5921,3743,3637,81,106,"PCPC",3
17,"17233",2192,1470,1434,33,36,"PCPC",3
43,"43009",1421,913,897,18,16,"PCPC",2
25,"25193",771,509,501,8,8,"PCPC",3
25,"25125",450,297,289,10,8,"PCPC",0
25,"25249",207,151,150,4,1,"PCPC",0
43,"43123",70216,45627,44828,906,799,"PCPC",94
25,"25138",605,440,428,13,12,"PCPC",0
25,"25087",65,41,39,0,2,"PCPC",0
25,"25043",830,483,467,17,16,"PCPC",1
43,"43097",379,283,278,6,5,"PCPC",0
43,"43004",6411,4089,4001,92,88,"PCPC",19
17,"17176",141,96,95,3,1,"PCPC",0
25,"25221",125,76,76,0,0,"PCPC",0
25,"25008",1187,834,818,15,16,"PCPC",1
43,"43056",931,537,515,18,22,"PCPC",0
43,"43167",390,284,280,12,4,"PCPC",0
43,"43037",16656,9986,9812,163,174,"PCPC",11
17,"17167",2818,1886,1858,52,28,"PCPC",0
17,"17234",183,131,128,2,3,"PCPC",1
17,"17076",126,77,76,5,1,"PCPC",1
43,"43051",8749,5494,5411,78,83,"PCPC",19
25,"25112",286,202,199,11,3,"PCPC",0
25,"25240",1398,976,958,17,18,"PCPC",0
43,"43048",830,547,530,16,17,"PCPC",0
43,"43024",1459,958,937,17,21,"PCPC",0
25,"25146",227,150,149,0,1,"PCPC",0
25,"25105",146,90,89,1,1,"PCPC",1
25,"25176",341,243,240,7,3,"PCPC",0
43,"43133",5697,3470,3388,76,82,"PCPC",8
17,"17014",64,39,37,0,2,"PCPC",0
25,"25001",146,76,76,1,0,"PCPC",0
43,"43907",4122,2759,2712,52,47,"PCPC",1
43,"43095",2434,1658,1624,27,34,"PCPC",6
17,"17182",257,177,175,2,2,"PCPC",0
43,"43071",975,677,664,14,13,"PCPC",1
25,"25013",2274,1344,1321,25,23,"PCPC",3
25,"25019",4626,2971,2932,54,39,"PCPC",4
17,"17134",235,149,148,3,1,"PCPC",0
17,"17132",1296,913,900,15,13,"PCPC",1
25,"25069",471,291,289,9,2,"PCPC",0
17,"17126",309,231,229,9,2,"PCPC",0
17,"17147",8385,5401,5325,105,76,"PCPC",10
25,"25126",286,192,189,7,3,"PCPC",0
17,"17111",789,584,574,15,10,"PCPC",0
25,"25145",88,67,67,2,0,"PCPC",0
25,"25060",92,53,52,1,1,"PCPC",0
17,"17199",6630,4242,4162,80,80,"PCPC",9
17,"17164",4092,2409,2346,60,63,"PCPC",2
17,"17215",1918,1350,1321,40,29,"PCPC",1
17,"17202",3799,2398,2366,44,32,"PCPC",5
17,"17161",978,693,687,21,6,"PCPC",0
43,"43904",2918,1779,1732,49,47,"PCPC",3
25,"25200",353,225,217,4,8,"PCPC",2
17,"17085",295,212,208,12,4,"PCPC",1
43,"43175",590,419,411,8,8,"PCPC",0
25,"25031",57,34,34,1,0,"PCPC",0
25,"25202",110,62,59,3,3,"PCPC",0
43,"43040",350,251,246,18,5,"PCPC",1
25,"25217",10570,6660,6500,191,160,"PCPC",16
25,"25903",261,176,170,9,6,"PCPC",0
25,"25161",361,222,218,1,4,"PCPC",0
17,"17001",557,370,365,7,5,"PCPC",0
43,"43062",298,227,223,7,4,"PCPC",0
25,"25128",151,83,81,1,2,"PCPC",0
43,"43081",574,415,404,13,11,"PCPC",0
43,"43126",1170,802,783,19,19,"PCPC",0
43,"43035",280,202,198,0,4,"PCPC",0
25,"25030",147,101,95,3,6,"PCPC",0
17,"17168",393,285,281,8,4,"PCPC",0
43,"43111",2096,1305,1281,19,24,"PCPC",2
25,"25189",2085,1348,1327,38,21,"PCPC",2
43,"43044",3990,2768,2715,72,53,"PCPC",9
17,"17232",159,107,104,0,3,"PCPC",0
25,"25033",1125,738,718,17,20,"PCPC",1
25,"25183",485,336,327,6,9,"PCPC",3
43,"43031",1509,1016,992,20,24,"PCPC",0
25,"25239",627,310,310,7,0,"PCPC",0
17,"17158",404,266,264,3,2,"PCPC",1
25,"25073",662,382,379,11,3,"PCPC",2
43,"43127",778,530,524,6,6,"PCPC",1
43,"43139",2166,1319,1270,37,49,"PCPC",1
25,"25906",235,160,154,3,6,"PCPC",0
43,"43099",330,240,236,4,4,"PCPC",0
25,"25012",2204,1432,1406,29,26,"PCPC",4
25,"25053",1085,733,727,10,6,"PCPC",0
25,"25111",116,70,70,0,0,"PCPC",1
25,"25180",245,167,165,3,2,"PCPC",1
25,"25150",185,119,113,4,6,"PCPC",0
43,"43030",454,321,307,5,14,"PCPC",0
17,"17187",574,414,402,1,12,"PCPC",0
25,"25035",428,289,284,5,5,"PCPC",0
25,"25212",233,185,185,8,0,"PCPC",0
25,"25082",265,156,155,8,1,"PCPC",0
17,"17088",551,374,363,4,11,"PCPC",1
17,"17903",893,565,556,14,9,"PCPC",1
25,"25253",175,132,129,1,3,"PCPC",0
17,"17224",355,246,241,10,5,"PCPC",0
17,"17146",2952,1895,1864,49,31,"PCPC",7
17,"17107",301,203,200,8,3,"PCPC",0
17,"17143",134,89,87,2,2,"PCPC",0
17,"17201",131,89,89,2,0,"PCPC",0
43,"43049",805,555,536,6,19,"PCPC",2
25,"25071",56,37,35,2,2,"PCPC",0
43,"43144",1187,787,772,12,15,"PCPC",1
25,"25247",142,80,78,3,2,"PCPC",0
17,"17079",62633,40844,40101,670,743,"PCPC",54
17,"17064",341,253,250,4,3,"PCPC",1
43,"43064",2063,1420,1391,37,29,"PCPC",0
25,"25142",387,265,264,5,1,"PCPC",0
25,"25157",183,128,128,4,0,"PCPC",0
43,"43114",383,238,234,6,4,"PCPC",0
17,"17139",1346,899,869,21,30,"PCPC",0
17,"17226",852,539,535,0,4,"PCPC",0
17,"17077",580,374,372,5,2,"PCPC",0
17,"17061",175,123,123,4,0,"PCPC",0
43,"43159",89,51,51,2,0,"PCPC",0
17,"17228",280,172,170,4,2,"PCPC",0
17,"17078",346,231,226,3,5,"PCPC",0
43,"43022",1559,1097,1074,22,23,"PCPC",0
25,"25020",328,216,209,4,7,"PCPC",1
17,"17155",14284,8528,8391,143,137,"PCPC",18
25,"25040",10654,6905,6768,144,137,"PCPC",13
25,"25228",2907,2043,2021,43,22,"PCPC",2
17,"17102",571,354,350,7,4,"PCPC",0
43,"43173",114,65,64,0,1,"PCPC",0
43,"43146",45,33,30,1,3,"PCPC",0
25,"25057",198,140,136,2,4,"PCPC",0
17,"17003",101,67,64,2,3,"PCPC",0
43,"43122",92,65,61,0,4,"PCPC",0
17,"17037",105,66,66,2,0,"PCPC",0
25,"25070",888,594,582,18,12,"PCPC",0
17,"17068",252,156,156,4,0,"PCPC",1
43,"43085",229,178,171,0,7,"PCPC",1
17,"17095",19245,11212,11067,160,145,"PCPC",34
25,"25155",714,490,485,8,5,"PCPC",1
17,"17083",2886,1825,1801,39,24,"PCPC",1
43,"43100",3062,2058,2021,52,37,"PCPC",5
25,"25085",153,103,100,2,3,"PCPC",0
43,"43002",1790,1252,1226,17,26,"PCPC",3
25,"25118",378,232,226,4,6,"PCPC",0
43,"43124",532,366,358,3,8,"PCPC",0
25,"25056",289,168,163,3,5,"PCPC",0
25,"25058",4390,2696,2650,57,46,"PCPC",2
25,"25255",468,318,309,9,9,"PCPC",1
43,"43903",2368,1504,1492,22,12,"PCPC",1
25,"25245",445,312,306,4,6,"PCPC",0
17,"17180",8076,4868,4767,81,101,"PCPC",7
25,"25119",2297,1554,1513,46,41,"PCPC",0
17,"17120",779,501,485,9,16,"PCPC",0
25,"25024",370,221,217,8,4,"PCPC",1
25,"25062",806,515,497,11,18,"PCPC",0
17,"17212",129,100,98,4,2,"PCPC",0
17,"17223",787,523,514,8,9,"PCPC",2
43,"43145",3968,2781,2742,52,39,"PCPC",7
43,"43108",1808,1183,1157,28,26,"PCPC",1
17,"17046",738,510,498,15,12,"PCPC",2
43,"43043",3065,1952,1919,39,33,"PCPC",6
43,"43010",302,227,223,7,4,"PCPC",1
17,"17174",183,120,117,5,3,"PCPC",0
25,"25002",481,306,302,6,4,"PCPC",0
43,"43075",102,63,63,1,0,"PCPC",0
25,"25096",988,633,613,12,20,"PCPC",0
12,"12036",668,529,514,6,15,"P.C.P.E.",0
12,"12106",1207,992,969,7,23,"P.C.P.E.",0
12,"12095",1027,790,775,15,15,"P.C.P.E.",2
12,"12102",547,474,466,2,8,"P.C.P.E.",0
12,"12132",524,407,401,4,6,"P.C.P.E.",2
12,"12040",116573,84142,83078,1257,1064,"P.C.P.E.",198
12,"12009",17124,12273,12098,150,175,"P.C.P.E.",23
12,"12113",100,72,72,0,0,"P.C.P.E.",0
12,"12112",104,90,90,0,0,"P.C.P.E.",1
12,"12100",1380,1124,1109,11,15,"P.C.P.E.",4
12,"12122",835,674,658,14,16,"P.C.P.E.",0
12,"12099",583,485,465,3,20,"P.C.P.E.",0
12,"12142",158,122,121,1,1,"P.C.P.E.",0
12,"12103",85,65,65,4,0,"P.C.P.E.",0
12,"12003",1058,830,813,15,17,"P.C.P.E.",4
12,"12136",2663,2325,2284,33,41,"P.C.P.E.",0
12,"12129",1936,1372,1326,29,46,"P.C.P.E.",2
12,"12058",99,74,74,0,0,"P.C.P.E.",0
12,"12074",783,679,676,3,3,"P.C.P.E.",0
12,"12027",16914,11657,11452,188,205,"P.C.P.E.",16
12,"12005",8066,5835,5441,116,394,"P.C.P.E.",10
12,"12116",56,45,45,0,0,"P.C.P.E.",0
12,"12051",520,382,376,1,6,"P.C.P.E.",0
12,"12089",4277,3009,2946,32,63,"P.C.P.E.",4
12,"12063",59,42,41,0,1,"P.C.P.E.",0
12,"12090",127,109,107,2,2,"P.C.P.E.",0
12,"12011",4663,3578,3525,28,53,"P.C.P.E.",0
12,"12139",344,219,216,0,3,"P.C.P.E.",0
12,"12067",563,458,439,8,19,"P.C.P.E.",0
12,"12109",700,564,555,7,9,"P.C.P.E.",0
12,"12093",254,190,187,0,3,"P.C.P.E.",0
12,"12043",620,499,487,2,12,"P.C.P.E.",2
12,"12012",2747,2196,2135,24,61,"P.C.P.E.",11
12,"12126",24420,18431,18136,231,295,"P.C.P.E.",34
12,"12117",3674,2846,2794,25,52,"P.C.P.E.",6
12,"12059",276,227,227,1,0,"P.C.P.E.",0
12,"12075",139,106,102,0,4,"P.C.P.E.",0
12,"12079",450,360,353,3,7,"P.C.P.E.",0
12,"12039",870,743,736,4,7,"P.C.P.E.",0
12,"12010",280,232,229,3,3,"P.C.P.E.",2
12,"12072",1191,1007,977,17,30,"P.C.P.E.",2
12,"12032",23406,16895,16721,227,174,"P.C.P.E.",29
12,"12123",70,50,48,2,2,"P.C.P.E.",0
12,"12065",181,155,155,0,0,"P.C.P.E.",0
12,"12097",78,59,59,4,0,"P.C.P.E.",0
12,"12055",112,79,78,3,1,"P.C.P.E.",0
12,"12073",168,135,135,1,0,"P.C.P.E.",2
12,"12049",471,366,344,10,22,"P.C.P.E.",0
12,"12004",4354,3145,3083,50,62,"P.C.P.E.",2
12,"12084",17219,12059,11911,165,148,"P.C.P.E.",9
12,"12050",1418,1183,1156,8,27,"P.C.P.E.",1
12,"12076",105,79,79,0,0,"P.C.P.E.",0
12,"12088",55,51,51,2,0,"P.C.P.E.",0
12,"12091",203,153,140,2,13,"P.C.P.E.",0
12,"12096",854,663,653,17,10,"P.C.P.E.",1
12,"12037",20,15,14,1,1,"P.C.P.E.",0
12,"12071",1355,1069,1050,3,19,"P.C.P.E.",2
12,"12901",3383,2664,2632,34,32,"P.C.P.E.",7
12,"12134",147,107,107,3,0,"P.C.P.E.",0
12,"12015",96,83,82,3,1,"P.C.P.E.",0
12,"12025",146,106,105,0,1,"P.C.P.E.",0
12,"12041",115,98,98,2,0,"P.C.P.E.",0
12,"12016",1589,1309,1293,15,16,"P.C.P.E.",1
12,"12101",385,309,296,3,13,"P.C.P.E.",0
12,"12108",495,394,389,4,5,"P.C.P.E.",0
12,"12060",467,367,353,2,14,"P.C.P.E.",0
12,"12119",153,87,87,0,0,"P.C.P.E.",0
12,"12046",236,177,176,4,1,"P.C.P.E.",2
12,"12020",131,109,107,1,2,"P.C.P.E.",0
12,"12127",92,64,61,0,3,"P.C.P.E.",0
12,"12048",293,208,205,2,3,"P.C.P.E.",0
12,"12031",3748,2751,2687,35,64,"P.C.P.E.",6
12,"12028",12115,9084,8992,137,92,"P.C.P.E.",16
12,"12038",195,135,134,8,1,"P.C.P.E.",1
12,"12114",228,178,173,2,5,"P.C.P.E.",1
12,"12026",946,728,702,16,26,"P.C.P.E.",0
12,"12085",4941,3183,3125,32,58,"P.C.P.E.",7
12,"12033",1970,1547,1509,8,38,"P.C.P.E.",1
12,"12131",92,78,78,1,0,"P.C.P.E.",0
12,"12078",365,273,267,5,6,"P.C.P.E.",0
12,"12013",180,131,130,0,1,"P.C.P.E.",0
12,"12133",64,47,47,0,0,"P.C.P.E.",1
12,"12121",1197,1050,1020,4,30,"P.C.P.E.",1
12,"12128",1448,1114,1092,16,22,"P.C.P.E.",0
12,"12042",664,549,530,5,19,"P.C.P.E.",0
12,"12029",760,619,601,7,18,"P.C.P.E.",1
12,"12125",235,203,201,1,2,"P.C.P.E.",0
12,"12052",627,510,491,9,19,"P.C.P.E.",0
12,"12137",47,36,35,0,1,"P.C.P.E.",0
12,"12140",1204,975,954,9,21,"P.C.P.E.",6
12,"12022",367,282,279,4,3,"P.C.P.E.",1
12,"12044",527,472,463,4,9,"P.C.P.E.",0
12,"12001",1098,821,817,8,4,"P.C.P.E.",0
12,"12008",236,203,199,4,4,"P.C.P.E.",0
12,"12057",650,530,515,6,15,"P.C.P.E.",1
12,"12081",654,519,515,2,4,"P.C.P.E.",1
12,"12098",665,552,539,9,13,"P.C.P.E.",0
12,"12064",118,91,89,1,2,"P.C.P.E.",0
12,"12094",807,612,604,14,8,"P.C.P.E.",1
12,"12007",747,674,660,9,14,"P.C.P.E.",0
12,"12083",106,89,88,0,1,"P.C.P.E.",0
12,"12104",6981,5464,5357,54,107,"P.C.P.E.",5
12,"12118",83,63,62,0,1,"P.C.P.E.",0
12,"12024",146,129,128,1,1,"P.C.P.E.",0
12,"12070",576,473,463,5,10,"P.C.P.E.",0
12,"12056",304,259,254,7,5,"P.C.P.E.",0
12,"12141",116,97,97,0,0,"P.C.P.E.",0
12,"12107",358,314,311,4,3,"P.C.P.E.",1
12,"12111",423,375,363,6,12,"P.C.P.E.",0
12,"12002",135,101,100,1,1,"P.C.P.E.",1
12,"12017",183,143,141,6,2,"P.C.P.E.",0
12,"12120",218,180,177,0,3,"P.C.P.E.",0
12,"12135",35189,25691,25345,380,346,"P.C.P.E.",61
12,"12061",431,324,316,6,8,"P.C.P.E.",1
12,"12018",326,274,265,1,9,"P.C.P.E.",2
12,"12077",4683,3476,3414,41,62,"P.C.P.E.",6
12,"12902",2056,1454,1411,14,43,"P.C.P.E.",0
12,"12006",185,160,153,0,7,"P.C.P.E.",0
12,"12045",388,301,286,2,15,"P.C.P.E.",0
12,"12138",18762,12489,12231,243,258,"P.C.P.E.",22
12,"12115",234,184,183,2,1,"P.C.P.E.",0
12,"12105",866,679,673,6,6,"P.C.P.E.",1
12,"12082",9741,7555,7408,84,147,"P.C.P.E.",11
12,"12130",425,348,344,2,4,"P.C.P.E.",0
12,"12034",1509,1125,1097,10,28,"P.C.P.E.",0
12,"12124",1902,1532,1499,15,33,"P.C.P.E.",3
12,"12014",191,139,137,4,2,"P.C.P.E.",0
12,"12092",143,98,98,0,0,"P.C.P.E.",1
12,"12080",2051,1692,1650,23,42,"P.C.P.E.",2
12,"12053",2121,1745,1719,11,26,"P.C.P.E.",7
12,"12110",253,199,195,3,4,"P.C.P.E.",0
12,"12021",4433,3368,3292,42,76,"P.C.P.E.",8
12,"12069",53,48,47,0,1,"P.C.P.E.",1
12,"12068",57,45,44,0,1,"P.C.P.E.",0
12,"12087",22,20,20,0,0,"P.C.P.E.",0
8,"8302",9271,5981,5892,82,89,"PSC-PSOE",1983
17,"17018",478,337,332,8,5,"PSC-PSOE",68
17,"17144",217,145,143,4,2,"PSC-PSOE",17
43,"43151",119,91,89,0,2,"PSC-PSOE",20
8,"8160",313,227,222,8,5,"PSC-PSOE",24
25,"25104",128,88,86,11,2,"PSC-PSOE",9
25,"25006",362,231,228,2,3,"PSC-PSOE",57
25,"25251",670,476,473,1,3,"PSC-PSOE",65
25,"25062",806,515,497,11,18,"PSC-PSOE",79
8,"8008",193,119,114,5,5,"PSC-PSOE",7
8,"8072",9910,6326,6235,140,91,"PSC-PSOE",1368
8,"8043",3067,2044,2023,29,21,"PSC-PSOE",550
25,"25145",88,67,67,2,0,"PSC-PSOE",4
43,"43096",103,81,77,3,4,"PSC-PSOE",10
25,"25014",264,170,164,11,6,"PSC-PSOE",27
17,"17116",369,230,227,3,3,"PSC-PSOE",29
25,"25223",951,562,546,14,16,"PSC-PSOE",67
17,"17073",1753,1320,1298,18,22,"PSC-PSOE",134
25,"25094",154,110,107,1,3,"PSC-PSOE",14
43,"43124",532,366,358,3,8,"PSC-PSOE",72
8,"8032",1955,1330,1294,18,36,"PSC-PSOE",234
8,"8044",4247,2763,2712,50,51,"PSC-PSOE",686
17,"17234",183,131,128,2,3,"PSC-PSOE",20
25,"25096",988,633,613,12,20,"PSC-PSOE",128
17,"17224",355,246,241,10,5,"PSC-PSOE",21
43,"43082",383,282,270,8,12,"PSC-PSOE",67
17,"17112",215,141,138,4,3,"PSC-PSOE",19
8,"8154",677,499,488,2,11,"PSC-PSOE",63
17,"17203",171,97,94,3,3,"PSC-PSOE",9
8,"8299",444,277,267,5,10,"PSC-PSOE",34
8,"8047",4141,2610,2580,49,30,"PSC-PSOE",618
8,"8168",418,268,266,0,2,"PSC-PSOE",40
17,"17202",3799,2398,2366,44,32,"PSC-PSOE",583
8,"8288",1735,985,957,13,28,"PSC-PSOE",297
25,"25181",189,128,123,3,5,"PSC-PSOE",18
25,"25232",1480,968,959,38,9,"PSC-PSOE",259
17,"17066",25667,15429,15157,244,272,"PSC-PSOE",3318
25,"25100",207,125,115,2,10,"PSC-PSOE",11
17,"17118",12541,7817,7681,130,136,"PSC-PSOE",1970
43,"43058",106,76,76,5,0,"PSC-PSOE",11
8,"8117",2424,1685,1661,45,24,"PSC-PSOE",294
25,"25197",158,102,101,2,1,"PSC-PSOE",14
8,"8228",303,230,227,5,3,"PSC-PSOE",25
17,"17052",134,84,83,2,1,"PSC-PSOE",13
43,"43156",4120,2811,2741,66,70,"PSC-PSOE",698
17,"17212",129,100,98,4,2,"PSC-PSOE",8
25,"25169",201,134,134,6,0,"PSC-PSOE",27
43,"43009",1421,913,897,18,16,"PSC-PSOE",190
43,"43104",1821,1209,1178,34,31,"PSC-PSOE",356
17,"17067",732,483,470,16,13,"PSC-PSOE",88
25,"25005",291,194,190,7,4,"PSC-PSOE",28
8,"8200",61189,40677,40069,736,608,"PSC-PSOE",14876
8,"8192",5450,3688,3634,79,54,"PSC-PSOE",620
25,"25227",674,375,372,2,3,"PSC-PSOE",96
25,"25027",1042,691,665,11,26,"PSC-PSOE",88
8,"8258",845,577,555,23,22,"PSC-PSOE",43
8,"8026",180,144,143,0,1,"PSC-PSOE",13
17,"17167",2818,1886,1858,52,28,"PSC-PSOE",437
8,"8267",6215,4100,4011,82,89,"PSC-PSOE",1159
17,"17199",6630,4242,4162,80,80,"PSC-PSOE",735
8,"8273",2287,1594,1547,18,47,"PSC-PSOE",229
43,"43905",13621,8120,8011,131,109,"PSC-PSOE",1952
8,"8304",822,587,578,16,9,"PSC-PSOE",136
8,"8078",224,154,151,2,3,"PSC-PSOE",7
8,"8048",622,461,454,9,7,"PSC-PSOE",89
25,"25134",657,421,416,4,5,"PSC-PSOE",107
43,"43014",14146,9153,8915,204,238,"PSC-PSOE",2254
17,"17063",169,113,111,5,2,"PSC-PSOE",7
25,"25179",198,141,136,1,5,"PSC-PSOE",11
25,"25135",1077,739,722,18,17,"PSC-PSOE",151
17,"17015",12254,7759,7553,143,206,"PSC-PSOE",1013
17,"17215",1918,1350,1321,40,29,"PSC-PSOE",211
25,"25046",438,299,286,6,13,"PSC-PSOE",55
17,"17101",567,349,339,4,10,"PSC-PSOE",71
8,"8069",3028,2071,2029,36,42,"PSC-PSOE",400
17,"17163",2478,1729,1681,41,48,"PSC-PSOE",208
43,"43093",3924,2507,2445,62,62,"PSC-PSOE",627
17,"17030",624,414,409,8,5,"PSC-PSOE",67
25,"25043",830,483,467,17,16,"PSC-PSOE",103
8,"8248",5239,3513,3443,71,70,"PSC-PSOE",744
43,"43161",17199,10765,10547,197,218,"PSC-PSOE",2356
8,"8197",7316,4983,4926,69,57,"PSC-PSOE",764
43,"43094",2209,1558,1524,31,34,"PSC-PSOE",346
25,"25008",1187,834,818,15,16,"PSC-PSOE",119
8,"8137",255,190,190,3,0,"PSC-PSOE",15
17,"17065",316,211,205,6,6,"PSC-PSOE",25
25,"25150",185,119,113,4,6,"PSC-PSOE",6
43,"43036",836,503,494,4,9,"PSC-PSOE",127
8,"8181",7722,5280,5188,112,92,"PSC-PSOE",1094
8,"8231",19810,12359,12196,244,163,"PSC-PSOE",3519
43,"43069",194,131,127,3,4,"PSC-PSOE",41
17,"17129",126,91,90,3,1,"PSC-PSOE",7
25,"25099",1185,720,709,9,11,"PSC-PSOE",89
17,"17035",548,385,379,7,6,"PSC-PSOE",34
8,"8120",6342,4801,4746,63,55,"PSC-PSOE",267
8,"8164",873,606,584,13,22,"PSC-PSOE",114
17,"17187",574,414,402,1,12,"PSC-PSOE",91
25,"25244",350,270,268,9,2,"PSC-PSOE",52
8,"8190",281,201,197,3,4,"PSC-PSOE",33
25,"25082",265,156,155,8,1,"PSC-PSOE",29
17,"17207",2357,1636,1584,40,52,"PSC-PSOE",156
8,"8002",202,143,140,4,3,"PSC-PSOE",5
25,"25203",8995,5418,5309,116,109,"PSC-PSOE",1232
25,"25908",250,169,168,4,1,"PSC-PSOE",22
8,"8219",14647,10347,10169,193,178,"PSC-PSOE",1835
17,"17901",964,628,621,16,7,"PSC-PSOE",113
17,"17153",172,127,123,1,4,"PSC-PSOE",17
43,"43033",772,547,533,4,14,"PSC-PSOE",111
8,"8217",24130,17554,17319,383,235,"PSC-PSOE",6106
25,"25152",160,92,90,4,2,"PSC-PSOE",11
17,"17105",257,152,146,4,6,"PSC-PSOE",13
25,"25907",506,297,292,6,5,"PSC-PSOE",43
17,"17103",4988,2788,2724,51,64,"PSC-PSOE",712
17,"17147",8385,5401,5325,105,76,"PSC-PSOE",1045
25,"25247",142,80,78,3,2,"PSC-PSOE",9
8,"8055",476,312,304,11,8,"PSC-PSOE",40
17,"17149",366,254,251,4,3,"PSC-PSOE",28
17,"17193",3978,2365,2305,38,60,"PSC-PSOE",491
25,"25138",605,440,428,13,12,"PSC-PSOE",54
8,"8158",2996,2012,1986,19,26,"PSC-PSOE",604
43,"43099",330,240,236,4,4,"PSC-PSOE",56
8,"8134",776,528,513,15,15,"PSC-PSOE",77
25,"25157",183,128,128,4,0,"PSC-PSOE",15
8,"8030",4849,3466,3422,50,44,"PSC-PSOE",398
8,"8036",172,124,124,4,0,"PSC-PSOE",13
43,"43001",706,481,473,12,8,"PSC-PSOE",119
43,"43169",477,377,364,8,13,"PSC-PSOE",68
25,"25098",266,177,177,0,0,"PSC-PSOE",31
8,"8301",47343,32098,31664,672,434,"PSC-PSOE",12075
17,"17233",2192,1470,1434,33,36,"PSC-PSOE",210
43,"43106",878,600,592,17,8,"PSC-PSOE",179
8,"8099",808,533,519,11,14,"PSC-PSOE",117
43,"43111",2096,1305,1281,19,24,"PSC-PSOE",315
43,"43129",4525,3032,2956,62,76,"PSC-PSOE",466
25,"25143",86,58,58,1,0,"PSC-PSOE",14
25,"25231",515,402,395,4,7,"PSC-PSOE",53
8,"8127",2274,1371,1338,23,33,"PSC-PSOE",329
8,"8073",60247,41448,40843,770,605,"PSC-PSOE",16813
25,"25032",71,44,42,1,2,"PSC-PSOE",6
25,"25074",178,137,132,3,5,"PSC-PSOE",22
17,"17058",177,115,114,2,1,"PSC-PSOE",10
8,"8270",17464,11828,11677,212,151,"PSC-PSOE",2521
43,"43031",1509,1016,992,20,24,"PSC-PSOE",163
17,"17031",172,94,93,1,1,"PSC-PSOE",10
25,"25089",107,66,64,0,2,"PSC-PSOE",6
8,"8223",1855,1178,1155,19,23,"PSC-PSOE",193
17,"17008",3745,2262,2195,34,67,"PSC-PSOE",454
8,"8079",335,255,243,14,12,"PSC-PSOE",28
17,"17002",567,413,401,4,12,"PSC-PSOE",38
17,"17196",209,139,138,6,1,"PSC-PSOE",23
8,"8213",6188,4031,3970,113,61,"PSC-PSOE",751
8,"8039",365,264,260,5,4,"PSC-PSOE",36
43,"43041",237,177,176,4,1,"PSC-PSOE",29
8,"8187",149633,104021,102629,1794,1392,"PSC-PSOE",32216
25,"25131",439,319,314,6,5,"PSC-PSOE",74
17,"17034",6723,4131,4064,77,67,"PSC-PSOE",963
8,"8016",1984,1319,1289,26,30,"PSC-PSOE",373
43,"43172",378,268,266,8,2,"PSC-PSOE",49
17,"17089",5486,3328,3288,43,40,"PSC-PSOE",656
17,"17123",365,274,266,8,8,"PSC-PSOE",28
25,"25202",110,62,59,3,3,"PSC-PSOE",18
17,"17096",182,96,94,2,2,"PSC-PSOE",9
25,"25172",1838,1267,1230,35,37,"PSC-PSOE",177
17,"17205",198,146,138,3,8,"PSC-PSOE",27
17,"17214",695,470,461,10,9,"PSC-PSOE",48
25,"25253",175,132,129,1,3,"PSC-PSOE",11
8,"8057",61,41,40,1,1,"PSC-PSOE",10
17,"17082",443,285,280,1,5,"PSC-PSOE",40
17,"17181",3228,2116,2081,19,35,"PSC-PSOE",375
17,"17007",1778,1137,1113,16,24,"PSC-PSOE",155
17,"17159",639,408,397,3,11,"PSC-PSOE",50
17,"17151",174,131,131,6,0,"PSC-PSOE",19
17,"17087",230,170,161,6,9,"PSC-PSOE",23
8,"8232",1793,1239,1220,20,19,"PSC-PSOE",200
17,"17190",811,548,532,7,16,"PSC-PSOE",70
25,"25004",553,405,400,13,5,"PSC-PSOE",85
25,"25141",171,111,107,2,4,"PSC-PSOE",10
43,"43061",55,31,31,1,0,"PSC-PSOE",2
43,"43120",454,287,283,1,4,"PSC-PSOE",73
17,"17014",64,39,37,0,2,"PSC-PSOE",4
17,"17078",346,231,226,3,5,"PSC-PSOE",17
25,"25007",1363,902,885,36,17,"PSC-PSOE",174
8,"8025",1460,990,963,14,27,"PSC-PSOE",198
8,"8143",2679,1772,1756,35,16,"PSC-PSOE",472
43,"43032",587,418,413,9,5,"PSC-PSOE",142
17,"17152",10378,6239,6156,100,83,"PSC-PSOE",1535
25,"25076",165,84,83,3,1,"PSC-PSOE",27
43,"43107",378,255,248,18,7,"PSC-PSOE",50
8,"8277",134,90,90,4,0,"PSC-PSOE",8
8,"8226",886,667,656,13,11,"PSC-PSOE",100
25,"25025",1307,874,859,32,15,"PSC-PSOE",174
43,"43102",517,377,366,2,11,"PSC-PSOE",157
17,"17225",208,138,134,1,4,"PSC-PSOE",32
8,"8005",5884,4114,4041,68,73,"PSC-PSOE",611
8,"8230",7452,5349,5286,94,63,"PSC-PSOE",1066
25,"25250",358,237,234,4,3,"PSC-PSOE",21
8,"8023",6546,4261,4194,86,67,"PSC-PSOE",810
17,"17005",404,258,254,12,4,"PSC-PSOE",47
8,"8247",903,627,608,10,19,"PSC-PSOE",55
17,"17095",19245,11212,11067,160,145,"PSC-PSOE",3376
8,"8111",220,188,188,4,0,"PSC-PSOE",17
17,"17085",295,212,208,12,4,"PSC-PSOE",46
43,"43131",4495,2842,2814,51,28,"PSC-PSOE",788
25,"25166",177,127,125,3,2,"PSC-PSOE",6
8,"8171",2158,1385,1359,27,26,"PSC-PSOE",99
8,"8241",80,61,61,1,0,"PSC-PSOE",4
17,"17114",22610,14079,13811,263,268,"PSC-PSOE",2920
43,"43062",298,227,223,7,4,"PSC-PSOE",47
8,"8225",92,68,68,2,0,"PSC-PSOE",2
43,"43901",8849,5651,5540,179,111,"PSC-PSOE",2082
43,"43056",931,537,515,18,22,"PSC-PSOE",96
43,"43059",264,185,185,4,0,"PSC-PSOE",27
17,"17006",1203,759,754,17,5,"PSC-PSOE",119
25,"25191",353,234,227,5,7,"PSC-PSOE",34
25,"25173",1784,1177,1139,20,38,"PSC-PSOE",383
25,"25161",361,222,218,1,4,"PSC-PSOE",35
25,"25211",701,378,368,5,10,"PSC-PSOE",57
25,"25086",569,379,370,4,9,"PSC-PSOE",70
8,"8086",13267,8791,8669,200,122,"PSC-PSOE",2068
25,"25128",151,83,81,1,2,"PSC-PSOE",6
8,"8902",3600,2518,2496,57,22,"PSC-PSOE",437
17,"17227",107,82,82,1,0,"PSC-PSOE",12
25,"25088",100,74,74,0,0,"PSC-PSOE",1
17,"17175",569,375,369,6,6,"PSC-PSOE",134
25,"25243",3408,2280,2252,49,28,"PSC-PSOE",548
25,"25220",1076,711,702,10,9,"PSC-PSOE",131
43,"43130",196,132,131,7,1,"PSC-PSOE",19
43,"43150",1337,994,977,12,17,"PSC-PSOE",116
8,"8903",217,178,176,10,2,"PSC-PSOE",24
25,"25154",126,77,77,2,0,"PSC-PSOE",13
43,"43902",2761,1836,1811,25,25,"PSC-PSOE",833
25,"25904",149,107,104,1,3,"PSC-PSOE",23
8,"8216",21,14,14,0,0,"PSC-PSOE",5
17,"17172",426,286,283,3,3,"PSC-PSOE",30
25,"25218",94,75,73,1,2,"PSC-PSOE",6
43,"43003",307,187,184,10,3,"PSC-PSOE",53
25,"25148",232,144,144,5,0,"PSC-PSOE",3
17,"17022",6771,4247,4169,76,78,"PSC-PSOE",1061
8,"8261",2273,1547,1525,30,22,"PSC-PSOE",305
8,"8131",696,483,469,7,14,"PSC-PSOE",97
17,"17173",174,121,119,1,2,"PSC-PSOE",26
8,"8040",10538,6916,6804,99,112,"PSC-PSOE",1515
43,"43110",307,216,214,5,2,"PSC-PSOE",44
8,"8194",24757,15009,14799,245,210,"PSC-PSOE",5250
8,"8087",158,133,132,6,1,"PSC-PSOE",11
43,"43089",272,193,185,1,8,"PSC-PSOE",49
17,"17044",6619,4293,4187,69,106,"PSC-PSOE",729
25,"25087",65,41,39,0,2,"PSC-PSOE",9
25,"25029",1766,1145,1118,38,27,"PSC-PSOE",314
25,"25047",1048,760,748,24,12,"PSC-PSOE",138
43,"43160",1278,840,812,9,28,"PSC-PSOE",234
25,"25139",549,358,357,5,1,"PSC-PSOE",47
43,"43012",3392,2346,2295,48,51,"PSC-PSOE",559
25,"25136",106,79,79,1,0,"PSC-PSOE",3
43,"43135",327,243,238,2,5,"PSC-PSOE",31
25,"25079",307,242,240,7,2,"PSC-PSOE",20
8,"8205",54870,41064,40491,682,573,"PSC-PSOE",6784
8,"8112",12946,8533,8390,227,143,"PSC-PSOE",1594
8,"8126",8299,5599,5508,103,91,"PSC-PSOE",1438
25,"25036",190,138,134,5,4,"PSC-PSOE",40
17,"17155",14284,8528,8391,143,137,"PSC-PSOE",2268
43,"43101",146,94,93,3,1,"PSC-PSOE",18
25,"25063",97,65,64,2,1,"PSC-PSOE",29
8,"8129",444,278,271,2,7,"PSC-PSOE",34
25,"25909",141,82,78,0,4,"PSC-PSOE",18
43,"43046",114,80,79,5,1,"PSC-PSOE",12
43,"43030",454,321,307,5,14,"PSC-PSOE",44
25,"25068",576,376,364,6,12,"PSC-PSOE",35
17,"17027",2865,1955,1892,34,63,"PSC-PSOE",325
25,"25039",299,189,186,7,3,"PSC-PSOE",49
43,"43022",1559,1097,1074,22,23,"PSC-PSOE",319
25,"25901",315,196,189,3,7,"PSC-PSOE",33
8,"8097",985,676,657,3,19,"PSC-PSOE",120
8,"8281",4735,3239,3193,57,46,"PSC-PSOE",484
43,"43126",1170,802,783,19,19,"PSC-PSOE",110
25,"25913",100,78,78,0,0,"PSC-PSOE",10
25,"25081",332,212,206,6,6,"PSC-PSOE",21
17,"17054",395,250,247,3,3,"PSC-PSOE",59
25,"25061",75,45,45,0,0,"PSC-PSOE",5
43,"43034",494,355,344,8,11,"PSC-PSOE",62
17,"17157",127,99,98,3,1,"PSC-PSOE",4
8,"8227",2372,1591,1549,38,42,"PSC-PSOE",318
17,"17209",605,469,463,21,6,"PSC-PSOE",73
43,"43167",390,284,280,12,4,"PSC-PSOE",32
25,"25910",118,77,76,3,1,"PSC-PSOE",13
43,"43119",739,500,496,5,4,"PSC-PSOE",110
25,"25248",926,615,601,17,14,"PSC-PSOE",52
25,"25056",289,168,163,3,5,"PSC-PSOE",17
43,"43023",244,179,177,8,2,"PSC-PSOE",75
8,"8010",4124,2674,2611,44,63,"PSC-PSOE",506
43,"43105",175,119,116,14,3,"PSC-PSOE",20
25,"25194",440,292,283,11,9,"PSC-PSOE",19
43,"43013",4369,2795,2747,54,48,"PSC-PSOE",572
8,"8209",6596,4415,4351,69,64,"PSC-PSOE",988
25,"25239",627,310,310,7,0,"PSC-PSOE",52
43,"43103",897,586,575,21,11,"PSC-PSOE",133
43,"43073",90,57,57,1,0,"PSC-PSOE",9
43,"43065",443,278,270,8,8,"PSC-PSOE",77
25,"25022",119,83,83,0,0,"PSC-PSOE",12
17,"17021",108,86,79,0,7,"PSC-PSOE",30
25,"25142",387,265,264,5,1,"PSC-PSOE",34
8,"8130",95,63,62,3,1,"PSC-PSOE",6
17,"17040",506,320,316,7,4,"PSC-PSOE",20
25,"25050",3249,2056,1988,40,68,"PSC-PSOE",255
17,"17211",864,628,612,12,16,"PSC-PSOE",46
8,"8133",157,100,97,2,3,"PSC-PSOE",2
25,"25042",211,131,127,0,4,"PSC-PSOE",2
25,"25013",2274,1344,1321,25,23,"PSC-PSOE",394
17,"17051",201,146,142,4,4,"PSC-PSOE",17
17,"17111",789,584,574,15,10,"PSC-PSOE",64
43,"43147",528,393,380,7,13,"PSC-PSOE",62
25,"25113",1227,869,856,28,13,"PSC-PSOE",193
8,"8103",636,453,446,16,7,"PSC-PSOE",46
8,"8196",18989,12658,12490,253,168,"PSC-PSOE",4547
25,"25177",379,240,236,2,4,"PSC-PSOE",40
25,"25201",119,78,76,3,2,"PSC-PSOE",9
8,"8033",12476,8513,8378,180,135,"PSC-PSOE",1981
8,"8114",17629,11781,11579,189,202,"PSC-PSOE",3608
17,"17158",404,266,264,3,2,"PSC-PSOE",31
8,"8295",10579,6896,6769,137,127,"PSC-PSOE",1789
8,"8260",17869,11898,11686,215,212,"PSC-PSOE",3457
17,"17128",309,232,224,5,8,"PSC-PSOE",30
8,"8204",2991,2076,2040,45,36,"PSC-PSOE",542
8,"8077",33925,23896,23548,381,348,"PSC-PSOE",7873
8,"8285",10168,6582,6423,152,159,"PSC-PSOE",1087
17,"17148",1546,980,957,24,23,"PSC-PSOE",235
8,"8176",166,111,109,0,2,"PSC-PSOE",2
25,"25155",714,490,485,8,5,"PSC-PSOE",85
43,"43067",626,445,431,21,14,"PSC-PSOE",166
17,"17102",571,354,350,7,4,"PSC-PSOE",48
25,"25175",221,151,150,0,1,"PSC-PSOE",13
43,"43083",141,97,97,2,0,"PSC-PSOE",16
43,"43010",302,227,223,7,4,"PSC-PSOE",47
8,"8037",1830,1247,1209,40,38,"PSC-PSOE",106
43,"43152",472,355,351,9,4,"PSC-PSOE",98
8,"8296",1683,1227,1203,29,24,"PSC-PSOE",136
8,"8068",6554,4323,4255,87,68,"PSC-PSOE",951
8,"8001",8538,5929,5838,120,91,"PSC-PSOE",1896
8,"8139",184,130,128,1,2,"PSC-PSOE",31
25,"25189",2085,1348,1327,38,21,"PSC-PSOE",269
17,"17074",490,345,342,5,3,"PSC-PSOE",78
17,"17071",1064,719,698,33,21,"PSC-PSOE",89
43,"43035",280,202,198,0,4,"PSC-PSOE",20
43,"43084",573,383,378,6,5,"PSC-PSOE",86
8,"8178",450,311,304,3,7,"PSC-PSOE",47
8,"8240",9104,6355,6262,101,93,"PSC-PSOE",1759
25,"25156",761,535,529,15,6,"PSC-PSOE",95
8,"8076",15925,10435,10242,179,193,"PSC-PSOE",3013
17,"17075",304,216,210,5,6,"PSC-PSOE",21
43,"43004",6411,4089,4001,92,88,"PSC-PSOE",976
8,"8904",10608,6654,6561,140,93,"PSC-PSOE",2611
43,"43171",13906,8978,8855,167,123,"PSC-PSOE",2543
8,"8210",4176,2661,2579,54,82,"PSC-PSOE",502
43,"43085",229,178,171,0,7,"PSC-PSOE",53
17,"17011",625,472,467,5,5,"PSC-PSOE",77
25,"25185",690,409,404,8,5,"PSC-PSOE",67
8,"8189",141,113,111,4,2,"PSC-PSOE",6
43,"43164",298,233,231,4,2,"PSC-PSOE",73
17,"17164",4092,2409,2346,60,63,"PSC-PSOE",452
8,"8298",25338,16982,16690,353,292,"PSC-PSOE",2361
17,"17028",327,220,217,4,3,"PSC-PSOE",17
25,"25205",563,373,362,12,11,"PSC-PSOE",41
17,"17141",5689,3485,3428,50,57,"PSC-PSOE",660
17,"17180",8076,4868,4767,81,101,"PSC-PSOE",982
17,"17056",1704,1171,1158,21,13,"PSC-PSOE",132
8,"8060",167,102,101,0,1,"PSC-PSOE",7
17,"17026",542,404,398,3,6,"PSC-PSOE",30
25,"25121",623,406,400,6,6,"PSC-PSOE",155
43,"43143",62,51,50,1,1,"PSC-PSOE",6
8,"8118",17077,11817,11598,203,219,"PSC-PSOE",2243
43,"43021",381,218,213,3,5,"PSC-PSOE",74
8,"8202",12206,8265,8129,183,136,"PSC-PSOE",1970
17,"17188",167,124,122,9,2,"PSC-PSOE",10
8,"8238",13892,10237,10094,206,143,"PSC-PSOE",2138
8,"8159",13482,9173,9040,239,133,"PSC-PSOE",2625
17,"17201",131,89,89,2,0,"PSC-PSOE",6
17,"17010",327,216,214,6,2,"PSC-PSOE",26
25,"25249",207,151,150,4,1,"PSC-PSOE",7
25,"25130",208,117,112,4,5,"PSC-PSOE",14
43,"43055",2002,1404,1374,36,30,"PSC-PSOE",374
43,"43068",573,388,378,5,10,"PSC-PSOE",118
8,"8150",245,181,178,11,3,"PSC-PSOE",15
25,"25122",1956,1281,1256,33,25,"PSC-PSOE",239
25,"25001",146,76,76,1,0,"PSC-PSOE",14
8,"8293",246,145,145,4,0,"PSC-PSOE",36
8,"8018",2664,1707,1669,29,38,"PSC-PSOE",509
43,"43078",841,557,547,7,10,"PSC-PSOE",104
43,"43057",45,27,27,2,0,"PSC-PSOE",5
8,"8257",116,84,81,0,3,"PSC-PSOE",12
25,"25171",2305,1496,1469,37,27,"PSC-PSOE",380
17,"17068",252,156,156,4,0,"PSC-PSOE",20
17,"17097",185,136,136,4,0,"PSC-PSOE",24
8,"8140",4665,3160,3103,55,57,"PSC-PSOE",779
8,"8107",10955,7236,7130,151,106,"PSC-PSOE",1901
25,"25190",271,180,176,12,4,"PSC-PSOE",41
8,"8224",771,538,528,26,10,"PSC-PSOE",107
17,"17126",309,231,229,9,2,"PSC-PSOE",24
25,"25034",2471,1622,1592,25,30,"PSC-PSOE",196
8,"8167",5703,3896,3831,82,65,"PSC-PSOE",1071
8,"8093",32,21,20,0,1,"PSC-PSOE",0
43,"43108",1808,1183,1157,28,26,"PSC-PSOE",200
8,"8022",12437,7598,7445,169,153,"PSC-PSOE",1547
25,"25224",144,93,91,6,2,"PSC-PSOE",17
43,"43063",588,358,350,13,8,"PSC-PSOE",54
8,"8251",4771,3214,3140,57,74,"PSC-PSOE",1070
8,"8090",120,86,86,2,0,"PSC-PSOE",7
8,"8151",504,345,338,6,7,"PSC-PSOE",20
25,"25216",250,175,173,5,2,"PSC-PSOE",6
25,"25164",404,270,264,5,6,"PSC-PSOE",44
8,"8132",381,247,241,6,6,"PSC-PSOE",17
43,"43162",4143,2892,2833,59,59,"PSC-PSOE",912
43,"43178",1262,891,870,24,21,"PSC-PSOE",132
25,"25009",690,479,471,9,8,"PSC-PSOE",68
25,"25075",122,85,83,0,2,"PSC-PSOE",4
43,"43098",362,251,247,1,4,"PSC-PSOE",35
25,"25038",1606,1104,1093,19,11,"PSC-PSOE",136
25,"25254",782,533,531,9,2,"PSC-PSOE",142
8,"8014",1906,1338,1313,37,25,"PSC-PSOE",230
43,"43090",1142,644,636,7,8,"PSC-PSOE",217
8,"8276",249,188,187,9,1,"PSC-PSOE",29
8,"8266",42860,30047,29521,536,526,"PSC-PSOE",9446
25,"25238",231,158,156,1,2,"PSC-PSOE",26
25,"25207",6253,3938,3872,91,66,"PSC-PSOE",624
17,"17220",780,550,545,13,5,"PSC-PSOE",60
8,"8236",1507,1027,1002,18,25,"PSC-PSOE",250
25,"25125",450,297,289,10,8,"PSC-PSOE",48
25,"25165",301,202,198,6,4,"PSC-PSOE",28
25,"25252",536,361,352,13,9,"PSC-PSOE",58
17,"17186",3593,2358,2317,33,41,"PSC-PSOE",669
8,"8308",145,116,115,1,1,"PSC-PSOE",3
8,"8053",2850,1788,1772,21,16,"PSC-PSOE",474
43,"43074",1697,1150,1120,25,30,"PSC-PSOE",224
8,"8042",2172,1459,1448,30,11,"PSC-PSOE",358
17,"17183",261,178,176,2,2,"PSC-PSOE",14
43,"43155",22951,14114,13856,326,258,"PSC-PSOE",3970
8,"8185",189,131,126,1,5,"PSC-PSOE",14
17,"17098",311,208,202,4,6,"PSC-PSOE",55
25,"25011",5241,3127,3080,48,47,"PSC-PSOE",530
43,"43025",660,453,446,13,7,"PSC-PSOE",150
8,"8193",928,565,554,15,11,"PSC-PSOE",100
8,"8234",3143,2040,2008,45,32,"PSC-PSOE",362
17,"17228",280,172,170,4,2,"PSC-PSOE",20
8,"8070",275,192,191,5,1,"PSC-PSOE",22
25,"25221",125,76,76,0,0,"PSC-PSOE",23
43,"43137",1873,1241,1212,27,29,"PSC-PSOE",292
17,"17138",1010,677,662,3,15,"PSC-PSOE",219
43,"43118",439,318,313,7,5,"PSC-PSOE",116
8,"8278",4668,3033,2949,67,84,"PSC-PSOE",195
8,"8084",1134,789,760,14,29,"PSC-PSOE",146
8,"8003",6983,5061,4993,53,68,"PSC-PSOE",722
8,"8105",9642,6571,6483,110,88,"PSC-PSOE",2478
25,"25176",341,243,240,7,3,"PSC-PSOE",29
8,"8024",409,266,260,4,6,"PSC-PSOE",48
17,"17003",101,67,64,2,3,"PSC-PSOE",13
17,"17117",14022,8705,8595,129,110,"PSC-PSOE",2266
8,"8235",3627,2506,2467,35,39,"PSC-PSOE",338
25,"25093",657,465,455,8,10,"PSC-PSOE",69
25,"25192",799,543,527,19,16,"PSC-PSOE",60
8,"8045",70,42,42,2,0,"PSC-PSOE",4
17,"17093",859,561,552,16,9,"PSC-PSOE",80
43,"43149",711,529,516,13,13,"PSC-PSOE",218
43,"43027",177,129,128,6,1,"PSC-PSOE",2
8,"8065",1224,796,778,13,18,"PSC-PSOE",145
43,"43019",1356,868,837,13,31,"PSC-PSOE",233
8,"8035",12099,7838,7735,123,103,"PSC-PSOE",1616
8,"8259",6362,4482,4420,97,62,"PSC-PSOE",964
43,"43174",152,104,101,1,3,"PSC-PSOE",8
17,"17046",738,510,498,15,12,"PSC-PSOE",103
8,"8175",3477,2303,2270,39,33,"PSC-PSOE",378
25,"25906",235,160,154,3,6,"PSC-PSOE",41
8,"8006",10984,7255,7092,104,163,"PSC-PSOE",1402
8,"8250",7083,4485,4426,72,59,"PSC-PSOE",1611
43,"43175",590,419,411,8,8,"PSC-PSOE",75
43,"43020",2119,1463,1427,26,36,"PSC-PSOE",391
25,"25210",1164,799,789,13,10,"PSC-PSOE",168
8,"8291",4516,2895,2855,56,40,"PSC-PSOE",719
43,"43139",2166,1319,1270,37,49,"PSC-PSOE",158
8,"8124",36292,24541,24210,471,331,"PSC-PSOE",8508
25,"25069",471,291,289,9,2,"PSC-PSOE",41
17,"17012",1093,689,679,11,10,"PSC-PSOE",108
8,"8207",1718,1296,1256,28,40,"PSC-PSOE",116
8,"8206",717,557,547,7,10,"PSC-PSOE",133
43,"43115",171,112,110,3,2,"PSC-PSOE",24
8,"8244",5746,4044,3940,102,104,"PSC-PSOE",967
25,"25092",135,100,97,2,3,"PSC-PSOE",5
25,"25182",1075,749,731,30,18,"PSC-PSOE",216
8,"8264",3983,2773,2744,30,29,"PSC-PSOE",364
17,"17025",1127,775,760,11,15,"PSC-PSOE",130
43,"43077",486,335,328,4,7,"PSC-PSOE",158
17,"17197",144,103,102,3,1,"PSC-PSOE",17
17,"17076",126,77,76,5,1,"PSC-PSOE",11
43,"43086",5269,3275,3196,92,79,"PSC-PSOE",647
8,"8221",11348,8413,8306,109,107,"PSC-PSOE",1708
8,"8169",47505,31997,31566,555,431,"PSC-PSOE",12264
8,"8269",2613,1840,1814,32,26,"PSC-PSOE",184
25,"25044",195,136,134,1,2,"PSC-PSOE",7
43,"43127",778,530,524,6,6,"PSC-PSOE",83
8,"8306",509,330,324,6,6,"PSC-PSOE",26
43,"43128",927,636,625,11,11,"PSC-PSOE",170
8,"8222",1827,1343,1317,21,26,"PSC-PSOE",292
17,"17057",1010,640,634,19,6,"PSC-PSOE",134
43,"43079",387,259,255,26,4,"PSC-PSOE",48
25,"25019",4626,2971,2932,54,39,"PSC-PSOE",668
25,"25212",233,185,185,8,0,"PSC-PSOE",26
17,"17217",347,267,251,5,16,"PSC-PSOE",35
25,"25077",474,281,277,5,4,"PSC-PSOE",32
8,"8170",458,300,288,13,12,"PSC-PSOE",26
17,"17001",557,370,365,7,5,"PSC-PSOE",59
17,"17125",132,90,89,1,1,"PSC-PSOE",8
25,"25196",127,87,86,3,1,"PSC-PSOE",7
17,"17178",1075,683,679,15,4,"PSC-PSOE",116
43,"43907",4122,2759,2712,52,47,"PSC-PSOE",1016
17,"17036",2822,1844,1806,36,38,"PSC-PSOE",374
17,"17161",978,693,687,21,6,"PSC-PSOE",76
17,"17189",1536,1061,1025,7,36,"PSC-PSOE",147
8,"8020",4542,3352,3298,77,54,"PSC-PSOE",627
17,"17137",3331,2163,2110,39,53,"PSC-PSOE",316
25,"25120",90759,58761,57778,1325,983,"PSC-PSOE",13710
17,"17135",380,273,269,9,4,"PSC-PSOE",38
8,"8161",10991,6841,6709,114,132,"PSC-PSOE",1764
43,"43047",4064,2412,2352,50,60,"PSC-PSOE",714
17,"17208",1012,642,622,12,20,"PSC-PSOE",60
8,"8110",13366,8493,8329,144,164,"PSC-PSOE",2558
8,"8019",1143222,778246,767530,12386,10716,"PSC-PSOE",197516
8,"8243",160,112,110,3,2,"PSC-PSOE",2
17,"17176",141,96,95,3,1,"PSC-PSOE",13
17,"17903",893,565,556,14,9,"PSC-PSOE",98
17,"17069",395,276,267,2,9,"PSC-PSOE",17
43,"43154",136,97,96,6,1,"PSC-PSOE",20
17,"17218",568,361,350,11,11,"PSC-PSOE",36
17,"17020",3446,2322,2268,45,54,"PSC-PSOE",315
25,"25078",1014,730,719,17,11,"PSC-PSOE",112
17,"17060",378,240,233,1,7,"PSC-PSOE",35
17,"17029",198,136,133,1,3,"PSC-PSOE",9
8,"8905",2268,1692,1657,28,35,"PSC-PSOE",331
25,"25067",768,498,494,14,4,"PSC-PSOE",93
17,"17039",1850,1299,1275,31,24,"PSC-PSOE",295
25,"25158",1647,1154,1135,27,19,"PSC-PSOE",135
17,"17038",343,261,256,2,5,"PSC-PSOE",14
25,"25183",485,336,327,6,9,"PSC-PSOE",56
17,"17110",1359,930,917,12,13,"PSC-PSOE",213
8,"8174",409,294,292,10,2,"PSC-PSOE",28
25,"25217",10570,6660,6500,191,160,"PSC-PSOE",1222
25,"25114",102,82,78,4,4,"PSC-PSOE",4
8,"8184",52133,33696,33220,656,476,"PSC-PSOE",10923
43,"43138",2719,1775,1730,45,45,"PSC-PSOE",357
8,"8300",5621,4021,3933,94,88,"PSC-PSOE",943
8,"8058",1699,1089,1061,25,28,"PSC-PSOE",333
17,"17064",341,253,250,4,3,"PSC-PSOE",41
43,"43163",24903,15475,15241,263,234,"PSC-PSOE",4403
17,"17221",4135,2789,2723,49,66,"PSC-PSOE",662
17,"17050",645,438,425,15,13,"PSC-PSOE",38
25,"25115",878,542,542,17,0,"PSC-PSOE",76
43,"43017",141,98,98,2,0,"PSC-PSOE",17
43,"43066",165,113,112,2,1,"PSC-PSOE",24
8,"8050",149,112,108,4,4,"PSC-PSOE",9
8,"8141",4666,3124,3066,57,58,"PSC-PSOE",661
43,"43121",636,385,371,6,14,"PSC-PSOE",98
8,"8012",1694,1155,1136,32,19,"PSC-PSOE",130
43,"43050",2407,1528,1504,20,24,"PSC-PSOE",423
8,"8113",52352,33606,33123,590,483,"PSC-PSOE",7028
8,"8083",1626,1199,1178,23,21,"PSC-PSOE",106
17,"17132",1296,913,900,15,13,"PSC-PSOE",154
25,"25215",399,229,226,4,3,"PSC-PSOE",50
8,"8121",85069,58372,57620,923,752,"PSC-PSOE",14948
43,"43170",880,601,592,9,9,"PSC-PSOE",139
43,"43029",330,202,194,6,8,"PSC-PSOE",23
25,"25055",187,115,115,3,0,"PSC-PSOE",3
17,"17145",1593,1090,1068,10,22,"PSC-PSOE",145
25,"25024",370,221,217,8,4,"PSC-PSOE",57
43,"43092",7051,4294,4220,45,74,"PSC-PSOE",994
8,"8104",713,454,441,9,13,"PSC-PSOE",49
25,"25073",662,382,379,11,3,"PSC-PSOE",66
43,"43165",624,471,459,6,12,"PSC-PSOE",69
43,"43133",5697,3470,3388,76,82,"PSC-PSOE",958
17,"17194",93,55,55,1,0,"PSC-PSOE",6
8,"8172",19889,13537,13333,267,204,"PSC-PSOE",3284
17,"17115",281,209,207,5,2,"PSC-PSOE",33
25,"25035",428,289,284,5,5,"PSC-PSOE",62
25,"25200",353,225,217,4,8,"PSC-PSOE",48
43,"43904",2918,1779,1732,49,47,"PSC-PSOE",431
8,"8239",471,338,333,6,5,"PSC-PSOE",51
8,"8290",1446,1075,1056,12,19,"PSC-PSOE",191
8,"8249",273,218,214,4,4,"PSC-PSOE",30
17,"17165",608,414,400,9,14,"PSC-PSOE",70
8,"8116",600,401,393,9,8,"PSC-PSOE",27
8,"8119",6039,3991,3884,74,107,"PSC-PSOE",1017
25,"25033",1125,738,718,17,20,"PSC-PSOE",122
25,"25012",2204,1432,1406,29,26,"PSC-PSOE",294
43,"43134",279,208,206,14,2,"PSC-PSOE",61
43,"43060",3049,2030,1980,62,50,"PSC-PSOE",715
43,"43142",1155,730,714,20,16,"PSC-PSOE",116
8,"8271",74,45,44,3,1,"PSC-PSOE",2
43,"43052",1001,669,636,12,33,"PSC-PSOE",201
17,"17024",301,207,204,4,3,"PSC-PSOE",17
25,"25023",4446,3079,3020,70,59,"PSC-PSOE",496
8,"8287",1053,738,730,26,8,"PSC-PSOE",125
8,"8237",1692,1155,1127,22,28,"PSC-PSOE",161
17,"17009",4089,2573,2490,59,83,"PSC-PSOE",341
17,"17170",192,135,134,1,1,"PSC-PSOE",7
43,"43039",117,85,83,3,2,"PSC-PSOE",3
25,"25058",4390,2696,2650,57,46,"PSC-PSOE",387
25,"25002",481,306,302,6,4,"PSC-PSOE",34
25,"25123",206,140,136,4,4,"PSC-PSOE",15
8,"8284",11920,7059,6942,139,117,"PSC-PSOE",1618
8,"8009",8932,6188,6088,103,100,"PSC-PSOE",992
17,"17200",616,406,393,12,13,"PSC-PSOE",89
17,"17088",551,374,363,4,11,"PSC-PSOE",49
8,"8211",32035,23059,22687,453,372,"PSC-PSOE",7095
25,"25149",1401,1031,1010,17,21,"PSC-PSOE",155
17,"17177",563,398,388,7,10,"PSC-PSOE",58
8,"8282",6092,4478,4405,79,73,"PSC-PSOE",820
43,"43176",832,575,572,16,3,"PSC-PSOE",94
17,"17206",167,108,107,2,1,"PSC-PSOE",7
8,"8292",1083,775,764,21,11,"PSC-PSOE",215
8,"8128",557,377,374,16,3,"PSC-PSOE",56
17,"17168",393,285,281,8,4,"PSC-PSOE",33
25,"25222",69,55,54,0,1,"PSC-PSOE",6
8,"8283",5862,3712,3618,72,94,"PSC-PSOE",488
17,"17077",580,374,372,5,2,"PSC-PSOE",41
25,"25111",116,70,70,0,0,"PSC-PSOE",5
43,"43054",2850,1815,1771,37,44,"PSC-PSOE",322
25,"25255",468,318,309,9,9,"PSC-PSOE",73
25,"25057",198,140,136,2,4,"PSC-PSOE",47
17,"17140",684,476,470,10,6,"PSC-PSOE",79
17,"17143",134,89,87,2,2,"PSC-PSOE",16
17,"17195",324,220,214,6,6,"PSC-PSOE",39
17,"17139",1346,899,869,21,30,"PSC-PSOE",171
25,"25226",257,162,158,5,4,"PSC-PSOE",49
8,"8063",434,336,333,8,3,"PSC-PSOE",28
8,"8109",200,155,153,1,2,"PSC-PSOE",9
8,"8263",20729,13742,13563,232,179,"PSC-PSOE",4164
17,"17160",14852,9257,9128,145,129,"PSC-PSOE",2561
25,"25020",328,216,209,4,7,"PSC-PSOE",41
17,"17094",1161,694,683,11,11,"PSC-PSOE",88
8,"8015",155673,101652,100264,1628,1388,"PSC-PSOE",32693
25,"25097",102,70,69,3,1,"PSC-PSOE",2
25,"25912",899,643,640,6,3,"PSC-PSOE",159
43,"43091",142,106,98,5,8,"PSC-PSOE",18
17,"17192",145,107,105,4,2,"PSC-PSOE",13
17,"17100",201,140,135,1,5,"PSC-PSOE",15
8,"8052",148,103,98,1,5,"PSC-PSOE",8
25,"25112",286,202,199,11,3,"PSC-PSOE",22
25,"25101",583,391,382,8,9,"PSC-PSOE",110
25,"25031",57,34,34,1,0,"PSC-PSOE",8
8,"8067",5657,3772,3671,75,101,"PSC-PSOE",692
8,"8179",591,415,405,6,10,"PSC-PSOE",53
8,"8101",169663,112624,111107,1841,1517,"PSC-PSOE",43154
25,"25193",771,509,501,8,8,"PSC-PSOE",62
8,"8071",248,172,167,2,5,"PSC-PSOE",30
43,"43080",254,175,173,7,2,"PSC-PSOE",24
25,"25132",128,87,85,3,2,"PSC-PSOE",9
25,"25102",733,478,464,15,14,"PSC-PSOE",72
43,"43040",350,251,246,18,5,"PSC-PSOE",48
17,"17099",74,52,50,1,2,"PSC-PSOE",4
8,"8142",127,83,83,4,0,"PSC-PSOE",13
25,"25124",161,110,109,4,1,"PSC-PSOE",6
8,"8307",47176,31341,30846,536,495,"PSC-PSOE",9329
17,"17162",137,80,78,2,2,"PSC-PSOE",7
25,"25206",289,187,184,3,3,"PSC-PSOE",39
8,"8092",3928,2511,2473,33,38,"PSC-PSOE",503
8,"8082",1143,733,723,17,10,"PSC-PSOE",195
8,"8246",1714,1175,1153,27,22,"PSC-PSOE",101
8,"8041",10032,6880,6761,112,119,"PSC-PSOE",2286
17,"17091",433,288,277,16,11,"PSC-PSOE",33
17,"17106",140,105,104,0,1,"PSC-PSOE",14
25,"25030",147,101,95,3,6,"PSC-PSOE",14
17,"17090",548,412,404,7,8,"PSC-PSOE",41
43,"43011",1013,745,729,21,16,"PSC-PSOE",95
25,"25109",279,183,183,2,0,"PSC-PSOE",16
8,"8153",502,357,350,7,7,"PSC-PSOE",35
17,"17081",236,165,162,2,3,"PSC-PSOE",12
17,"17232",159,107,104,0,3,"PSC-PSOE",18
25,"25174",438,289,283,4,6,"PSC-PSOE",52
43,"43112",294,184,181,2,3,"PSC-PSOE",39
43,"43113",454,321,316,10,5,"PSC-PSOE",55
8,"8203",2442,1526,1498,34,28,"PSC-PSOE",282
25,"25233",270,207,201,3,6,"PSC-PSOE",41
8,"8233",1867,1179,1169,29,10,"PSC-PSOE",123
8,"8182",2802,1871,1852,35,19,"PSC-PSOE",678
43,"43028",2654,1620,1588,27,32,"PSC-PSOE",422
25,"25048",1684,1120,1095,29,25,"PSC-PSOE",211
17,"17134",235,149,148,3,1,"PSC-PSOE",23
43,"43153",10307,6572,6450,94,122,"PSC-PSOE",1702
25,"25021",2693,1632,1605,40,27,"PSC-PSOE",403
17,"17150",1428,1018,996,24,22,"PSC-PSOE",143
43,"43007",635,448,441,7,7,"PSC-PSOE",64
25,"25064",122,91,88,7,3,"PSC-PSOE",3
43,"43140",2393,1612,1583,23,29,"PSC-PSOE",509
17,"17184",1281,803,787,21,16,"PSC-PSOE",84
43,"43141",131,71,70,3,1,"PSC-PSOE",14
25,"25905",386,264,258,12,6,"PSC-PSOE",25
8,"8146",1321,876,862,18,14,"PSC-PSOE",245
8,"8165",1689,1091,1070,18,21,"PSC-PSOE",265
17,"17136",173,124,120,0,4,"PSC-PSOE",17
43,"43132",365,217,214,8,3,"PSC-PSOE",19
43,"43042",2071,1504,1485,28,19,"PSC-PSOE",218
8,"8136",11117,7602,7478,174,124,"PSC-PSOE",2111
17,"17213",5282,3097,3041,42,56,"PSC-PSOE",645
25,"25186",231,168,168,3,0,"PSC-PSOE",8
43,"43043",3065,1952,1919,39,33,"PSC-PSOE",511
17,"17023",26941,17098,16799,344,299,"PSC-PSOE",5299
25,"25053",1085,733,727,10,6,"PSC-PSOE",132
8,"8085",1033,731,720,10,11,"PSC-PSOE",86
43,"43116",494,328,325,5,3,"PSC-PSOE",107
43,"43008",333,206,197,3,9,"PSC-PSOE",72
43,"43081",574,415,404,13,11,"PSC-PSOE",64
25,"25180",245,167,165,3,2,"PSC-PSOE",22
8,"8163",17986,11683,11548,159,135,"PSC-PSOE",3343
17,"17210",527,358,349,9,9,"PSC-PSOE",31
17,"17084",269,177,175,4,2,"PSC-PSOE",20
8,"8147",17023,11177,10961,184,216,"PSC-PSOE",3175
43,"43159",89,51,51,2,0,"PSC-PSOE",9
43,"43049",805,555,536,6,19,"PSC-PSOE",77
8,"8062",863,595,583,8,12,"PSC-PSOE",106
17,"17222",108,86,86,1,0,"PSC-PSOE",8
8,"8144",769,494,481,16,13,"PSC-PSOE",86
25,"25051",1710,1060,1044,23,16,"PSC-PSOE",145
8,"8297",138,99,99,2,0,"PSC-PSOE",2
25,"25129",175,105,105,3,0,"PSC-PSOE",4
8,"8191",5520,3601,3536,64,65,"PSC-PSOE",970
8,"8059",323,189,186,9,3,"PSC-PSOE",26
8,"8294",1870,1205,1171,22,34,"PSC-PSOE",144
43,"43071",975,677,664,14,13,"PSC-PSOE",97
8,"8253",134,91,91,2,0,"PSC-PSOE",5
43,"43145",3968,2781,2742,52,39,"PSC-PSOE",714
17,"17230",456,326,320,10,6,"PSC-PSOE",46
25,"25234",4572,2707,2648,57,59,"PSC-PSOE",670
8,"8201",458,305,298,12,7,"PSC-PSOE",41
43,"43906",2050,1332,1298,28,34,"PSC-PSOE",262
25,"25017",248,160,159,1,1,"PSC-PSOE",22
8,"8262",6835,4086,3993,94,93,"PSC-PSOE",1080
8,"8108",4879,3475,3437,64,38,"PSC-PSOE",804
8,"8252",24033,16704,16402,368,302,"PSC-PSOE",5744
25,"25911",472,306,296,2,10,"PSC-PSOE",26
8,"8031",2289,1619,1599,34,20,"PSC-PSOE",301
8,"8303",279,202,201,11,1,"PSC-PSOE",40
17,"17086",1687,1148,1129,14,19,"PSC-PSOE",245
43,"43005",3559,2191,2147,47,44,"PSC-PSOE",594
43,"43168",106,70,69,2,1,"PSC-PSOE",15
8,"8049",1340,839,816,10,23,"PSC-PSOE",98
43,"43038",20710,12999,12771,224,228,"PSC-PSOE",2937
43,"43117",150,118,115,1,3,"PSC-PSOE",23
17,"17198",404,264,259,9,5,"PSC-PSOE",42
17,"17120",779,501,485,9,16,"PSC-PSOE",60
43,"43045",156,110,109,1,1,"PSC-PSOE",12
17,"17062",5994,3686,3614,69,72,"PSC-PSOE",889
25,"25103",125,82,80,4,2,"PSC-PSOE",12
25,"25168",510,385,378,19,7,"PSC-PSOE",33
17,"17004",504,340,337,6,3,"PSC-PSOE",68
43,"43088",1810,1199,1177,29,22,"PSC-PSOE",160
8,"8096",40650,28247,27784,527,463,"PSC-PSOE",7544
43,"43044",3990,2768,2715,72,53,"PSC-PSOE",776
25,"25045",51,33,33,2,0,"PSC-PSOE",3
17,"17043",159,101,100,2,1,"PSC-PSOE",6
17,"17047",4803,2866,2803,30,63,"PSC-PSOE",512
17,"17037",105,66,66,2,0,"PSC-PSOE",3
25,"25902",581,411,395,15,16,"PSC-PSOE",31
8,"8051",17397,12178,12002,240,176,"PSC-PSOE",3175
8,"8256",669,498,496,16,2,"PSC-PSOE",62
8,"8305",26208,17810,17506,296,304,"PSC-PSOE",4349
43,"43006",712,484,475,10,9,"PSC-PSOE",189
25,"25151",641,451,444,20,7,"PSC-PSOE",41
17,"17119",89,65,64,3,1,"PSC-PSOE",3
25,"25037",396,275,273,9,2,"PSC-PSOE",40
17,"17048",6176,3818,3773,52,45,"PSC-PSOE",852
8,"8265",1575,1065,1026,38,39,"PSC-PSOE",143
8,"8094",1500,1102,1071,21,31,"PSC-PSOE",202
25,"25240",1398,976,958,17,18,"PSC-PSOE",181
17,"17902",1330,898,874,11,24,"PSC-PSOE",140
8,"8149",985,683,671,11,12,"PSC-PSOE",53
8,"8102",27850,18716,18470,373,246,"PSC-PSOE",3482
17,"17133",1336,889,866,14,23,"PSC-PSOE",96
17,"17042",415,297,292,2,5,"PSC-PSOE",46
17,"17223",787,523,514,8,9,"PSC-PSOE",123
25,"25153",215,165,161,0,4,"PSC-PSOE",23
17,"17171",148,111,109,5,2,"PSC-PSOE",15
25,"25059",796,580,575,9,5,"PSC-PSOE",180
43,"43122",92,65,61,0,4,"PSC-PSOE",11
17,"17182",257,177,175,2,2,"PSC-PSOE",48
8,"8195",88,64,64,2,0,"PSC-PSOE",2
8,"8212",508,366,363,1,3,"PSC-PSOE",30
25,"25052",1611,1094,1062,21,32,"PSC-PSOE",162
17,"17154",93,54,49,1,5,"PSC-PSOE",23
25,"25119",2297,1554,1513,46,41,"PSC-PSOE",288
25,"25070",888,594,582,18,12,"PSC-PSOE",119
25,"25137",8404,5264,5167,112,97,"PSC-PSOE",1005
17,"17121",230,159,158,7,1,"PSC-PSOE",11
8,"8229",561,404,398,12,6,"PSC-PSOE",26
8,"8123",18751,13394,13154,238,240,"PSC-PSOE",3599
43,"43136",10163,6312,6197,121,115,"PSC-PSOE",1942
25,"25140",785,472,460,5,12,"PSC-PSOE",63
25,"25163",237,147,142,2,5,"PSC-PSOE",4
8,"8080",42,33,33,2,0,"PSC-PSOE",8
8,"8011",1754,1116,1085,29,31,"PSC-PSOE",114
25,"25071",56,37,35,2,2,"PSC-PSOE",4
8,"8028",1049,667,657,15,10,"PSC-PSOE",195
25,"25133",748,499,483,7,16,"PSC-PSOE",85
43,"43903",2368,1504,1492,22,12,"PSC-PSOE",480
25,"25010",206,119,118,7,1,"PSC-PSOE",30
8,"8098",2374,1552,1535,28,17,"PSC-PSOE",300
17,"17109",759,428,414,10,14,"PSC-PSOE",42
8,"8274",4887,3326,3279,36,47,"PSC-PSOE",1077
8,"8214",6754,4659,4555,83,104,"PSC-PSOE",790
8,"8254",1721,1189,1174,26,15,"PSC-PSOE",93
17,"17080",165,115,114,1,1,"PSC-PSOE",15
17,"17041",237,153,153,1,0,"PSC-PSOE",34
8,"8138",4014,2735,2679,46,56,"PSC-PSOE",484
25,"25016",2203,1375,1357,20,18,"PSC-PSOE",295
8,"8220",2277,1641,1604,44,37,"PSC-PSOE",141
8,"8017",2740,1800,1768,38,32,"PSC-PSOE",363
8,"8007",6338,4165,4050,89,115,"PSC-PSOE",582
25,"25208",294,174,170,3,4,"PSC-PSOE",43
43,"43123",70216,45627,44828,906,799,"PSC-PSOE",11183
8,"8081",332,232,225,2,7,"PSC-PSOE",11
25,"25015",394,264,264,14,0,"PSC-PSOE",41
25,"25105",146,90,89,1,1,"PSC-PSOE",12
8,"8901",249,180,180,2,0,"PSC-PSOE",10
43,"43166",1521,1002,977,17,25,"PSC-PSOE",210
25,"25219",144,90,86,0,4,"PSC-PSOE",6
25,"25146",227,150,149,0,1,"PSC-PSOE",7
8,"8268",1110,768,755,17,13,"PSC-PSOE",226
8,"8177",52,31,31,1,0,"PSC-PSOE",2
8,"8027",673,527,515,9,12,"PSC-PSOE",128
8,"8038",1406,911,895,24,16,"PSC-PSOE",187
8,"8286",2865,1843,1796,30,47,"PSC-PSOE",502
43,"43053",190,149,149,2,0,"PSC-PSOE",36
25,"25903",261,176,170,9,6,"PSC-PSOE",29
17,"17079",62633,40844,40101,670,743,"PSC-PSOE",8811
8,"8066",1315,985,965,16,20,"PSC-PSOE",222
25,"25126",286,192,189,7,3,"PSC-PSOE",41
25,"25230",1665,1164,1140,36,24,"PSC-PSOE",282
8,"8280",116,74,72,3,2,"PSC-PSOE",10
8,"8046",12603,8826,8663,190,163,"PSC-PSOE",1879
17,"17107",301,203,200,8,3,"PSC-PSOE",15
25,"25204",1313,888,881,21,7,"PSC-PSOE",212
17,"17185",2273,1416,1379,32,37,"PSC-PSOE",233
17,"17169",2460,1690,1651,34,39,"PSC-PSOE",359
17,"17216",158,100,97,1,3,"PSC-PSOE",6
8,"8255",132,83,82,1,1,"PSC-PSOE",6
17,"17191",153,116,114,0,2,"PSC-PSOE",11
17,"17124",1670,1087,1056,18,31,"PSC-PSOE",235
17,"17019",1783,1264,1234,42,30,"PSC-PSOE",222
25,"25040",10654,6905,6768,144,137,"PSC-PSOE",1613
8,"8100",1934,1437,1401,40,36,"PSC-PSOE",78
43,"43095",2434,1658,1624,27,34,"PSC-PSOE",341
8,"8148",2240,1246,1223,22,23,"PSC-PSOE",380
17,"17055",158,121,121,4,0,"PSC-PSOE",21
43,"43146",45,33,30,1,3,"PSC-PSOE",3
8,"8089",33316,22369,22107,437,262,"PSC-PSOE",7118
8,"8208",5471,3859,3792,82,67,"PSC-PSOE",1085
25,"25225",603,395,387,7,8,"PSC-PSOE",38
17,"17226",852,539,535,0,4,"PSC-PSOE",110
25,"25060",92,53,52,1,1,"PSC-PSOE",3
8,"8166",1138,726,706,10,20,"PSC-PSOE",172
8,"8215",2594,1763,1728,51,35,"PSC-PSOE",317
8,"8122",1755,1063,1034,17,29,"PSC-PSOE",296
8,"8088",11250,8019,7861,144,158,"PSC-PSOE",1311
17,"17166",503,361,342,10,19,"PSC-PSOE",50
43,"43070",265,198,196,3,2,"PSC-PSOE",41
8,"8162",1955,1306,1271,28,35,"PSC-PSOE",285
25,"25228",2907,2043,2021,43,22,"PSC-PSOE",389
8,"8056",39345,26705,26396,449,309,"PSC-PSOE",6821
17,"17204",539,349,347,10,2,"PSC-PSOE",67
17,"17092",3520,2273,2228,42,45,"PSC-PSOE",547
43,"43037",16656,9986,9812,163,174,"PSC-PSOE",2739
43,"43114",383,238,234,6,4,"PSC-PSOE",57
17,"17061",175,123,123,4,0,"PSC-PSOE",4
8,"8275",242,188,186,4,2,"PSC-PSOE",10
8,"8157",8256,5729,5624,119,105,"PSC-PSOE",1689
43,"43076",467,308,300,7,8,"PSC-PSOE",81
25,"25041",625,432,420,20,12,"PSC-PSOE",82
17,"17130",333,236,233,5,3,"PSC-PSOE",23
8,"8091",5106,3379,3312,59,67,"PSC-PSOE",894
8,"8183",4497,2914,2865,43,49,"PSC-PSOE",540
25,"25209",1558,1041,1009,22,32,"PSC-PSOE",208
17,"17013",2774,1884,1859,21,25,"PSC-PSOE",474
43,"43148",89309,59260,58346,1202,914,"PSC-PSOE",15998
8,"8013",1234,834,820,23,14,"PSC-PSOE",138
8,"8074",10224,6571,6479,116,92,"PSC-PSOE",1813
8,"8155",6573,4411,4334,85,77,"PSC-PSOE",1182
43,"43016",3437,2323,2266,40,57,"PSC-PSOE",781
8,"8279",149233,101676,100363,1965,1313,"PSC-PSOE",29679
8,"8029",3389,2542,2514,45,28,"PSC-PSOE",331
17,"17033",5157,3142,3095,44,47,"PSC-PSOE",680
17,"17142",2440,1713,1681,39,32,"PSC-PSOE",325
17,"17146",2952,1895,1864,49,31,"PSC-PSOE",463
8,"8156",10672,7359,7225,121,134,"PSC-PSOE",1789
8,"8242",243,174,172,5,2,"PSC-PSOE",24
8,"8106",6858,4675,4559,113,116,"PSC-PSOE",1012
25,"25118",378,232,226,4,6,"PSC-PSOE",24
25,"25127",226,134,130,2,4,"PSC-PSOE",14
43,"43144",1187,787,772,12,15,"PSC-PSOE",157
25,"25170",271,197,196,4,1,"PSC-PSOE",49
25,"25072",5921,3743,3637,81,106,"PSC-PSOE",688
25,"25242",787,501,490,11,11,"PSC-PSOE",101
8,"8115",3870,2693,2644,60,49,"PSC-PSOE",754
43,"43177",338,242,236,6,6,"PSC-PSOE",52
43,"43158",109,63,61,5,2,"PSC-PSOE",6
17,"17032",1613,933,918,11,15,"PSC-PSOE",208
8,"8199",712,507,499,15,8,"PSC-PSOE",70
8,"8061",1467,960,952,10,8,"PSC-PSOE",240
17,"17016",725,491,481,8,10,"PSC-PSOE",63
43,"43100",3062,2058,2021,52,37,"PSC-PSOE",494
8,"8135",6647,4753,4678,79,75,"PSC-PSOE",1557
8,"8004",228,176,172,2,4,"PSC-PSOE",10
8,"8125",24559,16065,15798,293,267,"PSC-PSOE",5495
8,"8145",2597,1823,1784,23,39,"PSC-PSOE",403
25,"25167",253,176,172,0,4,"PSC-PSOE",4
43,"43109",2040,1332,1316,28,16,"PSC-PSOE",289
43,"43015",104,69,68,2,1,"PSC-PSOE",7
43,"43125",1008,706,701,10,5,"PSC-PSOE",226
17,"17049",3056,1986,1944,43,42,"PSC-PSOE",422
8,"8272",148,97,96,6,1,"PSC-PSOE",5
25,"25003",3853,2367,2340,68,27,"PSC-PSOE",399
43,"43072",97,73,70,0,3,"PSC-PSOE",11
8,"8180",26210,17504,17214,366,290,"PSC-PSOE",6107
43,"43097",379,283,278,6,5,"PSC-PSOE",46
25,"25245",445,312,306,4,6,"PSC-PSOE",101
8,"8075",3906,2442,2414,31,28,"PSC-PSOE",507
8,"8245",78826,51185,50445,962,740,"PSC-PSOE",20800
25,"25110",2662,1649,1602,44,47,"PSC-PSOE",348
43,"43064",2063,1420,1391,37,29,"PSC-PSOE",270
8,"8054",8733,6215,6077,123,138,"PSC-PSOE",1611
43,"43002",1790,1252,1226,17,26,"PSC-PSOE",365
8,"8188",106,87,86,4,1,"PSC-PSOE",4
43,"43051",8749,5494,5411,78,83,"PSC-PSOE",1723
25,"25085",153,103,100,2,3,"PSC-PSOE",13
8,"8198",4112,2766,2661,49,105,"PSC-PSOE",406
43,"43024",1459,958,937,17,21,"PSC-PSOE",264
17,"17174",183,120,117,5,3,"PSC-PSOE",8
8,"8289",4123,2802,2768,54,34,"PSC-PSOE",536
8,"8152",129,94,93,0,1,"PSC-PSOE",1
8,"8095",75,56,55,1,1,"PSC-PSOE",7
43,"43026",800,531,522,15,9,"PSC-PSOE",115
43,"43048",830,547,530,16,17,"PSC-PSOE",142
8,"8218",7968,5014,4932,129,82,"PSC-PSOE",1469
17,"17070",116,78,78,3,0,"PSC-PSOE",5
43,"43173",114,65,64,0,1,"PSC-PSOE",3
8,"8021",76,49,47,1,2,"PSC-PSOE",10
43,"43018",430,350,337,7,13,"PSC-PSOE",23
8,"8034",741,542,529,4,13,"PSC-PSOE",52
8,"8064",1847,1277,1246,14,31,"PSC-PSOE",202
17,"17083",2886,1825,1801,39,24,"PSC-PSOE",476
25,"25049",166,105,102,1,3,"PSC-PSOE",10
43,"43075",102,63,63,1,0,"PSC-PSOE",6
43,"43157",388,282,270,10,12,"PSC-PSOE",45
8,"8253",134,91,91,2,0,"P.P.",7
8,"8278",4668,3033,2949,67,84,"P.P.",210
8,"8218",7968,5014,4932,129,82,"P.P.",796
17,"17118",12541,7817,7681,130,136,"P.P.",1296
8,"8025",1460,990,963,14,27,"P.P.",179
17,"17149",366,254,251,4,3,"P.P.",10
8,"8069",3028,2071,2029,36,42,"P.P.",409
8,"8130",95,63,62,3,1,"P.P.",6
17,"17183",261,178,176,2,2,"P.P.",16
8,"8013",1234,834,820,23,14,"P.P.",134
8,"8168",418,268,266,0,2,"P.P.",88
8,"8109",200,155,153,1,2,"P.P.",20
8,"8258",845,577,555,23,22,"P.P.",25
8,"8033",12476,8513,8378,180,135,"P.P.",1467
8,"8120",6342,4801,4746,63,55,"P.P.",901
8,"8144",769,494,481,16,13,"P.P.",62
17,"17112",215,141,138,4,3,"P.P.",18
8,"8302",9271,5981,5892,82,89,"P.P.",1627
8,"8089",33316,22369,22107,437,262,"P.P.",5562
17,"17022",6771,4247,4169,76,78,"P.P.",488
17,"17030",624,414,409,8,5,"P.P.",95
8,"8008",193,119,114,5,5,"P.P.",23
8,"8146",1321,876,862,18,14,"P.P.",188
8,"8150",245,181,178,11,3,"P.P.",20
8,"8113",52352,33606,33123,590,483,"P.P.",5152
8,"8107",10955,7236,7130,151,106,"P.P.",2037
8,"8170",458,300,288,13,12,"P.P.",38
17,"17202",3799,2398,2366,44,32,"P.P.",404
8,"8167",5703,3896,3831,82,65,"P.P.",880
17,"17018",478,337,332,8,5,"P.P.",24
17,"17212",129,100,98,4,2,"P.P.",5
17,"17012",1093,689,679,11,10,"P.P.",165
17,"17066",25667,15429,15157,244,272,"P.P.",3764
8,"8901",249,180,180,2,0,"P.P.",5
8,"8104",713,454,441,9,13,"P.P.",57
17,"17076",126,77,76,5,1,"P.P.",8
8,"8099",808,533,519,11,14,"P.P.",41
8,"8197",7316,4983,4926,69,57,"P.P.",1240
8,"8273",2287,1594,1547,18,47,"P.P.",156
8,"8073",60247,41448,40843,770,605,"P.P.",9238
17,"17100",201,140,135,1,5,"P.P.",17
8,"8026",180,144,143,0,1,"P.P.",15
8,"8179",591,415,405,6,10,"P.P.",69
17,"17196",209,139,138,6,1,"P.P.",23
17,"17124",1670,1087,1056,18,31,"P.P.",93
17,"17199",6630,4242,4162,80,80,"P.P.",661
8,"8236",1507,1027,1002,18,25,"P.P.",163
8,"8096",40650,28247,27784,527,463,"P.P.",5386
8,"8280",116,74,72,3,2,"P.P.",6
8,"8074",10224,6571,6479,116,92,"P.P.",1740
8,"8086",13267,8791,8669,200,122,"P.P.",1892
8,"8103",636,453,446,16,7,"P.P.",74
17,"17047",4803,2866,2803,30,63,"P.P.",780
8,"8248",5239,3513,3443,71,70,"P.P.",657
8,"8067",5657,3772,3671,75,101,"P.P.",425
17,"17153",172,127,123,1,4,"P.P.",9
8,"8094",1500,1102,1071,21,31,"P.P.",151
17,"17014",64,39,37,0,2,"P.P.",12
8,"8301",47343,32098,31664,672,434,"P.P.",7749
17,"17157",127,99,98,3,1,"P.P.",6
8,"8077",33925,23896,23548,381,348,"P.P.",5988
17,"17215",1918,1350,1321,40,29,"P.P.",174
17,"17207",2357,1636,1584,40,52,"P.P.",104
17,"17027",2865,1955,1892,34,63,"P.P.",251
17,"17211",864,628,612,12,16,"P.P.",50
8,"8257",116,84,81,0,3,"P.P.",3
17,"17031",172,94,93,1,1,"P.P.",9
8,"8216",21,14,14,0,0,"P.P.",1
8,"8247",903,627,608,10,19,"P.P.",37
17,"17123",365,274,266,8,8,"P.P.",26
17,"17015",12254,7759,7553,143,206,"P.P.",778
17,"17078",346,231,226,3,5,"P.P.",27
8,"8004",228,176,172,2,4,"P.P.",3
8,"8059",323,189,186,9,3,"P.P.",11
8,"8143",2679,1772,1756,35,16,"P.P.",320
17,"17164",4092,2409,2346,60,63,"P.P.",185
17,"17121",230,159,158,7,1,"P.P.",20
17,"17225",208,138,134,1,4,"P.P.",9
8,"8189",141,113,111,4,2,"P.P.",6
8,"8227",2372,1591,1549,38,42,"P.P.",212
17,"17119",89,65,64,3,1,"P.P.",9
8,"8158",2996,2012,1986,19,26,"P.P.",303
17,"17174",183,120,117,5,3,"P.P.",9
8,"8210",4176,2661,2579,54,82,"P.P.",361
8,"8200",61189,40677,40069,736,608,"P.P.",8635
17,"17043",159,101,100,2,1,"P.P.",9
8,"8212",508,366,363,1,3,"P.P.",33
8,"8291",4516,2895,2855,56,40,"P.P.",663
17,"17067",732,483,470,16,13,"P.P.",24
17,"17158",404,266,264,3,2,"P.P.",57
17,"17903",893,565,556,14,9,"P.P.",58
8,"8251",4771,3214,3140,57,74,"P.P.",615
8,"8252",24033,16704,16402,368,302,"P.P.",4099
17,"17086",1687,1148,1129,14,19,"P.P.",306
8,"8220",2277,1641,1604,44,37,"P.P.",85
17,"17205",198,146,138,3,8,"P.P.",4
17,"17041",237,153,153,1,0,"P.P.",27
8,"8014",1906,1338,1313,37,25,"P.P.",148
8,"8175",3477,2303,2270,39,33,"P.P.",249
8,"8063",434,336,333,8,3,"P.P.",23
8,"8169",47505,31997,31566,555,431,"P.P.",6958
8,"8209",6596,4415,4351,69,64,"P.P.",1153
8,"8032",1955,1330,1294,18,36,"P.P.",221
17,"17214",695,470,461,10,9,"P.P.",75
17,"17166",503,361,342,10,19,"P.P.",20
8,"8058",1699,1089,1061,25,28,"P.P.",190
8,"8072",9910,6326,6235,140,91,"P.P.",1362
8,"8202",12206,8265,8129,183,136,"P.P.",1212
8,"8244",5746,4044,3940,102,104,"P.P.",770
8,"8137",255,190,190,3,0,"P.P.",19
8,"8106",6858,4675,4559,113,116,"P.P.",895
17,"17902",1330,898,874,11,24,"P.P.",67
17,"17134",235,149,148,3,1,"P.P.",8
8,"8249",273,218,214,4,4,"P.P.",21
8,"8298",25338,16982,16690,353,292,"P.P.",1747
8,"8023",6546,4261,4194,86,67,"P.P.",982
17,"17101",567,349,339,4,10,"P.P.",70
8,"8267",6215,4100,4011,82,89,"P.P.",690
8,"8176",166,111,109,0,2,"P.P.",23
17,"17138",1010,677,662,3,15,"P.P.",106
8,"8285",10168,6582,6423,152,159,"P.P.",573
17,"17167",2818,1886,1858,52,28,"P.P.",151
8,"8006",10984,7255,7092,104,163,"P.P.",1290
17,"17105",257,152,146,4,6,"P.P.",28
8,"8118",17077,11817,11598,203,219,"P.P.",2039
17,"17224",355,246,241,10,5,"P.P.",57
8,"8232",1793,1239,1220,20,19,"P.P.",160
17,"17087",230,170,161,6,9,"P.P.",17
8,"8262",6835,4086,3993,94,93,"P.P.",674
17,"17007",1778,1137,1113,16,24,"P.P.",124
17,"17159",639,408,397,3,11,"P.P.",55
8,"8017",2740,1800,1768,38,32,"P.P.",227
17,"17148",1546,980,957,24,23,"P.P.",163
17,"17058",177,115,114,2,1,"P.P.",13
17,"17002",567,413,401,4,12,"P.P.",53
8,"8260",17869,11898,11686,215,212,"P.P.",2748
8,"8174",409,294,292,10,2,"P.P.",49
17,"17901",964,628,621,16,7,"P.P.",53
8,"8263",20729,13742,13563,232,179,"P.P.",3259
8,"8052",148,103,98,1,5,"P.P.",10
17,"17140",684,476,470,10,6,"P.P.",59
17,"17054",395,250,247,3,3,"P.P.",39
8,"8293",246,145,145,4,0,"P.P.",5
17,"17046",738,510,498,15,12,"P.P.",44
17,"17221",4135,2789,2723,49,66,"P.P.",720
17,"17137",3331,2163,2110,39,53,"P.P.",188
8,"8133",157,100,97,2,3,"P.P.",23
8,"8241",80,61,61,1,0,"P.P.",7
8,"8141",4666,3124,3066,57,58,"P.P.",347
17,"17006",1203,759,754,17,5,"P.P.",96
8,"8237",1692,1155,1127,22,28,"P.P.",93
8,"8245",78826,51185,50445,962,740,"P.P.",12569
8,"8050",149,112,108,4,4,"P.P.",7
8,"8270",17464,11828,11677,212,151,"P.P.",2686
8,"8114",17629,11781,11579,189,202,"P.P.",2213
8,"8277",134,90,90,4,0,"P.P.",12
8,"8076",15925,10435,10242,179,193,"P.P.",2126
17,"17034",6723,4131,4064,77,67,"P.P.",746
17,"17063",169,113,111,5,2,"P.P.",8
17,"17040",506,320,316,7,4,"P.P.",34
8,"8124",36292,24541,24210,471,331,"P.P.",4965
8,"8097",985,676,657,3,19,"P.P.",61
8,"8305",26208,17810,17506,296,304,"P.P.",2723
17,"17109",759,428,414,10,14,"P.P.",32
17,"17084",269,177,175,4,2,"P.P.",15
17,"17142",2440,1713,1681,39,32,"P.P.",288
17,"17188",167,124,122,9,2,"P.P.",11
8,"8292",1083,775,764,21,11,"P.P.",129
17,"17117",14022,8705,8595,129,110,"P.P.",1584
17,"17026",542,404,398,3,6,"P.P.",49
17,"17036",2822,1844,1806,36,38,"P.P.",188
8,"8068",6554,4323,4255,87,68,"P.P.",955
8,"8194",24757,15009,14799,245,210,"P.P.",3818
17,"17150",1428,1018,996,24,22,"P.P.",102
8,"8230",7452,5349,5286,94,63,"P.P.",1176
17,"17033",5157,3142,3095,44,47,"P.P.",623
8,"8027",673,527,515,9,12,"P.P.",67
8,"8178",450,311,304,3,7,"P.P.",36
17,"17004",504,340,337,6,3,"P.P.",29
17,"17039",1850,1299,1275,31,24,"P.P.",164
8,"8213",6188,4031,3970,113,61,"P.P.",612
17,"17162",137,80,78,2,2,"P.P.",10
17,"17143",134,89,87,2,2,"P.P.",13
8,"8238",13892,10237,10094,206,143,"P.P.",1790
17,"17226",852,539,535,0,4,"P.P.",183
8,"8226",886,667,656,13,11,"P.P.",49
8,"8164",873,606,584,13,22,"P.P.",65
8,"8128",557,377,374,16,3,"P.P.",46
17,"17091",433,288,277,16,11,"P.P.",23
8,"8081",332,232,225,2,7,"P.P.",20
17,"17011",625,472,467,5,5,"P.P.",50
17,"17037",105,66,66,2,0,"P.P.",2
17,"17135",380,273,269,9,4,"P.P.",70
17,"17051",201,146,142,4,4,"P.P.",13
8,"8012",1694,1155,1136,32,19,"P.P.",106
8,"8093",32,21,20,0,1,"P.P.",0
8,"8134",776,528,513,15,15,"P.P.",69
8,"8060",167,102,101,0,1,"P.P.",15
8,"8043",3067,2044,2023,29,21,"P.P.",503
8,"8042",2172,1459,1448,30,11,"P.P.",360
8,"8148",2240,1246,1223,22,23,"P.P.",234
8,"8117",2424,1685,1661,45,24,"P.P.",224
8,"8183",4497,2914,2865,43,49,"P.P.",225
8,"8057",61,41,40,1,1,"P.P.",0
17,"17177",563,398,388,7,10,"P.P.",44
17,"17096",182,96,94,2,2,"P.P.",6
17,"17129",126,91,90,3,1,"P.P.",21
17,"17029",198,136,133,1,3,"P.P.",20
17,"17095",19245,11212,11067,160,145,"P.P.",2678
8,"8041",10032,6880,6761,112,119,"P.P.",1776
17,"17013",2774,1884,1859,21,25,"P.P.",352
17,"17197",144,103,102,3,1,"P.P.",12
8,"8151",504,345,338,6,7,"P.P.",36
17,"17233",2192,1470,1434,33,36,"P.P.",180
17,"17089",5486,3328,3288,43,40,"P.P.",455
17,"17145",1593,1090,1068,10,22,"P.P.",82
8,"8083",1626,1199,1178,23,21,"P.P.",45
8,"8196",18989,12658,12490,253,168,"P.P.",2961
8,"8259",6362,4482,4420,97,62,"P.P.",685
17,"17172",426,286,283,3,3,"P.P.",14
17,"17136",173,124,120,0,4,"P.P.",18
8,"8177",52,31,31,1,0,"P.P.",7
17,"17106",140,105,104,0,1,"P.P.",9
8,"8102",27850,18716,18470,373,246,"P.P.",2906
17,"17201",131,89,89,2,0,"P.P.",8
17,"17062",5994,3686,3614,69,72,"P.P.",675
17,"17200",616,406,393,12,13,"P.P.",33
8,"8147",17023,11177,10961,184,216,"P.P.",1976
8,"8307",47176,31341,30846,536,495,"P.P.",5537
8,"8066",1315,985,965,16,20,"P.P.",212
17,"17005",404,258,254,12,4,"P.P.",45
8,"8297",138,99,99,2,0,"P.P.",13
17,"17126",309,231,229,9,2,"P.P.",9
8,"8217",24130,17554,17319,383,235,"P.P.",3678
17,"17173",174,121,119,1,2,"P.P.",12
8,"8046",12603,8826,8663,190,163,"P.P.",1406
17,"17028",327,220,217,4,3,"P.P.",29
8,"8020",4542,3352,3298,77,54,"P.P.",630
17,"17208",1012,642,622,12,20,"P.P.",72
8,"8079",335,255,243,14,12,"P.P.",14
17,"17190",811,548,532,7,16,"P.P.",55
8,"8190",281,201,197,3,4,"P.P.",23
17,"17147",8385,5401,5325,105,76,"P.P.",618
17,"17048",6176,3818,3773,52,45,"P.P.",763
8,"8084",1134,789,760,14,29,"P.P.",108
17,"17193",3978,2365,2305,38,60,"P.P.",515
17,"17120",779,501,485,9,16,"P.P.",72
8,"8228",303,230,227,5,3,"P.P.",42
8,"8047",4141,2610,2580,49,30,"P.P.",452
17,"17064",341,253,250,4,3,"P.P.",34
8,"8108",4879,3475,3437,64,38,"P.P.",930
8,"8078",224,154,151,2,3,"P.P.",19
17,"17141",5689,3485,3428,50,57,"P.P.",744
17,"17103",4988,2788,2724,51,64,"P.P.",610
8,"8181",7722,5280,5188,112,92,"P.P.",1079
8,"8180",26210,17504,17214,366,290,"P.P.",4219
8,"8902",3600,2518,2496,57,22,"P.P.",546
8,"8266",42860,30047,29521,536,526,"P.P.",6689
8,"8065",1224,796,778,13,18,"P.P.",90
17,"17107",301,203,200,8,3,"P.P.",27
8,"8048",622,461,454,9,7,"P.P.",57
17,"17090",548,412,404,7,8,"P.P.",49
8,"8088",11250,8019,7861,144,158,"P.P.",1202
8,"8242",243,174,172,5,2,"P.P.",19
8,"8062",863,595,583,8,12,"P.P.",128
17,"17082",443,285,280,1,5,"P.P.",39
8,"8185",189,131,126,1,5,"P.P.",18
8,"8015",155673,101652,100264,1628,1388,"P.P.",26979
17,"17021",108,86,79,0,7,"P.P.",7
8,"8092",3928,2511,2473,33,38,"P.P.",273
8,"8056",39345,26705,26396,449,309,"P.P.",8003
17,"17008",3745,2262,2195,34,67,"P.P.",243
17,"17071",1064,719,698,33,21,"P.P.",52
17,"17144",217,145,143,4,2,"P.P.",15
8,"8207",1718,1296,1256,28,40,"P.P.",95
8,"8002",202,143,140,4,3,"P.P.",12
17,"17160",14852,9257,9128,145,129,"P.P.",1622
8,"8111",220,188,188,4,0,"P.P.",17
17,"17218",568,361,350,11,11,"P.P.",34
8,"8070",275,192,191,5,1,"P.P.",20
8,"8295",10579,6896,6769,137,127,"P.P.",1560
17,"17069",395,276,267,2,9,"P.P.",61
8,"8272",148,97,96,6,1,"P.P.",2
17,"17220",780,550,545,13,5,"P.P.",48
8,"8271",74,45,44,3,1,"P.P.",6
8,"8208",5471,3859,3792,82,67,"P.P.",793
8,"8139",184,130,128,1,2,"P.P.",6
8,"8132",381,247,241,6,6,"P.P.",19
17,"17056",1704,1171,1158,21,13,"P.P.",140
17,"17098",311,208,202,4,6,"P.P.",19
17,"17154",93,54,49,1,5,"P.P.",1
8,"8001",8538,5929,5838,120,91,"P.P.",1429
8,"8283",5862,3712,3618,72,94,"P.P.",434
17,"17115",281,209,207,5,2,"P.P.",23
8,"8031",2289,1619,1599,34,20,"P.P.",250
17,"17110",1359,930,917,12,13,"P.P.",165
8,"8184",52133,33696,33220,656,476,"P.P.",7907
8,"8085",1033,731,720,10,11,"P.P.",65
8,"8243",160,112,110,3,2,"P.P.",8
8,"8246",1714,1175,1153,27,22,"P.P.",88
8,"8153",502,357,350,7,7,"P.P.",38
17,"17223",787,523,514,8,9,"P.P.",81
8,"8195",88,64,64,2,0,"P.P.",8
8,"8163",17986,11683,11548,159,135,"P.P.",3022
17,"17182",257,177,175,2,2,"P.P.",53
17,"17111",789,584,574,15,10,"P.P.",58
17,"17232",159,107,104,0,3,"P.P.",12
8,"8018",2664,1707,1669,29,38,"P.P.",232
17,"17075",304,216,210,5,6,"P.P.",32
17,"17065",316,211,205,6,6,"P.P.",11
8,"8154",677,499,488,2,11,"P.P.",95
8,"8123",18751,13394,13154,238,240,"P.P.",1912
8,"8005",5884,4114,4041,68,73,"P.P.",754
17,"17163",2478,1729,1681,41,48,"P.P.",115
8,"8053",2850,1788,1772,21,16,"P.P.",316
8,"8284",11920,7059,6942,139,117,"P.P.",1483
8,"8166",1138,726,706,10,20,"P.P.",71
8,"8294",1870,1205,1171,22,34,"P.P.",170
17,"17079",62633,40844,40101,670,743,"P.P.",6702
8,"8110",13366,8493,8329,144,164,"P.P.",1622
17,"17088",551,374,363,4,11,"P.P.",28
17,"17080",165,115,114,1,1,"P.P.",11
8,"8036",172,124,124,4,0,"P.P.",14
8,"8087",158,133,132,6,1,"P.P.",11
8,"8221",11348,8413,8306,109,107,"P.P.",1667
8,"8255",132,83,82,1,1,"P.P.",1
17,"17102",571,354,350,7,4,"P.P.",49
17,"17209",605,469,463,21,6,"P.P.",76
8,"8028",1049,667,657,15,10,"P.P.",173
8,"8282",6092,4478,4405,79,73,"P.P.",790
8,"8129",444,278,271,2,7,"P.P.",24
17,"17081",236,165,162,2,3,"P.P.",17
8,"8082",1143,733,723,17,10,"P.P.",194
17,"17125",132,90,89,1,1,"P.P.",2
17,"17155",14284,8528,8391,143,137,"P.P.",1464
8,"8035",12099,7838,7735,123,103,"P.P.",1457
8,"8071",248,172,167,2,5,"P.P.",12
8,"8286",2865,1843,1796,30,47,"P.P.",395
17,"17042",415,297,292,2,5,"P.P.",20
8,"8055",476,312,304,11,8,"P.P.",37
17,"17139",1346,899,869,21,30,"P.P.",59
8,"8019",1143222,778246,767530,12386,10716,"P.P.",163658
17,"17198",404,264,259,9,5,"P.P.",45
17,"17077",580,374,372,5,2,"P.P.",54
17,"17210",527,358,349,9,9,"P.P.",66
17,"17186",3593,2358,2317,33,41,"P.P.",316
8,"8308",145,116,115,1,1,"P.P.",8
17,"17192",145,107,105,4,2,"P.P.",11
8,"8100",1934,1437,1401,40,36,"P.P.",111
8,"8240",9104,6355,6262,101,93,"P.P.",775
8,"8281",4735,3239,3193,57,46,"P.P.",443
8,"8264",3983,2773,2744,30,29,"P.P.",648
8,"8140",4665,3160,3103,55,57,"P.P.",406
17,"17097",185,136,136,4,0,"P.P.",8
8,"8038",1406,911,895,24,16,"P.P.",97
8,"8037",1830,1247,1209,40,38,"P.P.",95
17,"17151",174,131,131,6,0,"P.P.",20
8,"8155",6573,4411,4334,85,77,"P.P.",921
8,"8203",2442,1526,1498,34,28,"P.P.",305
8,"8090",120,86,86,2,0,"P.P.",11
8,"8193",928,565,554,15,11,"P.P.",96
17,"17085",295,212,208,12,4,"P.P.",8
8,"8121",85069,58372,57620,923,752,"P.P.",13231
8,"8234",3143,2040,2008,45,32,"P.P.",411
8,"8288",1735,985,957,13,28,"P.P.",182
8,"8115",3870,2693,2644,60,49,"P.P.",559
8,"8098",2374,1552,1535,28,17,"P.P.",312
17,"17061",175,123,123,4,0,"P.P.",15
8,"8256",669,498,496,16,2,"P.P.",77
17,"17169",2460,1690,1651,34,39,"P.P.",268
8,"8007",6338,4165,4050,89,115,"P.P.",578
8,"8192",5450,3688,3634,79,54,"P.P.",490
8,"8159",13482,9173,9040,239,133,"P.P.",1941
8,"8021",76,49,47,1,2,"P.P.",6
8,"8122",1755,1063,1034,17,29,"P.P.",161
17,"17057",1010,640,634,19,6,"P.P.",56
8,"8300",5621,4021,3933,94,88,"P.P.",921
17,"17175",569,375,369,6,6,"P.P.",93
8,"8304",822,587,578,16,9,"P.P.",58
17,"17189",1536,1061,1025,7,36,"P.P.",64
8,"8206",717,557,547,7,10,"P.P.",70
8,"8225",92,68,68,2,0,"P.P.",3
17,"17060",378,240,233,1,7,"P.P.",64
8,"8165",1689,1091,1070,18,21,"P.P.",150
8,"8239",471,338,333,6,5,"P.P.",53
8,"8080",42,33,33,2,0,"P.P.",6
17,"17025",1127,775,760,11,15,"P.P.",85
8,"8127",2274,1371,1338,23,33,"P.P.",227
8,"8011",1754,1116,1085,29,31,"P.P.",100
8,"8049",1340,839,816,10,23,"P.P.",82
17,"17068",252,156,156,4,0,"P.P.",10
8,"8250",7083,4485,4426,72,59,"P.P.",1064
8,"8287",1053,738,730,26,8,"P.P.",59
8,"8040",10538,6916,6804,99,112,"P.P.",1267
8,"8149",985,683,671,11,12,"P.P.",54
8,"8222",1827,1343,1317,21,26,"P.P.",203
17,"17023",26941,17098,16799,344,299,"P.P.",3579
17,"17187",574,414,402,1,12,"P.P.",37
8,"8289",4123,2802,2768,54,34,"P.P.",449
8,"8009",8932,6188,6088,103,100,"P.P.",1246
8,"8030",4849,3466,3422,50,44,"P.P.",630
8,"8191",5520,3601,3536,64,65,"P.P.",437
8,"8261",2273,1547,1525,30,22,"P.P.",405
8,"8904",10608,6654,6561,140,93,"P.P.",1773
17,"17016",725,491,481,8,10,"P.P.",56
8,"8233",1867,1179,1169,29,10,"P.P.",103
17,"17003",101,67,64,2,3,"P.P.",3
8,"8299",444,277,267,5,10,"P.P.",33
8,"8201",458,305,298,12,7,"P.P.",27
8,"8303",279,202,201,11,1,"P.P.",16
17,"17191",153,116,114,0,2,"P.P.",5
17,"17032",1613,933,918,11,15,"P.P.",55
8,"8219",14647,10347,10169,193,178,"P.P.",1737
8,"8215",2594,1763,1728,51,35,"P.P.",169
8,"8235",3627,2506,2467,35,39,"P.P.",304
8,"8276",249,188,187,9,1,"P.P.",23
8,"8116",600,401,393,9,8,"P.P.",35
17,"17130",333,236,233,5,3,"P.P.",15
17,"17222",108,86,86,1,0,"P.P.",1
17,"17152",10378,6239,6156,100,83,"P.P.",1717
17,"17001",557,370,365,7,5,"P.P.",32
17,"17070",116,78,78,3,0,"P.P.",5
17,"17092",3520,2273,2228,42,45,"P.P.",357
17,"17195",324,220,214,6,6,"P.P.",14
17,"17094",1161,694,683,11,11,"P.P.",107
8,"8157",8256,5729,5624,119,105,"P.P.",1185
17,"17185",2273,1416,1379,32,37,"P.P.",100
17,"17024",301,207,204,4,3,"P.P.",34
17,"17146",2952,1895,1864,49,31,"P.P.",360
8,"8003",6983,5061,4993,53,68,"P.P.",1027
8,"8024",409,266,260,4,6,"P.P.",41
8,"8022",12437,7598,7445,169,153,"P.P.",843
8,"8162",1955,1306,1271,28,35,"P.P.",243
17,"17217",347,267,251,5,16,"P.P.",20
17,"17009",4089,2573,2490,59,83,"P.P.",264
8,"8135",6647,4753,4678,79,75,"P.P.",1048
17,"17228",280,172,170,4,2,"P.P.",25
8,"8182",2802,1871,1852,35,19,"P.P.",440
8,"8204",2991,2076,2040,45,36,"P.P.",283
17,"17019",1783,1264,1234,42,30,"P.P.",96
8,"8161",10991,6841,6709,114,132,"P.P.",1530
17,"17044",6619,4293,4187,69,106,"P.P.",483
17,"17216",158,100,97,1,3,"P.P.",10
8,"8903",217,178,176,10,2,"P.P.",10
17,"17132",1296,913,900,15,13,"P.P.",132
8,"8160",313,227,222,8,5,"P.P.",19
8,"8268",1110,768,755,17,13,"P.P.",117
17,"17020",3446,2322,2268,45,54,"P.P.",182
8,"8105",9642,6571,6483,110,88,"P.P.",1626
17,"17168",393,285,281,8,4,"P.P.",31
8,"8112",12946,8533,8390,227,143,"P.P.",1112
8,"8051",17397,12178,12002,240,176,"P.P.",2063
8,"8075",3906,2442,2414,31,28,"P.P.",621
8,"8229",561,404,398,12,6,"P.P.",37
17,"17204",539,349,347,10,2,"P.P.",69
8,"8290",1446,1075,1056,12,19,"P.P.",132
17,"17176",141,96,95,3,1,"P.P.",19
17,"17227",107,82,82,1,0,"P.P.",8
17,"17128",309,232,224,5,8,"P.P.",41
17,"17165",608,414,400,9,14,"P.P.",30
8,"8188",106,87,86,4,1,"P.P.",15
8,"8054",8733,6215,6077,123,138,"P.P.",1418
17,"17035",548,385,379,7,6,"P.P.",44
8,"8214",6754,4659,4555,83,104,"P.P.",794
8,"8029",3389,2542,2514,45,28,"P.P.",436
17,"17050",645,438,425,15,13,"P.P.",43
17,"17055",158,121,121,4,0,"P.P.",6
8,"8199",712,507,499,15,8,"P.P.",64
8,"8091",5106,3379,3312,59,67,"P.P.",497
8,"8306",509,330,324,6,6,"P.P.",70
17,"17171",148,111,109,5,2,"P.P.",5
8,"8156",10672,7359,7225,121,134,"P.P.",1640
8,"8274",4887,3326,3279,36,47,"P.P.",465
17,"17181",3228,2116,2081,19,35,"P.P.",418
17,"17083",2886,1825,1801,39,24,"P.P.",265
8,"8231",19810,12359,12196,244,163,"P.P.",2891
8,"8187",149633,104021,102629,1794,1392,"P.P.",19145
8,"8064",1847,1277,1246,14,31,"P.P.",118
17,"17170",192,135,134,1,1,"P.P.",1
8,"8171",2158,1385,1359,27,26,"P.P.",124
8,"8039",365,264,260,5,4,"P.P.",14
8,"8905",2268,1692,1657,28,35,"P.P.",242
17,"17116",369,230,227,3,3,"P.P.",19
8,"8279",149233,101676,100363,1965,1313,"P.P.",20232
8,"8016",1984,1319,1289,26,30,"P.P.",95
17,"17178",1075,683,679,15,4,"P.P.",92
8,"8211",32035,23059,22687,453,372,"P.P.",4762
8,"8044",4247,2763,2712,50,51,"P.P.",480
17,"17206",167,108,107,2,1,"P.P.",7
17,"17194",93,55,55,1,0,"P.P.",4
17,"17184",1281,803,787,21,16,"P.P.",60
17,"17074",490,345,342,5,3,"P.P.",53
8,"8142",127,83,83,4,0,"P.P.",3
8,"8275",242,188,186,4,2,"P.P.",7
8,"8136",11117,7602,7478,174,124,"P.P.",1934
8,"8045",70,42,42,2,0,"P.P.",2
17,"17133",1336,889,866,14,23,"P.P.",60
8,"8119",6039,3991,3884,74,107,"P.P.",943
17,"17180",8076,4868,4767,81,101,"P.P.",623
17,"17213",5282,3097,3041,42,56,"P.P.",560
8,"8095",75,56,55,1,1,"P.P.",5
8,"8101",169663,112624,111107,1841,1517,"P.P.",26587
8,"8198",4112,2766,2661,49,105,"P.P.",445
8,"8138",4014,2735,2679,46,56,"P.P.",290
8,"8061",1467,960,952,10,8,"P.P.",220
17,"17093",859,561,552,16,9,"P.P.",93
17,"17038",343,261,256,2,5,"P.P.",21
8,"8254",1721,1189,1174,26,15,"P.P.",56
8,"8131",696,483,469,7,14,"P.P.",37
8,"8205",54870,41064,40491,682,573,"P.P.",7942
17,"17052",134,84,83,2,1,"P.P.",15
17,"17114",22610,14079,13811,263,268,"P.P.",1457
8,"8152",129,94,93,0,1,"P.P.",8
8,"8145",2597,1823,1784,23,39,"P.P.",254
17,"17203",171,97,94,3,3,"P.P.",7
8,"8269",2613,1840,1814,32,26,"P.P.",195
8,"8172",19889,13537,13333,267,204,"P.P.",2713
8,"8010",4124,2674,2611,44,63,"P.P.",313
8,"8223",1855,1178,1155,19,23,"P.P.",139
8,"8034",741,542,529,4,13,"P.P.",68
17,"17234",183,131,128,2,3,"P.P.",25
17,"17099",74,52,50,1,2,"P.P.",11
17,"17010",327,216,214,6,2,"P.P.",10
8,"8125",24559,16065,15798,293,267,"P.P.",3474
17,"17161",978,693,687,21,6,"P.P.",68
17,"17049",3056,1986,1944,43,42,"P.P.",234
8,"8126",8299,5599,5508,103,91,"P.P.",1251
8,"8296",1683,1227,1203,29,24,"P.P.",269
17,"17073",1753,1320,1298,18,22,"P.P.",162
17,"17230",456,326,320,10,6,"P.P.",66
8,"8265",1575,1065,1026,38,39,"P.P.",90
8,"8224",771,538,528,26,10,"P.P.",74
43,"43165",624,471,459,6,12,"PRE-R",0
43,"43114",383,238,234,6,4,"PRE-R",0
43,"43905",13621,8120,8011,131,109,"PRE-R",8
43,"43132",365,217,214,8,3,"PRE-R",0
43,"43066",165,113,112,2,1,"PRE-R",0
43,"43016",3437,2323,2266,40,57,"PRE-R",1
43,"43081",574,415,404,13,11,"PRE-R",0
43,"43089",272,193,185,1,8,"PRE-R",0
43,"43074",1697,1150,1120,25,30,"PRE-R",1
43,"43107",378,255,248,18,7,"PRE-R",0
43,"43015",104,69,68,2,1,"PRE-R",0
43,"43092",7051,4294,4220,45,74,"PRE-R",4
43,"43033",772,547,533,4,14,"PRE-R",0
43,"43097",379,283,278,6,5,"PRE-R",0
43,"43034",494,355,344,8,11,"PRE-R",0
43,"43148",89309,59260,58346,1202,914,"PRE-R",77
43,"43051",8749,5494,5411,78,83,"PRE-R",3
43,"43020",2119,1463,1427,26,36,"PRE-R",1
43,"43118",439,318,313,7,5,"PRE-R",0
43,"43150",1337,994,977,12,17,"PRE-R",0
43,"43079",387,259,255,26,4,"PRE-R",0
43,"43091",142,106,98,5,8,"PRE-R",1
43,"43055",2002,1404,1374,36,30,"PRE-R",3
43,"43049",805,555,536,6,19,"PRE-R",3
43,"43007",635,448,441,7,7,"PRE-R",0
43,"43041",237,177,176,4,1,"PRE-R",0
43,"43906",2050,1332,1298,28,34,"PRE-R",1
43,"43002",1790,1252,1226,17,26,"PRE-R",0
43,"43094",2209,1558,1524,31,34,"PRE-R",1
43,"43110",307,216,214,5,2,"PRE-R",0
43,"43156",4120,2811,2741,66,70,"PRE-R",3
43,"43116",494,328,325,5,3,"PRE-R",0
43,"43009",1421,913,897,18,16,"PRE-R",0
43,"43152",472,355,351,9,4,"PRE-R",0
43,"43014",14146,9153,8915,204,238,"PRE-R",17
43,"43006",712,484,475,10,9,"PRE-R",1
43,"43077",486,335,328,4,7,"PRE-R",0
43,"43023",244,179,177,8,2,"PRE-R",0
43,"43082",383,282,270,8,12,"PRE-R",1
43,"43001",706,481,473,12,8,"PRE-R",0
43,"43098",362,251,247,1,4,"PRE-R",1
43,"43173",114,65,64,0,1,"PRE-R",0
43,"43154",136,97,96,6,1,"PRE-R",0
43,"43048",830,547,530,16,17,"PRE-R",1
43,"43083",141,97,97,2,0,"PRE-R",0
43,"43060",3049,2030,1980,62,50,"PRE-R",0
43,"43085",229,178,171,0,7,"PRE-R",0
43,"43037",16656,9986,9812,163,174,"PRE-R",4
43,"43153",10307,6572,6450,94,122,"PRE-R",8
43,"43013",4369,2795,2747,54,48,"PRE-R",4
43,"43151",119,91,89,0,2,"PRE-R",0
43,"43024",1459,958,937,17,21,"PRE-R",1
43,"43143",62,51,50,1,1,"PRE-R",0
43,"43044",3990,2768,2715,72,53,"PRE-R",2
43,"43088",1810,1199,1177,29,22,"PRE-R",1
43,"43134",279,208,206,14,2,"PRE-R",0
43,"43027",177,129,128,6,1,"PRE-R",0
43,"43138",2719,1775,1730,45,45,"PRE-R",1
43,"43071",975,677,664,14,13,"PRE-R",1
43,"43137",1873,1241,1212,27,29,"PRE-R",3
43,"43047",4064,2412,2352,50,60,"PRE-R",3
43,"43056",931,537,515,18,22,"PRE-R",0
43,"43104",1821,1209,1178,34,31,"PRE-R",2
43,"43178",1262,891,870,24,21,"PRE-R",1
43,"43050",2407,1528,1504,20,24,"PRE-R",0
43,"43067",626,445,431,21,14,"PRE-R",0
43,"43031",1509,1016,992,20,24,"PRE-R",1
43,"43039",117,85,83,3,2,"PRE-R",0
43,"43124",532,366,358,3,8,"PRE-R",1
43,"43167",390,284,280,12,4,"PRE-R",0
43,"43025",660,453,446,13,7,"PRE-R",0
43,"43128",927,636,625,11,11,"PRE-R",0
43,"43172",378,268,266,8,2,"PRE-R",1
43,"43171",13906,8978,8855,167,123,"PRE-R",4
43,"43036",836,503,494,4,9,"PRE-R",0
43,"43062",298,227,223,7,4,"PRE-R",0
43,"43080",254,175,173,7,2,"PRE-R",1
43,"43026",800,531,522,15,9,"PRE-R",2
43,"43105",175,119,116,14,3,"PRE-R",0
43,"43102",517,377,366,2,11,"PRE-R",1
43,"43075",102,63,63,1,0,"PRE-R",0
43,"43018",430,350,337,7,13,"PRE-R",0
43,"43059",264,185,185,4,0,"PRE-R",0
43,"43100",3062,2058,2021,52,37,"PRE-R",3
43,"43119",739,500,496,5,4,"PRE-R",40
43,"43108",1808,1183,1157,28,26,"PRE-R",1
43,"43063",588,358,350,13,8,"PRE-R",0
43,"43146",45,33,30,1,3,"PRE-R",0
43,"43164",298,233,231,4,2,"PRE-R",0
43,"43021",381,218,213,3,5,"PRE-R",0
43,"43042",2071,1504,1485,28,19,"PRE-R",2
43,"43068",573,388,378,5,10,"PRE-R",0
43,"43052",1001,669,636,12,33,"PRE-R",0
43,"43158",109,63,61,5,2,"PRE-R",0
43,"43126",1170,802,783,19,19,"PRE-R",0
43,"43169",477,377,364,8,13,"PRE-R",0
43,"43149",711,529,516,13,13,"PRE-R",0
43,"43157",388,282,270,10,12,"PRE-R",0
43,"43011",1013,745,729,21,16,"PRE-R",1
43,"43012",3392,2346,2295,48,51,"PRE-R",4
43,"43123",70216,45627,44828,906,799,"PRE-R",48
43,"43106",878,600,592,17,8,"PRE-R",1
43,"43017",141,98,98,2,0,"PRE-R",0
43,"43140",2393,1612,1583,23,29,"PRE-R",2
43,"43901",8849,5651,5540,179,111,"PRE-R",5
43,"43008",333,206,197,3,9,"PRE-R",0
43,"43061",55,31,31,1,0,"PRE-R",0
43,"43073",90,57,57,1,0,"PRE-R",0
43,"43161",17199,10765,10547,197,218,"PRE-R",18
43,"43019",1356,868,837,13,31,"PRE-R",1
43,"43117",150,118,115,1,3,"PRE-R",0
43,"43099",330,240,236,4,4,"PRE-R",0
43,"43139",2166,1319,1270,37,49,"PRE-R",2
43,"43064",2063,1420,1391,37,29,"PRE-R",2
43,"43096",103,81,77,3,4,"PRE-R",0
43,"43170",880,601,592,9,9,"PRE-R",2
43,"43135",327,243,238,2,5,"PRE-R",0
43,"43030",454,321,307,5,14,"PRE-R",0
43,"43095",2434,1658,1624,27,34,"PRE-R",1
43,"43120",454,287,283,1,4,"PRE-R",0
43,"43166",1521,1002,977,17,25,"PRE-R",1
43,"43160",1278,840,812,9,28,"PRE-R",0
43,"43903",2368,1504,1492,22,12,"PRE-R",2
43,"43141",131,71,70,3,1,"PRE-R",0
43,"43129",4525,3032,2956,62,76,"PRE-R",4
43,"43029",330,202,194,6,8,"PRE-R",1
43,"43147",528,393,380,7,13,"PRE-R",0
43,"43072",97,73,70,0,3,"PRE-R",0
43,"43112",294,184,181,2,3,"PRE-R",0
43,"43038",20710,12999,12771,224,228,"PRE-R",13
43,"43111",2096,1305,1281,19,24,"PRE-R",2
43,"43162",4143,2892,2833,59,59,"PRE-R",2
43,"43907",4122,2759,2712,52,47,"PRE-R",1
43,"43175",590,419,411,8,8,"PRE-R",1
43,"43093",3924,2507,2445,62,62,"PRE-R",0
43,"43142",1155,730,714,20,16,"PRE-R",4
43,"43022",1559,1097,1074,22,23,"PRE-R",1
43,"43043",3065,1952,1919,39,33,"PRE-R",2
43,"43078",841,557,547,7,10,"PRE-R",0
43,"43069",194,131,127,3,4,"PRE-R",0
43,"43177",338,242,236,6,6,"PRE-R",0
43,"43053",190,149,149,2,0,"PRE-R",0
43,"43122",92,65,61,0,4,"PRE-R",0
43,"43046",114,80,79,5,1,"PRE-R",1
43,"43086",5269,3275,3196,92,79,"PRE-R",6
43,"43121",636,385,371,6,14,"PRE-R",0
43,"43902",2761,1836,1811,25,25,"PRE-R",1
43,"43155",22951,14114,13856,326,258,"PRE-R",10
43,"43003",307,187,184,10,3,"PRE-R",0
43,"43005",3559,2191,2147,47,44,"PRE-R",4
43,"43904",2918,1779,1732,49,47,"PRE-R",3
43,"43010",302,227,223,7,4,"PRE-R",1
43,"43076",467,308,300,7,8,"PRE-R",0
43,"43004",6411,4089,4001,92,88,"PRE-R",6
43,"43058",106,76,76,5,0,"PRE-R",0
43,"43045",156,110,109,1,1,"PRE-R",0
43,"43054",2850,1815,1771,37,44,"PRE-R",2
43,"43032",587,418,413,9,5,"PRE-R",0
43,"43144",1187,787,772,12,15,"PRE-R",2
43,"43163",24903,15475,15241,263,234,"PRE-R",14
43,"43133",5697,3470,3388,76,82,"PRE-R",8
43,"43125",1008,706,701,10,5,"PRE-R",1
43,"43115",171,112,110,3,2,"PRE-R",0
43,"43035",280,202,198,0,4,"PRE-R",0
43,"43113",454,321,316,10,5,"PRE-R",1
43,"43176",832,575,572,16,3,"PRE-R",1
43,"43145",3968,2781,2742,52,39,"PRE-R",1
43,"43127",778,530,524,6,6,"PRE-R",1
43,"43101",146,94,93,3,1,"PRE-R",0
43,"43070",265,198,196,3,2,"PRE-R",0
43,"43065",443,278,270,8,8,"PRE-R",0
43,"43090",1142,644,636,7,8,"PRE-R",1
43,"43028",2654,1620,1588,27,32,"PRE-R",3
43,"43109",2040,1332,1316,28,16,"PRE-R",2
43,"43131",4495,2842,2814,51,28,"PRE-R",2
43,"43130",196,132,131,7,1,"PRE-R",0
43,"43136",10163,6312,6197,121,115,"PRE-R",4
43,"43174",152,104,101,1,3,"PRE-R",0
43,"43103",897,586,575,21,11,"PRE-R",1
43,"43040",350,251,246,18,5,"PRE-R",2
43,"43057",45,27,27,2,0,"PRE-R",0
43,"43159",89,51,51,2,0,"PRE-R",0
43,"43084",573,383,378,6,5,"PRE-R",2
43,"43168",106,70,69,2,1,"PRE-R",0
25,"25027",1042,691,665,11,26,"PUM+J",0
25,"25155",714,490,485,8,5,"PUM+J",0
25,"25234",4572,2707,2648,57,59,"PUM+J",2
25,"25904",149,107,104,1,3,"PUM+J",0
25,"25075",122,85,83,0,2,"PUM+J",0
25,"25118",378,232,226,4,6,"PUM+J",0
25,"25021",2693,1632,1605,40,27,"PUM+J",0
25,"25901",315,196,189,3,7,"PUM+J",1
25,"25227",674,375,372,2,3,"PUM+J",1
25,"25074",178,137,132,3,5,"PUM+J",1
25,"25098",266,177,177,0,0,"PUM+J",1
25,"25063",97,65,64,2,1,"PUM+J",0
25,"25208",294,174,170,3,4,"PUM+J",0
25,"25913",100,78,78,0,0,"PUM+J",0
25,"25247",142,80,78,3,2,"PUM+J",1
25,"25078",1014,730,719,17,11,"PUM+J",3
25,"25205",563,373,362,12,11,"PUM+J",1
25,"25145",88,67,67,2,0,"PUM+J",0
25,"25910",118,77,76,3,1,"PUM+J",0
25,"25177",379,240,236,2,4,"PUM+J",0
25,"25051",1710,1060,1044,23,16,"PUM+J",3
25,"25123",206,140,136,4,4,"PUM+J",0
25,"25223",951,562,546,14,16,"PUM+J",2
25,"25071",56,37,35,2,2,"PUM+J",0
25,"25166",177,127,125,3,2,"PUM+J",0
25,"25911",472,306,296,2,10,"PUM+J",0
25,"25017",248,160,159,1,1,"PUM+J",0
25,"25908",250,169,168,4,1,"PUM+J",0
25,"25002",481,306,302,6,4,"PUM+J",0
25,"25023",4446,3079,3020,70,59,"PUM+J",7
25,"25135",1077,739,722,18,17,"PUM+J",0
25,"25040",10654,6905,6768,144,137,"PUM+J",7
25,"25055",187,115,115,3,0,"PUM+J",0
25,"25232",1480,968,959,38,9,"PUM+J",1
25,"25217",10570,6660,6500,191,160,"PUM+J",7
25,"25909",141,82,78,0,4,"PUM+J",0
25,"25068",576,376,364,6,12,"PUM+J",0
25,"25156",761,535,529,15,6,"PUM+J",2
25,"25086",569,379,370,4,9,"PUM+J",0
25,"25045",51,33,33,2,0,"PUM+J",2
25,"25008",1187,834,818,15,16,"PUM+J",0
25,"25081",332,212,206,6,6,"PUM+J",0
25,"25143",86,58,58,1,0,"PUM+J",0
25,"25181",189,128,123,3,5,"PUM+J",0
25,"25193",771,509,501,8,8,"PUM+J",0
25,"25240",1398,976,958,17,18,"PUM+J",0
25,"25089",107,66,64,0,2,"PUM+J",0
25,"25204",1313,888,881,21,7,"PUM+J",0
25,"25197",158,102,101,2,1,"PUM+J",0
25,"25082",265,156,155,8,1,"PUM+J",0
25,"25072",5921,3743,3637,81,106,"PUM+J",6
25,"25094",154,110,107,1,3,"PUM+J",0
25,"25218",94,75,73,1,2,"PUM+J",0
25,"25221",125,76,76,0,0,"PUM+J",1
25,"25141",171,111,107,2,4,"PUM+J",0
25,"25239",627,310,310,7,0,"PUM+J",1
25,"25043",830,483,467,17,16,"PUM+J",0
25,"25076",165,84,83,3,1,"PUM+J",0
25,"25172",1838,1267,1230,35,37,"PUM+J",3
25,"25222",69,55,54,0,1,"PUM+J",0
25,"25131",439,319,314,6,5,"PUM+J",0
25,"25139",549,358,357,5,1,"PUM+J",0
25,"25047",1048,760,748,24,12,"PUM+J",0
25,"25067",768,498,494,14,4,"PUM+J",0
25,"25254",782,533,531,9,2,"PUM+J",0
25,"25158",1647,1154,1135,27,19,"PUM+J",0
25,"25216",250,175,173,5,2,"PUM+J",0
25,"25200",353,225,217,4,8,"PUM+J",0
25,"25168",510,385,378,19,7,"PUM+J",0
25,"25034",2471,1622,1592,25,30,"PUM+J",0
25,"25912",899,643,640,6,3,"PUM+J",2
25,"25170",271,197,196,4,1,"PUM+J",0
25,"25101",583,391,382,8,9,"PUM+J",0
25,"25046",438,299,286,6,13,"PUM+J",0
25,"25001",146,76,76,1,0,"PUM+J",0
25,"25007",1363,902,885,36,17,"PUM+J",2
25,"25230",1665,1164,1140,36,24,"PUM+J",0
25,"25128",151,83,81,1,2,"PUM+J",0
25,"25109",279,183,183,2,0,"PUM+J",0
25,"25189",2085,1348,1327,38,21,"PUM+J",1
25,"25252",536,361,352,13,9,"PUM+J",1
25,"25058",4390,2696,2650,57,46,"PUM+J",5
25,"25215",399,229,226,4,3,"PUM+J",1
25,"25115",878,542,542,17,0,"PUM+J",0
25,"25103",125,82,80,4,2,"PUM+J",0
25,"25032",71,44,42,1,2,"PUM+J",0
25,"25151",641,451,444,20,7,"PUM+J",1
25,"25077",474,281,277,5,4,"PUM+J",0
25,"25248",926,615,601,17,14,"PUM+J",0
25,"25149",1401,1031,1010,17,21,"PUM+J",2
25,"25014",264,170,164,11,6,"PUM+J",1
25,"25037",396,275,273,9,2,"PUM+J",1
25,"25169",201,134,134,6,0,"PUM+J",0
25,"25132",128,87,85,3,2,"PUM+J",0
25,"25016",2203,1375,1357,20,18,"PUM+J",0
25,"25231",515,402,395,4,7,"PUM+J",0
25,"25244",350,270,268,9,2,"PUM+J",0
25,"25053",1085,733,727,10,6,"PUM+J",1
25,"25022",119,83,83,0,0,"PUM+J",0
25,"25207",6253,3938,3872,91,66,"PUM+J",8
25,"25111",116,70,70,0,0,"PUM+J",0
25,"25122",1956,1281,1256,33,25,"PUM+J",2
25,"25152",160,92,90,4,2,"PUM+J",1
25,"25003",3853,2367,2340,68,27,"PUM+J",5
25,"25130",208,117,112,4,5,"PUM+J",0
25,"25161",361,222,218,1,4,"PUM+J",0
25,"25220",1076,711,702,10,9,"PUM+J",2
25,"25036",190,138,134,5,4,"PUM+J",0
25,"25136",106,79,79,1,0,"PUM+J",0
25,"25025",1307,874,859,32,15,"PUM+J",5
25,"25120",90759,58761,57778,1325,983,"PUM+J",163
25,"25013",2274,1344,1321,25,23,"PUM+J",2
25,"25059",796,580,575,9,5,"PUM+J",1
25,"25192",799,543,527,19,16,"PUM+J",1
25,"25092",135,100,97,2,3,"PUM+J",0
25,"25212",233,185,185,8,0,"PUM+J",0
25,"25019",4626,2971,2932,54,39,"PUM+J",10
25,"25097",102,70,69,3,1,"PUM+J",0
25,"25906",235,160,154,3,6,"PUM+J",0
25,"25088",100,74,74,0,0,"PUM+J",0
25,"25174",438,289,283,4,6,"PUM+J",0
25,"25185",690,409,404,8,5,"PUM+J",0
25,"25020",328,216,209,4,7,"PUM+J",1
25,"25148",232,144,144,5,0,"PUM+J",0
25,"25079",307,242,240,7,2,"PUM+J",0
25,"25201",119,78,76,3,2,"PUM+J",0
25,"25005",291,194,190,7,4,"PUM+J",0
25,"25243",3408,2280,2252,49,28,"PUM+J",4
25,"25203",8995,5418,5309,116,109,"PUM+J",12
25,"25009",690,479,471,9,8,"PUM+J",0
25,"25210",1164,799,789,13,10,"PUM+J",1
25,"25907",506,297,292,6,5,"PUM+J",0
25,"25104",128,88,86,11,2,"PUM+J",0
25,"25175",221,151,150,0,1,"PUM+J",0
25,"25255",468,318,309,9,9,"PUM+J",1
25,"25029",1766,1145,1118,38,27,"PUM+J",1
25,"25048",1684,1120,1095,29,25,"PUM+J",3
25,"25113",1227,869,856,28,13,"PUM+J",0
25,"25233",270,207,201,3,6,"PUM+J",0
25,"25011",5241,3127,3080,48,47,"PUM+J",4
25,"25087",65,41,39,0,2,"PUM+J",0
25,"25226",257,162,158,5,4,"PUM+J",1
25,"25196",127,87,86,3,1,"PUM+J",0
25,"25099",1185,720,709,9,11,"PUM+J",1
25,"25182",1075,749,731,30,18,"PUM+J",2
25,"25012",2204,1432,1406,29,26,"PUM+J",2
25,"25004",553,405,400,13,5,"PUM+J",1
25,"25245",445,312,306,4,6,"PUM+J",1
25,"25093",657,465,455,8,10,"PUM+J",0
25,"25114",102,82,78,4,4,"PUM+J",0
25,"25085",153,103,100,2,3,"PUM+J",0
25,"25100",207,125,115,2,10,"PUM+J",1
25,"25238",231,158,156,1,2,"PUM+J",2
25,"25209",1558,1041,1009,22,32,"PUM+J",1
25,"25049",166,105,102,1,3,"PUM+J",1
25,"25124",161,110,109,4,1,"PUM+J",1
25,"25042",211,131,127,0,4,"PUM+J",0
25,"25150",185,119,113,4,6,"PUM+J",0
25,"25165",301,202,198,6,4,"PUM+J",0
25,"25202",110,62,59,3,3,"PUM+J",0
25,"25157",183,128,128,4,0,"PUM+J",1
25,"25050",3249,2056,1988,40,68,"PUM+J",4
25,"25171",2305,1496,1469,37,27,"PUM+J",1
25,"25112",286,202,199,11,3,"PUM+J",1
25,"25154",126,77,77,2,0,"PUM+J",1
25,"25061",75,45,45,0,0,"PUM+J",0
25,"25164",404,270,264,5,6,"PUM+J",0
25,"25142",387,265,264,5,1,"PUM+J",0
25,"25125",450,297,289,10,8,"PUM+J",0
25,"25191",353,234,227,5,7,"PUM+J",1
25,"25056",289,168,163,3,5,"PUM+J",0
25,"25194",440,292,283,11,9,"PUM+J",0
25,"25183",485,336,327,6,9,"PUM+J",0
25,"25180",245,167,165,3,2,"PUM+J",0
25,"25038",1606,1104,1093,19,11,"PUM+J",1
25,"25206",289,187,184,3,3,"PUM+J",1
25,"25129",175,105,105,3,0,"PUM+J",0
25,"25070",888,594,582,18,12,"PUM+J",3
25,"25030",147,101,95,3,6,"PUM+J",0
25,"25062",806,515,497,11,18,"PUM+J",0
25,"25102",733,478,464,15,14,"PUM+J",1
25,"25052",1611,1094,1062,21,32,"PUM+J",2
25,"25137",8404,5264,5167,112,97,"PUM+J",1
25,"25010",206,119,118,7,1,"PUM+J",0
25,"25219",144,90,86,0,4,"PUM+J",1
25,"25039",299,189,186,7,3,"PUM+J",3
25,"25173",1784,1177,1139,20,38,"PUM+J",2
25,"25041",625,432,420,20,12,"PUM+J",1
25,"25119",2297,1554,1513,46,41,"PUM+J",2
25,"25127",226,134,130,2,4,"PUM+J",0
25,"25146",227,150,149,0,1,"PUM+J",1
25,"25133",748,499,483,7,16,"PUM+J",0
25,"25031",57,34,34,1,0,"PUM+J",0
25,"25186",231,168,168,3,0,"PUM+J",0
25,"25225",603,395,387,7,8,"PUM+J",0
25,"25126",286,192,189,7,3,"PUM+J",0
25,"25163",237,147,142,2,5,"PUM+J",0
25,"25903",261,176,170,9,6,"PUM+J",1
25,"25096",988,633,613,12,20,"PUM+J",0
25,"25110",2662,1649,1602,44,47,"PUM+J",2
25,"25140",785,472,460,5,12,"PUM+J",3
25,"25228",2907,2043,2021,43,22,"PUM+J",3
25,"25902",581,411,395,15,16,"PUM+J",0
25,"25242",787,501,490,11,11,"PUM+J",0
25,"25176",341,243,240,7,3,"PUM+J",1
25,"25060",92,53,52,1,1,"PUM+J",0
25,"25033",1125,738,718,17,20,"PUM+J",1
25,"25006",362,231,228,2,3,"PUM+J",0
25,"25035",428,289,284,5,5,"PUM+J",2
25,"25064",122,91,88,7,3,"PUM+J",2
25,"25105",146,90,89,1,1,"PUM+J",0
25,"25190",271,180,176,12,4,"PUM+J",0
25,"25224",144,93,91,6,2,"PUM+J",0
25,"25121",623,406,400,6,6,"PUM+J",0
25,"25211",701,378,368,5,10,"PUM+J",3
25,"25134",657,421,416,4,5,"PUM+J",0
25,"25250",358,237,234,4,3,"PUM+J",0
25,"25024",370,221,217,8,4,"PUM+J",0
25,"25153",215,165,161,0,4,"PUM+J",0
25,"25044",195,136,134,1,2,"PUM+J",0
25,"25057",198,140,136,2,4,"PUM+J",1
25,"25073",662,382,379,11,3,"PUM+J",0
25,"25249",207,151,150,4,1,"PUM+J",0
25,"25069",471,291,289,9,2,"PUM+J",2
25,"25179",198,141,136,1,5,"PUM+J",0
25,"25251",670,476,473,1,3,"PUM+J",0
25,"25015",394,264,264,14,0,"PUM+J",1
25,"25905",386,264,258,12,6,"PUM+J",0
25,"25253",175,132,129,1,3,"PUM+J",0
25,"25138",605,440,428,13,12,"PUM+J",0
25,"25167",253,176,172,0,4,"PUM+J",0
8,"8243",160,112,110,3,2,"PIRATA.CAT",0
8,"8178",450,311,304,3,7,"PIRATA.CAT",0
17,"17207",2357,1636,1584,40,52,"PIRATA.CAT",4
8,"8083",1626,1199,1178,23,21,"PIRATA.CAT",5
17,"17118",12541,7817,7681,130,136,"PIRATA.CAT",37
17,"17144",217,145,143,4,2,"PIRATA.CAT",0
8,"8022",12437,7598,7445,169,153,"PIRATA.CAT",35
25,"25240",1398,976,958,17,18,"PIRATA.CAT",1
43,"43108",1808,1183,1157,28,26,"PIRATA.CAT",11
8,"8008",193,119,114,5,5,"PIRATA.CAT",1
8,"8103",636,453,446,16,7,"PIRATA.CAT",5
8,"8043",3067,2044,2023,29,21,"PIRATA.CAT",12
17,"17112",215,141,138,4,3,"PIRATA.CAT",0
17,"17057",1010,640,634,19,6,"PIRATA.CAT",5
8,"8054",8733,6215,6077,123,138,"PIRATA.CAT",42
43,"43167",390,284,280,12,4,"PIRATA.CAT",0
8,"8273",2287,1594,1547,18,47,"PIRATA.CAT",46
8,"8116",600,401,393,9,8,"PIRATA.CAT",2
17,"17135",380,273,269,9,4,"PIRATA.CAT",0
8,"8181",7722,5280,5188,112,92,"PIRATA.CAT",37
25,"25094",154,110,107,1,3,"PIRATA.CAT",0
17,"17202",3799,2398,2366,44,32,"PIRATA.CAT",45
17,"17215",1918,1350,1321,40,29,"PIRATA.CAT",2
25,"25085",153,103,100,2,3,"PIRATA.CAT",0
25,"25001",146,76,76,1,0,"PIRATA.CAT",1
17,"17212",129,100,98,4,2,"PIRATA.CAT",0
43,"43096",103,81,77,3,4,"PIRATA.CAT",1
17,"17105",257,152,146,4,6,"PIRATA.CAT",3
17,"17167",2818,1886,1858,52,28,"PIRATA.CAT",6
8,"8220",2277,1641,1604,44,37,"PIRATA.CAT",5
43,"43061",55,31,31,1,0,"PIRATA.CAT",0
8,"8304",822,587,578,16,9,"PIRATA.CAT",0
8,"8033",12476,8513,8378,180,135,"PIRATA.CAT",55
43,"43116",494,328,325,5,3,"PIRATA.CAT",0
25,"25050",3249,2056,1988,40,68,"PIRATA.CAT",15
25,"25226",257,162,158,5,4,"PIRATA.CAT",2
43,"43050",2407,1528,1504,20,24,"PIRATA.CAT",9
43,"43038",20710,12999,12771,224,228,"PIRATA.CAT",46
8,"8034",741,542,529,4,13,"PIRATA.CAT",5
25,"25251",670,476,473,1,3,"PIRATA.CAT",2
43,"43126",1170,802,783,19,19,"PIRATA.CAT",3
8,"8301",47343,32098,31664,672,434,"PIRATA.CAT",169
8,"8094",1500,1102,1071,21,31,"PIRATA.CAT",7
25,"25138",605,440,428,13,12,"PIRATA.CAT",2
8,"8013",1234,834,820,23,14,"PIRATA.CAT",2
25,"25192",799,543,527,19,16,"PIRATA.CAT",2
43,"43076",467,308,300,7,8,"PIRATA.CAT",2
43,"43156",4120,2811,2741,66,70,"PIRATA.CAT",27
17,"17066",25667,15429,15157,244,272,"PIRATA.CAT",89
17,"17087",230,170,161,6,9,"PIRATA.CAT",0
17,"17140",684,476,470,10,6,"PIRATA.CAT",3
25,"25180",245,167,165,3,2,"PIRATA.CAT",3
17,"17169",2460,1690,1651,34,39,"PIRATA.CAT",9
43,"43039",117,85,83,3,2,"PIRATA.CAT",0
43,"43100",3062,2058,2021,52,37,"PIRATA.CAT",13
17,"17225",208,138,134,1,4,"PIRATA.CAT",1
43,"43069",194,131,127,3,4,"PIRATA.CAT",1
8,"8261",2273,1547,1525,30,22,"PIRATA.CAT",6
8,"8278",4668,3033,2949,67,84,"PIRATA.CAT",17
43,"43124",532,366,358,3,8,"PIRATA.CAT",1
43,"43120",454,287,283,1,4,"PIRATA.CAT",1
17,"17075",304,216,210,5,6,"PIRATA.CAT",2
8,"8134",776,528,513,15,15,"PIRATA.CAT",1
43,"43172",378,268,266,8,2,"PIRATA.CAT",2
8,"8228",303,230,227,5,3,"PIRATA.CAT",0
43,"43042",2071,1504,1485,28,19,"PIRATA.CAT",10
43,"43123",70216,45627,44828,906,799,"PIRATA.CAT",261
17,"17196",209,139,138,6,1,"PIRATA.CAT",0
43,"43002",1790,1252,1226,17,26,"PIRATA.CAT",6
8,"8281",4735,3239,3193,57,46,"PIRATA.CAT",17
25,"25055",187,115,115,3,0,"PIRATA.CAT",0
8,"8251",4771,3214,3140,57,74,"PIRATA.CAT",18
17,"17047",4803,2866,2803,30,63,"PIRATA.CAT",15
25,"25027",1042,691,665,11,26,"PIRATA.CAT",4
25,"25046",438,299,286,6,13,"PIRATA.CAT",3
25,"25025",1307,874,859,32,15,"PIRATA.CAT",6
43,"43091",142,106,98,5,8,"PIRATA.CAT",1
25,"25103",125,82,80,4,2,"PIRATA.CAT",4
17,"17062",5994,3686,3614,69,72,"PIRATA.CAT",15
8,"8104",713,454,441,9,13,"PIRATA.CAT",3
25,"25174",438,289,283,4,6,"PIRATA.CAT",0
8,"8308",145,116,115,1,1,"PIRATA.CAT",0
17,"17142",2440,1713,1681,39,32,"PIRATA.CAT",13
43,"43175",590,419,411,8,8,"PIRATA.CAT",0
25,"25058",4390,2696,2650,57,46,"PIRATA.CAT",13
43,"43109",2040,1332,1316,28,16,"PIRATA.CAT",2
25,"25207",6253,3938,3872,91,66,"PIRATA.CAT",20
8,"8143",2679,1772,1756,35,16,"PIRATA.CAT",4
8,"8144",769,494,481,16,13,"PIRATA.CAT",1
8,"8200",61189,40677,40069,736,608,"PIRATA.CAT",180
17,"17002",567,413,401,4,12,"PIRATA.CAT",1
8,"8074",10224,6571,6479,116,92,"PIRATA.CAT",24
25,"25156",761,535,529,15,6,"PIRATA.CAT",1
25,"25074",178,137,132,3,5,"PIRATA.CAT",0
43,"43097",379,283,278,6,5,"PIRATA.CAT",4
43,"43049",805,555,536,6,19,"PIRATA.CAT",6
8,"8135",6647,4753,4678,79,75,"PIRATA.CAT",13
25,"25177",379,240,236,2,4,"PIRATA.CAT",0
8,"8125",24559,16065,15798,293,267,"PIRATA.CAT",105
43,"43905",13621,8120,8011,131,109,"PIRATA.CAT",36
17,"17015",12254,7759,7553,143,206,"PIRATA.CAT",46
17,"17107",301,203,200,8,3,"PIRATA.CAT",0
17,"17096",182,96,94,2,2,"PIRATA.CAT",0
43,"43027",177,129,128,6,1,"PIRATA.CAT",1
17,"17103",4988,2788,2724,51,64,"PIRATA.CAT",14
8,"8023",6546,4261,4194,86,67,"PIRATA.CAT",23
25,"25115",878,542,542,17,0,"PIRATA.CAT",2
8,"8185",189,131,126,1,5,"PIRATA.CAT",2
8,"8285",10168,6582,6423,152,159,"PIRATA.CAT",31
17,"17055",158,121,121,4,0,"PIRATA.CAT",2
8,"8090",120,86,86,2,0,"PIRATA.CAT",1
43,"43174",152,104,101,1,3,"PIRATA.CAT",2
43,"43020",2119,1463,1427,26,36,"PIRATA.CAT",1
17,"17013",2774,1884,1859,21,25,"PIRATA.CAT",5
43,"43135",327,243,238,2,5,"PIRATA.CAT",1
8,"8179",591,415,405,6,10,"PIRATA.CAT",1
25,"25218",94,75,73,1,2,"PIRATA.CAT",0
43,"43036",836,503,494,4,9,"PIRATA.CAT",1
8,"8232",1793,1239,1220,20,19,"PIRATA.CAT",9
8,"8038",1406,911,895,24,16,"PIRATA.CAT",1
25,"25910",118,77,76,3,1,"PIRATA.CAT",3
43,"43099",330,240,236,4,4,"PIRATA.CAT",0
8,"8216",21,14,14,0,0,"PIRATA.CAT",0
43,"43142",1155,730,714,20,16,"PIRATA.CAT",3
25,"25146",227,150,149,0,1,"PIRATA.CAT",0
25,"25239",627,310,310,7,0,"PIRATA.CAT",2
8,"8236",1507,1027,1002,18,25,"PIRATA.CAT",7
8,"8011",1754,1116,1085,29,31,"PIRATA.CAT",7
8,"8082",1143,733,723,17,10,"PIRATA.CAT",5
8,"8089",33316,22369,22107,437,262,"PIRATA.CAT",145
8,"8059",323,189,186,9,3,"PIRATA.CAT",0
25,"25100",207,125,115,2,10,"PIRATA.CAT",1
25,"25068",576,376,364,6,12,"PIRATA.CAT",2
25,"25072",5921,3743,3637,81,106,"PIRATA.CAT",21
25,"25140",785,472,460,5,12,"PIRATA.CAT",2
17,"17086",1687,1148,1129,14,19,"PIRATA.CAT",4
25,"25166",177,127,125,3,2,"PIRATA.CAT",0
8,"8087",158,133,132,6,1,"PIRATA.CAT",3
25,"25157",183,128,128,4,0,"PIRATA.CAT",0
25,"25243",3408,2280,2252,49,28,"PIRATA.CAT",16
25,"25086",569,379,370,4,9,"PIRATA.CAT",3
8,"8187",149633,104021,102629,1794,1392,"PIRATA.CAT",583
25,"25110",2662,1649,1602,44,47,"PIRATA.CAT",3
25,"25051",1710,1060,1044,23,16,"PIRATA.CAT",8
8,"8271",74,45,44,3,1,"PIRATA.CAT",0
43,"43012",3392,2346,2295,48,51,"PIRATA.CAT",11
17,"17149",366,254,251,4,3,"PIRATA.CAT",0
25,"25163",237,147,142,2,5,"PIRATA.CAT",2
8,"8012",1694,1155,1136,32,19,"PIRATA.CAT",1
8,"8106",6858,4675,4559,113,116,"PIRATA.CAT",25
17,"17218",568,361,350,11,11,"PIRATA.CAT",0
43,"43170",880,601,592,9,9,"PIRATA.CAT",7
25,"25149",1401,1031,1010,17,21,"PIRATA.CAT",6
25,"25139",549,358,357,5,1,"PIRATA.CAT",0
8,"8078",224,154,151,2,3,"PIRATA.CAT",0
25,"25047",1048,760,748,24,12,"PIRATA.CAT",4
17,"17129",126,91,90,3,1,"PIRATA.CAT",0
8,"8139",184,130,128,1,2,"PIRATA.CAT",0
25,"25232",1480,968,959,38,9,"PIRATA.CAT",2
25,"25197",158,102,101,2,1,"PIRATA.CAT",1
25,"25067",768,498,494,14,4,"PIRATA.CAT",1
8,"8037",1830,1247,1209,40,38,"PIRATA.CAT",3
43,"43102",517,377,366,2,11,"PIRATA.CAT",2
43,"43152",472,355,351,9,4,"PIRATA.CAT",1
43,"43906",2050,1332,1298,28,34,"PIRATA.CAT",8
17,"17166",503,361,342,10,19,"PIRATA.CAT",2
17,"17146",2952,1895,1864,49,31,"PIRATA.CAT",15
25,"25252",536,361,352,13,9,"PIRATA.CAT",2
25,"25189",2085,1348,1327,38,21,"PIRATA.CAT",8
25,"25060",92,53,52,1,1,"PIRATA.CAT",0
17,"17039",1850,1299,1275,31,24,"PIRATA.CAT",10
17,"17152",10378,6239,6156,100,83,"PIRATA.CAT",28
17,"17011",625,472,467,5,5,"PIRATA.CAT",0
8,"8226",886,667,656,13,11,"PIRATA.CAT",5
17,"17082",443,285,280,1,5,"PIRATA.CAT",2
43,"43162",4143,2892,2833,59,59,"PIRATA.CAT",8
8,"8213",6188,4031,3970,113,61,"PIRATA.CAT",20
25,"25190",271,180,176,12,4,"PIRATA.CAT",1
8,"8196",18989,12658,12490,253,168,"PIRATA.CAT",50
43,"43068",573,388,378,5,10,"PIRATA.CAT",2
43,"43150",1337,994,977,12,17,"PIRATA.CAT",3
17,"17138",1010,677,662,3,15,"PIRATA.CAT",8
8,"8298",25338,16982,16690,353,292,"PIRATA.CAT",74
25,"25202",110,62,59,3,3,"PIRATA.CAT",0
25,"25126",286,192,189,7,3,"PIRATA.CAT",0
8,"8154",677,499,488,2,11,"PIRATA.CAT",1
8,"8231",19810,12359,12196,244,163,"PIRATA.CAT",76
17,"17153",172,127,123,1,4,"PIRATA.CAT",1
25,"25010",206,119,118,7,1,"PIRATA.CAT",1
17,"17164",4092,2409,2346,60,63,"PIRATA.CAT",14
17,"17031",172,94,93,1,1,"PIRATA.CAT",0
25,"25227",674,375,372,2,3,"PIRATA.CAT",0
8,"8248",5239,3513,3443,71,70,"PIRATA.CAT",23
8,"8003",6983,5061,4993,53,68,"PIRATA.CAT",31
25,"25170",271,197,196,4,1,"PIRATA.CAT",0
17,"17036",2822,1844,1806,36,38,"PIRATA.CAT",15
8,"8108",4879,3475,3437,64,38,"PIRATA.CAT",19
17,"17178",1075,683,679,15,4,"PIRATA.CAT",7
25,"25254",782,533,531,9,2,"PIRATA.CAT",4
8,"8262",6835,4086,3993,94,93,"PIRATA.CAT",18
43,"43054",2850,1815,1771,37,44,"PIRATA.CAT",7
8,"8204",2991,2076,2040,45,36,"PIRATA.CAT",8
25,"25097",102,70,69,3,1,"PIRATA.CAT",1
25,"25079",307,242,240,7,2,"PIRATA.CAT",0
43,"43090",1142,644,636,7,8,"PIRATA.CAT",2
8,"8267",6215,4100,4011,82,89,"PIRATA.CAT",30
17,"17220",780,550,545,13,5,"PIRATA.CAT",4
8,"8174",409,294,292,10,2,"PIRATA.CAT",0
8,"8029",3389,2542,2514,45,28,"PIRATA.CAT",16
8,"8147",17023,11177,10961,184,216,"PIRATA.CAT",94
43,"43043",3065,1952,1919,39,33,"PIRATA.CAT",9
8,"8300",5621,4021,3933,94,88,"PIRATA.CAT",34
43,"43019",1356,868,837,13,31,"PIRATA.CAT",7
25,"25148",232,144,144,5,0,"PIRATA.CAT",0
8,"8167",5703,3896,3831,82,65,"PIRATA.CAT",10
8,"8032",1955,1330,1294,18,36,"PIRATA.CAT",4
17,"17050",645,438,425,15,13,"PIRATA.CAT",5
25,"25903",261,176,170,9,6,"PIRATA.CAT",0
25,"25075",122,85,83,0,2,"PIRATA.CAT",2
8,"8250",7083,4485,4426,72,59,"PIRATA.CAT",36
25,"25081",332,212,206,6,6,"PIRATA.CAT",1
43,"43028",2654,1620,1588,27,32,"PIRATA.CAT",9
8,"8036",172,124,124,4,0,"PIRATA.CAT",0
8,"8114",17629,11781,11579,189,202,"PIRATA.CAT",51
8,"8046",12603,8826,8663,190,163,"PIRATA.CAT",64
8,"8047",4141,2610,2580,49,30,"PIRATA.CAT",12
43,"43058",106,76,76,5,0,"PIRATA.CAT",2
8,"8295",10579,6896,6769,137,127,"PIRATA.CAT",41
17,"17091",433,288,277,16,11,"PIRATA.CAT",1
8,"8127",2274,1371,1338,23,33,"PIRATA.CAT",5
25,"25231",515,402,395,4,7,"PIRATA.CAT",2
43,"43143",62,51,50,1,1,"PIRATA.CAT",0
8,"8057",61,41,40,1,1,"PIRATA.CAT",0
17,"17076",126,77,76,5,1,"PIRATA.CAT",3
17,"17064",341,253,250,4,3,"PIRATA.CAT",1
8,"8293",246,145,145,4,0,"PIRATA.CAT",2
25,"25908",250,169,168,4,1,"PIRATA.CAT",1
17,"17035",548,385,379,7,6,"PIRATA.CAT",4
8,"8169",47505,31997,31566,555,431,"PIRATA.CAT",194
25,"25158",1647,1154,1135,27,19,"PIRATA.CAT",5
8,"8263",20729,13742,13563,232,179,"PIRATA.CAT",52
8,"8159",13482,9173,9040,239,133,"PIRATA.CAT",85
17,"17084",269,177,175,4,2,"PIRATA.CAT",0
17,"17125",132,90,89,1,1,"PIRATA.CAT",0
8,"8259",6362,4482,4420,97,62,"PIRATA.CAT",19
8,"8229",561,404,398,12,6,"PIRATA.CAT",0
43,"43149",711,529,516,13,13,"PIRATA.CAT",1
25,"25165",301,202,198,6,4,"PIRATA.CAT",1
25,"25039",299,189,186,7,3,"PIRATA.CAT",0
8,"8192",5450,3688,3634,79,54,"PIRATA.CAT",25
8,"8223",1855,1178,1155,19,23,"PIRATA.CAT",6
8,"8120",6342,4801,4746,63,55,"PIRATA.CAT",33
43,"43086",5269,3275,3196,92,79,"PIRATA.CAT",23
17,"17046",738,510,498,15,12,"PIRATA.CAT",2
43,"43006",712,484,475,10,9,"PIRATA.CAT",1
8,"8160",313,227,222,8,5,"PIRATA.CAT",1
8,"8015",155673,101652,100264,1628,1388,"PIRATA.CAT",568
25,"25909",141,82,78,0,4,"PIRATA.CAT",0
25,"25064",122,91,88,7,3,"PIRATA.CAT",0
17,"17034",6723,4131,4064,77,67,"PIRATA.CAT",24
17,"17134",235,149,148,3,1,"PIRATA.CAT",0
43,"43148",89309,59260,58346,1202,914,"PIRATA.CAT",294
8,"8210",4176,2661,2579,54,82,"PIRATA.CAT",23
8,"8040",10538,6916,6804,99,112,"PIRATA.CAT",40
25,"25904",149,107,104,1,3,"PIRATA.CAT",0
17,"17006",1203,759,754,17,5,"PIRATA.CAT",7
8,"8176",166,111,109,0,2,"PIRATA.CAT",0
17,"17038",343,261,256,2,5,"PIRATA.CAT",1
8,"8171",2158,1385,1359,27,26,"PIRATA.CAT",1
8,"8264",3983,2773,2744,30,29,"PIRATA.CAT",13
25,"25216",250,175,173,5,2,"PIRATA.CAT",0
8,"8061",1467,960,952,10,8,"PIRATA.CAT",3
17,"17051",201,146,142,4,4,"PIRATA.CAT",0
17,"17074",490,345,342,5,3,"PIRATA.CAT",7
17,"17026",542,404,398,3,6,"PIRATA.CAT",4
8,"8148",2240,1246,1223,22,23,"PIRATA.CAT",3
8,"8211",32035,23059,22687,453,372,"PIRATA.CAT",130
25,"25203",8995,5418,5309,116,109,"PIRATA.CAT",29
17,"17117",14022,8705,8595,129,110,"PIRATA.CAT",33
43,"43005",3559,2191,2147,47,44,"PIRATA.CAT",25
25,"25238",231,158,156,1,2,"PIRATA.CAT",1
17,"17177",563,398,388,7,10,"PIRATA.CAT",2
8,"8222",1827,1343,1317,21,26,"PIRATA.CAT",9
43,"43176",832,575,572,16,3,"PIRATA.CAT",1
25,"25022",119,83,83,0,0,"PIRATA.CAT",1
25,"25249",207,151,150,4,1,"PIRATA.CAT",0
8,"8086",13267,8791,8669,200,122,"PIRATA.CAT",43
8,"8153",502,357,350,7,7,"PIRATA.CAT",3
17,"17172",426,286,283,3,3,"PIRATA.CAT",2
17,"17221",4135,2789,2723,49,66,"PIRATA.CAT",20
17,"17232",159,107,104,0,3,"PIRATA.CAT",0
17,"17210",527,358,349,9,9,"PIRATA.CAT",1
43,"43057",45,27,27,2,0,"PIRATA.CAT",0
8,"8072",9910,6326,6235,140,91,"PIRATA.CAT",39
8,"8073",60247,41448,40843,770,605,"PIRATA.CAT",201
25,"25161",361,222,218,1,4,"PIRATA.CAT",2
25,"25183",485,336,327,6,9,"PIRATA.CAT",0
25,"25185",690,409,404,8,5,"PIRATA.CAT",2
8,"8140",4665,3160,3103,55,57,"PIRATA.CAT",12
17,"17005",404,258,254,12,4,"PIRATA.CAT",0
25,"25109",279,183,183,2,0,"PIRATA.CAT",0
25,"25005",291,194,190,7,4,"PIRATA.CAT",0
25,"25061",75,45,45,0,0,"PIRATA.CAT",0
43,"43166",1521,1002,977,17,25,"PIRATA.CAT",8
8,"8224",771,538,528,26,10,"PIRATA.CAT",3
43,"43134",279,208,206,14,2,"PIRATA.CAT",0
8,"8121",85069,58372,57620,923,752,"PIRATA.CAT",399
8,"8257",116,84,81,0,3,"PIRATA.CAT",0
17,"17183",261,178,176,2,2,"PIRATA.CAT",3
43,"43151",119,91,89,0,2,"PIRATA.CAT",1
43,"43131",4495,2842,2814,51,28,"PIRATA.CAT",5
8,"8208",5471,3859,3792,82,67,"PIRATA.CAT",25
8,"8155",6573,4411,4334,85,77,"PIRATA.CAT",28
25,"25905",386,264,258,12,6,"PIRATA.CAT",0
25,"25014",264,170,164,11,6,"PIRATA.CAT",0
17,"17194",93,55,55,1,0,"PIRATA.CAT",1
25,"25194",440,292,283,11,9,"PIRATA.CAT",3
8,"8129",444,278,271,2,7,"PIRATA.CAT",0
8,"8145",2597,1823,1784,23,39,"PIRATA.CAT",17
17,"17192",145,107,105,4,2,"PIRATA.CAT",1
17,"17168",393,285,281,8,4,"PIRATA.CAT",3
8,"8205",54870,41064,40491,682,573,"PIRATA.CAT",329
43,"43065",443,278,270,8,8,"PIRATA.CAT",0
17,"17162",137,80,78,2,2,"PIRATA.CAT",1
8,"8014",1906,1338,1313,37,25,"PIRATA.CAT",11
8,"8146",1321,876,862,18,14,"PIRATA.CAT",6
8,"8286",2865,1843,1796,30,47,"PIRATA.CAT",5
25,"25007",1363,902,885,36,17,"PIRATA.CAT",2
17,"17054",395,250,247,3,3,"PIRATA.CAT",1
43,"43101",146,94,93,3,1,"PIRATA.CAT",0
17,"17175",569,375,369,6,6,"PIRATA.CAT",1
17,"17204",539,349,347,10,2,"PIRATA.CAT",0
8,"8189",141,113,111,4,2,"PIRATA.CAT",1
25,"25137",8404,5264,5167,112,97,"PIRATA.CAT",17
8,"8260",17869,11898,11686,215,212,"PIRATA.CAT",63
8,"8227",2372,1591,1549,38,42,"PIRATA.CAT",6
17,"17176",141,96,95,3,1,"PIRATA.CAT",1
8,"8219",14647,10347,10169,193,178,"PIRATA.CAT",65
8,"8107",10955,7236,7130,151,106,"PIRATA.CAT",42
43,"43009",1421,913,897,18,16,"PIRATA.CAT",6
25,"25013",2274,1344,1321,25,23,"PIRATA.CAT",5
8,"8209",6596,4415,4351,69,64,"PIRATA.CAT",34
8,"8230",7452,5349,5286,94,63,"PIRATA.CAT",22
17,"17009",4089,2573,2490,59,83,"PIRATA.CAT",14
8,"8207",1718,1296,1256,28,40,"PIRATA.CAT",2
8,"8175",3477,2303,2270,39,33,"PIRATA.CAT",1
43,"43082",383,282,270,8,12,"PIRATA.CAT",3
43,"43110",307,216,214,5,2,"PIRATA.CAT",2
17,"17085",295,212,208,12,4,"PIRATA.CAT",1
17,"17109",759,428,414,10,14,"PIRATA.CAT",1
17,"17116",369,230,227,3,3,"PIRATA.CAT",1
8,"8282",6092,4478,4405,79,73,"PIRATA.CAT",24
43,"43127",778,530,524,6,6,"PIRATA.CAT",3
25,"25211",701,378,368,5,10,"PIRATA.CAT",2
43,"43018",430,350,337,7,13,"PIRATA.CAT",1
25,"25088",100,74,74,0,0,"PIRATA.CAT",0
17,"17154",93,54,49,1,5,"PIRATA.CAT",2
25,"25038",1606,1104,1093,19,11,"PIRATA.CAT",1
17,"17095",19245,11212,11067,160,145,"PIRATA.CAT",41
8,"8191",5520,3601,3536,64,65,"PIRATA.CAT",21
25,"25173",1784,1177,1139,20,38,"PIRATA.CAT",5
25,"25037",396,275,273,9,2,"PIRATA.CAT",3
43,"43070",265,198,196,3,2,"PIRATA.CAT",1
25,"25201",119,78,76,3,2,"PIRATA.CAT",0
8,"8068",6554,4323,4255,87,68,"PIRATA.CAT",29
25,"25099",1185,720,709,9,11,"PIRATA.CAT",3
8,"8177",52,31,31,1,0,"PIRATA.CAT",0
43,"43022",1559,1097,1074,22,23,"PIRATA.CAT",2
8,"8119",6039,3991,3884,74,107,"PIRATA.CAT",27
17,"17189",1536,1061,1025,7,36,"PIRATA.CAT",6
25,"25019",4626,2971,2932,54,39,"PIRATA.CAT",6
17,"17027",2865,1955,1892,34,63,"PIRATA.CAT",8
17,"17018",478,337,332,8,5,"PIRATA.CAT",5
17,"17061",175,123,123,4,0,"PIRATA.CAT",0
8,"8206",717,557,547,7,10,"PIRATA.CAT",5
8,"8202",12206,8265,8129,183,136,"PIRATA.CAT",42
43,"43907",4122,2759,2712,52,47,"PIRATA.CAT",10
17,"17159",639,408,397,3,11,"PIRATA.CAT",0
25,"25020",328,216,209,4,7,"PIRATA.CAT",0
8,"8066",1315,985,965,16,20,"PIRATA.CAT",3
8,"8056",39345,26705,26396,449,309,"PIRATA.CAT",170
8,"8299",444,277,267,5,10,"PIRATA.CAT",2
17,"17073",1753,1320,1298,18,22,"PIRATA.CAT",12
17,"17041",237,153,153,1,0,"PIRATA.CAT",2
8,"8141",4666,3124,3066,57,58,"PIRATA.CAT",15
25,"25016",2203,1375,1357,20,18,"PIRATA.CAT",1
8,"8168",418,268,266,0,2,"PIRATA.CAT",1
43,"43080",254,175,173,7,2,"PIRATA.CAT",0
43,"43047",4064,2412,2352,50,60,"PIRATA.CAT",13
17,"17058",177,115,114,2,1,"PIRATA.CAT",1
43,"43023",244,179,177,8,2,"PIRATA.CAT",1
17,"17228",280,172,170,4,2,"PIRATA.CAT",1
8,"8060",167,102,101,0,1,"PIRATA.CAT",0
8,"8010",4124,2674,2611,44,63,"PIRATA.CAT",10
25,"25102",733,478,464,15,14,"PIRATA.CAT",2
43,"43130",196,132,131,7,1,"PIRATA.CAT",0
25,"25191",353,234,227,5,7,"PIRATA.CAT",0
25,"25225",603,395,387,7,8,"PIRATA.CAT",0
17,"17209",605,469,463,21,6,"PIRATA.CAT",4
43,"43111",2096,1305,1281,19,24,"PIRATA.CAT",6
43,"43078",841,557,547,7,10,"PIRATA.CAT",1
43,"43163",24903,15475,15241,263,234,"PIRATA.CAT",69
8,"8142",127,83,83,4,0,"PIRATA.CAT",0
43,"43013",4369,2795,2747,54,48,"PIRATA.CAT",11
17,"17020",3446,2322,2268,45,54,"PIRATA.CAT",9
17,"17081",236,165,162,2,3,"PIRATA.CAT",0
43,"43008",333,206,197,3,9,"PIRATA.CAT",0
25,"25070",888,594,582,18,12,"PIRATA.CAT",1
17,"17090",548,412,404,7,8,"PIRATA.CAT",2
8,"8195",88,64,64,2,0,"PIRATA.CAT",0
25,"25125",450,297,289,10,8,"PIRATA.CAT",0
25,"25217",10570,6660,6500,191,160,"PIRATA.CAT",35
17,"17030",624,414,409,8,5,"PIRATA.CAT",2
17,"17014",64,39,37,0,2,"PIRATA.CAT",0
25,"25176",341,243,240,7,3,"PIRATA.CAT",1
25,"25154",126,77,77,2,0,"PIRATA.CAT",0
8,"8247",903,627,608,10,19,"PIRATA.CAT",2
17,"17211",864,628,612,12,16,"PIRATA.CAT",2
25,"25033",1125,738,718,17,20,"PIRATA.CAT",3
8,"8203",2442,1526,1498,34,28,"PIRATA.CAT",7
8,"8053",2850,1788,1772,21,16,"PIRATA.CAT",14
43,"43044",3990,2768,2715,72,53,"PIRATA.CAT",5
8,"8076",15925,10435,10242,179,193,"PIRATA.CAT",71
43,"43001",706,481,473,12,8,"PIRATA.CAT",8
43,"43074",1697,1150,1120,25,30,"PIRATA.CAT",8
25,"25141",171,111,107,2,4,"PIRATA.CAT",2
8,"8165",1689,1091,1070,18,21,"PIRATA.CAT",7
25,"25145",88,67,67,2,0,"PIRATA.CAT",0
25,"25234",4572,2707,2648,57,59,"PIRATA.CAT",8
43,"43178",1262,891,870,24,21,"PIRATA.CAT",2
8,"8026",180,144,143,0,1,"PIRATA.CAT",0
8,"8097",985,676,657,3,19,"PIRATA.CAT",6
8,"8077",33925,23896,23548,381,348,"PIRATA.CAT",162
25,"25105",146,90,89,1,1,"PIRATA.CAT",1
43,"43140",2393,1612,1583,23,29,"PIRATA.CAT",6
8,"8105",9642,6571,6483,110,88,"PIRATA.CAT",21
8,"8238",13892,10237,10094,206,143,"PIRATA.CAT",67
25,"25082",265,156,155,8,1,"PIRATA.CAT",0
25,"25228",2907,2043,2021,43,22,"PIRATA.CAT",2
17,"17063",169,113,111,5,2,"PIRATA.CAT",3
25,"25911",472,306,296,2,10,"PIRATA.CAT",0
17,"17223",787,523,514,8,9,"PIRATA.CAT",4
43,"43904",2918,1779,1732,49,47,"PIRATA.CAT",3
17,"17099",74,52,50,1,2,"PIRATA.CAT",1
8,"8249",273,218,214,4,4,"PIRATA.CAT",2
25,"25167",253,176,172,0,4,"PIRATA.CAT",0
43,"43051",8749,5494,5411,78,83,"PIRATA.CAT",20
17,"17115",281,209,207,5,2,"PIRATA.CAT",3
17,"17185",2273,1416,1379,32,37,"PIRATA.CAT",4
8,"8166",1138,726,706,10,20,"PIRATA.CAT",3
8,"8269",2613,1840,1814,32,26,"PIRATA.CAT",14
17,"17102",571,354,350,7,4,"PIRATA.CAT",0
17,"17224",355,246,241,10,5,"PIRATA.CAT",0
8,"8283",5862,3712,3618,72,94,"PIRATA.CAT",7
8,"8133",157,100,97,2,3,"PIRATA.CAT",0
17,"17004",504,340,337,6,3,"PIRATA.CAT",9
43,"43084",573,383,378,6,5,"PIRATA.CAT",1
25,"25120",90759,58761,57778,1325,983,"PIRATA.CAT",339
8,"8005",5884,4114,4041,68,73,"PIRATA.CAT",20
8,"8096",40650,28247,27784,527,463,"PIRATA.CAT",171
43,"43011",1013,745,729,21,16,"PIRATA.CAT",5
17,"17222",108,86,86,1,0,"PIRATA.CAT",2
25,"25034",2471,1622,1592,25,30,"PIRATA.CAT",6
8,"8052",148,103,98,1,5,"PIRATA.CAT",0
17,"17040",506,320,316,7,4,"PIRATA.CAT",3
17,"17173",174,121,119,1,2,"PIRATA.CAT",0
8,"8050",149,112,108,4,4,"PIRATA.CAT",1
8,"8137",255,190,190,3,0,"PIRATA.CAT",1
25,"25135",1077,739,722,18,17,"PIRATA.CAT",2
17,"17193",3978,2365,2305,38,60,"PIRATA.CAT",15
17,"17161",978,693,687,21,6,"PIRATA.CAT",5
43,"43113",454,321,316,10,5,"PIRATA.CAT",2
25,"25021",2693,1632,1605,40,27,"PIRATA.CAT",4
8,"8016",1984,1319,1289,26,30,"PIRATA.CAT",11
43,"43094",2209,1558,1524,31,34,"PIRATA.CAT",5
8,"8058",1699,1089,1061,25,28,"PIRATA.CAT",6
8,"8118",17077,11817,11598,203,219,"PIRATA.CAT",90
43,"43037",16656,9986,9812,163,174,"PIRATA.CAT",40
25,"25111",116,70,70,0,0,"PIRATA.CAT",0
25,"25179",198,141,136,1,5,"PIRATA.CAT",1
43,"43092",7051,4294,4220,45,74,"PIRATA.CAT",15
8,"8007",6338,4165,4050,89,115,"PIRATA.CAT",32
8,"8122",1755,1063,1034,17,29,"PIRATA.CAT",7
8,"8128",557,377,374,16,3,"PIRATA.CAT",1
8,"8252",24033,16704,16402,368,302,"PIRATA.CAT",120
17,"17056",1704,1171,1158,21,13,"PIRATA.CAT",8
17,"17148",1546,980,957,24,23,"PIRATA.CAT",6
43,"43160",1278,840,812,9,28,"PIRATA.CAT",2
25,"25171",2305,1496,1469,37,27,"PIRATA.CAT",7
8,"8109",200,155,153,1,2,"PIRATA.CAT",2
8,"8242",243,174,172,5,2,"PIRATA.CAT",1
25,"25057",198,140,136,2,4,"PIRATA.CAT",0
17,"17007",1778,1137,1113,16,24,"PIRATA.CAT",7
17,"17143",134,89,87,2,2,"PIRATA.CAT",1
17,"17137",3331,2163,2110,39,53,"PIRATA.CAT",9
25,"25134",657,421,416,4,5,"PIRATA.CAT",1
43,"43033",772,547,533,4,14,"PIRATA.CAT",2
17,"17097",185,136,136,4,0,"PIRATA.CAT",0
43,"43136",10163,6312,6197,121,115,"PIRATA.CAT",17
8,"8253",134,91,91,2,0,"PIRATA.CAT",1
25,"25221",125,76,76,0,0,"PIRATA.CAT",0
17,"17147",8385,5401,5325,105,76,"PIRATA.CAT",28
8,"8045",70,42,42,2,0,"PIRATA.CAT",0
43,"43161",17199,10765,10547,197,218,"PIRATA.CAT",105
25,"25124",161,110,109,4,1,"PIRATA.CAT",0
43,"43902",2761,1836,1811,25,25,"PIRATA.CAT",0
25,"25193",771,509,501,8,8,"PIRATA.CAT",2
8,"8234",3143,2040,2008,45,32,"PIRATA.CAT",13
8,"8030",4849,3466,3422,50,44,"PIRATA.CAT",22
17,"17119",89,65,64,3,1,"PIRATA.CAT",1
8,"8158",2996,2012,1986,19,26,"PIRATA.CAT",16
8,"8190",281,201,197,3,4,"PIRATA.CAT",0
17,"17181",3228,2116,2081,19,35,"PIRATA.CAT",4
8,"8101",169663,112624,111107,1841,1517,"PIRATA.CAT",776
25,"25032",71,44,42,1,2,"PIRATA.CAT",0
43,"43032",587,418,413,9,5,"PIRATA.CAT",5
8,"8255",132,83,82,1,1,"PIRATA.CAT",0
17,"17120",779,501,485,9,16,"PIRATA.CAT",2
25,"25101",583,391,382,8,9,"PIRATA.CAT",0
17,"17903",893,565,556,14,9,"PIRATA.CAT",3
43,"43048",830,547,530,16,17,"PIRATA.CAT",4
43,"43010",302,227,223,7,4,"PIRATA.CAT",1
25,"25206",289,187,184,3,3,"PIRATA.CAT",1
43,"43114",383,238,234,6,4,"PIRATA.CAT",1
25,"25114",102,82,78,4,4,"PIRATA.CAT",2
8,"8266",42860,30047,29521,536,526,"PIRATA.CAT",206
8,"8001",8538,5929,5838,120,91,"PIRATA.CAT",41
25,"25071",56,37,35,2,2,"PIRATA.CAT",0
43,"43155",22951,14114,13856,326,258,"PIRATA.CAT",46
43,"43147",528,393,380,7,13,"PIRATA.CAT",0
8,"8062",863,595,583,8,12,"PIRATA.CAT",1
43,"43901",8849,5651,5540,179,111,"PIRATA.CAT",10
17,"17033",5157,3142,3095,44,47,"PIRATA.CAT",15
25,"25029",1766,1145,1118,38,27,"PIRATA.CAT",8
25,"25230",1665,1164,1140,36,24,"PIRATA.CAT",4
25,"25906",235,160,154,3,6,"PIRATA.CAT",0
17,"17071",1064,719,698,33,21,"PIRATA.CAT",4
25,"25250",358,237,234,4,3,"PIRATA.CAT",0
43,"43017",141,98,98,2,0,"PIRATA.CAT",2
8,"8287",1053,738,730,26,8,"PIRATA.CAT",5
17,"17163",2478,1729,1681,41,48,"PIRATA.CAT",17
43,"43164",298,233,231,4,2,"PIRATA.CAT",0
43,"43088",1810,1199,1177,29,22,"PIRATA.CAT",6
17,"17012",1093,689,679,11,10,"PIRATA.CAT",7
8,"8217",24130,17554,17319,383,235,"PIRATA.CAT",104
17,"17008",3745,2262,2195,34,67,"PIRATA.CAT",12
8,"8268",1110,768,755,17,13,"PIRATA.CAT",1
8,"8277",134,90,90,4,0,"PIRATA.CAT",0
17,"17233",2192,1470,1434,33,36,"PIRATA.CAT",21
43,"43007",635,448,441,7,7,"PIRATA.CAT",2
43,"43079",387,259,255,26,4,"PIRATA.CAT",2
8,"8214",6754,4659,4555,83,104,"PIRATA.CAT",32
17,"17025",1127,775,760,11,15,"PIRATA.CAT",8
17,"17022",6771,4247,4169,76,78,"PIRATA.CAT",21
8,"8901",249,180,180,2,0,"PIRATA.CAT",0
25,"25118",378,232,226,4,6,"PIRATA.CAT",0
8,"8084",1134,789,760,14,29,"PIRATA.CAT",6
17,"17003",101,67,64,2,3,"PIRATA.CAT",1
43,"43059",264,185,185,4,0,"PIRATA.CAT",2
8,"8115",3870,2693,2644,60,49,"PIRATA.CAT",20
43,"43034",494,355,344,8,11,"PIRATA.CAT",2
8,"8292",1083,775,764,21,11,"PIRATA.CAT",3
25,"25119",2297,1554,1513,46,41,"PIRATA.CAT",9
43,"43035",280,202,198,0,4,"PIRATA.CAT",2
25,"25219",144,90,86,0,4,"PIRATA.CAT",4
17,"17174",183,120,117,5,3,"PIRATA.CAT",0
25,"25015",394,264,264,14,0,"PIRATA.CAT",0
8,"8085",1033,731,720,10,11,"PIRATA.CAT",6
8,"8239",471,338,333,6,5,"PIRATA.CAT",0
17,"17042",415,297,292,2,5,"PIRATA.CAT",7
25,"25209",1558,1041,1009,22,32,"PIRATA.CAT",4
43,"43075",102,63,63,1,0,"PIRATA.CAT",0
43,"43021",381,218,213,3,5,"PIRATA.CAT",1
25,"25164",404,270,264,5,6,"PIRATA.CAT",2
43,"43081",574,415,404,13,11,"PIRATA.CAT",2
17,"17121",230,159,158,7,1,"PIRATA.CAT",0
8,"8270",17464,11828,11677,212,151,"PIRATA.CAT",54
17,"17902",1330,898,874,11,24,"PIRATA.CAT",4
17,"17024",301,207,204,4,3,"PIRATA.CAT",0
8,"8280",116,74,72,3,2,"PIRATA.CAT",0
25,"25063",97,65,64,2,1,"PIRATA.CAT",1
17,"17214",695,470,461,10,9,"PIRATA.CAT",5
25,"25143",86,58,58,1,0,"PIRATA.CAT",0
8,"8117",2424,1685,1661,45,24,"PIRATA.CAT",9
43,"43107",378,255,248,18,7,"PIRATA.CAT",4
43,"43025",660,453,446,13,7,"PIRATA.CAT",0
8,"8274",4887,3326,3279,36,47,"PIRATA.CAT",7
43,"43014",14146,9153,8915,204,238,"PIRATA.CAT",19
25,"25002",481,306,302,6,4,"PIRATA.CAT",6
8,"8164",873,606,584,13,22,"PIRATA.CAT",6
8,"8284",11920,7059,6942,139,117,"PIRATA.CAT",36
43,"43077",486,335,328,4,7,"PIRATA.CAT",0
43,"43089",272,193,185,1,8,"PIRATA.CAT",3
43,"43159",89,51,51,2,0,"PIRATA.CAT",0
43,"43004",6411,4089,4001,92,88,"PIRATA.CAT",18
17,"17139",1346,899,869,21,30,"PIRATA.CAT",2
17,"17188",167,124,122,9,2,"PIRATA.CAT",1
8,"8088",11250,8019,7861,144,158,"PIRATA.CAT",49
25,"25087",65,41,39,0,2,"PIRATA.CAT",0
25,"25130",208,117,112,4,5,"PIRATA.CAT",0
25,"25017",248,160,159,1,1,"PIRATA.CAT",0
25,"25142",387,265,264,5,1,"PIRATA.CAT",5
8,"8152",129,94,93,0,1,"PIRATA.CAT",1
17,"17230",456,326,320,10,6,"PIRATA.CAT",9
8,"8017",2740,1800,1768,38,32,"PIRATA.CAT",11
17,"17106",140,105,104,0,1,"PIRATA.CAT",0
25,"25222",69,55,54,0,1,"PIRATA.CAT",0
43,"43103",897,586,575,21,11,"PIRATA.CAT",2
17,"17227",107,82,82,1,0,"PIRATA.CAT",1
17,"17078",346,231,226,3,5,"PIRATA.CAT",0
25,"25131",439,319,314,6,5,"PIRATA.CAT",0
25,"25255",468,318,309,9,9,"PIRATA.CAT",3
17,"17001",557,370,365,7,5,"PIRATA.CAT",4
43,"43095",2434,1658,1624,27,34,"PIRATA.CAT",9
25,"25212",233,185,185,8,0,"PIRATA.CAT",0
43,"43106",878,600,592,17,8,"PIRATA.CAT",0
8,"8170",458,300,288,13,12,"PIRATA.CAT",1
17,"17067",732,483,470,16,13,"PIRATA.CAT",0
25,"25077",474,281,277,5,4,"PIRATA.CAT",2
8,"8294",1870,1205,1171,22,34,"PIRATA.CAT",9
8,"8019",1143222,778246,767530,12386,10716,"PIRATA.CAT",6207
8,"8025",1460,990,963,14,27,"PIRATA.CAT",5
43,"43137",1873,1241,1212,27,29,"PIRATA.CAT",1
8,"8110",13366,8493,8329,144,164,"PIRATA.CAT",24
17,"17190",811,548,532,7,16,"PIRATA.CAT",4
43,"43115",171,112,110,3,2,"PIRATA.CAT",4
8,"8124",36292,24541,24210,471,331,"PIRATA.CAT",148
8,"8063",434,336,333,8,3,"PIRATA.CAT",3
43,"43063",588,358,350,13,8,"PIRATA.CAT",2
17,"17199",6630,4242,4162,80,80,"PIRATA.CAT",22
8,"8100",1934,1437,1401,40,36,"PIRATA.CAT",4
43,"43105",175,119,116,14,3,"PIRATA.CAT",0
8,"8305",26208,17810,17506,296,304,"PIRATA.CAT",119
25,"25152",160,92,90,4,2,"PIRATA.CAT",0
8,"8265",1575,1065,1026,38,39,"PIRATA.CAT",3
8,"8172",19889,13537,13333,267,204,"PIRATA.CAT",86
8,"8256",669,498,496,16,2,"PIRATA.CAT",9
17,"17049",3056,1986,1944,43,42,"PIRATA.CAT",15
25,"25011",5241,3127,3080,48,47,"PIRATA.CAT",9
43,"43056",931,537,515,18,22,"PIRATA.CAT",0
25,"25062",806,515,497,11,18,"PIRATA.CAT",2
25,"25052",1611,1094,1062,21,32,"PIRATA.CAT",2
17,"17136",173,124,120,0,4,"PIRATA.CAT",1
8,"8112",12946,8533,8390,227,143,"PIRATA.CAT",27
43,"43171",13906,8978,8855,167,123,"PIRATA.CAT",40
43,"43073",90,57,57,1,0,"PIRATA.CAT",0
43,"43122",92,65,61,0,4,"PIRATA.CAT",1
25,"25003",3853,2367,2340,68,27,"PIRATA.CAT",7
17,"17182",257,177,175,2,2,"PIRATA.CAT",5
43,"43154",136,97,96,6,1,"PIRATA.CAT",0
25,"25902",581,411,395,15,16,"PIRATA.CAT",0
43,"43157",388,282,270,10,12,"PIRATA.CAT",0
17,"17197",144,103,102,3,1,"PIRATA.CAT",1
43,"43046",114,80,79,5,1,"PIRATA.CAT",5
8,"8199",712,507,499,15,8,"PIRATA.CAT",0
25,"25004",553,405,400,13,5,"PIRATA.CAT",2
8,"8297",138,99,99,2,0,"PIRATA.CAT",1
8,"8123",18751,13394,13154,238,240,"PIRATA.CAT",70
43,"43098",362,251,247,1,4,"PIRATA.CAT",1
17,"17021",108,86,79,0,7,"PIRATA.CAT",1
17,"17068",252,156,156,4,0,"PIRATA.CAT",1
17,"17100",201,140,135,1,5,"PIRATA.CAT",0
8,"8002",202,143,140,4,3,"PIRATA.CAT",0
43,"43139",2166,1319,1270,37,49,"PIRATA.CAT",13
25,"25089",107,66,64,0,2,"PIRATA.CAT",0
8,"8080",42,33,33,2,0,"PIRATA.CAT",0
43,"43169",477,377,364,8,13,"PIRATA.CAT",1
25,"25196",127,87,86,3,1,"PIRATA.CAT",0
8,"8151",504,345,338,6,7,"PIRATA.CAT",0
8,"8194",24757,15009,14799,245,210,"PIRATA.CAT",113
17,"17028",327,220,217,4,3,"PIRATA.CAT",0
43,"43045",156,110,109,1,1,"PIRATA.CAT",1
17,"17044",6619,4293,4187,69,106,"PIRATA.CAT",33
25,"25104",128,88,86,11,2,"PIRATA.CAT",0
8,"8221",11348,8413,8306,109,107,"PIRATA.CAT",66
8,"8289",4123,2802,2768,54,34,"PIRATA.CAT",14
17,"17101",567,349,339,4,10,"PIRATA.CAT",0
25,"25175",221,151,150,0,1,"PIRATA.CAT",2
17,"17184",1281,803,787,21,16,"PIRATA.CAT",3
25,"25169",201,134,134,6,0,"PIRATA.CAT",1
17,"17151",174,131,131,6,0,"PIRATA.CAT",1
43,"43040",350,251,246,18,5,"PIRATA.CAT",2
8,"8095",75,56,55,1,1,"PIRATA.CAT",0
43,"43903",2368,1504,1492,22,12,"PIRATA.CAT",3
8,"8075",3906,2442,2414,31,28,"PIRATA.CAT",7
8,"8126",8299,5599,5508,103,91,"PIRATA.CAT",41
8,"8279",149233,101676,100363,1965,1313,"PIRATA.CAT",760
17,"17195",324,220,214,6,6,"PIRATA.CAT",1
43,"43141",131,71,70,3,1,"PIRATA.CAT",0
8,"8048",622,461,454,9,7,"PIRATA.CAT",2
43,"43168",106,70,69,2,1,"PIRATA.CAT",0
43,"43117",150,118,115,1,3,"PIRATA.CAT",0
17,"17226",852,539,535,0,4,"PIRATA.CAT",5
25,"25122",1956,1281,1256,33,25,"PIRATA.CAT",8
25,"25041",625,432,420,20,12,"PIRATA.CAT",2
17,"17065",316,211,205,6,6,"PIRATA.CAT",1
25,"25044",195,136,134,1,2,"PIRATA.CAT",1
17,"17157",127,99,98,3,1,"PIRATA.CAT",0
8,"8291",4516,2895,2855,56,40,"PIRATA.CAT",19
8,"8240",9104,6355,6262,101,93,"PIRATA.CAT",28
25,"25153",215,165,161,0,4,"PIRATA.CAT",0
43,"43003",307,187,184,10,3,"PIRATA.CAT",0
25,"25128",151,83,81,1,2,"PIRATA.CAT",0
8,"8079",335,255,243,14,12,"PIRATA.CAT",1
17,"17123",365,274,266,8,8,"PIRATA.CAT",4
25,"25912",899,643,640,6,3,"PIRATA.CAT",4
25,"25023",4446,3079,3020,70,59,"PIRATA.CAT",10
25,"25078",1014,730,719,17,11,"PIRATA.CAT",3
25,"25247",142,80,78,3,2,"PIRATA.CAT",0
17,"17141",5689,3485,3428,50,57,"PIRATA.CAT",22
43,"43121",636,385,371,6,14,"PIRATA.CAT",0
17,"17048",6176,3818,3773,52,45,"PIRATA.CAT",23
17,"17019",1783,1264,1234,42,30,"PIRATA.CAT",6
17,"17205",198,146,138,3,8,"PIRATA.CAT",0
17,"17060",378,240,233,1,7,"PIRATA.CAT",0
25,"25098",266,177,177,0,0,"PIRATA.CAT",0
17,"17206",167,108,107,2,1,"PIRATA.CAT",0
43,"43029",330,202,194,6,8,"PIRATA.CAT",1
17,"17158",404,266,264,3,2,"PIRATA.CAT",1
17,"17191",153,116,114,0,2,"PIRATA.CAT",0
43,"43132",365,217,214,8,3,"PIRATA.CAT",3
8,"8258",845,577,555,23,22,"PIRATA.CAT",3
17,"17010",327,216,214,6,2,"PIRATA.CAT",3
25,"25244",350,270,268,9,2,"PIRATA.CAT",0
8,"8272",148,97,96,6,1,"PIRATA.CAT",0
17,"17077",580,374,372,5,2,"PIRATA.CAT",1
8,"8905",2268,1692,1657,28,35,"PIRATA.CAT",13
8,"8018",2664,1707,1669,29,38,"PIRATA.CAT",2
8,"8069",3028,2071,2029,36,42,"PIRATA.CAT",16
8,"8042",2172,1459,1448,30,11,"PIRATA.CAT",6
8,"8102",27850,18716,18470,373,246,"PIRATA.CAT",128
17,"17198",404,264,259,9,5,"PIRATA.CAT",4
17,"17016",725,491,481,8,10,"PIRATA.CAT",2
25,"25048",1684,1120,1095,29,25,"PIRATA.CAT",4
8,"8149",985,683,671,11,12,"PIRATA.CAT",1
25,"25042",211,131,127,0,4,"PIRATA.CAT",2
43,"43158",109,63,61,5,2,"PIRATA.CAT",0
17,"17111",789,584,574,15,10,"PIRATA.CAT",6
25,"25204",1313,888,881,21,7,"PIRATA.CAT",2
43,"43104",1821,1209,1178,34,31,"PIRATA.CAT",6
25,"25036",190,138,134,5,4,"PIRATA.CAT",1
17,"17180",8076,4868,4767,81,101,"PIRATA.CAT",26
43,"43112",294,184,181,2,3,"PIRATA.CAT",3
8,"8237",1692,1155,1127,22,28,"PIRATA.CAT",4
8,"8130",95,63,62,3,1,"PIRATA.CAT",0
43,"43177",338,242,236,6,6,"PIRATA.CAT",4
17,"17052",134,84,83,2,1,"PIRATA.CAT",0
43,"43041",237,177,176,4,1,"PIRATA.CAT",0
25,"25151",641,451,444,20,7,"PIRATA.CAT",0
43,"43145",3968,2781,2742,52,39,"PIRATA.CAT",13
43,"43030",454,321,307,5,14,"PIRATA.CAT",3
25,"25901",315,196,189,3,7,"PIRATA.CAT",0
43,"43053",190,149,149,2,0,"PIRATA.CAT",0
17,"17080",165,115,114,1,1,"PIRATA.CAT",0
43,"43066",165,113,112,2,1,"PIRATA.CAT",1
17,"17069",395,276,267,2,9,"PIRATA.CAT",1
8,"8111",220,188,188,4,0,"PIRATA.CAT",1
8,"8132",381,247,241,6,6,"PIRATA.CAT",0
17,"17029",198,136,133,1,3,"PIRATA.CAT",2
8,"8028",1049,667,657,15,10,"PIRATA.CAT",6
25,"25172",1838,1267,1230,35,37,"PIRATA.CAT",8
17,"17203",171,97,94,3,3,"PIRATA.CAT",0
8,"8215",2594,1763,1728,51,35,"PIRATA.CAT",9
25,"25205",563,373,362,12,11,"PIRATA.CAT",1
25,"25093",657,465,455,8,10,"PIRATA.CAT",8
17,"17200",616,406,393,12,13,"PIRATA.CAT",2
17,"17110",1359,930,917,12,13,"PIRATA.CAT",2
8,"8225",92,68,68,2,0,"PIRATA.CAT",1
8,"8055",476,312,304,11,8,"PIRATA.CAT",0
43,"43119",739,500,496,5,4,"PIRATA.CAT",2
25,"25030",147,101,95,3,6,"PIRATA.CAT",0
8,"8039",365,264,260,5,4,"PIRATA.CAT",1
8,"8067",5657,3772,3671,75,101,"PIRATA.CAT",22
43,"43144",1187,787,772,12,15,"PIRATA.CAT",7
8,"8041",10032,6880,6761,112,119,"PIRATA.CAT",31
25,"25012",2204,1432,1406,29,26,"PIRATA.CAT",5
25,"25053",1085,733,727,10,6,"PIRATA.CAT",2
8,"8093",32,21,20,0,1,"PIRATA.CAT",0
8,"8092",3928,2511,2473,33,38,"PIRATA.CAT",9
17,"17037",105,66,66,2,0,"PIRATA.CAT",0
17,"17126",309,231,229,9,2,"PIRATA.CAT",0
25,"25112",286,202,199,11,3,"PIRATA.CAT",1
25,"25907",506,297,292,6,5,"PIRATA.CAT",2
8,"8113",52352,33606,33123,590,483,"PIRATA.CAT",145
8,"8198",4112,2766,2661,49,105,"PIRATA.CAT",24
25,"25056",289,168,163,3,5,"PIRATA.CAT",0
17,"17208",1012,642,622,12,20,"PIRATA.CAT",9
8,"8197",7316,4983,4926,69,57,"PIRATA.CAT",28
17,"17079",62633,40844,40101,670,743,"PIRATA.CAT",312
25,"25181",189,128,123,3,5,"PIRATA.CAT",2
8,"8161",10991,6841,6709,114,132,"PIRATA.CAT",31
25,"25092",135,100,97,2,3,"PIRATA.CAT",1
25,"25121",623,406,400,6,6,"PIRATA.CAT",2
8,"8241",80,61,61,1,0,"PIRATA.CAT",1
25,"25008",1187,834,818,15,16,"PIRATA.CAT",2
8,"8138",4014,2735,2679,46,56,"PIRATA.CAT",18
43,"43165",624,471,459,6,12,"PIRATA.CAT",4
8,"8276",249,188,187,9,1,"PIRATA.CAT",0
17,"17130",333,236,233,5,3,"PIRATA.CAT",3
25,"25043",830,483,467,17,16,"PIRATA.CAT",0
8,"8180",26210,17504,17214,366,290,"PIRATA.CAT",107
43,"43072",97,73,70,0,3,"PIRATA.CAT",0
43,"43133",5697,3470,3388,76,82,"PIRATA.CAT",28
25,"25208",294,174,170,3,4,"PIRATA.CAT",3
8,"8004",228,176,172,2,4,"PIRATA.CAT",0
25,"25200",353,225,217,4,8,"PIRATA.CAT",2
8,"8044",4247,2763,2712,50,51,"PIRATA.CAT",13
17,"17145",1593,1090,1068,10,22,"PIRATA.CAT",1
25,"25245",445,312,306,4,6,"PIRATA.CAT",1
8,"8163",17986,11683,11548,159,135,"PIRATA.CAT",52
25,"25233",270,207,201,3,6,"PIRATA.CAT",3
25,"25076",165,84,83,3,1,"PIRATA.CAT",0
8,"8275",242,188,186,4,2,"PIRATA.CAT",1
8,"8049",1340,839,816,10,23,"PIRATA.CAT",2
8,"8302",9271,5981,5892,82,89,"PIRATA.CAT",36
43,"43153",10307,6572,6450,94,122,"PIRATA.CAT",21
17,"17186",3593,2358,2317,33,41,"PIRATA.CAT",18
43,"43093",3924,2507,2445,62,62,"PIRATA.CAT",16
17,"17043",159,101,100,2,1,"PIRATA.CAT",0
8,"8157",8256,5729,5624,119,105,"PIRATA.CAT",28
17,"17160",14852,9257,9128,145,129,"PIRATA.CAT",45
25,"25210",1164,799,789,13,10,"PIRATA.CAT",1
17,"17217",347,267,251,5,16,"PIRATA.CAT",4
17,"17216",158,100,97,1,3,"PIRATA.CAT",5
25,"25242",787,501,490,11,11,"PIRATA.CAT",0
43,"43146",45,33,30,1,3,"PIRATA.CAT",0
43,"43085",229,178,171,0,7,"PIRATA.CAT",1
17,"17170",192,135,134,1,1,"PIRATA.CAT",5
8,"8156",10672,7359,7225,121,134,"PIRATA.CAT",45
8,"8009",8932,6188,6088,103,100,"PIRATA.CAT",40
8,"8193",928,565,554,15,11,"PIRATA.CAT",1
43,"43128",927,636,625,11,11,"PIRATA.CAT",6
25,"25123",206,140,136,4,4,"PIRATA.CAT",2
43,"43031",1509,1016,992,20,24,"PIRATA.CAT",3
8,"8244",5746,4044,3940,102,104,"PIRATA.CAT",18
43,"43064",2063,1420,1391,37,29,"PIRATA.CAT",1
8,"8902",3600,2518,2496,57,22,"PIRATA.CAT",14
8,"8099",808,533,519,11,14,"PIRATA.CAT",2
8,"8212",508,366,363,1,3,"PIRATA.CAT",0
25,"25073",662,382,379,11,3,"PIRATA.CAT",2
25,"25040",10654,6905,6768,144,137,"PIRATA.CAT",23
17,"17234",183,131,128,2,3,"PIRATA.CAT",2
17,"17171",148,111,109,5,2,"PIRATA.CAT",0
43,"43016",3437,2323,2266,40,57,"PIRATA.CAT",22
17,"17201",131,89,89,2,0,"PIRATA.CAT",0
8,"8306",509,330,324,6,6,"PIRATA.CAT",0
25,"25150",185,119,113,4,6,"PIRATA.CAT",1
8,"8303",279,202,201,11,1,"PIRATA.CAT",0
8,"8184",52133,33696,33220,656,476,"PIRATA.CAT",205
8,"8233",1867,1179,1169,29,10,"PIRATA.CAT",2
25,"25069",471,291,289,9,2,"PIRATA.CAT",1
43,"43060",3049,2030,1980,62,50,"PIRATA.CAT",25
8,"8201",458,305,298,12,7,"PIRATA.CAT",2
25,"25913",100,78,78,0,0,"PIRATA.CAT",1
17,"17098",311,208,202,4,6,"PIRATA.CAT",4
25,"25127",226,134,130,2,4,"PIRATA.CAT",1
8,"8307",47176,31341,30846,536,495,"PIRATA.CAT",218
43,"43062",298,227,223,7,4,"PIRATA.CAT",3
8,"8903",217,178,176,10,2,"PIRATA.CAT",1
25,"25220",1076,711,702,10,9,"PIRATA.CAT",4
8,"8006",10984,7255,7092,104,163,"PIRATA.CAT",39
25,"25009",690,479,471,9,8,"PIRATA.CAT",2
43,"43118",439,318,313,7,5,"PIRATA.CAT",1
8,"8254",1721,1189,1174,26,15,"PIRATA.CAT",5
8,"8098",2374,1552,1535,28,17,"PIRATA.CAT",13
8,"8071",248,172,167,2,5,"PIRATA.CAT",3
17,"17128",309,232,224,5,8,"PIRATA.CAT",0
17,"17092",3520,2273,2228,42,45,"PIRATA.CAT",15
8,"8182",2802,1871,1852,35,19,"PIRATA.CAT",11
17,"17150",1428,1018,996,24,22,"PIRATA.CAT",9
8,"8070",275,192,191,5,1,"PIRATA.CAT",1
25,"25129",175,105,105,3,0,"PIRATA.CAT",1
25,"25253",175,132,129,1,3,"PIRATA.CAT",1
17,"17124",1670,1087,1056,18,31,"PIRATA.CAT",3
8,"8290",1446,1075,1056,12,19,"PIRATA.CAT",8
17,"17165",608,414,400,9,14,"PIRATA.CAT",1
8,"8188",106,87,86,4,1,"PIRATA.CAT",0
8,"8183",4497,2914,2865,43,49,"PIRATA.CAT",9
17,"17089",5486,3328,3288,43,40,"PIRATA.CAT",9
17,"17132",1296,913,900,15,13,"PIRATA.CAT",2
43,"43015",104,69,68,2,1,"PIRATA.CAT",0
8,"8218",7968,5014,4932,129,82,"PIRATA.CAT",22
17,"17901",964,628,621,16,7,"PIRATA.CAT",7
25,"25035",428,289,284,5,5,"PIRATA.CAT",1
25,"25182",1075,749,731,30,18,"PIRATA.CAT",4
8,"8065",1224,796,778,13,18,"PIRATA.CAT",7
25,"25168",510,385,378,19,7,"PIRATA.CAT",0
25,"25132",128,87,85,3,2,"PIRATA.CAT",1
17,"17155",14284,8528,8391,143,137,"PIRATA.CAT",68
25,"25155",714,490,485,8,5,"PIRATA.CAT",1
8,"8031",2289,1619,1599,34,20,"PIRATA.CAT",10
43,"43125",1008,706,701,10,5,"PIRATA.CAT",4
43,"43067",626,445,431,21,14,"PIRATA.CAT",3
8,"8296",1683,1227,1203,29,24,"PIRATA.CAT",2
43,"43052",1001,669,636,12,33,"PIRATA.CAT",5
8,"8035",12099,7838,7735,123,103,"PIRATA.CAT",42
8,"8136",11117,7602,7478,174,124,"PIRATA.CAT",14
25,"25045",51,33,33,2,0,"PIRATA.CAT",0
25,"25223",951,562,546,14,16,"PIRATA.CAT",4
17,"17213",5282,3097,3041,42,56,"PIRATA.CAT",22
8,"8051",17397,12178,12002,240,176,"PIRATA.CAT",90
8,"8235",3627,2506,2467,35,39,"PIRATA.CAT",20
25,"25024",370,221,217,8,4,"PIRATA.CAT",2
25,"25186",231,168,168,3,0,"PIRATA.CAT",0
25,"25049",166,105,102,1,3,"PIRATA.CAT",0
8,"8904",10608,6654,6561,140,93,"PIRATA.CAT",48
17,"17187",574,414,402,1,12,"PIRATA.CAT",5
43,"43071",975,677,664,14,13,"PIRATA.CAT",2
8,"8150",245,181,178,11,3,"PIRATA.CAT",4
25,"25031",57,34,34,1,0,"PIRATA.CAT",0
17,"17088",551,374,363,4,11,"PIRATA.CAT",3
8,"8027",673,527,515,9,12,"PIRATA.CAT",0
8,"8091",5106,3379,3312,59,67,"PIRATA.CAT",40
8,"8024",409,266,260,4,6,"PIRATA.CAT",0
43,"43173",114,65,64,0,1,"PIRATA.CAT",0
43,"43024",1459,958,937,17,21,"PIRATA.CAT",1
25,"25248",926,615,601,17,14,"PIRATA.CAT",1
43,"43138",2719,1775,1730,45,45,"PIRATA.CAT",3
17,"17114",22610,14079,13811,263,268,"PIRATA.CAT",70
8,"8162",1955,1306,1271,28,35,"PIRATA.CAT",11
8,"8020",4542,3352,3298,77,54,"PIRATA.CAT",29
8,"8245",78826,51185,50445,962,740,"PIRATA.CAT",274
8,"8021",76,49,47,1,2,"PIRATA.CAT",2
25,"25006",362,231,228,2,3,"PIRATA.CAT",0
17,"17093",859,561,552,16,9,"PIRATA.CAT",6
17,"17032",1613,933,918,11,15,"PIRATA.CAT",8
17,"17133",1336,889,866,14,23,"PIRATA.CAT",5
17,"17083",2886,1825,1801,39,24,"PIRATA.CAT",10
25,"25059",796,580,575,9,5,"PIRATA.CAT",0
43,"43026",800,531,522,15,9,"PIRATA.CAT",2
17,"17023",26941,17098,16799,344,299,"PIRATA.CAT",74
8,"8246",1714,1175,1153,27,22,"PIRATA.CAT",8
25,"25136",106,79,79,1,0,"PIRATA.CAT",1
43,"43055",2002,1404,1374,36,30,"PIRATA.CAT",5
25,"25096",988,633,613,12,20,"PIRATA.CAT",6
25,"25224",144,93,91,6,2,"PIRATA.CAT",0
8,"8081",332,232,225,2,7,"PIRATA.CAT",2
17,"17094",1161,694,683,11,11,"PIRATA.CAT",5
43,"43129",4525,3032,2956,62,76,"PIRATA.CAT",15
25,"25113",1227,869,856,28,13,"PIRATA.CAT",4
25,"25215",399,229,226,4,3,"PIRATA.CAT",0
8,"8064",1847,1277,1246,14,31,"PIRATA.CAT",9
17,"17070",116,78,78,3,0,"PIRATA.CAT",1
43,"43083",141,97,97,2,0,"PIRATA.CAT",0
8,"8131",696,483,469,7,14,"PIRATA.CAT",1
8,"8288",1735,985,957,13,28,"PIRATA.CAT",3
25,"25133",748,499,483,7,16,"PIRATA.CAT",0
8,"8152",129,94,93,0,1,"PxC",1
43,"43173",114,65,64,0,1,"PxC",0
43,"43154",136,97,96,6,1,"PxC",0
8,"8228",303,230,227,5,3,"PxC",4
8,"8288",1735,985,957,13,28,"PxC",30
25,"25126",286,192,189,7,3,"PxC",1
17,"17123",365,274,266,8,8,"PxC",0
43,"43014",14146,9153,8915,204,238,"PxC",199
17,"17184",1281,803,787,21,16,"PxC",3
17,"17044",6619,4293,4187,69,106,"PxC",30
8,"8028",1049,667,657,15,10,"PxC",22
8,"8059",323,189,186,9,3,"PxC",4
17,"17002",567,413,401,4,12,"PxC",4
43,"43005",3559,2191,2147,47,44,"PxC",9
8,"8008",193,119,114,5,5,"PxC",0
17,"17049",3056,1986,1944,43,42,"PxC",20
17,"17167",2818,1886,1858,52,28,"PxC",23
8,"8227",2372,1591,1549,38,42,"PxC",27
25,"25202",110,62,59,3,3,"PxC",0
17,"17073",1753,1320,1298,18,22,"PxC",3
8,"8019",1143222,778246,767530,12386,10716,"PxC",9442
8,"8192",5450,3688,3634,79,54,"PxC",65
43,"43151",119,91,89,0,2,"PxC",0
25,"25034",2471,1622,1592,25,30,"PxC",6
8,"8104",713,454,441,9,13,"PxC",4
8,"8230",7452,5349,5286,94,63,"PxC",66
17,"17164",4092,2409,2346,60,63,"PxC",24
17,"17051",201,146,142,4,4,"PxC",0
43,"43145",3968,2781,2742,52,39,"PxC",13
17,"17008",3745,2262,2195,34,67,"PxC",31
43,"43066",165,113,112,2,1,"PxC",0
17,"17234",183,131,128,2,3,"PxC",1
17,"17027",2865,1955,1892,34,63,"PxC",7
8,"8030",4849,3466,3422,50,44,"PxC",28
25,"25005",291,194,190,7,4,"PxC",0
8,"8169",47505,31997,31566,555,431,"PxC",580
43,"43124",532,366,358,3,8,"PxC",0
43,"43132",365,217,214,8,3,"PxC",1
17,"17183",261,178,176,2,2,"PxC",4
8,"8255",132,83,82,1,1,"PxC",0
8,"8220",2277,1641,1604,44,37,"PxC",26
25,"25104",128,88,86,11,2,"PxC",0
8,"8046",12603,8826,8663,190,163,"PxC",138
25,"25222",69,55,54,0,1,"PxC",0
8,"8239",471,338,333,6,5,"PxC",6
17,"17137",3331,2163,2110,39,53,"PxC",16
25,"25215",399,229,226,4,3,"PxC",2
8,"8308",145,116,115,1,1,"PxC",1
17,"17233",2192,1470,1434,33,36,"PxC",14
8,"8074",10224,6571,6479,116,92,"PxC",89
25,"25166",177,127,125,3,2,"PxC",1
8,"8097",985,676,657,3,19,"PxC",15
17,"17135",380,273,269,9,4,"PxC",2
17,"17161",978,693,687,21,6,"PxC",2
8,"8207",1718,1296,1256,28,40,"PxC",8
43,"43152",472,355,351,9,4,"PxC",0
8,"8213",6188,4031,3970,113,61,"PxC",102
25,"25064",122,91,88,7,3,"PxC",0
25,"25013",2274,1344,1321,25,23,"PxC",4
8,"8110",13366,8493,8329,144,164,"PxC",222
17,"17060",378,240,233,1,7,"PxC",0
43,"43122",92,65,61,0,4,"PxC",0
8,"8286",2865,1843,1796,30,47,"PxC",63
17,"17144",217,145,143,4,2,"PxC",0
8,"8268",1110,768,755,17,13,"PxC",20
8,"8181",7722,5280,5188,112,92,"PxC",103
17,"17067",732,483,470,16,13,"PxC",2
8,"8117",2424,1685,1661,45,24,"PxC",56
8,"8238",13892,10237,10094,206,143,"PxC",115
25,"25908",250,169,168,4,1,"PxC",0
8,"8078",224,154,151,2,3,"PxC",3
17,"17148",1546,980,957,24,23,"PxC",6
17,"17091",433,288,277,16,11,"PxC",1
17,"17202",3799,2398,2366,44,32,"PxC",6
17,"17142",2440,1713,1681,39,32,"PxC",22
25,"25040",10654,6905,6768,144,137,"PxC",43
8,"8172",19889,13537,13333,267,204,"PxC",231
43,"43067",626,445,431,21,14,"PxC",4
43,"43094",2209,1558,1524,31,34,"PxC",3
8,"8190",281,201,197,3,4,"PxC",0
8,"8306",509,330,324,6,6,"PxC",9
8,"8091",5106,3379,3312,59,67,"PxC",52
17,"17224",355,246,241,10,5,"PxC",0
25,"25223",951,562,546,14,16,"PxC",4
17,"17107",301,203,200,8,3,"PxC",0
17,"17198",404,264,259,9,5,"PxC",1
25,"25192",799,543,527,19,16,"PxC",3
17,"17098",311,208,202,4,6,"PxC",1
8,"8162",1955,1306,1271,28,35,"PxC",28
17,"17038",343,261,256,2,5,"PxC",2
17,"17154",93,54,49,1,5,"PxC",0
8,"8245",78826,51185,50445,962,740,"PxC",1576
17,"17230",456,326,320,10,6,"PxC",2
8,"8304",822,587,578,16,9,"PxC",14
43,"43116",494,328,325,5,3,"PxC",1
25,"25148",232,144,144,5,0,"PxC",0
8,"8114",17629,11781,11579,189,202,"PxC",274
43,"43135",327,243,238,2,5,"PxC",0
25,"25230",1665,1164,1140,36,24,"PxC",8
8,"8047",4141,2610,2580,49,30,"PxC",59
17,"17191",153,116,114,0,2,"PxC",0
8,"8010",4124,2674,2611,44,63,"PxC",79
17,"17076",126,77,76,5,1,"PxC",0
8,"8125",24559,16065,15798,293,267,"PxC",398
43,"43010",302,227,223,7,4,"PxC",1
8,"8069",3028,2071,2029,36,42,"PxC",35
8,"8298",25338,16982,16690,353,292,"PxC",438
17,"17074",490,345,342,5,3,"PxC",6
8,"8054",8733,6215,6077,123,138,"PxC",146
8,"8105",9642,6571,6483,110,88,"PxC",193
8,"8041",10032,6880,6761,112,119,"PxC",222
8,"8109",200,155,153,1,2,"PxC",0
8,"8068",6554,4323,4255,87,68,"PxC",116
8,"8131",696,483,469,7,14,"PxC",3
25,"25078",1014,730,719,17,11,"PxC",3
25,"25158",1647,1154,1135,27,19,"PxC",6
17,"17196",209,139,138,6,1,"PxC",2
8,"8057",61,41,40,1,1,"PxC",1
25,"25227",674,375,372,2,3,"PxC",0
8,"8187",149633,104021,102629,1794,1392,"PxC",1927
25,"25001",146,76,76,1,0,"PxC",2
8,"8223",1855,1178,1155,19,23,"PxC",10
8,"8253",134,91,91,2,0,"PxC",0
8,"8236",1507,1027,1002,18,25,"PxC",21
8,"8146",1321,876,862,18,14,"PxC",28
8,"8150",245,181,178,11,3,"PxC",5
8,"8113",52352,33606,33123,590,483,"PxC",932
25,"25077",474,281,277,5,4,"PxC",0
8,"8302",9271,5981,5892,82,89,"PxC",261
8,"8265",1575,1065,1026,38,39,"PxC",22
8,"8044",4247,2763,2712,50,51,"PxC",48
25,"25085",153,103,100,2,3,"PxC",0
8,"8292",1083,775,764,21,11,"PxC",15
43,"43905",13621,8120,8011,131,109,"PxC",30
25,"25082",265,156,155,8,1,"PxC",1
8,"8271",74,45,44,3,1,"PxC",0
8,"8278",4668,3033,2949,67,84,"PxC",70
8,"8002",202,143,140,4,3,"PxC",0
43,"43164",298,233,231,4,2,"PxC",2
25,"25135",1077,739,722,18,17,"PxC",5
25,"25072",5921,3743,3637,81,106,"PxC",37
43,"43088",1810,1199,1177,29,22,"PxC",9
43,"43034",494,355,344,8,11,"PxC",4
17,"17128",309,232,224,5,8,"PxC",0
17,"17015",12254,7759,7553,143,206,"PxC",61
25,"25244",350,270,268,9,2,"PxC",1
25,"25121",623,406,400,6,6,"PxC",0
8,"8118",17077,11817,11598,203,219,"PxC",94
43,"43160",1278,840,812,9,28,"PxC",4
43,"43037",16656,9986,9812,163,174,"PxC",112
25,"25225",603,395,387,7,8,"PxC",0
17,"17158",404,266,264,3,2,"PxC",3
8,"8128",557,377,374,16,3,"PxC",1
8,"8160",313,227,222,8,5,"PxC",3
25,"25216",250,175,173,5,2,"PxC",0
8,"8267",6215,4100,4011,82,89,"PxC",90
8,"8101",169663,112624,111107,1841,1517,"PxC",4154
43,"43053",190,149,149,2,0,"PxC",2
17,"17195",324,220,214,6,6,"PxC",0
25,"25120",90759,58761,57778,1325,983,"PxC",353
43,"43177",338,242,236,6,6,"PxC",5
43,"43117",150,118,115,1,3,"PxC",1
25,"25209",1558,1041,1009,22,32,"PxC",1
25,"25212",233,185,185,8,0,"PxC",3
17,"17054",395,250,247,3,3,"PxC",0
17,"17175",569,375,369,6,6,"PxC",3
17,"17140",684,476,470,10,6,"PxC",2
8,"8263",20729,13742,13563,232,179,"PxC",422
25,"25185",690,409,404,8,5,"PxC",0
43,"43172",378,268,266,8,2,"PxC",0
8,"8006",10984,7255,7092,104,163,"PxC",117
25,"25086",569,379,370,4,9,"PxC",1
43,"43020",2119,1463,1427,26,36,"PxC",14
8,"8087",158,133,132,6,1,"PxC",0
17,"17902",1330,898,874,11,24,"PxC",3
43,"43148",89309,59260,58346,1202,914,"PxC",339
43,"43060",3049,2030,1980,62,50,"PxC",4
43,"43093",3924,2507,2445,62,62,"PxC",16
8,"8281",4735,3239,3193,57,46,"PxC",28
8,"8241",80,61,61,1,0,"PxC",0
17,"17048",6176,3818,3773,52,45,"PxC",21
8,"8121",85069,58372,57620,923,752,"PxC",2509
17,"17088",551,374,363,4,11,"PxC",4
25,"25172",1838,1267,1230,35,37,"PxC",8
25,"25234",4572,2707,2648,57,59,"PxC",10
17,"17120",779,501,485,9,16,"PxC",3
8,"8285",10168,6582,6423,152,159,"PxC",235
8,"8071",248,172,167,2,5,"PxC",0
43,"43129",4525,3032,2956,62,76,"PxC",10
43,"43032",587,418,413,9,5,"PxC",3
25,"25170",271,197,196,4,1,"PxC",2
8,"8222",1827,1343,1317,21,26,"PxC",30
8,"8191",5520,3601,3536,64,65,"PxC",68
25,"25130",208,117,112,4,5,"PxC",1
17,"17188",167,124,122,9,2,"PxC",0
17,"17020",3446,2322,2268,45,54,"PxC",16
8,"8120",6342,4801,4746,63,55,"PxC",20
43,"43071",975,677,664,14,13,"PxC",2
17,"17043",159,101,100,2,1,"PxC",0
8,"8166",1138,726,706,10,20,"PxC",19
43,"43141",131,71,70,3,1,"PxC",1
8,"8156",10672,7359,7225,121,134,"PxC",91
17,"17087",230,170,161,6,9,"PxC",1
43,"43114",383,238,234,6,4,"PxC",1
17,"17118",12541,7817,7681,130,136,"PxC",44
43,"43128",927,636,625,11,11,"PxC",5
43,"43046",114,80,79,5,1,"PxC",0
17,"17018",478,337,332,8,5,"PxC",2
8,"8273",2287,1594,1547,18,47,"PxC",11
17,"17217",347,267,251,5,16,"PxC",0
8,"8261",2273,1547,1525,30,22,"PxC",21
43,"43018",430,350,337,7,13,"PxC",0
43,"43142",1155,730,714,20,16,"PxC",8
25,"25154",126,77,77,2,0,"PxC",0
8,"8063",434,336,333,8,3,"PxC",6
17,"17205",198,146,138,3,8,"PxC",0
17,"17022",6771,4247,4169,76,78,"PxC",38
17,"17173",174,121,119,1,2,"PxC",1
8,"8124",36292,24541,24210,471,331,"PxC",631
17,"17031",172,94,93,1,1,"PxC",1
8,"8165",1689,1091,1070,18,21,"PxC",21
17,"17211",864,628,612,12,16,"PxC",4
25,"25042",211,131,127,0,4,"PxC",1
43,"43089",272,193,185,1,8,"PxC",0
25,"25211",701,378,368,5,10,"PxC",3
8,"8901",249,180,180,2,0,"PxC",1
8,"8023",6546,4261,4194,86,67,"PxC",99
17,"17124",1670,1087,1056,18,31,"PxC",8
25,"25197",158,102,101,2,1,"PxC",0
8,"8155",6573,4411,4334,85,77,"PxC",169
25,"25102",733,478,464,15,14,"PxC",1
43,"43031",1509,1016,992,20,24,"PxC",5
8,"8262",6835,4086,3993,94,93,"PxC",117
8,"8201",458,305,298,12,7,"PxC",1
17,"17081",236,165,162,2,3,"PxC",2
8,"8017",2740,1800,1768,38,32,"PxC",58
17,"17099",74,52,50,1,2,"PxC",2
8,"8005",5884,4114,4041,68,73,"PxC",30
25,"25239",627,310,310,7,0,"PxC",2
17,"17166",503,361,342,10,19,"PxC",1
8,"8066",1315,985,965,16,20,"PxC",18
17,"17192",145,107,105,4,2,"PxC",0
25,"25143",86,58,58,1,0,"PxC",0
17,"17014",64,39,37,0,2,"PxC",0
17,"17075",304,216,210,5,6,"PxC",0
25,"25119",2297,1554,1513,46,41,"PxC",3
8,"8011",1754,1116,1085,29,31,"PxC",23
17,"17065",316,211,205,6,6,"PxC",0
8,"8217",24130,17554,17319,383,235,"PxC",292
8,"8154",677,499,488,2,11,"PxC",9
8,"8179",591,415,405,6,10,"PxC",18
25,"25190",271,180,176,12,4,"PxC",0
43,"43099",330,240,236,4,4,"PxC",0
8,"8210",4176,2661,2579,54,82,"PxC",57
8,"8025",1460,990,963,14,27,"PxC",32
43,"43091",142,106,98,5,8,"PxC",0
8,"8301",47343,32098,31664,672,434,"PxC",946
17,"17085",295,212,208,12,4,"PxC",1
43,"43134",279,208,206,14,2,"PxC",0
17,"17187",574,414,402,1,12,"PxC",3
8,"8036",172,124,124,4,0,"PxC",2
25,"25113",1227,869,856,28,13,"PxC",6
25,"25210",1164,799,789,13,10,"PxC",1
17,"17176",141,96,95,3,1,"PxC",2
43,"43063",588,358,350,13,8,"PxC",1
43,"43061",55,31,31,1,0,"PxC",0
25,"25191",353,234,227,5,7,"PxC",1
17,"17066",25667,15429,15157,244,272,"PxC",144
8,"8180",26210,17504,17214,366,290,"PxC",463
43,"43045",156,110,109,1,1,"PxC",0
17,"17006",1203,759,754,17,5,"PxC",2
8,"8202",12206,8265,8129,183,136,"PxC",168
17,"17129",126,91,90,3,1,"PxC",1
43,"43111",2096,1305,1281,19,24,"PxC",15
43,"43077",486,335,328,4,7,"PxC",0
25,"25114",102,82,78,4,4,"PxC",0
43,"43038",20710,12999,12771,224,228,"PxC",51
17,"17064",341,253,250,4,3,"PxC",1
25,"25015",394,264,264,14,0,"PxC",1
8,"8112",12946,8533,8390,227,143,"PxC",312
43,"43090",1142,644,636,7,8,"PxC",7
43,"43108",1808,1183,1157,28,26,"PxC",8
17,"17155",14284,8528,8391,143,137,"PxC",307
25,"25100",207,125,115,2,10,"PxC",0
25,"25255",468,318,309,9,9,"PxC",0
25,"25171",2305,1496,1469,37,27,"PxC",6
17,"17103",4988,2788,2724,51,64,"PxC",24
43,"43030",454,321,307,5,14,"PxC",5
8,"8099",808,533,519,11,14,"PxC",10
8,"8293",246,145,145,4,0,"PxC",3
43,"43001",706,481,473,12,8,"PxC",3
25,"25140",785,472,460,5,12,"PxC",0
17,"17069",395,276,267,2,9,"PxC",1
43,"43068",573,388,378,5,10,"PxC",1
17,"17041",237,153,153,1,0,"PxC",2
17,"17126",309,231,229,9,2,"PxC",1
17,"17101",567,349,339,4,10,"PxC",3
8,"8083",1626,1199,1178,23,21,"PxC",11
8,"8022",12437,7598,7445,169,153,"PxC",152
8,"8197",7316,4983,4926,69,57,"PxC",45
17,"17062",5994,3686,3614,69,72,"PxC",19
43,"43107",378,255,248,18,7,"PxC",1
25,"25092",135,100,97,2,3,"PxC",0
25,"25163",237,147,142,2,5,"PxC",0
8,"8168",418,268,266,0,2,"PxC",6
17,"17009",4089,2573,2490,59,83,"PxC",32
25,"25910",118,77,76,3,1,"PxC",0
8,"8081",332,232,225,2,7,"PxC",2
8,"8050",149,112,108,4,4,"PxC",3
43,"43080",254,175,173,7,2,"PxC",1
17,"17151",174,131,131,6,0,"PxC",1
43,"43130",196,132,131,7,1,"PxC",0
8,"8225",92,68,68,2,0,"PxC",0
17,"17007",1778,1137,1113,16,24,"PxC",5
25,"25099",1185,720,709,9,11,"PxC",2
43,"43004",6411,4089,4001,92,88,"PxC",16
25,"25022",119,83,83,0,0,"PxC",0
8,"8092",3928,2511,2473,33,38,"PxC",65
17,"17077",580,374,372,5,2,"PxC",2
17,"17052",134,84,83,2,1,"PxC",0
8,"8045",70,42,42,2,0,"PxC",2
17,"17163",2478,1729,1681,41,48,"PxC",7
25,"25050",3249,2056,1988,40,68,"PxC",16
17,"17134",235,149,148,3,1,"PxC",0
43,"43065",443,278,270,8,8,"PxC",0
8,"8206",717,557,547,7,10,"PxC",6
17,"17189",1536,1061,1025,7,36,"PxC",9
8,"8196",18989,12658,12490,253,168,"PxC",469
25,"25071",56,37,35,2,2,"PxC",0
43,"43009",1421,913,897,18,16,"PxC",3
43,"43062",298,227,223,7,4,"PxC",0
8,"8103",636,453,446,16,7,"PxC",9
25,"25004",553,405,400,13,5,"PxC",0
25,"25907",506,297,292,6,5,"PxC",1
25,"25037",396,275,273,9,2,"PxC",1
43,"43050",2407,1528,1504,20,24,"PxC",7
8,"8158",2996,2012,1986,19,26,"PxC",18
43,"43003",307,187,184,10,3,"PxC",0
43,"43175",590,419,411,8,8,"PxC",1
8,"8026",180,144,143,0,1,"PxC",0
8,"8012",1694,1155,1136,32,19,"PxC",17
43,"43036",836,503,494,4,9,"PxC",8
43,"43057",45,27,27,2,0,"PxC",0
17,"17208",1012,642,622,12,20,"PxC",4
8,"8183",4497,2914,2865,43,49,"PxC",103
17,"17086",1687,1148,1129,14,19,"PxC",5
17,"17092",3520,2273,2228,42,45,"PxC",9
43,"43167",390,284,280,12,4,"PxC",4
43,"43140",2393,1612,1583,23,29,"PxC",36
17,"17193",3978,2365,2305,38,60,"PxC",22
17,"17013",2774,1884,1859,21,25,"PxC",7
8,"8258",845,577,555,23,22,"PxC",11
43,"43083",141,97,97,2,0,"PxC",1
17,"17089",5486,3328,3288,43,40,"PxC",38
17,"17117",14022,8705,8595,129,110,"PxC",76
8,"8232",1793,1239,1220,20,19,"PxC",11
17,"17026",542,404,398,3,6,"PxC",3
8,"8252",24033,16704,16402,368,302,"PxC",447
17,"17080",165,115,114,1,1,"PxC",2
8,"8007",6338,4165,4050,89,115,"PxC",94
43,"43064",2063,1420,1391,37,29,"PxC",20
8,"8075",3906,2442,2414,31,28,"PxC",56
8,"8004",228,176,172,2,4,"PxC",0
25,"25176",341,243,240,7,3,"PxC",0
43,"43125",1008,706,701,10,5,"PxC",3
17,"17115",281,209,207,5,2,"PxC",1
8,"8035",12099,7838,7735,123,103,"PxC",171
17,"17024",301,207,204,4,3,"PxC",0
8,"8126",8299,5599,5508,103,91,"PxC",76
17,"17094",1161,694,683,11,11,"PxC",2
8,"8042",2172,1459,1448,30,11,"PxC",34
17,"17004",504,340,337,6,3,"PxC",4
25,"25063",97,65,64,2,1,"PxC",0
8,"8216",21,14,14,0,0,"PxC",0
8,"8250",7083,4485,4426,72,59,"PxC",180
8,"8137",255,190,190,3,0,"PxC",3
17,"17222",108,86,86,1,0,"PxC",1
17,"17082",443,285,280,1,5,"PxC",1
25,"25061",75,45,45,0,0,"PxC",0
17,"17112",215,141,138,4,3,"PxC",3
43,"43109",2040,1332,1316,28,16,"PxC",17
43,"43902",2761,1836,1811,25,25,"PxC",5
8,"8224",771,538,528,26,10,"PxC",7
25,"25132",128,87,85,3,2,"PxC",1
25,"25016",2203,1375,1357,20,18,"PxC",9
17,"17228",280,172,170,4,2,"PxC",0
8,"8211",32035,23059,22687,453,372,"PxC",436
43,"43097",379,283,278,6,5,"PxC",2
17,"17056",1704,1171,1158,21,13,"PxC",6
8,"8016",1984,1319,1289,26,30,"PxC",17
43,"43028",2654,1620,1588,27,32,"PxC",27
8,"8027",673,527,515,9,12,"PxC",7
25,"25087",65,41,39,0,2,"PxC",0
43,"43069",194,131,127,3,4,"PxC",0
43,"43127",778,530,524,6,6,"PxC",2
17,"17095",19245,11212,11067,160,145,"PxC",69
17,"17039",1850,1299,1275,31,24,"PxC",15
17,"17201",131,89,89,2,0,"PxC",1
25,"25206",289,187,184,3,3,"PxC",0
43,"43138",2719,1775,1730,45,45,"PxC",18
43,"43035",280,202,198,0,4,"PxC",5
43,"43054",2850,1815,1771,37,44,"PxC",5
25,"25030",147,101,95,3,6,"PxC",0
17,"17078",346,231,226,3,5,"PxC",3
8,"8294",1870,1205,1171,22,34,"PxC",15
25,"25076",165,84,83,3,1,"PxC",1
8,"8243",160,112,110,3,2,"PxC",3
17,"17227",107,82,82,1,0,"PxC",0
25,"25019",4626,2971,2932,54,39,"PxC",7
25,"25909",141,82,78,0,4,"PxC",0
43,"43144",1187,787,772,12,15,"PxC",5
17,"17097",185,136,136,4,0,"PxC",1
43,"43086",5269,3275,3196,92,79,"PxC",16
43,"43112",294,184,181,2,3,"PxC",1
8,"8049",1340,839,816,10,23,"PxC",26
25,"25165",301,202,198,6,4,"PxC",0
25,"25027",1042,691,665,11,26,"PxC",3
43,"43012",3392,2346,2295,48,51,"PxC",7
8,"8200",61189,40677,40069,736,608,"PxC",1752
25,"25074",178,137,132,3,5,"PxC",0
8,"8257",116,84,81,0,3,"PxC",1
8,"8043",3067,2044,2023,29,21,"PxC",35
17,"17150",1428,1018,996,24,22,"PxC",10
43,"43041",237,177,176,4,1,"PxC",0
17,"17218",568,361,350,11,11,"PxC",1
43,"43113",454,321,316,10,5,"PxC",0
8,"8090",120,86,86,2,0,"PxC",1
25,"25129",175,105,105,3,0,"PxC",0
17,"17170",192,135,134,1,1,"PxC",0
8,"8244",5746,4044,3940,102,104,"PxC",62
8,"8080",42,33,33,2,0,"PxC",1
25,"25182",1075,749,731,30,18,"PxC",2
43,"43121",636,385,371,6,14,"PxC",2
25,"25194",440,292,283,11,9,"PxC",1
17,"17029",198,136,133,1,3,"PxC",0
8,"8195",88,64,64,2,0,"PxC",0
8,"8251",4771,3214,3140,57,74,"PxC",88
8,"8067",5657,3772,3671,75,101,"PxC",87
8,"8065",1224,796,778,13,18,"PxC",9
25,"25093",657,465,455,8,10,"PxC",7
25,"25153",215,165,161,0,4,"PxC",4
8,"8174",409,294,292,10,2,"PxC",3
17,"17071",1064,719,698,33,21,"PxC",5
17,"17162",137,80,78,2,2,"PxC",0
8,"8123",18751,13394,13154,238,240,"PxC",185
8,"8001",8538,5929,5838,120,91,"PxC",274
8,"8082",1143,733,723,17,10,"PxC",26
8,"8153",502,357,350,7,7,"PxC",5
8,"8307",47176,31341,30846,536,495,"PxC",397
8,"8073",60247,41448,40843,770,605,"PxC",1028
8,"8072",9910,6326,6235,140,91,"PxC",105
25,"25250",358,237,234,4,3,"PxC",0
8,"8062",863,595,583,8,12,"PxC",9
8,"8134",776,528,513,15,15,"PxC",6
17,"17005",404,258,254,12,4,"PxC",2
17,"17153",172,127,123,1,4,"PxC",1
8,"8185",189,131,126,1,5,"PxC",6
8,"8033",12476,8513,8378,180,135,"PxC",136
25,"25174",438,289,283,4,6,"PxC",0
17,"17034",6723,4131,4064,77,67,"PxC",25
8,"8175",3477,2303,2270,39,33,"PxC",76
43,"43017",141,98,98,2,0,"PxC",1
17,"17119",89,65,64,3,1,"PxC",0
17,"17141",5689,3485,3428,50,57,"PxC",11
8,"8274",4887,3326,3279,36,47,"PxC",123
17,"17138",1010,677,662,3,15,"PxC",3
8,"8040",10538,6916,6804,99,112,"PxC",139
17,"17177",563,398,388,7,10,"PxC",4
43,"43026",800,531,522,15,9,"PxC",0
43,"43074",1697,1150,1120,25,30,"PxC",10
25,"25127",226,134,130,2,4,"PxC",0
25,"25145",88,67,67,2,0,"PxC",3
25,"25240",1398,976,958,17,18,"PxC",6
17,"17063",169,113,111,5,2,"PxC",0
8,"8208",5471,3859,3792,82,67,"PxC",62
43,"43095",2434,1658,1624,27,34,"PxC",13
25,"25183",485,336,327,6,9,"PxC",4
8,"8132",381,247,241,6,6,"PxC",10
25,"25152",160,92,90,4,2,"PxC",0
25,"25905",386,264,258,12,6,"PxC",4
17,"17145",1593,1090,1068,10,22,"PxC",9
17,"17125",132,90,89,1,1,"PxC",1
25,"25096",988,633,613,12,20,"PxC",2
25,"25128",151,83,81,1,2,"PxC",0
17,"17901",964,628,621,16,7,"PxC",7
8,"8249",273,218,214,4,4,"PxC",2
8,"8240",9104,6355,6262,101,93,"PxC",92
8,"8086",13267,8791,8669,200,122,"PxC",204
8,"8015",155673,101652,100264,1628,1388,"PxC",1487
25,"25137",8404,5264,5167,112,97,"PxC",68
8,"8290",1446,1075,1056,12,19,"PxC",18
25,"25053",1085,733,727,10,6,"PxC",3
25,"25055",187,115,115,3,0,"PxC",0
17,"17055",158,121,121,4,0,"PxC",1
43,"43118",439,318,313,7,5,"PxC",0
43,"43076",467,308,300,7,8,"PxC",0
25,"25177",379,240,236,2,4,"PxC",0
25,"25253",175,132,129,1,3,"PxC",0
17,"17212",129,100,98,4,2,"PxC",0
8,"8070",275,192,191,5,1,"PxC",2
8,"8287",1053,738,730,26,8,"PxC",14
43,"43115",171,112,110,3,2,"PxC",0
8,"8203",2442,1526,1498,34,28,"PxC",21
25,"25193",771,509,501,8,8,"PxC",0
25,"25002",481,306,302,6,4,"PxC",0
8,"8151",504,345,338,6,7,"PxC",2
8,"8194",24757,15009,14799,245,210,"PxC",556
8,"8138",4014,2735,2679,46,56,"PxC",47
17,"17035",548,385,379,7,6,"PxC",3
25,"25179",198,141,136,1,5,"PxC",2
43,"43013",4369,2795,2747,54,48,"PxC",16
8,"8231",19810,12359,12196,244,163,"PxC",192
8,"8282",6092,4478,4405,79,73,"PxC",23
25,"25169",201,134,134,6,0,"PxC",0
43,"43168",106,70,69,2,1,"PxC",0
43,"43143",62,51,50,1,1,"PxC",0
25,"25038",1606,1104,1093,19,11,"PxC",1
43,"43174",152,104,101,1,3,"PxC",0
17,"17181",3228,2116,2081,19,35,"PxC",21
43,"43901",8849,5651,5540,179,111,"PxC",17
25,"25150",185,119,113,4,6,"PxC",2
8,"8088",11250,8019,7861,144,158,"PxC",111
43,"43120",454,287,283,1,4,"PxC",0
25,"25180",245,167,165,3,2,"PxC",0
8,"8242",243,174,172,5,2,"PxC",2
17,"17149",366,254,251,4,3,"PxC",2
25,"25068",576,376,364,6,12,"PxC",7
8,"8089",33316,22369,22107,437,262,"PxC",461
43,"43176",832,575,572,16,3,"PxC",1
43,"43006",712,484,475,10,9,"PxC",2
8,"8905",2268,1692,1657,28,35,"PxC",18
8,"8283",5862,3712,3618,72,94,"PxC",94
17,"17207",2357,1636,1584,40,52,"PxC",12
8,"8171",2158,1385,1359,27,26,"PxC",19
8,"8234",3143,2040,2008,45,32,"PxC",34
8,"8233",1867,1179,1169,29,10,"PxC",35
43,"43136",10163,6312,6197,121,115,"PxC",25
43,"43015",104,69,68,2,1,"PxC",0
8,"8291",4516,2895,2855,56,40,"PxC",78
8,"8247",903,627,608,10,19,"PxC",13
8,"8141",4666,3124,3066,57,58,"PxC",117
17,"17160",14852,9257,9128,145,129,"PxC",80
25,"25123",206,140,136,4,4,"PxC",0
8,"8029",3389,2542,2514,45,28,"PxC",17
25,"25020",328,216,209,4,7,"PxC",0
8,"8060",167,102,101,0,1,"PxC",1
17,"17147",8385,5401,5325,105,76,"PxC",59
25,"25069",471,291,289,9,2,"PxC",8
25,"25901",315,196,189,3,7,"PxC",0
43,"43007",635,448,441,7,7,"PxC",0
8,"8111",220,188,188,4,0,"PxC",3
8,"8204",2991,2076,2040,45,36,"PxC",32
17,"17209",605,469,463,21,6,"PxC",4
25,"25141",171,111,107,2,4,"PxC",0
8,"8052",148,103,98,1,5,"PxC",1
8,"8051",17397,12178,12002,240,176,"PxC",198
8,"8235",3627,2506,2467,35,39,"PxC",23
8,"8229",561,404,398,12,6,"PxC",7
25,"25035",428,289,284,5,5,"PxC",5
8,"8031",2289,1619,1599,34,20,"PxC",90
17,"17110",1359,930,917,12,13,"PxC",3
43,"43171",13906,8978,8855,167,123,"PxC",45
8,"8276",249,188,187,9,1,"PxC",2
43,"43056",931,537,515,18,22,"PxC",3
17,"17070",116,78,78,3,0,"PxC",1
43,"43049",805,555,536,6,19,"PxC",0
43,"43106",878,600,592,17,8,"PxC",0
25,"25033",1125,738,718,17,20,"PxC",3
25,"25134",657,421,416,4,5,"PxC",2
8,"8164",873,606,584,13,22,"PxC",9
43,"43131",4495,2842,2814,51,28,"PxC",22
17,"17030",624,414,409,8,5,"PxC",0
25,"25081",332,212,206,6,6,"PxC",0
8,"8032",1955,1330,1294,18,36,"PxC",21
25,"25051",1710,1060,1044,23,16,"PxC",2
25,"25904",149,107,104,1,3,"PxC",0
25,"25218",94,75,73,1,2,"PxC",0
43,"43039",117,85,83,3,2,"PxC",0
8,"8270",17464,11828,11677,212,151,"PxC",68
43,"43155",22951,14114,13856,326,258,"PxC",330
8,"8144",769,494,481,16,13,"PxC",15
43,"43153",10307,6572,6450,94,122,"PxC",43
25,"25101",583,391,382,8,9,"PxC",1
17,"17058",177,115,114,2,1,"PxC",0
8,"8182",2802,1871,1852,35,19,"PxC",60
25,"25247",142,80,78,3,2,"PxC",0
17,"17215",1918,1350,1321,40,29,"PxC",14
25,"25052",1611,1094,1062,21,32,"PxC",4
17,"17136",173,124,120,0,4,"PxC",3
17,"17003",101,67,64,2,3,"PxC",0
8,"8064",1847,1277,1246,14,31,"PxC",24
8,"8198",4112,2766,2661,49,105,"PxC",62
25,"25044",195,136,134,1,2,"PxC",0
25,"25254",782,533,531,9,2,"PxC",2
25,"25067",768,498,494,14,4,"PxC",0
8,"8098",2374,1552,1535,28,17,"PxC",56
8,"8142",127,83,83,4,0,"PxC",0
25,"25911",472,306,296,2,10,"PxC",3
8,"8199",712,507,499,15,8,"PxC",13
8,"8902",3600,2518,2496,57,22,"PxC",35
17,"17032",1613,933,918,11,15,"PxC",2
8,"8085",1033,731,720,10,11,"PxC",9
43,"43011",1013,745,729,21,16,"PxC",2
43,"43157",388,282,270,10,12,"PxC",2
25,"25097",102,70,69,3,1,"PxC",0
17,"17204",539,349,347,10,2,"PxC",7
43,"43043",3065,1952,1919,39,33,"PxC",7
43,"43075",102,63,63,1,0,"PxC",0
8,"8127",2274,1371,1338,23,33,"PxC",41
43,"43150",1337,994,977,12,17,"PxC",2
17,"17157",127,99,98,3,1,"PxC",0
8,"8157",8256,5729,5624,119,105,"PxC",133
43,"43110",307,216,214,5,2,"PxC",0
25,"25098",266,177,177,0,0,"PxC",0
8,"8260",17869,11898,11686,215,212,"PxC",477
17,"17186",3593,2358,2317,33,41,"PxC",23
8,"8053",2850,1788,1772,21,16,"PxC",56
25,"25112",286,202,199,11,3,"PxC",2
25,"25201",119,78,76,3,2,"PxC",0
17,"17084",269,177,175,4,2,"PxC",0
17,"17221",4135,2789,2723,49,66,"PxC",38
43,"43079",387,259,255,26,4,"PxC",2
43,"43161",17199,10765,10547,197,218,"PxC",59
8,"8009",8932,6188,6088,103,100,"PxC",144
43,"43055",2002,1404,1374,36,30,"PxC",2
17,"17190",811,548,532,7,16,"PxC",1
17,"17025",1127,775,760,11,15,"PxC",7
8,"8037",1830,1247,1209,40,38,"PxC",37
17,"17116",369,230,227,3,3,"PxC",1
8,"8108",4879,3475,3437,64,38,"PxC",58
25,"25017",248,160,159,1,1,"PxC",2
8,"8048",622,461,454,9,7,"PxC",4
17,"17105",257,152,146,4,6,"PxC",0
17,"17206",167,108,107,2,1,"PxC",0
25,"25124",161,110,109,4,1,"PxC",1
8,"8021",76,49,47,1,2,"PxC",0
25,"25008",1187,834,818,15,16,"PxC",3
25,"25006",362,231,228,2,3,"PxC",3
25,"25173",1784,1177,1139,20,38,"PxC",2
43,"43070",265,198,196,3,2,"PxC",0
8,"8272",148,97,96,6,1,"PxC",1
8,"8170",458,300,288,13,12,"PxC",9
25,"25122",1956,1281,1256,33,25,"PxC",14
25,"25009",690,479,471,9,8,"PxC",1
25,"25203",8995,5418,5309,116,109,"PxC",6
17,"17096",182,96,94,2,2,"PxC",2
25,"25161",361,222,218,1,4,"PxC",0
25,"25047",1048,760,748,24,12,"PxC",6
25,"25039",299,189,186,7,3,"PxC",0
43,"43103",897,586,575,21,11,"PxC",6
17,"17061",175,123,123,4,0,"PxC",0
25,"25094",154,110,107,1,3,"PxC",0
17,"17037",105,66,66,2,0,"PxC",0
43,"43907",4122,2759,2712,52,47,"PxC",20
25,"25204",1313,888,881,21,7,"PxC",4
8,"8079",335,255,243,14,12,"PxC",3
43,"43044",3990,2768,2715,72,53,"PxC",24
25,"25903",261,176,170,9,6,"PxC",1
25,"25089",107,66,64,0,2,"PxC",0
8,"8264",3983,2773,2744,30,29,"PxC",20
43,"43158",109,63,61,5,2,"PxC",1
8,"8143",2679,1772,1756,35,16,"PxC",34
43,"43023",244,179,177,8,2,"PxC",3
25,"25010",206,119,118,7,1,"PxC",1
17,"17199",6630,4242,4162,80,80,"PxC",77
17,"17180",8076,4868,4767,81,101,"PxC",45
8,"8295",10579,6896,6769,137,127,"PxC",107
43,"43178",1262,891,870,24,21,"PxC",5
25,"25138",605,440,428,13,12,"PxC",1
25,"25118",378,232,226,4,6,"PxC",0
25,"25011",5241,3127,3080,48,47,"PxC",20
8,"8275",242,188,186,4,2,"PxC",3
25,"25902",581,411,395,15,16,"PxC",12
8,"8034",741,542,529,4,13,"PxC",10
17,"17042",415,297,292,2,5,"PxC",2
43,"43078",841,557,547,7,10,"PxC",0
43,"43016",3437,2323,2266,40,57,"PxC",32
43,"43162",4143,2892,2833,59,59,"PxC",1
25,"25200",353,225,217,4,8,"PxC",3
17,"17111",789,584,574,15,10,"PxC",1
8,"8266",42860,30047,29521,536,526,"PxC",421
25,"25142",387,265,264,5,1,"PxC",1
25,"25059",796,580,575,9,5,"PxC",2
25,"25217",10570,6660,6500,191,160,"PxC",59
17,"17210",527,358,349,9,9,"PxC",1
17,"17143",134,89,87,2,2,"PxC",0
43,"43008",333,206,197,3,9,"PxC",1
43,"43098",362,251,247,1,4,"PxC",1
43,"43033",772,547,533,4,14,"PxC",5
25,"25168",510,385,378,19,7,"PxC",3
17,"17185",2273,1416,1379,32,37,"PxC",9
43,"43147",528,393,380,7,13,"PxC",0
25,"25023",4446,3079,3020,70,59,"PxC",19
17,"17011",625,472,467,5,5,"PxC",0
43,"43139",2166,1319,1270,37,49,"PxC",8
43,"43022",1559,1097,1074,22,23,"PxC",4
8,"8189",141,113,111,4,2,"PxC",0
25,"25207",6253,3938,3872,91,66,"PxC",26
25,"25912",899,643,640,6,3,"PxC",2
8,"8130",95,63,62,3,1,"PxC",2
17,"17130",333,236,233,5,3,"PxC",0
8,"8039",365,264,260,5,4,"PxC",2
25,"25146",227,150,149,0,1,"PxC",0
8,"8161",10991,6841,6709,114,132,"PxC",237
17,"17079",62633,40844,40101,670,743,"PxC",303
8,"8148",2240,1246,1223,22,23,"PxC",26
25,"25224",144,93,91,6,2,"PxC",0
43,"43159",89,51,51,2,0,"PxC",0
43,"43042",2071,1504,1485,28,19,"PxC",3
8,"8177",52,31,31,1,0,"PxC",5
8,"8084",1134,789,760,14,29,"PxC",13
8,"8221",11348,8413,8306,109,107,"PxC",30
25,"25231",515,402,395,4,7,"PxC",3
8,"8205",54870,41064,40491,682,573,"PxC",199
25,"25045",51,33,33,2,0,"PxC",0
8,"8300",5621,4021,3933,94,88,"PxC",87
25,"25125",450,297,289,10,8,"PxC",0
17,"17102",571,354,350,7,4,"PxC",0
17,"17033",5157,3142,3095,44,47,"PxC",26
8,"8055",476,312,304,11,8,"PxC",6
8,"8135",6647,4753,4678,79,75,"PxC",111
43,"43019",1356,868,837,13,31,"PxC",0
43,"43051",8749,5494,5411,78,83,"PxC",56
8,"8219",14647,10347,10169,193,178,"PxC",100
25,"25109",279,183,183,2,0,"PxC",0
25,"25036",190,138,134,5,4,"PxC",0
43,"43027",177,129,128,6,1,"PxC",0
17,"17165",608,414,400,9,14,"PxC",0
8,"8277",134,90,90,4,0,"PxC",2
17,"17152",10378,6239,6156,100,83,"PxC",59
43,"43101",146,94,93,3,1,"PxC",0
25,"25243",3408,2280,2252,49,28,"PxC",5
8,"8056",39345,26705,26396,449,309,"PxC",440
17,"17225",208,138,134,1,4,"PxC",1
8,"8237",1692,1155,1127,22,28,"PxC",21
8,"8100",1934,1437,1401,40,36,"PxC",15
17,"17214",695,470,461,10,9,"PxC",1
17,"17068",252,156,156,4,0,"PxC",0
8,"8280",116,74,72,3,2,"PxC",1
25,"25043",830,483,467,17,16,"PxC",0
8,"8129",444,278,271,2,7,"PxC",1
25,"25110",2662,1649,1602,44,47,"PxC",12
17,"17019",1783,1264,1234,42,30,"PxC",11
43,"43105",175,119,116,14,3,"PxC",0
17,"17109",759,428,414,10,14,"PxC",1
25,"25221",125,76,76,0,0,"PxC",0
25,"25031",57,34,34,1,0,"PxC",0
17,"17169",2460,1690,1651,34,39,"PxC",16
17,"17903",893,565,556,14,9,"PxC",3
8,"8077",33925,23896,23548,381,348,"PxC",429
43,"43085",229,178,171,0,7,"PxC",1
8,"8122",1755,1063,1034,17,29,"PxC",58
25,"25111",116,70,70,0,0,"PxC",0
43,"43029",330,202,194,6,8,"PxC",0
8,"8246",1714,1175,1153,27,22,"PxC",24
25,"25205",563,373,362,12,11,"PxC",6
8,"8289",4123,2802,2768,54,34,"PxC",34
25,"25003",3853,2367,2340,68,27,"PxC",9
25,"25070",888,594,582,18,12,"PxC",1
17,"17200",616,406,393,12,13,"PxC",0
25,"25056",289,168,163,3,5,"PxC",1
8,"8038",1406,911,895,24,16,"PxC",24
17,"17216",158,100,97,1,3,"PxC",0
8,"8119",6039,3991,3884,74,107,"PxC",114
8,"8303",279,202,201,11,1,"PxC",5
8,"8248",5239,3513,3443,71,70,"PxC",61
25,"25164",404,270,264,5,6,"PxC",1
8,"8159",13482,9173,9040,239,133,"PxC",226
25,"25249",207,151,150,4,1,"PxC",0
8,"8167",5703,3896,3831,82,65,"PxC",212
8,"8297",138,99,99,2,0,"PxC",0
25,"25060",92,53,52,1,1,"PxC",0
43,"43096",103,81,77,3,4,"PxC",1
43,"43137",1873,1241,1212,27,29,"PxC",18
8,"8096",40650,28247,27784,527,463,"PxC",528
25,"25115",878,542,542,17,0,"PxC",0
25,"25233",270,207,201,3,6,"PxC",4
17,"17146",2952,1895,1864,49,31,"PxC",18
17,"17172",426,286,283,3,3,"PxC",2
25,"25046",438,299,286,6,13,"PxC",2
43,"43123",70216,45627,44828,906,799,"PxC",412
8,"8094",1500,1102,1071,21,31,"PxC",17
25,"25151",641,451,444,20,7,"PxC",3
25,"25058",4390,2696,2650,57,46,"PxC",10
43,"43169",477,377,364,8,13,"PxC",0
25,"25181",189,128,123,3,5,"PxC",0
43,"43126",1170,802,783,19,19,"PxC",2
8,"8184",52133,33696,33220,656,476,"PxC",647
8,"8013",1234,834,820,23,14,"PxC",20
25,"25186",231,168,168,3,0,"PxC",1
17,"17083",2886,1825,1801,39,24,"PxC",18
43,"43102",517,377,366,2,11,"PxC",1
17,"17178",1075,683,679,15,4,"PxC",5
43,"43058",106,76,76,5,0,"PxC",0
8,"8178",450,311,304,3,7,"PxC",6
25,"25228",2907,2043,2021,43,22,"PxC",7
25,"25049",166,105,102,1,3,"PxC",0
8,"8116",600,401,393,9,8,"PxC",5
8,"8188",106,87,86,4,1,"PxC",1
17,"17114",22610,14079,13811,263,268,"PxC",131
43,"43163",24903,15475,15241,263,234,"PxC",449
25,"25238",231,158,156,1,2,"PxC",2
17,"17182",257,177,175,2,2,"PxC",3
25,"25156",761,535,529,15,6,"PxC",0
17,"17168",393,285,281,8,4,"PxC",2
17,"17057",1010,640,634,19,6,"PxC",9
17,"17012",1093,689,679,11,10,"PxC",7
25,"25189",2085,1348,1327,38,21,"PxC",4
43,"43081",574,415,404,13,11,"PxC",7
43,"43904",2918,1779,1732,49,47,"PxC",7
8,"8106",6858,4675,4559,113,116,"PxC",88
17,"17021",108,86,79,0,7,"PxC",0
8,"8284",11920,7059,6942,139,117,"PxC",184
43,"43047",4064,2412,2352,50,60,"PxC",7
8,"8107",10955,7236,7130,151,106,"PxC",187
8,"8147",17023,11177,10961,184,216,"PxC",418
25,"25007",1363,902,885,36,17,"PxC",4
25,"25032",71,44,42,1,2,"PxC",0
25,"25014",264,170,164,11,6,"PxC",1
25,"25073",662,382,379,11,3,"PxC",0
8,"8904",10608,6654,6561,140,93,"PxC",215
25,"25167",253,176,172,0,4,"PxC",0
43,"43170",880,601,592,9,9,"PxC",3
17,"17028",327,220,217,4,3,"PxC",0
8,"8305",26208,17810,17506,296,304,"PxC",311
17,"17220",780,550,545,13,5,"PxC",1
17,"17213",5282,3097,3041,42,56,"PxC",22
8,"8115",3870,2693,2644,60,49,"PxC",57
8,"8176",166,111,109,0,2,"PxC",1
17,"17159",639,408,397,3,11,"PxC",0
25,"25196",127,87,86,3,1,"PxC",0
43,"43048",830,547,530,16,17,"PxC",5
25,"25208",294,174,170,3,4,"PxC",1
17,"17036",2822,1844,1806,36,38,"PxC",12
43,"43119",739,500,496,5,4,"PxC",5
25,"25136",106,79,79,1,0,"PxC",0
25,"25079",307,242,240,7,2,"PxC",0
17,"17010",327,216,214,6,2,"PxC",0
43,"43052",1001,669,636,12,33,"PxC",4
25,"25157",183,128,128,4,0,"PxC",0
43,"43073",90,57,57,1,0,"PxC",0
25,"25252",536,361,352,13,9,"PxC",2
43,"43166",1521,1002,977,17,25,"PxC",7
8,"8209",6596,4415,4351,69,64,"PxC",63
8,"8163",17986,11683,11548,159,135,"PxC",265
17,"17090",548,412,404,7,8,"PxC",1
25,"25075",122,85,83,0,2,"PxC",0
25,"25219",144,90,86,0,4,"PxC",4
25,"25041",625,432,420,20,12,"PxC",0
25,"25103",125,82,80,4,2,"PxC",0
8,"8226",886,667,656,13,11,"PxC",9
43,"43100",3062,2058,2021,52,37,"PxC",21
43,"43059",264,185,185,4,0,"PxC",0
8,"8020",4542,3352,3298,77,54,"PxC",26
8,"8140",4665,3160,3103,55,57,"PxC",104
43,"43072",97,73,70,0,3,"PxC",0
8,"8903",217,178,176,10,2,"PxC",2
8,"8215",2594,1763,1728,51,35,"PxC",38
8,"8269",2613,1840,1814,32,26,"PxC",27
25,"25131",439,319,314,6,5,"PxC",1
25,"25012",2204,1432,1406,29,26,"PxC",17
43,"43906",2050,1332,1298,28,34,"PxC",7
8,"8193",928,565,554,15,11,"PxC",5
8,"8254",1721,1189,1174,26,15,"PxC",17
17,"17093",859,561,552,16,9,"PxC",3
17,"17100",201,140,135,1,5,"PxC",0
25,"25048",1684,1120,1095,29,25,"PxC",4
25,"25149",1401,1031,1010,17,21,"PxC",3
17,"17040",506,320,316,7,4,"PxC",3
8,"8024",409,266,260,4,6,"PxC",6
8,"8259",6362,4482,4420,97,62,"PxC",75
25,"25025",1307,874,859,32,15,"PxC",1
25,"25232",1480,968,959,38,9,"PxC",2
43,"43165",624,471,459,6,12,"PxC",0
43,"43104",1821,1209,1178,34,31,"PxC",5
8,"8214",6754,4659,4555,83,104,"PxC",51
8,"8299",444,277,267,5,10,"PxC",8
8,"8018",2664,1707,1669,29,38,"PxC",31
8,"8296",1683,1227,1203,29,24,"PxC",7
17,"17171",148,111,109,5,2,"PxC",1
43,"43084",573,383,378,6,5,"PxC",1
25,"25248",926,615,601,17,14,"PxC",3
8,"8256",669,498,496,16,2,"PxC",7
43,"43146",45,33,30,1,3,"PxC",0
17,"17023",26941,17098,16799,344,299,"PxC",100
25,"25245",445,312,306,4,6,"PxC",1
8,"8102",27850,18716,18470,373,246,"PxC",388
43,"43156",4120,2811,2741,66,70,"PxC",8
8,"8058",1699,1089,1061,25,28,"PxC",28
43,"43133",5697,3470,3388,76,82,"PxC",171
43,"43092",7051,4294,4220,45,74,"PxC",17
17,"17050",645,438,425,15,13,"PxC",4
25,"25906",235,160,154,3,6,"PxC",0
8,"8136",11117,7602,7478,174,124,"PxC",155
25,"25220",1076,711,702,10,9,"PxC",3
17,"17121",230,159,158,7,1,"PxC",1
8,"8093",32,21,20,0,1,"PxC",0
25,"25226",257,162,158,5,4,"PxC",0
25,"25057",198,140,136,2,4,"PxC",0
17,"17232",159,107,104,0,3,"PxC",0
43,"43082",383,282,270,8,12,"PxC",0
25,"25175",221,151,150,0,1,"PxC",0
17,"17223",787,523,514,8,9,"PxC",4
17,"17106",140,105,104,0,1,"PxC",4
43,"43903",2368,1504,1492,22,12,"PxC",5
43,"43025",660,453,446,13,7,"PxC",3
17,"17174",183,120,117,5,3,"PxC",0
17,"17194",93,55,55,1,0,"PxC",1
43,"43040",350,251,246,18,5,"PxC",1
25,"25242",787,501,490,11,11,"PxC",3
8,"8139",184,130,128,1,2,"PxC",0
25,"25029",1766,1145,1118,38,27,"PxC",16
25,"25139",549,358,357,5,1,"PxC",0
17,"17046",738,510,498,15,12,"PxC",3
25,"25105",146,90,89,1,1,"PxC",0
17,"17226",852,539,535,0,4,"PxC",3
25,"25155",714,490,485,8,5,"PxC",1
43,"43021",381,218,213,3,5,"PxC",1
8,"8003",6983,5061,4993,53,68,"PxC",39
25,"25021",2693,1632,1605,40,27,"PxC",9
17,"17132",1296,913,900,15,13,"PxC",12
8,"8076",15925,10435,10242,179,193,"PxC",376
17,"17197",144,103,102,3,1,"PxC",2
17,"17047",4803,2866,2803,30,63,"PxC",24
8,"8149",985,683,671,11,12,"PxC",8
8,"8212",508,366,363,1,3,"PxC",4
25,"25088",100,74,74,0,0,"PxC",0
8,"8133",157,100,97,2,3,"PxC",0
25,"25251",670,476,473,1,3,"PxC",6
8,"8061",1467,960,952,10,8,"PxC",37
8,"8014",1906,1338,1313,37,25,"PxC",29
17,"17001",557,370,365,7,5,"PxC",1
17,"17016",725,491,481,8,10,"PxC",5
25,"25062",806,515,497,11,18,"PxC",2
43,"43002",1790,1252,1226,17,26,"PxC",12
25,"25133",748,499,483,7,16,"PxC",2
25,"25913",100,78,78,0,0,"PxC",1
17,"17139",1346,899,869,21,30,"PxC",1
43,"43149",711,529,516,13,13,"PxC",1
17,"17203",171,97,94,3,3,"PxC",4
8,"8218",7968,5014,4932,129,82,"PxC",143
8,"8095",75,56,55,1,1,"PxC",0
25,"25024",370,221,217,8,4,"PxC",0
17,"17133",1336,889,866,14,23,"PxC",11
8,"8145",2597,1823,1784,23,39,"PxC",31
43,"43024",1459,958,937,17,21,"PxC",29
8,"8279",149233,101676,100363,1965,1313,"PxC",3046
47,"47084",1230,981,968,19,13,"PUM+J",1
50,"50135",100,76,75,2,1,"PUM+J",0
44,"44143",382,292,292,5,0,"PUM+J",0
6,"6037",1789,1258,1252,6,6,"PUM+J",0
49,"49063",371,291,290,3,1,"PUM+J",1
13,"13057",1214,1018,998,9,20,"PUM+J",0
15,"15027",1537,1263,1242,22,21,"PUM+J",1
18,"18137",1057,875,868,8,7,"PUM+J",0
50,"50093",113,84,84,2,0,"PUM+J",0
6,"6027",732,655,645,8,10,"PUM+J",6
18,"18043",140,89,87,1,2,"PUM+J",0
9,"9131",412,332,321,6,11,"PUM+J",2
44,"44175",138,111,111,4,0,"PUM+J",0
5,"5243",101,69,68,0,1,"PUM+J",0
50,"50221",38,20,20,0,0,"PUM+J",0
47,"47158",906,716,710,10,6,"PUM+J",0
28,"28080",45696,36832,36529,402,303,"PUM+J",58
7,"7013",6525,4528,4409,78,119,"PUM+J",17
28,"28050",3576,2706,2663,21,43,"PUM+J",1
28,"28124",83,55,53,0,2,"PUM+J",0
26,"26129",1010,794,780,7,14,"PUM+J",0
5,"5162",107,71,71,0,0,"PUM+J",0
49,"49160",54,35,34,3,1,"PUM+J",0
28,"28102",913,700,693,9,7,"PUM+J",1
9,"9301",625,510,504,11,6,"PUM+J",0
49,"49159",289,225,225,2,0,"PUM+J",2
7,"7032",19658,12168,11959,238,209,"PUM+J",34
10,"10034",376,283,278,5,5,"PUM+J",0
32,"32068",1631,1187,1174,4,13,"PUM+J",1
9,"9244",53,44,44,0,0,"PUM+J",0
10,"10090",552,404,396,3,8,"PUM+J",1
5,"5063",48,39,39,2,0,"PUM+J",0
9,"9213",370,260,260,5,0,"PUM+J",1
50,"50125",421,284,280,1,4,"PUM+J",0
34,"34201",212,178,172,1,6,"PUM+J",0
40,"40110",391,303,302,6,1,"PUM+J",0
14,"14037",3500,2662,2616,29,46,"PUM+J",6
41,"41053",20729,16178,15971,142,207,"PUM+J",12
2,"2071",1053,899,895,5,4,"PUM+J",1
9,"9258",190,159,159,5,0,"PUM+J",1
33,"33045",4692,3347,3297,42,50,"PUM+J",0
34,"34902",146,121,121,1,0,"PUM+J",0
5,"5199",48,39,39,0,0,"PUM+J",0
40,"40146",270,222,222,0,0,"PUM+J",0
6,"6122",6620,4904,4797,44,107,"PUM+J",7
9,"9047",62,48,45,0,3,"PUM+J",0
14,"14050",2418,1983,1966,23,17,"PUM+J",4
49,"49079",110,93,92,2,1,"PUM+J",0
10,"10134",585,420,412,1,8,"PUM+J",1
10,"10070",765,614,613,5,1,"PUM+J",0
47,"47057",237,198,198,3,0,"PUM+J",0
5,"5178",392,310,304,2,6,"PUM+J",0
18,"18082",912,691,683,8,8,"PUM+J",1
49,"49189",228,151,150,3,1,"PUM+J",1
9,"9230",41,33,33,0,0,"PUM+J",0
50,"50205",98,72,71,2,1,"PUM+J",1
22,"22087",85,56,55,4,1,"PUM+J",0
15,"15036",60838,40345,39667,915,678,"PUM+J",61
6,"6031",490,387,385,8,2,"PUM+J",3
40,"40032",394,293,288,6,5,"PUM+J",0
49,"49109",657,534,529,12,5,"PUM+J",1
15,"15077",8677,6349,6269,82,80,"PUM+J",2
9,"9065",152,137,137,1,0,"PUM+J",0
24,"24145",656,420,420,11,0,"PUM+J",0
44,"44149",106,79,78,2,1,"PUM+J",0
44,"44042",139,87,87,0,0,"PUM+J",0
24,"24063",453,323,322,2,1,"PUM+J",0
32,"32064",561,439,437,5,2,"PUM+J",0
31,"31245",87,59,58,5,1,"PUM+J",0
6,"6067",2030,1583,1572,16,11,"PUM+J",0
5,"5088",34,26,26,0,0,"PUM+J",0
6,"6010",1144,903,898,6,5,"PUM+J",1
44,"44171",186,127,124,3,3,"PUM+J",0
41,"41061",2205,1798,1770,2,28,"PUM+J",0
15,"15048",4769,3470,3415,57,55,"PUM+J",9
31,"31258",7679,5561,5475,92,86,"PUM+J",25
50,"50074",6516,4378,4222,77,156,"PUM+J",9
28,"28092",148714,112174,110838,1215,1336,"PUM+J",127
6,"6128",4466,3310,3264,50,46,"PUM+J",4
22,"22028",424,311,310,3,1,"PUM+J",0
7,"7021",255,197,193,1,4,"PUM+J",0
18,"18906",955,736,731,5,5,"PUM+J",0
9,"9013",48,41,41,1,0,"PUM+J",0
5,"5072",91,72,72,1,0,"PUM+J",0
50,"50284",176,131,130,1,1,"PUM+J",0
10,"10094",247,212,211,0,1,"PUM+J",0
26,"26174",154,122,122,2,0,"PUM+J",0
47,"47218",983,776,767,7,9,"PUM+J",0
7,"7007",454,304,300,4,4,"PUM+J",0
16,"16001",79,66,66,1,0,"PUM+J",0
35,"35024",12420,6978,6819,131,159,"PUM+J",15
9,"9455",48,39,39,0,0,"PUM+J",0
6,"6005",1699,1332,1320,19,12,"PUM+J",2
24,"24209",3016,2006,1984,20,22,"PUM+J",1
16,"16093",80,57,57,0,0,"PUM+J",0
49,"49268",480,365,362,8,3,"PUM+J",0
10,"10902",727,608,599,5,9,"PUM+J",1
40,"40154",23,21,21,1,0,"PUM+J",0
41,"41064",5629,4041,4006,28,35,"PUM+J",5
21,"21059",203,166,162,1,4,"PUM+J",0
50,"50100",355,273,266,3,7,"PUM+J",0
32,"32080",394,311,309,3,2,"PUM+J",0
21,"21031",1309,903,871,9,32,"PUM+J",2
41,"41052",2967,2305,2288,7,17,"PUM+J",0
35,"35016",291589,181013,177964,2856,3049,"PUM+J",609
16,"16010",184,135,133,1,2,"PUM+J",0
9,"9128",82,65,63,0,2,"PUM+J",0
5,"5012",156,134,132,1,2,"PUM+J",0
9,"9173",135,116,116,1,0,"PUM+J",0
47,"47147",129,96,96,0,0,"PUM+J",0
9,"9098",553,416,410,11,6,"PUM+J",5
6,"6036",5228,4075,4028,22,47,"PUM+J",5
34,"34027",1224,875,861,14,14,"PUM+J",2
9,"9422",24,18,16,0,2,"PUM+J",0
28,"28066",7033,5439,5383,45,56,"PUM+J",5
50,"50174",107,92,90,0,2,"PUM+J",0
24,"24107",316,208,206,1,2,"PUM+J",0
14,"14036",3774,2928,2909,51,19,"PUM+J",5
10,"10042",79,63,62,2,1,"PUM+J",0
34,"34136",192,122,122,1,0,"PUM+J",0
34,"34152",142,114,109,1,5,"PUM+J",0
34,"34225",4837,3650,3580,73,70,"PUM+J",11
34,"34238",348,289,287,4,2,"PUM+J",0
24,"24141",101,83,80,6,3,"PUM+J",0
24,"24221",850,635,619,6,16,"PUM+J",0
22,"22230",302,234,231,11,3,"PUM+J",0
24,"24031",220,180,176,3,4,"PUM+J",0
28,"28173",507,397,390,2,7,"PUM+J",2
34,"34010",560,458,451,7,7,"PUM+J",0
16,"16100",764,660,655,3,5,"PUM+J",0
9,"9362",219,185,184,2,1,"PUM+J",1
18,"18128",361,284,283,5,1,"PUM+J",2
42,"42119",192,124,123,0,1,"PUM+J",0
24,"24104",291,198,196,3,2,"PUM+J",0
50,"50260",42,35,35,1,0,"PUM+J",1
22,"22906",190,152,147,3,5,"PUM+J",0
16,"16175",5058,4363,4295,70,68,"PUM+J",5
49,"49136",347,249,247,6,2,"PUM+J",1
16,"16218",207,170,169,4,1,"PUM+J",0
31,"31025",751,501,495,12,6,"PUM+J",5
26,"26160",684,538,528,5,10,"PUM+J",0
24,"24059",956,592,585,9,7,"PUM+J",2
49,"49098",242,177,175,4,2,"PUM+J",0
16,"16128",70,64,64,2,0,"PUM+J",0
50,"50289",71,59,59,0,0,"PUM+J",0
5,"5082",569,467,462,1,5,"PUM+J",0
32,"32054",87289,63027,61875,1263,1152,"PUM+J",383
31,"31011",688,437,432,17,5,"PUM+J",7
16,"16133",4466,3522,3453,51,69,"PUM+J",6
2,"2069",11624,9091,8907,119,184,"PUM+J",6
26,"26114",87,74,72,0,2,"PUM+J",0
47,"47048",204,168,167,2,1,"PUM+J",0
2,"2020",519,433,430,0,3,"PUM+J",1
47,"47226",180,152,148,1,4,"PUM+J",0
6,"6048",879,758,740,4,18,"PUM+J",0
50,"50149",48,35,35,0,0,"PUM+J",0
28,"28160",7496,5680,5613,46,67,"PUM+J",6
47,"47141",148,121,119,1,2,"PUM+J",1
22,"22077",421,327,323,14,4,"PUM+J",0
6,"6143",3308,2625,2595,24,30,"PUM+J",4
47,"47126",49,43,42,1,1,"PUM+J",0
31,"31054",498,310,308,1,2,"PUM+J",0
35,"35018",11652,6488,6367,107,121,"PUM+J",19
5,"5025",108,86,86,2,0,"PUM+J",0
24,"24086",323,245,243,1,2,"PUM+J",1
9,"9906",1199,912,903,12,9,"PUM+J",0
47,"47138",259,198,195,3,3,"PUM+J",0
9,"9351",63,46,44,0,2,"PUM+J",0
13,"13052",6580,4869,4786,76,83,"PUM+J",6
13,"13026",482,387,384,1,3,"PUM+J",0
50,"50208",1831,1321,1305,24,16,"PUM+J",3
35,"35013",6779,5059,4961,105,98,"PUM+J",9
5,"5048",131,112,111,0,1,"PUM+J",0
34,"34156",56,48,48,2,0,"PUM+J",0
10,"10190",569,438,435,6,3,"PUM+J",3
31,"31198",38,33,33,0,0,"PUM+J",0
44,"44155",1162,819,801,24,18,"PUM+J",0
31,"31012",839,577,570,10,7,"PUM+J",1
6,"6028",4366,3881,3809,35,72,"PUM+J",2
33,"33046",546,429,421,3,8,"PUM+J",0
49,"49141",397,289,286,7,3,"PUM+J",0
24,"24103",330,180,177,0,3,"PUM+J",0
22,"22151",97,71,71,0,0,"PUM+J",0
41,"41087",9827,7300,7150,51,150,"PUM+J",16
9,"9192",74,55,53,0,2,"PUM+J",0
5,"5093",431,330,329,1,1,"PUM+J",0
9,"9022",83,58,58,2,0,"PUM+J",1
14,"14001",3633,3095,3064,25,31,"PUM+J",1
44,"44231",54,38,36,2,2,"PUM+J",1
44,"44145",1078,723,714,26,9,"PUM+J",2
5,"5096",74,56,56,0,0,"PUM+J",0
6,"6152",1327,983,967,8,16,"PUM+J",1
24,"24110",1291,914,904,16,10,"PUM+J",0
40,"40003",144,123,120,1,3,"PUM+J",0
42,"42154",95,73,73,0,0,"PUM+J",0
5,"5176",237,193,190,4,3,"PUM+J",0
22,"22218",49,33,33,1,0,"PUM+J",0
16,"16063",97,81,81,0,0,"PUM+J",0
34,"34135",429,334,329,6,5,"PUM+J",0
7,"7046",13748,8294,8183,183,111,"PUM+J",9
24,"24082",877,698,690,13,8,"PUM+J",1
9,"9054",107,80,80,1,0,"PUM+J",0
22,"22009",704,488,473,15,15,"PUM+J",2
47,"47179",408,315,306,6,9,"PUM+J",0
5,"5193",224,197,197,2,0,"PUM+J",0
2,"2085",345,288,284,2,4,"PUM+J",0
22,"22017",917,677,661,8,16,"PUM+J",1
24,"24102",701,536,530,3,6,"PUM+J",0
5,"5258",123,105,104,1,1,"PUM+J",0
18,"18144",779,592,590,3,2,"PUM+J",0
47,"47220",194,143,142,4,1,"PUM+J",0
10,"10003",616,463,458,3,5,"PUM+J",1
31,"31207",280,198,195,7,3,"PUM+J",0
18,"18079",3497,2729,2706,15,23,"PUM+J",1
7,"7010",4668,3229,3174,58,55,"PUM+J",5
47,"47170",40,30,30,0,0,"PUM+J",1
2,"2004",654,554,544,7,10,"PUM+J",0
50,"50140",172,108,108,1,0,"PUM+J",0
28,"28149",5276,4132,4063,43,69,"PUM+J",4
50,"50223",956,751,745,14,6,"PUM+J",1
31,"31065",1927,1391,1362,39,29,"PUM+J",0
15,"15030",201751,141022,138934,2981,2088,"PUM+J",371
40,"40073",425,371,367,3,4,"PUM+J",1
44,"44035",122,99,98,3,1,"PUM+J",0
9,"9108",399,287,283,5,4,"PUM+J",1
10,"10015",688,539,523,5,16,"PUM+J",0
9,"9093",154,127,125,1,2,"PUM+J",0
16,"16280",205,177,175,1,2,"PUM+J",0
50,"50147",845,637,627,12,10,"PUM+J",1
6,"6083",45013,31929,31491,527,438,"PUM+J",106
26,"26096",244,204,201,2,3,"PUM+J",0
16,"16189",263,213,211,2,2,"PUM+J",0
47,"47018",33,30,28,2,2,"PUM+J",0
22,"22042",115,93,91,1,2,"PUM+J",0
6,"6093",4599,3658,3612,22,46,"PUM+J",8
24,"24088",1103,903,885,4,18,"PUM+J",0
50,"50188",34,28,27,0,1,"PUM+J",0
9,"9378",42,26,26,0,0,"PUM+J",0
28,"28120",1259,946,931,11,15,"PUM+J",2
22,"22027",351,251,250,8,1,"PUM+J",0
16,"16040",97,76,75,1,1,"PUM+J",0
9,"9177",1154,823,815,12,8,"PUM+J",1
41,"41029",13231,9756,9610,128,146,"PUM+J",28
9,"9102",44,36,36,0,0,"PUM+J",0
9,"9226",74,57,57,0,0,"PUM+J",0
5,"5001",210,180,176,2,4,"PUM+J",0
32,"32014",1271,939,925,9,14,"PUM+J",0
13,"13030",153,123,123,1,0,"PUM+J",0
2,"2044",1207,908,893,5,15,"PUM+J",3
15,"15026",2025,1426,1413,17,13,"PUM+J",1
44,"44003",19,19,19,0,0,"PUM+J",0
40,"40234",441,363,355,3,8,"PUM+J",1
13,"13031",2384,1908,1874,23,34,"PUM+J",2
10,"10095",346,290,283,3,7,"PUM+J",2
2,"2013",158,123,121,1,2,"PUM+J",0
41,"41065",23028,15133,14958,191,175,"PUM+J",7
50,"50122",68,47,45,2,2,"PUM+J",0
21,"21042",15246,8640,8572,154,68,"PUM+J",14
15,"15091",1171,839,829,9,10,"PUM+J",0
31,"31004",36,21,20,0,1,"PUM+J",0
47,"47110",471,386,378,6,8,"PUM+J",0
22,"22035",261,179,176,3,3,"PUM+J",2
10,"10103",480,385,380,3,5,"PUM+J",1
44,"44219",207,159,157,1,2,"PUM+J",0
44,"44220",137,97,96,1,1,"PUM+J",1
9,"9112",115,80,80,4,0,"PUM+J",0
14,"14018",3795,3004,2970,24,34,"PUM+J",2
35,"35009",19678,13799,13442,155,357,"PUM+J",36
40,"40202",79,59,58,0,1,"PUM+J",0
31,"31010",5788,3716,3637,48,79,"PUM+J",9
31,"31039",94,65,61,0,4,"PUM+J",0
22,"22189",199,140,138,5,2,"PUM+J",0
9,"9182",104,81,81,1,0,"PUM+J",0
50,"50063",76,67,67,0,0,"PUM+J",0
14,"14040",3821,2986,2949,40,37,"PUM+J",0
9,"9133",39,33,33,1,0,"PUM+J",0
26,"26155",173,134,134,1,0,"PUM+J",0
31,"31073",332,228,226,1,2,"PUM+J",0
49,"49184",190,135,133,1,2,"PUM+J",1
33,"33013",466,349,345,4,4,"PUM+J",0
5,"5029",132,102,102,0,0,"PUM+J",0
34,"34140",113,84,84,2,0,"PUM+J",0
50,"50218",113,92,92,0,0,"PUM+J",0
40,"40001",713,575,562,10,13,"PUM+J",1
31,"31091",365,227,224,3,3,"PUM+J",0
6,"6024",1215,1015,1006,4,9,"PUM+J",0
31,"31216",3911,2699,2653,82,46,"PUM+J",8
10,"10088",244,168,168,0,0,"PUM+J",0
31,"31098",1762,1285,1262,34,23,"PUM+J",0
9,"9105",111,85,81,2,4,"PUM+J",0
24,"24229",473,348,344,8,4,"PUM+J",0
41,"41086",15877,10246,10150,146,96,"PUM+J",10
44,"44068",690,544,528,6,16,"PUM+J",0
42,"42162",2482,1871,1850,23,21,"PUM+J",4
44,"44211",39,32,32,2,0,"PUM+J",0
40,"40157",74,51,50,2,1,"PUM+J",0
31,"31248",318,190,187,2,3,"PUM+J",0
10,"10093",413,339,332,2,7,"PUM+J",0
5,"5085",35,34,34,0,0,"PUM+J",0
42,"42006",166,110,107,3,3,"PUM+J",0
16,"16170",733,552,543,3,9,"PUM+J",0
26,"26139",68,55,55,4,0,"PUM+J",0
9,"9117",82,59,59,1,0,"PUM+J",0
40,"40053",116,92,90,1,2,"PUM+J",1
22,"22252",130,98,96,5,2,"PUM+J",0
28,"28019",1195,901,888,5,13,"PUM+J",2
16,"16035",287,216,213,2,3,"PUM+J",1
5,"5235",136,120,119,2,1,"PUM+J",0
26,"26109",105,87,84,0,3,"PUM+J",0
26,"26044",60,48,46,1,2,"PUM+J",0
44,"44184",34,21,21,2,0,"PUM+J",0
33,"33018",2971,2139,2121,32,18,"PUM+J",1
34,"34182",860,657,649,8,8,"PUM+J",0
18,"18107",988,769,760,3,9,"PUM+J",0
28,"28156",958,742,733,12,9,"PUM+J",1
40,"40128",144,116,116,5,0,"PUM+J",1
26,"26121",33,28,28,0,0,"PUM+J",0
31,"31016",7377,5149,5072,101,77,"PUM+J",31
6,"6043",661,542,532,3,10,"PUM+J",0
24,"24025",331,237,237,5,0,"PUM+J",1
49,"49224",161,114,112,2,2,"PUM+J",0
50,"50240",1127,799,783,25,16,"PUM+J",2
32,"32002",2060,1566,1551,13,15,"PUM+J",4
18,"18098",6440,4743,4679,44,64,"PUM+J",2
18,"18001",288,212,212,1,0,"PUM+J",0
2,"2028",139,115,115,1,0,"PUM+J",0
42,"42031",31,19,19,0,0,"PUM+J",0
44,"44059",571,446,434,10,12,"PUM+J",0
18,"18152",1037,822,818,9,4,"PUM+J",1
38,"38052",1344,886,872,5,14,"PUM+J",1
24,"24190",183,134,131,1,3,"PUM+J",0
44,"44174",435,310,309,3,1,"PUM+J",0
34,"34017",960,772,760,15,12,"PUM+J",2
26,"26124",860,705,694,3,11,"PUM+J",0
16,"16240",134,100,98,0,2,"PUM+J",0
40,"40010",140,117,117,0,0,"PUM+J",0
50,"50164",407,271,268,4,3,"PUM+J",1
26,"26016",32,27,27,0,0,"PUM+J",0
18,"18056",3695,2961,2940,25,21,"PUM+J",0
9,"9249",54,44,42,1,2,"PUM+J",0
28,"28100",3970,2903,2865,32,38,"PUM+J",2
18,"18010",576,464,458,4,6,"PUM+J",1
44,"44076",2338,1839,1797,36,42,"PUM+J",3
9,"9123",31,27,27,0,0,"PUM+J",0
9,"9446",13,9,9,0,0,"PUM+J",0
15,"15086",3110,2281,2259,30,22,"PUM+J",2
50,"50249",333,280,272,2,8,"PUM+J",0
24,"24119",742,524,510,15,14,"PUM+J",1
41,"41009",1272,914,899,8,15,"PUM+J",0
31,"31106",676,534,518,10,16,"PUM+J",2
24,"24029",840,590,579,11,11,"PUM+J",2
49,"49147",301,243,239,4,4,"PUM+J",0
9,"9198",115,85,85,1,0,"PUM+J",0
16,"16033",1792,1485,1454,10,31,"PUM+J",2
24,"24038",3206,2439,2399,37,40,"PUM+J",0
44,"44056",577,436,434,7,2,"PUM+J",0
34,"34204",53,45,44,0,1,"PUM+J",0
28,"28003",196,154,151,2,3,"PUM+J",0
9,"9100",56,46,44,0,2,"PUM+J",0
10,"10153",331,266,263,1,3,"PUM+J",1
28,"28127",60108,48418,48039,568,379,"PUM+J",51
2,"2023",636,534,533,6,1,"PUM+J",0
32,"32062",963,735,729,10,6,"PUM+J",3
9,"9183",58,47,46,1,1,"PUM+J",0
40,"40125",99,72,71,3,1,"PUM+J",0
26,"26118",64,58,56,0,2,"PUM+J",0
44,"44049",886,652,627,6,25,"PUM+J",2
14,"14008",2905,2226,2200,18,26,"PUM+J",0
5,"5195",241,168,164,0,4,"PUM+J",0
49,"49012",73,43,43,0,0,"PUM+J",0
31,"31034",43,29,29,0,0,"PUM+J",0
50,"50166",282,216,210,1,6,"PUM+J",0
41,"41031",1319,879,875,6,4,"PUM+J",1
16,"16188",106,76,76,0,0,"PUM+J",0
18,"18050",1657,1209,1196,5,13,"PUM+J",0
49,"49111",144,117,116,10,1,"PUM+J",0
9,"9113",503,397,390,7,7,"PUM+J",0
34,"34160",154,119,116,0,3,"PUM+J",0
26,"26020",506,372,364,10,8,"PUM+J",0
28,"28009",13466,10392,10286,102,106,"PUM+J",15
15,"15058",26931,19505,19196,471,309,"PUM+J",47
16,"16017",406,337,334,1,3,"PUM+J",0
28,"28083",8037,6078,6025,66,53,"PUM+J",7
9,"9396",152,113,113,0,0,"PUM+J",4
10,"10157",289,218,212,1,6,"PUM+J",0
28,"28174",1745,1233,1224,11,9,"PUM+J",2
24,"24178",83,67,67,2,0,"PUM+J",0
10,"10008",1393,1105,1086,10,19,"PUM+J",1
24,"24042",79,68,68,0,0,"PUM+J",0
41,"41082",3448,2827,2796,15,31,"PUM+J",1
38,"38013",2823,1856,1843,18,13,"PUM+J",2
16,"16053",414,334,326,2,8,"PUM+J",2
44,"44089",57,50,49,0,1,"PUM+J",0
6,"6002",4321,3272,3195,32,77,"PUM+J",11
24,"24108",421,316,314,6,2,"PUM+J",0
22,"22059",1149,792,764,23,28,"PUM+J",1
9,"9201",33,22,22,2,0,"PUM+J",0
5,"5079",68,52,50,1,2,"PUM+J",0
26,"26141",132,101,101,2,0,"PUM+J",0
9,"9275",202,140,139,5,1,"PUM+J",0
9,"9195",64,40,40,1,0,"PUM+J",0
41,"41019",4528,3194,3168,41,26,"PUM+J",1
2,"2076",371,292,287,3,5,"PUM+J",0
6,"6146",1188,951,936,8,15,"PUM+J",0
44,"44230",154,127,127,3,0,"PUM+J",0
24,"24105",1460,1095,1075,27,20,"PUM+J",1
2,"2035",1988,1601,1586,19,15,"PUM+J",4
10,"10011",611,527,519,5,8,"PUM+J",2
18,"18182",1982,1405,1397,6,8,"PUM+J",1
2,"2060",1232,974,964,10,10,"PUM+J",0
21,"21068",1009,726,721,10,5,"PUM+J",0
44,"44196",152,116,114,2,2,"PUM+J",0
24,"24225",1089,798,784,15,14,"PUM+J",4
22,"22220",192,138,136,5,2,"PUM+J",0
9,"9356",57,38,37,1,1,"PUM+J",0
26,"26123",129,113,113,1,0,"PUM+J",1
10,"10052",186,138,138,0,0,"PUM+J",0
49,"49205",429,313,309,10,4,"PUM+J",1
5,"5078",128,112,111,2,1,"PUM+J",0
5,"5021",2044,1592,1557,37,35,"PUM+J",0
6,"6086",1270,956,949,2,7,"PUM+J",0
7,"7024",6070,3232,3170,60,62,"PUM+J",5
21,"21055",6320,4819,4760,46,59,"PUM+J",3
26,"26153",12,9,8,0,1,"PUM+J",0
6,"6061",1116,1000,989,8,11,"PUM+J",1
24,"24116",451,297,294,5,3,"PUM+J",1
5,"5208",55,45,45,0,0,"PUM+J",0
21,"21026",255,181,169,2,12,"PUM+J",0
24,"24078",426,323,316,0,7,"PUM+J",0
42,"42011",22,14,14,1,0,"PUM+J",0
10,"10152",499,424,418,4,6,"PUM+J",0
50,"50141",116,98,98,1,0,"PUM+J",0
26,"26145",251,201,199,3,2,"PUM+J",0
13,"13043",251,208,206,1,2,"PUM+J",0
32,"32016",1021,781,776,2,5,"PUM+J",0
15,"15034",3116,2146,2114,20,32,"PUM+J",0
28,"28118",72,49,47,1,2,"PUM+J",0
13,"13036",837,671,666,3,5,"PUM+J",0
10,"10091",391,327,324,3,3,"PUM+J",3
22,"22239",90,76,76,2,0,"PUM+J",0
26,"26009",426,318,313,4,5,"PUM+J",1
50,"50210",39,28,24,0,4,"PUM+J",0
41,"41071",5603,3999,3932,28,67,"PUM+J",1
24,"24097",244,161,156,4,5,"PUM+J",1
24,"24058",224,166,163,1,3,"PUM+J",0
16,"16274",147,125,125,1,0,"PUM+J",1
44,"44150",30,30,30,0,0,"PUM+J",0
16,"16123",110,74,73,1,1,"PUM+J",0
42,"42196",14,11,11,0,0,"PUM+J",0
50,"50076",113,89,89,0,0,"PUM+J",0
5,"5180",109,92,91,1,1,"PUM+J",0
26,"26099",1281,1050,1025,19,25,"PUM+J",5
31,"31118",182,114,114,6,0,"PUM+J",1
47,"47146",236,196,195,4,1,"PUM+J",0
5,"5124",134,111,109,1,2,"PUM+J",0
31,"31058",240,184,179,0,5,"PUM+J",1
24,"24173",1023,757,747,4,10,"PUM+J",0
26,"26157",306,268,263,1,5,"PUM+J",0
16,"16237",116,98,98,3,0,"PUM+J",0
49,"49258",127,107,104,0,3,"PUM+J",0
44,"44197",60,37,37,1,0,"PUM+J",0
6,"6021",971,761,747,6,14,"PUM+J",3
32,"32023",1360,1030,1011,6,19,"PUM+J",1
34,"34032",47,36,36,1,0,"PUM+J",0
16,"16152",42,38,37,3,1,"PUM+J",0
28,"28014",31360,23434,23133,203,301,"PUM+J",22
24,"24095",293,211,208,1,3,"PUM+J",0
41,"41903",6653,5134,5070,61,64,"PUM+J",1
28,"28134",55921,42676,42221,505,455,"PUM+J",61
16,"16067",135,97,97,2,0,"PUM+J",0
34,"34039",66,57,56,0,1,"PUM+J",0
10,"10166",351,246,238,2,8,"PUM+J",0
10,"10026",598,458,447,5,11,"PUM+J",1
6,"6138",1070,838,829,13,9,"PUM+J",0
10,"10013",305,242,237,1,5,"PUM+J",0
49,"49240",237,190,186,1,4,"PUM+J",0
34,"34019",139,108,108,5,0,"PUM+J",0
5,"5156",260,188,185,0,3,"PUM+J",2
22,"22156",256,209,203,5,6,"PUM+J",1
16,"16019",252,210,207,2,3,"PUM+J",0
21,"21037",491,386,378,1,8,"PUM+J",1
9,"9238",1026,612,601,6,11,"PUM+J",0
28,"28163",395,305,301,7,4,"PUM+J",0
32,"32075",3839,2957,2910,51,47,"PUM+J",14
10,"10033",440,340,336,4,4,"PUM+J",0
50,"50133",126,101,100,1,1,"PUM+J",1
18,"18047",5603,3833,3805,67,28,"PUM+J",4
33,"33012",5341,3816,3777,43,39,"PUM+J",0
18,"18147",3742,2419,2386,20,33,"PUM+J",0
44,"44128",84,56,56,3,0,"PUM+J",0
16,"16020",20,15,15,0,0,"PUM+J",0
44,"44205",757,541,527,12,14,"PUM+J",0
9,"9056",4957,3607,3557,70,50,"PUM+J",6
41,"41066",1417,1121,1113,9,8,"PUM+J",1
2,"2015",1508,1230,1211,7,19,"PUM+J",2
28,"28159",629,482,478,2,4,"PUM+J",1
5,"5095",301,253,250,2,3,"PUM+J",0
50,"50068",2082,1514,1481,18,33,"PUM+J",0
26,"26132",130,98,96,2,2,"PUM+J",0
35,"35001",4663,3639,3569,39,70,"PUM+J",9
15,"15051",4780,3333,3289,61,44,"PUM+J",2
50,"50234",251,201,191,13,10,"PUM+J",0
42,"42153",19,16,16,0,0,"PUM+J",0
2,"2016",600,471,468,5,3,"PUM+J",0
9,"9229",213,163,163,1,0,"PUM+J",0
21,"21062",1444,1003,991,7,12,"PUM+J",0
44,"44124",88,63,61,3,2,"PUM+J",0
21,"21032",1790,1362,1347,14,15,"PUM+J",0
47,"47193",1538,1229,1211,23,18,"PUM+J",2
35,"35033",6415,4394,4302,51,92,"PUM+J",8
42,"42116",63,50,48,3,2,"PUM+J",0
16,"16027",779,619,612,5,7,"PUM+J",1
2,"2901",2223,1678,1667,19,11,"PUM+J",2
49,"49180",169,113,107,2,6,"PUM+J",0
35,"35034",6372,2951,2921,33,30,"PUM+J",13
34,"34149",26,18,18,0,0,"PUM+J",0
10,"10077",719,551,543,3,8,"PUM+J",0
41,"41059",31676,23199,22889,330,310,"PUM+J",42
13,"13084",973,800,793,6,7,"PUM+J",2
15,"15043",5491,4033,3971,45,62,"PUM+J",14
22,"22051",108,86,84,2,2,"PUM+J",0
41,"41088",542,414,408,1,6,"PUM+J",0
18,"18140",42971,28391,28126,335,265,"PUM+J",19
10,"10097",109,97,96,0,1,"PUM+J",0
9,"9449",94,80,80,2,0,"PUM+J",0
9,"9067",460,335,328,5,7,"PUM+J",0
7,"7005",6331,4128,4058,76,70,"PUM+J",5
22,"22043",112,72,71,2,1,"PUM+J",0
34,"34109",62,47,46,0,1,"PUM+J",0
24,"24118",132,96,96,2,0,"PUM+J",0
6,"6075",517,433,429,3,4,"PUM+J",0
34,"34180",84,68,68,0,0,"PUM+J",0
22,"22095",87,61,61,1,0,"PUM+J",0
44,"44209",892,666,649,6,17,"PUM+J",1
40,"40178",104,80,79,1,1,"PUM+J",0
15,"15073",21991,14686,14456,216,230,"PUM+J",27
34,"34067",142,88,88,3,0,"PUM+J",0
5,"5121",250,181,178,1,3,"PUM+J",0
50,"50227",105,79,79,2,0,"PUM+J",0
32,"32006",1814,1344,1330,20,14,"PUM+J",1
22,"22114",137,94,94,4,0,"PUM+J",0
18,"18045",1211,892,885,4,7,"PUM+J",2
28,"28138",78,48,46,0,2,"PUM+J",0
49,"49238",289,233,231,3,2,"PUM+J",0
34,"34230",12,8,8,0,0,"PUM+J",0
5,"5185",109,89,89,1,0,"PUM+J",0
16,"16106",2839,2351,2331,10,20,"PUM+J",3
5,"5010",173,141,134,2,7,"PUM+J",0
22,"22206",218,169,167,3,2,"PUM+J",0
10,"10122",253,197,191,2,6,"PUM+J",0
41,"41070",5598,4101,4039,79,62,"PUM+J",8
10,"10175",1509,1149,1127,4,22,"PUM+J",1
47,"47134",186,155,149,2,6,"PUM+J",0
5,"5042",156,126,126,0,0,"PUM+J",0
16,"16007",1272,1056,1051,7,5,"PUM+J",1
21,"21077",1690,1335,1321,8,14,"PUM+J",0
31,"31260",1263,788,780,11,8,"PUM+J",2
2,"2058",390,290,285,0,5,"PUM+J",0
6,"6149",10390,8354,8215,111,139,"PUM+J",15
13,"13073",565,459,456,2,3,"PUM+J",0
28,"28055",932,713,707,5,6,"PUM+J",0
18,"18053",1836,1345,1340,11,5,"PUM+J",1
22,"22055",347,291,289,5,2,"PUM+J",2
28,"28152",14903,11954,11865,125,89,"PUM+J",14
6,"6125",1852,1419,1399,11,20,"PUM+J",1
9,"9090",61,50,50,0,0,"PUM+J",0
44,"44191",806,602,594,6,8,"PUM+J",3
42,"42213",31,24,24,2,0,"PUM+J",0
31,"31192",148,107,104,1,3,"PUM+J",0
50,"50261",246,199,199,4,0,"PUM+J",0
31,"31189",1229,745,740,5,5,"PUM+J",1
22,"22225",2784,1839,1805,42,34,"PUM+J",10
50,"50154",129,98,97,1,1,"PUM+J",0
24,"24093",388,262,258,1,4,"PUM+J",0
40,"40229",45,37,37,0,0,"PUM+J",0
16,"16165",84,70,70,0,0,"PUM+J",0
31,"31007",137,96,90,2,6,"PUM+J",1
44,"44092",89,68,68,0,0,"PUM+J",0
14,"14025",3061,2547,2517,13,30,"PUM+J",0
15,"15020",4187,2802,2781,18,21,"PUM+J",1
16,"16013",24,23,23,0,0,"PUM+J",0
18,"18039",3733,2901,2878,18,23,"PUM+J",13
9,"9135",41,29,29,1,0,"PUM+J",0
16,"16110",98,81,81,3,0,"PUM+J",0
31,"31038",1372,982,968,17,14,"PUM+J",6
49,"49229",134,99,99,2,0,"PUM+J",0
47,"47055",212,169,168,3,1,"PUM+J",1
42,"42108",13,10,10,1,0,"PUM+J",0
2,"2025",7496,6153,5985,69,168,"PUM+J",20
28,"28028",1615,1204,1173,11,31,"PUM+J",4
50,"50036",103,81,80,2,1,"PUM+J",0
14,"14057",6115,5040,4975,71,65,"PUM+J",8
47,"47037",194,160,159,1,1,"PUM+J",0
50,"50090",165,117,117,1,0,"PUM+J",0
31,"31076",2314,1843,1823,39,20,"PUM+J",11
44,"44216",25877,18461,18057,467,404,"PUM+J",43
28,"28065",118796,93292,92186,919,1106,"PUM+J",122
10,"10004",733,576,565,6,11,"PUM+J",1
10,"10135",1366,1004,998,3,6,"PUM+J",0
34,"34006",82,72,72,1,0,"PUM+J",0
42,"42007",143,110,110,2,0,"PUM+J",1
24,"24066",561,440,437,5,3,"PUM+J",1
44,"44090",84,71,71,0,0,"PUM+J",1
34,"34015",45,40,40,0,0,"PUM+J",0
18,"18042",425,344,342,2,2,"PUM+J",0
50,"50213",117,83,82,0,1,"PUM+J",0
16,"16039",466,330,326,1,4,"PUM+J",2
6,"6030",171,132,131,0,1,"PUM+J",0
34,"34134",61,49,47,0,2,"PUM+J",0
41,"41048",2296,1749,1726,21,23,"PUM+J",1
6,"6130",216,182,180,0,2,"PUM+J",0
50,"50038",1583,1194,1174,29,20,"PUM+J",1
49,"49246",248,212,210,1,2,"PUM+J",0
14,"14028",333,279,277,1,2,"PUM+J",0
47,"47092",123,100,99,2,1,"PUM+J",0
14,"14059",713,572,567,5,5,"PUM+J",0
26,"26177",322,276,274,2,2,"PUM+J",3
22,"22905",312,249,247,4,2,"PUM+J",0
9,"9001",29,25,25,0,0,"PUM+J",0
34,"34192",103,75,74,1,1,"PUM+J",0
26,"26119",223,186,185,2,1,"PUM+J",0
9,"9382",33,30,30,0,0,"PUM+J",0
9,"9159",57,49,48,0,1,"PUM+J",1
10,"10020",1671,1386,1374,14,12,"PUM+J",1
22,"22078",468,302,301,8,1,"PUM+J",0
40,"40189",560,455,438,6,17,"PUM+J",0
15,"15070",9684,6627,6464,141,163,"PUM+J",13
34,"34050",216,170,166,1,4,"PUM+J",0
49,"49185",171,140,140,3,0,"PUM+J",1
14,"14060",4843,3857,3787,47,70,"PUM+J",2
28,"28181",20003,16133,15952,159,181,"PUM+J",24
40,"40048",40,30,30,0,0,"PUM+J",0
42,"42058",129,103,101,1,2,"PUM+J",0
24,"24028",426,350,331,3,19,"PUM+J",1
34,"34240",102,84,83,1,1,"PUM+J",1
18,"18066",2072,1558,1552,8,6,"PUM+J",0
22,"22020",110,81,79,3,2,"PUM+J",0
16,"16117",1130,871,857,8,14,"PUM+J",0
18,"18148",874,714,706,6,8,"PUM+J",0
22,"22173",247,150,150,3,0,"PUM+J",1
47,"47058",199,157,157,3,0,"PUM+J",2
33,"33014",9318,6380,6320,66,60,"PUM+J",3
49,"49191",305,248,246,2,2,"PUM+J",0
21,"21027",67,52,52,0,0,"PUM+J",0
6,"6033",1387,1075,1068,6,7,"PUM+J",2
49,"49168",96,78,78,1,0,"PUM+J",0
47,"47217",1812,1395,1377,20,18,"PUM+J",5
6,"6019",2111,1621,1596,24,25,"PUM+J",2
26,"26001",211,174,168,3,6,"PUM+J",0
38,"38012",2535,1735,1716,11,19,"PUM+J",9
40,"40019",43,35,35,0,0,"PUM+J",0
9,"9007",66,50,50,0,0,"PUM+J",0
26,"26122",109,94,92,2,2,"PUM+J",1
49,"49129",903,671,661,16,10,"PUM+J",0
31,"31176",2777,1999,1955,57,44,"PUM+J",9
10,"10160",235,183,183,1,0,"PUM+J",0
22,"22204",1122,773,756,19,17,"PUM+J",0
9,"9372",207,169,165,1,4,"PUM+J",0
26,"26168",5055,3534,3484,47,50,"PUM+J",16
49,"49251",191,157,154,7,3,"PUM+J",0
31,"31135",116,87,86,9,1,"PUM+J",0
47,"47177",112,83,79,1,4,"PUM+J",1
47,"47232",107,77,75,1,2,"PUM+J",0
21,"21076",2108,1647,1628,22,19,"PUM+J",1
6,"6091",3854,2961,2906,33,55,"PUM+J",9
9,"9476",67,52,52,0,0,"PUM+J",1
26,"26052",181,146,146,0,0,"PUM+J",1
31,"31086",11499,8520,8389,214,131,"PUM+J",39
40,"40006",23,20,20,0,0,"PUM+J",0
31,"31126",372,247,244,6,3,"PUM+J",2
42,"42120",148,91,91,4,0,"PUM+J",0
49,"49027",178,134,127,1,7,"PUM+J",1
15,"15064",2356,1859,1824,35,35,"PUM+J",2
22,"22094",109,76,74,5,2,"PUM+J",1
42,"42158",112,79,79,6,0,"PUM+J",0
44,"44129",44,34,33,0,1,"PUM+J",0
33,"33054",1780,1272,1263,8,9,"PUM+J",0
40,"40054",145,103,102,1,1,"PUM+J",0
50,"50235",2371,1723,1701,36,22,"PUM+J",3
5,"5108",64,41,41,0,0,"PUM+J",0
24,"24184",206,111,111,0,0,"PUM+J",0
33,"33077",1351,938,931,7,7,"PUM+J",0
10,"10105",2599,1869,1835,25,34,"PUM+J",8
49,"49091",278,197,197,4,0,"PUM+J",0
5,"5264",68,48,48,1,0,"PUM+J",0
49,"49077",210,146,144,1,2,"PUM+J",1
28,"28166",325,269,268,8,1,"PUM+J",0
10,"10155",1156,829,819,4,10,"PUM+J",3
47,"47211",45,38,38,1,0,"PUM+J",0
28,"28126",59,37,37,0,0,"PUM+J",0
44,"44226",163,112,112,3,0,"PUM+J",0
5,"5047",4267,3345,3275,34,70,"PUM+J",5
13,"13063",3839,2801,2771,31,30,"PUM+J",5
6,"6080",1942,1519,1507,9,12,"PUM+J",1
50,"50182",3704,2551,2515,44,36,"PUM+J",7
34,"34205",70,55,55,1,0,"PUM+J",0
22,"22136",908,671,662,11,9,"PUM+J",0
24,"24002",271,213,213,2,0,"PUM+J",0
42,"42176",30,22,22,0,0,"PUM+J",0
15,"15076",2766,1971,1936,18,35,"PUM+J",6
44,"44227",81,59,59,0,0,"PUM+J",0
6,"6112",411,330,326,0,4,"PUM+J",0
41,"41081",28121,20027,19785,275,242,"PUM+J",26
31,"31079",99,64,63,0,1,"PUM+J",0
6,"6051",1606,1314,1302,10,12,"PUM+J",0
22,"22075",150,103,101,7,2,"PUM+J",0
5,"5179",231,206,204,2,2,"PUM+J",0
33,"33048",169,120,120,1,0,"PUM+J",0
9,"9169",96,80,80,1,0,"PUM+J",0
24,"24003",725,528,520,8,8,"PUM+J",0
31,"31018",422,303,299,8,4,"PUM+J",3
6,"6097",2475,1934,1902,27,32,"PUM+J",2
32,"32056",1861,1378,1369,8,9,"PUM+J",1
24,"24041",602,403,396,3,7,"PUM+J",0
6,"6098",537,436,435,6,1,"PUM+J",0
9,"9152",273,207,207,1,0,"PUM+J",0
16,"16198",1451,1126,1105,21,21,"PUM+J",3
16,"16011",39,30,30,0,0,"PUM+J",0
42,"42025",1305,964,945,15,19,"PUM+J",1
26,"26010",98,82,79,1,3,"PUM+J",0
6,"6089",607,530,529,2,1,"PUM+J",0
44,"44213",60,48,48,0,0,"PUM+J",0
50,"50251",8379,6225,6116,110,109,"PUM+J",7
31,"31020",488,247,246,0,1,"PUM+J",0
44,"44111",101,68,68,4,0,"PUM+J",0
49,"49078",209,173,172,1,1,"PUM+J",3
31,"31186",299,205,200,3,5,"PUM+J",1
22,"22909",349,259,252,3,7,"PUM+J",0
49,"49199",266,214,211,1,3,"PUM+J",1
26,"26147",34,29,29,2,0,"PUM+J",0
22,"22199",7259,4980,4861,128,119,"PUM+J",9
10,"10032",1768,1438,1415,9,23,"PUM+J",1
34,"34211",202,175,170,1,5,"PUM+J",0
47,"47101",1740,1458,1444,12,14,"PUM+J",3
15,"15078",78092,56506,55597,1110,909,"PUM+J",96
31,"31234",148,107,105,6,2,"PUM+J",1
18,"18087",187449,138136,136783,1548,1353,"PUM+J",221
6,"6040",1032,807,807,11,0,"PUM+J",0
16,"16202",908,753,744,10,9,"PUM+J",3
18,"18064",419,347,345,3,2,"PUM+J",0
18,"18153",8348,6170,6118,88,52,"PUM+J",1
50,"50167",235,191,184,1,7,"PUM+J",1
26,"26148",189,151,150,0,1,"PUM+J",0
18,"18033",282,227,226,0,1,"PUM+J",0
24,"24046",1002,704,696,20,8,"PUM+J",3
41,"41058",16497,12415,12248,181,167,"PUM+J",6
31,"31052",89,62,58,1,4,"PUM+J",0
47,"47149",44,22,20,0,2,"PUM+J",0
28,"28023",4350,3425,3392,32,33,"PUM+J",3
24,"24099",199,164,162,0,2,"PUM+J",0
15,"15061",6105,4391,4307,64,84,"PUM+J",2
18,"18187",587,432,432,0,0,"PUM+J",0
32,"32060",885,650,641,10,9,"PUM+J",1
32,"32004",2071,1145,1142,7,3,"PUM+J",0
50,"50244",215,155,155,6,0,"PUM+J",0
50,"50098",215,150,146,2,4,"PUM+J",1
22,"22037",115,87,79,0,8,"PUM+J",0
49,"49114",51,34,33,1,1,"PUM+J",0
50,"50012",105,93,90,0,3,"PUM+J",0
18,"18192",1581,1331,1318,6,13,"PUM+J",0
15,"15074",4254,3246,3219,35,27,"PUM+J",4
26,"26179",49,39,36,0,3,"PUM+J",0
28,"28010",9309,7304,7229,71,75,"PUM+J",11
22,"22050",100,84,83,0,1,"PUM+J",0
2,"2030",3180,2499,2456,13,43,"PUM+J",2
49,"49125",1344,956,939,21,17,"PUM+J",2
18,"18149",5096,3949,3900,36,49,"PUM+J",4
47,"47036",257,212,212,1,0,"PUM+J",0
9,"9101",79,66,66,2,0,"PUM+J",0
5,"5216",237,195,192,0,3,"PUM+J",0
34,"34228",93,80,80,0,0,"PUM+J",0
5,"5099",555,472,466,4,6,"PUM+J",1
22,"22250",368,261,255,12,6,"PUM+J",1
2,"2056",1816,1518,1506,15,12,"PUM+J",3
16,"16078",40954,30382,29933,568,449,"PUM+J",52
42,"42098",14,8,8,0,0,"PUM+J",0
15,"15063",2849,2022,2001,28,21,"PUM+J",2
44,"44182",216,173,173,4,0,"PUM+J",0
14,"14062",1114,889,882,9,7,"PUM+J",0
35,"35029",3981,2341,2315,43,26,"PUM+J",3
15,"15082",15075,11217,11046,187,171,"PUM+J",21
22,"22099",532,411,408,6,3,"PUM+J",1
50,"50283",73,55,55,1,0,"PUM+J",0
42,"42037",38,23,20,3,3,"PUM+J",0
5,"5056",94,78,73,1,5,"PUM+J",0
24,"24170",2006,1410,1394,14,16,"PUM+J",0
2,"2081",18319,14324,14096,225,228,"PUM+J",30
49,"49117",505,376,369,5,7,"PUM+J",1
21,"21056",2992,2172,2096,29,76,"PUM+J",1
49,"49118",215,174,173,2,1,"PUM+J",2
34,"34041",100,79,78,1,1,"PUM+J",1
31,"31904",1590,1054,1031,19,23,"PUM+J",1
6,"6153",20332,15398,15216,239,182,"PUM+J",41
24,"24011",244,131,129,0,2,"PUM+J",0
16,"16049",158,129,129,1,0,"PUM+J",0
24,"24117",493,376,369,2,7,"PUM+J",0
32,"32044",939,774,764,8,10,"PUM+J",1
24,"24171",417,231,231,2,0,"PUM+J",0
9,"9443",197,160,154,5,6,"PUM+J",0
28,"28017",1120,905,888,8,17,"PUM+J",0
10,"10158",367,307,306,3,1,"PUM+J",0
50,"50073",2265,1773,1756,20,17,"PUM+J",0
49,"49105",158,135,133,2,2,"PUM+J",0
41,"41027",4061,2783,2752,28,31,"PUM+J",4
16,"16012",102,81,80,0,1,"PUM+J",0
34,"34125",99,77,75,1,2,"PUM+J",0
34,"34114",240,171,171,0,0,"PUM+J",0
2,"2027",347,301,301,2,0,"PUM+J",0
9,"9211",1489,1137,1121,28,16,"PUM+J",1
47,"47137",27,22,22,2,0,"PUM+J",0
6,"6156",1190,989,978,9,11,"PUM+J",3
35,"35006",29515,20731,20286,362,445,"PUM+J",45
50,"50163",3427,2448,2413,62,35,"PUM+J",7
18,"18028",992,826,821,4,5,"PUM+J",0
50,"50258",54,37,37,0,0,"PUM+J",1
9,"9268",108,78,78,0,0,"PUM+J",0
26,"26028",135,108,106,2,2,"PUM+J",0
34,"34170",72,56,56,1,0,"PUM+J",0
24,"24015",2391,1812,1782,20,30,"PUM+J",1
13,"13041",298,225,225,1,0,"PUM+J",0
5,"5081",44,36,36,0,0,"PUM+J",0
10,"10029",447,362,355,1,7,"PUM+J",0
24,"24094",1466,1023,1006,24,17,"PUM+J",3
6,"6157",497,350,343,0,7,"PUM+J",0
10,"10125",925,705,689,3,16,"PUM+J",0
2,"2048",1320,1076,1061,11,15,"PUM+J",1
32,"32059",1983,1526,1510,27,16,"PUM+J",0
42,"42193",17,10,10,0,0,"PUM+J",0
34,"34084",142,124,122,3,2,"PUM+J",0
9,"9052",40,31,31,1,0,"PUM+J",0
31,"31907",9914,7394,7282,198,112,"PUM+J",51
49,"49179",401,285,284,2,1,"PUM+J",0
42,"42043",3905,2931,2875,48,56,"PUM+J",9
10,"10044",1520,1120,1103,10,17,"PUM+J",3
49,"49230",122,98,95,1,3,"PUM+J",0
24,"24056",3200,2368,2332,53,36,"PUM+J",7
9,"9181",334,271,271,14,0,"PUM+J",2
15,"15068",5404,3780,3725,53,55,"PUM+J",1
14,"14047",1566,1154,1143,19,11,"PUM+J",1
16,"16107",161,101,98,1,3,"PUM+J",0
14,"14044",1585,1279,1265,12,14,"PUM+J",0
9,"9904",548,412,407,7,5,"PUM+J",1
21,"21023",2106,1471,1456,7,15,"PUM+J",1
10,"10046",216,185,184,1,1,"PUM+J",0
13,"13044",2747,1996,1950,20,46,"PUM+J",2
22,"22089",329,246,237,8,9,"PUM+J",1
2,"2083",246,215,215,0,0,"PUM+J",0
9,"9232",182,146,146,1,0,"PUM+J",0
49,"49261",1579,1161,1145,36,16,"PUM+J",3
49,"49219",7742,5643,5562,87,81,"PUM+J",11
47,"47192",99,84,84,0,0,"PUM+J",0
49,"49183",111,87,87,2,0,"PUM+J",0
26,"26162",116,94,93,2,1,"PUM+J",0
9,"9055",55,46,44,0,2,"PUM+J",0
5,"5191",124,98,98,2,0,"PUM+J",1
22,"22060",1180,909,891,13,18,"PUM+J",0
49,"49048",162,119,119,2,0,"PUM+J",0
49,"49097",97,55,55,1,0,"PUM+J",0
10,"10006",1306,1081,1070,7,11,"PUM+J",1
28,"28145",2125,1643,1620,15,23,"PUM+J",1
47,"47014",55,47,47,0,0,"PUM+J",0
49,"49220",161,122,118,5,4,"PUM+J",2
49,"49233",119,78,78,2,0,"PUM+J",0
44,"44082",90,67,66,1,1,"PUM+J",0
6,"6162",2964,2415,2390,19,25,"PUM+J",2
6,"6071",257,236,230,1,6,"PUM+J",2
16,"16203",9839,7520,7342,101,178,"PUM+J",12
22,"22165",515,409,403,9,6,"PUM+J",0
6,"6117",1471,1155,1130,8,25,"PUM+J",3
7,"7065",2061,1376,1345,29,31,"PUM+J",3
22,"22217",406,314,309,4,5,"PUM+J",1
9,"9184",4,4,4,0,0,"PUM+J",0
44,"44084",63,51,50,0,1,"PUM+J",0
5,"5005",199,170,169,1,1,"PUM+J",1
34,"34062",175,126,124,3,2,"PUM+J",1
49,"49264",652,439,435,2,4,"PUM+J",1
41,"41024",22383,15333,15160,213,173,"PUM+J",17
49,"49171",704,568,561,6,7,"PUM+J",1
13,"13046",786,654,644,2,10,"PUM+J",1
13,"13047",5822,4735,4650,52,85,"PUM+J",7
44,"44126",344,250,236,1,14,"PUM+J",0
26,"26027",169,126,126,1,0,"PUM+J",0
32,"32033",843,595,583,7,12,"PUM+J",0
6,"6073",787,563,552,9,11,"PUM+J",2
49,"49100",322,236,233,1,3,"PUM+J",0
47,"47222",92,77,77,4,0,"PUM+J",0
16,"16906",104,83,82,0,1,"PUM+J",0
9,"9908",509,328,321,5,7,"PUM+J",1
5,"5034",17,13,13,0,0,"PUM+J",0
34,"34165",86,67,67,0,0,"PUM+J",0
10,"10051",489,373,373,2,0,"PUM+J",0
47,"47151",32,29,29,0,0,"PUM+J",0
44,"44114",254,194,188,4,6,"PUM+J",3
38,"38011",19299,12565,12313,152,252,"PUM+J",34
2,"2080",580,450,443,4,7,"PUM+J",0
50,"50198",46,36,36,2,0,"PUM+J",0
9,"9220",82,60,60,2,0,"PUM+J",0
50,"50042",16,14,14,0,0,"PUM+J",0
28,"28061",19624,15082,14905,162,177,"PUM+J",18
13,"13016",708,555,553,2,2,"PUM+J",0
50,"50121",297,250,245,6,5,"PUM+J",0
50,"50180",111,91,89,3,2,"PUM+J",0
9,"9327",34,34,34,0,0,"PUM+J",0
42,"42052",17,10,10,0,0,"PUM+J",0
5,"5165",386,292,280,7,12,"PUM+J",0
49,"49188",142,101,100,3,1,"PUM+J",0
22,"22067",82,54,49,3,5,"PUM+J",0
35,"35012",9662,5511,5446,45,65,"PUM+J",3
14,"14073",3009,2246,2224,32,22,"PUM+J",1
2,"2057",2138,1736,1712,30,24,"PUM+J",4
44,"44237",450,352,343,5,9,"PUM+J",0
2,"2021",1114,872,860,7,12,"PUM+J",1
16,"16036",143,117,115,1,2,"PUM+J",0
9,"9328",81,56,56,2,0,"PUM+J",0
18,"18115",2380,1843,1823,14,20,"PUM+J",0
22,"22222",510,367,365,6,2,"PUM+J",2
2,"2022",431,346,343,1,3,"PUM+J",0
9,"9074",735,558,547,7,11,"PUM+J",1
47,"47035",956,778,768,5,10,"PUM+J",0
42,"42205",99,70,70,0,0,"PUM+J",0
6,"6078",548,457,453,2,4,"PUM+J",2
32,"32077",1234,999,993,23,6,"PUM+J",0
50,"50206",499,386,384,10,2,"PUM+J",0
50,"50294",77,58,57,0,1,"PUM+J",0
44,"44118",183,129,127,2,2,"PUM+J",0
2,"2059",336,262,258,3,4,"PUM+J",0
28,"28901",765,579,567,2,12,"PUM+J",1
24,"24122",1424,1001,992,9,9,"PUM+J",0
10,"10096",3384,2581,2533,32,48,"PUM+J",3
6,"6155",1911,1384,1363,18,21,"PUM+J",2
10,"10137",428,373,371,1,2,"PUM+J",0
22,"22024",222,144,139,3,5,"PUM+J",0
10,"10218",1184,896,893,0,3,"PUM+J",0
26,"26042",852,660,651,11,9,"PUM+J",0
26,"26112",270,201,200,0,1,"PUM+J",0
15,"15066",4180,3098,3062,38,36,"PUM+J",6
5,"5265",87,68,66,2,2,"PUM+J",1
42,"42013",45,35,34,1,1,"PUM+J",0
32,"32083",960,675,672,0,3,"PUM+J",0
49,"49192",166,139,139,2,0,"PUM+J",1
44,"44132",64,57,56,0,1,"PUM+J",0
40,"40136",130,106,106,1,0,"PUM+J",0
7,"7017",800,556,539,14,17,"PUM+J",2
2,"2073",4924,3923,3847,76,76,"PUM+J",7
14,"14056",23507,17245,17071,259,174,"PUM+J",16
49,"49017",264,189,187,1,2,"PUM+J",0
6,"6127",2922,2306,2279,27,27,"PUM+J",2
24,"24174",525,393,387,6,6,"PUM+J",1
7,"7040",266127,162699,160491,2698,2208,"PUM+J",463
9,"9109",1181,664,631,16,33,"PUM+J",11
10,"10057",166,133,133,0,0,"PUM+J",0
18,"18119",1778,1401,1391,14,10,"PUM+J",1
15,"15039",1374,1027,998,27,29,"PUM+J",1
38,"38049",2794,1721,1694,12,27,"PUM+J",6
47,"47063",107,87,87,2,0,"PUM+J",0
9,"9025",150,112,110,0,2,"PUM+J",1
40,"40089",248,183,177,3,6,"PUM+J",0
15,"15011",15507,10935,10751,123,184,"PUM+J",21
40,"40170",1383,1091,1072,11,19,"PUM+J",2
42,"42044",62,47,46,0,1,"PUM+J",0
35,"35017",22331,13463,13144,217,319,"PUM+J",24
47,"47171",453,371,368,10,3,"PUM+J",1
6,"6032",76,59,59,1,0,"PUM+J",1
16,"16199",27,20,19,0,1,"PUM+J",0
6,"6160",3190,2343,2314,12,29,"PUM+J",3
15,"15031",22951,16018,15696,382,322,"PUM+J",53
26,"26102",6158,4794,4716,60,78,"PUM+J",7
16,"16266",402,334,325,4,9,"PUM+J",0
49,"49082",400,331,324,2,7,"PUM+J",1
24,"24070",4434,3199,3136,34,63,"PUM+J",4
18,"18012",2693,1841,1831,11,10,"PUM+J",4
49,"49153",183,141,139,1,2,"PUM+J",0
5,"5901",289,197,196,4,1,"PUM+J",0
22,"22032",120,78,73,5,5,"PUM+J",0
9,"9381",38,30,30,0,0,"PUM+J",0
9,"9335",62,52,51,1,1,"PUM+J",0
40,"40188",120,82,81,0,1,"PUM+J",0
50,"50126",2473,1747,1724,41,23,"PUM+J",1
32,"32087",1935,1609,1591,11,18,"PUM+J",1
9,"9199",97,75,74,0,1,"PUM+J",0
5,"5062",213,188,184,3,4,"PUM+J",0
9,"9079",49,44,44,1,0,"PUM+J",0
24,"24098",1251,837,819,19,18,"PUM+J",0
28,"28073",11899,8877,8769,112,108,"PUM+J",11
50,"50186",44,30,29,0,1,"PUM+J",0
31,"31193",1312,969,948,33,21,"PUM+J",2
47,"47066",1114,891,888,10,3,"PUM+J",5
49,"49155",105,85,85,0,0,"PUM+J",1
18,"18022",12448,8777,8659,111,118,"PUM+J",8
28,"28167",7818,6016,5942,82,74,"PUM+J",4
44,"44179",369,245,243,6,2,"PUM+J",0
31,"31062",1103,849,832,7,17,"PUM+J",2
9,"9384",310,223,218,3,5,"PUM+J",0
18,"18013",4392,3268,3223,23,45,"PUM+J",6
5,"5075",100,76,76,1,0,"PUM+J",0
10,"10036",345,262,251,2,11,"PUM+J",2
31,"31184",66,60,59,0,1,"PUM+J",0
49,"49022",319,266,261,3,5,"PUM+J",4
44,"44013",11286,7797,7584,242,213,"PUM+J",19
49,"49099",127,96,96,1,0,"PUM+J",0
50,"50215",21,20,19,0,1,"PUM+J",0
41,"41076",2227,1507,1492,5,15,"PUM+J",0
32,"32090",834,662,657,4,5,"PUM+J",0
10,"10104",5233,3904,3824,30,80,"PUM+J",2
40,"40095",507,437,425,2,12,"PUM+J",0
10,"10063",175,142,142,1,0,"PUM+J",0
34,"34034",129,104,104,1,0,"PUM+J",0
10,"10037",74974,56844,55950,898,894,"PUM+J",176
18,"18168",864,613,605,4,8,"PUM+J",1
28,"28109",1621,1121,1104,9,17,"PUM+J",1
41,"41051",2103,1705,1686,7,19,"PUM+J",1
26,"26151",455,384,382,1,2,"PUM+J",1
22,"22066",699,479,464,8,15,"PUM+J",1
16,"16092",158,132,132,0,0,"PUM+J",0
5,"5228",193,146,145,1,1,"PUM+J",0
31,"31094",123,100,97,3,3,"PUM+J",2
24,"24062",151,107,107,0,0,"PUM+J",0
28,"28154",5232,3910,3860,40,50,"PUM+J",8
47,"47169",70,57,57,0,0,"PUM+J",0
34,"34052",187,147,147,1,0,"PUM+J",0
9,"9163",642,526,518,3,8,"PUM+J",0
10,"10065",188,123,123,1,0,"PUM+J",0
47,"47043",330,267,264,1,3,"PUM+J",1
40,"40005",34,32,31,1,1,"PUM+J",0
32,"32019",11469,8297,8180,134,117,"PUM+J",23
22,"22040",155,129,127,3,2,"PUM+J",0
22,"22187",295,222,222,3,0,"PUM+J",0
26,"26012",17,15,15,1,0,"PUM+J",0
15,"15045",4178,2743,2727,22,16,"PUM+J",0
10,"10025",408,355,337,4,18,"PUM+J",2
24,"24077",237,205,199,2,6,"PUM+J",0
49,"49206",948,706,692,15,14,"PUM+J",3
41,"41093",17665,13712,13526,179,186,"PUM+J",28
41,"41026",4273,3577,3538,15,39,"PUM+J",1
9,"9164",179,130,130,1,0,"PUM+J",0
2,"2034",1419,1153,1146,18,7,"PUM+J",1
44,"44268",30,25,25,0,0,"PUM+J",0
24,"24183",900,571,567,10,4,"PUM+J",2
5,"5046",44,39,38,1,1,"PUM+J",0
10,"10108",231,152,152,0,0,"PUM+J",0
49,"49162",217,157,155,2,2,"PUM+J",0
50,"50132",697,544,536,11,8,"PUM+J",1
10,"10109",1834,1307,1287,18,20,"PUM+J",1
49,"49076",333,260,257,10,3,"PUM+J",0
16,"16094",142,112,111,1,1,"PUM+J",0
18,"18126",1461,1129,1121,15,8,"PUM+J",2
47,"47180",96,82,81,0,1,"PUM+J",0
34,"34155",142,118,117,3,1,"PUM+J",0
47,"47045",839,636,632,3,4,"PUM+J",0
9,"9023",993,771,765,22,6,"PUM+J",7
21,"21048",327,226,226,5,0,"PUM+J",0
22,"22190",120,76,73,4,3,"PUM+J",0
31,"31168",247,165,163,0,2,"PUM+J",0
24,"24080",228,165,164,0,1,"PUM+J",0
31,"31159",1158,864,846,17,18,"PUM+J",2
5,"5080",75,53,53,1,0,"PUM+J",0
9,"9347",136,113,109,5,4,"PUM+J",0
10,"10110",2326,1751,1703,11,48,"PUM+J",5
16,"16137",64,41,40,0,1,"PUM+J",0
10,"10069",858,680,673,2,7,"PUM+J",1
31,"31108",1969,1474,1452,23,22,"PUM+J",7
18,"18095",1916,1428,1306,21,122,"PUM+J",0
41,"41054",671,556,550,0,6,"PUM+J",0
26,"26113",35,31,31,1,0,"PUM+J",0
31,"31261",271,202,201,4,1,"PUM+J",0
28,"28104",11704,9455,9361,119,94,"PUM+J",7
21,"21049",3468,2327,2283,18,44,"PUM+J",2
10,"10071",179,133,133,1,0,"PUM+J",1
44,"44189",69,57,57,0,0,"PUM+J",1
18,"18096",348,289,287,1,2,"PUM+J",0
33,"33071",671,528,523,4,5,"PUM+J",0
9,"9124",1598,1151,1129,19,22,"PUM+J",2
34,"34208",62,52,52,2,0,"PUM+J",0
5,"5049",440,335,330,8,5,"PUM+J",0
16,"16014",659,534,528,8,6,"PUM+J",0
50,"50046",201,155,153,2,2,"PUM+J",1
9,"9485",62,56,56,0,0,"PUM+J",1
16,"16903",1097,855,828,9,27,"PUM+J",1
10,"10901",1148,844,839,18,5,"PUM+J",2
47,"47199",84,61,60,1,1,"PUM+J",0
6,"6113",2750,2143,2105,26,38,"PUM+J",6
33,"33004",69056,49228,48730,726,498,"PUM+J",28
10,"10005",551,439,424,4,15,"PUM+J",2
31,"31171",738,521,495,7,26,"PUM+J",1
24,"24164",397,215,213,2,2,"PUM+J",0
31,"31030",155,113,112,3,1,"PUM+J",0
9,"9127",54,39,39,0,0,"PUM+J",0
21,"21030",1757,1448,1426,14,22,"PUM+J",1
9,"9078",41,37,35,0,2,"PUM+J",0
7,"7041",2077,1583,1549,27,34,"PUM+J",1
31,"31264",173,110,108,1,2,"PUM+J",0
9,"9257",93,73,72,2,1,"PUM+J",0
24,"24044",176,138,136,2,2,"PUM+J",0
6,"6054",5468,4305,4185,35,120,"PUM+J",9
44,"44110",57,45,45,0,0,"PUM+J",0
2,"2003",129078,98135,97009,1430,1126,"PUM+J",356
44,"44024",24,19,19,0,0,"PUM+J",0
9,"9172",129,110,109,2,1,"PUM+J",1
10,"10060",1037,758,742,9,16,"PUM+J",0
50,"50058",80,65,64,0,1,"PUM+J",0
49,"49065",1212,939,926,3,13,"PUM+J",2
26,"26104",18,16,16,0,0,"PUM+J",0
44,"44025",6168,4326,4150,68,176,"PUM+J",9
22,"22048",12485,9146,9028,237,118,"PUM+J",21
5,"5214",46,23,23,1,0,"PUM+J",0
21,"21021",11825,7657,7574,108,83,"PUM+J",11
13,"13012",475,322,318,1,4,"PUM+J",0
32,"32063",2127,1469,1444,22,25,"PUM+J",5
16,"16908",227,181,179,1,2,"PUM+J",0
10,"10144",999,782,773,7,9,"PUM+J",2
50,"50224",70,52,49,2,3,"PUM+J",0
5,"5236",147,101,101,0,0,"PUM+J",0
50,"50290",436,334,331,4,3,"PUM+J",0
2,"2017",895,685,682,4,3,"PUM+J",0
28,"28052",3799,2753,2719,17,34,"PUM+J",0
22,"22049",88,70,69,5,1,"PUM+J",0
18,"18167",1927,1397,1380,13,17,"PUM+J",2
50,"50159",728,554,544,4,10,"PUM+J",0
47,"47015",229,172,170,1,2,"PUM+J",1
6,"6103",4777,3702,3671,31,31,"PUM+J",27
18,"18100",7304,5807,5737,62,70,"PUM+J",2
5,"5183",165,142,140,0,2,"PUM+J",0
47,"47213",122,99,99,1,0,"PUM+J",0
41,"41007",12177,8150,8016,126,134,"PUM+J",9
33,"33006",1674,1130,1120,10,10,"PUM+J",1
5,"5043",86,68,68,0,0,"PUM+J",0
42,"42035",847,600,592,4,8,"PUM+J",2
47,"47160",466,368,364,5,4,"PUM+J",0
15,"15044",1436,1083,1068,10,15,"PUM+J",6
16,"16147",78,63,62,1,1,"PUM+J",0
24,"24023",272,196,193,6,3,"PUM+J",0
24,"24034",3434,2524,2481,37,43,"PUM+J",6
47,"47186",251279,193705,191693,2746,2012,"PUM+J",370
44,"44067",132,89,89,0,0,"PUM+J",2
31,"31903",6058,3985,3919,67,66,"PUM+J",12
22,"22052",997,776,769,15,7,"PUM+J",2
14,"14032",434,377,375,1,2,"PUM+J",0
44,"44102",30,29,28,0,1,"PUM+J",0
44,"44236",77,48,47,0,1,"PUM+J",0
28,"28176",10977,8790,8718,68,72,"PUM+J",11
50,"50901",170,122,121,1,1,"PUM+J",0
32,"32067",1487,1004,995,10,9,"PUM+J",1
10,"10120",168,122,119,1,3,"PUM+J",3
9,"9221",446,343,340,7,3,"PUM+J",3
10,"10121",8063,6048,5988,51,60,"PUM+J",16
31,"31085",451,334,327,3,7,"PUM+J",3
50,"50052",100,82,82,0,0,"PUM+J",0
6,"6015",116077,82756,81836,989,920,"PUM+J",277
16,"16247",87,65,62,1,3,"PUM+J",0
22,"22205",472,369,363,5,6,"PUM+J",0
47,"47215",60,52,52,2,0,"PUM+J",0
15,"15055",4780,3247,3181,70,66,"PUM+J",2
6,"6062",638,493,492,3,1,"PUM+J",1
18,"18036",3553,2762,2741,20,21,"PUM+J",5
9,"9907",1385,1053,1041,31,12,"PUM+J",3
33,"33069",3611,2615,2597,25,18,"PUM+J",0
44,"44157",62,45,44,0,1,"PUM+J",0
9,"9086",629,467,461,5,6,"PUM+J",1
33,"33031",38090,25034,24730,380,304,"PUM+J",17
35,"35005",1170,864,853,7,11,"PUM+J",2
5,"5252",70,52,51,0,1,"PUM+J",0
10,"10203",4770,3397,3327,40,70,"PUM+J",4
6,"6154",2830,2108,2080,38,28,"PUM+J",4
22,"22054",1602,1040,982,42,58,"PUM+J",4
44,"44199",52,40,39,0,1,"PUM+J",1
2,"2084",362,276,270,2,6,"PUM+J",0
49,"49227",295,238,237,5,1,"PUM+J",1
41,"41062",2252,1719,1698,12,21,"PUM+J",0
13,"13018",860,740,727,2,13,"PUM+J",0
40,"40120",173,145,144,1,1,"PUM+J",0
34,"34126",284,226,224,3,2,"PUM+J",0
31,"31906",2493,1796,1770,57,26,"PUM+J",12
47,"47044",325,257,252,1,5,"PUM+J",0
10,"10164",770,557,547,2,10,"PUM+J",1
34,"34083",1888,1355,1338,15,17,"PUM+J",4
28,"28133",5868,4236,4144,23,92,"PUM+J",0
22,"22158",11978,8404,8279,149,125,"PUM+J",15
9,"9445",46,31,31,1,0,"PUM+J",0
24,"24054",492,359,351,1,8,"PUM+J",2
47,"47163",315,253,250,2,3,"PUM+J",1
49,"49164",158,120,114,2,6,"PUM+J",0
28,"28119",1911,1527,1514,13,13,"PUM+J",3
15,"15029",6266,4668,4618,49,50,"PUM+J",4
15,"15057",12467,8936,8744,102,192,"PUM+J",13
32,"32035",1632,1100,1088,8,12,"PUM+J",0
44,"44159",47,43,43,0,0,"PUM+J",0
40,"40122",551,417,414,9,3,"PUM+J",0
50,"50056",450,329,328,4,1,"PUM+J",0
21,"21028",419,320,315,3,5,"PUM+J",0
34,"34001",36,29,29,2,0,"PUM+J",0
6,"6066",1798,1348,1340,7,8,"PUM+J",0
22,"22058",194,138,137,5,1,"PUM+J",0
13,"13020",4805,3475,3434,40,41,"PUM+J",0
10,"10126",1660,1221,1201,9,20,"PUM+J",4
41,"41090",3488,2792,2751,22,41,"PUM+J",1
35,"35008",6151,4514,4419,59,95,"PUM+J",8
44,"44077",80,62,62,1,0,"PUM+J",0
9,"9447",36,33,33,0,0,"PUM+J",0
21,"21070",6278,4489,4445,42,44,"PUM+J",5
32,"32085",10730,7588,7475,100,113,"PUM+J",16
6,"6144",588,476,464,2,12,"PUM+J",4
50,"50146",211,168,167,4,1,"PUM+J",0
49,"49138",269,190,189,0,1,"PUM+J",1
40,"40107",113,93,90,3,3,"PUM+J",0
34,"34903",240,161,160,2,1,"PUM+J",0
50,"50057",1468,1022,1004,17,18,"PUM+J",1
18,"18063",1189,795,789,7,6,"PUM+J",0
18,"18133",2256,1783,1773,12,10,"PUM+J",2
32,"32026",2775,2096,2064,37,32,"PUM+J",9
18,"18109",607,461,456,1,5,"PUM+J",0
15,"15032",3639,2642,2586,35,56,"PUM+J",2
44,"44080",294,216,211,3,5,"PUM+J",0
50,"50204",2519,1823,1804,24,19,"PUM+J",3
16,"16155",549,430,426,2,4,"PUM+J",0
40,"40216",753,621,611,15,10,"PUM+J",0
44,"44163",119,91,91,0,0,"PUM+J",1
5,"5027",290,233,230,2,3,"PUM+J",0
31,"31152",1406,1003,975,23,28,"PUM+J",3
47,"47140",132,109,108,1,1,"PUM+J",1
49,"49112",131,93,93,2,0,"PUM+J",0
47,"47212",386,327,325,1,2,"PUM+J",0
44,"44123",117,79,78,2,1,"PUM+J",0
34,"34177",170,147,143,2,4,"PUM+J",0
31,"31001",88,58,58,1,0,"PUM+J",0
10,"10129",374,279,276,2,3,"PUM+J",0
10,"10089",1399,1043,1032,15,11,"PUM+J",3
47,"47167",258,230,229,3,1,"PUM+J",1
41,"41014",2484,1956,1936,13,20,"PUM+J",0
28,"28002",2650,2018,1993,24,25,"PUM+J",2
9,"9368",26,18,18,0,0,"PUM+J",0
16,"16157",229,187,182,2,5,"PUM+J",0
18,"18145",10083,7592,7499,78,93,"PUM+J",11
47,"47221",115,102,102,0,0,"PUM+J",0
44,"44100",200,147,146,0,1,"PUM+J",0
24,"24007",798,582,566,2,16,"PUM+J",1
26,"26120",1515,1215,1198,20,17,"PUM+J",0
50,"50060",187,138,136,1,2,"PUM+J",0
49,"49127",2227,1617,1587,48,30,"PUM+J",4
47,"47185",97,76,75,1,1,"PUM+J",0
9,"9189",146,101,99,2,2,"PUM+J",0
24,"24060",660,382,382,0,0,"PUM+J",0
31,"31002",421,292,284,5,8,"PUM+J",0
31,"31215",4618,3384,3315,54,69,"PUM+J",23
22,"22063",184,142,140,2,2,"PUM+J",0
22,"22907",1444,1034,1018,12,16,"PUM+J",4
44,"44086",485,380,371,5,9,"PUM+J",3
10,"10009",285,223,221,0,2,"PUM+J",3
9,"9115",96,71,70,4,1,"PUM+J",0
50,"50022",548,430,416,10,14,"PUM+J",1
9,"9403",98,75,75,0,0,"PUM+J",0
21,"21044",17018,11390,11290,132,100,"PUM+J",10
18,"18905",12975,9260,9209,155,51,"PUM+J",13
9,"9191",45,34,33,1,1,"PUM+J",0
10,"10214",226,178,176,2,2,"PUM+J",0
41,"41016",6950,5194,5120,45,74,"PUM+J",5
44,"44127",79,62,61,0,1,"PUM+J",1
31,"31084",1949,1369,1361,11,8,"PUM+J",1
6,"6151",1109,850,846,6,4,"PUM+J",0
21,"21025",3969,2731,2686,33,45,"PUM+J",4
22,"22908",231,167,162,2,5,"PUM+J",1
49,"49145",251,154,153,0,1,"PUM+J",0
28,"28161",44185,33371,32966,353,405,"PUM+J",56
24,"24144",781,551,541,13,10,"PUM+J",2
5,"5100",307,245,245,2,0,"PUM+J",0
13,"13027",3582,2770,2715,25,55,"PUM+J",0
44,"44088",32,31,31,1,0,"PUM+J",0
33,"33061",446,260,259,1,1,"PUM+J",1
9,"9235",179,148,142,1,6,"PUM+J",0
40,"40131",48,41,41,0,0,"PUM+J",0
31,"31096",127,112,110,2,2,"PUM+J",0
7,"7003",10671,6262,6149,79,113,"PUM+J",13
34,"34181",471,350,346,7,4,"PUM+J",0
31,"31035",60,47,47,0,0,"PUM+J",0
31,"31005",312,209,206,4,3,"PUM+J",1
9,"9103",247,201,200,2,1,"PUM+J",0
5,"5035",105,87,87,2,0,"PUM+J",0
31,"31036",957,631,616,22,15,"PUM+J",2
15,"15037",4181,2839,2804,25,35,"PUM+J",1
50,"50152",1569,1151,1135,31,16,"PUM+J",3
49,"49103",435,354,350,6,4,"PUM+J",2
10,"10136",289,229,228,0,1,"PUM+J",2
24,"24227",1664,1159,1148,16,11,"PUM+J",6
44,"44252",78,63,60,0,3,"PUM+J",0
5,"5067",85,68,68,0,0,"PUM+J",0
5,"5167",274,230,224,6,6,"PUM+J",0
26,"26126",32,31,31,1,0,"PUM+J",0
50,"50153",1002,757,748,12,9,"PUM+J",0
16,"16038",50,40,40,0,0,"PUM+J",0
31,"31067",1982,1400,1363,28,37,"PUM+J",0
5,"5069",91,79,78,1,1,"PUM+J",0
50,"50239",65,44,44,0,0,"PUM+J",0
35,"35014",9943,5438,5316,95,122,"PUM+J",8
47,"47197",932,739,730,15,9,"PUM+J",0
26,"26127",236,206,204,1,2,"PUM+J",0
32,"32009",10752,7778,7684,120,94,"PUM+J",12
42,"42160",288,222,221,2,1,"PUM+J",0
18,"18017",17990,12070,11962,80,108,"PUM+J",10
22,"22072",209,130,128,2,2,"PUM+J",0
28,"28902",453,338,329,3,9,"PUM+J",0
31,"31068",3004,2258,2207,43,51,"PUM+J",11
9,"9281",159,134,132,5,2,"PUM+J",1
16,"16139",346,279,277,2,2,"PUM+J",0
21,"21038",1146,786,767,9,19,"PUM+J",2
24,"24067",700,453,447,4,6,"PUM+J",0
6,"6126",2199,1706,1686,14,20,"PUM+J",3
26,"26128",116,94,93,0,1,"PUM+J",0
10,"10056",605,484,476,5,8,"PUM+J",1
2,"2061",715,570,565,4,5,"PUM+J",0
40,"40184",269,227,224,4,3,"PUM+J",0
42,"42209",155,114,110,2,4,"PUM+J",0
9,"9283",63,36,36,0,0,"PUM+J",0
50,"50183",369,277,274,5,3,"PUM+J",0
49,"49243",117,85,85,0,0,"PUM+J",0
44,"44133",21,16,16,0,0,"PUM+J",0
44,"44047",267,162,160,4,2,"PUM+J",0
40,"40044",160,117,114,4,3,"PUM+J",0
10,"10017",884,681,673,6,8,"PUM+J",0
14,"14027",7948,5944,5871,92,73,"PUM+J",6
33,"33011",12085,7186,7116,89,70,"PUM+J",2
6,"6022",2719,2274,2245,14,29,"PUM+J",1
44,"44109",123,86,84,2,2,"PUM+J",0
18,"18097",1022,758,752,4,6,"PUM+J",1
5,"5083",155,120,113,1,7,"PUM+J",0
47,"47083",80,61,59,3,2,"PUM+J",3
40,"40171",32,25,25,0,0,"PUM+J",0
15,"15050",1971,1110,1097,27,13,"PUM+J",2
42,"42149",404,292,286,12,6,"PUM+J",2
32,"32037",828,660,654,10,6,"PUM+J",3
9,"9288",98,80,80,1,0,"PUM+J",0
16,"16086",935,814,802,14,12,"PUM+J",0
47,"47200",91,73,73,0,0,"PUM+J",0
47,"47148",475,389,384,2,5,"PUM+J",0
41,"41022",4281,3087,3066,15,21,"PUM+J",2
18,"18021",16026,11376,11219,186,157,"PUM+J",21
16,"16043",105,86,86,1,0,"PUM+J",1
16,"16273",328,277,275,2,2,"PUM+J",0
50,"50156",234,186,183,2,3,"PUM+J",0
44,"44218",37,26,26,2,0,"PUM+J",0
13,"13034",56981,42819,42306,742,513,"PUM+J",71
6,"6161",335,261,259,2,2,"PUM+J",1
49,"49007",387,289,289,4,0,"PUM+J",0
7,"7009",744,593,576,11,17,"PUM+J",3
47,"47229",235,161,161,1,0,"PUM+J",0
9,"9424",42,35,34,1,1,"PUM+J",0
41,"41049",8898,6881,6812,95,69,"PUM+J",4
24,"24071",1060,808,797,6,11,"PUM+J",0
9,"9029",186,138,137,4,1,"PUM+J",2
10,"10143",169,135,131,1,4,"PUM+J",1
5,"5204",654,521,516,7,5,"PUM+J",1
24,"24073",521,385,382,4,3,"PUM+J",1
26,"26135",181,139,137,1,2,"PUM+J",1
10,"10062",421,332,325,3,7,"PUM+J",0
5,"5192",96,78,77,1,1,"PUM+J",0
49,"49234",439,336,332,5,4,"PUM+J",0
16,"16045",226,177,176,2,1,"PUM+J",0
9,"9246",662,469,457,3,12,"PUM+J",1
31,"31194",308,212,210,6,2,"PUM+J",0
9,"9140",136,110,110,1,0,"PUM+J",0
32,"32089",1480,1063,1045,7,18,"PUM+J",0
35,"35019",30279,17607,17380,158,227,"PUM+J",36
14,"14030",8519,6832,6753,64,79,"PUM+J",41
5,"5076",477,397,385,4,12,"PUM+J",1
9,"9114",88,75,73,0,2,"PUM+J",0
18,"18154",1062,770,769,0,1,"PUM+J",0
10,"10022",442,377,370,1,7,"PUM+J",1
28,"28074",136617,106248,105095,1101,1153,"PUM+J",157
42,"42064",92,76,76,0,0,"PUM+J",1
40,"40004",534,428,420,3,8,"PUM+J",1
49,"49115",191,151,149,3,2,"PUM+J",0
5,"5055",649,525,518,3,7,"PUM+J",0
50,"50236",124,103,103,2,0,"PUM+J",0
10,"10106",144,123,123,4,0,"PUM+J",0
5,"5109",438,359,351,5,8,"PUM+J",0
50,"50216",267,201,194,8,7,"PUM+J",0
24,"24115",54654,38629,38010,716,619,"PUM+J",86
15,"15035",11969,8239,8120,192,119,"PUM+J",14
10,"10133",1247,1045,1028,7,17,"PUM+J",1
14,"14052",9720,6444,6384,58,60,"PUM+J",2
24,"24157",2580,2046,2000,39,46,"PUM+J",6
5,"5905",253,200,198,1,2,"PUM+J",0
16,"16174",209,170,167,0,3,"PUM+J",0
5,"5008",244,200,196,1,4,"PUM+J",0
50,"50131",243,185,183,6,2,"PUM+J",0
22,"22130",9983,6691,6573,148,118,"PUM+J",14
13,"13038",1770,1397,1380,8,17,"PUM+J",2
28,"28011",437,318,315,2,3,"PUM+J",1
13,"13071",41043,28435,28183,370,252,"PUM+J",49
9,"9297",326,270,266,7,4,"PUM+J",0
40,"40148",259,213,212,3,1,"PUM+J",0
44,"44144",326,233,227,7,6,"PUM+J",0
5,"5112",125,88,87,0,1,"PUM+J",0
40,"40906",1793,1428,1405,32,23,"PUM+J",3
18,"18124",387,270,267,0,3,"PUM+J",0
34,"34028",154,128,126,1,2,"PUM+J",1
42,"42024",95,80,73,1,7,"PUM+J",0
34,"34245",322,240,236,3,4,"PUM+J",0
44,"44105",82,63,63,2,0,"PUM+J",0
40,"40101",770,584,577,16,7,"PUM+J",0
13,"13039",14349,10928,10776,149,152,"PUM+J",15
16,"16134",4283,3398,3361,59,37,"PUM+J",3
9,"9120",46,35,34,1,1,"PUM+J",0
18,"18159",1051,873,869,4,4,"PUM+J",0
14,"14034",367,301,292,1,9,"PUM+J",1
42,"42069",1591,1122,1114,33,8,"PUM+J",5
10,"10149",434,323,319,1,4,"PUM+J",1
16,"16050",298,245,238,0,7,"PUM+J",1
41,"41094",6089,4757,4680,47,77,"PUM+J",4
24,"24039",2157,1738,1727,30,11,"PUM+J",0
44,"44187",224,170,163,2,7,"PUM+J",0
21,"21017",3581,2416,2389,27,27,"PUM+J",1
18,"18161",220,180,178,0,2,"PUM+J",0
40,"40009",49,41,41,0,0,"PUM+J",0
18,"18059",4055,3232,3191,37,41,"PUM+J",0
15,"15047",2606,1789,1761,33,28,"PUM+J",1
9,"9390",645,522,518,9,4,"PUM+J",1
21,"21047",1965,1355,1325,17,30,"PUM+J",1
9,"9391",383,290,284,7,6,"PUM+J",0
42,"42124",71,50,50,0,0,"PUM+J",0
31,"31017",358,220,219,12,1,"PUM+J",0
5,"5242",692,556,553,18,3,"PUM+J",0
44,"44107",233,161,154,3,7,"PUM+J",0
18,"18141",484,326,325,1,1,"PUM+J",0
50,"50277",82,63,63,0,0,"PUM+J",0
16,"16181",73,62,62,1,0,"PUM+J",0
9,"9302",116,87,87,3,0,"PUM+J",0
34,"34112",50,39,38,2,1,"PUM+J",0
24,"24081",143,111,110,1,1,"PUM+J",0
41,"41096",6079,4673,4595,47,78,"PUM+J",3
47,"47155",3043,2246,2225,35,21,"PUM+J",8
5,"5014",5559,4197,4101,53,96,"PUM+J",5
26,"26144",196,163,162,2,1,"PUM+J",0
10,"10030",502,364,362,5,2,"PUM+J",1
22,"22244",61,46,44,1,2,"PUM+J",0
9,"9255",90,68,68,0,0,"PUM+J",0
16,"16186",521,434,429,2,5,"PUM+J",0
13,"13042",953,704,693,5,11,"PUM+J",0
9,"9392",51,42,42,1,0,"PUM+J",0
2,"2037",22380,15942,15724,203,218,"PUM+J",40
22,"22124",229,171,170,2,1,"PUM+J",1
31,"31099",68,50,50,0,0,"PUM+J",1
41,"41012",3115,2314,2271,29,43,"PUM+J",1
49,"49244",48,30,30,1,0,"PUM+J",0
18,"18049",632,476,474,5,2,"PUM+J",1
42,"42110",82,58,58,2,0,"PUM+J",0
9,"9256",369,254,252,2,2,"PUM+J",1
26,"26117",2152,1682,1655,20,27,"PUM+J",1
2,"2063",1537,1252,1242,11,10,"PUM+J",0
28,"28058",137542,103880,102686,1155,1194,"PUM+J",142
26,"26146",141,98,96,0,2,"PUM+J",1
50,"50136",617,469,462,4,7,"PUM+J",0
9,"9901",407,319,308,8,11,"PUM+J",0
21,"21051",272,202,201,5,1,"PUM+J",0
31,"31051",270,182,181,8,1,"PUM+J",1
26,"26103",796,616,611,11,5,"PUM+J",0
10,"10073",759,589,583,3,6,"PUM+J",2
50,"50019",79,57,55,1,2,"PUM+J",0
24,"24043",144,77,77,0,0,"PUM+J",0
28,"28128",366,280,275,2,5,"PUM+J",0
9,"9437",298,249,247,5,2,"PUM+J",1
16,"16044",51,35,35,0,0,"PUM+J",0
15,"15041",9718,7514,7425,102,89,"PUM+J",7
44,"44064",93,63,62,0,1,"PUM+J",0
49,"49262",401,317,313,1,4,"PUM+J",1
50,"50137",1119,842,834,12,8,"PUM+J",0
2,"2040",631,569,566,3,3,"PUM+J",0
14,"14070",1385,1131,1111,4,20,"PUM+J",0
9,"9043",215,151,151,1,0,"PUM+J",0
9,"9307",119,89,88,1,1,"PUM+J",1
16,"16145",508,421,417,6,4,"PUM+J",0
2,"2041",399,311,304,1,7,"PUM+J",0
5,"5118",91,66,66,0,0,"PUM+J",0
5,"5017",87,69,68,1,1,"PUM+J",0
34,"34120",65774,49378,48608,830,770,"PUM+J",149
50,"50187",72,45,45,1,0,"PUM+J",0
15,"15071",8233,5751,5668,93,83,"PUM+J",14
44,"44065",60,40,40,0,0,"PUM+J",0
26,"26149",67,50,49,1,1,"PUM+J",0
31,"31113",147,87,85,2,2,"PUM+J",0
5,"5140",112,100,99,1,1,"PUM+J",0
9,"9353",62,51,51,2,0,"PUM+J",0
34,"34036",211,159,157,0,2,"PUM+J",2
50,"50078",278,210,208,2,2,"PUM+J",0
22,"22249",110,83,81,0,2,"PUM+J",0
26,"26022",232,191,190,1,1,"PUM+J",0
9,"9219",28514,20244,19951,326,293,"PUM+J",56
9,"9083",27,21,21,0,0,"PUM+J",1
24,"24211",291,226,224,3,2,"PUM+J",0
44,"44195",103,71,70,0,1,"PUM+J",0
18,"18067",704,526,521,1,5,"PUM+J",0
50,"50160",2397,1905,1865,19,40,"PUM+J",1
47,"47223",172,147,147,6,0,"PUM+J",0
21,"21014",4063,3424,3408,27,16,"PUM+J",1
13,"13048",538,441,433,5,8,"PUM+J",0
10,"10119",714,489,482,3,7,"PUM+J",4
41,"41033",5237,3915,3878,20,37,"PUM+J",6
2,"2043",1335,1120,1108,10,12,"PUM+J",1
16,"16191",1001,867,864,13,3,"PUM+J",0
49,"49172",594,389,383,0,6,"PUM+J",0
24,"24036",321,190,188,0,2,"PUM+J",0
10,"10038",98,84,83,0,1,"PUM+J",0
6,"6014",6843,4894,4839,30,55,"PUM+J",6
40,"40161",38,28,28,0,0,"PUM+J",0
5,"5217",69,54,54,0,0,"PUM+J",0
35,"35003",4764,2733,2680,34,53,"PUM+J",2
50,"50255",219,150,148,1,2,"PUM+J",0
9,"9009",167,129,128,8,1,"PUM+J",2
24,"24129",125,88,86,5,2,"PUM+J",0
50,"50170",411,316,313,2,3,"PUM+J",0
10,"10039",448,352,350,0,2,"PUM+J",0
24,"24010",8550,6242,6111,100,131,"PUM+J",12
16,"16022",102,76,76,2,0,"PUM+J",0
40,"40021",33,32,32,0,0,"PUM+J",0
9,"9406",242,193,193,2,0,"PUM+J",1
2,"2009",19661,14804,14570,259,234,"PUM+J",34
50,"50228",295,238,236,10,2,"PUM+J",0
42,"42140",17,10,10,0,0,"PUM+J",0
6,"6016",3013,2363,2306,31,57,"PUM+J",0
34,"34168",60,56,56,0,0,"PUM+J",0
34,"34124",70,55,55,1,0,"PUM+J",0
2,"2046",1165,954,941,16,13,"PUM+J",2
34,"34081",53,42,41,0,1,"PUM+J",0
34,"34169",431,331,329,5,2,"PUM+J",0
47,"47162",80,62,62,1,0,"PUM+J",0
2,"2010",1877,1557,1519,15,38,"PUM+J",1
5,"5022",1649,1335,1328,7,7,"PUM+J",2
47,"47080",45,39,39,1,0,"PUM+J",0
5,"5090",72,64,63,1,1,"PUM+J",0
15,"15028",1485,1130,1118,14,12,"PUM+J",0
40,"40024",920,712,704,7,8,"PUM+J",1
50,"50229",62,47,46,2,1,"PUM+J",0
31,"31178",540,395,392,4,3,"PUM+J",0
22,"22012",93,74,74,5,0,"PUM+J",0
18,"18038",1097,906,900,3,6,"PUM+J",0
16,"16025",31,23,23,0,0,"PUM+J",0
50,"50143",608,427,424,5,3,"PUM+J",0
44,"44074",435,344,337,5,7,"PUM+J",0
16,"16196",658,578,568,6,10,"PUM+J",0
9,"9224",172,125,125,3,0,"PUM+J",0
5,"5092",172,142,139,0,3,"PUM+J",0
44,"44119",119,84,84,2,0,"PUM+J",0
10,"10165",274,231,229,0,2,"PUM+J",0
40,"40025",158,124,124,0,0,"PUM+J",0
5,"5013",890,746,739,4,7,"PUM+J",0
41,"41011",15274,11359,11207,145,152,"PUM+J",4
5,"5221",398,298,297,10,1,"PUM+J",0
14,"14016",1406,1123,1115,9,8,"PUM+J",0
15,"15085",3576,2656,2612,29,44,"PUM+J",2
2,"2012",1834,1632,1622,12,10,"PUM+J",1
7,"7028",876,607,595,6,12,"PUM+J",0
10,"10043",866,636,622,1,14,"PUM+J",1
24,"24134",3682,2636,2588,44,48,"PUM+J",8
38,"38005",5327,3316,3270,38,46,"PUM+J",7
28,"28112",168,138,137,0,1,"PUM+J",0
9,"9136",203,153,146,3,7,"PUM+J",1
22,"22902",240,169,169,3,0,"PUM+J",0
40,"40168",36,27,27,0,0,"PUM+J",0
14,"14046",4587,3671,3641,35,30,"PUM+J",0
44,"44203",8,8,8,0,0,"PUM+J",0
42,"42148",14,14,14,0,0,"PUM+J",0
40,"40028",106,89,88,1,1,"PUM+J",0
10,"10167",322,265,264,1,1,"PUM+J",0
31,"31191",2930,2194,2148,43,46,"PUM+J",6
24,"24004",535,391,390,0,1,"PUM+J",0
49,"49214",720,560,558,6,2,"PUM+J",0
22,"22002",107,85,84,3,1,"PUM+J",2
26,"26032",58,52,52,1,0,"PUM+J",0
22,"22088",171,133,128,5,5,"PUM+J",0
10,"10113",2440,1891,1859,11,32,"PUM+J",3
24,"24219",580,435,431,10,4,"PUM+J",1
5,"5094",158,124,124,3,0,"PUM+J",0
28,"28113",31318,23779,23436,271,343,"PUM+J",22
41,"41013",4762,3359,3327,9,32,"PUM+J",2
31,"31061",67,47,47,2,0,"PUM+J",0
22,"22110",822,602,588,3,14,"PUM+J",0
47,"47004",1261,1047,1031,11,16,"PUM+J",0
40,"40030",520,432,425,9,7,"PUM+J",1
42,"42093",56,39,38,0,1,"PUM+J",0
9,"9095",88,75,73,2,2,"PUM+J",0
9,"9318",63,38,38,0,0,"PUM+J",0
22,"22214",131,101,100,2,1,"PUM+J",0
5,"5161",638,525,522,0,3,"PUM+J",1
40,"40172",34,27,26,0,1,"PUM+J",0
31,"31244",153,97,97,3,0,"PUM+J",0
16,"16255",159,123,122,3,1,"PUM+J",0
21,"21001",628,434,428,5,6,"PUM+J",0
22,"22061",6611,4789,4698,110,91,"PUM+J",13
31,"31092",676,447,446,6,1,"PUM+J",0
26,"26163",143,118,116,2,2,"PUM+J",0
31,"31153",2246,1504,1487,13,17,"PUM+J",1
31,"31031",234,144,143,1,1,"PUM+J",0
33,"33035",11413,8105,8035,104,70,"PUM+J",6
47,"47005",578,467,455,5,12,"PUM+J",2
44,"44246",1591,1030,997,15,33,"PUM+J",0
9,"9018",24688,17880,17508,345,372,"PUM+J",43
26,"26165",350,297,294,1,3,"PUM+J",0
28,"28136",618,527,516,2,11,"PUM+J",1
24,"24021",1791,1251,1228,14,23,"PUM+J",2
13,"13024",938,703,699,3,4,"PUM+J",0
15,"15033",2581,2094,2079,15,15,"PUM+J",5
9,"9174",859,645,639,11,6,"PUM+J",1
47,"47194",322,244,233,1,11,"PUM+J",1
2,"2018",922,759,754,7,5,"PUM+J",0
9,"9369",460,339,336,4,3,"PUM+J",0
21,"21063",2624,2109,2097,13,12,"PUM+J",3
7,"7901",642,483,470,5,13,"PUM+J",0
49,"49010",338,271,265,4,6,"PUM+J",1
24,"24142",24843,17695,17371,409,324,"PUM+J",34
24,"24100",760,563,553,14,10,"PUM+J",0
9,"9231",77,42,42,0,0,"PUM+J",1
13,"13025",321,257,254,1,3,"PUM+J",0
40,"40065",520,401,393,6,8,"PUM+J",0
9,"9202",26,24,24,1,0,"PUM+J",0
32,"32030",1120,857,846,9,11,"PUM+J",1
49,"49187",1317,967,954,31,13,"PUM+J",3
31,"31003",131,101,101,1,0,"PUM+J",1
2,"2019",2455,2107,2077,16,30,"PUM+J",3
41,"41042",5902,4572,4509,37,63,"PUM+J",2
26,"26078",85,69,69,0,0,"PUM+J",0
47,"47007",3453,2616,2580,42,36,"PUM+J",5
34,"34167",124,105,105,0,0,"PUM+J",0
28,"28068",10502,7857,7778,68,79,"PUM+J",10
16,"16206",250,188,188,2,0,"PUM+J",0
44,"44002",62,47,47,1,0,"PUM+J",0
44,"44250",20,11,11,1,0,"PUM+J",0
40,"40081",151,109,107,2,2,"PUM+J",0
40,"40222",190,157,156,1,1,"PUM+J",0
5,"5131",118,86,86,3,0,"PUM+J",0
22,"22115",415,307,304,2,3,"PUM+J",0
32,"32007",1674,1263,1243,4,20,"PUM+J",1
26,"26079",690,568,562,5,6,"PUM+J",2
28,"28162",2263,1802,1786,32,16,"PUM+J",1
9,"9144",61,51,50,0,1,"PUM+J",1
21,"21035",9657,6943,6871,64,72,"PUM+J",3
10,"10216",1549,1247,1235,15,12,"PUM+J",1
16,"16161",84,73,72,4,1,"PUM+J",0
18,"18180",655,450,447,1,3,"PUM+J",0
31,"31217",382,256,244,5,12,"PUM+J",0
9,"9277",130,101,101,1,0,"PUM+J",1
32,"32008",7618,5529,5433,83,96,"PUM+J",26
50,"50266",139,95,94,1,1,"PUM+J",0
50,"50005",245,199,195,1,4,"PUM+J",0
9,"9279",195,140,140,4,0,"PUM+J",0
40,"40179",634,545,538,4,7,"PUM+J",1
9,"9148",95,75,75,2,0,"PUM+J",1
9,"9374",96,85,81,3,4,"PUM+J",0
32,"32045",2640,1999,1980,23,19,"PUM+J",4
9,"9194",2033,1557,1535,28,22,"PUM+J",1
26,"26170",471,353,348,4,5,"PUM+J",0
31,"31219",93,75,73,1,2,"PUM+J",0
6,"6079",623,525,522,6,3,"PUM+J",0
10,"10054",551,435,428,6,7,"PUM+J",0
22,"22069",436,317,315,5,2,"PUM+J",0
16,"16163",75,57,57,0,0,"PUM+J",0
26,"26041",152,106,104,0,2,"PUM+J",1
34,"34184",54,37,36,0,1,"PUM+J",0
10,"10217",535,423,422,3,1,"PUM+J",0
31,"31037",94,68,68,0,0,"PUM+J",0
9,"9280",34,23,23,0,0,"PUM+J",0
18,"18084",3954,3039,3015,50,24,"PUM+J",1
34,"34139",179,143,143,1,0,"PUM+J",0
5,"5231",172,142,141,0,1,"PUM+J",0
9,"9151",509,389,383,5,6,"PUM+J",4
40,"40135",298,247,242,4,5,"PUM+J",0
44,"44046",58,44,44,1,0,"PUM+J",0
47,"47172",149,125,124,3,1,"PUM+J",1
6,"6081",1114,870,865,10,5,"PUM+J",2
18,"18048",2277,1705,1688,19,17,"PUM+J",2
7,"7006",4964,3234,3157,51,77,"PUM+J",10
7,"7039",4920,3488,3377,54,111,"PUM+J",6
44,"44008",1695,1280,1257,11,23,"PUM+J",1
40,"40088",303,242,238,0,4,"PUM+J",1
40,"40183",148,127,127,0,0,"PUM+J",0
40,"40043",1842,1494,1469,28,25,"PUM+J",2
28,"28165",1689,1310,1295,5,15,"PUM+J",0
49,"49194",380,250,247,4,3,"PUM+J",0
50,"50268",59,46,46,3,0,"PUM+J",0
10,"10099",633,458,450,4,8,"PUM+J",0
44,"44258",75,56,55,0,1,"PUM+J",0
50,"50124",474,375,367,11,8,"PUM+J",0
15,"15067",8142,6054,5978,73,76,"PUM+J",6
2,"2062",456,348,344,2,4,"PUM+J",0
9,"9464",44,28,28,0,0,"PUM+J",0
9,"9270",180,147,143,2,4,"PUM+J",0
49,"49273",217,144,144,0,0,"PUM+J",0
40,"40029",50,43,42,0,1,"PUM+J",0
22,"22125",38140,26924,26463,676,461,"PUM+J",70
47,"47227",62,52,52,1,0,"PUM+J",0
47,"47219",46,36,36,1,0,"PUM+J",0
38,"38007",1844,1209,1188,5,21,"PUM+J",1
15,"15040",2891,2160,2129,18,31,"PUM+J",0
34,"34189",59,47,47,3,0,"PUM+J",0
10,"10018",1761,1321,1296,17,25,"PUM+J",2
28,"28121",185,153,152,0,1,"PUM+J",2
42,"42111",310,228,222,2,6,"PUM+J",0
50,"50010",77,65,64,5,1,"PUM+J",0
44,"44010",189,138,138,2,0,"PUM+J",0
44,"44096",173,139,133,4,6,"PUM+J",0
9,"9466",151,111,110,1,1,"PUM+J",0
50,"50242",102,82,82,2,0,"PUM+J",0
47,"47174",302,236,234,3,2,"PUM+J",0
31,"31132",160,124,124,6,0,"PUM+J",0
42,"42017",154,134,130,2,4,"PUM+J",0
6,"6085",3437,2566,2530,32,36,"PUM+J",2
32,"32050",2663,1991,1974,17,17,"PUM+J",3
50,"50095",12558,9029,8910,179,119,"PUM+J",10
31,"31041",1397,938,913,26,25,"PUM+J",7
32,"32051",1574,1296,1290,7,6,"PUM+J",1
42,"42115",72,48,48,0,0,"PUM+J",0
40,"40142",53,43,41,1,2,"PUM+J",0
26,"26007",551,434,422,3,12,"PUM+J",2
5,"5041",1051,840,827,13,13,"PUM+J",1
31,"31133",48,34,34,3,0,"PUM+J",1
34,"34022",1136,926,908,5,18,"PUM+J",1
18,"18051",1196,857,852,4,5,"PUM+J",0
44,"44180",71,52,52,1,0,"PUM+J",0
40,"40002",38,31,31,1,0,"PUM+J",0
31,"31072",5098,3764,3698,75,66,"PUM+J",6
22,"22128",203,164,161,7,3,"PUM+J",1
44,"44138",158,109,106,0,3,"PUM+J",0
7,"7044",8326,6044,5846,99,198,"PUM+J",12
50,"50039",580,450,446,3,4,"PUM+J",3
21,"21043",1898,1382,1350,9,32,"PUM+J",4
16,"16224",96,69,69,0,0,"PUM+J",0
42,"42167",305,223,222,3,1,"PUM+J",0
34,"34023",5318,3947,3891,64,56,"PUM+J",4
18,"18088",1576,1258,1253,2,5,"PUM+J",0
49,"49157",177,140,140,0,0,"PUM+J",0
32,"32053",1500,1206,1199,19,7,"PUM+J",5
41,"41050",5102,4224,4183,39,41,"PUM+J",1
24,"24114",3441,2322,2304,42,18,"PUM+J",1
15,"15072",9868,7077,6951,79,126,"PUM+J",7
22,"22096",301,239,237,8,2,"PUM+J",1
24,"24101",465,274,266,5,8,"PUM+J",1
41,"41092",7649,5816,5738,39,78,"PUM+J",2
47,"47068",41,28,28,0,0,"PUM+J",0
24,"24156",264,187,186,6,1,"PUM+J",0
31,"31227",8257,5987,5884,125,103,"PUM+J",17
21,"21074",2752,1981,1968,15,13,"PUM+J",0
50,"50071",134,97,96,0,1,"PUM+J",0
42,"42155",188,121,120,0,1,"PUM+J",0
31,"31014",280,197,196,2,1,"PUM+J",1
40,"40145",1152,933,920,3,13,"PUM+J",0
34,"34025",54,42,42,0,0,"PUM+J",0
6,"6090",904,724,710,10,14,"PUM+J",0
31,"31044",276,224,223,0,1,"PUM+J",0
16,"16048",432,339,337,8,2,"PUM+J",0
5,"5207",743,595,591,1,4,"PUM+J",3
50,"50189",776,588,576,9,12,"PUM+J",1
47,"47017",205,177,176,1,1,"PUM+J",0
44,"44054",125,97,97,2,0,"PUM+J",0
41,"41078",2587,1979,1970,15,9,"PUM+J",0
32,"32055",1412,1056,1037,5,19,"PUM+J",1
47,"47206",111,99,99,0,0,"PUM+J",0
44,"44267",79,63,61,2,2,"PUM+J",0
50,"50217",496,380,379,0,1,"PUM+J",0
14,"14033",1289,974,958,18,16,"PUM+J",1
10,"10066",182,136,133,1,3,"PUM+J",0
31,"31015",1989,1404,1380,29,24,"PUM+J",3
26,"26140",268,213,207,2,6,"PUM+J",0
26,"26183",65,54,54,0,0,"PUM+J",0
21,"21046",1715,1354,1343,15,11,"PUM+J",1
7,"7048",15296,8559,8439,176,120,"PUM+J",24
9,"9166",97,87,87,1,0,"PUM+J",1
14,"14064",352,265,261,3,4,"PUM+J",0
34,"34202",28,21,21,0,0,"PUM+J",0
50,"50276",148,116,114,3,2,"PUM+J",0
5,"5144",92,66,66,4,0,"PUM+J",0
42,"42173",28809,20268,19748,632,520,"PUM+J",51
31,"31137",215,108,106,1,2,"PUM+J",2
31,"31046",58,41,41,3,0,"PUM+J",0
44,"44106",173,132,131,8,1,"PUM+J",0
42,"42071",186,104,103,3,1,"PUM+J",0
9,"9075",126,102,101,1,1,"PUM+J",0
24,"24040",494,369,366,6,3,"PUM+J",0
15,"15075",12042,8639,8486,147,153,"PUM+J",18
50,"50191",505,395,390,4,5,"PUM+J",0
32,"32058",5253,3872,3821,57,51,"PUM+J",10
44,"44146",185,160,159,8,1,"PUM+J",1
24,"24161",307,231,228,1,3,"PUM+J",0
21,"21078",2865,2085,2066,21,19,"PUM+J",4
40,"40056",41,34,34,0,0,"PUM+J",0
34,"34070",182,138,137,1,1,"PUM+J",0
22,"22085",119,97,94,0,3,"PUM+J",0
16,"16096",279,231,229,7,2,"PUM+J",0
38,"38026",32174,24822,24431,283,391,"PUM+J",45
50,"50104",379,306,303,4,3,"PUM+J",1
33,"33002",10837,7667,7588,77,79,"PUM+J",3
6,"6050",4277,3500,3457,36,43,"PUM+J",2
31,"31109",1365,946,934,11,12,"PUM+J",1
6,"6096",254,202,201,0,1,"PUM+J",2
49,"49165",72,63,63,0,0,"PUM+J",0
50,"50278",207,152,149,4,3,"PUM+J",0
31,"31049",733,479,479,4,0,"PUM+J",0
24,"24163",3706,2760,2714,57,46,"PUM+J",3
31,"31139",172,97,97,1,0,"PUM+J",1
9,"9303",92,64,64,0,0,"PUM+J",0
44,"44022",550,387,380,6,7,"PUM+J",0
22,"22139",86,66,63,2,3,"PUM+J",0
10,"10193",1410,1179,1158,16,21,"PUM+J",1
14,"14067",3821,3105,3082,38,23,"PUM+J",3
31,"31232",24440,17810,17436,420,374,"PUM+J",76
9,"9287",201,159,158,4,1,"PUM+J",1
34,"34186",61,53,53,0,0,"PUM+J",0
10,"10140",1143,941,927,9,14,"PUM+J",1
10,"10154",194,150,145,0,5,"PUM+J",0
9,"9350",502,384,376,7,8,"PUM+J",0
22,"22141",129,103,102,3,1,"PUM+J",0
50,"50279",111,79,79,1,0,"PUM+J",0
5,"5051",194,165,154,0,11,"PUM+J",0
9,"9125",648,463,460,5,3,"PUM+J",0
18,"18062",9418,6916,6835,62,81,"PUM+J",11
10,"10114",926,670,652,8,18,"PUM+J",0
22,"22246",93,63,62,0,1,"PUM+J",0
18,"18032",248,166,166,2,0,"PUM+J",0
41,"41083",1176,915,908,8,7,"PUM+J",0
49,"49124",279,203,202,2,1,"PUM+J",0
6,"6145",929,746,743,5,3,"PUM+J",0
31,"31111",100,75,75,1,0,"PUM+J",0
5,"5116",131,114,109,0,5,"PUM+J",0
26,"26060",100,71,71,3,0,"PUM+J",1
42,"42181",453,357,347,7,10,"PUM+J",1
18,"18902",950,769,762,6,7,"PUM+J",0
50,"50107",953,785,780,13,5,"PUM+J",0
21,"21052",4741,2897,2839,21,58,"PUM+J",2
13,"13078",9291,7062,6993,92,69,"PUM+J",34
31,"31021",75,52,52,0,0,"PUM+J",0
18,"18099",1551,1217,1205,11,12,"PUM+J",3
5,"5084",81,70,69,0,1,"PUM+J",0
31,"31081",335,249,243,8,6,"PUM+J",0
9,"9217",389,273,270,8,3,"PUM+J",0
5,"5245",344,285,284,5,1,"PUM+J",0
34,"34213",67,50,50,0,0,"PUM+J",0
15,"15079",1709,1268,1253,14,15,"PUM+J",1
10,"10076",825,619,610,7,9,"PUM+J",1
28,"28129",7219,5536,5461,71,75,"PUM+J",7
13,"13013",7141,5682,5564,60,118,"PUM+J",9
2,"2042",897,712,709,6,3,"PUM+J",1
35,"35028",8810,4687,4603,71,84,"PUM+J",6
16,"16243",451,395,388,3,7,"PUM+J",0
22,"22201",287,203,198,2,5,"PUM+J",0
47,"47076",16922,13030,12899,212,131,"PUM+J",20
50,"50168",34,26,26,1,0,"PUM+J",0
44,"44153",1882,1273,1246,10,27,"PUM+J",3
24,"24047",856,623,612,5,11,"PUM+J",1
47,"47023",2863,2278,2258,38,20,"PUM+J",1
15,"15080",1913,1407,1389,15,18,"PUM+J",1
5,"5119",41,31,31,0,0,"PUM+J",0
31,"31023",5338,3986,3920,120,66,"PUM+J",27
16,"16909",737,590,585,9,5,"PUM+J",0
14,"14010",4087,3144,3121,15,23,"PUM+J",0
31,"31053",595,430,418,6,12,"PUM+J",2
5,"5007",126,104,102,0,2,"PUM+J",0
14,"14031",634,516,514,1,2,"PUM+J",0
7,"7056",4701,3164,3090,55,74,"PUM+J",10
44,"44027",168,140,140,2,0,"PUM+J",0
7,"7023",3541,2414,2365,88,49,"PUM+J",5
47,"47024",283,211,210,1,1,"PUM+J",1
32,"32066",634,492,488,0,4,"PUM+J",0
22,"22150",491,342,336,9,6,"PUM+J",1
18,"18136",1973,1679,1668,5,11,"PUM+J",0
9,"9441",70,59,59,2,0,"PUM+J",0
10,"10079",891,711,706,6,5,"PUM+J",0
9,"9262",158,139,137,7,2,"PUM+J",0
16,"16148",634,553,547,5,6,"PUM+J",0
33,"33075",305,191,190,0,1,"PUM+J",0
50,"50080",41,31,31,1,0,"PUM+J",0
47,"47025",127,103,103,0,0,"PUM+J",0
14,"14072",1169,925,922,5,3,"PUM+J",0
31,"31145",173,129,127,2,2,"PUM+J",1
10,"10080",385,294,287,0,7,"PUM+J",0
18,"18102",8556,6358,6272,42,86,"PUM+J",0
9,"9311",70,51,51,0,0,"PUM+J",0
42,"42188",64,51,51,0,0,"PUM+J",1
26,"26066",277,229,228,9,1,"PUM+J",1
50,"50024",652,541,531,8,10,"PUM+J",1
16,"16193",77,68,67,0,1,"PUM+J",0
18,"18068",1456,1105,1088,13,17,"PUM+J",0
28,"28086",4603,3286,3248,29,38,"PUM+J",8
5,"5122",156,124,124,0,0,"PUM+J",0
44,"44070",62,47,47,1,0,"PUM+J",0
7,"7026",30036,16912,16661,294,251,"PUM+J",55
32,"32069",4573,3624,3580,35,44,"PUM+J",6
13,"13083",2529,1837,1795,26,42,"PUM+J",1
22,"22155",89,67,67,2,0,"PUM+J",0
42,"42038",42,32,31,3,1,"PUM+J",0
50,"50172",187,140,138,4,2,"PUM+J",0
42,"42190",102,71,71,3,0,"PUM+J",0
50,"50285",635,452,445,8,7,"PUM+J",1
18,"18069",506,375,371,4,4,"PUM+J",0
31,"31117",670,471,467,3,4,"PUM+J",1
47,"47188",125,112,109,3,3,"PUM+J",0
40,"40211",72,65,65,1,0,"PUM+J",0
24,"24053",503,338,332,3,6,"PUM+J",1
18,"18173",8858,6238,6187,64,51,"PUM+J",3
41,"41901",2626,2190,2167,24,23,"PUM+J",1
41,"41063",2678,1869,1853,22,16,"PUM+J",1
49,"49092",160,123,123,2,0,"PUM+J",0
9,"9011",86,56,56,1,0,"PUM+J",0
28,"28177",9470,7524,7466,87,58,"PUM+J",20
47,"47001",51,44,42,2,2,"PUM+J",0
21,"21058",2609,1867,1857,15,10,"PUM+J",3
18,"18007",808,602,591,5,11,"PUM+J",0
16,"16109",46,34,34,2,0,"PUM+J",0
35,"35032",3432,2605,2548,37,57,"PUM+J",9
47,"47002",30,27,27,1,0,"PUM+J",0
49,"49003",896,650,647,11,3,"PUM+J",0
9,"9225",95,61,61,3,0,"PUM+J",0
10,"10002",396,317,314,5,3,"PUM+J",0
22,"22057",377,283,278,3,5,"PUM+J",0
31,"31119",49,28,28,0,0,"PUM+J",0
50,"50287",298,214,211,10,3,"PUM+J",0
33,"33056",5278,3576,3540,41,36,"PUM+J",2
13,"13086",209,167,166,0,1,"PUM+J",2
47,"47028",31,21,20,0,1,"PUM+J",0
24,"24016",544,323,322,4,1,"PUM+J",3
22,"22209",161,115,115,4,0,"PUM+J",1
47,"47190",103,87,87,7,0,"PUM+J",0
5,"5060",127,108,105,1,3,"PUM+J",0
40,"40074",271,221,218,3,3,"PUM+J",0
49,"49094",276,180,180,2,0,"PUM+J",0
31,"31029",987,693,680,16,13,"PUM+J",4
2,"2086",2856,2019,2005,9,14,"PUM+J",6
10,"10086",342,259,250,5,9,"PUM+J",0
13,"13087",22953,16674,16376,298,298,"PUM+J",26
33,"33072",1737,1171,1159,11,12,"PUM+J",0
34,"34222",122,94,94,2,0,"PUM+J",0
49,"49006",168,124,122,2,2,"PUM+J",0
31,"31120",408,267,265,8,2,"PUM+J",1
9,"9137",177,134,134,6,0,"PUM+J",0
34,"34130",228,187,186,6,1,"PUM+J",0
14,"14048",1244,975,970,5,5,"PUM+J",1
2,"2051",1729,1318,1303,10,15,"PUM+J",2
42,"42003",76,54,51,0,3,"PUM+J",0
10,"10168",318,240,238,1,2,"PUM+J",0
18,"18176",265,183,181,0,2,"PUM+J",0
6,"6115",1261,893,885,7,8,"PUM+J",1
22,"22163",431,353,344,5,9,"PUM+J",0
28,"28044",5403,4245,4188,27,57,"PUM+J",8
26,"26073",100,85,84,1,1,"PUM+J",0
9,"9448",225,188,186,1,2,"PUM+J",0
16,"16071",25,23,23,0,0,"PUM+J",0
44,"44164",32,25,25,0,0,"PUM+J",1
28,"28180",5179,4033,3975,18,58,"PUM+J",5
7,"7064",5286,3340,3279,53,61,"PUM+J",7
16,"16156",122,91,91,0,0,"PUM+J",0
49,"49232",95,78,78,1,0,"PUM+J",0
44,"44206",156,119,117,3,2,"PUM+J",0
34,"34049",421,313,311,4,2,"PUM+J",2
10,"10047",978,795,780,9,15,"PUM+J",1
16,"16031",62,34,32,4,2,"PUM+J",0
5,"5225",423,346,342,8,4,"PUM+J",0
44,"44165",182,140,140,1,0,"PUM+J",0
38,"38042",3876,2850,2809,24,41,"PUM+J",3
18,"18912",1576,1193,1185,7,8,"PUM+J",0
16,"16115",60,45,45,0,0,"PUM+J",0
18,"18111",2647,1957,1941,24,16,"PUM+J",1
6,"6026",865,671,665,4,6,"PUM+J",1
9,"9057",155,125,124,0,1,"PUM+J",0
16,"16258",288,215,213,1,2,"PUM+J",0
6,"6118",228,181,181,1,0,"PUM+J",0
22,"22062",189,126,125,2,1,"PUM+J",0
21,"21033",508,385,382,7,3,"PUM+J",0
28,"28182",219,179,178,2,1,"PUM+J",0
22,"22112",9618,6642,6533,205,109,"PUM+J",24
7,"7033",25954,14975,14738,328,237,"PUM+J",30
31,"31154",229,133,133,4,0,"PUM+J",0
31,"31093",305,207,203,2,4,"PUM+J",1
50,"50291",112,75,73,0,2,"PUM+J",0
44,"44085",61,38,38,0,0,"PUM+J",0
10,"10049",3952,3348,3259,36,89,"PUM+J",5
22,"22113",512,357,353,8,4,"PUM+J",1
15,"15090",1267,959,953,4,6,"PUM+J",1
6,"6104",701,588,584,12,4,"PUM+J",1
26,"26064",2341,1770,1749,26,21,"PUM+J",5
10,"10092",316,263,262,1,1,"PUM+J",0
10,"10010",2358,1597,1576,18,21,"PUM+J",2
21,"21004",1530,1059,1042,9,17,"PUM+J",2
16,"16118",1454,1221,1211,19,10,"PUM+J",3
31,"31155",264,187,183,7,4,"PUM+J",0
18,"18044",208,132,132,4,0,"PUM+J",0
44,"44041",67,56,51,1,5,"PUM+J",0
31,"31064",1500,1137,1120,12,17,"PUM+J",4
32,"32042",1784,1292,1282,13,10,"PUM+J",1
6,"6120",3508,2772,2741,31,31,"PUM+J",5
24,"24182",448,339,333,9,6,"PUM+J",0
15,"15007",3702,2670,2642,19,28,"PUM+J",4
6,"6121",3436,2700,2662,35,38,"PUM+J",4
41,"41043",647,457,454,5,3,"PUM+J",0
16,"16264",505,440,438,6,2,"PUM+J",0
40,"40223",241,190,190,2,0,"PUM+J",0
40,"40082",131,111,110,5,1,"PUM+J",0
28,"28069",51,35,33,1,2,"PUM+J",0
14,"14022",4077,3147,3102,20,45,"PUM+J",1
10,"10012",615,525,520,4,5,"PUM+J",1
26,"26169",83,73,72,0,1,"PUM+J",2
50,"50237",103,76,75,0,1,"PUM+J",1
14,"14053",6040,4455,4376,78,79,"PUM+J",3
28,"28047",38404,28739,28436,312,303,"PUM+J",43
13,"13093",4333,3281,3229,43,52,"PUM+J",3
6,"6123",4699,3509,3448,54,61,"PUM+J",9
44,"44005",59,43,43,1,0,"PUM+J",0
15,"15093",4562,3314,3270,37,44,"PUM+J",1
24,"24064",1532,1128,1107,17,21,"PUM+J",3
44,"44172",345,257,251,3,6,"PUM+J",0
47,"47116",426,363,358,0,5,"PUM+J",0
34,"34231",273,209,206,2,3,"PUM+J",0
49,"49148",213,144,143,0,1,"PUM+J",0
18,"18116",2972,2237,2213,19,24,"PUM+J",1
38,"38046",8848,6410,6301,75,109,"PUM+J",22
50,"50034",923,634,617,10,17,"PUM+J",3
5,"5166",235,181,178,1,3,"PUM+J",1
44,"44044",103,79,78,0,1,"PUM+J",0
34,"34096",56,41,39,1,2,"PUM+J",0
31,"31250",2887,1827,1802,20,25,"PUM+J",4
50,"50092",329,273,272,0,1,"PUM+J",0
9,"9458",422,325,316,5,9,"PUM+J",3
31,"31158",264,174,173,1,1,"PUM+J",0
5,"5197",114,98,98,1,0,"PUM+J",3
13,"13095",94,70,70,1,0,"PUM+J",0
9,"9329",117,80,79,1,1,"PUM+J",0
34,"34232",802,632,623,9,9,"PUM+J",1
49,"49149",422,305,303,6,2,"PUM+J",2
50,"50295",54,42,41,0,1,"PUM+J",0
50,"50123",428,335,332,9,3,"PUM+J",0
26,"26083",303,234,234,1,0,"PUM+J",2
32,"32010",457,362,356,0,6,"PUM+J",0
5,"5037",296,213,212,0,1,"PUM+J",0
41,"41020",12710,8954,8882,91,72,"PUM+J",5
28,"28007",122891,95200,94139,990,1061,"PUM+J",108
24,"24150",262,182,182,3,0,"PUM+J",1
49,"49193",503,365,357,4,8,"PUM+J",1
9,"9064",353,277,277,6,0,"PUM+J",0
38,"38016",1250,664,646,3,18,"PUM+J",0
47,"47090",2511,1907,1880,23,27,"PUM+J",4
34,"34233",158,128,128,3,0,"PUM+J",0
16,"16084",49,36,35,0,1,"PUM+J",0
18,"18183",685,502,500,3,2,"PUM+J",1
5,"5169",241,218,218,0,0,"PUM+J",0
10,"10139",117,98,97,1,1,"PUM+J",0
22,"22176",173,154,149,2,5,"PUM+J",1
47,"47011",600,493,489,4,4,"PUM+J",0
33,"33064",237,175,173,1,2,"PUM+J",0
16,"16125",1734,1367,1350,12,17,"PUM+J",3
47,"47173",862,683,675,5,8,"PUM+J",1
5,"5039",58,48,48,0,0,"PUM+J",0
38,"38039",10198,7548,7429,78,119,"PUM+J",24
18,"18151",276,191,188,0,3,"PUM+J",0
49,"49152",572,401,395,6,6,"PUM+J",0
2,"2026",845,723,716,5,7,"PUM+J",0
5,"5105",349,275,272,12,3,"PUM+J",1
31,"31009",717,510,497,14,13,"PUM+J",3
21,"21041",114169,74740,73814,1129,926,"PUM+J",110
24,"24152",481,326,322,5,4,"PUM+J",0
40,"40186",50,33,33,0,0,"PUM+J",0
47,"47039",196,163,163,1,0,"PUM+J",0
38,"38051",7081,5298,5229,64,69,"PUM+J",4
47,"47228",481,385,383,3,2,"PUM+J",0
28,"28144",5663,4456,4410,47,46,"PUM+J",5
42,"42060",33,22,22,0,0,"PUM+J",0
28,"28051",1469,1147,1129,7,18,"PUM+J",5
33,"33065",1150,791,784,16,7,"PUM+J",0
40,"40092",132,100,100,0,0,"PUM+J",0
9,"9337",126,88,87,1,1,"PUM+J",0
15,"15014",4239,3151,3104,39,47,"PUM+J",3
50,"50214",31,22,21,1,1,"PUM+J",0
9,"9200",54,35,35,2,0,"PUM+J",0
26,"26047",2076,1702,1682,17,20,"PUM+J",2
40,"40046",99,81,78,2,3,"PUM+J",0
22,"22127",483,357,353,9,4,"PUM+J",1
44,"44262",141,114,113,2,1,"PUM+J",0
31,"31163",2008,1458,1434,22,24,"PUM+J",7
42,"42215",821,561,545,19,16,"PUM+J",1
13,"13001",1372,1087,1067,8,20,"PUM+J",0
41,"41075",9987,7904,7809,71,95,"PUM+J",6
47,"47230",318,266,259,2,7,"PUM+J",2
31,"31225",40,32,32,0,0,"PUM+J",1
22,"22079",126,97,97,4,0,"PUM+J",0
26,"26091",165,139,139,0,0,"PUM+J",0
50,"50128",36,30,29,0,1,"PUM+J",0
40,"40094",375,286,284,4,2,"PUM+J",0
40,"40143",97,72,72,0,0,"PUM+J",0
7,"7043",3522,2384,2345,35,39,"PUM+J",10
50,"50129",258,164,164,0,0,"PUM+J",0
49,"49202",221,158,157,2,1,"PUM+J",0
22,"22184",203,172,167,2,5,"PUM+J",0
16,"16131",154,116,115,0,1,"PUM+J",0
47,"47041",166,135,133,2,2,"PUM+J",1
40,"40097",114,96,94,2,2,"PUM+J",2
44,"44141",147,99,95,0,4,"PUM+J",1
5,"5173",62,55,55,1,0,"PUM+J",0
44,"44169",403,285,278,0,7,"PUM+J",0
28,"28146",1672,1220,1205,4,15,"PUM+J",0
42,"42022",253,177,171,2,6,"PUM+J",1
18,"18024",882,696,688,12,8,"PUM+J",1
41,"41077",8817,6520,6375,53,145,"PUM+J",2
13,"13004",1130,937,923,6,14,"PUM+J",0
50,"50161",124,86,86,1,0,"PUM+J",0
28,"28123",48429,38681,38187,429,494,"PUM+J",37
35,"35020",6142,4227,4192,24,35,"PUM+J",4
28,"28147",910,705,698,5,7,"PUM+J",0
38,"38022",18671,13075,12890,111,185,"PUM+J",24
32,"32091",1971,1472,1466,12,6,"PUM+J",1
42,"42065",28,24,24,0,0,"PUM+J",0
44,"44266",134,107,105,2,2,"PUM+J",0
24,"24197",784,570,564,7,6,"PUM+J",0
26,"26011",7455,5452,5353,93,99,"PUM+J",16
42,"42219",45,33,33,1,0,"PUM+J",0
10,"10148",32554,23348,22955,365,393,"PUM+J",69
44,"44103",128,95,95,0,0,"PUM+J",1
28,"28076",417,325,321,1,4,"PUM+J",0
40,"40052",95,69,69,0,0,"PUM+J",0
9,"9072",272,210,209,4,1,"PUM+J",0
50,"50246",48,33,33,1,0,"PUM+J",0
32,"32092",596,367,364,2,3,"PUM+J",1
49,"49252",370,310,305,6,5,"PUM+J",1
7,"7047",2161,1447,1407,31,40,"PUM+J",4
47,"47096",139,109,107,0,2,"PUM+J",1
13,"13006",641,529,519,4,10,"PUM+J",0
14,"14003",1289,1046,1026,12,20,"PUM+J",1
18,"18027",2575,1913,1899,15,14,"PUM+J",0
34,"34108",561,477,465,6,12,"PUM+J",1
41,"41001",1642,1314,1302,10,12,"PUM+J",1
9,"9073",889,672,663,12,9,"PUM+J",1
28,"28101",222,158,158,4,0,"PUM+J",1
33,"33001",1772,984,971,14,13,"PUM+J",0
50,"50072",181,128,127,1,1,"PUM+J",0
32,"32020",2958,2300,2283,19,17,"PUM+J",1
9,"9346",95,83,83,1,0,"PUM+J",0
41,"41080",1289,1010,997,13,13,"PUM+J",3
22,"22135",200,152,147,5,5,"PUM+J",1
2,"2072",1598,1220,1198,5,22,"PUM+J",3
5,"5177",164,134,133,0,1,"PUM+J",0
26,"26098",99,74,73,2,1,"PUM+J",1
15,"15019",26096,18466,18187,350,279,"PUM+J",21
6,"6003",875,705,691,4,14,"PUM+J",0
50,"50248",552,421,407,5,14,"PUM+J",1
40,"40196",44,34,34,3,0,"PUM+J",0
6,"6049",1088,847,829,3,18,"PUM+J",2
6,"6004",1607,1317,1309,10,8,"PUM+J",0
47,"47127",150,110,108,0,2,"PUM+J",0
5,"5145",57,41,41,0,0,"PUM+J",0
31,"31078",2502,1880,1852,33,28,"PUM+J",1
5,"5114",1418,1195,1182,9,13,"PUM+J",2
47,"47154",168,144,144,7,0,"PUM+J",0
9,"9483",226,173,171,4,2,"PUM+J",0
9,"9037",122,91,90,2,1,"PUM+J",0
21,"21018",1821,1283,1273,19,10,"PUM+J",1
34,"34901",1233,955,946,14,9,"PUM+J",1
50,"50134",134,102,101,3,1,"PUM+J",0
50,"50220",59,43,43,1,0,"PUM+J",0
31,"31170",46,40,39,3,1,"PUM+J",0
40,"40105",60,51,51,1,0,"PUM+J",0
33,"33003",737,475,471,6,4,"PUM+J",0
14,"14006",1326,1170,1148,12,22,"PUM+J",0
47,"47209",43,33,33,0,0,"PUM+J",0
9,"9214",724,477,467,4,10,"PUM+J",4
10,"10112",1582,1299,1284,5,15,"PUM+J",0
40,"40106",232,173,173,3,0,"PUM+J",0
44,"44190",81,52,52,0,0,"PUM+J",0
47,"47128",57,52,48,1,4,"PUM+J",0
9,"9077",38,26,25,0,1,"PUM+J",0
24,"24068",500,357,349,3,8,"PUM+J",0
21,"21050",12322,8772,8679,99,93,"PUM+J",10
47,"47156",182,155,148,0,7,"PUM+J",0
22,"22245",329,261,257,3,4,"PUM+J",0
31,"31263",241,135,132,0,3,"PUM+J",0
49,"49081",1457,1166,1141,17,25,"PUM+J",1
49,"49167",223,173,171,5,2,"PUM+J",1
16,"16141",161,132,131,1,1,"PUM+J",0
26,"26018",10396,8186,8041,161,145,"PUM+J",15
44,"44063",82,55,55,2,0,"PUM+J",0
5,"5016",6231,4831,4763,56,68,"PUM+J",5
41,"41098",4650,3665,3603,43,62,"PUM+J",3
31,"31142",1443,906,899,16,7,"PUM+J",3
16,"16056",495,377,374,11,3,"PUM+J",0
10,"10196",309,244,244,1,0,"PUM+J",0
14,"14069",7733,5910,5824,68,86,"PUM+J",2
22,"22003",148,117,116,2,1,"PUM+J",2
24,"24206",1831,1362,1341,13,21,"PUM+J",2
9,"9395",164,134,133,1,1,"PUM+J",1
24,"24123",835,559,555,6,4,"PUM+J",1
28,"28037",1598,1263,1250,10,13,"PUM+J",0
31,"31172",375,295,288,11,7,"PUM+J",2
6,"6147",390,321,319,3,2,"PUM+J",0
10,"10115",3622,2872,2800,52,72,"PUM+J",7
35,"35026",78933,49860,48955,780,905,"PUM+J",151
34,"34035",122,98,96,0,2,"PUM+J",0
49,"49169",42,34,33,1,1,"PUM+J",1
9,"9902",491,363,357,4,6,"PUM+J",3
18,"18002",625,505,504,2,1,"PUM+J",0
24,"24006",521,384,378,4,6,"PUM+J",0
44,"44193",99,71,67,0,4,"PUM+J",0
50,"50196",110,87,86,4,1,"PUM+J",1
40,"40016",63,45,45,0,0,"PUM+J",1
47,"47131",189,145,145,4,0,"PUM+J",0
9,"9308",70,51,51,0,0,"PUM+J",1
9,"9082",49,41,41,0,0,"PUM+J",0
50,"50253",461,381,375,3,6,"PUM+J",0
5,"5215",186,138,136,1,2,"PUM+J",0
5,"5182",862,673,668,2,5,"PUM+J",1
31,"31173",881,754,733,12,21,"PUM+J",2
2,"2005",602,490,488,2,2,"PUM+J",0
15,"15024",4726,3634,3555,51,79,"PUM+J",4
10,"10118",306,262,261,2,1,"PUM+J",0
13,"13014",565,457,452,3,5,"PUM+J",0
31,"31083",50,37,37,0,0,"PUM+J",0
9,"9261",486,342,338,7,4,"PUM+J",2
24,"24008",9789,7277,7179,110,98,"PUM+J",15
22,"22203",92,79,79,0,0,"PUM+J",1
50,"50070",70,42,41,0,1,"PUM+J",0
22,"22007",863,636,621,8,15,"PUM+J",2
34,"34038",284,228,225,9,3,"PUM+J",0
40,"40113",438,330,322,4,8,"PUM+J",5
9,"9046",41,30,30,0,0,"PUM+J",0
26,"26107",97,79,79,1,0,"PUM+J",0
13,"13015",5755,4334,4293,40,41,"PUM+J",2
49,"49087",581,358,356,3,2,"PUM+J",0
6,"6059",1959,1476,1466,8,10,"PUM+J",4
28,"28175",780,641,630,8,11,"PUM+J",0
31,"31175",78,55,54,0,1,"PUM+J",0
26,"26108",324,245,243,4,2,"PUM+J",2
49,"49266",83,69,69,1,0,"PUM+J",0
16,"16062",30,27,27,0,0,"PUM+J",0
24,"24089",106265,77385,76124,1666,1261,"PUM+J",153
26,"26152",38,31,31,0,0,"PUM+J",0
26,"26025",78,69,69,1,0,"PUM+J",0
41,"41034",22561,16014,15840,270,174,"PUM+J",26
33,"33007",1680,1186,1179,10,7,"PUM+J",0
9,"9085",486,348,339,8,9,"PUM+J",0
28,"28110",1912,1492,1475,8,17,"PUM+J",0
24,"24212",1105,856,846,14,10,"PUM+J",2
24,"24213",162,134,133,1,1,"PUM+J",0
9,"9358",261,200,199,3,1,"PUM+J",1
16,"16149",179,140,138,2,2,"PUM+J",0
49,"49225",172,130,129,0,1,"PUM+J",0
44,"44116",96,68,65,3,3,"PUM+J",0
13,"13017",307,230,226,0,4,"PUM+J",0
6,"6108",2355,1773,1746,24,27,"PUM+J",6
40,"40118",59,44,43,1,1,"PUM+J",0
14,"14013",17006,13114,12958,166,156,"PUM+J",15
9,"9223",46,40,40,0,0,"PUM+J",1
6,"6017",292,250,250,0,0,"PUM+J",1
24,"24091",704,502,496,8,6,"PUM+J",3
49,"49041",443,337,334,7,3,"PUM+J",0
24,"24214",716,518,509,4,9,"PUM+J",0
50,"50903",2234,1622,1597,35,25,"PUM+J",4
14,"14014",2610,2160,2125,19,35,"PUM+J",2
10,"10040",455,344,334,8,10,"PUM+J",0
10,"10123",601,502,492,0,10,"PUM+J",0
42,"42087",48,38,37,1,1,"PUM+J",0
50,"50054",63,46,46,0,0,"PUM+J",0
47,"47053",125,100,99,1,1,"PUM+J",0
6,"6109",4006,3435,3372,21,63,"PUM+J",3
5,"5058",81,61,59,0,2,"PUM+J",0
49,"49270",156,112,112,6,0,"PUM+J",0
50,"50142",45,25,24,0,1,"PUM+J",0
50,"50173",175,104,104,2,0,"PUM+J",0
9,"9179",45,37,37,0,0,"PUM+J",0
14,"14045",3093,2662,2642,14,20,"PUM+J",2
10,"10001",270,231,229,2,2,"PUM+J",1
50,"50230",1295,914,903,13,11,"PUM+J",2
28,"28042",1091,814,808,5,6,"PUM+J",1
6,"6065",327,262,259,2,3,"PUM+J",0
34,"34045",84,75,74,1,1,"PUM+J",0
33,"33033",10609,7179,7107,91,72,"PUM+J",5
41,"41902",4682,3136,3101,34,35,"PUM+J",0
16,"16066",2402,2064,1997,32,67,"PUM+J",4
49,"49178",679,469,461,9,8,"PUM+J",2
9,"9409",138,105,102,0,3,"PUM+J",0
16,"16197",73,50,50,1,0,"PUM+J",0
6,"6020",1852,1476,1462,5,14,"PUM+J",5
35,"35007",569,392,391,2,1,"PUM+J",0
16,"16251",1903,1510,1493,18,17,"PUM+J",1
13,"13053",14718,10958,10766,159,192,"PUM+J",13
33,"33010",1922,1284,1277,14,7,"PUM+J",0
34,"34127",118,77,74,1,3,"PUM+J",0
6,"6158",13094,9945,9753,131,192,"PUM+J",52
21,"21029",1633,1276,1259,15,17,"PUM+J",2
32,"32036",1528,1217,1202,13,15,"PUM+J",2
9,"9269",39,33,33,0,0,"PUM+J",0
7,"7029",4090,2921,2866,44,55,"PUM+J",3
14,"14017",10755,8220,8149,101,71,"PUM+J",5
28,"28064",143,112,110,1,2,"PUM+J",0
40,"40124",261,190,183,9,7,"PUM+J",1
6,"6068",481,383,378,3,5,"PUM+J",0
32,"32073",1415,1111,1100,8,11,"PUM+J",0
34,"34129",191,144,142,0,2,"PUM+J",0
50,"50175",1088,742,732,10,10,"PUM+J",1
13,"13022",403,314,314,2,0,"PUM+J",0
50,"50232",176,123,120,5,3,"PUM+J",1
6,"6023",4572,3301,3261,34,40,"PUM+J",4
41,"41039",31429,23337,23138,294,199,"PUM+J",23
10,"10209",297,217,213,3,4,"PUM+J",0
2,"2014",390,333,326,5,7,"PUM+J",0
47,"47056",90,69,69,2,0,"PUM+J",0
32,"32001",4938,3715,3667,50,48,"PUM+J",13
47,"47139",1080,845,833,11,12,"PUM+J",0
50,"50233",120,89,88,2,1,"PUM+J",1
16,"16030",28,24,24,0,0,"PUM+J",0
44,"44244",93,56,56,5,0,"PUM+J",0
32,"32074",1180,892,876,11,16,"PUM+J",2
9,"9366",99,67,65,1,2,"PUM+J",0
28,"28135",928,665,659,6,6,"PUM+J",0
6,"6070",7805,6083,6001,76,82,"PUM+J",14
31,"31213",114,58,58,0,0,"PUM+J",0
38,"38041",6780,4905,4813,57,92,"PUM+J",15
49,"49139",195,146,146,0,0,"PUM+J",0
32,"32076",2358,1835,1823,18,12,"PUM+J",3
40,"40031",515,410,404,7,6,"PUM+J",1
42,"42004",2383,1776,1740,30,36,"PUM+J",4
6,"6025",5083,3898,3851,51,47,"PUM+J",3
31,"31183",667,516,508,8,8,"PUM+J",3
44,"44207",187,147,146,5,1,"PUM+J",0
5,"5129",153,98,95,0,3,"PUM+J",0
34,"34005",899,707,698,8,9,"PUM+J",1
28,"28115",57612,46786,46458,458,328,"PUM+J",65
32,"32003",950,736,727,3,9,"PUM+J",0
50,"50148",365,256,251,2,5,"PUM+J",0
41,"41015",5263,3820,3752,34,68,"PUM+J",8
50,"50263",235,160,160,1,0,"PUM+J",0
18,"18112",132,90,90,1,0,"PUM+J",0
40,"40220",71,57,52,0,5,"PUM+J",0
35,"35010",3565,2178,2135,26,43,"PUM+J",3
16,"16073",214,170,170,2,0,"PUM+J",0
34,"34051",112,92,91,7,1,"PUM+J",0
40,"40033",61,48,47,3,1,"PUM+J",0
44,"44001",69,48,47,0,1,"PUM+J",0
10,"10131",12797,9017,8922,131,95,"PUM+J",21
9,"9019",153,104,104,1,0,"PUM+J",0
15,"15025",1173,780,777,10,3,"PUM+J",1
16,"16159",299,204,202,5,2,"PUM+J",0
10,"10132",420,293,287,1,6,"PUM+J",0
41,"41068",13809,10171,10072,100,99,"PUM+J",3
49,"49101",186,134,129,0,5,"PUM+J",1
28,"28116",666,507,498,5,9,"PUM+J",1
6,"6029",1230,884,880,5,4,"PUM+J",2
42,"42009",97,69,67,2,2,"PUM+J",0
49,"49236",86,64,64,0,0,"PUM+J",0
34,"34009",34,31,31,3,0,"PUM+J",0
42,"42051",23,12,11,0,1,"PUM+J",0
50,"50150",716,430,427,10,3,"PUM+J",0
9,"9141",607,503,481,10,22,"PUM+J",1
32,"32078",1366,1026,1018,3,8,"PUM+J",1
16,"16119",181,130,130,0,0,"PUM+J",0
9,"9059",137122,103909,102353,2008,1556,"PUM+J",258
40,"40130",139,106,106,4,0,"PUM+J",0
49,"49102",217,178,176,3,2,"PUM+J",0
47,"47143",146,108,107,0,1,"PUM+J",0
9,"9060",171,142,142,0,0,"PUM+J",0
50,"50151",713,536,531,5,5,"PUM+J",1
7,"7002",6305,4188,4073,80,115,"PUM+J",9
34,"34011",406,327,327,4,0,"PUM+J",1
33,"33038",2442,1757,1725,14,32,"PUM+J",0
18,"18015",465,381,379,1,2,"PUM+J",0
47,"47060",262,220,218,1,2,"PUM+J",1
22,"22221",108,70,69,5,1,"PUM+J",1
50,"50293",492,339,338,6,1,"PUM+J",0
47,"47224",92,77,77,0,0,"PUM+J",0
28,"28005",132097,100509,99506,1069,1003,"PUM+J",110
9,"9417",43,38,38,0,0,"PUM+J",0
49,"49239",723,506,495,12,11,"PUM+J",1
13,"13028",10536,8503,8331,140,172,"PUM+J",4
47,"47061",266,227,223,0,4,"PUM+J",1
5,"5196",69,54,54,2,0,"PUM+J",0
40,"40132",75,50,50,1,0,"PUM+J",1
16,"16162",51,36,36,0,0,"PUM+J",0
13,"13029",102,90,89,0,1,"PUM+J",1
41,"41018",9457,6940,6867,66,73,"PUM+J",6
31,"31188",185,139,137,2,2,"PUM+J",5
34,"34137",31,24,24,3,0,"PUM+J",0
15,"15901",3855,2463,2419,48,44,"PUM+J",4
47,"47145",658,482,473,7,9,"PUM+J",1
9,"9375",42,30,30,1,0,"PUM+J",0
50,"50006",978,758,749,16,9,"PUM+J",0
16,"16083",58,30,30,1,0,"PUM+J",0
38,"38014",1446,1018,1007,8,11,"PUM+J",7
47,"47062",185,153,153,5,0,"PUM+J",0
50,"50267",648,450,441,8,9,"PUM+J",1
24,"24106",340,229,228,6,1,"PUM+J",1
49,"49107",160,113,111,2,2,"PUM+J",0
9,"9377",658,509,505,11,4,"PUM+J",0
24,"24027",1184,853,837,7,16,"PUM+J",2
47,"47198",71,56,56,2,0,"PUM+J",1
10,"10178",797,604,597,5,7,"PUM+J",1
34,"34185",72,48,45,0,3,"PUM+J",0
10,"10098",412,317,313,5,4,"PUM+J",0
2,"2024",3424,2765,2726,32,39,"PUM+J",2
50,"50065",59,37,37,2,0,"PUM+J",0
26,"26084",5999,4440,4399,56,41,"PUM+J",28
47,"47118",159,122,122,2,0,"PUM+J",0
32,"32011",1026,660,650,4,10,"PUM+J",1
50,"50241",634,462,455,2,7,"PUM+J",0
5,"5266",112,92,89,0,3,"PUM+J",0
44,"44094",116,105,103,4,2,"PUM+J",0
18,"18018",658,520,514,4,6,"PUM+J",0
40,"40138",2195,1758,1725,18,33,"PUM+J",1
31,"31160",111,93,93,7,0,"PUM+J",0
49,"49151",680,494,491,6,3,"PUM+J",1
24,"24151",514,391,387,6,4,"PUM+J",0
31,"31221",1182,774,767,12,7,"PUM+J",2
32,"32048",1004,687,671,48,16,"PUM+J",0
31,"31222",67,46,44,3,2,"PUM+J",0
26,"26173",10,10,10,1,0,"PUM+J",0
47,"47119",101,78,77,0,1,"PUM+J",0
9,"9380",85,71,71,1,0,"PUM+J",0
26,"26004",82,64,64,1,0,"PUM+J",0
16,"16042",1286,1101,1089,8,12,"PUM+J",0
32,"32049",863,566,563,7,3,"PUM+J",1
5,"5040",77,59,59,1,0,"PUM+J",0
33,"33042",4434,3172,3135,43,37,"PUM+J",3
49,"49197",187,126,126,3,0,"PUM+J",0
10,"10903",813,620,615,3,5,"PUM+J",0
21,"21040",3096,2370,2351,28,19,"PUM+J",1
13,"13033",1719,1436,1419,6,17,"PUM+J",0
10,"10141",289,209,209,0,0,"PUM+J",0
10,"10101",172,134,129,1,5,"PUM+J",0
47,"47121",590,495,490,4,5,"PUM+J",0
40,"40141",881,658,647,9,11,"PUM+J",4
28,"28008",1734,1244,1221,11,23,"PUM+J",0
50,"50067",14124,10049,9870,203,179,"PUM+J",15
22,"22229",127,93,89,4,4,"PUM+J",0
5,"5201",557,444,437,2,7,"PUM+J",0
10,"10019",1414,1054,1037,10,17,"PUM+J",5
44,"44097",158,97,95,1,2,"PUM+J",1
5,"5107",74,54,53,0,1,"PUM+J",0
34,"34020",63,44,44,0,0,"PUM+J",1
9,"9289",1540,1127,1117,16,10,"PUM+J",1
31,"31224",980,691,681,9,10,"PUM+J",1
6,"6132",876,656,648,2,8,"PUM+J",2
40,"40047",47,37,36,0,1,"PUM+J",0
41,"41023",7901,6050,5972,45,78,"PUM+J",1
15,"15042",3249,2341,2303,25,38,"PUM+J",2
34,"34146",60,42,40,1,2,"PUM+J",0
26,"26134",102,82,80,2,2,"PUM+J",0
42,"42216",27,22,22,0,0,"PUM+J",0
22,"22036",101,82,82,1,0,"PUM+J",0
24,"24112",323,230,228,0,2,"PUM+J",0
50,"50157",313,253,250,7,3,"PUM+J",2
13,"13035",1043,794,770,10,24,"PUM+J",1
9,"9425",561,431,418,3,13,"PUM+J",0
50,"50011",131,113,113,8,0,"PUM+J",0
26,"26008",1909,1544,1527,19,17,"PUM+J",2
47,"47150",338,273,271,2,2,"PUM+J",0
6,"6042",1017,824,820,5,4,"PUM+J",1
18,"18122",16253,12271,12109,132,162,"PUM+J",17
41,"41091",545464,388043,383816,5325,4227,"PUM+J",689
31,"31195",186,127,126,1,1,"PUM+J",0
7,"7011",26954,16786,16595,299,191,"PUM+J",20
44,"44101",60,47,47,1,0,"PUM+J",0
49,"49249",78,63,63,0,0,"PUM+J",0
9,"9162",122,94,93,1,1,"PUM+J",2
44,"44221",377,305,297,6,8,"PUM+J",0
22,"22080",288,217,217,4,0,"PUM+J",0
24,"24074",107,87,87,0,0,"PUM+J",0
10,"10023",854,688,682,9,6,"PUM+J",2
2,"2031",626,507,502,3,5,"PUM+J",0
26,"26136",111,90,90,3,0,"PUM+J",0
6,"6044",28321,21143,20931,232,212,"PUM+J",53
18,"18157",1062,793,783,9,10,"PUM+J",2
31,"31165",2868,2094,2046,43,48,"PUM+J",6
9,"9248",63,52,52,0,0,"PUM+J",1
26,"26138",4646,3468,3398,46,70,"PUM+J",8
32,"32018",1351,1100,1092,9,8,"PUM+J",3
41,"41025",1999,1502,1476,13,26,"PUM+J",2
9,"9206",65,56,55,2,1,"PUM+J",0
42,"42171",158,99,94,3,5,"PUM+J",0
44,"44223",80,55,55,0,0,"PUM+J",0
9,"9388",32,25,24,2,1,"PUM+J",0
5,"5044",301,217,217,3,0,"PUM+J",0
22,"22131",96,79,77,2,2,"PUM+J",0
24,"24158",333,223,223,6,0,"PUM+J",0
40,"40905",143,103,103,1,0,"PUM+J",0
49,"49026",236,189,184,3,5,"PUM+J",0
16,"16228",202,146,144,2,2,"PUM+J",0
31,"31229",46,38,37,0,1,"PUM+J",0
26,"26095",126,102,102,0,0,"PUM+J",0
33,"33023",3410,2501,2485,40,16,"PUM+J",1
31,"31259",503,341,336,6,5,"PUM+J",0
7,"7014",6697,3818,3757,38,61,"PUM+J",5
22,"22083",522,437,428,4,9,"PUM+J",0
44,"44224",26,15,15,0,0,"PUM+J",0
9,"9250",295,234,230,5,4,"PUM+J",0
47,"47153",135,94,93,1,1,"PUM+J",0
18,"18057",5045,3755,3721,44,34,"PUM+J",4
28,"28012",830,654,651,6,3,"PUM+J",0
7,"7015",20783,12244,12016,381,228,"PUM+J",35
16,"16231",47,43,43,0,0,"PUM+J",0
26,"26053",221,177,173,5,4,"PUM+J",0
50,"50247",794,572,567,7,5,"PUM+J",0
24,"24160",741,545,539,17,6,"PUM+J",0
35,"35023",11640,8412,8178,97,234,"PUM+J",14
49,"49119",245,194,191,2,3,"PUM+J",0
42,"42175",28,19,19,0,0,"PUM+J",0
32,"32021",1043,793,788,7,5,"PUM+J",0
10,"10027",88,78,78,0,0,"PUM+J",0
49,"49257",277,180,179,0,1,"PUM+J",1
50,"50102",918,722,713,12,9,"PUM+J",1
34,"34029",832,696,683,11,13,"PUM+J",0
34,"34069",2330,1769,1749,25,20,"PUM+J",4
22,"22242",75,53,52,0,1,"PUM+J",0
28,"28013",38226,27886,27547,246,339,"PUM+J",36
47,"47071",406,333,329,6,4,"PUM+J",2
31,"31199",161,103,103,1,0,"PUM+J",1
40,"40198",30,21,20,0,1,"PUM+J",0
10,"10192",910,679,670,3,9,"PUM+J",1
26,"26056",440,345,339,4,6,"PUM+J",0
10,"10111",1453,1052,1046,13,6,"PUM+J",0
9,"9168",329,254,254,2,0,"PUM+J",0
21,"21079",749,556,553,6,3,"PUM+J",0
40,"40152",750,615,595,4,20,"PUM+J",2
22,"22243",45,27,27,1,0,"PUM+J",0
41,"41055",15121,11082,10997,98,85,"PUM+J",3
24,"24120",379,258,256,3,2,"PUM+J",1
47,"47073",141,118,116,1,2,"PUM+J",0
44,"44108",352,228,225,8,3,"PUM+J",2
31,"31231",127,93,91,1,2,"PUM+J",0
34,"34157",2471,1936,1912,26,24,"PUM+J",4
18,"18162",947,726,721,8,5,"PUM+J",0
49,"49031",150,128,127,2,1,"PUM+J",0
5,"5115",590,458,450,1,8,"PUM+J",0
44,"44021",114,81,77,1,4,"PUM+J",0
49,"49259",121,88,87,1,1,"PUM+J",0
15,"15021",5114,3527,3475,77,52,"PUM+J",5
49,"49080",736,571,560,5,11,"PUM+J",1
21,"21019",645,464,458,2,6,"PUM+J",0
2,"2001",731,601,584,6,17,"PUM+J",0
15,"15049",1211,851,843,7,8,"PUM+J",1
41,"41030",527,436,429,6,7,"PUM+J",0
9,"9304",197,168,165,1,3,"PUM+J",1
24,"24205",995,719,712,9,7,"PUM+J",1
40,"40014",60,39,39,1,0,"PUM+J",0
24,"24084",182,133,132,1,1,"PUM+J",0
40,"40108",120,83,82,1,1,"PUM+J",0
22,"22047",228,200,200,5,0,"PUM+J",1
2,"2002",479,411,407,3,4,"PUM+J",1
6,"6008",636,561,552,6,9,"PUM+J",2
6,"6100",1000,828,821,3,7,"PUM+J",0
42,"42078",1110,829,817,15,12,"PUM+J",0
40,"40201",48,48,48,2,0,"PUM+J",0
24,"24165",400,284,279,4,5,"PUM+J",0
40,"40156",361,268,264,5,4,"PUM+J",0
7,"7053",1133,863,839,16,24,"PUM+J",3
9,"9216",390,278,272,2,6,"PUM+J",0
7,"7020",3455,2491,2453,46,38,"PUM+J",2
5,"5117",213,183,180,0,3,"PUM+J",0
50,"50252",5345,3860,3792,79,68,"PUM+J",1
18,"18165",3942,2819,2776,27,43,"PUM+J",1
40,"40203",814,643,631,14,12,"PUM+J",0
34,"34074",764,610,597,11,13,"PUM+J",1
34,"34904",355,247,241,3,6,"PUM+J",0
38,"38030",1875,1320,1301,11,19,"PUM+J",1
42,"42080",168,115,114,0,1,"PUM+J",1
31,"31143",105,62,58,2,4,"PUM+J",1
34,"34161",23,20,20,0,0,"PUM+J",0
22,"22090",115,82,82,5,0,"PUM+J",0
18,"18903",960,761,753,1,8,"PUM+J",1
18,"18135",4752,3252,3212,34,40,"PUM+J",2
49,"49221",266,148,147,6,1,"PUM+J",1
47,"47159",862,704,695,20,9,"PUM+J",2
22,"22006",319,203,197,5,6,"PUM+J",0
28,"28038",4999,3659,3590,32,69,"PUM+J",3
21,"21053",3278,2363,2325,20,38,"PUM+J",1
10,"10035",1941,1517,1492,15,25,"PUM+J",5
31,"31235",189,111,110,0,1,"PUM+J",0
44,"44113",79,57,55,0,2,"PUM+J",1
7,"7022",11700,7512,7371,128,141,"PUM+J",17
50,"50108",50,31,31,0,0,"PUM+J",0
9,"9006",68,40,39,1,1,"PUM+J",0
2,"2006",612,540,534,1,6,"PUM+J",0
35,"35002",21673,14480,14253,172,227,"PUM+J",37
24,"24210",532,329,328,2,1,"PUM+J",0
15,"15081",1139,869,853,9,16,"PUM+J",0
22,"22149",321,244,241,5,3,"PUM+J",0
9,"9175",143,99,98,0,1,"PUM+J",0
50,"50254",179,136,136,0,0,"PUM+J",0
40,"40160",120,94,92,2,2,"PUM+J",0
31,"31205",465,335,325,9,10,"PUM+J",0
41,"41100",1097,894,878,8,16,"PUM+J",1
24,"24009",362,188,184,0,4,"PUM+J",0
22,"22008",194,168,167,11,1,"PUM+J",1
24,"24049",1528,1144,1124,22,20,"PUM+J",0
50,"50197",89,65,65,3,0,"PUM+J",0
44,"44115",121,100,100,0,0,"PUM+J",0
18,"18035",1254,991,982,7,9,"PUM+J",0
24,"24090",366,225,224,2,1,"PUM+J",0
40,"40020",200,155,149,2,6,"PUM+J",0
47,"47187",101,82,81,1,1,"PUM+J",0
50,"50110",424,315,314,6,1,"PUM+J",0
7,"7057",7102,4702,4611,85,91,"PUM+J",12
6,"6060",5865,4657,4592,67,65,"PUM+J",2
31,"31206",2079,1517,1475,33,42,"PUM+J",9
22,"22251",391,288,278,4,10,"PUM+J",1
2,"2045",3763,3086,3035,42,51,"PUM+J",2
9,"9405",143,106,105,2,1,"PUM+J",0
31,"31116",71,48,48,2,0,"PUM+J",0
24,"24130",468,343,337,6,6,"PUM+J",1
35,"35030",8295,5433,5315,54,118,"PUM+J",7
31,"31239",302,229,224,7,5,"PUM+J",0
49,"49131",312,227,225,7,2,"PUM+J",0
35,"35004",35462,18498,18196,325,302,"PUM+J",34
26,"26154",12,12,12,3,0,"PUM+J",0
41,"41035",1171,898,889,12,9,"PUM+J",1
9,"9132",174,129,127,3,2,"PUM+J",3
32,"32032",8284,6295,6198,84,97,"PUM+J",5
49,"49132",338,245,238,0,7,"PUM+J",1
49,"49269",241,171,170,5,1,"PUM+J",0
16,"16064",699,588,580,4,8,"PUM+J",0
42,"42141",124,90,87,1,3,"PUM+J",0
16,"16195",545,436,433,6,3,"PUM+J",0
5,"5187",1833,1385,1361,16,24,"PUM+J",1
44,"44238",2475,1718,1692,50,26,"PUM+J",6
5,"5253",95,75,74,0,1,"PUM+J",0
24,"24012",291,196,194,2,2,"PUM+J",0
10,"10163",374,310,308,0,2,"PUM+J",0
18,"18171",2093,1719,1704,10,15,"PUM+J",0
16,"16065",454,380,374,4,6,"PUM+J",0
6,"6018",808,608,598,5,10,"PUM+J",3
38,"38004",4522,3034,2975,33,59,"PUM+J",11
49,"49177",298,199,196,6,3,"PUM+J",0
15,"15056",5873,4205,4150,63,55,"PUM+J",3
7,"7060",2534,1724,1697,30,27,"PUM+J",2
28,"28020",145,102,100,0,2,"PUM+J",0
49,"49133",344,247,243,3,4,"PUM+J",0
24,"24133",379,279,279,0,0,"PUM+J",0
18,"18105",5222,3866,3839,32,27,"PUM+J",1
13,"13019",5254,4038,3978,62,60,"PUM+J",1
16,"16026",104,79,79,1,0,"PUM+J",1
22,"22014",265,192,191,1,1,"PUM+J",1
44,"44075",329,250,240,4,10,"PUM+J",0
40,"40166",275,247,246,2,1,"PUM+J",0
10,"10206",237,177,174,0,3,"PUM+J",0
31,"31241",164,117,116,4,1,"PUM+J",0
49,"49271",221,178,176,2,2,"PUM+J",1
50,"50084",84,64,64,1,0,"PUM+J",0
5,"5189",478,361,360,3,1,"PUM+J",0
42,"42089",54,44,44,3,0,"PUM+J",1
31,"31210",219,169,167,3,2,"PUM+J",1
47,"47164",391,326,320,3,6,"PUM+J",0
34,"34171",1071,762,753,16,9,"PUM+J",1
49,"49135",687,485,475,3,10,"PUM+J",2
50,"50231",285,231,224,7,7,"PUM+J",0
22,"22107",131,81,77,1,4,"PUM+J",0
18,"18909",668,536,534,2,2,"PUM+J",0
9,"9014",190,113,113,3,0,"PUM+J",0
31,"31211",25,14,14,2,0,"PUM+J",0
2,"2050",121,95,95,1,0,"PUM+J",0
34,"34047",1814,1435,1413,24,22,"PUM+J",4
24,"24096",145,96,93,0,3,"PUM+J",0
50,"50085",205,143,143,3,0,"PUM+J",0
24,"24218",476,344,340,11,4,"PUM+J",0
47,"47165",7036,5328,5258,67,70,"PUM+J",6
15,"15059",10658,7889,7728,125,161,"PUM+J",13
5,"5224",104,90,90,0,0,"PUM+J",0
24,"24057",1459,1121,1092,16,29,"PUM+J",1
9,"9365",38,27,27,0,0,"PUM+J",0
15,"15088",3769,2626,2599,21,27,"PUM+J",4
16,"16070",35,29,29,0,0,"PUM+J",0
31,"31121",79,53,52,2,1,"PUM+J",0
9,"9411",174,104,103,1,1,"PUM+J",2
50,"50176",237,161,160,4,1,"PUM+J",0
5,"5127",715,601,596,4,5,"PUM+J",0
16,"16254",213,166,165,2,1,"PUM+J",0
34,"34176",146,120,118,2,2,"PUM+J",0
47,"47166",276,226,223,0,3,"PUM+J",0
15,"15060",5599,4139,4069,82,70,"PUM+J",9
34,"34224",53,42,41,0,1,"PUM+J",0
18,"18911",6796,4923,4867,74,56,"PUM+J",6
24,"24019",367,293,287,5,6,"PUM+J",0
10,"10169",587,460,450,2,10,"PUM+J",0
22,"22018",357,272,271,4,1,"PUM+J",0
42,"42094",520,376,362,14,14,"PUM+J",0
15,"15004",4891,3595,3545,61,50,"PUM+J",3
26,"26074",128,102,101,0,1,"PUM+J",1
32,"32039",1424,1084,1069,10,15,"PUM+J",1
26,"26034",678,526,510,3,16,"PUM+J",4
31,"31214",95,64,64,1,0,"PUM+J",0
10,"10211",461,341,334,3,7,"PUM+J",0
40,"40173",148,121,120,3,1,"PUM+J",0
18,"18177",463,285,281,4,4,"PUM+J",0
16,"16204",306,235,235,5,0,"PUM+J",0
44,"44125",78,57,57,1,0,"PUM+J",0
5,"5030",43,39,39,0,0,"PUM+J",0
6,"6901",2113,1729,1706,26,23,"PUM+J",4
24,"24223",2793,2121,2113,63,8,"PUM+J",3
28,"28067",3893,2996,2950,26,46,"PUM+J",4
49,"49142",264,180,179,2,1,"PUM+J",1
34,"34089",173,128,125,5,3,"PUM+J",0
9,"9451",244,208,202,1,6,"PUM+J",1
26,"26076",144,124,123,3,1,"PUM+J",0
31,"31063",96,77,75,0,2,"PUM+J",1
18,"18078",768,638,637,1,1,"PUM+J",1
50,"50119",997,740,720,13,20,"PUM+J",0
42,"42097",19,16,16,0,0,"PUM+J",0
47,"47059",108,77,76,1,1,"PUM+J",0
47,"47142",172,132,131,2,1,"PUM+J",0
18,"18114",678,508,508,6,0,"PUM+J",1
42,"42201",27,24,24,2,0,"PUM+J",0
9,"9326",156,119,114,2,5,"PUM+J",0
9,"9143",24,14,14,1,0,"PUM+J",0
26,"26077",15,15,15,1,0,"PUM+J",0
49,"49011",236,195,194,5,1,"PUM+J",0
47,"47168",32,29,28,1,1,"PUM+J",0
16,"16034",207,174,173,0,1,"PUM+J",0
40,"40177",171,145,145,2,0,"PUM+J",1
22,"22170",622,439,430,13,9,"PUM+J",0
16,"16205",126,94,93,0,1,"PUM+J",0
50,"50207",126,97,95,1,2,"PUM+J",0
5,"5262",378,308,307,2,1,"PUM+J",0
41,"41069",28331,21065,20877,252,188,"PUM+J",24
10,"10174",177,145,145,2,0,"PUM+J",0
26,"26038",93,71,69,1,2,"PUM+J",1
44,"44087",98,87,87,2,0,"PUM+J",1
28,"28004",5761,4098,4044,38,54,"PUM+J",0
31,"31095",83,70,70,1,0,"PUM+J",0
9,"9021",62,33,33,1,0,"PUM+J",0
7,"7036",25502,17151,16914,294,237,"PUM+J",34
50,"50062",1750,1298,1275,22,23,"PUM+J",2
21,"21066",522,440,431,4,9,"PUM+J",0
5,"5132",1040,770,753,2,17,"PUM+J",1
16,"16211",462,317,313,2,4,"PUM+J",0
10,"10053",303,253,246,5,7,"PUM+J",0
13,"13094",338,276,275,2,1,"PUM+J",0
26,"26039",44,38,36,1,2,"PUM+J",0
24,"24024",717,501,498,10,3,"PUM+J",0
34,"34094",64,47,44,1,3,"PUM+J",0
24,"24146",284,223,221,0,2,"PUM+J",0
47,"47009",117,88,88,1,0,"PUM+J",0
44,"44130",38,27,27,0,0,"PUM+J",0
5,"5036",136,107,106,0,1,"PUM+J",0
21,"21067",418,318,312,5,6,"PUM+J",0
9,"9418",79,60,58,0,2,"PUM+J",0
28,"28140",2665,2167,2141,26,26,"PUM+J",3
24,"24148",1759,1362,1348,29,14,"PUM+J",3
31,"31006",1988,1434,1395,22,39,"PUM+J",1
24,"24026",1304,1015,1001,17,14,"PUM+J",2
15,"15065",7570,5710,5628,71,82,"PUM+J",5
42,"42055",183,128,127,4,1,"PUM+J",0
40,"40086",738,628,619,12,9,"PUM+J",2
50,"50035",78,61,56,2,5,"PUM+J",0
16,"16213",39,32,32,1,0,"PUM+J",0
42,"42056",26,23,22,1,1,"PUM+J",0
31,"31128",406,261,261,4,0,"PUM+J",2
18,"18083",296,242,242,1,0,"PUM+J",0
9,"9149",37,25,25,0,0,"PUM+J",0
44,"44045",373,303,301,4,2,"PUM+J",1
49,"49241",275,225,221,2,4,"PUM+J",0
41,"41072",4083,3073,3046,12,27,"PUM+J",0
5,"5038",131,88,84,0,4,"PUM+J",0
6,"6035",1048,879,871,5,8,"PUM+J",0
32,"32047",2003,1595,1575,10,20,"PUM+J",4
5,"5232",106,84,80,1,4,"PUM+J",0
44,"44257",184,132,131,6,1,"PUM+J",0
21,"21039",313,233,232,2,1,"PUM+J",0
26,"26043",397,313,306,6,7,"PUM+J",2
13,"13064",1465,1127,1110,21,17,"PUM+J",3
22,"22074",311,227,219,5,8,"PUM+J",0
50,"50008",5110,3458,3406,56,52,"PUM+J",4
9,"9241",198,159,158,5,1,"PUM+J",1
42,"42057",197,133,133,6,0,"PUM+J",0
41,"41046",3055,2456,2418,23,38,"PUM+J",1
13,"13097",2309,1843,1825,20,18,"PUM+J",4
49,"49062",142,104,104,1,0,"PUM+J",0
31,"31252",91,60,58,0,2,"PUM+J",0
47,"47099",174,153,153,4,0,"PUM+J",1
6,"6082",373,315,311,3,4,"PUM+J",0
34,"34234",72,56,55,1,1,"PUM+J",0
47,"47012",134,105,105,0,0,"PUM+J",0
13,"13065",3011,2105,2088,24,17,"PUM+J",2
26,"26130",229,181,177,0,4,"PUM+J",0
6,"6038",816,621,620,6,1,"PUM+J",1
40,"40139",302,243,238,5,5,"PUM+J",3
41,"41021",20767,14040,13822,240,218,"PUM+J",30
6,"6039",1848,1564,1546,13,18,"PUM+J",1
9,"9242",93,82,82,2,0,"PUM+J",0
24,"24030",4397,3272,3229,54,43,"PUM+J",6
18,"18086",397,321,321,3,0,"PUM+J",0
31,"31223",1043,783,771,14,12,"PUM+J",1
49,"49245",296,218,218,2,0,"PUM+J",0
9,"9243",87,66,64,2,2,"PUM+J",0
24,"24153",253,201,199,4,2,"PUM+J",0
40,"40045",123,102,102,0,0,"PUM+J",1
13,"13066",2444,2094,2065,15,29,"PUM+J",1
49,"49020",323,275,272,1,3,"PUM+J",0
42,"42164",1699,1244,1209,13,35,"PUM+J",3
50,"50185",150,109,109,2,0,"PUM+J",0
49,"49154",147,104,102,1,2,"PUM+J",0
47,"47175",6562,5041,4957,62,84,"PUM+J",9
34,"34190",59,42,42,4,0,"PUM+J",0
15,"15013",6160,4229,4165,70,64,"PUM+J",4
31,"31071",17,15,15,0,0,"PUM+J",0
18,"18121",135,109,109,0,0,"PUM+J",0
21,"21011",3531,2672,2639,15,33,"PUM+J",2
10,"10183",1022,818,805,5,13,"PUM+J",0
38,"38019",12624,8174,8099,65,75,"PUM+J",16
10,"10061",1765,1305,1290,13,15,"PUM+J",3
44,"44051",2783,2144,2089,38,55,"PUM+J",5
2,"2029",3210,2512,2481,37,31,"PUM+J",5
28,"28122",504,367,366,2,1,"PUM+J",0
26,"26049",189,141,137,1,4,"PUM+J",0
9,"9030",135,97,97,2,0,"PUM+J",0
9,"9292",98,73,71,3,2,"PUM+J",0
9,"9338",220,173,168,5,5,"PUM+J",1
24,"24155",524,428,420,6,8,"PUM+J",0
50,"50040",98,77,76,2,1,"PUM+J",0
49,"49156",265,217,214,6,3,"PUM+J",0
47,"47176",229,157,157,0,0,"PUM+J",0
31,"31103",51,40,40,3,0,"PUM+J",0
16,"16089",386,310,308,10,2,"PUM+J",0
22,"22129",193,124,123,4,1,"PUM+J",0
44,"44014",2603,1965,1912,25,53,"PUM+J",8
49,"49023",1033,736,728,10,8,"PUM+J",1
31,"31134",195,134,132,3,2,"PUM+J",1
9,"9339",139,105,104,1,1,"PUM+J",0
2,"2067",1197,938,924,6,14,"PUM+J",0
26,"26050",114,84,81,1,3,"PUM+J",0
28,"28075",5127,3976,3916,42,60,"PUM+J",7
10,"10186",1031,906,896,8,10,"PUM+J",2
2,"2068",379,290,284,3,6,"PUM+J",2
9,"9295",78,54,53,0,1,"PUM+J",0
31,"31105",1619,1306,1284,30,22,"PUM+J",5
31,"31196",40,35,35,1,0,"PUM+J",0
34,"34199",1354,1004,978,27,26,"PUM+J",1
28,"28032",4469,3412,3369,32,43,"PUM+J",6
5,"5142",113,97,96,0,1,"PUM+J",1
50,"50013",244,195,195,1,0,"PUM+J",0
18,"18054",879,646,644,4,2,"PUM+J",0
34,"34107",91,67,67,4,0,"PUM+J",0
40,"40099",61,52,52,2,0,"PUM+J",0
49,"49116",401,308,305,4,3,"PUM+J",1
47,"47152",94,65,65,0,0,"PUM+J",0
21,"21015",728,453,447,6,6,"PUM+J",0
9,"9343",94,77,76,0,1,"PUM+J",1
9,"9034",301,250,250,3,0,"PUM+J",0
16,"16279",251,175,172,1,3,"PUM+J",0
6,"6137",1035,848,842,2,6,"PUM+J",2
28,"28169",1244,971,962,8,9,"PUM+J",1
6,"6046",1288,1050,1042,11,8,"PUM+J",1
31,"31136",438,283,283,10,0,"PUM+J",0
47,"47069",128,108,108,0,0,"PUM+J",0
6,"6092",592,468,456,5,12,"PUM+J",0
50,"50275",103,76,76,0,0,"PUM+J",0
10,"10067",10392,7979,7804,111,175,"PUM+J",17
50,"50190",751,576,565,7,11,"PUM+J",3
22,"22133",123,87,85,2,2,"PUM+J",2
32,"32057",608,475,473,4,2,"PUM+J",1
38,"38024",14851,9589,9399,93,190,"PUM+J",24
16,"16234",52,38,36,0,2,"PUM+J",0
15,"15018",1211,821,805,11,16,"PUM+J",1
31,"31197",69,58,57,1,1,"PUM+J",0
9,"9298",90,74,74,1,0,"PUM+J",0
18,"18103",803,653,647,5,6,"PUM+J",2
49,"49163",235,167,167,0,0,"PUM+J",1
47,"47097",345,291,289,7,2,"PUM+J",0
24,"24001",241,148,147,3,1,"PUM+J",1
18,"18094",2398,1882,1868,16,14,"PUM+J",1
26,"26055",38,32,30,0,2,"PUM+J",0
9,"9167",60,49,49,2,0,"PUM+J",0
50,"50044",259,175,175,0,0,"PUM+J",0
10,"10068",780,624,595,5,29,"PUM+J",7
31,"31047",283,208,204,3,4,"PUM+J",1
33,"33047",1178,939,931,2,8,"PUM+J",0
44,"44020",23,15,15,0,0,"PUM+J",0
5,"5241",3145,2303,2273,27,30,"PUM+J",2
16,"16236",964,762,758,10,4,"PUM+J",2
6,"6140",654,533,523,7,10,"PUM+J",0
34,"34110",96,83,81,2,2,"PUM+J",0
6,"6141",1803,1419,1397,23,22,"PUM+J",1
50,"50192",240,188,184,9,4,"PUM+J",0
16,"16902",165,128,126,1,2,"PUM+J",0
28,"28171",4148,2972,2929,21,43,"PUM+J",1
28,"28150",2985,2363,2345,21,18,"PUM+J",1
34,"34071",186,160,160,1,0,"PUM+J",0
22,"22195",231,193,189,6,4,"PUM+J",1
31,"31048",154,118,117,0,1,"PUM+J",1
50,"50017",1734,1232,1212,41,20,"PUM+J",0
40,"40057",1522,1272,1260,19,12,"PUM+J",2
42,"42075",91,71,70,1,1,"PUM+J",0
42,"42177",78,64,62,4,2,"PUM+J",1
49,"49166",1294,1003,988,29,15,"PUM+J",2
31,"31262",219,158,157,4,1,"PUM+J",0
50,"50105",343,263,259,2,4,"PUM+J",0
24,"24203",109,73,73,0,0,"PUM+J",0
50,"50259",89,53,53,1,0,"PUM+J",0
34,"34072",189,169,166,2,3,"PUM+J",0
9,"9434",1167,916,902,24,14,"PUM+J",2
49,"49260",814,653,644,6,9,"PUM+J",2
33,"33026",9144,6019,5959,87,60,"PUM+J",2
22,"22001",242,177,173,2,4,"PUM+J",0
2,"2074",6093,4630,4548,57,82,"PUM+J",10
22,"22046",784,618,599,15,19,"PUM+J",0
28,"28151",3025,2237,2185,9,52,"PUM+J",1
16,"16239",158,114,112,2,2,"PUM+J",0
42,"42128",43,38,38,2,0,"PUM+J",0
28,"28015",14491,11562,11417,155,145,"PUM+J",14
40,"40059",124,104,104,2,0,"PUM+J",0
42,"42129",706,523,509,14,14,"PUM+J",1
26,"26019",365,296,295,6,1,"PUM+J",4
16,"16905",1017,811,806,14,5,"PUM+J",1
40,"40060",86,65,64,3,1,"PUM+J",0
49,"49216",175,144,142,3,2,"PUM+J",2
9,"9170",218,158,157,0,1,"PUM+J",0
50,"50194",102,67,67,2,0,"PUM+J",0
38,"38029",1456,732,715,4,17,"PUM+J",1
28,"28036",2301,1809,1784,13,25,"PUM+J",14
16,"16143",20,14,13,1,1,"PUM+J",0
33,"33050",653,406,402,0,4,"PUM+J",0
50,"50195",48,38,38,1,0,"PUM+J",0
22,"22200",271,198,191,3,7,"PUM+J",1
5,"5181",39,26,26,0,0,"PUM+J",0
33,"33027",929,617,613,5,4,"PUM+J",0
31,"31203",30,25,25,0,0,"PUM+J",0
9,"9438",547,440,433,9,7,"PUM+J",4
5,"5052",102,91,91,0,0,"PUM+J",0
40,"40061",66,53,52,1,1,"PUM+J",0
16,"16242",367,315,313,4,2,"PUM+J",0
40,"40111",72,57,55,0,2,"PUM+J",1
40,"40158",24,18,17,0,1,"PUM+J",0
6,"6148",991,826,818,9,8,"PUM+J",5
31,"31901",15574,11165,10974,201,191,"PUM+J",67
10,"10117",264,174,174,2,0,"PUM+J",0
49,"49084",306,234,234,8,0,"PUM+J",0
34,"34076",632,524,520,13,4,"PUM+J",1
47,"47102",302,250,248,3,2,"PUM+J",0
2,"2078",967,770,756,9,14,"PUM+J",2
16,"16102",1320,1016,1007,15,9,"PUM+J",1
50,"50281",76,63,63,2,0,"PUM+J",0
22,"22202",146,120,120,1,0,"PUM+J",0
26,"26062",94,78,77,1,1,"PUM+J",0
47,"47077",291,232,232,1,0,"PUM+J",0
9,"9129",112,93,93,0,0,"PUM+J",0
18,"18034",510,377,375,2,2,"PUM+J",0
10,"10159",341,278,277,1,1,"PUM+J",0
50,"50051",886,677,671,9,6,"PUM+J",0
47,"47050",3557,2688,2651,50,37,"PUM+J",2
13,"13080",418,310,309,1,1,"PUM+J",0
10,"10199",181,142,140,1,2,"PUM+J",1
42,"42185",29,23,23,1,0,"PUM+J",0
40,"40205",292,221,220,2,1,"PUM+J",1
41,"41060",15176,10797,10693,114,104,"PUM+J",6
2,"2007",1139,923,916,0,7,"PUM+J",1
9,"9084",200,147,147,4,0,"PUM+J",0
50,"50298",5319,4023,3955,72,68,"PUM+J",5
16,"16245",430,338,329,2,9,"PUM+J",2
31,"31115",171,112,109,2,3,"PUM+J",0
44,"44156",57,40,38,1,2,"PUM+J",0
5,"5087",144,87,87,0,0,"PUM+J",0
9,"9176",60,47,45,2,2,"PUM+J",0
15,"15054",32172,20472,20154,519,318,"PUM+J",51
9,"9310",14,10,9,2,1,"PUM+J",0
40,"40068",39,32,32,0,0,"PUM+J",0
24,"24051",484,375,368,2,7,"PUM+J",0
34,"34216",65,50,50,1,0,"PUM+J",0
28,"28131",12664,9454,9342,100,112,"PUM+J",10
38,"38034",4092,3034,2983,30,51,"PUM+J",7
34,"34080",6066,4238,4169,57,69,"PUM+J",5
10,"10202",665,533,523,7,10,"PUM+J",1
38,"38001",17632,9601,9475,121,126,"PUM+J",32
40,"40208",828,650,638,7,12,"PUM+J",0
49,"49088",90,67,66,3,1,"PUM+J",0
34,"34218",486,366,365,3,1,"PUM+J",0
5,"5057",2593,2172,2152,16,20,"PUM+J",0
2,"2082",121,107,107,1,0,"PUM+J",0
18,"18005",366,279,277,3,2,"PUM+J",0
44,"44031",124,72,72,0,0,"PUM+J",0
40,"40210",110,71,67,1,4,"PUM+J",1
18,"18907",1997,1627,1612,5,15,"PUM+J",1
9,"9048",1565,1166,1148,20,18,"PUM+J",47
50,"50025",4569,3319,3271,68,48,"PUM+J",4
40,"40164",188,145,142,0,3,"PUM+J",0
26,"26081",23,17,17,0,0,"PUM+J",0
22,"22207",135,86,79,4,7,"PUM+J",0
9,"9444",81,54,52,1,2,"PUM+J",0
24,"24052",178,113,111,0,2,"PUM+J",0
26,"26111",266,203,200,4,3,"PUM+J",2
28,"28041",4006,3190,3154,45,36,"PUM+J",1
10,"10083",105,74,74,0,0,"PUM+J",0
44,"44158",1159,904,873,15,31,"PUM+J",2
7,"7027",20045,12873,12678,204,195,"PUM+J",27
24,"24215",169,121,120,1,1,"PUM+J",0
18,"18070",287,240,239,2,1,"PUM+J",0
49,"49043",304,256,256,6,0,"PUM+J",0
50,"50286",90,73,73,2,0,"PUM+J",0
5,"5157",256,187,183,0,4,"PUM+J",0
34,"34220",145,125,123,0,2,"PUM+J",0
32,"32034",1228,995,990,5,5,"PUM+J",0
41,"41037",3228,2510,2483,27,27,"PUM+J",0
28,"28063",268,209,203,4,6,"PUM+J",0
50,"50055",3592,2520,2473,59,47,"PUM+J",4
44,"44200",41,30,30,0,0,"PUM+J",0
44,"44240",168,135,132,2,3,"PUM+J",0
34,"34221",190,143,143,3,0,"PUM+J",1
31,"31149",2381,1626,1607,7,19,"PUM+J",0
31,"31179",558,384,384,3,0,"PUM+J",1
18,"18071",5589,4268,4205,44,63,"PUM+J",3
49,"49272",102,87,86,0,1,"PUM+J",0
28,"28178",1017,799,791,11,8,"PUM+J",0
40,"40214",243,204,199,0,5,"PUM+J",0
22,"22160",219,166,166,5,0,"PUM+J",0
32,"32072",3949,2881,2841,32,40,"PUM+J",4
31,"31150",234,163,162,5,1,"PUM+J",0
7,"7062",7206,4073,4035,72,38,"PUM+J",5
22,"22122",62,57,57,3,0,"PUM+J",0
24,"24175",1760,1324,1303,29,21,"PUM+J",1
26,"26071",8475,6088,5964,92,124,"PUM+J",39
50,"50202",182,125,122,2,3,"PUM+J",1
44,"44161",487,363,358,9,5,"PUM+J",0
18,"18175",11534,8772,8698,68,74,"PUM+J",8
50,"50203",1083,814,798,28,16,"PUM+J",1
49,"49137",179,149,147,2,2,"PUM+J",0
28,"28001",61,46,45,1,1,"PUM+J",0
49,"49096",188,149,146,2,3,"PUM+J",0
49,"49095",318,232,232,5,0,"PUM+J",3
5,"5190",61,48,48,3,0,"PUM+J",0
44,"44122",1441,1009,990,21,19,"PUM+J",2
28,"28158",632,505,495,4,10,"PUM+J",1
13,"13088",649,531,526,3,5,"PUM+J",0
47,"47191",113,81,80,1,1,"PUM+J",0
50,"50117",131,101,100,1,1,"PUM+J",0
28,"28089",3531,2786,2753,25,33,"PUM+J",4
7,"7063",1414,1050,1030,25,20,"PUM+J",7
28,"28114",148,110,110,0,0,"PUM+J",4
5,"5257",153,105,104,0,1,"PUM+J",0
16,"16113",3075,2363,2338,36,25,"PUM+J",3
22,"22904",908,660,653,14,7,"PUM+J",0
34,"34131",67,57,56,0,1,"PUM+J",0
9,"9272",319,225,225,5,0,"PUM+J",1
18,"18074",297,245,245,5,0,"PUM+J",0
24,"24177",477,325,319,3,6,"PUM+J",0
13,"13023",8731,6818,6732,94,86,"PUM+J",5
49,"49008",535,395,394,7,1,"PUM+J",0
5,"5128",361,288,280,3,8,"PUM+J",1
9,"9273",55,47,47,0,0,"PUM+J",0
28,"28045",30286,23148,22879,226,269,"PUM+J",39
26,"26075",377,297,289,4,8,"PUM+J",0
28,"28090",7899,6216,6131,60,85,"PUM+J",11
40,"40127",45,33,33,0,0,"PUM+J",0
22,"22215",137,90,90,1,0,"PUM+J",2
42,"42095",1575,1136,1106,40,30,"PUM+J",1
40,"40219",635,519,505,7,14,"PUM+J",1
44,"44038",112,94,92,3,2,"PUM+J",0
10,"10007",680,537,519,5,18,"PUM+J",1
50,"50030",232,164,160,1,4,"PUM+J",1
10,"10172",728,531,522,3,9,"PUM+J",1
50,"50178",325,228,225,4,3,"PUM+J",0
22,"22019",190,141,138,4,3,"PUM+J",0
42,"42096",316,218,215,9,3,"PUM+J",2
38,"38009",3910,2687,2633,31,54,"PUM+J",12
47,"47085",16967,12618,12472,208,146,"PUM+J",18
42,"42200",98,70,67,1,3,"PUM+J",0
6,"6119",680,539,534,3,5,"PUM+J",2
14,"14020",415,323,319,3,4,"PUM+J",0
5,"5064",117,94,93,4,1,"PUM+J",0
49,"49235",486,344,340,6,4,"PUM+J",2
24,"24061",1713,1223,1210,34,13,"PUM+J",4
44,"44208",32,23,23,1,0,"PUM+J",0
44,"44168",194,154,152,4,2,"PUM+J",0
31,"31185",541,377,374,2,3,"PUM+J",0
40,"40221",50,41,41,0,0,"PUM+J",1
50,"50061",228,191,183,3,8,"PUM+J",0
22,"22168",22,16,16,0,0,"PUM+J",0
38,"38044",2325,1550,1532,7,18,"PUM+J",2
28,"28025",426,336,332,2,4,"PUM+J",1
26,"26037",150,129,128,1,1,"PUM+J",0
35,"35011",23140,15550,15320,199,230,"PUM+J",39
42,"42008",69,50,50,0,0,"PUM+J",0
5,"5227",409,307,305,2,2,"PUM+J",0
5,"5164",34,24,24,0,0,"PUM+J",0
40,"40035",146,114,112,3,2,"PUM+J",2
49,"49055",115,96,95,1,1,"PUM+J",0
47,"47195",449,350,346,5,4,"PUM+J",0
50,"50004",613,445,441,6,4,"PUM+J",1
50,"50265",63,46,46,1,0,"PUM+J",0
49,"49146",330,268,265,6,3,"PUM+J",0
28,"28183",935,663,649,7,14,"PUM+J",1
44,"44210",754,573,567,3,6,"PUM+J",0
16,"16209",153,129,129,0,0,"PUM+J",0
50,"50033",81,64,64,0,0,"PUM+J",0
31,"31156",268,202,201,5,1,"PUM+J",0
49,"49056",324,251,247,3,4,"PUM+J",0
42,"42053",27,26,25,1,1,"PUM+J",0
31,"31066",915,660,647,19,13,"PUM+J",3
47,"47144",85,65,65,2,0,"PUM+J",0
26,"26080",529,427,425,2,2,"PUM+J",2
16,"16121",270,211,207,1,4,"PUM+J",0
9,"9061",187,146,144,1,2,"PUM+J",0
9,"9456",142,110,110,3,0,"PUM+J",0
6,"6124",1750,1418,1378,17,40,"PUM+J",1
49,"49058",341,262,259,4,3,"PUM+J",0
40,"40084",65,53,53,2,0,"PUM+J",0
42,"42206",10,9,9,1,0,"PUM+J",0
26,"26013",350,267,264,5,3,"PUM+J",1
9,"9236",41,38,37,0,1,"PUM+J",0
28,"28094",774,557,551,5,6,"PUM+J",1
42,"42054",20,14,14,0,0,"PUM+J",0
16,"16122",259,195,190,2,5,"PUM+J",0
24,"24065",2104,1512,1488,27,24,"PUM+J",0
50,"50238",114,82,80,0,2,"PUM+J",0
33,"33017",3289,2378,2350,35,28,"PUM+J",2
41,"41045",5505,3946,3889,68,57,"PUM+J",6
9,"9062",52,33,32,1,1,"PUM+J",0
7,"7038",1962,1504,1480,20,24,"PUM+J",2
44,"44173",107,87,77,5,10,"PUM+J",0
16,"16269",494,412,407,5,5,"PUM+J",0
42,"42207",49,37,34,0,3,"PUM+J",2
6,"6034",190,134,129,3,5,"PUM+J",0
9,"9419",82,61,61,0,0,"PUM+J",0
40,"40182",207,155,155,6,0,"PUM+J",1
40,"40041",1035,819,799,14,20,"PUM+J",1
5,"5135",440,363,360,0,3,"PUM+J",1
24,"24187",881,664,659,14,5,"PUM+J",2
33,"33063",467,367,363,4,4,"PUM+J",0
22,"22175",211,158,158,9,0,"PUM+J",1
21,"21069",1778,1245,1242,11,3,"PUM+J",0
16,"16124",1909,1573,1555,14,18,"PUM+J",1
9,"9332",137,88,85,1,3,"PUM+J",0
42,"42015",34,24,24,5,0,"PUM+J",0
32,"32084",1084,818,805,0,13,"PUM+J",0
31,"31008",97,64,63,1,1,"PUM+J",1
21,"21008",2717,1994,1978,11,16,"PUM+J",0
49,"49018",341,281,279,5,2,"PUM+J",0
34,"34058",212,179,178,0,1,"PUM+J",0
40,"40199",110,88,86,3,2,"PUM+J",1
22,"22045",104,83,80,2,3,"PUM+J",0
13,"13009",1573,1265,1255,6,10,"PUM+J",0
16,"16085",151,123,122,2,1,"PUM+J",0
31,"31069",860,660,647,2,13,"PUM+J",3
50,"50212",52,48,48,0,0,"PUM+J",1
22,"22029",130,99,98,6,1,"PUM+J",0
33,"33041",7488,5356,5309,65,47,"PUM+J",2
41,"41047",9810,7427,7321,99,106,"PUM+J",9
14,"14058",8116,6274,6215,76,59,"PUM+J",9
6,"6084",1105,932,917,5,15,"PUM+J",0
42,"42163",53,41,41,0,0,"PUM+J",0
40,"40185",977,725,712,13,13,"PUM+J",3
5,"5267",102,78,77,1,1,"PUM+J",0
41,"41074",3079,2406,2386,14,20,"PUM+J",0
42,"42212",75,45,45,2,0,"PUM+J",0
16,"16004",325,247,246,0,1,"PUM+J",0
40,"40233",457,350,348,1,2,"PUM+J",0
9,"9066",62,44,42,0,2,"PUM+J",0
26,"26087",222,180,178,5,2,"PUM+J",0
47,"47065",898,762,752,9,10,"PUM+J",1
31,"31254",1956,1495,1476,16,19,"PUM+J",5
31,"31162",53,35,34,1,1,"PUM+J",1
10,"10142",822,635,625,4,10,"PUM+J",0
44,"44178",69,45,44,0,1,"PUM+J",0
28,"28097",127,94,92,0,2,"PUM+J",0
47,"47122",2078,1697,1665,21,32,"PUM+J",1
24,"24154",1068,803,795,6,8,"PUM+J",2
49,"49021",14682,10495,10296,194,199,"PUM+J",24
50,"50270",39,30,29,1,1,"PUM+J",1
24,"24191",112,88,88,1,0,"PUM+J",1
42,"42061",297,190,188,4,2,"PUM+J",0
13,"13902",497,396,394,3,2,"PUM+J",0
9,"9471",171,127,125,1,2,"PUM+J",0
21,"21072",10233,7829,7666,124,163,"PUM+J",18
6,"6041",459,406,404,4,2,"PUM+J",0
21,"21012",331,254,246,2,8,"PUM+J",0
32,"32088",1749,1232,1217,10,15,"PUM+J",0
42,"42062",36,23,22,0,1,"PUM+J",0
44,"44099",724,519,511,4,8,"PUM+J",0
14,"14029",4380,3344,3308,35,36,"PUM+J",2
50,"50272",12481,8744,8642,176,102,"PUM+J",17
40,"40902",137,118,118,3,0,"PUM+J",0
47,"47204",275,221,219,3,2,"PUM+J",0
33,"33066",42885,29326,29013,460,313,"PUM+J",13
38,"38901",1389,917,907,16,10,"PUM+J",2
42,"42063",69,53,53,4,0,"PUM+J",0
34,"34104",274,224,224,4,0,"PUM+J",0
31,"31164",604,462,448,9,14,"PUM+J",1
6,"6134",561,399,398,5,1,"PUM+J",0
9,"9386",61,45,45,0,0,"PUM+J",0
13,"13003",503,390,387,2,3,"PUM+J",0
15,"15016",5135,3816,3771,22,45,"PUM+J",5
42,"42217",38,32,32,0,0,"PUM+J",0
49,"49203",345,294,292,4,2,"PUM+J",1
5,"5174",81,71,71,1,0,"PUM+J",0
40,"40904",332,271,268,5,3,"PUM+J",1
42,"42218",86,59,59,0,0,"PUM+J",1
34,"34241",20,12,11,0,1,"PUM+J",0
49,"49158",229,174,172,0,2,"PUM+J",0
34,"34106",121,100,99,2,1,"PUM+J",2
31,"31074",430,304,303,10,1,"PUM+J",1
16,"16009",79,63,62,0,1,"PUM+J",0
16,"16278",91,69,69,2,0,"PUM+J",0
34,"34066",66,55,54,0,1,"PUM+J",0
26,"26051",271,219,214,4,5,"PUM+J",1
18,"18188",1659,1329,1308,9,21,"PUM+J",0
10,"10187",486,349,345,2,4,"PUM+J",0
21,"21045",261,200,200,5,0,"PUM+J",0
35,"35021",14982,9948,9749,138,199,"PUM+J",20
42,"42068",99,74,74,5,0,"PUM+J",1
42,"42023",78,58,58,1,0,"PUM+J",0
50,"50274",78,45,45,1,0,"PUM+J",0
31,"31228",540,376,364,13,12,"PUM+J",2
24,"24198",644,423,417,7,6,"PUM+J",0
34,"34243",352,274,273,5,1,"PUM+J",0
50,"50101",922,648,637,8,11,"PUM+J",0
9,"9208",252,192,192,6,0,"PUM+J",1
49,"49075",153,128,122,0,6,"PUM+J",1
9,"9478",53,41,41,1,0,"PUM+J",0
31,"31167",859,600,593,11,7,"PUM+J",3
40,"40007",86,70,69,0,1,"PUM+J",0
44,"44055",85,63,62,2,1,"PUM+J",0
40,"40149",563,446,434,9,12,"PUM+J",0
15,"15046",6949,4641,4539,56,102,"PUM+J",6
47,"47070",33,30,30,1,0,"PUM+J",0
34,"34068",32,23,23,0,0,"PUM+J",0
41,"41010",4338,2990,2958,48,32,"PUM+J",5
28,"28111",618,486,479,2,7,"PUM+J",0
50,"50043",258,170,166,2,4,"PUM+J",0
28,"28170",2503,1744,1727,20,17,"PUM+J",2
6,"6094",1508,1130,1119,6,11,"PUM+J",0
14,"14004",2016,1560,1543,8,17,"PUM+J",0
31,"31077",5349,4025,3917,103,108,"PUM+J",18
28,"28056",782,604,586,6,18,"PUM+J",0
40,"40008",44,37,36,0,1,"PUM+J",0
16,"16177",86,68,68,0,0,"PUM+J",0
16,"16051",166,140,140,1,0,"PUM+J",0
42,"42123",172,128,128,3,0,"PUM+J",1
26,"26015",205,167,165,1,2,"PUM+J",0
31,"31169",2285,1621,1590,43,31,"PUM+J",1
24,"24201",1123,790,777,14,13,"PUM+J",1
10,"10028",125,88,88,0,0,"PUM+J",0
26,"26143",187,154,151,4,3,"PUM+J",1
10,"10151",245,204,202,2,2,"PUM+J",1
13,"13008",473,362,360,4,2,"PUM+J",0
44,"44147",439,320,314,14,6,"PUM+J",0
47,"47208",56,45,43,1,2,"PUM+J",0
44,"44060",42,34,34,0,0,"PUM+J",0
22,"22044",278,195,191,7,4,"PUM+J",1
2,"2036",104,78,78,0,0,"PUM+J",0
22,"22193",318,266,264,7,2,"PUM+J",1
42,"42073",84,53,53,0,0,"PUM+J",0
47,"47046",124,105,103,0,2,"PUM+J",0
5,"5211",484,406,405,3,1,"PUM+J",0
50,"50045",1289,1011,992,14,19,"PUM+J",0
6,"6006",4664,3435,3367,50,68,"PUM+J",1
31,"31200",763,527,514,17,13,"PUM+J",3
41,"41003",2196,1803,1782,21,21,"PUM+J",4
49,"49044",80,63,63,3,0,"PUM+J",0
10,"10085",334,244,243,1,1,"PUM+J",0
47,"47082",816,664,661,10,3,"PUM+J",3
13,"13010",910,729,726,8,3,"PUM+J",0
47,"47047",217,171,170,5,1,"PUM+J",0
47,"47182",1371,991,982,12,9,"PUM+J",0
34,"34033",17,15,15,0,0,"PUM+J",0
14,"14007",15871,11609,11477,121,132,"PUM+J",6
40,"40155",3083,2333,2280,73,53,"PUM+J",5
32,"32025",1218,954,941,12,13,"PUM+J",0
34,"34113",35,28,27,0,1,"PUM+J",0
21,"21020",398,282,282,3,0,"PUM+J",0
50,"50047",60,34,34,2,0,"PUM+J",0
24,"24083",1165,831,819,17,12,"PUM+J",1
15,"15022",6102,4207,4164,52,43,"PUM+J",4
31,"31080",544,428,426,7,2,"PUM+J",3
34,"34159",375,275,264,8,11,"PUM+J",2
13,"13011",5166,3555,3500,31,55,"PUM+J",7
34,"34073",184,153,152,7,1,"PUM+J",0
13,"13077",3654,2535,2480,31,55,"PUM+J",3
9,"9306",127,94,94,0,0,"PUM+J",0
31,"31050",6253,4045,3987,74,58,"PUM+J",4
10,"10195",7917,6143,6054,36,89,"PUM+J",7
16,"16057",109,82,82,1,0,"PUM+J",0
47,"47075",4999,4020,3957,39,63,"PUM+J",6
9,"9352",134,107,106,0,1,"PUM+J",1
34,"34116",76,50,49,1,1,"PUM+J",0
6,"6055",2105,1623,1599,13,24,"PUM+J",1
50,"50077",254,189,188,4,1,"PUM+J",1
10,"10075",276,189,189,1,0,"PUM+J",0
7,"7054",19930,11186,11028,196,158,"PUM+J",35
14,"14009",2864,2021,2003,8,18,"PUM+J",3
47,"47183",150,125,122,0,3,"PUM+J",0
44,"44151",215,143,140,1,3,"PUM+J",0
26,"26105",2181,1712,1690,24,22,"PUM+J",5
32,"32027",1156,850,836,15,14,"PUM+J",0
6,"6056",487,411,411,1,0,"PUM+J",0
16,"16190",5151,4229,4144,52,85,"PUM+J",4
41,"41032",4059,3122,3062,22,60,"PUM+J",2
40,"40017",103,89,88,2,1,"PUM+J",0
15,"15052",4567,3539,3493,22,46,"PUM+J",3
42,"42081",158,131,131,3,0,"PUM+J",0
21,"21022",173,123,123,1,0,"PUM+J",0
50,"50297",495260,360632,355561,7046,5071,"PUM+J",718
16,"16146",96,74,70,0,4,"PUM+J",0
50,"50050",109,73,73,1,0,"PUM+J",0
5,"5086",96,81,81,2,0,"PUM+J",0
33,"33074",3699,2643,2611,30,32,"PUM+J",1
33,"33029",420,243,241,3,2,"PUM+J",1
44,"44234",76,63,63,0,0,"PUM+J",0
49,"49085",1173,912,908,16,4,"PUM+J",1
26,"26063",131,104,102,2,2,"PUM+J",0
16,"16103",310,263,259,4,4,"PUM+J",0
6,"6150",860,722,710,2,12,"PUM+J",0
47,"47214",1517,1215,1191,34,24,"PUM+J",0
5,"5184",288,225,224,0,1,"PUM+J",0
49,"49223",770,606,601,8,5,"PUM+J",0
47,"47132",45,40,40,0,0,"PUM+J",0
40,"40206",179,136,134,0,2,"PUM+J",0
18,"18101",8990,6659,6556,96,103,"PUM+J",12
34,"34215",166,146,145,1,1,"PUM+J",0
49,"49038",114,81,80,0,1,"PUM+J",0
14,"14042",18991,14726,14495,290,231,"PUM+J",17
42,"42083",28,25,25,0,0,"PUM+J",1
47,"47051",351,269,256,5,13,"PUM+J",1
26,"26024",273,220,219,2,1,"PUM+J",0
14,"14011",595,498,497,4,1,"PUM+J",0
5,"5154",46,35,35,0,0,"PUM+J",0
41,"41101",5752,4663,4629,25,34,"PUM+J",1
34,"34123",1798,1479,1436,18,43,"PUM+J",2
14,"14012",6305,4749,4690,44,59,"PUM+J",6
13,"13082",25643,17973,17798,257,175,"PUM+J",16
50,"50023",240,180,180,4,0,"PUM+J",0
47,"47161",3886,3133,3105,45,28,"PUM+J",0
40,"40115",126,98,95,2,3,"PUM+J",0
7,"7025",457,355,346,3,9,"PUM+J",1
31,"31238",125,99,98,3,1,"PUM+J",0
7,"7058",2803,2100,2046,38,54,"PUM+J",5
31,"31055",264,194,193,0,1,"PUM+J",1
22,"22053",867,567,554,13,13,"PUM+J",0
49,"49090",207,168,168,4,0,"PUM+J",0
42,"42085",219,167,167,2,0,"PUM+J",0
24,"24131",813,583,580,9,3,"PUM+J",1
26,"26110",178,149,147,3,2,"PUM+J",0
18,"18138",2460,1751,1741,1,10,"PUM+J",0
47,"47216",124,99,98,2,1,"PUM+J",1
24,"24092",883,707,702,6,5,"PUM+J",0
44,"44071",657,453,448,9,5,"PUM+J",3
49,"49104",383,281,276,2,5,"PUM+J",1
47,"47225",89,67,66,0,1,"PUM+J",0
6,"6063",3079,2467,2454,16,13,"PUM+J",2
47,"47135",93,77,76,0,1,"PUM+J",0
18,"18037",488,408,404,0,4,"PUM+J",0
9,"9266",87,72,72,0,0,"PUM+J",1
22,"22253",71,54,54,1,0,"PUM+J",0
49,"49176",757,502,501,5,1,"PUM+J",0
5,"5220",386,316,312,0,4,"PUM+J",0
32,"32070",660,457,452,1,5,"PUM+J",0
47,"47081",57,44,44,1,0,"PUM+J",0
50,"50201",466,366,363,7,3,"PUM+J",1
5,"5023",177,160,158,1,2,"PUM+J",0
49,"49228",64,56,56,0,0,"PUM+J",0
42,"42088",69,56,56,1,0,"PUM+J",0
31,"31027",824,611,609,2,2,"PUM+J",0
9,"9315",362,267,265,9,2,"PUM+J",3
51,"51001",58533,32223,31745,498,478,"PUM+J",63
31,"31209",155,105,104,1,1,"PUM+J",0
9,"9012",105,77,74,3,3,"PUM+J",1
28,"28157",605,452,446,2,6,"PUM+J",0
5,"5059",112,91,88,1,3,"PUM+J",0
32,"32071",1614,1121,1112,4,9,"PUM+J",1
44,"44120",217,126,121,5,5,"PUM+J",0
5,"5125",60,52,52,0,0,"PUM+J",0
31,"31180",240,174,170,5,4,"PUM+J",0
26,"26030",12,12,12,0,0,"PUM+J",0
2,"2049",937,717,708,2,9,"PUM+J",1
44,"44201",526,449,443,9,6,"PUM+J",0
22,"22212",93,79,79,0,0,"PUM+J",0
16,"16153",1006,856,843,8,13,"PUM+J",0
9,"9463",261,205,205,1,0,"PUM+J",0
28,"28179",1385,1039,1027,10,12,"PUM+J",0
26,"26057",52,42,42,0,0,"PUM+J",0
31,"31028",217,129,128,1,1,"PUM+J",1
34,"34174",213,179,178,4,1,"PUM+J",2
33,"33034",11390,7583,7501,85,82,"PUM+J",3
47,"47003",263,224,222,1,2,"PUM+J",0
16,"16154",4946,3975,3914,58,61,"PUM+J",6
31,"31908",997,692,683,9,9,"PUM+J",6
34,"34175",101,80,80,2,0,"PUM+J",0
42,"42001",308,242,237,4,5,"PUM+J",0
38,"38006",35862,18726,18500,209,226,"PUM+J",55
21,"21060",11685,8026,7932,135,94,"PUM+J",10
10,"10087",1754,1283,1262,4,21,"PUM+J",0
15,"15087",6054,4004,3956,79,48,"PUM+J",5
5,"5061",264,222,214,5,8,"PUM+J",0
22,"22213",3152,2265,2230,62,35,"PUM+J",2
42,"42092",89,60,60,0,0,"PUM+J",0
10,"10128",5805,4456,4336,50,120,"PUM+J",9
31,"31182",45,28,28,2,0,"PUM+J",0
38,"38040",4697,3007,2962,31,45,"PUM+J",4
33,"33057",1635,1150,1132,16,18,"PUM+J",0
6,"6069",3116,2316,2288,46,28,"PUM+J",6
9,"9027",54,48,43,0,5,"PUM+J",0
50,"50086",193,109,109,0,0,"PUM+J",0
22,"22164",46,32,32,0,0,"PUM+J",0
42,"42151",38,32,29,0,3,"PUM+J",0
2,"2052",493,417,412,9,5,"PUM+J",0
32,"32038",497,360,358,2,2,"PUM+J",0
42,"42197",90,71,71,0,0,"PUM+J",0
6,"6116",1680,1331,1317,15,14,"PUM+J",0
47,"47031",203,149,149,0,0,"PUM+J",0
9,"9017",96,76,74,0,2,"PUM+J",0
31,"31122",4506,3333,3281,76,52,"PUM+J",25
50,"50177",355,268,265,4,3,"PUM+J",0
16,"16072",161,126,123,0,3,"PUM+J",0
50,"50002",166,130,130,2,0,"PUM+J",0
50,"50262",1216,916,904,20,12,"PUM+J",0
10,"10130",1745,1360,1341,10,19,"PUM+J",2
16,"16032",304,253,244,2,9,"PUM+J",0
34,"34178",106,93,93,1,0,"PUM+J",0
31,"31032",1785,1330,1305,24,25,"PUM+J",4
47,"47006",196,151,146,1,5,"PUM+J",0
41,"41067",7055,5368,5295,64,73,"PUM+J",5
34,"34133",108,90,90,0,0,"PUM+J",0
9,"9274",1160,924,914,14,10,"PUM+J",7
9,"9058",357,278,276,4,2,"PUM+J",0
42,"42049",141,83,81,1,2,"PUM+J",0
21,"21002",14281,10297,10173,141,124,"PUM+J",24
16,"16116",104,67,66,1,1,"PUM+J",1
24,"24143",515,376,373,6,3,"PUM+J",0
28,"28137",1626,1231,1222,9,9,"PUM+J",1
6,"6902",1688,1325,1313,21,12,"PUM+J",1
18,"18146",1059,791,776,2,15,"PUM+J",1
22,"22167",515,417,399,16,18,"PUM+J",0
40,"40129",203,166,162,1,4,"PUM+J",0
22,"22021",2080,1524,1505,31,19,"PUM+J",4
18,"18179",583,417,409,7,8,"PUM+J",0
49,"49237",157,110,110,0,0,"PUM+J",0
22,"22064",184,139,137,3,2,"PUM+J",0
9,"9325",217,151,148,1,3,"PUM+J",0
9,"9020",276,222,222,6,0,"PUM+J",0
50,"50089",6673,4936,4877,120,59,"PUM+J",13
9,"9387",121,92,91,3,1,"PUM+J",0
10,"10024",663,490,480,3,10,"PUM+J",0
50,"50292",138,117,115,4,2,"PUM+J",0
34,"34229",75,60,60,2,0,"PUM+J",1
41,"41017",13878,10053,9926,130,127,"PUM+J",17
33,"33015",1695,1177,1161,12,16,"PUM+J",0
18,"18014",5667,4132,4085,43,47,"PUM+J",3
10,"10147",1263,1003,965,5,38,"PUM+J",1
5,"5110",710,584,581,1,3,"PUM+J",0
9,"9373",485,332,331,5,1,"PUM+J",0
9,"9416",61,44,44,0,0,"PUM+J",0
5,"5229",90,79,77,2,2,"PUM+J",0
28,"28117",116,90,90,1,0,"PUM+J",0
31,"31187",122,68,68,2,0,"PUM+J",1
47,"47087",376,320,315,7,5,"PUM+J",0
38,"38045",4181,2176,2140,13,36,"PUM+J",1
44,"44004",450,334,332,2,2,"PUM+J",0
22,"22023",474,382,380,4,2,"PUM+J",1
6,"6077",373,307,304,4,3,"PUM+J",0
41,"41044",6838,5064,5005,67,59,"PUM+J",4
50,"50181",1053,787,760,9,27,"PUM+J",1
26,"26125",2720,2121,2084,26,37,"PUM+J",10
5,"5101",297,224,222,4,2,"PUM+J",0
31,"31127",145,89,89,2,0,"PUM+J",1
33,"33016",19516,14345,14210,198,135,"PUM+J",4
9,"9119",51,38,38,0,0,"PUM+J",0
47,"47105",210,181,179,1,2,"PUM+J",0
10,"10176",384,300,293,5,7,"PUM+J",0
10,"10014",1907,1507,1488,14,19,"PUM+J",0
9,"9104",56,49,49,0,0,"PUM+J",0
31,"31097",10461,7152,7029,129,123,"PUM+J",33
7,"7004",3669,2511,2453,51,58,"PUM+J",6
47,"47089",184,139,138,1,1,"PUM+J",0
34,"34056",2147,1557,1535,21,22,"PUM+J",2
42,"42105",54,45,45,0,0,"PUM+J",0
40,"40040",2677,1990,1966,24,24,"PUM+J",2
24,"24185",512,414,402,3,12,"PUM+J",0
16,"16082",318,226,226,1,0,"PUM+J",1
42,"42106",15,14,14,0,0,"PUM+J",0
49,"49242",503,421,410,5,11,"PUM+J",0
44,"44007",194,152,145,3,7,"PUM+J",0
26,"26082",121,95,95,0,0,"PUM+J",0
44,"44131",26,20,20,0,0,"PUM+J",0
49,"49059",111,83,82,2,1,"PUM+J",0
5,"5134",47,37,37,0,0,"PUM+J",0
15,"15038",2363,1643,1610,29,33,"PUM+J",2
10,"10138",551,451,443,7,8,"PUM+J",1
26,"26172",35,29,29,0,0,"PUM+J",0
9,"9196",161,111,110,0,1,"PUM+J",0
35,"35015",9065,4859,4770,64,89,"PUM+J",4
44,"44215",156,100,100,2,0,"PUM+J",1
49,"49108",512,387,381,9,6,"PUM+J",0
16,"16041",395,289,287,6,2,"PUM+J",1
22,"22227",225,172,168,3,4,"PUM+J",0
10,"10179",340,262,257,3,5,"PUM+J",0
44,"44093",86,64,64,3,0,"PUM+J",0
34,"34099",56,49,47,1,2,"PUM+J",0
44,"44148",98,77,77,3,0,"PUM+J",1
18,"18085",818,538,532,4,6,"PUM+J",0
49,"49004",137,105,105,3,0,"PUM+J",0
50,"50250",58,43,43,4,0,"PUM+J",0
44,"44229",150,108,107,5,1,"PUM+J",0
28,"28143",81,71,67,1,4,"PUM+J",0
10,"10058",994,751,738,13,13,"PUM+J",0
33,"33019",3262,2283,2244,12,39,"PUM+J",4
13,"13032",1218,926,922,9,4,"PUM+J",0
34,"34141",190,162,160,0,2,"PUM+J",0
49,"49110",382,236,233,1,3,"PUM+J",0
50,"50155",119,91,91,1,0,"PUM+J",0
31,"31070",2706,1949,1912,34,37,"PUM+J",10
32,"32086",2874,2026,2003,18,23,"PUM+J",0
26,"26005",2251,1602,1580,18,22,"PUM+J",1
24,"24902",375,292,289,1,3,"PUM+J",2
22,"22076",331,241,235,3,6,"PUM+J",0
26,"26131",44,36,36,0,0,"PUM+J",0
16,"16169",75,44,44,0,0,"PUM+J",0
9,"9110",95,68,68,1,0,"PUM+J",0
26,"26006",1853,1456,1430,15,26,"PUM+J",6
10,"10059",414,352,349,4,3,"PUM+J",0
34,"34143",181,142,140,3,2,"PUM+J",0
34,"34060",150,123,123,2,0,"PUM+J",0
44,"44261",777,600,594,8,6,"PUM+J",0
33,"33020",13542,9300,9173,135,127,"PUM+J",4
5,"5106",39,26,26,0,0,"PUM+J",0
42,"42113",553,412,404,7,8,"PUM+J",1
5,"5074",755,639,638,5,1,"PUM+J",0
22,"22181",91,57,55,0,2,"PUM+J",0
10,"10102",534,447,440,4,7,"PUM+J",1
47,"47022",62,54,54,0,0,"PUM+J",0
44,"44050",3183,2208,2154,78,54,"PUM+J",0
26,"26089",108356,81446,80090,1450,1356,"PUM+J",411
49,"49247",507,340,332,6,8,"PUM+J",1
47,"47203",69,57,56,0,1,"PUM+J",0
49,"49201",330,280,278,9,2,"PUM+J",0
16,"16006",133,117,116,2,1,"PUM+J",1
10,"10021",5421,4189,4099,47,90,"PUM+J",11
34,"34147",192,139,137,1,2,"PUM+J",0
31,"31102",162,80,78,0,2,"PUM+J",0
38,"38020",14520,9396,9202,121,194,"PUM+J",26
31,"31042",2719,2100,2057,27,43,"PUM+J",4
2,"2066",258,219,217,2,2,"PUM+J",0
5,"5205",78,59,58,0,1,"PUM+J",0
24,"24113",404,318,310,3,8,"PUM+J",1
16,"16172",413,330,318,1,12,"PUM+J",0
49,"49067",416,300,300,2,0,"PUM+J",1
22,"22232",98,78,75,0,3,"PUM+J",0
10,"10145",132,112,111,0,1,"PUM+J",0
47,"47067",198,159,156,5,3,"PUM+J",0
34,"34024",27,18,17,1,1,"PUM+J",0
7,"7045",1189,843,823,23,20,"PUM+J",2
13,"13069",704,605,590,2,15,"PUM+J",1
9,"9472",58,46,46,0,0,"PUM+J",0
42,"42118",26,20,20,0,0,"PUM+J",0
32,"32017",1333,906,895,10,11,"PUM+J",2
9,"9247",28,21,20,0,1,"PUM+J",0
49,"49250",1330,998,985,19,13,"PUM+J",3
50,"50245",121,80,80,1,0,"PUM+J",1
10,"10146",1439,991,975,11,16,"PUM+J",2
26,"26180",243,185,181,4,4,"PUM+J",0
7,"7012",1880,1437,1405,20,32,"PUM+J",5
31,"31013",668,382,375,12,7,"PUM+J",1
10,"10200",499,368,368,0,0,"PUM+J",0
6,"6105",655,450,448,1,2,"PUM+J",0
6,"6136",1621,1300,1283,11,17,"PUM+J",1
47,"47205",414,307,298,5,9,"PUM+J",0
5,"5904",149,99,97,0,2,"PUM+J",0
33,"33068",1224,704,703,5,1,"PUM+J",0
47,"47042",63,50,49,3,1,"PUM+J",0
42,"42135",89,59,59,1,0,"PUM+J",0
42,"42036",52,40,39,2,1,"PUM+J",1
22,"22235",101,88,87,1,1,"PUM+J",0
44,"44183",78,49,46,0,3,"PUM+J",0
18,"18025",326,242,238,0,4,"PUM+J",0
31,"31045",501,384,377,16,7,"PUM+J",3
5,"5045",104,82,82,0,0,"PUM+J",0
9,"9430",18,15,15,0,0,"PUM+J",0
18,"18158",10328,7336,7254,69,82,"PUM+J",2
9,"9389",77,66,66,0,0,"PUM+J",0
50,"50162",160,108,108,2,0,"PUM+J",0
2,"2033",1955,1565,1536,15,29,"PUM+J",6
50,"50015",109,73,73,0,0,"PUM+J",0
49,"49255",455,372,367,1,5,"PUM+J",1
13,"13072",803,638,633,13,5,"PUM+J",2
28,"28034",356,278,276,1,2,"PUM+J",0
2,"2070",439,372,366,4,6,"PUM+J",1
50,"50257",195,154,154,0,0,"PUM+J",0
16,"16081",64,46,45,1,1,"PUM+J",0
31,"31057",1863,1450,1409,32,41,"PUM+J",3
31,"31056",183,123,122,4,1,"PUM+J",1
16,"16095",98,68,68,0,0,"PUM+J",0
10,"10150",374,331,328,2,3,"PUM+J",0
28,"28125",2808,2077,2055,19,22,"PUM+J",3
26,"26142",804,661,648,1,13,"PUM+J",1
13,"13040",933,755,744,4,11,"PUM+J",1
44,"44019",75,38,37,0,1,"PUM+J",0
9,"9431",124,102,100,2,2,"PUM+J",0
44,"44225",129,100,98,5,2,"PUM+J",0
49,"49029",675,553,542,6,11,"PUM+J",1
31,"31138",939,648,646,14,2,"PUM+J",0
5,"5210",105,83,82,2,1,"PUM+J",0
41,"41095",40097,27969,27731,354,238,"PUM+J",30
18,"18193",13680,9874,9764,130,110,"PUM+J",10
6,"6095",9330,6974,6873,129,101,"PUM+J",16
49,"49030",96,78,77,2,1,"PUM+J",0
49,"49121",382,270,270,1,0,"PUM+J",1
24,"24202",8677,5486,5377,103,109,"PUM+J",13
47,"47181",170,128,128,1,0,"PUM+J",0
14,"14005",6334,4262,4206,61,56,"PUM+J",6
9,"9253",108,95,94,4,1,"PUM+J",0
13,"13074",1000,886,878,15,8,"PUM+J",0
14,"14066",5911,4515,4473,54,42,"PUM+J",9
18,"18194",2258,1656,1652,11,4,"PUM+J",1
33,"33025",9455,6331,6277,84,54,"PUM+J",5
5,"5147",174,141,135,4,6,"PUM+J",1
28,"28057",1419,1084,1074,12,10,"PUM+J",0
42,"42125",73,65,64,4,1,"PUM+J",1
42,"42028",62,45,43,2,2,"PUM+J",0
41,"41038",96442,66696,65945,1021,751,"PUM+J",108
49,"49210",493,358,356,6,2,"PUM+J",0
18,"18174",470,368,363,1,5,"PUM+J",0
49,"49046",283,240,235,2,5,"PUM+J",0
5,"5256",119,101,100,0,1,"PUM+J",1
41,"41097",3096,2489,2451,21,38,"PUM+J",1
18,"18030",612,457,456,0,1,"PUM+J",0
50,"50193",635,483,465,3,18,"PUM+J",1
44,"44228",121,97,96,2,1,"PUM+J",0
10,"10194",557,449,440,0,9,"PUM+J",0
13,"13076",514,436,428,0,8,"PUM+J",0
34,"34158",336,202,200,0,2,"PUM+J",2
16,"16055",698,485,481,8,4,"PUM+J",1
5,"5212",274,202,197,0,5,"PUM+J",0
16,"16187",78,61,60,3,1,"PUM+J",0
31,"31202",4247,3014,2957,69,57,"PUM+J",6
18,"18163",327,246,238,0,8,"PUM+J",0
41,"41057",299,191,189,0,2,"PUM+J",0
18,"18164",1881,1351,1342,16,9,"PUM+J",0
28,"28172",7648,6130,6076,65,54,"PUM+J",9
10,"10072",892,663,655,3,8,"PUM+J",2
28,"28082",5144,3967,3905,46,62,"PUM+J",4
49,"49033",761,563,556,9,7,"PUM+J",1
14,"14068",581,460,457,7,3,"PUM+J",1
28,"28107",443,338,333,7,5,"PUM+J",0
40,"40109",84,70,67,0,3,"PUM+J",0
40,"40015",33,30,30,1,0,"PUM+J",0
47,"47157",544,462,458,9,4,"PUM+J",1
2,"2077",51,46,45,0,1,"PUM+J",0
6,"6101",489,397,395,5,2,"PUM+J",0
44,"44192",401,324,322,5,2,"PUM+J",0
40,"40077",713,526,519,12,7,"PUM+J",2
50,"50280",370,296,291,5,5,"PUM+J",0
10,"10210",599,453,452,3,1,"PUM+J",1
49,"49034",467,363,359,3,4,"PUM+J",1
14,"14039",2705,2204,2189,12,15,"PUM+J",2
10,"10197",143,96,94,1,2,"PUM+J",1
49,"49035",260,231,229,4,2,"PUM+J",0
24,"24087",670,513,513,12,0,"PUM+J",0
31,"31082",634,402,398,10,4,"PUM+J",0
33,"33051",7576,5379,5335,65,44,"PUM+J",0
5,"5152",737,618,609,5,9,"PUM+J",0
44,"44232",408,301,295,5,6,"PUM+J",1
5,"5018",27,24,24,0,0,"PUM+J",0
13,"13079",12220,9665,9502,177,163,"PUM+J",12
32,"32065",720,550,539,3,11,"PUM+J",0
44,"44026",89,69,69,0,0,"PUM+J",0
41,"41006",2743,1972,1957,13,15,"PUM+J",0
6,"6012",3263,2498,2476,31,22,"PUM+J",3
26,"26106",78,70,69,0,1,"PUM+J",0
24,"24168",493,397,391,7,6,"PUM+J",1
44,"44066",121,88,86,0,2,"PUM+J",0
42,"42134",2626,1945,1896,36,49,"PUM+J",3
34,"34163",61,56,56,1,0,"PUM+J",0
24,"24127",327,258,255,1,3,"PUM+J",0
9,"9130",87,72,71,0,1,"PUM+J",0
28,"28130",27391,21367,21111,235,256,"PUM+J",30
50,"50169",371,275,274,5,1,"PUM+J",0
21,"21054",8024,6159,6072,67,87,"PUM+J",8
9,"9905",432,313,309,1,4,"PUM+J",1
50,"50139",372,280,278,3,2,"PUM+J",0
21,"21024",502,363,358,10,5,"PUM+J",0
49,"49222",404,297,294,4,3,"PUM+J",0
47,"47133",2382,1861,1841,30,20,"PUM+J",1
10,"10050",1208,1003,983,8,20,"PUM+J",0
18,"18089",15803,10794,10712,95,82,"PUM+J",9
13,"13049",838,654,648,0,6,"PUM+J",0
24,"24050",113,91,90,0,1,"PUM+J",0
33,"33030",921,682,668,4,14,"PUM+J",0
40,"40069",87,76,75,0,1,"PUM+J",1
28,"28085",3794,2980,2933,18,47,"PUM+J",1
5,"5261",48,32,31,0,1,"PUM+J",0
49,"49069",414,276,270,1,6,"PUM+J",0
2,"2008",1332,985,966,12,19,"PUM+J",5
49,"49039",333,243,240,6,3,"PUM+J",1
49,"49267",101,77,77,1,0,"PUM+J",1
49,"49130",218,159,156,3,3,"PUM+J",1
9,"9442",385,295,289,4,6,"PUM+J",0
42,"42139",22,18,17,0,1,"PUM+J",0
47,"47078",178,159,154,7,5,"PUM+J",0
18,"18170",377,238,237,0,1,"PUM+J",0
9,"9178",61,48,48,0,0,"PUM+J",0
32,"32031",1079,837,828,5,9,"PUM+J",0
50,"50171",126,90,89,4,1,"PUM+J",0
31,"31147",103,81,80,3,1,"PUM+J",0
40,"40022",210,154,151,2,3,"PUM+J",0
13,"13050",533,427,421,3,6,"PUM+J",1
31,"31026",154,125,122,1,3,"PUM+J",0
22,"22102",194,152,149,4,3,"PUM+J",0
13,"13061",5898,4442,4373,56,69,"PUM+J",9
28,"28062",311,233,226,0,7,"PUM+J",0
40,"40039",257,188,184,2,4,"PUM+J",1
21,"21006",3565,2477,2441,29,36,"PUM+J",1
44,"44032",18,12,12,0,0,"PUM+J",0
10,"10082",1947,1601,1572,10,29,"PUM+J",3
24,"24172",491,234,232,2,2,"PUM+J",0
31,"31905",2707,1913,1881,32,32,"PUM+J",17
9,"9134",237,164,159,7,5,"PUM+J",1
40,"40072",170,134,132,1,2,"PUM+J",0
10,"10041",1070,850,846,8,4,"PUM+J",1
47,"47189",164,134,134,1,0,"PUM+J",0
2,"2047",109,94,94,0,0,"PUM+J",0
26,"26068",83,65,64,0,1,"PUM+J",2
13,"13085",2455,2146,2118,21,28,"PUM+J",2
5,"5024",268,205,201,2,4,"PUM+J",0
26,"26069",276,211,208,5,3,"PUM+J",0
40,"40121",325,266,262,3,4,"PUM+J",0
22,"22157",251,176,175,9,1,"PUM+J",0
33,"33055",1589,1212,1192,16,20,"PUM+J",1
5,"5158",410,333,331,2,2,"PUM+J",0
49,"49093",308,248,245,5,3,"PUM+J",0
31,"31088",5358,3655,3592,97,63,"PUM+J",25
22,"22208",168,136,133,2,3,"PUM+J",0
9,"9180",132,97,95,8,2,"PUM+J",0
40,"40213",99,75,74,1,1,"PUM+J",0
44,"44034",150,117,117,1,0,"PUM+J",0
40,"40026",114,98,97,2,1,"PUM+J",0
50,"50144",36,32,32,0,0,"PUM+J",0
24,"24217",144,108,107,2,1,"PUM+J",2
22,"22106",25,17,17,0,0,"PUM+J",1
44,"44241",575,442,427,4,15,"PUM+J",1
28,"28095",1358,1092,1077,8,15,"PUM+J",0
50,"50027",260,209,202,2,7,"PUM+J",1
22,"22226",823,640,627,11,13,"PUM+J",0
42,"42194",200,165,163,4,2,"PUM+J",0
9,"9433",67,46,45,2,1,"PUM+J",0
9,"9316",108,87,84,0,3,"PUM+J",0
16,"16068",143,117,116,6,1,"PUM+J",0
22,"22015",336,237,235,11,2,"PUM+J",0
5,"5222",155,132,132,1,0,"PUM+J",0
10,"10045",1119,884,859,5,25,"PUM+J",1
18,"18040",246,147,146,0,1,"PUM+J",0
49,"49231",360,256,254,4,2,"PUM+J",0
31,"31090",156,77,77,0,0,"PUM+J",0
13,"13054",5032,3901,3824,70,77,"PUM+J",4
44,"44204",24,21,21,0,0,"PUM+J",0
44,"44036",27,17,17,0,0,"PUM+J",0
47,"47030",1075,822,801,13,21,"PUM+J",0
22,"22109",243,178,178,2,0,"PUM+J",0
13,"13055",738,585,578,8,7,"PUM+J",0
24,"24137",1226,920,904,16,16,"PUM+J",3
7,"7030",1576,1150,1135,26,15,"PUM+J",5
50,"50288",3252,2412,2380,50,32,"PUM+J",3
21,"21071",216,169,169,5,0,"PUM+J",0
31,"31131",841,610,594,12,16,"PUM+J",5
32,"32013",2464,1695,1671,10,24,"PUM+J",4
9,"9412",846,568,563,4,5,"PUM+J",1
9,"9228",168,143,143,3,0,"PUM+J",0
26,"26033",183,157,156,2,1,"PUM+J",0
44,"44037",483,349,344,10,5,"PUM+J",2
34,"34048",72,58,56,3,2,"PUM+J",0
21,"21061",5089,3657,3635,33,22,"PUM+J",1
10,"10156",116,91,91,0,0,"PUM+J",0
42,"42152",96,71,69,1,2,"PUM+J",1
40,"40901",379,292,288,11,4,"PUM+J",0
5,"5259",132,115,114,1,1,"PUM+J",0
42,"42048",78,63,62,3,1,"PUM+J",0
13,"13089",1906,1610,1553,12,57,"PUM+J",1
42,"42198",24,17,17,0,0,"PUM+J",1
9,"9450",31,26,26,1,0,"PUM+J",0
2,"2053",3053,2550,2517,33,33,"PUM+J",5
9,"9139",104,84,80,3,4,"PUM+J",0
34,"34132",128,103,102,2,1,"PUM+J",1
32,"32040",1587,1226,1219,7,7,"PUM+J",4
33,"33059",5049,3480,3447,37,33,"PUM+J",0
50,"50059",790,593,586,12,7,"PUM+J",0
10,"10171",376,287,282,0,5,"PUM+J",0
47,"47113",166,136,135,1,1,"PUM+J",0
41,"41041",9646,7901,7791,58,110,"PUM+J",6
9,"9413",500,335,331,1,4,"PUM+J",0
50,"50118",2312,1737,1718,22,19,"PUM+J",1
50,"50031",167,105,103,0,2,"PUM+J",0
31,"31246",148,101,100,3,1,"PUM+J",1
49,"49186",273,205,204,1,1,"PUM+J",0
32,"32041",884,576,568,2,8,"PUM+J",3
44,"44249",58,40,40,1,0,"PUM+J",0
24,"24224",665,490,484,8,6,"PUM+J",1
31,"31033",55,34,34,0,0,"PUM+J",1
14,"14021",259993,183200,181402,2936,1798,"PUM+J",412
31,"31247",171,121,121,1,0,"PUM+J",0
33,"33060",15694,11036,10883,112,153,"PUM+J",5
50,"50179",269,230,229,2,1,"PUM+J",0
49,"49143",243,161,157,0,4,"PUM+J",2
31,"31125",269,172,169,6,3,"PUM+J",1
42,"42050",29,20,20,1,0,"PUM+J",0
26,"26181",14,12,12,0,0,"PUM+J",0
44,"44154",271,196,195,7,1,"PUM+J",0
40,"40192",179,151,150,1,1,"PUM+J",0
49,"49025",187,143,142,3,1,"PUM+J",0
5,"5065",498,424,422,7,2,"PUM+J",1
42,"42202",33,15,14,1,1,"PUM+J",0
34,"34092",331,272,267,6,5,"PUM+J",0
16,"16246",520,417,407,1,10,"PUM+J",0
33,"33053",1206,817,811,6,6,"PUM+J",0
2,"2032",323,261,259,1,2,"PUM+J",0
28,"28026",5852,4506,4449,40,57,"PUM+J",2
16,"16160",76,54,53,1,1,"PUM+J",0
22,"22022",582,448,438,12,10,"PUM+J",2
42,"42157",18,16,15,0,1,"PUM+J",0
47,"47008",26,17,17,0,0,"PUM+J",0
40,"40083",88,72,72,1,0,"PUM+J",0
6,"6076",854,639,631,9,8,"PUM+J",2
47,"47115",306,248,248,2,0,"PUM+J",0
42,"42204",64,49,44,4,5,"PUM+J",1
50,"50209",2559,1685,1661,34,24,"PUM+J",4
49,"49057",125,98,94,1,4,"PUM+J",0
15,"15092",6869,4965,4907,53,58,"PUM+J",3
31,"31157",3567,2435,2393,32,42,"PUM+J",4
40,"40224",34,25,25,0,0,"PUM+J",0
32,"32081",2240,1698,1682,13,16,"PUM+J",1
16,"16176",61,45,43,0,2,"PUM+J",0
49,"49190",81,65,64,2,1,"PUM+J",0
33,"33008",1934,1474,1459,11,15,"PUM+J",0
42,"42086",40,25,25,1,0,"PUM+J",0
40,"40180",319,259,255,3,4,"PUM+J",0
47,"47088",121,100,100,0,0,"PUM+J",0
28,"28141",5568,4097,4051,31,46,"PUM+J",5
14,"14054",13632,10857,10652,194,205,"PUM+J",16
32,"32082",1403,1055,1047,9,8,"PUM+J",0
40,"40181",4413,3439,3361,43,78,"PUM+J",9
13,"13062",595,490,480,4,10,"PUM+J",1
22,"22117",2585,1880,1848,57,32,"PUM+J",2
10,"10177",1692,1351,1318,15,33,"PUM+J",5
22,"22174",520,401,394,11,7,"PUM+J",0
10,"10055",709,523,508,13,15,"PUM+J",1
50,"50007",61,45,45,0,0,"PUM+J",1
13,"13096",7716,5759,5659,70,100,"PUM+J",7
5,"5103",84,68,68,3,0,"PUM+J",0
15,"15010",2009,1468,1441,24,27,"PUM+J",2
34,"34057",483,365,357,2,8,"PUM+J",0
28,"28164",2807,2194,2173,10,21,"PUM+J",0
49,"49016",272,216,211,1,5,"PUM+J",0
9,"9024",159,124,123,2,1,"PUM+J",0
9,"9330",1562,1212,1176,10,36,"PUM+J",1
34,"34098",756,544,540,10,4,"PUM+J",0
16,"16215",285,192,186,2,6,"PUM+J",0
49,"49150",169,129,126,0,3,"PUM+J",0
42,"42208",23,15,15,1,0,"PUM+J",0
31,"31129",405,285,281,1,4,"PUM+J",0
34,"34018",229,184,182,3,2,"PUM+J",0
24,"24230",450,333,327,4,6,"PUM+J",0
40,"40230",117,92,90,1,2,"PUM+J",0
9,"9076",24,15,15,0,0,"PUM+J",0
14,"14026",2043,1434,1421,10,13,"PUM+J",0
40,"40012",280,215,213,2,2,"PUM+J",0
26,"26070",203,179,177,3,2,"PUM+J",1
26,"26031",120,100,100,0,0,"PUM+J",2
9,"9039",58,50,49,0,1,"PUM+J",0
42,"42178",144,105,104,3,1,"PUM+J",0
26,"26086",18,17,17,0,0,"PUM+J",0
44,"44135",149,110,109,1,1,"PUM+J",0
42,"42016",25,13,13,0,0,"PUM+J",0
49,"49019",256,206,205,5,1,"PUM+J",0
5,"5136",110,75,75,3,0,"PUM+J",0
44,"44009",805,608,595,18,13,"PUM+J",2
7,"7008",5422,3782,3705,61,77,"PUM+J",12
31,"31100",298,193,193,2,0,"PUM+J",0
26,"26045",13,13,13,0,0,"PUM+J",0
28,"28029",538,416,414,4,2,"PUM+J",1
47,"47013",118,97,97,2,0,"PUM+J",0
40,"40140",100,74,73,1,1,"PUM+J",0
26,"26176",69,55,54,0,1,"PUM+J",0
2,"2064",413,350,348,7,2,"PUM+J",0
15,"15069",7019,5036,4938,85,98,"PUM+J",7
16,"16099",232,180,178,5,2,"PUM+J",0
34,"34210",103,93,91,2,2,"PUM+J",0
18,"18184",2140,1663,1645,18,18,"PUM+J",0
7,"7042",10393,6536,6421,96,115,"PUM+J",17
16,"16087",229,193,187,4,6,"PUM+J",0
5,"5139",74,62,59,2,3,"PUM+J",0
24,"24207",320,274,272,5,2,"PUM+J",0
44,"44136",51,39,39,0,0,"PUM+J",0
26,"26088",48,41,41,0,0,"PUM+J",0
42,"42182",62,53,53,2,0,"PUM+J",1
42,"42183",131,95,94,7,1,"PUM+J",0
49,"49200",1011,789,771,6,18,"PUM+J",1
44,"44137",215,165,163,5,2,"PUM+J",0
42,"42165",424,291,280,6,11,"PUM+J",2
49,"49066",531,392,386,2,6,"PUM+J",0
5,"5002",1996,1497,1476,15,21,"PUM+J",2
24,"24032",134,102,101,1,1,"PUM+J",0
9,"9160",104,75,74,0,1,"PUM+J",0
32,"32052",2126,1690,1673,28,17,"PUM+J",4
5,"5902",319,262,262,0,0,"PUM+J",0
5,"5172",147,122,122,0,0,"PUM+J",0
42,"42020",4385,3055,2957,74,98,"PUM+J",6
24,"24193",371,254,252,3,2,"PUM+J",0
13,"13903",564,461,454,2,7,"PUM+J",0
50,"50096",49,35,35,0,0,"PUM+J",0
31,"31256",113,64,64,0,0,"PUM+J",0
9,"9032",118,68,68,0,0,"PUM+J",0
6,"6088",12879,9362,9222,153,140,"PUM+J",35
21,"21073",1840,1249,1236,13,13,"PUM+J",4
31,"31043",42,30,30,1,0,"PUM+J",0
50,"50273",36,22,22,0,0,"PUM+J",0
18,"18023",16072,11594,11488,131,106,"PUM+J",14
15,"15015",2840,2006,1964,43,42,"PUM+J",3
5,"5141",99,90,89,0,1,"PUM+J",0
47,"47095",41,36,36,3,0,"PUM+J",0
14,"14061",841,700,693,3,7,"PUM+J",0
33,"33044",180964,129466,128346,1888,1120,"PUM+J",101
13,"13070",769,653,640,1,13,"PUM+J",0
40,"40191",265,191,190,1,1,"PUM+J",1
44,"44053",111,77,76,2,1,"PUM+J",0
47,"47016",94,77,77,1,0,"PUM+J",0
34,"34077",283,219,216,3,3,"PUM+J",0
21,"21064",6331,4390,4352,46,38,"PUM+J",5
16,"16192",54,37,37,1,0,"PUM+J",0
6,"6106",447,335,333,7,2,"PUM+J",0
44,"44142",39,28,28,1,0,"PUM+J",0
9,"9340",72,41,41,0,0,"PUM+J",0
22,"22039",920,721,710,12,11,"PUM+J",3
50,"50032",330,233,228,3,5,"PUM+J",0
50,"50120",53,41,41,0,0,"PUM+J",0
41,"41008",1073,884,875,0,9,"PUM+J",0
28,"28039",139,103,103,1,0,"PUM+J",0
47,"47125",55,46,46,0,0,"PUM+J",0
40,"40193",231,188,185,6,3,"PUM+J",2
44,"44017",316,232,229,1,3,"PUM+J",0
14,"14002",10991,8444,8358,106,86,"PUM+J",8
13,"13005",23052,18002,17700,255,302,"PUM+J",20
31,"31075",96,61,61,0,0,"PUM+J",0
5,"5143",81,61,61,0,0,"PUM+J",0
9,"9035",336,255,251,3,4,"PUM+J",2
10,"10189",2728,2108,2063,24,45,"PUM+J",3
21,"21016",1076,823,790,11,33,"PUM+J",0
24,"24037",429,282,277,4,5,"PUM+J",0
34,"34154",78,62,62,0,0,"PUM+J",0
42,"42121",77,56,56,1,0,"PUM+J",0
42,"42189",75,58,58,2,0,"PUM+J",0
33,"33076",12662,8733,8670,120,63,"PUM+J",2
18,"18016",339,254,253,2,1,"PUM+J",0
28,"28048",489,398,389,3,9,"PUM+J",0
5,"5089",500,390,375,3,15,"PUM+J",0
47,"47207",325,265,263,4,2,"PUM+J",0
40,"40195",946,722,707,13,15,"PUM+J",0
50,"50016",51,30,30,1,0,"PUM+J",0
40,"40055",41,32,31,0,1,"PUM+J",0
16,"16901",793,590,582,2,8,"PUM+J",0
24,"24199",432,280,278,2,2,"PUM+J",0
42,"42070",45,29,28,0,1,"PUM+J",0
5,"5209",104,78,78,0,0,"PUM+J",0
26,"26014",472,358,353,6,5,"PUM+J",1
10,"10191",527,421,414,3,7,"PUM+J",0
42,"42026",25,16,16,0,0,"PUM+J",0
49,"49208",428,266,261,1,5,"PUM+J",0
40,"40104",261,179,178,1,1,"PUM+J",1
49,"49209",568,374,372,1,2,"PUM+J",0
31,"31230",118,88,85,1,3,"PUM+J",0
22,"22137",1164,850,839,14,11,"PUM+J",4
42,"42192",43,36,36,2,0,"PUM+J",0
15,"15001",4985,3560,3506,63,54,"PUM+J",6
16,"16097",196,167,166,2,1,"PUM+J",0
26,"26100",59,51,51,1,0,"PUM+J",0
16,"16052",596,469,464,2,5,"PUM+J",1
13,"13075",212,161,159,1,2,"PUM+J",0
7,"7050",3099,2008,1979,45,29,"PUM+J",3
22,"22086",207,149,147,1,2,"PUM+J",0
28,"28035",1314,1058,1046,3,12,"PUM+J",0
6,"6142",284,240,235,4,5,"PUM+J",0
44,"44160",473,315,312,8,3,"PUM+J",1
9,"9348",150,122,122,2,0,"PUM+J",2
28,"28071",77,57,55,0,2,"PUM+J",0
16,"16166",277,210,202,0,8,"PUM+J",0
18,"18029",1892,1355,1347,6,8,"PUM+J",1
31,"31242",235,157,157,2,0,"PUM+J",1
5,"5126",78,70,70,0,0,"PUM+J",0
47,"47074",155,125,124,0,1,"PUM+J",1
16,"16904",508,413,407,10,6,"PUM+J",2
38,"38028",22003,14876,14589,158,287,"PUM+J",29
26,"26101",46,35,34,0,1,"PUM+J",0
32,"32061",1196,976,973,4,3,"PUM+J",0
42,"42030",115,88,86,2,2,"PUM+J",0
9,"9215",426,290,287,1,3,"PUM+J",0
6,"6099",1127,815,805,6,10,"PUM+J",1
2,"2075",1689,1386,1372,10,14,"PUM+J",2
7,"7052",4578,2671,2651,46,20,"PUM+J",9
41,"41056",3697,3041,3008,25,33,"PUM+J",3
16,"16142",118,93,93,1,0,"PUM+J",0
47,"47021",84,61,61,2,0,"PUM+J",0
7,"7019",230,165,164,1,1,"PUM+J",0
47,"47100",169,146,144,1,2,"PUM+J",0
28,"28043",5944,4199,4147,56,52,"PUM+J",1
26,"26072",310,270,264,4,6,"PUM+J",0
50,"50066",2357,1677,1659,42,18,"PUM+J",1
31,"31233",103,87,82,2,5,"PUM+J",1
14,"14038",31501,23683,23394,336,289,"PUM+J",27
33,"33073",9341,5825,5773,69,52,"PUM+J",3
15,"15023",6629,4879,4795,52,84,"PUM+J",5
31,"31212",173,117,117,3,0,"PUM+J",3
18,"18134",5528,3751,3679,57,72,"PUM+J",5
5,"5151",100,86,82,1,4,"PUM+J",0
16,"16016",258,178,178,1,0,"PUM+J",0
40,"40078",180,143,143,1,0,"PUM+J",1
10,"10170",269,217,215,4,2,"PUM+J",1
14,"14049",16358,12577,12478,137,99,"PUM+J",4
42,"42032",186,143,141,2,2,"PUM+J",0
44,"44112",473,353,350,4,3,"PUM+J",0
10,"10116",3762,2781,2705,36,76,"PUM+J",11
31,"31204",45,35,34,0,1,"PUM+J",0
6,"6057",575,481,474,2,7,"PUM+J",0
44,"44194",128,92,89,1,3,"PUM+J",1
6,"6011",24301,17977,17819,268,158,"PUM+J",62
5,"5246",68,57,56,1,1,"PUM+J",0
28,"28153",608,422,406,1,16,"PUM+J",0
9,"9259",239,178,177,2,1,"PUM+J",0
50,"50021",42,34,33,1,1,"PUM+J",0
28,"28060",1471,1205,1192,8,13,"PUM+J",0
47,"47184",575,447,443,6,4,"PUM+J",0
22,"22248",119,94,92,3,2,"PUM+J",0
9,"9218",384,285,279,8,6,"PUM+J",0
16,"16018",417,350,342,3,8,"PUM+J",0
49,"49128",617,480,474,10,6,"PUM+J",2
34,"34121",208,153,152,0,1,"PUM+J",0
32,"32029",557,426,424,1,2,"PUM+J",1
49,"49037",201,171,171,2,0,"PUM+J",0
5,"5247",267,164,164,0,0,"PUM+J",0
9,"9045",283,196,196,4,0,"PUM+J",0
40,"40112",2346,1848,1798,35,50,"PUM+J",9
6,"6013",283,245,244,1,1,"PUM+J",2
5,"5120",38,28,28,1,0,"PUM+J",0
42,"42082",9,9,9,0,0,"PUM+J",0
15,"15053",8164,5679,5592,60,87,"PUM+J",5
28,"28084",15408,11489,11355,122,134,"PUM+J",16
26,"26167",66,51,51,2,0,"PUM+J",1
28,"28168",1144,821,810,15,11,"PUM+J",0
18,"18123",307,239,238,1,1,"PUM+J",0
49,"49071",822,558,557,5,1,"PUM+J",1
28,"28018",3572,2837,2795,20,42,"PUM+J",1
18,"18004",818,601,594,2,7,"PUM+J",0
47,"47104",2917,2391,2357,31,34,"PUM+J",1
9,"9428",124,107,107,1,0,"PUM+J",0
24,"24169",3205,2317,2282,33,35,"PUM+J",1
16,"16104",65,52,52,1,0,"PUM+J",0
31,"31024",116,56,56,2,0,"PUM+J",0
13,"13081",684,553,527,1,26,"PUM+J",0
10,"10201",202,173,171,3,2,"PUM+J",0
40,"40162",420,320,314,1,6,"PUM+J",1
42,"42084",27,21,21,0,0,"PUM+J",0
26,"26065",57,43,43,0,0,"PUM+J",1
40,"40207",724,551,540,9,11,"PUM+J",1
10,"10215",437,338,333,3,5,"PUM+J",0
5,"5155",60,44,44,1,0,"PUM+J",0
15,"15083",1198,874,855,8,19,"PUM+J",2
34,"34217",1089,866,849,19,17,"PUM+J",0
41,"41102",14343,11050,10837,206,213,"PUM+J",8
38,"38035",8172,4990,4919,62,71,"PUM+J",16
7,"7059",3011,2077,2012,22,65,"PUM+J",4
50,"50053",756,570,563,14,7,"PUM+J",0
42,"42103",626,487,481,3,6,"PUM+J",1
16,"16265",27,26,26,0,0,"PUM+J",0
9,"9010",35,27,27,1,0,"PUM+J",0
5,"5219",45,33,33,0,0,"PUM+J",0
28,"28070",139,98,97,0,1,"PUM+J",1
16,"16024",134,92,91,1,1,"PUM+J",0
9,"9360",37,29,29,0,0,"PUM+J",0
49,"49226",279,235,233,1,2,"PUM+J",1
16,"16248",887,733,710,20,23,"PUM+J",0
22,"22103",697,532,523,10,9,"PUM+J",1
33,"33032",12060,8627,8491,107,136,"PUM+J",6
40,"40071",52,45,45,4,0,"PUM+J",0
9,"9408",45,36,36,0,0,"PUM+J",0
14,"14075",624,508,500,8,8,"PUM+J",1
49,"49002",77,59,59,1,0,"PUM+J",0
42,"42142",55,41,38,2,3,"PUM+J",0
50,"50114",157,120,120,1,0,"PUM+J",0
22,"22105",132,104,102,2,2,"PUM+J",0
34,"34082",96,79,75,0,4,"PUM+J",0
2,"2011",730,612,610,3,2,"PUM+J",0
5,"5188",55,47,47,0,0,"PUM+J",0
9,"9091",746,556,550,8,6,"PUM+J",0
50,"50211",277,193,193,1,0,"PUM+J",0
5,"5168",3682,2846,2801,43,45,"PUM+J",0
10,"10084",1416,994,972,12,22,"PUM+J",1
38,"38037",13166,8509,8332,65,177,"PUM+J",14
26,"26029",33,25,24,1,1,"PUM+J",0
16,"16250",94,71,71,0,0,"PUM+J",0
22,"22901",792,515,508,13,7,"PUM+J",0
42,"42145",140,111,111,2,0,"PUM+J",1
26,"26158",296,238,237,7,1,"PUM+J",0
28,"28021",418,334,328,4,6,"PUM+J",0
18,"18150",6452,4666,4625,56,41,"PUM+J",3
26,"26003",446,388,387,8,1,"PUM+J",0
47,"47040",67,51,50,0,1,"PUM+J",0
16,"16238",560,484,479,3,5,"PUM+J",0
26,"26035",22,14,14,0,0,"PUM+J",0
15,"15002",21528,15479,15218,314,261,"PUM+J",32
44,"44167",41,31,31,1,0,"PUM+J",0
34,"34046",45,35,34,0,1,"PUM+J",1
9,"9410",3181,2079,2049,48,30,"PUM+J",8
50,"50115",3280,2234,2205,32,29,"PUM+J",3
50,"50028",120,86,85,2,1,"PUM+J",1
26,"26161",9,8,8,0,0,"PUM+J",0
5,"5026",229,193,192,2,1,"PUM+J",0
28,"28022",30019,24469,24279,292,190,"PUM+J",33
6,"6159",2341,1522,1510,8,12,"PUM+J",2
22,"22903",672,555,547,6,8,"PUM+J",1
34,"34086",105,89,89,1,0,"PUM+J",0
18,"18011",4246,3195,3172,23,23,"PUM+J",5
6,"6114",152,122,122,0,0,"PUM+J",0
42,"42045",345,238,234,2,4,"PUM+J",0
18,"18910",832,601,594,6,7,"PUM+J",0
34,"34087",108,88,87,1,1,"PUM+J",0
49,"49064",566,372,368,8,4,"PUM+J",0
9,"9155",27,17,17,0,0,"PUM+J",0
26,"26059",1137,887,869,9,18,"PUM+J",2
28,"28030",1591,1268,1230,12,38,"PUM+J",0
44,"44011",67,47,47,0,0,"PUM+J",0
9,"9138",92,77,74,0,3,"PUM+J",0
6,"6131",1037,871,865,8,6,"PUM+J",0
34,"34237",645,506,498,6,8,"PUM+J",0
24,"24018",180,150,149,1,1,"PUM+J",0
41,"41005",8792,6642,6585,71,57,"PUM+J",3
47,"47033",209,170,168,3,2,"PUM+J",0
42,"42079",32,25,25,0,0,"PUM+J",0
22,"22142",114,91,91,2,0,"PUM+J",0
41,"41040",9567,7305,7210,93,95,"PUM+J",11
44,"44245",274,189,184,1,5,"PUM+J",1
22,"22111",180,126,125,3,1,"PUM+J",1
14,"14019",6486,5288,5243,65,45,"PUM+J",0
49,"49050",558,382,375,3,7,"PUM+J",0
24,"24222",13915,9939,9751,304,188,"PUM+J",27
40,"40126",96,80,78,0,2,"PUM+J",0
47,"47034",90,65,63,0,2,"PUM+J",0
16,"16171",1930,1616,1584,25,32,"PUM+J",3
24,"24226",223,154,153,1,1,"PUM+J",0
14,"14051",1392,1148,1130,11,18,"PUM+J",1
22,"22236",266,213,213,3,0,"PUM+J",0
5,"5097",525,378,373,4,5,"PUM+J",0
15,"15089",4354,3255,3216,55,39,"PUM+J",5
34,"34227",84,69,67,3,2,"PUM+J",1
31,"31123",652,379,373,8,6,"PUM+J",0
5,"5903",171,118,118,0,0,"PUM+J",0
49,"49053",978,809,796,10,13,"PUM+J",3
24,"24179",331,219,214,4,5,"PUM+J",0
44,"44040",206,167,166,5,1,"PUM+J",0
9,"9190",97,73,72,0,1,"PUM+J",0
5,"5163",1762,1400,1380,5,20,"PUM+J",2
5,"5033",184,159,155,3,4,"PUM+J",0
13,"13091",570,484,478,0,6,"PUM+J",0
21,"21034",1253,875,861,7,14,"PUM+J",1
5,"5194",147,131,130,4,1,"PUM+J",0
49,"49054",929,690,687,12,3,"PUM+J",2
15,"15006",5539,3940,3866,53,74,"PUM+J",4
13,"13092",1924,1655,1635,4,20,"PUM+J",1
24,"24076",1210,917,907,26,10,"PUM+J",0
49,"49086",127,108,107,1,1,"PUM+J",1
50,"50109",101,79,79,2,0,"PUM+J",0
5,"5249",101,73,71,1,2,"PUM+J",0
16,"16008",131,89,88,2,1,"PUM+J",0
24,"24181",1652,1303,1288,12,15,"PUM+J",0
34,"34093",101,74,74,1,0,"PUM+J",0
31,"31237",198,137,136,7,1,"PUM+J",1
41,"41089",6394,4593,4526,57,67,"PUM+J",5
28,"28046",4208,3297,3272,31,25,"PUM+J",1
38,"38033",3987,2696,2656,23,40,"PUM+J",4
50,"50296",417,313,310,6,3,"PUM+J",0
32,"32043",2679,2006,1985,14,21,"PUM+J",3
42,"42100",31,31,31,0,0,"PUM+J",1
47,"47196",43,29,29,0,0,"PUM+J",0
28,"28093",1911,1537,1518,19,19,"PUM+J",2
34,"34053",222,177,172,4,5,"PUM+J",0
38,"38023",118865,76393,75039,928,1354,"PUM+J",283
44,"44033",307,222,221,5,1,"PUM+J",0
22,"22188",100,68,66,3,2,"PUM+J",1
26,"26021",2758,2190,2163,21,27,"PUM+J",5
49,"49013",300,230,228,6,2,"PUM+J",0
16,"16219",106,83,82,0,1,"PUM+J",0
31,"31249",1926,1376,1361,30,15,"PUM+J",7
44,"44198",205,160,160,5,0,"PUM+J",0
44,"44018",27,23,23,0,0,"PUM+J",0
35,"35022",43892,27289,26876,326,413,"PUM+J",55
50,"50081",562,410,400,7,10,"PUM+J",0
28,"28027",1232,937,919,9,18,"PUM+J",0
31,"31177",264,162,158,3,4,"PUM+J",3
14,"14024",1926,1557,1527,14,30,"PUM+J",1
24,"24228",732,543,529,4,14,"PUM+J",6
15,"15009",11109,8179,8014,129,165,"PUM+J",14
38,"38047",1819,1269,1239,12,30,"PUM+J",1
42,"42159",40,31,31,1,0,"PUM+J",0
33,"33062",452,282,281,3,1,"PUM+J",1
49,"49015",259,213,208,2,5,"PUM+J",0
44,"44006",293,220,212,3,8,"PUM+J",0
33,"33024",229816,164603,163179,2100,1424,"PUM+J",112
18,"18181",253,183,182,0,1,"PUM+J",0
9,"9460",187,144,142,2,2,"PUM+J",0
31,"31220",771,584,572,9,12,"PUM+J",2
28,"28006",74554,57439,56890,586,549,"PUM+J",84
32,"32046",1375,976,962,3,14,"PUM+J",1
50,"50064",469,377,373,5,4,"PUM+J",0
26,"26171",212,171,170,6,1,"PUM+J",0
33,"33040",4702,3285,3236,44,49,"PUM+J",3
49,"49134",203,142,142,4,0,"PUM+J",0
32,"32079",1448,1103,1094,14,9,"PUM+J",2
40,"40087",112,85,83,0,2,"PUM+J",1
16,"16270",192,156,155,0,1,"PUM+J",0
41,"41002",1510,1161,1140,4,21,"PUM+J",1
10,"10219",1408,984,971,11,13,"PUM+J",1
10,"10016",321,266,262,2,4,"PUM+J",1
5,"5070",41,33,33,0,0,"PUM+J",0
47,"47020",283,237,232,5,5,"PUM+J",0
9,"9239",52,42,42,1,0,"PUM+J",0
33,"33078",159,108,106,1,2,"PUM+J",0
6,"6133",1744,1343,1328,22,15,"PUM+J",1
33,"33028",1466,812,806,5,6,"PUM+J",0
18,"18093",2580,1837,1820,8,17,"PUM+J",0
33,"33043",710,529,528,1,1,"PUM+J",1
9,"9345",134,102,102,1,0,"PUM+J",0
2,"2065",517,450,449,4,1,"PUM+J",1
44,"44061",89,55,55,1,0,"PUM+J",0
44,"44260",160,117,115,5,2,"PUM+J",1
24,"24189",5410,3630,3572,83,58,"PUM+J",11
15,"15012",3767,2973,2926,51,47,"PUM+J",5
44,"44176",167,131,130,5,1,"PUM+J",0
18,"18120",274,238,237,2,1,"PUM+J",0
5,"5073",319,258,254,7,4,"PUM+J",0
10,"10181",739,607,598,6,9,"PUM+J",0
50,"50184",132,106,106,1,0,"PUM+J",0
40,"40091",140,111,109,1,2,"PUM+J",0
42,"42059",23,19,19,1,0,"PUM+J",0
13,"13901",945,734,719,6,15,"PUM+J",0
5,"5234",58,49,49,0,0,"PUM+J",0
34,"34100",141,105,105,1,0,"PUM+J",0
34,"34236",176,134,134,1,0,"PUM+J",1
16,"16253",340,256,256,4,0,"PUM+J",0
15,"15003",1936,1400,1382,19,18,"PUM+J",0
28,"28096",16844,12441,12308,117,133,"PUM+J",12
26,"26046",1617,1237,1219,14,18,"PUM+J",4
5,"5244",66,45,45,0,0,"PUM+J",0
31,"31040",197,137,135,2,2,"PUM+J",0
24,"24005",437,308,305,3,3,"PUM+J",0
6,"6009",214,178,178,2,0,"PUM+J",0
42,"42130",70,55,54,2,1,"PUM+J",0
22,"22025",1104,790,767,27,23,"PUM+J",5
16,"16263",936,730,719,8,11,"PUM+J",1
50,"50041",21,13,13,0,0,"PUM+J",0
9,"9071",48,32,32,0,0,"PUM+J",1
6,"6111",502,389,387,8,2,"PUM+J",1
34,"34102",226,187,185,3,2,"PUM+J",0
5,"5171",84,74,73,0,1,"PUM+J",0
10,"10184",771,609,597,7,12,"PUM+J",1
16,"16275",15,12,12,0,0,"PUM+J",0
38,"38053",3752,2459,2397,28,62,"PUM+J",3
10,"10161",76,59,59,1,0,"PUM+J",0
6,"6001",730,546,538,4,8,"PUM+J",0
49,"49248",224,183,180,4,3,"PUM+J",1
22,"22082",320,231,229,1,2,"PUM+J",2
47,"47049",94,71,71,1,0,"PUM+J",0
6,"6107",1610,1131,1128,6,3,"PUM+J",2
9,"9068",25,19,19,2,0,"PUM+J",0
10,"10198",1213,1068,1054,12,14,"PUM+J",1
9,"9439",909,720,697,16,23,"PUM+J",2
16,"16130",633,504,492,5,12,"PUM+J",1
13,"13002",1576,1143,1134,4,9,"PUM+J",0
24,"24194",327,237,236,5,1,"PUM+J",0
28,"28053",6035,4854,4783,61,71,"PUM+J",7
16,"16276",32,23,22,1,1,"PUM+J",0
47,"47094",154,129,127,0,2,"PUM+J",0
34,"34196",94,74,73,1,1,"PUM+J",0
9,"9070",38,27,27,3,0,"PUM+J",0
21,"21013",10601,7384,7231,110,153,"PUM+J",3
33,"33067",802,650,639,12,11,"PUM+J",0
9,"9473",94,81,81,2,0,"PUM+J",1
26,"26093",60,41,41,0,0,"PUM+J",0
49,"49204",85,64,64,0,0,"PUM+J",0
44,"44222",136,99,99,2,0,"PUM+J",0
50,"50225",1638,1079,1062,7,17,"PUM+J",0
6,"6074",4777,3730,3659,41,71,"PUM+J",13
10,"10173",557,436,431,6,5,"PUM+J",0
16,"16173",249,189,188,0,1,"PUM+J",1
9,"9355",117,88,87,1,1,"PUM+J",0
34,"34242",97,81,79,6,2,"PUM+J",0
40,"40051",54,41,40,0,1,"PUM+J",0
24,"24149",149,120,118,3,2,"PUM+J",0
10,"10124",873,707,707,16,0,"PUM+J",0
26,"26002",805,617,605,6,12,"PUM+J",4
24,"24216",782,582,574,3,8,"PUM+J",1
6,"6045",513,418,412,8,6,"PUM+J",1
31,"31166",274,183,182,2,1,"PUM+J",1
28,"28054",10459,7798,7698,65,100,"PUM+J",10
5,"5175",190,149,149,2,0,"PUM+J",0
28,"28033",3581,2712,2691,14,21,"PUM+J",3
50,"50083",96,72,72,1,0,"PUM+J",0
31,"31265",81,52,50,0,2,"PUM+J",0
22,"22172",613,463,452,6,11,"PUM+J",2
49,"49113",188,166,161,2,5,"PUM+J",0
50,"50111",191,141,138,2,3,"PUM+J",1
31,"31174",115,72,70,1,2,"PUM+J",0
22,"22041",175,138,138,1,0,"PUM+J",0
6,"6047",878,686,680,5,6,"PUM+J",1
26,"26026",1344,1108,1096,14,12,"PUM+J",0
31,"31146",46,34,34,1,0,"PUM+J",0
10,"10162",616,505,496,1,9,"PUM+J",0
10,"10081",183,143,142,0,1,"PUM+J",0
14,"14023",2084,1809,1787,13,22,"PUM+J",2
42,"42039",270,172,169,2,3,"PUM+J",0
14,"14074",2387,2002,1995,26,7,"PUM+J",1
50,"50219",3704,2672,2625,39,47,"PUM+J",7
49,"49207",279,206,204,2,2,"PUM+J",3
9,"9209",4617,3269,3234,44,35,"PUM+J",10
33,"33070",3481,2557,2521,33,36,"PUM+J",0
49,"49256",289,229,224,3,5,"PUM+J",0
28,"28078",39,23,23,1,0,"PUM+J",0
31,"31148",99,69,66,2,3,"PUM+J",1
41,"41036",4053,2930,2899,29,31,"PUM+J",0
31,"31107",1706,1321,1311,17,10,"PUM+J",5
41,"41028",1880,1479,1458,28,21,"PUM+J",2
14,"14035",6153,4715,4656,51,59,"PUM+J",5
32,"32022",1591,1219,1207,9,12,"PUM+J",4
7,"7016",2726,1848,1809,34,39,"PUM+J",1
40,"40151",52,42,42,0,0,"PUM+J",0
18,"18127",15897,11597,11483,133,114,"PUM+J",6
34,"34079",1391,1088,1077,17,11,"PUM+J",2
5,"5077",205,164,160,2,4,"PUM+J",0
33,"33022",992,709,696,12,13,"PUM+J",0
5,"5206",29,23,21,2,2,"PUM+J",0
9,"9063",223,191,189,1,2,"PUM+J",0
9,"9038",123,92,92,0,0,"PUM+J",0
16,"16185",63,45,44,0,1,"PUM+J",0
34,"34206",952,796,780,9,16,"PUM+J",1
42,"42144",464,343,331,3,12,"PUM+J",0
42,"42027",87,61,61,4,0,"PUM+J",1
31,"31112",106,79,78,0,1,"PUM+J",1
16,"16079",33,21,21,0,0,"PUM+J",0
33,"33058",1863,1307,1286,11,21,"PUM+J",1
42,"42010",19,15,15,1,0,"PUM+J",0
41,"41084",2875,2362,2335,9,27,"PUM+J",1
16,"16023",468,332,327,3,5,"PUM+J",1
18,"18904",858,620,612,3,8,"PUM+J",0
31,"31059",204,140,139,3,1,"PUM+J",1
40,"40013",67,56,54,1,2,"PUM+J",0
10,"10031",189,158,158,1,0,"PUM+J",0
24,"24121",645,511,502,10,9,"PUM+J",1
32,"32024",5054,3668,3609,40,59,"PUM+J",8
9,"9394",805,594,588,13,6,"PUM+J",0
31,"31201",144714,104019,102644,2027,1375,"PUM+J",456
42,"42076",237,185,179,6,6,"PUM+J",1
41,"41004",55127,37662,37179,622,483,"PUM+J",51
28,"28106",72603,53231,52524,681,707,"PUM+J",87
16,"16015",407,311,311,4,0,"PUM+J",0
33,"33049",6806,4629,4581,70,48,"PUM+J",2
50,"50222",1695,1117,1091,16,26,"PUM+J",1
50,"50106",137,107,106,0,1,"PUM+J",0
31,"31253",123,102,97,0,5,"PUM+J",0
28,"28072",5232,4065,4007,35,58,"PUM+J",6
16,"16112",1562,1159,1140,12,19,"PUM+J",0
24,"24109",1098,672,663,12,9,"PUM+J",0
10,"10182",146,112,108,0,4,"PUM+J",0
9,"9423",34,28,28,1,0,"PUM+J",0
9,"9016",87,55,54,1,1,"PUM+J",0
31,"31101",1305,892,874,15,18,"PUM+J",3
47,"47054",673,545,541,8,4,"PUM+J",0
49,"49120",79,58,58,1,0,"PUM+J",2
47,"47109",183,151,151,4,0,"PUM+J",0
22,"22119",1433,994,981,14,13,"PUM+J",1
16,"16091",86,66,66,1,0,"PUM+J",0
31,"31251",3147,2274,2225,39,49,"PUM+J",21
42,"42046",55,35,35,0,0,"PUM+J",0
22,"22143",244,166,161,2,5,"PUM+J",1
26,"26061",1552,1119,1099,31,20,"PUM+J",3
35,"35027",10510,7523,7375,88,148,"PUM+J",16
5,"5218",148,123,117,1,6,"PUM+J",0
50,"50271",283,209,207,4,2,"PUM+J",0
26,"26094",97,86,85,0,1,"PUM+J",0
28,"28016",86,68,67,3,1,"PUM+J",0
44,"44263",332,249,243,10,6,"PUM+J",0
6,"6087",2258,1855,1832,24,23,"PUM+J",0
5,"5066",480,397,392,5,5,"PUM+J",0
28,"28059",4061,3169,3130,38,39,"PUM+J",2
40,"40174",402,292,290,5,2,"PUM+J",1
16,"16158",550,427,423,2,4,"PUM+J",0
49,"49170",111,87,85,1,2,"PUM+J",1
40,"40062",54,44,44,0,0,"PUM+J",0
13,"13904",556,448,441,14,7,"PUM+J",2
49,"49036",592,410,403,5,7,"PUM+J",0
40,"40159",150,111,110,0,1,"PUM+J",0
10,"10078",451,349,341,3,8,"PUM+J",0
34,"34037",345,256,253,4,3,"PUM+J",0
50,"50079",281,213,210,2,3,"PUM+J",0
40,"40063",7290,5366,5171,68,195,"PUM+J",14
40,"40018",102,88,87,2,1,"PUM+J",0
49,"49265",143,105,105,1,0,"PUM+J",0
9,"9354",33,29,29,2,0,"PUM+J",0
26,"26023",505,386,380,6,6,"PUM+J",1
9,"9415",290,192,192,4,0,"PUM+J",0
9,"9276",420,275,245,5,30,"PUM+J",7
44,"44265",203,169,158,6,11,"PUM+J",0
22,"22234",818,609,605,12,4,"PUM+J",2
41,"41085",3918,3173,3128,42,45,"PUM+J",4
16,"16047",249,192,191,5,1,"PUM+J",0
49,"49173",430,272,272,5,0,"PUM+J",0
47,"47130",105,86,85,2,1,"PUM+J",0
42,"42018",178,129,124,0,5,"PUM+J",0
16,"16277",128,100,100,3,0,"PUM+J",0
24,"24196",2183,1573,1543,11,30,"PUM+J",3
38,"38025",6649,4858,4778,52,80,"PUM+J",16
47,"47010",11275,8800,8701,163,99,"PUM+J",18
50,"50026",459,360,354,5,6,"PUM+J",1
5,"5254",212,186,185,2,1,"PUM+J",0
21,"21065",295,212,211,0,1,"PUM+J",0
9,"9265",44,36,35,2,1,"PUM+J",0
52,"52001",51028,26966,26659,496,307,"PUM+J",79
42,"42156",30,21,21,0,0,"PUM+J",0
34,"34088",219,179,177,4,2,"PUM+J",2
10,"10107",1062,832,821,7,11,"PUM+J",1
15,"15017",18860,12975,12737,325,238,"PUM+J",39
40,"40194",40248,30946,30365,525,581,"PUM+J",113
49,"49009",430,309,309,0,0,"PUM+J",0
40,"40163",62,51,51,5,0,"PUM+J",0
50,"50199",380,263,254,2,9,"PUM+J",0
44,"44117",357,278,275,0,3,"PUM+J",1
40,"40070",137,91,91,0,0,"PUM+J",0
50,"50256",90,59,59,1,0,"PUM+J",2
9,"9312",113,94,91,0,3,"PUM+J",0
5,"5186",1670,1306,1287,9,19,"PUM+J",2
7,"7037",3269,1737,1700,37,37,"PUM+J",3
16,"16212",286,229,226,3,3,"PUM+J",0
26,"26067",22,19,19,1,0,"PUM+J",0
38,"38036",6477,4514,4422,40,92,"PUM+J",9
9,"9088",77,40,40,0,0,"PUM+J",0
33,"33009",951,673,663,7,10,"PUM+J",1
44,"44239",29,25,25,1,0,"PUM+J",0
24,"24132",683,440,435,5,5,"PUM+J",1
9,"9480",106,87,87,0,0,"PUM+J",0
44,"44185",117,91,90,0,1,"PUM+J",0
6,"6110",176,130,124,0,6,"PUM+J",0
15,"15084",3681,2676,2656,34,20,"PUM+J",1
16,"16151",66,56,56,0,0,"PUM+J",0
10,"10205",2081,1486,1457,19,29,"PUM+J",5
18,"18908",827,669,660,7,9,"PUM+J",0
16,"16249",2076,1728,1700,11,28,"PUM+J",1
47,"47231",4272,3268,3243,64,25,"PUM+J",2
5,"5238",815,649,641,6,8,"PUM+J",0
47,"47027",2680,2059,2024,23,35,"PUM+J",8
34,"34031",29,26,26,0,0,"PUM+J",0
13,"13037",901,752,745,2,7,"PUM+J",0
14,"14015",2198,1776,1755,16,21,"PUM+J",1
47,"47117",306,231,228,4,3,"PUM+J",1
42,"42107",86,60,59,2,1,"PUM+J",0
9,"9051",181,136,133,2,3,"PUM+J",0
24,"24162",1631,1214,1195,33,19,"PUM+J",5
44,"44251",271,218,218,5,0,"PUM+J",0
50,"50243",346,277,272,2,5,"PUM+J",0
16,"16101",160,142,142,0,0,"PUM+J",0
42,"42166",68,49,48,1,1,"PUM+J",0
10,"10188",553,473,468,2,5,"PUM+J",0
15,"15062",6304,4418,4356,44,62,"PUM+J",7
5,"5226",92,67,67,0,0,"PUM+J",0
28,"28088",251,174,173,5,1,"PUM+J",0
16,"16111",171,130,128,0,2,"PUM+J",0
26,"26058",151,114,109,1,5,"PUM+J",0
9,"9363",1047,798,792,9,6,"PUM+J",2
9,"9227",131,100,100,1,0,"PUM+J",0
13,"13021",459,358,355,5,3,"PUM+J",0
26,"26115",20,20,20,4,0,"PUM+J",0
49,"49005",156,102,101,2,1,"PUM+J",0
34,"34003",167,132,130,7,2,"PUM+J",2
50,"50094",1744,1220,1193,25,27,"PUM+J",3
49,"49047",120,91,90,1,1,"PUM+J",0
31,"31060",12916,8830,8687,158,143,"PUM+J",39
34,"34004",5790,4354,4262,84,92,"PUM+J",7
49,"49275",53766,37940,37379,774,561,"PUM+J",125
18,"18132",3461,2797,2772,19,25,"PUM+J",1
31,"31141",132,100,98,1,2,"PUM+J",0
44,"44062",38,34,34,0,0,"PUM+J",0
24,"24176",336,267,261,3,6,"PUM+J",0
49,"49181",386,308,307,2,1,"PUM+J",0
26,"26175",57,46,45,1,1,"PUM+J",0
38,"38018",4397,3216,3163,27,53,"PUM+J",10
14,"14065",1846,1509,1492,14,17,"PUM+J",3
9,"9432",212,161,158,1,3,"PUM+J",0
5,"5213",117,94,88,0,6,"PUM+J",0
22,"22126",100,81,80,2,1,"PUM+J",0
40,"40049",52,39,39,1,0,"PUM+J",0
38,"38015",4326,3132,3099,21,33,"PUM+J",12
50,"50029",676,527,517,6,10,"PUM+J",0
47,"47112",2671,2231,2198,28,33,"PUM+J",7
7,"7035",1542,1190,1161,19,29,"PUM+J",3
16,"16129",112,79,74,0,5,"PUM+J",0
7,"7061",9429,5937,5800,125,137,"PUM+J",9
21,"21005",15205,11006,10909,108,97,"PUM+J",7
9,"9414",197,159,159,2,0,"PUM+J",1
49,"49083",67,48,48,1,0,"PUM+J",0
24,"24167",813,509,509,8,0,"PUM+J",0
9,"9429",64,44,44,2,0,"PUM+J",0
24,"24159",1901,1492,1477,11,15,"PUM+J",3
16,"16088",125,103,103,1,0,"PUM+J",0
38,"38031",28391,21797,21431,234,366,"PUM+J",45
50,"50087",31,25,25,0,0,"PUM+J",0
15,"15005",23875,15132,14895,356,237,"PUM+J",34
5,"5200",56,43,42,0,1,"PUM+J",0
5,"5260",114,101,101,1,0,"PUM+J",0
40,"40079",236,174,171,0,3,"PUM+J",0
31,"31124",209,139,138,1,1,"PUM+J",0
21,"21075",375,294,291,12,3,"PUM+J",1
2,"2054",421,346,343,2,3,"PUM+J",1
38,"38043",18628,12966,12763,134,203,"PUM+J",52
40,"40034",85,73,73,1,0,"PUM+J",0
9,"9454",46,31,30,1,1,"PUM+J",0
21,"21003",691,540,536,7,4,"PUM+J",0
33,"33037",37135,25522,25262,291,260,"PUM+J",8
42,"42021",101,70,70,1,0,"PUM+J",0
9,"9294",123,96,93,1,3,"PUM+J",0
31,"31114",384,320,318,37,2,"PUM+J",6
42,"42187",65,51,51,0,0,"PUM+J",0
42,"42168",128,82,81,4,1,"PUM+J",0
16,"16910",104,69,69,1,0,"PUM+J",0
40,"40218",111,81,80,1,1,"PUM+J",0
44,"44028",202,159,156,2,3,"PUM+J",0
50,"50099",3136,2333,2297,27,36,"PUM+J",1
2,"2079",2936,2305,2235,29,70,"PUM+J",7
50,"50130",415,288,288,7,0,"PUM+J",0
47,"47098",607,496,492,9,4,"PUM+J",1
9,"9122",93,71,71,4,0,"PUM+J",0
31,"31208",2574,2003,1966,32,37,"PUM+J",4
5,"5198",80,65,65,1,0,"PUM+J",0
22,"22081",268,197,196,4,1,"PUM+J",2
28,"28079",2290453,1721837,1705310,17342,16527,"PUM+J",3116
13,"13060",291,235,229,0,6,"PUM+J",0
38,"38008",5430,3844,3772,46,72,"PUM+J",7
16,"16150",120,90,90,0,0,"PUM+J",0
34,"34055",288,215,212,4,3,"PUM+J",0
40,"40036",531,440,424,10,16,"PUM+J",0
28,"28148",79726,60405,59651,724,754,"PUM+J",75
41,"41099",4141,2818,2799,37,19,"PUM+J",4
32,"32028",1805,1369,1354,16,15,"PUM+J",0
28,"28040",15089,9976,9852,116,124,"PUM+J",13
49,"49175",263,215,215,4,0,"PUM+J",1
44,"44029",637,495,490,6,5,"PUM+J",0
49,"49040",118,102,98,1,4,"PUM+J",0
9,"9044",54,45,45,1,0,"PUM+J",0
15,"15008",5657,4224,4157,62,67,"PUM+J",9
38,"38002",991,716,708,1,8,"PUM+J",1
40,"40228",539,446,437,2,9,"PUM+J",1
9,"9314",113,89,88,4,1,"PUM+J",1
40,"40134",769,628,620,19,8,"PUM+J",1
22,"22223",92,65,64,3,1,"PUM+J",0
5,"5113",90,74,74,0,0,"PUM+J",0
9,"9251",417,292,288,3,4,"PUM+J",1
9,"9036",32,27,27,2,0,"PUM+J",0
40,"40103",157,121,120,0,1,"PUM+J",1
13,"13051",358,291,289,5,2,"PUM+J",0
9,"9050",77,52,52,0,0,"PUM+J",0
33,"33039",1719,1325,1319,14,6,"PUM+J",1
28,"28049",59507,46919,46379,488,540,"PUM+J",67
14,"14055",18619,13802,13607,192,195,"PUM+J",15
31,"31190",48,34,34,1,0,"PUM+J",0
5,"5104",35,29,29,0,0,"PUM+J",0
31,"31240",553,360,359,3,1,"PUM+J",0
40,"40212",29,22,20,0,2,"PUM+J",2
40,"40150",76,62,62,1,0,"PUM+J",0
50,"50113",653,528,526,9,2,"PUM+J",0
44,"44181",82,63,63,3,0,"PUM+J",0
49,"49042",271,216,216,1,0,"PUM+J",0
28,"28132",10987,8066,7943,90,123,"PUM+J",14
42,"42014",83,55,55,1,0,"PUM+J",0
42,"42161",158,119,119,0,0,"PUM+J",1
24,"24139",2320,1687,1654,16,33,"PUM+J",3
22,"22013",304,239,236,3,3,"PUM+J",0
16,"16167",357,318,315,5,3,"PUM+J",0
34,"34059",462,377,375,5,2,"PUM+J",0
16,"16216",358,300,296,2,4,"PUM+J",0
34,"34061",116,78,78,2,0,"PUM+J",0
50,"50020",868,646,629,5,17,"PUM+J",0
5,"5251",80,58,58,0,0,"PUM+J",0
22,"22011",102,78,78,3,0,"PUM+J",0
13,"13068",1058,801,793,4,8,"PUM+J",1
26,"26017",380,277,276,3,1,"PUM+J",0
50,"50165",1880,1339,1274,49,65,"PUM+J",4
5,"5148",34,27,27,0,0,"PUM+J",1
33,"33036",11674,8695,8605,104,90,"PUM+J",2
22,"22228",501,382,369,15,13,"PUM+J",0
6,"6135",1094,898,890,14,8,"PUM+J",1
31,"31243",313,227,223,5,4,"PUM+J",0
5,"5130",95,76,76,0,0,"PUM+J",0
22,"22178",107,92,92,1,0,"PUM+J",0
31,"31110",97,53,53,3,0,"PUM+J",0
34,"34101",54,44,44,0,0,"PUM+J",0
47,"47064",30,21,21,1,0,"PUM+J",1
13,"13098",2265,1805,1759,19,46,"PUM+J",2
44,"44217",37,28,27,0,1,"PUM+J",0
34,"34223",233,175,175,2,0,"PUM+J",0
9,"9094",49,39,39,0,0,"PUM+J",0
50,"50116",220,154,153,0,1,"PUM+J",0
31,"31151",77,49,49,2,0,"PUM+J",0
16,"16005",275,215,215,2,0,"PUM+J",2
28,"28087",3150,2475,2453,26,22,"PUM+J",2
16,"16271",659,568,566,4,2,"PUM+J",0
22,"22186",217,173,173,3,0,"PUM+J",0
10,"10064",1549,1229,1209,6,20,"PUM+J",0
16,"16132",36,31,31,0,0,"PUM+J",0
44,"44016",541,384,379,5,5,"PUM+J",0
9,"9407",31,27,27,0,0,"PUM+J",0
42,"42041",36,25,25,4,0,"PUM+J",0
9,"9267",135,118,118,3,0,"PUM+J",0
9,"9361",134,99,98,0,1,"PUM+J",0
40,"40093",88,77,72,0,5,"PUM+J",0
42,"42042",46,35,33,1,2,"PUM+J",0
49,"49032",369,295,291,0,4,"PUM+J",0
28,"28031",1981,1524,1500,9,24,"PUM+J",0
44,"44264",249,196,193,1,3,"PUM+J",0
38,"38021",1792,1184,1160,6,24,"PUM+J",5
31,"31226",597,339,335,2,4,"PUM+J",0
9,"9467",65,49,49,0,0,"PUM+J",0
44,"44012",389,297,293,5,4,"PUM+J",0
31,"31255",100,78,78,1,0,"PUM+J",0
47,"47026",59,46,46,1,0,"PUM+J",0
40,"40204",187,139,134,4,5,"PUM+J",0
49,"49052",200,149,144,1,5,"PUM+J",1
42,"42184",76,50,49,0,1,"PUM+J",0
42,"42033",54,48,48,0,0,"PUM+J",0
50,"50264",184,140,134,0,6,"PUM+J",2
6,"6064",900,715,706,2,9,"PUM+J",0
34,"34122",80,65,62,2,3,"PUM+J",0
18,"18006",4116,2862,2831,25,31,"PUM+J",2
44,"44256",37,35,35,9,0,"PUM+J",0
10,"10185",587,457,450,1,7,"PUM+J",2
9,"9427",1561,1090,1078,18,12,"PUM+J",2
50,"50069",68,32,32,0,0,"PUM+J",0
16,"16046",262,191,191,1,0,"PUM+J",0
22,"22233",94,69,69,0,0,"PUM+J",1
49,"49024",736,551,544,16,7,"PUM+J",3
31,"31902",3722,2670,2632,77,38,"PUM+J",13
24,"24022",364,231,230,2,1,"PUM+J",0
49,"49061",141,106,105,1,1,"PUM+J",0
9,"9421",269,189,189,5,0,"PUM+J",0
28,"28155",529,427,416,2,11,"PUM+J",0
42,"42012",43,29,29,1,0,"PUM+J",0
40,"40225",1152,931,918,10,13,"PUM+J",0
24,"24014",7677,5352,5289,75,63,"PUM+J",7
10,"10204",489,364,351,3,13,"PUM+J",0
16,"16108",68,56,55,0,1,"PUM+J",0
16,"16227",128,95,94,0,1,"PUM+J",0
50,"50082",108,73,72,0,1,"PUM+J",0
42,"42172",31,28,28,3,0,"PUM+J",0
38,"38038",161890,99555,97980,1101,1575,"PUM+J",391
24,"24055",747,557,549,11,8,"PUM+J",0
24,"24166",1521,1137,1112,27,25,"PUM+J",2
26,"26164",70,42,42,1,0,"PUM+J",0
9,"9033",104,82,80,1,2,"PUM+J",0
47,"47019",93,69,68,0,1,"PUM+J",0
47,"47124",435,364,358,5,6,"PUM+J",2
47,"47052",6207,4812,4761,79,51,"PUM+J",12
13,"13056",10945,8173,8070,111,103,"PUM+J",10
13,"13067",380,314,312,3,2,"PUM+J",0
47,"47178",190,162,161,1,1,"PUM+J",1
31,"31236",1333,887,874,15,13,"PUM+J",3
49,"49028",119,103,103,1,0,"PUM+J",1
9,"9482",33,31,30,1,1,"PUM+J",0
42,"42019",562,392,383,9,9,"PUM+J",0
34,"34246",78,64,64,0,0,"PUM+J",0
22,"22254",1175,868,856,14,12,"PUM+J",0
18,"18117",535,444,440,2,4,"PUM+J",2
50,"50018",973,761,755,12,6,"PUM+J",0
42,"42029",164,114,113,1,1,"PUM+J",0
26,"26166",152,139,136,1,3,"PUM+J",0
16,"16135",192,127,125,0,2,"PUM+J",0
31,"31087",163,122,121,3,1,"PUM+J",0
40,"40100",303,241,231,5,10,"PUM+J",0
7,"7055",7000,4471,4379,67,92,"PUM+J",13
24,"24079",1045,721,710,15,11,"PUM+J",1
7,"7049",1482,1046,1037,14,9,"PUM+J",3
33,"33005",1600,1084,1080,6,4,"PUM+J",0
44,"44152",62,50,50,3,0,"PUM+J",0
34,"34042",299,249,246,5,3,"PUM+J",1
47,"47086",4062,3162,3120,37,42,"PUM+J",4
16,"16098",586,480,474,10,6,"PUM+J",0
6,"6058",2048,1595,1574,22,21,"PUM+J",3
28,"28024",156,132,132,5,0,"PUM+J",0
50,"50088",337,273,264,4,9,"PUM+J",0
47,"47106",63,52,52,0,0,"PUM+J",0
44,"44023",13,11,11,0,0,"PUM+J",0
9,"9323",71,44,44,2,0,"PUM+J",1
26,"26178",88,74,73,1,1,"PUM+J",0
22,"22177",101,79,75,1,4,"PUM+J",0
42,"42195",112,74,72,1,2,"PUM+J",1
24,"24020",480,326,324,9,2,"PUM+J",1
16,"16140",34,27,27,0,0,"PUM+J",0
42,"42191",187,143,141,5,2,"PUM+J",0
18,"18901",583,374,368,3,6,"PUM+J",1
6,"6053",642,466,454,4,12,"PUM+J",1
9,"9321",1760,1338,1327,20,11,"PUM+J",2
9,"9398",92,68,68,2,0,"PUM+J",1
22,"22247",31,21,20,1,1,"PUM+J",0
9,"9903",3299,2373,2349,45,24,"PUM+J",1
9,"9041",27,27,27,0,0,"PUM+J",0
5,"5138",326,278,275,2,3,"PUM+J",0
6,"6102",1045,851,840,7,11,"PUM+J",1
34,"34179",32,21,21,0,0,"PUM+J",0
49,"49068",523,356,353,5,3,"PUM+J",0
10,"10100",792,554,538,1,16,"PUM+J",1
44,"44121",63,48,48,1,0,"PUM+J",0
21,"21007",6088,4174,4123,57,51,"PUM+J",7
38,"38003",1446,1053,1044,4,9,"PUM+J",0
10,"10207",499,394,392,1,2,"PUM+J",0
2,"2039",1050,862,848,16,14,"PUM+J",0
14,"14071",1025,739,733,8,6,"PUM+J",0
16,"16061",1035,861,848,15,13,"PUM+J",0
5,"5239",215,171,170,2,1,"PUM+J",0
14,"14063",1121,875,866,9,9,"PUM+J",0
5,"5019",44095,34409,33934,505,475,"PUM+J",45
18,"18189",723,547,541,6,6,"PUM+J",0
22,"22084",524,362,354,11,8,"PUM+J",1
6,"6072",2370,1907,1885,9,22,"PUM+J",4
38,"38048",3884,2615,2587,34,28,"PUM+J",7
50,"50138",49,43,43,2,0,"PUM+J",0
34,"34214",176,144,143,3,1,"PUM+J",0
21,"21057",1054,699,697,9,2,"PUM+J",0
5,"5123",90,69,69,3,0,"PUM+J",0
2,"2055",1267,900,884,6,16,"PUM+J",1
5,"5230",79,73,73,1,0,"PUM+J",0
18,"18003",13486,10245,10100,145,145,"PUM+J",14
14,"14041",3215,2492,2439,45,53,"PUM+J",1
18,"18076",880,676,676,3,0,"PUM+J",0
41,"41079",9349,7095,7001,71,94,"PUM+J",5
18,"18185",608,484,479,2,5,"PUM+J",0
35,"35031",6968,4927,4862,71,65,"PUM+J",21
22,"22004",146,97,97,2,0,"PUM+J",1
16,"16225",89,69,68,1,1,"PUM+J",0
47,"47032",161,130,129,3,1,"PUM+J",0
24,"24125",545,374,373,5,1,"PUM+J",0
50,"50001",130,96,96,0,0,"PUM+J",0
21,"21036",213,172,167,1,5,"PUM+J",0
10,"10127",4663,3554,3498,38,56,"PUM+J",8
26,"26048",29,27,26,1,1,"PUM+J",0
32,"32015",995,697,694,9,3,"PUM+J",0
6,"6139",600,489,481,5,8,"PUM+J",1
49,"49174",131,97,97,1,0,"PUM+J",0
40,"40076",6641,4958,4862,67,96,"PUM+J",6
47,"47210",396,324,321,5,3,"PUM+J",0
44,"44235",103,71,68,0,3,"PUM+J",0
22,"22197",504,395,390,7,5,"PUM+J",3
14,"14043",7664,5935,5874,53,61,"PUM+J",8
50,"50200",534,436,432,9,4,"PUM+J",0
16,"16060",841,714,704,11,10,"PUM+J",0
7,"7034",971,724,708,10,16,"PUM+J",2
10,"10213",605,478,477,1,1,"PUM+J",0
5,"5102",1850,1487,1475,11,12,"PUM+J",1
5,"5240",3351,2472,2428,22,44,"PUM+J",4
50,"50014",169,108,108,1,0,"PUM+J",0
10,"10208",141,118,118,1,0,"PUM+J",0
42,"42131",53,38,37,0,1,"PUM+J",0
49,"49126",232,175,173,3,2,"PUM+J",0
47,"47093",865,658,642,11,16,"PUM+J",0
13,"13059",232,186,184,0,2,"PUM+J",0
34,"34151",184,125,123,1,2,"PUM+J",0
50,"50902",97,85,85,1,0,"PUM+J",0
40,"40165",95,72,71,1,1,"PUM+J",0
24,"24136",596,465,463,12,2,"PUM+J",3
28,"28099",1670,1258,1246,9,12,"PUM+J",1
32,"32012",912,763,756,8,7,"PUM+J",1
7,"7031",23371,14443,14213,285,230,"PUM+J",24
21,"21010",14308,8960,8861,154,99,"PUM+J",7
22,"22182",271,160,150,4,10,"PUM+J",0
38,"38010",4054,2642,2599,17,43,"PUM+J",4
7,"7001",3450,2544,2470,36,74,"PUM+J",2
47,"47111",1005,804,794,5,10,"PUM+J",0
13,"13090",1202,994,972,4,22,"PUM+J",0
10,"10048",299,232,231,0,1,"PUM+J",0
26,"26036",16873,12341,12167,190,174,"PUM+J",27
44,"44212",45,35,35,0,0,"PUM+J",0
31,"31104",1990,1374,1355,20,19,"PUM+J",5
16,"16074",53,42,42,1,0,"PUM+J",0
40,"40080",68,53,52,0,1,"PUM+J",0
31,"31161",321,251,246,5,5,"PUM+J",0
28,"28091",5202,3714,3671,34,43,"PUM+J",1
47,"47114",4107,2877,2834,37,43,"PUM+J",6
16,"16058",120,103,102,1,1,"PUM+J",1
13,"13045",744,615,608,6,7,"PUM+J",1
32,"32005",957,760,753,8,7,"PUM+J",1
26,"26054",381,298,292,2,6,"PUM+J",1
13,"13007",1319,1069,1051,18,18,"PUM+J",1
22,"22162",135,107,107,3,0,"PUM+J",3
42,"42117",146,115,111,1,4,"PUM+J",0
34,"34103",105,92,92,5,0,"PUM+J",0
47,"47091",97,82,80,3,2,"PUM+J",0
50,"50282",88,66,63,3,3,"PUM+J",0
10,"10212",1688,1276,1242,16,34,"PUM+J",4
5,"5133",62,49,49,0,0,"PUM+J",0
22,"22116",1571,1127,1114,37,13,"PUM+J",1
18,"18046",1960,1327,1312,5,15,"PUM+J",0
34,"34012",368,277,275,9,2,"PUM+J",2
22,"22068",79,51,51,2,0,"PUM+J",0
40,"40903",102,75,75,0,0,"PUM+J",0
49,"49263",69,54,54,2,0,"PUM+J",0
40,"40144",19,17,17,1,0,"PUM+J",1
44,"44243",38,27,26,3,1,"PUM+J",0
47,"47103",277,218,214,1,4,"PUM+J",1
31,"31022",544,378,369,1,9,"PUM+J",0
44,"44043",126,94,94,7,0,"PUM+J",0
40,"40119",182,149,145,2,4,"PUM+J",0
6,"6129",631,493,490,2,3,"PUM+J",5
44,"44177",120,85,85,1,0,"PUM+J",0
18,"18061",1109,882,869,1,13,"PUM+J",0
5,"5149",128,97,97,1,0,"PUM+J",0
31,"31019",1858,1288,1266,25,22,"PUM+J",0
16,"16126",811,701,692,13,9,"PUM+J",3
5,"5170",63,50,50,0,0,"PUM+J",0
22,"22144",258,203,203,5,0,"PUM+J",0
50,"50003",141,108,108,3,0,"PUM+J",0
5,"5053",94,73,71,0,2,"PUM+J",0
24,"24124",419,286,282,0,4,"PUM+J",0
40,"40176",418,344,341,8,3,"PUM+J",1
5,"5153",112,89,89,5,0,"PUM+J",0
50,"50075",89,74,74,1,0,"PUM+J",0
49,"49122",701,542,534,7,8,"PUM+J",4
5,"5237",198,157,155,3,2,"PUM+J",0
47,"47123",456,356,353,10,3,"PUM+J",0
42,"42034",40,29,29,0,0,"PUM+J",1
16,"16217",113,95,92,0,3,"PUM+J",0
42,"42174",188,142,138,5,4,"PUM+J",0
7,"7902",1071,734,712,22,22,"PUM+J",2
50,"50269",316,186,185,1,1,"PUM+J",0
40,"40231",128,102,100,3,2,"PUM+J",0
42,"42132",159,132,127,4,5,"PUM+J",1
42,"42127",47,35,35,0,0,"PUM+J",0
10,"10180",5446,3957,3917,28,40,"PUM+J",2
40,"40123",168,130,126,3,4,"PUM+J",0
35,"35025",1941,1345,1328,12,17,"PUM+J",6
44,"44048",77,59,59,0,0,"PUM+J",0
49,"49014",134,104,102,1,2,"PUM+J",0
16,"16194",298,238,238,1,0,"PUM+J",0
34,"34063",102,92,91,2,1,"PUM+J",0
26,"26092",112,89,88,2,1,"PUM+J",0
28,"28108",3002,2254,2228,31,26,"PUM+J",4
33,"33021",4932,3544,3502,45,42,"PUM+J",2
18,"18913",827,653,646,2,7,"PUM+J",1
50,"50037",140,110,103,3,7,"PUM+J",1
16,"16002",195,175,172,0,3,"PUM+J",0
38,"38032",13032,8487,8357,101,130,"PUM+J",31
31,"31144",840,509,508,7,1,"PUM+J",4
42,"42211",92,69,68,0,1,"PUM+J",0
40,"40075",182,149,146,4,3,"PUM+J",0
2,"2038",296,254,254,1,0,"PUM+J",0
7,"7018",389,275,271,0,4,"PUM+J",1
5,"5263",175,133,131,0,2,"PUM+J",0
44,"44052",96,60,59,2,1,"PUM+J",0
26,"26150",129,104,104,0,0,"PUM+J",0
9,"9003",205,156,154,4,2,"PUM+J",0
16,"16244",735,615,606,3,9,"PUM+J",0
22,"22016",654,476,464,10,12,"PUM+J",0
5,"5159",287,216,216,0,0,"PUM+J",0
18,"18143",949,722,704,2,18,"PUM+J",1
5,"5054",1282,979,965,5,14,"PUM+J",0
31,"31181",168,121,119,3,2,"PUM+J",0
50,"50009",122,93,93,0,0,"PUM+J",0
9,"9197",160,129,128,3,1,"PUM+J",0
31,"31130",319,213,209,1,4,"PUM+J",0
49,"49123",557,421,415,5,6,"PUM+J",0
9,"9154",150,107,107,3,0,"PUM+J",0
5,"5160",339,290,286,2,4,"PUM+J",0
47,"47038",128,91,91,0,0,"PUM+J",0
40,"40200",47,41,39,0,2,"PUM+J",0
9,"9440",105,80,80,0,0,"PUM+J",0
24,"24180",1196,868,862,22,6,"PUM+J",3
18,"18020",1473,1111,1106,7,5,"PUM+J",0
41,"41073",1789,1292,1272,5,20,"PUM+J",1
16,"16259",30,26,26,1,0,"PUM+J",0
24,"24188",3830,2987,2928,51,59,"PUM+J",9
31,"31140",117,91,89,3,2,"PUM+J",0
50,"50048",43,33,33,1,0,"PUM+J",0
31,"31089",246,198,195,4,3,"PUM+J",1
24,"24017",630,476,468,11,8,"PUM+J",1
40,"40037",47,35,35,0,0,"PUM+J",0
16,"16003",147,122,121,0,1,"PUM+J",0
33,"33052",758,526,518,2,8,"PUM+J",0
47,"47129",954,744,731,4,13,"PUM+J",3
34,"34091",136,105,103,1,2,"PUM+J",0
9,"9317",17,15,15,0,0,"PUM+J",1
5,"5233",246,212,212,2,0,"PUM+J",0
24,"24901",994,698,686,8,12,"PUM+J",1
40,"40190",50,41,40,1,1,"PUM+J",0
50,"50091",56,39,39,1,0,"PUM+J",0
38,"38050",2516,1765,1734,9,31,"PUM+J",5
9,"9400",340,253,249,4,4,"PUM+J",0
40,"40215",109,94,91,0,3,"PUM+J",0
24,"24069",53,44,44,0,0,"PUM+J",0
44,"44247",335,251,243,10,8,"PUM+J",1
42,"42090",96,75,74,3,1,"PUM+J",0
6,"6052",3965,3176,3134,33,42,"PUM+J",3
7,"7051",4925,2993,2947,66,46,"PUM+J",5
13,"13058",4155,3320,3285,24,35,"PUM+J",2
31,"31257",827,598,585,16,13,"PUM+J",1
44,"44039",255,189,189,5,0,"PUM+J",0
38,"38017",24438,13769,13576,176,193,"PUM+J",28
18,"18178",834,685,683,3,2,"PUM+J",0
18,"18072",710,507,499,2,8,"PUM+J",1
6,"6007",1557,1200,1189,4,11,"PUM+J",1
26,"26040",67,63,62,2,1,"PUM+J",0
21,"21009",916,622,608,6,14,"PUM+J",0
9,"9309",343,252,246,7,6,"PUM+J",0
16,"16029",114,80,80,0,0,"PUM+J",0
9,"9026",384,296,295,8,1,"PUM+J",2
16,"16272",273,215,215,2,0,"PUM+J",1
24,"24033",214,157,152,3,5,"PUM+J",0
47,"47079",67,56,56,1,0,"PUM+J",0
5,"5015",100,78,78,0,0,"PUM+J",0
9,"9334",52,40,39,1,1,"PUM+J",0
38,"38027",5392,3530,3459,41,71,"PUM+J",3
28,"28903",29222,23945,23689,296,256,"PUM+J",50
40,"40058",368,306,304,1,2,"PUM+J",1
47,"47029",61,54,53,0,1,"PUM+J",0
18,"18108",892,674,673,2,1,"PUM+J",1
7,"7059",3011,2077,2012,22,65,"PSM-IV-EXM-EQUO",148
7,"7025",457,355,346,3,9,"PSM-IV-EXM-EQUO",38
7,"7065",2061,1376,1345,29,31,"PSM-IV-EXM-EQUO",247
7,"7036",25502,17151,16914,294,237,"PSM-IV-EXM-EQUO",1092
7,"7037",3269,1737,1700,37,37,"PSM-IV-EXM-EQUO",121
7,"7007",454,304,300,4,4,"PSM-IV-EXM-EQUO",54
7,"7039",4920,3488,3377,54,111,"PSM-IV-EXM-EQUO",256
7,"7003",10671,6262,6149,79,113,"PSM-IV-EXM-EQUO",292
7,"7032",19658,12168,11959,238,209,"PSM-IV-EXM-EQUO",550
7,"7061",9429,5937,5800,125,137,"PSM-IV-EXM-EQUO",692
7,"7028",876,607,595,6,12,"PSM-IV-EXM-EQUO",116
7,"7031",23371,14443,14213,285,230,"PSM-IV-EXM-EQUO",764
7,"7033",25954,14975,14738,328,237,"PSM-IV-EXM-EQUO",1352
7,"7044",8326,6044,5846,99,198,"PSM-IV-EXM-EQUO",603
7,"7051",4925,2993,2947,66,46,"PSM-IV-EXM-EQUO",290
7,"7029",4090,2921,2866,44,55,"PSM-IV-EXM-EQUO",299
7,"7013",6525,4528,4409,78,119,"PSM-IV-EXM-EQUO",419
7,"7009",744,593,576,11,17,"PSM-IV-EXM-EQUO",109
7,"7040",266127,162699,160491,2698,2208,"PSM-IV-EXM-EQUO",10485
7,"7014",6697,3818,3757,38,61,"PSM-IV-EXM-EQUO",327
7,"7045",1189,843,823,23,20,"PSM-IV-EXM-EQUO",91
7,"7043",3522,2384,2345,35,39,"PSM-IV-EXM-EQUO",344
7,"7901",642,483,470,5,13,"PSM-IV-EXM-EQUO",60
7,"7017",800,556,539,14,17,"PSM-IV-EXM-EQUO",84
7,"7047",2161,1447,1407,31,40,"PSM-IV-EXM-EQUO",172
7,"7046",13748,8294,8183,183,111,"PSM-IV-EXM-EQUO",123
7,"7038",1962,1504,1480,20,24,"PSM-IV-EXM-EQUO",331
7,"7026",30036,16912,16661,294,251,"PSM-IV-EXM-EQUO",347
7,"7054",19930,11186,11028,196,158,"PSM-IV-EXM-EQUO",243
7,"7011",26954,16786,16595,299,191,"PSM-IV-EXM-EQUO",472
7,"7053",1133,863,839,16,24,"PSM-IV-EXM-EQUO",112
7,"7057",7102,4702,4611,85,91,"PSM-IV-EXM-EQUO",216
7,"7058",2803,2100,2046,38,54,"PSM-IV-EXM-EQUO",234
7,"7056",4701,3164,3090,55,74,"PSM-IV-EXM-EQUO",405
7,"7902",1071,734,712,22,22,"PSM-IV-EXM-EQUO",25
7,"7023",3541,2414,2365,88,49,"PSM-IV-EXM-EQUO",222
7,"7018",389,275,271,0,4,"PSM-IV-EXM-EQUO",51
7,"7020",3455,2491,2453,46,38,"PSM-IV-EXM-EQUO",777
7,"7049",1482,1046,1037,14,9,"PSM-IV-EXM-EQUO",189
7,"7030",1576,1150,1135,26,15,"PSM-IV-EXM-EQUO",237
7,"7055",7000,4471,4379,67,92,"PSM-IV-EXM-EQUO",256
7,"7022",11700,7512,7371,128,141,"PSM-IV-EXM-EQUO",589
7,"7004",3669,2511,2453,51,58,"PSM-IV-EXM-EQUO",345
7,"7041",2077,1583,1549,27,34,"PSM-IV-EXM-EQUO",439
7,"7063",1414,1050,1030,25,20,"PSM-IV-EXM-EQUO",133
7,"7024",6070,3232,3170,60,62,"PSM-IV-EXM-EQUO",103
7,"7048",15296,8559,8439,176,120,"PSM-IV-EXM-EQUO",190
7,"7015",20783,12244,12016,381,228,"PSM-IV-EXM-EQUO",1028
7,"7062",7206,4073,4035,72,38,"PSM-IV-EXM-EQUO",192
7,"7005",6331,4128,4058,76,70,"PSM-IV-EXM-EQUO",306
7,"7019",230,165,164,1,1,"PSM-IV-EXM-EQUO",22
7,"7042",10393,6536,6421,96,115,"PSM-IV-EXM-EQUO",650
7,"7027",20045,12873,12678,204,195,"PSM-IV-EXM-EQUO",1022
7,"7002",6305,4188,4073,80,115,"PSM-IV-EXM-EQUO",191
7,"7035",1542,1190,1161,19,29,"PSM-IV-EXM-EQUO",193
7,"7034",971,724,708,10,16,"PSM-IV-EXM-EQUO",101
7,"7064",5286,3340,3279,53,61,"PSM-IV-EXM-EQUO",159
7,"7001",3450,2544,2470,36,74,"PSM-IV-EXM-EQUO",229
7,"7012",1880,1437,1405,20,32,"PSM-IV-EXM-EQUO",412
7,"7008",5422,3782,3705,61,77,"PSM-IV-EXM-EQUO",373
7,"7010",4668,3229,3174,58,55,"PSM-IV-EXM-EQUO",297
7,"7006",4964,3234,3157,51,77,"PSM-IV-EXM-EQUO",502
7,"7050",3099,2008,1979,45,29,"PSM-IV-EXM-EQUO",31
7,"7060",2534,1724,1697,30,27,"PSM-IV-EXM-EQUO",268
7,"7016",2726,1848,1809,34,39,"PSM-IV-EXM-EQUO",173
7,"7021",255,197,193,1,4,"PSM-IV-EXM-EQUO",21
7,"7052",4578,2671,2651,46,20,"PSM-IV-EXM-EQUO",156
46,"46126",5471,4454,4392,53,62,"RPS",1
46,"46049",292,249,245,0,4,"RPS",0
46,"46103",1244,998,972,12,26,"RPS",3
5,"5135",440,363,360,0,3,"RPS",2
28,"28023",4350,3425,3392,32,33,"RPS",2
30,"30005",29081,22312,22142,184,170,"RPS",15
28,"28057",1419,1084,1074,12,10,"RPS",0
5,"5169",241,218,218,0,0,"RPS",0
5,"5212",274,202,197,0,5,"RPS",0
28,"28028",1615,1204,1173,11,31,"RPS",0
28,"28076",417,325,321,1,4,"RPS",0
5,"5063",48,39,39,2,0,"RPS",0
39,"39007",479,348,347,3,1,"RPS",0
46,"46169",31753,24041,23802,270,239,"RPS",25
46,"46101",868,720,716,8,4,"RPS",0
3,"3038",338,294,291,2,3,"RPS",0
5,"5192",96,78,77,1,1,"RPS",0
46,"46174",1003,854,847,6,7,"RPS",0
39,"39086",386,282,280,1,2,"RPS",1
3,"3076",8373,6319,6222,68,97,"RPS",3
39,"39051",73,62,62,2,0,"RPS",0
39,"39003",321,265,261,0,4,"RPS",0
5,"5266",112,92,89,0,3,"RPS",0
5,"5256",119,101,100,0,1,"RPS",0
46,"46249",9650,7288,7191,125,97,"RPS",3
3,"3065",164772,124457,123236,1556,1221,"RPS",338
28,"28011",437,318,315,2,3,"RPS",0
5,"5002",1996,1497,1476,15,21,"RPS",6
21,"21015",728,453,447,6,6,"RPS",1
46,"46111",10589,7823,7710,94,113,"RPS",3
5,"5233",246,212,212,2,0,"RPS",0
46,"46045",1288,1065,1044,2,21,"RPS",1
3,"3020",108,87,86,1,1,"RPS",0
3,"3032",112,90,88,0,2,"RPS",0
21,"21029",1633,1276,1259,15,17,"RPS",1
46,"46166",8260,6422,6324,60,98,"RPS",1
39,"39081",440,372,369,3,3,"RPS",0
5,"5240",3351,2472,2428,22,44,"RPS",1
28,"28125",2808,2077,2055,19,22,"RPS",1
28,"28039",139,103,103,1,0,"RPS",0
5,"5113",90,74,74,0,0,"RPS",0
21,"21014",4063,3424,3408,27,16,"RPS",1
39,"39054",4265,3338,3276,57,62,"RPS",1
46,"46168",1828,1461,1449,7,12,"RPS",0
5,"5239",215,171,170,2,1,"RPS",0
39,"39092",1030,753,747,1,6,"RPS",0
5,"5185",109,89,89,1,0,"RPS",1
3,"3040",260,224,220,0,4,"RPS",0
46,"46176",1965,1423,1405,12,18,"RPS",0
39,"39097",732,476,470,4,6,"RPS",0
5,"5902",319,262,262,0,0,"RPS",0
28,"28034",356,278,276,1,2,"RPS",0
30,"30002",9802,7628,7553,48,75,"RPS",3
46,"46213",15621,11361,11164,214,197,"RPS",13
3,"3091",256,220,219,1,1,"RPS",1
28,"28073",11899,8877,8769,112,108,"RPS",8
46,"46010",927,706,699,3,7,"RPS",1
46,"46012",930,698,684,9,14,"RPS",0
3,"3021",5594,4630,4517,46,113,"RPS",3
28,"28165",1689,1310,1295,5,15,"RPS",0
46,"46014",3092,2449,2420,26,29,"RPS",0
21,"21036",213,172,167,1,5,"RPS",0
46,"46053",584,484,461,2,23,"RPS",0
21,"21016",1076,823,790,11,33,"RPS",2
28,"28138",78,48,46,0,2,"RPS",0
30,"30032",2839,2361,2337,21,24,"RPS",1
21,"21055",6320,4819,4760,46,59,"RPS",5
46,"46087",137,105,105,1,0,"RPS",0
5,"5121",250,181,178,1,3,"RPS",0
46,"46227",923,787,771,4,16,"RPS",0
39,"39023",6048,4795,4747,43,48,"RPS",5
3,"3010",330,269,266,3,3,"RPS",0
28,"28040",15089,9976,9852,116,124,"RPS",10
30,"30901",10113,8265,8194,70,71,"RPS",8
5,"5026",229,193,192,2,1,"RPS",0
30,"30020",5989,4533,4487,14,46,"RPS",2
5,"5110",710,584,581,1,3,"RPS",0
39,"39058",862,586,584,6,2,"RPS",1
28,"28030",1591,1268,1230,12,38,"RPS",1
3,"3033",127,102,97,2,5,"RPS",0
28,"28027",1232,937,919,9,18,"RPS",0
28,"28055",932,713,707,5,6,"RPS",0
5,"5147",174,141,135,4,6,"RPS",0
28,"28052",3799,2753,2719,17,34,"RPS",1
21,"21001",628,434,428,5,6,"RPS",0
28,"28064",143,112,110,1,2,"RPS",0
28,"28107",443,338,333,7,5,"RPS",0
28,"28179",1385,1039,1027,10,12,"RPS",0
46,"46196",159,145,144,1,1,"RPS",0
5,"5072",91,72,72,1,0,"RPS",1
5,"5217",69,54,54,0,0,"RPS",0
21,"21066",522,440,431,4,9,"RPS",0
46,"46065",1606,1250,1234,15,16,"RPS",0
5,"5013",890,746,739,4,7,"RPS",0
5,"5164",34,24,24,0,0,"RPS",0
28,"28102",913,700,693,9,7,"RPS",0
5,"5086",96,81,81,2,0,"RPS",0
5,"5100",307,245,245,2,0,"RPS",2
5,"5082",569,467,462,1,5,"RPS",0
46,"46134",2326,1691,1664,20,27,"RPS",5
5,"5008",244,200,196,1,4,"RPS",0
30,"30040",733,640,635,2,5,"RPS",1
5,"5204",654,521,516,7,5,"RPS",0
46,"46109",6143,4731,4637,40,94,"RPS",3
39,"39016",24213,18549,18362,265,187,"RPS",23
28,"28104",11704,9455,9361,119,94,"RPS",3
39,"39055",1130,881,869,10,12,"RPS",0
46,"46107",1998,1650,1623,8,27,"RPS",0
21,"21018",1821,1283,1273,19,10,"RPS",0
5,"5081",44,36,36,0,0,"RPS",0
5,"5252",70,52,51,0,1,"RPS",0
30,"30031",560,471,469,3,2,"RPS",0
46,"46028",424,352,347,5,5,"RPS",0
3,"3111",5244,4184,4146,39,38,"RPS",7
39,"39083",1214,785,775,7,10,"RPS",0
21,"21076",2108,1647,1628,22,19,"RPS",0
28,"28162",2263,1802,1786,32,16,"RPS",1
39,"39080",3627,2743,2693,19,50,"RPS",4
46,"46060",9510,7506,7408,52,98,"RPS",4
46,"46063",1764,1441,1423,15,18,"RPS",0
3,"3006",479,380,369,2,11,"RPS",0
5,"5029",132,102,102,0,0,"RPS",1
28,"28002",2650,2018,1993,24,25,"RPS",0
3,"3024",3908,3324,3271,34,53,"RPS",3
5,"5259",132,115,114,1,1,"RPS",7
46,"46115",515,364,354,1,10,"RPS",1
3,"3079",18028,14580,14317,189,263,"RPS",8
5,"5207",743,595,591,1,4,"RPS",0
46,"46182",1190,864,855,11,9,"RPS",0
5,"5052",102,91,91,0,0,"RPS",0
46,"46215",1451,1185,1169,8,16,"RPS",1
46,"46123",1808,1440,1410,7,30,"RPS",0
5,"5025",108,86,86,2,0,"RPS",0
46,"46122",2737,2154,2131,18,23,"RPS",1
46,"46205",14277,10882,10764,115,118,"RPS",9
30,"30006",823,719,711,5,8,"RPS",0
5,"5005",199,170,169,1,1,"RPS",0
28,"28152",14903,11954,11865,125,89,"RPS",7
21,"21040",3096,2370,2351,28,19,"RPS",1
5,"5199",48,39,39,0,0,"RPS",0
28,"28903",29222,23945,23689,296,256,"RPS",7
28,"28155",529,427,416,2,11,"RPS",0
46,"46020",3793,3084,3046,21,38,"RPS",2
21,"21035",9657,6943,6871,64,72,"RPS",3
46,"46006",4643,3847,3785,32,62,"RPS",1
21,"21021",11825,7657,7574,108,83,"RPS",19
28,"28124",83,55,53,0,2,"RPS",0
28,"28181",20003,16133,15952,159,181,"RPS",9
28,"28147",910,705,698,5,7,"RPS",0
46,"46002",1166,942,915,7,27,"RPS",0
28,"28009",13466,10392,10286,102,106,"RPS",6
3,"3125",340,276,275,2,1,"RPS",0
5,"5041",1051,840,827,13,13,"RPS",3
46,"46093",2082,1722,1716,9,6,"RPS",1
39,"39085",6722,5198,5134,60,64,"RPS",3
28,"28140",2665,2167,2141,26,26,"RPS",3
3,"3902",9578,7085,7007,65,78,"RPS",4
39,"39040",4350,3413,3373,30,40,"RPS",3
46,"46211",1716,1459,1447,9,12,"RPS",0
39,"39066",895,710,703,6,7,"RPS",1
46,"46069",166,149,148,1,1,"RPS",0
28,"28041",4006,3190,3154,45,36,"RPS",1
46,"46114",565,501,495,3,6,"RPS",0
5,"5128",361,288,280,3,8,"RPS",2
46,"46095",632,505,495,1,10,"RPS",0
28,"28090",7899,6216,6131,60,85,"RPS",2
5,"5235",136,120,119,2,1,"RPS",0
21,"21032",1790,1362,1347,14,15,"RPS",0
21,"21075",375,294,291,12,3,"RPS",0
5,"5196",69,54,54,2,0,"RPS",0
39,"39031",1227,965,956,4,9,"RPS",0
46,"46203",3669,3002,2964,36,38,"RPS",4
46,"46133",686,572,565,1,7,"RPS",1
3,"3084",593,518,513,2,5,"RPS",0
28,"28085",3794,2980,2933,18,47,"RPS",0
5,"5079",68,52,50,1,2,"RPS",0
3,"3127",399,336,322,3,14,"RPS",0
39,"39042",5928,4680,4634,44,46,"RPS",3
5,"5214",46,23,23,1,0,"RPS",0
21,"21049",3468,2327,2283,18,44,"RPS",1
5,"5104",35,29,29,0,0,"RPS",0
46,"46125",858,724,710,6,14,"RPS",0
21,"21042",15246,8640,8572,154,68,"RPS",11
3,"3007",160,131,127,0,4,"RPS",0
39,"39002",3400,2554,2514,35,40,"RPS",1
30,"30026",15165,10524,10369,80,155,"RPS",5
39,"39078",1407,1041,1033,10,8,"RPS",2
3,"3046",1530,1136,1121,11,15,"RPS",0
3,"3045",233,204,203,2,1,"RPS",0
46,"46030",800,677,662,6,15,"RPS",0
3,"3061",1052,842,836,6,6,"RPS",0
46,"46144",699,547,536,2,11,"RPS",0
28,"28016",86,68,67,3,1,"RPS",0
5,"5165",386,292,280,7,12,"RPS",4
46,"46047",551,479,469,10,10,"RPS",0
21,"21052",4741,2897,2839,21,58,"RPS",5
5,"5127",715,601,596,4,5,"RPS",0
5,"5093",431,330,329,1,1,"RPS",0
3,"3096",5863,4550,4457,57,93,"RPS",9
21,"21069",1778,1245,1242,11,3,"RPS",0
21,"21011",3531,2672,2639,15,33,"RPS",1
28,"28114",148,110,110,0,0,"RPS",0
46,"46033",220,183,181,0,2,"RPS",0
39,"39070",152,118,118,0,0,"RPS",0
39,"39025",8985,7048,6955,70,93,"RPS",3
28,"28097",127,94,92,0,2,"RPS",0
3,"3068",48,45,45,1,0,"RPS",0
3,"3137",719,536,530,3,6,"RPS",1
46,"46252",142,108,107,1,1,"RPS",0
3,"3119",15887,12128,11988,122,140,"RPS",12
46,"46050",161,126,123,1,3,"RPS",0
46,"46225",360,319,310,5,9,"RPS",0
46,"46118",3883,3141,3105,28,36,"RPS",4
21,"21079",749,556,553,6,3,"RPS",2
46,"46180",715,585,581,4,4,"RPS",0
28,"28086",4603,3286,3248,29,38,"RPS",0
5,"5225",423,346,342,8,4,"RPS",0
28,"28033",3581,2712,2691,14,21,"RPS",0
21,"21031",1309,903,871,9,32,"RPS",0
3,"3035",672,560,550,0,10,"RPS",0
5,"5010",173,141,134,2,7,"RPS",0
46,"46195",1975,1631,1631,33,0,"RPS",2
28,"28092",148714,112174,110838,1215,1336,"RPS",76
28,"28183",935,663,649,7,14,"RPS",1
21,"21077",1690,1335,1321,8,14,"RPS",0
3,"3013",1144,941,926,5,15,"RPS",0
5,"5046",44,39,38,1,1,"RPS",0
30,"30011",4687,3776,3726,20,50,"RPS",2
46,"46038",368,264,260,1,4,"RPS",0
28,"28059",4061,3169,3130,38,39,"RPS",1
46,"46152",96,70,70,0,0,"RPS",0
3,"3016",91,67,66,1,1,"RPS",0
46,"46257",5579,4546,4512,32,34,"RPS",2
46,"46200",1915,1625,1595,15,30,"RPS",1
39,"39089",163,126,126,0,0,"RPS",0
28,"28118",72,49,47,1,2,"RPS",0
3,"3088",5381,4056,3988,47,68,"RPS",2
46,"46208",1141,990,978,6,12,"RPS",0
5,"5136",110,75,75,3,0,"RPS",0
21,"21072",10233,7829,7666,124,163,"RPS",8
46,"46161",1454,1192,1179,8,13,"RPS",0
5,"5044",301,217,217,3,0,"RPS",0
21,"21012",331,254,246,2,8,"RPS",0
21,"21039",313,233,232,2,1,"RPS",0
39,"39096",719,521,518,4,3,"RPS",0
3,"3054",371,321,315,2,6,"RPS",0
46,"46130",934,745,734,6,11,"RPS",0
28,"28180",5179,4033,3975,18,58,"RPS",1
46,"46160",1976,1591,1570,21,21,"RPS",0
28,"28021",418,334,328,4,6,"RPS",0
46,"46903",5210,4037,4000,40,37,"RPS",3
46,"46179",2186,1849,1804,17,45,"RPS",0
46,"46113",2338,1804,1797,14,7,"RPS",2
30,"30022",16489,12207,12042,152,165,"RPS",7
39,"39063",1018,769,762,6,7,"RPS",0
28,"28159",629,482,478,2,4,"RPS",0
28,"28150",2985,2363,2345,21,18,"RPS",1
46,"46016",1097,927,917,12,10,"RPS",0
3,"3134",159,129,126,0,3,"RPS",0
28,"28014",31360,23434,23133,203,301,"RPS",9
46,"46207",6453,5086,5031,52,55,"RPS",1
46,"46119",856,702,693,0,9,"RPS",0
21,"21046",1715,1354,1343,15,11,"RPS",3
30,"30014",1686,1400,1387,10,13,"RPS",2
46,"46058",1787,1460,1441,10,19,"RPS",0
5,"5142",113,97,96,0,1,"RPS",0
28,"28119",1911,1527,1514,13,13,"RPS",0
46,"46246",1081,917,904,5,13,"RPS",0
3,"3009",47547,35945,35298,603,647,"RPS",39
3,"3131",181,161,157,1,4,"RPS",0
28,"28082",5144,3967,3905,46,62,"RPS",2
28,"28051",1469,1147,1129,7,18,"RPS",0
5,"5901",289,197,196,4,1,"RPS",0
46,"46262",228,161,158,0,3,"RPS",0
46,"46220",48981,34657,34242,450,415,"RPS",119
46,"46106",1616,1196,1188,6,8,"RPS",1
28,"28074",136617,106248,105095,1101,1153,"RPS",86
46,"46190",48324,34747,34424,431,323,"RPS",44
3,"3062",206,175,175,0,0,"RPS",0
5,"5186",1670,1306,1287,9,19,"RPS",2
5,"5062",213,188,184,3,4,"RPS",0
5,"5105",349,275,272,12,3,"RPS",0
39,"39088",70,61,61,1,0,"RPS",0
39,"39077",256,196,196,1,0,"RPS",0
39,"39094",927,702,691,0,11,"RPS",0
5,"5226",92,67,67,0,0,"RPS",0
5,"5151",100,86,82,1,4,"RPS",0
21,"21065",295,212,211,0,1,"RPS",2
5,"5035",105,87,87,2,0,"RPS",0
5,"5242",692,556,553,18,3,"RPS",0
28,"28047",38404,28739,28436,312,303,"RPS",15
5,"5114",1418,1195,1182,9,13,"RPS",1
46,"46230",14204,10650,10515,112,135,"RPS",7
5,"5205",78,59,58,0,1,"RPS",0
28,"28151",3025,2237,2185,9,52,"RPS",1
5,"5084",81,70,69,0,1,"RPS",0
5,"5053",94,73,71,0,2,"RPS",0
46,"46139",4594,3794,3734,28,60,"RPS",0
5,"5206",29,23,21,2,2,"RPS",0
5,"5067",85,68,68,0,0,"RPS",0
46,"46096",320,267,267,0,0,"RPS",0
5,"5905",253,200,198,1,2,"RPS",0
39,"39098",1522,1256,1244,8,12,"RPS",0
46,"46254",1085,847,834,12,13,"RPS",1
28,"28088",251,174,173,5,1,"RPS",0
5,"5159",287,216,216,0,0,"RPS",0
5,"5171",84,74,73,0,1,"RPS",0
5,"5249",101,73,71,1,2,"RPS",0
5,"5118",91,66,66,0,0,"RPS",0
21,"21048",327,226,226,5,0,"RPS",0
39,"39044",3864,2940,2905,44,35,"RPS",3
21,"21010",14308,8960,8861,154,99,"RPS",5
46,"46192",755,564,554,9,10,"RPS",0
39,"39019",2009,1556,1536,10,20,"RPS",0
5,"5115",590,458,450,1,8,"RPS",0
5,"5001",210,180,176,2,4,"RPS",1
28,"28050",3576,2706,2663,21,43,"RPS",0
30,"30037",17942,13830,13734,90,96,"RPS",7
5,"5258",123,105,104,1,1,"RPS",0
39,"39037",2061,1609,1586,10,23,"RPS",1
46,"46025",2495,1962,1941,24,21,"RPS",0
5,"5070",41,33,33,0,0,"RPS",0
3,"3099",41561,32556,32248,288,308,"RPS",27
21,"21045",261,200,200,5,0,"RPS",0
46,"46090",1668,1488,1452,9,36,"RPS",0
28,"28019",1195,901,888,5,13,"RPS",0
46,"46241",440,336,314,4,22,"RPS",0
46,"46044",4301,3284,3169,50,115,"RPS",0
5,"5021",2044,1592,1557,37,35,"RPS",2
46,"46250",574266,435877,431619,4626,4258,"RPS",277
46,"46234",388,308,307,3,1,"RPS",0
46,"46104",2012,1691,1676,9,15,"RPS",0
5,"5131",118,86,86,3,0,"RPS",0
39,"39091",2026,1636,1628,14,8,"RPS",0
46,"46155",1072,861,849,4,12,"RPS",3
39,"39011",1646,1295,1294,5,1,"RPS",0
30,"30029",11533,8854,8768,73,86,"RPS",4
39,"39018",4077,3212,3160,44,52,"RPS",2
28,"28108",3002,2254,2228,31,26,"RPS",1
39,"39028",3513,2760,2718,23,42,"RPS",1
28,"28013",38226,27886,27547,246,339,"RPS",10
39,"39017",588,424,419,2,5,"RPS",0
3,"3060",124,100,98,0,2,"RPS",1
46,"46098",2556,2072,2057,12,15,"RPS",0
28,"28161",44185,33371,32966,353,405,"RPS",20
46,"46150",1898,1555,1541,8,14,"RPS",1
39,"39100",922,718,712,8,6,"RPS",0
28,"28158",632,505,495,4,10,"RPS",0
5,"5124",134,111,109,1,2,"RPS",0
21,"21004",1530,1059,1042,9,17,"RPS",0
5,"5040",77,59,59,1,0,"RPS",0
39,"39076",3388,2673,2641,22,32,"RPS",1
3,"3083",5708,4267,4196,66,71,"RPS",2
28,"28001",61,46,45,1,1,"RPS",0
5,"5218",148,123,117,1,6,"RPS",0
21,"21026",255,181,169,2,12,"RPS",0
5,"5045",104,82,82,0,0,"RPS",0
28,"28110",1912,1492,1475,8,17,"RPS",0
28,"28037",1598,1263,1250,10,13,"RPS",0
5,"5139",74,62,59,2,3,"RPS",0
5,"5117",213,183,180,0,3,"RPS",0
46,"46036",675,440,431,11,9,"RPS",0
28,"28071",77,57,55,0,2,"RPS",1
39,"39074",6785,5287,5233,50,54,"RPS",2
28,"28143",81,71,67,1,4,"RPS",1
5,"5065",498,424,422,7,2,"RPS",0
46,"46214",15129,11609,11500,116,109,"RPS",5
28,"28126",59,37,37,0,0,"RPS",0
21,"21078",2865,2085,2066,21,19,"RPS",0
3,"3121",20518,14464,14315,137,149,"RPS",17
30,"30034",1182,956,943,3,13,"RPS",0
46,"46112",582,475,463,4,12,"RPS",0
5,"5126",78,70,70,0,0,"RPS",0
5,"5222",155,132,132,1,0,"RPS",0
5,"5129",153,98,95,0,3,"RPS",0
46,"46212",1598,1233,1218,5,15,"RPS",0
46,"46204",6906,5426,5357,62,69,"RPS",1
21,"21028",419,320,315,3,5,"RPS",0
39,"39021",536,448,444,1,4,"RPS",0
5,"5122",156,124,124,0,0,"RPS",1
46,"46247",1059,829,823,6,6,"RPS",0
21,"21056",2992,2172,2096,29,76,"RPS",0
39,"39029",642,521,517,6,4,"RPS",0
21,"21033",508,385,382,7,3,"RPS",0
5,"5209",104,78,78,0,0,"RPS",0
3,"3101",4648,3694,3607,29,87,"RPS",5
28,"28131",12664,9454,9342,100,112,"RPS",5
39,"39084",873,647,642,4,5,"RPS",0
3,"3012",1021,870,862,3,8,"RPS",1
39,"39102",2330,1748,1731,13,17,"RPS",3
28,"28006",74554,57439,56890,586,549,"RPS",38
30,"30027",45194,35272,34973,366,299,"RPS",21
30,"30023",3572,2859,2811,22,48,"RPS",0
3,"3113",4154,3295,3251,24,44,"RPS",3
5,"5224",104,90,90,0,0,"RPS",0
3,"3056",8929,6927,6776,74,151,"RPS",6
39,"39041",1775,1432,1414,15,18,"RPS",0
46,"46079",381,304,299,3,5,"RPS",0
39,"39027",3213,2506,2473,21,33,"RPS",2
28,"28032",4469,3412,3369,32,43,"RPS",1
3,"3031",39966,27099,26802,291,297,"RPS",16
3,"3114",1620,1320,1305,10,15,"RPS",1
5,"5074",755,639,638,5,1,"RPS",1
39,"39068",663,488,485,4,3,"RPS",1
30,"30028",6810,5333,5251,44,82,"RPS",3
5,"5232",106,84,80,1,4,"RPS",0
28,"28066",7033,5439,5383,45,56,"RPS",3
46,"46068",326,292,285,3,7,"RPS",0
5,"5245",344,285,284,5,1,"RPS",2
5,"5022",1649,1335,1328,7,7,"RPS",0
28,"28169",1244,971,962,8,9,"RPS",0
28,"28160",7496,5680,5613,46,67,"RPS",4
3,"3138",3218,2403,2388,22,15,"RPS",3
5,"5175",190,149,149,2,0,"RPS",0
46,"46015",7042,5644,5581,53,63,"RPS",2
21,"21063",2624,2109,2097,13,12,"RPS",0
28,"28132",10987,8066,7943,90,123,"RPS",9
3,"3104",26809,20511,20193,317,318,"RPS",20
46,"46051",8122,6432,6378,57,54,"RPS",1
5,"5177",164,134,133,0,1,"RPS",0
5,"5080",75,53,53,1,0,"RPS",0
46,"46074",2656,2071,2053,22,18,"RPS",0
46,"46059",1310,1076,1058,2,18,"RPS",0
46,"46159",23111,17258,17086,141,172,"RPS",11
39,"39030",1971,1397,1379,20,18,"RPS",0
46,"46198",815,660,654,4,6,"RPS",0
46,"46146",1718,1395,1374,10,21,"RPS",2
5,"5154",46,35,35,0,0,"RPS",0
3,"3071",3993,3180,3128,40,52,"RPS",4
46,"46127",2790,2298,2267,23,31,"RPS",2
21,"21064",6331,4390,4352,46,38,"RPS",2
30,"30001",4763,3992,3956,26,36,"RPS",4
5,"5066",480,397,392,5,5,"RPS",2
28,"28117",116,90,90,1,0,"RPS",0
46,"46073",1119,931,915,14,16,"RPS",0
28,"28168",1144,821,810,15,11,"RPS",0
5,"5238",815,649,641,6,8,"RPS",0
5,"5221",398,298,297,10,1,"RPS",0
46,"46157",3068,2523,2491,17,32,"RPS",0
3,"3057",232,179,178,0,1,"RPS",0
5,"5167",274,230,224,6,6,"RPS",0
5,"5208",55,45,45,0,0,"RPS",0
3,"3095",4498,3558,3517,29,41,"RPS",3
28,"28136",618,527,516,2,11,"RPS",0
46,"46258",2792,2196,2164,14,32,"RPS",3
5,"5251",80,58,58,0,0,"RPS",0
5,"5101",297,224,222,4,2,"RPS",0
28,"28176",10977,8790,8718,68,72,"RPS",4
46,"46153",445,374,366,7,8,"RPS",0
46,"46188",660,579,576,4,3,"RPS",0
5,"5088",34,26,26,0,0,"RPS",0
46,"46239",457,331,323,2,8,"RPS",0
3,"3044",4459,3798,3753,21,45,"RPS",2
39,"39049",339,244,242,5,2,"RPS",0
5,"5030",43,39,39,0,0,"RPS",0
39,"39072",375,234,234,4,0,"RPS",0
46,"46221",350,319,317,3,2,"RPS",0
46,"46181",17153,13332,13184,108,148,"RPS",6
3,"3008",176,142,140,1,2,"RPS",0
3,"3034",1343,1140,1126,5,14,"RPS",0
46,"46229",1065,840,831,8,9,"RPS",0
30,"30018",7493,6003,5922,52,81,"RPS",3
46,"46013",16111,12469,12328,145,141,"RPS",9
28,"28056",782,604,586,6,18,"RPS",0
28,"28049",59507,46919,46379,488,540,"RPS",224
46,"46100",307,264,255,0,9,"RPS",0
28,"28175",780,641,630,8,11,"RPS",0
46,"46132",2124,1845,1817,14,28,"RPS",1
46,"46041",369,255,255,1,0,"RPS",0
21,"21068",1009,726,721,10,5,"RPS",0
21,"21058",2609,1867,1857,15,10,"RPS",0
5,"5264",68,48,48,1,0,"RPS",0
5,"5103",84,68,68,3,0,"RPS",0
5,"5092",172,142,139,0,3,"RPS",0
46,"46184",26507,20314,20010,263,304,"RPS",11
39,"39033",604,480,473,3,7,"RPS",0
5,"5254",212,186,185,2,1,"RPS",1
46,"46117",476,377,373,6,4,"RPS",1
46,"46222",378,321,310,1,11,"RPS",0
30,"30008",13289,9992,9849,86,143,"RPS",15
5,"5014",5559,4197,4101,53,96,"RPS",8
46,"46052",532,471,463,2,8,"RPS",0
3,"3039",92,70,66,1,4,"RPS",0
3,"3122",40476,29591,29265,341,326,"RPS",23
28,"28112",168,138,137,0,1,"RPS",0
3,"3042",1337,1028,1019,8,9,"RPS",0
5,"5229",90,79,77,2,2,"RPS",0
5,"5262",378,308,307,2,1,"RPS",2
5,"5140",112,100,99,1,1,"RPS",0
39,"39052",17031,13198,13034,187,164,"RPS",5
28,"28083",8037,6078,6025,66,53,"RPS",1
46,"46023",318,275,267,2,8,"RPS",0
5,"5155",60,44,44,1,0,"RPS",0
46,"46077",7637,5979,5845,64,134,"RPS",2
46,"46904",782,659,650,6,9,"RPS",0
5,"5057",2593,2172,2152,16,20,"RPS",3
21,"21017",3581,2416,2389,27,27,"RPS",0
28,"28149",5276,4132,4063,43,69,"RPS",3
30,"30042",1841,1531,1519,10,12,"RPS",2
46,"46233",3911,3025,2988,10,37,"RPS",2
5,"5090",72,64,63,1,1,"RPS",0
5,"5241",3145,2303,2273,27,30,"RPS",2
5,"5160",339,290,286,2,4,"RPS",0
5,"5201",557,444,437,2,7,"RPS",0
46,"46240",226,188,185,3,3,"RPS",0
28,"28178",1017,799,791,11,8,"RPS",1
28,"28043",5944,4199,4147,56,52,"RPS",4
28,"28096",16844,12441,12308,117,133,"RPS",5
5,"5234",58,49,49,0,0,"RPS",0
28,"28144",5663,4456,4410,47,46,"RPS",0
5,"5181",39,26,26,0,0,"RPS",0
5,"5213",117,94,88,0,6,"RPS",0
30,"30010",6804,5691,5647,36,44,"RPS",2
39,"39062",1759,1397,1387,9,10,"RPS",2
3,"3105",5322,4218,4124,34,94,"RPS",1
3,"3023",1425,1259,1233,11,26,"RPS",0
46,"46076",651,541,528,2,13,"RPS",0
39,"39048",1616,1326,1308,8,18,"RPS",0
28,"28174",1745,1233,1224,11,9,"RPS",1
5,"5085",35,34,34,0,0,"RPS",0
46,"46007",11576,8929,8848,71,81,"RPS",7
39,"39057",2298,1735,1719,17,16,"RPS",3
28,"28101",222,158,158,4,0,"RPS",0
5,"5161",638,525,522,0,3,"RPS",0
39,"39095",2292,1824,1801,24,23,"RPS",2
46,"46131",49087,37846,37477,422,369,"RPS",22
28,"28093",1911,1537,1518,19,19,"RPS",0
3,"3051",356,314,311,2,3,"RPS",0
5,"5143",81,61,61,0,0,"RPS",0
5,"5112",125,88,87,0,1,"RPS",0
46,"46163",1811,1487,1463,12,24,"RPS",1
3,"3069",2830,2009,1979,22,30,"RPS",3
5,"5246",68,57,56,1,1,"RPS",0
46,"46186",18444,14173,14029,135,144,"RPS",7
5,"5102",1850,1487,1475,11,12,"RPS",1
3,"3903",2431,1991,1960,18,31,"RPS",0
3,"3001",359,296,292,2,4,"RPS",0
28,"28089",3531,2786,2753,25,33,"RPS",0
46,"46148",1400,1131,1114,13,17,"RPS",0
3,"3136",484,393,386,1,7,"RPS",0
39,"39059",8476,6365,6284,73,81,"RPS",6
46,"46019",8671,7195,7109,70,86,"RPS",1
28,"28109",1621,1121,1104,9,17,"RPS",1
5,"5034",17,13,13,0,0,"RPS",0
28,"28166",325,269,268,8,1,"RPS",1
3,"3070",1962,1582,1552,8,30,"RPS",0
30,"30013",7369,5780,5731,53,49,"RPS",5
3,"3106",642,542,535,3,7,"RPS",0
3,"3027",150,131,130,1,1,"RPS",0
5,"5087",144,87,87,0,0,"RPS",0
28,"28079",2290453,1721837,1705310,17342,16527,"RPS",978
46,"46092",304,206,201,1,5,"RPS",1
28,"28100",3970,2903,2865,32,38,"RPS",1
5,"5265",87,68,66,2,2,"RPS",0
28,"28171",4148,2972,2929,21,43,"RPS",3
30,"30043",24501,19738,19416,230,322,"RPS",13
5,"5078",128,112,111,2,1,"RPS",0
28,"28148",79726,60405,59651,724,754,"RPS",31
5,"5162",107,71,71,0,0,"RPS",0
46,"46141",424,338,336,2,2,"RPS",0
21,"21005",15205,11006,10909,108,97,"RPS",9
3,"3901",1070,826,818,14,8,"RPS",0
28,"28902",453,338,329,3,9,"RPS",1
5,"5193",224,197,197,2,0,"RPS",0
28,"28017",1120,905,888,8,17,"RPS",0
39,"39069",1957,1595,1570,18,25,"RPS",0
39,"39035",10031,7685,7601,74,84,"RPS",3
28,"28129",7219,5536,5461,71,75,"RPS",2
5,"5097",525,378,373,4,5,"RPS",0
28,"28008",1734,1244,1221,11,23,"RPS",2
5,"5056",94,78,73,1,5,"RPS",0
46,"46066",1264,1060,1050,5,10,"RPS",1
3,"3120",2329,1810,1785,16,25,"RPS",0
39,"39047",1987,1495,1482,9,13,"RPS",0
21,"21037",491,386,378,1,8,"RPS",1
46,"46099",987,764,754,2,10,"RPS",1
5,"5051",194,165,154,0,11,"RPS",0
46,"46108",550,446,444,3,2,"RPS",1
28,"28005",132097,100509,99506,1069,1003,"RPS",48
46,"46094",20341,15367,15222,152,145,"RPS",8
28,"28078",39,23,23,1,0,"RPS",0
3,"3904",1416,1104,1096,11,8,"RPS",1
5,"5109",438,359,351,5,8,"RPS",0
3,"3074",1752,1479,1466,5,13,"RPS",1
46,"46124",768,641,632,10,9,"RPS",0
3,"3041",5811,4325,4269,33,56,"RPS",7
5,"5188",55,47,47,0,0,"RPS",0
21,"21007",6088,4174,4123,57,51,"RPS",4
46,"46260",2576,2140,2106,24,34,"RPS",0
46,"46011",7727,5874,5777,75,97,"RPS",3
46,"46171",16753,12565,12399,122,166,"RPS",7
21,"21025",3969,2731,2686,33,45,"RPS",2
46,"46173",1393,1156,1137,10,19,"RPS",0
46,"46138",338,297,296,1,1,"RPS",0
28,"28035",1314,1058,1046,3,12,"RPS",0
46,"46238",13401,10371,10283,96,88,"RPS",5
3,"3043",2933,2494,2447,27,47,"RPS",1
5,"5211",484,406,405,3,1,"RPS",0
28,"28045",30286,23148,22879,226,269,"RPS",14
5,"5125",60,52,52,0,0,"RPS",0
21,"21038",1146,786,767,9,19,"RPS",0
46,"46071",488,418,402,10,16,"RPS",0
3,"3050",17818,12860,12706,160,154,"RPS",20
46,"46147",16527,11836,11716,105,120,"RPS",8
46,"46042",3376,2873,2819,17,54,"RPS",0
46,"46244",57805,41885,41595,415,290,"RPS",19
3,"3028",1049,903,895,6,8,"RPS",0
46,"46082",4661,3447,3401,46,46,"RPS",6
30,"30012",9037,7242,7142,62,100,"RPS",0
46,"46078",28197,20643,20415,205,228,"RPS",12
46,"46037",1146,1007,1003,5,4,"RPS",2
28,"28069",51,35,33,1,2,"RPS",0
5,"5123",90,69,69,3,0,"RPS",0
46,"46091",126,108,108,0,0,"RPS",0
28,"28163",395,305,301,7,4,"RPS",0
28,"28141",5568,4097,4051,31,46,"RPS",1
5,"5095",301,253,250,2,3,"RPS",0
3,"3022",160,133,131,1,2,"RPS",0
5,"5047",4267,3345,3275,34,70,"RPS",2
21,"21020",398,282,282,3,0,"RPS",0
5,"5149",128,97,97,1,0,"RPS",0
30,"30033",9940,7794,7700,79,94,"RPS",1
5,"5060",127,108,105,1,3,"RPS",2
21,"21041",114169,74740,73814,1129,926,"RPS",76
3,"3078",528,424,423,2,1,"RPS",0
28,"28029",538,416,414,4,2,"RPS",0
5,"5033",184,159,155,3,4,"RPS",1
3,"3067",94,81,79,1,2,"RPS",0
5,"5138",326,278,275,2,3,"RPS",0
46,"46084",1587,1363,1332,7,31,"RPS",0
5,"5178",392,310,304,2,6,"RPS",3
5,"5077",205,164,160,2,4,"RPS",0
5,"5210",105,83,82,2,1,"RPS",0
3,"3049",12150,10039,9892,88,147,"RPS",8
3,"3133",40056,25746,25554,231,192,"RPS",25
46,"46003",988,864,847,13,17,"RPS",0
46,"46242",361,288,280,4,8,"RPS",0
3,"3002",3559,2747,2707,16,40,"RPS",5
28,"28134",55921,42676,42221,505,455,"RPS",33
28,"28061",19624,15082,14905,162,177,"RPS",10
28,"28145",2125,1643,1620,15,23,"RPS",1
5,"5132",1040,770,753,2,17,"RPS",0
5,"5042",156,126,126,0,0,"RPS",0
28,"28067",3893,2996,2950,26,46,"RPS",2
30,"30003",23570,16482,16354,169,128,"RPS",8
46,"46031",10580,7900,7809,87,91,"RPS",5
5,"5182",862,673,668,2,5,"RPS",1
3,"3003",460,382,370,1,12,"RPS",0
28,"28038",4999,3659,3590,32,69,"RPS",1
3,"3030",522,464,453,6,11,"RPS",0
39,"39064",1339,1072,1066,7,6,"RPS",2
30,"30024",57868,41894,41513,393,381,"RPS",42
46,"46022",15090,10922,10840,99,82,"RPS",8
30,"30041",12957,9360,9288,89,72,"RPS",2
46,"46027",997,869,855,4,14,"RPS",1
5,"5027",290,233,230,2,3,"RPS",0
28,"28094",774,557,551,5,6,"RPS",1
28,"28003",196,154,151,2,3,"RPS",1
28,"28065",118796,93292,92186,919,1106,"RPS",54
5,"5120",38,28,28,1,0,"RPS",0
30,"30039",18615,14213,14068,134,145,"RPS",5
46,"46017",32928,24879,24672,267,207,"RPS",13
46,"46235",21966,16641,16465,167,176,"RPS",11
39,"39022",985,735,734,5,1,"RPS",0
3,"3118",2368,1746,1718,16,28,"RPS",3
3,"3005",7482,6191,6146,49,45,"RPS",9
3,"3130",43,30,29,0,1,"RPS",0
46,"46154",836,684,678,7,6,"RPS",0
5,"5219",45,33,33,0,0,"RPS",0
30,"30004",1164,958,952,1,6,"RPS",0
46,"46057",483,357,349,9,8,"RPS",1
5,"5158",410,333,331,2,2,"RPS",0
46,"46149",398,307,305,1,2,"RPS",0
39,"39013",561,413,412,2,1,"RPS",0
46,"46223",7685,6040,5996,62,44,"RPS",3
46,"46236",996,853,844,7,9,"RPS",1
21,"21008",2717,1994,1978,11,16,"RPS",1
46,"46034",1791,1477,1468,8,9,"RPS",0
3,"3086",145,119,118,1,1,"RPS",1
28,"28087",3150,2475,2453,26,22,"RPS",2
5,"5089",500,390,375,3,15,"RPS",0
46,"46228",2434,1881,1859,30,22,"RPS",0
46,"46001",863,647,641,5,6,"RPS",1
46,"46193",8494,6662,6580,73,82,"RPS",2
28,"28167",7818,6016,5942,82,74,"RPS",11
46,"46080",1090,860,849,2,11,"RPS",1
39,"39005",1319,1048,1026,3,22,"RPS",1
3,"3077",1411,1146,1130,14,16,"RPS",0
28,"28020",145,102,100,0,2,"RPS",0
46,"46004",1933,1563,1541,8,22,"RPS",0
5,"5012",156,134,132,1,2,"RPS",0
28,"28060",1471,1205,1192,8,13,"RPS",0
46,"46116",12587,9821,9724,120,97,"RPS",3
46,"46167",411,312,309,0,3,"RPS",0
5,"5016",6231,4831,4763,56,68,"RPS",64
46,"46018",689,597,592,12,5,"RPS",0
46,"46086",80,71,71,3,0,"RPS",1
46,"46156",2065,1746,1721,14,25,"RPS",1
46,"46187",1339,1096,1083,13,13,"RPS",0
21,"21027",67,52,52,0,0,"RPS",1
46,"46259",537,426,424,9,2,"RPS",0
46,"46039",2200,1849,1820,12,29,"RPS",0
5,"5024",268,205,201,2,4,"RPS",1
46,"46175",469,406,401,5,5,"RPS",0
46,"46206",595,497,495,3,2,"RPS",1
5,"5157",256,187,183,0,4,"RPS",0
5,"5145",57,41,41,0,0,"RPS",0
5,"5231",172,142,141,0,1,"RPS",0
39,"39010",688,533,524,6,9,"RPS",0
46,"46009",3140,2521,2498,15,23,"RPS",3
5,"5043",86,68,68,0,0,"RPS",0
5,"5904",149,99,97,0,2,"RPS",0
28,"28063",268,209,203,4,6,"RPS",1
21,"21002",14281,10297,10173,141,124,"RPS",43
46,"46005",22815,17016,16838,185,178,"RPS",7
39,"39101",328,251,247,5,4,"RPS",2
3,"3098",526,410,400,6,10,"RPS",0
3,"3075",160,139,136,2,3,"RPS",1
3,"3102",7346,5827,5751,39,76,"RPS",4
3,"3072",331,284,277,2,7,"RPS",0
28,"28054",10459,7798,7698,65,100,"RPS",9
3,"3036",84,72,72,0,0,"RPS",0
3,"3047",8867,6219,6113,76,106,"RPS",5
28,"28026",5852,4506,4449,40,57,"RPS",3
21,"21073",1840,1249,1236,13,13,"RPS",1
5,"5263",175,133,131,0,2,"RPS",0
5,"5106",39,26,26,0,0,"RPS",0
46,"46209",1984,1606,1594,11,12,"RPS",0
5,"5200",56,43,42,0,1,"RPS",0
28,"28072",5232,4065,4007,35,58,"RPS",4
28,"28048",489,398,389,3,9,"RPS",0
3,"3018",11899,8855,8720,119,135,"RPS",9
46,"46083",15427,12079,11941,109,138,"RPS",8
46,"46237",7261,5405,5350,54,55,"RPS",3
39,"39099",2987,2416,2391,28,25,"RPS",0
28,"28058",137542,103880,102686,1155,1194,"RPS",69
3,"3029",260,191,186,0,5,"RPS",0
39,"39015",898,692,688,7,4,"RPS",1
39,"39090",731,577,572,3,5,"RPS",1
28,"28075",5127,3976,3916,42,60,"RPS",6
28,"28123",48429,38681,38187,429,494,"RPS",19
46,"46201",83,50,49,0,1,"RPS",0
21,"21024",502,363,358,10,5,"RPS",0
3,"3048",4747,3878,3817,16,61,"RPS",2
28,"28121",185,153,152,0,1,"RPS",1
5,"5055",649,525,518,3,7,"RPS",0
3,"3082",11741,8208,8102,80,106,"RPS",5
28,"28133",5868,4236,4144,23,92,"RPS",4
5,"5134",47,37,37,0,0,"RPS",0
46,"46067",1798,1487,1472,10,15,"RPS",0
5,"5058",81,61,59,0,2,"RPS",0
46,"46072",3711,3006,2932,38,74,"RPS",1
28,"28153",608,422,406,1,16,"RPS",0
3,"3140",26223,19998,19552,338,446,"RPS",31
5,"5017",87,69,68,1,1,"RPS",0
5,"5152",737,618,609,5,9,"RPS",0
3,"3053",7082,5754,5664,60,90,"RPS",6
39,"39071",463,358,358,2,0,"RPS",0
30,"30017",11683,9332,9233,95,99,"RPS",2
5,"5168",3682,2846,2801,43,45,"RPS",1
46,"46026",1217,1043,1035,2,8,"RPS",1
46,"46120",1133,889,870,2,19,"RPS",1
21,"21047",1965,1355,1325,17,30,"RPS",0
28,"28115",57612,46786,46458,458,328,"RPS",25
46,"46263",333,243,241,2,2,"RPS",0
28,"28046",4208,3297,3272,31,25,"RPS",0
39,"39009",3200,2427,2402,24,25,"RPS",1
46,"46145",21751,16601,16397,155,204,"RPS",7
3,"3037",354,293,289,1,4,"RPS",0
5,"5180",109,92,91,1,1,"RPS",1
46,"46081",10254,8188,8101,52,87,"RPS",3
28,"28128",366,280,275,2,5,"RPS",0
46,"46089",2116,1653,1627,9,26,"RPS",0
39,"39061",3458,2673,2644,42,29,"RPS",2
46,"46219",143,127,126,1,1,"RPS",0
3,"3103",288,248,243,2,5,"RPS",0
21,"21060",11685,8026,7932,135,94,"RPS",5
5,"5037",296,213,212,0,1,"RPS",0
30,"30025",4780,3901,3874,18,27,"RPS",4
28,"28154",5232,3910,3860,40,50,"RPS",1
5,"5220",386,316,312,0,4,"RPS",0
3,"3110",294,239,238,0,1,"RPS",0
5,"5227",409,307,305,2,2,"RPS",0
39,"39065",272,199,197,2,2,"RPS",0
28,"28004",5761,4098,4044,38,54,"RPS",0
28,"28044",5403,4245,4188,27,57,"RPS",0
46,"46162",1230,1045,1027,6,18,"RPS",1
5,"5096",74,56,56,0,0,"RPS",0
3,"3019",14914,12087,11927,137,160,"RPS",20
30,"30015",18792,14453,14336,120,117,"RPS",6
5,"5243",101,69,68,0,1,"RPS",0
28,"28007",122891,95200,94139,990,1061,"RPS",64
5,"5048",131,112,111,0,1,"RPS",0
5,"5189",478,361,360,3,1,"RPS",0
28,"28095",1358,1092,1077,8,15,"RPS",1
39,"39039",648,496,493,0,3,"RPS",0
46,"46128",1649,1322,1292,14,30,"RPS",0
39,"39073",9275,6984,6903,83,81,"RPS",2
46,"46105",16708,12164,12040,100,124,"RPS",9
5,"5230",79,73,73,1,0,"RPS",0
46,"46164",11634,8843,8724,90,119,"RPS",7
46,"46255",3135,2530,2508,11,22,"RPS",0
39,"39043",1321,1082,1072,8,10,"RPS",0
28,"28164",2807,2194,2173,10,21,"RPS",1
3,"3055",5128,4121,4076,43,45,"RPS",3
5,"5156",260,188,185,0,3,"RPS",0
5,"5166",235,181,178,1,3,"RPS",0
5,"5133",62,49,49,0,0,"RPS",0
28,"28070",139,98,97,0,1,"RPS",0
3,"3097",973,791,779,6,12,"RPS",1
28,"28025",426,336,332,2,4,"RPS",0
46,"46165",6962,5390,5322,53,68,"RPS",0
3,"3094",8442,6105,6053,70,52,"RPS",5
28,"28173",507,397,390,2,7,"RPS",1
30,"30019",25722,18740,18553,164,187,"RPS",10
3,"3090",16226,12224,12116,139,108,"RPS",7
39,"39008",13716,10396,10274,129,122,"RPS",6
21,"21009",916,622,608,6,14,"RPS",1
5,"5170",63,50,50,0,0,"RPS",0
46,"46075",166,148,145,3,3,"RPS",0
46,"46129",553,430,423,4,7,"RPS",1
46,"46040",1227,1028,1021,13,7,"RPS",0
5,"5253",95,75,74,0,1,"RPS",0
3,"3017",380,331,324,7,7,"RPS",0
21,"21051",272,202,201,5,1,"RPS",0
21,"21034",1253,875,861,7,14,"RPS",0
46,"46197",1902,1559,1554,15,5,"RPS",0
3,"3124",482,420,415,7,5,"RPS",0
5,"5107",74,54,53,0,1,"RPS",0
46,"46151",717,596,589,3,7,"RPS",0
5,"5236",147,101,101,0,0,"RPS",0
28,"28172",7648,6130,6076,65,54,"RPS",0
21,"21059",203,166,162,1,4,"RPS",0
5,"5038",131,88,84,0,4,"RPS",0
28,"28157",605,452,446,2,6,"RPS",0
5,"5059",112,91,88,1,3,"RPS",1
46,"46070",15946,11979,11874,113,105,"RPS",8
3,"3004",624,497,486,7,11,"RPS",0
5,"5247",267,164,164,0,0,"RPS",0
46,"46024",448,365,358,1,7,"RPS",0
5,"5187",1833,1385,1361,16,24,"RPS",4
5,"5228",193,146,145,1,1,"RPS",0
46,"46217",912,758,751,4,7,"RPS",0
3,"3011",7341,5277,5218,72,59,"RPS",4
46,"46256",6734,4902,4858,33,44,"RPS",1
30,"30036",13978,10244,10141,94,103,"RPS",3
46,"46199",5661,4328,4280,38,48,"RPS",1
28,"28135",928,665,659,6,6,"RPS",1
21,"21061",5089,3657,3635,33,22,"RPS",4
5,"5130",95,76,76,0,0,"RPS",0
5,"5198",80,65,65,1,0,"RPS",0
3,"3064",4976,4098,4058,26,40,"RPS",5
30,"30009",11961,9992,9880,92,112,"RPS",3
39,"39093",351,260,253,2,7,"RPS",2
28,"28177",9470,7524,7466,87,58,"RPS",1
28,"28130",27391,21367,21111,235,256,"RPS",21
39,"39060",6723,5453,5360,56,93,"RPS",4
21,"21022",173,123,123,1,0,"RPS",0
28,"28137",1626,1231,1222,9,9,"RPS",1
30,"30030",305669,236235,234391,2112,1844,"RPS",164
21,"21057",1054,699,697,9,2,"RPS",0
46,"46194",15267,11622,11491,110,131,"RPS",3
3,"3116",1167,912,904,12,8,"RPS",0
46,"46035",6470,5115,5047,38,68,"RPS",5
46,"46056",203,164,160,2,4,"RPS",0
46,"46218",1082,964,936,5,28,"RPS",0
28,"28022",30019,24469,24279,292,190,"RPS",10
5,"5069",91,79,78,1,1,"RPS",0
5,"5007",126,104,102,0,2,"RPS",0
21,"21013",10601,7384,7231,110,153,"RPS",3
46,"46185",422,360,359,7,1,"RPS",0
28,"28042",1091,814,808,5,6,"RPS",0
39,"39026",1825,1383,1371,12,12,"RPS",0
46,"46008",2727,2249,2233,17,16,"RPS",2
3,"3129",1188,936,918,10,18,"RPS",1
28,"28068",10502,7857,7778,68,79,"RPS",2
5,"5163",1762,1400,1380,5,20,"RPS",0
3,"3128",3944,2847,2812,16,35,"RPS",4
39,"39087",43561,33709,33242,404,467,"RPS",32
5,"5064",117,94,93,4,1,"RPS",0
28,"28015",14491,11562,11417,155,145,"RPS",4
46,"46136",2476,1890,1865,16,25,"RPS",1
46,"46055",1286,1083,1067,11,16,"RPS",0
46,"46140",379,314,313,0,1,"RPS",0
21,"21070",6278,4489,4445,42,44,"RPS",1
3,"3063",25410,18205,17989,208,216,"RPS",19
3,"3015",12241,9734,9636,88,98,"RPS",8
39,"39020",23947,15404,15122,267,282,"RPS",19
46,"46189",490,400,396,3,4,"RPS",0
46,"46191",1952,1554,1528,9,26,"RPS",0
21,"21044",17018,11390,11290,132,100,"RPS",9
46,"46137",273,232,229,1,3,"RPS",0
5,"5108",64,41,41,0,0,"RPS",0
46,"46202",15578,11811,11676,110,135,"RPS",9
3,"3085",275,218,215,2,3,"RPS",1
28,"28170",2503,1744,1727,20,17,"RPS",0
5,"5018",27,24,24,0,0,"RPS",0
30,"30016",149046,103847,102890,1031,957,"RPS",79
3,"3025",1252,1054,1044,4,10,"RPS",0
21,"21067",418,318,312,5,6,"RPS",0
28,"28099",1670,1258,1246,9,12,"RPS",2
5,"5261",48,32,31,0,1,"RPS",0
28,"28116",666,507,498,5,9,"RPS",1
5,"5039",58,48,48,0,0,"RPS",0
3,"3107",2288,1670,1647,15,23,"RPS",2
5,"5197",114,98,98,1,0,"RPS",0
28,"28062",311,233,226,0,7,"RPS",0
5,"5191",124,98,98,2,0,"RPS",0
28,"28036",2301,1809,1784,13,25,"RPS",1
3,"3052",984,837,820,10,17,"RPS",0
21,"21062",1444,1003,991,7,12,"RPS",0
46,"46902",425,333,332,3,1,"RPS",1
39,"39024",2065,1616,1601,8,15,"RPS",0
39,"39075",140941,103308,102362,1364,946,"RPS",88
46,"46085",11344,8526,8426,87,100,"RPS",6
5,"5049",440,335,330,8,5,"RPS",1
5,"5216",237,195,192,0,3,"RPS",1
28,"28091",5202,3714,3671,34,43,"RPS",1
28,"28106",72603,53231,52524,681,707,"RPS",35
5,"5194",147,131,130,4,1,"RPS",0
39,"39045",410,324,323,5,1,"RPS",0
5,"5019",44095,34409,33934,505,475,"RPS",40
5,"5172",147,122,122,0,0,"RPS",0
21,"21043",1898,1382,1350,9,32,"RPS",0
46,"46032",5583,4342,4287,39,55,"RPS",1
3,"3059",20261,15951,15825,82,126,"RPS",8
46,"46121",116,103,101,0,2,"RPS",0
28,"28122",504,367,366,2,1,"RPS",0
5,"5903",171,118,118,0,0,"RPS",0
28,"28113",31318,23779,23436,271,343,"RPS",14
5,"5215",186,138,136,1,2,"RPS",0
39,"39012",6666,5148,5061,43,87,"RPS",3
46,"46172",4838,3492,3445,24,47,"RPS",3
30,"30902",7463,5291,5228,38,63,"RPS",4
5,"5075",100,76,76,1,0,"RPS",0
28,"28012",830,654,651,6,3,"RPS",0
39,"39082",1688,1280,1266,9,14,"RPS",0
39,"39034",289,209,209,3,0,"RPS",1
46,"46183",5946,4718,4656,35,62,"RPS",1
21,"21053",3278,2363,2325,20,38,"RPS",0
39,"39001",2146,1669,1645,20,24,"RPS",1
28,"28084",15408,11489,11355,122,134,"RPS",19
46,"46243",149,120,117,0,3,"RPS",0
21,"21050",12322,8772,8679,99,93,"RPS",3
46,"46135",9634,7671,7586,64,85,"RPS",5
28,"28018",3572,2837,2795,20,42,"RPS",0
21,"21054",8024,6159,6072,67,87,"RPS",4
30,"30007",6115,4651,4603,29,48,"RPS",0
5,"5195",241,168,164,0,4,"RPS",0
28,"28182",219,179,178,2,1,"RPS",0
3,"3109",2745,2332,2302,18,30,"RPS",0
5,"5099",555,472,466,4,6,"RPS",0
5,"5054",1282,979,965,5,14,"RPS",2
5,"5153",112,89,89,5,0,"RPS",0
39,"39067",901,628,623,1,5,"RPS",1
46,"46224",179,131,128,0,3,"RPS",0
28,"28024",156,132,132,5,0,"RPS",0
5,"5260",114,101,101,1,0,"RPS",0
5,"5036",136,107,106,0,1,"RPS",0
3,"3058",4798,4126,4103,26,23,"RPS",7
30,"30038",15057,11640,11555,82,85,"RPS",7
5,"5267",102,78,77,1,1,"RPS",0
3,"3112",684,566,561,4,5,"RPS",0
5,"5174",81,71,71,1,0,"RPS",0
28,"28120",1259,946,931,11,15,"RPS",0
46,"46029",20887,16124,15988,144,136,"RPS",13
3,"3132",571,464,461,8,3,"RPS",0
46,"46170",3464,2944,2908,24,36,"RPS",2
46,"46177",4594,3576,3523,29,53,"RPS",3
46,"46158",1037,829,822,9,7,"RPS",0
28,"28080",45696,36832,36529,402,303,"RPS",18
21,"21071",216,169,169,5,0,"RPS",0
39,"39036",1023,802,790,5,12,"RPS",1
46,"46251",2599,2215,2179,21,36,"RPS",2
39,"39050",305,207,205,1,2,"RPS",0
21,"21003",691,540,536,7,4,"RPS",0
39,"39053",251,179,179,1,0,"RPS",0
5,"5176",237,193,190,4,3,"RPS",0
3,"3117",381,321,317,4,4,"RPS",0
46,"46210",346,300,295,4,5,"RPS",0
46,"46248",4847,3655,3597,25,58,"RPS",3
46,"46178",4406,3235,3201,22,34,"RPS",6
5,"5119",41,31,31,0,0,"RPS",0
46,"46088",196,146,140,0,6,"RPS",0
28,"28053",6035,4854,4783,61,71,"RPS",5
5,"5144",92,66,66,4,0,"RPS",0
46,"46261",1706,1388,1366,13,22,"RPS",0
21,"21074",2752,1981,1968,15,13,"RPS",1
39,"39079",9035,6959,6897,55,62,"RPS",4
39,"39004",1593,1321,1305,9,16,"RPS",1
46,"46110",21420,15810,15671,134,139,"RPS",11
3,"3093",19646,15399,15159,173,240,"RPS",19
5,"5061",264,222,214,5,8,"RPS",0
46,"46062",4589,3794,3752,46,42,"RPS",0
46,"46097",890,674,662,2,12,"RPS",1
46,"46054",11422,8666,8566,82,100,"RPS",7
5,"5257",153,105,104,0,1,"RPS",0
46,"46245",478,357,354,1,3,"RPS",0
3,"3123",7435,5860,5744,63,116,"RPS",3
3,"3081",1409,1102,1087,14,15,"RPS",1
39,"39056",2387,1857,1835,22,22,"RPS",1
28,"28156",958,742,733,12,9,"RPS",0
39,"39038",1465,1065,1047,8,18,"RPS",0
5,"5023",177,160,158,1,2,"RPS",0
46,"46048",3484,2915,2875,26,40,"RPS",3
28,"28010",9309,7304,7229,71,75,"RPS",10
5,"5244",66,45,45,0,0,"RPS",0
46,"46226",34,34,33,0,1,"RPS",0
46,"46061",331,276,273,3,3,"RPS",0
5,"5173",62,55,55,1,0,"RPS",0
28,"28111",618,486,479,2,7,"RPS",0
46,"46216",4806,3857,3825,39,32,"RPS",2
5,"5116",131,114,109,0,5,"RPS",0
21,"21030",1757,1448,1426,14,22,"RPS",3
3,"3139",21796,15501,15320,160,181,"RPS",15
5,"5083",155,120,113,1,7,"RPS",0
5,"5094",158,124,124,3,0,"RPS",0
46,"46102",19880,15358,15179,122,179,"RPS",8
46,"46043",149,139,139,0,0,"RPS",0
5,"5073",319,258,254,7,4,"RPS",3
30,"30021",8550,6423,6349,44,74,"RPS",4
3,"3100",540,448,443,2,5,"RPS",0
39,"39046",1442,1071,1050,13,21,"RPS",0
46,"46253",118,105,102,7,3,"RPS",0
3,"3115",267,242,242,2,0,"RPS",0
21,"21023",2106,1471,1456,7,15,"RPS",0
5,"5184",288,225,224,0,1,"RPS",1
28,"28901",765,579,567,2,12,"RPS",0
3,"3026",1210,1004,989,11,15,"RPS",2
5,"5237",198,157,155,3,2,"RPS",0
28,"28031",1981,1524,1500,9,24,"RPS",1
28,"28146",1672,1220,1205,4,15,"RPS",0
46,"46143",4278,3309,3266,46,43,"RPS",1
5,"5183",165,142,140,0,2,"RPS",0
3,"3089",9696,7447,7302,83,145,"RPS",4
5,"5148",34,27,27,0,0,"RPS",0
5,"5076",477,397,385,4,12,"RPS",5
46,"46021",23273,17264,17091,163,173,"RPS",6
3,"3066",42697,31279,30833,566,446,"RPS",24
46,"46046",922,699,694,2,5,"RPS",0
30,"30035",17849,12871,12744,133,127,"RPS",13
28,"28127",60108,48418,48039,568,379,"RPS",17
3,"3073",219,199,199,0,0,"RPS",0
21,"21006",3565,2477,2441,29,36,"RPS",3
46,"46142",870,682,673,7,9,"RPS",0
5,"5141",99,90,89,0,1,"RPS",0
39,"39032",1576,1215,1209,10,6,"RPS",2
5,"5190",61,48,48,3,0,"RPS",0
46,"46231",2496,1831,1817,16,14,"RPS",0
39,"39006",1732,1381,1373,23,8,"RPS",3
46,"46064",547,463,458,2,5,"RPS",0
46,"46232",920,730,722,6,8,"RPS",0
3,"3092",6780,5364,5269,96,95,"RPS",3
3,"3014",234288,168004,166418,1795,1586,"RPS",193
39,"39014",943,706,700,9,6,"RPS",0
21,"21019",645,464,458,2,6,"RPS",0
3,"3135",228,185,181,0,4,"RPS",3
5,"5015",100,78,78,0,0,"RPS",0
5,"5179",231,206,204,2,2,"RPS",0
3,"3080",1288,1116,1103,6,13,"RPS",0
38,"38030",1875,1320,1301,11,19,"SSP-SxTF-EQUO",12
38,"38051",7081,5298,5229,64,69,"SSP-SxTF-EQUO",35
38,"38048",3884,2615,2587,34,28,"SSP-SxTF-EQUO",15
38,"38046",8848,6410,6301,75,109,"SSP-SxTF-EQUO",281
38,"38022",18671,13075,12890,111,185,"SSP-SxTF-EQUO",171
38,"38017",24438,13769,13576,176,193,"SSP-SxTF-EQUO",179
38,"38029",1456,732,715,4,17,"SSP-SxTF-EQUO",10
38,"38007",1844,1209,1188,5,21,"SSP-SxTF-EQUO",14
38,"38005",5327,3316,3270,38,46,"SSP-SxTF-EQUO",57
38,"38047",1819,1269,1239,12,30,"SSP-SxTF-EQUO",6
38,"38003",1446,1053,1044,4,9,"SSP-SxTF-EQUO",11
38,"38024",14851,9589,9399,93,190,"SSP-SxTF-EQUO",67
38,"38025",6649,4858,4778,52,80,"SSP-SxTF-EQUO",50
38,"38002",991,716,708,1,8,"SSP-SxTF-EQUO",5
38,"38026",32174,24822,24431,283,391,"SSP-SxTF-EQUO",335
38,"38034",4092,3034,2983,30,51,"SSP-SxTF-EQUO",33
38,"38018",4397,3216,3163,27,53,"SSP-SxTF-EQUO",37
38,"38044",2325,1550,1532,7,18,"SSP-SxTF-EQUO",6
38,"38038",161890,99555,97980,1101,1575,"SSP-SxTF-EQUO",2960
38,"38053",3752,2459,2397,28,62,"SSP-SxTF-EQUO",35
38,"38041",6780,4905,4813,57,92,"SSP-SxTF-EQUO",109
38,"38013",2823,1856,1843,18,13,"SSP-SxTF-EQUO",9
38,"38042",3876,2850,2809,24,41,"SSP-SxTF-EQUO",34
38,"38012",2535,1735,1716,11,19,"SSP-SxTF-EQUO",32
38,"38049",2794,1721,1694,12,27,"SSP-SxTF-EQUO",34
38,"38010",4054,2642,2599,17,43,"SSP-SxTF-EQUO",109
38,"38014",1446,1018,1007,8,11,"SSP-SxTF-EQUO",10
38,"38045",4181,2176,2140,13,36,"SSP-SxTF-EQUO",6
38,"38011",19299,12565,12313,152,252,"SSP-SxTF-EQUO",276
38,"38036",6477,4514,4422,40,92,"SSP-SxTF-EQUO",58
38,"38039",10198,7548,7429,78,119,"SSP-SxTF-EQUO",115
38,"38027",5392,3530,3459,41,71,"SSP-SxTF-EQUO",44
38,"38008",5430,3844,3772,46,72,"SSP-SxTF-EQUO",37
38,"38033",3987,2696,2656,23,40,"SSP-SxTF-EQUO",13
38,"38006",35862,18726,18500,209,226,"SSP-SxTF-EQUO",257
38,"38043",18628,12966,12763,134,203,"SSP-SxTF-EQUO",419
38,"38009",3910,2687,2633,31,54,"SSP-SxTF-EQUO",44
38,"38019",12624,8174,8099,65,75,"SSP-SxTF-EQUO",47
38,"38020",14520,9396,9202,121,194,"SSP-SxTF-EQUO",151
38,"38001",17632,9601,9475,121,126,"SSP-SxTF-EQUO",66
38,"38052",1344,886,872,5,14,"SSP-SxTF-EQUO",27
38,"38031",28391,21797,21431,234,366,"SSP-SxTF-EQUO",228
38,"38021",1792,1184,1160,6,24,"SSP-SxTF-EQUO",10
38,"38037",13166,8509,8332,65,177,"SSP-SxTF-EQUO",110
38,"38035",8172,4990,4919,62,71,"SSP-SxTF-EQUO",47
38,"38028",22003,14876,14589,158,287,"SSP-SxTF-EQUO",221
38,"38004",4522,3034,2975,33,59,"SSP-SxTF-EQUO",41
38,"38032",13032,8487,8357,101,130,"SSP-SxTF-EQUO",338
38,"38901",1389,917,907,16,10,"SSP-SxTF-EQUO",3
38,"38015",4326,3132,3099,21,33,"SSP-SxTF-EQUO",33
38,"38050",2516,1765,1734,9,31,"SSP-SxTF-EQUO",16
38,"38016",1250,664,646,3,18,"SSP-SxTF-EQUO",11
38,"38023",118865,76393,75039,928,1354,"SSP-SxTF-EQUO",2855
38,"38040",4697,3007,2962,31,45,"SSP-SxTF-EQUO",29
44,"44063",82,55,55,2,0,"SXT",0
44,"44156",57,40,38,1,2,"SXT",0
44,"44261",777,600,594,8,6,"SXT",0
44,"44049",886,652,627,6,25,"SXT",0
44,"44172",345,257,251,3,6,"SXT",0
44,"44144",326,233,227,7,6,"SXT",0
44,"44089",57,50,49,0,1,"SXT",0
44,"44191",806,602,594,6,8,"SXT",0
44,"44055",85,63,62,2,1,"SXT",0
44,"44043",126,94,94,7,0,"SXT",0
44,"44178",69,45,44,0,1,"SXT",0
44,"44092",89,68,68,0,0,"SXT",0
44,"44145",1078,723,714,26,9,"SXT",2
44,"44208",32,23,23,1,0,"SXT",0
44,"44212",45,35,35,0,0,"SXT",0
44,"44031",124,72,72,0,0,"SXT",0
44,"44001",69,48,47,0,1,"SXT",0
44,"44108",352,228,225,8,3,"SXT",0
44,"44026",89,69,69,0,0,"SXT",0
44,"44243",38,27,26,3,1,"SXT",0
44,"44249",58,40,40,1,0,"SXT",0
44,"44067",132,89,89,0,0,"SXT",2
44,"44218",37,26,26,2,0,"SXT",0
44,"44009",805,608,595,18,13,"SXT",0
44,"44152",62,50,50,3,0,"SXT",0
44,"44177",120,85,85,1,0,"SXT",0
44,"44105",82,63,63,2,0,"SXT",0
44,"44125",78,57,57,1,0,"SXT",0
44,"44011",67,47,47,0,0,"SXT",0
44,"44247",335,251,243,10,8,"SXT",1
44,"44106",173,132,131,8,1,"SXT",0
44,"44076",2338,1839,1797,36,42,"SXT",2
44,"44175",138,111,111,4,0,"SXT",0
44,"44201",526,449,443,9,6,"SXT",1
44,"44216",25877,18461,18057,467,404,"SXT",11
44,"44160",473,315,312,8,3,"SXT",0
44,"44161",487,363,358,9,5,"SXT",0
44,"44066",121,88,86,0,2,"SXT",0
44,"44094",116,105,103,4,2,"SXT",0
44,"44101",60,47,47,1,0,"SXT",0
44,"44163",119,91,91,0,0,"SXT",0
44,"44085",61,38,38,0,0,"SXT",0
44,"44167",41,31,31,1,0,"SXT",0
44,"44187",224,170,163,2,7,"SXT",1
44,"44056",577,436,434,7,2,"SXT",0
44,"44199",52,40,39,0,1,"SXT",0
44,"44071",657,453,448,9,5,"SXT",0
44,"44226",163,112,112,3,0,"SXT",0
44,"44109",123,86,84,2,2,"SXT",0
44,"44133",21,16,16,0,0,"SXT",0
44,"44237",450,352,343,5,9,"SXT",0
44,"44224",26,15,15,0,0,"SXT",0
44,"44184",34,21,21,2,0,"SXT",0
44,"44203",8,8,8,0,0,"SXT",0
44,"44221",377,305,297,6,8,"SXT",0
44,"44244",93,56,56,5,0,"SXT",0
44,"44040",206,167,166,5,1,"SXT",0
44,"44053",111,77,76,2,1,"SXT",0
44,"44227",81,59,59,0,0,"SXT",0
44,"44222",136,99,99,2,0,"SXT",0
44,"44189",69,57,57,0,0,"SXT",0
44,"44033",307,222,221,5,1,"SXT",0
44,"44023",13,11,11,0,0,"SXT",0
44,"44032",18,12,12,0,0,"SXT",0
44,"44176",167,131,130,5,1,"SXT",0
44,"44077",80,62,62,1,0,"SXT",0
44,"44230",154,127,127,3,0,"SXT",0
44,"44129",44,34,33,0,1,"SXT",1
44,"44198",205,160,160,5,0,"SXT",0
44,"44142",39,28,28,1,0,"SXT",0
44,"44179",369,245,243,6,2,"SXT",0
44,"44100",200,147,146,0,1,"SXT",0
44,"44050",3183,2208,2154,78,54,"SXT",1
44,"44018",27,23,23,0,0,"SXT",0
44,"44035",122,99,98,3,1,"SXT",0
44,"44086",485,380,371,5,9,"SXT",0
44,"44007",194,152,145,3,7,"SXT",0
44,"44044",103,79,78,0,1,"SXT",1
44,"44235",103,71,68,0,3,"SXT",0
44,"44241",575,442,427,4,15,"SXT",0
44,"44027",168,140,140,2,0,"SXT",0
44,"44110",57,45,45,0,0,"SXT",0
44,"44022",550,387,380,6,7,"SXT",0
44,"44036",27,17,17,0,0,"SXT",0
44,"44158",1159,904,873,15,31,"SXT",0
44,"44149",106,79,78,2,1,"SXT",0
44,"44131",26,20,20,0,0,"SXT",0
44,"44181",82,63,63,3,0,"SXT",0
44,"44258",75,56,55,0,1,"SXT",0
44,"44017",316,232,229,1,3,"SXT",0
44,"44038",112,94,92,3,2,"SXT",0
44,"44051",2783,2144,2089,38,55,"SXT",4
44,"44150",30,30,30,0,0,"SXT",9
44,"44005",59,43,43,1,0,"SXT",0
44,"44211",39,32,32,2,0,"SXT",0
44,"44213",60,48,48,0,0,"SXT",0
44,"44045",373,303,301,4,2,"SXT",0
44,"44008",1695,1280,1257,11,23,"SXT",0
44,"44146",185,160,159,8,1,"SXT",1
44,"44021",114,81,77,1,4,"SXT",0
44,"44137",215,165,163,5,2,"SXT",0
44,"44238",2475,1718,1692,50,26,"SXT",1
44,"44006",293,220,212,3,8,"SXT",0
44,"44010",189,138,138,2,0,"SXT",1
44,"44080",294,216,211,3,5,"SXT",0
44,"44039",255,189,189,5,0,"SXT",0
44,"44265",203,169,158,6,11,"SXT",0
44,"44209",892,666,649,6,17,"SXT",2
44,"44090",84,71,71,0,0,"SXT",0
44,"44246",1591,1030,997,15,33,"SXT",0
44,"44207",187,147,146,5,1,"SXT",0
44,"44012",389,297,293,5,4,"SXT",0
44,"44013",11286,7797,7584,242,213,"SXT",75
44,"44052",96,60,59,2,1,"SXT",0
44,"44200",41,30,30,0,0,"SXT",0
44,"44159",47,43,43,0,0,"SXT",0
44,"44239",29,25,25,1,0,"SXT",0
44,"44119",119,84,84,2,0,"SXT",1
44,"44204",24,21,21,0,0,"SXT",0
44,"44232",408,301,295,5,6,"SXT",0
44,"44065",60,40,40,0,0,"SXT",0
44,"44084",63,51,50,0,1,"SXT",0
44,"44074",435,344,337,5,7,"SXT",0
44,"44020",23,15,15,0,0,"SXT",0
44,"44228",121,97,96,2,1,"SXT",0
44,"44256",37,35,35,9,0,"SXT",0
44,"44003",19,19,19,0,0,"SXT",0
44,"44215",156,100,100,2,0,"SXT",0
44,"44165",182,140,140,1,0,"SXT",0
44,"44132",64,57,56,0,1,"SXT",0
44,"44004",450,334,332,2,2,"SXT",1
44,"44061",89,55,55,1,0,"SXT",0
44,"44126",344,250,236,1,14,"SXT",0
44,"44096",173,139,133,4,6,"SXT",0
44,"44185",117,91,90,0,1,"SXT",0
44,"44154",271,196,195,7,1,"SXT",1
44,"44114",254,194,188,4,6,"SXT",0
44,"44124",88,63,61,3,2,"SXT",0
44,"44236",77,48,47,0,1,"SXT",0
44,"44219",207,159,157,1,2,"SXT",0
44,"44225",129,100,98,5,2,"SXT",0
44,"44157",62,45,44,0,1,"SXT",0
44,"44252",78,63,60,0,3,"SXT",0
44,"44234",76,63,63,0,0,"SXT",1
44,"44194",128,92,89,1,3,"SXT",0
44,"44148",98,77,77,3,0,"SXT",0
44,"44220",137,97,96,1,1,"SXT",0
44,"44025",6168,4326,4150,68,176,"SXT",5
44,"44141",147,99,95,0,4,"SXT",0
44,"44210",754,573,567,3,6,"SXT",0
44,"44151",215,143,140,1,3,"SXT",0
44,"44250",20,11,11,1,0,"SXT",0
44,"44062",38,34,34,0,0,"SXT",0
44,"44118",183,129,127,2,2,"SXT",0
44,"44127",79,62,61,0,1,"SXT",0
44,"44019",75,38,37,0,1,"SXT",0
44,"44263",332,249,243,10,6,"SXT",0
44,"44024",24,19,19,0,0,"SXT",0
44,"44014",2603,1965,1912,25,53,"SXT",13
44,"44168",194,154,152,4,2,"SXT",0
44,"44217",37,28,27,0,1,"SXT",0
44,"44206",156,119,117,3,2,"SXT",0
44,"44103",128,95,95,0,0,"SXT",0
44,"44128",84,56,56,3,0,"SXT",0
44,"44070",62,47,47,1,0,"SXT",0
44,"44060",42,34,34,0,0,"SXT",0
44,"44120",217,126,121,5,5,"SXT",0
44,"44093",86,64,64,3,0,"SXT",0
44,"44268",30,25,25,0,0,"SXT",0
44,"44117",357,278,275,0,3,"SXT",0
44,"44042",139,87,87,0,0,"SXT",0
44,"44171",186,127,124,3,3,"SXT",0
44,"44113",79,57,55,0,2,"SXT",0
44,"44267",79,63,61,2,2,"SXT",0
44,"44195",103,71,70,0,1,"SXT",1
44,"44223",80,55,55,0,0,"SXT",0
44,"44138",158,109,106,0,3,"SXT",0
44,"44192",401,324,322,5,2,"SXT",0
44,"44029",637,495,490,6,5,"SXT",1
44,"44264",249,196,193,1,3,"SXT",0
44,"44048",77,59,59,0,0,"SXT",0
44,"44107",233,161,154,3,7,"SXT",0
44,"44173",107,87,77,5,10,"SXT",0
44,"44135",149,110,109,1,1,"SXT",0
44,"44122",1441,1009,990,21,19,"SXT",2
44,"44229",150,108,107,5,1,"SXT",0
44,"44002",62,47,47,1,0,"SXT",0
44,"44102",30,29,28,0,1,"SXT",0
44,"44231",54,38,36,2,2,"SXT",0
44,"44130",38,27,27,0,0,"SXT",0
44,"44169",403,285,278,0,7,"SXT",0
44,"44193",99,71,67,0,4,"SXT",1
44,"44197",60,37,37,1,0,"SXT",0
44,"44059",571,446,434,10,12,"SXT",0
44,"44046",58,44,44,1,0,"SXT",0
44,"44121",63,48,48,1,0,"SXT",0
44,"44088",32,31,31,1,0,"SXT",0
44,"44099",724,519,511,4,8,"SXT",0
44,"44112",473,353,350,4,3,"SXT",0
44,"44047",267,162,160,4,2,"SXT",0
44,"44097",158,97,95,1,2,"SXT",2
44,"44240",168,135,132,2,3,"SXT",0
44,"44147",439,320,314,14,6,"SXT",0
44,"44251",271,218,218,5,0,"SXT",0
44,"44262",141,114,113,2,1,"SXT",0
44,"44260",160,117,115,5,2,"SXT",0
44,"44054",125,97,97,2,0,"SXT",0
44,"44180",71,52,52,1,0,"SXT",0
44,"44153",1882,1273,1246,10,27,"SXT",0
44,"44087",98,87,87,2,0,"SXT",0
44,"44266",134,107,105,2,2,"SXT",1
44,"44123",117,79,78,2,1,"SXT",0
44,"44075",329,250,240,4,10,"SXT",0
44,"44182",216,173,173,4,0,"SXT",0
44,"44064",93,63,62,0,1,"SXT",0
44,"44190",81,52,52,0,0,"SXT",0
44,"44257",184,132,131,6,1,"SXT",0
44,"44183",78,49,46,0,3,"SXT",0
44,"44143",382,292,292,5,0,"SXT",1
44,"44016",541,384,379,5,5,"SXT",1
44,"44174",435,310,309,3,1,"SXT",0
44,"44111",101,68,68,4,0,"SXT",0
44,"44196",152,116,114,2,2,"SXT",0
44,"44068",690,544,528,6,16,"SXT",2
44,"44041",67,56,51,1,5,"SXT",0
44,"44034",150,117,117,1,0,"SXT",0
44,"44164",32,25,25,0,0,"SXT",0
44,"44115",121,100,100,0,0,"SXT",0
44,"44028",202,159,156,2,3,"SXT",1
44,"44245",274,189,184,1,5,"SXT",1
44,"44037",483,349,344,10,5,"SXT",0
44,"44082",90,67,66,1,1,"SXT",1
44,"44116",96,68,65,3,3,"SXT",0
44,"44205",757,541,527,12,14,"SXT",12
44,"44155",1162,819,801,24,18,"SXT",0
44,"44136",51,39,39,0,0,"SXT",0
18,"18043",140,89,87,1,2,"SAIn",0
23,"23042",359,278,277,0,1,"SAIn",0
18,"18094",2398,1882,1868,16,14,"SAIn",0
29,"29060",775,573,572,1,1,"SAIn",0
33,"33075",305,191,190,0,1,"SAIn",1
47,"47038",128,91,91,0,0,"SAIn",0
41,"41007",12177,8150,8016,126,134,"SAIn",2
31,"31158",264,174,173,1,1,"SAIn",0
9,"9312",113,94,91,0,3,"SAIn",0
31,"31208",2574,2003,1966,32,37,"SAIn",2
9,"9133",39,33,33,1,0,"SAIn",0
14,"14074",2387,2002,1995,26,7,"SAIn",0
31,"31243",313,227,223,5,4,"SAIn",0
31,"31117",670,471,467,3,4,"SAIn",0
41,"41045",5505,3946,3889,68,57,"SAIn",1
39,"39020",23947,15404,15122,267,282,"SAIn",12
35,"35013",6779,5059,4961,105,98,"SAIn",3
31,"31195",186,127,126,1,1,"SAIn",0
36,"36059",5438,3874,3805,47,69,"SAIn",0
39,"39098",1522,1256,1244,8,12,"SAIn",0
14,"14065",1846,1509,1492,14,17,"SAIn",0
33,"33046",546,429,421,3,8,"SAIn",0
39,"39038",1465,1065,1047,8,18,"SAIn",0
31,"31137",215,108,106,1,2,"SAIn",1
9,"9173",135,116,116,1,0,"SAIn",0
34,"34022",1136,926,908,5,18,"SAIn",0
39,"39079",9035,6959,6897,55,62,"SAIn",1
15,"15051",4780,3333,3289,61,44,"SAIn",0
34,"34096",56,41,39,1,2,"SAIn",1
31,"31131",841,610,594,12,16,"SAIn",1
47,"47132",45,40,40,0,0,"SAIn",0
39,"39072",375,234,234,4,0,"SAIn",0
29,"29070",35228,23374,23146,258,228,"SAIn",15
34,"34245",322,240,236,3,4,"SAIn",0
31,"31147",103,81,80,3,1,"SAIn",1
18,"18180",655,450,447,1,3,"SAIn",0
9,"9337",126,88,87,1,1,"SAIn",0
28,"28118",72,49,47,1,2,"SAIn",0
39,"39055",1130,881,869,10,12,"SAIn",0
14,"14020",415,323,319,3,4,"SAIn",0
31,"31246",148,101,100,3,1,"SAIn",0
9,"9279",195,140,140,4,0,"SAIn",1
29,"29007",25572,17726,17564,227,162,"SAIn",6
34,"34234",72,56,55,1,1,"SAIn",0
28,"28005",132097,100509,99506,1069,1003,"SAIn",227
41,"41038",96442,66696,65945,1021,751,"SAIn",47
9,"9443",197,160,154,5,6,"SAIn",0
18,"18148",874,714,706,6,8,"SAIn",0
47,"47011",600,493,489,4,4,"SAIn",0
31,"31001",88,58,58,1,0,"SAIn",0
9,"9095",88,75,73,2,2,"SAIn",0
9,"9384",310,223,218,3,5,"SAIn",2
34,"34124",70,55,55,1,0,"SAIn",0
18,"18115",2380,1843,1823,14,20,"SAIn",0
41,"41018",9457,6940,6867,66,73,"SAIn",0
47,"47106",63,52,52,0,0,"SAIn",0
28,"28108",3002,2254,2228,31,26,"SAIn",0
47,"47164",391,326,320,3,6,"SAIn",0
33,"33031",38090,25034,24730,380,304,"SAIn",9
9,"9136",203,153,146,3,7,"SAIn",0
28,"28152",14903,11954,11865,125,89,"SAIn",4
34,"34129",191,144,142,0,2,"SAIn",0
18,"18184",2140,1663,1645,18,18,"SAIn",0
31,"31221",1182,774,767,12,7,"SAIn",0
18,"18053",1836,1345,1340,11,5,"SAIn",2
9,"9048",1565,1166,1148,20,18,"SAIn",1
14,"14050",2418,1983,1966,23,17,"SAIn",0
9,"9065",152,137,137,1,0,"SAIn",0
18,"18030",612,457,456,0,1,"SAIn",0
9,"9375",42,30,30,1,0,"SAIn",0
39,"39036",1023,802,790,5,12,"SAIn",1
9,"9444",81,54,52,1,2,"SAIn",0
29,"29055",1837,1478,1454,12,24,"SAIn",0
14,"14037",3500,2662,2616,29,46,"SAIn",2
18,"18183",685,502,500,3,2,"SAIn",0
34,"34161",23,20,20,0,0,"SAIn",0
31,"31032",1785,1330,1305,24,25,"SAIn",1
31,"31196",40,35,35,1,0,"SAIn",0
18,"18906",955,736,731,5,5,"SAIn",0
28,"28073",11899,8877,8769,112,108,"SAIn",0
28,"28029",538,416,414,4,2,"SAIn",0
47,"47114",4107,2877,2834,37,43,"SAIn",0
28,"28115",57612,46786,46458,458,328,"SAIn",16
47,"47029",61,54,53,0,1,"SAIn",0
28,"28137",1626,1231,1222,9,9,"SAIn",0
9,"9236",41,38,37,0,1,"SAIn",0
15,"15011",15507,10935,10751,123,184,"SAIn",4
33,"33001",1772,984,971,14,13,"SAIn",0
28,"28183",935,663,649,7,14,"SAIn",0
39,"39063",1018,769,762,6,7,"SAIn",0
23,"23032",598,518,515,0,3,"SAIn",0
28,"28158",632,505,495,4,10,"SAIn",1
18,"18082",912,691,683,8,8,"SAIn",0
18,"18194",2258,1656,1652,11,4,"SAIn",1
41,"41001",1642,1314,1302,10,12,"SAIn",0
9,"9414",197,159,159,2,0,"SAIn",0
18,"18046",1960,1327,1312,5,15,"SAIn",0
31,"31069",860,660,647,2,13,"SAIn",0
9,"9104",56,49,49,0,0,"SAIn",0
31,"31125",269,172,169,6,3,"SAIn",0
9,"9348",150,122,122,2,0,"SAIn",0
31,"31253",123,102,97,0,5,"SAIn",0
18,"18126",1461,1129,1121,15,8,"SAIn",0
47,"47101",1740,1458,1444,12,14,"SAIn",0
18,"18902",950,769,762,6,7,"SAIn",0
9,"9232",182,146,146,1,0,"SAIn",0
29,"29025",34637,22545,22354,268,191,"SAIn",13
34,"34041",100,79,78,1,1,"SAIn",0
23,"23051",2805,2312,2290,8,22,"SAIn",3
29,"29026",1130,815,799,7,16,"SAIn",0
9,"9317",17,15,15,0,0,"SAIn",0
18,"18905",12975,9260,9209,155,51,"SAIn",0
31,"31045",501,384,377,16,7,"SAIn",0
47,"47162",80,62,62,1,0,"SAIn",0
9,"9127",54,39,39,0,0,"SAIn",0
9,"9463",261,205,205,1,0,"SAIn",6
9,"9063",223,191,189,1,2,"SAIn",0
18,"18084",3954,3039,3015,50,24,"SAIn",1
34,"34132",128,103,102,2,1,"SAIn",1
29,"29047",1165,973,969,0,4,"SAIn",1
18,"18087",187449,138136,136783,1548,1353,"SAIn",87
33,"33054",1780,1272,1263,8,9,"SAIn",0
31,"31005",312,209,206,4,3,"SAIn",0
39,"39056",2387,1857,1835,22,22,"SAIn",4
39,"39071",463,358,358,2,0,"SAIn",0
23,"23088",6177,4955,4872,94,83,"SAIn",17
41,"41020",12710,8954,8882,91,72,"SAIn",0
9,"9054",107,80,80,1,0,"SAIn",0
47,"47179",408,315,306,6,9,"SAIn",0
9,"9154",150,107,107,3,0,"SAIn",0
47,"47138",259,198,195,3,3,"SAIn",0
33,"33029",420,243,241,3,2,"SAIn",0
9,"9226",74,57,57,0,0,"SAIn",0
34,"34189",59,47,47,3,0,"SAIn",0
9,"9124",1598,1151,1129,19,22,"SAIn",0
14,"14058",8116,6274,6215,76,59,"SAIn",0
23,"23006",4644,3913,3871,36,42,"SAIn",4
14,"14044",1585,1279,1265,12,14,"SAIn",0
47,"47099",174,153,153,4,0,"SAIn",0
31,"31089",246,198,195,4,3,"SAIn",0
35,"35008",6151,4514,4419,59,95,"SAIn",0
9,"9351",63,46,44,0,2,"SAIn",0
41,"41068",13809,10171,10072,100,99,"SAIn",2
9,"9055",55,46,44,0,2,"SAIn",0
28,"28116",666,507,498,5,9,"SAIn",0
15,"15031",22951,16018,15696,382,322,"SAIn",13
18,"18078",768,638,637,1,1,"SAIn",0
34,"34223",233,175,175,2,0,"SAIn",0
23,"23087",11474,9197,9123,90,74,"SAIn",7
28,"28165",1689,1310,1295,5,15,"SAIn",0
47,"47064",30,21,21,1,0,"SAIn",0
9,"9148",95,75,75,2,0,"SAIn",0
47,"47087",376,320,315,7,5,"SAIn",0
31,"31235",189,111,110,0,1,"SAIn",1
47,"47223",172,147,147,6,0,"SAIn",0
34,"34213",67,50,50,0,0,"SAIn",0
39,"39086",386,282,280,1,2,"SAIn",0
47,"47184",575,447,443,6,4,"SAIn",0
14,"14009",2864,2021,2003,8,18,"SAIn",0
33,"33020",13542,9300,9173,135,127,"SAIn",5
31,"31245",87,59,58,5,1,"SAIn",0
47,"47073",141,118,116,1,2,"SAIn",0
15,"15002",21528,15479,15218,314,261,"SAIn",23
18,"18096",348,289,287,1,2,"SAIn",1
9,"9151",509,389,383,5,6,"SAIn",0
15,"15074",4254,3246,3219,35,27,"SAIn",0
47,"47008",26,17,17,0,0,"SAIn",0
18,"18103",803,653,647,5,6,"SAIn",0
18,"18909",668,536,534,2,2,"SAIn",0
41,"41036",4053,2930,2899,29,31,"SAIn",1
9,"9100",56,46,44,0,2,"SAIn",0
9,"9328",81,56,56,2,0,"SAIn",0
9,"9246",662,469,457,3,12,"SAIn",0
9,"9160",104,75,74,0,1,"SAIn",0
9,"9230",41,33,33,0,0,"SAIn",0
23,"23011",2227,1644,1620,25,24,"SAIn",2
14,"14030",8519,6832,6753,64,79,"SAIn",2
9,"9169",96,80,80,1,0,"SAIn",1
9,"9386",61,45,45,0,0,"SAIn",0
9,"9366",99,67,65,1,2,"SAIn",0
14,"14018",3795,3004,2970,24,34,"SAIn",0
34,"34048",72,58,56,3,2,"SAIn",0
36,"36004",10264,7383,7263,80,120,"SAIn",6
39,"39015",898,692,688,7,4,"SAIn",0
15,"15044",1436,1083,1068,10,15,"SAIn",0
34,"34224",53,42,41,0,1,"SAIn",0
9,"9248",63,52,52,0,0,"SAIn",0
36,"36001",3138,2060,2049,13,11,"SAIn",0
28,"28119",1911,1527,1514,13,13,"SAIn",0
39,"39052",17031,13198,13034,187,164,"SAIn",7
15,"15085",3576,2656,2612,29,44,"SAIn",2
34,"34057",483,365,357,2,8,"SAIn",0
29,"29069",80337,50235,49723,690,512,"SAIn",21
31,"31231",127,93,91,1,2,"SAIn",0
15,"15063",2849,2022,2001,28,21,"SAIn",4
47,"47169",70,57,57,0,0,"SAIn",0
47,"47143",146,108,107,0,1,"SAIn",0
34,"34167",124,105,105,0,0,"SAIn",0
39,"39094",927,702,691,0,11,"SAIn",0
14,"14029",4380,3344,3308,35,36,"SAIn",0
33,"33026",9144,6019,5959,87,60,"SAIn",2
34,"34058",212,179,178,0,1,"SAIn",0
29,"29006",721,516,508,5,8,"SAIn",1
23,"23904",3070,2047,2033,19,14,"SAIn",1
36,"36032",3666,2789,2755,25,34,"SAIn",2
31,"31129",405,285,281,1,4,"SAIn",0
15,"15067",8142,6054,5978,73,76,"SAIn",1
28,"28140",2665,2167,2141,26,26,"SAIn",3
31,"31150",234,163,162,5,1,"SAIn",0
36,"36039",14581,11007,10782,167,225,"SAIn",9
29,"29073",1520,1032,1021,10,11,"SAIn",0
28,"28148",79726,60405,59651,724,754,"SAIn",17
31,"31229",46,38,37,0,1,"SAIn",0
47,"47126",49,43,42,1,1,"SAIn",0
23,"23091",790,668,664,3,4,"SAIn",0
47,"47225",89,67,66,0,1,"SAIn",0
9,"9120",46,35,34,1,1,"SAIn",1
14,"14024",1926,1557,1527,14,30,"SAIn",1
18,"18088",1576,1258,1253,2,5,"SAIn",0
23,"23039",2239,1799,1764,9,35,"SAIn",1
9,"9272",319,225,225,5,0,"SAIn",1
28,"28173",507,397,390,2,7,"SAIn",1
28,"28022",30019,24469,24279,292,190,"SAIn",7
41,"41030",527,436,429,6,7,"SAIn",0
36,"36022",9203,6423,6226,100,197,"SAIn",6
28,"28123",48429,38681,38187,429,494,"SAIn",15
28,"28021",418,334,328,4,6,"SAIn",0
9,"9101",79,66,66,2,0,"SAIn",0
31,"31216",3911,2699,2653,82,46,"SAIn",7
39,"39022",985,735,734,5,1,"SAIn",0
18,"18114",678,508,508,6,0,"SAIn",0
31,"31064",1500,1137,1120,12,17,"SAIn",0
36,"36042",17897,12635,12437,157,198,"SAIn",10
9,"9258",190,159,159,5,0,"SAIn",0
28,"28902",453,338,329,3,9,"SAIn",0
39,"39004",1593,1321,1305,9,16,"SAIn",0
47,"47181",170,128,128,1,0,"SAIn",0
47,"47155",3043,2246,2225,35,21,"SAIn",3
31,"31102",162,80,78,0,2,"SAIn",0
14,"14056",23507,17245,17071,259,174,"SAIn",14
29,"29049",3137,2365,2352,19,13,"SAIn",0
23,"23037",513,430,424,3,6,"SAIn",0
9,"9394",805,594,588,13,6,"SAIn",0
31,"31908",997,692,683,9,9,"SAIn",0
28,"28026",5852,4506,4449,40,57,"SAIn",1
34,"34068",32,23,23,0,0,"SAIn",0
41,"41093",17665,13712,13526,179,186,"SAIn",10
47,"47199",84,61,60,1,1,"SAIn",0
31,"31239",302,229,224,7,5,"SAIn",0
9,"9197",160,129,128,3,1,"SAIn",0
34,"34076",632,524,520,13,4,"SAIn",0
31,"31232",24440,17810,17436,420,374,"SAIn",15
35,"35016",291589,181013,177964,2856,3049,"SAIn",126
9,"9422",24,18,16,0,2,"SAIn",0
18,"18085",818,538,532,4,6,"SAIn",0
47,"47228",481,385,383,3,2,"SAIn",0
9,"9304",197,168,165,1,3,"SAIn",0
41,"41073",1789,1292,1272,5,20,"SAIn",0
28,"28170",2503,1744,1727,20,17,"SAIn",0
9,"9046",41,30,30,0,0,"SAIn",0
9,"9041",27,27,27,0,0,"SAIn",0
33,"33012",5341,3816,3777,43,39,"SAIn",0
34,"34126",284,226,224,3,2,"SAIn",0
31,"31094",123,100,97,3,3,"SAIn",0
36,"36005",8231,5985,5873,84,112,"SAIn",2
39,"39007",479,348,347,3,1,"SAIn",0
31,"31121",79,53,52,2,1,"SAIn",0
31,"31118",182,114,114,6,0,"SAIn",0
29,"29052",245,151,151,0,0,"SAIn",0
34,"34045",84,75,74,1,1,"SAIn",0
28,"28049",59507,46919,46379,488,540,"SAIn",23
34,"34180",84,68,68,0,0,"SAIn",0
15,"15007",3702,2670,2642,19,28,"SAIn",0
18,"18185",608,484,479,2,5,"SAIn",0
33,"33043",710,529,528,1,1,"SAIn",0
29,"29030",839,669,668,5,1,"SAIn",0
31,"31112",106,79,78,0,1,"SAIn",0
9,"9424",42,35,34,1,1,"SAIn",0
47,"47093",865,658,642,11,16,"SAIn",0
28,"28150",2985,2363,2345,21,18,"SAIn",0
14,"14054",13632,10857,10652,194,205,"SAIn",7
47,"47091",97,82,80,3,2,"SAIn",0
31,"31262",219,158,157,4,1,"SAIn",0
47,"47209",43,33,33,0,0,"SAIn",0
34,"34027",1224,875,861,14,14,"SAIn",0
39,"39023",6048,4795,4747,43,48,"SAIn",3
41,"41070",5598,4101,4039,79,62,"SAIn",4
9,"9345",134,102,102,1,0,"SAIn",0
34,"34196",94,74,73,1,1,"SAIn",0
47,"47159",862,704,695,20,9,"SAIn",0
9,"9398",92,68,68,2,0,"SAIn",0
47,"47059",108,77,76,1,1,"SAIn",0
14,"14051",1392,1148,1130,11,18,"SAIn",0
15,"15025",1173,780,777,10,3,"SAIn",1
34,"34121",208,153,152,0,1,"SAIn",0
18,"18034",510,377,375,2,2,"SAIn",0
33,"33027",929,617,613,5,4,"SAIn",0
23,"23038",3273,2658,2638,29,20,"SAIn",5
18,"18001",288,212,212,1,0,"SAIn",0
33,"33004",69056,49228,48730,726,498,"SAIn",19
34,"34087",108,88,87,1,1,"SAIn",0
29,"29042",14047,9845,9735,118,110,"SAIn",5
9,"9020",276,222,222,6,0,"SAIn",0
18,"18032",248,166,166,2,0,"SAIn",0
29,"29901",41445,27372,27158,295,214,"SAIn",15
39,"39019",2009,1556,1536,10,20,"SAIn",0
14,"14052",9720,6444,6384,58,60,"SAIn",1
28,"28164",2807,2194,2173,10,21,"SAIn",2
31,"31008",97,64,63,1,1,"SAIn",0
41,"41086",15877,10246,10150,146,96,"SAIn",5
9,"9340",72,41,41,0,0,"SAIn",0
47,"47069",128,108,108,0,0,"SAIn",0
28,"28033",3581,2712,2691,14,21,"SAIn",0
18,"18179",583,417,409,7,8,"SAIn",0
47,"47161",3886,3133,3105,45,28,"SAIn",11
28,"28107",443,338,333,7,5,"SAIn",2
31,"31225",40,32,32,0,0,"SAIn",0
9,"9140",136,110,110,1,0,"SAIn",1
47,"47082",816,664,661,10,3,"SAIn",0
18,"18093",2580,1837,1820,8,17,"SAIn",1
47,"47232",107,77,75,1,2,"SAIn",0
31,"31035",60,47,47,0,0,"SAIn",1
15,"15020",4187,2802,2781,18,21,"SAIn",2
34,"34154",78,62,62,0,0,"SAIn",0
28,"28104",11704,9455,9361,119,94,"SAIn",1
34,"34208",62,52,52,2,0,"SAIn",0
39,"39089",163,126,126,0,0,"SAIn",0
18,"18005",366,279,277,3,2,"SAIn",0
18,"18068",1456,1105,1088,13,17,"SAIn",0
28,"28111",618,486,479,2,7,"SAIn",0
47,"47026",59,46,46,1,0,"SAIn",0
28,"28177",9470,7524,7466,87,58,"SAIn",2
15,"15028",1485,1130,1118,14,12,"SAIn",1
31,"31046",58,41,41,3,0,"SAIn",0
18,"18069",506,375,371,4,4,"SAIn",1
9,"9473",94,81,81,2,0,"SAIn",0
9,"9395",164,134,133,1,1,"SAIn",0
9,"9130",87,72,71,0,1,"SAIn",0
31,"31115",171,112,109,2,3,"SAIn",0
34,"34165",86,67,67,0,0,"SAIn",0
34,"34175",101,80,80,2,0,"SAIn",1
47,"47004",1261,1047,1031,11,16,"SAIn",2
41,"41092",7649,5816,5738,39,78,"SAIn",3
39,"39027",3213,2506,2473,21,33,"SAIn",0
9,"9163",642,526,518,3,8,"SAIn",0
18,"18117",535,444,440,2,4,"SAIn",0
31,"31007",137,96,90,2,6,"SAIn",0
23,"23044",4897,3943,3893,13,50,"SAIn",2
18,"18099",1551,1217,1205,11,12,"SAIn",1
31,"31251",3147,2274,2225,39,49,"SAIn",3
39,"39100",922,718,712,8,6,"SAIn",2
47,"47146",236,196,195,4,1,"SAIn",1
34,"34017",960,772,760,15,12,"SAIn",2
33,"33063",467,367,363,4,4,"SAIn",0
41,"41055",15121,11082,10997,98,85,"SAIn",2
31,"31052",89,62,58,1,4,"SAIn",0
34,"34074",764,610,597,11,13,"SAIn",1
15,"15077",8677,6349,6269,82,80,"SAIn",4
31,"31048",154,118,117,0,1,"SAIn",0
31,"31907",9914,7394,7282,198,112,"SAIn",23
31,"31059",204,140,139,3,1,"SAIn",0
41,"41061",2205,1798,1770,2,28,"SAIn",0
34,"34032",47,36,36,1,0,"SAIn",0
15,"15083",1198,874,855,8,19,"SAIn",0
39,"39064",1339,1072,1066,7,6,"SAIn",3
35,"35007",569,392,391,2,1,"SAIn",0
31,"31029",987,693,680,16,13,"SAIn",0
29,"29018",2088,1565,1540,9,25,"SAIn",1
41,"41012",3115,2314,2271,29,43,"SAIn",1
34,"34210",103,93,91,2,2,"SAIn",0
31,"31050",6253,4045,3987,74,58,"SAIn",2
15,"15003",1936,1400,1382,19,18,"SAIn",1
36,"36055",13678,10508,10288,155,220,"SAIn",9
35,"35017",22331,13463,13144,217,319,"SAIn",7
47,"47217",1812,1395,1377,20,18,"SAIn",1
29,"29014",250,152,150,0,2,"SAIn",0
28,"28044",5403,4245,4188,27,57,"SAIn",0
39,"39012",6666,5148,5061,43,87,"SAIn",6
34,"34004",5790,4354,4262,84,92,"SAIn",2
41,"41042",5902,4572,4509,37,63,"SAIn",1
41,"41077",8817,6520,6375,53,145,"SAIn",0
18,"18133",2256,1783,1773,12,10,"SAIn",0
9,"9432",212,161,158,1,3,"SAIn",0
15,"15057",12467,8936,8744,102,192,"SAIn",1
28,"28001",61,46,45,1,1,"SAIn",0
29,"29094",54317,36540,36174,410,366,"SAIn",10
9,"9012",105,77,74,3,3,"SAIn",0
39,"39080",3627,2743,2693,19,50,"SAIn",2
28,"28129",7219,5536,5461,71,75,"SAIn",2
18,"18903",960,761,753,1,8,"SAIn",0
9,"9001",29,25,25,0,0,"SAIn",0
31,"31021",75,52,52,0,0,"SAIn",0
39,"39033",604,480,473,3,7,"SAIn",0
9,"9079",49,44,44,1,0,"SAIn",0
33,"33013",466,349,345,4,4,"SAIn",0
15,"15032",3639,2642,2586,35,56,"SAIn",1
9,"9229",213,163,163,1,0,"SAIn",0
18,"18121",135,109,109,0,0,"SAIn",0
28,"28125",2808,2077,2055,19,22,"SAIn",0
15,"15089",4354,3255,3216,55,39,"SAIn",1
18,"18177",463,285,281,4,4,"SAIn",0
18,"18039",3733,2901,2878,18,23,"SAIn",1
28,"28041",4006,3190,3154,45,36,"SAIn",0
28,"28064",143,112,110,1,2,"SAIn",0
31,"31180",240,174,170,5,4,"SAIn",0
9,"9259",239,178,177,2,1,"SAIn",1
47,"47185",97,76,75,1,1,"SAIn",0
47,"47058",199,157,157,3,0,"SAIn",0
34,"34050",216,170,166,1,4,"SAIn",0
9,"9451",244,208,202,1,6,"SAIn",0
33,"33014",9318,6380,6320,66,60,"SAIn",0
34,"34227",84,69,67,3,2,"SAIn",0
18,"18112",132,90,90,1,0,"SAIn",0
9,"9058",357,278,276,4,2,"SAIn",0
47,"47113",166,136,135,1,1,"SAIn",0
41,"41085",3918,3173,3128,42,45,"SAIn",0
14,"14071",1025,739,733,8,6,"SAIn",0
9,"9228",168,143,143,3,0,"SAIn",0
18,"18101",8990,6659,6556,96,103,"SAIn",0
9,"9125",648,463,460,5,3,"SAIn",0
41,"41056",3697,3041,3008,25,33,"SAIn",0
28,"28154",5232,3910,3860,40,50,"SAIn",0
41,"41097",3096,2489,2451,21,38,"SAIn",0
31,"31080",544,428,426,7,2,"SAIn",0
34,"34052",187,147,147,1,0,"SAIn",0
18,"18014",5667,4132,4085,43,47,"SAIn",2
31,"31105",1619,1306,1284,30,22,"SAIn",0
18,"18070",287,240,239,2,1,"SAIn",0
41,"41017",13878,10053,9926,130,127,"SAIn",7
28,"28161",44185,33371,32966,353,405,"SAIn",8
28,"28040",15089,9976,9852,116,124,"SAIn",1
9,"9326",156,119,114,2,5,"SAIn",0
28,"28046",4208,3297,3272,31,25,"SAIn",1
9,"9009",167,129,128,8,1,"SAIn",0
9,"9047",62,48,45,0,3,"SAIn",0
29,"29089",3343,2514,2489,14,25,"SAIn",1
18,"18102",8556,6358,6272,42,86,"SAIn",2
34,"34225",4837,3650,3580,73,70,"SAIn",3
15,"15076",2766,1971,1936,18,35,"SAIn",0
9,"9221",446,343,340,7,3,"SAIn",1
9,"9086",629,467,461,5,6,"SAIn",1
39,"39028",3513,2760,2718,23,42,"SAIn",5
31,"31242",235,157,157,2,0,"SAIn",1
28,"28038",4999,3659,3590,32,69,"SAIn",5
9,"9417",43,38,38,0,0,"SAIn",0
34,"34136",192,122,122,1,0,"SAIn",0
14,"14023",2084,1809,1787,13,22,"SAIn",0
34,"34012",368,277,275,9,2,"SAIn",1
31,"31096",127,112,110,2,2,"SAIn",0
28,"28901",765,579,567,2,12,"SAIn",0
31,"31066",915,660,647,19,13,"SAIn",3
39,"39046",1442,1071,1050,13,21,"SAIn",0
47,"47196",43,29,29,0,0,"SAIn",0
28,"28048",489,398,389,3,9,"SAIn",0
31,"31157",3567,2435,2393,32,42,"SAIn",1
33,"33077",1351,938,931,7,7,"SAIn",0
31,"31023",5338,3986,3920,120,66,"SAIn",20
9,"9224",172,125,125,3,0,"SAIn",0
47,"47214",1517,1215,1191,34,24,"SAIn",1
41,"41059",31676,23199,22889,330,310,"SAIn",18
23,"23033",1382,1166,1152,7,14,"SAIn",0
31,"31902",3722,2670,2632,77,38,"SAIn",5
15,"15035",11969,8239,8120,192,119,"SAIn",2
34,"34220",145,125,123,0,2,"SAIn",0
9,"9268",108,78,78,0,0,"SAIn",0
34,"34082",96,79,75,0,4,"SAIn",0
36,"36038",65661,47940,47214,836,726,"SAIn",44
29,"29072",3258,2484,2447,30,37,"SAIn",0
47,"47198",71,56,56,2,0,"SAIn",0
33,"33025",9455,6331,6277,84,54,"SAIn",1
36,"36019",1681,1204,1188,14,16,"SAIn",0
29,"29036",670,504,499,4,5,"SAIn",0
31,"31169",2285,1621,1590,43,31,"SAIn",0
31,"31139",172,97,97,1,0,"SAIn",1
33,"33040",4702,3285,3236,44,49,"SAIn",2
9,"9421",269,189,189,5,0,"SAIn",1
31,"31197",69,58,57,1,1,"SAIn",0
47,"47032",161,130,129,3,1,"SAIn",0
23,"23005",30698,23126,22916,310,210,"SAIn",35
9,"9241",198,159,158,5,1,"SAIn",2
15,"15039",1374,1027,998,27,29,"SAIn",0
29,"29099",958,739,730,5,9,"SAIn",0
47,"47119",101,78,77,0,1,"SAIn",0
34,"34055",288,215,212,4,3,"SAIn",0
34,"34186",61,53,53,0,0,"SAIn",0
29,"29056",1177,807,794,3,13,"SAIn",0
47,"47227",62,52,52,1,0,"SAIn",0
9,"9464",44,28,28,0,0,"SAIn",0
47,"47003",263,224,222,1,2,"SAIn",2
39,"39067",901,628,623,1,5,"SAIn",1
15,"15087",6054,4004,3956,79,48,"SAIn",0
29,"29028",1253,887,876,8,11,"SAIn",0
33,"33042",4434,3172,3135,43,37,"SAIn",0
9,"9466",151,111,110,1,1,"SAIn",0
28,"28120",1259,946,931,11,15,"SAIn",0
47,"47211",45,38,38,1,0,"SAIn",0
28,"28159",629,482,478,2,4,"SAIn",0
9,"9183",58,47,46,1,1,"SAIn",0
47,"47130",105,86,85,2,1,"SAIn",0
35,"35034",6372,2951,2921,33,30,"SAIn",0
9,"9448",225,188,186,1,2,"SAIn",0
29,"29048",1508,1254,1245,6,9,"SAIn",0
28,"28133",5868,4236,4144,23,92,"SAIn",2
18,"18164",1881,1351,1342,16,9,"SAIn",1
9,"9306",127,94,94,0,0,"SAIn",0
39,"39085",6722,5198,5134,60,64,"SAIn",1
18,"18017",17990,12070,11962,80,108,"SAIn",3
41,"41058",16497,12415,12248,181,167,"SAIn",1
31,"31132",160,124,124,6,0,"SAIn",0
39,"39051",73,62,62,2,0,"SAIn",0
9,"9067",460,335,328,5,7,"SAIn",0
29,"29058",1560,1103,1096,5,7,"SAIn",1
34,"34146",60,42,40,1,2,"SAIn",0
47,"47192",99,84,84,0,0,"SAIn",1
15,"15041",9718,7514,7425,102,89,"SAIn",2
28,"28030",1591,1268,1230,12,38,"SAIn",0
9,"9289",1540,1127,1117,16,10,"SAIn",1
47,"47152",94,65,65,0,0,"SAIn",0
31,"31255",100,78,78,1,0,"SAIn",0
36,"36035",14551,10675,10469,160,206,"SAIn",7
31,"31153",2246,1504,1487,13,17,"SAIn",5
28,"28903",29222,23945,23689,296,256,"SAIn",12
9,"9189",146,101,99,2,2,"SAIn",0
31,"31099",68,50,50,0,0,"SAIn",0
34,"34006",82,72,72,1,0,"SAIn",0
28,"28122",504,367,366,2,1,"SAIn",0
28,"28160",7496,5680,5613,46,67,"SAIn",3
41,"41050",5102,4224,4183,39,41,"SAIn",0
47,"47204",275,221,219,3,2,"SAIn",0
31,"31256",113,64,64,0,0,"SAIn",0
31,"31012",839,577,570,10,7,"SAIn",1
31,"31103",51,40,40,3,0,"SAIn",0
9,"9294",123,96,93,1,3,"SAIn",0
47,"47067",198,159,156,5,3,"SAIn",0
31,"31134",195,134,132,3,2,"SAIn",0
41,"41076",2227,1507,1492,5,15,"SAIn",0
18,"18023",16072,11594,11488,131,106,"SAIn",0
18,"18003",13486,10245,10100,145,145,"SAIn",1
15,"15053",8164,5679,5592,60,87,"SAIn",1
15,"15081",1139,869,853,9,16,"SAIn",0
14,"14041",3215,2492,2439,45,53,"SAIn",0
9,"9141",607,503,481,10,22,"SAIn",2
34,"34130",228,187,186,6,1,"SAIn",2
31,"31165",2868,2094,2046,43,48,"SAIn",1
47,"47095",41,36,36,3,0,"SAIn",0
47,"47033",209,170,168,3,2,"SAIn",0
34,"34092",331,272,267,6,5,"SAIn",0
31,"31185",541,377,374,2,3,"SAIn",1
9,"9442",385,295,289,4,6,"SAIn",0
47,"47017",205,177,176,1,1,"SAIn",0
9,"9102",44,36,36,0,0,"SAIn",0
34,"34152",142,114,109,1,5,"SAIn",0
31,"31258",7679,5561,5475,92,86,"SAIn",17
34,"34242",97,81,79,6,2,"SAIn",0
14,"14022",4077,3147,3102,20,45,"SAIn",1
29,"29043",2596,1670,1647,24,23,"SAIn",0
15,"15082",15075,11217,11046,187,171,"SAIn",21
34,"34238",348,289,287,4,2,"SAIn",0
41,"41026",4273,3577,3538,15,39,"SAIn",1
47,"47043",330,267,264,1,3,"SAIn",0
14,"14033",1289,974,958,18,16,"SAIn",2
9,"9297",326,270,266,7,4,"SAIn",0
33,"33023",3410,2501,2485,40,16,"SAIn",1
9,"9035",336,255,251,3,4,"SAIn",0
47,"47178",190,162,161,1,1,"SAIn",0
31,"31106",676,534,518,10,16,"SAIn",0
28,"28034",356,278,276,1,2,"SAIn",0
47,"47097",345,291,289,7,2,"SAIn",0
28,"28055",932,713,707,5,6,"SAIn",0
9,"9480",106,87,87,0,0,"SAIn",0
36,"36017",18554,13573,13378,200,195,"SAIn",7
9,"9298",90,74,74,1,0,"SAIn",0
15,"15046",6949,4641,4539,56,102,"SAIn",7
29,"29063",358,272,271,2,1,"SAIn",1
34,"34109",62,47,46,0,1,"SAIn",0
47,"47153",135,94,93,1,1,"SAIn",0
9,"9036",32,27,27,2,0,"SAIn",0
33,"33009",951,673,663,7,10,"SAIn",0
9,"9195",64,40,40,1,0,"SAIn",0
14,"14075",624,508,500,8,8,"SAIn",0
23,"23076",831,681,671,5,10,"SAIn",0
41,"41063",2678,1869,1853,22,16,"SAIn",1
31,"31047",283,208,204,3,4,"SAIn",0
47,"47127",150,110,108,0,2,"SAIn",0
39,"39074",6785,5287,5233,50,54,"SAIn",3
34,"34098",756,544,540,10,4,"SAIn",0
23,"23062",1476,1274,1264,2,10,"SAIn",1
47,"47180",96,82,81,0,1,"SAIn",0
9,"9105",111,85,81,2,4,"SAIn",0
9,"9239",52,42,42,1,0,"SAIn",0
15,"15901",3855,2463,2419,48,44,"SAIn",0
23,"23004",478,416,415,1,1,"SAIn",0
34,"34233",158,128,128,3,0,"SAIn",0
39,"39048",1616,1326,1308,8,18,"SAIn",0
39,"39057",2298,1735,1719,17,16,"SAIn",0
15,"15048",4769,3470,3415,57,55,"SAIn",3
23,"23015",1476,1189,1179,10,10,"SAIn",0
9,"9392",51,42,42,1,0,"SAIn",0
28,"28079",2290453,1721837,1705310,17342,16527,"SAIn",676
9,"9483",226,173,171,4,2,"SAIn",0
33,"33071",671,528,523,4,5,"SAIn",0
9,"9434",1167,916,902,24,14,"SAIn",1
23,"23020",1623,1414,1400,16,14,"SAIn",1
35,"35024",12420,6978,6819,131,159,"SAIn",2
34,"34071",186,160,160,1,0,"SAIn",1
9,"9485",62,56,56,0,0,"SAIn",0
23,"23021",541,464,453,0,11,"SAIn",1
34,"34902",146,121,121,1,0,"SAIn",0
47,"47173",862,683,675,5,8,"SAIn",0
29,"29902",2577,1689,1665,20,24,"SAIn",0
39,"39049",339,244,242,5,2,"SAIn",0
47,"47210",396,324,321,5,3,"SAIn",0
18,"18132",3461,2797,2772,19,25,"SAIn",2
9,"9198",115,85,85,1,0,"SAIn",0
28,"28096",16844,12441,12308,117,133,"SAIn",3
9,"9216",390,278,272,2,6,"SAIn",2
47,"47030",1075,822,801,13,21,"SAIn",1
23,"23081",1643,1245,1234,12,11,"SAIn",1
31,"31152",1406,1003,975,23,28,"SAIn",1
18,"18063",1189,795,789,7,6,"SAIn",0
18,"18098",6440,4743,4679,44,64,"SAIn",2
9,"9467",65,49,49,0,0,"SAIn",0
28,"28015",14491,11562,11417,155,145,"SAIn",1
9,"9318",63,38,38,0,0,"SAIn",0
23,"23024",12634,9916,9673,116,243,"SAIn",3
47,"47083",80,61,59,3,2,"SAIn",0
15,"15042",3249,2341,2303,25,38,"SAIn",2
39,"39077",256,196,196,1,0,"SAIn",0
23,"23098",923,808,807,6,1,"SAIn",0
9,"9113",503,397,390,7,7,"SAIn",0
31,"31203",30,25,25,0,0,"SAIn",0
33,"33050",653,406,402,0,4,"SAIn",0
28,"28174",1745,1233,1224,11,9,"SAIn",0
9,"9288",98,80,80,1,0,"SAIn",0
47,"47075",4999,4020,3957,39,63,"SAIn",0
31,"31081",335,249,243,8,6,"SAIn",0
34,"34177",170,147,143,2,4,"SAIn",0
23,"23026",3872,3051,2994,23,57,"SAIn",5
14,"14070",1385,1131,1111,4,20,"SAIn",1
9,"9159",57,49,48,0,1,"SAIn",0
14,"14060",4843,3857,3787,47,70,"SAIn",2
18,"18145",10083,7592,7499,78,93,"SAIn",3
28,"28136",618,527,516,2,11,"SAIn",0
39,"39035",10031,7685,7601,74,84,"SAIn",4
18,"18076",880,676,676,3,0,"SAIn",0
14,"14040",3821,2986,2949,40,37,"SAIn",1
47,"47094",154,129,127,0,2,"SAIn",0
39,"39060",6723,5453,5360,56,93,"SAIn",3
36,"36025",2442,1531,1516,10,15,"SAIn",0
9,"9083",27,21,21,0,0,"SAIn",0
28,"28153",608,422,406,1,16,"SAIn",11
31,"31204",45,35,34,0,1,"SAIn",0
9,"9084",200,147,147,4,0,"SAIn",0
47,"47213",122,99,99,1,0,"SAIn",0
28,"28084",15408,11489,11355,122,134,"SAIn",0
47,"47103",277,218,214,1,4,"SAIn",0
9,"9904",548,412,407,7,5,"SAIn",1
47,"47222",92,77,77,4,0,"SAIn",0
34,"34037",345,256,253,4,3,"SAIn",0
9,"9309",343,252,246,7,6,"SAIn",0
9,"9143",24,14,14,1,0,"SAIn",0
23,"23012",4250,3235,3216,19,19,"SAIn",11
39,"39053",251,179,179,1,0,"SAIn",0
9,"9403",98,75,75,0,0,"SAIn",1
23,"23071",1811,1444,1431,13,13,"SAIn",0
47,"47068",41,28,28,0,0,"SAIn",0
34,"34025",54,42,42,0,0,"SAIn",0
34,"34199",1354,1004,978,27,26,"SAIn",2
18,"18044",208,132,132,4,0,"SAIn",0
9,"9455",48,39,39,0,0,"SAIn",0
31,"31084",1949,1369,1361,11,8,"SAIn",0
39,"39088",70,61,61,1,0,"SAIn",0
33,"33022",992,709,696,12,13,"SAIn",1
31,"31904",1590,1054,1031,19,23,"SAIn",3
9,"9311",70,51,51,0,0,"SAIn",0
9,"9906",1199,912,903,12,9,"SAIn",5
34,"34168",60,56,56,0,0,"SAIn",0
9,"9405",143,106,105,2,1,"SAIn",0
14,"14073",3009,2246,2224,32,22,"SAIn",1
47,"47105",210,181,179,1,2,"SAIn",0
47,"47051",351,269,256,5,13,"SAIn",0
41,"41035",1171,898,889,12,9,"SAIn",0
23,"23031",771,649,646,6,3,"SAIn",0
39,"39011",1646,1295,1294,5,1,"SAIn",0
34,"34080",6066,4238,4169,57,69,"SAIn",2
9,"9132",174,129,127,3,2,"SAIn",0
23,"23074",3039,2491,2451,29,40,"SAIn",3
9,"9010",35,27,27,1,0,"SAIn",0
31,"31086",11499,8520,8389,214,131,"SAIn",34
9,"9358",261,200,199,3,1,"SAIn",0
41,"41901",2626,2190,2167,24,23,"SAIn",0
31,"31026",154,125,122,1,3,"SAIn",0
18,"18171",2093,1719,1704,10,15,"SAIn",0
34,"34125",99,77,75,1,2,"SAIn",0
47,"47197",932,739,730,15,9,"SAIn",0
18,"18037",488,408,404,0,4,"SAIn",0
18,"18105",5222,3866,3839,32,27,"SAIn",1
28,"28156",958,742,733,12,9,"SAIn",0
33,"33055",1589,1212,1192,16,20,"SAIn",0
14,"14014",2610,2160,2125,19,35,"SAIn",1
9,"9445",46,31,31,1,0,"SAIn",0
9,"9050",77,52,52,0,0,"SAIn",0
31,"31148",99,69,66,2,3,"SAIn",0
31,"31230",118,88,85,1,3,"SAIn",0
9,"9134",237,164,159,7,5,"SAIn",0
47,"47081",57,44,44,1,0,"SAIn",1
28,"28087",3150,2475,2453,26,22,"SAIn",2
47,"47226",180,152,148,1,4,"SAIn",0
9,"9253",108,95,94,4,1,"SAIn",1
28,"28013",38226,27886,27547,246,339,"SAIn",4
15,"15047",2606,1789,1761,33,28,"SAIn",1
29,"29064",584,428,422,4,6,"SAIn",0
18,"18127",15897,11597,11483,133,114,"SAIn",3
14,"14005",6334,4262,4206,61,56,"SAIn",3
31,"31159",1158,864,846,17,18,"SAIn",4
36,"36031",572,484,479,5,5,"SAIn",0
41,"41064",5629,4041,4006,28,35,"SAIn",1
9,"9052",40,31,31,1,0,"SAIn",0
35,"35033",6415,4394,4302,51,92,"SAIn",2
41,"41090",3488,2792,2751,22,41,"SAIn",0
34,"34127",118,77,74,1,3,"SAIn",0
9,"9363",1047,798,792,9,6,"SAIn",1
9,"9447",36,33,33,0,0,"SAIn",0
28,"28088",251,174,173,5,1,"SAIn",0
39,"39066",895,710,703,6,7,"SAIn",0
39,"39092",1030,753,747,1,6,"SAIn",5
34,"34001",36,29,29,2,0,"SAIn",0
31,"31079",99,64,63,0,1,"SAIn",0
47,"47129",954,744,731,4,13,"SAIn",0
18,"18108",892,674,673,2,1,"SAIn",0
28,"28179",1385,1039,1027,10,12,"SAIn",1
18,"18163",327,246,238,0,8,"SAIn",0
41,"41082",3448,2827,2796,15,31,"SAIn",0
34,"34100",141,105,105,1,0,"SAIn",0
39,"39093",351,260,253,2,7,"SAIn",1
39,"39076",3388,2673,2641,22,32,"SAIn",3
9,"9227",131,100,100,1,0,"SAIn",0
9,"9137",177,134,134,6,0,"SAIn",0
28,"28065",118796,93292,92186,919,1106,"SAIn",28
9,"9078",41,37,35,0,2,"SAIn",0
47,"47139",1080,845,833,11,12,"SAIn",0
47,"47200",91,73,73,0,0,"SAIn",0
18,"18901",583,374,368,3,6,"SAIn",0
28,"28058",137542,103880,102686,1155,1194,"SAIn",20
29,"29020",3188,2448,2424,30,24,"SAIn",0
34,"34061",116,78,78,2,0,"SAIn",0
14,"14059",713,572,567,5,5,"SAIn",0
15,"15013",6160,4229,4165,70,64,"SAIn",2
34,"34190",59,42,42,4,0,"SAIn",1
47,"47149",44,22,20,0,2,"SAIn",0
47,"47175",6562,5041,4957,62,84,"SAIn",8
47,"47158",906,716,710,10,6,"SAIn",0
23,"23084",1046,817,812,4,5,"SAIn",2
28,"28114",148,110,110,0,0,"SAIn",0
47,"47229",235,161,161,1,0,"SAIn",0
15,"15033",2581,2094,2079,15,15,"SAIn",1
35,"35009",19678,13799,13442,155,357,"SAIn",3
47,"47085",16967,12618,12472,208,146,"SAIn",8
18,"18111",2647,1957,1941,24,16,"SAIn",3
31,"31183",667,516,508,8,8,"SAIn",1
9,"9003",205,156,154,4,2,"SAIn",1
9,"9098",553,416,410,11,6,"SAIn",0
35,"35001",4663,3639,3569,39,70,"SAIn",2
29,"29096",2880,2012,1971,28,41,"SAIn",1
18,"18002",625,505,504,2,1,"SAIn",0
29,"29067",420165,273593,271376,3342,2217,"SAIn",169
31,"31184",66,60,59,0,1,"SAIn",0
9,"9018",24688,17880,17508,345,372,"SAIn",23
41,"41015",5263,3820,3752,34,68,"SAIn",0
31,"31123",652,379,373,8,6,"SAIn",1
31,"31093",305,207,203,2,4,"SAIn",0
35,"35010",3565,2178,2135,26,43,"SAIn",0
18,"18913",827,653,646,2,7,"SAIn",1
31,"31164",604,462,448,9,14,"SAIn",0
29,"29077",225,157,157,1,0,"SAIn",0
47,"47186",251279,193705,191693,2746,2012,"SAIn",253
29,"29041",2796,1950,1921,24,29,"SAIn",1
9,"9454",46,31,30,1,1,"SAIn",0
34,"34077",283,219,216,3,3,"SAIn",0
34,"34163",61,56,56,1,0,"SAIn",0
9,"9905",432,313,309,1,4,"SAIn",0
31,"31034",43,29,29,0,0,"SAIn",0
28,"28138",78,48,46,0,2,"SAIn",0
47,"47195",449,350,346,5,4,"SAIn",0
31,"31003",131,101,101,1,0,"SAIn",0
35,"35011",23140,15550,15320,199,230,"SAIn",7
9,"9117",82,59,59,1,0,"SAIn",0
23,"23902",2495,2081,2067,4,14,"SAIn",0
34,"34216",65,50,50,1,0,"SAIn",0
31,"31248",318,190,187,2,3,"SAIn",0
28,"28092",148714,112174,110838,1215,1336,"SAIn",24
28,"28061",19624,15082,14905,162,177,"SAIn",7
31,"31014",280,197,196,2,1,"SAIn",2
9,"9085",486,348,339,8,9,"SAIn",0
41,"41034",22561,16014,15840,270,174,"SAIn",34
28,"28018",3572,2837,2795,20,42,"SAIn",0
47,"47206",111,99,99,0,0,"SAIn",0
41,"41078",2587,1979,1970,15,9,"SAIn",1
9,"9416",61,44,44,0,0,"SAIn",0
9,"9144",61,51,50,0,1,"SAIn",0
9,"9022",83,58,58,2,0,"SAIn",0
9,"9192",74,55,53,0,2,"SAIn",0
9,"9374",96,85,81,3,4,"SAIn",0
31,"31126",372,247,244,6,3,"SAIn",0
9,"9194",2033,1557,1535,28,22,"SAIn",1
34,"34181",471,350,346,7,4,"SAIn",0
15,"15008",5657,4224,4157,62,67,"SAIn",1
9,"9061",187,146,144,1,2,"SAIn",1
33,"33061",446,260,259,1,1,"SAIn",0
34,"34230",12,8,8,0,0,"SAIn",0
47,"47224",92,77,77,0,0,"SAIn",0
39,"39073",9275,6984,6903,83,81,"SAIn",2
47,"47009",117,88,88,1,0,"SAIn",0
28,"28027",1232,937,919,9,18,"SAIn",0
28,"28069",51,35,33,1,2,"SAIn",0
47,"47188",125,112,109,3,3,"SAIn",0
29,"29100",2442,1834,1824,14,10,"SAIn",0
9,"9088",77,40,40,0,0,"SAIn",0
23,"23048",884,691,679,6,12,"SAIn",0
23,"23047",1658,1342,1339,6,3,"SAIn",0
9,"9280",34,23,23,0,0,"SAIn",0
15,"15009",11109,8179,8014,129,165,"SAIn",3
31,"31128",406,261,261,4,0,"SAIn",0
39,"39039",648,496,493,0,3,"SAIn",0
14,"14045",3093,2662,2642,14,20,"SAIn",1
47,"47010",11275,8800,8701,163,99,"SAIn",7
9,"9024",159,124,123,2,1,"SAIn",0
47,"47172",149,125,124,3,1,"SAIn",0
9,"9180",132,97,95,8,2,"SAIn",0
18,"18149",5096,3949,3900,36,49,"SAIn",2
15,"15038",2363,1643,1610,29,33,"SAIn",0
34,"34232",802,632,623,9,9,"SAIn",1
9,"9377",658,509,505,11,4,"SAIn",1
28,"28157",605,452,446,2,6,"SAIn",0
47,"47028",31,21,20,0,1,"SAIn",0
9,"9303",92,64,64,0,0,"SAIn",0
29,"29027",2416,1907,1893,15,14,"SAIn",0
23,"23049",1942,1514,1486,16,28,"SAIn",0
28,"28095",1358,1092,1077,8,15,"SAIn",2
47,"47063",107,87,87,2,0,"SAIn",0
47,"47037",194,160,159,1,1,"SAIn",0
18,"18048",2277,1705,1688,19,17,"SAIn",0
9,"9064",353,277,277,6,0,"SAIn",0
9,"9025",150,112,110,0,2,"SAIn",0
23,"23095",8882,6668,6628,31,40,"SAIn",6
9,"9109",1181,664,631,16,33,"SAIn",8
47,"47147",129,96,96,0,0,"SAIn",0
15,"15058",26931,19505,19196,471,309,"SAIn",11
28,"28113",31318,23779,23436,271,343,"SAIn",4
34,"34141",190,162,160,0,2,"SAIn",0
9,"9242",93,82,82,2,0,"SAIn",0
31,"31191",2930,2194,2148,43,46,"SAIn",6
33,"33064",237,175,173,1,2,"SAIn",0
29,"29074",818,631,630,3,1,"SAIn",0
31,"31090",156,77,77,0,0,"SAIn",0
39,"39041",1775,1432,1414,15,18,"SAIn",6
34,"34034",129,104,104,1,0,"SAIn",0
9,"9110",95,68,68,1,0,"SAIn",0
47,"47148",475,389,384,2,5,"SAIn",0
36,"36033",12323,9328,9150,97,178,"SAIn",7
31,"31071",17,15,15,0,0,"SAIn",0
9,"9437",298,249,247,5,2,"SAIn",0
41,"41074",3079,2406,2386,14,20,"SAIn",0
34,"34236",176,134,134,1,0,"SAIn",0
15,"15050",1971,1110,1097,27,13,"SAIn",0
9,"9056",4957,3607,3557,70,50,"SAIn",2
9,"9138",92,77,74,0,3,"SAIn",0
14,"14069",7733,5910,5824,68,86,"SAIn",0
31,"31010",5788,3716,3637,48,79,"SAIn",4
9,"9043",215,151,151,1,0,"SAIn",0
23,"23067",2523,2004,1974,16,30,"SAIn",0
28,"28166",325,269,268,8,1,"SAIn",0
36,"36045",24724,17794,17459,237,335,"SAIn",14
34,"34116",76,50,49,1,1,"SAIn",0
9,"9902",491,363,357,4,6,"SAIn",1
9,"9244",53,44,44,0,0,"SAIn",0
29,"29002",1246,896,893,11,3,"SAIn",0
23,"23009",12876,10335,10231,109,104,"SAIn",12
29,"29040",1934,1344,1332,12,12,"SAIn",0
28,"28024",156,132,132,5,0,"SAIn",0
31,"31031",234,144,143,1,1,"SAIn",0
34,"34049",421,313,311,4,2,"SAIn",0
18,"18912",1576,1193,1185,7,8,"SAIn",0
9,"9174",859,645,639,11,6,"SAIn",1
28,"28002",2650,2018,1993,24,25,"SAIn",0
15,"15014",4239,3151,3104,39,47,"SAIn",0
9,"9201",33,22,22,2,0,"SAIn",0
29,"29059",2551,1986,1964,11,22,"SAIn",0
34,"34240",102,84,83,1,1,"SAIn",0
31,"31194",308,212,210,6,2,"SAIn",1
29,"29003",1133,902,900,5,2,"SAIn",0
9,"9247",28,21,20,0,1,"SAIn",0
31,"31073",332,228,226,1,2,"SAIn",0
47,"47050",3557,2688,2651,50,37,"SAIn",4
31,"31083",50,37,37,0,0,"SAIn",0
34,"34149",26,18,18,0,0,"SAIn",0
28,"28067",3893,2996,2950,26,46,"SAIn",1
31,"31013",668,382,375,12,7,"SAIn",3
15,"15072",9868,7077,6951,79,126,"SAIn",3
28,"28068",10502,7857,7778,68,79,"SAIn",4
47,"47142",172,132,131,2,1,"SAIn",0
34,"34106",121,100,99,2,1,"SAIn",1
28,"28075",5127,3976,3916,42,60,"SAIn",1
28,"28053",6035,4854,4783,61,71,"SAIn",0
14,"14061",841,700,693,3,7,"SAIn",0
9,"9033",104,82,80,1,2,"SAIn",0
9,"9190",97,73,72,0,1,"SAIn",0
18,"18136",1973,1679,1668,5,11,"SAIn",0
29,"29068",6209,4025,3983,41,42,"SAIn",2
18,"18024",882,696,688,12,8,"SAIn",0
18,"18188",1659,1329,1308,9,21,"SAIn",1
34,"34229",75,60,60,2,0,"SAIn",0
9,"9220",82,60,60,2,0,"SAIn",0
31,"31085",451,334,327,3,7,"SAIn",1
9,"9060",171,142,142,0,0,"SAIn",0
47,"47115",306,248,248,2,0,"SAIn",0
18,"18004",818,601,594,2,7,"SAIn",1
9,"9177",1154,823,815,12,8,"SAIn",2
18,"18124",387,270,267,0,3,"SAIn",0
31,"31075",96,61,61,0,0,"SAIn",0
15,"15045",4178,2743,2727,22,16,"SAIn",2
9,"9208",252,192,192,6,0,"SAIn",1
9,"9249",54,44,42,1,2,"SAIn",0
23,"23059",5974,4910,4852,37,58,"SAIn",1
31,"31136",438,283,283,10,0,"SAIn",1
23,"23016",442,355,354,5,1,"SAIn",0
14,"14063",1121,875,866,9,9,"SAIn",0
39,"39029",642,521,517,6,4,"SAIn",0
29,"29080",6598,4703,4663,31,40,"SAIn",0
9,"9478",53,41,41,1,0,"SAIn",0
34,"34243",352,274,273,5,1,"SAIn",0
14,"14064",352,265,261,3,4,"SAIn",0
14,"14034",367,301,292,1,9,"SAIn",0
41,"41027",4061,2783,2752,28,31,"SAIn",0
36,"36051",14288,10228,10079,124,149,"SAIn",3
9,"9166",97,87,87,1,0,"SAIn",0
23,"23017",1668,1392,1377,10,15,"SAIn",0
31,"31067",1982,1400,1363,28,37,"SAIn",2
41,"41010",4338,2990,2958,48,32,"SAIn",1
47,"47208",56,45,43,1,2,"SAIn",0
28,"28178",1017,799,791,11,8,"SAIn",0
18,"18028",992,826,821,4,5,"SAIn",0
33,"33002",10837,7667,7588,77,79,"SAIn",1
9,"9391",383,290,284,7,6,"SAIn",0
9,"9419",82,61,61,0,0,"SAIn",0
41,"41095",40097,27969,27731,354,238,"SAIn",8
34,"34031",29,26,26,0,0,"SAIn",0
28,"28078",39,23,23,1,0,"SAIn",0
9,"9281",159,134,132,5,2,"SAIn",0
34,"34157",2471,1936,1912,26,24,"SAIn",1
34,"34206",952,796,780,9,16,"SAIn",0
9,"9037",122,91,90,2,1,"SAIn",0
18,"18193",13680,9874,9764,130,110,"SAIn",5
28,"28141",5568,4097,4051,31,46,"SAIn",1
31,"31241",164,117,116,4,1,"SAIn",0
15,"15029",6266,4668,4618,49,50,"SAIn",0
9,"9123",31,27,27,0,0,"SAIn",0
33,"33048",169,120,120,1,0,"SAIn",0
41,"41081",28121,20027,19785,275,242,"SAIn",6
9,"9213",370,260,260,5,0,"SAIn",1
39,"39031",1227,965,956,4,9,"SAIn",1
36,"36020",2581,1947,1922,27,25,"SAIn",3
18,"18162",947,726,721,8,5,"SAIn",0
9,"9433",67,46,45,2,1,"SAIn",0
29,"29009",1525,1126,1109,9,17,"SAIn",0
9,"9038",123,92,92,0,0,"SAIn",0
41,"41003",2196,1803,1782,21,21,"SAIn",0
9,"9076",24,15,15,0,0,"SAIn",0
9,"9214",724,477,467,4,10,"SAIn",0
9,"9380",85,71,71,1,0,"SAIn",0
39,"39058",862,586,584,6,2,"SAIn",0
28,"28036",2301,1809,1784,13,25,"SAIn",0
34,"34158",336,202,200,0,2,"SAIn",0
39,"39084",873,647,642,4,5,"SAIn",0
9,"9256",369,254,252,2,2,"SAIn",0
31,"31100",298,193,193,2,0,"SAIn",3
23,"23096",2678,2298,2276,18,22,"SAIn",2
18,"18040",246,147,146,0,1,"SAIn",0
15,"15022",6102,4207,4164,52,43,"SAIn",3
23,"23066",4348,3687,3654,21,33,"SAIn",2
34,"34114",240,171,171,0,0,"SAIn",0
35,"35025",1941,1345,1328,12,17,"SAIn",0
47,"47165",7036,5328,5258,67,70,"SAIn",3
31,"31263",241,135,132,0,3,"SAIn",0
34,"34903",240,161,160,2,1,"SAIn",0
47,"47065",898,762,752,9,10,"SAIn",0
36,"36023",8522,6206,6062,64,144,"SAIn",5
9,"9029",186,138,137,4,1,"SAIn",0
41,"41014",2484,1956,1936,13,20,"SAIn",0
15,"15079",1709,1268,1253,14,15,"SAIn",1
23,"23053",9431,7160,7128,42,32,"SAIn",6
28,"28009",13466,10392,10286,102,106,"SAIn",3
29,"29011",3013,1893,1876,7,17,"SAIn",0
9,"9307",119,89,88,1,1,"SAIn",0
28,"28090",7899,6216,6131,60,85,"SAIn",0
33,"33035",11413,8105,8035,104,70,"SAIn",3
39,"39016",24213,18549,18362,265,187,"SAIn",19
29,"29095",3431,2660,2607,23,53,"SAIn",0
14,"14039",2705,2204,2189,12,15,"SAIn",1
29,"29021",153,113,113,0,0,"SAIn",0
28,"28097",127,94,92,0,2,"SAIn",0
9,"9425",561,431,418,3,13,"SAIn",1
23,"23069",5489,4656,4586,36,70,"SAIn",4
9,"9082",49,41,41,0,0,"SAIn",0
29,"29050",483,341,340,1,1,"SAIn",0
39,"39061",3458,2673,2644,42,29,"SAIn",1
47,"47131",189,145,145,4,0,"SAIn",0
15,"15052",4567,3539,3493,22,46,"SAIn",3
39,"39009",3200,2427,2402,24,25,"SAIn",0
31,"31022",544,378,369,1,9,"SAIn",0
9,"9006",68,40,39,1,1,"SAIn",0
31,"31144",840,509,508,7,1,"SAIn",0
9,"9440",105,80,80,0,0,"SAIn",0
31,"31236",1333,887,874,15,13,"SAIn",6
33,"33059",5049,3480,3447,37,33,"SAIn",0
18,"18122",16253,12271,12109,132,162,"SAIn",2
47,"47024",283,211,210,1,1,"SAIn",0
9,"9441",70,59,59,2,0,"SAIn",0
23,"23028",6428,4855,4802,26,53,"SAIn",7
31,"31053",595,430,418,6,12,"SAIn",1
9,"9219",28514,20244,19951,326,293,"SAIn",11
14,"14062",1114,889,882,9,7,"SAIn",0
9,"9261",486,342,338,7,4,"SAIn",4
9,"9129",112,93,93,0,0,"SAIn",0
28,"28175",780,641,630,8,11,"SAIn",0
9,"9175",143,99,98,0,1,"SAIn",0
39,"39010",688,533,524,6,9,"SAIn",1
23,"23057",823,717,711,4,6,"SAIn",0
29,"29023",1661,1080,1074,15,6,"SAIn",0
47,"47042",63,50,49,3,1,"SAIn",0
33,"33007",1680,1186,1179,10,7,"SAIn",1
9,"9007",66,50,50,0,0,"SAIn",0
29,"29061",1045,861,855,7,6,"SAIn",1
31,"31228",540,376,364,13,12,"SAIn",0
35,"35020",6142,4227,4192,24,35,"SAIn",1
9,"9131",412,332,321,6,11,"SAIn",0
41,"41101",5752,4663,4629,25,34,"SAIn",1
31,"31024",116,56,56,2,0,"SAIn",0
28,"28076",417,325,321,1,4,"SAIn",0
9,"9373",485,332,331,5,1,"SAIn",0
14,"14043",7664,5935,5874,53,61,"SAIn",4
15,"15027",1537,1263,1242,22,21,"SAIn",0
34,"34123",1798,1479,1436,18,43,"SAIn",1
47,"47215",60,52,52,2,0,"SAIn",0
18,"18137",1057,875,868,8,7,"SAIn",2
18,"18170",377,238,237,0,1,"SAIn",0
34,"34217",1089,866,849,19,17,"SAIn",1
41,"41009",1272,914,899,8,15,"SAIn",0
47,"47134",186,155,149,2,6,"SAIn",0
35,"35030",8295,5433,5315,54,118,"SAIn",1
9,"9908",509,328,321,5,7,"SAIn",0
9,"9907",1385,1053,1041,31,12,"SAIn",3
34,"34081",53,42,41,0,1,"SAIn",0
18,"18016",339,254,253,2,1,"SAIn",0
31,"31178",540,395,392,4,3,"SAIn",1
47,"47216",124,99,98,2,1,"SAIn",0
34,"34042",299,249,246,5,3,"SAIn",0
28,"28062",311,233,226,0,7,"SAIn",0
36,"36029",16178,11902,11636,148,266,"SAIn",13
9,"9062",52,33,32,1,1,"SAIn",0
35,"35005",1170,864,853,7,11,"SAIn",0
41,"41062",2252,1719,1698,12,21,"SAIn",0
47,"47109",183,151,151,4,0,"SAIn",0
9,"9090",61,50,50,0,0,"SAIn",0
31,"31240",553,360,359,3,1,"SAIn",0
47,"47019",93,69,68,0,1,"SAIn",0
9,"9011",86,56,56,1,0,"SAIn",0
34,"34170",72,56,56,1,0,"SAIn",0
41,"41902",4682,3136,3101,34,35,"SAIn",1
9,"9225",95,61,61,3,0,"SAIn",0
9,"9315",362,267,265,9,2,"SAIn",1
41,"41037",3228,2510,2483,27,27,"SAIn",0
31,"31209",155,105,104,1,1,"SAIn",1
31,"31098",1762,1285,1262,34,23,"SAIn",6
9,"9302",116,87,87,3,0,"SAIn",0
29,"29008",14069,9934,9859,118,75,"SAIn",1
39,"39091",2026,1636,1628,14,8,"SAIn",0
31,"31149",2381,1626,1607,7,19,"SAIn",0
18,"18010",576,464,458,4,6,"SAIn",0
29,"29092",596,457,454,10,3,"SAIn",0
47,"47110",471,386,378,6,8,"SAIn",0
47,"47002",30,27,27,1,0,"SAIn",0
18,"18174",470,368,363,1,5,"SAIn",0
29,"29046",2777,2032,2013,10,19,"SAIn",0
15,"15030",201751,141022,138934,2981,2088,"SAIn",101
28,"28112",168,138,137,0,1,"SAIn",0
34,"34222",122,94,94,2,0,"SAIn",0
47,"47218",983,776,767,7,9,"SAIn",0
9,"9316",108,87,84,0,3,"SAIn",0
41,"41903",6653,5134,5070,61,64,"SAIn",4
36,"36021",11798,8742,8574,136,168,"SAIn",1
23,"23064",1680,1483,1478,8,5,"SAIn",0
33,"33011",12085,7186,7116,89,70,"SAIn",0
9,"9270",180,147,143,2,4,"SAIn",0
14,"14047",1566,1154,1143,19,11,"SAIn",0
41,"41039",31429,23337,23138,294,199,"SAIn",9
9,"9170",218,158,157,0,1,"SAIn",0
31,"31212",173,117,117,3,0,"SAIn",0
18,"18049",632,476,474,5,2,"SAIn",0
34,"34003",167,132,130,7,2,"SAIn",0
41,"41013",4762,3359,3327,9,32,"SAIn",2
9,"9411",174,104,103,1,1,"SAIn",0
18,"18143",949,722,704,2,18,"SAIn",0
9,"9381",38,30,30,0,0,"SAIn",0
28,"28089",3531,2786,2753,25,33,"SAIn",0
14,"14028",333,279,277,1,2,"SAIn",0
9,"9039",58,50,49,0,1,"SAIn",0
23,"23052",1186,1012,997,1,15,"SAIn",0
39,"39042",5928,4680,4634,44,46,"SAIn",1
41,"41022",4281,3087,3066,15,21,"SAIn",0
18,"18074",297,245,245,5,0,"SAIn",0
41,"41005",8792,6642,6585,71,57,"SAIn",1
47,"47212",386,327,325,1,2,"SAIn",0
47,"47166",276,226,223,0,3,"SAIn",0
39,"39068",663,488,485,4,3,"SAIn",7
34,"34020",63,44,44,0,0,"SAIn",0
41,"41031",1319,879,875,6,4,"SAIn",0
28,"28016",86,68,67,3,1,"SAIn",0
9,"9068",25,19,19,2,0,"SAIn",0
47,"47057",237,198,198,3,0,"SAIn",0
28,"28052",3799,2753,2719,17,34,"SAIn",1
9,"9323",71,44,44,2,0,"SAIn",0
31,"31062",1103,849,832,7,17,"SAIn",2
31,"31214",95,64,64,1,0,"SAIn",0
36,"36002",3154,2381,2358,35,23,"SAIn",0
31,"31113",147,87,85,2,2,"SAIn",0
9,"9274",1160,924,914,14,10,"SAIn",1
39,"39069",1957,1595,1570,18,25,"SAIn",3
9,"9369",460,339,336,4,3,"SAIn",0
31,"31215",4618,3384,3315,54,69,"SAIn",0
34,"34089",173,128,125,5,3,"SAIn",1
34,"34133",108,90,90,0,0,"SAIn",0
36,"36003",9876,7155,7007,100,148,"SAIn",3
47,"47176",229,157,157,0,0,"SAIn",1
47,"47077",291,232,232,1,0,"SAIn",0
18,"18187",587,432,432,0,0,"SAIn",0
23,"23086",11411,8918,8798,129,120,"SAIn",7
34,"34178",106,93,93,1,0,"SAIn",0
39,"39070",152,118,118,0,0,"SAIn",0
31,"31063",96,77,75,0,2,"SAIn",0
41,"41033",5237,3915,3878,20,37,"SAIn",0
34,"34179",32,21,21,0,0,"SAIn",0
34,"34010",560,458,451,7,7,"SAIn",1
29,"29051",37991,24498,24095,381,403,"SAIn",9
33,"33037",37135,25522,25262,291,260,"SAIn",5
34,"34134",61,49,47,0,2,"SAIn",0
31,"31247",171,121,121,1,0,"SAIn",0
34,"34241",20,12,11,0,1,"SAIn",0
47,"47104",2917,2391,2357,31,34,"SAIn",0
9,"9191",45,34,33,1,1,"SAIn",0
39,"39045",410,324,323,5,1,"SAIn",0
14,"14072",1169,925,922,5,3,"SAIn",1
28,"28085",3794,2980,2933,18,47,"SAIn",0
41,"41060",15176,10797,10693,114,104,"SAIn",0
15,"15073",21991,14686,14456,216,230,"SAIn",6
47,"47096",139,109,107,0,2,"SAIn",0
31,"31095",83,70,70,1,0,"SAIn",0
15,"15026",2025,1426,1413,17,13,"SAIn",1
18,"18056",3695,2961,2940,25,21,"SAIn",0
29,"29024",414,271,261,6,10,"SAIn",1
15,"15036",60838,40345,39667,915,678,"SAIn",16
23,"23001",1058,922,920,6,2,"SAIn",0
28,"28004",5761,4098,4044,38,54,"SAIn",0
9,"9277",130,101,101,1,0,"SAIn",0
15,"15092",6869,4965,4907,53,58,"SAIn",3
47,"47144",85,65,65,2,0,"SAIn",0
23,"23046",2441,2049,2027,13,22,"SAIn",0
47,"47061",266,227,223,0,4,"SAIn",0
31,"31187",122,68,68,2,0,"SAIn",0
34,"34094",64,47,44,1,3,"SAIn",0
31,"31076",2314,1843,1823,39,20,"SAIn",10
9,"9327",34,34,34,0,0,"SAIn",0
9,"9389",77,66,66,0,0,"SAIn",0
31,"31015",1989,1404,1380,29,24,"SAIn",2
29,"29053",1715,1239,1221,7,18,"SAIn",0
39,"39047",1987,1495,1482,9,13,"SAIn",1
47,"47088",121,100,100,0,0,"SAIn",0
15,"15065",7570,5710,5628,71,82,"SAIn",1
39,"39090",731,577,572,3,5,"SAIn",0
28,"28094",774,557,551,5,6,"SAIn",0
33,"33017",3289,2378,2350,35,28,"SAIn",3
39,"39099",2987,2416,2391,28,25,"SAIn",0
34,"34182",860,657,649,8,8,"SAIn",0
47,"47117",306,231,228,4,3,"SAIn",0
9,"9408",45,36,36,0,0,"SAIn",0
28,"28070",139,98,97,0,1,"SAIn",0
35,"35014",9943,5438,5316,95,122,"SAIn",2
9,"9460",187,144,142,2,2,"SAIn",1
15,"15010",2009,1468,1441,24,27,"SAIn",0
47,"47062",185,153,153,5,0,"SAIn",0
34,"34015",45,40,40,0,0,"SAIn",0
34,"34184",54,37,36,0,1,"SAIn",0
28,"28056",782,604,586,6,18,"SAIn",0
34,"34139",179,143,143,1,0,"SAIn",1
36,"36008",21702,15366,15037,261,329,"SAIn",15
18,"18059",4055,3232,3191,37,41,"SAIn",0
31,"31906",2493,1796,1770,57,26,"SAIn",10
31,"31261",271,202,201,4,1,"SAIn",0
9,"9283",63,36,36,0,0,"SAIn",0
34,"34185",72,48,45,0,3,"SAIn",0
36,"36009",5138,3147,3108,24,39,"SAIn",1
23,"23094",3917,3200,3166,32,34,"SAIn",0
28,"28028",1615,1204,1173,11,31,"SAIn",2
36,"36010",2987,2312,2282,30,30,"SAIn",1
39,"39101",328,251,247,5,4,"SAIn",0
23,"23050",91354,68649,67925,990,724,"SAIn",144
9,"9152",273,207,207,1,0,"SAIn",0
31,"31190",48,34,34,1,0,"SAIn",0
33,"33018",2971,2139,2121,32,18,"SAIn",2
31,"31211",25,14,14,2,0,"SAIn",0
18,"18128",361,284,283,5,1,"SAIn",0
31,"31039",94,65,61,0,4,"SAIn",0
34,"34059",462,377,375,5,2,"SAIn",0
31,"31222",67,46,44,3,2,"SAIn",0
34,"34019",139,108,108,5,0,"SAIn",0
33,"33019",3262,2283,2244,12,39,"SAIn",0
9,"9334",52,40,39,1,1,"SAIn",0
47,"47219",46,36,36,1,0,"SAIn",0
18,"18020",1473,1111,1106,7,5,"SAIn",0
39,"39050",305,207,205,1,2,"SAIn",0
47,"47012",134,105,105,0,0,"SAIn",0
34,"34033",17,15,15,0,0,"SAIn",0
18,"18097",1022,758,752,4,6,"SAIn",0
29,"29001",4176,3339,3303,23,36,"SAIn",0
28,"28082",5144,3967,3905,46,62,"SAIn",0
34,"34237",645,506,498,6,8,"SAIn",0
31,"31161",321,251,246,5,5,"SAIn",0
31,"31172",375,295,288,11,7,"SAIn",3
47,"47183",150,125,122,0,3,"SAIn",0
34,"34060",150,123,123,2,0,"SAIn",0
9,"9155",27,17,17,0,0,"SAIn",0
31,"31041",1397,938,913,26,25,"SAIn",5
28,"28145",2125,1643,1620,15,23,"SAIn",0
31,"31101",1305,892,874,15,18,"SAIn",5
34,"34904",355,247,241,3,6,"SAIn",0
34,"34005",899,707,698,8,9,"SAIn",0
47,"47220",194,143,142,4,1,"SAIn",0
15,"15060",5599,4139,4069,82,70,"SAIn",2
34,"34102",226,187,185,3,2,"SAIn",0
36,"36057",236900,168990,166060,2833,2930,"SAIn",134
18,"18134",5528,3751,3679,57,72,"SAIn",3
23,"23010",14447,10777,10704,109,73,"SAIn",4
9,"9030",135,97,97,2,0,"SAIn",0
34,"34103",105,92,92,5,0,"SAIn",0
14,"14019",6486,5288,5243,65,45,"SAIn",0
33,"33044",180964,129466,128346,1888,1120,"SAIn",116
35,"35018",11652,6488,6367,107,121,"SAIn",5
34,"34062",175,126,124,3,2,"SAIn",0
15,"15071",8233,5751,5668,93,83,"SAIn",3
36,"36013",2690,1801,1778,11,23,"SAIn",2
9,"9338",220,173,168,5,5,"SAIn",0
23,"23055",48167,33913,33612,400,301,"SAIn",20
31,"31226",597,339,335,2,4,"SAIn",0
18,"18100",7304,5807,5737,62,70,"SAIn",1
31,"31002",421,292,284,5,8,"SAIn",2
9,"9400",340,253,249,4,4,"SAIn",0
29,"29032",6673,5204,5140,43,64,"SAIn",3
15,"15015",2840,2006,1964,43,42,"SAIn",1
41,"41051",2103,1705,1686,7,19,"SAIn",0
47,"47151",32,29,29,0,0,"SAIn",0
9,"9276",420,275,245,5,30,"SAIn",0
28,"28147",910,705,698,5,7,"SAIn",0
9,"9428",124,107,107,1,0,"SAIn",0
31,"31043",42,30,30,1,0,"SAIn",0
34,"34151",184,125,123,1,2,"SAIn",0
9,"9115",96,71,70,4,1,"SAIn",1
18,"18123",307,239,238,1,1,"SAIn",0
33,"33060",15694,11036,10883,112,153,"SAIn",5
15,"15062",6304,4418,4356,44,62,"SAIn",2
36,"36049",6608,5189,5097,56,92,"SAIn",5
9,"9429",64,44,44,2,0,"SAIn",0
15,"15091",1171,839,829,9,10,"SAIn",0
31,"31135",116,87,86,9,1,"SAIn",0
28,"28100",3970,2903,2865,32,38,"SAIn",3
39,"39062",1759,1397,1387,9,10,"SAIn",1
33,"33030",921,682,668,4,14,"SAIn",0
9,"9430",18,15,15,0,0,"SAIn",0
39,"39097",732,476,470,4,6,"SAIn",0
9,"9262",158,139,137,7,2,"SAIn",0
9,"9388",32,25,24,2,1,"SAIn",1
35,"35021",14982,9948,9749,138,199,"SAIn",2
9,"9034",301,250,250,3,0,"SAIn",0
28,"28011",437,318,315,2,3,"SAIn",0
41,"41052",2967,2305,2288,7,17,"SAIn",0
18,"18189",723,547,541,6,6,"SAIn",0
33,"33069",3611,2615,2597,25,18,"SAIn",0
9,"9073",889,672,663,12,9,"SAIn",4
29,"29034",462,360,357,0,3,"SAIn",0
39,"39003",321,265,261,0,4,"SAIn",0
23,"23060",19107,14365,14264,130,101,"SAIn",8
47,"47079",67,56,56,1,0,"SAIn",0
39,"39081",440,372,369,3,3,"SAIn",0
18,"18036",3553,2762,2741,20,21,"SAIn",1
14,"14013",17006,13114,12958,166,156,"SAIn",7
18,"18027",2575,1913,1899,15,14,"SAIn",0
18,"18057",5045,3755,3721,44,34,"SAIn",1
9,"9209",4617,3269,3234,44,35,"SAIn",3
15,"15075",12042,8639,8486,147,153,"SAIn",3
34,"34231",273,209,206,2,3,"SAIn",0
41,"41054",671,556,550,0,6,"SAIn",0
31,"31078",2502,1880,1852,33,28,"SAIn",2
28,"28102",913,700,693,9,7,"SAIn",0
31,"31077",5349,4025,3917,103,108,"SAIn",9
18,"18161",220,180,178,0,2,"SAIn",0
47,"47045",839,636,632,3,4,"SAIn",0
33,"33070",3481,2557,2521,33,36,"SAIn",0
33,"33047",1178,939,931,2,8,"SAIn",0
34,"34069",2330,1769,1749,25,20,"SAIn",2
36,"36052",7517,5563,5461,54,102,"SAIn",3
31,"31138",939,648,646,14,2,"SAIn",0
28,"28126",59,37,37,0,0,"SAIn",0
47,"47071",406,333,329,6,4,"SAIn",1
47,"47189",164,134,134,1,0,"SAIn",0
29,"29082",29311,20220,20051,223,169,"SAIn",4
9,"9347",136,113,109,5,4,"SAIn",0
9,"9179",45,37,37,0,0,"SAIn",0
34,"34083",1888,1355,1338,15,17,"SAIn",0
39,"39013",561,413,412,2,1,"SAIn",0
31,"31109",1365,946,934,11,12,"SAIn",4
41,"41096",6079,4673,4595,47,78,"SAIn",0
29,"29037",227,170,170,0,0,"SAIn",0
47,"47020",283,237,232,5,5,"SAIn",1
18,"18029",1892,1355,1347,6,8,"SAIn",0
39,"39083",1214,785,775,7,10,"SAIn",0
9,"9077",38,26,25,0,1,"SAIn",0
28,"28172",7648,6130,6076,65,54,"SAIn",1
31,"31018",422,303,299,8,4,"SAIn",3
23,"23063",3960,3073,3037,21,36,"SAIn",1
14,"14036",3774,2928,2909,51,19,"SAIn",3
9,"9410",3181,2079,2049,48,30,"SAIn",0
34,"34171",1071,762,753,16,9,"SAIn",0
15,"15021",5114,3527,3475,77,52,"SAIn",4
28,"28151",3025,2237,2185,9,52,"SAIn",2
14,"14068",581,460,457,7,3,"SAIn",0
28,"28127",60108,48418,48039,568,379,"SAIn",9
34,"34113",35,28,27,0,1,"SAIn",0
47,"47021",84,61,61,2,0,"SAIn",0
18,"18119",1778,1401,1391,14,10,"SAIn",0
31,"31141",132,100,98,1,2,"SAIn",0
14,"14038",31501,23683,23394,336,289,"SAIn",5
47,"47047",217,171,170,5,1,"SAIn",0
47,"47191",113,81,80,1,1,"SAIn",0
41,"41065",23028,15133,14958,191,175,"SAIn",3
9,"9215",426,290,287,1,3,"SAIn",0
41,"41021",20767,14040,13822,240,218,"SAIn",8
23,"23065",1701,1238,1226,10,12,"SAIn",1
31,"31223",1043,783,771,14,12,"SAIn",1
9,"9335",62,52,51,1,1,"SAIn",0
14,"14048",1244,975,970,5,5,"SAIn",0
47,"47157",544,462,458,9,4,"SAIn",0
34,"34073",184,153,152,7,1,"SAIn",0
39,"39059",8476,6365,6284,73,81,"SAIn",1
23,"23025",2845,2292,2271,17,21,"SAIn",0
9,"9396",152,113,113,0,0,"SAIn",0
33,"33058",1863,1307,1286,11,21,"SAIn",0
9,"9257",93,73,72,2,1,"SAIn",0
9,"9352",134,107,106,0,1,"SAIn",0
36,"36056",5087,3883,3830,37,53,"SAIn",2
47,"47221",115,102,102,0,0,"SAIn",0
9,"9449",94,80,80,2,0,"SAIn",1
39,"39034",289,209,209,3,0,"SAIn",0
47,"47076",16922,13030,12899,212,131,"SAIn",19
18,"18165",3942,2819,2776,27,43,"SAIn",0
29,"29086",814,538,536,9,2,"SAIn",0
34,"34036",211,159,157,0,2,"SAIn",0
23,"23070",4142,2877,2846,20,31,"SAIn",2
41,"41006",2743,1972,1957,13,15,"SAIn",0
47,"47049",94,71,71,1,0,"SAIn",0
47,"47102",302,250,248,3,2,"SAIn",0
47,"47023",2863,2278,2258,38,20,"SAIn",3
35,"35027",10510,7523,7375,88,148,"SAIn",2
35,"35002",21673,14480,14253,172,227,"SAIn",8
28,"28060",1471,1205,1192,8,13,"SAIn",0
41,"41067",7055,5368,5295,64,73,"SAIn",2
39,"39087",43561,33709,33242,404,467,"SAIn",31
9,"9202",26,24,24,1,0,"SAIn",0
9,"9354",33,29,29,2,0,"SAIn",0
36,"36058",5021,3589,3516,54,73,"SAIn",1
28,"28039",139,103,103,1,0,"SAIn",0
18,"18066",2072,1558,1552,8,6,"SAIn",0
28,"28130",27391,21367,21111,235,256,"SAIn",2
15,"15090",1267,959,953,4,6,"SAIn",0
35,"35028",8810,4687,4603,71,84,"SAIn",2
9,"9231",77,42,42,0,0,"SAIn",0
9,"9372",207,169,165,1,4,"SAIn",0
9,"9059",137122,103909,102353,2008,1556,"SAIn",311
9,"9176",60,47,45,2,2,"SAIn",2
31,"31104",1990,1374,1355,20,19,"SAIn",1
9,"9295",78,54,53,0,1,"SAIn",0
47,"47078",178,159,154,7,5,"SAIn",0
9,"9071",48,32,32,0,0,"SAIn",0
14,"14011",595,498,497,4,1,"SAIn",0
14,"14042",18991,14726,14495,290,231,"SAIn",4
18,"18089",15803,10794,10712,95,82,"SAIn",1
28,"28032",4469,3412,3369,32,43,"SAIn",1
36,"36027",4478,3376,3339,29,37,"SAIn",4
9,"9072",272,210,209,4,1,"SAIn",0
18,"18045",1211,892,885,4,7,"SAIn",0
35,"35012",9662,5511,5446,45,65,"SAIn",0
28,"28110",1912,1492,1475,8,17,"SAIn",1
15,"15055",4780,3247,3181,70,66,"SAIn",1
31,"31177",264,162,158,3,4,"SAIn",0
36,"36061",8729,6747,6640,68,107,"SAIn",5
28,"28131",12664,9454,9342,100,112,"SAIn",0
9,"9265",44,36,35,2,1,"SAIn",0
28,"28132",10987,8066,7943,90,123,"SAIn",1
31,"31207",280,198,195,7,3,"SAIn",0
31,"31055",264,194,193,0,1,"SAIn",0
41,"41087",9827,7300,7150,51,150,"SAIn",1
9,"9250",295,234,230,5,4,"SAIn",0
31,"31025",751,501,495,12,6,"SAIn",2
28,"28169",1244,971,962,8,9,"SAIn",0
35,"35022",43892,27289,26876,326,413,"SAIn",20
9,"9406",242,193,193,2,0,"SAIn",2
23,"23002",17740,14007,13858,171,149,"SAIn",10
28,"28086",4603,3286,3248,29,38,"SAIn",3
29,"29091",8777,6226,6126,64,100,"SAIn",0
9,"9223",46,40,40,0,0,"SAIn",0
29,"29044",866,631,627,3,4,"SAIn",0
34,"34218",486,366,365,3,1,"SAIn",1
9,"9267",135,118,118,3,0,"SAIn",0
39,"39065",272,199,197,2,2,"SAIn",0
41,"41088",542,414,408,1,6,"SAIn",0
23,"23075",3404,2800,2782,24,18,"SAIn",1
47,"47163",315,253,250,2,3,"SAIn",0
47,"47001",51,44,42,2,2,"SAIn",0
34,"34169",431,331,329,5,2,"SAIn",0
23,"23034",2591,2146,2124,13,22,"SAIn",0
18,"18908",827,669,660,7,9,"SAIn",1
31,"31068",3004,2258,2207,43,51,"SAIn",1
9,"9196",161,111,110,0,1,"SAIn",0
18,"18182",1982,1405,1397,6,8,"SAIn",0
47,"47036",257,212,212,1,0,"SAIn",0
9,"9314",113,89,88,4,1,"SAIn",0
31,"31027",824,611,609,2,2,"SAIn",0
28,"28042",1091,814,808,5,6,"SAIn",0
15,"15086",3110,2281,2259,30,22,"SAIn",0
14,"14046",4587,3671,3641,35,30,"SAIn",1
9,"9269",39,33,33,0,0,"SAIn",0
47,"47055",212,169,168,3,1,"SAIn",0
14,"14016",1406,1123,1115,9,8,"SAIn",0
39,"39014",943,706,700,9,6,"SAIn",0
34,"34221",190,143,143,3,0,"SAIn",1
18,"18071",5589,4268,4205,44,63,"SAIn",1
34,"34084",142,124,122,3,2,"SAIn",0
31,"31028",217,129,128,1,1,"SAIn",0
34,"34099",56,49,47,1,2,"SAIn",0
34,"34046",45,35,34,0,1,"SAIn",0
28,"28080",45696,36832,36529,402,303,"SAIn",17
28,"28143",81,71,67,1,4,"SAIn",0
9,"9181",334,271,271,14,0,"SAIn",0
18,"18011",4246,3195,3172,23,23,"SAIn",1
9,"9014",190,113,113,3,0,"SAIn",0
31,"31060",12916,8830,8687,158,143,"SAIn",27
18,"18072",710,507,499,2,8,"SAIn",0
33,"33034",11390,7583,7501,85,82,"SAIn",1
9,"9094",49,39,39,0,0,"SAIn",1
34,"34143",181,142,140,3,2,"SAIn",0
39,"39024",2065,1616,1601,8,15,"SAIn",0
15,"15068",5404,3780,3725,53,55,"SAIn",0
41,"41057",299,191,189,0,2,"SAIn",0
41,"41048",2296,1749,1726,21,23,"SAIn",0
47,"47156",182,155,148,0,7,"SAIn",0
31,"31070",2706,1949,1912,34,37,"SAIn",2
47,"47022",62,54,54,0,0,"SAIn",0
9,"9382",33,30,30,0,0,"SAIn",0
33,"33057",1635,1150,1132,16,18,"SAIn",0
9,"9016",87,55,54,1,1,"SAIn",0
14,"14049",16358,12577,12478,137,99,"SAIn",2
18,"18012",2693,1841,1831,11,10,"SAIn",0
18,"18021",16026,11376,11219,186,157,"SAIn",2
34,"34131",67,57,56,0,1,"SAIn",1
31,"31030",155,113,112,3,1,"SAIn",0
31,"31213",114,58,58,0,0,"SAIn",0
31,"31193",1312,969,948,33,21,"SAIn",3
47,"47066",1114,891,888,10,3,"SAIn",0
31,"31122",4506,3333,3281,76,52,"SAIn",18
9,"9413",500,335,331,1,4,"SAIn",0
23,"23040",1538,1319,1311,3,8,"SAIn",1
9,"9321",1760,1338,1327,20,11,"SAIn",0
39,"39043",1321,1082,1072,8,10,"SAIn",1
47,"47031",203,149,149,0,0,"SAIn",0
47,"47193",1538,1229,1211,23,18,"SAIn",0
47,"47167",258,230,229,3,1,"SAIn",0
28,"28167",7818,6016,5942,82,74,"SAIn",1
41,"41041",9646,7901,7791,58,110,"SAIn",2
28,"28045",30286,23148,22879,226,269,"SAIn",4
47,"47006",196,151,146,1,5,"SAIn",0
23,"23101",413,324,321,3,3,"SAIn",0
47,"47205",414,307,298,5,9,"SAIn",0
23,"23085",2350,1963,1956,8,7,"SAIn",1
31,"31174",115,72,70,1,2,"SAIn",0
9,"9032",118,68,68,0,0,"SAIn",0
36,"36036",2616,1981,1948,24,33,"SAIn",0
9,"9415",290,192,192,4,0,"SAIn",0
28,"28003",196,154,151,2,3,"SAIn",0
34,"34063",102,92,91,2,1,"SAIn",0
14,"14021",259993,183200,181402,2936,1798,"SAIn",144
31,"31257",827,598,585,16,13,"SAIn",1
36,"36048",5416,4045,3971,55,74,"SAIn",1
31,"31155",264,187,183,7,4,"SAIn",0
47,"47007",3453,2616,2580,42,36,"SAIn",2
31,"31044",276,224,223,0,1,"SAIn",0
28,"28168",1144,821,810,15,11,"SAIn",1
47,"47177",112,83,79,1,4,"SAIn",0
34,"34038",284,228,225,9,3,"SAIn",0
34,"34066",66,55,54,0,1,"SAIn",0
18,"18067",704,526,521,1,5,"SAIn",0
29,"29088",2784,2019,1975,14,44,"SAIn",0
36,"36060",30264,21398,21051,344,347,"SAIn",16
33,"33045",4692,3347,3297,42,50,"SAIn",1
35,"35029",3981,2341,2315,43,26,"SAIn",2
15,"15017",18860,12975,12737,325,238,"SAIn",9
34,"34067",142,88,88,3,0,"SAIn",0
47,"47034",90,65,63,0,2,"SAIn",0
31,"31186",299,205,200,3,5,"SAIn",1
14,"14053",6040,4455,4376,78,79,"SAIn",2
9,"9021",62,33,33,1,0,"SAIn",0
9,"9456",142,110,110,3,0,"SAIn",0
34,"34053",222,177,172,4,5,"SAIn",0
31,"31156",268,202,201,5,1,"SAIn",1
36,"36006",11387,8911,8727,72,184,"SAIn",2
31,"31217",382,256,244,5,12,"SAIn",2
28,"28162",2263,1802,1786,32,16,"SAIn",0
33,"33008",1934,1474,1459,11,15,"SAIn",0
33,"33024",229816,164603,163179,2100,1424,"SAIn",55
39,"39037",2061,1609,1586,10,23,"SAIn",0
47,"47052",6207,4812,4761,79,51,"SAIn",2
47,"47070",33,30,30,1,0,"SAIn",0
18,"18159",1051,873,869,4,4,"SAIn",0
9,"9458",422,325,316,5,9,"SAIn",1
33,"33039",1719,1325,1319,14,6,"SAIn",0
29,"29054",39904,27540,27307,240,233,"SAIn",12
36,"36007",1778,1258,1238,2,20,"SAIn",0
18,"18116",2972,2237,2213,19,24,"SAIn",1
28,"28163",395,305,301,7,4,"SAIn",0
31,"31250",2887,1827,1802,20,25,"SAIn",1
33,"33016",19516,14345,14210,198,135,"SAIn",4
41,"41071",5603,3999,3932,28,67,"SAIn",1
33,"33062",452,282,281,3,1,"SAIn",0
47,"47089",184,139,138,1,1,"SAIn",0
14,"14025",3061,2547,2517,13,30,"SAIn",0
18,"18047",5603,3833,3805,67,28,"SAIn",2
36,"36041",13141,9405,9238,114,167,"SAIn",2
31,"31017",358,220,219,12,1,"SAIn",0
34,"34110",96,83,81,2,2,"SAIn",0
28,"28014",31360,23434,23133,203,301,"SAIn",8
9,"9075",126,102,101,1,1,"SAIn",0
31,"31199",161,103,103,1,0,"SAIn",0
29,"29085",156,116,113,0,3,"SAIn",0
31,"31058",240,184,179,0,5,"SAIn",0
31,"31088",5358,3655,3592,97,63,"SAIn",13
9,"9330",1562,1212,1176,10,36,"SAIn",2
31,"31038",1372,982,968,17,14,"SAIn",2
34,"34901",1233,955,946,14,9,"SAIn",0
41,"41046",3055,2456,2418,23,38,"SAIn",0
28,"28050",3576,2706,2663,21,43,"SAIn",0
18,"18018",658,520,514,4,6,"SAIn",0
47,"47090",2511,1907,1880,23,27,"SAIn",0
14,"14026",2043,1434,1421,10,13,"SAIn",0
18,"18151",276,191,188,0,3,"SAIn",0
28,"28007",122891,95200,94139,990,1061,"SAIn",35
9,"9255",90,68,68,0,0,"SAIn",0
41,"41075",9987,7904,7809,71,95,"SAIn",2
31,"31170",46,40,39,3,1,"SAIn",0
14,"14067",3821,3105,3082,38,23,"SAIn",0
9,"9287",201,159,158,4,1,"SAIn",0
14,"14027",7948,5944,5871,92,73,"SAIn",3
9,"9026",384,296,295,8,1,"SAIn",1
47,"47074",155,125,124,0,1,"SAIn",0
28,"28072",5232,4065,4007,35,58,"SAIn",0
34,"34072",189,169,166,2,3,"SAIn",0
39,"39006",1732,1381,1373,23,8,"SAIn",0
47,"47121",590,495,490,4,5,"SAIn",0
28,"28128",366,280,275,2,5,"SAIn",1
28,"28106",72603,53231,52524,681,707,"SAIn",10
29,"29084",28386,19450,19202,296,248,"SAIn",10
31,"31009",717,510,497,14,13,"SAIn",0
41,"41004",55127,37662,37179,622,483,"SAIn",20
31,"31110",97,53,53,3,0,"SAIn",0
23,"23007",3116,2483,2458,15,25,"SAIn",1
34,"34101",54,44,44,0,0,"SAIn",0
35,"35026",78933,49860,48955,780,905,"SAIn",55
18,"18120",274,238,237,2,1,"SAIn",0
9,"9199",97,75,74,0,1,"SAIn",0
31,"31224",980,691,681,9,10,"SAIn",0
23,"23097",6510,4687,4639,36,48,"SAIn",5
31,"31234",148,107,105,6,2,"SAIn",0
28,"28121",185,153,152,0,1,"SAIn",0
31,"31227",8257,5987,5884,125,103,"SAIn",5
34,"34035",122,98,96,0,2,"SAIn",0
18,"18109",607,461,456,1,5,"SAIn",0
9,"9273",55,47,47,0,0,"SAIn",0
47,"47005",578,467,455,5,12,"SAIn",0
47,"47048",204,168,167,2,1,"SAIn",0
31,"31072",5098,3764,3698,75,66,"SAIn",5
28,"28074",136617,106248,105095,1101,1153,"SAIn",25
9,"9471",171,127,125,1,2,"SAIn",0
29,"29076",2022,1384,1374,14,10,"SAIn",1
33,"33066",42885,29326,29013,460,313,"SAIn",8
39,"39078",1407,1041,1033,10,8,"SAIn",2
9,"9044",54,45,45,1,0,"SAIn",0
34,"34108",561,477,465,6,12,"SAIn",0
31,"31042",2719,2100,2057,27,43,"SAIn",2
9,"9427",1561,1090,1078,18,12,"SAIn",0
41,"41099",4141,2818,2799,37,19,"SAIn",0
14,"14010",4087,3144,3121,15,23,"SAIn",0
34,"34023",5318,3947,3891,64,56,"SAIn",4
47,"47123",456,356,353,10,3,"SAIn",1
33,"33052",758,526,518,2,8,"SAIn",0
28,"28031",1981,1524,1500,9,24,"SAIn",0
47,"47041",166,135,133,2,2,"SAIn",0
9,"9070",38,27,27,3,0,"SAIn",0
36,"36015",4379,3151,3101,38,50,"SAIn",0
41,"41100",1097,894,878,8,16,"SAIn",0
47,"47124",435,364,358,5,6,"SAIn",0
34,"34051",112,92,91,7,1,"SAIn",0
28,"28025",426,336,332,2,4,"SAIn",0
34,"34228",93,80,80,0,0,"SAIn",0
34,"34009",34,31,31,3,0,"SAIn",1
14,"14031",634,516,514,1,2,"SAIn",0
9,"9355",117,88,87,1,1,"SAIn",0
31,"31903",6058,3985,3919,67,66,"SAIn",10
23,"23029",924,730,727,2,3,"SAIn",0
31,"31074",430,304,303,10,1,"SAIn",1
23,"23072",2063,1661,1643,16,18,"SAIn",5
31,"31145",173,129,127,2,2,"SAIn",0
41,"41025",1999,1502,1476,13,26,"SAIn",0
41,"41028",1880,1479,1458,28,21,"SAIn",1
15,"15054",32172,20472,20154,519,318,"SAIn",12
14,"14032",434,377,375,1,2,"SAIn",0
39,"39054",4265,3338,3276,57,62,"SAIn",3
9,"9206",65,56,55,2,1,"SAIn",0
31,"31259",503,341,336,6,5,"SAIn",0
28,"28101",222,158,158,4,0,"SAIn",0
9,"9343",94,77,76,0,1,"SAIn",0
9,"9164",179,130,130,1,0,"SAIn",0
34,"34202",28,21,21,0,0,"SAIn",0
28,"28176",10977,8790,8718,68,72,"SAIn",0
31,"31176",2777,1999,1955,57,44,"SAIn",3
31,"31146",46,34,34,1,0,"SAIn",0
47,"47125",55,46,46,0,0,"SAIn",0
33,"33056",5278,3576,3540,41,36,"SAIn",0
36,"36050",7602,5424,5339,50,85,"SAIn",4
35,"35004",35462,18498,18196,325,302,"SAIn",14
28,"28054",10459,7798,7698,65,100,"SAIn",4
33,"33072",1737,1171,1159,11,12,"SAIn",1
18,"18062",9418,6916,6835,62,81,"SAIn",2
14,"14017",10755,8220,8149,101,71,"SAIn",0
14,"14003",1289,1046,1026,12,20,"SAIn",0
41,"41053",20729,16178,15971,142,207,"SAIn",11
18,"18192",1581,1331,1318,6,13,"SAIn",1
36,"36018",3492,2516,2494,25,22,"SAIn",0
34,"34246",78,64,64,0,0,"SAIn",0
23,"23061",7309,5637,5584,60,53,"SAIn",1
9,"9346",95,83,83,1,0,"SAIn",0
9,"9482",33,31,30,1,1,"SAIn",0
47,"47154",168,144,144,7,0,"SAIn",0
34,"34155",142,118,117,3,1,"SAIn",0
9,"9390",645,522,518,9,4,"SAIn",0
34,"34156",56,48,48,2,0,"SAIn",0
23,"23018",2415,1791,1781,9,10,"SAIn",0
35,"35023",11640,8412,8178,97,234,"SAIn",3
18,"18181",253,183,182,0,1,"SAIn",0
9,"9051",181,136,133,2,3,"SAIn",0
9,"9361",134,99,98,0,1,"SAIn",0
36,"36030",4387,3206,3177,35,29,"SAIn",2
33,"33073",9341,5825,5773,69,52,"SAIn",1
9,"9017",96,76,74,0,2,"SAIn",0
35,"35006",29515,20731,20286,362,445,"SAIn",23
18,"18007",808,602,591,5,11,"SAIn",0
23,"23019",1590,1355,1339,7,16,"SAIn",0
14,"14066",5911,4515,4473,54,42,"SAIn",2
33,"33010",1922,1284,1277,14,7,"SAIn",0
39,"39005",1319,1048,1026,3,22,"SAIn",0
28,"28035",1314,1058,1046,3,12,"SAIn",0
29,"29083",2212,1679,1652,15,27,"SAIn",0
41,"41029",13231,9756,9610,128,146,"SAIn",3
36,"36053",5677,4204,4157,51,47,"SAIn",3
31,"31200",763,527,514,17,13,"SAIn",0
9,"9450",31,26,26,1,0,"SAIn",0
33,"33028",1466,812,806,5,6,"SAIn",1
28,"28017",1120,905,888,8,17,"SAIn",1
47,"47128",57,52,48,1,4,"SAIn",0
23,"23041",519,455,448,2,7,"SAIn",0
29,"29010",1703,1411,1377,7,34,"SAIn",0
15,"15024",4726,3634,3555,51,79,"SAIn",2
14,"14057",6115,5040,4975,71,65,"SAIn",4
9,"9350",502,384,376,7,8,"SAIn",0
18,"18175",11534,8772,8698,68,74,"SAIn",3
28,"28135",928,665,659,6,6,"SAIn",0
29,"29066",363,263,260,1,3,"SAIn",0
9,"9093",154,127,125,1,2,"SAIn",0
47,"47111",1005,804,794,5,10,"SAIn",0
31,"31181",168,121,119,3,2,"SAIn",0
31,"31233",103,87,82,2,5,"SAIn",0
14,"14008",2905,2226,2200,18,26,"SAIn",0
9,"9162",122,94,93,1,1,"SAIn",0
47,"47100",169,146,144,1,2,"SAIn",0
31,"31192",148,107,104,1,3,"SAIn",0
23,"23008",1552,1280,1266,9,14,"SAIn",0
29,"29039",2822,2091,2074,8,17,"SAIn",0
31,"31264",173,110,108,1,2,"SAIn",0
34,"34211",202,175,170,1,5,"SAIn",0
31,"31142",1443,906,899,16,7,"SAIn",0
18,"18144",779,592,590,3,2,"SAIn",0
28,"28109",1621,1121,1104,9,17,"SAIn",0
23,"23014",2529,2058,2039,13,19,"SAIn",0
36,"36034",3684,2686,2651,32,35,"SAIn",3
18,"18042",425,344,342,2,2,"SAIn",0
28,"28066",7033,5439,5383,45,56,"SAIn",0
31,"31092",676,447,446,6,1,"SAIn",0
41,"41066",1417,1121,1113,9,8,"SAIn",0
9,"9353",62,51,51,2,0,"SAIn",0
31,"31173",881,754,733,12,21,"SAIn",0
18,"18033",282,227,226,0,1,"SAIn",1
9,"9308",70,51,51,0,0,"SAIn",0
33,"33006",1674,1130,1120,10,10,"SAIn",1
18,"18904",858,620,612,3,8,"SAIn",0
47,"47187",101,82,81,1,1,"SAIn",0
36,"36028",4207,3294,3254,21,40,"SAIn",0
9,"9235",179,148,142,1,6,"SAIn",0
29,"29012",9817,7063,6991,51,72,"SAIn",6
36,"36054",10862,8201,8087,87,114,"SAIn",2
29,"29031",1652,1123,1118,11,5,"SAIn",0
33,"33041",7488,5356,5309,65,47,"SAIn",1
47,"47182",1371,991,982,12,9,"SAIn",0
31,"31133",48,34,34,3,0,"SAIn",0
31,"31114",384,320,318,37,2,"SAIn",0
33,"33074",3699,2643,2611,30,32,"SAIn",1
18,"18167",1927,1397,1380,13,17,"SAIn",3
9,"9045",283,196,196,4,0,"SAIn",1
15,"15006",5539,3940,3866,53,74,"SAIn",1
36,"36037",2727,1923,1896,18,27,"SAIn",0
23,"23901",1194,1048,1045,8,3,"SAIn",3
34,"34104",274,224,224,4,0,"SAIn",0
18,"18006",4116,2862,2831,25,31,"SAIn",1
39,"39001",2146,1669,1645,20,24,"SAIn",2
36,"36026",20494,14048,13798,232,250,"SAIn",8
9,"9325",217,151,148,1,3,"SAIn",1
15,"15016",5135,3816,3771,22,45,"SAIn",1
34,"34024",27,18,17,1,1,"SAIn",0
41,"41008",1073,884,875,0,9,"SAIn",0
14,"14001",3633,3095,3064,25,31,"SAIn",0
18,"18035",1254,991,982,7,9,"SAIn",0
23,"23093",3313,2706,2673,13,33,"SAIn",1
31,"31061",67,47,47,2,0,"SAIn",0
23,"23030",1270,1052,1045,3,7,"SAIn",0
47,"47025",127,103,103,0,0,"SAIn",0
31,"31238",125,99,98,3,1,"SAIn",1
36,"36016",1373,865,853,7,12,"SAIn",0
33,"33015",1695,1177,1161,12,16,"SAIn",1
33,"33038",2442,1757,1725,14,32,"SAIn",3
28,"28155",529,427,416,2,11,"SAIn",0
31,"31116",71,48,48,2,0,"SAIn",0
29,"29015",31805,22566,22347,272,219,"SAIn",16
31,"31004",36,21,20,0,1,"SAIn",0
34,"34135",429,334,329,6,5,"SAIn",0
41,"41043",647,457,454,5,3,"SAIn",0
18,"18107",988,769,760,3,9,"SAIn",0
41,"41072",4083,3073,3046,12,27,"SAIn",0
36,"36046",4093,3175,3120,31,55,"SAIn",1
39,"39002",3400,2554,2514,35,40,"SAIn",1
9,"9368",26,18,18,0,0,"SAIn",0
28,"28057",1419,1084,1074,12,10,"SAIn",0
33,"33003",737,475,471,6,4,"SAIn",1
28,"28083",8037,6078,6025,66,53,"SAIn",2
41,"41047",9810,7427,7321,99,106,"SAIn",2
9,"9266",87,72,72,0,0,"SAIn",0
9,"9178",61,48,48,0,0,"SAIn",0
33,"33032",12060,8627,8491,107,136,"SAIn",3
15,"15084",3681,2676,2656,34,20,"SAIn",3
18,"18138",2460,1751,1741,1,10,"SAIn",1
31,"31057",1863,1450,1409,32,41,"SAIn",1
23,"23092",27970,20921,20651,284,270,"SAIn",74
31,"31905",2707,1913,1881,32,32,"SAIn",8
28,"28091",5202,3714,3671,34,43,"SAIn",1
47,"47080",45,39,39,1,0,"SAIn",0
28,"28020",145,102,100,0,2,"SAIn",0
9,"9407",31,27,27,0,0,"SAIn",0
18,"18173",8858,6238,6187,64,51,"SAIn",0
47,"47145",658,482,473,7,9,"SAIn",0
34,"34204",53,45,44,0,1,"SAIn",0
28,"28149",5276,4132,4063,43,69,"SAIn",1
31,"31189",1229,745,740,5,5,"SAIn",1
36,"36012",3839,2884,2825,14,59,"SAIn",4
47,"47133",2382,1861,1841,30,20,"SAIn",1
31,"31040",197,137,135,2,2,"SAIn",0
28,"28059",4061,3169,3130,38,39,"SAIn",1
18,"18140",42971,28391,28126,335,265,"SAIn",10
23,"23077",668,523,518,2,5,"SAIn",0
9,"9013",48,41,41,1,0,"SAIn",0
9,"9168",329,254,254,2,0,"SAIn",0
9,"9135",41,29,29,1,0,"SAIn",0
18,"18141",484,326,325,1,1,"SAIn",0
9,"9362",219,185,184,2,1,"SAIn",0
9,"9091",746,556,550,8,6,"SAIn",0
33,"33033",10609,7179,7107,91,72,"SAIn",0
23,"23035",1066,919,912,3,7,"SAIn",0
9,"9184",4,4,4,0,0,"SAIn",0
31,"31011",688,437,432,17,5,"SAIn",5
23,"23090",1371,1188,1177,6,11,"SAIn",2
18,"18013",4392,3268,3223,23,45,"SAIn",2
31,"31249",1926,1376,1361,30,15,"SAIn",5
33,"33051",7576,5379,5335,65,44,"SAIn",3
31,"31154",229,133,133,4,0,"SAIn",0
36,"36024",17164,12723,12500,163,223,"SAIn",18
31,"31049",733,479,479,4,0,"SAIn",2
9,"9182",104,81,81,1,0,"SAIn",1
15,"15049",1211,851,843,7,8,"SAIn",0
31,"31171",738,521,495,7,26,"SAIn",2
31,"31151",77,49,49,2,0,"SAIn",0
15,"15040",2891,2160,2129,18,31,"SAIn",0
14,"14007",15871,11609,11477,121,132,"SAIn",3
39,"39032",1576,1215,1209,10,6,"SAIn",0
9,"9901",407,319,308,8,11,"SAIn",1
47,"47171",453,371,368,10,3,"SAIn",0
15,"15034",3116,2146,2114,20,32,"SAIn",0
18,"18146",1059,791,776,2,15,"SAIn",0
28,"28051",1469,1147,1129,7,18,"SAIn",0
9,"9066",62,44,42,0,2,"SAIn",0
47,"47039",196,163,163,1,0,"SAIn",0
18,"18176",265,183,181,0,2,"SAIn",0
31,"31182",45,28,28,2,0,"SAIn",0
23,"23082",1985,1464,1451,9,13,"SAIn",0
34,"34215",166,146,145,1,1,"SAIn",0
18,"18095",1916,1428,1306,21,122,"SAIn",0
34,"34079",1391,1088,1077,17,11,"SAIn",1
47,"47016",94,77,77,1,0,"SAIn",0
15,"15078",78092,56506,55597,1110,909,"SAIn",132
31,"31244",153,97,97,3,0,"SAIn",0
33,"33078",159,108,106,1,2,"SAIn",0
31,"31163",2008,1458,1434,22,24,"SAIn",2
28,"28180",5179,4033,3975,18,58,"SAIn",0
15,"15005",23875,15132,14895,356,237,"SAIn",4
15,"15061",6105,4391,4307,64,84,"SAIn",1
28,"28023",4350,3425,3392,32,33,"SAIn",1
39,"39025",8985,7048,6955,70,93,"SAIn",1
47,"47141",148,121,119,1,2,"SAIn",0
23,"23073",4671,3778,3735,19,43,"SAIn",2
31,"31065",1927,1391,1362,39,29,"SAIn",1
9,"9439",909,720,697,16,23,"SAIn",1
18,"18135",4752,3252,3212,34,40,"SAIn",0
9,"9200",54,35,35,2,0,"SAIn",0
47,"47040",67,51,50,0,1,"SAIn",0
15,"15080",1913,1407,1389,15,18,"SAIn",1
9,"9903",3299,2373,2349,45,24,"SAIn",2
29,"29065",207,151,149,1,2,"SAIn",0
33,"33049",6806,4629,4581,70,48,"SAIn",1
31,"31901",15574,11165,10974,201,191,"SAIn",44
9,"9218",384,285,279,8,6,"SAIn",0
41,"41016",6950,5194,5120,45,74,"SAIn",5
33,"33036",11674,8695,8605,104,90,"SAIn",4
41,"41024",22383,15333,15160,213,173,"SAIn",10
47,"47150",338,273,271,2,2,"SAIn",0
39,"39018",4077,3212,3160,44,52,"SAIn",4
28,"28134",55921,42676,42221,505,455,"SAIn",14
23,"23003",8778,6945,6877,51,68,"SAIn",4
31,"31037",94,68,68,0,0,"SAIn",0
39,"39044",3864,2940,2905,44,35,"SAIn",2
9,"9339",139,105,104,1,1,"SAIn",0
47,"47160",466,368,364,5,4,"SAIn",0
31,"31175",78,55,54,0,1,"SAIn",0
29,"29004",343,281,281,0,0,"SAIn",0
31,"31054",498,310,308,1,2,"SAIn",0
31,"31108",1969,1474,1452,23,22,"SAIn",2
9,"9172",129,110,109,2,1,"SAIn",0
41,"41083",1176,915,908,8,7,"SAIn",0
31,"31111",100,75,75,1,0,"SAIn",1
31,"31206",2079,1517,1475,33,42,"SAIn",8
34,"34201",212,178,172,1,6,"SAIn",0
34,"34088",219,179,177,4,2,"SAIn",1
9,"9476",67,52,52,0,0,"SAIn",0
28,"28124",83,55,53,0,2,"SAIn",0
29,"29098",1312,1043,1036,22,7,"SAIn",0
23,"23045",2180,1671,1667,3,4,"SAIn",0
18,"18147",3742,2419,2386,20,33,"SAIn",1
33,"33076",12662,8733,8670,120,63,"SAIn",2
14,"14012",6305,4749,4690,44,59,"SAIn",0
47,"47118",159,122,122,2,0,"SAIn",1
31,"31252",91,60,58,0,2,"SAIn",0
34,"34039",66,57,56,0,1,"SAIn",0
14,"14002",10991,8444,8358,106,86,"SAIn",2
9,"9292",98,73,71,3,2,"SAIn",0
34,"34214",176,144,143,3,1,"SAIn",0
18,"18153",8348,6170,6118,88,52,"SAIn",1
28,"28047",38404,28739,28436,312,303,"SAIn",16
15,"15023",6629,4879,4795,52,84,"SAIn",1
31,"31140",117,91,89,3,2,"SAIn",0
31,"31036",957,631,616,22,15,"SAIn",1
41,"41044",6838,5064,5005,67,59,"SAIn",0
15,"15093",4562,3314,3270,37,44,"SAIn",1
39,"39021",536,448,444,1,4,"SAIn",0
34,"34137",31,24,24,3,0,"SAIn",0
31,"31016",7377,5149,5072,101,77,"SAIn",11
39,"39026",1825,1383,1371,12,12,"SAIn",0
28,"28146",1672,1220,1205,4,15,"SAIn",0
28,"28010",9309,7304,7229,71,75,"SAIn",4
9,"9238",1026,612,601,6,11,"SAIn",0
28,"28006",74554,57439,56890,586,549,"SAIn",10
14,"14055",18619,13802,13607,192,195,"SAIn",6
14,"14035",6153,4715,4656,51,59,"SAIn",2
18,"18152",1037,822,818,9,4,"SAIn",0
39,"39102",2330,1748,1731,13,17,"SAIn",1
34,"34160",154,119,116,0,3,"SAIn",0
9,"9412",846,568,563,4,5,"SAIn",0
34,"34122",80,65,62,2,3,"SAIn",0
15,"15004",4891,3595,3545,61,50,"SAIn",0
15,"15088",3769,2626,2599,21,27,"SAIn",2
31,"31091",365,227,224,3,3,"SAIn",0
35,"35003",4764,2733,2680,34,53,"SAIn",2
14,"14015",2198,1776,1755,16,21,"SAIn",0
28,"28063",268,209,203,4,6,"SAIn",0
34,"34070",182,138,137,1,1,"SAIn",0
9,"9332",137,88,85,1,3,"SAIn",0
9,"9108",399,287,283,5,4,"SAIn",0
35,"35015",9065,4859,4770,64,89,"SAIn",2
36,"36043",5188,3435,3390,35,45,"SAIn",4
47,"47014",55,47,47,0,0,"SAIn",0
41,"41091",545464,388043,383816,5325,4227,"SAIn",318
18,"18064",419,347,345,3,2,"SAIn",0
39,"39095",2292,1824,1801,24,23,"SAIn",0
41,"41102",14343,11050,10837,206,213,"SAIn",2
9,"9217",389,273,270,8,3,"SAIn",1
15,"15070",9684,6627,6464,141,163,"SAIn",0
23,"23054",393,288,286,1,2,"SAIn",0
47,"47230",318,266,259,2,7,"SAIn",0
23,"23099",4649,3638,3594,39,44,"SAIn",1
39,"39040",4350,3413,3373,30,40,"SAIn",0
15,"15059",10658,7889,7728,125,161,"SAIn",6
34,"34174",213,179,178,4,1,"SAIn",0
31,"31019",1858,1288,1266,25,22,"SAIn",2
31,"31120",408,267,265,8,2,"SAIn",1
47,"47056",90,69,69,2,0,"SAIn",0
29,"29090",1805,1265,1260,5,5,"SAIn",0
31,"31107",1706,1321,1311,17,10,"SAIn",0
41,"41080",1289,1010,997,13,13,"SAIn",0
23,"23056",3182,2539,2523,20,16,"SAIn",1
33,"33065",1150,791,784,16,7,"SAIn",0
9,"9423",34,28,28,1,0,"SAIn",0
18,"18157",1062,793,783,9,10,"SAIn",0
18,"18168",864,613,605,4,8,"SAIn",0
36,"36011",1939,1189,1172,15,17,"SAIn",1
34,"34176",146,120,118,2,2,"SAIn",0
9,"9310",14,10,9,2,1,"SAIn",0
18,"18911",6796,4923,4867,74,56,"SAIn",2
18,"18050",1657,1209,1196,5,13,"SAIn",2
15,"15069",7019,5036,4938,85,98,"SAIn",2
9,"9446",13,9,9,0,0,"SAIn",0
47,"47140",132,109,108,1,1,"SAIn",0
29,"29075",12666,8284,8218,62,66,"SAIn",3
33,"33005",1600,1084,1080,6,4,"SAIn",1
34,"34192",103,75,74,1,1,"SAIn",0
47,"47203",69,57,56,0,1,"SAIn",1
41,"41040",9567,7305,7210,93,95,"SAIn",0
18,"18079",3497,2729,2706,15,23,"SAIn",1
28,"28093",1911,1537,1518,19,19,"SAIn",0
18,"18015",465,381,379,1,2,"SAIn",0
9,"9103",247,201,200,2,1,"SAIn",0
18,"18051",1196,857,852,4,5,"SAIn",0
47,"47170",40,30,30,0,0,"SAIn",0
9,"9356",57,38,37,1,1,"SAIn",0
34,"34205",70,55,55,1,0,"SAIn",0
34,"34147",192,139,137,1,2,"SAIn",0
31,"31143",105,62,58,2,4,"SAIn",0
18,"18022",12448,8777,8659,111,118,"SAIn",1
31,"31130",319,213,209,1,4,"SAIn",1
31,"31205",465,335,325,9,10,"SAIn",1
29,"29087",409,306,305,3,1,"SAIn",0
36,"36047",2723,1875,1853,27,22,"SAIn",0
15,"15043",5491,4033,3971,45,62,"SAIn",3
29,"29013",1718,1302,1283,4,19,"SAIn",0
23,"23080",1832,1425,1414,3,11,"SAIn",0
18,"18178",834,685,683,3,2,"SAIn",0
29,"29097",4076,3060,3018,40,42,"SAIn",3
31,"31020",488,247,246,0,1,"SAIn",1
9,"9275",202,140,139,5,1,"SAIn",1
31,"31124",209,139,138,1,1,"SAIn",1
47,"47098",607,496,492,9,4,"SAIn",0
29,"29017",6766,5162,5114,48,48,"SAIn",1
9,"9027",54,48,43,0,5,"SAIn",1
41,"41098",4650,3665,3603,43,62,"SAIn",0
31,"31162",53,35,34,1,1,"SAIn",0
28,"28037",1598,1263,1250,10,13,"SAIn",0
31,"31202",4247,3014,2957,69,57,"SAIn",3
9,"9438",547,440,433,9,7,"SAIn",1
47,"47084",1230,981,968,19,13,"SAIn",0
15,"15001",4985,3560,3506,63,54,"SAIn",1
34,"34107",91,67,67,4,0,"SAIn",0
18,"18025",326,242,238,0,4,"SAIn",0
31,"31166",274,183,182,2,1,"SAIn",0
9,"9119",51,38,38,0,0,"SAIn",0
15,"15064",2356,1859,1824,35,35,"SAIn",0
14,"14006",1326,1170,1148,12,22,"SAIn",2
47,"47190",103,87,87,7,0,"SAIn",0
18,"18150",6452,4666,4625,56,41,"SAIn",2
39,"39017",588,424,419,2,5,"SAIn",0
41,"41049",8898,6881,6812,95,69,"SAIn",2
23,"23027",763,619,616,1,3,"SAIn",0
41,"41019",4528,3194,3168,41,26,"SAIn",0
39,"39096",719,521,518,4,3,"SAIn",0
34,"34120",65774,49378,48608,830,770,"SAIn",41
29,"29035",1717,1280,1270,14,10,"SAIn",1
47,"47122",2078,1697,1665,21,32,"SAIn",0
31,"31254",1956,1495,1476,16,19,"SAIn",3
47,"47116",426,363,358,0,5,"SAIn",0
47,"47018",33,30,28,2,2,"SAIn",0
34,"34028",154,128,126,1,2,"SAIn",0
28,"28012",830,654,651,6,3,"SAIn",0
47,"47194",322,244,233,1,11,"SAIn",0
18,"18083",296,242,242,1,0,"SAIn",0
34,"34159",375,275,264,8,11,"SAIn",0
31,"31051",270,182,181,8,1,"SAIn",0
9,"9167",60,49,49,2,0,"SAIn",0
41,"41089",6394,4593,4526,57,67,"SAIn",1
18,"18154",1062,770,769,0,1,"SAIn",0
34,"34112",50,39,38,2,1,"SAIn",0
31,"31237",198,137,136,7,1,"SAIn",0
28,"28144",5663,4456,4410,47,46,"SAIn",3
9,"9211",1489,1137,1121,28,16,"SAIn",0
47,"47174",302,236,234,3,2,"SAIn",0
28,"28008",1734,1244,1221,11,23,"SAIn",2
9,"9112",115,80,80,4,0,"SAIn",0
9,"9243",87,66,64,2,2,"SAIn",0
41,"41032",4059,3122,3062,22,60,"SAIn",1
47,"47207",325,265,263,4,2,"SAIn",0
29,"29045",1750,1246,1239,6,7,"SAIn",0
47,"47168",32,29,28,1,1,"SAIn",0
9,"9409",138,105,102,0,3,"SAIn",0
9,"9301",625,510,504,11,6,"SAIn",1
28,"28171",4148,2972,2929,21,43,"SAIn",0
35,"35032",3432,2605,2548,37,57,"SAIn",0
39,"39008",13716,10396,10274,129,122,"SAIn",9
31,"31082",634,402,398,10,4,"SAIn",0
41,"41023",7901,6050,5972,45,78,"SAIn",0
34,"34093",101,74,74,1,0,"SAIn",0
41,"41011",15274,11359,11207,145,152,"SAIn",4
33,"33067",802,650,639,12,11,"SAIn",0
15,"15012",3767,2973,2926,51,47,"SAIn",2
47,"47092",123,100,99,2,1,"SAIn",0
47,"47015",229,172,170,1,2,"SAIn",0
18,"18054",879,646,644,4,2,"SAIn",0
28,"28181",20003,16133,15952,159,181,"SAIn",2
31,"31260",1263,788,780,11,8,"SAIn",3
31,"31201",144714,104019,102644,2027,1375,"SAIn",557
29,"29019",908,720,714,0,6,"SAIn",0
28,"28043",5944,4199,4147,56,52,"SAIn",0
29,"29038",16309,10579,10494,152,85,"SAIn",3
39,"39075",140941,103308,102362,1364,946,"SAIn",100
15,"15056",5873,4205,4150,63,55,"SAIn",2
18,"18086",397,321,321,3,0,"SAIn",0
28,"28071",77,57,55,0,2,"SAIn",0
9,"9431",124,102,100,2,2,"SAIn",0
47,"47135",93,77,76,0,1,"SAIn",0
18,"18038",1097,906,900,3,6,"SAIn",0
9,"9023",993,771,765,22,6,"SAIn",4
47,"47060",262,220,218,1,2,"SAIn",0
9,"9329",117,80,79,1,1,"SAIn",0
15,"15019",26096,18466,18187,350,279,"SAIn",9
29,"29022",202,142,141,2,1,"SAIn",0
29,"29057",413,311,308,2,3,"SAIn",0
36,"36044",2595,1862,1834,23,28,"SAIn",1
29,"29029",452,339,336,0,3,"SAIn",0
18,"18910",832,601,594,6,7,"SAIn",0
31,"31220",771,584,572,9,12,"SAIn",2
34,"34047",1814,1435,1413,24,22,"SAIn",0
15,"15018",1211,821,805,11,16,"SAIn",0
35,"35031",6968,4927,4862,71,65,"SAIn",1
28,"28099",1670,1258,1246,9,12,"SAIn",0
31,"31033",55,34,34,0,0,"SAIn",0
9,"9128",82,65,63,0,2,"SAIn",0
41,"41084",2875,2362,2335,9,27,"SAIn",0
29,"29062",647,573,571,1,2,"SAIn",0
41,"41069",28331,21065,20877,252,188,"SAIn",8
34,"34140",113,84,84,2,0,"SAIn",0
18,"18061",1109,882,869,1,13,"SAIn",0
34,"34018",229,184,182,3,2,"SAIn",2
29,"29093",2299,1767,1732,7,35,"SAIn",0
18,"18907",1997,1627,1612,5,15,"SAIn",0
14,"14004",2016,1560,1543,8,17,"SAIn",1
31,"31056",183,123,122,4,1,"SAIn",0
47,"47054",673,545,541,8,4,"SAIn",0
23,"23043",554,411,407,6,4,"SAIn",0
47,"47013",118,97,97,2,0,"SAIn",0
47,"47044",325,257,252,1,5,"SAIn",0
47,"47053",125,100,99,1,1,"SAIn",0
47,"47086",4062,3162,3120,37,42,"SAIn",1
28,"28019",1195,901,888,5,13,"SAIn",0
34,"34086",105,89,89,1,0,"SAIn",0
34,"34056",2147,1557,1535,21,22,"SAIn",2
31,"31168",247,165,163,0,2,"SAIn",3
47,"47046",124,105,103,0,2,"SAIn",0
18,"18158",10328,7336,7254,69,82,"SAIn",0
33,"33053",1206,817,811,6,6,"SAIn",0
9,"9472",58,46,46,0,0,"SAIn",0
9,"9114",88,75,73,0,2,"SAIn",0
9,"9057",155,125,124,0,1,"SAIn",1
23,"23058",8497,6642,6591,44,51,"SAIn",3
9,"9074",735,558,547,7,11,"SAIn",2
29,"29005",4307,2967,2951,18,16,"SAIn",0
39,"39030",1971,1397,1379,20,18,"SAIn",0
9,"9418",79,60,58,0,2,"SAIn",0
31,"31097",10461,7152,7029,129,123,"SAIn",25
23,"23079",3750,3084,3063,19,21,"SAIn",2
47,"47027",2680,2059,2024,23,35,"SAIn",1
9,"9251",417,292,288,3,4,"SAIn",3
31,"31160",111,93,93,7,0,"SAIn",0
31,"31006",1988,1434,1395,22,39,"SAIn",1
9,"9149",37,25,25,0,0,"SAIn",0
9,"9365",38,27,27,0,0,"SAIn",0
31,"31127",145,89,89,2,0,"SAIn",0
36,"36901",4085,3285,3235,21,50,"SAIn",1
29,"29081",290,226,226,3,0,"SAIn",0
47,"47137",27,22,22,2,0,"SAIn",0
41,"41002",1510,1161,1140,4,21,"SAIn",0
36,"36014",2145,1568,1548,9,20,"SAIn",0
31,"31210",219,169,167,3,2,"SAIn",3
31,"31219",93,75,73,1,2,"SAIn",0
31,"31119",49,28,28,0,0,"SAIn",1
31,"31265",81,52,50,0,2,"SAIn",0
33,"33068",1224,704,703,5,1,"SAIn",0
36,"36040",2627,1938,1907,24,31,"SAIn",3
9,"9019",153,104,104,1,0,"SAIn",0
9,"9387",121,92,91,3,1,"SAIn",1
41,"41094",6089,4757,4680,47,77,"SAIn",2
47,"47112",2671,2231,2198,28,33,"SAIn",0
23,"23903",3537,2892,2877,12,15,"SAIn",0
9,"9378",42,26,26,0,0,"SAIn",0
31,"31188",185,139,137,2,2,"SAIn",0
33,"33021",4932,3544,3502,45,42,"SAIn",3
31,"31167",859,600,593,11,7,"SAIn",1
34,"34091",136,105,103,1,2,"SAIn",1
47,"47035",956,778,768,5,10,"SAIn",0
23,"23905",1884,1447,1438,4,9,"SAIn",0
9,"9122",93,71,71,4,0,"SAIn",0
28,"28117",116,90,90,1,0,"SAIn",0
35,"35019",30279,17607,17380,158,227,"SAIn",12
41,"41079",9349,7095,7001,71,94,"SAIn",7
29,"29033",1385,878,868,4,10,"SAIn",0
9,"9139",104,84,80,3,4,"SAIn",0
39,"39082",1688,1280,1266,9,14,"SAIn",0
29,"29079",2500,2016,2000,23,16,"SAIn",0
15,"15066",4180,3098,3062,38,36,"SAIn",0
29,"29071",915,601,598,4,3,"SAIn",0
15,"15037",4181,2839,2804,25,35,"SAIn",0
34,"34011",406,327,327,4,0,"SAIn",0
31,"31087",163,122,121,3,1,"SAIn",0
31,"31198",38,33,33,0,0,"SAIn",0
31,"31179",558,384,384,3,0,"SAIn",0
34,"34029",832,696,683,11,13,"SAIn",0
29,"29016",272,180,179,5,1,"SAIn",0
9,"9360",37,29,29,0,0,"SAIn",0
28,"28182",219,179,178,2,1,"SAIn",0
47,"47231",4272,3268,3243,64,25,"SAIn",2
35,"35017",22331,13463,13144,217,319,"UNIDAD DEL PUEBLO",12
35,"35014",9943,5438,5316,95,122,"UNIDAD DEL PUEBLO",4
35,"35003",4764,2733,2680,34,53,"UNIDAD DEL PUEBLO",2
35,"35011",23140,15550,15320,199,230,"UNIDAD DEL PUEBLO",36
35,"35015",9065,4859,4770,64,89,"UNIDAD DEL PUEBLO",11
35,"35032",3432,2605,2548,37,57,"UNIDAD DEL PUEBLO",3
35,"35020",6142,4227,4192,24,35,"UNIDAD DEL PUEBLO",2
35,"35007",569,392,391,2,1,"UNIDAD DEL PUEBLO",0
35,"35008",6151,4514,4419,59,95,"UNIDAD DEL PUEBLO",4
35,"35005",1170,864,853,7,11,"UNIDAD DEL PUEBLO",3
35,"35009",19678,13799,13442,155,357,"UNIDAD DEL PUEBLO",19
35,"35031",6968,4927,4862,71,65,"UNIDAD DEL PUEBLO",7
35,"35024",12420,6978,6819,131,159,"UNIDAD DEL PUEBLO",5
35,"35012",9662,5511,5446,45,65,"UNIDAD DEL PUEBLO",9
35,"35021",14982,9948,9749,138,199,"UNIDAD DEL PUEBLO",42
35,"35002",21673,14480,14253,172,227,"UNIDAD DEL PUEBLO",25
35,"35013",6779,5059,4961,105,98,"UNIDAD DEL PUEBLO",5
35,"35033",6415,4394,4302,51,92,"UNIDAD DEL PUEBLO",8
35,"35029",3981,2341,2315,43,26,"UNIDAD DEL PUEBLO",3
35,"35018",11652,6488,6367,107,121,"UNIDAD DEL PUEBLO",5
35,"35022",43892,27289,26876,326,413,"UNIDAD DEL PUEBLO",183
35,"35034",6372,2951,2921,33,30,"UNIDAD DEL PUEBLO",6
35,"35030",8295,5433,5315,54,118,"UNIDAD DEL PUEBLO",6
35,"35027",10510,7523,7375,88,148,"UNIDAD DEL PUEBLO",11
35,"35019",30279,17607,17380,158,227,"UNIDAD DEL PUEBLO",49
35,"35010",3565,2178,2135,26,43,"UNIDAD DEL PUEBLO",3
35,"35016",291589,181013,177964,2856,3049,"UNIDAD DEL PUEBLO",451
35,"35006",29515,20731,20286,362,445,"UNIDAD DEL PUEBLO",66
35,"35026",78933,49860,48955,780,905,"UNIDAD DEL PUEBLO",105
35,"35001",4663,3639,3569,39,70,"UNIDAD DEL PUEBLO",5
35,"35028",8810,4687,4603,71,84,"UNIDAD DEL PUEBLO",4
35,"35004",35462,18498,18196,325,302,"UNIDAD DEL PUEBLO",21
35,"35025",1941,1345,1328,12,17,"UNIDAD DEL PUEBLO",1
35,"35023",11640,8412,8178,97,234,"UNIDAD DEL PUEBLO",14
47,"47052",6207,4812,4761,79,51,"U.R.C.L.",14
47,"47086",4062,3162,3120,37,42,"U.R.C.L.",0
47,"47135",93,77,76,0,1,"U.R.C.L.",0
47,"47041",166,135,133,2,2,"U.R.C.L.",0
34,"34058",212,179,178,0,1,"U.R.C.L.",0
34,"34071",186,160,160,1,0,"U.R.C.L.",0
47,"47207",325,265,263,4,2,"U.R.C.L.",1
47,"47035",956,778,768,5,10,"U.R.C.L.",0
34,"34024",27,18,17,1,1,"U.R.C.L.",0
47,"47026",59,46,46,1,0,"U.R.C.L.",0
34,"34112",50,39,38,2,1,"U.R.C.L.",0
34,"34217",1089,866,849,19,17,"U.R.C.L.",1
47,"47059",108,77,76,1,1,"U.R.C.L.",0
47,"47143",146,108,107,0,1,"U.R.C.L.",1
34,"34184",54,37,36,0,1,"U.R.C.L.",0
34,"34227",84,69,67,3,2,"U.R.C.L.",0
34,"34140",113,84,84,2,0,"U.R.C.L.",0
47,"47044",325,257,252,1,5,"U.R.C.L.",1
34,"34028",154,128,126,1,2,"U.R.C.L.",1
34,"34155",142,118,117,3,1,"U.R.C.L.",1
47,"47130",105,86,85,2,1,"U.R.C.L.",0
34,"34190",59,42,42,4,0,"U.R.C.L.",0
34,"34068",32,23,23,0,0,"U.R.C.L.",0
34,"34902",146,121,121,1,0,"U.R.C.L.",0
34,"34082",96,79,75,0,4,"U.R.C.L.",0
34,"34116",76,50,49,1,1,"U.R.C.L.",0
34,"34234",72,56,55,1,1,"U.R.C.L.",0
47,"47209",43,33,33,0,0,"U.R.C.L.",0
47,"47099",174,153,153,4,0,"U.R.C.L.",1
34,"34175",101,80,80,2,0,"U.R.C.L.",0
47,"47128",57,52,48,1,4,"U.R.C.L.",0
34,"34091",136,105,103,1,2,"U.R.C.L.",0
34,"34204",53,45,44,0,1,"U.R.C.L.",0
34,"34081",53,42,41,0,1,"U.R.C.L.",1
47,"47204",275,221,219,3,2,"U.R.C.L.",0
47,"47194",322,244,233,1,11,"U.R.C.L.",0
34,"34051",112,92,91,7,1,"U.R.C.L.",1
34,"34010",560,458,451,7,7,"U.R.C.L.",0
47,"47053",125,100,99,1,1,"U.R.C.L.",0
34,"34196",94,74,73,1,1,"U.R.C.L.",0
47,"47196",43,29,29,0,0,"U.R.C.L.",0
47,"47097",345,291,289,7,2,"U.R.C.L.",2
34,"34113",35,28,27,0,1,"U.R.C.L.",0
47,"47034",90,65,63,0,2,"U.R.C.L.",0
34,"34084",142,124,122,3,2,"U.R.C.L.",0
34,"34240",102,84,83,1,1,"U.R.C.L.",0
34,"34159",375,275,264,8,11,"U.R.C.L.",1
47,"47009",117,88,88,1,0,"U.R.C.L.",0
34,"34230",12,8,8,0,0,"U.R.C.L.",0
34,"34076",632,524,520,13,4,"U.R.C.L.",0
34,"34089",173,128,125,5,3,"U.R.C.L.",0
34,"34104",274,224,224,4,0,"U.R.C.L.",0
34,"34025",54,42,42,0,0,"U.R.C.L.",0
34,"34017",960,772,760,15,12,"U.R.C.L.",1
34,"34236",176,134,134,1,0,"U.R.C.L.",0
47,"47083",80,61,59,3,2,"U.R.C.L.",0
34,"34165",86,67,67,0,0,"U.R.C.L.",0
34,"34120",65774,49378,48608,830,770,"U.R.C.L.",75
47,"47080",45,39,39,1,0,"U.R.C.L.",0
34,"34222",122,94,94,2,0,"U.R.C.L.",0
47,"47177",112,83,79,1,4,"U.R.C.L.",1
34,"34903",240,161,160,2,1,"U.R.C.L.",0
47,"47200",91,73,73,0,0,"U.R.C.L.",0
47,"47216",124,99,98,2,1,"U.R.C.L.",1
34,"34904",355,247,241,3,6,"U.R.C.L.",0
34,"34127",118,77,74,1,3,"U.R.C.L.",0
34,"34141",190,162,160,0,2,"U.R.C.L.",0
47,"47091",97,82,80,3,2,"U.R.C.L.",0
47,"47147",129,96,96,0,0,"U.R.C.L.",0
34,"34206",952,796,780,9,16,"U.R.C.L.",1
34,"34048",72,58,56,3,2,"U.R.C.L.",0
34,"34094",64,47,44,1,3,"U.R.C.L.",0
47,"47183",150,125,122,0,3,"U.R.C.L.",0
47,"47145",658,482,473,7,9,"U.R.C.L.",0
47,"47164",391,326,320,3,6,"U.R.C.L.",0
47,"47119",101,78,77,0,1,"U.R.C.L.",0
47,"47007",3453,2616,2580,42,36,"U.R.C.L.",14
34,"34131",67,57,56,0,1,"U.R.C.L.",0
34,"34169",431,331,329,5,2,"U.R.C.L.",0
34,"34108",561,477,465,6,12,"U.R.C.L.",1
47,"47123",456,356,353,10,3,"U.R.C.L.",1
34,"34130",228,187,186,6,1,"U.R.C.L.",0
34,"34210",103,93,91,2,2,"U.R.C.L.",0
47,"47199",84,61,60,1,1,"U.R.C.L.",0
34,"34243",352,274,273,5,1,"U.R.C.L.",3
47,"47170",40,30,30,0,0,"U.R.C.L.",1
34,"34073",184,153,152,7,1,"U.R.C.L.",0
47,"47013",118,97,97,2,0,"U.R.C.L.",0
34,"34151",184,125,123,1,2,"U.R.C.L.",0
34,"34132",128,103,102,2,1,"U.R.C.L.",0
34,"34006",82,72,72,1,0,"U.R.C.L.",0
47,"47133",2382,1861,1841,30,20,"U.R.C.L.",0
34,"34020",63,44,44,0,0,"U.R.C.L.",0
34,"34237",645,506,498,6,8,"U.R.C.L.",0
47,"47180",96,82,81,0,1,"U.R.C.L.",1
47,"47121",590,495,490,4,5,"U.R.C.L.",0
34,"34223",233,175,175,2,0,"U.R.C.L.",1
47,"47174",302,236,234,3,2,"U.R.C.L.",1
47,"47140",132,109,108,1,1,"U.R.C.L.",2
47,"47152",94,65,65,0,0,"U.R.C.L.",0
47,"47058",199,157,157,3,0,"U.R.C.L.",0
34,"34009",34,31,31,3,0,"U.R.C.L.",1
47,"47085",16967,12618,12472,208,146,"U.R.C.L.",27
47,"47182",1371,991,982,12,9,"U.R.C.L.",0
47,"47215",60,52,52,2,0,"U.R.C.L.",0
47,"47031",203,149,149,0,0,"U.R.C.L.",0
47,"47011",600,493,489,4,4,"U.R.C.L.",0
34,"34046",45,35,34,0,1,"U.R.C.L.",1
47,"47173",862,683,675,5,8,"U.R.C.L.",0
34,"34099",56,49,47,1,2,"U.R.C.L.",0
47,"47187",101,82,81,1,1,"U.R.C.L.",1
34,"34018",229,184,182,3,2,"U.R.C.L.",1
47,"47030",1075,822,801,13,21,"U.R.C.L.",0
47,"47021",84,61,61,2,0,"U.R.C.L.",0
47,"47169",70,57,57,0,0,"U.R.C.L.",0
47,"47092",123,100,99,2,1,"U.R.C.L.",0
34,"34157",2471,1936,1912,26,24,"U.R.C.L.",10
34,"34136",192,122,122,1,0,"U.R.C.L.",0
47,"47067",198,159,156,5,3,"U.R.C.L.",0
47,"47094",154,129,127,0,2,"U.R.C.L.",0
47,"47061",266,227,223,0,4,"U.R.C.L.",0
47,"47176",229,157,157,0,0,"U.R.C.L.",0
34,"34182",860,657,649,8,8,"U.R.C.L.",0
47,"47114",4107,2877,2834,37,43,"U.R.C.L.",1
47,"47103",277,218,214,1,4,"U.R.C.L.",3
34,"34062",175,126,124,3,2,"U.R.C.L.",0
34,"34147",192,139,137,1,2,"U.R.C.L.",0
34,"34123",1798,1479,1436,18,43,"U.R.C.L.",2
34,"34177",170,147,143,2,4,"U.R.C.L.",1
34,"34041",100,79,78,1,1,"U.R.C.L.",0
47,"47160",466,368,364,5,4,"U.R.C.L.",1
34,"34241",20,12,11,0,1,"U.R.C.L.",0
47,"47054",673,545,541,8,4,"U.R.C.L.",0
47,"47154",168,144,144,7,0,"U.R.C.L.",0
34,"34045",84,75,74,1,1,"U.R.C.L.",0
47,"47098",607,496,492,9,4,"U.R.C.L.",2
34,"34224",53,42,41,0,1,"U.R.C.L.",0
47,"47057",237,198,198,3,0,"U.R.C.L.",0
47,"47065",898,762,752,9,10,"U.R.C.L.",0
47,"47111",1005,804,794,5,10,"U.R.C.L.",0
47,"47088",121,100,100,0,0,"U.R.C.L.",0
47,"47116",426,363,358,0,5,"U.R.C.L.",0
34,"34199",1354,1004,978,27,26,"U.R.C.L.",1
34,"34185",72,48,45,0,3,"U.R.C.L.",0
34,"34233",158,128,128,3,0,"U.R.C.L.",0
34,"34171",1071,762,753,16,9,"U.R.C.L.",0
47,"47218",983,776,767,7,9,"U.R.C.L.",0
47,"47093",865,658,642,11,16,"U.R.C.L.",0
47,"47037",194,160,159,1,1,"U.R.C.L.",0
34,"34168",60,56,56,0,0,"U.R.C.L.",0
47,"47155",3043,2246,2225,35,21,"U.R.C.L.",2
47,"47076",16922,13030,12899,212,131,"U.R.C.L.",20
47,"47079",67,56,56,1,0,"U.R.C.L.",0
47,"47219",46,36,36,1,0,"U.R.C.L.",0
34,"34087",108,88,87,1,1,"U.R.C.L.",0
47,"47028",31,21,20,0,1,"U.R.C.L.",0
34,"34050",216,170,166,1,4,"U.R.C.L.",0
47,"47074",155,125,124,0,1,"U.R.C.L.",2
47,"47153",135,94,93,1,1,"U.R.C.L.",0
47,"47162",80,62,62,1,0,"U.R.C.L.",0
47,"47150",338,273,271,2,2,"U.R.C.L.",0
47,"47185",97,76,75,1,1,"U.R.C.L.",0
47,"47012",134,105,105,0,0,"U.R.C.L.",0
34,"34003",167,132,130,7,2,"U.R.C.L.",0
34,"34100",141,105,105,1,0,"U.R.C.L.",0
47,"47077",291,232,232,1,0,"U.R.C.L.",0
47,"47144",85,65,65,2,0,"U.R.C.L.",0
47,"47002",30,27,27,1,0,"U.R.C.L.",0
47,"47167",258,230,229,3,1,"U.R.C.L.",1
47,"47211",45,38,38,1,0,"U.R.C.L.",0
34,"34114",240,171,171,0,0,"U.R.C.L.",0
47,"47205",414,307,298,5,9,"U.R.C.L.",0
47,"47142",172,132,131,2,1,"U.R.C.L.",0
47,"47137",27,22,22,2,0,"U.R.C.L.",0
34,"34110",96,83,81,2,2,"U.R.C.L.",0
47,"47019",93,69,68,0,1,"U.R.C.L.",0
47,"47163",315,253,250,2,3,"U.R.C.L.",2
47,"47220",194,143,142,4,1,"U.R.C.L.",0
34,"34246",78,64,64,0,0,"U.R.C.L.",0
47,"47191",113,81,80,1,1,"U.R.C.L.",0
34,"34181",471,350,346,7,4,"U.R.C.L.",0
34,"34060",150,123,123,2,0,"U.R.C.L.",0
34,"34221",190,143,143,3,0,"U.R.C.L.",1
34,"34038",284,228,225,9,3,"U.R.C.L.",0
47,"47229",235,161,161,1,0,"U.R.C.L.",0
34,"34146",60,42,40,1,2,"U.R.C.L.",0
34,"34001",36,29,29,2,0,"U.R.C.L.",0
34,"34049",421,313,311,4,2,"U.R.C.L.",0
47,"47046",124,105,103,0,2,"U.R.C.L.",0
47,"47055",212,169,168,3,1,"U.R.C.L.",0
47,"47014",55,47,47,0,0,"U.R.C.L.",0
47,"47017",205,177,176,1,1,"U.R.C.L.",0
34,"34225",4837,3650,3580,73,70,"U.R.C.L.",7
47,"47004",1261,1047,1031,11,16,"U.R.C.L.",0
34,"34167",124,105,105,0,0,"U.R.C.L.",0
34,"34124",70,55,55,1,0,"U.R.C.L.",0
34,"34055",288,215,212,4,3,"U.R.C.L.",0
47,"47032",161,130,129,3,1,"U.R.C.L.",1
47,"47141",148,121,119,1,2,"U.R.C.L.",1
47,"47113",166,136,135,1,1,"U.R.C.L.",0
34,"34103",105,92,92,5,0,"U.R.C.L.",0
34,"34220",145,125,123,0,2,"U.R.C.L.",0
47,"47168",32,29,28,1,1,"U.R.C.L.",0
34,"34063",102,92,91,2,1,"U.R.C.L.",1
47,"47015",229,172,170,1,2,"U.R.C.L.",0
47,"47056",90,69,69,2,0,"U.R.C.L.",0
34,"34022",1136,926,908,5,18,"U.R.C.L.",1
47,"47023",2863,2278,2258,38,20,"U.R.C.L.",1
47,"47165",7036,5328,5258,67,70,"U.R.C.L.",10
47,"47047",217,171,170,5,1,"U.R.C.L.",0
47,"47124",435,364,358,5,6,"U.R.C.L.",1
34,"34034",129,104,104,1,0,"U.R.C.L.",0
34,"34052",187,147,147,1,0,"U.R.C.L.",0
34,"34133",108,90,90,0,0,"U.R.C.L.",0
34,"34154",78,62,62,0,0,"U.R.C.L.",0
34,"34083",1888,1355,1338,15,17,"U.R.C.L.",1
47,"47127",150,110,108,0,2,"U.R.C.L.",1
34,"34134",61,49,47,0,2,"U.R.C.L.",0
34,"34102",226,187,185,3,2,"U.R.C.L.",0
47,"47213",122,99,99,1,0,"U.R.C.L.",0
47,"47159",862,704,695,20,9,"U.R.C.L.",4
34,"34135",429,334,329,6,5,"U.R.C.L.",0
34,"34180",84,68,68,0,0,"U.R.C.L.",0
47,"47181",170,128,128,1,0,"U.R.C.L.",0
34,"34901",1233,955,946,14,9,"U.R.C.L.",2
34,"34070",182,138,137,1,1,"U.R.C.L.",0
47,"47221",115,102,102,0,0,"U.R.C.L.",0
47,"47070",33,30,30,1,0,"U.R.C.L.",1
47,"47122",2078,1697,1665,21,32,"U.R.C.L.",1
34,"34061",116,78,78,2,0,"U.R.C.L.",0
34,"34067",142,88,88,3,0,"U.R.C.L.",0
47,"47063",107,87,87,2,0,"U.R.C.L.",0
47,"47125",55,46,46,0,0,"U.R.C.L.",0
34,"34053",222,177,172,4,5,"U.R.C.L.",1
34,"34036",211,159,157,0,2,"U.R.C.L.",0
34,"34161",23,20,20,0,0,"U.R.C.L.",0
47,"47230",318,266,259,2,7,"U.R.C.L.",0
34,"34012",368,277,275,9,2,"U.R.C.L.",0
47,"47110",471,386,378,6,8,"U.R.C.L.",0
34,"34086",105,89,89,1,0,"U.R.C.L.",1
34,"34228",93,80,80,0,0,"U.R.C.L.",0
34,"34179",32,21,21,0,0,"U.R.C.L.",0
34,"34149",26,18,18,0,0,"U.R.C.L.",0
34,"34158",336,202,200,0,2,"U.R.C.L.",0
34,"34059",462,377,375,5,2,"U.R.C.L.",0
34,"34077",283,219,216,3,3,"U.R.C.L.",0
34,"34069",2330,1769,1749,25,20,"U.R.C.L.",1
47,"47188",125,112,109,3,3,"U.R.C.L.",0
47,"47214",1517,1215,1191,34,24,"U.R.C.L.",2
47,"47050",3557,2688,2651,50,37,"U.R.C.L.",6
34,"34056",2147,1557,1535,21,22,"U.R.C.L.",1
47,"47222",92,77,77,4,0,"U.R.C.L.",0
34,"34232",802,632,623,9,9,"U.R.C.L.",1
34,"34238",348,289,287,4,2,"U.R.C.L.",0
47,"47020",283,237,232,5,5,"U.R.C.L.",0
47,"47217",1812,1395,1377,20,18,"U.R.C.L.",1
34,"34029",832,696,683,11,13,"U.R.C.L.",1
47,"47089",184,139,138,1,1,"U.R.C.L.",0
34,"34229",75,60,60,2,0,"U.R.C.L.",0
34,"34170",72,56,56,1,0,"U.R.C.L.",0
47,"47025",127,103,103,0,0,"U.R.C.L.",0
47,"47042",63,50,49,3,1,"U.R.C.L.",0
47,"47158",906,716,710,10,6,"U.R.C.L.",0
47,"47048",204,168,167,2,1,"U.R.C.L.",0
47,"47075",4999,4020,3957,39,63,"U.R.C.L.",9
47,"47192",99,84,84,0,0,"U.R.C.L.",0
34,"34023",5318,3947,3891,64,56,"U.R.C.L.",5
47,"47102",302,250,248,3,2,"U.R.C.L.",0
34,"34176",146,120,118,2,2,"U.R.C.L.",0
47,"47206",111,99,99,0,0,"U.R.C.L.",0
47,"47172",149,125,124,3,1,"U.R.C.L.",0
34,"34192",103,75,74,1,1,"U.R.C.L.",0
47,"47090",2511,1907,1880,23,27,"U.R.C.L.",1
47,"47175",6562,5041,4957,62,84,"U.R.C.L.",8
47,"47043",330,267,264,1,3,"U.R.C.L.",9
34,"34093",101,74,74,1,0,"U.R.C.L.",0
34,"34213",67,50,50,0,0,"U.R.C.L.",0
47,"47049",94,71,71,1,0,"U.R.C.L.",0
47,"47193",1538,1229,1211,23,18,"U.R.C.L.",0
47,"47151",32,29,29,0,0,"U.R.C.L.",0
34,"34042",299,249,246,5,3,"U.R.C.L.",0
34,"34178",106,93,93,1,0,"U.R.C.L.",0
47,"47082",816,664,661,10,3,"U.R.C.L.",5
47,"47210",396,324,321,5,3,"U.R.C.L.",0
47,"47132",45,40,40,0,0,"U.R.C.L.",0
47,"47139",1080,845,833,11,12,"U.R.C.L.",3
34,"34072",189,169,166,2,3,"U.R.C.L.",0
47,"47171",453,371,368,10,3,"U.R.C.L.",0
47,"47038",128,91,91,0,0,"U.R.C.L.",4
34,"34101",54,44,44,0,0,"U.R.C.L.",0
47,"47157",544,462,458,9,4,"U.R.C.L.",0
47,"47010",11275,8800,8701,163,99,"U.R.C.L.",22
47,"47073",141,118,116,1,2,"U.R.C.L.",0
34,"34031",29,26,26,0,0,"U.R.C.L.",0
47,"47112",2671,2231,2198,28,33,"U.R.C.L.",3
47,"47106",63,52,52,0,0,"U.R.C.L.",0
47,"47071",406,333,329,6,4,"U.R.C.L.",3
34,"34139",179,143,143,1,0,"U.R.C.L.",1
47,"47068",41,28,28,0,0,"U.R.C.L.",0
47,"47166",276,226,223,0,3,"U.R.C.L.",0
47,"47115",306,248,248,2,0,"U.R.C.L.",2
47,"47118",159,122,122,2,0,"U.R.C.L.",0
47,"47051",351,269,256,5,13,"U.R.C.L.",1
34,"34216",65,50,50,1,0,"U.R.C.L.",0
47,"47078",178,159,154,7,5,"U.R.C.L.",0
47,"47105",210,181,179,1,2,"U.R.C.L.",0
34,"34218",486,366,365,3,1,"U.R.C.L.",0
47,"47231",4272,3268,3243,64,25,"U.R.C.L.",2
47,"47060",262,220,218,1,2,"U.R.C.L.",0
34,"34005",899,707,698,8,9,"U.R.C.L.",0
47,"47184",575,447,443,6,4,"U.R.C.L.",0
34,"34080",6066,4238,4169,57,69,"U.R.C.L.",4
47,"47178",190,162,161,1,1,"U.R.C.L.",0
47,"47134",186,155,149,2,6,"U.R.C.L.",0
47,"47149",44,22,20,0,2,"U.R.C.L.",0
47,"47066",1114,891,888,10,3,"U.R.C.L.",0
47,"47024",283,211,210,1,1,"U.R.C.L.",0
47,"47179",408,315,306,6,9,"U.R.C.L.",0
47,"47033",209,170,168,3,2,"U.R.C.L.",1
34,"34035",122,98,96,0,2,"U.R.C.L.",0
34,"34088",219,179,177,4,2,"U.R.C.L.",0
34,"34109",62,47,46,0,1,"U.R.C.L.",0
47,"47203",69,57,56,0,1,"U.R.C.L.",0
47,"47018",33,30,28,2,2,"U.R.C.L.",0
47,"47029",61,54,53,0,1,"U.R.C.L.",1
34,"34163",61,56,56,1,0,"U.R.C.L.",0
34,"34208",62,52,52,2,0,"U.R.C.L.",0
47,"47129",954,744,731,4,13,"U.R.C.L.",2
34,"34121",208,153,152,0,1,"U.R.C.L.",0
47,"47104",2917,2391,2357,31,34,"U.R.C.L.",5
47,"47095",41,36,36,3,0,"U.R.C.L.",0
34,"34098",756,544,540,10,4,"U.R.C.L.",3
47,"47006",196,151,146,1,5,"U.R.C.L.",0
34,"34215",166,146,145,1,1,"U.R.C.L.",1
47,"47005",578,467,455,5,12,"U.R.C.L.",3
34,"34074",764,610,597,11,13,"U.R.C.L.",0
34,"34039",66,57,56,0,1,"U.R.C.L.",0
47,"47081",57,44,44,1,0,"U.R.C.L.",0
47,"47198",71,56,56,2,0,"U.R.C.L.",0
47,"47195",449,350,346,5,4,"U.R.C.L.",0
34,"34092",331,272,267,6,5,"U.R.C.L.",0
47,"47022",62,54,54,0,0,"U.R.C.L.",0
47,"47040",67,51,50,0,1,"U.R.C.L.",0
34,"34032",47,36,36,1,0,"U.R.C.L.",0
47,"47131",189,145,145,4,0,"U.R.C.L.",0
34,"34096",56,41,39,1,2,"U.R.C.L.",0
47,"47208",56,45,43,1,2,"U.R.C.L.",0
34,"34137",31,24,24,3,0,"U.R.C.L.",0
34,"34122",80,65,62,2,3,"U.R.C.L.",0
34,"34027",1224,875,861,14,14,"U.R.C.L.",1
47,"47161",3886,3133,3105,45,28,"U.R.C.L.",1
34,"34202",28,21,21,0,0,"U.R.C.L.",0
47,"47232",107,77,75,1,2,"U.R.C.L.",0
34,"34015",45,40,40,0,0,"U.R.C.L.",0
47,"47008",26,17,17,0,0,"U.R.C.L.",0
47,"47027",2680,2059,2024,23,35,"U.R.C.L.",4
47,"47062",185,153,153,5,0,"U.R.C.L.",0
47,"47003",263,224,222,1,2,"U.R.C.L.",0
34,"34160",154,119,116,0,3,"U.R.C.L.",0
34,"34143",181,142,140,3,2,"U.R.C.L.",0
47,"47189",164,134,134,1,0,"U.R.C.L.",0
47,"47226",180,152,148,1,4,"U.R.C.L.",1
34,"34214",176,144,143,3,1,"U.R.C.L.",3
34,"34189",59,47,47,3,0,"U.R.C.L.",0
34,"34019",139,108,108,5,0,"U.R.C.L.",0
34,"34231",273,209,206,2,3,"U.R.C.L.",0
47,"47101",1740,1458,1444,12,14,"U.R.C.L.",0
34,"34047",1814,1435,1413,24,22,"U.R.C.L.",2
34,"34156",56,48,48,2,0,"U.R.C.L.",0
47,"47109",183,151,151,4,0,"U.R.C.L.",0
34,"34205",70,55,55,1,0,"U.R.C.L.",0
47,"47117",306,231,228,4,3,"U.R.C.L.",3
34,"34057",483,365,357,2,8,"U.R.C.L.",9
34,"34107",91,67,67,4,0,"U.R.C.L.",0
47,"47223",172,147,147,6,0,"U.R.C.L.",1
34,"34129",191,144,142,0,2,"U.R.C.L.",0
47,"47016",94,77,77,1,0,"U.R.C.L.",0
34,"34037",345,256,253,4,3,"U.R.C.L.",0
34,"34004",5790,4354,4262,84,92,"U.R.C.L.",10
47,"47224",92,77,77,0,0,"U.R.C.L.",0
47,"47146",236,196,195,4,1,"U.R.C.L.",0
34,"34011",406,327,327,4,0,"U.R.C.L.",1
47,"47096",139,109,107,0,2,"U.R.C.L.",0
34,"34186",61,53,53,0,0,"U.R.C.L.",0
34,"34201",212,178,172,1,6,"U.R.C.L.",0
47,"47186",251279,193705,191693,2746,2012,"U.R.C.L.",296
47,"47228",481,385,383,3,2,"U.R.C.L.",0
47,"47212",386,327,325,1,2,"U.R.C.L.",0
47,"47084",1230,981,968,19,13,"U.R.C.L.",4
47,"47156",182,155,148,0,7,"U.R.C.L.",0
47,"47039",196,163,163,1,0,"U.R.C.L.",0
47,"47225",89,67,66,0,1,"U.R.C.L.",0
47,"47001",51,44,42,2,2,"U.R.C.L.",0
34,"34242",97,81,79,6,2,"U.R.C.L.",0
47,"47227",62,52,52,1,0,"U.R.C.L.",0
47,"47036",257,212,212,1,0,"U.R.C.L.",0
47,"47148",475,389,384,2,5,"U.R.C.L.",1
34,"34211",202,175,170,1,5,"U.R.C.L.",0
47,"47064",30,21,21,1,0,"U.R.C.L.",0
34,"34125",99,77,75,1,2,"U.R.C.L.",0
47,"47126",49,43,42,1,1,"U.R.C.L.",0
47,"47069",128,108,108,0,0,"U.R.C.L.",0
47,"47045",839,636,632,3,4,"U.R.C.L.",2
34,"34079",1391,1088,1077,17,11,"U.R.C.L.",2
34,"34033",17,15,15,0,0,"U.R.C.L.",0
34,"34106",121,100,99,2,1,"U.R.C.L.",2
34,"34174",213,179,178,4,1,"U.R.C.L.",0
34,"34152",142,114,109,1,5,"U.R.C.L.",2
47,"47197",932,739,730,15,9,"U.R.C.L.",0
47,"47190",103,87,87,7,0,"U.R.C.L.",0
34,"34066",66,55,54,0,1,"U.R.C.L.",0
34,"34126",284,226,224,3,2,"U.R.C.L.",1
34,"34245",322,240,236,3,4,"U.R.C.L.",0
47,"47087",376,320,315,7,5,"U.R.C.L.",0
47,"47100",169,146,144,1,2,"U.R.C.L.",0
47,"47138",259,198,195,3,3,"U.R.C.L.",0
44,"44209",892,666,649,6,17,"U.C.E.",0
46,"46079",381,304,299,3,5,"U.C.E.",0
19,"19027",185,140,138,1,2,"U.C.E.",0
22,"22029",130,99,98,6,1,"U.C.E.",0
47,"47140",132,109,108,1,1,"U.C.E.",0
19,"19241",45,37,37,2,0,"U.C.E.",0
19,"19003",50,36,35,1,1,"U.C.E.",0
31,"31186",299,205,200,3,5,"U.C.E.",1
24,"24044",176,138,136,2,2,"U.C.E.",0
24,"24102",701,536,530,3,6,"U.C.E.",0
31,"31152",1406,1003,975,23,28,"U.C.E.",0
50,"50101",922,648,637,8,11,"U.C.E.",0
26,"26167",66,51,51,2,0,"U.C.E.",0
1,"1046",629,428,421,5,7,"U.C.E.",3
7,"7002",6305,4188,4073,80,115,"U.C.E.",4
22,"22039",920,721,710,12,11,"U.C.E.",0
31,"31081",335,249,243,8,6,"U.C.E.",0
37,"37184",381,295,289,5,6,"U.C.E.",0
50,"50061",228,191,183,3,8,"U.C.E.",0
18,"18036",3553,2762,2741,20,21,"U.C.E.",2
46,"46237",7261,5405,5350,54,55,"U.C.E.",4
19,"19154",79,68,67,0,1,"U.C.E.",0
19,"19116",16,10,10,0,0,"U.C.E.",0
5,"5041",1051,840,827,13,13,"U.C.E.",0
23,"23044",4897,3943,3893,13,50,"U.C.E.",2
34,"34186",61,53,53,0,0,"U.C.E.",0
50,"50207",126,97,95,1,2,"U.C.E.",0
23,"23014",2529,2058,2039,13,19,"U.C.E.",0
7,"7015",20783,12244,12016,381,228,"U.C.E.",11
47,"47153",135,94,93,1,1,"U.C.E.",0
46,"46025",2495,1962,1941,24,21,"U.C.E.",0
19,"19185",40,21,19,0,2,"U.C.E.",0
8,"8163",17986,11683,11548,159,135,"U.C.E.",26
3,"3086",145,119,118,1,1,"U.C.E.",0
5,"5077",205,164,160,2,4,"U.C.E.",0
34,"34106",121,100,99,2,1,"U.C.E.",0
10,"10067",10392,7979,7804,111,175,"U.C.E.",11
30,"30006",823,719,711,5,8,"U.C.E.",0
42,"42171",158,99,94,3,5,"U.C.E.",1
18,"18175",11534,8772,8698,68,74,"U.C.E.",2
31,"31034",43,29,29,0,0,"U.C.E.",0
10,"10020",1671,1386,1374,14,12,"U.C.E.",1
26,"26155",173,134,134,1,0,"U.C.E.",0
15,"15037",4181,2839,2804,25,35,"U.C.E.",0
41,"41901",2626,2190,2167,24,23,"U.C.E.",0
34,"34241",20,12,11,0,1,"U.C.E.",0
8,"8148",2240,1246,1223,22,23,"U.C.E.",1
26,"26143",187,154,151,4,3,"U.C.E.",0
19,"19242",112,93,92,1,1,"U.C.E.",1
23,"23901",1194,1048,1045,8,3,"U.C.E.",0
39,"39027",3213,2506,2473,21,33,"U.C.E.",1
46,"46010",927,706,699,3,7,"U.C.E.",0
19,"19151",1126,849,830,3,19,"U.C.E.",0
15,"15040",2891,2160,2129,18,31,"U.C.E.",1
34,"34137",31,24,24,3,0,"U.C.E.",0
47,"47133",2382,1861,1841,30,20,"U.C.E.",1
50,"50195",48,38,38,1,0,"U.C.E.",0
37,"37290",143,111,110,1,1,"U.C.E.",0
44,"44145",1078,723,714,26,9,"U.C.E.",0
8,"8248",5239,3513,3443,71,70,"U.C.E.",0
19,"19222",120,90,89,3,1,"U.C.E.",0
12,"12114",228,178,173,2,5,"U.C.E.",0
24,"24053",503,338,332,3,6,"U.C.E.",0
34,"34129",191,144,142,0,2,"U.C.E.",0
18,"18157",1062,793,783,9,10,"U.C.E.",1
17,"17022",6771,4247,4169,76,78,"U.C.E.",4
5,"5258",123,105,104,1,1,"U.C.E.",0
1,"1008",781,566,546,7,20,"U.C.E.",0
12,"12089",4277,3009,2946,32,63,"U.C.E.",0
41,"41010",4338,2990,2958,48,32,"U.C.E.",0
46,"46205",14277,10882,10764,115,118,"U.C.E.",6
19,"19039",73,57,57,0,0,"U.C.E.",0
23,"23038",3273,2658,2638,29,20,"U.C.E.",1
5,"5093",431,330,329,1,1,"U.C.E.",0
45,"45053",8208,6763,6663,103,100,"U.C.E.",5
37,"37149",78,69,69,0,0,"U.C.E.",0
24,"24092",883,707,702,6,5,"U.C.E.",1
37,"37263",361,277,275,1,2,"U.C.E.",1
5,"5087",144,87,87,0,0,"U.C.E.",0
45,"45110",1918,1585,1570,10,15,"U.C.E.",0
50,"50275",103,76,76,0,0,"U.C.E.",0
8,"8109",200,155,153,1,2,"U.C.E.",0
24,"24177",477,325,319,3,6,"U.C.E.",0
17,"17001",557,370,365,7,5,"U.C.E.",0
47,"47132",45,40,40,0,0,"U.C.E.",0
26,"26129",1010,794,780,7,14,"U.C.E.",0
24,"24074",107,87,87,0,0,"U.C.E.",0
24,"24026",1304,1015,1001,17,14,"U.C.E.",1
36,"36018",3492,2516,2494,25,22,"U.C.E.",0
5,"5043",86,68,68,0,0,"U.C.E.",0
18,"18905",12975,9260,9209,155,51,"U.C.E.",3
47,"47199",84,61,60,1,1,"U.C.E.",0
46,"46081",10254,8188,8101,52,87,"U.C.E.",5
18,"18078",768,638,637,1,1,"U.C.E.",0
47,"47165",7036,5328,5258,67,70,"U.C.E.",1
31,"31056",183,123,122,4,1,"U.C.E.",0
8,"8104",713,454,441,9,13,"U.C.E.",0
10,"10006",1306,1081,1070,7,11,"U.C.E.",0
8,"8268",1110,768,755,17,13,"U.C.E.",0
4,"4066",13570,9018,8963,97,55,"U.C.E.",3
33,"33057",1635,1150,1132,16,18,"U.C.E.",0
15,"15066",4180,3098,3062,38,36,"U.C.E.",2
4,"4012",230,195,195,2,0,"U.C.E.",0
8,"8209",6596,4415,4351,69,64,"U.C.E.",3
8,"8195",88,64,64,2,0,"U.C.E.",1
12,"12122",835,674,658,14,16,"U.C.E.",0
10,"10004",733,576,565,6,11,"U.C.E.",0
33,"33037",37135,25522,25262,291,260,"U.C.E.",12
8,"8122",1755,1063,1034,17,29,"U.C.E.",2
3,"3004",624,497,486,7,11,"U.C.E.",0
24,"24218",476,344,340,11,4,"U.C.E.",0
18,"18014",5667,4132,4085,43,47,"U.C.E.",1
37,"37364",893,653,644,10,9,"U.C.E.",1
22,"22212",93,79,79,0,0,"U.C.E.",0
19,"19289",33,28,28,1,0,"U.C.E.",0
10,"10058",994,751,738,13,13,"U.C.E.",0
16,"16216",358,300,296,2,4,"U.C.E.",0
46,"46045",1288,1065,1044,2,21,"U.C.E.",1
24,"24014",7677,5352,5289,75,63,"U.C.E.",4
22,"22150",491,342,336,9,6,"U.C.E.",0
39,"39084",873,647,642,4,5,"U.C.E.",0
31,"31905",2707,1913,1881,32,32,"U.C.E.",1
37,"37214",134,94,94,4,0,"U.C.E.",0
19,"19007",460,351,345,5,6,"U.C.E.",1
4,"4094",206,152,152,0,0,"U.C.E.",0
8,"8231",19810,12359,12196,244,163,"U.C.E.",21
18,"18138",2460,1751,1741,1,10,"U.C.E.",0
34,"34218",486,366,365,3,1,"U.C.E.",0
10,"10032",1768,1438,1415,9,23,"U.C.E.",0
18,"18069",506,375,371,4,4,"U.C.E.",0
15,"15093",4562,3314,3270,37,44,"U.C.E.",1
18,"18094",2398,1882,1868,16,14,"U.C.E.",2
3,"3051",356,314,311,2,3,"U.C.E.",1
37,"37202",938,742,726,25,16,"U.C.E.",0
34,"34190",59,42,42,4,0,"U.C.E.",0
26,"26147",34,29,29,2,0,"U.C.E.",0
19,"19066",78,63,62,0,1,"U.C.E.",0
10,"10095",346,290,283,3,7,"U.C.E.",1
31,"31040",197,137,135,2,2,"U.C.E.",0
5,"5074",755,639,638,5,1,"U.C.E.",0
15,"15026",2025,1426,1413,17,13,"U.C.E.",0
26,"26176",69,55,54,0,1,"U.C.E.",0
5,"5231",172,142,141,0,1,"U.C.E.",0
44,"44174",435,310,309,3,1,"U.C.E.",0
41,"41036",4053,2930,2899,29,31,"U.C.E.",0
22,"22051",108,86,84,2,2,"U.C.E.",0
40,"40054",145,103,102,1,1,"U.C.E.",0
50,"50142",45,25,24,0,1,"U.C.E.",0
14,"14047",1566,1154,1143,19,11,"U.C.E.",0
1,"1051",3662,2242,2210,26,32,"U.C.E.",4
40,"40216",753,621,611,15,10,"U.C.E.",0
22,"22116",1571,1127,1114,37,13,"U.C.E.",1
22,"22059",1149,792,764,23,28,"U.C.E.",0
37,"37134",250,192,189,1,3,"U.C.E.",0
46,"46028",424,352,347,5,5,"U.C.E.",0
19,"19082",91,68,67,1,1,"U.C.E.",0
19,"19265",157,102,101,0,1,"U.C.E.",0
34,"34204",53,45,44,0,1,"U.C.E.",0
5,"5189",478,361,360,3,1,"U.C.E.",0
4,"4099",5086,4023,3980,26,43,"U.C.E.",2
31,"31104",1990,1374,1355,20,19,"U.C.E.",3
41,"41092",7649,5816,5738,39,78,"U.C.E.",2
36,"36016",1373,865,853,7,12,"U.C.E.",0
39,"39049",339,244,242,5,2,"U.C.E.",0
50,"50085",205,143,143,3,0,"U.C.E.",0
26,"26121",33,28,28,0,0,"U.C.E.",0
10,"10035",1941,1517,1492,15,25,"U.C.E.",1
34,"34125",99,77,75,1,2,"U.C.E.",0
15,"15065",7570,5710,5628,71,82,"U.C.E.",0
46,"46062",4589,3794,3752,46,42,"U.C.E.",1
16,"16020",20,15,15,0,0,"U.C.E.",0
16,"16047",249,192,191,5,1,"U.C.E.",0
22,"22176",173,154,149,2,5,"U.C.E.",0
4,"4902",42901,28927,28711,338,216,"U.C.E.",18
37,"37175",408,319,311,6,8,"U.C.E.",0
47,"47188",125,112,109,3,3,"U.C.E.",0
15,"15068",5404,3780,3725,53,55,"U.C.E.",2
46,"46032",5583,4342,4287,39,55,"U.C.E.",2
50,"50099",3136,2333,2297,27,36,"U.C.E.",1
4,"4044",1517,1232,1224,8,8,"U.C.E.",0
24,"24031",220,180,176,3,4,"U.C.E.",1
31,"31064",1500,1137,1120,12,17,"U.C.E.",0
46,"46014",3092,2449,2420,26,29,"U.C.E.",1
40,"40001",713,575,562,10,13,"U.C.E.",0
3,"3053",7082,5754,5664,60,90,"U.C.E.",7
22,"22207",135,86,79,4,7,"U.C.E.",0
5,"5103",84,68,68,3,0,"U.C.E.",0
44,"44163",119,91,91,0,0,"U.C.E.",0
39,"39041",1775,1432,1414,15,18,"U.C.E.",0
10,"10114",926,670,652,8,18,"U.C.E.",2
15,"15036",60838,40345,39667,915,678,"U.C.E.",16
34,"34243",352,274,273,5,1,"U.C.E.",0
19,"19219",18,12,12,0,0,"U.C.E.",0
8,"8291",4516,2895,2855,56,40,"U.C.E.",10
18,"18068",1456,1105,1088,13,17,"U.C.E.",1
47,"47179",408,315,306,6,9,"U.C.E.",0
18,"18048",2277,1705,1688,19,17,"U.C.E.",1
31,"31160",111,93,93,7,0,"U.C.E.",0
44,"44180",71,52,52,1,0,"U.C.E.",0
42,"42140",17,10,10,0,0,"U.C.E.",0
4,"4101",3927,2827,2804,34,23,"U.C.E.",1
37,"37050",71,48,48,1,0,"U.C.E.",0
16,"16010",184,135,133,1,2,"U.C.E.",0
12,"12055",112,79,78,3,1,"U.C.E.",0
24,"24079",1045,721,710,15,11,"U.C.E.",0
42,"42025",1305,964,945,15,19,"U.C.E.",1
22,"22095",87,61,61,1,0,"U.C.E.",0
8,"8129",444,278,271,2,7,"U.C.E.",1
46,"46202",15578,11811,11676,110,135,"U.C.E.",2
45,"45185",7912,6321,6180,68,141,"U.C.E.",0
41,"41079",9349,7095,7001,71,94,"U.C.E.",4
26,"26093",60,41,41,0,0,"U.C.E.",0
12,"12117",3674,2846,2794,25,52,"U.C.E.",1
8,"8266",42860,30047,29521,536,526,"U.C.E.",56
18,"18143",949,722,704,2,18,"U.C.E.",0
34,"34228",93,80,80,0,0,"U.C.E.",0
50,"50114",157,120,120,1,0,"U.C.E.",0
5,"5177",164,134,133,0,1,"U.C.E.",0
46,"46011",7727,5874,5777,75,97,"U.C.E.",1
19,"19296",43,31,30,1,1,"U.C.E.",0
19,"19155",61,52,50,1,2,"U.C.E.",0
1,"1002",8057,5854,5757,48,97,"U.C.E.",4
37,"37098",355,267,265,1,2,"U.C.E.",0
22,"22044",278,195,191,7,4,"U.C.E.",0
22,"22085",119,97,94,0,3,"U.C.E.",0
46,"46157",3068,2523,2491,17,32,"U.C.E.",0
50,"50005",245,199,195,1,4,"U.C.E.",0
19,"19218",60,35,35,0,0,"U.C.E.",0
19,"19165",51,43,42,0,1,"U.C.E.",0
44,"44128",84,56,56,3,0,"U.C.E.",0
34,"34217",1089,866,849,19,17,"U.C.E.",1
19,"19262",184,137,136,0,1,"U.C.E.",0
40,"40179",634,545,538,4,7,"U.C.E.",1
19,"19081",43,33,33,0,0,"U.C.E.",0
41,"41035",1171,898,889,12,9,"U.C.E.",0
14,"14017",10755,8220,8149,101,71,"U.C.E.",2
15,"15055",4780,3247,3181,70,66,"U.C.E.",2
8,"8009",8932,6188,6088,103,100,"U.C.E.",13
41,"41053",20729,16178,15971,142,207,"U.C.E.",8
46,"46109",6143,4731,4637,40,94,"U.C.E.",3
24,"24203",109,73,73,0,0,"U.C.E.",0
41,"41018",9457,6940,6867,66,73,"U.C.E.",2
5,"5105",349,275,272,12,3,"U.C.E.",0
24,"24082",877,698,690,13,8,"U.C.E.",0
8,"8241",80,61,61,1,0,"U.C.E.",0
10,"10140",1143,941,927,9,14,"U.C.E.",1
41,"41070",5598,4101,4039,79,62,"U.C.E.",1
34,"34012",368,277,275,9,2,"U.C.E.",0
4,"4080",194,169,168,1,1,"U.C.E.",0
37,"37228",388,339,336,2,3,"U.C.E.",0
4,"4084",370,290,285,6,5,"U.C.E.",0
34,"34155",142,118,117,3,1,"U.C.E.",1
31,"31219",93,75,73,1,2,"U.C.E.",0
31,"31043",42,30,30,1,0,"U.C.E.",0
44,"44011",67,47,47,0,0,"U.C.E.",0
41,"41074",3079,2406,2386,14,20,"U.C.E.",0
33,"33004",69056,49228,48730,726,498,"U.C.E.",17
19,"19046",20318,15118,14892,219,226,"U.C.E.",18
33,"33027",929,617,613,5,4,"U.C.E.",0
50,"50222",1695,1117,1091,16,26,"U.C.E.",0
45,"45190",502,425,414,6,11,"U.C.E.",2
19,"19267",22,15,15,0,0,"U.C.E.",0
15,"15041",9718,7514,7425,102,89,"U.C.E.",2
5,"5048",131,112,111,0,1,"U.C.E.",0
12,"12141",116,97,97,0,0,"U.C.E.",0
35,"35027",10510,7523,7375,88,148,"U.C.E.",6
16,"16045",226,177,176,2,1,"U.C.E.",0
42,"42103",626,487,481,3,6,"U.C.E.",0
8,"8053",2850,1788,1772,21,16,"U.C.E.",1
23,"23903",3537,2892,2877,12,15,"U.C.E.",3
44,"44065",60,40,40,0,0,"U.C.E.",0
50,"50199",380,263,254,2,9,"U.C.E.",0
8,"8207",1718,1296,1256,28,40,"U.C.E.",2
44,"44171",186,127,124,3,3,"U.C.E.",0
3,"3122",40476,29591,29265,341,326,"U.C.E.",25
18,"18180",655,450,447,1,3,"U.C.E.",0
34,"34140",113,84,84,2,0,"U.C.E.",0
10,"10039",448,352,350,0,2,"U.C.E.",0
18,"18163",327,246,238,0,8,"U.C.E.",0
37,"37104",32,24,23,0,1,"U.C.E.",0
5,"5205",78,59,58,0,1,"U.C.E.",0
22,"22045",104,83,80,2,3,"U.C.E.",0
18,"18154",1062,770,769,0,1,"U.C.E.",0
47,"47230",318,266,259,2,7,"U.C.E.",0
17,"17058",177,115,114,2,1,"U.C.E.",0
19,"19048",18,12,11,1,1,"U.C.E.",0
5,"5097",525,378,373,4,5,"U.C.E.",0
50,"50060",187,138,136,1,2,"U.C.E.",0
44,"44110",57,45,45,0,0,"U.C.E.",0
15,"15072",9868,7077,6951,79,126,"U.C.E.",3
40,"40904",332,271,268,5,3,"U.C.E.",18
10,"10119",714,489,482,3,7,"U.C.E.",0
34,"34165",86,67,67,0,0,"U.C.E.",0
15,"15084",3681,2676,2656,34,20,"U.C.E.",1
16,"16007",1272,1056,1051,7,5,"U.C.E.",0
16,"16277",128,100,100,3,0,"U.C.E.",0
22,"22203",92,79,79,0,0,"U.C.E.",0
17,"17060",378,240,233,1,7,"U.C.E.",0
44,"44115",121,100,100,0,0,"U.C.E.",0
50,"50254",179,136,136,0,0,"U.C.E.",0
46,"46187",1339,1096,1083,13,13,"U.C.E.",1
37,"37120",107,88,87,0,1,"U.C.E.",0
44,"44087",98,87,87,2,0,"U.C.E.",0
5,"5052",102,91,91,0,0,"U.C.E.",0
35,"35009",19678,13799,13442,155,357,"U.C.E.",11
46,"46173",1393,1156,1137,10,19,"U.C.E.",1
19,"19254",57,50,50,0,0,"U.C.E.",0
46,"46015",7042,5644,5581,53,63,"U.C.E.",1
18,"18137",1057,875,868,8,7,"U.C.E.",0
44,"44084",63,51,50,0,1,"U.C.E.",0
16,"16063",97,81,81,0,0,"U.C.E.",0
24,"24110",1291,914,904,16,10,"U.C.E.",0
42,"42095",1575,1136,1106,40,30,"U.C.E.",6
39,"39069",1957,1595,1570,18,25,"U.C.E.",0
10,"10175",1509,1149,1127,4,22,"U.C.E.",0
19,"19178",45,34,34,0,0,"U.C.E.",0
12,"12136",2663,2325,2284,33,41,"U.C.E.",3
40,"40012",280,215,213,2,2,"U.C.E.",0
22,"22906",190,152,147,3,5,"U.C.E.",0
5,"5240",3351,2472,2428,22,44,"U.C.E.",0
37,"37247",216,176,173,1,3,"U.C.E.",0
24,"24038",3206,2439,2399,37,40,"U.C.E.",0
26,"26096",244,204,201,2,3,"U.C.E.",0
15,"15083",1198,874,855,8,19,"U.C.E.",0
16,"16023",468,332,327,3,5,"U.C.E.",0
47,"47216",124,99,98,2,1,"U.C.E.",0
3,"3132",571,464,461,8,3,"U.C.E.",0
23,"23905",1884,1447,1438,4,9,"U.C.E.",2
50,"50025",4569,3319,3271,68,48,"U.C.E.",2
44,"44199",52,40,39,0,1,"U.C.E.",0
16,"16024",134,92,91,1,1,"U.C.E.",0
26,"26111",266,203,200,4,3,"U.C.E.",1
5,"5249",101,73,71,1,2,"U.C.E.",0
50,"50113",653,528,526,9,2,"U.C.E.",0
22,"22047",228,200,200,5,0,"U.C.E.",0
26,"26069",276,211,208,5,3,"U.C.E.",0
10,"10083",105,74,74,0,0,"U.C.E.",0
8,"8105",9642,6571,6483,110,88,"U.C.E.",6
34,"34029",832,696,683,11,13,"U.C.E.",0
34,"34233",158,128,128,3,0,"U.C.E.",0
47,"47180",96,82,81,0,1,"U.C.E.",1
50,"50191",505,395,390,4,5,"U.C.E.",0
47,"47019",93,69,68,0,1,"U.C.E.",0
47,"47163",315,253,250,2,3,"U.C.E.",1
35,"35018",11652,6488,6367,107,121,"U.C.E.",7
10,"10143",169,135,131,1,4,"U.C.E.",0
10,"10034",376,283,278,5,5,"U.C.E.",0
24,"24112",323,230,228,0,2,"U.C.E.",0
17,"17202",3799,2398,2366,44,32,"U.C.E.",5
50,"50077",254,189,188,4,1,"U.C.E.",0
8,"8175",3477,2303,2270,39,33,"U.C.E.",4
46,"46203",3669,3002,2964,36,38,"U.C.E.",1
44,"44224",26,15,15,0,0,"U.C.E.",0
34,"34113",35,28,27,0,1,"U.C.E.",0
42,"42204",64,49,44,4,5,"U.C.E.",0
39,"39028",3513,2760,2718,23,42,"U.C.E.",0
24,"24024",717,501,498,10,3,"U.C.E.",0
35,"35013",6779,5059,4961,105,98,"U.C.E.",3
22,"22902",240,169,169,3,0,"U.C.E.",1
12,"12132",524,407,401,4,6,"U.C.E.",1
40,"40123",168,130,126,3,4,"U.C.E.",1
44,"44035",122,99,98,3,1,"U.C.E.",0
31,"31180",240,174,170,5,4,"U.C.E.",1
37,"37200",192,142,142,0,0,"U.C.E.",0
17,"17215",1918,1350,1321,40,29,"U.C.E.",1
42,"42211",92,69,68,0,1,"U.C.E.",0
46,"46029",20887,16124,15988,144,136,"U.C.E.",7
4,"4095",777,547,541,8,6,"U.C.E.",0
16,"16905",1017,811,806,14,5,"U.C.E.",1
22,"22002",107,85,84,3,1,"U.C.E.",0
23,"23066",4348,3687,3654,21,33,"U.C.E.",2
22,"22103",697,532,523,10,9,"U.C.E.",2
42,"42187",65,51,51,0,0,"U.C.E.",0
50,"50298",5319,4023,3955,72,68,"U.C.E.",1
37,"37229",144,108,108,0,0,"U.C.E.",0
37,"37086",105,75,72,3,3,"U.C.E.",1
26,"26146",141,98,96,0,2,"U.C.E.",0
37,"37128",261,211,210,2,1,"U.C.E.",0
39,"39067",901,628,623,1,5,"U.C.E.",0
19,"19246",48,38,38,1,0,"U.C.E.",0
31,"31182",45,28,28,2,0,"U.C.E.",0
23,"23082",1985,1464,1451,9,13,"U.C.E.",1
16,"16066",2402,2064,1997,32,67,"U.C.E.",0
42,"42125",73,65,64,4,1,"U.C.E.",0
31,"31265",81,52,50,0,2,"U.C.E.",0
45,"45183",2189,1537,1514,10,23,"U.C.E.",2
1,"1023",290,236,235,1,1,"U.C.E.",0
47,"47161",3886,3133,3105,45,28,"U.C.E.",4
45,"45019",7033,5207,5110,89,97,"U.C.E.",3
5,"5053",94,73,71,0,2,"U.C.E.",0
50,"50234",251,201,191,13,10,"U.C.E.",0
41,"41078",2587,1979,1970,15,9,"U.C.E.",1
10,"10126",1660,1221,1201,9,20,"U.C.E.",1
16,"16041",395,289,287,6,2,"U.C.E.",1
16,"16053",414,334,326,2,8,"U.C.E.",0
31,"31150",234,163,162,5,1,"U.C.E.",0
19,"19183",108,87,86,1,1,"U.C.E.",0
44,"44220",137,97,96,1,1,"U.C.E.",0
26,"26008",1909,1544,1527,19,17,"U.C.E.",1
10,"10062",421,332,325,3,7,"U.C.E.",0
1,"1043",2322,1623,1595,12,28,"U.C.E.",4
22,"22019",190,141,138,4,3,"U.C.E.",0
50,"50187",72,45,45,1,0,"U.C.E.",0
8,"8194",24757,15009,14799,245,210,"U.C.E.",20
47,"47159",862,704,695,20,9,"U.C.E.",0
33,"33006",1674,1130,1120,10,10,"U.C.E.",0
23,"23057",823,717,711,4,6,"U.C.E.",0
18,"18054",879,646,644,4,2,"U.C.E.",0
24,"24049",1528,1144,1124,22,20,"U.C.E.",0
42,"42064",92,76,76,0,0,"U.C.E.",0
45,"45033",407,302,295,3,7,"U.C.E.",0
24,"24065",2104,1512,1488,27,24,"U.C.E.",0
44,"44173",107,87,77,5,10,"U.C.E.",0
8,"8112",12946,8533,8390,227,143,"U.C.E.",1
37,"37245",357,273,272,2,1,"U.C.E.",0
31,"31094",123,100,97,3,3,"U.C.E.",0
12,"12137",47,36,35,0,1,"U.C.E.",0
17,"17099",74,52,50,1,2,"U.C.E.",0
34,"34009",34,31,31,3,0,"U.C.E.",0
8,"8205",54870,41064,40491,682,573,"U.C.E.",33
33,"33007",1680,1186,1179,10,7,"U.C.E.",1
47,"47143",146,108,107,0,1,"U.C.E.",0
44,"44097",158,97,95,1,2,"U.C.E.",0
4,"4096",293,220,219,1,1,"U.C.E.",0
33,"33002",10837,7667,7588,77,79,"U.C.E.",2
37,"37367",218,182,176,0,6,"U.C.E.",0
45,"45195",2229,1806,1784,11,22,"U.C.E.",0
1,"1009",1296,876,863,9,13,"U.C.E.",1
5,"5021",2044,1592,1557,37,35,"U.C.E.",1
40,"40006",23,20,20,0,0,"U.C.E.",0
8,"8171",2158,1385,1359,27,26,"U.C.E.",0
36,"36002",3154,2381,2358,35,23,"U.C.E.",2
35,"35010",3565,2178,2135,26,43,"U.C.E.",4
3,"3014",234288,168004,166418,1795,1586,"U.C.E.",151
31,"31249",1926,1376,1361,30,15,"U.C.E.",1
17,"17062",5994,3686,3614,69,72,"U.C.E.",3
12,"12129",1936,1372,1326,29,46,"U.C.E.",1
15,"15027",1537,1263,1242,22,21,"U.C.E.",0
24,"24091",704,502,496,8,6,"U.C.E.",0
22,"22054",1602,1040,982,42,58,"U.C.E.",1
40,"40180",319,259,255,3,4,"U.C.E.",0
3,"3902",9578,7085,7007,65,78,"U.C.E.",3
50,"50238",114,82,80,0,2,"U.C.E.",0
31,"31066",915,660,647,19,13,"U.C.E.",1
35,"35014",9943,5438,5316,95,122,"U.C.E.",6
14,"14013",17006,13114,12958,166,156,"U.C.E.",7
17,"17164",4092,2409,2346,60,63,"U.C.E.",0
22,"22173",247,150,150,3,0,"U.C.E.",0
19,"19252",90,80,78,0,2,"U.C.E.",0
40,"40134",769,628,620,19,8,"U.C.E.",2
12,"12085",4941,3183,3125,32,58,"U.C.E.",2
5,"5065",498,424,422,7,2,"U.C.E.",0
23,"23075",3404,2800,2782,24,18,"U.C.E.",1
34,"34170",72,56,56,1,0,"U.C.E.",0
15,"15901",3855,2463,2419,48,44,"U.C.E.",0
46,"46051",8122,6432,6378,57,54,"U.C.E.",1
42,"42192",43,36,36,2,0,"U.C.E.",0
5,"5080",75,53,53,1,0,"U.C.E.",0
24,"24054",492,359,351,1,8,"U.C.E.",0
41,"41011",15274,11359,11207,145,152,"U.C.E.",2
19,"19188",72,48,48,1,0,"U.C.E.",0
44,"44092",89,68,68,0,0,"U.C.E.",0
18,"18047",5603,3833,3805,67,28,"U.C.E.",2
46,"46192",755,564,554,9,10,"U.C.E.",1
37,"37262",81,66,64,2,2,"U.C.E.",0
5,"5085",35,34,34,0,0,"U.C.E.",0
24,"24116",451,297,294,5,3,"U.C.E.",0
10,"10130",1745,1360,1341,10,19,"U.C.E.",0
50,"50157",313,253,250,7,3,"U.C.E.",0
40,"40126",96,80,78,0,2,"U.C.E.",0
46,"46041",369,255,255,1,0,"U.C.E.",0
8,"8196",18989,12658,12490,253,168,"U.C.E.",14
37,"37171",437,362,358,4,4,"U.C.E.",0
7,"7003",10671,6262,6149,79,113,"U.C.E.",11
12,"12070",576,473,463,5,10,"U.C.E.",0
47,"47173",862,683,675,5,8,"U.C.E.",0
34,"34234",72,56,55,1,1,"U.C.E.",0
50,"50240",1127,799,783,25,16,"U.C.E.",0
50,"50154",129,98,97,1,1,"U.C.E.",0
45,"45065",317,261,258,0,3,"U.C.E.",0
37,"37251",137,98,93,3,5,"U.C.E.",0
47,"47012",134,105,105,0,0,"U.C.E.",0
19,"19190",2499,1829,1785,32,44,"U.C.E.",1
3,"3043",2933,2494,2447,27,47,"U.C.E.",2
10,"10127",4663,3554,3498,38,56,"U.C.E.",8
47,"47003",263,224,222,1,2,"U.C.E.",0
46,"46037",1146,1007,1003,5,4,"U.C.E.",0
26,"26117",2152,1682,1655,20,27,"U.C.E.",0
47,"47021",84,61,61,2,0,"U.C.E.",0
40,"40014",60,39,39,1,0,"U.C.E.",0
19,"19142",259,191,190,0,1,"U.C.E.",0
12,"12068",57,45,44,0,1,"U.C.E.",0
19,"19317",150,122,121,2,1,"U.C.E.",1
41,"41083",1176,915,908,8,7,"U.C.E.",0
35,"35017",22331,13463,13144,217,319,"U.C.E.",28
37,"37241",172,135,134,1,1,"U.C.E.",0
17,"17046",738,510,498,15,12,"U.C.E.",0
37,"37215",156,106,106,1,0,"U.C.E.",0
24,"24070",4434,3199,3136,34,63,"U.C.E.",0
47,"47039",196,163,163,1,0,"U.C.E.",0
8,"8243",160,112,110,3,2,"U.C.E.",0
14,"14059",713,572,567,5,5,"U.C.E.",0
18,"18184",2140,1663,1645,18,18,"U.C.E.",0
42,"42107",86,60,59,2,1,"U.C.E.",0
37,"37141",158,140,139,1,1,"U.C.E.",0
24,"24202",8677,5486,5377,103,109,"U.C.E.",1
34,"34157",2471,1936,1912,26,24,"U.C.E.",0
46,"46258",2792,2196,2164,14,32,"U.C.E.",1
18,"18158",10328,7336,7254,69,82,"U.C.E.",4
33,"33053",1206,817,811,6,6,"U.C.E.",0
18,"18145",10083,7592,7499,78,93,"U.C.E.",1
19,"19216",143,112,105,2,7,"U.C.E.",0
39,"39101",328,251,247,5,4,"U.C.E.",1
14,"14006",1326,1170,1148,12,22,"U.C.E.",2
31,"31214",95,64,64,1,0,"U.C.E.",0
31,"31002",421,292,284,5,8,"U.C.E.",0
46,"46242",361,288,280,4,8,"U.C.E.",0
34,"34132",128,103,102,2,1,"U.C.E.",0
47,"47204",275,221,219,3,2,"U.C.E.",0
36,"36047",2723,1875,1853,27,22,"U.C.E.",0
41,"41076",2227,1507,1492,5,15,"U.C.E.",0
19,"19331",2497,1898,1847,19,51,"U.C.E.",0
47,"47058",199,157,157,3,0,"U.C.E.",0
37,"37142",613,436,434,7,2,"U.C.E.",0
31,"31032",1785,1330,1305,24,25,"U.C.E.",1
15,"15034",3116,2146,2114,20,32,"U.C.E.",1
37,"37232",412,374,373,1,1,"U.C.E.",0
46,"46064",547,463,458,2,5,"U.C.E.",0
1,"1028",1106,773,760,8,13,"U.C.E.",1
14,"14072",1169,925,922,5,3,"U.C.E.",0
14,"14011",595,498,497,4,1,"U.C.E.",0
22,"22007",863,636,621,8,15,"U.C.E.",0
19,"19010",15,13,13,1,0,"U.C.E.",0
44,"44221",377,305,297,6,8,"U.C.E.",1
42,"42118",26,20,20,0,0,"U.C.E.",0
16,"16173",249,189,188,0,1,"U.C.E.",0
50,"50245",121,80,80,1,0,"U.C.E.",0
26,"26136",111,90,90,3,0,"U.C.E.",1
50,"50160",2397,1905,1865,19,40,"U.C.E.",2
22,"22080",288,217,217,4,0,"U.C.E.",0
50,"50236",124,103,103,2,0,"U.C.E.",0
3,"3038",338,294,291,2,3,"U.C.E.",1
37,"37358",163,143,139,0,4,"U.C.E.",0
8,"8212",508,366,363,1,3,"U.C.E.",0
16,"16040",97,76,75,1,1,"U.C.E.",0
14,"14029",4380,3344,3308,35,36,"U.C.E.",2
12,"12094",807,612,604,14,8,"U.C.E.",0
10,"10156",116,91,91,0,0,"U.C.E.",0
20,"20065",3176,2156,2137,19,19,"U.C.E.",3
31,"31082",634,402,398,10,4,"U.C.E.",0
46,"46196",159,145,144,1,1,"U.C.E.",0
20,"20058",770,549,547,3,2,"U.C.E.",0
19,"19318",36,19,19,1,0,"U.C.E.",0
37,"37203",174,148,148,0,0,"U.C.E.",0
37,"37023",1040,819,811,11,8,"U.C.E.",1
34,"34011",406,327,327,4,0,"U.C.E.",0
46,"46026",1217,1043,1035,2,8,"U.C.E.",0
46,"46147",16527,11836,11716,105,120,"U.C.E.",5
46,"46050",161,126,123,1,3,"U.C.E.",0
4,"4032",5476,3666,3643,34,23,"U.C.E.",4
17,"17041",237,153,153,1,0,"U.C.E.",0
39,"39081",440,372,369,3,3,"U.C.E.",0
18,"18057",5045,3755,3721,44,34,"U.C.E.",1
5,"5112",125,88,87,0,1,"U.C.E.",1
16,"16050",298,245,238,0,7,"U.C.E.",0
31,"31046",58,41,41,3,0,"U.C.E.",0
24,"24104",291,198,196,3,2,"U.C.E.",1
3,"3085",275,218,215,2,3,"U.C.E.",1
44,"44106",173,132,131,8,1,"U.C.E.",0
44,"44225",129,100,98,5,2,"U.C.E.",1
19,"19052",37,32,31,1,1,"U.C.E.",0
22,"22239",90,76,76,2,0,"U.C.E.",0
5,"5012",156,134,132,1,2,"U.C.E.",0
23,"23092",27970,20921,20651,284,270,"U.C.E.",14
50,"50229",62,47,46,2,1,"U.C.E.",0
24,"24093",388,262,258,1,4,"U.C.E.",0
34,"34246",78,64,64,0,0,"U.C.E.",0
42,"42124",71,50,50,0,0,"U.C.E.",0
5,"5058",81,61,59,0,2,"U.C.E.",0
40,"40196",44,34,34,3,0,"U.C.E.",0
47,"47089",184,139,138,1,1,"U.C.E.",0
15,"15019",26096,18466,18187,350,279,"U.C.E.",6
33,"33025",9455,6331,6277,84,54,"U.C.E.",1
5,"5178",392,310,304,2,6,"U.C.E.",0
45,"45177",2295,1898,1857,15,41,"U.C.E.",1
8,"8189",141,113,111,4,2,"U.C.E.",0
8,"8236",1507,1027,1002,18,25,"U.C.E.",2
34,"34135",429,334,329,6,5,"U.C.E.",0
18,"18045",1211,892,885,4,7,"U.C.E.",0
20,"20081",7346,4957,4925,35,32,"U.C.E.",7
19,"19087",22,16,16,0,0,"U.C.E.",1
5,"5107",74,54,53,0,1,"U.C.E.",0
19,"19261",42,31,31,1,0,"U.C.E.",0
41,"41052",2967,2305,2288,7,17,"U.C.E.",7
22,"22160",219,166,166,5,0,"U.C.E.",2
10,"10017",884,681,673,6,8,"U.C.E.",1
5,"5115",590,458,450,1,8,"U.C.E.",0
33,"33003",737,475,471,6,4,"U.C.E.",0
46,"46182",1190,864,855,11,9,"U.C.E.",4
17,"17116",369,230,227,3,3,"U.C.E.",0
14,"14037",3500,2662,2616,29,46,"U.C.E.",1
19,"19168",324,233,231,6,2,"U.C.E.",2
44,"44109",123,86,84,2,2,"U.C.E.",0
35,"35025",1941,1345,1328,12,17,"U.C.E.",3
37,"37114",92,75,74,1,1,"U.C.E.",0
3,"3044",4459,3798,3753,21,45,"U.C.E.",2
44,"44094",116,105,103,4,2,"U.C.E.",0
34,"34100",141,105,105,1,0,"U.C.E.",0
50,"50242",102,82,82,2,0,"U.C.E.",0
5,"5244",66,45,45,0,0,"U.C.E.",0
37,"37115",135,107,101,2,6,"U.C.E.",0
44,"44229",150,108,107,5,1,"U.C.E.",0
26,"26073",100,85,84,1,1,"U.C.E.",0
26,"26103",796,616,611,11,5,"U.C.E.",0
10,"10128",5805,4456,4336,50,120,"U.C.E.",2
26,"26019",365,296,295,6,1,"U.C.E.",0
18,"18086",397,321,321,3,0,"U.C.E.",0
17,"17056",1704,1171,1158,21,13,"U.C.E.",0
16,"16015",407,311,311,4,0,"U.C.E.",0
37,"37377",268,209,208,1,1,"U.C.E.",0
19,"19019",23,18,18,0,0,"U.C.E.",0
17,"17087",230,170,161,6,9,"U.C.E.",0
23,"23025",2845,2292,2271,17,21,"U.C.E.",0
22,"22003",148,117,116,2,1,"U.C.E.",0
18,"18061",1109,882,869,1,13,"U.C.E.",0
8,"8253",134,91,91,2,0,"U.C.E.",0
23,"23094",3917,3200,3166,32,34,"U.C.E.",3
42,"42027",87,61,61,4,0,"U.C.E.",0
39,"39025",8985,7048,6955,70,93,"U.C.E.",9
50,"50048",43,33,33,1,0,"U.C.E.",0
44,"44210",754,573,567,3,6,"U.C.E.",1
15,"15045",4178,2743,2727,22,16,"U.C.E.",0
36,"36010",2987,2312,2282,30,30,"U.C.E.",5
36,"36043",5188,3435,3390,35,45,"U.C.E.",4
19,"19237",53,40,39,2,1,"U.C.E.",0
1,"1057",266,212,212,2,0,"U.C.E.",0
40,"40127",45,33,33,0,0,"U.C.E.",0
8,"8182",2802,1871,1852,35,19,"U.C.E.",3
33,"33067",802,650,639,12,11,"U.C.E.",0
37,"37045",27,21,21,0,0,"U.C.E.",0
8,"8110",13366,8493,8329,144,164,"U.C.E.",7
3,"3047",8867,6219,6113,76,106,"U.C.E.",12
8,"8019",1143222,778246,767530,12386,10716,"U.C.E.",866
7,"7010",4668,3229,3174,58,55,"U.C.E.",3
26,"26150",129,104,104,0,0,"U.C.E.",0
5,"5005",199,170,169,1,1,"U.C.E.",0
34,"34163",61,56,56,1,0,"U.C.E.",0
19,"19150",128,112,108,0,4,"U.C.E.",0
17,"17009",4089,2573,2490,59,83,"U.C.E.",3
41,"41051",2103,1705,1686,7,19,"U.C.E.",0
46,"46226",34,34,33,0,1,"U.C.E.",0
10,"10023",854,688,682,9,6,"U.C.E.",0
47,"47067",198,159,156,5,3,"U.C.E.",0
5,"5184",288,225,224,0,1,"U.C.E.",0
44,"44234",76,63,63,0,0,"U.C.E.",0
37,"37157",94,65,65,0,0,"U.C.E.",0
50,"50169",371,275,274,5,1,"U.C.E.",0
40,"40113",438,330,322,4,8,"U.C.E.",0
42,"42035",847,600,592,4,8,"U.C.E.",0
31,"31023",5338,3986,3920,120,66,"U.C.E.",5
11,"11041",9805,7136,7067,87,69,"U.C.E.",1
17,"17121",230,159,158,7,1,"U.C.E.",0
44,"44235",103,71,68,0,3,"U.C.E.",0
41,"41008",1073,884,875,0,9,"U.C.E.",0
15,"15079",1709,1268,1253,14,15,"U.C.E.",1
24,"24062",151,107,107,0,0,"U.C.E.",0
50,"50167",235,191,184,1,7,"U.C.E.",0
22,"22077",421,327,323,14,4,"U.C.E.",0
4,"4045",1877,1512,1497,23,15,"U.C.E.",1
44,"44103",128,95,95,0,0,"U.C.E.",0
18,"18912",1576,1193,1185,7,8,"U.C.E.",0
17,"17015",12254,7759,7553,143,206,"U.C.E.",2
24,"24006",521,384,378,4,6,"U.C.E.",0
31,"31173",881,754,733,12,21,"U.C.E.",1
11,"11042",1232,933,922,4,11,"U.C.E.",0
26,"26152",38,31,31,0,0,"U.C.E.",0
19,"19050",21,19,19,0,0,"U.C.E.",0
3,"3901",1070,826,818,14,8,"U.C.E.",0
19,"19139",32,23,23,0,0,"U.C.E.",0
44,"44117",357,278,275,0,3,"U.C.E.",0
18,"18170",377,238,237,0,1,"U.C.E.",0
24,"24078",426,323,316,0,7,"U.C.E.",0
34,"34168",60,56,56,0,0,"U.C.E.",0
35,"35004",35462,18498,18196,325,302,"U.C.E.",26
22,"22011",102,78,78,3,0,"U.C.E.",0
10,"10081",183,143,142,0,1,"U.C.E.",0
34,"34169",431,331,329,5,2,"U.C.E.",1
8,"8044",4247,2763,2712,50,51,"U.C.E.",3
8,"8043",3067,2044,2023,29,21,"U.C.E.",0
44,"44157",62,45,44,0,1,"U.C.E.",1
17,"17212",129,100,98,4,2,"U.C.E.",0
50,"50082",108,73,72,0,1,"U.C.E.",0
17,"17124",1670,1087,1056,18,31,"U.C.E.",0
31,"31026",154,125,122,1,3,"U.C.E.",0
7,"7027",20045,12873,12678,204,195,"U.C.E.",9
12,"12078",365,273,267,5,6,"U.C.E.",0
41,"41071",5603,3999,3932,28,67,"U.C.E.",1
12,"12100",1380,1124,1109,11,15,"U.C.E.",0
30,"30042",1841,1531,1519,10,12,"U.C.E.",0
45,"45148",340,256,256,1,0,"U.C.E.",0
10,"10110",2326,1751,1703,11,48,"U.C.E.",0
11,"11007",17997,10781,10676,184,105,"U.C.E.",7
40,"40212",29,22,20,0,2,"U.C.E.",0
46,"46019",8671,7195,7109,70,86,"U.C.E.",5
24,"24173",1023,757,747,4,10,"U.C.E.",0
11,"11902",3578,2400,2376,21,24,"U.C.E.",0
8,"8199",712,507,499,15,8,"U.C.E.",0
7,"7035",1542,1190,1161,19,29,"U.C.E.",1
40,"40151",52,42,42,0,0,"U.C.E.",0
39,"39057",2298,1735,1719,17,16,"U.C.E.",0
47,"47096",139,109,107,0,2,"U.C.E.",1
44,"44112",473,353,350,4,3,"U.C.E.",1
47,"47134",186,155,149,2,6,"U.C.E.",0
34,"34167",124,105,105,0,0,"U.C.E.",0
3,"3065",164772,124457,123236,1556,1221,"U.C.E.",145
16,"16166",277,210,202,0,8,"U.C.E.",0
24,"24003",725,528,520,8,8,"U.C.E.",0
26,"26030",12,12,12,0,0,"U.C.E.",0
50,"50084",84,64,64,1,0,"U.C.E.",0
41,"41903",6653,5134,5070,61,64,"U.C.E.",2
37,"37239",235,208,201,2,7,"U.C.E.",0
37,"37163",44,36,36,0,0,"U.C.E.",0
46,"46190",48324,34747,34424,431,323,"U.C.E.",48
34,"34001",36,29,29,2,0,"U.C.E.",0
44,"44121",63,48,48,1,0,"U.C.E.",0
26,"26115",20,20,20,4,0,"U.C.E.",0
24,"24017",630,476,468,11,8,"U.C.E.",1
44,"44243",38,27,26,3,1,"U.C.E.",0
20,"20051",7033,4843,4779,57,64,"U.C.E.",6
19,"19201",70,52,52,2,0,"U.C.E.",0
47,"47082",816,664,661,10,3,"U.C.E.",0
31,"31080",544,428,426,7,2,"U.C.E.",0
24,"24043",144,77,77,0,0,"U.C.E.",3
45,"45041",3617,2672,2635,21,37,"U.C.E.",0
18,"18040",246,147,146,0,1,"U.C.E.",0
46,"46110",21420,15810,15671,134,139,"U.C.E.",20
22,"22017",917,677,661,8,16,"U.C.E.",0
39,"39007",479,348,347,3,1,"U.C.E.",0
22,"22904",908,660,653,14,7,"U.C.E.",1
3,"3067",94,81,79,1,2,"U.C.E.",0
8,"8232",1793,1239,1220,20,19,"U.C.E.",2
44,"44080",294,216,211,3,5,"U.C.E.",0
40,"40172",34,27,26,0,1,"U.C.E.",0
31,"31030",155,113,112,3,1,"U.C.E.",0
24,"24097",244,161,156,4,5,"U.C.E.",0
19,"19036",279,238,236,1,2,"U.C.E.",0
26,"26033",183,157,156,2,1,"U.C.E.",0
31,"31108",1969,1474,1452,23,22,"U.C.E.",1
34,"34116",76,50,49,1,1,"U.C.E.",0
3,"3046",1530,1136,1121,11,15,"U.C.E.",1
26,"26052",181,146,146,0,0,"U.C.E.",0
46,"46215",1451,1185,1169,8,16,"U.C.E.",0
41,"41038",96442,66696,65945,1021,751,"U.C.E.",26
19,"19247",171,125,118,6,7,"U.C.E.",1
18,"18042",425,344,342,2,2,"U.C.E.",0
12,"12063",59,42,41,0,1,"U.C.E.",0
26,"26134",102,82,80,2,2,"U.C.E.",1
38,"38008",5430,3844,3772,46,72,"U.C.E.",4
5,"5902",319,262,262,0,0,"U.C.E.",0
24,"24073",521,385,382,4,3,"U.C.E.",0
26,"26165",350,297,294,1,3,"U.C.E.",1
19,"19259",37,32,32,0,0,"U.C.E.",0
22,"22006",319,203,197,5,6,"U.C.E.",1
50,"50002",166,130,130,2,0,"U.C.E.",0
31,"31022",544,378,369,1,9,"U.C.E.",0
15,"15062",6304,4418,4356,44,62,"U.C.E.",7
40,"40018",102,88,87,2,1,"U.C.E.",0
34,"34037",345,256,253,4,3,"U.C.E.",0
34,"34179",32,21,21,0,0,"U.C.E.",0
22,"22064",184,139,137,3,2,"U.C.E.",0
8,"8101",169663,112624,111107,1841,1517,"U.C.E.",205
35,"35029",3981,2341,2315,43,26,"U.C.E.",2
8,"8152",129,94,93,0,1,"U.C.E.",0
5,"5261",48,32,31,0,1,"U.C.E.",0
31,"31185",541,377,374,2,3,"U.C.E.",0
41,"41042",5902,4572,4509,37,63,"U.C.E.",1
12,"12075",139,106,102,0,4,"U.C.E.",0
5,"5099",555,472,466,4,6,"U.C.E.",0
15,"15063",2849,2022,2001,28,21,"U.C.E.",1
16,"16074",53,42,42,1,0,"U.C.E.",0
16,"16206",250,188,188,2,0,"U.C.E.",0
44,"44003",19,19,19,0,0,"U.C.E.",0
42,"42009",97,69,67,2,2,"U.C.E.",0
47,"47169",70,57,57,0,0,"U.C.E.",0
40,"40115",126,98,95,2,3,"U.C.E.",0
17,"17096",182,96,94,2,2,"U.C.E.",0
10,"10120",168,122,119,1,3,"U.C.E.",1
19,"19001",64,56,56,1,0,"U.C.E.",0
40,"40035",146,114,112,3,2,"U.C.E.",0
19,"19160",944,600,593,6,7,"U.C.E.",0
8,"8203",2442,1526,1498,34,28,"U.C.E.",1
37,"37166",206,172,171,3,1,"U.C.E.",0
47,"47196",43,29,29,0,0,"U.C.E.",0
12,"12077",4683,3476,3414,41,62,"U.C.E.",0
16,"16119",181,130,130,0,0,"U.C.E.",0
41,"41043",647,457,454,5,3,"U.C.E.",2
10,"10026",598,458,447,5,11,"U.C.E.",0
37,"37359",194,155,152,1,3,"U.C.E.",0
17,"17221",4135,2789,2723,49,66,"U.C.E.",2
24,"24145",656,420,420,11,0,"U.C.E.",0
8,"8227",2372,1591,1549,38,42,"U.C.E.",1
23,"23090",1371,1188,1177,6,11,"U.C.E.",2
39,"39098",1522,1256,1244,8,12,"U.C.E.",0
3,"3040",260,224,220,0,4,"U.C.E.",0
19,"19186",93,77,77,0,0,"U.C.E.",0
37,"37172",857,584,580,5,4,"U.C.E.",0
37,"37323",549,427,418,6,9,"U.C.E.",0
40,"40084",65,53,53,2,0,"U.C.E.",0
20,"20023",451,260,259,2,1,"U.C.E.",0
10,"10013",305,242,237,1,5,"U.C.E.",0
7,"7004",3669,2511,2453,51,58,"U.C.E.",1
18,"18181",253,183,182,0,1,"U.C.E.",0
24,"24025",331,237,237,5,0,"U.C.E.",1
47,"47145",658,482,473,7,9,"U.C.E.",0
44,"44118",183,129,127,2,2,"U.C.E.",0
16,"16065",454,380,374,4,6,"U.C.E.",1
41,"41019",4528,3194,3168,41,26,"U.C.E.",0
46,"46221",350,319,317,3,2,"U.C.E.",0
50,"50230",1295,914,903,13,11,"U.C.E.",1
47,"47189",164,134,134,1,0,"U.C.E.",0
26,"26127",236,206,204,1,2,"U.C.E.",0
5,"5069",91,79,78,1,1,"U.C.E.",0
18,"18182",1982,1405,1397,6,8,"U.C.E.",0
37,"37286",231,166,160,2,6,"U.C.E.",1
40,"40182",207,155,155,6,0,"U.C.E.",0
31,"31037",94,68,68,0,0,"U.C.E.",0
34,"34057",483,365,357,2,8,"U.C.E.",0
19,"19189",136,99,97,0,2,"U.C.E.",0
22,"22243",45,27,27,1,0,"U.C.E.",0
17,"17211",864,628,612,12,16,"U.C.E.",0
11,"11014",16318,11093,11031,144,62,"U.C.E.",4
45,"45170",257,186,183,0,3,"U.C.E.",0
24,"24055",747,557,549,11,8,"U.C.E.",0
44,"44093",86,64,64,3,0,"U.C.E.",0
5,"5116",131,114,109,0,5,"U.C.E.",0
18,"18039",3733,2901,2878,18,23,"U.C.E.",1
4,"4035",8213,6218,6171,51,47,"U.C.E.",2
42,"42108",13,10,10,1,0,"U.C.E.",0
24,"24107",316,208,206,1,2,"U.C.E.",0
46,"46223",7685,6040,5996,62,44,"U.C.E.",2
5,"5038",131,88,84,0,4,"U.C.E.",0
7,"7040",266127,162699,160491,2698,2208,"U.C.E.",178
50,"50184",132,106,106,1,0,"U.C.E.",0
33,"33064",237,175,173,1,2,"U.C.E.",0
22,"22227",225,172,168,3,4,"U.C.E.",0
42,"42162",2482,1871,1850,23,21,"U.C.E.",4
38,"38017",24438,13769,13576,176,193,"U.C.E.",11
26,"26174",154,122,122,2,0,"U.C.E.",0
18,"18049",632,476,474,5,2,"U.C.E.",1
8,"8272",148,97,96,6,1,"U.C.E.",0
8,"8201",458,305,298,12,7,"U.C.E.",0
34,"34159",375,275,264,8,11,"U.C.E.",0
46,"46135",9634,7671,7586,64,85,"U.C.E.",3
37,"37029",226,181,178,4,3,"U.C.E.",1
14,"14018",3795,3004,2970,24,34,"U.C.E.",0
8,"8098",2374,1552,1535,28,17,"U.C.E.",1
19,"19280",3415,2521,2490,27,31,"U.C.E.",1
18,"18050",1657,1209,1196,5,13,"U.C.E.",0
18,"18120",274,238,237,2,1,"U.C.E.",0
5,"5106",39,26,26,0,0,"U.C.E.",0
37,"37177",310,242,241,1,1,"U.C.E.",0
40,"40234",441,363,355,3,8,"U.C.E.",0
26,"26088",48,41,41,0,0,"U.C.E.",0
42,"42164",1699,1244,1209,13,35,"U.C.E.",3
37,"37254",189,168,164,1,4,"U.C.E.",0
16,"16087",229,193,187,4,6,"U.C.E.",0
8,"8304",822,587,578,16,9,"U.C.E.",0
10,"10142",822,635,625,4,10,"U.C.E.",1
26,"26132",130,98,96,2,2,"U.C.E.",0
40,"40203",814,643,631,14,12,"U.C.E.",1
42,"42130",70,55,54,2,1,"U.C.E.",0
37,"37016",539,424,420,8,4,"U.C.E.",0
31,"31011",688,437,432,17,5,"U.C.E.",0
34,"34192",103,75,74,1,1,"U.C.E.",0
5,"5204",654,521,516,7,5,"U.C.E.",0
16,"16157",229,187,182,2,5,"U.C.E.",0
31,"31153",2246,1504,1487,13,17,"U.C.E.",0
3,"3013",1144,941,926,5,15,"U.C.E.",1
24,"24020",480,326,324,9,2,"U.C.E.",0
45,"45167",1552,1296,1278,14,18,"U.C.E.",0
23,"23085",2350,1963,1956,8,7,"U.C.E.",1
40,"40143",97,72,72,0,0,"U.C.E.",0
45,"45094",441,358,353,6,5,"U.C.E.",0
37,"37167",164,140,132,6,8,"U.C.E.",0
40,"40190",50,41,40,1,1,"U.C.E.",0
30,"30003",23570,16482,16354,169,128,"U.C.E.",13
42,"42020",4385,3055,2957,74,98,"U.C.E.",5
31,"31123",652,379,373,8,6,"U.C.E.",0
8,"8141",4666,3124,3066,57,58,"U.C.E.",1
24,"24088",1103,903,885,4,18,"U.C.E.",0
19,"19270",17,16,16,0,0,"U.C.E.",0
24,"24100",760,563,553,14,10,"U.C.E.",0
37,"37009",225,189,185,2,4,"U.C.E.",0
36,"36059",5438,3874,3805,47,69,"U.C.E.",3
42,"42217",38,32,32,0,0,"U.C.E.",0
40,"40049",52,39,39,1,0,"U.C.E.",0
37,"37181",301,232,230,2,2,"U.C.E.",0
40,"40051",54,41,40,0,1,"U.C.E.",0
44,"44142",39,28,28,1,0,"U.C.E.",0
1,"1011",245,189,185,7,4,"U.C.E.",0
10,"10064",1549,1229,1209,6,20,"U.C.E.",0
10,"10187",486,349,345,2,4,"U.C.E.",0
8,"8216",21,14,14,0,0,"U.C.E.",0
40,"40005",34,32,31,1,1,"U.C.E.",0
26,"26138",4646,3468,3398,46,70,"U.C.E.",2
37,"37282",238,169,168,3,1,"U.C.E.",0
46,"46049",292,249,245,0,4,"U.C.E.",0
16,"16133",4466,3522,3453,51,69,"U.C.E.",3
30,"30031",560,471,469,3,2,"U.C.E.",1
26,"26123",129,113,113,1,0,"U.C.E.",1
39,"39051",73,62,62,2,0,"U.C.E.",2
19,"19196",99,80,74,2,6,"U.C.E.",0
34,"34152",142,114,109,1,5,"U.C.E.",0
10,"10147",1263,1003,965,5,38,"U.C.E.",4
47,"47069",128,108,108,0,0,"U.C.E.",0
42,"42024",95,80,73,1,7,"U.C.E.",1
47,"47170",40,30,30,0,0,"U.C.E.",0
12,"12108",495,394,389,4,5,"U.C.E.",0
22,"22082",320,231,229,1,2,"U.C.E.",0
47,"47207",325,265,263,4,2,"U.C.E.",0
16,"16036",143,117,115,1,2,"U.C.E.",0
7,"7048",15296,8559,8439,176,120,"U.C.E.",8
34,"34154",78,62,62,0,0,"U.C.E.",0
26,"26053",221,177,173,5,4,"U.C.E.",0
4,"4046",826,645,634,4,11,"U.C.E.",0
8,"8063",434,336,333,8,3,"U.C.E.",0
4,"4047",2290,1956,1937,9,19,"U.C.E.",0
40,"40195",946,722,707,13,15,"U.C.E.",1
19,"19263",34,27,27,0,0,"U.C.E.",0
16,"16094",142,112,111,1,1,"U.C.E.",0
8,"8064",1847,1277,1246,14,31,"U.C.E.",0
50,"50015",109,73,73,0,0,"U.C.E.",0
24,"24039",2157,1738,1727,30,11,"U.C.E.",0
10,"10068",780,624,595,5,29,"U.C.E.",0
8,"8145",2597,1823,1784,23,39,"U.C.E.",1
36,"36007",1778,1258,1238,2,20,"U.C.E.",0
18,"18127",15897,11597,11483,133,114,"U.C.E.",9
3,"3019",14914,12087,11927,137,160,"U.C.E.",10
45,"45038",3125,2401,2374,33,27,"U.C.E.",2
18,"18161",220,180,178,0,2,"U.C.E.",0
17,"17114",22610,14079,13811,263,268,"U.C.E.",4
33,"33070",3481,2557,2521,33,36,"U.C.E.",2
10,"10151",245,204,202,2,2,"U.C.E.",0
38,"38026",32174,24822,24431,283,391,"U.C.E.",12
20,"20072",4643,2967,2948,46,19,"U.C.E.",3
23,"23018",2415,1791,1781,9,10,"U.C.E.",2
50,"50164",407,271,268,4,3,"U.C.E.",0
8,"8156",10672,7359,7225,121,134,"U.C.E.",9
12,"12080",2051,1692,1650,23,42,"U.C.E.",1
50,"50074",6516,4378,4222,77,156,"U.C.E.",2
37,"37334",86,50,49,0,1,"U.C.E.",0
8,"8117",2424,1685,1661,45,24,"U.C.E.",1
46,"46053",584,484,461,2,23,"U.C.E.",0
10,"10166",351,246,238,2,8,"U.C.E.",0
15,"15001",4985,3560,3506,63,54,"U.C.E.",4
34,"34185",72,48,45,0,3,"U.C.E.",0
10,"10070",765,614,613,5,1,"U.C.E.",0
34,"34206",952,796,780,9,16,"U.C.E.",0
44,"44228",121,97,96,2,1,"U.C.E.",0
46,"46260",2576,2140,2106,24,34,"U.C.E.",0
15,"15077",8677,6349,6269,82,80,"U.C.E.",0
31,"31049",733,479,479,4,0,"U.C.E.",0
18,"18096",348,289,287,1,2,"U.C.E.",0
3,"3088",5381,4056,3988,47,68,"U.C.E.",2
22,"22001",242,177,173,2,4,"U.C.E.",0
45,"45151",631,474,470,1,4,"U.C.E.",0
33,"33049",6806,4629,4581,70,48,"U.C.E.",1
40,"40058",368,306,304,1,2,"U.C.E.",0
23,"23021",541,464,453,0,11,"U.C.E.",0
12,"12059",276,227,227,1,0,"U.C.E.",0
8,"8191",5520,3601,3536,64,65,"U.C.E.",5
41,"41097",3096,2489,2451,21,38,"U.C.E.",0
44,"44205",757,541,527,12,14,"U.C.E.",0
45,"45115",2600,2140,2105,14,35,"U.C.E.",4
45,"45005",267,223,218,4,5,"U.C.E.",0
37,"37127",229,183,182,3,1,"U.C.E.",1
50,"50047",60,34,34,2,0,"U.C.E.",0
11,"11038",13815,10849,10756,126,93,"U.C.E.",2
17,"17086",1687,1148,1129,14,19,"U.C.E.",0
50,"50251",8379,6225,6116,110,109,"U.C.E.",4
31,"31233",103,87,82,2,5,"U.C.E.",0
3,"3056",8929,6927,6776,74,151,"U.C.E.",7
18,"18063",1189,795,789,7,6,"U.C.E.",0
31,"31051",270,182,181,8,1,"U.C.E.",1
37,"37266",83,54,54,1,0,"U.C.E.",0
17,"17027",2865,1955,1892,34,63,"U.C.E.",1
44,"44231",54,38,36,2,2,"U.C.E.",0
17,"17057",1010,640,634,19,6,"U.C.E.",0
47,"47130",105,86,85,2,1,"U.C.E.",0
34,"34146",60,42,40,1,2,"U.C.E.",0
47,"47093",865,658,642,11,16,"U.C.E.",0
31,"31142",1443,906,899,16,7,"U.C.E.",0
37,"37304",190,144,142,1,2,"U.C.E.",0
5,"5245",344,285,284,5,1,"U.C.E.",1
47,"47184",575,447,443,6,4,"U.C.E.",0
18,"18033",282,227,226,0,1,"U.C.E.",0
41,"41049",8898,6881,6812,95,69,"U.C.E.",2
37,"37117",1320,948,937,16,11,"U.C.E.",1
42,"42216",27,22,22,0,0,"U.C.E.",0
1,"1010",2276,1649,1618,27,31,"U.C.E.",1
46,"46039",2200,1849,1820,12,29,"U.C.E.",0
45,"45106",7666,6045,5945,92,100,"U.C.E.",3
34,"34062",175,126,124,3,2,"U.C.E.",0
31,"31113",147,87,85,2,2,"U.C.E.",0
31,"31144",840,509,508,7,1,"U.C.E.",0
26,"26062",94,78,77,1,1,"U.C.E.",0
5,"5153",112,89,89,5,0,"U.C.E.",0
46,"46016",1097,927,917,12,10,"U.C.E.",0
10,"10009",285,223,221,0,2,"U.C.E.",0
35,"35011",23140,15550,15320,199,230,"U.C.E.",20
39,"39053",251,179,179,1,0,"U.C.E.",0
15,"15071",8233,5751,5668,93,83,"U.C.E.",0
8,"8245",78826,51185,50445,962,740,"U.C.E.",87
8,"8132",381,247,241,6,6,"U.C.E.",0
26,"26064",2341,1770,1749,26,21,"U.C.E.",0
39,"39061",3458,2673,2644,42,29,"U.C.E.",1
47,"47185",97,76,75,1,1,"U.C.E.",1
44,"44027",168,140,140,2,0,"U.C.E.",0
36,"36026",20494,14048,13798,232,250,"U.C.E.",8
15,"15081",1139,869,853,9,16,"U.C.E.",0
47,"47186",251279,193705,191693,2746,2012,"U.C.E.",113
39,"39062",1759,1397,1387,9,10,"U.C.E.",0
5,"5055",649,525,518,3,7,"U.C.E.",0
31,"31903",6058,3985,3919,67,66,"U.C.E.",7
18,"18136",1973,1679,1668,5,11,"U.C.E.",0
17,"17191",153,116,114,0,2,"U.C.E.",0
34,"34242",97,81,79,6,2,"U.C.E.",0
5,"5088",34,26,26,0,0,"U.C.E.",0
34,"34216",65,50,50,1,0,"U.C.E.",0
45,"45109",3030,2507,2417,30,90,"U.C.E.",2
42,"42037",38,23,20,3,3,"U.C.E.",0
47,"47187",101,82,81,1,1,"U.C.E.",0
3,"3061",1052,842,836,6,6,"U.C.E.",1
47,"47025",127,103,103,0,0,"U.C.E.",0
31,"31055",264,194,193,0,1,"U.C.E.",0
50,"50023",240,180,180,4,0,"U.C.E.",0
8,"8154",677,499,488,2,11,"U.C.E.",0
16,"16049",158,129,129,1,0,"U.C.E.",0
44,"44031",124,72,72,0,0,"U.C.E.",0
39,"39063",1018,769,762,6,7,"U.C.E.",0
40,"40208",828,650,638,7,12,"U.C.E.",0
45,"45122",4828,3816,3746,48,70,"U.C.E.",0
18,"18102",8556,6358,6272,42,86,"U.C.E.",0
50,"50171",126,90,89,4,1,"U.C.E.",0
44,"44198",205,160,160,5,0,"U.C.E.",0
5,"5186",1670,1306,1287,9,19,"U.C.E.",0
10,"10203",4770,3397,3327,40,70,"U.C.E.",3
16,"16107",161,101,98,1,3,"U.C.E.",1
30,"30015",18792,14453,14336,120,117,"U.C.E.",7
22,"22206",218,169,167,3,2,"U.C.E.",0
18,"18103",803,653,647,5,6,"U.C.E.",0
46,"46091",126,108,108,0,0,"U.C.E.",0
22,"22012",93,74,74,5,0,"U.C.E.",0
10,"10204",489,364,351,3,13,"U.C.E.",1
8,"8165",1689,1091,1070,18,21,"U.C.E.",1
39,"39030",1971,1397,1379,20,18,"U.C.E.",0
37,"37081",1000,807,800,5,7,"U.C.E.",0
19,"19309",37,32,31,0,1,"U.C.E.",0
4,"4022",375,296,295,0,1,"U.C.E.",0
8,"8136",11117,7602,7478,174,124,"U.C.E.",10
19,"19277",22,17,17,0,0,"U.C.E.",0
38,"38037",13166,8509,8332,65,177,"U.C.E.",10
37,"37197",101,72,70,1,2,"U.C.E.",0
12,"12131",92,78,78,1,0,"U.C.E.",0
37,"37124",227,181,179,3,2,"U.C.E.",0
45,"45124",2183,1868,1823,20,45,"U.C.E.",2
24,"24015",2391,1812,1782,20,30,"U.C.E.",3
18,"18038",1097,906,900,3,6,"U.C.E.",0
31,"31048",154,118,117,0,1,"U.C.E.",0
44,"44147",439,320,314,14,6,"U.C.E.",0
37,"37138",212,174,169,5,5,"U.C.E.",0
50,"50008",5110,3458,3406,56,52,"U.C.E.",4
24,"24016",544,323,322,4,1,"U.C.E.",0
50,"50268",59,46,46,3,0,"U.C.E.",0
22,"22226",823,640,627,11,13,"U.C.E.",0
26,"26070",203,179,177,3,2,"U.C.E.",0
18,"18174",470,368,363,1,5,"U.C.E.",0
10,"10085",334,244,243,1,1,"U.C.E.",1
18,"18909",668,536,534,2,2,"U.C.E.",0
42,"42193",17,10,10,0,0,"U.C.E.",0
39,"39040",4350,3413,3373,30,40,"U.C.E.",0
36,"36032",3666,2789,2755,25,34,"U.C.E.",3
3,"3135",228,185,181,0,4,"U.C.E.",1
46,"46166",8260,6422,6324,60,98,"U.C.E.",5
40,"40214",243,204,199,0,5,"U.C.E.",0
22,"22015",336,237,235,11,2,"U.C.E.",0
10,"10086",342,259,250,5,9,"U.C.E.",0
8,"8077",33925,23896,23548,381,348,"U.C.E.",27
34,"34222",122,94,94,2,0,"U.C.E.",0
4,"4024",3049,2396,2361,19,35,"U.C.E.",0
15,"15087",6054,4004,3956,79,48,"U.C.E.",4
47,"47139",1080,845,833,11,12,"U.C.E.",0
46,"46159",23111,17258,17086,141,172,"U.C.E.",11
16,"16030",28,24,24,0,0,"U.C.E.",0
30,"30902",7463,5291,5228,38,63,"U.C.E.",1
14,"14038",31501,23683,23394,336,289,"U.C.E.",12
38,"38006",35862,18726,18500,209,226,"U.C.E.",18
5,"5190",61,48,48,3,0,"U.C.E.",0
18,"18109",607,461,456,1,5,"U.C.E.",0
40,"40076",6641,4958,4862,67,96,"U.C.E.",8
3,"3001",359,296,292,2,4,"U.C.E.",0
1,"1039",211,164,158,1,6,"U.C.E.",1
23,"23039",2239,1799,1764,9,35,"U.C.E.",3
42,"42196",14,11,11,0,0,"U.C.E.",0
31,"31243",313,227,223,5,4,"U.C.E.",1
31,"31061",67,47,47,2,0,"U.C.E.",0
12,"12134",147,107,107,3,0,"U.C.E.",0
45,"45203",2535,1883,1829,21,54,"U.C.E.",0
18,"18144",779,592,590,3,2,"U.C.E.",0
26,"26148",189,151,150,0,1,"U.C.E.",0
44,"44064",93,63,62,0,1,"U.C.E.",0
5,"5096",74,56,56,0,0,"U.C.E.",0
5,"5029",132,102,102,0,0,"U.C.E.",0
22,"22164",46,32,32,0,0,"U.C.E.",0
37,"37317",323,281,278,3,3,"U.C.E.",0
31,"31122",4506,3333,3281,76,52,"U.C.E.",9
47,"47212",386,327,325,1,2,"U.C.E.",0
47,"47193",1538,1229,1211,23,18,"U.C.E.",0
23,"23041",519,455,448,2,7,"U.C.E.",0
18,"18111",2647,1957,1941,24,16,"U.C.E.",2
12,"12039",870,743,736,4,7,"U.C.E.",0
34,"34225",4837,3650,3580,73,70,"U.C.E.",1
44,"44207",187,147,146,5,1,"U.C.E.",1
18,"18100",7304,5807,5737,62,70,"U.C.E.",3
19,"19037",153,128,128,0,0,"U.C.E.",0
5,"5064",117,94,93,4,1,"U.C.E.",0
38,"38042",3876,2850,2809,24,41,"U.C.E.",0
8,"8080",42,33,33,2,0,"U.C.E.",0
45,"45131",327,262,258,1,4,"U.C.E.",0
5,"5054",1282,979,965,5,14,"U.C.E.",0
20,"20043",1782,1220,1214,13,6,"U.C.E.",0
26,"26023",505,386,380,6,6,"U.C.E.",0
46,"46137",273,232,229,1,3,"U.C.E.",0
12,"12064",118,91,89,1,2,"U.C.E.",0
8,"8235",3627,2506,2467,35,39,"U.C.E.",1
3,"3037",354,293,289,1,4,"U.C.E.",0
8,"8142",127,83,83,4,0,"U.C.E.",0
1,"1044",242,174,173,1,1,"U.C.E.",0
30,"30021",8550,6423,6349,44,74,"U.C.E.",2
16,"16263",936,730,719,8,11,"U.C.E.",0
8,"8081",332,232,225,2,7,"U.C.E.",0
18,"18112",132,90,90,1,0,"U.C.E.",0
37,"37206",100,81,80,1,1,"U.C.E.",0
16,"16118",1454,1221,1211,19,10,"U.C.E.",0
50,"50120",53,41,41,0,0,"U.C.E.",0
44,"44169",403,285,278,0,7,"U.C.E.",0
12,"12097",78,59,59,4,0,"U.C.E.",0
31,"31085",451,334,327,3,7,"U.C.E.",0
46,"46219",143,127,126,1,1,"U.C.E.",0
44,"44127",79,62,61,0,1,"U.C.E.",0
4,"4067",657,526,524,1,2,"U.C.E.",0
36,"36005",8231,5985,5873,84,112,"U.C.E.",7
47,"47144",85,65,65,2,0,"U.C.E.",0
37,"37133",108,79,77,0,2,"U.C.E.",0
45,"45060",204,151,148,1,3,"U.C.E.",0
46,"46244",57805,41885,41595,415,290,"U.C.E.",27
50,"50151",713,536,531,5,5,"U.C.E.",0
16,"16265",27,26,26,0,0,"U.C.E.",0
45,"45023",1936,1476,1456,18,20,"U.C.E.",0
50,"50293",492,339,338,6,1,"U.C.E.",0
37,"37321",169,144,144,1,0,"U.C.E.",0
42,"42205",99,70,70,0,0,"U.C.E.",0
12,"12009",17124,12273,12098,150,175,"U.C.E.",13
26,"26039",44,38,36,1,2,"U.C.E.",0
40,"40037",47,35,35,0,0,"U.C.E.",0
17,"17135",380,273,269,9,4,"U.C.E.",1
18,"18115",2380,1843,1823,14,20,"U.C.E.",0
18,"18082",912,691,683,8,8,"U.C.E.",0
12,"12109",700,564,555,7,9,"U.C.E.",0
23,"23091",790,668,664,3,4,"U.C.E.",0
47,"47035",956,778,768,5,10,"U.C.E.",0
42,"42012",43,29,29,1,0,"U.C.E.",0
10,"10176",384,300,293,5,7,"U.C.E.",1
3,"3008",176,142,140,1,2,"U.C.E.",0
10,"10217",535,423,422,3,1,"U.C.E.",0
31,"31220",771,584,572,9,12,"U.C.E.",1
12,"12130",425,348,344,2,4,"U.C.E.",0
8,"8085",1033,731,720,10,11,"U.C.E.",0
47,"47197",932,739,730,15,9,"U.C.E.",1
31,"31250",2887,1827,1802,20,25,"U.C.E.",4
37,"37209",376,258,253,4,5,"U.C.E.",0
37,"37324",415,338,334,2,4,"U.C.E.",0
34,"34184",54,37,36,0,1,"U.C.E.",0
22,"22072",209,130,128,2,2,"U.C.E.",0
10,"10097",109,97,96,0,1,"U.C.E.",0
18,"18116",2972,2237,2213,19,24,"U.C.E.",0
31,"31068",3004,2258,2207,43,51,"U.C.E.",1
40,"40228",539,446,437,2,9,"U.C.E.",1
22,"22025",1104,790,767,27,23,"U.C.E.",0
24,"24185",512,414,402,3,12,"U.C.E.",0
46,"46246",1081,917,904,5,13,"U.C.E.",0
45,"45113",2094,1589,1555,6,34,"U.C.E.",0
14,"14036",3774,2928,2909,51,19,"U.C.E.",2
50,"50093",113,84,84,2,0,"U.C.E.",0
40,"40074",271,221,218,3,3,"U.C.E.",0
50,"50174",107,92,90,0,2,"U.C.E.",0
3,"3010",330,269,266,3,3,"U.C.E.",0
18,"18117",535,444,440,2,4,"U.C.E.",0
37,"37212",123,95,92,1,3,"U.C.E.",0
16,"16084",49,36,35,0,1,"U.C.E.",0
50,"50183",369,277,274,5,3,"U.C.E.",0
37,"37327",191,148,148,9,0,"U.C.E.",0
50,"50124",474,375,367,11,8,"U.C.E.",0
5,"5169",241,218,218,0,0,"U.C.E.",0
19,"19006",873,634,620,1,14,"U.C.E.",1
5,"5233",246,212,212,2,0,"U.C.E.",0
37,"37288",252,194,194,3,0,"U.C.E.",1
8,"8179",591,415,405,6,10,"U.C.E.",1
41,"41073",1789,1292,1272,5,20,"U.C.E.",1
31,"31070",2706,1949,1912,34,37,"U.C.E.",1
38,"38050",2516,1765,1734,9,31,"U.C.E.",2
16,"16042",1286,1101,1089,8,12,"U.C.E.",0
17,"17105",257,152,146,4,6,"U.C.E.",0
18,"18119",1778,1401,1391,14,10,"U.C.E.",0
44,"44096",173,139,133,4,6,"U.C.E.",0
34,"34143",181,142,140,3,2,"U.C.E.",0
19,"19245",1222,954,943,10,11,"U.C.E.",0
14,"14028",333,279,277,1,2,"U.C.E.",0
47,"47148",475,389,384,2,5,"U.C.E.",0
44,"44135",149,110,109,1,1,"U.C.E.",0
17,"17016",725,491,481,8,10,"U.C.E.",0
8,"8242",243,174,172,5,2,"U.C.E.",0
34,"34101",54,44,44,0,0,"U.C.E.",0
3,"3012",1021,870,862,3,8,"U.C.E.",0
24,"24030",4397,3272,3229,54,43,"U.C.E.",1
46,"46248",4847,3655,3597,25,58,"U.C.E.",1
31,"31041",1397,938,913,26,25,"U.C.E.",0
46,"46200",1915,1625,1595,15,30,"U.C.E.",2
42,"42165",424,291,280,6,11,"U.C.E.",0
31,"31132",160,124,124,6,0,"U.C.E.",0
17,"17018",478,337,332,8,5,"U.C.E.",0
22,"22035",261,179,176,3,3,"U.C.E.",0
10,"10102",534,447,440,4,7,"U.C.E.",0
31,"31072",5098,3764,3698,75,66,"U.C.E.",5
5,"5235",136,120,119,2,1,"U.C.E.",0
10,"10103",480,385,380,3,5,"U.C.E.",0
18,"18121",135,109,109,0,0,"U.C.E.",0
41,"41066",1417,1121,1113,9,8,"U.C.E.",0
16,"16005",275,215,215,2,0,"U.C.E.",1
45,"45180",2714,2018,1980,19,38,"U.C.E.",1
17,"17079",62633,40844,40101,670,743,"U.C.E.",35
38,"38053",3752,2459,2397,28,62,"U.C.E.",5
19,"19226",40,31,30,0,1,"U.C.E.",0
19,"19330",93,81,81,2,0,"U.C.E.",0
26,"26120",1515,1215,1198,20,17,"U.C.E.",0
46,"46031",10580,7900,7809,87,91,"U.C.E.",6
42,"42062",36,23,22,0,1,"U.C.E.",0
44,"44051",2783,2144,2089,38,55,"U.C.E.",1
24,"24194",327,237,236,5,1,"U.C.E.",0
31,"31012",839,577,570,10,7,"U.C.E.",0
22,"22020",110,81,79,3,2,"U.C.E.",0
31,"31184",66,60,59,0,1,"U.C.E.",0
14,"14020",415,323,319,3,4,"U.C.E.",0
40,"40034",85,73,73,1,0,"U.C.E.",0
46,"46145",21751,16601,16397,155,204,"U.C.E.",6
42,"42021",101,70,70,1,0,"U.C.E.",0
34,"34149",26,18,18,0,0,"U.C.E.",0
3,"3015",12241,9734,9636,88,98,"U.C.E.",4
47,"47123",456,356,353,10,3,"U.C.E.",0
16,"16132",36,31,31,0,0,"U.C.E.",0
1,"1059",183468,127839,125801,1422,2038,"U.C.E.",240
30,"30030",305669,236235,234391,2112,1844,"U.C.E.",154
19,"19228",39,30,29,0,1,"U.C.E.",0
8,"8184",52133,33696,33220,656,476,"U.C.E.",57
37,"37294",11233,8282,8167,139,115,"U.C.E.",8
24,"24114",3441,2322,2304,42,18,"U.C.E.",0
17,"17111",789,584,574,15,10,"U.C.E.",0
22,"22170",622,439,430,13,9,"U.C.E.",1
3,"3005",7482,6191,6146,49,45,"U.C.E.",5
12,"12087",22,20,20,0,0,"U.C.E.",0
19,"19333",142,86,84,0,2,"U.C.E.",0
5,"5905",253,200,198,1,2,"U.C.E.",0
22,"22187",295,222,222,3,0,"U.C.E.",0
50,"50014",169,108,108,1,0,"U.C.E.",0
8,"8246",1714,1175,1153,27,22,"U.C.E.",0
15,"15073",21991,14686,14456,216,230,"U.C.E.",6
34,"34067",142,88,88,3,0,"U.C.E.",1
40,"40193",231,188,185,6,3,"U.C.E.",0
37,"37222",124,92,92,2,0,"U.C.E.",0
42,"42068",99,74,74,5,0,"U.C.E.",0
31,"31075",96,61,61,0,0,"U.C.E.",0
16,"16279",251,175,172,1,3,"U.C.E.",0
44,"44055",85,63,62,2,1,"U.C.E.",0
37,"37109",191,142,141,1,1,"U.C.E.",1
22,"22041",175,138,138,1,0,"U.C.E.",0
1,"1016",461,241,237,2,4,"U.C.E.",0
18,"18027",2575,1913,1899,15,14,"U.C.E.",0
4,"4079",45851,31893,31644,430,249,"U.C.E.",15
5,"5079",68,52,50,1,2,"U.C.E.",0
50,"50132",697,544,536,11,8,"U.C.E.",0
44,"44018",27,23,23,0,0,"U.C.E.",0
33,"33046",546,429,421,3,8,"U.C.E.",0
3,"3120",2329,1810,1785,16,25,"U.C.E.",4
30,"30032",2839,2361,2337,21,24,"U.C.E.",3
17,"17083",2886,1825,1801,39,24,"U.C.E.",1
31,"31077",5349,4025,3917,103,108,"U.C.E.",7
46,"46035",6470,5115,5047,38,68,"U.C.E.",0
46,"46245",478,357,354,1,3,"U.C.E.",3
37,"37067",2938,2306,2267,47,39,"U.C.E.",2
16,"16901",793,590,582,2,8,"U.C.E.",0
40,"40104",261,179,178,1,1,"U.C.E.",0
16,"16051",166,140,140,1,0,"U.C.E.",0
8,"8095",75,56,55,1,1,"U.C.E.",0
50,"50219",3704,2672,2625,39,47,"U.C.E.",0
44,"44146",185,160,159,8,1,"U.C.E.",0
44,"44059",571,446,434,10,12,"U.C.E.",0
42,"42071",186,104,103,3,1,"U.C.E.",0
46,"46108",550,446,444,3,2,"U.C.E.",0
19,"19127",97,66,66,1,0,"U.C.E.",0
19,"19129",48,33,31,0,2,"U.C.E.",0
3,"3020",108,87,86,1,1,"U.C.E.",0
50,"50220",59,43,43,1,0,"U.C.E.",0
19,"19232",89,68,67,0,1,"U.C.E.",1
8,"8015",155673,101652,100264,1628,1388,"U.C.E.",130
20,"20062",995,687,667,5,20,"U.C.E.",1
18,"18018",658,520,514,4,6,"U.C.E.",0
15,"15067",8142,6054,5978,73,76,"U.C.E.",3
30,"30034",1182,956,943,3,13,"U.C.E.",0
10,"10030",502,364,362,5,2,"U.C.E.",0
39,"39083",1214,785,775,7,10,"U.C.E.",0
44,"44148",98,77,77,3,0,"U.C.E.",0
1,"1019",155,124,124,0,0,"U.C.E.",0
34,"34208",62,52,52,2,0,"U.C.E.",0
16,"16014",659,534,528,8,6,"U.C.E.",1
12,"12058",99,74,74,0,0,"U.C.E.",0
50,"50221",38,20,20,0,0,"U.C.E.",0
34,"34902",146,121,121,1,0,"U.C.E.",0
3,"3021",5594,4630,4517,46,113,"U.C.E.",4
23,"23064",1680,1483,1478,8,5,"U.C.E.",0
33,"33072",1737,1171,1159,11,12,"U.C.E.",0
37,"37302",337,230,229,5,1,"U.C.E.",0
14,"14068",581,460,457,7,3,"U.C.E.",0
22,"22141",129,103,102,3,1,"U.C.E.",0
39,"39032",1576,1215,1209,10,6,"U.C.E.",0
42,"42178",144,105,104,3,1,"U.C.E.",0
50,"50136",617,469,462,4,7,"U.C.E.",0
47,"47210",396,324,321,5,3,"U.C.E.",0
42,"42078",1110,829,817,15,12,"U.C.E.",1
24,"24083",1165,831,819,17,12,"U.C.E.",1
46,"46183",5946,4718,4656,35,62,"U.C.E.",3
44,"44063",82,55,55,2,0,"U.C.E.",0
5,"5117",213,183,180,0,3,"U.C.E.",0
20,"20076",6978,4823,4762,38,61,"U.C.E.",3
31,"31171",738,521,495,7,26,"U.C.E.",0
14,"14008",2905,2226,2200,18,26,"U.C.E.",0
15,"15050",1971,1110,1097,27,13,"U.C.E.",0
10,"10073",759,589,583,3,6,"U.C.E.",0
46,"46233",3911,3025,2988,10,37,"U.C.E.",3
46,"46160",1976,1591,1570,21,21,"U.C.E.",1
22,"22089",329,246,237,8,9,"U.C.E.",1
31,"31112",106,79,78,0,1,"U.C.E.",0
50,"50137",1119,842,834,12,8,"U.C.E.",0
19,"19268",34,26,25,0,1,"U.C.E.",0
26,"26104",18,16,16,0,0,"U.C.E.",0
24,"24086",323,245,243,1,2,"U.C.E.",0
14,"14009",2864,2021,2003,8,18,"U.C.E.",0
22,"22048",12485,9146,9028,237,118,"U.C.E.",7
41,"41058",16497,12415,12248,181,167,"U.C.E.",6
39,"39086",386,282,280,1,2,"U.C.E.",0
8,"8018",2664,1707,1669,29,38,"U.C.E.",2
3,"3025",1252,1054,1044,4,10,"U.C.E.",0
22,"22004",146,97,97,2,0,"U.C.E.",4
41,"41084",2875,2362,2335,9,27,"U.C.E.",0
4,"4086",1903,1376,1371,11,5,"U.C.E.",0
37,"37217",60,49,48,1,1,"U.C.E.",0
34,"34121",208,153,152,0,1,"U.C.E.",0
44,"44153",1882,1273,1246,10,27,"U.C.E.",2
5,"5018",27,24,24,0,0,"U.C.E.",0
16,"16019",252,210,207,2,3,"U.C.E.",0
40,"40112",2346,1848,1798,35,50,"U.C.E.",1
31,"31083",50,37,37,0,0,"U.C.E.",0
18,"18135",4752,3252,3212,34,40,"U.C.E.",1
39,"39009",3200,2427,2402,24,25,"U.C.E.",0
44,"44141",147,99,95,0,4,"U.C.E.",1
37,"37269",475,383,382,2,1,"U.C.E.",0
40,"40205",292,221,220,2,1,"U.C.E.",0
10,"10118",306,262,261,2,1,"U.C.E.",0
41,"41085",3918,3173,3128,42,45,"U.C.E.",0
44,"44195",103,71,70,0,1,"U.C.E.",0
19,"19136",22,15,15,0,0,"U.C.E.",0
8,"8102",27850,18716,18470,373,246,"U.C.E.",29
23,"23071",1811,1444,1431,13,13,"U.C.E.",2
24,"24211",291,226,224,3,2,"U.C.E.",0
45,"45157",2097,1519,1499,15,20,"U.C.E.",1
31,"31084",1949,1369,1361,11,8,"U.C.E.",0
44,"44068",690,544,528,6,16,"U.C.E.",1
15,"15025",1173,780,777,10,3,"U.C.E.",1
46,"46114",565,501,495,3,6,"U.C.E.",0
8,"8287",1053,738,730,26,8,"U.C.E.",2
50,"50227",105,79,79,2,0,"U.C.E.",0
23,"23073",4671,3778,3735,19,43,"U.C.E.",2
24,"24170",2006,1410,1394,14,16,"U.C.E.",1
37,"37234",376,275,272,2,3,"U.C.E.",0
22,"22052",997,776,769,15,7,"U.C.E.",2
17,"17061",175,123,123,4,0,"U.C.E.",0
19,"19024",7736,5738,5646,82,92,"U.C.E.",1
24,"24090",366,225,224,2,1,"U.C.E.",1
47,"47215",60,52,52,2,0,"U.C.E.",0
42,"42085",219,167,167,2,0,"U.C.E.",0
41,"41061",2205,1798,1770,2,28,"U.C.E.",1
22,"22053",867,567,554,13,13,"U.C.E.",0
44,"44070",62,47,47,1,0,"U.C.E.",0
45,"45158",2577,1948,1909,18,39,"U.C.E.",0
50,"50228",295,238,236,10,2,"U.C.E.",1
17,"17002",567,413,401,4,12,"U.C.E.",0
45,"45159",100,84,84,1,0,"U.C.E.",0
18,"18907",1997,1627,1612,5,15,"U.C.E.",1
47,"47026",59,46,46,1,0,"U.C.E.",0
12,"12067",563,458,439,8,19,"U.C.E.",1
17,"17003",101,67,64,2,3,"U.C.E.",0
47,"47135",93,77,76,0,1,"U.C.E.",0
39,"39090",731,577,572,3,5,"U.C.E.",0
39,"39012",6666,5148,5061,43,87,"U.C.E.",2
46,"46043",149,139,139,0,0,"U.C.E.",0
41,"41088",542,414,408,1,6,"U.C.E.",0
37,"37123",206,166,165,1,1,"U.C.E.",0
10,"10123",601,502,492,0,10,"U.C.E.",0
8,"8198",4112,2766,2661,49,105,"U.C.E.",1
46,"46116",12587,9821,9724,120,97,"U.C.E.",8
15,"15028",1485,1130,1118,14,12,"U.C.E.",0
17,"17184",1281,803,787,21,16,"U.C.E.",0
44,"44200",41,30,30,0,0,"U.C.E.",0
18,"18105",5222,3866,3839,32,27,"U.C.E.",2
34,"34220",145,125,123,0,2,"U.C.E.",0
5,"5090",72,64,63,1,1,"U.C.E.",0
34,"34126",284,226,224,3,2,"U.C.E.",0
34,"34083",1888,1355,1338,15,17,"U.C.E.",0
45,"45161",11339,7989,7869,95,120,"U.C.E.",5
44,"44159",47,43,43,0,0,"U.C.E.",0
5,"5124",134,111,109,1,2,"U.C.E.",0
31,"31907",9914,7394,7282,198,112,"U.C.E.",9
37,"37003",134,103,102,0,1,"U.C.E.",0
23,"23077",668,523,518,2,5,"U.C.E.",0
10,"10192",910,679,670,3,9,"U.C.E.",0
35,"35015",9065,4859,4770,64,89,"U.C.E.",6
31,"31119",49,28,28,0,0,"U.C.E.",0
8,"8230",7452,5349,5286,94,63,"U.C.E.",4
5,"5221",398,298,297,10,1,"U.C.E.",0
37,"37199",157,115,113,0,2,"U.C.E.",0
4,"4093",1869,1341,1334,10,7,"U.C.E.",0
44,"44201",526,449,443,9,6,"U.C.E.",1
39,"39014",943,706,700,9,6,"U.C.E.",0
46,"46020",3793,3084,3046,21,38,"U.C.E.",1
12,"12071",1355,1069,1050,3,19,"U.C.E.",1
33,"33011",12085,7186,7116,89,70,"U.C.E.",4
47,"47138",259,198,195,3,3,"U.C.E.",0
15,"15030",201751,141022,138934,2981,2088,"U.C.E.",71
17,"17186",3593,2358,2317,33,41,"U.C.E.",2
19,"19311",87,60,60,0,0,"U.C.E.",0
45,"45163",8239,6203,6073,103,130,"U.C.E.",3
8,"8107",10955,7236,7130,151,106,"U.C.E.",3
18,"18108",892,674,673,2,1,"U.C.E.",0
44,"44077",80,62,62,1,0,"U.C.E.",0
17,"17128",309,232,224,5,8,"U.C.E.",0
34,"34130",228,187,186,6,1,"U.C.E.",0
19,"19070",100,74,74,0,0,"U.C.E.",0
30,"30901",10113,8265,8194,70,71,"U.C.E.",6
46,"46143",4278,3309,3266,46,43,"U.C.E.",3
36,"36033",12323,9328,9150,97,178,"U.C.E.",8
19,"19146",51,40,38,0,2,"U.C.E.",0
35,"35008",6151,4514,4419,59,95,"U.C.E.",6
37,"37353",142,119,119,2,0,"U.C.E.",0
20,"20015",1307,980,979,13,1,"U.C.E.",0
23,"23081",1643,1245,1234,12,11,"U.C.E.",2
45,"45164",191,160,158,0,2,"U.C.E.",0
22,"22060",1180,909,891,13,18,"U.C.E.",0
47,"47220",194,143,142,4,1,"U.C.E.",0
42,"42093",56,39,38,0,1,"U.C.E.",0
15,"15032",3639,2642,2586,35,56,"U.C.E.",2
26,"26118",64,58,56,0,2,"U.C.E.",1
24,"24098",1251,837,819,19,18,"U.C.E.",1
36,"36035",14551,10675,10469,160,206,"U.C.E.",11
16,"16255",159,123,122,3,1,"U.C.E.",1
34,"34224",53,42,41,0,1,"U.C.E.",0
17,"17097",185,136,136,4,0,"U.C.E.",0
22,"22062",189,126,125,2,1,"U.C.E.",0
37,"37242",99,73,72,0,1,"U.C.E.",0
17,"17008",3745,2262,2195,34,67,"U.C.E.",3
26,"26119",223,186,185,2,1,"U.C.E.",0
15,"15033",2581,2094,2079,15,15,"U.C.E.",0
45,"45057",222,197,189,0,8,"U.C.E.",0
46,"46047",551,479,469,10,10,"U.C.E.",0
12,"12105",866,679,673,6,6,"U.C.E.",0
5,"5226",92,67,67,0,0,"U.C.E.",0
34,"34178",106,93,93,1,0,"U.C.E.",0
50,"50087",31,25,25,0,0,"U.C.E.",0
24,"24222",13915,9939,9751,304,188,"U.C.E.",5
8,"8111",220,188,188,4,0,"U.C.E.",0
19,"19248",64,53,53,0,0,"U.C.E.",0
34,"34133",108,90,90,0,0,"U.C.E.",0
44,"44085",61,38,38,0,0,"U.C.E.",0
19,"19135",120,102,100,2,2,"U.C.E.",0
12,"12028",12115,9084,8992,137,92,"U.C.E.",2
44,"44208",32,23,23,1,0,"U.C.E.",0
45,"45058",409,334,332,2,2,"U.C.E.",0
37,"37244",132,97,95,5,2,"U.C.E.",0
10,"10091",391,327,324,3,3,"U.C.E.",0
3,"3139",21796,15501,15320,160,181,"U.C.E.",24
18,"18044",208,132,132,4,0,"U.C.E.",0
19,"19249",38,32,32,0,0,"U.C.E.",0
41,"41016",6950,5194,5120,45,74,"U.C.E.",1
11,"11022",48624,26656,26430,345,226,"U.C.E.",16
24,"24224",665,490,484,8,6,"U.C.E.",0
37,"37132",398,317,311,3,6,"U.C.E.",0
17,"17010",327,216,214,6,2,"U.C.E.",0
10,"10132",420,293,287,1,6,"U.C.E.",0
24,"24101",465,274,266,5,8,"U.C.E.",0
40,"40130",139,106,106,4,0,"U.C.E.",0
34,"34229",75,60,60,2,0,"U.C.E.",0
42,"42098",14,8,8,0,0,"U.C.E.",0
41,"41017",13878,10053,9926,130,127,"U.C.E.",3
15,"15035",11969,8239,8120,192,119,"U.C.E.",0
35,"35012",9662,5511,5446,45,65,"U.C.E.",5
22,"22066",699,479,464,8,15,"U.C.E.",0
26,"26124",860,705,694,3,11,"U.C.E.",0
31,"31004",36,21,20,0,1,"U.C.E.",0
42,"42100",31,31,31,0,0,"U.C.E.",0
10,"10012",615,525,520,4,5,"U.C.E.",0
19,"19250",25,23,22,0,1,"U.C.E.",0
31,"31095",83,70,70,1,0,"U.C.E.",0
19,"19152",674,505,498,2,7,"U.C.E.",0
46,"46250",574266,435877,431619,4626,4258,"U.C.E.",281
44,"44089",57,50,49,0,1,"U.C.E.",0
37,"37096",235,199,197,3,2,"U.C.E.",0
34,"34230",12,8,8,0,0,"U.C.E.",0
24,"24227",1664,1159,1148,16,11,"U.C.E.",0
37,"37012",155,124,120,1,4,"U.C.E.",1
24,"24064",1532,1128,1107,17,21,"U.C.E.",1
8,"8084",1134,789,760,14,29,"U.C.E.",1
18,"18046",1960,1327,1312,5,15,"U.C.E.",0
40,"40225",1152,931,918,10,13,"U.C.E.",1
45,"45135",4437,3621,3550,44,71,"U.C.E.",0
46,"46124",768,641,632,10,9,"U.C.E.",1
17,"17012",1093,689,679,11,10,"U.C.E.",0
10,"10136",289,229,228,0,1,"U.C.E.",0
3,"3903",2431,1991,1960,18,31,"U.C.E.",1
45,"45063",504,378,372,3,6,"U.C.E.",0
44,"44090",84,71,71,0,0,"U.C.E.",0
3,"3041",5811,4325,4269,33,56,"U.C.E.",8
31,"31098",1762,1285,1262,34,23,"U.C.E.",2
16,"16039",466,330,326,1,4,"U.C.E.",2
37,"37211",223,169,169,1,0,"U.C.E.",0
24,"24066",561,440,437,5,3,"U.C.E.",0
37,"37249",48,36,36,0,0,"U.C.E.",0
4,"4103",1555,1159,1157,8,2,"U.C.E.",0
44,"44213",60,48,48,0,0,"U.C.E.",0
31,"31189",1229,745,740,5,5,"U.C.E.",2
47,"47146",236,196,195,4,1,"U.C.E.",0
15,"15038",2363,1643,1610,29,33,"U.C.E.",0
18,"18150",6452,4666,4625,56,41,"U.C.E.",0
3,"3904",1416,1104,1096,11,8,"U.C.E.",0
37,"37351",305,261,258,2,3,"U.C.E.",0
46,"46052",532,471,463,2,8,"U.C.E.",0
8,"8240",9104,6355,6262,101,93,"U.C.E.",11
41,"41072",4083,3073,3046,12,27,"U.C.E.",0
10,"10139",117,98,97,1,1,"U.C.E.",0
39,"39022",985,735,734,5,1,"U.C.E.",0
31,"31008",97,64,63,1,1,"U.C.E.",0
19,"19156",1032,782,762,4,20,"U.C.E.",0
12,"12081",654,519,515,2,4,"U.C.E.",1
46,"46126",5471,4454,4392,53,62,"U.C.E.",1
24,"24230",450,333,327,4,6,"U.C.E.",0
22,"22074",311,227,219,5,8,"U.C.E.",0
31,"31222",67,46,44,3,2,"U.C.E.",0
1,"1003",1199,863,848,2,15,"U.C.E.",1
30,"30026",15165,10524,10369,80,155,"U.C.E.",7
41,"41021",20767,14040,13822,240,218,"U.C.E.",2
22,"22075",150,103,101,7,2,"U.C.E.",0
23,"23095",8882,6668,6628,31,40,"U.C.E.",2
47,"47227",62,52,52,1,0,"U.C.E.",0
37,"37213",97,77,76,0,1,"U.C.E.",0
1,"1054",959,680,675,8,5,"U.C.E.",0
8,"8302",9271,5981,5892,82,89,"U.C.E.",9
37,"37139",199,167,163,1,4,"U.C.E.",0
46,"46054",11422,8666,8566,82,100,"U.C.E.",10
10,"10018",1761,1321,1296,17,25,"U.C.E.",1
39,"39024",2065,1616,1601,8,15,"U.C.E.",0
4,"4073",389,289,286,4,3,"U.C.E.",1
26,"26005",2251,1602,1580,18,22,"U.C.E.",2
31,"31254",1956,1495,1476,16,19,"U.C.E.",3
22,"22228",501,382,369,15,13,"U.C.E.",0
10,"10141",289,209,209,0,0,"U.C.E.",0
19,"19224",119,95,94,0,1,"U.C.E.",0
31,"31010",5788,3716,3637,48,79,"U.C.E.",1
16,"16128",70,64,64,2,0,"U.C.E.",0
4,"4038",3140,2258,2231,44,27,"U.C.E.",0
47,"47228",481,385,383,3,2,"U.C.E.",0
47,"47122",2078,1697,1665,21,32,"U.C.E.",0
46,"46254",1085,847,834,12,13,"U.C.E.",0
16,"16044",51,35,35,0,0,"U.C.E.",0
31,"31193",1312,969,948,33,21,"U.C.E.",0
40,"40142",53,43,41,1,2,"U.C.E.",0
11,"11029",5360,3445,3423,27,22,"U.C.E.",1
42,"42115",72,48,48,0,0,"U.C.E.",1
5,"5075",100,76,76,1,0,"U.C.E.",1
18,"18051",1196,857,852,4,5,"U.C.E.",0
50,"50039",580,450,446,3,4,"U.C.E.",0
5,"5002",1996,1497,1476,15,21,"U.C.E.",1
40,"40094",375,286,284,4,2,"U.C.E.",0
41,"41023",7901,6050,5972,45,78,"U.C.E.",1
34,"34147",192,139,137,1,2,"U.C.E.",0
39,"39026",1825,1383,1371,12,12,"U.C.E.",0
42,"42116",63,50,48,3,2,"U.C.E.",0
37,"37368",18,15,15,1,0,"U.C.E.",0
44,"44100",200,147,146,0,1,"U.C.E.",1
37,"37255",58,47,47,3,0,"U.C.E.",0
50,"50244",215,155,155,6,0,"U.C.E.",0
5,"5042",156,126,126,0,0,"U.C.E.",0
10,"10104",5233,3904,3824,30,80,"U.C.E.",7
17,"17098",311,208,202,4,6,"U.C.E.",0
24,"24223",2793,2121,2113,63,8,"U.C.E.",0
45,"45181",2276,1788,1764,10,24,"U.C.E.",0
34,"34151",184,125,123,1,2,"U.C.E.",0
33,"33044",180964,129466,128346,1888,1120,"U.C.E.",34
5,"5109",438,359,351,5,8,"U.C.E.",0
8,"8306",509,330,324,6,6,"U.C.E.",0
8,"8215",2594,1763,1728,51,35,"U.C.E.",3
5,"5007",126,104,102,0,2,"U.C.E.",0
17,"17020",3446,2322,2268,45,54,"U.C.E.",0
37,"37369",143,103,103,0,0,"U.C.E.",1
7,"7012",1880,1437,1405,20,32,"U.C.E.",0
20,"20031",179,114,113,1,1,"U.C.E.",1
16,"16092",158,132,132,0,0,"U.C.E.",0
37,"37258",206,151,149,2,2,"U.C.E.",0
8,"8032",1955,1330,1294,18,36,"U.C.E.",0
44,"44016",541,384,379,5,5,"U.C.E.",0
15,"15017",18860,12975,12737,325,238,"U.C.E.",8
22,"22081",268,197,196,4,1,"U.C.E.",0
23,"23902",2495,2081,2067,4,14,"U.C.E.",0
44,"44182",216,173,173,4,0,"U.C.E.",0
44,"44054",125,97,97,2,0,"U.C.E.",0
50,"50131",243,185,183,6,2,"U.C.E.",1
5,"5078",128,112,111,2,1,"U.C.E.",0
18,"18025",326,242,238,0,4,"U.C.E.",0
34,"34027",1224,875,861,14,14,"U.C.E.",2
10,"10025",408,355,337,4,18,"U.C.E.",1
37,"37145",276,217,214,0,3,"U.C.E.",0
35,"35021",14982,9948,9749,138,199,"U.C.E.",9
47,"47152",94,65,65,0,0,"U.C.E.",0
19,"19334",50,37,37,0,0,"U.C.E.",0
3,"3119",15887,12128,11988,122,140,"U.C.E.",9
19,"19298",75,53,52,2,1,"U.C.E.",1
37,"37335",432,347,346,0,1,"U.C.E.",0
26,"26013",350,267,264,5,3,"U.C.E.",1
8,"8308",145,116,115,1,1,"U.C.E.",0
40,"40149",563,446,434,9,12,"U.C.E.",0
46,"46131",49087,37846,37477,422,369,"U.C.E.",18
8,"8278",4668,3033,2949,67,84,"U.C.E.",0
50,"50218",113,92,92,0,0,"U.C.E.",0
35,"35022",43892,27289,26876,326,413,"U.C.E.",38
10,"10149",434,323,319,1,4,"U.C.E.",1
45,"45074",428,349,343,3,6,"U.C.E.",0
47,"47070",33,30,30,1,0,"U.C.E.",0
15,"15046",6949,4641,4539,56,102,"U.C.E.",2
37,"37260",175,122,122,1,0,"U.C.E.",0
18,"18028",992,826,821,4,5,"U.C.E.",0
19,"19166",179,123,121,4,2,"U.C.E.",0
1,"1063",1803,1290,1284,18,6,"U.C.E.",2
1,"1017",910,629,621,17,8,"U.C.E.",0
46,"46059",1310,1076,1058,2,18,"U.C.E.",1
8,"8034",741,542,529,4,13,"U.C.E.",0
46,"46132",2124,1845,1817,14,28,"U.C.E.",1
50,"50073",2265,1773,1756,20,17,"U.C.E.",1
41,"41095",40097,27969,27731,354,238,"U.C.E.",14
45,"45186",3217,2573,2527,24,46,"U.C.E.",1
12,"12091",203,153,140,2,13,"U.C.E.",0
46,"46206",595,497,495,3,2,"U.C.E.",0
5,"5210",105,83,82,2,1,"U.C.E.",0
8,"8219",14647,10347,10169,193,178,"U.C.E.",2
5,"5114",1418,1195,1182,9,13,"U.C.E.",0
40,"40010",140,117,117,0,0,"U.C.E.",0
19,"19167",136,112,109,4,3,"U.C.E.",0
8,"8190",281,201,197,3,4,"U.C.E.",0
22,"22086",207,149,147,1,2,"U.C.E.",0
24,"24081",143,111,110,1,1,"U.C.E.",0
8,"8127",2274,1371,1338,23,33,"U.C.E.",0
12,"12092",143,98,98,0,0,"U.C.E.",0
37,"37028",175,130,125,1,5,"U.C.E.",0
31,"31079",99,64,63,0,1,"U.C.E.",0
24,"24120",379,258,256,3,2,"U.C.E.",0
5,"5211",484,406,405,3,1,"U.C.E.",0
26,"26144",196,163,162,2,1,"U.C.E.",0
33,"33026",9144,6019,5959,87,60,"U.C.E.",0
20,"20038",382,281,280,1,1,"U.C.E.",0
34,"34158",336,202,200,0,2,"U.C.E.",0
39,"39058",862,586,584,6,2,"U.C.E.",0
1,"1020",317,222,220,0,2,"U.C.E.",0
46,"46086",80,71,71,3,0,"U.C.E.",0
46,"46207",6453,5086,5031,52,55,"U.C.E.",1
44,"44149",106,79,78,2,1,"U.C.E.",0
23,"23065",1701,1238,1226,10,12,"U.C.E.",0
24,"24004",535,391,390,0,1,"U.C.E.",0
3,"3055",5128,4121,4076,43,45,"U.C.E.",1
19,"19169",51,35,35,0,0,"U.C.E.",0
41,"41030",527,436,429,6,7,"U.C.E.",0
24,"24122",1424,1001,992,9,9,"U.C.E.",0
19,"19132",105,79,79,0,0,"U.C.E.",0
15,"15078",78092,56506,55597,1110,909,"U.C.E.",26
8,"8017",2740,1800,1768,38,32,"U.C.E.",1
47,"47074",155,125,124,0,1,"U.C.E.",0
22,"22088",171,133,128,5,5,"U.C.E.",0
4,"4014",162,136,136,0,0,"U.C.E.",0
8,"8283",5862,3712,3618,72,94,"U.C.E.",2
50,"50223",956,751,745,14,6,"U.C.E.",0
47,"47022",62,54,54,0,0,"U.C.E.",0
41,"41098",4650,3665,3603,43,62,"U.C.E.",1
16,"16100",764,660,655,3,5,"U.C.E.",2
12,"12124",1902,1532,1499,15,33,"U.C.E.",0
45,"45153",1704,1376,1353,9,23,"U.C.E.",0
42,"42079",32,25,25,0,0,"U.C.E.",0
50,"50252",5345,3860,3792,79,68,"U.C.E.",1
8,"8130",95,63,62,3,1,"U.C.E.",0
37,"37267",210,169,165,0,4,"U.C.E.",0
40,"40016",63,45,45,0,0,"U.C.E.",0
5,"5118",91,66,66,0,0,"U.C.E.",0
22,"22247",31,21,20,1,1,"U.C.E.",0
15,"15051",4780,3333,3289,61,44,"U.C.E.",1
17,"17088",551,374,363,4,11,"U.C.E.",0
15,"15023",6629,4879,4795,52,84,"U.C.E.",3
8,"8100",1934,1437,1401,40,36,"U.C.E.",0
16,"16190",5151,4229,4144,52,85,"U.C.E.",2
23,"23070",4142,2877,2846,20,31,"U.C.E.",0
26,"26106",78,70,69,0,1,"U.C.E.",0
16,"16909",737,590,585,9,5,"U.C.E.",1
45,"45008",158,129,127,0,2,"U.C.E.",0
35,"35028",8810,4687,4603,71,84,"U.C.E.",1
7,"7022",11700,7512,7371,128,141,"U.C.E.",6
37,"37268",113,78,77,1,1,"U.C.E.",0
24,"24008",9789,7277,7179,110,98,"U.C.E.",1
44,"44113",79,57,55,0,2,"U.C.E.",0
18,"18122",16253,12271,12109,132,162,"U.C.E.",6
8,"8225",92,68,68,2,0,"U.C.E.",0
17,"17089",5486,3328,3288,43,40,"U.C.E.",2
37,"37033",86,64,63,1,1,"U.C.E.",0
17,"17029",198,136,133,1,3,"U.C.E.",0
41,"41100",1097,894,878,8,16,"U.C.E.",0
5,"5120",38,28,28,1,0,"U.C.E.",0
15,"15053",8164,5679,5592,60,87,"U.C.E.",4
45,"45194",57,41,41,0,0,"U.C.E.",0
10,"10160",235,183,183,1,0,"U.C.E.",0
16,"16061",1035,861,848,15,13,"U.C.E.",1
10,"10159",341,278,277,1,1,"U.C.E.",0
24,"24127",327,258,255,1,3,"U.C.E.",0
17,"17030",624,414,409,8,5,"U.C.E.",1
41,"41034",22561,16014,15840,270,174,"U.C.E.",8
19,"19239",99,74,73,1,1,"U.C.E.",0
4,"4089",805,607,597,1,10,"U.C.E.",0
19,"19240",64,47,46,1,1,"U.C.E.",0
16,"16022",102,76,76,2,0,"U.C.E.",0
12,"12065",181,155,155,0,0,"U.C.E.",0
10,"10038",98,84,83,0,1,"U.C.E.",0
34,"34123",1798,1479,1436,18,43,"U.C.E.",1
20,"20045",46542,30907,30536,425,371,"U.C.E.",46
4,"4019",269,210,209,3,1,"U.C.E.",0
44,"44116",96,68,65,3,3,"U.C.E.",1
22,"22099",532,411,408,6,3,"U.C.E.",0
24,"24130",468,343,337,6,6,"U.C.E.",1
50,"50902",97,85,85,1,0,"U.C.E.",0
24,"24011",244,131,129,0,2,"U.C.E.",0
50,"50256",90,59,59,1,0,"U.C.E.",0
7,"7025",457,355,346,3,9,"U.C.E.",0
26,"26026",1344,1108,1096,14,12,"U.C.E.",0
14,"14043",7664,5935,5874,53,61,"U.C.E.",2
26,"26110",178,149,147,3,2,"U.C.E.",1
3,"3131",181,161,157,1,4,"U.C.E.",0
37,"37036",74,54,52,0,2,"U.C.E.",0
19,"19064",97,84,83,1,1,"U.C.E.",0
46,"46212",1598,1233,1218,5,15,"U.C.E.",0
8,"8134",776,528,513,15,15,"U.C.E.",1
5,"5219",45,33,33,0,0,"U.C.E.",1
46,"46213",15621,11361,11164,214,197,"U.C.E.",8
8,"8135",6647,4753,4678,79,75,"U.C.E.",1
12,"12099",583,485,465,3,20,"U.C.E.",0
44,"44238",2475,1718,1692,50,26,"U.C.E.",3
24,"24132",683,440,435,5,5,"U.C.E.",0
33,"33032",12060,8627,8491,107,136,"U.C.E.",4
45,"45197",1972,1570,1538,8,32,"U.C.E.",0
44,"44239",29,25,25,1,0,"U.C.E.",0
39,"39038",1465,1065,1047,8,18,"U.C.E.",0
47,"47053",125,100,99,1,1,"U.C.E.",0
26,"26112",270,201,200,0,1,"U.C.E.",0
42,"42142",55,41,38,2,3,"U.C.E.",0
50,"50201",466,366,363,7,3,"U.C.E.",0
41,"41089",6394,4593,4526,57,67,"U.C.E.",9
5,"5024",268,205,201,2,4,"U.C.E.",0
46,"46214",15129,11609,11500,116,109,"U.C.E.",4
40,"40025",158,124,124,0,0,"U.C.E.",0
33,"33010",1922,1284,1277,14,7,"U.C.E.",0
3,"3031",39966,27099,26802,291,297,"U.C.E.",25
50,"50144",36,32,32,0,0,"U.C.E.",0
30,"30043",24501,19738,19416,230,322,"U.C.E.",19
18,"18071",5589,4268,4205,44,63,"U.C.E.",1
22,"22106",25,17,17,0,0,"U.C.E.",0
5,"5125",60,52,52,0,0,"U.C.E.",0
20,"20013",5331,3662,3637,33,25,"U.C.E.",2
50,"50231",285,231,224,7,7,"U.C.E.",0
8,"8046",12603,8826,8663,190,163,"U.C.E.",3
16,"16067",135,97,97,2,0,"U.C.E.",0
17,"17034",6723,4131,4064,77,67,"U.C.E.",1
31,"31028",217,129,128,1,1,"U.C.E.",0
46,"46069",166,149,148,1,1,"U.C.E.",0
42,"42145",140,111,111,2,0,"U.C.E.",0
5,"5025",108,86,86,2,0,"U.C.E.",0
8,"8138",4014,2735,2679,46,56,"U.C.E.",3
17,"17126",309,231,229,9,2,"U.C.E.",0
12,"12036",668,529,514,6,15,"U.C.E.",1
45,"45200",4633,3768,3672,37,96,"U.C.E.",0
26,"26160",684,538,528,5,10,"U.C.E.",0
40,"40170",1383,1091,1072,11,19,"U.C.E.",2
12,"12102",547,474,466,2,8,"U.C.E.",0
15,"15058",26931,19505,19196,471,309,"U.C.E.",2
8,"8108",4879,3475,3437,64,38,"U.C.E.",3
50,"50232",176,123,120,5,3,"U.C.E.",0
15,"15059",10658,7889,7728,125,161,"U.C.E.",3
12,"12072",1191,1007,977,17,30,"U.C.E.",0
50,"50146",211,168,167,4,1,"U.C.E.",0
26,"26032",58,52,52,1,0,"U.C.E.",0
26,"26162",116,94,93,2,1,"U.C.E.",0
16,"16070",35,29,29,0,0,"U.C.E.",0
50,"50261",246,199,199,4,0,"U.C.E.",0
50,"50176",237,161,160,4,1,"U.C.E.",0
37,"37165",27,20,20,1,0,"U.C.E.",0
31,"31121",79,53,52,2,1,"U.C.E.",0
24,"24018",180,150,149,1,1,"U.C.E.",0
10,"10046",216,185,184,1,1,"U.C.E.",0
5,"5027",290,233,230,2,3,"U.C.E.",0
37,"37042",45,35,35,1,0,"U.C.E.",0
34,"34048",72,58,56,3,2,"U.C.E.",0
34,"34131",67,57,56,0,1,"U.C.E.",0
45,"45165",62818,47242,46629,549,613,"U.C.E.",29
22,"22061",6611,4789,4698,110,91,"U.C.E.",5
37,"37354",4828,3589,3522,76,67,"U.C.E.",3
50,"50177",355,268,265,4,3,"U.C.E.",0
39,"39042",5928,4680,4634,44,46,"U.C.E.",1
34,"34049",421,313,311,4,2,"U.C.E.",0
26,"26034",678,526,510,3,16,"U.C.E.",0
17,"17037",105,66,66,2,0,"U.C.E.",0
17,"17217",347,267,251,5,16,"U.C.E.",0
19,"19182",38,24,22,0,2,"U.C.E.",0
24,"24141",101,83,80,6,3,"U.C.E.",0
45,"45204",621,500,497,1,3,"U.C.E.",1
46,"46193",8494,6662,6580,73,82,"U.C.E.",3
45,"45166",1734,1460,1429,8,31,"U.C.E.",0
39,"39095",2292,1824,1801,24,23,"U.C.E.",1
15,"15089",4354,3255,3216,55,39,"U.C.E.",3
12,"12005",8066,5835,5441,116,394,"U.C.E.",5
8,"8234",3143,2040,2008,45,32,"U.C.E.",0
24,"24142",24843,17695,17371,409,324,"U.C.E.",11
34,"34050",216,170,166,1,4,"U.C.E.",0
24,"24021",1791,1251,1228,14,23,"U.C.E.",1
40,"40017",103,89,88,2,1,"U.C.E.",0
16,"16033",1792,1485,1454,10,31,"U.C.E.",1
36,"36004",10264,7383,7263,80,120,"U.C.E.",4
44,"44126",344,250,236,1,14,"U.C.E.",0
5,"5227",409,307,305,2,2,"U.C.E.",0
5,"5194",147,131,130,4,1,"U.C.E.",0
46,"46072",3711,3006,2932,38,74,"U.C.E.",1
47,"47168",32,29,28,1,1,"U.C.E.",0
37,"37169",196,137,136,1,1,"U.C.E.",0
31,"31216",3911,2699,2653,82,46,"U.C.E.",3
24,"24143",515,376,373,6,3,"U.C.E.",0
17,"17039",1850,1299,1275,31,24,"U.C.E.",1
22,"22114",137,94,94,4,0,"U.C.E.",0
50,"50004",613,445,441,6,4,"U.C.E.",0
7,"7034",971,724,708,10,16,"U.C.E.",0
34,"34052",187,147,147,1,0,"U.C.E.",1
10,"10173",557,436,431,6,5,"U.C.E.",1
34,"34010",560,458,451,7,7,"U.C.E.",1
42,"42156",30,21,21,0,0,"U.C.E.",0
5,"5034",17,13,13,0,0,"U.C.E.",0
10,"10051",489,373,373,2,0,"U.C.E.",2
12,"12076",105,79,79,0,0,"U.C.E.",0
47,"47008",26,17,17,0,0,"U.C.E.",0
46,"46195",1975,1631,1631,33,0,"U.C.E.",1
22,"22022",582,448,438,12,10,"U.C.E.",0
36,"36039",14581,11007,10782,167,225,"U.C.E.",13
50,"50180",111,91,89,3,2,"U.C.E.",0
40,"40036",531,440,424,10,16,"U.C.E.",1
5,"5229",90,79,77,2,2,"U.C.E.",0
46,"46074",2656,2071,2053,22,18,"U.C.E.",1
31,"31035",60,47,47,0,0,"U.C.E.",1
31,"31126",372,247,244,6,3,"U.C.E.",0
8,"8237",1692,1155,1127,22,28,"U.C.E.",3
31,"31187",122,68,68,2,0,"U.C.E.",0
19,"19153",25,17,17,0,0,"U.C.E.",0
46,"46220",48981,34657,34242,450,415,"U.C.E.",10
14,"14054",13632,10857,10652,194,205,"U.C.E.",5
22,"22222",510,367,365,6,2,"U.C.E.",0
39,"39046",1442,1071,1050,13,21,"U.C.E.",0
44,"44044",103,79,78,0,1,"U.C.E.",0
31,"31005",312,209,206,4,3,"U.C.E.",0
31,"31097",10461,7152,7029,129,123,"U.C.E.",7
38,"38013",2823,1856,1843,18,13,"U.C.E.",0
31,"31036",957,631,616,22,15,"U.C.E.",2
3,"3074",1752,1479,1466,5,13,"U.C.E.",0
19,"19187",64,54,54,0,0,"U.C.E.",0
23,"23003",8778,6945,6877,51,68,"U.C.E.",3
44,"44006",293,220,212,3,8,"U.C.E.",0
16,"16212",286,229,226,3,3,"U.C.E.",0
10,"10055",709,523,508,13,15,"U.C.E.",1
46,"46075",166,148,145,3,3,"U.C.E.",0
22,"22069",436,317,315,5,2,"U.C.E.",0
24,"24228",732,543,529,4,14,"U.C.E.",0
38,"38015",4326,3132,3099,21,33,"U.C.E.",2
1,"1001",2010,1362,1336,26,26,"U.C.E.",5
20,"20060",92,83,82,0,1,"U.C.E.",0
37,"37173",1643,1298,1285,26,13,"U.C.E.",1
50,"50267",648,450,441,8,9,"U.C.E.",0
4,"4034",152,106,105,1,1,"U.C.E.",0
10,"10056",605,484,476,5,8,"U.C.E.",0
46,"46003",988,864,847,13,17,"U.C.E.",0
24,"24106",340,229,228,6,1,"U.C.E.",0
17,"17014",64,39,37,0,2,"U.C.E.",0
46,"46222",378,321,310,1,11,"U.C.E.",0
31,"31099",68,50,50,0,0,"U.C.E.",0
22,"22122",62,57,57,3,0,"U.C.E.",0
37,"37287",341,247,246,1,1,"U.C.E.",1
12,"12011",4663,3578,3525,28,53,"U.C.E.",1
18,"18084",3954,3039,3015,50,24,"U.C.E.",0
8,"8147",17023,11177,10961,184,216,"U.C.E.",12
10,"10179",340,262,257,3,5,"U.C.E.",0
44,"44258",75,56,55,0,1,"U.C.E.",1
40,"40184",269,227,224,4,3,"U.C.E.",1
17,"17167",2818,1886,1858,52,28,"U.C.E.",0
42,"42209",155,114,110,2,4,"U.C.E.",0
47,"47147",129,96,96,0,0,"U.C.E.",0
44,"44009",805,608,595,18,13,"U.C.E.",0
17,"17138",1010,677,662,3,15,"U.C.E.",2
44,"44133",21,16,16,0,0,"U.C.E.",0
17,"17044",6619,4293,4187,69,106,"U.C.E.",1
7,"7008",5422,3782,3705,61,77,"U.C.E.",5
31,"31191",2930,2194,2148,43,46,"U.C.E.",5
47,"47091",97,82,80,3,2,"U.C.E.",0
40,"40233",457,350,348,1,2,"U.C.E.",0
5,"5040",77,59,59,1,0,"U.C.E.",0
31,"31100",298,193,193,2,0,"U.C.E.",0
26,"26175",57,46,45,1,1,"U.C.E.",0
50,"50155",119,91,91,1,0,"U.C.E.",0
12,"12113",100,72,72,0,0,"U.C.E.",0
44,"44261",777,600,594,8,6,"U.C.E.",0
19,"19159",108,91,88,1,3,"U.C.E.",0
26,"26046",1617,1237,1219,14,18,"U.C.E.",1
30,"30001",4763,3992,3956,26,36,"U.C.E.",3
37,"37178",107,88,87,0,1,"U.C.E.",0
44,"44262",141,114,113,2,1,"U.C.E.",0
42,"42018",178,129,124,0,5,"U.C.E.",0
31,"31101",1305,892,874,15,18,"U.C.E.",0
18,"18152",1037,822,818,9,4,"U.C.E.",0
7,"7042",10393,6536,6421,96,115,"U.C.E.",6
44,"44219",207,159,157,1,2,"U.C.E.",0
45,"45068",164,135,133,1,2,"U.C.E.",0
30,"30002",9802,7628,7553,48,75,"U.C.E.",1
17,"17047",4803,2866,2803,30,63,"U.C.E.",4
12,"12014",191,139,137,4,2,"U.C.E.",0
19,"19192",1743,1370,1359,10,11,"U.C.E.",0
8,"8059",323,189,186,9,3,"U.C.E.",0
23,"23098",923,808,807,6,1,"U.C.E.",0
8,"8150",245,181,178,11,3,"U.C.E.",0
26,"26177",322,276,274,2,2,"U.C.E.",0
5,"5172",147,122,122,0,0,"U.C.E.",1
3,"3080",1288,1116,1103,6,13,"U.C.E.",2
40,"40048",40,30,30,0,0,"U.C.E.",0
23,"23010",14447,10777,10704,109,73,"U.C.E.",6
17,"17048",6176,3818,3773,52,45,"U.C.E.",3
36,"36013",2690,1801,1778,11,23,"U.C.E.",0
31,"31133",48,34,34,3,0,"U.C.E.",0
34,"34196",94,74,73,1,1,"U.C.E.",0
50,"50098",215,150,146,2,4,"U.C.E.",0
24,"24113",404,318,310,3,8,"U.C.E.",1
40,"40003",144,123,120,1,3,"U.C.E.",0
5,"5130",95,76,76,0,0,"U.C.E.",0
10,"10063",175,142,142,1,0,"U.C.E.",0
24,"24033",214,157,152,3,5,"U.C.E.",0
4,"4043",520,439,435,3,4,"U.C.E.",1
44,"44101",60,47,47,1,0,"U.C.E.",0
46,"46008",2727,2249,2233,17,16,"U.C.E.",2
22,"22129",193,124,123,4,1,"U.C.E.",0
19,"19194",113,80,76,1,4,"U.C.E.",0
26,"26180",243,185,181,4,4,"U.C.E.",1
24,"24034",3434,2524,2481,37,43,"U.C.E.",5
14,"14062",1114,889,882,9,7,"U.C.E.",0
5,"5238",815,649,641,6,8,"U.C.E.",0
37,"37061",254,187,185,0,2,"U.C.E.",0
15,"15044",1436,1083,1068,10,15,"U.C.E.",0
37,"37257",52,43,43,0,0,"U.C.E.",0
50,"50161",124,86,86,1,0,"U.C.E.",0
10,"10024",663,490,480,3,10,"U.C.E.",1
17,"17050",645,438,425,15,13,"U.C.E.",0
16,"16008",131,89,88,2,1,"U.C.E.",0
46,"46106",1616,1196,1188,6,8,"U.C.E.",1
50,"50071",134,97,96,0,1,"U.C.E.",0
26,"26139",68,55,55,4,0,"U.C.E.",0
7,"7046",13748,8294,8183,183,111,"U.C.E.",11
34,"34201",212,178,172,1,6,"U.C.E.",0
46,"46257",5579,4546,4512,32,34,"U.C.E.",0
44,"44143",382,292,292,5,0,"U.C.E.",0
47,"47178",190,162,161,1,1,"U.C.E.",0
38,"38023",118865,76393,75039,928,1354,"U.C.E.",114
47,"47017",205,177,176,1,1,"U.C.E.",0
37,"37183",425,321,316,3,5,"U.C.E.",1
5,"5010",173,141,134,2,7,"U.C.E.",0
24,"24159",1901,1492,1477,11,15,"U.C.E.",2
46,"46034",1791,1477,1468,8,9,"U.C.E.",0
42,"42120",148,91,91,4,0,"U.C.E.",0
15,"15074",4254,3246,3219,35,27,"U.C.E.",0
17,"17051",201,146,142,4,4,"U.C.E.",1
44,"44144",326,233,227,7,6,"U.C.E.",1
31,"31045",501,384,377,16,7,"U.C.E.",0
50,"50190",751,576,565,7,11,"U.C.E.",3
8,"8155",6573,4411,4334,85,77,"U.C.E.",8
19,"19197",29,19,19,0,0,"U.C.E.",0
47,"47126",49,43,42,1,1,"U.C.E.",0
31,"31076",2314,1843,1823,39,20,"U.C.E.",2
24,"24160",741,545,539,17,6,"U.C.E.",0
42,"42026",25,16,16,0,0,"U.C.E.",0
47,"47018",33,30,28,2,2,"U.C.E.",0
31,"31016",7377,5149,5072,101,77,"U.C.E.",7
19,"19198",22,19,19,0,0,"U.C.E.",0
18,"18059",4055,3232,3191,37,41,"U.C.E.",0
31,"31260",1263,788,780,11,8,"U.C.E.",0
42,"42175",28,19,19,0,0,"U.C.E.",0
18,"18095",1916,1428,1306,21,122,"U.C.E.",0
16,"16181",73,62,62,1,0,"U.C.E.",1
12,"12120",218,180,177,0,3,"U.C.E.",0
34,"34205",70,55,55,1,0,"U.C.E.",0
17,"17052",134,84,83,2,1,"U.C.E.",0
45,"45002",2500,1771,1756,26,15,"U.C.E.",2
16,"16236",964,762,758,10,4,"U.C.E.",0
8,"8157",8256,5729,5624,119,105,"U.C.E.",5
19,"19096",99,79,78,1,1,"U.C.E.",1
5,"5047",4267,3345,3275,34,70,"U.C.E.",4
8,"8250",7083,4485,4426,72,59,"U.C.E.",4
37,"37300",586,430,421,6,9,"U.C.E.",0
19,"19199",24,21,21,0,0,"U.C.E.",0
46,"46230",14204,10650,10515,112,135,"U.C.E.",8
12,"12121",1197,1050,1020,4,30,"U.C.E.",0
5,"5242",692,556,553,18,3,"U.C.E.",0
10,"10193",1410,1179,1158,16,21,"U.C.E.",0
40,"40057",1522,1272,1260,19,12,"U.C.E.",1
47,"47099",174,153,153,4,0,"U.C.E.",0
46,"46134",2326,1691,1664,20,27,"U.C.E.",2
37,"37187",567,449,448,3,1,"U.C.E.",1
10,"10071",179,133,133,1,0,"U.C.E.",0
47,"47181",170,128,128,1,0,"U.C.E.",0
46,"46012",930,698,684,9,14,"U.C.E.",1
20,"20074",11660,8003,7951,31,52,"U.C.E.",5
50,"50018",973,761,755,12,6,"U.C.E.",1
4,"4083",1933,1511,1497,16,14,"U.C.E.",1
8,"8097",985,676,657,3,19,"U.C.E.",0
39,"39006",1732,1381,1373,23,8,"U.C.E.",0
41,"41056",3697,3041,3008,25,33,"U.C.E.",1
19,"19234",63,48,48,0,0,"U.C.E.",0
18,"18062",9418,6916,6835,62,81,"U.C.E.",2
24,"24042",79,68,68,0,0,"U.C.E.",0
47,"47100",169,146,144,1,2,"U.C.E.",0
34,"34210",103,93,91,2,2,"U.C.E.",0
7,"7052",4578,2671,2651,46,20,"U.C.E.",5
47,"47182",1371,991,982,12,9,"U.C.E.",0
37,"37265",224,192,191,1,1,"U.C.E.",0
18,"18133",2256,1783,1773,12,10,"U.C.E.",0
16,"16187",78,61,60,3,1,"U.C.E.",0
46,"46013",16111,12469,12328,145,141,"U.C.E.",10
18,"18098",6440,4743,4679,44,64,"U.C.E.",2
5,"5051",194,165,154,0,11,"U.C.E.",1
47,"47157",544,462,458,9,4,"U.C.E.",1
31,"31111",100,75,75,1,0,"U.C.E.",0
8,"8222",1827,1343,1317,21,26,"U.C.E.",4
1,"1022",826,615,602,6,13,"U.C.E.",0
10,"10033",440,340,336,4,4,"U.C.E.",0
7,"7020",3455,2491,2453,46,38,"U.C.E.",1
5,"5016",6231,4831,4763,56,68,"U.C.E.",4
12,"12125",235,203,201,1,2,"U.C.E.",0
19,"19099",337,211,210,6,1,"U.C.E.",1
47,"47101",1740,1458,1444,12,14,"U.C.E.",2
30,"30011",4687,3776,3726,20,50,"U.C.E.",1
8,"8160",313,227,222,8,5,"U.C.E.",0
50,"50107",953,785,780,13,5,"U.C.E.",0
19,"19202",16,14,14,0,0,"U.C.E.",0
37,"37191",127,86,85,1,1,"U.C.E.",0
18,"18099",1551,1217,1205,11,12,"U.C.E.",0
19,"19304",235,169,166,1,3,"U.C.E.",0
46,"46161",1454,1192,1179,8,13,"U.C.E.",1
10,"10076",825,619,610,7,9,"U.C.E.",1
24,"24209",3016,2006,1984,20,22,"U.C.E.",0
15,"15052",4567,3539,3493,22,46,"U.C.E.",0
22,"22094",109,76,74,5,2,"U.C.E.",0
20,"20005",1341,890,885,4,5,"U.C.E.",1
44,"44152",62,50,50,3,0,"U.C.E.",0
50,"50196",110,87,86,4,1,"U.C.E.",0
24,"24047",856,623,612,5,11,"U.C.E.",0
22,"22149",321,244,241,5,3,"U.C.E.",0
46,"46234",388,308,307,3,1,"U.C.E.",0
10,"10077",719,551,543,3,8,"U.C.E.",0
18,"18066",2072,1558,1552,8,6,"U.C.E.",1
37,"37074",172,136,135,1,1,"U.C.E.",0
45,"45083",421,353,345,0,8,"U.C.E.",0
34,"34077",283,219,216,3,3,"U.C.E.",0
34,"34215",166,146,145,1,1,"U.C.E.",0
16,"16244",735,615,606,3,9,"U.C.E.",0
19,"19103",303,247,244,3,3,"U.C.E.",1
16,"16103",310,263,259,4,4,"U.C.E.",0
12,"12029",760,619,601,7,18,"U.C.E.",0
24,"24169",3205,2317,2282,33,35,"U.C.E.",1
50,"50282",88,66,63,3,3,"U.C.E.",0
31,"31145",173,129,127,2,2,"U.C.E.",0
3,"3094",8442,6105,6053,70,52,"U.C.E.",4
46,"46235",21966,16641,16465,167,176,"U.C.E.",7
31,"31054",498,310,308,1,2,"U.C.E.",0
37,"37270",201,159,158,0,1,"U.C.E.",0
50,"50255",219,150,148,1,2,"U.C.E.",0
3,"3027",150,131,130,1,1,"U.C.E.",0
44,"44197",60,37,37,1,0,"U.C.E.",0
50,"50140",172,108,108,1,0,"U.C.E.",0
42,"42188",64,51,51,0,0,"U.C.E.",0
3,"3095",4498,3558,3517,29,41,"U.C.E.",3
18,"18004",818,601,594,2,7,"U.C.E.",0
4,"4056",144,118,118,0,0,"U.C.E.",0
40,"40069",87,76,75,0,1,"U.C.E.",0
8,"8073",60247,41448,40843,770,605,"U.C.E.",87
26,"26066",277,229,228,9,1,"U.C.E.",0
5,"5251",80,58,58,0,0,"U.C.E.",0
8,"8164",873,606,584,13,22,"U.C.E.",1
19,"19307",30,27,27,0,0,"U.C.E.",0
37,"37195",48,32,32,0,0,"U.C.E.",0
50,"50024",652,541,531,8,10,"U.C.E.",0
19,"19105",2235,1709,1686,23,23,"U.C.E.",0
41,"41102",14343,11050,10837,206,213,"U.C.E.",2
39,"39037",2061,1609,1586,10,23,"U.C.E.",0
19,"19308",67,61,61,0,0,"U.C.E.",0
26,"26067",22,19,19,1,0,"U.C.E.",0
4,"4057",1454,1081,1071,1,10,"U.C.E.",1
50,"50200",534,436,432,9,4,"U.C.E.",0
39,"39064",1339,1072,1066,7,6,"U.C.E.",0
50,"50285",635,452,445,8,7,"U.C.E.",0
46,"46018",689,597,592,12,5,"U.C.E.",1
36,"36029",16178,11902,11636,148,266,"U.C.E.",7
24,"24172",491,234,232,2,2,"U.C.E.",0
31,"31147",103,81,80,3,1,"U.C.E.",0
19,"19211",450,340,334,0,6,"U.C.E.",0
41,"41062",2252,1719,1698,12,21,"U.C.E.",0
1,"1033",679,537,532,2,5,"U.C.E.",0
46,"46164",11634,8843,8724,90,119,"U.C.E.",8
10,"10041",1070,850,846,8,4,"U.C.E.",0
50,"50173",175,104,104,2,0,"U.C.E.",0
20,"20903",3625,2282,2267,52,15,"U.C.E.",2
16,"16249",2076,1728,1700,11,28,"U.C.E.",0
18,"18173",8858,6238,6187,64,51,"U.C.E.",1
10,"10205",2081,1486,1457,19,29,"U.C.E.",2
5,"5157",256,187,183,0,4,"U.C.E.",0
22,"22013",304,239,236,3,3,"U.C.E.",0
12,"12101",385,309,296,3,13,"U.C.E.",0
10,"10042",79,63,62,2,1,"U.C.E.",0
50,"50143",608,427,424,5,3,"U.C.E.",0
31,"31058",240,184,179,0,5,"U.C.E.",0
34,"34127",118,77,74,1,3,"U.C.E.",0
16,"16153",1006,856,843,8,13,"U.C.E.",0
19,"19067",91,59,59,0,0,"U.C.E.",0
39,"39039",648,496,493,0,3,"U.C.E.",0
35,"35033",6415,4394,4302,51,92,"U.C.E.",2
17,"17157",127,99,98,3,1,"U.C.E.",0
8,"8076",15925,10435,10242,179,193,"U.C.E.",20
37,"37083",190,165,165,3,0,"U.C.E.",0
31,"31059",204,140,139,3,1,"U.C.E.",0
50,"50202",182,125,122,2,3,"U.C.E.",0
15,"15086",3110,2281,2259,30,22,"U.C.E.",1
50,"50027",260,209,202,2,7,"U.C.E.",0
8,"8168",418,268,266,0,2,"U.C.E.",0
24,"24175",1760,1324,1303,29,21,"U.C.E.",0
19,"19244",95,82,82,6,0,"U.C.E.",0
47,"47110",471,386,378,6,8,"U.C.E.",0
3,"3100",540,448,443,2,5,"U.C.E.",0
19,"19213",72,60,60,1,0,"U.C.E.",0
18,"18910",832,601,594,6,7,"U.C.E.",0
42,"42044",62,47,46,0,1,"U.C.E.",0
17,"17095",19245,11212,11067,160,145,"U.C.E.",4
19,"19034",23,23,23,1,0,"U.C.E.",0
40,"40124",261,190,183,9,7,"U.C.E.",0
18,"18072",710,507,499,2,8,"U.C.E.",0
46,"46216",4806,3857,3825,39,32,"U.C.E.",0
22,"22016",654,476,464,10,12,"U.C.E.",0
50,"50204",2519,1823,1804,24,19,"U.C.E.",0
4,"4063",1199,871,862,6,9,"U.C.E.",0
31,"31060",12916,8830,8687,158,143,"U.C.E.",12
50,"50289",71,59,59,0,0,"U.C.E.",0
16,"16113",3075,2363,2338,36,25,"U.C.E.",1
10,"10087",1754,1283,1262,4,21,"U.C.E.",3
45,"45017",268,215,212,1,3,"U.C.E.",0
40,"40125",99,72,71,3,1,"U.C.E.",0
40,"40077",713,526,519,12,7,"U.C.E.",0
47,"47192",99,84,84,0,0,"U.C.E.",0
46,"46241",440,336,314,4,22,"U.C.E.",2
18,"18074",297,245,245,5,0,"U.C.E.",0
44,"44245",274,189,184,1,5,"U.C.E.",0
31,"31001",88,58,58,1,0,"U.C.E.",0
3,"3002",3559,2747,2707,16,40,"U.C.E.",0
15,"15004",4891,3595,3545,61,50,"U.C.E.",1
19,"19111",180,147,146,0,1,"U.C.E.",0
24,"24059",956,592,585,9,7,"U.C.E.",0
16,"16115",60,45,45,0,0,"U.C.E.",0
37,"37318",225,167,165,0,2,"U.C.E.",0
33,"33058",1863,1307,1286,11,21,"U.C.E.",1
10,"10089",1399,1043,1032,15,11,"U.C.E.",0
5,"5063",48,39,39,2,0,"U.C.E.",0
46,"46096",320,267,267,0,0,"U.C.E.",1
44,"44165",182,140,140,1,0,"U.C.E.",0
34,"34177",170,147,143,2,4,"U.C.E.",0
18,"18076",880,676,676,3,0,"U.C.E.",0
46,"46120",1133,889,870,2,19,"U.C.E.",1
16,"16259",30,26,26,1,0,"U.C.E.",0
16,"16116",104,67,66,1,1,"U.C.E.",0
36,"36036",2616,1981,1948,24,33,"U.C.E.",1
46,"46023",318,275,267,2,8,"U.C.E.",0
44,"44167",41,31,31,1,0,"U.C.E.",0
24,"24061",1713,1223,1210,34,13,"U.C.E.",2
34,"34227",84,69,67,3,2,"U.C.E.",0
20,"20018",11027,7428,7387,53,41,"U.C.E.",3
5,"5193",224,197,197,2,0,"U.C.E.",0
8,"8296",1683,1227,1203,29,24,"U.C.E.",0
12,"12106",1207,992,969,7,23,"U.C.E.",0
7,"7902",1071,734,712,22,22,"U.C.E.",0
47,"47194",322,244,233,1,11,"U.C.E.",0
15,"15090",1267,959,953,4,6,"U.C.E.",0
31,"31155",264,187,183,7,4,"U.C.E.",0
8,"8174",409,294,292,10,2,"U.C.E.",0
45,"45132",1916,1487,1473,9,14,"U.C.E.",0
45,"45021",2399,1834,1804,23,30,"U.C.E.",1
44,"44041",67,56,51,1,5,"U.C.E.",1
22,"22168",22,16,16,0,0,"U.C.E.",0
47,"47195",449,350,346,5,4,"U.C.E.",2
46,"46243",149,120,117,0,3,"U.C.E.",0
46,"46098",2556,2072,2057,12,15,"U.C.E.",1
33,"33060",15694,11036,10883,112,153,"U.C.E.",1
8,"8082",1143,733,723,17,10,"U.C.E.",2
3,"3106",642,542,535,3,7,"U.C.E.",0
17,"17133",1336,889,866,14,23,"U.C.E.",0
31,"31248",318,190,187,2,3,"U.C.E.",0
23,"23045",2180,1671,1667,3,4,"U.C.E.",2
39,"39019",2009,1556,1536,10,20,"U.C.E.",0
39,"39097",732,476,470,4,6,"U.C.E.",0
18,"18147",3742,2419,2386,20,33,"U.C.E.",0
39,"39071",463,358,358,2,0,"U.C.E.",0
37,"37092",1403,1034,1022,12,12,"U.C.E.",1
8,"8002",202,143,140,4,3,"U.C.E.",0
47,"47115",306,248,248,2,0,"U.C.E.",0
1,"1047",942,674,655,4,19,"U.C.E.",2
39,"39072",375,234,234,4,0,"U.C.E.",0
44,"44251",271,218,218,5,0,"U.C.E.",0
31,"31217",382,256,244,5,12,"U.C.E.",1
15,"15008",5657,4224,4157,62,67,"U.C.E.",2
5,"5263",175,133,131,0,2,"U.C.E.",0
16,"16211",462,317,313,2,4,"U.C.E.",0
26,"26080",529,427,425,2,2,"U.C.E.",0
22,"22068",79,51,51,2,0,"U.C.E.",0
50,"50294",77,58,57,0,1,"U.C.E.",0
39,"39047",1987,1495,1482,9,13,"U.C.E.",0
5,"5067",85,68,68,0,0,"U.C.E.",0
24,"24184",206,111,111,0,0,"U.C.E.",0
16,"16266",402,334,325,4,9,"U.C.E.",0
46,"46027",997,869,855,4,14,"U.C.E.",0
31,"31158",264,174,173,1,1,"U.C.E.",0
34,"34231",273,209,206,2,3,"U.C.E.",0
26,"26082",121,95,95,0,0,"U.C.E.",0
17,"17074",490,345,342,5,3,"U.C.E.",0
12,"12044",527,472,463,4,9,"U.C.E.",0
30,"30024",57868,41894,41513,393,381,"U.C.E.",27
24,"24149",149,120,118,3,2,"U.C.E.",0
42,"42055",183,128,127,4,1,"U.C.E.",0
10,"10218",1184,896,893,0,3,"U.C.E.",0
42,"42056",26,23,22,1,1,"U.C.E.",0
8,"8269",2613,1840,1814,32,26,"U.C.E.",1
40,"40087",112,85,83,0,2,"U.C.E.",0
50,"50210",39,28,24,0,4,"U.C.E.",0
46,"46125",858,724,710,6,14,"U.C.E.",0
42,"42208",23,15,15,1,0,"U.C.E.",0
37,"37250",405,277,274,1,3,"U.C.E.",0
42,"42057",197,133,133,6,0,"U.C.E.",0
7,"7006",4964,3234,3157,51,77,"U.C.E.",5
34,"34058",212,179,178,0,1,"U.C.E.",0
5,"5070",41,33,33,0,0,"U.C.E.",0
23,"23049",1942,1514,1486,16,28,"U.C.E.",1
24,"24067",700,453,447,4,6,"U.C.E.",1
40,"40230",117,92,90,1,2,"U.C.E.",1
8,"8178",450,311,304,3,7,"U.C.E.",0
46,"46101",868,720,716,8,4,"U.C.E.",0
19,"19118",17,13,13,0,0,"U.C.E.",0
44,"44175",138,111,111,4,0,"U.C.E.",0
19,"19044",319,248,245,0,3,"U.C.E.",0
23,"23005",30698,23126,22916,310,210,"U.C.E.",19
46,"46004",1933,1563,1541,8,22,"U.C.E.",1
24,"24068",500,357,349,3,8,"U.C.E.",0
10,"10099",633,458,450,4,8,"U.C.E.",0
44,"44176",167,131,130,5,1,"U.C.E.",0
19,"19223",129,94,90,1,4,"U.C.E.",0
39,"39075",140941,103308,102362,1364,946,"U.C.E.",55
46,"46150",1898,1555,1541,8,14,"U.C.E.",1
8,"8006",10984,7255,7092,104,163,"U.C.E.",8
42,"42058",129,103,101,1,2,"U.C.E.",0
42,"42059",23,19,19,1,0,"U.C.E.",0
45,"45176",3570,2619,2583,45,36,"U.C.E.",0
50,"50038",1583,1194,1174,29,20,"U.C.E.",4
50,"50213",117,83,82,0,1,"U.C.E.",0
17,"17077",580,374,372,5,2,"U.C.E.",0
47,"47121",590,495,490,4,5,"U.C.E.",0
45,"45140",1087,885,867,6,18,"U.C.E.",0
8,"8180",26210,17504,17214,366,290,"U.C.E.",29
23,"23052",1186,1012,997,1,15,"U.C.E.",0
8,"8273",2287,1594,1547,18,47,"U.C.E.",6
3,"3045",233,204,203,2,1,"U.C.E.",0
16,"16086",935,814,802,14,12,"U.C.E.",0
10,"10182",146,112,108,0,4,"U.C.E.",3
44,"44178",69,45,44,0,1,"U.C.E.",0
47,"47013",118,97,97,2,0,"U.C.E.",0
19,"19121",277,219,217,0,2,"U.C.E.",0
34,"34102",226,187,185,3,2,"U.C.E.",0
42,"42215",821,561,545,19,16,"U.C.E.",1
8,"8181",7722,5280,5188,112,92,"U.C.E.",7
37,"37216",300,270,266,2,4,"U.C.E.",0
47,"47203",69,57,56,0,1,"U.C.E.",0
34,"34238",348,289,287,4,2,"U.C.E.",0
39,"39077",256,196,196,1,0,"U.C.E.",0
46,"46104",2012,1691,1676,9,15,"U.C.E.",0
44,"44099",724,519,511,4,8,"U.C.E.",0
15,"15070",9684,6627,6464,141,163,"U.C.E.",5
12,"12050",1418,1183,1156,8,27,"U.C.E.",0
41,"41075",9987,7904,7809,71,95,"U.C.E.",0
47,"47149",44,22,20,0,2,"U.C.E.",0
16,"16275",15,12,12,0,0,"U.C.E.",0
16,"16130",633,504,492,5,12,"U.C.E.",0
33,"33066",42885,29326,29013,460,313,"U.C.E.",15
19,"19009",253,187,184,0,3,"U.C.E.",0
30,"30029",11533,8854,8768,73,86,"U.C.E.",4
10,"10185",587,457,450,1,7,"U.C.E.",0
23,"23011",2227,1644,1620,25,24,"U.C.E.",1
18,"18088",1576,1258,1253,2,5,"U.C.E.",0
5,"5173",62,55,55,1,0,"U.C.E.",0
11,"11003",1290,952,940,8,12,"U.C.E.",0
39,"39078",1407,1041,1033,10,8,"U.C.E.",0
39,"39052",17031,13198,13034,187,164,"U.C.E.",1
18,"18023",16072,11594,11488,131,106,"U.C.E.",4
15,"15015",2840,2006,1964,43,42,"U.C.E.",1
10,"10105",2599,1869,1835,25,34,"U.C.E.",2
8,"8091",5106,3379,3312,59,67,"U.C.E.",9
8,"8183",4497,2914,2865,43,49,"U.C.E.",3
37,"37218",81,51,51,1,0,"U.C.E.",0
17,"17080",165,115,114,1,1,"U.C.E.",0
50,"50216",267,201,194,8,7,"U.C.E.",0
47,"47095",41,36,36,3,0,"U.C.E.",0
5,"5044",301,217,217,3,0,"U.C.E.",0
4,"4007",791,599,599,5,0,"U.C.E.",0
33,"33022",992,709,696,12,13,"U.C.E.",1
50,"50246",48,33,33,1,0,"U.C.E.",0
24,"24036",321,190,188,0,2,"U.C.E.",0
46,"46130",934,745,734,6,11,"U.C.E.",1
46,"46227",923,787,771,4,16,"U.C.E.",0
44,"44266",134,107,105,2,2,"U.C.E.",0
1,"1060",223,181,178,1,3,"U.C.E.",0
50,"50100",355,273,266,3,7,"U.C.E.",0
16,"16093",80,57,57,0,0,"U.C.E.",0
37,"37221",465,360,353,0,7,"U.C.E.",0
50,"50217",496,380,379,0,1,"U.C.E.",0
3,"3118",2368,1746,1718,16,28,"U.C.E.",2
40,"40906",1793,1428,1405,32,23,"U.C.E.",2
50,"50042",16,14,14,0,0,"U.C.E.",0
44,"44183",78,49,46,0,3,"U.C.E.",0
18,"18126",1461,1129,1121,15,8,"U.C.E.",0
5,"5045",104,82,82,0,0,"U.C.E.",0
46,"46082",4661,3447,3401,46,46,"U.C.E.",2
23,"23059",5974,4910,4852,37,58,"U.C.E.",4
10,"10108",231,152,152,0,0,"U.C.E.",0
44,"44184",34,21,21,2,0,"U.C.E.",0
45,"45146",117,99,98,0,1,"U.C.E.",0
1,"1062",333,236,232,5,4,"U.C.E.",0
8,"8094",1500,1102,1071,21,31,"U.C.E.",0
16,"16280",205,177,175,1,2,"U.C.E.",0
44,"44105",82,63,63,2,0,"U.C.E.",0
26,"26141",132,101,101,2,0,"U.C.E.",0
45,"45147",598,484,478,9,6,"U.C.E.",0
36,"36051",14288,10228,10079,124,149,"U.C.E.",5
44,"44185",117,91,90,0,1,"U.C.E.",0
33,"33001",1772,984,971,14,13,"U.C.E.",0
16,"16011",39,30,30,0,0,"U.C.E.",0
47,"47208",56,45,43,1,2,"U.C.E.",0
19,"19231",16,14,14,0,0,"U.C.E.",0
16,"16012",102,81,80,0,1,"U.C.E.",0
14,"14004",2016,1560,1543,8,17,"U.C.E.",0
17,"17174",183,120,117,5,3,"U.C.E.",0
44,"44226",163,112,112,3,0,"U.C.E.",0
23,"23061",7309,5637,5584,60,53,"U.C.E.",3
34,"34110",96,83,81,2,2,"U.C.E.",0
45,"45149",638,542,533,2,9,"U.C.E.",0
44,"44187",224,170,163,2,7,"U.C.E.",0
41,"41080",1289,1010,997,13,13,"U.C.E.",0
46,"46181",17153,13332,13184,108,148,"U.C.E.",8
42,"42073",84,53,53,0,0,"U.C.E.",0
34,"34901",1233,955,946,14,9,"U.C.E.",1
16,"16013",24,23,23,0,0,"U.C.E.",0
37,"37338",82,69,67,0,2,"U.C.E.",0
41,"41081",28121,20027,19785,275,242,"U.C.E.",8
37,"37112",162,124,124,3,0,"U.C.E.",0
37,"37113",439,365,365,7,0,"U.C.E.",0
10,"10112",1582,1299,1284,5,15,"U.C.E.",1
44,"44060",42,34,34,0,0,"U.C.E.",0
46,"46036",675,440,431,11,9,"U.C.E.",1
17,"17054",395,250,247,3,3,"U.C.E.",0
22,"22195",231,193,189,6,4,"U.C.E.",0
44,"44189",69,57,57,0,0,"U.C.E.",0
19,"19233",108,93,90,2,3,"U.C.E.",0
45,"45150",471,388,382,1,6,"U.C.E.",0
50,"50134",134,102,101,3,1,"U.C.E.",0
39,"39005",1319,1048,1026,3,22,"U.C.E.",0
10,"10113",2440,1891,1859,11,32,"U.C.E.",7
3,"3089",9696,7447,7302,83,145,"U.C.E.",8
36,"36022",9203,6423,6226,100,197,"U.C.E.",1
37,"37188",198,164,160,7,4,"U.C.E.",1
5,"5212",274,202,197,0,5,"U.C.E.",0
40,"40200",47,41,39,0,2,"U.C.E.",0
42,"42076",237,185,179,6,6,"U.C.E.",1
19,"19018",189,145,138,2,7,"U.C.E.",0
24,"24205",995,719,712,9,7,"U.C.E.",0
44,"44191",806,602,594,6,8,"U.C.E.",2
37,"37341",52,32,32,0,0,"U.C.E.",0
34,"34903",240,161,160,2,1,"U.C.E.",0
4,"4051",476,406,400,3,6,"U.C.E.",1
16,"16240",134,100,98,0,2,"U.C.E.",0
31,"31263",241,135,132,0,3,"U.C.E.",0
12,"12093",254,190,187,0,3,"U.C.E.",0
34,"34034",129,104,104,1,0,"U.C.E.",0
44,"44230",154,127,127,3,0,"U.C.E.",0
5,"5151",100,86,82,1,4,"U.C.E.",0
10,"10115",3622,2872,2800,52,72,"U.C.E.",2
33,"33050",653,406,402,0,4,"U.C.E.",0
30,"30010",6804,5691,5647,36,44,"U.C.E.",2
45,"45006",1524,1128,1110,13,18,"U.C.E.",1
47,"47048",204,168,167,2,1,"U.C.E.",0
46,"46184",26507,20314,20010,263,304,"U.C.E.",13
18,"18134",5528,3751,3679,57,72,"U.C.E.",0
44,"44193",99,71,67,0,4,"U.C.E.",0
46,"46111",10589,7823,7710,94,113,"U.C.E.",3
45,"45154",1459,1148,1140,12,8,"U.C.E.",2
11,"11011",1685,1231,1216,8,15,"U.C.E.",0
33,"33073",9341,5825,5773,69,52,"U.C.E.",2
34,"34120",65774,49378,48608,830,770,"U.C.E.",42
12,"12061",431,324,316,6,8,"U.C.E.",0
3,"3024",3908,3324,3271,34,53,"U.C.E.",4
50,"50224",70,52,49,2,3,"U.C.E.",0
22,"22049",88,70,69,5,1,"U.C.E.",0
44,"44194",128,92,89,1,3,"U.C.E.",0
46,"46112",582,475,463,4,12,"U.C.E.",1
41,"41032",4059,3122,3062,22,60,"U.C.E.",0
23,"23069",5489,4656,4586,36,70,"U.C.E.",1
8,"8284",11920,7059,6942,139,117,"U.C.E.",12
5,"5086",96,81,81,2,0,"U.C.E.",0
40,"40111",72,57,55,0,2,"U.C.E.",1
15,"15024",4726,3634,3555,51,79,"U.C.E.",2
22,"22050",100,84,83,0,1,"U.C.E.",0
10,"10117",264,174,174,2,0,"U.C.E.",0
46,"46186",18444,14173,14029,135,144,"U.C.E.",14
44,"44066",121,88,86,0,2,"U.C.E.",0
37,"37119",115,98,98,0,0,"U.C.E.",0
16,"16910",104,69,69,1,0,"U.C.E.",0
42,"42082",9,9,9,0,0,"U.C.E.",0
17,"17181",3228,2116,2081,19,35,"U.C.E.",2
47,"47213",122,99,99,1,0,"U.C.E.",0
46,"46040",1227,1028,1021,13,7,"U.C.E.",0
31,"31902",3722,2670,2632,77,38,"U.C.E.",3
17,"17090",548,412,404,7,8,"U.C.E.",0
24,"24089",106265,77385,76124,1666,1261,"U.C.E.",35
30,"30039",18615,14213,14068,134,145,"U.C.E.",7
47,"47214",1517,1215,1191,34,24,"U.C.E.",0
3,"3129",1188,936,918,10,18,"U.C.E.",1
50,"50051",886,677,671,9,6,"U.C.E.",1
33,"33075",305,191,190,0,1,"U.C.E.",0
22,"22096",301,239,237,8,2,"U.C.E.",1
45,"45084",2395,1879,1842,21,37,"U.C.E.",0
44,"44196",152,116,114,2,2,"U.C.E.",0
18,"18035",1254,991,982,7,9,"U.C.E.",0
8,"8103",636,453,446,16,7,"U.C.E.",0
39,"39088",70,61,61,1,0,"U.C.E.",0
3,"3130",43,30,29,0,1,"U.C.E.",0
22,"22205",472,369,363,5,6,"U.C.E.",0
31,"31904",1590,1054,1031,19,23,"U.C.E.",3
5,"5185",109,89,89,1,0,"U.C.E.",0
41,"41087",9827,7300,7150,51,150,"U.C.E.",1
20,"20009",11794,7805,7725,103,80,"U.C.E.",18
5,"5089",500,390,375,3,15,"U.C.E.",0
37,"37122",210,175,174,3,1,"U.C.E.",0
10,"10121",8063,6048,5988,51,60,"U.C.E.",8
3,"3028",1049,903,895,6,8,"U.C.E.",0
42,"42038",42,32,31,3,1,"U.C.E.",0
40,"40118",59,44,43,1,1,"U.C.E.",0
20,"20010",1392,949,941,8,8,"U.C.E.",1
33,"33008",1934,1474,1459,11,15,"U.C.E.",0
8,"8288",1735,985,957,13,28,"U.C.E.",2
24,"24214",716,518,509,4,9,"U.C.E.",1
3,"3029",260,191,186,0,5,"U.C.E.",0
31,"31087",163,122,121,3,1,"U.C.E.",0
33,"33009",951,673,663,7,10,"U.C.E.",0
4,"4091",380,322,318,3,4,"U.C.E.",0
5,"5187",1833,1385,1361,16,24,"U.C.E.",0
50,"50054",63,46,46,0,0,"U.C.E.",0
20,"20011",1700,1265,1258,11,7,"U.C.E.",2
3,"3030",522,464,453,6,11,"U.C.E.",1
31,"31178",540,395,392,4,3,"U.C.E.",0
37,"37001",224,182,181,0,1,"U.C.E.",0
31,"31148",99,69,66,2,3,"U.C.E.",0
46,"46189",490,400,396,3,4,"U.C.E.",0
10,"10001",270,231,229,2,2,"U.C.E.",0
23,"23034",2591,2146,2124,13,22,"U.C.E.",0
22,"22208",168,136,133,2,3,"U.C.E.",0
47,"47217",1812,1395,1377,20,18,"U.C.E.",0
31,"31088",5358,3655,3592,97,63,"U.C.E.",7
10,"10124",873,707,707,16,0,"U.C.E.",2
39,"39091",2026,1636,1628,14,8,"U.C.E.",0
26,"26113",35,31,31,1,0,"U.C.E.",0
20,"20012",149,97,97,0,0,"U.C.E.",0
44,"44075",329,250,240,4,10,"U.C.E.",0
45,"45162",773,599,594,3,5,"U.C.E.",0
42,"42089",54,44,44,3,0,"U.C.E.",0
40,"40213",99,75,74,1,1,"U.C.E.",0
10,"10002",396,317,314,5,3,"U.C.E.",0
22,"22057",377,283,278,3,5,"U.C.E.",0
19,"19145",64,49,48,2,1,"U.C.E.",0
37,"37125",243,184,180,3,4,"U.C.E.",0
23,"23079",3750,3084,3063,19,21,"U.C.E.",2
40,"40122",551,417,414,9,3,"U.C.E.",1
10,"10003",616,463,458,3,5,"U.C.E.",1
8,"8200",61189,40677,40069,736,608,"U.C.E.",50
35,"35007",569,392,391,2,1,"U.C.E.",0
31,"31211",25,14,14,2,0,"U.C.E.",0
5,"5026",229,193,192,2,1,"U.C.E.",0
34,"34174",213,179,178,4,1,"U.C.E.",0
3,"3032",112,90,88,0,2,"U.C.E.",0
23,"23080",1832,1425,1414,3,11,"U.C.E.",1
5,"5094",158,124,124,3,0,"U.C.E.",0
44,"44122",1441,1009,990,21,19,"U.C.E.",0
12,"12133",64,47,47,0,0,"U.C.E.",0
8,"8047",4141,2610,2580,49,30,"U.C.E.",3
24,"24057",1459,1121,1092,16,29,"U.C.E.",0
3,"3033",127,102,97,2,5,"U.C.E.",1
46,"46191",1952,1554,1528,9,26,"U.C.E.",1
10,"10005",551,439,424,4,15,"U.C.E.",0
5,"5224",104,90,90,0,0,"U.C.E.",0
17,"17187",574,414,402,1,12,"U.C.E.",0
22,"22213",3152,2265,2230,62,35,"U.C.E.",0
47,"47056",90,69,69,2,0,"U.C.E.",0
50,"50233",120,89,88,2,1,"U.C.E.",0
33,"33012",5341,3816,3777,43,39,"U.C.E.",0
19,"19071",7346,5380,5294,76,86,"U.C.E.",4
11,"11019",1871,1449,1425,9,24,"U.C.E.",0
41,"41039",31429,23337,23138,294,199,"U.C.E.",7
17,"17188",167,124,122,9,2,"U.C.E.",0
8,"8202",12206,8265,8129,183,136,"U.C.E.",13
46,"46046",922,699,694,2,5,"U.C.E.",0
5,"5095",301,253,250,2,3,"U.C.E.",0
23,"23084",1046,817,812,4,5,"U.C.E.",0
44,"44082",90,67,66,1,1,"U.C.E.",0
17,"17007",1778,1137,1113,16,24,"U.C.E.",0
10,"10007",680,537,519,5,18,"U.C.E.",1
8,"8294",1870,1205,1171,22,34,"U.C.E.",0
47,"47221",115,102,102,0,0,"U.C.E.",0
37,"37006",157,108,107,0,1,"U.C.E.",0
24,"24099",199,164,162,0,2,"U.C.E.",0
47,"47057",237,198,198,3,0,"U.C.E.",0
33,"33013",466,349,345,4,4,"U.C.E.",0
26,"26075",377,297,289,4,8,"U.C.E.",0
47,"47141",148,121,119,1,2,"U.C.E.",0
42,"42006",166,110,107,3,3,"U.C.E.",0
39,"39043",1321,1082,1072,8,10,"U.C.E.",0
15,"15061",6105,4391,4307,64,84,"U.C.E.",1
8,"8295",10579,6896,6769,137,127,"U.C.E.",23
10,"10008",1393,1105,1086,10,19,"U.C.E.",0
31,"31093",305,207,203,2,4,"U.C.E.",0
50,"50235",2371,1723,1701,36,22,"U.C.E.",4
4,"4098",1616,1255,1249,7,6,"U.C.E.",2
41,"41068",13809,10171,10072,100,99,"U.C.E.",0
37,"37168",470,357,353,1,4,"U.C.E.",0
37,"37281",36,34,33,0,1,"U.C.E.",0
8,"8204",2991,2076,2040,45,36,"U.C.E.",4
40,"40129",203,166,162,1,4,"U.C.E.",0
46,"46048",3484,2915,2875,26,40,"U.C.E.",2
8,"8020",4542,3352,3298,77,54,"U.C.E.",4
34,"34134",61,49,47,0,2,"U.C.E.",0
46,"46194",15267,11622,11491,110,131,"U.C.E.",18
23,"23087",11474,9197,9123,90,74,"U.C.E.",7
39,"39096",719,521,518,4,3,"U.C.E.",0
7,"7001",3450,2544,2470,36,74,"U.C.E.",0
14,"14021",259993,183200,181402,2936,1798,"U.C.E.",104
22,"22220",192,138,136,5,2,"U.C.E.",0
45,"45169",239,183,183,1,0,"U.C.E.",0
16,"16159",299,204,202,5,2,"U.C.E.",0
8,"8143",2679,1772,1756,35,16,"U.C.E.",0
16,"16160",76,54,53,1,1,"U.C.E.",0
10,"10134",585,420,412,1,8,"U.C.E.",0
23,"23088",6177,4955,4872,94,83,"U.C.E.",88
17,"17011",625,472,467,5,5,"U.C.E.",0
8,"8022",12437,7598,7445,169,153,"U.C.E.",4
41,"41044",6838,5064,5005,67,59,"U.C.E.",4
30,"30023",3572,2859,2811,22,48,"U.C.E.",1
37,"37246",5430,4363,4315,63,48,"U.C.E.",3
40,"40131",48,41,41,0,0,"U.C.E.",0
22,"22221",108,70,69,5,1,"U.C.E.",1
8,"8206",717,557,547,7,10,"U.C.E.",0
16,"16161",84,73,72,4,1,"U.C.E.",0
22,"22067",82,54,49,3,5,"U.C.E.",0
24,"24103",330,180,177,0,3,"U.C.E.",0
12,"12139",344,219,216,0,3,"U.C.E.",0
14,"14023",2084,1809,1787,13,22,"U.C.E.",1
3,"3073",219,199,199,0,0,"U.C.E.",0
50,"50152",1569,1151,1135,31,16,"U.C.E.",1
44,"44211",39,32,32,2,0,"U.C.E.",0
45,"45024",1105,870,856,16,14,"U.C.E.",2
17,"17101",567,349,339,4,10,"U.C.E.",0
50,"50209",2559,1685,1661,34,24,"U.C.E.",0
45,"45171",1359,1114,1093,13,21,"U.C.E.",0
5,"5102",1850,1487,1475,11,12,"U.C.E.",1
37,"37248",160,130,130,1,0,"U.C.E.",0
42,"42105",54,45,45,0,0,"U.C.E.",0
39,"39021",536,448,444,1,4,"U.C.E.",0
46,"46251",2599,2215,2179,21,36,"U.C.E.",0
50,"50063",76,67,67,0,0,"U.C.E.",0
8,"8208",5471,3859,3792,82,67,"U.C.E.",10
37,"37136",702,494,485,4,9,"U.C.E.",0
19,"19221",56,41,41,2,0,"U.C.E.",0
24,"24105",1460,1095,1075,27,20,"U.C.E.",1
14,"14025",3061,2547,2517,13,30,"U.C.E.",0
16,"16165",84,70,70,0,0,"U.C.E.",0
10,"10137",428,373,371,1,2,"U.C.E.",0
23,"23093",3313,2706,2673,13,33,"U.C.E.",0
17,"17194",93,55,55,1,0,"U.C.E.",0
44,"44257",184,132,131,6,1,"U.C.E.",0
33,"33017",3289,2378,2350,35,28,"U.C.E.",0
46,"46198",815,660,654,4,6,"U.C.E.",1
10,"10015",688,539,523,5,16,"U.C.E.",1
10,"10138",551,451,443,7,8,"U.C.E.",1
3,"3042",1337,1028,1019,8,9,"U.C.E.",0
26,"26002",805,617,605,6,12,"U.C.E.",0
8,"8116",600,401,393,9,8,"U.C.E.",2
5,"5199",48,39,39,0,0,"U.C.E.",0
44,"44215",156,100,100,2,0,"U.C.E.",0
46,"46252",142,108,107,1,1,"U.C.E.",0
15,"15039",1374,1027,998,27,29,"U.C.E.",0
45,"45174",343,289,288,0,1,"U.C.E.",0
24,"24028",426,350,331,3,19,"U.C.E.",0
37,"37099",104,64,62,1,2,"U.C.E.",0
24,"24151",514,391,387,6,4,"U.C.E.",0
7,"7007",454,304,300,4,4,"U.C.E.",1
26,"26004",82,64,64,1,0,"U.C.E.",0
24,"24901",994,698,686,8,12,"U.C.E.",2
11,"11027",67042,43386,43065,557,321,"U.C.E.",28
18,"18151",276,191,188,0,3,"U.C.E.",0
22,"22177",101,79,75,1,4,"U.C.E.",0
4,"4903",4331,3183,3164,31,19,"U.C.E.",3
34,"34141",190,162,160,0,2,"U.C.E.",0
35,"35016",291589,181013,177964,2856,3049,"U.C.E.",222
19,"19191",19,15,15,0,0,"U.C.E.",0
24,"24108",421,316,314,6,2,"U.C.E.",0
46,"46253",118,105,102,7,3,"U.C.E.",0
44,"44217",37,28,27,0,1,"U.C.E.",0
47,"47065",898,762,752,9,10,"U.C.E.",0
24,"24902",375,292,289,1,3,"U.C.E.",0
23,"23097",6510,4687,4639,36,48,"U.C.E.",4
26,"26131",44,36,36,0,0,"U.C.E.",0
37,"37017",249,200,199,0,1,"U.C.E.",0
37,"37140",731,490,475,0,15,"U.C.E.",0
23,"23008",1552,1280,1266,9,14,"U.C.E.",2
24,"24190",183,134,131,1,3,"U.C.E.",0
4,"4003",17244,11933,11840,94,93,"U.C.E.",8
8,"8303",279,202,201,11,1,"U.C.E.",0
34,"34020",63,44,44,0,0,"U.C.E.",0
5,"5001",210,180,176,2,4,"U.C.E.",0
17,"17140",684,476,470,10,6,"U.C.E.",0
37,"37366",46,35,34,0,1,"U.C.E.",0
47,"47229",235,161,161,1,0,"U.C.E.",1
46,"46127",2790,2298,2267,23,31,"U.C.E.",1
47,"47066",1114,891,888,10,3,"U.C.E.",0
15,"15042",3249,2341,2303,25,38,"U.C.E.",2
8,"8213",6188,4031,3970,113,61,"U.C.E.",2
19,"19258",103,81,81,0,0,"U.C.E.",0
36,"36046",4093,3175,3120,31,55,"U.C.E.",7
46,"46177",4594,3576,3523,29,53,"U.C.E.",4
46,"46128",1649,1322,1292,14,30,"U.C.E.",0
10,"10021",5421,4189,4099,47,90,"U.C.E.",4
8,"8244",5746,4044,3940,102,104,"U.C.E.",4
37,"37020",449,371,365,7,6,"U.C.E.",0
4,"4005",631,531,524,6,7,"U.C.E.",1
19,"19161",243,171,166,2,5,"U.C.E.",0
46,"46255",3135,2530,2508,11,22,"U.C.E.",4
8,"8029",3389,2542,2514,45,28,"U.C.E.",0
5,"5236",147,101,101,0,0,"U.C.E.",0
23,"23101",413,324,321,3,3,"U.C.E.",0
31,"31164",604,462,448,9,14,"U.C.E.",0
17,"17109",759,428,414,10,14,"U.C.E.",0
8,"8121",85069,58372,57620,923,752,"U.C.E.",77
10,"10022",442,377,370,1,7,"U.C.E.",0
41,"41024",22383,15333,15160,213,173,"U.C.E.",4
37,"37143",410,342,338,3,4,"U.C.E.",0
42,"42117",146,115,111,1,4,"U.C.E.",0
18,"18053",1836,1345,1340,11,5,"U.C.E.",0
37,"37021",86,70,68,2,2,"U.C.E.",0
3,"3048",4747,3878,3817,16,61,"U.C.E.",2
40,"40004",534,428,420,3,8,"U.C.E.",0
40,"40144",19,17,17,1,0,"U.C.E.",0
26,"26010",98,82,79,1,3,"U.C.E.",0
47,"47151",32,29,29,0,0,"U.C.E.",0
19,"19049",19,11,11,0,0,"U.C.E.",0
46,"46256",6734,4902,4858,33,44,"U.C.E.",2
8,"8276",249,188,187,9,1,"U.C.E.",0
8,"8031",2289,1619,1599,34,20,"U.C.E.",1
8,"8123",18751,13394,13154,238,240,"U.C.E.",15
26,"26051",271,219,214,4,5,"U.C.E.",0
3,"3016",91,67,66,1,1,"U.C.E.",0
24,"24197",784,570,564,7,6,"U.C.E.",0
18,"18056",3695,2961,2940,25,21,"U.C.E.",1
17,"17143",134,89,87,2,2,"U.C.E.",0
8,"8093",32,21,20,0,1,"U.C.E.",0
14,"14032",434,377,375,1,2,"U.C.E.",0
41,"41026",4273,3577,3538,15,39,"U.C.E.",1
31,"31014",280,197,196,2,1,"U.C.E.",0
5,"5110",710,584,581,1,3,"U.C.E.",0
20,"20033",884,650,641,4,9,"U.C.E.",0
4,"4008",530,423,418,4,5,"U.C.E.",0
19,"19230",438,317,309,4,8,"U.C.E.",0
40,"40101",770,584,577,16,7,"U.C.E.",0
26,"26095",126,102,102,0,0,"U.C.E.",0
46,"46058",1787,1460,1441,10,19,"U.C.E.",0
41,"41027",4061,2783,2752,28,31,"U.C.E.",0
39,"39029",642,521,517,6,4,"U.C.E.",0
16,"16176",61,45,43,0,2,"U.C.E.",0
8,"8217",24130,17554,17319,383,235,"U.C.E.",34
45,"45184",219,150,148,3,2,"U.C.E.",0
22,"22083",522,437,428,4,9,"U.C.E.",0
10,"10189",2728,2108,2063,24,45,"U.C.E.",0
34,"34108",561,477,465,6,12,"U.C.E.",0
40,"40008",44,37,36,0,1,"U.C.E.",0
11,"11034",2381,1807,1784,19,23,"U.C.E.",0
8,"8218",7968,5014,4932,129,82,"U.C.E.",7
26,"26014",472,358,353,6,5,"U.C.E.",1
34,"34028",154,128,126,1,2,"U.C.E.",1
5,"5113",90,74,74,0,0,"U.C.E.",0
17,"17023",26941,17098,16799,344,299,"U.C.E.",13
10,"10150",374,331,328,2,3,"U.C.E.",0
4,"4011",2814,2283,2263,25,20,"U.C.E.",1
26,"26142",804,661,648,1,13,"U.C.E.",0
41,"41054",671,556,550,0,6,"U.C.E.",0
17,"17203",171,97,94,3,3,"U.C.E.",0
44,"44107",233,161,154,3,7,"U.C.E.",1
31,"31199",161,103,103,1,0,"U.C.E.",0
10,"10028",125,88,88,0,0,"U.C.E.",0
24,"24002",271,213,213,2,0,"U.C.E.",0
26,"26015",205,167,165,1,2,"U.C.E.",0
15,"15047",2606,1789,1761,33,28,"U.C.E.",2
37,"37026",201,176,176,3,0,"U.C.E.",0
35,"35024",12420,6978,6819,131,159,"U.C.E.",6
26,"26056",440,345,339,4,6,"U.C.E.",0
24,"24119",742,524,510,15,14,"U.C.E.",0
17,"17024",301,207,204,4,3,"U.C.E.",0
18,"18162",947,726,721,8,5,"U.C.E.",0
44,"44227",81,59,59,0,0,"U.C.E.",0
44,"44108",352,228,225,8,3,"U.C.E.",1
31,"31018",422,303,299,8,4,"U.C.E.",1
41,"41029",13231,9756,9610,128,146,"U.C.E.",2
15,"15048",4769,3470,3415,57,55,"U.C.E.",0
8,"8903",217,178,176,10,2,"U.C.E.",0
41,"41096",6079,4673,4595,47,78,"U.C.E.",5
10,"10152",499,424,418,4,6,"U.C.E.",0
37,"37150",43,36,34,0,2,"U.C.E.",0
34,"34032",47,36,36,1,0,"U.C.E.",1
45,"45077",554,430,423,7,7,"U.C.E.",0
18,"18030",612,457,456,0,1,"U.C.E.",0
47,"47129",954,744,731,4,13,"U.C.E.",0
26,"26101",46,35,34,0,1,"U.C.E.",0
10,"10194",557,449,440,0,9,"U.C.E.",1
8,"8016",1984,1319,1289,26,30,"U.C.E.",0
10,"10153",331,266,263,1,3,"U.C.E.",0
19,"19266",278,234,231,4,3,"U.C.E.",0
5,"5015",100,78,78,0,0,"U.C.E.",0
37,"37264",78,52,52,0,0,"U.C.E.",0
17,"17117",14022,8705,8595,129,110,"U.C.E.",12
26,"26018",10396,8186,8041,161,145,"U.C.E.",3
17,"17177",563,398,388,7,10,"U.C.E.",0
36,"36055",13678,10508,10288,155,220,"U.C.E.",5
37,"37152",474,357,351,2,6,"U.C.E.",1
40,"40060",86,65,64,3,1,"U.C.E.",0
8,"8252",24033,16704,16402,368,302,"U.C.E.",34
23,"23024",12634,9916,9673,116,243,"U.C.E.",6
17,"17206",167,108,107,2,1,"U.C.E.",0
39,"39085",6722,5198,5134,60,64,"U.C.E.",8
45,"45116",682,576,565,0,11,"U.C.E.",0
46,"46262",228,161,158,0,3,"U.C.E.",0
24,"24123",835,559,555,6,4,"U.C.E.",0
19,"19170",214,139,138,0,1,"U.C.E.",0
35,"35026",78933,49860,48955,780,905,"U.C.E.",44
37,"37154",156,130,125,1,5,"U.C.E.",0
47,"47075",4999,4020,3957,39,63,"U.C.E.",2
16,"16189",263,213,211,2,2,"U.C.E.",2
45,"45080",3,3,3,0,0,"U.C.E.",0
8,"8038",1406,911,895,24,16,"U.C.E.",0
34,"34035",122,98,96,0,2,"U.C.E.",0
14,"14039",2705,2204,2189,12,15,"U.C.E.",2
5,"5017",87,69,68,1,1,"U.C.E.",0
16,"16058",120,103,102,1,1,"U.C.E.",0
26,"26021",2758,2190,2163,21,27,"U.C.E.",0
20,"20041",279,153,151,5,2,"U.C.E.",0
47,"47158",906,716,710,10,6,"U.C.E.",0
37,"37231",285,227,225,6,2,"U.C.E.",0
31,"31204",45,35,34,0,1,"U.C.E.",0
31,"31235",189,111,110,0,1,"U.C.E.",1
50,"50253",461,381,375,3,6,"U.C.E.",0
17,"17028",327,220,217,4,3,"U.C.E.",0
50,"50168",34,26,26,1,0,"U.C.E.",0
41,"41099",4141,2818,2799,37,19,"U.C.E.",1
4,"4017",1337,965,960,7,5,"U.C.E.",1
11,"11040",411,317,309,0,8,"U.C.E.",1
20,"20042",3354,2131,2117,18,14,"U.C.E.",0
16,"16060",841,714,704,11,10,"U.C.E.",0
45,"45193",661,557,548,1,9,"U.C.E.",0
31,"31114",384,320,318,37,2,"U.C.E.",0
17,"17120",779,501,485,9,16,"U.C.E.",1
37,"37381",153,114,109,3,5,"U.C.E.",0
12,"12096",854,663,653,17,10,"U.C.E.",1
46,"46210",346,300,295,4,5,"U.C.E.",0
10,"10037",74974,56844,55950,898,894,"U.C.E.",62
47,"47160",466,368,364,5,4,"U.C.E.",0
40,"40160",120,94,92,2,2,"U.C.E.",0
22,"22250",368,261,255,12,6,"U.C.E.",0
7,"7023",3541,2414,2365,88,49,"U.C.E.",4
5,"5216",237,195,192,0,3,"U.C.E.",0
5,"5217",69,54,54,0,0,"U.C.E.",0
8,"8133",157,100,97,2,3,"U.C.E.",0
24,"24009",362,188,184,0,4,"U.C.E.",1
31,"31206",2079,1517,1475,33,42,"U.C.E.",0
41,"41086",15877,10246,10150,146,96,"U.C.E.",1
12,"12128",1448,1114,1092,16,22,"U.C.E.",1
31,"31115",171,112,109,2,3,"U.C.E.",0
39,"39036",1023,802,790,5,12,"U.C.E.",0
19,"19061",76,57,55,3,2,"U.C.E.",0
50,"50080",41,31,31,1,0,"U.C.E.",0
46,"46903",5210,4037,4000,40,37,"U.C.E.",2
5,"5121",250,181,178,1,3,"U.C.E.",0
42,"42139",22,18,17,0,1,"U.C.E.",0
17,"17123",365,274,266,8,8,"U.C.E.",0
46,"46904",782,659,650,6,9,"U.C.E.",0
31,"31116",71,48,48,2,0,"U.C.E.",0
31,"31025",751,501,495,12,6,"U.C.E.",1
37,"37159",100,77,75,0,2,"U.C.E.",0
10,"10161",76,59,59,1,0,"U.C.E.",0
40,"40163",62,51,51,5,0,"U.C.E.",0
42,"42086",40,25,25,1,0,"U.C.E.",0
5,"5022",1649,1335,1328,7,7,"U.C.E.",2
19,"19175",39,31,31,0,0,"U.C.E.",0
10,"10162",616,505,496,1,9,"U.C.E.",0
22,"22102",194,152,149,4,3,"U.C.E.",0
14,"14044",1585,1279,1265,12,14,"U.C.E.",0
45,"45086",491,406,399,3,7,"U.C.E.",0
34,"34041",100,79,78,1,1,"U.C.E.",0
40,"40022",210,154,151,2,3,"U.C.E.",1
5,"5123",90,69,69,3,0,"U.C.E.",0
37,"37160",644,474,464,4,10,"U.C.E.",0
45,"45087",8428,6434,6292,74,142,"U.C.E.",0
8,"8228",303,230,227,5,3,"U.C.E.",2
35,"35031",6968,4927,4862,71,65,"U.C.E.",5
17,"17032",1613,933,918,11,15,"U.C.E.",2
31,"31118",182,114,114,6,0,"U.C.E.",0
18,"18037",488,408,404,0,4,"U.C.E.",0
35,"35032",3432,2605,2548,37,57,"U.C.E.",3
37,"37161",157,118,116,1,2,"U.C.E.",0
23,"23076",831,681,671,5,10,"U.C.E.",0
45,"45198",1950,1661,1641,9,20,"U.C.E.",0
41,"41902",4682,3136,3101,34,35,"U.C.E.",0
10,"10164",770,557,547,2,10,"U.C.E.",0
50,"50083",96,72,72,1,0,"U.C.E.",0
17,"17125",132,90,89,1,1,"U.C.E.",0
37,"37038",808,671,664,6,7,"U.C.E.",1
12,"12001",1098,821,817,8,4,"U.C.E.",0
5,"5059",112,91,88,1,3,"U.C.E.",0
8,"8106",6858,4675,4559,113,116,"U.C.E.",10
3,"3134",159,129,126,0,3,"U.C.E.",0
34,"34171",1071,762,753,16,9,"U.C.E.",0
37,"37350",452,368,364,5,4,"U.C.E.",0
37,"37039",325,241,236,0,5,"U.C.E.",0
19,"19278",30,28,28,0,0,"U.C.E.",0
20,"20049",4081,2741,2723,30,18,"U.C.E.",1
7,"7028",876,607,595,6,12,"U.C.E.",0
37,"37275",136,98,98,0,0,"U.C.E.",0
46,"46142",870,682,673,7,9,"U.C.E.",0
31,"31210",219,169,167,3,2,"U.C.E.",0
37,"37276",188,136,135,0,1,"U.C.E.",0
33,"33033",10609,7179,7107,91,72,"U.C.E.",3
45,"45126",278,188,187,0,1,"U.C.E.",0
39,"39066",895,710,703,6,7,"U.C.E.",0
46,"46239",457,331,323,2,8,"U.C.E.",0
40,"40028",106,89,88,1,1,"U.C.E.",0
17,"17035",548,385,379,7,6,"U.C.E.",0
16,"16068",143,117,116,6,1,"U.C.E.",0
5,"5126",78,70,70,0,0,"U.C.E.",0
42,"42001",308,242,237,4,5,"U.C.E.",0
15,"15031",22951,16018,15696,382,322,"U.C.E.",5
3,"3066",42697,31279,30833,566,446,"U.C.E.",31
26,"26161",9,8,8,0,0,"U.C.E.",0
50,"50175",1088,742,732,10,10,"U.C.E.",2
22,"22163",431,353,344,5,9,"U.C.E.",0
7,"7030",1576,1150,1135,26,15,"U.C.E.",0
50,"50260",42,35,35,1,0,"U.C.E.",0
40,"40029",50,43,42,0,1,"U.C.E.",0
10,"10168",318,240,238,1,2,"U.C.E.",0
47,"47166",276,226,223,0,3,"U.C.E.",0
50,"50116",220,154,153,0,1,"U.C.E.",0
45,"45202",3876,3037,2984,13,53,"U.C.E.",2
26,"26072",310,270,264,4,6,"U.C.E.",0
47,"47005",578,467,455,5,12,"U.C.E.",0
37,"37278",736,538,529,7,9,"U.C.E.",0
17,"17036",2822,1844,1806,36,38,"U.C.E.",1
46,"46144",699,547,536,2,11,"U.C.E.",0
33,"33035",11413,8105,8035,104,70,"U.C.E.",1
5,"5128",361,288,280,3,8,"U.C.E.",0
10,"10170",269,217,215,4,2,"U.C.E.",0
44,"44124",88,63,61,3,2,"U.C.E.",0
15,"15060",5599,4139,4069,82,70,"U.C.E.",6
50,"50262",1216,916,904,20,12,"U.C.E.",1
45,"45093",168,133,133,0,0,"U.C.E.",0
8,"8140",4665,3160,3103,55,57,"U.C.E.",2
22,"22111",180,126,125,3,1,"U.C.E.",0
19,"19073",24,20,19,0,1,"U.C.E.",0
47,"47167",258,230,229,3,1,"U.C.E.",0
31,"31092",676,447,446,6,1,"U.C.E.",2
3,"3069",2830,2009,1979,22,30,"U.C.E.",5
10,"10090",552,404,396,3,8,"U.C.E.",0
26,"26076",144,124,123,3,1,"U.C.E.",0
24,"24060",660,382,382,0,0,"U.C.E.",0
22,"22112",9618,6642,6533,205,109,"U.C.E.",7
19,"19282",210,157,157,0,0,"U.C.E.",0
47,"47006",196,151,146,1,5,"U.C.E.",0
16,"16204",306,235,235,5,0,"U.C.E.",0
50,"50178",325,228,225,4,3,"U.C.E.",0
22,"22218",49,33,33,1,0,"U.C.E.",0
3,"3036",84,72,72,0,0,"U.C.E.",0
19,"19217",85,57,54,2,3,"U.C.E.",0
31,"31215",4618,3384,3315,54,69,"U.C.E.",7
22,"22113",512,357,353,8,4,"U.C.E.",0
17,"17218",568,361,350,11,11,"U.C.E.",0
45,"45901",811,595,591,2,4,"U.C.E.",0
31,"31033",55,34,34,0,0,"U.C.E.",0
5,"5033",184,159,155,3,4,"U.C.E.",0
17,"17220",780,550,545,13,5,"U.C.E.",0
18,"18178",834,685,683,3,2,"U.C.E.",0
5,"5228",193,146,145,1,1,"U.C.E.",0
14,"14052",9720,6444,6384,58,60,"U.C.E.",2
20,"20020",143,104,104,1,0,"U.C.E.",0
34,"34092",331,272,267,6,5,"U.C.E.",0
50,"50089",6673,4936,4877,120,59,"U.C.E.",1
40,"40178",104,80,79,1,1,"U.C.E.",0
36,"36038",65661,47940,47214,836,726,"U.C.E.",31
16,"16078",40954,30382,29933,568,449,"U.C.E.",28
46,"46073",1119,931,915,14,16,"U.C.E.",0
24,"24182",448,339,333,9,6,"U.C.E.",0
45,"45133",2803,2241,2199,18,42,"U.C.E.",0
16,"16035",287,216,213,2,3,"U.C.E.",0
33,"33015",1695,1177,1161,12,16,"U.C.E.",0
5,"5195",241,168,164,0,4,"U.C.E.",1
46,"46001",863,647,641,5,6,"U.C.E.",0
18,"18179",583,417,409,7,8,"U.C.E.",0
8,"8144",769,494,481,16,13,"U.C.E.",0
22,"22909",349,259,252,3,7,"U.C.E.",0
16,"16079",33,21,21,0,0,"U.C.E.",0
19,"19285",26,20,20,2,0,"U.C.E.",0
47,"47088",121,100,100,0,0,"U.C.E.",0
34,"34136",192,122,122,1,0,"U.C.E.",0
12,"12008",236,203,199,4,4,"U.C.E.",0
15,"15092",6869,4965,4907,53,58,"U.C.E.",1
44,"44252",78,63,60,0,3,"U.C.E.",0
15,"15064",2356,1859,1824,35,35,"U.C.E.",1
24,"24146",284,223,221,0,2,"U.C.E.",0
26,"26170",471,353,348,4,5,"U.C.E.",0
5,"5101",297,224,222,4,2,"U.C.E.",0
22,"22117",2585,1880,1848,57,32,"U.C.E.",1
45,"45098",2273,1799,1756,11,43,"U.C.E.",0
10,"10054",551,435,428,6,7,"U.C.E.",1
46,"46002",1166,942,915,7,27,"U.C.E.",0
45,"45099",3449,2451,2405,22,46,"U.C.E.",0
44,"44130",38,27,27,0,0,"U.C.E.",0
41,"41045",5505,3946,3889,68,57,"U.C.E.",1
38,"38014",1446,1018,1007,8,11,"U.C.E.",0
40,"40040",2677,1990,1966,24,24,"U.C.E.",0
40,"40181",4413,3439,3361,43,78,"U.C.E.",5
8,"8115",3870,2693,2644,60,49,"U.C.E.",4
17,"17042",415,297,292,2,5,"U.C.E.",0
26,"26171",212,171,170,6,1,"U.C.E.",1
50,"50007",61,45,45,0,0,"U.C.E.",0
37,"37174",1150,942,922,3,20,"U.C.E.",0
17,"17136",173,124,120,0,4,"U.C.E.",1
16,"16213",39,32,32,1,0,"U.C.E.",0
16,"16123",110,74,73,1,1,"U.C.E.",0
44,"44007",194,152,145,3,7,"U.C.E.",0
47,"47011",600,493,489,4,4,"U.C.E.",0
46,"46076",651,541,528,2,13,"U.C.E.",0
17,"17103",4988,2788,2724,51,64,"U.C.E.",3
26,"26172",35,29,29,0,0,"U.C.E.",0
46,"46149",398,307,305,1,2,"U.C.E.",0
38,"38016",1250,664,646,3,18,"U.C.E.",1
26,"26043",397,313,306,6,7,"U.C.E.",0
47,"47172",149,125,124,3,1,"U.C.E.",0
3,"3076",8373,6319,6222,68,97,"U.C.E.",1
40,"40043",1842,1494,1469,28,25,"U.C.E.",0
19,"19288",22,21,21,0,0,"U.C.E.",0
39,"39048",1616,1326,1308,8,18,"U.C.E.",0
50,"50036",103,81,80,2,1,"U.C.E.",0
26,"26128",116,94,93,0,1,"U.C.E.",0
45,"45027",433,352,349,1,3,"U.C.E.",1
10,"10180",5446,3957,3917,28,40,"U.C.E.",10
31,"31039",94,65,61,0,4,"U.C.E.",0
16,"16085",151,123,122,2,1,"U.C.E.",0
3,"3077",1411,1146,1130,14,16,"U.C.E.",0
46,"46077",7637,5979,5845,64,134,"U.C.E.",4
39,"39023",6048,4795,4747,43,48,"U.C.E.",1
36,"36011",1939,1189,1172,15,17,"U.C.E.",1
50,"50009",122,93,93,0,0,"U.C.E.",0
10,"10181",739,607,598,6,9,"U.C.E.",0
5,"5039",58,48,48,0,0,"U.C.E.",0
10,"10059",414,352,349,4,3,"U.C.E.",0
47,"47092",123,100,99,2,1,"U.C.E.",0
40,"40185",977,725,712,13,13,"U.C.E.",0
31,"31131",841,610,594,12,16,"U.C.E.",1
44,"44010",189,138,138,2,0,"U.C.E.",0
1,"1006",181,133,127,2,6,"U.C.E.",0
44,"44136",51,39,39,0,0,"U.C.E.",0
5,"5138",326,278,275,2,3,"U.C.E.",0
39,"39050",305,207,205,1,2,"U.C.E.",0
31,"31162",53,35,34,1,1,"U.C.E.",1
40,"40186",50,33,33,0,0,"U.C.E.",0
17,"17227",107,82,82,1,0,"U.C.E.",0
19,"19086",1655,1310,1295,10,15,"U.C.E.",0
17,"17139",1346,899,869,21,30,"U.C.E.",0
1,"1056",256,183,181,1,2,"U.C.E.",0
18,"18021",16026,11376,11219,186,157,"U.C.E.",7
10,"10183",1022,818,805,5,13,"U.C.E.",2
3,"3079",18028,14580,14317,189,263,"U.C.E.",24
50,"50096",49,35,35,0,0,"U.C.E.",0
38,"38019",12624,8174,8099,65,75,"U.C.E.",7
26,"26047",2076,1702,1682,17,20,"U.C.E.",2
45,"45105",426,326,322,2,4,"U.C.E.",1
44,"44012",389,297,293,5,4,"U.C.E.",0
16,"16088",125,103,103,1,0,"U.C.E.",0
16,"16171",1930,1616,1584,25,32,"U.C.E.",0
7,"7043",3522,2384,2345,35,39,"U.C.E.",6
50,"50186",44,30,29,0,1,"U.C.E.",0
18,"18153",8348,6170,6118,88,52,"U.C.E.",1
46,"46080",1090,860,849,2,11,"U.C.E.",1
31,"31225",40,32,32,0,0,"U.C.E.",0
8,"8060",167,102,101,0,1,"U.C.E.",0
17,"17228",280,172,170,4,2,"U.C.E.",0
22,"22128",203,164,161,7,3,"U.C.E.",0
15,"15014",4239,3151,3104,39,47,"U.C.E.",2
26,"26049",189,141,137,1,4,"U.C.E.",0
20,"20030",22191,15262,15148,164,114,"U.C.E.",32
44,"44013",11286,7797,7584,242,213,"U.C.E.",10
5,"5141",99,90,89,0,1,"U.C.E.",0
7,"7044",8326,6044,5846,99,198,"U.C.E.",2
47,"47176",229,157,157,0,0,"U.C.E.",0
37,"37180",69,46,46,0,0,"U.C.E.",0
36,"36015",4379,3151,3101,38,50,"U.C.E.",1
17,"17049",3056,1986,1944,43,42,"U.C.E.",3
3,"3081",1409,1102,1087,14,15,"U.C.E.",1
50,"50273",36,22,22,0,0,"U.C.E.",0
7,"7045",1189,843,823,23,20,"U.C.E.",0
10,"10186",1031,906,896,8,10,"U.C.E.",0
44,"44265",203,169,158,6,11,"U.C.E.",0
50,"50188",34,28,27,0,1,"U.C.E.",0
17,"17142",2440,1713,1681,39,32,"U.C.E.",0
38,"38022",18671,13075,12890,111,185,"U.C.E.",11
19,"19260",44,41,41,1,0,"U.C.E.",0
20,"20032",8949,6189,6117,55,72,"U.C.E.",5
45,"45182",1077,873,856,11,17,"U.C.E.",1
45,"45072",690,535,532,7,3,"U.C.E.",0
44,"44223",80,55,55,0,0,"U.C.E.",0
50,"50070",70,42,41,0,1,"U.C.E.",0
47,"47177",112,83,79,1,4,"U.C.E.",0
8,"8092",3928,2511,2473,33,38,"U.C.E.",1
22,"22235",101,88,87,1,1,"U.C.E.",0
8,"8062",863,595,583,8,12,"U.C.E.",1
22,"22131",96,79,77,2,2,"U.C.E.",0
18,"18093",2580,1837,1820,8,17,"U.C.E.",0
14,"14063",1121,875,866,9,9,"U.C.E.",1
12,"12118",83,63,62,0,1,"U.C.E.",0
46,"46009",3140,2521,2498,15,23,"U.C.E.",0
10,"10148",32554,23348,22955,365,393,"U.C.E.",28
8,"8124",36292,24541,24210,471,331,"U.C.E.",46
19,"19297",34,29,29,0,0,"U.C.E.",0
50,"50189",776,588,576,9,12,"U.C.E.",0
40,"40194",40248,30946,30365,525,581,"U.C.E.",35
24,"24158",333,223,223,6,0,"U.C.E.",0
22,"22133",123,87,85,2,2,"U.C.E.",0
37,"37297",441,376,369,1,7,"U.C.E.",0
18,"18192",1581,1331,1318,6,13,"U.C.E.",0
17,"17144",217,145,143,4,2,"U.C.E.",0
16,"16134",4283,3398,3361,59,37,"U.C.E.",4
42,"42121",77,56,56,1,0,"U.C.E.",0
14,"14003",1289,1046,1026,12,20,"U.C.E.",0
40,"40103",157,121,120,0,1,"U.C.E.",0
22,"22135",200,152,147,5,5,"U.C.E.",0
12,"12021",4433,3368,3292,42,76,"U.C.E.",1
39,"39055",1130,881,869,10,12,"U.C.E.",0
26,"26054",381,298,292,2,6,"U.C.E.",0
47,"47098",607,496,492,9,4,"U.C.E.",0
19,"19092",437,331,326,4,5,"U.C.E.",0
37,"37185",602,452,448,8,4,"U.C.E.",0
50,"50102",918,722,713,12,9,"U.C.E.",0
8,"8014",1906,1338,1313,37,25,"U.C.E.",0
10,"10191",527,421,414,3,7,"U.C.E.",0
19,"19095",14,9,8,0,1,"U.C.E.",0
16,"16096",279,231,229,7,2,"U.C.E.",0
14,"14065",1846,1509,1492,14,17,"U.C.E.",2
5,"5241",3145,2303,2273,27,30,"U.C.E.",2
1,"1018",1395,952,943,7,9,"U.C.E.",0
10,"10069",858,680,673,2,7,"U.C.E.",1
50,"50277",82,63,63,0,0,"U.C.E.",0
24,"24161",307,231,228,1,3,"U.C.E.",0
5,"5081",44,36,36,0,0,"U.C.E.",0
34,"34070",182,138,137,1,1,"U.C.E.",0
40,"40056",41,34,34,0,0,"U.C.E.",0
8,"8066",1315,985,965,16,20,"U.C.E.",1
16,"16237",116,98,98,3,0,"U.C.E.",0
22,"22137",1164,850,839,14,11,"U.C.E.",1
23,"23019",1590,1355,1339,7,16,"U.C.E.",0
26,"26057",52,42,42,0,0,"U.C.E.",0
40,"40199",110,88,86,3,2,"U.C.E.",0
50,"50104",379,306,303,4,3,"U.C.E.",0
37,"37301",78,58,58,0,0,"U.C.E.",0
41,"41055",15121,11082,10997,98,85,"U.C.E.",5
24,"24163",3706,2760,2714,57,46,"U.C.E.",0
19,"19200",150,105,105,1,0,"U.C.E.",0
18,"18194",2258,1656,1652,11,4,"U.C.E.",0
50,"50193",635,483,465,3,18,"U.C.E.",0
26,"26058",151,114,109,1,5,"U.C.E.",0
8,"8158",2996,2012,1986,19,26,"U.C.E.",1
50,"50046",201,155,153,2,2,"U.C.E.",0
26,"26145",251,201,199,3,2,"U.C.E.",0
31,"31232",24440,17810,17436,420,374,"U.C.E.",16
17,"17902",1330,898,874,11,24,"U.C.E.",1
14,"14067",3821,3105,3082,38,23,"U.C.E.",0
45,"45004",603,497,494,6,3,"U.C.E.",0
38,"38028",22003,14876,14589,158,287,"U.C.E.",6
18,"18901",583,374,368,3,6,"U.C.E.",0
20,"20039",2003,1517,1512,9,5,"U.C.E.",0
8,"8159",13482,9173,9040,239,133,"U.C.E.",10
16,"16099",232,180,178,5,2,"U.C.E.",0
5,"5083",155,120,113,1,7,"U.C.E.",0
10,"10155",1156,829,819,4,10,"U.C.E.",0
24,"24005",437,308,305,3,3,"U.C.E.",0
39,"39059",8476,6365,6284,73,81,"U.C.E.",0
42,"42129",706,523,509,14,14,"U.C.E.",0
36,"36056",5087,3883,3830,37,53,"U.C.E.",7
17,"17149",366,254,251,4,3,"U.C.E.",0
44,"44024",24,19,19,0,0,"U.C.E.",0
42,"42182",62,53,53,2,0,"U.C.E.",0
40,"40202",79,59,58,0,1,"U.C.E.",0
38,"38030",1875,1320,1301,11,19,"U.C.E.",1
44,"44151",215,143,140,1,3,"U.C.E.",1
3,"3091",256,220,219,1,1,"U.C.E.",0
37,"37303",207,158,152,3,6,"U.C.E.",0
50,"50280",370,296,291,5,5,"U.C.E.",4
45,"45117",800,679,668,7,11,"U.C.E.",0
34,"34074",764,610,597,11,13,"U.C.E.",1
40,"40062",54,44,44,0,0,"U.C.E.",0
42,"42033",54,48,48,0,0,"U.C.E.",0
31,"31143",105,62,58,2,4,"U.C.E.",0
19,"19203",35,27,27,0,0,"U.C.E.",0
7,"7054",19930,11186,11028,196,158,"U.C.E.",12
20,"20078",1146,885,884,6,1,"U.C.E.",0
10,"10198",1213,1068,1054,12,14,"U.C.E.",0
26,"26105",2181,1712,1690,24,22,"U.C.E.",0
12,"12126",24420,18431,18136,231,295,"U.C.E.",6
16,"16243",451,395,388,3,7,"U.C.E.",0
50,"50281",76,63,63,2,0,"U.C.E.",0
22,"22144",258,203,203,5,0,"U.C.E.",0
47,"47024",283,211,210,1,1,"U.C.E.",0
8,"8161",10991,6841,6709,114,132,"U.C.E.",7
31,"31053",595,430,418,6,12,"U.C.E.",0
42,"42034",40,29,29,0,0,"U.C.E.",0
36,"36025",2442,1531,1516,10,15,"U.C.E.",1
26,"26063",131,104,102,2,2,"U.C.E.",0
41,"41059",31676,23199,22889,330,310,"U.C.E.",1
42,"42185",29,23,23,1,0,"U.C.E.",0
37,"37193",432,310,309,5,1,"U.C.E.",2
12,"12127",92,64,61,0,3,"U.C.E.",0
38,"38032",13032,8487,8357,101,130,"U.C.E.",7
31,"31236",1333,887,874,15,13,"U.C.E.",0
30,"30013",7369,5780,5731,53,49,"U.C.E.",2
18,"18003",13486,10245,10100,145,145,"U.C.E.",6
8,"8162",1955,1306,1271,28,35,"U.C.E.",3
22,"22008",194,168,167,11,1,"U.C.E.",1
18,"18101",8990,6659,6556,96,103,"U.C.E.",3
50,"50198",46,36,36,2,0,"U.C.E.",0
19,"19104",16,12,12,1,0,"U.C.E.",0
40,"40206",179,136,134,0,2,"U.C.E.",1
37,"37233",59,46,45,1,1,"U.C.E.",0
20,"20008",757,499,499,8,0,"U.C.E.",0
45,"45010",471,374,372,2,2,"U.C.E.",0
7,"7057",7102,4702,4611,85,91,"U.C.E.",6
22,"22009",704,488,473,15,15,"U.C.E.",1
42,"42036",52,40,39,2,1,"U.C.E.",0
40,"40207",724,551,540,9,11,"U.C.E.",0
23,"23030",1270,1052,1045,3,7,"U.C.E.",1
45,"45011",316,271,268,1,3,"U.C.E.",0
15,"15082",15075,11217,11046,187,171,"U.C.E.",10
10,"10202",665,533,523,7,10,"U.C.E.",0
19,"19209",50,40,39,0,1,"U.C.E.",0
10,"10080",385,294,287,0,7,"U.C.E.",0
50,"50284",176,131,130,1,1,"U.C.E.",0
23,"23031",771,649,646,6,3,"U.C.E.",0
46,"46236",996,853,844,7,9,"U.C.E.",0
45,"45085",1511,1111,1100,10,11,"U.C.E.",1
4,"4058",402,324,322,5,2,"U.C.E.",0
23,"23032",598,518,515,0,3,"U.C.E.",0
7,"7059",3011,2077,2012,22,65,"U.C.E.",0
34,"34081",53,42,41,0,1,"U.C.E.",0
18,"18005",366,279,277,3,2,"U.C.E.",0
19,"19106",95,68,66,0,2,"U.C.E.",0
19,"19210",34,29,29,1,0,"U.C.E.",0
8,"8258",845,577,555,23,22,"U.C.E.",0
45,"45013",1870,1504,1486,5,18,"U.C.E.",0
5,"5057",2593,2172,2152,16,20,"U.C.E.",0
38,"38036",6477,4514,4422,40,92,"U.C.E.",8
10,"10082",1947,1601,1572,10,29,"U.C.E.",1
8,"8075",3906,2442,2414,31,28,"U.C.E.",6
33,"33054",1780,1272,1263,8,9,"U.C.E.",3
17,"17154",93,54,49,1,5,"U.C.E.",0
50,"50257",195,154,154,0,0,"U.C.E.",1
47,"47106",63,52,52,0,0,"U.C.E.",0
8,"8166",1138,726,706,10,20,"U.C.E.",1
37,"37198",212,176,173,2,3,"U.C.E.",0
5,"5253",95,75,74,0,1,"U.C.E.",0
50,"50286",90,73,73,2,0,"U.C.E.",0
37,"37312",278,232,229,1,3,"U.C.E.",0
18,"18007",808,602,591,5,11,"U.C.E.",0
4,"4059",1231,837,830,8,7,"U.C.E.",1
42,"42042",46,35,33,1,2,"U.C.E.",0
24,"24094",1466,1023,1006,24,17,"U.C.E.",4
35,"35006",29515,20731,20286,362,445,"U.C.E.",11
37,"37313",581,440,435,7,5,"U.C.E.",2
22,"22014",265,192,191,1,1,"U.C.E.",0
39,"39065",272,199,197,2,2,"U.C.E.",0
10,"10165",274,231,229,0,2,"U.C.E.",0
18,"18107",988,769,760,3,9,"U.C.E.",0
44,"44034",150,117,117,1,0,"U.C.E.",0
47,"47028",31,21,20,0,1,"U.C.E.",0
1,"1036",15236,10511,10372,141,139,"U.C.E.",12
7,"7062",7206,4073,4035,72,38,"U.C.E.",9
47,"47190",103,87,87,7,0,"U.C.E.",0
41,"41064",5629,4041,4006,28,35,"U.C.E.",1
44,"44160",473,315,312,8,3,"U.C.E.",0
23,"23037",513,430,424,3,6,"U.C.E.",0
11,"11017",3219,2403,2388,18,15,"U.C.E.",2
17,"17094",1161,694,683,11,11,"U.C.E.",0
20,"20050",293,213,211,3,2,"U.C.E.",1
31,"31242",235,157,157,2,0,"U.C.E.",0
47,"47029",61,54,53,0,1,"U.C.E.",0
20,"20906",117,89,89,0,0,"U.C.E.",0
45,"45016",3804,2926,2876,52,50,"U.C.E.",0
17,"17158",404,266,264,3,2,"U.C.E.",0
37,"37164",280,217,213,9,4,"U.C.E.",0
31,"31029",987,693,680,16,13,"U.C.E.",2
19,"19314",46,41,41,0,0,"U.C.E.",0
8,"8262",6835,4086,3993,94,93,"U.C.E.",6
42,"42045",345,238,234,2,4,"U.C.E.",0
41,"41013",4762,3359,3327,9,32,"U.C.E.",0
50,"50203",1083,814,798,28,16,"U.C.E.",3
30,"30019",25722,18740,18553,164,187,"U.C.E.",6
17,"17067",732,483,470,16,13,"U.C.E.",2
46,"46167",411,312,309,0,3,"U.C.E.",0
10,"10209",297,217,213,3,4,"U.C.E.",0
45,"45055",1052,886,870,10,16,"U.C.E.",0
3,"3034",1343,1140,1126,5,14,"U.C.E.",0
24,"24219",580,435,431,10,4,"U.C.E.",0
50,"50029",676,527,517,6,10,"U.C.E.",0
36,"36034",3684,2686,2651,32,35,"U.C.E.",5
15,"15088",3769,2626,2599,21,27,"U.C.E.",0
31,"31244",153,97,97,3,0,"U.C.E.",0
1,"1041",159,116,113,1,3,"U.C.E.",0
8,"8170",458,300,288,13,12,"U.C.E.",0
44,"44164",32,25,25,0,0,"U.C.E.",0
17,"17068",252,156,156,4,0,"U.C.E.",0
46,"46095",632,505,495,1,10,"U.C.E.",0
17,"17160",14852,9257,9128,145,129,"U.C.E.",7
50,"50205",98,72,71,2,1,"U.C.E.",0
30,"30020",5989,4533,4487,14,46,"U.C.E.",4
31,"31062",1103,849,832,7,17,"U.C.E.",1
16,"16258",288,215,213,1,2,"U.C.E.",0
1,"1042",915,678,661,1,17,"U.C.E.",1
42,"42198",24,17,17,0,0,"U.C.E.",0
8,"8079",335,255,243,14,12,"U.C.E.",0
16,"16032",304,253,244,2,9,"U.C.E.",0
42,"42153",19,16,16,0,0,"U.C.E.",0
4,"4028",239,212,207,0,5,"U.C.E.",0
42,"42200",98,70,67,1,3,"U.C.E.",0
23,"23042",359,278,277,0,1,"U.C.E.",0
3,"3103",288,248,243,2,5,"U.C.E.",2
41,"41067",7055,5368,5295,64,73,"U.C.E.",0
17,"17069",395,276,267,2,9,"U.C.E.",0
18,"18913",827,653,646,2,7,"U.C.E.",0
50,"50291",112,75,73,0,2,"U.C.E.",0
47,"47222",92,77,77,4,0,"U.C.E.",1
31,"31246",148,101,100,3,1,"U.C.E.",0
31,"31063",96,77,75,0,2,"U.C.E.",0
15,"15006",5539,3940,3866,53,74,"U.C.E.",0
42,"42050",29,20,20,1,0,"U.C.E.",0
12,"12041",115,98,98,2,0,"U.C.E.",0
38,"38044",2325,1550,1532,7,18,"U.C.E.",2
10,"10213",605,478,477,1,1,"U.C.E.",1
47,"47033",209,170,168,3,2,"U.C.E.",0
20,"20019",10105,6640,6555,73,85,"U.C.E.",6
37,"37320",96,70,70,0,0,"U.C.E.",0
34,"34051",112,92,91,7,1,"U.C.E.",0
37,"37131",200,150,148,1,2,"U.C.E.",0
10,"10092",316,263,262,1,1,"U.C.E.",0
45,"45022",427,317,314,8,3,"U.C.E.",0
24,"24023",272,196,193,6,3,"U.C.E.",0
10,"10093",413,339,332,2,7,"U.C.E.",0
12,"12138",18762,12489,12231,243,258,"U.C.E.",10
50,"50150",716,430,427,10,3,"U.C.E.",0
44,"44042",139,87,87,0,0,"U.C.E.",0
42,"42052",17,10,10,0,0,"U.C.E.",0
47,"47034",90,65,63,0,2,"U.C.E.",0
39,"39045",410,324,323,5,1,"U.C.E.",0
5,"5066",480,397,392,5,5,"U.C.E.",0
18,"18114",678,508,508,6,0,"U.C.E.",0
31,"31065",1927,1391,1362,39,29,"U.C.E.",2
40,"40223",241,190,190,2,0,"U.C.E.",1
5,"5165",386,292,280,7,12,"U.C.E.",0
40,"40083",88,72,72,1,0,"U.C.E.",0
45,"45134",1606,1260,1242,10,18,"U.C.E.",0
44,"44004",450,334,332,2,2,"U.C.E.",2
50,"50208",1831,1321,1305,24,16,"U.C.E.",2
44,"44088",32,31,31,1,0,"U.C.E.",0
4,"4068",187,137,137,1,0,"U.C.E.",0
22,"22023",474,382,380,4,2,"U.C.E.",0
37,"37208",92,59,58,0,1,"U.C.E.",0
34,"34094",64,47,44,1,3,"U.C.E.",0
50,"50121",297,250,245,6,5,"U.C.E.",0
46,"46099",987,764,754,2,10,"U.C.E.",0
45,"45025",1237,919,907,11,12,"U.C.E.",1
46,"46172",4838,3492,3445,24,47,"U.C.E.",3
26,"26081",23,17,17,0,0,"U.C.E.",0
19,"19220",2225,1482,1456,7,26,"U.C.E.",2
10,"10096",3384,2581,2533,32,48,"U.C.E.",2
8,"8003",6983,5061,4993,53,68,"U.C.E.",11
3,"3109",2745,2332,2302,18,30,"U.C.E.",1
47,"47036",257,212,212,1,0,"U.C.E.",0
8,"8177",52,31,31,1,0,"U.C.E.",0
16,"16122",259,195,190,2,5,"U.C.E.",0
8,"8004",228,176,172,2,4,"U.C.E.",0
36,"36041",13141,9405,9238,114,167,"U.C.E.",6
18,"18017",17990,12070,11962,80,108,"U.C.E.",1
4,"4070",1649,1267,1255,9,12,"U.C.E.",0
23,"23048",884,691,679,6,12,"U.C.E.",0
45,"45136",5891,4414,4368,55,46,"U.C.E.",2
37,"37013",133,93,85,5,8,"U.C.E.",0
50,"50064",469,377,373,5,4,"U.C.E.",0
50,"50035",78,61,56,2,5,"U.C.E.",0
10,"10219",1408,984,971,11,13,"U.C.E.",0
19,"19005",92,80,79,0,1,"U.C.E.",0
37,"37325",102,77,77,0,0,"U.C.E.",0
22,"22027",351,251,250,8,1,"U.C.E.",1
17,"17166",503,361,342,10,19,"U.C.E.",0
47,"47198",71,56,56,2,0,"U.C.E.",0
36,"36042",17897,12635,12437,157,198,"U.C.E.",10
50,"50211",277,193,193,1,0,"U.C.E.",0
8,"8005",5884,4114,4041,68,73,"U.C.E.",4
10,"10901",1148,844,839,18,5,"U.C.E.",1
1,"1053",590,341,333,4,8,"U.C.E.",0
17,"17196",209,139,138,6,1,"U.C.E.",0
14,"14056",23507,17245,17071,259,174,"U.C.E.",2
10,"10057",166,133,133,0,0,"U.C.E.",0
46,"46247",1059,829,823,6,6,"U.C.E.",0
45,"45028",3696,3059,3024,40,35,"U.C.E.",0
24,"24188",3830,2987,2928,51,59,"U.C.E.",1
46,"46174",1003,854,847,6,7,"U.C.E.",0
16,"16272",273,215,215,2,0,"U.C.E.",0
5,"5072",91,72,72,1,0,"U.C.E.",0
23,"23051",2805,2312,2290,8,22,"U.C.E.",1
50,"50125",421,284,280,1,4,"U.C.E.",0
19,"19119",93,80,79,2,1,"U.C.E.",0
10,"10902",727,608,599,5,9,"U.C.E.",0
50,"50212",52,48,48,0,0,"U.C.E.",0
12,"12902",2056,1454,1411,14,43,"U.C.E.",0
8,"8007",6338,4165,4050,89,115,"U.C.E.",3
22,"22178",107,92,92,1,0,"U.C.E.",0
10,"10100",792,554,538,1,16,"U.C.E.",0
24,"24069",53,44,44,0,0,"U.C.E.",0
16,"16003",147,122,121,0,1,"U.C.E.",0
47,"47200",91,73,73,0,0,"U.C.E.",0
44,"44177",120,85,85,1,0,"U.C.E.",1
16,"16043",105,86,86,1,0,"U.C.E.",0
26,"26006",1853,1456,1430,15,26,"U.C.E.",3
16,"16273",328,277,275,2,2,"U.C.E.",0
45,"45030",486,378,374,4,4,"U.C.E.",0
36,"36045",24724,17794,17459,237,335,"U.C.E.",17
22,"22229",127,93,89,4,4,"U.C.E.",0
11,"11001",4389,3110,3072,13,38,"U.C.E.",1
19,"19225",879,625,618,9,7,"U.C.E.",0
38,"38052",1344,886,872,5,14,"U.C.E.",1
42,"42061",297,190,188,4,2,"U.C.E.",0
46,"46103",1244,998,972,12,26,"U.C.E.",2
44,"44050",3183,2208,2154,78,54,"U.C.E.",0
24,"24071",1060,808,797,6,11,"U.C.E.",0
50,"50214",31,22,21,1,1,"U.C.E.",0
44,"44179",369,245,243,6,2,"U.C.E.",0
40,"40901",379,292,288,11,4,"U.C.E.",0
47,"47040",67,51,50,0,1,"U.C.E.",0
19,"19122",96,65,65,0,0,"U.C.E.",0
37,"37291",261,215,214,1,1,"U.C.E.",1
40,"40002",38,31,31,1,0,"U.C.E.",0
34,"34103",105,92,92,5,0,"U.C.E.",0
26,"26091",165,139,139,0,0,"U.C.E.",0
37,"37103",483,354,351,1,3,"U.C.E.",0
40,"40902",137,118,118,3,0,"U.C.E.",0
40,"40189",560,455,438,6,17,"U.C.E.",0
16,"16276",32,23,22,1,1,"U.C.E.",0
14,"14061",841,700,693,3,7,"U.C.E.",0
44,"44052",96,60,59,2,1,"U.C.E.",0
1,"1058",1342,877,872,8,5,"U.C.E.",0
34,"34104",274,224,224,4,0,"U.C.E.",0
22,"22037",115,87,79,0,8,"U.C.E.",0
12,"12052",627,510,491,9,19,"U.C.E.",0
37,"37332",78,52,49,0,3,"U.C.E.",0
39,"39079",9035,6959,6897,55,62,"U.C.E.",4
47,"47041",166,135,133,2,2,"U.C.E.",0
14,"14001",3633,3095,3064,25,31,"U.C.E.",0
3,"3116",1167,912,904,12,8,"U.C.E.",2
50,"50041",21,13,13,0,0,"U.C.E.",0
37,"37219",197,121,120,0,1,"U.C.E.",0
18,"18123",307,239,238,1,1,"U.C.E.",0
17,"17081",236,165,162,2,3,"U.C.E.",0
24,"24076",1210,917,907,26,10,"U.C.E.",0
22,"22130",9983,6691,6573,148,118,"U.C.E.",5
46,"46033",220,183,181,0,2,"U.C.E.",0
10,"10065",188,123,123,1,0,"U.C.E.",0
37,"37182",92,72,72,2,0,"U.C.E.",0
5,"5142",113,97,96,0,1,"U.C.E.",0
20,"20068",199,132,129,2,3,"U.C.E.",0
46,"46179",2186,1849,1804,17,45,"U.C.E.",1
37,"37370",345,261,260,1,1,"U.C.E.",0
37,"37296",385,311,308,3,3,"U.C.E.",0
31,"31258",7679,5561,5475,92,86,"U.C.E.",2
8,"8012",1694,1155,1136,32,19,"U.C.E.",0
14,"14002",10991,8444,8358,106,86,"U.C.E.",0
47,"47206",111,99,99,0,0,"U.C.E.",0
10,"10107",1062,832,821,7,11,"U.C.E.",1
17,"17082",443,285,280,1,5,"U.C.E.",0
11,"11005",4617,3287,3214,26,73,"U.C.E.",0
45,"45036",704,559,537,4,22,"U.C.E.",0
3,"3017",380,331,324,7,7,"U.C.E.",0
33,"33069",3611,2615,2597,25,18,"U.C.E.",0
22,"22188",100,68,66,3,2,"U.C.E.",1
42,"42069",1591,1122,1114,33,8,"U.C.E.",4
7,"7014",6697,3818,3757,38,61,"U.C.E.",2
39,"39003",321,265,261,0,4,"U.C.E.",0
39,"39002",3400,2554,2514,35,40,"U.C.E.",0
33,"33024",229816,164603,163179,2100,1424,"U.C.E.",61
38,"38024",14851,9589,9399,93,190,"U.C.E.",3
41,"41094",6089,4757,4680,47,77,"U.C.E.",1
20,"20034",3192,2035,2030,11,5,"U.C.E.",0
22,"22042",115,93,91,1,2,"U.C.E.",0
31,"31168",247,165,163,0,2,"U.C.E.",1
46,"46107",1998,1650,1623,8,27,"U.C.E.",1
34,"34245",322,240,236,3,4,"U.C.E.",0
37,"37223",127,102,101,1,1,"U.C.E.",0
42,"42070",45,29,28,0,1,"U.C.E.",0
16,"16137",64,41,40,0,1,"U.C.E.",0
11,"11006",24221,16564,16470,197,94,"U.C.E.",15
37,"37373",793,591,589,4,2,"U.C.E.",1
37,"37025",264,217,216,1,1,"U.C.E.",1
8,"8125",24559,16065,15798,293,267,"U.C.E.",33
34,"34109",62,47,46,0,1,"U.C.E.",0
24,"24201",1123,790,777,14,13,"U.C.E.",0
50,"50249",333,280,272,2,8,"U.C.E.",1
36,"36052",7517,5563,5461,54,102,"U.C.E.",3
1,"1901",2254,1561,1528,24,33,"U.C.E.",3
23,"23062",1476,1274,1264,2,10,"U.C.E.",0
37,"37224",216,190,186,5,4,"U.C.E.",0
17,"17901",964,628,621,16,7,"U.C.E.",0
8,"8280",116,74,72,3,2,"U.C.E.",0
40,"40105",60,51,51,1,0,"U.C.E.",0
37,"37225",119,101,95,3,6,"U.C.E.",1
14,"14005",6334,4262,4206,61,56,"U.C.E.",0
18,"18128",361,284,283,5,1,"U.C.E.",1
50,"50045",1289,1011,992,14,19,"U.C.E.",2
19,"19130",58473,45114,44362,688,752,"U.C.E.",30
47,"47209",43,33,33,0,0,"U.C.E.",0
17,"17085",295,212,208,12,4,"U.C.E.",0
19,"19901",43,34,34,0,0,"U.C.E.",0
45,"45040",1504,1058,1046,5,12,"U.C.E.",1
20,"20001",249,167,167,4,0,"U.C.E.",0
42,"42075",91,71,70,1,1,"U.C.E.",0
44,"44190",81,52,52,0,0,"U.C.E.",0
5,"5082",569,467,462,1,5,"U.C.E.",0
37,"37226",167,129,127,1,2,"U.C.E.",0
37,"37339",345,280,279,3,1,"U.C.E.",1
37,"37070",538,428,427,12,1,"U.C.E.",0
4,"4050",818,611,602,5,9,"U.C.E.",1
40,"40106",232,173,173,3,0,"U.C.E.",0
22,"22197",504,395,390,7,5,"U.C.E.",0
34,"34114",240,171,171,0,0,"U.C.E.",0
16,"16904",508,413,407,10,6,"U.C.E.",0
26,"26102",6158,4794,4716,60,78,"U.C.E.",1
15,"15021",5114,3527,3475,77,52,"U.C.E.",2
16,"16141",161,132,131,1,1,"U.C.E.",0
45,"45152",653,503,497,2,6,"U.C.E.",0
41,"41004",55127,37662,37179,622,483,"U.C.E.",18
45,"45079",368,278,273,1,5,"U.C.E.",0
42,"42181",453,357,347,7,10,"U.C.E.",0
12,"12025",146,106,105,0,1,"U.C.E.",0
5,"5213",117,94,88,0,6,"U.C.E.",0
47,"47211",45,38,38,1,0,"U.C.E.",0
42,"42031",31,19,19,0,0,"U.C.E.",0
17,"17178",1075,683,679,15,4,"U.C.E.",0
34,"34904",355,247,241,3,6,"U.C.E.",0
8,"8192",5450,3688,3634,79,54,"U.C.E.",6
31,"31172",375,295,288,11,7,"U.C.E.",0
24,"24084",182,133,132,1,1,"U.C.E.",0
19,"19020",52,39,39,3,0,"U.C.E.",0
19,"19171",4352,3299,3221,35,78,"U.C.E.",2
44,"44192",401,324,322,5,2,"U.C.E.",0
45,"45043",827,679,670,3,9,"U.C.E.",1
16,"16017",406,337,334,1,3,"U.C.E.",0
22,"22201",287,203,198,2,5,"U.C.E.",0
5,"5182",862,673,668,2,5,"U.C.E.",0
17,"17180",8076,4868,4767,81,101,"U.C.E.",0
30,"30037",17942,13830,13734,90,96,"U.C.E.",11
16,"16145",508,421,417,6,4,"U.C.E.",0
42,"42081",158,131,131,3,0,"U.C.E.",0
26,"26149",67,50,49,1,1,"U.C.E.",0
41,"41006",2743,1972,1957,13,15,"U.C.E.",0
19,"19021",1129,818,800,10,18,"U.C.E.",2
5,"5119",41,31,31,0,0,"U.C.E.",0
37,"37343",56,42,40,0,2,"U.C.E.",0
24,"24087",670,513,513,12,0,"U.C.E.",0
14,"14010",4087,3144,3121,15,23,"U.C.E.",1
45,"45046",2455,1884,1862,11,22,"U.C.E.",0
50,"50050",109,73,73,1,0,"U.C.E.",0
36,"36058",5021,3589,3516,54,73,"U.C.E.",0
31,"31174",115,72,70,1,2,"U.C.E.",0
50,"50139",372,280,278,3,2,"U.C.E.",0
8,"8285",10168,6582,6423,152,159,"U.C.E.",6
46,"46113",2338,1804,1797,14,7,"U.C.E.",0
3,"3059",20261,15951,15825,82,126,"U.C.E.",16
3,"3128",3944,2847,2812,16,35,"U.C.E.",4
37,"37345",179,156,156,2,0,"U.C.E.",0
3,"3026",1210,1004,989,11,15,"U.C.E.",1
11,"11013",2284,1691,1670,15,21,"U.C.E.",1
16,"16147",78,63,62,1,1,"U.C.E.",0
50,"50901",170,122,121,1,1,"U.C.E.",0
8,"8286",2865,1843,1796,30,47,"U.C.E.",3
31,"31175",78,55,54,0,1,"U.C.E.",0
37,"37382",202,172,171,3,1,"U.C.E.",0
24,"24212",1105,856,846,14,10,"U.C.E.",1
36,"36060",30264,21398,21051,344,347,"U.C.E.",19
10,"10079",891,711,706,6,5,"U.C.E.",0
42,"42083",28,25,25,0,0,"U.C.E.",1
30,"30040",733,640,635,2,5,"U.C.E.",1
23,"23072",2063,1661,1643,16,18,"U.C.E.",0
31,"31176",2777,1999,1955,57,44,"U.C.E.",2
37,"37346",264,211,210,1,1,"U.C.E.",0
39,"39010",688,533,524,6,9,"U.C.E.",0
16,"16148",634,553,547,5,6,"U.C.E.",0
36,"36061",8729,6747,6640,68,107,"U.C.E.",8
45,"45048",388,310,308,2,2,"U.C.E.",0
45,"45049",394,315,315,6,0,"U.C.E.",0
34,"34124",70,55,55,1,0,"U.C.E.",0
41,"41009",1272,914,899,8,15,"U.C.E.",0
4,"4090",435,338,335,3,3,"U.C.E.",0
37,"37235",226,194,192,0,2,"U.C.E.",1
16,"16193",77,68,67,0,1,"U.C.E.",1
17,"17091",433,288,277,16,11,"U.C.E.",0
46,"46115",515,364,354,1,10,"U.C.E.",0
17,"17183",261,178,176,2,2,"U.C.E.",0
50,"50053",756,570,563,14,7,"U.C.E.",0
39,"39011",1646,1295,1294,5,1,"U.C.E.",0
23,"23074",3039,2491,2451,29,40,"U.C.E.",3
31,"31177",264,162,158,3,4,"U.C.E.",0
30,"30041",12957,9360,9288,89,72,"U.C.E.",8
10,"10122",253,197,191,2,6,"U.C.E.",0
35,"35005",1170,864,853,7,11,"U.C.E.",0
46,"46188",660,579,576,4,3,"U.C.E.",1
36,"36901",4085,3285,3235,21,50,"U.C.E.",2
18,"18171",2093,1719,1704,10,15,"U.C.E.",0
50,"50903",2234,1622,1597,35,25,"U.C.E.",1
37,"37236",163,123,119,4,4,"U.C.E.",0
44,"44074",435,344,337,5,7,"U.C.E.",0
16,"16151",66,56,56,0,0,"U.C.E.",0
45,"45160",1104,911,896,12,15,"U.C.E.",2
37,"37349",136,105,104,2,1,"U.C.E.",0
33,"33078",159,108,106,1,2,"U.C.E.",0
47,"47137",27,22,22,2,0,"U.C.E.",0
19,"19031",18,11,11,0,0,"U.C.E.",0
16,"16025",31,23,23,0,0,"U.C.E.",0
12,"12069",53,48,47,0,1,"U.C.E.",0
4,"4092",2897,2351,2325,13,26,"U.C.E.",4
15,"15029",6266,4668,4618,49,50,"U.C.E.",0
45,"45199",2712,1817,1796,17,21,"U.C.E.",2
16,"16026",104,79,79,1,0,"U.C.E.",0
8,"8290",1446,1075,1056,12,19,"U.C.E.",0
19,"19143",1610,1287,1268,9,19,"U.C.E.",1
17,"17004",504,340,337,6,3,"U.C.E.",0
42,"42144",464,343,331,3,12,"U.C.E.",2
8,"8137",255,190,190,3,0,"U.C.E.",0
24,"24217",144,108,107,2,1,"U.C.E.",0
10,"10125",925,705,689,3,16,"U.C.E.",0
31,"31241",164,117,116,4,1,"U.C.E.",0
41,"41090",3488,2792,2751,22,41,"U.C.E.",1
47,"47218",983,776,767,7,9,"U.C.E.",0
24,"24095",293,211,208,1,3,"U.C.E.",0
44,"44076",2338,1839,1797,36,42,"U.C.E.",2
17,"17214",695,470,461,10,9,"U.C.E.",0
50,"50259",89,53,53,1,0,"U.C.E.",0
26,"26071",8475,6088,5964,92,124,"U.C.E.",5
26,"26031",120,100,100,0,0,"U.C.E.",0
10,"10044",1520,1120,1103,10,17,"U.C.E.",0
37,"37126",36,26,26,0,0,"U.C.E.",0
37,"37352",199,150,142,0,8,"U.C.E.",0
41,"41012",3115,2314,2271,29,43,"U.C.E.",0
34,"34223",233,175,175,2,0,"U.C.E.",0
8,"8169",47505,31997,31566,555,431,"U.C.E.",58
45,"45054",4285,3321,3274,32,47,"U.C.E.",1
17,"17006",1203,759,754,17,5,"U.C.E.",0
39,"39015",898,692,688,7,4,"U.C.E.",0
42,"42149",404,292,286,12,6,"U.C.E.",1
34,"34175",101,80,80,2,0,"U.C.E.",0
46,"46070",15946,11979,11874,113,105,"U.C.E.",4
16,"16155",549,430,426,2,4,"U.C.E.",0
7,"7064",5286,3340,3279,53,61,"U.C.E.",6
3,"3136",484,393,386,1,7,"U.C.E.",0
7,"7031",23371,14443,14213,285,230,"U.C.E.",7
24,"24139",2320,1687,1654,16,33,"U.C.E.",1
38,"38007",1844,1209,1188,5,21,"U.C.E.",1
10,"10169",587,460,450,2,10,"U.C.E.",0
50,"50057",1468,1022,1004,17,18,"U.C.E.",0
20,"20016",1526,937,932,4,5,"U.C.E.",0
42,"42094",520,376,362,14,14,"U.C.E.",0
5,"5191",124,98,98,2,0,"U.C.E.",1
19,"19147",58,45,40,0,5,"U.C.E.",0
24,"24221",850,635,619,6,16,"U.C.E.",0
3,"3035",672,560,550,0,10,"U.C.E.",0
39,"39094",927,702,691,0,11,"U.C.E.",0
10,"10129",374,279,276,2,3,"U.C.E.",0
41,"41014",2484,1956,1936,13,20,"U.C.E.",0
45,"45056",2246,1523,1502,16,21,"U.C.E.",1
37,"37007",467,368,363,6,5,"U.C.E.",0
22,"22215",137,90,90,1,0,"U.C.E.",0
19,"19148",56,41,38,1,3,"U.C.E.",0
31,"31183",667,516,508,8,8,"U.C.E.",3
50,"50059",790,593,586,12,7,"U.C.E.",1
10,"10048",299,232,231,0,1,"U.C.E.",0
7,"7901",642,483,470,5,13,"U.C.E.",0
31,"31245",87,59,58,5,1,"U.C.E.",0
10,"10171",376,287,282,0,5,"U.C.E.",0
3,"3138",3218,2403,2388,22,15,"U.C.E.",4
17,"17038",343,261,256,2,5,"U.C.E.",0
37,"37356",90,66,66,1,0,"U.C.E.",0
16,"16158",550,427,423,2,4,"U.C.E.",0
10,"10131",12797,9017,8922,131,95,"U.C.E.",9
22,"22063",184,142,140,2,2,"U.C.E.",0
19,"19283",40,33,33,0,0,"U.C.E.",0
11,"11021",6838,5102,5049,67,53,"U.C.E.",0
22,"22217",406,314,309,4,5,"U.C.E.",1
33,"33014",9318,6380,6320,66,60,"U.C.E.",1
45,"45205",6333,4544,4451,58,93,"U.C.E.",8
16,"16205",126,94,93,0,1,"U.C.E.",0
31,"31003",131,101,101,1,0,"U.C.E.",0
45,"45059",1758,1465,1437,10,28,"U.C.E.",1
16,"16034",207,174,173,0,1,"U.C.E.",0
14,"14051",1392,1148,1130,11,18,"U.C.E.",0
3,"3140",26223,19998,19552,338,446,"U.C.E.",26
44,"44086",485,380,371,5,9,"U.C.E.",0
18,"18146",1059,791,776,2,15,"U.C.E.",1
37,"37357",283,216,214,0,2,"U.C.E.",0
19,"19321",46,29,29,0,0,"U.C.E.",0
20,"20056",3975,2692,2669,17,23,"U.C.E.",1
46,"46146",1718,1395,1374,10,21,"U.C.E.",2
31,"31125",269,172,169,6,3,"U.C.E.",0
38,"38011",19299,12565,12313,152,252,"U.C.E.",14
3,"3039",92,70,66,1,4,"U.C.E.",0
5,"5100",307,245,245,2,0,"U.C.E.",0
8,"8297",138,99,99,2,0,"U.C.E.",0
17,"17100",201,140,135,1,5,"U.C.E.",0
17,"17192",145,107,105,4,2,"U.C.E.",0
47,"47223",172,147,147,6,0,"U.C.E.",0
33,"33038",2442,1757,1725,14,32,"U.C.E.",0
26,"26168",5055,3534,3484,47,50,"U.C.E.",1
19,"19040",73,42,42,1,0,"U.C.E.",0
8,"8113",52352,33606,33123,590,483,"U.C.E.",39
24,"24226",223,154,153,1,1,"U.C.E.",0
47,"47060",262,220,218,1,2,"U.C.E.",0
34,"34053",222,177,172,4,5,"U.C.E.",0
7,"7036",25502,17151,16914,294,237,"U.C.E.",14
19,"19251",41,35,34,0,1,"U.C.E.",0
40,"40132",75,50,50,1,0,"U.C.E.",0
18,"18148",874,714,706,6,8,"U.C.E.",0
19,"19041",166,127,127,3,0,"U.C.E.",0
26,"26125",2720,2121,2084,26,37,"U.C.E.",2
16,"16162",51,36,36,0,0,"U.C.E.",0
22,"22223",92,65,64,3,1,"U.C.E.",0
8,"8023",6546,4261,4194,86,67,"U.C.E.",10
16,"16038",50,40,40,0,0,"U.C.E.",1
14,"14024",1926,1557,1527,14,30,"U.C.E.",0
11,"11025",4371,3260,3226,34,34,"U.C.E.",2
37,"37135",1234,972,961,8,11,"U.C.E.",0
31,"31127",145,89,89,2,0,"U.C.E.",0
18,"18149",5096,3949,3900,36,49,"U.C.E.",0
50,"50239",65,44,44,0,0,"U.C.E.",0
16,"16163",75,57,57,0,0,"U.C.E.",0
45,"45172",757,597,594,7,3,"U.C.E.",0
12,"12079",450,360,353,3,7,"U.C.E.",0
34,"34015",45,40,40,0,0,"U.C.E.",0
37,"37361",91,67,62,0,5,"U.C.E.",0
5,"5037",296,213,212,0,1,"U.C.E.",0
50,"50092",329,273,272,0,1,"U.C.E.",0
47,"47062",185,153,153,5,0,"U.C.E.",1
17,"17102",571,354,350,7,4,"U.C.E.",0
26,"26001",211,174,168,3,6,"U.C.E.",0
45,"45173",9133,7147,7035,78,112,"U.C.E.",1
50,"50065",59,37,37,2,0,"U.C.E.",0
4,"4001",1139,890,884,6,6,"U.C.E.",0
33,"33018",2971,2139,2121,32,18,"U.C.E.",1
8,"8301",47343,32098,31664,672,434,"U.C.E.",63
41,"41020",12710,8954,8882,91,72,"U.C.E.",2
8,"8026",180,144,143,0,1,"U.C.E.",0
19,"19255",95,68,68,0,0,"U.C.E.",0
5,"5104",35,29,29,0,0,"U.C.E.",0
31,"31129",405,285,281,1,4,"U.C.E.",0
16,"16271",659,568,566,4,2,"U.C.E.",0
16,"16001",79,66,66,1,0,"U.C.E.",0
44,"44008",1695,1280,1257,11,23,"U.C.E.",2
44,"44216",25877,18461,18057,467,404,"U.C.E.",24
5,"5266",112,92,89,0,3,"U.C.E.",0
40,"40138",2195,1758,1725,18,33,"U.C.E.",1
40,"40139",302,243,238,5,5,"U.C.E.",0
50,"50241",634,462,455,2,7,"U.C.E.",1
33,"33019",3262,2283,2244,12,39,"U.C.E.",1
11,"11028",32224,20706,20482,359,224,"U.C.E.",11
50,"50066",2357,1677,1659,42,18,"U.C.E.",0
8,"8118",17077,11817,11598,203,219,"U.C.E.",10
23,"23096",2678,2298,2276,18,22,"U.C.E.",3
45,"45067",2385,1923,1878,19,45,"U.C.E.",0
34,"34019",139,108,108,5,0,"U.C.E.",0
26,"26130",229,181,177,0,4,"U.C.E.",0
40,"40140",100,74,73,1,1,"U.C.E.",0
17,"17106",140,105,104,0,1,"U.C.E.",0
42,"42111",310,228,222,2,6,"U.C.E.",0
44,"44218",37,26,26,2,0,"U.C.E.",0
41,"41048",2296,1749,1726,21,23,"U.C.E.",0
46,"46005",22815,17016,16838,185,178,"U.C.E.",17
39,"39102",2330,1748,1731,13,17,"U.C.E.",1
7,"7009",744,593,576,11,17,"U.C.E.",2
50,"50156",234,186,183,2,3,"U.C.E.",0
20,"20064",12380,7568,7464,112,104,"U.C.E.",8
24,"24153",253,201,199,4,2,"U.C.E.",0
16,"16004",325,247,246,0,1,"U.C.E.",0
46,"46152",96,70,70,0,0,"U.C.E.",0
20,"20028",2204,1400,1379,11,21,"U.C.E.",2
42,"42019",562,392,383,9,9,"U.C.E.",0
16,"16170",733,552,543,3,9,"U.C.E.",2
22,"22230",302,234,231,11,3,"U.C.E.",0
4,"4004",458,367,364,6,3,"U.C.E.",0
26,"26007",551,434,422,3,12,"U.C.E.",0
34,"34061",116,78,78,2,0,"U.C.E.",0
50,"50243",346,277,272,2,5,"U.C.E.",1
8,"8120",6342,4801,4746,63,55,"U.C.E.",1
24,"24193",371,254,252,3,2,"U.C.E.",0
46,"46007",11576,8929,8848,71,81,"U.C.E.",13
17,"17019",1783,1264,1234,42,30,"U.C.E.",0
50,"50159",728,554,544,4,10,"U.C.E.",1
8,"8214",6754,4659,4555,83,104,"U.C.E.",2
31,"31194",308,212,210,6,2,"U.C.E.",0
22,"22182",271,160,150,4,10,"U.C.E.",1
37,"37292",101,84,84,2,0,"U.C.E.",1
46,"46201",83,50,49,0,1,"U.C.E.",0
15,"15043",5491,4033,3971,45,62,"U.C.E.",4
34,"34023",5318,3947,3891,64,56,"U.C.E.",8
4,"4006",7156,5175,5106,51,69,"U.C.E.",1
35,"35019",30279,17607,17380,158,227,"U.C.E.",19
7,"7011",26954,16786,16595,299,191,"U.C.E.",16
46,"46056",203,164,160,2,4,"U.C.E.",0
47,"47150",338,273,271,2,2,"U.C.E.",0
41,"41091",545464,388043,383816,5325,4227,"U.C.E.",112
37,"37256",245,191,190,2,1,"U.C.E.",0
14,"14031",634,516,514,1,2,"U.C.E.",1
46,"46129",553,430,423,4,7,"U.C.E.",0
8,"8061",1467,960,952,10,8,"U.C.E.",0
37,"37144",398,302,301,3,1,"U.C.E.",0
19,"19162",71,52,51,0,1,"U.C.E.",1
5,"5206",29,23,21,2,2,"U.C.E.",0
47,"47068",41,28,28,0,0,"U.C.E.",0
8,"8307",47176,31341,30846,536,495,"U.C.E.",61
17,"17110",1359,930,917,12,13,"U.C.E.",1
19,"19011",286,219,218,3,1,"U.C.E.",0
31,"31013",668,382,375,12,7,"U.C.E.",0
8,"8277",134,90,90,4,0,"U.C.E.",0
40,"40145",1152,933,920,3,13,"U.C.E.",0
31,"31135",116,87,86,9,1,"U.C.E.",0
8,"8153",502,357,350,7,7,"U.C.E.",0
44,"44102",30,29,28,0,1,"U.C.E.",0
42,"42119",192,124,123,0,1,"U.C.E.",0
3,"3050",17818,12860,12706,160,154,"U.C.E.",9
37,"37371",285,190,190,2,0,"U.C.E.",0
5,"5008",244,200,196,1,4,"U.C.E.",0
7,"7013",6525,4528,4409,78,119,"U.C.E.",6
26,"26183",65,54,54,0,0,"U.C.E.",0
50,"50274",78,45,45,1,0,"U.C.E.",0
33,"33023",3410,2501,2485,40,16,"U.C.E.",0
14,"14033",1289,974,958,18,16,"U.C.E.",0
26,"26012",17,15,15,1,0,"U.C.E.",0
40,"40148",259,213,212,3,1,"U.C.E.",0
50,"50072",181,128,127,1,1,"U.C.E.",0
23,"23016",442,355,354,5,1,"U.C.E.",0
45,"45073",351,265,261,3,4,"U.C.E.",0
50,"50247",794,572,567,7,5,"U.C.E.",0
34,"34068",32,23,23,0,0,"U.C.E.",0
8,"8013",1234,834,820,23,14,"U.C.E.",2
50,"50043",258,170,166,2,4,"U.C.E.",0
10,"10027",88,78,78,0,0,"U.C.E.",1
8,"8033",12476,8513,8378,180,135,"U.C.E.",7
46,"46259",537,426,424,9,2,"U.C.E.",1
14,"14064",352,265,261,3,4,"U.C.E.",0
8,"8901",249,180,180,2,0,"U.C.E.",0
37,"37147",201,153,151,1,2,"U.C.E.",0
37,"37148",451,344,343,3,1,"U.C.E.",0
40,"40009",49,41,41,0,0,"U.C.E.",0
31,"31047",283,208,204,3,4,"U.C.E.",0
46,"46229",1065,840,831,8,9,"U.C.E.",1
5,"5046",44,39,38,1,1,"U.C.E.",0
47,"47071",406,333,329,6,4,"U.C.E.",0
24,"24001",241,148,147,3,1,"U.C.E.",0
45,"45112",2022,1470,1423,12,47,"U.C.E.",0
8,"8126",8299,5599,5508,103,91,"U.C.E.",6
5,"5013",890,746,739,4,7,"U.C.E.",0
14,"14035",6153,4715,4656,51,59,"U.C.E.",0
20,"20036",12731,8519,8431,131,88,"U.C.E.",8
39,"39082",1688,1280,1266,9,14,"U.C.E.",1
5,"5147",174,141,135,4,6,"U.C.E.",1
31,"31200",763,527,514,17,13,"U.C.E.",1
37,"37375",764,636,627,19,9,"U.C.E.",1
47,"47073",141,118,116,1,2,"U.C.E.",0
17,"17204",539,349,347,10,2,"U.C.E.",0
26,"26016",32,27,27,0,0,"U.C.E.",0
46,"46060",9510,7506,7408,52,98,"U.C.E.",7
37,"37027",242,196,192,2,4,"U.C.E.",0
50,"50165",1880,1339,1274,49,65,"U.C.E.",1
3,"3054",371,321,315,2,6,"U.C.E.",0
31,"31109",1365,946,934,11,12,"U.C.E.",3
5,"5243",101,69,68,0,1,"U.C.E.",0
19,"19054",184,156,151,2,5,"U.C.E.",0
7,"7017",800,556,539,14,17,"U.C.E.",2
39,"39031",1227,965,956,4,9,"U.C.E.",1
47,"47155",3043,2246,2225,35,21,"U.C.E.",2
45,"45078",1451,1243,1228,7,15,"U.C.E.",0
20,"20002",347,237,237,8,0,"U.C.E.",0
3,"3123",7435,5860,5744,63,116,"U.C.E.",3
24,"24121",645,511,502,10,9,"U.C.E.",0
4,"4013",137455,94867,94142,1203,725,"U.C.E.",54
42,"42128",43,38,38,2,0,"U.C.E.",1
46,"46261",1706,1388,1366,13,22,"U.C.E.",0
31,"31110",97,53,53,3,0,"U.C.E.",0
8,"8037",1830,1247,1209,40,38,"U.C.E.",0
47,"47156",182,155,148,0,7,"U.C.E.",0
44,"44150",30,30,30,0,0,"U.C.E.",0
47,"47183",150,125,122,0,3,"U.C.E.",0
50,"50194",102,67,67,2,0,"U.C.E.",0
22,"22245",329,261,257,3,4,"U.C.E.",0
40,"40156",361,268,264,5,4,"U.C.E.",0
26,"26059",1137,887,869,9,18,"U.C.E.",0
19,"19098",22,18,18,0,0,"U.C.E.",0
17,"17903",893,565,556,14,9,"U.C.E.",0
50,"50019",79,57,55,1,2,"U.C.E.",0
14,"14069",7733,5910,5824,68,86,"U.C.E.",3
37,"37378",118,85,85,3,0,"U.C.E.",0
31,"31020",488,247,246,0,1,"U.C.E.",0
44,"44111",101,68,68,4,0,"U.C.E.",1
17,"17118",12541,7817,7681,130,136,"U.C.E.",2
41,"41031",1319,879,875,6,4,"U.C.E.",0
42,"42032",186,143,141,2,2,"U.C.E.",0
39,"39034",289,209,209,3,0,"U.C.E.",0
18,"18064",419,347,345,3,2,"U.C.E.",0
34,"34160",154,119,116,0,3,"U.C.E.",0
24,"24166",1521,1137,1112,27,25,"U.C.E.",0
8,"8223",1855,1178,1155,19,23,"U.C.E.",0
17,"17208",1012,642,622,12,20,"U.C.E.",0
10,"10157",289,218,212,1,6,"U.C.E.",1
18,"18165",3942,2819,2776,27,43,"U.C.E.",2
5,"5214",46,23,23,1,0,"U.C.E.",0
33,"33074",3699,2643,2611,30,32,"U.C.E.",0
38,"38031",28391,21797,21431,234,366,"U.C.E.",11
26,"26022",232,191,190,1,1,"U.C.E.",0
3,"3058",4798,4126,4103,26,23,"U.C.E.",2
47,"47023",2863,2278,2258,38,20,"U.C.E.",0
37,"37380",57,45,44,1,1,"U.C.E.",0
40,"40158",24,18,17,0,1,"U.C.E.",0
19,"19059",84,60,60,0,0,"U.C.E.",0
40,"40159",150,111,110,0,1,"U.C.E.",0
5,"5215",186,138,136,1,2,"U.C.E.",0
33,"33029",420,243,241,3,2,"U.C.E.",0
47,"47077",291,232,232,1,0,"U.C.E.",0
42,"42132",159,132,127,4,5,"U.C.E.",0
8,"8040",10538,6916,6804,99,112,"U.C.E.",7
19,"19173",52,42,42,3,0,"U.C.E.",0
1,"1027",430,283,276,4,7,"U.C.E.",0
42,"42134",2626,1945,1896,36,49,"U.C.E.",2
26,"26151",455,384,382,1,2,"U.C.E.",0
41,"41033",5237,3915,3878,20,37,"U.C.E.",1
44,"44114",254,194,188,4,6,"U.C.E.",0
24,"24168",493,397,391,7,6,"U.C.E.",0
14,"14041",3215,2492,2439,45,53,"U.C.E.",1
17,"17152",10378,6239,6156,100,83,"U.C.E.",5
46,"46162",1230,1045,1027,6,18,"U.C.E.",0
20,"20080",8104,5497,5454,52,43,"U.C.E.",7
16,"16062",30,27,27,0,0,"U.C.E.",0
36,"36027",4478,3376,3339,29,37,"U.C.E.",1
22,"22204",1122,773,756,19,17,"U.C.E.",0
7,"7024",6070,3232,3170,60,62,"U.C.E.",3
8,"8042",2172,1459,1448,30,11,"U.C.E.",0
14,"14042",18991,14726,14495,290,231,"U.C.E.",6
15,"15054",32172,20472,20154,519,318,"U.C.E.",7
34,"34038",284,228,225,9,3,"U.C.E.",0
46,"46138",338,297,296,1,1,"U.C.E.",0
26,"26025",78,69,69,1,0,"U.C.E.",0
44,"44236",77,48,47,0,1,"U.C.E.",1
37,"37271",393,324,318,5,6,"U.C.E.",0
33,"33031",38090,25034,24730,380,304,"U.C.E.",7
40,"40021",33,32,32,0,0,"U.C.E.",0
35,"35030",8295,5433,5315,54,118,"U.C.E.",7
44,"44237",450,352,343,5,9,"U.C.E.",0
5,"5218",148,123,117,1,6,"U.C.E.",0
16,"16247",87,65,62,1,3,"U.C.E.",0
40,"40162",420,320,314,1,6,"U.C.E.",2
46,"46066",1264,1060,1050,5,10,"U.C.E.",1
16,"16064",699,588,580,4,8,"U.C.E.",0
45,"45196",1363,1092,1076,3,16,"U.C.E.",0
16,"16194",298,238,238,1,0,"U.C.E.",0
11,"11901",5576,4433,4398,69,35,"U.C.E.",2
50,"50081",562,410,400,7,10,"U.C.E.",0
47,"47079",67,56,56,1,0,"U.C.E.",0
19,"19176",280,216,216,0,0,"U.C.E.",0
22,"22253",71,54,54,1,0,"U.C.E.",0
3,"3063",25410,18205,17989,208,216,"U.C.E.",20
5,"5023",177,160,158,1,2,"U.C.E.",0
17,"17063",169,113,111,5,2,"U.C.E.",0
20,"20047",494,321,319,2,2,"U.C.E.",0
19,"19065",126,100,100,3,0,"U.C.E.",0
5,"5220",386,316,312,0,4,"U.C.E.",1
47,"47080",45,39,39,1,0,"U.C.E.",0
14,"14045",3093,2662,2642,14,20,"U.C.E.",0
22,"22105",132,104,102,2,2,"U.C.E.",0
20,"20048",175,102,102,1,0,"U.C.E.",0
26,"26157",306,268,263,1,5,"U.C.E.",0
50,"50172",187,140,138,4,2,"U.C.E.",0
34,"34045",84,75,74,1,1,"U.C.E.",0
17,"17033",5157,3142,3095,44,47,"U.C.E.",6
40,"40165",95,72,71,1,1,"U.C.E.",0
42,"42088",69,56,56,1,0,"U.C.E.",0
37,"37002",152,90,89,1,1,"U.C.E.",0
8,"8045",70,42,42,2,0,"U.C.E.",0
17,"17213",5282,3097,3041,42,56,"U.C.E.",4
44,"44120",217,126,121,5,5,"U.C.E.",1
10,"10043",866,636,622,1,14,"U.C.E.",0
10,"10084",1416,994,972,12,22,"U.C.E.",0
24,"24174",525,393,387,6,6,"U.C.E.",1
40,"40166",275,247,246,2,1,"U.C.E.",0
24,"24134",3682,2636,2588,44,48,"U.C.E.",1
26,"26114",87,74,72,0,2,"U.C.E.",0
45,"45089",1615,1238,1221,16,17,"U.C.E.",0
47,"47164",391,326,320,3,6,"U.C.E.",0
33,"33056",5278,3576,3540,41,36,"U.C.E.",1
16,"16197",73,50,50,1,0,"U.C.E.",0
50,"50287",298,214,211,10,3,"U.C.E.",0
46,"46093",2082,1722,1716,9,6,"U.C.E.",1
42,"42194",200,165,163,4,2,"U.C.E.",0
18,"18010",576,464,458,4,6,"U.C.E.",0
17,"17066",25667,15429,15157,244,272,"U.C.E.",20
7,"7029",4090,2921,2866,44,55,"U.C.E.",3
45,"45090",396,335,333,0,2,"U.C.E.",0
16,"16199",27,20,19,0,1,"U.C.E.",0
10,"10045",1119,884,859,5,25,"U.C.E.",0
10,"10167",322,265,264,1,1,"U.C.E.",0
35,"35034",6372,2951,2921,33,30,"U.C.E.",6
37,"37041",80,53,53,1,0,"U.C.E.",0
24,"24137",1226,920,904,16,16,"U.C.E.",0
34,"34087",108,88,87,1,1,"U.C.E.",0
46,"46021",23273,17264,17091,163,173,"U.C.E.",19
37,"37201",263,196,196,5,0,"U.C.E.",0
37,"37277",58,39,38,1,1,"U.C.E.",0
41,"41065",23028,15133,14958,191,175,"U.C.E.",5
14,"14048",1244,975,970,5,5,"U.C.E.",0
45,"45128",2558,1831,1806,20,25,"U.C.E.",1
20,"20907",136,94,94,0,0,"U.C.E.",0
8,"8293",246,145,145,4,0,"U.C.E.",0
8,"8139",184,130,128,1,2,"U.C.E.",0
19,"19181",69,54,54,5,0,"U.C.E.",0
8,"8048",622,461,454,9,7,"U.C.E.",0
26,"26163",143,118,116,2,2,"U.C.E.",1
3,"3068",48,45,45,1,0,"U.C.E.",0
14,"14049",16358,12577,12478,137,99,"U.C.E.",3
34,"34176",146,120,118,2,2,"U.C.E.",0
42,"42152",96,71,69,1,2,"U.C.E.",0
42,"42004",2383,1776,1740,30,36,"U.C.E.",1
40,"40173",148,121,120,3,1,"U.C.E.",0
50,"50086",193,109,109,0,0,"U.C.E.",0
19,"19281",25,24,22,3,2,"U.C.E.",0
16,"16072",161,126,123,0,3,"U.C.E.",1
16,"16203",9839,7520,7342,101,178,"U.C.E.",4
17,"17130",333,236,233,5,3,"U.C.E.",0
37,"37279",780,580,571,6,9,"U.C.E.",0
46,"46217",912,758,751,4,7,"U.C.E.",0
4,"4097",299,229,227,0,2,"U.C.E.",0
20,"20017",8670,5923,5890,27,33,"U.C.E.",5
44,"44125",78,57,57,1,0,"U.C.E.",0
5,"5162",107,71,71,0,0,"U.C.E.",0
20,"20054",476,350,348,1,2,"U.C.E.",0
5,"5259",132,115,114,1,1,"U.C.E.",0
44,"44246",1591,1030,997,15,33,"U.C.E.",0
50,"50263",235,160,160,1,0,"U.C.E.",0
10,"10049",3952,3348,3259,36,89,"U.C.E.",3
40,"40033",61,48,47,3,1,"U.C.E.",0
17,"17190",811,548,532,7,16,"U.C.E.",0
40,"40176",418,344,341,8,3,"U.C.E.",0
44,"44247",335,251,243,10,8,"U.C.E.",0
22,"22907",1444,1034,1018,12,16,"U.C.E.",0
39,"39070",152,118,118,0,0,"U.C.E.",1
40,"40221",50,41,41,0,0,"U.C.E.",0
42,"42008",69,50,50,0,0,"U.C.E.",0
40,"40177",171,145,145,2,0,"U.C.E.",0
12,"12107",358,314,311,4,3,"U.C.E.",1
44,"44040",206,167,166,5,1,"U.C.E.",0
26,"26166",152,139,136,1,3,"U.C.E.",0
47,"47007",3453,2616,2580,42,36,"U.C.E.",0
45,"45095",742,606,585,2,21,"U.C.E.",0
50,"50292",138,117,115,4,2,"U.C.E.",0
19,"19114",40,34,34,0,0,"U.C.E.",0
24,"24225",1089,798,784,15,14,"U.C.E.",0
8,"8001",8538,5929,5838,120,91,"U.C.E.",7
22,"22021",2080,1524,1505,31,19,"U.C.E.",1
40,"40082",131,111,110,5,1,"U.C.E.",0
15,"15007",3702,2670,2642,19,28,"U.C.E.",1
17,"17070",116,78,78,3,0,"U.C.E.",0
3,"3072",331,284,277,2,7,"U.C.E.",1
34,"34181",471,350,346,7,4,"U.C.E.",0
19,"19076",36,29,29,0,0,"U.C.E.",0
10,"10052",186,138,138,0,0,"U.C.E.",0
36,"36006",11387,8911,8727,72,184,"U.C.E.",3
50,"50033",81,64,64,0,0,"U.C.E.",0
19,"19322",35,28,27,1,1,"U.C.E.",0
17,"17040",506,320,316,7,4,"U.C.E.",0
16,"16209",153,129,129,0,0,"U.C.E.",0
22,"22115",415,307,304,2,3,"U.C.E.",0
50,"50265",63,46,46,1,0,"U.C.E.",0
37,"37322",2501,1692,1676,32,16,"U.C.E.",0
8,"8176",166,111,109,0,2,"U.C.E.",1
50,"50091",56,39,39,1,0,"U.C.E.",0
23,"23001",1058,922,920,6,2,"U.C.E.",0
17,"17222",108,86,86,1,0,"U.C.E.",0
50,"50181",1053,787,760,9,27,"U.C.E.",0
34,"34182",860,657,649,8,8,"U.C.E.",0
4,"4033",161,120,119,1,1,"U.C.E.",0
5,"5133",62,49,49,0,0,"U.C.E.",0
26,"26040",67,63,62,2,1,"U.C.E.",0
42,"42158",112,79,79,6,0,"U.C.E.",0
34,"34096",56,41,39,1,2,"U.C.E.",0
24,"24148",1759,1362,1348,29,14,"U.C.E.",0
37,"37051",90,72,72,0,0,"U.C.E.",0
40,"40039",257,188,184,2,4,"U.C.E.",0
15,"15009",11109,8179,8014,129,165,"U.C.E.",4
5,"5036",136,107,106,0,1,"U.C.E.",0
37,"37052",274,213,212,1,1,"U.C.E.",0
37,"37285",457,349,347,2,2,"U.C.E.",0
42,"42013",45,35,34,1,1,"U.C.E.",0
18,"18083",296,242,242,1,0,"U.C.E.",0
16,"16083",58,30,30,1,0,"U.C.E.",1
19,"19080",90,64,64,0,0,"U.C.E.",0
16,"16269",494,412,407,5,5,"U.C.E.",0
30,"30025",4780,3901,3874,18,27,"U.C.E.",5
14,"14055",18619,13802,13607,192,195,"U.C.E.",5
10,"10178",797,604,597,5,7,"U.C.E.",2
36,"36008",21702,15366,15037,261,329,"U.C.E.",10
17,"17043",159,101,100,2,1,"U.C.E.",0
16,"16124",1909,1573,1555,14,18,"U.C.E.",0
17,"17075",304,216,210,5,6,"U.C.E.",0
24,"24027",1184,853,837,7,16,"U.C.E.",0
44,"44132",64,57,56,0,1,"U.C.E.",0
33,"33040",4702,3285,3236,44,49,"U.C.E.",0
31,"31038",1372,982,968,17,14,"U.C.E.",3
17,"17137",3331,2163,2110,39,53,"U.C.E.",0
36,"36009",5138,3147,3108,24,39,"U.C.E.",2
39,"39074",6785,5287,5233,50,54,"U.C.E.",1
37,"37137",114,87,87,3,0,"U.C.E.",0
20,"20025",1174,814,803,4,11,"U.C.E.",0
38,"38049",2794,1721,1694,12,27,"U.C.E.",2
42,"42161",158,119,119,0,0,"U.C.E.",0
22,"22028",424,311,310,3,1,"U.C.E.",0
47,"47119",101,78,77,0,1,"U.C.E.",0
37,"37055",132,112,107,2,5,"U.C.E.",0
26,"26044",60,48,46,1,2,"U.C.E.",0
12,"12112",104,90,90,0,0,"U.C.E.",0
1,"1004",1427,1021,996,15,25,"U.C.E.",0
8,"8057",61,41,40,1,1,"U.C.E.",0
23,"23007",3116,2483,2458,15,25,"U.C.E.",1
46,"46078",28197,20643,20415,205,228,"U.C.E.",16
41,"41047",9810,7427,7321,99,106,"U.C.E.",5
45,"45103",457,400,394,0,6,"U.C.E.",0
19,"19290",872,622,613,7,9,"U.C.E.",0
16,"16217",113,95,92,0,3,"U.C.E.",0
50,"50094",1744,1220,1193,25,27,"U.C.E.",0
50,"50126",2473,1747,1724,41,23,"U.C.E.",1
42,"42017",154,134,130,2,4,"U.C.E.",0
37,"37057",223,190,190,0,0,"U.C.E.",0
30,"30027",45194,35272,34973,366,299,"U.C.E.",14
26,"26087",222,180,178,5,2,"U.C.E.",0
50,"50095",12558,9029,8910,179,119,"U.C.E.",2
36,"36012",3839,2884,2825,14,59,"U.C.E.",0
50,"50270",39,30,29,1,1,"U.C.E.",0
5,"5171",84,74,73,0,1,"U.C.E.",0
38,"38051",7081,5298,5229,64,69,"U.C.E.",8
22,"22032",120,78,73,5,5,"U.C.E.",0
5,"5901",289,197,196,4,1,"U.C.E.",0
10,"10060",1037,758,742,9,16,"U.C.E.",0
17,"17078",346,231,226,3,5,"U.C.E.",0
40,"40188",120,82,81,0,1,"U.C.E.",0
31,"31224",980,691,681,9,10,"U.C.E.",1
44,"44137",215,165,163,5,2,"U.C.E.",0
44,"44263",332,249,243,10,6,"U.C.E.",1
37,"37331",234,161,161,3,0,"U.C.E.",0
47,"47175",6562,5041,4957,62,84,"U.C.E.",2
31,"31042",2719,2100,2057,27,43,"U.C.E.",1
33,"33020",13542,9300,9173,135,127,"U.C.E.",5
20,"20029",4283,3014,2998,26,16,"U.C.E.",2
24,"24032",134,102,101,1,1,"U.C.E.",0
12,"12116",56,45,45,0,0,"U.C.E.",0
19,"19193",30,29,29,1,0,"U.C.E.",0
14,"14060",4843,3857,3787,47,70,"U.C.E.",0
12,"12115",234,184,183,2,1,"U.C.E.",0
19,"19293",1860,1407,1373,16,34,"U.C.E.",1
44,"44138",158,109,106,0,3,"U.C.E.",0
41,"41050",5102,4224,4183,39,41,"U.C.E.",2
16,"16224",96,69,69,0,0,"U.C.E.",0
18,"18187",587,432,432,0,0,"U.C.E.",0
12,"12016",1589,1309,1293,15,16,"U.C.E.",2
16,"16091",86,66,66,1,0,"U.C.E.",2
42,"42167",305,223,222,3,1,"U.C.E.",0
38,"38021",1792,1184,1160,6,24,"U.C.E.",0
47,"47015",229,172,170,1,2,"U.C.E.",0
50,"50012",105,93,90,0,3,"U.C.E.",0
19,"19089",33,22,22,1,0,"U.C.E.",0
31,"31226",597,339,335,2,4,"U.C.E.",0
18,"18024",882,696,688,12,8,"U.C.E.",0
40,"40191",265,191,190,1,1,"U.C.E.",1
31,"31227",8257,5987,5884,125,103,"U.C.E.",10
17,"17230",456,326,320,10,6,"U.C.E.",0
23,"23012",4250,3235,3216,19,19,"U.C.E.",3
17,"17232",159,107,104,0,3,"U.C.E.",0
50,"50013",244,195,195,1,0,"U.C.E.",0
17,"17200",616,406,393,12,13,"U.C.E.",0
46,"46154",836,684,678,7,6,"U.C.E.",0
16,"16048",432,339,337,8,2,"U.C.E.",0
26,"26094",97,86,85,0,1,"U.C.E.",0
37,"37107",11407,8234,8116,123,118,"U.C.E.",4
34,"34025",54,42,42,0,0,"U.C.E.",0
23,"23015",1476,1189,1179,10,10,"U.C.E.",1
31,"31136",438,283,283,10,0,"U.C.E.",0
26,"26181",14,12,12,0,0,"U.C.E.",0
42,"42023",78,58,58,1,0,"U.C.E.",0
10,"10188",553,473,468,2,5,"U.C.E.",0
44,"44267",79,63,61,2,2,"U.C.E.",0
31,"31166",274,183,182,2,1,"U.C.E.",0
37,"37108",108,95,95,1,0,"U.C.E.",0
44,"44017",316,232,229,1,3,"U.C.E.",0
36,"36017",18554,13573,13378,200,195,"U.C.E.",7
40,"40053",116,92,90,1,2,"U.C.E.",0
12,"12020",131,109,107,1,2,"U.C.E.",0
46,"46155",1072,861,849,4,12,"U.C.E.",0
23,"23904",3070,2047,2033,19,14,"U.C.E.",0
17,"17233",2192,1470,1434,33,36,"U.C.E.",1
42,"42173",28809,20268,19748,632,520,"U.C.E.",24
47,"47044",325,257,252,1,5,"U.C.E.",0
40,"40007",86,70,69,0,1,"U.C.E.",1
26,"26140",268,213,207,2,6,"U.C.E.",0
4,"4009",165,124,122,2,2,"U.C.E.",1
10,"10109",1834,1307,1287,18,20,"U.C.E.",1
24,"24199",432,280,278,2,2,"U.C.E.",0
23,"23060",19107,14365,14264,130,101,"U.C.E.",9
34,"34069",2330,1769,1749,25,20,"U.C.E.",0
37,"37065",346,269,267,0,2,"U.C.E.",0
15,"15075",12042,8639,8486,147,153,"U.C.E.",5
16,"16234",52,38,36,0,2,"U.C.E.",0
50,"50044",259,175,175,0,0,"U.C.E.",0
26,"26098",99,74,73,2,1,"U.C.E.",0
24,"24118",132,96,96,2,0,"U.C.E.",0
8,"8249",273,218,214,4,4,"U.C.E.",0
31,"31230",118,88,85,1,3,"U.C.E.",0
34,"34156",56,48,48,2,0,"U.C.E.",0
47,"47154",168,144,144,7,0,"U.C.E.",0
30,"30007",6115,4651,4603,29,48,"U.C.E.",3
42,"42176",30,22,22,0,0,"U.C.E.",0
4,"4048",1459,1110,1100,11,10,"U.C.E.",1
7,"7016",2726,1848,1809,34,39,"U.C.E.",0
39,"39004",1593,1321,1305,9,16,"U.C.E.",0
46,"46084",1587,1363,1332,7,31,"U.C.E.",1
47,"47045",839,636,632,3,4,"U.C.E.",0
16,"16902",165,128,126,1,2,"U.C.E.",0
26,"26100",59,51,51,1,0,"U.C.E.",0
42,"42028",62,45,43,2,2,"U.C.E.",0
24,"24162",1631,1214,1195,33,19,"U.C.E.",1
50,"50017",1734,1232,1212,41,20,"U.C.E.",0
24,"24041",602,403,396,3,7,"U.C.E.",0
15,"15076",2766,1971,1936,18,35,"U.C.E.",1
45,"45114",608,476,468,3,8,"U.C.E.",0
31,"31262",219,158,157,4,1,"U.C.E.",0
37,"37069",952,737,723,12,14,"U.C.E.",2
30,"30008",13289,9992,9849,86,143,"U.C.E.",11
17,"17055",158,121,121,4,0,"U.C.E.",0
47,"47020",283,237,232,5,5,"U.C.E.",0
19,"19301",47,38,38,0,0,"U.C.E.",0
8,"8251",4771,3214,3140,57,74,"U.C.E.",2
45,"45189",655,510,502,3,8,"U.C.E.",0
31,"31140",117,91,89,3,2,"U.C.E.",0
34,"34071",186,160,160,1,0,"U.C.E.",0
12,"12024",146,129,128,1,1,"U.C.E.",0
41,"41082",3448,2827,2796,15,31,"U.C.E.",1
47,"47047",217,171,170,5,1,"U.C.E.",0
46,"46232",920,730,722,6,8,"U.C.E.",0
40,"40201",48,48,48,2,0,"U.C.E.",0
14,"14007",15871,11609,11477,121,132,"U.C.E.",2
3,"3022",160,133,131,1,2,"U.C.E.",0
3,"3124",482,420,415,7,5,"U.C.E.",0
42,"42030",115,88,86,2,2,"U.C.E.",0
31,"31050",6253,4045,3987,74,58,"U.C.E.",1
16,"16056",495,377,374,11,3,"U.C.E.",0
50,"50166",282,216,210,1,6,"U.C.E.",0
8,"8905",2268,1692,1657,28,35,"U.C.E.",2
22,"22199",7259,4980,4861,128,119,"U.C.E.",4
11,"11010",6452,4534,4510,61,24,"U.C.E.",0
19,"19302",64,60,60,2,0,"U.C.E.",0
50,"50279",111,79,79,1,0,"U.C.E.",0
19,"19235",121,92,87,0,5,"U.C.E.",0
40,"40109",84,70,67,0,3,"U.C.E.",0
41,"41057",299,191,189,0,2,"U.C.E.",0
46,"46038",368,264,260,1,4,"U.C.E.",1
26,"26061",1552,1119,1099,31,20,"U.C.E.",0
23,"23026",3872,3051,2994,23,57,"U.C.E.",0
37,"37190",235,195,193,1,2,"U.C.E.",0
8,"8099",808,533,519,11,14,"U.C.E.",0
24,"24046",1002,704,696,20,8,"U.C.E.",0
10,"10075",276,189,189,1,0,"U.C.E.",0
18,"18903",960,761,753,1,8,"U.C.E.",0
50,"50020",868,646,629,5,17,"U.C.E.",0
14,"14070",1385,1131,1111,4,20,"U.C.E.",0
8,"8069",3028,2071,2029,36,42,"U.C.E.",1
45,"45045",1313,992,979,12,13,"U.C.E.",1
15,"15080",1913,1407,1389,15,18,"U.C.E.",0
24,"24167",813,509,509,8,0,"U.C.E.",0
19,"19134",22,14,14,0,0,"U.C.E.",0
30,"30012",9037,7242,7142,62,100,"U.C.E.",5
42,"42184",76,50,49,0,1,"U.C.E.",0
39,"39060",6723,5453,5360,56,93,"U.C.E.",2
7,"7055",7000,4471,4379,67,92,"U.C.E.",4
37,"37306",316,194,192,1,2,"U.C.E.",0
40,"40063",7290,5366,5171,68,195,"U.C.E.",5
10,"10199",181,142,140,1,2,"U.C.E.",0
23,"23028",6428,4855,4802,26,53,"U.C.E.",6
5,"5247",267,164,164,0,0,"U.C.E.",0
31,"31901",15574,11165,10974,201,191,"U.C.E.",8
17,"17209",605,469,463,21,6,"U.C.E.",1
8,"8255",132,83,82,1,1,"U.C.E.",0
50,"50197",89,65,65,3,0,"U.C.E.",0
46,"46089",2116,1653,1627,9,26,"U.C.E.",0
3,"3093",19646,15399,15159,173,240,"U.C.E.",7
26,"26107",97,79,79,1,0,"U.C.E.",0
8,"8071",248,172,167,2,5,"U.C.E.",1
45,"45156",3528,2985,2924,19,61,"U.C.E.",0
4,"4088",2516,1849,1832,7,17,"U.C.E.",2
19,"19306",42,31,31,1,0,"U.C.E.",0
41,"41060",15176,10797,10693,114,104,"U.C.E.",3
31,"31024",116,56,56,2,0,"U.C.E.",1
45,"45121",6553,4720,4653,43,67,"U.C.E.",1
26,"26065",57,43,43,0,0,"U.C.E.",0
19,"19208",55,41,41,1,0,"U.C.E.",0
44,"44155",1162,819,801,24,18,"U.C.E.",1
30,"30014",1686,1400,1387,10,13,"U.C.E.",2
50,"50170",411,316,313,2,3,"U.C.E.",0
10,"10201",202,173,171,3,2,"U.C.E.",0
42,"42084",27,21,21,0,0,"U.C.E.",0
31,"31146",46,34,34,1,0,"U.C.E.",0
18,"18906",955,736,731,5,5,"U.C.E.",0
34,"34080",6066,4238,4169,57,69,"U.C.E.",0
38,"38034",4092,3034,2983,30,51,"U.C.E.",0
17,"17153",172,127,123,1,4,"U.C.E.",0
38,"38035",8172,4990,4919,62,71,"U.C.E.",1
5,"5155",60,44,44,1,0,"U.C.E.",0
19,"19174",126,88,86,0,2,"U.C.E.",0
1,"1031",1229,916,899,13,17,"U.C.E.",0
24,"24052",178,113,111,0,2,"U.C.E.",0
5,"5056",94,78,73,1,5,"U.C.E.",0
42,"42190",102,71,71,3,0,"U.C.E.",0
3,"3096",5863,4550,4457,57,93,"U.C.E.",5
50,"50111",191,141,138,2,3,"U.C.E.",0
5,"5156",260,188,185,0,3,"U.C.E.",0
20,"20902",14148,9874,9798,120,76,"U.C.E.",15
14,"14074",2387,2002,1995,26,7,"U.C.E.",0
16,"16248",887,733,710,20,23,"U.C.E.",1
3,"3097",973,791,779,6,12,"U.C.E.",1
5,"5252",70,52,51,0,1,"U.C.E.",0
45,"45050",508,385,378,0,7,"U.C.E.",0
44,"44158",1159,904,873,15,31,"U.C.E.",2
45,"45123",2961,2081,2049,30,32,"U.C.E.",0
42,"42191",187,143,141,5,2,"U.C.E.",0
44,"44032",18,12,12,0,0,"U.C.E.",0
42,"42039",270,172,169,2,3,"U.C.E.",0
18,"18908",827,669,660,7,9,"U.C.E.",0
19,"19107",349,289,288,1,1,"U.C.E.",0
31,"31057",1863,1450,1409,32,41,"U.C.E.",0
30,"30016",149046,103847,102890,1031,957,"U.C.E.",74
42,"42041",36,25,25,4,0,"U.C.E.",0
33,"33055",1589,1212,1192,16,20,"U.C.E.",0
37,"37237",330,250,242,1,8,"U.C.E.",0
22,"22055",347,291,289,5,2,"U.C.E.",0
19,"19243",53,39,39,0,0,"U.C.E.",0
46,"46238",13401,10371,10283,96,88,"U.C.E.",18
34,"34221",190,143,143,3,0,"U.C.E.",0
41,"41063",2678,1869,1853,22,16,"U.C.E.",0
7,"7061",9429,5937,5800,125,137,"U.C.E.",10
16,"16152",42,38,37,3,1,"U.C.E.",0
37,"37162",232,184,182,4,2,"U.C.E.",0
8,"8167",5703,3896,3831,82,65,"U.C.E.",5
15,"15085",3576,2656,2612,29,44,"U.C.E.",3
23,"23035",1066,919,912,3,7,"U.C.E.",1
4,"4060",486,373,372,0,1,"U.C.E.",0
14,"14016",1406,1123,1115,9,8,"U.C.E.",1
39,"39092",1030,753,747,1,6,"U.C.E.",0
31,"31089",246,198,195,4,3,"U.C.E.",0
22,"22058",194,138,137,5,1,"U.C.E.",0
12,"12002",135,101,100,1,1,"U.C.E.",0
16,"16198",1451,1126,1105,21,21,"U.C.E.",0
15,"15002",21528,15479,15218,314,261,"U.C.E.",7
44,"44161",487,363,358,9,5,"U.C.E.",0
5,"5060",127,108,105,1,3,"U.C.E.",0
8,"8261",2273,1547,1525,30,22,"U.C.E.",0
12,"12037",20,15,14,1,1,"U.C.E.",0
5,"5061",264,222,214,5,8,"U.C.E.",0
46,"46240",226,188,185,3,3,"U.C.E.",0
5,"5160",339,290,286,2,4,"U.C.E.",0
39,"39093",351,260,253,2,7,"U.C.E.",0
45,"45201",3439,2353,2317,31,36,"U.C.E.",0
37,"37315",99,77,75,3,2,"U.C.E.",0
46,"46094",20341,15367,15222,152,145,"U.C.E.",12
47,"47191",113,81,80,1,1,"U.C.E.",0
3,"3101",4648,3694,3607,29,87,"U.C.E.",2
34,"34003",167,132,130,7,2,"U.C.E.",0
31,"31091",365,227,224,3,3,"U.C.E.",0
12,"12003",1058,830,813,15,17,"U.C.E.",0
12,"12103",85,65,65,4,0,"U.C.E.",0
24,"24058",224,166,163,1,3,"U.C.E.",0
18,"18911",6796,4923,4867,74,56,"U.C.E.",6
37,"37005",92,65,65,0,0,"U.C.E.",0
39,"39068",663,488,485,4,3,"U.C.E.",0
10,"10088",244,168,168,0,0,"U.C.E.",0
42,"42197",90,71,71,0,0,"U.C.E.",1
3,"3102",7346,5827,5751,39,76,"U.C.E.",4
12,"12135",35189,25691,25345,380,346,"U.C.E.",24
38,"38041",6780,4905,4813,57,92,"U.C.E.",0
26,"26074",128,102,101,0,1,"U.C.E.",1
44,"44038",112,94,92,3,2,"U.C.E.",0
19,"19215",206,170,166,0,4,"U.C.E.",0
40,"40078",180,143,143,1,0,"U.C.E.",0
22,"22018",357,272,271,4,1,"U.C.E.",0
40,"40219",635,519,505,7,14,"U.C.E.",1
8,"8264",3983,2773,2744,30,29,"U.C.E.",3
47,"47112",2671,2231,2198,28,33,"U.C.E.",0
11,"11002",4291,3388,3374,19,14,"U.C.E.",0
46,"46169",31753,24041,23802,270,239,"U.C.E.",10
26,"26164",70,42,42,1,0,"U.C.E.",0
24,"24179",331,219,214,4,5,"U.C.E.",0
14,"14050",2418,1983,1966,23,17,"U.C.E.",0
50,"50118",2312,1737,1718,22,19,"U.C.E.",1
47,"47113",166,136,135,1,1,"U.C.E.",0
19,"19319",4203,3139,3104,28,35,"U.C.E.",1
17,"17161",978,693,687,21,6,"U.C.E.",0
46,"46024",448,365,358,1,7,"U.C.E.",0
4,"4065",387,320,318,1,2,"U.C.E.",0
37,"37204",286,216,214,0,2,"U.C.E.",2
3,"3104",26809,20511,20193,317,318,"U.C.E.",19
37,"37008",4316,3518,3457,31,61,"U.C.E.",1
10,"10172",728,531,522,3,9,"U.C.E.",0
8,"8172",19889,13537,13333,267,204,"U.C.E.",11
37,"37205",235,199,195,5,4,"U.C.E.",0
23,"23043",554,411,407,6,4,"U.C.E.",0
47,"47059",108,77,76,1,1,"U.C.E.",0
47,"47142",172,132,131,2,1,"U.C.E.",0
42,"42155",188,121,120,0,1,"U.C.E.",0
42,"42097",19,16,16,0,0,"U.C.E.",0
10,"10133",1247,1045,1028,7,17,"U.C.E.",2
8,"8021",76,49,47,1,2,"U.C.E.",0
31,"31124",209,139,138,1,1,"U.C.E.",0
3,"3071",3993,3180,3128,40,52,"U.C.E.",3
37,"37047",178,111,111,0,0,"U.C.E.",0
37,"37170",1571,1122,1107,22,15,"U.C.E.",0
12,"12007",747,674,660,9,14,"U.C.E.",0
15,"15091",1171,839,829,9,10,"U.C.E.",1
41,"41069",28331,21065,20877,252,188,"U.C.E.",10
5,"5262",378,308,307,2,1,"U.C.E.",0
26,"26079",690,568,562,5,6,"U.C.E.",0
38,"38045",4181,2176,2140,13,36,"U.C.E.",1
31,"31156",268,202,201,5,1,"U.C.E.",0
46,"46122",2737,2154,2131,18,23,"U.C.E.",0
19,"19078",58,49,48,0,1,"U.C.E.",0
42,"42157",18,16,15,0,1,"U.C.E.",0
12,"12042",664,549,530,5,19,"U.C.E.",0
46,"46171",16753,12565,12399,122,166,"U.C.E.",6
3,"3007",160,131,127,0,4,"U.C.E.",0
37,"37207",287,211,208,2,3,"U.C.E.",0
17,"17193",3978,2365,2305,38,60,"U.C.E.",0
10,"10094",247,212,211,0,1,"U.C.E.",0
38,"38046",8848,6410,6301,75,109,"U.C.E.",8
5,"5166",235,181,178,1,3,"U.C.E.",0
36,"36040",2627,1938,1907,24,31,"U.C.E.",1
45,"45062",1161,959,928,8,31,"U.C.E.",0
1,"1049",147,115,115,1,0,"U.C.E.",0
42,"42206",10,9,9,1,0,"U.C.E.",0
44,"44172",345,257,251,3,6,"U.C.E.",0
37,"37360",252,194,194,1,0,"U.C.E.",0
5,"5230",79,73,73,1,0,"U.C.E.",0
5,"5167",274,230,224,6,6,"U.C.E.",0
12,"12140",1204,975,954,9,21,"U.C.E.",0
38,"38047",1819,1269,1239,12,30,"U.C.E.",0
44,"44212",45,35,35,0,0,"U.C.E.",0
19,"19324",199,151,151,2,0,"U.C.E.",0
22,"22174",520,401,394,11,7,"U.C.E.",0
40,"40086",738,628,619,12,9,"U.C.E.",3
50,"50153",1002,757,748,12,9,"U.C.E.",0
33,"33062",452,282,281,3,1,"U.C.E.",1
34,"34232",802,632,623,9,9,"U.C.E.",0
19,"19117",1526,1155,1132,26,23,"U.C.E.",0
8,"8146",1321,876,862,18,14,"U.C.E.",1
8,"8055",476,312,304,11,8,"U.C.E.",0
42,"42106",15,14,14,0,0,"U.C.E.",0
37,"37362",4333,3276,3238,65,38,"U.C.E.",5
50,"50295",54,42,41,0,1,"U.C.E.",0
15,"15010",2009,1468,1441,24,27,"U.C.E.",1
47,"47226",180,152,148,1,4,"U.C.E.",0
38,"38048",3884,2615,2587,34,28,"U.C.E.",2
26,"26083",303,234,234,1,0,"U.C.E.",0
31,"31251",3147,2274,2225,39,49,"U.C.E.",3
8,"8086",13267,8791,8669,200,122,"U.C.E.",12
3,"3111",5244,4184,4146,39,38,"U.C.E.",2
26,"26084",5999,4440,4399,56,41,"U.C.E.",1
34,"34099",56,49,47,1,2,"U.C.E.",0
37,"37015",248,169,168,0,1,"U.C.E.",0
41,"41046",3055,2456,2418,23,38,"U.C.E.",0
12,"12142",158,122,121,1,1,"U.C.E.",0
40,"40088",303,242,238,0,4,"U.C.E.",0
47,"47118",159,122,122,2,0,"U.C.E.",0
44,"44061",89,55,55,1,0,"U.C.E.",0
44,"44047",267,162,160,4,2,"U.C.E.",0
17,"17076",126,77,76,5,1,"U.C.E.",0
16,"16002",195,175,172,0,3,"U.C.E.",0
3,"3011",7341,5277,5218,72,59,"U.C.E.",5
31,"31069",860,660,647,2,13,"U.C.E.",0
40,"40091",140,111,109,1,2,"U.C.E.",0
50,"50037",140,110,103,3,7,"U.C.E.",0
19,"19120",107,95,95,1,0,"U.C.E.",0
31,"31161",321,251,246,5,5,"U.C.E.",0
36,"36044",2595,1862,1834,23,28,"U.C.E.",3
5,"5073",319,258,254,7,4,"U.C.E.",0
46,"46102",19880,15358,15179,122,179,"U.C.E.",9
46,"46224",179,131,128,0,3,"U.C.E.",0
3,"3113",4154,3295,3251,24,44,"U.C.E.",2
19,"19327",551,459,449,3,10,"U.C.E.",0
50,"50067",14124,10049,9870,203,179,"U.C.E.",9
16,"16169",75,44,44,0,0,"U.C.E.",0
19,"19257",3595,2593,2543,48,50,"U.C.E.",1
10,"10101",172,134,129,1,5,"U.C.E.",0
8,"8119",6039,3991,3884,74,107,"U.C.E.",10
37,"37018",128,89,87,0,2,"U.C.E.",0
12,"12082",9741,7555,7408,84,147,"U.C.E.",5
10,"10019",1414,1054,1037,10,17,"U.C.E.",0
15,"15013",6160,4229,4165,70,64,"U.C.E.",0
46,"46030",800,677,662,6,15,"U.C.E.",0
50,"50010",77,65,64,5,1,"U.C.E.",0
24,"24191",112,88,88,1,0,"U.C.E.",0
40,"40093",88,77,72,0,5,"U.C.E.",0
23,"23054",393,288,286,1,2,"U.C.E.",0
37,"37330",338,272,270,3,2,"U.C.E.",0
45,"45141",981,815,790,6,25,"U.C.E.",0
19,"19329",62,52,50,0,2,"U.C.E.",0
8,"8089",33316,22369,22107,437,262,"U.C.E.",38
40,"40047",47,37,36,0,1,"U.C.E.",0
18,"18087",187449,138136,136783,1548,1353,"U.C.E.",44
46,"46055",1286,1083,1067,11,16,"U.C.E.",3
16,"16908",227,181,179,1,2,"U.C.E.",0
45,"45142",7974,6294,6178,89,116,"U.C.E.",1
3,"3115",267,242,242,2,0,"U.C.E.",0
31,"31102",162,80,78,0,2,"U.C.E.",0
4,"4075",4783,3731,3700,33,31,"U.C.E.",2
24,"24155",524,428,420,6,8,"U.C.E.",0
31,"31073",332,228,226,1,2,"U.C.E.",0
40,"40095",507,437,425,2,12,"U.C.E.",1
34,"34240",102,84,83,1,1,"U.C.E.",0
42,"42063",69,53,53,4,0,"U.C.E.",0
22,"22184",203,172,167,2,5,"U.C.E.",0
8,"8030",4849,3466,3422,50,44,"U.C.E.",1
5,"5903",171,118,118,0,0,"U.C.E.",0
37,"37106",289,199,196,2,3,"U.C.E.",0
26,"26092",112,89,88,2,1,"U.C.E.",0
50,"50040",98,77,76,2,1,"U.C.E.",0
41,"41077",8817,6520,6375,53,145,"U.C.E.",2
22,"22233",94,69,69,0,0,"U.C.E.",0
40,"40903",102,75,75,0,0,"U.C.E.",0
45,"45144",839,701,691,11,10,"U.C.E.",0
44,"44181",82,63,63,3,0,"U.C.E.",0
5,"5904",149,99,97,0,2,"U.C.E.",0
17,"17172",426,286,283,3,3,"U.C.E.",0
19,"19124",420,293,291,3,2,"U.C.E.",0
12,"12017",183,143,141,6,2,"U.C.E.",0
40,"40099",61,52,52,2,0,"U.C.E.",0
16,"16227",128,95,94,0,1,"U.C.E.",0
17,"17021",108,86,79,0,7,"U.C.E.",0
22,"22040",155,129,127,3,2,"U.C.E.",0
44,"44053",111,77,76,2,1,"U.C.E.",0
17,"17201",131,89,89,2,0,"U.C.E.",0
24,"24115",54654,38629,38010,716,619,"U.C.E.",23
40,"40905",143,103,103,1,0,"U.C.E.",0
16,"16278",91,69,69,2,0,"U.C.E.",0
40,"40100",303,241,231,5,10,"U.C.E.",0
19,"19125",54,42,42,2,0,"U.C.E.",0
20,"20069",146828,101992,101225,1287,767,"U.C.E.",101
3,"3083",5708,4267,4196,66,71,"U.C.E.",3
31,"31259",503,341,336,6,5,"U.C.E.",0
47,"47043",330,267,264,1,3,"U.C.E.",1
19,"19013",143,110,108,1,2,"U.C.E.",0
31,"31015",1989,1404,1380,29,24,"U.C.E.",1
50,"50162",160,108,108,2,0,"U.C.E.",0
24,"24037",429,282,277,4,5,"U.C.E.",0
34,"34202",28,21,21,0,0,"U.C.E.",0
39,"39080",3627,2743,2693,19,50,"U.C.E.",1
10,"10066",182,136,133,1,3,"U.C.E.",0
39,"39054",4265,3338,3276,57,62,"U.C.E.",0
31,"31137",215,108,106,1,2,"U.C.E.",0
24,"24117",493,376,369,2,7,"U.C.E.",0
46,"46204",6906,5426,5357,62,69,"U.C.E.",0
37,"37336",54,49,47,0,2,"U.C.E.",0
22,"22189",199,140,138,5,2,"U.C.E.",0
8,"8187",149633,104021,102629,1794,1392,"U.C.E.",138
12,"12056",304,259,254,7,5,"U.C.E.",1
19,"19335",77,61,61,1,0,"U.C.E.",0
47,"47127",150,110,108,0,2,"U.C.E.",0
50,"50133",126,101,100,1,1,"U.C.E.",0
14,"14034",367,301,292,1,9,"U.C.E.",0
45,"45075",205,162,159,4,3,"U.C.E.",0
39,"39056",2387,1857,1835,22,22,"U.C.E.",0
16,"16177",86,68,68,0,0,"U.C.E.",0
22,"22084",524,362,354,11,8,"U.C.E.",0
18,"18193",13680,9874,9764,130,110,"U.C.E.",1
33,"33047",1178,939,931,2,8,"U.C.E.",0
26,"26099",1281,1050,1025,19,25,"U.C.E.",0
24,"24080",228,165,164,0,1,"U.C.E.",0
4,"4081",367,312,309,0,3,"U.C.E.",0
50,"50192",240,188,184,9,4,"U.C.E.",0
37,"37186",109,88,88,2,0,"U.C.E.",1
18,"18029",1892,1355,1347,6,8,"U.C.E.",0
35,"35023",11640,8412,8178,97,234,"U.C.E.",4
8,"8902",3600,2518,2496,57,22,"U.C.E.",3
16,"16052",596,469,464,2,5,"U.C.E.",1
41,"41002",1510,1161,1140,4,21,"U.C.E.",0
12,"12057",650,530,515,6,15,"U.C.E.",0
10,"10111",1453,1052,1046,13,6,"U.C.E.",1
8,"8281",4735,3239,3193,57,46,"U.C.E.",0
19,"19017",87,70,70,0,0,"U.C.E.",0
34,"34112",50,39,38,2,1,"U.C.E.",0
16,"16185",63,45,44,0,1,"U.C.E.",0
23,"23063",3960,3073,3037,21,36,"U.C.E.",1
15,"15020",4187,2802,2781,18,21,"U.C.E.",3
34,"34046",45,35,34,0,1,"U.C.E.",0
41,"41003",2196,1803,1782,21,21,"U.C.E.",0
5,"5179",231,206,204,2,2,"U.C.E.",0
45,"45188",2883,2180,2151,30,29,"U.C.E.",0
18,"18097",1022,758,752,4,6,"U.C.E.",0
37,"37340",155,121,121,0,0,"U.C.E.",0
8,"8128",557,377,374,16,3,"U.C.E.",0
22,"22046",784,618,599,15,19,"U.C.E.",0
34,"34033",17,15,15,0,0,"U.C.E.",0
10,"10154",194,150,145,0,5,"U.C.E.",0
5,"5180",109,92,91,1,1,"U.C.E.",0
40,"40107",113,93,90,3,3,"U.C.E.",0
19,"19055",54,41,37,1,4,"U.C.E.",0
31,"31141",132,100,98,1,2,"U.C.E.",1
24,"24164",397,215,213,2,2,"U.C.E.",0
34,"34072",189,169,166,2,3,"U.C.E.",0
12,"12123",70,50,48,2,2,"U.C.E.",0
8,"8068",6554,4323,4255,87,68,"U.C.E.",4
3,"3090",16226,12224,12116,139,108,"U.C.E.",11
37,"37071",90,80,80,1,0,"U.C.E.",0
26,"26060",100,71,71,3,0,"U.C.E.",0
17,"17148",1546,980,957,24,23,"U.C.E.",0
12,"12060",467,367,353,2,14,"U.C.E.",0
5,"5084",81,70,69,0,1,"U.C.E.",0
16,"16057",109,82,82,1,0,"U.C.E.",2
31,"31203",30,25,25,0,0,"U.C.E.",0
4,"4085",453,384,383,0,1,"U.C.E.",0
20,"20040",15103,9781,9686,148,95,"U.C.E.",6
20,"20077",5382,3766,3741,42,25,"U.C.E.",0
4,"4015",149,115,115,0,0,"U.C.E.",0
3,"3057",232,179,178,0,1,"U.C.E.",0
40,"40015",33,30,30,1,0,"U.C.E.",0
23,"23067",2523,2004,1974,16,30,"U.C.E.",3
40,"40110",391,303,302,6,1,"U.C.E.",0
42,"42183",131,95,94,7,1,"U.C.E.",0
16,"16242",367,315,313,4,2,"U.C.E.",0
39,"39008",13716,10396,10274,129,122,"U.C.E.",8
47,"47131",189,145,145,4,0,"U.C.E.",0
11,"11020",163674,106898,106082,1655,816,"U.C.E.",41
47,"47049",94,71,71,1,0,"U.C.E.",0
50,"50297",495260,360632,355561,7046,5071,"U.C.E.",278
8,"8131",696,483,469,7,14,"U.C.E.",0
37,"37032",530,410,409,4,1,"U.C.E.",1
36,"36057",236900,168990,166060,2833,2930,"U.C.E.",147
4,"4087",198,162,159,2,3,"U.C.E.",0
19,"19238",42,32,31,1,1,"U.C.E.",0
45,"45155",481,382,375,3,7,"U.C.E.",0
30,"30038",15057,11640,11555,82,85,"U.C.E.",6
37,"37118",141,115,114,3,1,"U.C.E.",0
5,"5183",165,142,140,0,2,"U.C.E.",0
47,"47050",3557,2688,2651,50,37,"U.C.E.",0
10,"10036",345,262,251,2,11,"U.C.E.",0
19,"19269",103,84,83,0,1,"U.C.E.",1
5,"5019",44095,34409,33934,505,475,"U.C.E.",17
37,"37344",259,212,211,5,1,"U.C.E.",1
18,"18034",510,377,375,2,2,"U.C.E.",0
50,"50079",281,213,210,2,3,"U.C.E.",0
26,"26108",324,245,243,4,2,"U.C.E.",0
50,"50225",1638,1079,1062,7,17,"U.C.E.",1
16,"16245",430,338,329,2,9,"U.C.E.",0
19,"19023",121,95,94,5,1,"U.C.E.",0
26,"26024",273,220,219,2,1,"U.C.E.",0
8,"8256",669,498,496,16,2,"U.C.E.",0
50,"50109",101,79,79,2,0,"U.C.E.",0
45,"45047",2404,1685,1662,7,23,"U.C.E.",0
42,"42135",89,59,59,1,0,"U.C.E.",0
35,"35003",4764,2733,2680,34,53,"U.C.E.",5
46,"46065",1606,1250,1234,15,16,"U.C.E.",1
22,"22151",97,71,71,0,0,"U.C.E.",0
26,"26109",105,87,84,0,3,"U.C.E.",0
20,"20044",368,258,257,1,1,"U.C.E.",0
24,"24129",125,88,86,5,2,"U.C.E.",0
31,"31238",125,99,98,3,1,"U.C.E.",0
47,"47051",351,269,256,5,13,"U.C.E.",0
24,"24213",162,134,133,1,1,"U.C.E.",2
46,"46042",3376,2873,2819,17,54,"U.C.E.",0
39,"39089",163,126,126,0,0,"U.C.E.",0
12,"12032",23406,16895,16721,227,174,"U.C.E.",13
31,"31239",302,229,224,7,5,"U.C.E.",0
37,"37079",77,64,63,1,1,"U.C.E.",0
37,"37196",93,74,70,1,4,"U.C.E.",0
37,"37347",481,374,371,6,3,"U.C.E.",0
16,"16150",120,90,90,0,0,"U.C.E.",0
8,"8197",7316,4983,4926,69,57,"U.C.E.",1
11,"11015",59476,38207,37898,501,309,"U.C.E.",12
24,"24012",291,196,194,2,2,"U.C.E.",0
31,"31086",11499,8520,8389,214,131,"U.C.E.",12
16,"16108",68,56,55,0,1,"U.C.E.",0
44,"44071",657,453,448,9,5,"U.C.E.",1
47,"47001",51,44,42,2,2,"U.C.E.",0
31,"31208",2574,2003,1966,32,37,"U.C.E.",1
17,"17092",3520,2273,2228,42,45,"U.C.E.",5
14,"14014",2610,2160,2125,19,35,"U.C.E.",0
33,"33077",1351,938,931,7,7,"U.C.E.",0
16,"16195",545,436,433,6,3,"U.C.E.",0
44,"44119",119,84,84,2,0,"U.C.E.",0
8,"8289",4123,2802,2768,54,34,"U.C.E.",2
3,"3133",40056,25746,25554,231,192,"U.C.E.",28
18,"18140",42971,28391,28126,335,265,"U.C.E.",12
5,"5188",55,47,47,0,0,"U.C.E.",0
45,"45088",2038,1379,1356,14,23,"U.C.E.",0
18,"18070",287,240,239,2,1,"U.C.E.",0
24,"24216",782,582,574,3,8,"U.C.E.",0
46,"46044",4301,3284,3169,50,115,"U.C.E.",2
40,"40121",325,266,262,3,4,"U.C.E.",0
14,"14015",2198,1776,1755,16,21,"U.C.E.",4
46,"46117",476,377,373,6,4,"U.C.E.",1
19,"19177",82,67,66,0,1,"U.C.E.",0
45,"45014",4087,2851,2816,36,35,"U.C.E.",0
46,"46068",326,292,285,3,7,"U.C.E.",1
37,"37238",102,77,76,0,1,"U.C.E.",0
46,"46141",424,338,336,2,2,"U.C.E.",0
22,"22158",11978,8404,8279,149,125,"U.C.E.",9
34,"34084",142,124,122,3,2,"U.C.E.",0
44,"44241",575,442,427,4,15,"U.C.E.",0
46,"46165",6962,5390,5322,53,68,"U.C.E.",6
40,"40168",36,27,27,0,0,"U.C.E.",0
17,"17225",208,138,134,1,4,"U.C.E.",0
23,"23020",1623,1414,1400,16,14,"U.C.E.",1
38,"38038",161890,99555,97980,1101,1575,"U.C.E.",105
20,"20905",142,105,103,1,2,"U.C.E.",0
10,"10207",499,394,392,1,2,"U.C.E.",0
5,"5159",287,216,216,0,0,"U.C.E.",0
31,"31908",997,692,683,9,9,"U.C.E.",0
47,"47055",212,169,168,3,1,"U.C.E.",0
37,"37240",781,552,540,10,12,"U.C.E.",0
24,"24096",145,96,93,0,3,"U.C.E.",0
31,"31090",156,77,77,0,0,"U.C.E.",0
44,"44204",24,21,21,0,0,"U.C.E.",0
47,"47004",1261,1047,1031,11,16,"U.C.E.",0
10,"10208",141,118,118,1,0,"U.C.E.",0
47,"47083",80,61,59,3,2,"U.C.E.",0
50,"50288",3252,2412,2380,50,32,"U.C.E.",0
16,"16112",1562,1159,1140,12,19,"U.C.E.",1
4,"4062",4604,3711,3654,22,57,"U.C.E.",1
44,"44123",117,79,78,2,1,"U.C.E.",0
42,"42003",76,54,51,0,3,"U.C.E.",0
31,"31181",168,121,119,3,2,"U.C.E.",0
37,"37316",792,565,559,7,6,"U.C.E.",0
20,"20052",1154,849,847,14,2,"U.C.E.",0
33,"33034",11390,7583,7501,85,82,"U.C.E.",1
40,"40030",520,432,425,9,7,"U.C.E.",0
50,"50001",130,96,96,0,0,"U.C.E.",0
12,"12073",168,135,135,1,0,"U.C.E.",0
46,"46119",856,702,693,0,9,"U.C.E.",0
39,"39016",24213,18549,18362,265,187,"U.C.E.",7
50,"50058",80,65,64,0,1,"U.C.E.",0
37,"37355",187,142,140,2,2,"U.C.E.",0
44,"44206",156,119,117,3,2,"U.C.E.",1
37,"37129",247,198,198,4,0,"U.C.E.",1
8,"8049",1340,839,816,10,23,"U.C.E.",0
17,"17189",1536,1061,1025,7,36,"U.C.E.",0
3,"3137",719,536,530,3,6,"U.C.E.",0
50,"50148",365,256,251,2,5,"U.C.E.",0
47,"47014",55,47,47,0,0,"U.C.E.",0
22,"22127",483,357,353,9,4,"U.C.E.",0
45,"45069",1791,1409,1389,8,20,"U.C.E.",1
4,"4064",2585,1817,1803,18,14,"U.C.E.",0
26,"26035",22,14,14,0,0,"U.C.E.",0
15,"15005",23875,15132,14895,356,237,"U.C.E.",20
16,"16073",214,170,170,2,0,"U.C.E.",0
41,"41015",5263,3820,3752,34,68,"U.C.E.",0
12,"12074",783,679,676,3,3,"U.C.E.",0
19,"19038",48,33,33,0,0,"U.C.E.",0
34,"34006",82,72,72,1,0,"U.C.E.",0
18,"18043",140,89,87,1,2,"U.C.E.",0
46,"46218",1082,964,936,5,28,"U.C.E.",0
37,"37046",11929,8847,8683,146,164,"U.C.E.",3
46,"46170",3464,2944,2908,24,36,"U.C.E.",2
17,"17132",1296,913,900,15,13,"U.C.E.",0
10,"10050",1208,1003,983,8,20,"U.C.E.",0
50,"50149",48,35,35,0,0,"U.C.E.",0
8,"8051",17397,12178,12002,240,176,"U.C.E.",8
50,"50179",269,230,229,2,1,"U.C.E.",0
47,"47086",4062,3162,3120,37,42,"U.C.E.",0
12,"12006",185,160,153,0,7,"U.C.E.",0
26,"26122",109,94,92,2,2,"U.C.E.",0
39,"39018",4077,3212,3160,44,52,"U.C.E.",1
22,"22234",818,609,605,12,4,"U.C.E.",1
35,"35020",6142,4227,4192,24,35,"U.C.E.",3
37,"37091",181,127,119,0,8,"U.C.E.",0
50,"50032",330,233,228,3,5,"U.C.E.",0
17,"17162",137,80,78,2,2,"U.C.E.",1
4,"4030",1222,930,924,5,6,"U.C.E.",0
4,"4100",7918,5465,5425,52,40,"U.C.E.",1
10,"10011",611,527,519,5,8,"U.C.E.",0
14,"14022",4077,3147,3102,20,45,"U.C.E.",2
11,"11023",9209,6979,6929,81,50,"U.C.E.",2
50,"50237",103,76,75,0,1,"U.C.E.",0
20,"20057",194,122,122,0,0,"U.C.E.",0
18,"18015",465,381,379,1,2,"U.C.E.",0
10,"10174",177,145,145,2,0,"U.C.E.",0
37,"37049",163,119,119,0,0,"U.C.E.",0
45,"45061",2523,1839,1813,20,26,"U.C.E.",2
37,"37011",131,87,86,2,1,"U.C.E.",0
5,"5143",81,61,61,0,0,"U.C.E.",0
10,"10216",1549,1247,1235,15,12,"U.C.E.",2
24,"24183",900,571,567,10,4,"U.C.E.",0
8,"8298",25338,16982,16690,353,292,"U.C.E.",7
8,"8114",17629,11781,11579,189,202,"U.C.E.",7
8,"8238",13892,10237,10094,206,143,"U.C.E.",14
26,"26169",83,73,72,0,1,"U.C.E.",0
10,"10135",1366,1004,998,3,6,"U.C.E.",0
46,"46123",1808,1440,1410,7,30,"U.C.E.",0
20,"20022",832,527,521,9,6,"U.C.E.",2
42,"42011",22,14,14,1,0,"U.C.E.",0
44,"44005",59,43,43,1,0,"U.C.E.",0
18,"18016",339,254,253,2,1,"U.C.E.",0
46,"46197",1902,1559,1554,15,5,"U.C.E.",0
26,"26126",32,31,31,1,0,"U.C.E.",0
19,"19079",7,7,7,0,0,"U.C.E.",0
4,"4102",12940,9247,9152,90,95,"U.C.E.",12
7,"7005",6331,4128,4058,76,70,"U.C.E.",3
47,"47225",89,67,66,0,1,"U.C.E.",0
46,"46148",1400,1131,1114,13,17,"U.C.E.",0
22,"22225",2784,1839,1805,42,34,"U.C.E.",3
8,"8299",444,277,267,5,10,"U.C.E.",0
31,"31007",137,96,90,2,6,"U.C.E.",0
40,"40135",298,247,242,4,5,"U.C.E.",0
42,"42160",288,222,221,2,1,"U.C.E.",0
22,"22175",211,158,158,9,0,"U.C.E.",0
23,"23004",478,416,415,1,1,"U.C.E.",0
8,"8024",409,266,260,4,6,"U.C.E.",0
31,"31128",406,261,261,4,0,"U.C.E.",0
3,"3075",160,139,136,2,3,"U.C.E.",1
5,"5134",47,37,37,0,0,"U.C.E.",0
24,"24229",473,348,344,8,4,"U.C.E.",0
5,"5198",80,65,65,1,0,"U.C.E.",0
45,"45064",3801,2987,2953,38,34,"U.C.E.",0
26,"26003",446,388,387,8,1,"U.C.E.",1
17,"17195",324,220,214,6,6,"U.C.E.",0
10,"10016",321,266,262,2,4,"U.C.E.",0
45,"45138",1185,998,973,5,25,"U.C.E.",0
8,"8210",4176,2661,2579,54,82,"U.C.E.",3
39,"39100",922,718,712,8,6,"U.C.E.",0
15,"15011",15507,10935,10751,123,184,"U.C.E.",8
50,"50250",58,43,43,4,0,"U.C.E.",0
50,"50115",3280,2234,2205,32,29,"U.C.E.",1
16,"16139",346,279,277,2,2,"U.C.E.",0
12,"12901",3383,2664,2632,34,32,"U.C.E.",1
47,"47064",30,21,21,1,0,"U.C.E.",0
14,"14027",7948,5944,5871,92,73,"U.C.E.",0
37,"37252",127,92,92,0,0,"U.C.E.",0
45,"45066",7334,5602,5536,52,66,"U.C.E.",2
22,"22125",38140,26924,26463,676,461,"U.C.E.",27
45,"45175",698,587,579,5,8,"U.C.E.",0
19,"19256",48,44,43,0,1,"U.C.E.",0
8,"8211",32035,23059,22687,453,372,"U.C.E.",21
19,"19157",66,56,56,4,0,"U.C.E.",0
5,"5200",56,43,42,0,1,"U.C.E.",0
34,"34189",59,47,47,3,0,"U.C.E.",0
1,"1055",906,632,623,7,9,"U.C.E.",0
37,"37365",172,152,149,2,3,"U.C.E.",0
20,"20063",7889,5381,5340,48,41,"U.C.E.",6
8,"8149",985,683,671,11,12,"U.C.E.",0
31,"31223",1043,783,771,14,12,"U.C.E.",0
3,"3078",528,424,423,2,1,"U.C.E.",0
41,"41022",4281,3087,3066,15,21,"U.C.E.",1
34,"34060",150,123,123,2,0,"U.C.E.",0
24,"24109",1098,672,663,12,9,"U.C.E.",2
8,"8027",673,527,515,9,12,"U.C.E.",0
18,"18032",248,166,166,2,0,"U.C.E.",1
19,"19008",34,25,25,1,0,"U.C.E.",0
31,"31071",17,15,15,0,0,"U.C.E.",0
42,"42213",31,24,24,2,0,"U.C.E.",0
37,"37058",68,44,44,0,0,"U.C.E.",0
45,"45104",457,375,370,2,5,"U.C.E.",0
8,"8028",1049,667,657,15,10,"U.C.E.",0
40,"40141",881,658,647,9,11,"U.C.E.",1
50,"50068",2082,1514,1481,18,33,"U.C.E.",2
10,"10184",771,609,597,7,12,"U.C.E.",1
23,"23099",4649,3638,3594,39,44,"U.C.E.",3
30,"30028",6810,5333,5251,44,82,"U.C.E.",1
19,"19047",87,71,70,2,1,"U.C.E.",1
17,"17119",89,65,64,3,1,"U.C.E.",0
22,"22248",119,94,92,3,2,"U.C.E.",0
45,"45192",2549,2178,2155,39,23,"U.C.E.",1
8,"8305",26208,17810,17506,296,304,"U.C.E.",18
19,"19088",98,67,66,0,1,"U.C.E.",0
26,"26048",29,27,26,1,1,"U.C.E.",0
42,"42166",68,49,48,1,1,"U.C.E.",0
12,"12015",96,83,82,3,1,"U.C.E.",0
10,"10144",999,782,773,7,9,"U.C.E.",0
12,"12084",17219,12059,11911,165,148,"U.C.E.",12
14,"14030",8519,6832,6753,64,79,"U.C.E.",1
31,"31103",51,40,40,3,0,"U.C.E.",0
31,"31134",195,134,132,3,2,"U.C.E.",1
11,"11031",76347,49071,48616,681,455,"U.C.E.",24
10,"10145",132,112,111,0,1,"U.C.E.",0
5,"5108",64,41,41,0,0,"U.C.E.",0
26,"26009",426,318,313,4,5,"U.C.E.",0
47,"47231",4272,3268,3243,64,25,"U.C.E.",0
5,"5237",198,157,155,3,2,"U.C.E.",0
17,"17171",148,111,109,5,2,"U.C.E.",0
45,"45071",1896,1592,1575,21,17,"U.C.E.",1
31,"31195",186,127,126,1,1,"U.C.E.",0
19,"19294",27,26,26,1,0,"U.C.E.",0
31,"31257",827,598,585,16,13,"U.C.E.",2
44,"44222",136,99,99,2,0,"U.C.E.",0
44,"44154",271,196,195,7,1,"U.C.E.",0
19,"19060",165,127,121,3,6,"U.C.E.",0
16,"16174",209,170,167,0,3,"U.C.E.",0
42,"42022",253,177,171,2,6,"U.C.E.",0
11,"11032",53183,32205,31982,441,223,"U.C.E.",9
42,"42219",45,33,33,1,0,"U.C.E.",1
39,"39001",2146,1669,1645,20,24,"U.C.E.",0
47,"47016",94,77,77,1,0,"U.C.E.",0
47,"47232",107,77,75,1,2,"U.C.E.",0
5,"5207",743,595,591,1,4,"U.C.E.",0
40,"40146",270,222,222,0,0,"U.C.E.",0
19,"19163",73,59,59,0,0,"U.C.E.",1
45,"45035",307,236,236,3,0,"U.C.E.",0
47,"47125",55,46,46,0,0,"U.C.E.",0
8,"8185",189,131,126,1,5,"U.C.E.",0
31,"31106",676,534,518,10,16,"U.C.E.",1
37,"37146",135,117,117,1,0,"U.C.E.",0
46,"46090",1668,1488,1452,9,36,"U.C.E.",0
8,"8247",903,627,608,10,19,"U.C.E.",0
37,"37259",44,32,32,3,0,"U.C.E.",0
18,"18159",1051,873,869,4,4,"U.C.E.",0
41,"41093",17665,13712,13526,179,186,"U.C.E.",2
12,"12088",55,51,51,2,0,"U.C.E.",0
44,"44268",30,25,25,0,0,"U.C.E.",0
19,"19015",104,88,87,0,1,"U.C.E.",0
31,"31229",46,38,37,0,1,"U.C.E.",0
17,"17173",174,121,119,1,2,"U.C.E.",0
31,"31198",38,33,33,0,0,"U.C.E.",0
5,"5176",237,193,190,4,3,"U.C.E.",0
31,"31167",859,600,593,11,7,"U.C.E.",0
45,"45037",1730,1325,1304,15,21,"U.C.E.",1
44,"44019",75,38,37,0,1,"U.C.E.",0
40,"40150",76,62,62,1,0,"U.C.E.",0
31,"31107",1706,1321,1311,17,10,"U.C.E.",1
7,"7049",1482,1046,1037,14,9,"U.C.E.",0
45,"45111",65,47,44,1,3,"U.C.E.",0
37,"37261",255,191,191,2,0,"U.C.E.",1
50,"50276",148,116,114,3,2,"U.C.E.",0
37,"37298",206,144,140,1,4,"U.C.E.",0
50,"50016",51,30,30,1,0,"U.C.E.",0
44,"44020",23,15,15,0,0,"U.C.E.",0
31,"31017",358,220,219,12,1,"U.C.E.",0
50,"50163",3427,2448,2413,62,35,"U.C.E.",0
41,"41028",1880,1479,1458,28,21,"U.C.E.",1
22,"22043",112,72,71,2,1,"U.C.E.",0
22,"22242",75,53,52,0,1,"U.C.E.",0
20,"20073",4689,3196,3176,28,20,"U.C.E.",2
31,"31078",2502,1880,1852,33,28,"U.C.E.",1
22,"22193",318,266,264,7,2,"U.C.E.",1
11,"11036",725,484,482,10,2,"U.C.E.",0
45,"45187",4187,3581,3512,25,69,"U.C.E.",1
10,"10029",447,362,355,1,7,"U.C.E.",0
5,"5014",5559,4197,4101,53,96,"U.C.E.",1
46,"46133",686,572,565,1,7,"U.C.E.",0
20,"20037",100,65,64,2,1,"U.C.E.",0
42,"42177",78,64,62,4,2,"U.C.E.",0
16,"16903",1097,855,828,9,27,"U.C.E.",1
22,"22209",161,115,115,4,0,"U.C.E.",1
23,"23050",91354,68649,67925,990,724,"U.C.E.",74
33,"33071",671,528,523,4,5,"U.C.E.",0
18,"18132",3461,2797,2772,19,25,"U.C.E.",0
30,"30035",17849,12871,12744,133,127,"U.C.E.",4
50,"50135",100,76,75,2,1,"U.C.E.",0
7,"7018",389,275,271,0,4,"U.C.E.",0
16,"16239",158,114,112,2,2,"U.C.E.",0
22,"22087",85,56,55,4,1,"U.C.E.",0
7,"7051",4925,2993,2947,66,46,"U.C.E.",1
8,"8282",6092,4478,4405,79,73,"U.C.E.",4
44,"44062",38,34,34,0,0,"U.C.E.",0
31,"31019",1858,1288,1266,25,22,"U.C.E.",1
19,"19097",28,27,27,0,0,"U.C.E.",0
40,"40013",67,56,54,1,2,"U.C.E.",0
40,"40108",120,83,82,1,1,"U.C.E.",0
30,"30018",7493,6003,5922,52,81,"U.C.E.",6
5,"5257",153,105,104,0,1,"U.C.E.",0
17,"17026",542,404,398,3,6,"U.C.E.",0
22,"22246",93,63,62,0,1,"U.C.E.",1
18,"18164",1881,1351,1342,16,9,"U.C.E.",0
10,"10195",7917,6143,6054,36,89,"U.C.E.",4
50,"50106",137,107,106,0,1,"U.C.E.",0
4,"4052",11567,8189,8124,158,65,"U.C.E.",4
37,"37030",90,71,70,4,1,"U.C.E.",0
16,"16202",908,753,744,10,9,"U.C.E.",0
37,"37342",252,216,211,3,5,"U.C.E.",0
39,"39033",604,480,473,3,7,"U.C.E.",0
24,"24165",400,284,279,4,5,"U.C.E.",0
5,"5181",39,26,26,0,0,"U.C.E.",0
7,"7053",1133,863,839,16,24,"U.C.E.",1
22,"22143",244,166,161,2,5,"U.C.E.",0
26,"26020",506,372,364,10,8,"U.C.E.",1
34,"34211",202,175,170,1,5,"U.C.E.",0
16,"16101",160,142,142,0,0,"U.C.E.",0
34,"34088",219,179,177,4,2,"U.C.E.",0
33,"33051",7576,5379,5335,65,44,"U.C.E.",0
37,"37031",399,308,307,5,1,"U.C.E.",0
7,"7032",19658,12168,11959,238,209,"U.C.E.",19
45,"45179",608,476,471,3,5,"U.C.E.",0
34,"34022",1136,926,908,5,18,"U.C.E.",0
19,"19172",76,65,64,1,1,"U.C.E.",0
44,"44026",89,69,69,0,0,"U.C.E.",1
4,"4053",12062,9283,9180,119,103,"U.C.E.",4
24,"24007",798,582,566,2,16,"U.C.E.",2
34,"34161",23,20,20,0,0,"U.C.E.",0
50,"50021",42,34,33,1,1,"U.C.E.",0
8,"8254",1721,1189,1174,26,15,"U.C.E.",1
14,"14040",3821,2986,2949,40,37,"U.C.E.",1
35,"35002",21673,14480,14253,172,227,"U.C.E.",21
10,"10158",367,307,306,3,1,"U.C.E.",0
37,"37156",4319,3280,3233,28,47,"U.C.E.",1
47,"47103",277,218,214,1,4,"U.C.E.",0
23,"23027",763,619,616,1,3,"U.C.E.",2
40,"40065",520,401,393,6,8,"U.C.E.",0
45,"45119",3274,2279,2236,37,43,"U.C.E.",1
45,"45009",588,430,422,2,8,"U.C.E.",0
46,"46902",425,333,332,3,1,"U.C.E.",0
17,"17151",174,131,131,6,0,"U.C.E.",0
38,"38033",3987,2696,2656,23,40,"U.C.E.",1
19,"19305",166,130,130,0,0,"U.C.E.",0
17,"17182",257,177,175,2,2,"U.C.E.",0
34,"34122",80,65,62,2,3,"U.C.E.",0
26,"26037",150,129,128,1,1,"U.C.E.",0
19,"19195",41,30,30,1,0,"U.C.E.",0
40,"40019",43,35,35,0,0,"U.C.E.",0
41,"41101",5752,4663,4629,25,34,"U.C.E.",0
16,"16246",520,417,407,1,10,"U.C.E.",2
24,"24010",8550,6242,6111,100,131,"U.C.E.",3
50,"50283",73,55,55,1,0,"U.C.E.",0
37,"37034",91,72,72,0,0,"U.C.E.",0
37,"37158",262,181,179,0,2,"U.C.E.",0
18,"18067",704,526,521,1,5,"U.C.E.",0
19,"19138",298,223,219,3,4,"U.C.E.",0
1,"1030",170,123,120,1,3,"U.C.E.",0
34,"34039",66,57,56,0,1,"U.C.E.",0
8,"8226",886,667,656,13,11,"U.C.E.",0
37,"37035",220,176,173,1,3,"U.C.E.",0
26,"26153",12,9,8,0,1,"U.C.E.",0
12,"12098",665,552,539,9,13,"U.C.E.",0
20,"20021",216,122,122,0,0,"U.C.E.",0
16,"16106",2839,2351,2331,10,20,"U.C.E.",1
46,"46163",1811,1487,1463,12,24,"U.C.E.",0
14,"14073",3009,2246,2224,32,22,"U.C.E.",2
22,"22252",130,98,96,5,2,"U.C.E.",0
46,"46139",4594,3794,3734,28,60,"U.C.E.",0
17,"17031",172,94,93,1,1,"U.C.E.",0
7,"7026",30036,16912,16661,294,251,"U.C.E.",16
50,"50141",116,98,98,1,0,"U.C.E.",0
26,"26154",12,12,12,3,0,"U.C.E.",0
7,"7058",2803,2100,2046,38,54,"U.C.E.",1
37,"37272",162,121,120,1,1,"U.C.E.",0
31,"31117",670,471,467,3,4,"U.C.E.",0
24,"24131",813,583,580,9,3,"U.C.E.",0
8,"8074",10224,6571,6479,116,92,"U.C.E.",4
19,"19274",881,652,644,8,8,"U.C.E.",0
40,"40164",188,145,142,0,3,"U.C.E.",2
26,"26027",169,126,126,1,0,"U.C.E.",0
34,"34082",96,79,75,0,4,"U.C.E.",0
4,"4021",188,157,157,2,0,"U.C.E.",0
8,"8259",6362,4482,4420,97,62,"U.C.E.",7
26,"26028",135,108,106,2,2,"U.C.E.",0
50,"50258",54,37,37,0,0,"U.C.E.",1
16,"16196",658,578,568,6,10,"U.C.E.",0
41,"41037",3228,2510,2483,27,27,"U.C.E.",0
40,"40024",920,712,704,7,8,"U.C.E.",1
7,"7060",2534,1724,1697,30,27,"U.C.E.",1
17,"17185",2273,1416,1379,32,37,"U.C.E.",4
47,"47054",673,545,541,8,4,"U.C.E.",0
31,"31027",824,611,609,2,2,"U.C.E.",0
26,"26158",296,238,237,7,1,"U.C.E.",0
24,"24133",379,279,279,0,0,"U.C.E.",0
50,"50026",459,360,354,5,6,"U.C.E.",1
37,"37274",123032,90819,89629,1506,1190,"U.C.E.",76
42,"42043",3905,2931,2875,48,56,"U.C.E.",1
44,"44240",168,135,132,2,3,"U.C.E.",0
30,"30017",11683,9332,9233,95,99,"U.C.E.",1
15,"15057",12467,8936,8744,102,192,"U.C.E.",7
5,"5254",212,186,185,2,1,"U.C.E.",0
17,"17005",404,258,254,12,4,"U.C.E.",0
42,"42015",34,24,24,5,0,"U.C.E.",0
40,"40136",130,106,106,1,0,"U.C.E.",0
50,"50105",343,263,259,2,4,"U.C.E.",0
18,"18141",484,326,325,1,1,"U.C.E.",0
19,"19109",53,40,40,1,0,"U.C.E.",0
37,"37314",79,61,61,3,0,"U.C.E.",0
19,"19108",117,97,95,0,2,"U.C.E.",0
16,"16251",1903,1510,1493,18,17,"U.C.E.",1
5,"5222",155,132,132,1,0,"U.C.E.",0
22,"22107",131,81,77,1,4,"U.C.E.",0
34,"34047",1814,1435,1413,24,22,"U.C.E.",0
22,"22109",243,178,178,2,0,"U.C.E.",0
19,"19179",109,77,75,3,2,"U.C.E.",0
31,"31120",408,267,265,8,2,"U.C.E.",0
45,"45127",739,550,538,5,12,"U.C.E.",2
37,"37004",31,23,23,0,0,"U.C.E.",0
38,"38039",10198,7548,7429,78,119,"U.C.E.",9
46,"46151",717,596,589,3,7,"U.C.E.",0
10,"10903",813,620,615,3,5,"U.C.E.",0
7,"7063",1414,1050,1030,25,20,"U.C.E.",1
44,"44037",483,349,344,10,5,"U.C.E.",0
47,"47030",1075,822,801,13,21,"U.C.E.",0
40,"40171",32,25,25,0,0,"U.C.E.",0
50,"50185",150,109,109,2,0,"U.C.E.",0
36,"36001",3138,2060,2049,13,11,"U.C.E.",0
5,"5127",715,601,596,4,5,"U.C.E.",0
47,"47174",302,236,234,3,2,"U.C.E.",0
45,"45092",252,223,221,0,2,"U.C.E.",0
44,"44244",93,56,56,5,0,"U.C.E.",0
46,"46071",488,418,402,10,16,"U.C.E.",0
8,"8233",1867,1179,1169,29,10,"U.C.E.",1
31,"31031",234,144,143,1,1,"U.C.E.",0
12,"12104",6981,5464,5357,54,107,"U.C.E.",3
10,"10047",978,795,780,9,15,"U.C.E.",0
4,"4027",260,186,186,0,0,"U.C.E.",1
5,"5225",423,346,342,8,4,"U.C.E.",0
16,"16129",112,79,74,0,5,"U.C.E.",0
41,"41040",9567,7305,7210,93,95,"U.C.E.",4
20,"20053",4830,2895,2868,36,27,"U.C.E.",9
16,"16219",106,83,82,0,1,"U.C.E.",0
36,"36024",17164,12723,12500,163,223,"U.C.E.",6
35,"35001",4663,3639,3569,39,70,"U.C.E.",1
17,"17141",5689,3485,3428,50,57,"U.C.E.",2
18,"18177",463,285,281,4,4,"U.C.E.",0
37,"37089",74,54,54,2,0,"U.C.E.",0
10,"10211",461,341,334,3,7,"U.C.E.",0
40,"40079",236,174,171,0,3,"U.C.E.",0
42,"42049",141,83,81,1,2,"U.C.E.",1
19,"19074",81,69,69,0,0,"U.C.E.",0
4,"4029",10682,7542,7474,63,68,"U.C.E.",4
5,"5030",43,39,39,0,0,"U.C.E.",0
7,"7033",25954,14975,14738,328,237,"U.C.E.",13
3,"3003",460,382,370,1,12,"U.C.E.",0
41,"41041",9646,7901,7791,58,110,"U.C.E.",1
33,"33059",5049,3480,3447,37,33,"U.C.E.",1
12,"12040",116573,84142,83078,1257,1064,"U.C.E.",49
8,"8265",1575,1065,1026,38,39,"U.C.E.",0
36,"36037",2727,1923,1896,18,27,"U.C.E.",1
50,"50264",184,140,134,0,6,"U.C.E.",0
50,"50119",997,740,720,13,20,"U.C.E.",0
26,"26077",15,15,15,1,0,"U.C.E.",0
38,"38043",18628,12966,12763,134,203,"U.C.E.",12
3,"3070",1962,1582,1552,8,30,"U.C.E.",2
23,"23086",11411,8918,8798,129,120,"U.C.E.",50
18,"18089",15803,10794,10712,95,82,"U.C.E.",1
24,"24050",113,91,90,0,1,"U.C.E.",0
31,"31044",276,224,223,0,1,"U.C.E.",0
34,"34199",1354,1004,978,27,26,"U.C.E.",1
5,"5131",118,86,86,3,0,"U.C.E.",0
40,"40192",179,151,150,1,1,"U.C.E.",0
24,"24181",1652,1303,1288,12,15,"U.C.E.",1
31,"31247",171,121,121,1,0,"U.C.E.",0
40,"40222",190,157,156,1,1,"U.C.E.",0
37,"37283",130,104,104,1,0,"U.C.E.",0
8,"8052",148,103,98,1,5,"U.C.E.",0
50,"50090",165,117,117,1,0,"U.C.E.",0
34,"34093",101,74,74,1,0,"U.C.E.",0
14,"14053",6040,4455,4376,78,79,"U.C.E.",1
10,"10215",437,338,333,3,5,"U.C.E.",0
34,"34180",84,68,68,0,0,"U.C.E.",0
45,"45097",1094,934,925,9,9,"U.C.E.",0
16,"16228",202,146,144,2,2,"U.C.E.",0
36,"36050",7602,5424,5339,50,85,"U.C.E.",3
37,"37024",101,80,80,0,0,"U.C.E.",0
39,"39020",23947,15404,15122,267,282,"U.C.E.",13
10,"10053",303,253,246,5,7,"U.C.E.",2
5,"5035",105,87,87,2,0,"U.C.E.",0
4,"4069",4729,3740,3706,52,34,"U.C.E.",0
40,"40224",34,25,25,0,0,"U.C.E.",0
5,"5132",1040,770,753,2,17,"U.C.E.",0
16,"16081",64,46,45,1,1,"U.C.E.",0
34,"34055",288,215,212,4,3,"U.C.E.",0
31,"31157",3567,2435,2393,32,42,"U.C.E.",1
12,"12043",620,499,487,2,12,"U.C.E.",0
7,"7037",3269,1737,1700,37,37,"U.C.E.",3
20,"20059",8816,6335,6293,32,42,"U.C.E.",3
50,"50034",923,634,617,10,17,"U.C.E.",1
39,"39073",9275,6984,6903,83,81,"U.C.E.",1
12,"12010",280,232,229,3,3,"U.C.E.",0
16,"16082",318,226,226,1,0,"U.C.E.",1
7,"7038",1962,1504,1480,20,24,"U.C.E.",0
5,"5264",68,48,48,1,0,"U.C.E.",2
12,"12110",253,199,195,3,4,"U.C.E.",0
26,"26041",152,106,104,0,2,"U.C.E.",0
17,"17224",355,246,241,10,5,"U.C.E.",0
47,"47171",453,371,368,10,3,"U.C.E.",2
37,"37097",47,39,39,1,0,"U.C.E.",0
26,"26042",852,660,651,11,9,"U.C.E.",0
34,"34098",756,544,540,10,4,"U.C.E.",0
11,"11035",13266,8794,8668,115,126,"U.C.E.",6
31,"31139",172,97,97,1,0,"U.C.E.",0
19,"19004",67,56,56,0,0,"U.C.E.",0
50,"50123",428,335,332,9,3,"U.C.E.",1
50,"50296",417,313,310,6,3,"U.C.E.",0
5,"5232",106,84,80,1,4,"U.C.E.",0
42,"42014",83,55,55,1,0,"U.C.E.",0
40,"40183",148,127,127,0,0,"U.C.E.",0
40,"40041",1035,819,799,14,20,"U.C.E.",0
10,"10098",412,317,313,5,4,"U.C.E.",1
19,"19043",92,82,82,1,0,"U.C.E.",0
14,"14026",2043,1434,1421,10,13,"U.C.E.",0
31,"31170",46,40,39,3,1,"U.C.E.",0
46,"46061",331,276,273,3,3,"U.C.E.",0
24,"24150",262,182,182,3,0,"U.C.E.",0
4,"4071",452,364,363,1,1,"U.C.E.",0
47,"47046",124,105,103,0,2,"U.C.E.",0
33,"33041",7488,5356,5309,65,47,"U.C.E.",0
8,"8271",74,45,44,3,1,"U.C.E.",0
24,"24029",840,590,579,11,11,"U.C.E.",0
34,"34059",462,377,375,5,2,"U.C.E.",0
16,"16126",811,701,692,13,9,"U.C.E.",0
18,"18183",685,502,500,3,2,"U.C.E.",0
14,"14058",8116,6274,6215,76,59,"U.C.E.",0
7,"7041",2077,1583,1549,27,34,"U.C.E.",2
37,"37176",136,103,100,1,3,"U.C.E.",0
42,"42163",53,41,41,0,0,"U.C.E.",0
45,"45029",233,207,202,4,5,"U.C.E.",1
45,"45091",419,311,309,5,2,"U.C.E.",0
31,"31151",77,49,49,2,0,"U.C.E.",0
37,"37101",185,143,141,1,2,"U.C.E.",0
37,"37329",40,36,36,2,0,"U.C.E.",0
33,"33065",1150,791,784,16,7,"U.C.E.",0
5,"5201",557,444,437,2,7,"U.C.E.",0
20,"20075",4447,2823,2798,32,25,"U.C.E.",2
37,"37253",137,115,115,1,0,"U.C.E.",0
12,"12013",180,131,130,0,1,"U.C.E.",0
1,"1021",473,332,324,3,8,"U.C.E.",1
17,"17207",2357,1636,1584,40,52,"U.C.E.",0
16,"16188",106,76,76,0,0,"U.C.E.",0
44,"44049",886,652,627,6,25,"U.C.E.",0
42,"42060",33,22,22,0,0,"U.C.E.",0
22,"22126",100,81,80,2,1,"U.C.E.",0
34,"34237",645,506,498,6,8,"U.C.E.",1
4,"4074",2731,1959,1936,26,23,"U.C.E.",2
45,"45031",2773,2011,1975,25,36,"U.C.E.",2
31,"31255",100,78,78,1,0,"U.C.E.",0
20,"20004",254,153,153,5,0,"U.C.E.",0
46,"46006",4643,3847,3785,32,62,"U.C.E.",2
37,"37019",157,114,113,0,1,"U.C.E.",0
10,"10197",143,96,94,1,2,"U.C.E.",0
23,"23053",9431,7160,7128,42,32,"U.C.E.",2
18,"18185",608,484,479,2,5,"U.C.E.",0
16,"16102",1320,1016,1007,15,9,"U.C.E.",0
4,"4041",334,247,245,0,2,"U.C.E.",0
45,"45032",471,340,333,2,7,"U.C.E.",0
22,"22232",98,78,75,0,3,"U.C.E.",0
8,"8274",4887,3326,3279,36,47,"U.C.E.",4
34,"34214",176,144,143,3,1,"U.C.E.",1
50,"50272",12481,8744,8642,176,102,"U.C.E.",7
37,"37059",132,110,110,2,0,"U.C.E.",0
34,"34063",102,92,91,2,1,"U.C.E.",0
26,"26179",49,39,36,0,3,"U.C.E.",0
11,"11030",22528,14741,14557,195,184,"U.C.E.",6
22,"22079",126,97,97,4,0,"U.C.E.",0
16,"16225",89,69,68,1,1,"U.C.E.",0
45,"45107",3006,2344,2299,32,45,"U.C.E.",1
16,"16131",154,116,115,0,1,"U.C.E.",0
26,"26050",114,84,81,1,3,"U.C.E.",0
46,"46105",16708,12164,12040,100,124,"U.C.E.",8
36,"36014",2145,1568,1548,9,20,"U.C.E.",0
37,"37060",229,179,173,2,6,"U.C.E.",0
37,"37293",131,108,106,5,2,"U.C.E.",0
19,"19123",40,34,34,0,0,"U.C.E.",0
42,"42168",128,82,81,4,1,"U.C.E.",0
19,"19184",88,63,62,1,1,"U.C.E.",0
10,"10106",144,123,123,4,0,"U.C.E.",0
5,"5154",46,35,35,0,0,"U.C.E.",0
4,"4055",418,368,367,5,1,"U.C.E.",0
5,"5175",190,149,149,2,0,"U.C.E.",0
16,"16191",1001,867,864,13,3,"U.C.E.",1
41,"41025",1999,1502,1476,13,26,"U.C.E.",0
19,"19332",106,76,72,4,4,"U.C.E.",0
12,"12053",2121,1745,1719,11,26,"U.C.E.",1
37,"37062",92,73,73,1,0,"U.C.E.",0
40,"40052",95,69,69,0,0,"U.C.E.",0
46,"46057",483,357,349,9,8,"U.C.E.",0
26,"26011",7455,5452,5353,93,99,"U.C.E.",5
3,"3049",12150,10039,9892,88,147,"U.C.E.",9
37,"37022",287,237,232,0,5,"U.C.E.",0
33,"33045",4692,3347,3297,42,50,"U.C.E.",3
31,"31228",540,376,364,13,12,"U.C.E.",3
24,"24051",484,375,368,2,7,"U.C.E.",0
14,"14012",6305,4749,4690,44,59,"U.C.E.",0
50,"50052",100,82,82,0,0,"U.C.E.",0
42,"42172",31,28,28,3,0,"U.C.E.",0
1,"1014",385,281,274,6,7,"U.C.E.",0
12,"12119",153,87,87,0,0,"U.C.E.",0
5,"5239",215,171,170,2,1,"U.C.E.",0
31,"31197",69,58,57,1,1,"U.C.E.",0
5,"5209",104,78,78,0,0,"U.C.E.",0
47,"47097",345,291,289,7,2,"U.C.E.",0
19,"19051",94,83,83,1,0,"U.C.E.",0
16,"16231",47,43,43,0,0,"U.C.E.",0
37,"37372",145,109,109,0,0,"U.C.E.",0
5,"5208",55,45,45,0,0,"U.C.E.",0
19,"19323",50,41,39,0,2,"U.C.E.",0
19,"19126",1552,1140,1119,16,21,"U.C.E.",1
42,"42174",188,142,138,5,4,"U.C.E.",0
16,"16095",98,68,68,0,0,"U.C.E.",0
37,"37337",140,122,121,0,1,"U.C.E.",0
37,"37110",112,89,88,1,1,"U.C.E.",0
46,"46083",15427,12079,11941,109,138,"U.C.E.",5
3,"3052",984,837,820,10,17,"U.C.E.",1
50,"50248",552,421,407,5,14,"U.C.E.",1
17,"17145",1593,1090,1068,10,22,"U.C.E.",0
17,"17234",183,131,128,2,3,"U.C.E.",0
40,"40055",41,32,31,0,1,"U.C.E.",0
8,"8188",106,87,86,4,1,"U.C.E.",0
24,"24040",494,369,366,6,3,"U.C.E.",0
8,"8054",8733,6215,6077,123,138,"U.C.E.",7
31,"31138",939,648,646,14,2,"U.C.E.",4
36,"36053",5677,4204,4157,51,47,"U.C.E.",9
17,"17175",569,375,369,6,6,"U.C.E.",1
31,"31261",271,202,201,4,1,"U.C.E.",0
8,"8096",40650,28247,27784,527,463,"U.C.E.",28
40,"40198",30,21,20,0,1,"U.C.E.",0
12,"12022",367,282,279,4,3,"U.C.E.",0
4,"4049",4981,3652,3630,34,22,"U.C.E.",1
16,"16097",196,167,166,2,1,"U.C.E.",0
38,"38027",5392,3530,3459,41,71,"U.C.E.",0
45,"45015",624,485,480,2,5,"U.C.E.",0
11,"11026",4834,3736,3691,27,45,"U.C.E.",2
44,"44021",114,81,77,1,4,"U.C.E.",1
1,"1902",776,532,526,6,6,"U.C.E.",2
50,"50056",450,329,328,4,1,"U.C.E.",0
37,"37363",121,100,99,0,1,"U.C.E.",0
37,"37068",386,291,287,6,4,"U.C.E.",1
8,"8067",5657,3772,3671,75,101,"U.C.E.",6
46,"46085",11344,8526,8426,87,100,"U.C.E.",4
50,"50075",89,74,74,1,0,"U.C.E.",0
22,"22139",86,66,63,2,3,"U.C.E.",0
11,"11009",636,430,424,2,6,"U.C.E.",1
26,"26017",380,277,276,3,1,"U.C.E.",0
37,"37376",2373,1720,1700,23,20,"U.C.E.",1
16,"16098",586,480,474,10,6,"U.C.E.",0
7,"7019",230,165,164,1,1,"U.C.E.",0
22,"22903",672,555,547,6,8,"U.C.E.",0
31,"31009",717,510,497,14,13,"U.C.E.",1
37,"37100",89,77,76,4,1,"U.C.E.",0
24,"24152",481,326,322,5,4,"U.C.E.",0
18,"18902",950,769,762,6,7,"U.C.E.",0
10,"10072",892,663,655,3,8,"U.C.E.",0
38,"38029",1456,732,715,4,17,"U.C.E.",0
16,"16254",213,166,165,2,1,"U.C.E.",0
22,"22076",331,241,235,3,6,"U.C.E.",0
8,"8078",224,154,151,2,3,"U.C.E.",0
4,"4026",75,58,58,0,0,"U.C.E.",0
24,"24206",1831,1362,1341,13,21,"U.C.E.",0
17,"17216",158,100,97,1,3,"U.C.E.",0
16,"16143",20,14,13,1,1,"U.C.E.",0
33,"33005",1600,1084,1080,6,4,"U.C.E.",0
31,"31234",148,107,105,6,2,"U.C.E.",0
46,"46087",137,105,105,1,0,"U.C.E.",0
45,"45191",601,506,498,1,8,"U.C.E.",0
18,"18001",288,212,212,1,0,"U.C.E.",0
24,"24207",320,274,272,5,2,"U.C.E.",0
5,"5192",96,78,77,1,1,"U.C.E.",0
14,"14019",6486,5288,5243,65,45,"U.C.E.",1
46,"46168",1828,1461,1449,7,12,"U.C.E.",0
45,"45129",145,121,120,0,1,"U.C.E.",0
40,"40061",66,53,52,1,1,"U.C.E.",0
37,"37230",221,173,171,0,2,"U.C.E.",0
10,"10061",1765,1305,1290,13,15,"U.C.E.",2
50,"50108",50,31,31,0,0,"U.C.E.",0
8,"8224",771,538,528,26,10,"U.C.E.",0
3,"3127",399,336,322,3,14,"U.C.E.",0
34,"34213",67,50,50,0,0,"U.C.E.",1
50,"50290",436,334,331,4,3,"U.C.E.",0
16,"16018",417,350,342,3,8,"U.C.E.",1
19,"19022",673,501,496,4,5,"U.C.E.",0
16,"16146",96,74,70,0,4,"U.C.E.",0
46,"46185",422,360,359,7,1,"U.C.E.",0
14,"14071",1025,739,733,8,6,"U.C.E.",0
4,"4054",384,328,325,0,3,"U.C.E.",0
18,"18167",1927,1397,1380,13,17,"U.C.E.",0
42,"42096",316,218,215,9,3,"U.C.E.",2
31,"31205",465,335,325,9,10,"U.C.E.",0
39,"39035",10031,7685,7601,74,84,"U.C.E.",3
10,"10078",451,349,341,3,8,"U.C.E.",0
20,"20079",17229,12010,11927,143,83,"U.C.E.",10
8,"8041",10032,6880,6761,112,119,"U.C.E.",16
41,"41007",12177,8150,8016,126,134,"U.C.E.",6
33,"33052",758,526,518,2,8,"U.C.E.",0
50,"50031",167,105,103,0,2,"U.C.E.",0
47,"47205",414,307,298,5,9,"U.C.E.",0
22,"22908",231,167,162,2,5,"U.C.E.",0
42,"42065",28,24,24,0,0,"U.C.E.",0
5,"5174",81,71,71,1,0,"U.C.E.",0
37,"37077",293,262,258,3,4,"U.C.E.",0
3,"3082",11741,8208,8102,80,106,"U.C.E.",7
40,"40068",39,32,32,0,0,"U.C.E.",0
3,"3060",124,100,98,0,2,"U.C.E.",1
46,"46017",32928,24879,24672,267,207,"U.C.E.",14
47,"47078",178,159,154,7,5,"U.C.E.",0
37,"37194",271,206,204,0,2,"U.C.E.",0
46,"46211",1716,1459,1447,9,12,"U.C.E.",0
17,"17163",2478,1729,1681,41,48,"U.C.E.",0
50,"50110",424,315,314,6,1,"U.C.E.",1
44,"44029",637,495,490,6,5,"U.C.E.",0
38,"38001",17632,9601,9475,121,126,"U.C.E.",15
47,"47052",6207,4812,4761,79,51,"U.C.E.",2
38,"38012",2535,1735,1716,11,19,"U.C.E.",1
33,"33068",1224,704,703,5,1,"U.C.E.",0
17,"17112",215,141,138,4,3,"U.C.E.",0
20,"20070",1109,817,815,4,2,"U.C.E.",0
19,"19115",41,26,26,1,0,"U.C.E.",0
44,"44156",57,40,38,1,2,"U.C.E.",1
40,"40070",137,91,91,0,0,"U.C.E.",0
45,"45012",683,572,566,10,6,"U.C.E.",0
22,"22155",89,67,67,2,0,"U.C.E.",0
38,"38002",991,716,708,1,8,"U.C.E.",0
40,"40210",110,71,67,1,4,"U.C.E.",0
19,"19272",86,67,65,1,2,"U.C.E.",0
37,"37080",242,187,185,1,2,"U.C.E.",0
1,"1032",536,412,400,0,12,"U.C.E.",0
5,"5196",69,54,54,2,0,"U.C.E.",0
46,"46140",379,314,313,0,1,"U.C.E.",0
26,"26068",83,65,64,0,1,"U.C.E.",0
40,"40120",173,145,144,1,1,"U.C.E.",0
42,"42087",48,38,37,1,1,"U.C.E.",0
17,"17165",608,414,400,9,14,"U.C.E.",0
14,"14075",624,508,500,8,8,"U.C.E.",0
22,"22254",1175,868,856,14,12,"U.C.E.",1
22,"22157",251,176,175,9,1,"U.C.E.",0
36,"36030",4387,3206,3177,35,29,"U.C.E.",1
40,"40072",170,134,132,1,2,"U.C.E.",0
45,"45051",1658,1305,1293,20,12,"U.C.E.",0
24,"24215",169,121,120,1,1,"U.C.E.",0
45,"45100",205,169,169,0,0,"U.C.E.",0
19,"19053",2172,1602,1587,14,15,"U.C.E.",1
47,"47010",11275,8800,8701,163,99,"U.C.E.",2
3,"3098",526,410,400,6,10,"U.C.E.",0
1,"1034",177,140,137,1,3,"U.C.E.",0
10,"10206",237,177,174,0,3,"U.C.E.",0
11,"11016",14611,9848,9774,114,74,"U.C.E.",3
8,"8260",17869,11898,11686,215,212,"U.C.E.",17
40,"40026",114,98,97,2,1,"U.C.E.",0
40,"40073",425,371,367,3,4,"U.C.E.",2
47,"47002",30,27,27,1,0,"U.C.E.",0
17,"17065",316,211,205,6,6,"U.C.E.",0
4,"4023",144,116,116,2,0,"U.C.E.",0
20,"20024",400,238,235,0,3,"U.C.E.",0
46,"46231",2496,1831,1817,16,14,"U.C.E.",2
31,"31221",1182,774,767,12,7,"U.C.E.",1
4,"4901",576,427,426,5,1,"U.C.E.",0
3,"3009",47547,35945,35298,603,647,"U.C.E.",71
17,"17176",141,96,95,3,1,"U.C.E.",0
20,"20066",467,316,316,0,0,"U.C.E.",0
5,"5256",119,101,100,0,1,"U.C.E.",0
31,"31190",48,34,34,1,0,"U.C.E.",0
24,"24056",3200,2368,2332,53,36,"U.C.E.",0
16,"16111",171,130,128,0,2,"U.C.E.",2
42,"42148",14,14,14,0,0,"U.C.E.",0
22,"22162",135,107,107,3,0,"U.C.E.",0
47,"47111",1005,804,794,5,10,"U.C.E.",0
15,"15003",1936,1400,1382,19,18,"U.C.E.",1
11,"11018",1528,1194,1178,9,16,"U.C.E.",0
40,"40231",128,102,100,3,2,"U.C.E.",0
40,"40215",109,94,91,0,3,"U.C.E.",0
18,"18011",4246,3195,3172,23,23,"U.C.E.",0
34,"34086",105,89,89,1,0,"U.C.E.",0
44,"44036",27,17,17,0,0,"U.C.E.",0
19,"19214",94,78,78,2,0,"U.C.E.",0
19,"19110",73,59,57,4,2,"U.C.E.",0
40,"40045",123,102,102,0,0,"U.C.E.",1
40,"40155",3083,2333,2280,73,53,"U.C.E.",2
37,"37289",265,211,209,0,2,"U.C.E.",0
17,"17226",852,539,535,0,4,"U.C.E.",0
38,"38040",4697,3007,2962,31,45,"U.C.E.",1
22,"22142",114,91,91,2,0,"U.C.E.",1
8,"8263",20729,13742,13563,232,179,"U.C.E.",14
23,"23040",1538,1319,1311,3,8,"U.C.E.",0
42,"42046",55,35,35,0,0,"U.C.E.",0
7,"7065",2061,1376,1345,29,31,"U.C.E.",1
10,"10210",599,453,452,3,1,"U.C.E.",0
46,"46022",15090,10922,10840,99,82,"U.C.E.",9
5,"5161",638,525,522,0,3,"U.C.E.",0
40,"40157",74,51,50,2,1,"U.C.E.",0
50,"50128",36,30,29,0,1,"U.C.E.",0
31,"31163",2008,1458,1434,22,24,"U.C.E.",4
5,"5139",74,62,59,2,3,"U.C.E.",0
40,"40031",515,410,404,7,6,"U.C.E.",0
16,"16274",147,125,125,1,0,"U.C.E.",0
34,"34036",211,159,157,0,2,"U.C.E.",0
37,"37179",230,194,191,3,3,"U.C.E.",0
18,"18022",12448,8777,8659,111,118,"U.C.E.",4
5,"5129",153,98,95,0,3,"U.C.E.",0
3,"3006",479,380,369,2,11,"U.C.E.",0
46,"46263",333,243,241,2,2,"U.C.E.",0
40,"40174",402,292,290,5,2,"U.C.E.",0
5,"5260",114,101,101,1,0,"U.C.E.",0
50,"50206",499,386,384,10,2,"U.C.E.",0
19,"19112",68,50,50,0,0,"U.C.E.",0
47,"47032",161,130,129,3,1,"U.C.E.",0
20,"20055",17856,11885,11791,91,94,"U.C.E.",8
16,"16117",1130,871,857,8,14,"U.C.E.",0
31,"31256",113,64,64,0,0,"U.C.E.",0
8,"8050",149,112,108,4,4,"U.C.E.",0
19,"19075",81,53,50,4,3,"U.C.E.",0
47,"47114",4107,2877,2834,37,43,"U.C.E.",0
37,"37090",59,54,50,0,4,"U.C.E.",0
46,"46121",116,103,101,0,2,"U.C.E.",0
10,"10010",2358,1597,1576,18,21,"U.C.E.",1
31,"31074",430,304,303,10,1,"U.C.E.",1
30,"30004",1164,958,952,1,6,"U.C.E.",0
45,"45168",61519,47265,46528,736,737,"U.C.E.",22
45,"45108",564,461,456,2,5,"U.C.E.",0
44,"44067",132,89,89,0,0,"U.C.E.",0
37,"37307",177,132,130,0,2,"U.C.E.",0
11,"11004",87610,53062,52639,828,423,"U.C.E.",16
16,"16192",54,37,37,1,0,"U.C.E.",0
3,"3117",381,321,317,4,4,"U.C.E.",0
24,"24144",781,551,541,13,10,"U.C.E.",0
42,"42051",23,12,11,0,1,"U.C.E.",0
40,"40081",151,109,107,2,2,"U.C.E.",0
8,"8267",6215,4100,4011,82,89,"U.C.E.",6
24,"24063",453,323,322,2,1,"U.C.E.",0
19,"19090",107,87,86,0,1,"U.C.E.",0
50,"50062",1750,1298,1275,22,23,"U.C.E.",2
4,"4031",2495,1942,1931,13,11,"U.C.E.",1
26,"26038",93,71,69,1,2,"U.C.E.",1
42,"42010",19,15,15,1,0,"U.C.E.",0
16,"16009",79,63,62,0,1,"U.C.E.",0
37,"37121",557,458,451,8,7,"U.C.E.",0
40,"40020",200,155,149,2,6,"U.C.E.",0
30,"30005",29081,22312,22142,184,170,"U.C.E.",25
18,"18189",723,547,541,6,6,"U.C.E.",0
31,"31231",127,93,91,1,2,"U.C.E.",0
23,"23046",2441,2049,2027,13,22,"U.C.E.",0
23,"23002",17740,14007,13858,171,149,"U.C.E.",18
37,"37284",334,256,254,1,2,"U.C.E.",0
47,"47224",92,77,77,0,0,"U.C.E.",0
33,"33061",446,260,259,1,1,"U.C.E.",0
22,"22024",222,144,139,3,5,"U.C.E.",0
42,"42054",20,14,14,0,0,"U.C.E.",1
50,"50122",68,47,45,2,2,"U.C.E.",0
40,"40089",248,183,177,3,6,"U.C.E.",1
17,"17073",1753,1320,1298,18,22,"U.C.E.",1
39,"39099",2987,2416,2391,28,25,"U.C.E.",0
33,"33016",19516,14345,14210,198,135,"U.C.E.",3
31,"31067",1982,1400,1363,28,37,"U.C.E.",1
20,"20035",497,346,344,1,2,"U.C.E.",0
50,"50006",978,758,749,16,9,"U.C.E.",0
31,"31188",185,139,137,2,2,"U.C.E.",0
19,"19042",41,32,32,0,0,"U.C.E.",0
44,"44045",373,303,301,4,2,"U.C.E.",0
42,"42207",49,37,34,0,3,"U.C.E.",0
45,"45026",269,200,198,2,2,"U.C.E.",0
42,"42159",40,31,31,1,0,"U.C.E.",0
12,"12090",127,109,107,2,2,"U.C.E.",0
44,"44256",37,35,35,9,0,"U.C.E.",0
37,"37116",75,55,55,1,0,"U.C.E.",0
37,"37374",1204,1018,1004,9,14,"U.C.E.",1
36,"36019",1681,1204,1188,14,16,"U.C.E.",0
39,"39013",561,413,412,2,1,"U.C.E.",1
5,"5168",3682,2846,2801,43,45,"U.C.E.",2
12,"12045",388,301,286,2,15,"U.C.E.",0
31,"31159",1158,864,846,17,18,"U.C.E.",0
47,"47037",194,160,159,1,1,"U.C.E.",0
16,"16270",192,156,155,0,1,"U.C.E.",0
34,"34017",960,772,760,15,12,"U.C.E.",0
24,"24187",881,664,659,14,5,"U.C.E.",0
11,"11008",16655,11309,11189,184,120,"U.C.E.",4
20,"20904",98,67,66,0,1,"U.C.E.",0
36,"36054",10862,8201,8087,87,114,"U.C.E.",4
47,"47128",57,52,48,1,4,"U.C.E.",0
4,"4082",309,216,214,3,2,"U.C.E.",0
46,"46225",360,319,310,5,9,"U.C.E.",0
45,"45081",16099,12232,12079,154,153,"U.C.E.",12
16,"16125",1734,1367,1350,12,17,"U.C.E.",0
17,"17205",198,146,138,3,8,"U.C.E.",0
18,"18020",1473,1111,1106,7,5,"U.C.E.",0
24,"24189",5410,3630,3572,83,58,"U.C.E.",3
34,"34018",229,184,182,3,2,"U.C.E.",0
31,"31252",91,60,58,0,2,"U.C.E.",0
42,"42110",82,58,58,2,0,"U.C.E.",0
44,"44264",249,196,193,1,3,"U.C.E.",0
46,"46199",5661,4328,4280,38,48,"U.C.E.",2
31,"31212",173,117,117,3,0,"U.C.E.",0
20,"20027",2809,1929,1918,25,11,"U.C.E.",0
31,"31130",319,213,209,1,4,"U.C.E.",0
4,"4002",1146,891,884,1,7,"U.C.E.",1
31,"31253",123,102,97,0,5,"U.C.E.",0
40,"40092",132,100,100,0,0,"U.C.E.",0
17,"17197",144,103,102,3,1,"U.C.E.",0
37,"37189",139,90,90,1,0,"U.C.E.",0
15,"15012",3767,2973,2926,51,47,"U.C.E.",3
4,"4037",1393,1090,1079,8,11,"U.C.E.",0
15,"15069",7019,5036,4938,85,98,"U.C.E.",3
16,"16218",207,170,169,4,1,"U.C.E.",0
10,"10196",309,244,244,1,0,"U.C.E.",0
18,"18188",1659,1329,1308,9,21,"U.C.E.",0
17,"17168",393,285,281,8,4,"U.C.E.",0
12,"12049",471,366,344,10,22,"U.C.E.",0
30,"30036",13978,10244,10141,94,103,"U.C.E.",4
40,"40046",99,81,78,2,3,"U.C.E.",0
46,"46249",9650,7288,7191,125,97,"U.C.E.",2
17,"17198",404,264,259,9,5,"U.C.E.",0
16,"16031",62,34,32,4,2,"U.C.E.",0
3,"3125",340,276,275,2,1,"U.C.E.",0
42,"42113",553,412,404,7,8,"U.C.E.",0
12,"12004",4354,3145,3083,50,62,"U.C.E.",1
46,"46176",1965,1423,1405,12,18,"U.C.E.",0
37,"37087",779,590,586,18,4,"U.C.E.",0
12,"12083",106,89,88,0,1,"U.C.E.",0
8,"8193",928,565,554,15,11,"U.C.E.",0
4,"4016",2184,1699,1677,15,22,"U.C.E.",0
22,"22236",266,213,213,3,0,"U.C.E.",0
24,"24154",1068,803,795,6,8,"U.C.E.",1
45,"45082",1333,1143,1123,14,20,"U.C.E.",0
22,"22036",101,82,82,1,0,"U.C.E.",0
50,"50129",258,164,164,0,0,"U.C.E.",0
38,"38901",1389,917,907,16,10,"U.C.E.",0
23,"23055",48167,33913,33612,400,301,"U.C.E.",21
16,"16089",386,310,308,10,2,"U.C.E.",1
20,"20046",1157,734,729,6,5,"U.C.E.",0
18,"18904",858,620,612,3,8,"U.C.E.",0
8,"8010",4124,2674,2611,44,63,"U.C.E.",0
24,"24156",264,187,186,6,1,"U.C.E.",1
23,"23056",3182,2539,2523,20,16,"U.C.E.",0
50,"50069",68,32,32,0,0,"U.C.E.",0
45,"45143",1302,916,901,6,15,"U.C.E.",0
5,"5076",477,397,385,4,12,"U.C.E.",0
22,"22249",110,83,81,0,2,"U.C.E.",0
7,"7056",4701,3164,3090,55,74,"U.C.E.",2
37,"37299",237,167,165,2,2,"U.C.E.",0
45,"45001",1901,1468,1431,14,37,"U.C.E.",0
20,"20067",31173,20218,20017,270,201,"U.C.E.",43
44,"44014",2603,1965,1912,25,53,"U.C.E.",4
31,"31237",198,137,136,7,1,"U.C.E.",0
23,"23033",1382,1166,1152,7,14,"U.C.E.",0
23,"23029",924,730,727,2,3,"U.C.E.",0
36,"36049",6608,5189,5097,56,92,"U.C.E.",5
31,"31196",40,35,35,1,0,"U.C.E.",0
45,"45034",1375,1108,1079,18,29,"U.C.E.",0
15,"15016",5135,3816,3771,22,45,"U.C.E.",1
4,"4078",1069,837,832,6,5,"U.C.E.",0
22,"22251",391,288,278,4,10,"U.C.E.",0
12,"12018",326,274,265,1,9,"U.C.E.",0
47,"47087",376,320,315,7,5,"U.C.E.",0
19,"19271",53,45,45,1,0,"U.C.E.",0
24,"24077",237,205,199,2,6,"U.C.E.",0
16,"16110",98,81,81,3,0,"U.C.E.",0
34,"34107",91,67,67,4,0,"U.C.E.",0
24,"24198",644,423,417,7,6,"U.C.E.",1
33,"33076",12662,8733,8670,120,63,"U.C.E.",2
20,"20061",4011,2666,2653,23,13,"U.C.E.",2
3,"3092",6780,5364,5269,96,95,"U.C.E.",9
46,"46228",2434,1881,1859,30,22,"U.C.E.",0
47,"47105",210,181,179,1,2,"U.C.E.",1
16,"16149",179,140,138,2,2,"U.C.E.",0
3,"3084",593,518,513,2,5,"U.C.E.",1
36,"36028",4207,3294,3254,21,40,"U.C.E.",1
5,"5144",92,66,66,4,0,"U.C.E.",0
11,"11024",6811,5241,5202,58,39,"U.C.E.",0
37,"37151",150,125,121,1,4,"U.C.E.",0
17,"17025",1127,775,760,11,15,"U.C.E.",0
42,"42092",89,60,60,0,0,"U.C.E.",0
16,"16135",192,127,125,0,2,"U.C.E.",0
3,"3018",11899,8855,8720,119,135,"U.C.E.",7
22,"22190",120,76,73,4,3,"U.C.E.",0
37,"37037",130,100,99,0,1,"U.C.E.",0
4,"4010",602,492,491,10,1,"U.C.E.",0
22,"22136",908,671,662,11,9,"U.C.E.",0
46,"46156",2065,1746,1721,14,25,"U.C.E.",3
8,"8058",1699,1089,1061,25,28,"U.C.E.",1
46,"46175",469,406,401,5,5,"U.C.E.",0
38,"38003",1446,1053,1044,4,9,"U.C.E.",1
5,"5145",57,41,41,0,0,"U.C.E.",0
44,"44033",307,222,221,5,1,"U.C.E.",1
10,"10146",1439,991,975,11,16,"U.C.E.",2
34,"34079",1391,1088,1077,17,11,"U.C.E.",0
50,"50076",113,89,89,0,0,"U.C.E.",0
19,"19032",202,11,11,0,0,"U.C.E.",0
8,"8065",1224,796,778,13,18,"U.C.E.",3
17,"17084",269,177,175,4,2,"U.C.E.",2
8,"8229",561,404,398,12,6,"U.C.E.",0
45,"45076",603,420,419,3,1,"U.C.E.",0
19,"19264",45,39,39,0,0,"U.C.E.",0
8,"8220",2277,1641,1604,44,37,"U.C.E.",0
45,"45039",236,197,190,2,7,"U.C.E.",0
36,"36020",2581,1947,1922,27,25,"U.C.E.",1
34,"34005",899,707,698,8,9,"U.C.E.",0
7,"7039",4920,3488,3377,54,111,"U.C.E.",0
5,"5158",410,333,331,2,2,"U.C.E.",0
33,"33048",169,120,120,1,0,"U.C.E.",0
50,"50271",283,209,207,4,2,"U.C.E.",0
18,"18124",387,270,267,0,3,"U.C.E.",0
50,"50030",232,164,160,1,4,"U.C.E.",0
17,"17146",2952,1895,1864,49,31,"U.C.E.",1
12,"12046",236,177,176,4,1,"U.C.E.",0
16,"16140",34,27,27,0,0,"U.C.E.",0
36,"36021",11798,8742,8574,136,168,"U.C.E.",6
16,"16055",698,485,481,8,4,"U.C.E.",0
31,"31201",144714,104019,102644,2027,1375,"U.C.E.",100
11,"11012",103946,68124,67375,856,749,"U.C.E.",39
50,"50138",49,43,43,2,0,"U.C.E.",0
36,"36003",9876,7155,7007,100,148,"U.C.E.",5
14,"14057",6115,5040,4975,71,65,"U.C.E.",0
42,"42195",112,74,72,1,2,"U.C.E.",0
16,"16029",114,80,80,0,0,"U.C.E.",0
46,"46118",3883,3141,3105,28,36,"U.C.E.",2
34,"34236",176,134,134,1,0,"U.C.E.",0
44,"44023",13,11,11,0,0,"U.C.E.",0
31,"31202",4247,3014,2957,69,57,"U.C.E.",3
44,"44168",194,154,152,4,2,"U.C.E.",0
37,"37273",115,83,83,1,0,"U.C.E.",0
40,"40059",124,104,104,2,0,"U.C.E.",0
31,"31192",148,107,104,1,3,"U.C.E.",0
8,"8088",11250,8019,7861,144,158,"U.C.E.",10
47,"47162",80,62,62,1,0,"U.C.E.",0
47,"47027",2680,2059,2024,23,35,"U.C.E.",2
47,"47042",63,50,49,3,1,"U.C.E.",0
46,"46208",1141,990,978,6,12,"U.C.E.",0
5,"5062",213,188,184,3,4,"U.C.E.",0
41,"41005",8792,6642,6585,71,57,"U.C.E.",1
37,"37072",184,157,155,5,2,"U.C.E.",0
19,"19303",56,48,47,1,1,"U.C.E.",0
16,"16906",104,83,82,0,1,"U.C.E.",0
45,"45018",445,332,322,4,10,"U.C.E.",0
36,"36023",8522,6206,6062,64,144,"U.C.E.",5
50,"50011",131,113,113,8,0,"U.C.E.",0
12,"12034",1509,1125,1097,10,28,"U.C.E.",0
17,"17169",2460,1690,1651,34,39,"U.C.E.",2
44,"44025",6168,4326,4150,68,176,"U.C.E.",4
17,"17107",301,203,200,8,3,"U.C.E.",0
46,"46100",307,264,255,0,9,"U.C.E.",0
7,"7050",3099,2008,1979,45,29,"U.C.E.",1
19,"19229",83,71,68,0,3,"U.C.E.",0
40,"40204",187,139,134,4,5,"U.C.E.",0
45,"45130",354,287,283,2,4,"U.C.E.",1
12,"12095",1027,790,775,15,15,"U.C.E.",0
31,"31052",89,62,58,1,4,"U.C.E.",1
18,"18002",625,505,504,2,1,"U.C.E.",0
37,"37130",177,153,153,2,0,"U.C.E.",0
37,"37348",114,91,90,1,1,"U.C.E.",0
33,"33039",1719,1325,1319,14,6,"U.C.E.",0
44,"44203",8,8,8,0,0,"U.C.E.",0
42,"42007",143,110,110,2,0,"U.C.E.",0
24,"24180",1196,868,862,22,6,"U.C.E.",1
46,"46097",890,674,662,2,12,"U.C.E.",1
26,"26036",16873,12341,12167,190,174,"U.C.E.",7
20,"20007",300,203,202,2,1,"U.C.E.",0
19,"19204",168,129,126,2,3,"U.C.E.",0
44,"44002",62,47,47,1,0,"U.C.E.",0
37,"37311",251,210,209,8,1,"U.C.E.",0
34,"34073",184,153,152,7,1,"U.C.E.",0
15,"15056",5873,4205,4150,63,55,"U.C.E.",0
34,"34139",179,143,143,1,0,"U.C.E.",0
31,"31240",553,360,359,3,1,"U.C.E.",0
22,"22119",1433,994,981,14,13,"U.C.E.",0
42,"42218",86,59,59,0,0,"U.C.E.",0
24,"24157",2580,2046,2000,39,46,"U.C.E.",2
4,"4018",293,250,245,2,5,"U.C.E.",0
37,"37309",42,26,25,3,1,"U.C.E.",0
40,"40161",38,28,28,0,0,"U.C.E.",0
47,"47104",2917,2391,2357,31,34,"U.C.E.",1
12,"12031",3748,2751,2687,35,64,"U.C.E.",2
19,"19284",11,11,11,0,0,"U.C.E.",0
37,"37010",963,705,690,5,15,"U.C.E.",0
18,"18079",3497,2729,2706,15,23,"U.C.E.",0
44,"44250",20,11,11,1,0,"U.C.E.",0
8,"8008",193,119,114,5,5,"U.C.E.",0
47,"47063",107,87,87,2,0,"U.C.E.",0
14,"14066",5911,4515,4473,54,42,"U.C.E.",1
33,"33030",921,682,668,4,14,"U.C.E.",0
5,"5152",737,618,609,5,9,"U.C.E.",0
11,"11039",9943,6634,6582,104,52,"U.C.E.",0
22,"22078",468,302,301,8,1,"U.C.E.",0
24,"24171",417,231,231,2,0,"U.C.E.",0
47,"47009",117,88,88,1,0,"U.C.E.",0
19,"19002",99,77,76,0,1,"U.C.E.",0
40,"40119",182,149,145,2,4,"U.C.E.",0
50,"50266",139,95,94,1,1,"U.C.E.",0
4,"4020",361,265,263,1,2,"U.C.E.",0
5,"5267",102,78,77,1,1,"U.C.E.",0
16,"16027",779,619,612,5,7,"U.C.E.",0
18,"18013",4392,3268,3223,23,45,"U.C.E.",0
19,"19045",180,145,145,1,0,"U.C.E.",0
24,"24136",596,465,463,12,2,"U.C.E.",0
10,"10040",455,344,334,8,10,"U.C.E.",0
34,"34042",299,249,246,5,3,"U.C.E.",0
47,"47061",266,227,223,0,4,"U.C.E.",0
10,"10014",1907,1507,1488,14,19,"U.C.E.",4
42,"42141",124,90,87,1,3,"U.C.E.",0
4,"4061",668,541,536,7,5,"U.C.E.",0
50,"50088",337,273,264,4,9,"U.C.E.",0
50,"50182",3704,2551,2515,44,36,"U.C.E.",0
38,"38018",4397,3216,3163,27,53,"U.C.E.",2
42,"42212",75,45,45,2,0,"U.C.E.",5
19,"19287",153,114,113,2,1,"U.C.E.",0
19,"19286",743,566,554,8,12,"U.C.E.",1
34,"34056",2147,1557,1535,21,22,"U.C.E.",0
5,"5149",128,97,97,1,0,"U.C.E.",0
34,"34004",5790,4354,4262,84,92,"U.C.E.",7
31,"31264",173,110,108,1,2,"U.C.E.",0
3,"3064",4976,4098,4058,26,40,"U.C.E.",5
8,"8239",471,338,333,6,5,"U.C.E.",0
26,"26029",33,25,24,1,1,"U.C.E.",0
16,"16250",94,71,71,0,0,"U.C.E.",0
38,"38005",5327,3316,3270,38,46,"U.C.E.",0
3,"3099",41561,32556,32248,288,308,"U.C.E.",23
17,"17134",235,149,148,3,1,"U.C.E.",0
37,"37102",430,323,322,1,1,"U.C.E.",0
22,"22181",91,57,55,0,2,"U.C.E.",0
47,"47090",2511,1907,1880,23,27,"U.C.E.",2
23,"23058",8497,6642,6591,44,51,"U.C.E.",2
8,"8270",17464,11828,11677,212,151,"U.C.E.",11
23,"23009",12876,10335,10231,109,104,"U.C.E.",4
33,"33043",710,529,528,1,1,"U.C.E.",0
45,"45007",747,641,632,1,9,"U.C.E.",1
44,"44039",255,189,189,5,0,"U.C.E.",0
16,"16167",357,318,315,5,3,"U.C.E.",0
20,"20026",214,172,172,0,0,"U.C.E.",0
8,"8151",504,345,338,6,7,"U.C.E.",0
39,"39017",588,424,419,2,5,"U.C.E.",0
44,"44129",44,34,33,0,1,"U.C.E.",0
45,"45070",1415,1175,1162,11,13,"U.C.E.",0
16,"16046",262,191,191,1,0,"U.C.E.",0
37,"37056",56,47,47,0,0,"U.C.E.",0
5,"5136",110,75,75,3,0,"U.C.E.",0
22,"22124",229,171,170,2,1,"U.C.E.",0
19,"19033",79,55,55,0,0,"U.C.E.",0
24,"24176",336,267,261,3,6,"U.C.E.",0
40,"40080",68,53,52,0,1,"U.C.E.",0
10,"10177",1692,1351,1318,15,33,"U.C.E.",4
42,"42016",25,13,13,0,0,"U.C.E.",0
17,"17013",2774,1884,1859,21,25,"U.C.E.",1
40,"40211",72,65,65,1,0,"U.C.E.",0
40,"40071",52,45,45,4,0,"U.C.E.",0
18,"18006",4116,2862,2831,25,31,"U.C.E.",0
16,"16109",46,34,34,2,0,"U.C.E.",0
44,"44028",202,159,156,2,3,"U.C.E.",0
34,"34066",66,55,54,0,1,"U.C.E.",0
3,"3105",5322,4218,4124,34,94,"U.C.E.",7
22,"22214",131,101,100,2,1,"U.C.E.",0
50,"50147",845,637,627,12,10,"U.C.E.",0
17,"17129",126,91,90,3,1,"U.C.E.",0
47,"47031",203,149,149,0,0,"U.C.E.",0
12,"12026",946,728,702,16,26,"U.C.E.",0
24,"24178",83,67,67,2,0,"U.C.E.",0
8,"8025",1460,990,963,14,27,"U.C.E.",3
8,"8056",39345,26705,26396,449,309,"U.C.E.",39
40,"40152",750,615,595,4,20,"U.C.E.",0
37,"37044",461,363,360,1,3,"U.C.E.",0
45,"45003",607,515,511,3,4,"U.C.E.",0
3,"3114",1620,1320,1305,10,15,"U.C.E.",0
44,"44046",58,44,44,1,0,"U.C.E.",0
1,"1061",155,122,122,2,0,"U.C.E.",0
3,"3107",2288,1670,1647,15,23,"U.C.E.",2
16,"16175",5058,4363,4295,70,68,"U.C.E.",4
42,"42053",27,26,25,1,1,"U.C.E.",0
37,"37280",84,64,64,0,0,"U.C.E.",0
37,"37243",123,89,88,1,1,"U.C.E.",0
31,"31096",127,112,110,2,2,"U.C.E.",1
5,"5049",440,335,330,8,5,"U.C.E.",0
4,"4036",246,205,204,1,1,"U.C.E.",1
26,"26045",13,13,13,0,0,"U.C.E.",0
11,"11037",5640,4337,4285,32,52,"U.C.E.",3
33,"33021",4932,3544,3502,45,42,"U.C.E.",3
4,"4076",1325,1050,1041,7,9,"U.C.E.",0
46,"46178",4406,3235,3201,22,34,"U.C.E.",0
44,"44249",58,40,40,1,0,"U.C.E.",0
24,"24022",364,231,230,2,1,"U.C.E.",2
23,"23047",1658,1342,1339,6,3,"U.C.E.",1
39,"39076",3388,2673,2641,22,32,"U.C.E.",1
34,"34091",136,105,103,1,2,"U.C.E.",0
42,"42123",172,128,128,3,0,"U.C.E.",0
12,"12048",293,208,205,2,3,"U.C.E.",1
41,"41001",1642,1314,1302,10,12,"U.C.E.",0
10,"10190",569,438,435,6,3,"U.C.E.",0
44,"44131",26,20,20,0,0,"U.C.E.",0
5,"5197",114,98,98,1,0,"U.C.E.",0
47,"47124",435,364,358,5,6,"U.C.E.",1
16,"16016",258,178,178,1,0,"U.C.E.",0
26,"26078",85,69,69,0,0,"U.C.E.",0
16,"16264",505,440,438,6,2,"U.C.E.",0
5,"5164",34,24,24,0,0,"U.C.E.",0
31,"31105",1619,1306,1284,30,22,"U.C.E.",2
45,"45145",2430,1866,1821,13,45,"U.C.E.",1
30,"30022",16489,12207,12042,152,165,"U.C.E.",3
42,"42048",78,63,62,3,1,"U.C.E.",0
42,"42151",38,32,29,0,3,"U.C.E.",0
17,"17159",639,408,397,3,11,"U.C.E.",0
17,"17155",14284,8528,8391,143,137,"U.C.E.",3
26,"26089",108356,81446,80090,1450,1356,"U.C.E.",42
16,"16215",285,192,186,2,6,"U.C.E.",1
8,"8035",12099,7838,7735,123,103,"U.C.E.",6
42,"42080",168,115,114,0,1,"U.C.E.",0
37,"37379",167,128,125,4,3,"U.C.E.",0
5,"5140",112,100,99,1,1,"U.C.E.",0
46,"46209",1984,1606,1594,11,12,"U.C.E.",0
42,"42189",75,58,58,2,0,"U.C.E.",0
37,"37063",94,77,76,3,1,"U.C.E.",0
40,"40154",23,21,21,1,0,"U.C.E.",0
45,"45118",1980,1412,1390,13,22,"U.C.E.",1
17,"17199",6630,4242,4162,80,80,"U.C.E.",2
50,"50215",21,20,19,0,1,"U.C.E.",0
24,"24210",532,329,328,2,1,"U.C.E.",1
40,"40044",160,117,114,4,3,"U.C.E.",0
47,"47116",426,363,358,0,5,"U.C.E.",0
47,"47117",306,231,228,4,3,"U.C.E.",0
8,"8279",149233,101676,100363,1965,1313,"U.C.E.",122
23,"23017",1668,1392,1377,10,15,"U.C.E.",0
5,"5234",58,49,49,0,0,"U.C.E.",0
10,"10212",1688,1276,1242,16,34,"U.C.E.",1
44,"44056",577,436,434,7,2,"U.C.E.",0
12,"12051",520,382,376,1,6,"U.C.E.",0
19,"19299",94,75,75,0,0,"U.C.E.",0
10,"10214",226,178,176,2,2,"U.C.E.",0
26,"26055",38,32,30,0,2,"U.C.E.",0
20,"20071",14488,9499,9419,93,80,"U.C.E.",5
22,"22156",256,209,203,5,6,"U.C.E.",0
17,"17223",787,523,514,8,9,"U.C.E.",1
1,"1013",711,477,474,1,3,"U.C.E.",1
40,"40218",111,81,80,1,1,"U.C.E.",0
47,"47081",57,44,44,1,0,"U.C.E.",0
17,"17064",341,253,250,4,3,"U.C.E.",0
33,"33063",467,367,363,4,4,"U.C.E.",1
37,"37014",1198,862,852,8,10,"U.C.E.",1
45,"45101",3761,3212,3181,19,31,"U.C.E.",0
45,"45120",159,125,122,0,3,"U.C.E.",0
31,"31207",280,198,195,7,3,"U.C.E.",0
17,"17115",281,209,207,5,2,"U.C.E.",0
16,"16071",25,23,23,0,0,"U.C.E.",0
12,"12111",423,375,363,6,12,"U.C.E.",0
5,"5135",440,363,360,0,3,"U.C.E.",0
19,"19310",13,9,8,0,1,"U.C.E.",0
5,"5265",87,68,66,2,2,"U.C.E.",0
10,"10116",3762,2781,2705,36,76,"U.C.E.",3
19,"19091",30,22,22,2,0,"U.C.E.",0
20,"20901",1468,951,947,13,4,"U.C.E.",1
8,"8070",275,192,191,5,1,"U.C.E.",0
8,"8221",11348,8413,8306,109,107,"U.C.E.",9
26,"26135",181,139,137,1,2,"U.C.E.",0
15,"15018",1211,821,805,11,16,"U.C.E.",0
4,"4072",339,272,271,0,1,"U.C.E.",1
15,"15049",1211,851,843,7,8,"U.C.E.",1
16,"16186",521,434,429,2,5,"U.C.E.",0
22,"22202",146,120,120,1,0,"U.C.E.",0
50,"50028",120,86,85,2,1,"U.C.E.",1
47,"47219",46,36,36,1,0,"U.C.E.",0
40,"40075",182,149,146,4,3,"U.C.E.",0
45,"45102",3539,2581,2533,23,48,"U.C.E.",0
5,"5163",1762,1400,1380,5,20,"U.C.E.",0
38,"38025",6649,4858,4778,52,80,"U.C.E.",2
44,"44048",77,59,59,0,0,"U.C.E.",0
12,"12033",1970,1547,1509,8,38,"U.C.E.",0
34,"34031",29,26,26,0,0,"U.C.E.",0
19,"19212",795,644,632,2,12,"U.C.E.",0
47,"47084",1230,981,968,19,13,"U.C.E.",1
8,"8300",5621,4021,3933,94,88,"U.C.E.",3
19,"19300",746,595,585,3,10,"U.C.E.",0
45,"45137",1610,1057,1047,11,10,"U.C.E.",0
50,"50130",415,288,288,7,0,"U.C.E.",0
4,"4077",343,313,313,1,0,"U.C.E.",0
20,"20003",547,361,359,3,2,"U.C.E.",0
22,"22200",271,198,191,3,7,"U.C.E.",0
3,"3023",1425,1259,1233,11,26,"U.C.E.",0
19,"19133",103,89,88,2,1,"U.C.E.",0
22,"22905",312,249,247,4,2,"U.C.E.",1
5,"5122",156,124,124,0,0,"U.C.E.",0
44,"44022",550,387,380,6,7,"U.C.E.",1
34,"34089",173,128,125,5,3,"U.C.E.",0
40,"40032",394,293,288,6,5,"U.C.E.",0
20,"20006",277,177,175,6,2,"U.C.E.",0
42,"42090",96,75,74,3,1,"U.C.E.",0
1,"1052",240,191,191,1,0,"U.C.E.",0
37,"37054",273,230,229,2,1,"U.C.E.",1
50,"50055",3592,2520,2473,59,47,"U.C.E.",0
38,"38020",14520,9396,9202,121,194,"U.C.E.",7
8,"8039",365,264,260,5,4,"U.C.E.",0
7,"7047",2161,1447,1407,31,40,"U.C.E.",5
37,"37073",583,458,455,7,3,"U.C.E.",1
5,"5170",63,50,50,0,0,"U.C.E.",0
30,"30033",9940,7794,7700,79,94,"U.C.E.",4
18,"18176",265,183,181,0,2,"U.C.E.",0
40,"40229",45,37,37,0,0,"U.C.E.",0
36,"36031",572,484,479,5,5,"U.C.E.",0
26,"26173",10,10,10,1,0,"U.C.E.",0
42,"42201",27,24,24,2,0,"U.C.E.",0
42,"42154",95,73,73,0,0,"U.C.E.",0
19,"19113",519,396,395,4,1,"U.C.E.",0
47,"47094",154,129,127,0,2,"U.C.E.",0
3,"3062",206,175,175,0,0,"U.C.E.",0
33,"33042",4434,3172,3135,43,37,"U.C.E.",3
36,"36048",5416,4045,3971,55,74,"U.C.E.",2
16,"16104",65,52,52,1,0,"U.C.E.",0
24,"24019",367,293,287,5,6,"U.C.E.",0
37,"37192",362,229,221,3,8,"U.C.E.",0
44,"44043",126,94,94,7,0,"U.C.E.",1
17,"17147",8385,5401,5325,105,76,"U.C.E.",3
10,"10031",189,158,158,1,0,"U.C.E.",0
22,"22901",792,515,508,13,7,"U.C.E.",2
45,"45052",2793,2247,2212,38,35,"U.C.E.",1
24,"24196",2183,1573,1543,11,30,"U.C.E.",2
37,"37333",247,160,154,2,6,"U.C.E.",0
8,"8072",9910,6326,6235,140,91,"U.C.E.",7
18,"18168",864,613,605,4,8,"U.C.E.",0
10,"10200",499,368,368,0,0,"U.C.E.",0
8,"8083",1626,1199,1178,23,21,"U.C.E.",0
37,"37088",208,173,172,4,1,"U.C.E.",0
44,"44001",69,48,47,0,1,"U.C.E.",1
38,"38004",4522,3034,2975,33,59,"U.C.E.",3
19,"19325",127,105,102,4,3,"U.C.E.",0
3,"3121",20518,14464,14315,137,149,"U.C.E.",14
40,"40128",144,116,116,5,0,"U.C.E.",1
22,"22244",61,46,44,1,2,"U.C.E.",0
31,"31179",558,384,384,3,0,"U.C.E.",0
10,"10163",374,310,308,0,2,"U.C.E.",0
46,"46067",1798,1487,1472,10,15,"U.C.E.",0
22,"22090",115,82,82,5,0,"U.C.E.",0
46,"46136",2476,1890,1865,16,25,"U.C.E.",1
46,"46180",715,585,581,4,4,"U.C.E.",0
16,"16154",4946,3975,3914,58,61,"U.C.E.",0
17,"17071",1064,719,698,33,21,"U.C.E.",0
37,"37310",154,115,115,1,0,"U.C.E.",0
45,"45020",1396,1165,1151,15,14,"U.C.E.",0
26,"26178",88,74,73,1,1,"U.C.E.",0
37,"37082",869,663,650,3,13,"U.C.E.",1
45,"45125",2407,1977,1949,22,28,"U.C.E.",2
50,"50269",316,186,185,1,1,"U.C.E.",0
38,"38010",4054,2642,2599,17,43,"U.C.E.",3
19,"19057",79,56,56,0,0,"U.C.E.",0
37,"37085",4334,3254,3201,69,53,"U.C.E.",1
40,"40097",114,96,94,2,2,"U.C.E.",0
46,"46092",304,206,201,1,5,"U.C.E.",0
31,"31169",2285,1621,1590,43,31,"U.C.E.",0
16,"16121",270,211,207,1,4,"U.C.E.",0
16,"16253",340,256,256,4,0,"U.C.E.",0
16,"16156",122,91,91,0,0,"U.C.E.",1
14,"14046",4587,3671,3641,35,30,"U.C.E.",0
8,"8275",242,188,186,4,2,"U.C.E.",0
37,"37040",431,362,362,4,0,"U.C.E.",1
22,"22167",515,417,399,16,18,"U.C.E.",0
3,"3112",684,566,561,4,5,"U.C.E.",1
23,"23006",4644,3913,3871,36,42,"U.C.E.",0
45,"45042",184,154,151,3,3,"U.C.E.",0
31,"31906",2493,1796,1770,57,26,"U.C.E.",5
22,"22172",613,463,452,6,11,"U.C.E.",1
37,"37155",81,57,57,0,0,"U.C.E.",0
17,"17170",192,135,134,1,1,"U.C.E.",0
47,"47109",183,151,151,4,0,"U.C.E.",0
24,"24125",545,374,373,5,1,"U.C.E.",1
37,"37305",206,153,152,4,1,"U.C.E.",0
19,"19016",74,50,49,0,1,"U.C.E.",0
31,"31209",155,105,104,1,1,"U.C.E.",0
31,"31149",2381,1626,1607,7,19,"U.C.E.",0
31,"31021",75,52,52,0,0,"U.C.E.",0
37,"37328",218,155,149,2,6,"U.C.E.",1
18,"18085",818,538,532,4,6,"U.C.E.",0
37,"37319",138,94,94,1,0,"U.C.E.",0
12,"12012",2747,2196,2135,24,61,"U.C.E.",1
1,"1037",625,403,398,6,5,"U.C.E.",1
50,"50117",131,101,100,1,1,"U.C.E.",0
46,"46088",196,146,140,0,6,"U.C.E.",0
12,"12038",195,135,134,8,1,"U.C.E.",0
17,"17210",527,358,349,9,9,"U.C.E.",0
8,"8257",116,84,81,0,3,"U.C.E.",0
34,"34076",632,524,520,13,4,"U.C.E.",0
38,"38009",3910,2687,2633,31,54,"U.C.E.",2
31,"31213",114,58,58,0,0,"U.C.E.",0
37,"37078",888,728,714,9,14,"U.C.E.",1
50,"50022",548,430,416,10,14,"U.C.E.",0
18,"18012",2693,1841,1831,11,10,"U.C.E.",0
22,"22110",822,602,588,3,14,"U.C.E.",0
19,"19291",1271,925,902,3,23,"U.C.E.",3
44,"44260",160,117,115,5,2,"U.C.E.",0
22,"22165",515,409,403,9,6,"U.C.E.",0
11,"11033",19983,12960,12807,199,153,"U.C.E.",3
3,"3110",294,239,238,0,1,"U.C.E.",1
17,"17093",859,561,552,16,9,"U.C.E.",0
16,"16172",413,330,318,1,12,"U.C.E.",0
31,"31006",1988,1434,1395,22,39,"U.C.E.",1
17,"17150",1428,1018,996,24,22,"U.C.E.",0
34,"34024",27,18,17,1,1,"U.C.E.",0
5,"5092",172,142,139,0,3,"U.C.E.",0
39,"39044",3864,2940,2905,44,35,"U.C.E.",1
5,"5246",68,57,56,1,1,"U.C.E.",0
33,"33036",11674,8695,8605,104,90,"U.C.E.",4
44,"44232",408,301,295,5,6,"U.C.E.",1
33,"33028",1466,812,806,5,6,"U.C.E.",0
8,"8087",158,133,132,6,1,"U.C.E.",0
46,"46153",445,374,366,7,8,"U.C.E.",0
8,"8090",120,86,86,2,0,"U.C.E.",0
50,"50278",207,152,149,4,3,"U.C.E.",0
31,"31165",2868,2094,2046,43,48,"U.C.E.",2
8,"8036",172,124,124,4,0,"U.C.E.",0
42,"42202",33,15,14,1,1,"U.C.E.",0
20,"20014",1101,660,654,8,6,"U.C.E.",0
8,"8011",1754,1116,1085,29,31,"U.C.E.",1
8,"8292",1083,775,764,21,11,"U.C.E.",0
45,"45096",1021,800,778,5,22,"U.C.E.",0
26,"26086",18,17,17,0,0,"U.C.E.",0
16,"16238",560,484,479,3,5,"U.C.E.",0
22,"22186",217,173,173,3,0,"U.C.E.",0
19,"19227",95,64,63,1,1,"U.C.E.",0
50,"50078",278,210,208,2,2,"U.C.E.",0
15,"15022",6102,4207,4164,52,43,"U.C.E.",2
16,"16006",133,117,116,2,1,"U.C.E.",1
42,"42127",47,35,35,0,0,"U.C.E.",0
19,"19279",66,56,56,0,0,"U.C.E.",0
47,"47102",302,250,248,3,2,"U.C.E.",0
40,"40220",71,57,52,0,5,"U.C.E.",0
42,"42131",53,38,37,0,1,"U.C.E.",0
19,"19326",1125,800,786,10,14,"U.C.E.",0
16,"16142",118,93,93,1,0,"U.C.E.",0
45,"45139",231,198,194,0,4,"U.C.E.",0
39,"39087",43561,33709,33242,404,467,"U.C.E.",12
50,"50003",141,108,108,3,0,"U.C.E.",1
47,"47038",128,91,91,0,0,"U.C.E.",0
31,"31154",229,133,133,4,0,"U.C.E.",0
8,"8904",10608,6654,6561,140,93,"U.C.E.",18
19,"19058",6455,5028,4933,63,95,"U.C.E.",2
19,"19102",122,101,100,0,1,"U.C.E.",0
5,"5148",34,27,27,0,0,"U.C.E.",0
46,"46158",1037,829,822,9,7,"U.C.E.",1
47,"47076",16922,13030,12899,212,131,"U.C.E.",8
12,"12027",16914,11657,11452,188,205,"U.C.E.",9
24,"24124",419,286,282,0,4,"U.C.E.",0
42,"42029",164,114,113,1,1,"U.C.E.",0
30,"30009",11961,9992,9880,92,112,"U.C.E.",5
46,"46063",1764,1441,1423,15,18,"U.C.E.",5
7,"7021",255,197,193,1,4,"U.C.E.",0
47,"47085",16967,12618,12472,208,146,"U.C.E.",6
25,"25191",353,234,227,5,7,"UCE",0
29,"29089",3343,2514,2489,14,25,"UCE",1
25,"25170",271,197,196,4,1,"UCE",0
32,"32056",1861,1378,1369,8,9,"UCE",0
13,"13048",538,441,433,5,8,"UCE",0
25,"25225",603,395,387,7,8,"UCE",1
48,"48084",23491,15322,15084,213,238,"UCE",9
29,"29025",34637,22545,22354,268,191,"UCE",9
28,"28058",137542,103880,102686,1155,1194,"UCE",40
43,"43111",2096,1305,1281,19,24,"UCE",0
27,"27023",2770,2196,2178,30,18,"UCE",0
28,"28005",132097,100509,99506,1069,1003,"UCE",24
29,"29090",1805,1265,1260,5,5,"UCE",0
29,"29053",1715,1239,1221,7,18,"UCE",0
48,"48006",285,246,243,3,3,"UCE",0
13,"13083",2529,1837,1795,26,42,"UCE",2
28,"28099",1670,1258,1246,9,12,"UCE",0
29,"29080",6598,4703,4663,31,40,"UCE",6
28,"28036",2301,1809,1784,13,25,"UCE",1
48,"48083",7021,4722,4656,74,66,"UCE",1
43,"43130",196,132,131,7,1,"UCE",0
43,"43127",778,530,524,6,6,"UCE",0
28,"28023",4350,3425,3392,32,33,"UCE",1
48,"48053",856,683,680,8,3,"UCE",0
27,"27008",1458,1130,1115,18,15,"UCE",0
32,"32081",2240,1698,1682,13,16,"UCE",1
48,"48064",599,490,490,1,0,"UCE",0
13,"13031",2384,1908,1874,23,34,"UCE",0
25,"25035",428,289,284,5,5,"UCE",0
28,"28080",45696,36832,36529,402,303,"UCE",3
43,"43097",379,283,278,6,5,"UCE",1
28,"28159",629,482,478,2,4,"UCE",0
29,"29013",1718,1302,1283,4,19,"UCE",0
43,"43092",7051,4294,4220,45,74,"UCE",6
25,"25227",674,375,372,2,3,"UCE",0
48,"48915",362,273,271,2,2,"UCE",0
29,"29014",250,152,150,0,2,"UCE",0
13,"13003",503,390,387,2,3,"UCE",0
28,"28095",1358,1092,1077,8,15,"UCE",0
25,"25076",165,84,83,3,1,"UCE",0
25,"25240",1398,976,958,17,18,"UCE",0
28,"28091",5202,3714,3671,34,43,"UCE",2
25,"25908",250,169,168,4,1,"UCE",0
28,"28118",72,49,47,1,2,"UCE",0
28,"28054",10459,7798,7698,65,100,"UCE",7
48,"48042",1401,1116,1099,15,17,"UCE",1
25,"25219",144,90,86,0,4,"UCE",0
25,"25132",128,87,85,3,2,"UCE",0
29,"29071",915,601,598,4,3,"UCE",2
29,"29077",225,157,157,1,0,"UCE",0
29,"29050",483,341,340,1,1,"UCE",0
29,"29035",1717,1280,1270,14,10,"UCE",0
25,"25154",126,77,77,2,0,"UCE",0
48,"48027",21610,15409,15274,145,135,"UCE",14
25,"25138",605,440,428,13,12,"UCE",0
43,"43903",2368,1504,1492,22,12,"UCE",0
25,"25111",116,70,70,0,0,"UCE",0
25,"25248",926,615,601,17,14,"UCE",0
29,"29081",290,226,226,3,0,"UCE",0
29,"29016",272,180,179,5,1,"UCE",0
48,"48052",1526,1213,1205,7,8,"UCE",0
43,"43146",45,33,30,1,3,"UCE",0
28,"28041",4006,3190,3154,45,36,"UCE",0
43,"43049",805,555,536,6,19,"UCE",0
29,"29021",153,113,113,0,0,"UCE",0
13,"13904",556,448,441,14,7,"UCE",0
28,"28065",118796,93292,92186,919,1106,"UCE",25
29,"29019",908,720,714,0,6,"UCE",0
43,"43164",298,233,231,4,2,"UCE",0
48,"48021",1460,1024,1012,13,12,"UCE",0
25,"25205",563,373,362,12,11,"UCE",0
29,"29049",3137,2365,2352,19,13,"UCE",2
32,"32008",7618,5529,5433,83,96,"UCE",6
13,"13090",1202,994,972,4,22,"UCE",0
25,"25173",1784,1177,1139,20,38,"UCE",0
43,"43137",1873,1241,1212,27,29,"UCE",0
25,"25251",670,476,473,1,3,"UCE",0
25,"25126",286,192,189,7,3,"UCE",0
28,"28062",311,233,226,0,7,"UCE",0
25,"25190",271,180,176,12,4,"UCE",0
48,"48011",9742,6697,6628,82,69,"UCE",6
25,"25012",2204,1432,1406,29,26,"UCE",3
43,"43091",142,106,98,5,8,"UCE",0
25,"25913",100,78,78,0,0,"UCE",0
25,"25197",158,102,101,2,1,"UCE",0
13,"13077",3654,2535,2480,31,55,"UCE",3
13,"13062",595,490,480,4,10,"UCE",0
32,"32088",1749,1232,1217,10,15,"UCE",0
28,"28035",1314,1058,1046,3,12,"UCE",0
28,"28086",4603,3286,3248,29,38,"UCE",0
28,"28165",1689,1310,1295,5,15,"UCE",0
32,"32060",885,650,641,10,9,"UCE",0
25,"25073",662,382,379,11,3,"UCE",0
25,"25902",581,411,395,15,16,"UCE",0
32,"32032",8284,6295,6198,84,97,"UCE",2
29,"29020",3188,2448,2424,30,24,"UCE",0
43,"43053",190,149,149,2,0,"UCE",0
48,"48908",242,194,194,1,0,"UCE",0
13,"13057",1214,1018,998,9,20,"UCE",1
29,"29058",1560,1103,1096,5,7,"UCE",0
32,"32049",863,566,563,7,3,"UCE",0
13,"13058",4155,3320,3285,24,35,"UCE",0
32,"32076",2358,1835,1823,18,12,"UCE",4
25,"25029",1766,1145,1118,38,27,"UCE",1
48,"48097",1359,936,915,9,21,"UCE",2
27,"27025",3005,2414,2377,25,37,"UCE",4
13,"13024",938,703,699,3,4,"UCE",0
29,"29042",14047,9845,9735,118,110,"UCE",10
28,"28069",51,35,33,1,2,"UCE",0
13,"13094",338,276,275,2,1,"UCE",0
13,"13072",803,638,633,13,5,"UCE",0
48,"48012",2036,1630,1616,9,14,"UCE",0
43,"43085",229,178,171,0,7,"UCE",0
13,"13092",1924,1655,1635,4,20,"UCE",1
25,"25217",10570,6660,6500,191,160,"UCE",1
25,"25052",1611,1094,1062,21,32,"UCE",0
43,"43904",2918,1779,1732,49,47,"UCE",3
13,"13030",153,123,123,1,0,"UCE",0
25,"25003",3853,2367,2340,68,27,"UCE",1
43,"43007",635,448,441,7,7,"UCE",0
29,"29083",2212,1679,1652,15,27,"UCE",0
13,"13055",738,585,578,8,7,"UCE",1
43,"43160",1278,840,812,9,28,"UCE",0
25,"25133",748,499,483,7,16,"UCE",0
25,"25038",1606,1104,1093,19,11,"UCE",0
43,"43163",24903,15475,15241,263,234,"UCE",10
48,"48095",2367,1593,1577,20,16,"UCE",0
28,"28073",11899,8877,8769,112,108,"UCE",0
32,"32002",2060,1566,1551,13,15,"UCE",0
29,"29901",41445,27372,27158,295,214,"UCE",10
29,"29062",647,573,571,1,2,"UCE",0
43,"43907",4122,2759,2712,52,47,"UCE",8
32,"32092",596,367,364,2,3,"UCE",0
28,"28001",61,46,45,1,1,"UCE",0
48,"48082",38551,25768,25482,316,286,"UCE",16
28,"28158",632,505,495,4,10,"UCE",0
48,"48016",5214,3782,3736,46,46,"UCE",5
48,"48015",34932,24209,23966,296,243,"UCE",26
25,"25128",151,83,81,1,2,"UCE",0
43,"43082",383,282,270,8,12,"UCE",0
25,"25910",118,77,76,3,1,"UCE",0
25,"25043",830,483,467,17,16,"UCE",0
28,"28050",3576,2706,2663,21,43,"UCE",0
43,"43031",1509,1016,992,20,24,"UCE",0
25,"25208",294,174,170,3,4,"UCE",0
28,"28177",9470,7524,7466,87,58,"UCE",2
29,"29006",721,516,508,5,8,"UCE",0
43,"43906",2050,1332,1298,28,34,"UCE",0
48,"48043",4256,3066,3040,33,26,"UCE",2
27,"27064",1706,1233,1214,14,19,"UCE",0
25,"25167",253,176,172,0,4,"UCE",0
32,"32069",4573,3624,3580,35,44,"UCE",2
43,"43054",2850,1815,1771,37,44,"UCE",1
25,"25130",208,117,112,4,5,"UCE",0
48,"48094",3299,2398,2377,15,21,"UCE",4
32,"32005",957,760,753,8,7,"UCE",0
28,"28123",48429,38681,38187,429,494,"UCE",14
25,"25230",1665,1164,1140,36,24,"UCE",0
43,"43117",150,118,115,1,3,"UCE",0
43,"43140",2393,1612,1583,23,29,"UCE",1
48,"48077",3398,2490,2477,33,13,"UCE",0
13,"13042",953,704,693,5,11,"UCE",0
29,"29075",12666,8284,8218,62,66,"UCE",2
48,"48029",8022,5488,5409,83,79,"UCE",10
32,"32030",1120,857,846,9,11,"UCE",0
13,"13034",56981,42819,42306,742,513,"UCE",15
25,"25242",787,501,490,11,11,"UCE",0
29,"29064",584,428,422,4,6,"UCE",0
28,"28181",20003,16133,15952,159,181,"UCE",1
43,"43112",294,184,181,2,3,"UCE",0
25,"25104",128,88,86,11,2,"UCE",0
28,"28033",3581,2712,2691,14,21,"UCE",0
43,"43905",13621,8120,8011,131,109,"UCE",11
32,"32004",2071,1145,1142,7,3,"UCE",0
43,"43015",104,69,68,2,1,"UCE",0
27,"27015",4587,3465,3409,55,56,"UCE",3
25,"25061",75,45,45,0,0,"UCE",0
25,"25094",154,110,107,1,3,"UCE",0
27,"27021",1936,1295,1271,19,24,"UCE",1
29,"29047",1165,973,969,0,4,"UCE",0
13,"13073",565,459,456,2,3,"UCE",0
27,"27006",2789,1949,1911,22,38,"UCE",3
29,"29059",2551,1986,1964,11,22,"UCE",3
28,"28019",1195,901,888,5,13,"UCE",0
25,"25211",701,378,368,5,10,"UCE",1
28,"28007",122891,95200,94139,990,1061,"UCE",28
43,"43166",1521,1002,977,17,25,"UCE",1
28,"28014",31360,23434,23133,203,301,"UCE",5
13,"13901",945,734,719,6,15,"UCE",1
28,"28051",1469,1147,1129,7,18,"UCE",1
28,"28128",366,280,275,2,5,"UCE",0
48,"48017",13554,9303,9234,64,69,"UCE",3
29,"29048",1508,1254,1245,6,9,"UCE",1
48,"48039",263,217,216,4,1,"UCE",0
25,"25911",472,306,296,2,10,"UCE",0
25,"25015",394,264,264,14,0,"UCE",0
48,"48002",7971,5377,5290,65,87,"UCE",2
25,"25203",8995,5418,5309,116,109,"UCE",5
25,"25053",1085,733,727,10,6,"UCE",0
43,"43167",390,284,280,12,4,"UCE",0
28,"28093",1911,1537,1518,19,19,"UCE",0
32,"32083",960,675,672,0,3,"UCE",0
25,"25148",232,144,144,5,0,"UCE",0
25,"25122",1956,1281,1256,33,25,"UCE",0
28,"28052",3799,2753,2719,17,34,"UCE",0
43,"43068",573,388,378,5,10,"UCE",0
13,"13078",9291,7062,6993,92,69,"UCE",2
48,"48018",905,591,587,8,4,"UCE",0
32,"32047",2003,1595,1575,10,20,"UCE",0
25,"25027",1042,691,665,11,26,"UCE",0
28,"28090",7899,6216,6131,60,85,"UCE",1
43,"43102",517,377,366,2,11,"UCE",0
28,"28136",618,527,516,2,11,"UCE",0
13,"13001",1372,1087,1067,8,20,"UCE",1
32,"32003",950,736,727,3,9,"UCE",0
29,"29902",2577,1689,1665,20,24,"UCE",0
27,"27035",194,119,119,0,0,"UCE",0
28,"28150",2985,2363,2345,21,18,"UCE",0
48,"48056",849,610,608,3,2,"UCE",1
13,"13039",14349,10928,10776,149,152,"UCE",1
28,"28096",16844,12441,12308,117,133,"UCE",6
28,"28153",608,422,406,1,16,"UCE",1
25,"25005",291,194,190,7,4,"UCE",0
32,"32061",1196,976,973,4,3,"UCE",0
25,"25141",171,111,107,2,4,"UCE",0
25,"25172",1838,1267,1230,35,37,"UCE",1
27,"27044",3089,2167,2125,31,42,"UCE",2
27,"27058",3908,2946,2915,28,31,"UCE",4
28,"28060",1471,1205,1192,8,13,"UCE",0
48,"48031",370,296,296,1,0,"UCE",0
25,"25049",166,105,102,1,3,"UCE",0
25,"25232",1480,968,959,38,9,"UCE",0
29,"29005",4307,2967,2951,18,16,"UCE",0
28,"28135",928,665,659,6,6,"UCE",1
13,"13026",482,387,384,1,3,"UCE",0
25,"25149",1401,1031,1010,17,21,"UCE",0
27,"27029",1525,1243,1221,18,22,"UCE",1
32,"32078",1366,1026,1018,3,8,"UCE",0
43,"43133",5697,3470,3388,76,82,"UCE",4
29,"29008",14069,9934,9859,118,75,"UCE",5
13,"13064",1465,1127,1110,21,17,"UCE",1
28,"28126",59,37,37,0,0,"UCE",0
48,"48007",354,254,253,1,1,"UCE",0
43,"43030",454,321,307,5,14,"UCE",0
25,"25247",142,80,78,3,2,"UCE",1
43,"43057",45,27,27,2,0,"UCE",1
43,"43081",574,415,404,13,11,"UCE",0
13,"13023",8731,6818,6732,94,86,"UCE",2
25,"25088",100,74,74,0,0,"UCE",0
43,"43126",1170,802,783,19,19,"UCE",0
25,"25171",2305,1496,1469,37,27,"UCE",2
28,"28076",417,325,321,1,4,"UCE",0
28,"28176",10977,8790,8718,68,72,"UCE",1
48,"48914",324,278,276,0,2,"UCE",0
28,"28138",78,48,46,0,2,"UCE",0
25,"25081",332,212,206,6,6,"UCE",0
43,"43148",89309,59260,58346,1202,914,"UCE",69
48,"48049",564,446,446,2,0,"UCE",0
32,"32073",1415,1111,1100,8,11,"UCE",0
43,"43017",141,98,98,2,0,"UCE",0
43,"43009",1421,913,897,18,16,"UCE",1
13,"13054",5032,3901,3824,70,77,"UCE",1
28,"28174",1745,1233,1224,11,9,"UCE",0
28,"28162",2263,1802,1786,32,16,"UCE",1
48,"48067",1204,895,892,4,3,"UCE",0
13,"13061",5898,4442,4373,56,69,"UCE",2
13,"13006",641,529,519,4,10,"UCE",0
48,"48078",39866,27311,26995,311,316,"UCE",21
28,"28125",2808,2077,2055,19,22,"UCE",0
43,"43157",388,282,270,10,12,"UCE",0
32,"32057",608,475,473,4,2,"UCE",0
43,"43106",878,600,592,17,8,"UCE",0
48,"48050",216,173,172,0,1,"UCE",0
32,"32017",1333,906,895,10,11,"UCE",1
32,"32062",963,735,729,10,6,"UCE",0
32,"32018",1351,1100,1092,9,8,"UCE",0
28,"28111",618,486,479,2,7,"UCE",0
25,"25156",761,535,529,15,6,"UCE",0
28,"28156",958,742,733,12,9,"UCE",0
27,"27019",8247,6146,6022,101,124,"UCE",8
28,"28049",59507,46919,46379,488,540,"UCE",12
43,"43016",3437,2323,2266,40,57,"UCE",2
27,"27004",1379,981,966,4,15,"UCE",0
25,"25036",190,138,134,5,4,"UCE",0
25,"25209",1558,1041,1009,22,32,"UCE",2
13,"13075",212,161,159,1,2,"UCE",0
25,"25097",102,70,69,3,1,"UCE",0
48,"48059",397,289,286,0,3,"UCE",0
48,"48070",559,413,407,1,6,"UCE",0
28,"28028",1615,1204,1173,11,31,"UCE",0
32,"32023",1360,1030,1011,6,19,"UCE",1
29,"29037",227,170,170,0,0,"UCE",0
43,"43174",152,104,101,1,3,"UCE",0
25,"25157",183,128,128,4,0,"UCE",0
27,"27005",2792,2101,2076,21,25,"UCE",3
25,"25055",187,115,115,3,0,"UCE",0
29,"29099",958,739,730,5,9,"UCE",0
32,"32020",2958,2300,2283,19,17,"UCE",1
28,"28113",31318,23779,23436,271,343,"UCE",4
29,"29038",16309,10579,10494,152,85,"UCE",1
32,"32016",1021,781,776,2,5,"UCE",0
27,"27016",7521,5439,5338,83,101,"UCE",6
29,"29092",596,457,454,10,3,"UCE",1
25,"25037",396,275,273,9,2,"UCE",0
28,"28072",5232,4065,4007,35,58,"UCE",0
25,"25222",69,55,54,0,1,"UCE",0
25,"25056",289,168,163,3,5,"UCE",0
43,"43159",89,51,51,2,0,"UCE",0
25,"25017",248,160,159,1,1,"UCE",0
29,"29094",54317,36540,36174,410,366,"UCE",13
28,"28008",1734,1244,1221,11,23,"UCE",0
13,"13088",649,531,526,3,5,"UCE",0
32,"32074",1180,892,876,11,16,"UCE",0
32,"32006",1814,1344,1330,20,14,"UCE",0
43,"43061",55,31,31,1,0,"UCE",0
29,"29001",4176,3339,3303,23,36,"UCE",1
25,"25067",768,498,494,14,4,"UCE",1
25,"25238",231,158,156,1,2,"UCE",0
48,"48065",3311,2340,2323,23,17,"UCE",1
25,"25252",536,361,352,13,9,"UCE",0
28,"28902",453,338,329,3,9,"UCE",0
48,"48091",1170,860,851,3,9,"UCE",0
25,"25001",146,76,76,1,0,"UCE",0
13,"13012",475,322,318,1,4,"UCE",0
28,"28129",7219,5536,5461,71,75,"UCE",4
28,"28145",2125,1643,1620,15,23,"UCE",0
43,"43070",265,198,196,3,2,"UCE",1
27,"27041",2644,1946,1915,29,31,"UCE",2
48,"48081",1938,1449,1435,14,14,"UCE",0
32,"32038",497,360,358,2,2,"UCE",0
27,"27024",1759,1346,1324,17,22,"UCE",1
32,"32052",2126,1690,1673,28,17,"UCE",2
25,"25039",299,189,186,7,3,"UCE",0
28,"28002",2650,2018,1993,24,25,"UCE",0
28,"28045",30286,23148,22879,226,269,"UCE",10
28,"28164",2807,2194,2173,10,21,"UCE",0
13,"13097",2309,1843,1825,20,18,"UCE",0
25,"25051",1710,1060,1044,23,16,"UCE",0
28,"28148",79726,60405,59651,724,754,"UCE",13
28,"28012",830,654,651,6,3,"UCE",0
29,"29073",1520,1032,1021,10,11,"UCE",3
28,"28115",57612,46786,46458,458,328,"UCE",7
25,"25002",481,306,302,6,4,"UCE",0
28,"28038",4999,3659,3590,32,69,"UCE",0
43,"43113",454,321,316,10,5,"UCE",0
32,"32089",1480,1063,1045,7,18,"UCE",0
43,"43145",3968,2781,2742,52,39,"UCE",2
28,"28108",3002,2254,2228,31,26,"UCE",0
29,"29041",2796,1950,1921,24,29,"UCE",1
32,"32013",2464,1695,1671,10,24,"UCE",1
25,"25087",65,41,39,0,2,"UCE",0
25,"25150",185,119,113,4,6,"UCE",0
25,"25182",1075,749,731,30,18,"UCE",1
28,"28130",27391,21367,21111,235,256,"UCE",3
43,"43048",830,547,530,16,17,"UCE",0
13,"13052",6580,4869,4786,76,83,"UCE",2
48,"48014",1211,838,834,4,4,"UCE",0
29,"29051",37991,24498,24095,381,403,"UCE",13
43,"43141",131,71,70,3,1,"UCE",0
28,"28117",116,90,90,1,0,"UCE",0
13,"13063",3839,2801,2771,31,30,"UCE",1
28,"28018",3572,2837,2795,20,42,"UCE",0
25,"25013",2274,1344,1321,25,23,"UCE",0
28,"28131",12664,9454,9342,100,112,"UCE",3
25,"25071",56,37,35,2,2,"UCE",0
28,"28110",1912,1492,1475,8,17,"UCE",0
43,"43062",298,227,223,7,4,"UCE",0
28,"28040",15089,9976,9852,116,124,"UCE",3
43,"43099",330,240,236,4,4,"UCE",0
25,"25034",2471,1622,1592,25,30,"UCE",1
25,"25912",899,643,640,6,3,"UCE",0
25,"25115",878,542,542,17,0,"UCE",0
48,"48033",223,171,171,1,0,"UCE",0
43,"43107",378,255,248,18,7,"UCE",0
48,"48044",63869,47453,47085,511,368,"UCE",35
25,"25185",690,409,404,8,5,"UCE",0
25,"25177",379,240,236,2,4,"UCE",0
48,"48093",893,707,695,1,12,"UCE",1
28,"28043",5944,4199,4147,56,52,"UCE",0
32,"32065",720,550,539,3,11,"UCE",1
29,"29034",462,360,357,0,3,"UCE",0
43,"43034",494,355,344,8,11,"UCE",0
13,"13028",10536,8503,8331,140,172,"UCE",2
25,"25904",149,107,104,1,3,"UCE",0
48,"48023",601,499,492,4,7,"UCE",0
43,"43108",1808,1183,1157,28,26,"UCE",0
28,"28048",489,398,389,3,9,"UCE",0
43,"43010",302,227,223,7,4,"UCE",0
48,"48912",2340,1794,1776,22,18,"UCE",0
27,"27059",2320,1783,1763,25,20,"UCE",1
43,"43105",175,119,116,14,3,"UCE",0
32,"32001",4938,3715,3667,50,48,"UCE",1
43,"43075",102,63,63,1,0,"UCE",0
13,"13074",1000,886,878,15,8,"UCE",1
13,"13066",2444,2094,2065,15,29,"UCE",0
43,"43072",97,73,70,0,3,"UCE",0
25,"25200",353,225,217,4,8,"UCE",0
28,"28092",148714,112174,110838,1215,1336,"UCE",38
48,"48047",161,126,126,1,0,"UCE",0
48,"48906",796,625,622,5,3,"UCE",0
32,"32022",1591,1219,1207,9,12,"UCE",1
25,"25119",2297,1554,1513,46,41,"UCE",1
28,"28079",2290453,1721837,1705310,17342,16527,"UCE",406
43,"43051",8749,5494,5411,78,83,"UCE",7
28,"28119",1911,1527,1514,13,13,"UCE",0
43,"43142",1155,730,714,20,16,"UCE",0
25,"25007",1363,902,885,36,17,"UCE",0
32,"32011",1026,660,650,4,10,"UCE",0
43,"43060",3049,2030,1980,62,50,"UCE",0
43,"43158",109,63,61,5,2,"UCE",0
25,"25137",8404,5264,5167,112,97,"UCE",4
29,"29009",1525,1126,1109,9,17,"UCE",0
48,"48004",329,240,239,2,1,"UCE",0
29,"29056",1177,807,794,3,13,"UCE",0
32,"32068",1631,1187,1174,4,13,"UCE",0
43,"43050",2407,1528,1504,20,24,"UCE",1
25,"25250",358,237,234,4,3,"UCE",0
43,"43058",106,76,76,5,0,"UCE",0
48,"48071",6097,4307,4224,61,83,"UCE",3
25,"25244",350,270,268,9,2,"UCE",0
13,"13098",2265,1805,1759,19,46,"UCE",0
28,"28144",5663,4456,4410,47,46,"UCE",0
43,"43094",2209,1558,1524,31,34,"UCE",0
27,"27038",1035,817,809,9,8,"UCE",1
29,"29074",818,631,630,3,1,"UCE",0
28,"28120",1259,946,931,11,15,"UCE",0
32,"32085",10730,7588,7475,100,113,"UCE",5
32,"32037",828,660,654,10,6,"UCE",0
28,"28022",30019,24469,24279,292,190,"UCE",4
29,"29029",452,339,336,0,3,"UCE",0
25,"25114",102,82,78,4,4,"UCE",0
29,"29066",363,263,260,1,3,"UCE",0
28,"28173",507,397,390,2,7,"UCE",0
25,"25102",733,478,464,15,14,"UCE",1
25,"25096",988,633,613,12,20,"UCE",0
43,"43103",897,586,575,21,11,"UCE",1
28,"28178",1017,799,791,11,8,"UCE",3
28,"28020",145,102,100,0,2,"UCE",0
28,"28161",44185,33371,32966,353,405,"UCE",13
28,"28004",5761,4098,4044,38,54,"UCE",0
32,"32051",1574,1296,1290,7,6,"UCE",0
25,"25131",439,319,314,6,5,"UCE",1
27,"27009",2354,1812,1782,19,30,"UCE",1
48,"48073",7090,4865,4802,37,63,"UCE",0
43,"43176",832,575,572,16,3,"UCE",0
25,"25030",147,101,95,3,6,"UCE",0
13,"13067",380,314,312,3,2,"UCE",0
28,"28114",148,110,110,0,0,"UCE",0
25,"25048",1684,1120,1095,29,25,"UCE",0
43,"43088",1810,1199,1177,29,22,"UCE",1
43,"43046",114,80,79,5,1,"UCE",0
43,"43038",20710,12999,12771,224,228,"UCE",10
29,"29086",814,538,536,9,2,"UCE",0
43,"43129",4525,3032,2956,62,76,"UCE",1
48,"48037",727,528,519,2,9,"UCE",0
25,"25098",266,177,177,0,0,"UCE",0
25,"25202",110,62,59,3,3,"UCE",0
43,"43134",279,208,206,14,2,"UCE",0
27,"27043",1422,988,962,10,26,"UCE",0
25,"25152",160,92,90,4,2,"UCE",0
27,"27011",2663,1822,1785,23,37,"UCE",2
25,"25234",4572,2707,2648,57,59,"UCE",0
25,"25058",4390,2696,2650,57,46,"UCE",1
43,"43170",880,601,592,9,9,"UCE",1
28,"28084",15408,11489,11355,122,134,"UCE",2
25,"25113",1227,869,856,28,13,"UCE",1
28,"28182",219,179,178,2,1,"UCE",0
25,"25078",1014,730,719,17,11,"UCE",0
27,"27054",1332,1063,1054,12,9,"UCE",1
29,"29084",28386,19450,19202,296,248,"UCE",10
13,"13015",5755,4334,4293,40,41,"UCE",3
28,"28147",910,705,698,5,7,"UCE",0
43,"43035",280,202,198,0,4,"UCE",0
13,"13010",910,729,726,8,3,"UCE",0
29,"29068",6209,4025,3983,41,42,"UCE",1
43,"43089",272,193,185,1,8,"UCE",0
48,"48032",5864,4257,4223,32,34,"UCE",2
43,"43019",1356,868,837,13,31,"UCE",1
25,"25050",3249,2056,1988,40,68,"UCE",0
25,"25134",657,421,416,4,5,"UCE",0
32,"32031",1079,837,828,5,9,"UCE",0
27,"27061",1170,917,906,8,11,"UCE",2
32,"32067",1487,1004,995,10,9,"UCE",0
43,"43131",4495,2842,2814,51,28,"UCE",0
13,"13060",291,235,229,0,6,"UCE",0
25,"25174",438,289,283,4,6,"UCE",0
43,"43041",237,177,176,4,1,"UCE",0
48,"48903",1909,1455,1430,4,25,"UCE",2
28,"28169",1244,971,962,8,9,"UCE",0
13,"13082",25643,17973,17798,257,175,"UCE",7
13,"13027",3582,2770,2715,25,55,"UCE",1
32,"32080",394,311,309,3,2,"UCE",0
29,"29015",31805,22566,22347,272,219,"UCE",6
27,"27031",16169,11446,11214,194,232,"UCE",23
32,"32044",939,774,764,8,10,"UCE",0
32,"32077",1234,999,993,23,6,"UCE",0
29,"29070",35228,23374,23146,258,228,"UCE",27
43,"43156",4120,2811,2741,66,70,"UCE",1
48,"48001",5842,4040,4020,23,20,"UCE",7
43,"43026",800,531,522,15,9,"UCE",0
28,"28026",5852,4506,4449,40,57,"UCE",0
43,"43066",165,113,112,2,1,"UCE",0
25,"25158",1647,1154,1135,27,19,"UCE",0
32,"32024",5054,3668,3609,40,59,"UCE",3
27,"27032",3466,2565,2530,40,35,"UCE",2
43,"43116",494,328,325,5,3,"UCE",0
13,"13051",358,291,289,5,2,"UCE",0
48,"48009",767,585,580,4,5,"UCE",0
48,"48902",19232,12809,12633,182,176,"UCE",24
13,"13032",1218,926,922,9,4,"UCE",0
13,"13019",5254,4038,3978,62,60,"UCE",0
25,"25249",207,151,150,4,1,"UCE",0
29,"29023",1661,1080,1074,15,6,"UCE",0
13,"13085",2455,2146,2118,21,28,"UCE",0
25,"25189",2085,1348,1327,38,21,"UCE",1
28,"28027",1232,937,919,9,18,"UCE",1
32,"32079",1448,1103,1094,14,9,"UCE",0
43,"43065",443,278,270,8,8,"UCE",0
28,"28071",77,57,55,0,2,"UCE",0
13,"13008",473,362,360,4,2,"UCE",0
28,"28102",913,700,693,9,7,"UCE",0
25,"25220",1076,711,702,10,9,"UCE",1
13,"13041",298,225,225,1,0,"UCE",0
32,"32059",1983,1526,1510,27,16,"UCE",0
43,"43125",1008,706,701,10,5,"UCE",0
28,"28087",3150,2475,2453,26,22,"UCE",3
25,"25221",125,76,76,0,0,"UCE",0
25,"25210",1164,799,789,13,10,"UCE",0
29,"29027",2416,1907,1893,15,14,"UCE",1
28,"28057",1419,1084,1074,12,10,"UCE",0
28,"28021",418,334,328,4,6,"UCE",0
27,"27037",1205,857,845,13,12,"UCE",1
43,"43052",1001,669,636,12,33,"UCE",1
43,"43135",327,243,238,2,5,"UCE",1
13,"13020",4805,3475,3434,40,41,"UCE",0
25,"25135",1077,739,722,18,17,"UCE",0
28,"28903",29222,23945,23689,296,256,"UCE",2
28,"28134",55921,42676,42221,505,455,"UCE",16
43,"43076",467,308,300,7,8,"UCE",0
48,"48038",1087,826,821,7,5,"UCE",0
43,"43143",62,51,50,1,1,"UCE",0
13,"13080",418,310,309,1,1,"UCE",0
13,"13069",704,605,590,2,15,"UCE",0
27,"27022",5093,3535,3486,74,49,"UCE",4
25,"25008",1187,834,818,15,16,"UCE",0
25,"25099",1185,720,709,9,11,"UCE",0
29,"29010",1703,1411,1377,7,34,"UCE",2
13,"13022",403,314,314,2,0,"UCE",0
28,"28075",5127,3976,3916,42,60,"UCE",0
27,"27053",606,429,426,4,3,"UCE",0
28,"28063",268,209,203,4,6,"UCE",0
25,"25228",2907,2043,2021,43,22,"UCE",0
28,"28053",6035,4854,4783,61,71,"UCE",1
27,"27039",4363,3410,3346,63,64,"UCE",3
43,"43005",3559,2191,2147,47,44,"UCE",2
48,"48035",379,304,301,0,3,"UCE",0
25,"25146",227,150,149,0,1,"UCE",0
25,"25079",307,242,240,7,2,"UCE",0
28,"28152",14903,11954,11865,125,89,"UCE",1
25,"25161",361,222,218,1,4,"UCE",0
29,"29095",3431,2660,2607,23,53,"UCE",2
13,"13056",10945,8173,8070,111,103,"UCE",4
25,"25047",1048,760,748,24,12,"UCE",0
43,"43013",4369,2795,2747,54,48,"UCE",1
43,"43136",10163,6312,6197,121,115,"UCE",2
25,"25140",785,472,460,5,12,"UCE",0
48,"48074",3384,2441,2397,20,44,"UCE",2
32,"32039",1424,1084,1069,10,15,"UCE",1
28,"28024",156,132,132,5,0,"UCE",0
25,"25204",1313,888,881,21,7,"UCE",1
25,"25101",583,391,382,8,9,"UCE",0
25,"25215",399,229,226,4,3,"UCE",0
48,"48026",1093,881,875,3,6,"UCE",0
13,"13047",5822,4735,4650,52,85,"UCE",5
48,"48063",355,287,287,6,0,"UCE",0
29,"29012",9817,7063,6991,51,72,"UCE",3
32,"32040",1587,1226,1219,7,7,"UCE",0
28,"28160",7496,5680,5613,46,67,"UCE",0
25,"25224",144,93,91,6,2,"UCE",0
43,"43074",1697,1150,1120,25,30,"UCE",1
28,"28167",7818,6016,5942,82,74,"UCE",3
25,"25069",471,291,289,9,2,"UCE",0
28,"28017",1120,905,888,8,17,"UCE",0
43,"43154",136,97,96,6,1,"UCE",0
48,"48076",294,226,226,0,0,"UCE",0
32,"32012",912,763,756,8,7,"UCE",0
28,"28032",4469,3412,3369,32,43,"UCE",1
27,"27028",78862,57097,55890,1246,1207,"UCE",104
43,"43165",624,471,459,6,12,"UCE",0
25,"25164",404,270,264,5,6,"UCE",1
43,"43080",254,175,173,7,2,"UCE",0
48,"48054",23712,16643,16439,215,204,"UCE",19
25,"25142",387,265,264,5,1,"UCE",0
13,"13059",232,186,184,0,2,"UCE",0
25,"25125",450,297,289,10,8,"UCE",0
32,"32054",87289,63027,61875,1263,1152,"UCE",78
25,"25041",625,432,420,20,12,"UCE",0
13,"13016",708,555,553,2,2,"UCE",0
25,"25226",257,162,158,5,4,"UCE",0
43,"43033",772,547,533,4,14,"UCE",1
48,"48913",1231,936,922,10,14,"UCE",1
43,"43008",333,206,197,3,9,"UCE",0
28,"28101",222,158,158,4,0,"UCE",0
27,"27047",1851,1293,1273,16,20,"UCE",2
13,"13093",4333,3281,3229,43,52,"UCE",1
13,"13017",307,230,226,0,4,"UCE",0
25,"25143",86,58,58,1,0,"UCE",0
25,"25207",6253,3938,3872,91,66,"UCE",1
25,"25239",627,310,310,7,0,"UCE",0
43,"43001",706,481,473,12,8,"UCE",0
25,"25014",264,170,164,11,6,"UCE",0
27,"27062",681,535,532,7,3,"UCE",0
25,"25166",177,127,125,3,2,"UCE",0
27,"27001",2582,1687,1669,31,18,"UCE",3
28,"28151",3025,2237,2185,9,52,"UCE",1
27,"27026",2605,1785,1751,19,34,"UCE",0
32,"32048",1004,687,671,48,16,"UCE",0
25,"25905",386,264,258,12,6,"UCE",0
27,"27048",2404,1939,1909,36,30,"UCE",0
27,"27002",1835,1455,1437,16,18,"UCE",0
32,"32070",660,457,452,1,5,"UCE",0
32,"32029",557,426,424,1,2,"UCE",0
43,"43077",486,335,328,4,7,"UCE",0
32,"32025",1218,954,941,12,13,"UCE",0
43,"43011",1013,745,729,21,16,"UCE",1
25,"25059",796,580,575,9,5,"UCE",0
28,"28078",39,23,23,1,0,"UCE",0
32,"32034",1228,995,990,5,5,"UCE",1
25,"25006",362,231,228,2,3,"UCE",0
32,"32033",843,595,583,7,12,"UCE",0
29,"29052",245,151,151,0,0,"UCE",0
32,"32046",1375,976,962,3,14,"UCE",3
25,"25085",153,103,100,2,3,"UCE",0
43,"43043",3065,1952,1919,39,33,"UCE",2
43,"43093",3924,2507,2445,62,62,"UCE",2
28,"28112",168,138,137,0,1,"UCE",0
48,"48092",792,603,600,5,3,"UCE",0
27,"27034",1297,871,867,3,4,"UCE",0
32,"32071",1614,1121,1112,4,9,"UCE",1
43,"43150",1337,994,977,12,17,"UCE",0
43,"43027",177,129,128,6,1,"UCE",0
27,"27051",8224,6048,5953,108,95,"UCE",10
25,"25109",279,183,183,2,0,"UCE",0
25,"25016",2203,1375,1357,20,18,"UCE",2
25,"25129",175,105,105,3,0,"UCE",0
13,"13053",14718,10958,10766,159,192,"UCE",2
43,"43020",2119,1463,1427,26,36,"UCE",0
25,"25169",201,134,134,6,0,"UCE",0
43,"43012",3392,2346,2295,48,51,"UCE",2
43,"43004",6411,4089,4001,92,88,"UCE",1
28,"28106",72603,53231,52524,681,707,"UCE",24
25,"25243",3408,2280,2252,49,28,"UCE",1
25,"25120",90759,58761,57778,1325,983,"UCE",40
27,"27027",2111,1652,1605,21,47,"UCE",4
29,"29043",2596,1670,1647,24,23,"UCE",0
43,"43178",1262,891,870,24,21,"UCE",0
48,"48060",3689,2477,2466,12,11,"UCE",4
43,"43110",307,216,214,5,2,"UCE",0
28,"28179",1385,1039,1027,10,12,"UCE",0
13,"13021",459,358,355,5,3,"UCE",0
25,"25179",198,141,136,1,5,"UCE",0
43,"43032",587,418,413,9,5,"UCE",0
29,"29004",343,281,281,0,0,"UCE",0
25,"25032",71,44,42,1,2,"UCE",0
28,"28140",2665,2167,2141,26,26,"UCE",2
43,"43114",383,238,234,6,4,"UCE",0
28,"28137",1626,1231,1222,9,9,"UCE",0
28,"28025",426,336,332,2,4,"UCE",0
13,"13902",497,396,394,3,2,"UCE",3
25,"25105",146,90,89,1,1,"UCE",0
29,"29002",1246,896,893,11,3,"UCE",1
13,"13903",564,461,454,2,7,"UCE",0
28,"28097",127,94,92,0,2,"UCE",0
25,"25112",286,202,199,11,3,"UCE",0
43,"43071",975,677,664,14,13,"UCE",0
32,"32015",995,697,694,9,3,"UCE",1
28,"28009",13466,10392,10286,102,106,"UCE",4
28,"28121",185,153,152,0,1,"UCE",0
28,"28044",5403,4245,4188,27,57,"UCE",0
28,"28066",7033,5439,5383,45,56,"UCE",0
25,"25233",270,207,201,3,6,"UCE",0
25,"25077",474,281,277,5,4,"UCE",0
32,"32027",1156,850,836,15,14,"UCE",0
43,"43128",927,636,625,11,11,"UCE",0
48,"48041",721,588,585,9,3,"UCE",0
25,"25068",576,376,364,6,12,"UCE",0
43,"43169",477,377,364,8,13,"UCE",0
25,"25151",641,451,444,20,7,"UCE",0
25,"25901",315,196,189,3,7,"UCE",0
32,"32028",1805,1369,1354,16,15,"UCE",0
29,"29003",1133,902,900,5,2,"UCE",0
13,"13002",1576,1143,1134,4,9,"UCE",1
48,"48045",5060,3912,3849,31,63,"UCE",7
28,"28143",81,71,67,1,4,"UCE",0
43,"43028",2654,1620,1588,27,32,"UCE",0
25,"25040",10654,6905,6768,144,137,"UCE",4
48,"48911",373,300,296,1,4,"UCE",0
48,"48075",1915,1362,1325,15,37,"UCE",2
13,"13091",570,484,478,0,6,"UCE",1
43,"43064",2063,1420,1391,37,29,"UCE",0
28,"28172",7648,6130,6076,65,54,"UCE",1
28,"28015",14491,11562,11417,155,145,"UCE",4
13,"13004",1130,937,923,6,14,"UCE",0
28,"28056",782,604,586,6,18,"UCE",1
29,"29044",866,631,627,3,4,"UCE",0
32,"32058",5253,3872,3821,57,51,"UCE",5
25,"25092",135,100,97,2,3,"UCE",0
28,"28010",9309,7304,7229,71,75,"UCE",0
27,"27045",1149,817,812,7,5,"UCE",1
48,"48055",2620,1954,1934,22,20,"UCE",1
27,"27060",2938,2063,2028,26,35,"UCE",1
27,"27014",3511,2470,2437,45,33,"UCE",0
28,"28039",139,103,103,1,0,"UCE",0
25,"25165",301,202,198,6,4,"UCE",0
43,"43155",22951,14114,13856,326,258,"UCE",8
32,"32043",2679,2006,1985,14,21,"UCE",1
32,"32007",1674,1263,1243,4,20,"UCE",1
29,"29069",80337,50235,49723,690,512,"UCE",36
29,"29098",1312,1043,1036,22,7,"UCE",0
48,"48088",148,110,109,0,1,"UCE",0
43,"43123",70216,45627,44828,906,799,"UCE",36
32,"32019",11469,8297,8180,134,117,"UCE",5
27,"27046",1626,1177,1153,17,24,"UCE",0
48,"48066",350,277,277,0,0,"UCE",0
25,"25004",553,405,400,13,5,"UCE",0
25,"25100",207,125,115,2,10,"UCE",0
28,"28183",935,663,649,7,14,"UCE",0
43,"43902",2761,1836,1811,25,25,"UCE",1
48,"48089",2878,2120,2089,19,31,"UCE",1
48,"48034",13160,9290,9189,82,101,"UCE",14
43,"43124",532,366,358,3,8,"UCE",0
13,"13076",514,436,428,0,8,"UCE",0
48,"48086",2087,1432,1420,11,12,"UCE",0
32,"32064",561,439,437,5,2,"UCE",0
27,"27007",3015,2426,2374,42,52,"UCE",0
28,"28127",60108,48418,48039,568,379,"UCE",5
25,"25072",5921,3743,3637,81,106,"UCE",2
27,"27063",1916,1469,1440,14,29,"UCE",5
29,"29087",409,306,305,3,1,"UCE",0
13,"13025",321,257,254,1,3,"UCE",0
25,"25024",370,221,217,8,4,"UCE",0
25,"25044",195,136,134,1,2,"UCE",0
48,"48087",463,371,370,4,1,"UCE",1
29,"29032",6673,5204,5140,43,64,"UCE",1
29,"29060",775,573,572,1,1,"UCE",0
27,"27033",723,536,529,10,7,"UCE",1
29,"29054",39904,27540,27307,240,233,"UCE",18
28,"28006",74554,57439,56890,586,549,"UCE",25
29,"29055",1837,1478,1454,12,24,"UCE",1
29,"29082",29311,20220,20051,223,169,"UCE",11
43,"43101",146,94,93,3,1,"UCE",0
25,"25063",97,65,64,2,1,"UCE",0
28,"28171",4148,2972,2929,21,43,"UCE",0
43,"43084",573,383,378,6,5,"UCE",0
28,"28141",5568,4097,4051,31,46,"UCE",1
48,"48080",10161,6901,6815,95,86,"UCE",2
25,"25074",178,137,132,3,5,"UCE",0
28,"28064",143,112,110,1,2,"UCE",0
43,"43036",836,503,494,4,9,"UCE",1
13,"13071",41043,28435,28183,370,252,"UCE",6
43,"43109",2040,1332,1316,28,16,"UCE",0
32,"32084",1084,818,805,0,13,"UCE",0
43,"43003",307,187,184,10,3,"UCE",0
43,"43024",1459,958,937,17,21,"UCE",0
32,"32072",3949,2881,2841,32,40,"UCE",2
28,"28088",251,174,173,5,1,"UCE",0
25,"25046",438,299,286,6,13,"UCE",0
27,"27052",966,726,718,9,8,"UCE",0
13,"13009",1573,1265,1255,6,10,"UCE",0
48,"48910",3063,2122,2104,14,18,"UCE",4
28,"28132",10987,8066,7943,90,123,"UCE",3
28,"28029",538,416,414,4,2,"UCE",1
13,"13065",3011,2105,2088,24,17,"UCE",0
25,"25121",623,406,400,6,6,"UCE",0
43,"43044",3990,2768,2715,72,53,"UCE",1
43,"43069",194,131,127,3,4,"UCE",0
25,"25254",782,533,531,9,2,"UCE",0
29,"29093",2299,1767,1732,7,35,"UCE",0
43,"43100",3062,2058,2021,52,37,"UCE",3
28,"28003",196,154,151,2,3,"UCE",0
29,"29097",4076,3060,3018,40,42,"UCE",1
27,"27018",3871,2523,2489,32,34,"UCE",4
48,"48046",12635,9231,9161,61,70,"UCE",2
29,"29026",1130,815,799,7,16,"UCE",0
13,"13014",565,457,452,3,5,"UCE",1
25,"25223",951,562,546,14,16,"UCE",0
43,"43078",841,557,547,7,10,"UCE",0
43,"43177",338,242,236,6,6,"UCE",0
29,"29039",2822,2091,2074,8,17,"UCE",2
48,"48040",1274,936,921,10,15,"UCE",2
32,"32014",1271,939,925,9,14,"UCE",0
29,"29011",3013,1893,1876,7,17,"UCE",1
32,"32026",2775,2096,2064,37,32,"UCE",1
29,"29085",156,116,113,0,3,"UCE",0
48,"48909",194,163,163,0,0,"UCE",0
25,"25009",690,479,471,9,8,"UCE",0
28,"28180",5179,4033,3975,18,58,"UCE",0
43,"43172",378,268,266,8,2,"UCE",0
25,"25168",510,385,378,19,7,"UCE",0
43,"43171",13906,8978,8855,167,123,"UCE",16
29,"29079",2500,2016,2000,23,16,"UCE",0
48,"48051",225,157,156,0,1,"UCE",1
28,"28016",86,68,67,3,1,"UCE",0
25,"25086",569,379,370,4,9,"UCE",0
43,"43161",17199,10765,10547,197,218,"UCE",5
43,"43121",636,385,371,6,14,"UCE",0
48,"48019",3741,2613,2595,24,18,"UCE",2
13,"13035",1043,794,770,10,24,"UCE",0
27,"27012",1519,886,880,6,6,"UCE",1
27,"27017",1138,789,787,6,2,"UCE",0
43,"43118",439,318,313,7,5,"UCE",0
43,"43006",712,484,475,10,9,"UCE",0
28,"28067",3893,2996,2950,26,46,"UCE",0
48,"48907",351,290,290,1,0,"UCE",0
29,"29028",1253,887,876,8,11,"UCE",0
43,"43037",16656,9986,9812,163,174,"UCE",9
25,"25011",5241,3127,3080,48,47,"UCE",0
32,"32053",1500,1206,1199,19,7,"UCE",0
48,"48005",93,65,64,0,1,"UCE",1
25,"25231",515,402,395,4,7,"UCE",0
13,"13018",860,740,727,2,13,"UCE",1
43,"43162",4143,2892,2833,59,59,"UCE",0
25,"25124",161,110,109,4,1,"UCE",0
48,"48020",276378,191777,190141,2335,1636,"UCE",172
29,"29017",6766,5162,5114,48,48,"UCE",5
43,"43138",2719,1775,1730,45,45,"UCE",1
25,"25206",289,187,184,3,3,"UCE",0
43,"43098",362,251,247,1,4,"UCE",0
25,"25903",261,176,170,9,6,"UCE",0
48,"48901",4370,3156,3124,46,32,"UCE",1
32,"32090",834,662,657,4,5,"UCE",0
43,"43073",90,57,57,1,0,"UCE",0
29,"29061",1045,861,855,7,6,"UCE",0
43,"43901",8849,5651,5540,179,111,"UCE",2
13,"13049",838,654,648,0,6,"UCE",0
25,"25196",127,87,86,3,1,"UCE",0
28,"28155",529,427,416,2,11,"UCE",0
25,"25045",51,33,33,2,0,"UCE",0
43,"43090",1142,644,636,7,8,"UCE",0
29,"29033",1385,878,868,4,10,"UCE",0
25,"25093",657,465,455,8,10,"UCE",1
13,"13037",901,752,745,2,7,"UCE",0
25,"25183",485,336,327,6,9,"UCE",1
13,"13079",12220,9665,9502,177,163,"UCE",1
28,"28074",136617,106248,105095,1101,1153,"UCE",43
25,"25123",206,140,136,4,4,"UCE",0
25,"25023",4446,3079,3020,70,59,"UCE",0
28,"28047",38404,28739,28436,312,303,"UCE",6
13,"13050",533,427,421,3,6,"UCE",2
43,"43151",119,91,89,0,2,"UCE",0
29,"29067",420165,273593,271376,3342,2217,"UCE",159
43,"43079",387,259,255,26,4,"UCE",0
29,"29065",207,151,149,1,2,"UCE",0
29,"29096",2880,2012,1971,28,41,"UCE",1
32,"32036",1528,1217,1202,13,15,"UCE",0
13,"13043",251,208,206,1,2,"UCE",0
48,"48079",470,391,391,2,0,"UCE",0
25,"25075",122,85,83,0,2,"UCE",0
27,"27902",7198,5074,4976,106,98,"UCE",4
25,"25110",2662,1649,1602,44,47,"UCE",0
28,"28163",395,305,301,7,4,"UCE",0
13,"13029",102,90,89,0,1,"UCE",0
28,"28901",765,579,567,2,12,"UCE",0
28,"28068",10502,7857,7778,68,79,"UCE",5
43,"43173",114,65,64,0,1,"UCE",0
25,"25127",226,134,130,2,4,"UCE",0
27,"27003",2064,1531,1516,19,15,"UCE",2
27,"27065",13035,9432,9254,168,178,"UCE",4
25,"25025",1307,874,859,32,15,"UCE",0
28,"28149",5276,4132,4063,43,69,"UCE",1
48,"48905",2600,1903,1869,14,34,"UCE",0
27,"27066",12908,9554,9329,171,225,"UCE",12
43,"43149",711,529,516,13,13,"UCE",0
27,"27020",3807,3204,3161,33,43,"UCE",1
32,"32075",3839,2957,2910,51,47,"UCE",2
25,"25906",235,160,154,3,6,"UCE",0
29,"29024",414,271,261,6,10,"UCE",0
32,"32035",1632,1100,1088,8,12,"UCE",1
27,"27030",3744,2587,2525,32,62,"UCE",4
32,"32055",1412,1056,1037,5,19,"UCE",0
25,"25253",175,132,129,1,3,"UCE",0
13,"13038",1770,1397,1380,8,17,"UCE",0
28,"28089",3531,2786,2753,25,33,"UCE",0
25,"25010",206,119,118,7,1,"UCE",0
48,"48048",547,423,423,5,0,"UCE",0
28,"28104",11704,9455,9361,119,94,"UCE",3
28,"28157",605,452,446,2,6,"UCE",0
43,"43039",117,85,83,3,2,"UCE",0
28,"28055",932,713,707,5,6,"UCE",0
43,"43132",365,217,214,8,3,"UCE",0
29,"29022",202,142,141,2,1,"UCE",0
28,"28083",8037,6078,6025,66,53,"UCE",2
25,"25064",122,91,88,7,3,"UCE",0
25,"25031",57,34,34,1,0,"UCE",0
13,"13087",22953,16674,16376,298,298,"UCE",8
43,"43022",1559,1097,1074,22,23,"UCE",0
28,"28107",443,338,333,7,5,"UCE",0
25,"25020",328,216,209,4,7,"UCE",0
13,"13089",1906,1610,1553,12,57,"UCE",1
25,"25216",250,175,173,5,2,"UCE",0
43,"43083",141,97,97,2,0,"UCE",0
43,"43122",92,65,61,0,4,"UCE",0
25,"25155",714,490,485,8,5,"UCE",0
32,"32042",1784,1292,1282,13,10,"UCE",1
43,"43119",739,500,496,5,4,"UCE",1
48,"48062",317,263,262,1,1,"UCE",0
32,"32063",2127,1469,1444,22,25,"UCE",2
28,"28037",1598,1263,1250,10,13,"UCE",0
29,"29072",3258,2484,2447,30,37,"UCE",0
28,"28175",780,641,630,8,11,"UCE",0
48,"48010",427,303,300,2,3,"UCE",0
43,"43063",588,358,350,13,8,"UCE",0
43,"43086",5269,3275,3196,92,79,"UCE",1
25,"25060",92,53,52,1,1,"UCE",0
25,"25909",141,82,78,0,4,"UCE",0
43,"43029",330,202,194,6,8,"UCE",0
43,"43115",171,112,110,3,2,"UCE",0
28,"28042",1091,814,808,5,6,"UCE",0
13,"13005",23052,18002,17700,255,302,"UCE",4
28,"28124",83,55,53,0,2,"UCE",0
43,"43175",590,419,411,8,8,"UCE",0
28,"28011",437,318,315,2,3,"UCE",2
32,"32010",457,362,356,0,6,"UCE",1
28,"28109",1621,1121,1104,9,17,"UCE",2
27,"27042",1888,1427,1407,12,20,"UCE",1
13,"13013",7141,5682,5564,60,118,"UCE",1
25,"25042",211,131,127,0,4,"UCE",0
25,"25193",771,509,501,8,8,"UCE",0
25,"25163",237,147,142,2,5,"UCE",0
29,"29040",1934,1344,1332,12,12,"UCE",0
29,"29031",1652,1123,1118,11,5,"UCE",0
13,"13046",786,654,644,2,10,"UCE",0
28,"28061",19624,15082,14905,162,177,"UCE",4
25,"25022",119,83,83,0,0,"UCE",0
25,"25907",506,297,292,6,5,"UCE",0
48,"48028",767,623,621,1,2,"UCE",0
48,"48036",23973,16491,16344,179,147,"UCE",14
28,"28085",3794,2980,2933,18,47,"UCE",0
28,"28082",5144,3967,3905,46,62,"UCE",0
29,"29045",1750,1246,1239,6,7,"UCE",0
13,"13036",837,671,666,3,5,"UCE",1
29,"29091",8777,6226,6126,64,100,"UCE",1
28,"28046",4208,3297,3272,31,25,"UCE",1
48,"48058",977,706,700,2,6,"UCE",1
43,"43047",4064,2412,2352,50,60,"UCE",6
43,"43025",660,453,446,13,7,"UCE",0
13,"13096",7716,5759,5659,70,100,"UCE",1
13,"13095",94,70,70,1,0,"UCE",0
27,"27055",1494,1120,1107,8,13,"UCE",0
48,"48008",600,432,428,3,4,"UCE",0
43,"43147",528,393,380,7,13,"UCE",0
27,"27901",2559,1847,1831,27,16,"UCE",2
25,"25103",125,82,80,4,2,"UCE",0
25,"25019",4626,2971,2932,54,39,"UCE",2
43,"43021",381,218,213,3,5,"UCE",0
28,"28059",4061,3169,3130,38,39,"UCE",0
43,"43045",156,110,109,1,1,"UCE",0
28,"28116",666,507,498,5,9,"UCE",1
28,"28133",5868,4236,4144,23,92,"UCE",3
25,"25218",94,75,73,1,2,"UCE",0
25,"25062",806,515,497,11,18,"UCE",0
25,"25176",341,243,240,7,3,"UCE",0
43,"43144",1187,787,772,12,15,"UCE",1
48,"48022",2396,1524,1504,12,20,"UCE",1
29,"29036",670,504,499,4,5,"UCE",0
25,"25201",119,78,76,3,2,"UCE",0
43,"43139",2166,1319,1270,37,49,"UCE",0
27,"27010",4725,3427,3368,55,59,"UCE",3
43,"43023",244,179,177,8,2,"UCE",0
43,"43055",2002,1404,1374,36,30,"UCE",0
29,"29076",2022,1384,1374,14,10,"UCE",1
25,"25118",378,232,226,4,6,"UCE",0
48,"48072",1009,796,787,3,9,"UCE",0
43,"43042",2071,1504,1485,28,19,"UCE",3
48,"48068",1577,1224,1213,4,11,"UCE",2
13,"13033",1719,1436,1419,6,17,"UCE",0
48,"48003",14142,10268,10167,84,101,"UCE",5
29,"29018",2088,1565,1540,9,25,"UCE",1
28,"28168",1144,821,810,15,11,"UCE",1
28,"28013",38226,27886,27547,246,339,"UCE",4
27,"27050",3236,2475,2438,11,37,"UCE",5
13,"13070",769,653,640,1,13,"UCE",0
28,"28070",139,98,97,0,1,"UCE",0
25,"25021",2693,1632,1605,40,27,"UCE",0
28,"28094",774,557,551,5,6,"UCE",0
48,"48904",3510,2682,2665,26,17,"UCE",1
43,"43168",106,70,69,2,1,"UCE",0
28,"28146",1672,1220,1205,4,15,"UCE",0
25,"25153",215,165,161,0,4,"UCE",0
43,"43056",931,537,515,18,22,"UCE",0
43,"43096",103,81,77,3,4,"UCE",0
27,"27057",11297,8174,8005,162,169,"UCE",10
32,"32091",1971,1472,1466,12,6,"UCE",0
32,"32050",2663,1991,1974,17,17,"UCE",0
25,"25089",107,66,64,0,2,"UCE",0
48,"48030",626,487,483,0,4,"UCE",0
13,"13084",973,800,793,6,7,"UCE",0
43,"43040",350,251,246,18,5,"UCE",0
48,"48025",882,652,644,2,8,"UCE",0
28,"28031",1981,1524,1500,9,24,"UCE",2
27,"27040",3421,2718,2693,27,25,"UCE",2
27,"27013",3950,3156,3090,39,66,"UCE",3
43,"43153",10307,6572,6450,94,122,"UCE",3
43,"43120",454,287,283,1,4,"UCE",0
48,"48085",9893,6960,6885,93,75,"UCE",6
25,"25181",189,128,123,3,5,"UCE",0
25,"25186",231,168,168,3,0,"UCE",0
43,"43059",264,185,185,4,0,"UCE",0
32,"32041",884,576,568,2,8,"UCE",0
25,"25057",198,140,136,2,4,"UCE",0
32,"32021",1043,793,788,7,5,"UCE",1
32,"32087",1935,1609,1591,11,18,"UCE",1
48,"48061",773,585,582,6,3,"UCE",1
43,"43018",430,350,337,7,13,"UCE",0
25,"25033",1125,738,718,17,20,"UCE",1
32,"32009",10752,7778,7684,120,94,"UCE",4
48,"48096",6607,5007,4900,54,107,"UCE",3
25,"25255",468,318,309,9,9,"UCE",0
32,"32066",634,492,488,0,4,"UCE",0
13,"13045",744,615,608,6,7,"UCE",0
25,"25245",445,312,306,4,6,"UCE",0
25,"25136",106,79,79,1,0,"UCE",0
28,"28170",2503,1744,1727,20,17,"UCE",1
25,"25212",233,185,185,8,0,"UCE",0
29,"29088",2784,2019,1975,14,44,"UCE",0
28,"28122",504,367,366,2,1,"UCE",0
13,"13086",209,167,166,0,1,"UCE",0
13,"13044",2747,1996,1950,20,46,"UCE",1
43,"43104",1821,1209,1178,34,31,"UCE",0
25,"25139",549,358,357,5,1,"UCE",0
28,"28030",1591,1268,1230,12,38,"UCE",0
48,"48013",81335,54452,53803,771,649,"UCE",67
13,"13040",933,755,744,4,11,"UCE",1
43,"43095",2434,1658,1624,27,34,"UCE",1
43,"43067",626,445,431,21,14,"UCE",0
25,"25194",440,292,283,11,9,"UCE",0
29,"29046",2777,2032,2013,10,19,"UCE",1
13,"13068",1058,801,793,4,8,"UCE",0
28,"28100",3970,2903,2865,32,38,"UCE",1
27,"27056",1388,1043,1026,16,17,"UCE",2
32,"32045",2640,1999,1980,23,19,"UCE",2
48,"48024",1026,845,841,3,4,"UCE",0
29,"29057",413,311,308,2,3,"UCE",0
25,"25180",245,167,165,3,2,"UCE",0
48,"48069",12381,8760,8672,66,88,"UCE",4
28,"28154",5232,3910,3860,40,50,"UCE",0
28,"28034",356,278,276,1,2,"UCE",0
32,"32086",2874,2026,2003,18,23,"UCE",0
25,"25070",888,594,582,18,12,"UCE",1
13,"13011",5166,3555,3500,31,55,"UCE",3
27,"27049",1554,1073,1062,6,11,"UCE",0
32,"32082",1403,1055,1047,9,8,"UCE",0
43,"43014",14146,9153,8915,204,238,"UCE",2
29,"29030",839,669,668,5,1,"UCE",0
13,"13081",684,553,527,1,26,"UCE",0
28,"28166",325,269,268,8,1,"UCE",0
48,"48090",6153,4682,4571,40,111,"UCE",3
13,"13007",1319,1069,1051,18,18,"UCE",1
25,"25192",799,543,527,19,16,"UCE",0
43,"43152",472,355,351,9,4,"UCE",0
29,"29100",2442,1834,1824,14,10,"UCE",0
25,"25175",221,151,150,0,1,"UCE",0
25,"25082",265,156,155,8,1,"UCE",0
29,"29063",358,272,271,2,1,"UCE",1
48,"48057",5934,4407,4385,27,22,"UCE",0
25,"25145",88,67,67,2,0,"UCE",0
43,"43002",1790,1252,1226,17,26,"UCE",1
29,"29007",25572,17726,17564,227,162,"UCE",3
45,"45005",267,223,218,4,5,"U.C.I.T.",0
45,"45171",1359,1114,1093,13,21,"U.C.I.T.",1
45,"45147",598,484,478,9,6,"U.C.I.T.",0
45,"45202",3876,3037,2984,13,53,"U.C.I.T.",0
45,"45152",653,503,497,2,6,"U.C.I.T.",0
45,"45087",8428,6434,6292,74,142,"U.C.I.T.",7
45,"45190",502,425,414,6,11,"U.C.I.T.",1
45,"45140",1087,885,867,6,18,"U.C.I.T.",1
45,"45049",394,315,315,6,0,"U.C.I.T.",0
45,"45205",6333,4544,4451,58,93,"U.C.I.T.",5
45,"45028",3696,3059,3024,40,35,"U.C.I.T.",0
45,"45163",8239,6203,6073,103,130,"U.C.I.T.",9
45,"45184",219,150,148,3,2,"U.C.I.T.",1
45,"45138",1185,998,973,5,25,"U.C.I.T.",0
45,"45008",158,129,127,0,2,"U.C.I.T.",0
45,"45032",471,340,333,2,7,"U.C.I.T.",0
45,"45112",2022,1470,1423,12,47,"U.C.I.T.",0
45,"45082",1333,1143,1123,14,20,"U.C.I.T.",1
45,"45186",3217,2573,2527,24,46,"U.C.I.T.",0
45,"45045",1313,992,979,12,13,"U.C.I.T.",0
45,"45110",1918,1585,1570,10,15,"U.C.I.T.",0
45,"45018",445,332,322,4,10,"U.C.I.T.",0
45,"45166",1734,1460,1429,8,31,"U.C.I.T.",1
45,"45161",11339,7989,7869,95,120,"U.C.I.T.",9
45,"45119",3274,2279,2236,37,43,"U.C.I.T.",3
45,"45088",2038,1379,1356,14,23,"U.C.I.T.",6
45,"45013",1870,1504,1486,5,18,"U.C.I.T.",1
45,"45116",682,576,565,0,11,"U.C.I.T.",1
45,"45196",1363,1092,1076,3,16,"U.C.I.T.",0
45,"45128",2558,1831,1806,20,25,"U.C.I.T.",1
45,"45194",57,41,41,0,0,"U.C.I.T.",0
45,"45162",773,599,594,3,5,"U.C.I.T.",0
45,"45164",191,160,158,0,2,"U.C.I.T.",0
45,"45062",1161,959,928,8,31,"U.C.I.T.",0
45,"45086",491,406,399,3,7,"U.C.I.T.",0
45,"45107",3006,2344,2299,32,45,"U.C.I.T.",4
45,"45201",3439,2353,2317,31,36,"U.C.I.T.",10
45,"45173",9133,7147,7035,78,112,"U.C.I.T.",6
45,"45024",1105,870,856,16,14,"U.C.I.T.",2
45,"45034",1375,1108,1079,18,29,"U.C.I.T.",2
45,"45150",471,388,382,1,6,"U.C.I.T.",0
45,"45100",205,169,169,0,0,"U.C.I.T.",0
45,"45102",3539,2581,2533,23,48,"U.C.I.T.",1
45,"45079",368,278,273,1,5,"U.C.I.T.",0
45,"45074",428,349,343,3,6,"U.C.I.T.",0
45,"45083",421,353,345,0,8,"U.C.I.T.",0
45,"45132",1916,1487,1473,9,14,"U.C.I.T.",3
45,"45033",407,302,295,3,7,"U.C.I.T.",0
45,"45069",1791,1409,1389,8,20,"U.C.I.T.",2
45,"45065",317,261,258,0,3,"U.C.I.T.",0
45,"45124",2183,1868,1823,20,45,"U.C.I.T.",0
45,"45108",564,461,456,2,5,"U.C.I.T.",0
45,"45094",441,358,353,6,5,"U.C.I.T.",0
45,"45198",1950,1661,1641,9,20,"U.C.I.T.",1
45,"45003",607,515,511,3,4,"U.C.I.T.",3
45,"45104",457,375,370,2,5,"U.C.I.T.",0
45,"45148",340,256,256,1,0,"U.C.I.T.",0
45,"45181",2276,1788,1764,10,24,"U.C.I.T.",2
45,"45175",698,587,579,5,8,"U.C.I.T.",0
45,"45007",747,641,632,1,9,"U.C.I.T.",2
45,"45057",222,197,189,0,8,"U.C.I.T.",0
45,"45041",3617,2672,2635,21,37,"U.C.I.T.",1
45,"45099",3449,2451,2405,22,46,"U.C.I.T.",5
45,"45113",2094,1589,1555,6,34,"U.C.I.T.",2
45,"45154",1459,1148,1140,12,8,"U.C.I.T.",4
45,"45123",2961,2081,2049,30,32,"U.C.I.T.",1
45,"45188",2883,2180,2151,30,29,"U.C.I.T.",6
45,"45012",683,572,566,10,6,"U.C.I.T.",32
45,"45020",1396,1165,1151,15,14,"U.C.I.T.",3
45,"45172",757,597,594,7,3,"U.C.I.T.",56
45,"45016",3804,2926,2876,52,50,"U.C.I.T.",4
45,"45189",655,510,502,3,8,"U.C.I.T.",0
45,"45091",419,311,309,5,2,"U.C.I.T.",0
45,"45139",231,198,194,0,4,"U.C.I.T.",0
45,"45170",257,186,183,0,3,"U.C.I.T.",0
45,"45134",1606,1260,1242,10,18,"U.C.I.T.",1
45,"45185",7912,6321,6180,68,141,"U.C.I.T.",4
45,"45058",409,334,332,2,2,"U.C.I.T.",2
45,"45053",8208,6763,6663,103,100,"U.C.I.T.",4
45,"45151",631,474,470,1,4,"U.C.I.T.",2
45,"45182",1077,873,856,11,17,"U.C.I.T.",0
45,"45021",2399,1834,1804,23,30,"U.C.I.T.",32
45,"45160",1104,911,896,12,15,"U.C.I.T.",0
45,"45055",1052,886,870,10,16,"U.C.I.T.",0
45,"45146",117,99,98,0,1,"U.C.I.T.",0
45,"45118",1980,1412,1390,13,22,"U.C.I.T.",1
45,"45098",2273,1799,1756,11,43,"U.C.I.T.",1
45,"45009",588,430,422,2,8,"U.C.I.T.",1
45,"45193",661,557,548,1,9,"U.C.I.T.",1
45,"45027",433,352,349,1,3,"U.C.I.T.",1
45,"45025",1237,919,907,11,12,"U.C.I.T.",3
45,"45127",739,550,538,5,12,"U.C.I.T.",1
45,"45056",2246,1523,1502,16,21,"U.C.I.T.",6
45,"45031",2773,2011,1975,25,36,"U.C.I.T.",2
45,"45105",426,326,322,2,4,"U.C.I.T.",1
45,"45040",1504,1058,1046,5,12,"U.C.I.T.",3
45,"45077",554,430,423,7,7,"U.C.I.T.",0
45,"45115",2600,2140,2105,14,35,"U.C.I.T.",6
45,"45176",3570,2619,2583,45,36,"U.C.I.T.",4
45,"45156",3528,2985,2924,19,61,"U.C.I.T.",2
45,"45144",839,701,691,11,10,"U.C.I.T.",0
45,"45071",1896,1592,1575,21,17,"U.C.I.T.",1
45,"45095",742,606,585,2,21,"U.C.I.T.",1
45,"45093",168,133,133,0,0,"U.C.I.T.",0
45,"45111",65,47,44,1,3,"U.C.I.T.",0
45,"45155",481,382,375,3,7,"U.C.I.T.",0
45,"45192",2549,2178,2155,39,23,"U.C.I.T.",5
45,"45167",1552,1296,1278,14,18,"U.C.I.T.",0
45,"45159",100,84,84,1,0,"U.C.I.T.",0
45,"45017",268,215,212,1,3,"U.C.I.T.",0
45,"45197",1972,1570,1538,8,32,"U.C.I.T.",0
45,"45036",704,559,537,4,22,"U.C.I.T.",0
45,"45106",7666,6045,5945,92,100,"U.C.I.T.",5
45,"45081",16099,12232,12079,154,153,"U.C.I.T.",59
45,"45067",2385,1923,1878,19,45,"U.C.I.T.",2
45,"45075",205,162,159,4,3,"U.C.I.T.",0
45,"45130",354,287,283,2,4,"U.C.I.T.",3
45,"45052",2793,2247,2212,38,35,"U.C.I.T.",5
45,"45153",1704,1376,1353,9,23,"U.C.I.T.",0
45,"45076",603,420,419,3,1,"U.C.I.T.",5
45,"45063",504,378,372,3,6,"U.C.I.T.",0
45,"45026",269,200,198,2,2,"U.C.I.T.",0
45,"45089",1615,1238,1221,16,17,"U.C.I.T.",1
45,"45136",5891,4414,4368,55,46,"U.C.I.T.",2
45,"45078",1451,1243,1228,7,15,"U.C.I.T.",2
45,"45131",327,262,258,1,4,"U.C.I.T.",12
45,"45103",457,400,394,0,6,"U.C.I.T.",0
45,"45073",351,265,261,3,4,"U.C.I.T.",0
45,"45059",1758,1465,1437,10,28,"U.C.I.T.",0
45,"45195",2229,1806,1784,11,22,"U.C.I.T.",3
45,"45122",4828,3816,3746,48,70,"U.C.I.T.",5
45,"45121",6553,4720,4653,43,67,"U.C.I.T.",10
45,"45004",603,497,494,6,3,"U.C.I.T.",0
45,"45015",624,485,480,2,5,"U.C.I.T.",25
45,"45064",3801,2987,2953,38,34,"U.C.I.T.",3
45,"45114",608,476,468,3,8,"U.C.I.T.",0
45,"45101",3761,3212,3181,19,31,"U.C.I.T.",0
45,"45180",2714,2018,1980,19,38,"U.C.I.T.",1
45,"45109",3030,2507,2417,30,90,"U.C.I.T.",54
45,"45085",1511,1111,1100,10,11,"U.C.I.T.",1
45,"45050",508,385,378,0,7,"U.C.I.T.",1
45,"45142",7974,6294,6178,89,116,"U.C.I.T.",13
45,"45143",1302,916,901,6,15,"U.C.I.T.",1
45,"45080",3,3,3,0,0,"U.C.I.T.",0
45,"45191",601,506,498,1,8,"U.C.I.T.",0
45,"45042",184,154,151,3,3,"U.C.I.T.",0
45,"45090",396,335,333,0,2,"U.C.I.T.",0
45,"45200",4633,3768,3672,37,96,"U.C.I.T.",2
45,"45901",811,595,591,2,4,"U.C.I.T.",1
45,"45037",1730,1325,1304,15,21,"U.C.I.T.",1
45,"45054",4285,3321,3274,32,47,"U.C.I.T.",4
45,"45066",7334,5602,5536,52,66,"U.C.I.T.",7
45,"45046",2455,1884,1862,11,22,"U.C.I.T.",1
45,"45048",388,310,308,2,2,"U.C.I.T.",0
45,"45157",2097,1519,1499,15,20,"U.C.I.T.",2
45,"45135",4437,3621,3550,44,71,"U.C.I.T.",1
45,"45043",827,679,670,3,9,"U.C.I.T.",10
45,"45019",7033,5207,5110,89,97,"U.C.I.T.",11
45,"45060",204,151,148,1,3,"U.C.I.T.",0
45,"45137",1610,1057,1047,11,10,"U.C.I.T.",1
45,"45199",2712,1817,1796,17,21,"U.C.I.T.",7
45,"45002",2500,1771,1756,26,15,"U.C.I.T.",4
45,"45126",278,188,187,0,1,"U.C.I.T.",0
45,"45179",608,476,471,3,5,"U.C.I.T.",0
45,"45174",343,289,288,0,1,"U.C.I.T.",0
45,"45183",2189,1537,1514,10,23,"U.C.I.T.",2
45,"45051",1658,1305,1293,20,12,"U.C.I.T.",1
45,"45133",2803,2241,2199,18,42,"U.C.I.T.",3
45,"45035",307,236,236,3,0,"U.C.I.T.",0
45,"45006",1524,1128,1110,13,18,"U.C.I.T.",2
45,"45039",236,197,190,2,7,"U.C.I.T.",0
45,"45070",1415,1175,1162,11,13,"U.C.I.T.",1
45,"45061",2523,1839,1813,20,26,"U.C.I.T.",0
45,"45204",621,500,497,1,3,"U.C.I.T.",1
45,"45158",2577,1948,1909,18,39,"U.C.I.T.",1
45,"45117",800,679,668,7,11,"U.C.I.T.",1
45,"45068",164,135,133,1,2,"U.C.I.T.",0
45,"45168",61519,47265,46528,736,737,"U.C.I.T.",91
45,"45129",145,121,120,0,1,"U.C.I.T.",0
45,"45029",233,207,202,4,5,"U.C.I.T.",1
45,"45010",471,374,372,2,2,"U.C.I.T.",0
45,"45014",4087,2851,2816,36,35,"U.C.I.T.",4
45,"45011",316,271,268,1,3,"U.C.I.T.",2
45,"45169",239,183,183,1,0,"U.C.I.T.",0
45,"45001",1901,1468,1431,14,37,"U.C.I.T.",1
45,"45177",2295,1898,1857,15,41,"U.C.I.T.",3
45,"45187",4187,3581,3512,25,69,"U.C.I.T.",4
45,"45022",427,317,314,8,3,"U.C.I.T.",0
45,"45023",1936,1476,1456,18,20,"U.C.I.T.",3
45,"45097",1094,934,925,9,9,"U.C.I.T.",3
45,"45030",486,378,374,4,4,"U.C.I.T.",14
45,"45145",2430,1866,1821,13,45,"U.C.I.T.",3
45,"45149",638,542,533,2,9,"U.C.I.T.",0
45,"45120",159,125,122,0,3,"U.C.I.T.",0
45,"45047",2404,1685,1662,7,23,"U.C.I.T.",25
45,"45141",981,815,790,6,25,"U.C.I.T.",1
45,"45165",62818,47242,46629,549,613,"U.C.I.T.",49
45,"45203",2535,1883,1829,21,54,"U.C.I.T.",8
45,"45096",1021,800,778,5,22,"U.C.I.T.",0
45,"45125",2407,1977,1949,22,28,"U.C.I.T.",1
45,"45092",252,223,221,0,2,"U.C.I.T.",0
45,"45038",3125,2401,2374,33,27,"U.C.I.T.",2
45,"45084",2395,1879,1842,21,37,"U.C.I.T.",6
45,"45072",690,535,532,7,3,"U.C.I.T.",0
31,"31905",2707,1913,1881,32,32,"UPN-PP",679
31,"31262",219,158,157,4,1,"UPN-PP",52
31,"31109",1365,946,934,11,12,"UPN-PP",328
31,"31158",264,174,173,1,1,"UPN-PP",64
31,"31103",51,40,40,3,0,"UPN-PP",24
31,"31081",335,249,243,8,6,"UPN-PP",46
31,"31026",154,125,122,1,3,"UPN-PP",56
31,"31091",365,227,224,3,3,"UPN-PP",31
31,"31060",12916,8830,8687,158,143,"UPN-PP",2703
31,"31180",240,174,170,5,4,"UPN-PP",86
31,"31006",1988,1434,1395,22,39,"UPN-PP",637
31,"31016",7377,5149,5072,101,77,"UPN-PP",930
31,"31046",58,41,41,3,0,"UPN-PP",26
31,"31196",40,35,35,1,0,"UPN-PP",9
31,"31160",111,93,93,7,0,"UPN-PP",44
31,"31054",498,310,308,1,2,"UPN-PP",68
31,"31038",1372,982,968,17,14,"UPN-PP",429
31,"31040",197,137,135,2,2,"UPN-PP",50
31,"31212",173,117,117,3,0,"UPN-PP",75
31,"31121",79,53,52,2,1,"UPN-PP",26
31,"31172",375,295,288,11,7,"UPN-PP",125
31,"31106",676,534,518,10,16,"UPN-PP",246
31,"31031",234,144,143,1,1,"UPN-PP",26
31,"31195",186,127,126,1,1,"UPN-PP",35
31,"31036",957,631,616,22,15,"UPN-PP",221
31,"31193",1312,969,948,33,21,"UPN-PP",340
31,"31086",11499,8520,8389,214,131,"UPN-PP",3143
31,"31137",215,108,106,1,2,"UPN-PP",35
31,"31069",860,660,647,2,13,"UPN-PP",292
31,"31170",46,40,39,3,1,"UPN-PP",11
31,"31059",204,140,139,3,1,"UPN-PP",33
31,"31154",229,133,133,4,0,"UPN-PP",29
31,"31232",24440,17810,17436,420,374,"UPN-PP",8360
31,"31002",421,292,284,5,8,"UPN-PP",136
31,"31123",652,379,373,8,6,"UPN-PP",119
31,"31167",859,600,593,11,7,"UPN-PP",243
31,"31233",103,87,82,2,5,"UPN-PP",45
31,"31224",980,691,681,9,10,"UPN-PP",345
31,"31252",91,60,58,0,2,"UPN-PP",21
31,"31010",5788,3716,3637,48,79,"UPN-PP",855
31,"31249",1926,1376,1361,30,15,"UPN-PP",525
31,"31157",3567,2435,2393,32,42,"UPN-PP",1121
31,"31240",553,360,359,3,1,"UPN-PP",53
31,"31239",302,229,224,7,5,"UPN-PP",82
31,"31023",5338,3986,3920,120,66,"UPN-PP",1686
31,"31171",738,521,495,7,26,"UPN-PP",164
31,"31151",77,49,49,2,0,"UPN-PP",18
31,"31260",1263,788,780,11,8,"UPN-PP",342
31,"31050",6253,4045,3987,74,58,"UPN-PP",1311
31,"31214",95,64,64,1,0,"UPN-PP",17
31,"31177",264,162,158,3,4,"UPN-PP",74
31,"31164",604,462,448,9,14,"UPN-PP",206
31,"31139",172,97,97,1,0,"UPN-PP",54
31,"31155",264,187,183,7,4,"UPN-PP",70
31,"31152",1406,1003,975,23,28,"UPN-PP",479
31,"31189",1229,745,740,5,5,"UPN-PP",147
31,"31114",384,320,318,37,2,"UPN-PP",107
31,"31255",100,78,78,1,0,"UPN-PP",41
31,"31904",1590,1054,1031,19,23,"UPN-PP",296
31,"31265",81,52,50,0,2,"UPN-PP",22
31,"31263",241,135,132,0,3,"UPN-PP",9
31,"31062",1103,849,832,7,17,"UPN-PP",320
31,"31063",96,77,75,0,2,"UPN-PP",41
31,"31216",3911,2699,2653,82,46,"UPN-PP",1003
31,"31124",209,139,138,1,1,"UPN-PP",88
31,"31198",38,33,33,0,0,"UPN-PP",5
31,"31183",667,516,508,8,8,"UPN-PP",226
31,"31119",49,28,28,0,0,"UPN-PP",12
31,"31015",1989,1404,1380,29,24,"UPN-PP",677
31,"31146",46,34,34,1,0,"UPN-PP",18
31,"31143",105,62,58,2,4,"UPN-PP",42
31,"31166",274,183,182,2,1,"UPN-PP",108
31,"31174",115,72,70,1,2,"UPN-PP",33
31,"31188",185,139,137,2,2,"UPN-PP",39
31,"31141",132,100,98,1,2,"UPN-PP",72
31,"31104",1990,1374,1355,20,19,"UPN-PP",533
31,"31058",240,184,179,0,5,"UPN-PP",61
31,"31092",676,447,446,6,1,"UPN-PP",151
31,"31257",827,598,585,16,13,"UPN-PP",212
31,"31093",305,207,203,2,4,"UPN-PP",51
31,"31012",839,577,570,10,7,"UPN-PP",221
31,"31256",113,64,64,0,0,"UPN-PP",13
31,"31056",183,123,122,4,1,"UPN-PP",60
31,"31136",438,283,283,10,0,"UPN-PP",72
31,"31144",840,509,508,7,1,"UPN-PP",126
31,"31045",501,384,377,16,7,"UPN-PP",109
31,"31253",123,102,97,0,5,"UPN-PP",11
31,"31032",1785,1330,1305,24,25,"UPN-PP",509
31,"31211",25,14,14,2,0,"UPN-PP",10
31,"31049",733,479,479,4,0,"UPN-PP",89
31,"31042",2719,2100,2057,27,43,"UPN-PP",936
31,"31126",372,247,244,6,3,"UPN-PP",47
31,"31134",195,134,132,3,2,"UPN-PP",48
31,"31247",171,121,121,1,0,"UPN-PP",49
31,"31237",198,137,136,7,1,"UPN-PP",57
31,"31192",148,107,104,1,3,"UPN-PP",34
31,"31066",915,660,647,19,13,"UPN-PP",306
31,"31061",67,47,47,2,0,"UPN-PP",27
31,"31029",987,693,680,16,13,"UPN-PP",335
31,"31217",382,256,244,5,12,"UPN-PP",124
31,"31131",841,610,594,12,16,"UPN-PP",285
31,"31902",3722,2670,2632,77,38,"UPN-PP",953
31,"31033",55,34,34,0,0,"UPN-PP",0
31,"31165",2868,2094,2046,43,48,"UPN-PP",931
31,"31184",66,60,59,0,1,"UPN-PP",27
31,"31200",763,527,514,17,13,"UPN-PP",128
31,"31028",217,129,128,1,1,"UPN-PP",35
31,"31190",48,34,34,1,0,"UPN-PP",12
31,"31099",68,50,50,0,0,"UPN-PP",27
31,"31089",246,198,195,4,3,"UPN-PP",114
31,"31907",9914,7394,7282,198,112,"UPN-PP",2496
31,"31133",48,34,34,3,0,"UPN-PP",2
31,"31161",321,251,246,5,5,"UPN-PP",60
31,"31082",634,402,398,10,4,"UPN-PP",80
31,"31065",1927,1391,1362,39,29,"UPN-PP",658
31,"31153",2246,1504,1487,13,17,"UPN-PP",215
31,"31041",1397,938,913,26,25,"UPN-PP",376
31,"31003",131,101,101,1,0,"UPN-PP",25
31,"31235",189,111,110,0,1,"UPN-PP",34
31,"31208",2574,2003,1966,32,37,"UPN-PP",749
31,"31067",1982,1400,1363,28,37,"UPN-PP",554
31,"31147",103,81,80,3,1,"UPN-PP",37
31,"31168",247,165,163,0,2,"UPN-PP",79
31,"31127",145,89,89,2,0,"UPN-PP",37
31,"31205",465,335,325,9,10,"UPN-PP",119
31,"31163",2008,1458,1434,22,24,"UPN-PP",699
31,"31083",50,37,37,0,0,"UPN-PP",12
31,"31178",540,395,392,4,3,"UPN-PP",162
31,"31215",4618,3384,3315,54,69,"UPN-PP",1713
31,"31073",332,228,226,1,2,"UPN-PP",53
31,"31210",219,169,167,3,2,"UPN-PP",58
31,"31013",668,382,375,12,7,"UPN-PP",132
31,"31027",824,611,609,2,2,"UPN-PP",60
31,"31072",5098,3764,3698,75,66,"UPN-PP",1884
31,"31118",182,114,114,6,0,"UPN-PP",32
31,"31129",405,285,281,1,4,"UPN-PP",30
31,"31182",45,28,28,2,0,"UPN-PP",9
31,"31162",53,35,34,1,1,"UPN-PP",13
31,"31145",173,129,127,2,2,"UPN-PP",80
31,"31052",89,62,58,1,4,"UPN-PP",26
31,"31085",451,334,327,3,7,"UPN-PP",52
31,"31070",2706,1949,1912,34,37,"UPN-PP",787
31,"31250",2887,1827,1802,20,25,"UPN-PP",328
31,"31005",312,209,206,4,3,"UPN-PP",87
31,"31011",688,437,432,17,5,"UPN-PP",188
31,"31102",162,80,78,0,2,"UPN-PP",26
31,"31225",40,32,32,0,0,"UPN-PP",13
31,"31122",4506,3333,3281,76,52,"UPN-PP",967
31,"31001",88,58,58,1,0,"UPN-PP",16
31,"31229",46,38,37,0,1,"UPN-PP",20
31,"31116",71,48,48,2,0,"UPN-PP",31
31,"31207",280,198,195,7,3,"UPN-PP",62
31,"31901",15574,11165,10974,201,191,"UPN-PP",3713
31,"31202",4247,3014,2957,69,57,"UPN-PP",1518
31,"31035",60,47,47,0,0,"UPN-PP",24
31,"31258",7679,5561,5475,92,86,"UPN-PP",1403
31,"31223",1043,783,771,14,12,"UPN-PP",294
31,"31194",308,212,210,6,2,"UPN-PP",60
31,"31022",544,378,369,1,9,"UPN-PP",37
31,"31226",597,339,335,2,4,"UPN-PP",44
31,"31246",148,101,100,3,1,"UPN-PP",38
31,"31209",155,105,104,1,1,"UPN-PP",38
31,"31064",1500,1137,1120,12,17,"UPN-PP",550
31,"31053",595,430,418,6,12,"UPN-PP",174
31,"31076",2314,1843,1823,39,20,"UPN-PP",1054
31,"31228",540,376,364,13,12,"UPN-PP",138
31,"31259",503,341,336,6,5,"UPN-PP",63
31,"31100",298,193,193,2,0,"UPN-PP",92
31,"31097",10461,7152,7029,129,123,"UPN-PP",2856
31,"31906",2493,1796,1770,57,26,"UPN-PP",547
31,"31037",94,68,68,0,0,"UPN-PP",5
31,"31220",771,584,572,9,12,"UPN-PP",294
31,"31261",271,202,201,4,1,"UPN-PP",92
31,"31149",2381,1626,1607,7,19,"UPN-PP",236
31,"31179",558,384,384,3,0,"UPN-PP",188
31,"31018",422,303,299,8,4,"UPN-PP",111
31,"31230",118,88,85,1,3,"UPN-PP",44
31,"31185",541,377,374,2,3,"UPN-PP",163
31,"31094",123,100,97,3,3,"UPN-PP",47
31,"31243",313,227,223,5,4,"UPN-PP",83
31,"31204",45,35,34,0,1,"UPN-PP",21
31,"31019",1858,1288,1266,25,22,"UPN-PP",301
31,"31112",106,79,78,0,1,"UPN-PP",37
31,"31095",83,70,70,1,0,"UPN-PP",11
31,"31176",2777,1999,1955,57,44,"UPN-PP",902
31,"31111",100,75,75,1,0,"UPN-PP",20
31,"31245",87,59,58,5,1,"UPN-PP",26
31,"31087",163,122,121,3,1,"UPN-PP",25
31,"31219",93,75,73,1,2,"UPN-PP",35
31,"31048",154,118,117,0,1,"UPN-PP",89
31,"31105",1619,1306,1284,30,22,"UPN-PP",726
31,"31008",97,64,63,1,1,"UPN-PP",36
31,"31187",122,68,68,2,0,"UPN-PP",10
31,"31236",1333,887,874,15,13,"UPN-PP",358
31,"31021",75,52,52,0,0,"UPN-PP",19
31,"31248",318,190,187,2,3,"UPN-PP",75
31,"31024",116,56,56,2,0,"UPN-PP",2
31,"31096",127,112,110,2,2,"UPN-PP",51
31,"31231",127,93,91,1,2,"UPN-PP",56
31,"31077",5349,4025,3917,103,108,"UPN-PP",2088
31,"31213",114,58,58,0,0,"UPN-PP",6
31,"31169",2285,1621,1590,43,31,"UPN-PP",756
31,"31057",1863,1450,1409,32,41,"UPN-PP",752
31,"31071",17,15,15,0,0,"UPN-PP",9
31,"31140",117,91,89,3,2,"UPN-PP",34
31,"31130",319,213,209,1,4,"UPN-PP",75
31,"31055",264,194,193,0,1,"UPN-PP",23
31,"31039",94,65,61,0,4,"UPN-PP",19
31,"31150",234,163,162,5,1,"UPN-PP",33
31,"31242",235,157,157,2,0,"UPN-PP",72
31,"31191",2930,2194,2148,43,46,"UPN-PP",875
31,"31051",270,182,181,8,1,"UPN-PP",74
31,"31173",881,754,733,12,21,"UPN-PP",383
31,"31113",147,87,85,2,2,"UPN-PP",32
31,"31142",1443,906,899,16,7,"UPN-PP",392
31,"31244",153,97,97,3,0,"UPN-PP",32
31,"31079",99,64,63,0,1,"UPN-PP",36
31,"31107",1706,1321,1311,17,10,"UPN-PP",928
31,"31030",155,113,112,3,1,"UPN-PP",26
31,"31043",42,30,30,1,0,"UPN-PP",16
31,"31025",751,501,495,12,6,"UPN-PP",158
31,"31197",69,58,57,1,1,"UPN-PP",20
31,"31186",299,205,200,3,5,"UPN-PP",62
31,"31251",3147,2274,2225,39,49,"UPN-PP",944
31,"31221",1182,774,767,12,7,"UPN-PP",233
31,"31234",148,107,105,6,2,"UPN-PP",44
31,"31044",276,224,223,0,1,"UPN-PP",45
31,"31088",5358,3655,3592,97,63,"UPN-PP",1350
31,"31241",164,117,116,4,1,"UPN-PP",52
31,"31115",171,112,109,2,3,"UPN-PP",24
31,"31108",1969,1474,1452,23,22,"UPN-PP",784
31,"31075",96,61,61,0,0,"UPN-PP",22
31,"31120",408,267,265,8,2,"UPN-PP",102
31,"31110",97,53,53,3,0,"UPN-PP",24
31,"31009",717,510,497,14,13,"UPN-PP",159
31,"31222",67,46,44,3,2,"UPN-PP",4
31,"31125",269,172,169,6,3,"UPN-PP",75
31,"31007",137,96,90,2,6,"UPN-PP",43
31,"31034",43,29,29,0,0,"UPN-PP",8
31,"31084",1949,1369,1361,11,8,"UPN-PP",181
31,"31068",3004,2258,2207,43,51,"UPN-PP",959
31,"31020",488,247,246,0,1,"UPN-PP",24
31,"31199",161,103,103,1,0,"UPN-PP",42
31,"31047",283,208,204,3,4,"UPN-PP",87
31,"31017",358,220,219,12,1,"UPN-PP",60
31,"31138",939,648,646,14,2,"UPN-PP",70
31,"31156",268,202,201,5,1,"UPN-PP",45
31,"31014",280,197,196,2,1,"UPN-PP",96
31,"31101",1305,892,874,15,18,"UPN-PP",324
31,"31074",430,304,303,10,1,"UPN-PP",96
31,"31090",156,77,77,0,0,"UPN-PP",14
31,"31238",125,99,98,3,1,"UPN-PP",22
31,"31903",6058,3985,3919,67,66,"UPN-PP",1034
31,"31078",2502,1880,1852,33,28,"UPN-PP",819
31,"31206",2079,1517,1475,33,42,"UPN-PP",529
31,"31128",406,261,261,4,0,"UPN-PP",73
31,"31132",160,124,124,6,0,"UPN-PP",55
31,"31203",30,25,25,0,0,"UPN-PP",13
31,"31148",99,69,66,2,3,"UPN-PP",23
31,"31181",168,121,119,3,2,"UPN-PP",42
31,"31908",997,692,683,9,9,"UPN-PP",141
31,"31080",544,428,426,7,2,"UPN-PP",153
31,"31201",144714,104019,102644,2027,1375,"UPN-PP",40187
31,"31004",36,21,20,0,1,"UPN-PP",13
31,"31227",8257,5987,5884,125,103,"UPN-PP",1702
31,"31254",1956,1495,1476,16,19,"UPN-PP",613
31,"31175",78,55,54,0,1,"UPN-PP",32
31,"31159",1158,864,846,17,18,"UPN-PP",304
31,"31117",670,471,467,3,4,"UPN-PP",21
31,"31098",1762,1285,1262,34,23,"UPN-PP",444
31,"31135",116,87,86,9,1,"UPN-PP",48
31,"31264",173,110,108,1,2,"UPN-PP",37
37,"37188",198,164,160,7,4,"UPyD",8
47,"47189",164,134,134,1,0,"UPyD",1
10,"10060",1037,758,742,9,16,"UPyD",10
39,"39057",2298,1735,1719,17,16,"UPyD",44
17,"17055",158,121,121,4,0,"UPyD",0
8,"8201",458,305,298,12,7,"UPyD",0
13,"13020",4805,3475,3434,40,41,"UPyD",120
43,"43043",3065,1952,1919,39,33,"UPyD",37
37,"37137",114,87,87,3,0,"UPyD",1
46,"46125",858,724,710,6,14,"UPyD",14
13,"13043",251,208,206,1,2,"UPyD",5
6,"6116",1680,1331,1317,15,14,"UPyD",13
46,"46046",922,699,694,2,5,"UPyD",26
26,"26044",60,48,46,1,2,"UPyD",2
12,"12141",116,97,97,0,0,"UPyD",2
8,"8219",14647,10347,10169,193,178,"UPyD",104
37,"37205",235,199,195,5,4,"UPyD",10
8,"8236",1507,1027,1002,18,25,"UPyD",7
6,"6068",481,383,378,3,5,"UPyD",2
10,"10075",276,189,189,1,0,"UPyD",5
19,"19033",79,55,55,0,0,"UPyD",2
17,"17005",404,258,254,12,4,"UPyD",2
21,"21035",9657,6943,6871,64,72,"UPyD",146
9,"9151",509,389,383,5,6,"UPyD",10
26,"26172",35,29,29,0,0,"UPyD",1
22,"22068",79,51,51,2,0,"UPyD",4
7,"7025",457,355,346,3,9,"UPyD",9
9,"9197",160,129,128,3,1,"UPyD",10
42,"42090",96,75,74,3,1,"UPyD",4
50,"50185",150,109,109,2,0,"UPyD",2
12,"12120",218,180,177,0,3,"UPyD",0
33,"33004",69056,49228,48730,726,498,"UPyD",2026
28,"28172",7648,6130,6076,65,54,"UPyD",686
19,"19177",82,67,66,0,1,"UPyD",3
16,"16023",468,332,327,3,5,"UPyD",15
19,"19159",108,91,88,1,3,"UPyD",3
8,"8116",600,401,393,9,8,"UPyD",1
45,"45177",2295,1898,1857,15,41,"UPyD",28
26,"26118",64,58,56,0,2,"UPyD",5
44,"44230",154,127,127,3,0,"UPyD",1
3,"3039",92,70,66,1,4,"UPyD",1
23,"23093",3313,2706,2673,13,33,"UPyD",49
18,"18036",3553,2762,2741,20,21,"UPyD",198
37,"37170",1571,1122,1107,22,15,"UPyD",50
45,"45196",1363,1092,1076,3,16,"UPyD",25
6,"6040",1032,807,807,11,0,"UPyD",15
9,"9226",74,57,57,0,0,"UPyD",0
8,"8170",458,300,288,13,12,"UPyD",0
25,"25073",662,382,379,11,3,"UPyD",2
49,"49152",572,401,395,6,6,"UPyD",10
40,"40010",140,117,117,0,0,"UPyD",9
23,"23075",3404,2800,2782,24,18,"UPyD",52
34,"34141",190,162,160,0,2,"UPyD",4
2,"2035",1988,1601,1586,19,15,"UPyD",53
24,"24024",717,501,498,10,3,"UPyD",23
39,"39020",23947,15404,15122,267,282,"UPyD",587
23,"23098",923,808,807,6,1,"UPyD",6
47,"47045",839,636,632,3,4,"UPyD",15
41,"41063",2678,1869,1853,22,16,"UPyD",68
49,"49192",166,139,139,2,0,"UPyD",2
37,"37246",5430,4363,4315,63,48,"UPyD",228
37,"37120",107,88,87,0,1,"UPyD",6
24,"24067",700,453,447,4,6,"UPyD",8
19,"19270",17,16,16,0,0,"UPyD",2
12,"12065",181,155,155,0,0,"UPyD",4
31,"31095",83,70,70,1,0,"UPyD",0
26,"26151",455,384,382,1,2,"UPyD",6
40,"40012",280,215,213,2,2,"UPyD",2
17,"17125",132,90,89,1,1,"UPyD",0
24,"24901",994,698,686,8,12,"UPyD",19
37,"37251",137,98,93,3,5,"UPyD",7
9,"9112",115,80,80,4,0,"UPyD",2
14,"14029",4380,3344,3308,35,36,"UPyD",66
6,"6075",517,433,429,3,4,"UPyD",1
9,"9443",197,160,154,5,6,"UPyD",5
39,"39063",1018,769,762,6,7,"UPyD",7
5,"5008",244,200,196,1,4,"UPyD",7
6,"6046",1288,1050,1042,11,8,"UPyD",13
25,"25115",878,542,542,17,0,"UPyD",0
27,"27019",8247,6146,6022,101,124,"UPyD",78
19,"19036",279,238,236,1,2,"UPyD",5
44,"44211",39,32,32,2,0,"UPyD",1
6,"6035",1048,879,871,5,8,"UPyD",8
32,"32034",1228,995,990,5,5,"UPyD",3
46,"46243",149,120,117,0,3,"UPyD",3
10,"10142",822,635,625,4,10,"UPyD",10
10,"10013",305,242,237,1,5,"UPyD",6
34,"34047",1814,1435,1413,24,22,"UPyD",35
5,"5046",44,39,38,1,1,"UPyD",1
2,"2010",1877,1557,1519,15,38,"UPyD",37
50,"50025",4569,3319,3271,68,48,"UPyD",161
46,"46124",768,641,632,10,9,"UPyD",89
31,"31035",60,47,47,0,0,"UPyD",2
15,"15027",1537,1263,1242,22,21,"UPyD",17
24,"24058",224,166,163,1,3,"UPyD",2
34,"34208",62,52,52,2,0,"UPyD",2
41,"41049",8898,6881,6812,95,69,"UPyD",237
19,"19233",108,93,90,2,3,"UPyD",5
28,"28117",116,90,90,1,0,"UPyD",3
19,"19213",72,60,60,1,0,"UPyD",0
37,"37202",938,742,726,25,16,"UPyD",80
16,"16156",122,91,91,0,0,"UPyD",2
2,"2040",631,569,566,3,3,"UPyD",16
15,"15050",1971,1110,1097,27,13,"UPyD",6
18,"18144",779,592,590,3,2,"UPyD",41
6,"6085",3437,2566,2530,32,36,"UPyD",96
25,"25170",271,197,196,4,1,"UPyD",0
49,"49099",127,96,96,1,0,"UPyD",0
45,"45092",252,223,221,0,2,"UPyD",1
43,"43082",383,282,270,8,12,"UPyD",0
9,"9152",273,207,207,1,0,"UPyD",6
37,"37260",175,122,122,1,0,"UPyD",1
32,"32042",1784,1292,1282,13,10,"UPyD",10
3,"3016",91,67,66,1,1,"UPyD",4
34,"34216",65,50,50,1,0,"UPyD",0
6,"6122",6620,4904,4797,44,107,"UPyD",162
37,"37023",1040,819,811,11,8,"UPyD",68
31,"31002",421,292,284,5,8,"UPyD",1
26,"26120",1515,1215,1198,20,17,"UPyD",24
2,"2021",1114,872,860,7,12,"UPyD",14
37,"37132",398,317,311,3,6,"UPyD",2
21,"21029",1633,1276,1259,15,17,"UPyD",16
10,"10165",274,231,229,0,2,"UPyD",1
49,"49237",157,110,110,0,0,"UPyD",1
25,"25911",472,306,296,2,10,"UPyD",0
24,"24090",366,225,224,2,1,"UPyD",9
2,"2071",1053,899,895,5,4,"UPyD",15
21,"21046",1715,1354,1343,15,11,"UPyD",16
3,"3135",228,185,181,0,4,"UPyD",2
10,"10086",342,259,250,5,9,"UPyD",1
34,"34125",99,77,75,1,2,"UPyD",2
17,"17041",237,153,153,1,0,"UPyD",1
49,"49240",237,190,186,1,4,"UPyD",5
28,"28143",81,71,67,1,4,"UPyD",8
24,"24102",701,536,530,3,6,"UPyD",5
10,"10131",12797,9017,8922,131,95,"UPyD",490
27,"27052",966,726,718,9,8,"UPyD",6
10,"10067",10392,7979,7804,111,175,"UPyD",270
8,"8291",4516,2895,2855,56,40,"UPyD",33
9,"9232",182,146,146,1,0,"UPyD",5
24,"24023",272,196,193,6,3,"UPyD",5
37,"37144",398,302,301,3,1,"UPyD",7
15,"15053",8164,5679,5592,60,87,"UPyD",24
13,"13059",232,186,184,0,2,"UPyD",2
10,"10173",557,436,431,6,5,"UPyD",9
17,"17039",1850,1299,1275,31,24,"UPyD",4
44,"44115",121,100,100,0,0,"UPyD",3
49,"49103",435,354,350,6,4,"UPyD",5
46,"46219",143,127,126,1,1,"UPyD",3
49,"49247",507,340,332,6,8,"UPyD",7
29,"29083",2212,1679,1652,15,27,"UPyD",35
49,"49165",72,63,63,0,0,"UPyD",4
13,"13005",23052,18002,17700,255,302,"UPyD",983
2,"2073",4924,3923,3847,76,76,"UPyD",102
44,"44147",439,320,314,14,6,"UPyD",8
25,"25185",690,409,404,8,5,"UPyD",1
8,"8284",11920,7059,6942,139,117,"UPyD",58
49,"49225",172,130,129,0,1,"UPyD",4
15,"15026",2025,1426,1413,17,13,"UPyD",5
44,"44085",61,38,38,0,0,"UPyD",0
46,"46019",8671,7195,7109,70,86,"UPyD",196
8,"8203",2442,1526,1498,34,28,"UPyD",16
2,"2046",1165,954,941,16,13,"UPyD",28
2,"2008",1332,985,966,12,19,"UPyD",24
45,"45078",1451,1243,1228,7,15,"UPyD",12
14,"14054",13632,10857,10652,194,205,"UPyD",575
28,"28179",1385,1039,1027,10,12,"UPyD",86
9,"9283",63,36,36,0,0,"UPyD",0
44,"44094",116,105,103,4,2,"UPyD",2
49,"49162",217,157,155,2,2,"UPyD",1
43,"43050",2407,1528,1504,20,24,"UPyD",13
19,"19166",179,123,121,4,2,"UPyD",6
49,"49256",289,229,224,3,5,"UPyD",8
24,"24099",199,164,162,0,2,"UPyD",2
5,"5024",268,205,201,2,4,"UPyD",0
9,"9460",187,144,142,2,2,"UPyD",9
24,"24078",426,323,316,0,7,"UPyD",7
18,"18138",2460,1751,1741,1,10,"UPyD",43
18,"18140",42971,28391,28126,335,265,"UPyD",1051
41,"41031",1319,879,875,6,4,"UPyD",12
10,"10006",1306,1081,1070,7,11,"UPyD",14
16,"16254",213,166,165,2,1,"UPyD",6
18,"18037",488,408,404,0,4,"UPyD",22
19,"19146",51,40,38,0,2,"UPyD",0
25,"25076",165,84,83,3,1,"UPyD",0
5,"5084",81,70,69,0,1,"UPyD",0
35,"35032",3432,2605,2548,37,57,"UPyD",39
14,"14017",10755,8220,8149,101,71,"UPyD",237
19,"19241",45,37,37,2,0,"UPyD",2
10,"10056",605,484,476,5,8,"UPyD",6
43,"43125",1008,706,701,10,5,"UPyD",6
1,"1002",8057,5854,5757,48,97,"UPyD",46
5,"5038",131,88,84,0,4,"UPyD",3
31,"31011",688,437,432,17,5,"UPyD",18
50,"50096",49,35,35,0,0,"UPyD",0
22,"22201",287,203,198,2,5,"UPyD",1
39,"39010",688,533,524,6,9,"UPyD",6
28,"28181",20003,16133,15952,159,181,"UPyD",1559
28,"28115",57612,46786,46458,458,328,"UPyD",4736
9,"9009",167,129,128,8,1,"UPyD",11
18,"18086",397,321,321,3,0,"UPyD",2
16,"16087",229,193,187,4,6,"UPyD",3
42,"42162",2482,1871,1850,23,21,"UPyD",93
10,"10167",322,265,264,1,1,"UPyD",0
9,"9274",1160,924,914,14,10,"UPyD",44
5,"5126",78,70,70,0,0,"UPyD",1
49,"49248",224,183,180,4,3,"UPyD",1
41,"41076",2227,1507,1492,5,15,"UPyD",10
4,"4006",7156,5175,5106,51,69,"UPyD",109
12,"12112",104,90,90,0,0,"UPyD",2
46,"46010",927,706,699,3,7,"UPyD",26
2,"2058",390,290,285,0,5,"UPyD",1
39,"39029",642,521,517,6,4,"UPyD",6
41,"41044",6838,5064,5005,67,59,"UPyD",375
3,"3002",3559,2747,2707,16,40,"UPyD",88
41,"41022",4281,3087,3066,15,21,"UPyD",44
50,"50157",313,253,250,7,3,"UPyD",1
12,"12076",105,79,79,0,0,"UPyD",2
50,"50169",371,275,274,5,1,"UPyD",1
13,"13048",538,441,433,5,8,"UPyD",7
45,"45901",811,595,591,2,4,"UPyD",19
31,"31115",171,112,109,2,3,"UPyD",4
32,"32074",1180,892,876,11,16,"UPyD",5
19,"19218",60,35,35,0,0,"UPyD",1
10,"10024",663,490,480,3,10,"UPyD",10
28,"28124",83,55,53,0,2,"UPyD",10
9,"9395",164,134,133,1,1,"UPyD",9
2,"2019",2455,2107,2077,16,30,"UPyD",39
25,"25086",569,379,370,4,9,"UPyD",0
47,"47005",578,467,455,5,12,"UPyD",24
14,"14012",6305,4749,4690,44,59,"UPyD",60
13,"13034",56981,42819,42306,742,513,"UPyD",3174
46,"46030",800,677,662,6,15,"UPyD",14
9,"9072",272,210,209,4,1,"UPyD",18
31,"31034",43,29,29,0,0,"UPyD",1
23,"23088",6177,4955,4872,94,83,"UPyD",129
5,"5017",87,69,68,1,1,"UPyD",3
19,"19165",51,43,42,0,1,"UPyD",1
39,"39098",1522,1256,1244,8,12,"UPyD",21
10,"10008",1393,1105,1086,10,19,"UPyD",32
9,"9018",24688,17880,17508,345,372,"UPyD",1224
50,"50264",184,140,134,0,6,"UPyD",2
40,"40179",634,545,538,4,7,"UPyD",33
10,"10052",186,138,138,0,0,"UPyD",4
9,"9221",446,343,340,7,3,"UPyD",29
41,"41001",1642,1314,1302,10,12,"UPyD",20
18,"18126",1461,1129,1121,15,8,"UPyD",40
41,"41087",9827,7300,7150,51,150,"UPyD",410
31,"31066",915,660,647,19,13,"UPyD",6
27,"27902",7198,5074,4976,106,98,"UPyD",104
22,"22016",654,476,464,10,12,"UPyD",4
48,"48915",362,273,271,2,2,"UPyD",0
10,"10109",1834,1307,1287,18,20,"UPyD",39
34,"34230",12,8,8,0,0,"UPyD",0
20,"20053",4830,2895,2868,36,27,"UPyD",41
6,"6048",879,758,740,4,18,"UPyD",11
24,"24026",1304,1015,1001,17,14,"UPyD",27
23,"23905",1884,1447,1438,4,9,"UPyD",22
43,"43018",430,350,337,7,13,"UPyD",0
31,"31026",154,125,122,1,3,"UPyD",4
23,"23066",4348,3687,3654,21,33,"UPyD",225
17,"17030",624,414,409,8,5,"UPyD",2
5,"5069",91,79,78,1,1,"UPyD",4
32,"32082",1403,1055,1047,9,8,"UPyD",2
10,"10069",858,680,673,2,7,"UPyD",14
6,"6044",28321,21143,20931,232,212,"UPyD",784
17,"17075",304,216,210,5,6,"UPyD",0
30,"30042",1841,1531,1519,10,12,"UPyD",78
10,"10097",109,97,96,0,1,"UPyD",4
8,"8249",273,218,214,4,4,"UPyD",0
8,"8126",8299,5599,5508,103,91,"UPyD",60
41,"41002",1510,1161,1140,4,21,"UPyD",22
45,"45076",603,420,419,3,1,"UPyD",22
16,"16083",58,30,30,1,0,"UPyD",1
46,"46076",651,541,528,2,13,"UPyD",12
10,"10039",448,352,350,0,2,"UPyD",2
48,"48074",3384,2441,2397,20,44,"UPyD",14
8,"8130",95,63,62,3,1,"UPyD",0
21,"21036",213,172,167,1,5,"UPyD",1
50,"50208",1831,1321,1305,24,16,"UPyD",48
49,"49164",158,120,114,2,6,"UPyD",4
50,"50293",492,339,338,6,1,"UPyD",7
24,"24056",3200,2368,2332,53,36,"UPyD",70
45,"45200",4633,3768,3672,37,96,"UPyD",138
9,"9332",137,88,85,1,3,"UPyD",3
34,"34018",229,184,182,3,2,"UPyD",2
32,"32011",1026,660,650,4,10,"UPyD",2
31,"31232",24440,17810,17436,420,374,"UPyD",620
5,"5148",34,27,27,0,0,"UPyD",1
24,"24227",1664,1159,1148,16,11,"UPyD",70
34,"34204",53,45,44,0,1,"UPyD",1
6,"6022",2719,2274,2245,14,29,"UPyD",35
25,"25104",128,88,86,11,2,"UPyD",0
46,"46144",699,547,536,2,11,"UPyD",20
30,"30039",18615,14213,14068,134,145,"UPyD",596
25,"25118",378,232,226,4,6,"UPyD",0
46,"46205",14277,10882,10764,115,118,"UPyD",723
9,"9079",49,44,44,1,0,"UPyD",2
44,"44146",185,160,159,8,1,"UPyD",4
34,"34155",142,118,117,3,1,"UPyD",2
41,"41025",1999,1502,1476,13,26,"UPyD",39
50,"50213",117,83,82,0,1,"UPyD",2
43,"43029",330,202,194,6,8,"UPyD",0
6,"6115",1261,893,885,7,8,"UPyD",28
19,"19317",150,122,121,2,1,"UPyD",1
18,"18011",4246,3195,3172,23,23,"UPyD",158
8,"8159",13482,9173,9040,239,133,"UPyD",147
5,"5016",6231,4831,4763,56,68,"UPyD",339
31,"31051",270,182,181,8,1,"UPyD",1
22,"22003",148,117,116,2,1,"UPyD",8
37,"37178",107,88,87,0,1,"UPyD",2
24,"24098",1251,837,819,19,18,"UPyD",19
49,"49246",248,212,210,1,2,"UPyD",11
17,"17018",478,337,332,8,5,"UPyD",0
24,"24112",323,230,228,0,2,"UPyD",4
37,"37183",425,321,316,3,5,"UPyD",10
37,"37158",262,181,179,0,2,"UPyD",4
5,"5129",153,98,95,0,3,"UPyD",5
27,"27026",2605,1785,1751,19,34,"UPyD",3
50,"50190",751,576,565,7,11,"UPyD",15
44,"44203",8,8,8,0,0,"UPyD",0
45,"45192",2549,2178,2155,39,23,"UPyD",31
6,"6102",1045,851,840,7,11,"UPyD",7
32,"32088",1749,1232,1217,10,15,"UPyD",2
22,"22217",406,314,309,4,5,"UPyD",8
40,"40095",507,437,425,2,12,"UPyD",16
20,"20030",22191,15262,15148,164,114,"UPyD",204
45,"45167",1552,1296,1278,14,18,"UPyD",26
49,"49166",1294,1003,988,29,15,"UPyD",49
37,"37288",252,194,194,3,0,"UPyD",7
28,"28148",79726,60405,59651,724,754,"UPyD",5906
24,"24053",503,338,332,3,6,"UPyD",7
26,"26141",132,101,101,2,0,"UPyD",3
10,"10177",1692,1351,1318,15,33,"UPyD",66
46,"46234",388,308,307,3,1,"UPyD",14
6,"6009",214,178,178,2,0,"UPyD",5
48,"48009",767,585,580,4,5,"UPyD",1
43,"43007",635,448,441,7,7,"UPyD",0
19,"19252",90,80,78,0,2,"UPyD",2
24,"24009",362,188,184,0,4,"UPyD",4
22,"22021",2080,1524,1505,31,19,"UPyD",63
49,"49158",229,174,172,0,2,"UPyD",0
42,"42035",847,600,592,4,8,"UPyD",14
6,"6105",655,450,448,1,2,"UPyD",3
9,"9130",87,72,71,0,1,"UPyD",5
43,"43081",574,415,404,13,11,"UPyD",1
23,"23072",2063,1661,1643,16,18,"UPyD",25
45,"45096",1021,800,778,5,22,"UPyD",9
11,"11022",48624,26656,26430,345,226,"UPyD",1103
10,"10133",1247,1045,1028,7,17,"UPyD",5
9,"9143",24,14,14,1,0,"UPyD",1
9,"9220",82,60,60,2,0,"UPyD",2
49,"49204",85,64,64,0,0,"UPyD",1
8,"8123",18751,13394,13154,238,240,"UPyD",139
4,"4004",458,367,364,6,3,"UPyD",9
9,"9229",213,163,163,1,0,"UPyD",1
26,"26011",7455,5452,5353,93,99,"UPyD",219
41,"41026",4273,3577,3538,15,39,"UPyD",61
47,"47193",1538,1229,1211,23,18,"UPyD",82
10,"10130",1745,1360,1341,10,19,"UPyD",18
43,"43057",45,27,27,2,0,"UPyD",1
32,"32019",11469,8297,8180,134,117,"UPyD",59
49,"49090",207,168,168,4,0,"UPyD",2
37,"37171",437,362,358,4,4,"UPyD",7
9,"9266",87,72,72,0,0,"UPyD",1
28,"28132",10987,8066,7943,90,123,"UPyD",818
6,"6017",292,250,250,0,0,"UPyD",1
19,"19197",29,19,19,0,0,"UPyD",0
6,"6139",600,489,481,5,8,"UPyD",5
50,"50146",211,168,167,4,1,"UPyD",2
24,"24159",1901,1492,1477,11,15,"UPyD",47
49,"49227",295,238,237,5,1,"UPyD",5
8,"8101",169663,112624,111107,1841,1517,"UPyD",1895
16,"16095",98,68,68,0,0,"UPyD",6
22,"22129",193,124,123,4,1,"UPyD",1
34,"34218",486,366,365,3,1,"UPyD",7
26,"26068",83,65,64,0,1,"UPyD",2
16,"16024",134,92,91,1,1,"UPyD",5
44,"44063",82,55,55,2,0,"UPyD",2
27,"27018",3871,2523,2489,32,34,"UPyD",11
8,"8177",52,31,31,1,0,"UPyD",0
34,"34246",78,64,64,0,0,"UPyD",4
47,"47217",1812,1395,1377,20,18,"UPyD",112
46,"46108",550,446,444,3,2,"UPyD",12
34,"34110",96,83,81,2,2,"UPyD",2
40,"40056",41,34,34,0,0,"UPyD",0
10,"10015",688,539,523,5,16,"UPyD",9
22,"22136",908,671,662,11,9,"UPyD",21
49,"49178",679,469,461,9,8,"UPyD",34
22,"22105",132,104,102,2,2,"UPyD",1
9,"9315",362,267,265,9,2,"UPyD",19
13,"13085",2455,2146,2118,21,28,"UPyD",35
5,"5013",890,746,739,4,7,"UPyD",20
3,"3086",145,119,118,1,1,"UPyD",6
19,"19090",107,87,86,0,1,"UPyD",1
45,"45158",2577,1948,1909,18,39,"UPyD",64
25,"25010",206,119,118,7,1,"UPyD",0
36,"36057",236900,168990,166060,2833,2930,"UPyD",3339
41,"41060",15176,10797,10693,114,104,"UPyD",405
2,"2081",18319,14324,14096,225,228,"UPyD",420
34,"34058",212,179,178,0,1,"UPyD",4
8,"8107",10955,7236,7130,151,106,"UPyD",111
25,"25110",2662,1649,1602,44,47,"UPyD",12
47,"47138",259,198,195,3,3,"UPyD",3
15,"15021",5114,3527,3475,77,52,"UPyD",25
22,"22087",85,56,55,4,1,"UPyD",0
43,"43036",836,503,494,4,9,"UPyD",7
17,"17126",309,231,229,9,2,"UPyD",0
34,"34001",36,29,29,2,0,"UPyD",0
25,"25219",144,90,86,0,4,"UPyD",0
7,"7008",5422,3782,3705,61,77,"UPyD",122
8,"8208",5471,3859,3792,82,67,"UPyD",56
32,"32057",608,475,473,4,2,"UPyD",5
3,"3026",1210,1004,989,11,15,"UPyD",30
6,"6108",2355,1773,1746,24,27,"UPyD",32
19,"19133",103,89,88,2,1,"UPyD",1
43,"43005",3559,2191,2147,47,44,"UPyD",11
26,"26103",796,616,611,11,5,"UPyD",13
6,"6110",176,130,124,0,6,"UPyD",6
4,"4096",293,220,219,1,1,"UPyD",6
48,"48006",285,246,243,3,3,"UPyD",0
30,"30036",13978,10244,10141,94,103,"UPyD",529
8,"8293",246,145,145,4,0,"UPyD",0
49,"49125",1344,956,939,21,17,"UPyD",56
8,"8129",444,278,271,2,7,"UPyD",2
6,"6131",1037,871,865,8,6,"UPyD",9
37,"37128",261,211,210,2,1,"UPyD",3
22,"22017",917,677,661,8,16,"UPyD",18
17,"17036",2822,1844,1806,36,38,"UPyD",6
39,"39016",24213,18549,18362,265,187,"UPyD",788
9,"9321",1760,1338,1327,20,11,"UPyD",59
44,"44097",158,97,95,1,2,"UPyD",9
31,"31031",234,144,143,1,1,"UPyD",0
9,"9903",3299,2373,2349,45,24,"UPyD",127
4,"4041",334,247,245,0,2,"UPyD",8
32,"32051",1574,1296,1290,7,6,"UPyD",8
6,"6137",1035,848,842,2,6,"UPyD",23
6,"6106",447,335,333,7,2,"UPyD",16
44,"44161",487,363,358,9,5,"UPyD",7
28,"28007",122891,95200,94139,990,1061,"UPyD",10158
10,"10103",480,385,380,3,5,"UPyD",7
19,"19073",24,20,19,0,1,"UPyD",0
22,"22018",357,272,271,4,1,"UPyD",4
9,"9189",146,101,99,2,2,"UPyD",4
19,"19148",56,41,38,1,3,"UPyD",4
9,"9100",56,46,44,0,2,"UPyD",1
43,"43088",1810,1199,1177,29,22,"UPyD",8
13,"13904",556,448,441,14,7,"UPyD",14
12,"12084",17219,12059,11911,165,148,"UPyD",270
20,"20050",293,213,211,3,2,"UPyD",0
42,"42086",40,25,25,1,0,"UPyD",2
27,"27032",3466,2565,2530,40,35,"UPyD",14
48,"48034",13160,9290,9189,82,101,"UPyD",290
25,"25904",149,107,104,1,3,"UPyD",0
17,"17026",542,404,398,3,6,"UPyD",1
23,"23028",6428,4855,4802,26,53,"UPyD",182
42,"42082",9,9,9,0,0,"UPyD",0
37,"37269",475,383,382,2,1,"UPyD",12
46,"46064",547,463,458,2,5,"UPyD",24
37,"37257",52,43,43,0,0,"UPyD",2
31,"31044",276,224,223,0,1,"UPyD",1
19,"19162",71,52,51,0,1,"UPyD",1
47,"47160",466,368,364,5,4,"UPyD",9
30,"30022",16489,12207,12042,152,165,"UPyD",675
5,"5261",48,32,31,0,1,"UPyD",0
4,"4030",1222,930,924,5,6,"UPyD",12
41,"41068",13809,10171,10072,100,99,"UPyD",335
5,"5131",118,86,86,3,0,"UPyD",6
17,"17001",557,370,365,7,5,"UPyD",2
37,"37233",59,46,45,1,1,"UPyD",0
24,"24212",1105,856,846,14,10,"UPyD",20
34,"34242",97,81,79,6,2,"UPyD",4
9,"9373",485,332,331,5,1,"UPyD",13
44,"44155",1162,819,801,24,18,"UPyD",27
49,"49102",217,178,176,3,2,"UPyD",8
31,"31024",116,56,56,2,0,"UPyD",0
37,"37058",68,44,44,0,0,"UPyD",2
37,"37166",206,172,171,3,1,"UPyD",2
25,"25131",439,319,314,6,5,"UPyD",2
43,"43006",712,484,475,10,9,"UPyD",1
31,"31065",1927,1391,1362,39,29,"UPyD",13
43,"43017",141,98,98,2,0,"UPyD",0
39,"39019",2009,1556,1536,10,20,"UPyD",48
46,"46098",2556,2072,2057,12,15,"UPyD",45
35,"35004",35462,18498,18196,325,302,"UPyD",314
27,"27031",16169,11446,11214,194,232,"UPyD",93
9,"9144",61,51,50,0,1,"UPyD",2
45,"45061",2523,1839,1813,20,26,"UPyD",56
10,"10108",231,152,152,0,0,"UPyD",3
4,"4101",3927,2827,2804,34,23,"UPyD",100
13,"13054",5032,3901,3824,70,77,"UPyD",91
45,"45159",100,84,84,1,0,"UPyD",5
15,"15052",4567,3539,3493,22,46,"UPyD",9
40,"40119",182,149,145,2,4,"UPyD",10
19,"19150",128,112,108,0,4,"UPyD",2
9,"9329",117,80,79,1,1,"UPyD",3
19,"19042",41,32,32,0,0,"UPyD",2
50,"50034",923,634,617,10,17,"UPyD",13
8,"8145",2597,1823,1784,23,39,"UPyD",11
41,"41019",4528,3194,3168,41,26,"UPyD",162
9,"9418",79,60,58,0,2,"UPyD",0
17,"17063",169,113,111,5,2,"UPyD",0
5,"5090",72,64,63,1,1,"UPyD",4
22,"22025",1104,790,767,27,23,"UPyD",21
22,"22055",347,291,289,5,2,"UPyD",5
9,"9482",33,31,30,1,1,"UPyD",0
19,"19231",16,14,14,0,0,"UPyD",0
17,"17084",269,177,175,4,2,"UPyD",0
15,"15085",3576,2656,2612,29,44,"UPyD",16
39,"39048",1616,1326,1308,8,18,"UPyD",35
31,"31189",1229,745,740,5,5,"UPyD",6
32,"32083",960,675,672,0,3,"UPyD",7
6,"6126",2199,1706,1686,14,20,"UPyD",47
8,"8178",450,311,304,3,7,"UPyD",6
25,"25085",153,103,100,2,3,"UPyD",0
10,"10029",447,362,355,1,7,"UPyD",11
10,"10066",182,136,133,1,3,"UPyD",4
25,"25103",125,82,80,4,2,"UPyD",0
37,"37247",216,176,173,1,3,"UPyD",2
34,"34136",192,122,122,1,0,"UPyD",1
31,"31028",217,129,128,1,1,"UPyD",2
11,"11018",1528,1194,1178,9,16,"UPyD",23
6,"6036",5228,4075,4028,22,47,"UPyD",134
24,"24107",316,208,206,1,2,"UPyD",10
45,"45016",3804,2926,2876,52,50,"UPyD",219
8,"8137",255,190,190,3,0,"UPyD",0
9,"9181",334,271,271,14,0,"UPyD",14
31,"31039",94,65,61,0,4,"UPyD",0
48,"48059",397,289,286,0,3,"UPyD",0
10,"10057",166,133,133,0,0,"UPyD",3
19,"19186",93,77,77,0,0,"UPyD",2
2,"2050",121,95,95,1,0,"UPyD",1
9,"9328",81,56,56,2,0,"UPyD",4
18,"18108",892,674,673,2,1,"UPyD",11
49,"49105",158,135,133,2,2,"UPyD",5
50,"50166",282,216,210,1,6,"UPyD",2
42,"42128",43,38,38,2,0,"UPyD",4
49,"49124",279,203,202,2,1,"UPyD",3
23,"23081",1643,1245,1234,12,11,"UPyD",18
40,"40014",60,39,39,1,0,"UPyD",2
39,"39041",1775,1432,1414,15,18,"UPyD",29
34,"34048",72,58,56,3,2,"UPyD",2
2,"2027",347,301,301,2,0,"UPyD",11
37,"37277",58,39,38,1,1,"UPyD",2
31,"31061",67,47,47,2,0,"UPyD",0
28,"28015",14491,11562,11417,155,145,"UPyD",1582
8,"8181",7722,5280,5188,112,92,"UPyD",53
25,"25245",445,312,306,4,6,"UPyD",4
37,"37141",158,140,139,1,1,"UPyD",9
43,"43046",114,80,79,5,1,"UPyD",0
40,"40186",50,33,33,0,0,"UPyD",0
6,"6070",7805,6083,6001,76,82,"UPyD",147
39,"39077",256,196,196,1,0,"UPyD",0
9,"9244",53,44,44,0,0,"UPyD",2
10,"10034",376,283,278,5,5,"UPyD",0
24,"24124",419,286,282,0,4,"UPyD",4
16,"16058",120,103,102,1,1,"UPyD",0
6,"6157",497,350,343,0,7,"UPyD",6
21,"21052",4741,2897,2839,21,58,"UPyD",98
26,"26148",189,151,150,0,1,"UPyD",5
19,"19122",96,65,65,0,0,"UPyD",1
46,"46177",4594,3576,3523,29,53,"UPyD",194
41,"41023",7901,6050,5972,45,78,"UPyD",181
31,"31062",1103,849,832,7,17,"UPyD",13
37,"37243",123,89,88,1,1,"UPyD",0
5,"5108",64,41,41,0,0,"UPyD",0
47,"47167",258,230,229,3,1,"UPyD",3
17,"17141",5689,3485,3428,50,57,"UPyD",19
46,"46247",1059,829,823,6,6,"UPyD",30
30,"30024",57868,41894,41513,393,381,"UPyD",2055
5,"5136",110,75,75,3,0,"UPyD",3
36,"36036",2616,1981,1948,24,33,"UPyD",4
28,"28109",1621,1121,1104,9,17,"UPyD",69
22,"22037",115,87,79,0,8,"UPyD",5
24,"24033",214,157,152,3,5,"UPyD",2
9,"9905",432,313,309,1,4,"UPyD",20
40,"40129",203,166,162,1,4,"UPyD",2
28,"28146",1672,1220,1205,4,15,"UPyD",56
44,"44235",103,71,68,0,3,"UPyD",1
44,"44154",271,196,195,7,1,"UPyD",4
25,"25124",161,110,109,4,1,"UPyD",1
25,"25248",926,615,601,17,14,"UPyD",0
31,"31165",2868,2094,2046,43,48,"UPyD",38
10,"10187",486,349,345,2,4,"UPyD",5
50,"50099",3136,2333,2297,27,36,"UPyD",56
47,"47151",32,29,29,0,0,"UPyD",2
5,"5164",34,24,24,0,0,"UPyD",0
9,"9191",45,34,33,1,1,"UPyD",0
8,"8174",409,294,292,10,2,"UPyD",0
47,"47051",351,269,256,5,13,"UPyD",14
46,"46106",1616,1196,1188,6,8,"UPyD",53
26,"26052",181,146,146,0,0,"UPyD",1
34,"34152",142,114,109,1,5,"UPyD",3
40,"40035",146,114,112,3,2,"UPyD",10
34,"34123",1798,1479,1436,18,43,"UPyD",30
1,"1061",155,122,122,2,0,"UPyD",0
28,"28159",629,482,478,2,4,"UPyD",31
49,"49159",289,225,225,2,0,"UPyD",3
45,"45109",3030,2507,2417,30,90,"UPyD",44
16,"16049",158,129,129,1,0,"UPyD",1
49,"49252",370,310,305,6,5,"UPyD",12
19,"19196",99,80,74,2,6,"UPyD",1
16,"16119",181,130,130,0,0,"UPyD",0
47,"47043",330,267,264,1,3,"UPyD",5
50,"50132",697,544,536,11,8,"UPyD",36
9,"9119",51,38,38,0,0,"UPyD",5
46,"46066",1264,1060,1050,5,10,"UPyD",25
34,"34154",78,62,62,0,0,"UPyD",1
22,"22028",424,311,310,3,1,"UPyD",9
37,"37065",346,269,267,0,2,"UPyD",4
34,"34245",322,240,236,3,4,"UPyD",6
5,"5144",92,66,66,4,0,"UPyD",2
17,"17233",2192,1470,1434,33,36,"UPyD",3
43,"43100",3062,2058,2021,52,37,"UPyD",39
8,"8218",7968,5014,4932,129,82,"UPyD",29
47,"47179",408,315,306,6,9,"UPyD",15
36,"36018",3492,2516,2494,25,22,"UPyD",12
16,"16011",39,30,30,0,0,"UPyD",3
39,"39055",1130,881,869,10,12,"UPyD",24
49,"49148",213,144,143,0,1,"UPyD",3
31,"31006",1988,1434,1395,22,39,"UPyD",27
42,"42071",186,104,103,3,1,"UPyD",1
10,"10096",3384,2581,2533,32,48,"UPyD",53
41,"41080",1289,1010,997,13,13,"UPyD",34
34,"34233",158,128,128,3,0,"UPyD",1
46,"46027",997,869,855,4,14,"UPyD",27
16,"16137",64,41,40,0,1,"UPyD",0
5,"5177",164,134,133,0,1,"UPyD",5
43,"43027",177,129,128,6,1,"UPyD",1
39,"39004",1593,1321,1305,9,16,"UPyD",9
20,"20036",12731,8519,8431,131,88,"UPyD",111
12,"12121",1197,1050,1020,4,30,"UPyD",5
15,"15039",1374,1027,998,27,29,"UPyD",5
43,"43019",1356,868,837,13,31,"UPyD",10
21,"21018",1821,1283,1273,19,10,"UPyD",13
7,"7014",6697,3818,3757,38,61,"UPyD",77
15,"15030",201751,141022,138934,2981,2088,"UPyD",2883
5,"5082",569,467,462,1,5,"UPyD",16
5,"5060",127,108,105,1,3,"UPyD",3
47,"47164",391,326,320,3,6,"UPyD",13
16,"16053",414,334,326,2,8,"UPyD",9
45,"45174",343,289,288,0,1,"UPyD",9
28,"28903",29222,23945,23689,296,256,"UPyD",3103
31,"31038",1372,982,968,17,14,"UPyD",18
12,"12122",835,674,658,14,16,"UPyD",5
24,"24203",109,73,73,0,0,"UPyD",5
42,"42075",91,71,70,1,1,"UPyD",0
33,"33023",3410,2501,2485,40,16,"UPyD",49
25,"25157",183,128,128,4,0,"UPyD",0
24,"24083",1165,831,819,17,12,"UPyD",27
21,"21070",6278,4489,4445,42,44,"UPyD",124
9,"9170",218,158,157,0,1,"UPyD",5
22,"22046",784,618,599,15,19,"UPyD",10
47,"47129",954,744,731,4,13,"UPyD",26
16,"16905",1017,811,806,14,5,"UPyD",59
22,"22047",228,200,200,5,0,"UPyD",13
49,"49275",53766,37940,37379,774,561,"UPyD",2223
43,"43045",156,110,109,1,1,"UPyD",0
34,"34114",240,171,171,0,0,"UPyD",2
26,"26131",44,36,36,0,0,"UPyD",0
8,"8098",2374,1552,1535,28,17,"UPyD",11
28,"28173",507,397,390,2,7,"UPyD",14
49,"49216",175,144,142,3,2,"UPyD",2
12,"12073",168,135,135,1,0,"UPyD",3
2,"2076",371,292,287,3,5,"UPyD",10
6,"6008",636,561,552,6,9,"UPyD",6
12,"12060",467,367,353,2,14,"UPyD",9
27,"27055",1494,1120,1107,8,13,"UPyD",5
28,"28082",5144,3967,3905,46,62,"UPyD",399
16,"16044",51,35,35,0,0,"UPyD",2
15,"15023",6629,4879,4795,52,84,"UPyD",24
6,"6010",1144,903,898,6,5,"UPyD",21
28,"28166",325,269,268,8,1,"UPyD",9
15,"15070",9684,6627,6464,141,163,"UPyD",66
27,"27041",2644,1946,1915,29,31,"UPyD",5
20,"20065",3176,2156,2137,19,19,"UPyD",14
8,"8120",6342,4801,4746,63,55,"UPyD",25
12,"12074",783,679,676,3,3,"UPyD",11
31,"31082",634,402,398,10,4,"UPyD",1
39,"39086",386,282,280,1,2,"UPyD",1
9,"9353",62,51,51,2,0,"UPyD",3
5,"5182",862,673,668,2,5,"UPyD",15
3,"3047",8867,6219,6113,76,106,"UPyD",283
19,"19161",243,171,166,2,5,"UPyD",6
15,"15033",2581,2094,2079,15,15,"UPyD",8
8,"8183",4497,2914,2865,43,49,"UPyD",6
46,"46193",8494,6662,6580,73,82,"UPyD",394
31,"31080",544,428,426,7,2,"UPyD",5
37,"37381",153,114,109,3,5,"UPyD",3
47,"47185",97,76,75,1,1,"UPyD",3
50,"50159",728,554,544,4,10,"UPyD",12
6,"6103",4777,3702,3671,31,31,"UPyD",84
9,"9129",112,93,93,0,0,"UPyD",0
31,"31022",544,378,369,1,9,"UPyD",0
44,"44180",71,52,52,1,0,"UPyD",0
46,"46008",2727,2249,2233,17,16,"UPyD",38
29,"29041",2796,1950,1921,24,29,"UPyD",44
5,"5019",44095,34409,33934,505,475,"UPyD",4825
8,"8285",10168,6582,6423,152,159,"UPyD",23
41,"41085",3918,3173,3128,42,45,"UPyD",166
14,"14011",595,498,497,4,1,"UPyD",3
31,"31054",498,310,308,1,2,"UPyD",2
45,"45194",57,41,41,0,0,"UPyD",0
11,"11013",2284,1691,1670,15,21,"UPyD",63
24,"24049",1528,1144,1124,22,20,"UPyD",26
19,"19173",52,42,42,3,0,"UPyD",1
25,"25164",404,270,264,5,6,"UPyD",0
3,"3060",124,100,98,0,2,"UPyD",0
7,"7024",6070,3232,3170,60,62,"UPyD",52
50,"50061",228,191,183,3,8,"UPyD",1
19,"19138",298,223,219,3,4,"UPyD",11
50,"50901",170,122,121,1,1,"UPyD",7
39,"39089",163,126,126,0,0,"UPyD",3
9,"9429",64,44,44,2,0,"UPyD",1
40,"40099",61,52,52,2,0,"UPyD",1
12,"12128",1448,1114,1092,16,22,"UPyD",24
16,"16106",2839,2351,2331,10,20,"UPyD",28
25,"25165",301,202,198,6,4,"UPyD",0
47,"47215",60,52,52,2,0,"UPyD",0
49,"49088",90,67,66,3,1,"UPyD",0
11,"11014",16318,11093,11031,144,62,"UPyD",364
9,"9311",70,51,51,0,0,"UPyD",1
50,"50141",116,98,98,1,0,"UPyD",3
5,"5022",1649,1335,1328,7,7,"UPyD",62
23,"23074",3039,2491,2451,29,40,"UPyD",36
9,"9086",629,467,461,5,6,"UPyD",33
9,"9132",174,129,127,3,2,"UPyD",7
31,"31904",1590,1054,1031,19,23,"UPyD",16
25,"25197",158,102,101,2,1,"UPyD",0
9,"9312",113,94,91,0,3,"UPyD",1
32,"32069",4573,3624,3580,35,44,"UPyD",21
44,"44157",62,45,44,0,1,"UPyD",0
13,"13051",358,291,289,5,2,"UPyD",1
43,"43108",1808,1183,1157,28,26,"UPyD",4
41,"41010",4338,2990,2958,48,32,"UPyD",206
17,"17003",101,67,64,2,3,"UPyD",0
46,"46043",149,139,139,0,0,"UPyD",8
29,"29045",1750,1246,1239,6,7,"UPyD",43
37,"37197",101,72,70,1,2,"UPyD",3
49,"49270",156,112,112,6,0,"UPyD",15
8,"8198",4112,2766,2661,49,105,"UPyD",15
27,"27064",1706,1233,1214,14,19,"UPyD",11
37,"37236",163,123,119,4,4,"UPyD",5
35,"35006",29515,20731,20286,362,445,"UPyD",448
19,"19242",112,93,92,1,1,"UPyD",1
25,"25097",102,70,69,3,1,"UPyD",0
10,"10028",125,88,88,0,0,"UPyD",2
17,"17155",14284,8528,8391,143,137,"UPyD",51
31,"31057",1863,1450,1409,32,41,"UPyD",19
22,"22157",251,176,175,9,1,"UPyD",0
49,"49093",308,248,245,5,3,"UPyD",7
2,"2012",1834,1632,1622,12,10,"UPyD",37
6,"6111",502,389,387,8,2,"UPyD",2
31,"31017",358,220,219,12,1,"UPyD",8
5,"5048",131,112,111,0,1,"UPyD",0
28,"28028",1615,1204,1173,11,31,"UPyD",87
24,"24041",602,403,396,3,7,"UPyD",11
31,"31262",219,158,157,4,1,"UPyD",0
19,"19178",45,34,34,0,0,"UPyD",3
10,"10207",499,394,392,1,2,"UPyD",4
6,"6037",1789,1258,1252,6,6,"UPyD",16
45,"45126",278,188,187,0,1,"UPyD",4
36,"36032",3666,2789,2755,25,34,"UPyD",12
10,"10003",616,463,458,3,5,"UPyD",12
24,"24120",379,258,256,3,2,"UPyD",4
8,"8200",61189,40677,40069,736,608,"UPyD",668
19,"19145",64,49,48,2,1,"UPyD",0
45,"45163",8239,6203,6073,103,130,"UPyD",423
31,"31120",408,267,265,8,2,"UPyD",4
34,"34129",191,144,142,0,2,"UPyD",1
16,"16154",4946,3975,3914,58,61,"UPyD",132
9,"9317",17,15,15,0,0,"UPyD",0
2,"2086",2856,2019,2005,9,14,"UPyD",29
18,"18072",710,507,499,2,8,"UPyD",11
45,"45189",655,510,502,3,8,"UPyD",20
29,"29038",16309,10579,10494,152,85,"UPyD",551
47,"47156",182,155,148,0,7,"UPyD",2
9,"9078",41,37,35,0,2,"UPyD",1
27,"27053",606,429,426,4,3,"UPyD",5
46,"46191",1952,1554,1528,9,26,"UPyD",43
50,"50222",1695,1117,1091,16,26,"UPyD",25
6,"6160",3190,2343,2314,12,29,"UPyD",30
10,"10168",318,240,238,1,2,"UPyD",4
4,"4095",777,547,541,8,6,"UPyD",18
10,"10033",440,340,336,4,4,"UPyD",2
42,"42046",55,35,35,0,0,"UPyD",1
42,"42196",14,11,11,0,0,"UPyD",0
43,"43086",5269,3275,3196,92,79,"UPyD",18
16,"16113",3075,2363,2338,36,25,"UPyD",47
5,"5062",213,188,184,3,4,"UPyD",6
11,"11019",1871,1449,1425,9,24,"UPyD",66
28,"28066",7033,5439,5383,45,56,"UPyD",495
44,"44205",757,541,527,12,14,"UPyD",6
46,"46184",26507,20314,20010,263,304,"UPyD",890
3,"3024",3908,3324,3271,34,53,"UPyD",76
18,"18099",1551,1217,1205,11,12,"UPyD",58
48,"48040",1274,936,921,10,15,"UPyD",2
43,"43104",1821,1209,1178,34,31,"UPyD",0
33,"33005",1600,1084,1080,6,4,"UPyD",18
31,"31153",2246,1504,1487,13,17,"UPyD",6
2,"2017",895,685,682,4,3,"UPyD",5
50,"50205",98,72,71,2,1,"UPyD",5
17,"17097",185,136,136,4,0,"UPyD",0
13,"13024",938,703,699,3,4,"UPyD",18
3,"3003",460,382,370,1,12,"UPyD",6
13,"13036",837,671,666,3,5,"UPyD",8
50,"50234",251,201,191,13,10,"UPyD",13
22,"22232",98,78,75,0,3,"UPyD",3
5,"5042",156,126,126,0,0,"UPyD",1
23,"23042",359,278,277,0,1,"UPyD",6
22,"22007",863,636,621,8,15,"UPyD",19
32,"32028",1805,1369,1354,16,15,"UPyD",2
20,"20018",11027,7428,7387,53,41,"UPyD",16
47,"47194",322,244,233,1,11,"UPyD",12
10,"10009",285,223,221,0,2,"UPyD",1
24,"24088",1103,903,885,4,18,"UPyD",13
4,"4054",384,328,325,0,3,"UPyD",7
45,"45168",61519,47265,46528,736,737,"UPyD",3483
25,"25133",748,499,483,7,16,"UPyD",0
44,"44208",32,23,23,1,0,"UPyD",0
13,"13003",503,390,387,2,3,"UPyD",5
3,"3005",7482,6191,6146,49,45,"UPyD",213
10,"10092",316,263,262,1,1,"UPyD",10
9,"9101",79,66,66,2,0,"UPyD",2
31,"31064",1500,1137,1120,12,17,"UPyD",7
10,"10213",605,478,477,1,1,"UPyD",1
49,"49145",251,154,153,0,1,"UPyD",1
1,"1046",629,428,421,5,7,"UPyD",8
39,"39096",719,521,518,4,3,"UPyD",4
35,"35012",9662,5511,5446,45,65,"UPyD",61
5,"5021",2044,1592,1557,37,35,"UPyD",104
32,"32005",957,760,753,8,7,"UPyD",2
19,"19076",36,29,29,0,0,"UPyD",0
50,"50004",613,445,441,6,4,"UPyD",13
29,"29098",1312,1043,1036,22,7,"UPyD",25
24,"24051",484,375,368,2,7,"UPyD",8
19,"19152",674,505,498,2,7,"UPyD",14
47,"47143",146,108,107,0,1,"UPyD",4
32,"32080",394,311,309,3,2,"UPyD",0
25,"25081",332,212,206,6,6,"UPyD",0
18,"18045",1211,892,885,4,7,"UPyD",27
47,"47034",90,65,63,0,2,"UPyD",3
49,"49147",301,243,239,4,4,"UPyD",9
5,"5100",307,245,245,2,0,"UPyD",5
47,"47061",266,227,223,0,4,"UPyD",6
33,"33015",1695,1177,1161,12,16,"UPyD",10
49,"49239",723,506,495,12,11,"UPyD",14
6,"6077",373,307,304,4,3,"UPyD",6
45,"45171",1359,1114,1093,13,21,"UPyD",30
19,"19153",25,17,17,0,0,"UPyD",0
37,"37096",235,199,197,3,2,"UPyD",5
23,"23091",790,668,664,3,4,"UPyD",3
49,"49104",383,281,276,2,5,"UPyD",3
6,"6123",4699,3509,3448,54,61,"UPyD",77
9,"9280",34,23,23,0,0,"UPyD",0
8,"8115",3870,2693,2644,60,49,"UPyD",16
46,"46026",1217,1043,1035,2,8,"UPyD",21
41,"41018",9457,6940,6867,66,73,"UPyD",237
20,"20023",451,260,259,2,1,"UPyD",1
15,"15065",7570,5710,5628,71,82,"UPyD",43
28,"28163",395,305,301,7,4,"UPyD",20
25,"25052",1611,1094,1062,21,32,"UPyD",1
48,"48090",6153,4682,4571,40,111,"UPyD",51
34,"34015",45,40,40,0,0,"UPyD",1
23,"23092",27970,20921,20651,284,270,"UPyD",1045
41,"41071",5603,3999,3932,28,67,"UPyD",115
19,"19142",259,191,190,0,1,"UPyD",9
49,"49177",298,199,196,6,3,"UPyD",2
46,"46052",532,471,463,2,8,"UPyD",12
33,"33017",3289,2378,2350,35,28,"UPyD",24
28,"28141",5568,4097,4051,31,46,"UPyD",469
26,"26127",236,206,204,1,2,"UPyD",2
21,"21038",1146,786,767,9,19,"UPyD",22
23,"23094",3917,3200,3166,32,34,"UPyD",58
8,"8209",6596,4415,4351,69,64,"UPyD",59
25,"25119",2297,1554,1513,46,41,"UPyD",1
10,"10070",765,614,613,5,1,"UPyD",7
4,"4082",309,216,214,3,2,"UPyD",12
22,"22074",311,227,219,5,8,"UPyD",8
17,"17214",695,470,461,10,9,"UPyD",1
25,"25098",266,177,177,0,0,"UPyD",0
21,"21049",3468,2327,2283,18,44,"UPyD",51
12,"12081",654,519,515,2,4,"UPyD",31
34,"34186",61,53,53,0,0,"UPyD",4
42,"42108",13,10,10,1,0,"UPyD",0
17,"17157",127,99,98,3,1,"UPyD",1
13,"13098",2265,1805,1759,19,46,"UPyD",38
27,"27037",1205,857,845,13,12,"UPyD",6
16,"16041",395,289,287,6,2,"UPyD",8
33,"33018",2971,2139,2121,32,18,"UPyD",48
3,"3043",2933,2494,2447,27,47,"UPyD",61
25,"25179",198,141,136,1,5,"UPyD",0
21,"21039",313,233,232,2,1,"UPyD",8
49,"49231",360,256,254,4,2,"UPyD",9
24,"24096",145,96,93,0,3,"UPyD",5
27,"27022",5093,3535,3486,74,49,"UPyD",11
50,"50279",111,79,79,1,0,"UPyD",1
37,"37151",150,125,121,1,4,"UPyD",3
34,"34210",103,93,91,2,2,"UPyD",1
18,"18040",246,147,146,0,1,"UPyD",8
39,"39024",2065,1616,1601,8,15,"UPyD",36
31,"31090",156,77,77,0,0,"UPyD",0
28,"28008",1734,1244,1221,11,23,"UPyD",73
26,"26175",57,46,45,1,1,"UPyD",0
6,"6130",216,182,180,0,2,"UPyD",2
22,"22060",1180,909,891,13,18,"UPyD",23
19,"19120",107,95,95,1,0,"UPyD",5
43,"43144",1187,787,772,12,15,"UPyD",10
16,"16004",325,247,246,0,1,"UPyD",1
17,"17227",107,82,82,1,0,"UPyD",0
8,"8273",2287,1594,1547,18,47,"UPyD",2
46,"46054",11422,8666,8566,82,100,"UPyD",481
36,"36012",3839,2884,2825,14,59,"UPyD",18
24,"24110",1291,914,904,16,10,"UPyD",24
19,"19046",20318,15118,14892,219,226,"UPyD",1550
32,"32014",1271,939,925,9,14,"UPyD",6
37,"37129",247,198,198,4,0,"UPyD",16
28,"28009",13466,10392,10286,102,106,"UPyD",1134
7,"7065",2061,1376,1345,29,31,"UPyD",19
25,"25171",2305,1496,1469,37,27,"UPyD",7
44,"44219",207,159,157,1,2,"UPyD",3
37,"37217",60,49,48,1,1,"UPyD",4
18,"18121",135,109,109,0,0,"UPyD",3
46,"46104",2012,1691,1676,9,15,"UPyD",42
50,"50214",31,22,21,1,1,"UPyD",1
35,"35010",3565,2178,2135,26,43,"UPyD",30
19,"19037",153,128,128,0,0,"UPyD",3
8,"8214",6754,4659,4555,83,104,"UPyD",26
19,"19248",64,53,53,0,0,"UPyD",9
16,"16006",133,117,116,2,1,"UPyD",4
40,"40094",375,286,284,4,2,"UPyD",16
16,"16073",214,170,170,2,0,"UPyD",3
46,"46023",318,275,267,2,8,"UPyD",5
19,"19259",37,32,32,0,0,"UPyD",0
5,"5043",86,68,68,0,0,"UPyD",0
28,"28167",7818,6016,5942,82,74,"UPyD",731
6,"6134",561,399,398,5,1,"UPyD",3
6,"6043",661,542,532,3,10,"UPyD",13
18,"18122",16253,12271,12109,132,162,"UPyD",485
17,"17020",3446,2322,2268,45,54,"UPyD",4
18,"18054",879,646,644,4,2,"UPyD",18
10,"10118",306,262,261,2,1,"UPyD",8
34,"34151",184,125,123,1,2,"UPyD",2
25,"25182",1075,749,731,30,18,"UPyD",6
10,"10146",1439,991,975,11,16,"UPyD",12
24,"24114",3441,2322,2304,42,18,"UPyD",58
25,"25092",135,100,97,2,3,"UPyD",0
49,"49203",345,294,292,4,2,"UPyD",7
25,"25183",485,336,327,6,9,"UPyD",1
26,"26138",4646,3468,3398,46,70,"UPyD",120
24,"24115",54654,38629,38010,716,619,"UPyD",1953
6,"6029",1230,884,880,5,4,"UPyD",8
47,"47206",111,99,99,0,0,"UPyD",7
46,"46227",923,787,771,4,16,"UPyD",16
16,"16009",79,63,62,0,1,"UPyD",4
6,"6090",904,724,710,10,14,"UPyD",13
23,"23045",2180,1671,1667,3,4,"UPyD",6
46,"46130",934,745,734,6,11,"UPyD",24
18,"18056",3695,2961,2940,25,21,"UPyD",49
42,"42172",31,28,28,3,0,"UPyD",2
25,"25060",92,53,52,1,1,"UPyD",0
32,"32092",596,367,364,2,3,"UPyD",1
8,"8032",1955,1330,1294,18,36,"UPyD",7
6,"6092",592,468,456,5,12,"UPyD",5
22,"22235",101,88,87,1,1,"UPyD",1
14,"14003",1289,1046,1026,12,20,"UPyD",12
31,"31259",503,341,336,6,5,"UPyD",1
42,"42069",1591,1122,1114,33,8,"UPyD",20
6,"6138",1070,838,829,13,9,"UPyD",11
47,"47207",325,265,263,4,2,"UPyD",8
47,"47018",33,30,28,2,2,"UPyD",0
19,"19230",438,317,309,4,8,"UPyD",29
49,"49206",948,706,692,15,14,"UPyD",16
9,"9209",4617,3269,3234,44,35,"UPyD",176
37,"37222",124,92,92,2,0,"UPyD",3
21,"21016",1076,823,790,11,33,"UPyD",5
9,"9035",336,255,251,3,4,"UPyD",5
8,"8064",1847,1277,1246,14,31,"UPyD",0
26,"26014",472,358,353,6,5,"UPyD",11
29,"29063",358,272,271,2,1,"UPyD",5
3,"3052",984,837,820,10,17,"UPyD",29
28,"28013",38226,27886,27547,246,339,"UPyD",2206
6,"6140",654,533,523,7,10,"UPyD",11
47,"47208",56,45,43,1,2,"UPyD",1
31,"31077",5349,4025,3917,103,108,"UPyD",91
43,"43149",711,529,516,13,13,"UPyD",0
10,"10110",2326,1751,1703,11,48,"UPyD",37
34,"34156",56,48,48,2,0,"UPyD",1
46,"46251",2599,2215,2179,21,36,"UPyD",76
24,"24201",1123,790,777,14,13,"UPyD",47
9,"9251",417,292,288,3,4,"UPyD",10
24,"24119",742,524,510,15,14,"UPyD",17
36,"36052",7517,5563,5461,54,102,"UPyD",37
50,"50164",407,271,268,4,3,"UPyD",14
19,"19901",43,34,34,0,0,"UPyD",2
46,"46206",595,497,495,3,2,"UPyD",16
47,"47180",96,82,81,0,1,"UPyD",5
46,"46003",988,864,847,13,17,"UPyD",14
8,"8106",6858,4675,4559,113,116,"UPyD",52
34,"34206",952,796,780,9,16,"UPyD",9
31,"31018",422,303,299,8,4,"UPyD",15
20,"20905",142,105,103,1,2,"UPyD",0
50,"50174",107,92,90,0,2,"UPyD",0
19,"19129",48,33,31,0,2,"UPyD",0
47,"47155",3043,2246,2225,35,21,"UPyD",203
46,"46134",2326,1691,1664,20,27,"UPyD",129
12,"12080",2051,1692,1650,23,42,"UPyD",41
45,"45114",608,476,468,3,8,"UPyD",16
45,"45150",471,388,382,1,6,"UPyD",5
43,"43028",2654,1620,1588,27,32,"UPyD",9
19,"19168",324,233,231,6,2,"UPyD",8
5,"5014",5559,4197,4101,53,96,"UPyD",168
31,"31019",1858,1288,1266,25,22,"UPyD",20
50,"50135",100,76,75,2,1,"UPyD",1
26,"26129",1010,794,780,7,14,"UPyD",18
9,"9109",1181,664,631,16,33,"UPyD",40
6,"6129",631,493,490,2,3,"UPyD",5
31,"31020",488,247,246,0,1,"UPyD",0
19,"19234",63,48,48,0,0,"UPyD",3
2,"2075",1689,1386,1372,10,14,"UPyD",30
4,"4903",4331,3183,3164,31,19,"UPyD",59
43,"43103",897,586,575,21,11,"UPyD",9
10,"10154",194,150,145,0,5,"UPyD",1
47,"47074",155,125,124,0,1,"UPyD",2
8,"8282",6092,4478,4405,79,73,"UPyD",42
18,"18133",2256,1783,1773,12,10,"UPyD",36
16,"16056",495,377,374,11,3,"UPyD",8
4,"4085",453,384,383,0,1,"UPyD",6
37,"37229",144,108,108,0,0,"UPyD",3
45,"45190",502,425,414,6,11,"UPyD",5
37,"37152",474,357,351,2,6,"UPyD",15
31,"31111",100,75,75,1,0,"UPyD",0
24,"24044",176,138,136,2,2,"UPyD",6
12,"12124",1902,1532,1499,15,33,"UPyD",26
43,"43128",927,636,625,11,11,"UPyD",2
9,"9127",54,39,39,0,0,"UPyD",2
7,"7020",3455,2491,2453,46,38,"UPyD",57
50,"50243",346,277,272,2,5,"UPyD",0
34,"34116",76,50,49,1,1,"UPyD",2
43,"43096",103,81,77,3,4,"UPyD",0
25,"25089",107,66,64,0,2,"UPyD",0
43,"43177",338,242,236,6,6,"UPyD",0
48,"48007",354,254,253,1,1,"UPyD",0
31,"31112",106,79,78,0,1,"UPyD",0
3,"3058",4798,4126,4103,26,23,"UPyD",112
37,"37155",81,57,57,0,0,"UPyD",3
24,"24193",371,254,252,3,2,"UPyD",6
16,"16018",417,350,342,3,8,"UPyD",10
45,"45155",481,382,375,3,7,"UPyD",14
25,"25181",189,128,123,3,5,"UPyD",0
45,"45204",621,500,497,1,3,"UPyD",15
24,"24142",24843,17695,17371,409,324,"UPyD",1278
45,"45032",471,340,333,2,7,"UPyD",16
37,"37020",449,371,365,7,6,"UPyD",16
19,"19203",35,27,27,0,0,"UPyD",3
37,"37268",113,78,77,1,1,"UPyD",10
32,"32065",720,550,539,3,11,"UPyD",0
44,"44153",1882,1273,1246,10,27,"UPyD",41
46,"46186",18444,14173,14029,135,144,"UPyD",1079
5,"5086",96,81,81,2,0,"UPyD",4
25,"25070",888,594,582,18,12,"UPyD",0
2,"2006",612,540,534,1,6,"UPyD",8
25,"25012",2204,1432,1406,29,26,"UPyD",16
25,"25194",440,292,283,11,9,"UPyD",0
10,"10159",341,278,277,1,1,"UPyD",0
28,"28060",1471,1205,1192,8,13,"UPyD",68
10,"10119",714,489,482,3,7,"UPyD",7
49,"49129",903,671,661,16,10,"UPyD",16
25,"25102",733,478,464,15,14,"UPyD",1
41,"41033",5237,3915,3878,20,37,"UPyD",120
46,"46041",369,255,255,1,0,"UPyD",6
47,"47133",2382,1861,1841,30,20,"UPyD",143
46,"46235",21966,16641,16465,167,176,"UPyD",427
27,"27014",3511,2470,2437,45,33,"UPyD",12
37,"37270",201,159,158,0,1,"UPyD",11
49,"49087",581,358,356,3,2,"UPyD",4
39,"39088",70,61,61,1,0,"UPyD",1
3,"3117",381,321,317,4,4,"UPyD",5
19,"19240",64,47,46,1,1,"UPyD",4
32,"32031",1079,837,828,5,9,"UPyD",4
30,"30040",733,640,635,2,5,"UPyD",10
34,"34039",66,57,56,0,1,"UPyD",0
11,"11042",1232,933,922,4,11,"UPyD",21
2,"2045",3763,3086,3035,42,51,"UPyD",65
43,"43033",772,547,533,4,14,"UPyD",2
24,"24011",244,131,129,0,2,"UPyD",2
49,"49132",338,245,238,0,7,"UPyD",7
31,"31176",2777,1999,1955,57,44,"UPyD",54
50,"50256",90,59,59,1,0,"UPyD",2
8,"8134",776,528,513,15,15,"UPyD",6
21,"21026",255,181,169,2,12,"UPyD",6
40,"40163",62,51,51,5,0,"UPyD",6
30,"30041",12957,9360,9288,89,72,"UPyD",448
12,"12067",563,458,439,8,19,"UPyD",11
8,"8197",7316,4983,4926,69,57,"UPyD",44
46,"46212",1598,1233,1218,5,15,"UPyD",45
31,"31086",11499,8520,8389,214,131,"UPyD",237
46,"46115",515,364,354,1,10,"UPyD",24
45,"45086",491,406,399,3,7,"UPyD",9
37,"37037",130,100,99,0,1,"UPyD",4
8,"8135",6647,4753,4678,79,75,"UPyD",62
9,"9088",77,40,40,0,0,"UPyD",0
37,"37001",224,182,181,0,1,"UPyD",9
41,"41062",2252,1719,1698,12,21,"UPyD",12
37,"37161",157,118,116,1,2,"UPyD",2
18,"18171",2093,1719,1704,10,15,"UPyD",39
50,"50172",187,140,138,4,2,"UPyD",2
34,"34170",72,56,56,1,0,"UPyD",0
50,"50229",62,47,46,2,1,"UPyD",1
17,"17083",2886,1825,1801,39,24,"UPyD",7
43,"43109",2040,1332,1316,28,16,"UPyD",22
4,"4092",2897,2351,2325,13,26,"UPyD",49
49,"49092",160,123,123,2,0,"UPyD",0
49,"49134",203,142,142,4,0,"UPyD",3
16,"16196",658,578,568,6,10,"UPyD",6
9,"9408",45,36,36,0,0,"UPyD",1
50,"50083",96,72,72,1,0,"UPyD",6
8,"8199",712,507,499,15,8,"UPyD",3
16,"16181",73,62,62,1,0,"UPyD",0
19,"19222",120,90,89,3,1,"UPyD",2
37,"37125",243,184,180,3,4,"UPyD",5
3,"3031",39966,27099,26802,291,297,"UPyD",1217
6,"6142",284,240,235,4,5,"UPyD",2
26,"26003",446,388,387,8,1,"UPyD",5
43,"43084",573,383,378,6,5,"UPyD",1
49,"49272",102,87,86,0,1,"UPyD",0
50,"50144",36,32,32,0,0,"UPyD",1
22,"22902",240,169,169,3,0,"UPyD",9
19,"19278",30,28,28,0,0,"UPyD",1
44,"44121",63,48,48,1,0,"UPyD",2
49,"49136",347,249,247,6,2,"UPyD",6
3,"3065",164772,124457,123236,1556,1221,"UPyD",6973
44,"44076",2338,1839,1797,36,42,"UPyD",34
37,"37040",431,362,362,4,0,"UPyD",15
17,"17034",6723,4131,4064,77,67,"UPyD",29
24,"24218",476,344,340,11,4,"UPyD",10
22,"22107",131,81,77,1,4,"UPyD",3
24,"24017",630,476,468,11,8,"UPyD",9
8,"8047",4141,2610,2580,49,30,"UPyD",24
43,"43077",486,335,328,4,7,"UPyD",0
37,"37029",226,181,178,4,3,"UPyD",7
25,"25158",1647,1154,1135,27,19,"UPyD",1
3,"3033",127,102,97,2,5,"UPyD",3
41,"41039",31429,23337,23138,294,199,"UPyD",781
19,"19070",100,74,74,0,0,"UPyD",4
29,"29094",54317,36540,36174,410,366,"UPyD",1386
5,"5061",264,222,214,5,8,"UPyD",21
16,"16199",27,20,19,0,1,"UPyD",0
5,"5224",104,90,90,0,0,"UPyD",11
49,"49097",97,55,55,1,0,"UPyD",1
43,"43013",4369,2795,2747,54,48,"UPyD",19
17,"17067",732,483,470,16,13,"UPyD",1
50,"50147",845,637,627,12,10,"UPyD",30
2,"2015",1508,1230,1211,7,19,"UPyD",32
8,"8139",184,130,128,1,2,"UPyD",0
40,"40172",34,27,26,0,1,"UPyD",1
8,"8140",4665,3160,3103,55,57,"UPyD",3
6,"6161",335,261,259,2,2,"UPyD",12
10,"10116",3762,2781,2705,36,76,"UPyD",84
18,"18042",425,344,342,2,2,"UPyD",7
35,"35001",4663,3639,3569,39,70,"UPyD",51
28,"28152",14903,11954,11865,125,89,"UPyD",1259
44,"44124",88,63,61,3,2,"UPyD",1
26,"26163",143,118,116,2,2,"UPyD",5
44,"44206",156,119,117,3,2,"UPyD",4
16,"16031",62,34,32,4,2,"UPyD",1
24,"24020",480,326,324,9,2,"UPyD",20
17,"17217",347,267,251,5,16,"UPyD",0
45,"45093",168,133,133,0,0,"UPyD",6
43,"43907",4122,2759,2712,52,47,"UPyD",52
9,"9413",500,335,331,1,4,"UPyD",13
34,"34023",5318,3947,3891,64,56,"UPyD",185
23,"23101",413,324,321,3,3,"UPyD",4
18,"18145",10083,7592,7499,78,93,"UPyD",591
25,"25193",771,509,501,8,8,"UPyD",3
9,"9368",26,18,18,0,0,"UPyD",2
2,"2054",421,346,343,2,3,"UPyD",7
21,"21033",508,385,382,7,3,"UPyD",4
34,"34178",106,93,93,1,0,"UPyD",0
23,"23086",11411,8918,8798,129,120,"UPyD",301
46,"46048",3484,2915,2875,26,40,"UPyD",83
3,"3037",354,293,289,1,4,"UPyD",8
50,"50149",48,35,35,0,0,"UPyD",0
3,"3140",26223,19998,19552,338,446,"UPyD",970
6,"6028",4366,3881,3809,35,72,"UPyD",76
6,"6074",4777,3730,3659,41,71,"UPyD",150
28,"28161",44185,33371,32966,353,405,"UPyD",4090
32,"32078",1366,1026,1018,3,8,"UPyD",4
15,"15063",2849,2022,2001,28,21,"UPyD",12
9,"9454",46,31,30,1,1,"UPyD",1
25,"25079",307,242,240,7,2,"UPyD",0
37,"37047",178,111,111,0,0,"UPyD",1
49,"49011",236,195,194,5,1,"UPyD",6
18,"18078",768,638,637,1,1,"UPyD",7
10,"10051",489,373,373,2,0,"UPyD",2
43,"43016",3437,2323,2266,40,57,"UPyD",20
28,"28116",666,507,498,5,9,"UPyD",52
24,"24225",1089,798,784,15,14,"UPyD",25
31,"31004",36,21,20,0,1,"UPyD",0
47,"47169",70,57,57,0,0,"UPyD",2
2,"2020",519,433,430,0,3,"UPyD",1
37,"37207",287,211,208,2,3,"UPyD",24
37,"37133",108,79,77,0,2,"UPyD",2
8,"8113",52352,33606,33123,590,483,"UPyD",174
10,"10215",437,338,333,3,5,"UPyD",4
37,"37050",71,48,48,1,0,"UPyD",1
32,"32043",2679,2006,1985,14,21,"UPyD",6
45,"45097",1094,934,925,9,9,"UPyD",28
33,"33038",2442,1757,1725,14,32,"UPyD",41
35,"35013",6779,5059,4961,105,98,"UPyD",63
47,"47144",85,65,65,2,0,"UPyD",0
17,"17012",1093,689,679,11,10,"UPyD",9
4,"4102",12940,9247,9152,90,95,"UPyD",225
9,"9022",83,58,58,2,0,"UPyD",7
17,"17222",108,86,86,1,0,"UPyD",0
34,"34182",860,657,649,8,8,"UPyD",11
5,"5101",297,224,222,4,2,"UPyD",4
26,"26125",2720,2121,2084,26,37,"UPyD",84
13,"13029",102,90,89,0,1,"UPyD",7
47,"47171",453,371,368,10,3,"UPyD",17
9,"9279",195,140,140,4,0,"UPyD",4
31,"31127",145,89,89,2,0,"UPyD",0
29,"29026",1130,815,799,7,16,"UPyD",9
37,"37135",1234,972,961,8,11,"UPyD",35
45,"45099",3449,2451,2405,22,46,"UPyD",111
37,"37173",1643,1298,1285,26,13,"UPyD",30
6,"6079",623,525,522,6,3,"UPyD",8
37,"37123",206,166,165,1,1,"UPyD",2
34,"34232",802,632,623,9,9,"UPyD",9
37,"37211",223,169,169,1,0,"UPyD",11
13,"13096",7716,5759,5659,70,100,"UPyD",165
4,"4103",1555,1159,1157,8,2,"UPyD",18
6,"6080",1942,1519,1507,9,12,"UPyD",27
47,"47172",149,125,124,3,1,"UPyD",2
31,"31221",1182,774,767,12,7,"UPyD",7
17,"17043",159,101,100,2,1,"UPyD",0
9,"9239",52,42,42,1,0,"UPyD",0
50,"50192",240,188,184,9,4,"UPyD",5
37,"37250",405,277,274,1,3,"UPyD",8
49,"49242",503,421,410,5,11,"UPyD",9
24,"24016",544,323,322,4,1,"UPyD",4
34,"34112",50,39,38,2,1,"UPyD",1
4,"4035",8213,6218,6171,51,47,"UPyD",161
45,"45028",3696,3059,3024,40,35,"UPyD",87
22,"22176",173,154,149,2,5,"UPyD",1
25,"25120",90759,58761,57778,1325,983,"UPyD",493
17,"17138",1010,677,662,3,15,"UPyD",5
9,"9241",198,159,158,5,1,"UPyD",21
49,"49243",117,85,85,0,0,"UPyD",1
42,"42015",34,24,24,5,0,"UPyD",0
45,"45102",3539,2581,2533,23,48,"UPyD",93
31,"31222",67,46,44,3,2,"UPyD",0
13,"13065",3011,2105,2088,24,17,"UPyD",47
31,"31130",319,213,209,1,4,"UPyD",1
50,"50094",1744,1220,1193,25,27,"UPyD",29
24,"24108",421,316,314,6,2,"UPyD",4
9,"9242",93,82,82,2,0,"UPyD",1
4,"4024",3049,2396,2361,19,35,"UPyD",89
47,"47200",91,73,73,0,0,"UPyD",1
37,"37127",229,183,182,3,1,"UPyD",11
10,"10019",1414,1054,1037,10,17,"UPyD",32
18,"18152",1037,822,818,9,4,"UPyD",9
37,"37289",265,211,209,0,2,"UPyD",3
9,"9154",150,107,107,3,0,"UPyD",3
6,"6038",816,621,620,6,1,"UPyD",5
29,"29001",4176,3339,3303,23,36,"UPyD",66
31,"31162",53,35,34,1,1,"UPyD",1
16,"16273",328,277,275,2,2,"UPyD",6
31,"31010",5788,3716,3637,48,79,"UPyD",44
43,"43095",2434,1658,1624,27,34,"UPyD",20
45,"45140",1087,885,867,6,18,"UPyD",15
5,"5106",39,26,26,0,0,"UPyD",1
31,"31224",980,691,681,9,10,"UPyD",14
39,"39102",2330,1748,1731,13,17,"UPyD",30
12,"12114",228,178,173,2,5,"UPyD",13
8,"8243",160,112,110,3,2,"UPyD",0
49,"49154",147,104,102,1,2,"UPyD",0
5,"5041",1051,840,827,13,13,"UPyD",36
6,"6086",1270,956,949,2,7,"UPyD",13
43,"43038",20710,12999,12771,224,228,"UPyD",230
19,"19192",1743,1370,1359,10,11,"UPyD",48
17,"17107",301,203,200,8,3,"UPyD",0
31,"31163",2008,1458,1434,22,24,"UPyD",16
18,"18153",8348,6170,6118,88,52,"UPyD",342
16,"16130",633,504,492,5,12,"UPyD",11
9,"9471",171,127,125,1,2,"UPyD",4
39,"39025",8985,7048,6955,70,93,"UPyD",141
9,"9201",33,22,22,2,0,"UPyD",0
6,"6133",1744,1343,1328,22,15,"UPyD",31
13,"13057",1214,1018,998,9,20,"UPyD",20
8,"8110",13366,8493,8329,144,164,"UPyD",70
21,"21043",1898,1382,1350,9,32,"UPyD",29
31,"31032",1785,1330,1305,24,25,"UPyD",22
9,"9292",98,73,71,3,2,"UPyD",3
6,"6088",12879,9362,9222,153,140,"UPyD",306
18,"18154",1062,770,769,0,1,"UPyD",8
26,"26135",181,139,137,1,2,"UPyD",3
9,"9339",139,105,104,1,1,"UPyD",3
8,"8152",129,94,93,0,1,"UPyD",0
17,"17230",456,326,320,10,6,"UPyD",3
49,"49157",177,140,140,0,0,"UPyD",6
3,"3081",1409,1102,1087,14,15,"UPyD",29
31,"31013",668,382,375,12,7,"UPyD",5
18,"18089",15803,10794,10712,95,82,"UPyD",360
17,"17049",3056,1986,1944,43,42,"UPyD",16
34,"34199",1354,1004,978,27,26,"UPyD",34
19,"19194",113,80,76,1,4,"UPyD",5
32,"32017",1333,906,895,10,11,"UPyD",7
7,"7012",1880,1437,1405,20,32,"UPyD",7
39,"39053",251,179,179,1,0,"UPyD",1
50,"50273",36,22,22,0,0,"UPyD",0
49,"49251",191,157,154,7,3,"UPyD",4
2,"2068",379,290,284,3,6,"UPyD",8
37,"37022",287,237,232,0,5,"UPyD",2
29,"29005",4307,2967,2951,18,16,"UPyD",61
18,"18158",10328,7336,7254,69,82,"UPyD",172
27,"27045",1149,817,812,7,5,"UPyD",3
10,"10147",1263,1003,965,5,38,"UPyD",5
3,"3082",11741,8208,8102,80,106,"UPyD",309
22,"22131",96,79,77,2,2,"UPyD",6
24,"24077",237,205,199,2,6,"UPyD",4
16,"16175",5058,4363,4295,70,68,"UPyD",91
3,"3050",17818,12860,12706,160,154,"UPyD",880
10,"10065",188,123,123,1,0,"UPyD",5
31,"31197",69,58,57,1,1,"UPyD",0
48,"48033",223,171,171,1,0,"UPyD",0
4,"4008",530,423,418,4,5,"UPyD",7
24,"24198",644,423,417,7,6,"UPyD",9
40,"40007",86,70,69,0,1,"UPyD",0
34,"34243",352,274,273,5,1,"UPyD",4
37,"37146",135,117,117,1,0,"UPyD",1
29,"29062",647,573,571,1,2,"UPyD",2
24,"24117",493,376,369,2,7,"UPyD",4
48,"48903",1909,1455,1430,4,25,"UPyD",10
28,"28125",2808,2077,2055,19,22,"UPyD",130
22,"22083",522,437,428,4,9,"UPyD",3
49,"49119",245,194,191,2,3,"UPyD",2
9,"9166",97,87,87,1,0,"UPyD",3
12,"12089",4277,3009,2946,32,63,"UPyD",74
13,"13073",565,459,456,2,3,"UPyD",6
50,"50072",181,128,127,1,1,"UPyD",0
46,"46229",1065,840,831,8,9,"UPyD",16
10,"10068",780,624,595,5,29,"UPyD",7
40,"40008",44,37,36,0,1,"UPyD",0
45,"45185",7912,6321,6180,68,141,"UPyD",306
24,"24080",228,165,164,0,1,"UPyD",6
6,"6003",875,705,691,4,14,"UPyD",11
22,"22043",112,72,71,2,1,"UPyD",1
48,"48069",12381,8760,8672,66,88,"UPyD",78
10,"10151",245,204,202,2,2,"UPyD",1
44,"44226",163,112,112,3,0,"UPyD",2
34,"34205",70,55,55,1,0,"UPyD",0
41,"41054",671,556,550,0,6,"UPyD",26
9,"9432",212,161,158,1,3,"UPyD",3
31,"31231",127,93,91,1,2,"UPyD",5
37,"37149",78,69,69,0,0,"UPyD",2
9,"9168",329,254,254,2,0,"UPyD",3
19,"19264",45,39,39,0,0,"UPyD",3
17,"17014",64,39,37,0,2,"UPyD",0
33,"33025",9455,6331,6277,84,54,"UPyD",206
26,"26100",59,51,51,1,0,"UPyD",2
24,"24162",1631,1214,1195,33,19,"UPyD",75
31,"31089",246,198,195,4,3,"UPyD",10
18,"18096",348,289,287,1,2,"UPyD",1
10,"10030",502,364,362,5,2,"UPyD",7
22,"22244",61,46,44,1,2,"UPyD",1
13,"13075",212,161,159,1,2,"UPyD",3
49,"49122",701,542,534,7,8,"UPyD",25
34,"34158",336,202,200,0,2,"UPyD",5
9,"9255",90,68,68,0,0,"UPyD",3
45,"45003",607,515,511,3,4,"UPyD",13
6,"6097",2475,1934,1902,27,32,"UPyD",52
19,"19096",99,79,78,1,1,"UPyD",4
37,"37069",952,737,723,12,14,"UPyD",27
8,"8097",985,676,657,3,19,"UPyD",5
6,"6099",1127,815,805,6,10,"UPyD",18
46,"46159",23111,17258,17086,141,172,"UPyD",1061
44,"44149",106,79,78,2,1,"UPyD",1
12,"12093",254,190,187,0,3,"UPyD",2
39,"39075",140941,103308,102362,1364,946,"UPyD",5288
23,"23021",541,464,453,0,11,"UPyD",5
3,"3089",9696,7447,7302,83,145,"UPyD",214
31,"31233",103,87,82,2,5,"UPyD",1
12,"12123",70,50,48,2,2,"UPyD",0
26,"26146",141,98,96,0,2,"UPyD",4
44,"44191",806,602,594,6,8,"UPyD",7
4,"4084",370,290,285,6,5,"UPyD",10
16,"16187",78,61,60,3,1,"UPyD",0
9,"9257",93,73,72,2,1,"UPyD",7
50,"50194",102,67,67,2,0,"UPyD",1
10,"10073",759,589,583,3,6,"UPyD",8
6,"6100",1000,828,821,3,7,"UPyD",4
17,"17027",2865,1955,1892,34,63,"UPyD",6
25,"25223",951,562,546,14,16,"UPyD",0
29,"29085",156,116,113,0,3,"UPyD",3
24,"24006",521,384,378,4,6,"UPyD",8
29,"29011",3013,1893,1876,7,17,"UPyD",65
40,"40109",84,70,67,0,3,"UPyD",2
23,"23067",2523,2004,1974,16,30,"UPyD",34
4,"4038",3140,2258,2231,44,27,"UPyD",73
12,"12094",807,612,604,14,8,"UPyD",30
50,"50195",48,38,38,1,0,"UPyD",0
14,"14070",1385,1131,1111,4,20,"UPyD",17
46,"46233",3911,3025,2988,10,37,"UPyD",98
49,"49170",111,87,85,1,2,"UPyD",1
34,"34213",67,50,50,0,0,"UPyD",4
2,"2078",967,770,756,9,14,"UPyD",23
12,"12126",24420,18431,18136,231,295,"UPyD",438
41,"41084",2875,2362,2335,9,27,"UPyD",46
18,"18053",1836,1345,1340,11,5,"UPyD",30
21,"21073",1840,1249,1236,13,13,"UPyD",29
31,"31093",305,207,203,2,4,"UPyD",0
44,"44138",158,109,106,0,3,"UPyD",3
18,"18064",419,347,345,3,2,"UPyD",1
31,"31083",50,37,37,0,0,"UPyD",0
44,"44026",89,69,69,0,0,"UPyD",2
25,"25101",583,391,382,8,9,"UPyD",0
16,"16019",252,210,207,2,3,"UPyD",0
5,"5119",41,31,31,0,0,"UPyD",1
20,"20042",3354,2131,2117,18,14,"UPyD",5
3,"3093",19646,15399,15159,173,240,"UPyD",1535
8,"8225",92,68,68,2,0,"UPyD",0
19,"19103",303,247,244,3,3,"UPyD",7
30,"30013",7369,5780,5731,53,49,"UPyD",181
32,"32066",634,492,488,0,4,"UPyD",0
31,"31023",5338,3986,3920,120,66,"UPyD",151
10,"10037",74974,56844,55950,898,894,"UPyD",3632
50,"50197",89,65,65,3,0,"UPyD",0
50,"50022",548,430,416,10,14,"UPyD",4
22,"22150",491,342,336,9,6,"UPyD",17
35,"35029",3981,2341,2315,43,26,"UPyD",21
15,"15025",1173,780,777,10,3,"UPyD",5
4,"4088",2516,1849,1832,7,17,"UPyD",43
19,"19023",121,95,94,5,1,"UPyD",6
5,"5055",649,525,518,3,7,"UPyD",24
32,"32030",1120,857,846,9,11,"UPyD",3
37,"37346",264,211,210,1,1,"UPyD",4
19,"19307",30,27,27,0,0,"UPyD",1
31,"31055",264,194,193,0,1,"UPyD",1
32,"32067",1487,1004,995,10,9,"UPyD",3
25,"25013",2274,1344,1321,25,23,"UPyD",2
23,"23030",1270,1052,1045,3,7,"UPyD",11
48,"48044",63869,47453,47085,511,368,"UPyD",1105
36,"36028",4207,3294,3254,21,40,"UPyD",21
38,"38034",4092,3034,2983,30,51,"UPyD",41
42,"42037",38,23,20,3,3,"UPyD",0
49,"49040",118,102,98,1,4,"UPyD",2
18,"18170",377,238,237,0,1,"UPyD",9
22,"22011",102,78,78,3,0,"UPyD",5
9,"9177",1154,823,815,12,8,"UPyD",50
31,"31116",71,48,48,2,0,"UPyD",2
6,"6107",1610,1131,1128,6,3,"UPyD",11
44,"44117",357,278,275,0,3,"UPyD",7
41,"41102",14343,11050,10837,206,213,"UPyD",412
50,"50199",380,263,254,2,9,"UPyD",12
36,"36029",16178,11902,11636,148,266,"UPyD",111
50,"50284",176,131,130,1,1,"UPyD",2
41,"41035",1171,898,889,12,9,"UPyD",25
9,"9178",61,48,48,0,0,"UPyD",4
29,"29044",866,631,627,3,4,"UPyD",11
18,"18907",1997,1627,1612,5,15,"UPyD",21
8,"8165",1689,1091,1070,18,21,"UPyD",8
25,"25228",2907,2043,2021,43,22,"UPyD",15
44,"44071",657,453,448,9,5,"UPyD",11
50,"50200",534,436,432,9,4,"UPyD",9
32,"32070",660,457,452,1,5,"UPyD",0
18,"18103",803,653,647,5,6,"UPyD",3
19,"19211",450,340,334,0,6,"UPyD",12
47,"47163",315,253,250,2,3,"UPyD",6
33,"33009",951,673,663,7,10,"UPyD",11
31,"31240",553,360,359,3,1,"UPyD",1
10,"10042",79,63,62,2,1,"UPyD",1
24,"24173",1023,757,747,4,10,"UPyD",19
5,"5254",212,186,185,2,1,"UPyD",4
1,"1034",177,140,137,1,3,"UPyD",0
50,"50114",157,120,120,1,0,"UPyD",2
9,"9268",108,78,78,0,0,"UPyD",2
49,"49030",96,78,77,2,1,"UPyD",2
3,"3134",159,129,126,0,3,"UPyD",2
21,"21028",419,320,315,3,5,"UPyD",5
49,"49229",134,99,99,2,0,"UPyD",4
8,"8157",8256,5729,5624,119,105,"UPyD",86
49,"49135",687,485,475,3,10,"UPyD",11
29,"29018",2088,1565,1540,9,25,"UPyD",58
34,"34084",142,124,122,3,2,"UPyD",3
25,"25016",2203,1375,1357,20,18,"UPyD",1
4,"4060",486,373,372,0,1,"UPyD",1
28,"28088",251,174,173,5,1,"UPyD",17
28,"28043",5944,4199,4147,56,52,"UPyD",272
8,"8168",418,268,266,0,2,"UPyD",0
32,"32072",3949,2881,2841,32,40,"UPyD",25
9,"9136",203,153,146,3,7,"UPyD",7
42,"42194",200,165,163,4,2,"UPyD",9
47,"47190",103,87,87,7,0,"UPyD",5
42,"42148",14,14,14,0,0,"UPyD",1
26,"26071",8475,6088,5964,92,124,"UPyD",305
28,"28158",632,505,495,4,10,"UPyD",47
37,"37200",192,142,142,0,0,"UPyD",7
46,"46239",457,331,323,2,8,"UPyD",13
37,"37070",538,428,427,12,1,"UPyD",15
44,"44204",24,21,21,0,0,"UPyD",0
22,"22904",908,660,653,14,7,"UPyD",17
21,"21030",1757,1448,1426,14,22,"UPyD",17
39,"39093",351,260,253,2,7,"UPyD",2
44,"44080",294,216,211,3,5,"UPyD",5
37,"37241",172,135,134,1,1,"UPyD",2
33,"33057",1635,1150,1132,16,18,"UPyD",35
3,"3001",359,296,292,2,4,"UPyD",7
9,"9138",92,77,74,0,3,"UPyD",1
42,"42003",76,54,51,0,3,"UPyD",5
19,"19246",48,38,38,1,0,"UPyD",2
40,"40077",713,526,519,12,7,"UPyD",51
9,"9272",319,225,225,5,0,"UPyD",7
31,"31244",153,97,97,3,0,"UPyD",0
46,"46168",1828,1461,1449,7,12,"UPyD",55
10,"10088",244,168,168,0,0,"UPyD",2
9,"9412",846,568,563,4,5,"UPyD",25
45,"45129",145,121,120,0,1,"UPyD",2
4,"4063",1199,871,862,6,9,"UPyD",19
6,"6056",487,411,411,1,0,"UPyD",3
46,"46192",755,564,554,9,10,"UPyD",41
13,"13090",1202,994,972,4,22,"UPyD",9
22,"22164",46,32,32,0,0,"UPyD",2
37,"37317",323,281,278,3,3,"UPyD",8
39,"39069",1957,1595,1570,18,25,"UPyD",21
48,"48052",1526,1213,1205,7,8,"UPyD",6
34,"34225",4837,3650,3580,73,70,"UPyD",258
27,"27025",3005,2414,2377,25,37,"UPyD",18
46,"46096",320,267,267,0,0,"UPyD",16
32,"32076",2358,1835,1823,18,12,"UPyD",10
24,"24060",660,382,382,0,0,"UPyD",9
42,"42167",305,223,222,3,1,"UPyD",4
6,"6901",2113,1729,1706,26,23,"UPyD",20
42,"42096",316,218,215,9,3,"UPyD",7
10,"10049",3952,3348,3259,36,89,"UPyD",92
29,"29050",483,341,340,1,1,"UPyD",4
42,"42200",98,70,67,1,3,"UPyD",0
49,"49186",273,205,204,1,1,"UPyD",6
39,"39017",588,424,419,2,5,"UPyD",4
25,"25078",1014,730,719,17,11,"UPyD",2
43,"43040",350,251,246,18,5,"UPyD",0
8,"8295",10579,6896,6769,137,127,"UPyD",114
46,"46218",1082,964,936,5,28,"UPyD",14
39,"39018",4077,3212,3160,44,52,"UPyD",121
8,"8266",42860,30047,29521,536,526,"UPyD",508
34,"34228",93,80,80,0,0,"UPyD",5
18,"18044",208,132,132,4,0,"UPyD",0
18,"18146",1059,791,776,2,15,"UPyD",22
18,"18112",132,90,90,1,0,"UPyD",6
9,"9141",607,503,481,10,22,"UPyD",25
9,"9020",276,222,222,6,0,"UPyD",4
37,"37320",96,70,70,0,0,"UPyD",3
49,"49055",115,96,95,1,1,"UPyD",3
23,"23044",4897,3943,3893,13,50,"UPyD",103
49,"49187",1317,967,954,31,13,"UPyD",19
5,"5194",147,131,130,4,1,"UPyD",9
43,"43041",237,177,176,4,1,"UPyD",1
19,"19284",11,11,11,0,0,"UPyD",0
17,"17040",506,320,316,7,4,"UPyD",4
34,"34180",84,68,68,0,0,"UPyD",10
44,"44169",403,285,278,0,7,"UPyD",7
49,"49188",142,101,100,3,1,"UPyD",2
10,"10012",615,525,520,4,5,"UPyD",9
41,"41069",28331,21065,20877,252,188,"UPyD",724
27,"27030",3744,2587,2525,32,62,"UPyD",14
14,"14022",4077,3147,3102,20,45,"UPyD",50
16,"16265",27,26,26,0,0,"UPyD",0
44,"44042",139,87,87,0,0,"UPyD",1
25,"25239",627,310,310,7,0,"UPyD",2
44,"44043",126,94,94,7,0,"UPyD",2
24,"24145",656,420,420,11,0,"UPyD",6
42,"42157",18,16,15,0,1,"UPyD",0
47,"47088",121,100,100,0,0,"UPyD",0
44,"44172",345,257,251,3,6,"UPyD",2
39,"39072",375,234,234,4,0,"UPyD",3
8,"8176",166,111,109,0,2,"UPyD",0
30,"30023",3572,2859,2811,22,48,"UPyD",134
44,"44044",103,79,78,0,1,"UPyD",0
48,"48023",601,499,492,4,7,"UPyD",0
7,"7037",3269,1737,1700,37,37,"UPyD",34
46,"46099",987,764,754,2,10,"UPyD",37
34,"34231",273,209,206,2,3,"UPyD",8
45,"45025",1237,919,907,11,12,"UPyD",44
12,"12044",527,472,463,4,9,"UPyD",2
17,"17042",415,297,292,2,5,"UPyD",1
9,"9195",64,40,40,1,0,"UPyD",0
6,"6125",1852,1419,1399,11,20,"UPyD",15
24,"24065",2104,1512,1488,27,24,"UPyD",52
49,"49191",305,248,246,2,2,"UPyD",1
47,"47197",932,739,730,15,9,"UPyD",17
18,"18150",6452,4666,4625,56,41,"UPyD",214
44,"44213",60,48,48,0,0,"UPyD",2
24,"24105",1460,1095,1075,27,20,"UPyD",44
34,"34098",756,544,540,10,4,"UPyD",39
27,"27034",1297,871,867,3,4,"UPyD",4
36,"36041",13141,9405,9238,114,167,"UPyD",119
9,"9063",223,191,189,1,2,"UPyD",11
5,"5070",41,33,33,0,0,"UPyD",0
47,"47198",71,56,56,2,0,"UPyD",1
37,"37287",341,247,246,1,1,"UPyD",8
42,"42014",83,55,55,1,0,"UPyD",6
5,"5037",296,213,212,0,1,"UPyD",5
48,"48081",1938,1449,1435,14,14,"UPyD",5
26,"26043",397,313,306,6,7,"UPyD",7
37,"37175",408,319,311,6,8,"UPyD",8
26,"26173",10,10,10,1,0,"UPyD",0
14,"14056",23507,17245,17071,259,174,"UPyD",585
10,"10017",884,681,673,6,8,"UPyD",10
2,"2025",7496,6153,5985,69,168,"UPyD",299
8,"8148",2240,1246,1223,22,23,"UPyD",19
18,"18182",1982,1405,1397,6,8,"UPyD",27
15,"15011",15507,10935,10751,123,184,"UPyD",72
33,"33064",237,175,173,1,2,"UPyD",4
23,"23050",91354,68649,67925,990,724,"UPyD",3937
34,"34100",141,105,105,1,0,"UPyD",3
50,"50212",52,48,48,0,0,"UPyD",0
46,"46004",1933,1563,1541,8,22,"UPyD",56
47,"47173",862,683,675,5,8,"UPyD",23
50,"50125",421,284,280,1,4,"UPyD",0
34,"34236",176,134,134,1,0,"UPyD",5
43,"43094",2209,1558,1524,31,34,"UPyD",5
12,"12113",100,72,72,0,0,"UPyD",2
49,"49245",296,218,218,2,0,"UPyD",11
31,"31009",717,510,497,14,13,"UPyD",6
3,"3044",4459,3798,3753,21,45,"UPyD",144
16,"16086",935,814,802,14,12,"UPyD",15
33,"33042",4434,3172,3135,43,37,"UPyD",134
18,"18120",274,238,237,2,1,"UPyD",1
9,"9066",62,44,42,0,2,"UPyD",4
10,"10101",172,134,129,1,5,"UPyD",4
4,"4074",2731,1959,1936,26,23,"UPyD",87
9,"9424",42,35,34,1,1,"UPyD",0
26,"26176",69,55,54,0,1,"UPyD",0
43,"43070",265,198,196,3,2,"UPyD",0
48,"48028",767,623,621,1,2,"UPyD",1
37,"37366",46,35,34,0,1,"UPyD",1
47,"47039",196,163,163,1,0,"UPyD",2
9,"9067",460,335,328,5,7,"UPyD",5
25,"25057",198,140,136,2,4,"UPyD",1
32,"32087",1935,1609,1591,11,18,"UPyD",9
46,"46249",9650,7288,7191,125,97,"UPyD",431
29,"29030",839,669,668,5,1,"UPyD",10
26,"26047",2076,1702,1682,17,20,"UPyD",35
22,"22230",302,234,231,11,3,"UPyD",11
28,"28030",1591,1268,1230,12,38,"UPyD",120
40,"40189",560,455,438,6,17,"UPyD",28
24,"24071",1060,808,797,6,11,"UPyD",15
43,"43071",975,677,664,14,13,"UPyD",0
42,"42116",63,50,48,3,2,"UPyD",1
26,"26134",102,82,80,2,2,"UPyD",0
19,"19226",40,31,30,0,1,"UPyD",0
4,"4028",239,212,207,0,5,"UPyD",2
49,"49202",221,158,157,2,1,"UPyD",3
9,"9338",220,173,168,5,5,"UPyD",10
40,"40902",137,118,118,3,0,"UPyD",4
30,"30029",11533,8854,8768,73,86,"UPyD",298
2,"2066",258,219,217,2,2,"UPyD",0
23,"23011",2227,1644,1620,25,24,"UPyD",39
16,"16225",89,69,68,1,1,"UPyD",2
9,"9472",58,46,46,0,0,"UPyD",2
42,"42063",69,53,53,4,0,"UPyD",0
3,"3015",12241,9734,9636,88,98,"UPyD",409
2,"2031",626,507,502,3,5,"UPyD",12
23,"23901",1194,1048,1045,8,3,"UPyD",14
15,"15044",1436,1083,1068,10,15,"UPyD",5
50,"50130",415,288,288,7,0,"UPyD",0
26,"26093",60,41,41,0,0,"UPyD",0
9,"9071",48,32,32,0,0,"UPyD",1
8,"8092",3928,2511,2473,33,38,"UPyD",5
16,"16008",131,89,88,2,1,"UPyD",0
39,"39079",9035,6959,6897,55,62,"UPyD",190
43,"43072",97,73,70,0,3,"UPyD",0
42,"42168",128,82,81,4,1,"UPyD",0
17,"17111",789,584,574,15,10,"UPyD",0
23,"23014",2529,2058,2039,13,19,"UPyD",43
34,"34201",212,178,172,1,6,"UPyD",8
5,"5044",301,217,217,3,0,"UPyD",5
43,"43171",13906,8978,8855,167,123,"UPyD",166
19,"19296",43,31,30,1,1,"UPyD",0
30,"30031",560,471,469,3,2,"UPyD",18
50,"50217",496,380,379,0,1,"UPyD",4
37,"37221",465,360,353,0,7,"UPyD",5
18,"18189",723,547,541,6,6,"UPyD",4
16,"16228",202,146,144,2,2,"UPyD",5
26,"26094",97,86,85,0,1,"UPyD",3
24,"24158",333,223,223,6,0,"UPyD",14
9,"9343",94,77,76,0,1,"UPyD",3
46,"46009",3140,2521,2498,15,23,"UPyD",149
29,"29080",6598,4703,4663,31,40,"UPyD",194
16,"16134",4283,3398,3361,59,37,"UPyD",135
22,"22133",123,87,85,2,2,"UPyD",4
40,"40101",770,584,577,16,7,"UPyD",65
40,"40148",259,213,212,3,1,"UPyD",8
4,"4046",826,645,634,4,11,"UPyD",20
9,"9073",889,672,663,12,9,"UPyD",54
17,"17082",443,285,280,1,5,"UPyD",1
24,"24038",3206,2439,2399,37,40,"UPyD",61
4,"4047",2290,1956,1937,9,19,"UPyD",29
25,"25155",714,490,485,8,5,"UPyD",0
44,"44018",27,23,23,0,0,"UPyD",0
23,"23060",19107,14365,14264,130,101,"UPyD",467
24,"24160",741,545,539,17,6,"UPyD",13
13,"13007",1319,1069,1051,18,18,"UPyD",28
19,"19335",77,61,61,1,0,"UPyD",2
44,"44145",1078,723,714,26,9,"UPyD",28
6,"6094",1508,1130,1119,6,11,"UPyD",5
32,"32021",1043,793,788,7,5,"UPyD",4
37,"37337",140,122,121,0,1,"UPyD",11
18,"18059",4055,3232,3191,37,41,"UPyD",68
7,"7016",2726,1848,1809,34,39,"UPyD",63
18,"18095",1916,1428,1306,21,122,"UPyD",48
8,"8014",1906,1338,1313,37,25,"UPyD",6
49,"49078",209,173,172,1,1,"UPyD",2
45,"45148",340,256,256,1,0,"UPyD",5
43,"43002",1790,1252,1226,17,26,"UPyD",9
8,"8095",75,56,55,1,1,"UPyD",1
44,"44187",224,170,163,2,7,"UPyD",1
45,"45149",638,542,533,2,9,"UPyD",10
27,"27004",1379,981,966,4,15,"UPyD",3
18,"18128",361,284,283,5,1,"UPyD",6
37,"37300",586,430,421,6,9,"UPyD",25
16,"16097",196,167,166,2,1,"UPyD",5
16,"16013",24,23,23,0,0,"UPyD",1
8,"8015",155673,101652,100264,1628,1388,"UPyD",1275
44,"44189",69,57,57,0,0,"UPyD",4
50,"50220",59,43,43,1,0,"UPyD",1
50,"50221",38,20,20,0,0,"UPyD",2
41,"41029",13231,9756,9610,128,146,"UPyD",632
31,"31048",154,118,117,0,1,"UPyD",4
19,"19265",157,102,101,0,1,"UPyD",3
19,"19199",24,21,21,0,0,"UPyD",1
40,"40106",232,173,173,3,0,"UPyD",4
18,"18029",1892,1355,1347,6,8,"UPyD",25
49,"49080",736,571,560,5,11,"UPyD",9
44,"44190",81,52,52,0,0,"UPyD",3
42,"42076",237,185,179,6,6,"UPyD",4
49,"49081",1457,1166,1141,17,25,"UPyD",28
13,"13077",3654,2535,2480,31,55,"UPyD",87
46,"46086",80,71,71,3,0,"UPyD",1
6,"6098",537,436,435,6,1,"UPyD",2
7,"7052",4578,2671,2651,46,20,"UPyD",88
16,"16015",407,311,311,4,0,"UPyD",10
41,"41004",55127,37662,37179,622,483,"UPyD",2675
45,"45151",631,474,470,1,4,"UPyD",9
5,"5180",109,92,91,1,1,"UPyD",1
37,"37115",135,107,101,2,6,"UPyD",2
49,"49082",400,331,324,2,7,"UPyD",4
2,"2002",479,411,407,3,4,"UPyD",6
24,"24206",1831,1362,1341,13,21,"UPyD",23
40,"40108",120,83,82,1,1,"UPyD",4
41,"41057",299,191,189,0,2,"UPyD",7
47,"47047",217,171,170,5,1,"UPyD",4
9,"9901",407,319,308,8,11,"UPyD",19
34,"34904",355,247,241,3,6,"UPyD",8
5,"5051",194,165,154,0,11,"UPyD",6
40,"40202",79,59,58,0,1,"UPyD",0
24,"24123",835,559,555,6,4,"UPyD",8
37,"37190",235,195,193,1,2,"UPyD",3
19,"19058",6455,5028,4933,63,95,"UPyD",498
31,"31203",30,25,25,0,0,"UPyD",0
17,"17087",230,170,161,6,9,"UPyD",0
4,"4053",12062,9283,9180,119,103,"UPyD",269
22,"22048",12485,9146,9028,237,118,"UPyD",493
26,"26104",18,16,16,0,0,"UPyD",0
37,"37230",221,173,171,0,2,"UPyD",6
14,"14009",2864,2021,2003,8,18,"UPyD",32
16,"16017",406,337,334,1,3,"UPyD",3
31,"31265",81,52,50,0,2,"UPyD",0
9,"9173",135,116,116,1,0,"UPyD",4
26,"26105",2181,1712,1690,24,22,"UPyD",84
49,"49221",266,148,147,6,1,"UPyD",10
16,"16275",15,12,12,0,0,"UPyD",0
50,"50050",109,73,73,1,0,"UPyD",1
35,"35028",8810,4687,4603,71,84,"UPyD",106
31,"31174",115,72,70,1,2,"UPyD",2
43,"43105",175,119,116,14,3,"UPyD",1
28,"28108",3002,2254,2228,31,26,"UPyD",271
31,"31144",840,509,508,7,1,"UPyD",1
45,"45082",1333,1143,1123,14,20,"UPyD",16
34,"34214",176,144,143,3,1,"UPyD",8
6,"6149",10390,8354,8215,111,139,"UPyD",293
12,"12064",118,91,89,1,2,"UPyD",4
20,"20079",17229,12010,11927,143,83,"UPyD",94
18,"18135",4752,3252,3212,34,40,"UPyD",86
9,"9083",27,21,21,0,0,"UPyD",2
49,"49086",127,108,107,1,1,"UPyD",5
37,"37119",115,98,98,0,0,"UPyD",3
19,"19204",168,129,126,2,3,"UPyD",4
37,"37345",179,156,156,2,0,"UPyD",8
23,"23071",1811,1444,1431,13,13,"UPyD",20
9,"9219",28514,20244,19951,326,293,"UPyD",1226
33,"33007",1680,1186,1179,10,7,"UPyD",21
16,"16061",1035,861,848,15,13,"UPyD",28
24,"24050",113,91,90,0,1,"UPyD",4
19,"19060",165,127,121,3,6,"UPyD",6
19,"19239",99,74,73,1,1,"UPyD",1
21,"21024",502,363,358,10,5,"UPyD",6
18,"18136",1973,1679,1668,5,11,"UPyD",26
8,"8287",1053,738,730,26,8,"UPyD",2
37,"37234",376,275,272,2,3,"UPyD",6
9,"9356",57,38,37,1,1,"UPyD",1
22,"22009",704,488,473,15,15,"UPyD",8
10,"10120",168,122,119,1,3,"UPyD",4
18,"18035",1254,991,982,7,9,"UPyD",21
26,"26109",105,87,84,0,3,"UPyD",2
13,"13016",708,555,553,2,2,"UPyD",19
6,"6015",116077,82756,81836,989,920,"UPyD",4926
22,"22205",472,369,363,5,6,"UPyD",3
19,"19105",2235,1709,1686,23,23,"UPyD",168
37,"37121",557,458,451,8,7,"UPyD",15
40,"40118",59,44,43,1,1,"UPyD",2
41,"41009",1272,914,899,8,15,"UPyD",18
22,"22053",867,567,554,13,13,"UPyD",14
34,"34124",70,55,55,1,0,"UPyD",0
27,"27063",1916,1469,1440,14,29,"UPyD",3
25,"25166",177,127,125,3,2,"UPyD",0
25,"25072",5921,3743,3637,81,106,"UPyD",16
37,"37122",210,175,174,3,1,"UPyD",6
37,"37196",93,74,70,1,4,"UPyD",1
6,"6154",2830,2108,2080,38,28,"UPyD",34
19,"19027",185,140,138,1,2,"UPyD",7
41,"41088",542,414,408,1,6,"UPyD",20
12,"12068",57,45,44,0,1,"UPyD",3
3,"3029",260,191,186,0,5,"UPyD",2
24,"24172",491,234,232,2,2,"UPyD",2
6,"6018",808,608,598,5,10,"UPyD",7
50,"50142",45,25,24,0,1,"UPyD",0
8,"8289",4123,2802,2768,54,34,"UPyD",30
46,"46189",490,400,396,3,4,"UPyD",16
40,"40120",173,145,144,1,1,"UPyD",11
45,"45160",1104,911,896,12,15,"UPyD",35
9,"9090",61,50,50,0,0,"UPyD",2
20,"20048",175,102,102,1,0,"UPyD",0
5,"5058",81,61,59,0,2,"UPyD",4
37,"37124",227,181,179,3,2,"UPyD",6
5,"5092",172,142,139,0,3,"UPyD",24
43,"43083",141,97,97,2,0,"UPyD",0
49,"49228",64,56,56,0,0,"UPyD",0
4,"4059",1231,837,830,8,7,"UPyD",12
15,"15029",6266,4668,4618,49,50,"UPyD",8
22,"22209",161,115,115,4,0,"UPyD",10
28,"28112",168,138,137,0,1,"UPyD",9
13,"13019",5254,4038,3978,62,60,"UPyD",81
52,"52001",51028,26966,26659,496,307,"UPyD",986
25,"25074",178,137,132,3,5,"UPyD",0
9,"9180",132,97,95,8,2,"UPyD",8
37,"37351",305,261,258,2,3,"UPyD",3
9,"9316",108,87,84,0,3,"UPyD",3
18,"18141",484,326,325,1,1,"UPyD",7
8,"8290",1446,1075,1056,12,19,"UPyD",8
46,"46190",48324,34747,34424,431,323,"UPyD",2912
9,"9362",219,185,184,2,1,"UPyD",16
10,"10126",1660,1221,1201,9,20,"UPyD",34
3,"3032",112,90,88,0,2,"UPyD",2
19,"19244",95,82,82,6,0,"UPyD",3
49,"49230",122,98,95,1,3,"UPyD",6
49,"49094",276,180,180,2,0,"UPyD",7
17,"17187",574,414,402,1,12,"UPyD",3
48,"48082",38551,25768,25482,316,286,"UPyD",370
39,"39014",943,706,700,9,6,"UPyD",10
41,"41013",4762,3359,3327,9,32,"UPyD",61
30,"30902",7463,5291,5228,38,63,"UPyD",337
8,"8138",4014,2735,2679,46,56,"UPyD",14
19,"19245",1222,954,943,10,11,"UPyD",30
2,"2051",1729,1318,1303,10,15,"UPyD",31
37,"37041",80,53,53,1,0,"UPyD",4
9,"9137",177,134,134,6,0,"UPyD",11
44,"44122",1441,1009,990,21,19,"UPyD",26
39,"39015",898,692,688,7,4,"UPyD",8
24,"24097",244,161,156,4,5,"UPyD",5
25,"25908",250,169,168,4,1,"UPyD",0
8,"8078",224,154,151,2,3,"UPyD",0
34,"34224",53,42,41,0,1,"UPyD",1
9,"9094",49,39,39,0,0,"UPyD",2
38,"38040",4697,3007,2962,31,45,"UPyD",19
22,"22061",6611,4789,4698,110,91,"UPyD",163
16,"16030",28,24,24,0,0,"UPyD",0
6,"6024",1215,1015,1006,4,9,"UPyD",12
45,"45165",62818,47242,46629,549,613,"UPyD",2696
48,"48084",23491,15322,15084,213,238,"UPyD",191
33,"33012",5341,3816,3777,43,39,"UPyD",96
14,"14019",6486,5288,5243,65,45,"UPyD",161
10,"10048",299,232,231,0,1,"UPyD",1
49,"49233",119,78,78,2,0,"UPyD",3
2,"2016",600,471,468,5,3,"UPyD",16
10,"10129",374,279,276,2,3,"UPyD",6
32,"32002",2060,1566,1551,13,15,"UPyD",12
43,"43014",14146,9153,8915,204,238,"UPyD",34
17,"17189",1536,1061,1025,7,36,"UPyD",0
45,"45166",1734,1460,1429,8,31,"UPyD",42
8,"8019",1143222,778246,767530,12386,10716,"UPyD",9954
32,"32003",950,736,727,3,9,"UPyD",1
37,"37130",177,153,153,2,0,"UPyD",6
21,"21032",1790,1362,1347,14,15,"UPyD",19
9,"9140",136,110,110,1,0,"UPyD",1
24,"24223",2793,2121,2113,63,8,"UPyD",59
37,"37008",4316,3518,3457,31,61,"UPyD",191
37,"37356",90,66,66,1,0,"UPyD",1
47,"47141",148,121,119,1,2,"UPyD",1
34,"34133",108,90,90,0,0,"UPyD",3
37,"37131",200,150,148,1,2,"UPyD",5
23,"23085",2350,1963,1956,8,7,"UPyD",7
47,"47142",172,132,131,2,1,"UPyD",14
8,"8111",220,188,188,4,0,"UPyD",0
15,"15034",3116,2146,2114,20,32,"UPyD",6
14,"14051",1392,1148,1130,11,18,"UPyD",13
49,"49236",86,64,64,0,0,"UPyD",0
16,"16033",1792,1485,1454,10,31,"UPyD",38
37,"37009",225,189,185,2,4,"UPyD",3
42,"42201",27,24,24,2,0,"UPyD",0
21,"21003",691,540,536,7,4,"UPyD",6
8,"8081",332,232,225,2,7,"UPyD",0
3,"3004",624,497,486,7,11,"UPyD",32
46,"46194",15267,11622,11491,110,131,"UPyD",627
34,"34134",61,49,47,0,2,"UPyD",2
44,"44086",485,380,371,5,9,"UPyD",5
16,"16034",207,174,173,0,1,"UPyD",6
19,"19039",73,57,57,0,0,"UPyD",1
28,"28004",5761,4098,4044,38,54,"UPyD",289
20,"20020",143,104,104,1,0,"UPyD",0
42,"42204",64,49,44,4,5,"UPyD",2
43,"43139",2166,1319,1270,37,49,"UPyD",1
3,"3038",338,294,291,2,3,"UPyD",15
16,"16035",287,216,213,2,3,"UPyD",10
15,"15091",1171,839,829,9,10,"UPyD",6
16,"16161",84,73,72,4,1,"UPyD",7
49,"49238",289,233,231,3,2,"UPyD",7
19,"19219",18,12,12,0,0,"UPyD",1
18,"18147",3742,2419,2386,20,33,"UPyD",62
44,"44088",32,31,31,1,0,"UPyD",0
10,"10134",585,420,412,1,8,"UPyD",1
37,"37359",194,155,152,1,3,"UPyD",3
50,"50151",713,536,531,5,5,"UPyD",27
22,"22067",82,54,49,3,5,"UPyD",2
28,"28183",935,663,649,7,14,"UPyD",46
22,"22222",510,367,365,6,2,"UPyD",20
17,"17101",567,349,339,4,10,"UPyD",1
24,"24103",330,180,177,0,3,"UPyD",0
23,"23090",1371,1188,1177,6,11,"UPyD",8
18,"18148",874,714,706,6,8,"UPyD",16
33,"33016",19516,14345,14210,198,135,"UPyD",512
47,"47224",92,77,77,0,0,"UPyD",3
8,"8114",17629,11781,11579,189,202,"UPyD",128
28,"28901",765,579,567,2,12,"UPyD",38
12,"12078",365,273,267,5,6,"UPyD",3
20,"20022",832,527,521,9,6,"UPyD",0
10,"10217",535,423,422,3,1,"UPyD",7
21,"21037",491,386,378,1,8,"UPyD",6
9,"9104",56,49,49,0,0,"UPyD",3
15,"15037",4181,2839,2804,25,35,"UPyD",5
50,"50152",1569,1151,1135,31,16,"UPyD",16
19,"19324",199,151,151,2,0,"UPyD",5
10,"10055",709,523,508,13,15,"UPyD",10
18,"18181",253,183,182,0,1,"UPyD",0
22,"22174",520,401,394,11,7,"UPyD",5
42,"42106",15,14,14,0,0,"UPyD",2
49,"49241",275,225,221,2,4,"UPyD",8
5,"5103",84,68,68,3,0,"UPyD",3
10,"10137",428,373,371,1,2,"UPyD",3
16,"16165",84,70,70,0,0,"UPyD",1
37,"37014",1198,862,852,8,10,"UPyD",26
31,"31007",137,96,90,2,6,"UPyD",4
22,"22072",209,130,128,2,2,"UPyD",9
9,"9330",1562,1212,1176,10,36,"UPyD",55
3,"3042",1337,1028,1019,8,9,"UPyD",27
38,"38049",2794,1721,1694,12,27,"UPyD",14
3,"3009",47547,35945,35298,603,647,"UPyD",1835
43,"43068",573,388,378,5,10,"UPyD",0
3,"3111",5244,4184,4146,39,38,"UPyD",104
33,"33041",7488,5356,5309,65,47,"UPyD",110
16,"16084",49,36,35,0,1,"UPyD",1
46,"46053",584,484,461,2,23,"UPyD",10
25,"25148",232,144,144,5,0,"UPyD",0
14,"14026",2043,1434,1421,10,13,"UPyD",20
9,"9378",42,26,26,0,0,"UPyD",2
47,"47063",107,87,87,2,0,"UPyD",5
44,"44216",25877,18461,18057,467,404,"UPyD",1031
4,"4902",42901,28927,28711,338,216,"UPyD",1492
10,"10140",1143,941,927,9,14,"UPyD",19
37,"37138",212,174,169,5,5,"UPyD",6
5,"5105",349,275,272,12,3,"UPyD",27
50,"50241",634,462,455,2,7,"UPyD",17
24,"24189",5410,3630,3572,83,58,"UPyD",254
9,"9198",115,85,85,1,0,"UPyD",4
24,"24030",4397,3272,3229,54,43,"UPyD",81
17,"17016",725,491,481,8,10,"UPyD",2
16,"16042",1286,1101,1089,8,12,"UPyD",20
18,"18050",1657,1209,1196,5,13,"UPyD",50
26,"26130",229,181,177,0,4,"UPyD",5
49,"49111",144,117,116,10,1,"UPyD",2
23,"23097",6510,4687,4639,36,48,"UPyD",171
43,"43168",106,70,69,2,1,"UPyD",0
40,"40140",100,74,73,1,1,"UPyD",3
29,"29057",413,311,308,2,3,"UPyD",5
16,"16128",70,64,64,2,0,"UPyD",2
29,"29002",1246,896,893,11,3,"UPyD",33
8,"8303",279,202,201,11,1,"UPyD",2
50,"50010",77,65,64,5,1,"UPyD",4
6,"6039",1848,1564,1546,13,18,"UPyD",14
49,"49112",131,93,93,2,0,"UPyD",1
46,"46200",1915,1625,1595,15,30,"UPyD",39
28,"28121",185,153,152,0,1,"UPyD",9
37,"37254",189,168,164,1,4,"UPyD",0
43,"43022",1559,1097,1074,22,23,"UPyD",2
10,"10020",1671,1386,1374,14,12,"UPyD",16
37,"37179",230,194,191,3,3,"UPyD",7
16,"16005",275,215,215,2,0,"UPyD",7
44,"44179",369,245,243,6,2,"UPyD",5
7,"7010",4668,3229,3174,58,55,"UPyD",144
20,"20029",4283,3014,2998,26,16,"UPyD",13
4,"4075",4783,3731,3700,33,31,"UPyD",91
47,"47122",2078,1697,1665,21,32,"UPyD",58
3,"3014",234288,168004,166418,1795,1586,"UPyD",13797
4,"4005",631,531,524,6,7,"UPyD",6
48,"48096",6607,5007,4900,54,107,"UPyD",47
35,"35019",30279,17607,17380,158,227,"UPyD",342
31,"31103",51,40,40,3,0,"UPyD",1
37,"37368",18,15,15,1,0,"UPyD",3
10,"10022",442,377,370,1,7,"UPyD",2
45,"45180",2714,2018,1980,19,38,"UPyD",98
31,"31073",332,228,226,1,2,"UPyD",4
17,"17019",1783,1264,1234,42,30,"UPyD",2
28,"28122",504,367,366,2,1,"UPyD",22
5,"5005",199,170,169,1,1,"UPyD",4
26,"26136",111,90,90,3,0,"UPyD",2
26,"26179",49,39,36,0,3,"UPyD",1
21,"21044",17018,11390,11290,132,100,"UPyD",252
5,"5109",438,359,351,5,8,"UPyD",19
34,"34149",26,18,18,0,0,"UPyD",1
35,"35020",6142,4227,4192,24,35,"UPyD",32
12,"12085",4941,3183,3125,32,58,"UPyD",107
31,"31104",1990,1374,1355,20,19,"UPyD",13
10,"10023",854,688,682,9,6,"UPyD",10
34,"34024",27,18,17,1,1,"UPyD",1
49,"49250",1330,998,985,19,13,"UPyD",44
41,"41092",7649,5816,5738,39,78,"UPyD",166
13,"13037",901,752,745,2,7,"UPyD",13
32,"32055",1412,1056,1037,5,19,"UPyD",11
37,"37145",276,217,214,0,3,"UPyD",4
20,"20069",146828,101992,101225,1287,767,"UPyD",2692
45,"45145",2430,1866,1821,13,45,"UPyD",85
31,"31196",40,35,35,1,0,"UPyD",0
23,"23902",2495,2081,2067,4,14,"UPyD",18
9,"9117",82,59,59,1,0,"UPyD",1
27,"27046",1626,1177,1153,17,24,"UPyD",6
31,"31258",7679,5561,5475,92,86,"UPyD",99
28,"28076",417,325,321,1,4,"UPyD",23
49,"49117",505,376,369,5,7,"UPyD",9
44,"44103",128,95,95,0,0,"UPyD",1
23,"23903",3537,2892,2877,12,15,"UPyD",40
9,"9164",179,130,130,1,0,"UPyD",2
50,"50161",124,86,86,1,0,"UPyD",1
44,"44055",85,63,62,2,1,"UPyD",0
6,"6001",730,546,538,4,8,"UPyD",9
44,"44268",30,25,25,0,0,"UPyD",0
16,"16279",251,175,172,1,3,"UPyD",4
6,"6047",878,686,680,5,6,"UPyD",7
18,"18057",5045,3755,3721,44,34,"UPyD",269
44,"44056",577,436,434,7,2,"UPyD",12
16,"16135",192,127,125,0,2,"UPyD",0
49,"49255",455,372,367,1,5,"UPyD",12
26,"26096",244,204,201,2,3,"UPyD",14
29,"29007",25572,17726,17564,227,162,"UPyD",1209
9,"9120",46,35,34,1,1,"UPyD",2
50,"50162",160,108,108,2,0,"UPyD",4
28,"28012",830,654,651,6,3,"UPyD",65
25,"25096",988,633,613,12,20,"UPyD",1
31,"31107",1706,1321,1311,17,10,"UPyD",20
24,"24001",241,148,147,3,1,"UPyD",10
9,"9074",735,558,547,7,11,"UPyD",63
15,"15019",26096,18466,18187,350,279,"UPyD",101
27,"27049",1554,1073,1062,6,11,"UPyD",7
28,"28102",913,700,693,9,7,"UPyD",41
18,"18161",220,180,178,0,2,"UPyD",5
14,"14035",6153,4715,4656,51,59,"UPyD",56
40,"40151",52,42,42,0,0,"UPyD",3
35,"35023",11640,8412,8178,97,234,"UPyD",206
43,"43101",146,94,93,3,1,"UPyD",1
15,"15048",4769,3470,3415,57,55,"UPyD",34
12,"12091",203,153,140,2,13,"UPyD",9
26,"26015",205,167,165,1,2,"UPyD",6
16,"16052",596,469,464,2,5,"UPyD",16
39,"39083",1214,785,775,7,10,"UPyD",10
26,"26143",187,154,151,4,3,"UPyD",5
50,"50249",333,280,272,2,8,"UPyD",9
32,"32023",1360,1030,1011,6,19,"UPyD",8
34,"34031",29,26,26,0,0,"UPyD",3
7,"7017",800,556,539,14,17,"UPyD",12
43,"43076",467,308,300,7,8,"UPyD",1
12,"12092",143,98,98,0,0,"UPyD",3
18,"18194",2258,1656,1652,11,4,"UPyD",31
12,"12058",99,74,74,0,0,"UPyD",1
31,"31200",763,527,514,17,13,"UPyD",7
37,"37263",361,277,275,1,2,"UPyD",13
17,"17116",369,230,227,3,3,"UPyD",0
26,"26144",196,163,162,2,1,"UPyD",4
34,"34113",35,28,27,0,1,"UPyD",1
10,"10113",2440,1891,1859,11,32,"UPyD",43
5,"5149",128,97,97,1,0,"UPyD",3
49,"49214",720,560,558,6,2,"UPyD",15
19,"19130",58473,45114,44362,688,752,"UPyD",3554
8,"8904",10608,6654,6561,140,93,"UPyD",134
40,"40013",67,56,54,1,2,"UPyD",1
24,"24004",535,391,390,0,1,"UPyD",11
10,"10031",189,158,158,1,0,"UPyD",6
45,"45079",368,278,273,1,5,"UPyD",3
2,"2039",1050,862,848,16,14,"UPyD",21
29,"29010",1703,1411,1377,7,34,"UPyD",22
3,"3022",160,133,131,1,2,"UPyD",5
40,"40156",361,268,264,5,4,"UPyD",11
21,"21020",398,282,282,3,0,"UPyD",2
42,"42129",706,523,509,14,14,"UPyD",16
3,"3056",8929,6927,6776,74,151,"UPyD",237
32,"32025",1218,954,941,12,13,"UPyD",3
44,"44111",101,68,68,4,0,"UPyD",1
35,"35026",78933,49860,48955,780,905,"UPyD",1314
37,"37266",83,54,54,1,0,"UPyD",0
49,"49034",467,363,359,3,4,"UPyD",1
8,"8038",1406,911,895,24,16,"UPyD",4
8,"8160",313,227,222,8,5,"UPyD",0
31,"31264",173,110,108,1,2,"UPyD",1
9,"9396",152,113,113,0,0,"UPyD",3
39,"39007",479,348,347,3,1,"UPyD",5
19,"19171",4352,3299,3221,35,78,"UPyD",261
32,"32027",1156,850,836,15,14,"UPyD",0
42,"42130",70,55,54,2,1,"UPyD",4
19,"19268",34,26,25,0,1,"UPyD",0
35,"35027",10510,7523,7375,88,148,"UPyD",169
46,"46063",1764,1441,1423,15,18,"UPyD",48
43,"43153",10307,6572,6450,94,122,"UPyD",75
31,"31052",89,62,58,1,4,"UPyD",4
19,"19237",53,40,39,2,1,"UPyD",1
23,"23069",5489,4656,4586,36,70,"UPyD",106
22,"22049",88,70,69,5,1,"UPyD",1
31,"31901",15574,11165,10974,201,191,"UPyD",247
2,"2042",897,712,709,6,3,"UPyD",14
24,"24047",856,623,612,5,11,"UPyD",28
12,"12095",1027,790,775,15,15,"UPyD",18
22,"22094",109,76,74,5,2,"UPyD",0
18,"18100",7304,5807,5737,62,70,"UPyD",328
49,"49085",1173,912,908,16,4,"UPyD",31
9,"9400",340,253,249,4,4,"UPyD",5
26,"26022",232,191,190,1,1,"UPyD",3
37,"37232",412,374,373,1,1,"UPyD",5
24,"24008",9789,7277,7179,110,98,"UPyD",310
2,"2043",1335,1120,1108,10,12,"UPyD",18
21,"21054",8024,6159,6072,67,87,"UPyD",214
44,"44114",254,194,188,4,6,"UPyD",2
16,"16910",104,69,69,1,0,"UPyD",2
41,"41100",1097,894,878,8,16,"UPyD",22
37,"37157",94,65,65,0,0,"UPyD",1
28,"28130",27391,21367,21111,235,256,"UPyD",2151
11,"11041",9805,7136,7067,87,69,"UPyD",211
13,"13015",5755,4334,4293,40,41,"UPyD",100
47,"47214",1517,1215,1191,34,24,"UPyD",45
9,"9176",60,47,45,2,2,"UPyD",1
50,"50079",281,213,210,2,3,"UPyD",6
40,"40019",43,35,35,0,0,"UPyD",1
24,"24129",125,88,86,5,2,"UPyD",7
22,"22204",1122,773,756,19,17,"UPyD",19
50,"50140",172,108,108,1,0,"UPyD",1
42,"42188",64,51,51,0,0,"UPyD",5
25,"25071",56,37,35,2,2,"UPyD",0
39,"39036",1023,802,790,5,12,"UPyD",33
34,"34167",124,105,105,0,0,"UPyD",2
3,"3061",1052,842,836,6,6,"UPyD",26
10,"10038",98,84,83,0,1,"UPyD",1
31,"31207",280,198,195,7,3,"UPyD",3
26,"26152",38,31,31,0,0,"UPyD",1
42,"42139",22,18,17,0,1,"UPyD",2
37,"37035",220,176,173,1,3,"UPyD",5
32,"32032",8284,6295,6198,84,97,"UPyD",24
35,"35030",8295,5433,5315,54,118,"UPyD",66
9,"9265",44,36,35,2,1,"UPyD",2
48,"48011",9742,6697,6628,82,69,"UPyD",113
49,"49268",480,365,362,8,3,"UPyD",5
19,"19064",97,84,83,1,1,"UPyD",5
5,"5122",156,124,124,0,0,"UPyD",6
16,"16064",699,588,580,4,8,"UPyD",7
24,"24214",716,518,509,4,9,"UPyD",10
35,"35031",6968,4927,4862,71,65,"UPyD",147
21,"21056",2992,2172,2096,29,76,"UPyD",42
17,"17032",1613,933,918,11,15,"UPyD",4
38,"38003",1446,1053,1044,4,9,"UPyD",7
5,"5023",177,160,158,1,2,"UPyD",2
47,"47135",93,77,76,0,1,"UPyD",6
45,"45197",1972,1570,1538,8,32,"UPyD",27
17,"17124",1670,1087,1056,18,31,"UPyD",4
16,"16065",454,380,374,4,6,"UPyD",10
24,"24132",683,440,435,5,5,"UPyD",11
29,"29017",6766,5162,5114,48,48,"UPyD",189
10,"10041",1070,850,846,8,4,"UPyD",14
18,"18173",8858,6238,6187,64,51,"UPyD",183
6,"6019",2111,1621,1596,24,25,"UPyD",45
8,"8105",9642,6571,6483,110,88,"UPyD",87
5,"5124",134,111,109,1,2,"UPyD",0
24,"24133",379,279,279,0,0,"UPyD",8
18,"18070",287,240,239,2,1,"UPyD",12
21,"21058",2609,1867,1857,15,10,"UPyD",11
8,"8136",11117,7602,7478,174,124,"UPyD",73
28,"28178",1017,799,791,11,8,"UPyD",70
4,"4093",1869,1341,1334,10,7,"UPyD",29
40,"40166",275,247,246,2,1,"UPyD",13
26,"26029",33,25,24,1,1,"UPyD",1
20,"20012",149,97,97,0,0,"UPyD",0
6,"6020",1852,1476,1462,5,14,"UPyD",42
20,"20013",5331,3662,3637,33,25,"UPyD",27
37,"37039",325,241,236,0,5,"UPyD",7
26,"26114",87,74,72,0,2,"UPyD",2
45,"45199",2712,1817,1796,17,21,"UPyD",129
2,"2049",937,717,708,2,9,"UPyD",24
12,"12102",547,474,466,2,8,"UPyD",4
24,"24134",3682,2636,2588,44,48,"UPyD",89
46,"46215",1451,1185,1169,8,16,"UPyD",24
15,"15058",26931,19505,19196,471,309,"UPyD",482
9,"9269",39,33,33,0,0,"UPyD",4
47,"47003",263,224,222,1,2,"UPyD",2
37,"37275",136,98,98,0,0,"UPyD",2
34,"34174",213,179,178,4,1,"UPyD",7
39,"39040",4350,3413,3373,30,40,"UPyD",140
10,"10044",1520,1120,1103,10,17,"UPyD",24
29,"29019",908,720,714,0,6,"UPyD",5
28,"28134",55921,42676,42221,505,455,"UPyD",4542
9,"9014",190,113,113,3,0,"UPyD",4
6,"6159",2341,1522,1510,8,12,"UPyD",18
9,"9227",131,100,100,1,0,"UPyD",3
45,"45054",4285,3321,3274,32,47,"UPyD",114
14,"14018",3795,3004,2970,24,34,"UPyD",65
10,"10127",4663,3554,3498,38,56,"UPyD",117
46,"46143",4278,3309,3266,46,43,"UPyD",88
3,"3067",94,81,79,1,2,"UPyD",4
5,"5127",715,601,596,4,5,"UPyD",16
37,"37353",142,119,119,2,0,"UPyD",3
19,"19147",58,45,40,0,5,"UPyD",0
19,"19280",3415,2521,2490,27,31,"UPyD",255
5,"5095",301,253,250,2,3,"UPyD",7
14,"14048",1244,975,970,5,5,"UPyD",8
46,"46216",4806,3857,3825,39,32,"UPyD",322
17,"17216",158,100,97,1,3,"UPyD",0
5,"5225",423,346,342,8,4,"UPyD",22
15,"15060",5599,4139,4069,82,70,"UPyD",61
26,"26034",678,526,510,3,16,"UPyD",15
34,"34131",67,57,56,0,1,"UPyD",0
18,"18074",297,245,245,5,0,"UPyD",5
24,"24019",367,293,287,5,6,"UPyD",9
24,"24141",101,83,80,6,3,"UPyD",0
48,"48018",905,591,587,8,4,"UPyD",0
37,"37044",461,363,360,1,3,"UPyD",9
17,"17130",333,236,233,5,3,"UPyD",2
9,"9273",55,47,47,0,0,"UPyD",2
5,"5029",132,102,102,0,0,"UPyD",4
43,"43039",117,85,83,3,2,"UPyD",0
2,"2053",3053,2550,2517,33,33,"UPyD",67
17,"17218",568,361,350,11,11,"UPyD",0
3,"3036",84,72,72,0,0,"UPyD",2
38,"38009",3910,2687,2633,31,54,"UPyD",71
19,"19183",108,87,86,1,1,"UPyD",5
12,"12005",8066,5835,5441,116,394,"UPyD",148
28,"28024",156,132,132,5,0,"UPyD",13
40,"40033",61,48,47,3,1,"UPyD",3
44,"44247",335,251,243,10,8,"UPyD",3
8,"8141",4666,3124,3066,57,58,"UPyD",9
5,"5130",95,76,76,0,0,"UPyD",14
8,"8204",2991,2076,2040,45,36,"UPyD",18
22,"22063",184,142,140,2,2,"UPyD",3
37,"37168",470,357,353,1,4,"UPyD",5
44,"44126",344,250,236,1,14,"UPyD",1
12,"12107",358,314,311,4,3,"UPyD",11
5,"5099",555,472,466,4,6,"UPyD",11
24,"24101",465,274,266,5,8,"UPyD",10
31,"31185",541,377,374,2,3,"UPyD",1
45,"45169",239,183,183,1,0,"UPyD",7
44,"44127",79,62,61,0,1,"UPyD",3
19,"19184",88,63,62,1,1,"UPyD",0
24,"24022",364,231,230,2,1,"UPyD",2
36,"36004",10264,7383,7263,80,120,"UPyD",63
33,"33037",37135,25522,25262,291,260,"UPyD",567
28,"28138",78,48,46,0,2,"UPyD",6
2,"2056",1816,1518,1506,15,12,"UPyD",36
32,"32006",1814,1344,1330,20,14,"UPyD",3
9,"9102",44,36,36,0,0,"UPyD",1
31,"31125",269,172,169,6,3,"UPyD",3
14,"14052",9720,6444,6384,58,60,"UPyD",168
26,"26123",129,113,113,1,0,"UPyD",3
19,"19285",26,20,20,2,0,"UPyD",1
39,"39045",410,324,323,5,1,"UPyD",3
20,"20021",216,122,122,0,0,"UPyD",1
2,"2057",2138,1736,1712,30,24,"UPyD",38
46,"46001",863,647,641,5,6,"UPyD",22
10,"10053",303,253,246,5,7,"UPyD",0
8,"8144",769,494,481,16,13,"UPyD",0
50,"50090",165,117,117,1,0,"UPyD",1
16,"16079",33,21,21,0,0,"UPyD",1
34,"34181",471,350,346,7,4,"UPyD",5
15,"15064",2356,1859,1824,35,35,"UPyD",12
3,"3073",219,199,199,0,0,"UPyD",4
26,"26169",83,73,72,0,1,"UPyD",2
12,"12109",700,564,555,7,9,"UPyD",13
4,"4032",5476,3666,3643,34,23,"UPyD",100
5,"5036",136,107,106,0,1,"UPyD",8
44,"44130",38,27,27,0,0,"UPyD",0
5,"5133",62,49,49,0,0,"UPyD",6
8,"8238",13892,10237,10094,206,143,"UPyD",147
32,"32045",2640,1999,1980,23,19,"UPyD",13
46,"46221",350,319,317,3,2,"UPyD",8
19,"19187",64,54,54,0,0,"UPyD",0
2,"2059",336,262,258,3,4,"UPyD",4
9,"9148",95,75,75,2,0,"UPyD",5
50,"50091",56,39,39,1,0,"UPyD",2
19,"19079",7,7,7,0,0,"UPyD",0
45,"45172",757,597,594,7,3,"UPyD",10
15,"15901",3855,2463,2419,48,44,"UPyD",10
37,"37136",702,494,485,4,9,"UPyD",11
34,"34137",31,24,24,3,0,"UPyD",0
31,"31128",406,261,261,4,0,"UPyD",6
46,"46222",378,321,310,1,11,"UPyD",10
32,"32046",1375,976,962,3,14,"UPyD",5
8,"8146",1321,876,862,18,14,"UPyD",12
38,"38015",4326,3132,3099,21,33,"UPyD",47
34,"34057",483,365,357,2,8,"UPyD",7
31,"31037",94,68,68,0,0,"UPyD",0
15,"15066",4180,3098,3062,38,36,"UPyD",18
2,"2024",3424,2765,2726,32,39,"UPyD",86
44,"44092",89,68,68,0,0,"UPyD",0
35,"35015",9065,4859,4770,64,89,"UPyD",84
13,"13031",2384,1908,1874,23,34,"UPyD",46
48,"48026",1093,881,875,3,6,"UPyD",1
44,"44215",156,100,100,2,0,"UPyD",2
40,"40230",117,92,90,1,2,"UPyD",2
45,"45175",698,587,579,5,8,"UPyD",3
24,"24150",262,182,182,3,0,"UPyD",6
19,"19044",319,248,245,0,3,"UPyD",7
6,"6082",373,315,311,3,4,"UPyD",7
40,"40184",269,227,224,4,3,"UPyD",8
49,"49151",680,494,491,6,3,"UPyD",7
2,"2062",456,348,344,2,4,"UPyD",5
37,"37055",132,112,107,2,5,"UPyD",5
24,"24028",426,350,331,3,19,"UPyD",15
39,"39049",339,244,242,5,2,"UPyD",5
24,"24029",840,590,579,11,11,"UPyD",15
18,"18049",632,476,474,5,2,"UPyD",8
43,"43069",194,131,127,3,4,"UPyD",0
19,"19045",180,145,145,1,0,"UPyD",1
1,"1055",906,632,623,7,9,"UPyD",6
18,"18119",1778,1401,1391,14,10,"UPyD",77
13,"13033",1719,1436,1419,6,17,"UPyD",35
10,"10059",414,352,349,4,3,"UPyD",3
44,"44261",777,600,594,8,6,"UPyD",18
15,"15068",5404,3780,3725,53,55,"UPyD",9
22,"22228",501,382,369,15,13,"UPyD",32
10,"10181",739,607,598,6,9,"UPyD",12
37,"37177",310,242,241,1,1,"UPyD",5
44,"44136",51,39,39,0,0,"UPyD",0
8,"8028",1049,667,657,15,10,"UPyD",6
21,"21071",216,169,169,5,0,"UPyD",6
2,"2064",413,350,348,7,2,"UPyD",2
46,"46006",4643,3847,3785,32,62,"UPyD",162
45,"45068",164,135,133,1,2,"UPyD",4
16,"16218",207,170,169,4,1,"UPyD",4
9,"9288",98,80,80,1,0,"UPyD",2
17,"17047",4803,2866,2803,30,63,"UPyD",14
26,"26177",322,276,274,2,2,"UPyD",5
31,"31132",160,124,124,6,0,"UPyD",0
8,"8150",245,181,178,11,3,"UPyD",0
12,"12014",191,139,137,4,2,"UPyD",3
31,"31102",162,80,78,0,2,"UPyD",0
47,"47149",44,22,20,0,2,"UPyD",3
26,"26132",130,98,96,2,2,"UPyD",2
10,"10061",1765,1305,1290,13,15,"UPyD",18
8,"8059",323,189,186,9,3,"UPyD",0
19,"19160",944,600,593,6,7,"UPyD",25
2,"2029",3210,2512,2481,37,31,"UPyD",125
37,"37142",613,436,434,7,2,"UPyD",36
19,"19193",30,29,29,1,0,"UPyD",1
17,"17048",6176,3818,3773,52,45,"UPyD",41
46,"46007",11576,8929,8848,71,81,"UPyD",527
12,"12015",96,83,82,3,1,"UPyD",1
10,"10062",421,332,325,3,7,"UPyD",0
25,"25031",57,34,34,1,0,"UPyD",0
41,"41050",5102,4224,4183,39,41,"UPyD",99
24,"24113",404,318,310,3,8,"UPyD",12
43,"43047",4064,2412,2352,50,60,"UPyD",24
49,"49023",1033,736,728,10,8,"UPyD",15
32,"32053",1500,1206,1199,19,7,"UPyD",4
18,"18088",1576,1258,1253,2,5,"UPyD",7
28,"28074",136617,106248,105095,1101,1153,"UPyD",11175
36,"36015",4379,3151,3101,38,50,"UPyD",16
31,"31043",42,30,30,1,0,"UPyD",1
13,"13069",704,605,590,2,15,"UPyD",7
42,"42022",253,177,171,2,6,"UPyD",12
17,"17142",2440,1713,1681,39,32,"UPyD",6
37,"37181",301,232,230,2,2,"UPyD",3
8,"8061",1467,960,952,10,8,"UPyD",8
25,"25217",10570,6660,6500,191,160,"UPyD",24
44,"44016",541,384,379,5,5,"UPyD",17
49,"49116",401,308,305,4,3,"UPyD",4
16,"16047",249,192,191,5,1,"UPyD",3
2,"2032",323,261,259,1,2,"UPyD",1
30,"30005",29081,22312,22142,184,170,"UPyD",1321
39,"39001",2146,1669,1645,20,24,"UPyD",22
3,"3049",12150,10039,9892,88,147,"UPyD",274
46,"46154",836,684,678,7,6,"UPyD",10
5,"5238",815,649,641,6,8,"UPyD",31
50,"50013",244,195,195,1,0,"UPyD",7
38,"38023",118865,76393,75039,928,1354,"UPyD",2453
40,"40006",23,20,20,0,0,"UPyD",2
31,"31045",501,384,377,16,7,"UPyD",12
15,"15073",21991,14686,14456,216,230,"UPyD",103
4,"4045",1877,1512,1497,23,15,"UPyD",26
25,"25218",94,75,73,1,2,"UPyD",0
46,"46204",6906,5426,5357,62,69,"UPyD",283
44,"44144",326,233,227,7,6,"UPyD",7
17,"17022",6771,4247,4169,76,78,"UPyD",12
49,"49160",54,35,34,3,1,"UPyD",4
15,"15017",18860,12975,12737,325,238,"UPyD",280
17,"17112",215,141,138,4,3,"UPyD",3
21,"21076",2108,1647,1628,22,19,"UPyD",26
12,"12119",153,87,87,0,0,"UPyD",2
31,"31015",1989,1404,1380,29,24,"UPyD",22
43,"43026",800,531,522,15,9,"UPyD",5
17,"17051",201,146,142,4,4,"UPyD",1
40,"40054",145,103,102,1,1,"UPyD",7
8,"8155",6573,4411,4334,85,77,"UPyD",38
5,"5240",3351,2472,2428,22,44,"UPyD",90
2,"2070",439,372,366,4,6,"UPyD",4
3,"3085",275,218,215,2,3,"UPyD",3
31,"31137",215,108,106,1,2,"UPyD",1
7,"7048",15296,8559,8439,176,120,"UPyD",359
12,"12021",4433,3368,3292,42,76,"UPyD",55
37,"37147",201,153,151,1,2,"UPyD",4
37,"37261",255,191,191,2,0,"UPyD",4
10,"10150",374,331,328,2,3,"UPyD",5
48,"48002",7971,5377,5290,65,87,"UPyD",61
37,"37185",602,452,448,8,4,"UPyD",10
2,"2072",1598,1220,1198,5,22,"UPyD",37
8,"8156",10672,7359,7225,121,134,"UPyD",113
19,"19299",94,75,75,0,0,"UPyD",6
36,"36019",1681,1204,1188,14,16,"UPyD",8
48,"48036",23973,16491,16344,179,147,"UPyD",278
24,"24040",494,369,366,6,3,"UPyD",11
4,"4048",1459,1110,1100,11,10,"UPyD",17
20,"20073",4689,3196,3176,28,20,"UPyD",22
28,"28149",5276,4132,4063,43,69,"UPyD",416
31,"31108",1969,1474,1452,23,22,"UPyD",15
9,"9167",60,49,49,2,0,"UPyD",4
32,"32059",1983,1526,1510,27,16,"UPyD",5
15,"15076",2766,1971,1936,18,35,"UPyD",19
25,"25128",151,83,81,1,2,"UPyD",0
25,"25221",125,76,76,0,0,"UPyD",0
9,"9123",31,27,27,0,0,"UPyD",1
10,"10071",179,133,133,1,0,"UPyD",1
24,"24002",271,213,213,2,0,"UPyD",4
42,"42127",47,35,35,0,0,"UPyD",0
19,"19301",47,38,38,0,0,"UPyD",1
5,"5243",101,69,68,0,1,"UPyD",3
19,"19097",28,27,27,0,0,"UPyD",1
16,"16238",560,484,479,3,5,"UPyD",3
13,"13076",514,436,428,0,8,"UPyD",6
44,"44148",98,77,77,3,0,"UPyD",3
4,"4083",1933,1511,1497,16,14,"UPyD",19
37,"37228",388,339,336,2,3,"UPyD",6
31,"31049",733,479,479,4,0,"UPyD",0
26,"26145",251,201,199,3,2,"UPyD",7
18,"18097",1022,758,752,4,6,"UPyD",26
27,"27006",2789,1949,1911,22,38,"UPyD",22
4,"4050",818,611,602,5,9,"UPyD",10
49,"49167",223,173,171,5,2,"UPyD",3
46,"46232",920,730,722,6,8,"UPyD",27
5,"5049",440,335,330,8,5,"UPyD",51
31,"31050",6253,4045,3987,74,58,"UPyD",26
17,"17117",14022,8705,8595,129,110,"UPyD",40
45,"45152",653,503,497,2,6,"UPyD",9
24,"24005",437,308,305,3,3,"UPyD",7
47,"47183",150,125,122,0,3,"UPyD",5
25,"25130",208,117,112,4,5,"UPyD",0
20,"20076",6978,4823,4762,38,61,"UPyD",35
14,"14069",7733,5910,5824,68,86,"UPyD",124
34,"34211",202,175,170,1,5,"UPyD",4
24,"24165",400,284,279,4,5,"UPyD",3
28,"28016",86,68,67,3,1,"UPyD",3
40,"40060",86,65,64,3,1,"UPyD",1
39,"39033",604,480,473,3,7,"UPyD",9
26,"26147",34,29,29,2,0,"UPyD",4
44,"44151",215,143,140,1,3,"UPyD",1
45,"45191",601,506,498,1,8,"UPyD",4
2,"2077",51,46,45,0,1,"UPyD",0
4,"4052",11567,8189,8124,158,65,"UPyD",465
43,"43054",2850,1815,1771,37,44,"UPyD",4
22,"22143",244,166,161,2,5,"UPyD",3
27,"27010",4725,3427,3368,55,59,"UPyD",24
10,"10076",825,619,610,7,9,"UPyD",20
41,"41058",16497,12415,12248,181,167,"UPyD",601
24,"24167",813,509,509,8,0,"UPyD",27
37,"37231",285,227,225,6,2,"UPyD",13
33,"33006",1674,1130,1120,10,10,"UPyD",11
28,"28174",1745,1233,1224,11,9,"UPyD",89
3,"3127",399,336,322,3,14,"UPyD",0
41,"41006",2743,1972,1957,13,15,"UPyD",44
21,"21022",173,123,123,1,0,"UPyD",2
23,"23027",763,619,616,1,3,"UPyD",9
27,"27011",2663,1822,1785,23,37,"UPyD",14
16,"16060",841,714,704,11,10,"UPyD",10
49,"49127",2227,1617,1587,48,30,"UPyD",85
10,"10077",719,551,543,3,8,"UPyD",9
9,"9309",343,252,246,7,6,"UPyD",1
16,"16103",310,263,259,4,4,"UPyD",7
13,"13080",418,310,309,1,1,"UPyD",5
42,"42034",40,29,29,0,0,"UPyD",2
6,"6104",701,588,584,12,4,"UPyD",10
49,"49037",201,171,171,2,0,"UPyD",4
49,"49265",143,105,105,1,0,"UPyD",2
18,"18003",13486,10245,10100,145,145,"UPyD",669
41,"41059",31676,23199,22889,330,310,"UPyD",2013
37,"37193",432,310,309,5,1,"UPyD",4
37,"37077",293,262,258,3,4,"UPyD",6
20,"20043",1782,1220,1214,13,6,"UPyD",3
46,"46902",425,333,332,3,1,"UPyD",13
27,"27060",2938,2063,2028,26,35,"UPyD",7
31,"31237",198,137,136,7,1,"UPyD",2
22,"22008",194,168,167,11,1,"UPyD",4
15,"15082",15075,11217,11046,187,171,"UPyD",165
41,"41101",5752,4663,4629,25,34,"UPyD",94
26,"26108",324,245,243,4,2,"UPyD",10
15,"15054",32172,20472,20154,519,318,"UPyD",333
50,"50023",240,180,180,4,0,"UPyD",0
37,"37194",271,206,204,0,2,"UPyD",1
34,"34080",6066,4238,4169,57,69,"UPyD",137
3,"3095",4498,3558,3517,29,41,"UPyD",79
46,"46017",32928,24879,24672,267,207,"UPyD",1278
1,"1031",1229,916,899,13,17,"UPyD",13
5,"5056",94,78,73,1,5,"UPyD",9
10,"10080",385,294,287,0,7,"UPyD",2
41,"41061",2205,1798,1770,2,28,"UPyD",24
17,"17153",172,127,123,1,4,"UPyD",0
18,"18102",8556,6358,6272,42,86,"UPyD",178
34,"34081",53,42,41,0,1,"UPyD",5
2,"2082",121,107,107,1,0,"UPyD",2
43,"43058",106,76,76,5,0,"UPyD",1
27,"27016",7521,5439,5338,83,101,"UPyD",21
49,"49175",263,215,215,4,0,"UPyD",4
8,"8074",10224,6571,6479,116,92,"UPyD",100
40,"40070",137,91,91,0,0,"UPyD",3
19,"19210",34,29,29,1,0,"UPyD",3
24,"24052",178,113,111,0,2,"UPyD",2
5,"5057",2593,2172,2152,16,20,"UPyD",78
37,"37311",251,210,209,8,1,"UPyD",4
12,"12033",1970,1547,1509,8,38,"UPyD",33
15,"15084",3681,2676,2656,34,20,"UPyD",8
12,"12130",425,348,344,2,4,"UPyD",4
49,"49176",757,502,501,5,1,"UPyD",10
25,"25136",106,79,79,1,0,"UPyD",1
34,"34220",145,125,123,0,2,"UPyD",8
23,"23033",1382,1166,1152,7,14,"UPyD",18
22,"22013",304,239,236,3,3,"UPyD",6
49,"49002",77,59,59,1,0,"UPyD",4
41,"41036",4053,2930,2899,29,31,"UPyD",73
26,"26069",276,211,208,5,3,"UPyD",0
49,"49042",271,216,216,1,0,"UPyD",2
48,"48047",161,126,126,1,0,"UPyD",0
18,"18105",5222,3866,3839,32,27,"UPyD",67
43,"43059",264,185,185,4,0,"UPyD",0
28,"28133",5868,4236,4144,23,92,"UPyD",236
2,"2085",345,288,284,2,4,"UPyD",4
46,"46238",13401,10371,10283,96,88,"UPyD",327
15,"15057",12467,8936,8744,102,192,"UPyD",73
26,"26158",296,238,237,7,1,"UPyD",1
46,"46141",424,338,336,2,2,"UPyD",12
29,"29046",2777,2032,2013,10,19,"UPyD",60
16,"16067",135,97,97,2,0,"UPyD",0
15,"15086",3110,2281,2259,30,22,"UPyD",16
37,"37083",190,165,165,3,0,"UPyD",4
49,"49179",401,285,284,2,1,"UPyD",7
19,"19212",795,644,632,2,12,"UPyD",24
25,"25231",515,402,395,4,7,"UPyD",0
31,"31059",204,140,139,3,1,"UPyD",2
22,"22015",336,237,235,11,2,"UPyD",10
34,"34222",122,94,94,2,0,"UPyD",0
46,"46166",8260,6422,6324,60,98,"UPyD",371
12,"12132",524,407,401,4,6,"UPyD",7
25,"25138",605,440,428,13,12,"UPyD",2
5,"5256",119,101,100,0,1,"UPyD",7
32,"32073",1415,1111,1100,8,11,"UPyD",7
7,"7063",1414,1050,1030,25,20,"UPyD",36
6,"6113",2750,2143,2105,26,38,"UPyD",28
12,"12103",85,65,65,4,0,"UPyD",1
28,"28135",928,665,659,6,6,"UPyD",43
17,"17128",309,232,224,5,8,"UPyD",0
24,"24018",180,150,149,1,1,"UPyD",2
50,"50085",205,143,143,3,0,"UPyD",2
49,"49181",386,308,307,2,1,"UPyD",6
50,"50203",1083,814,798,28,16,"UPyD",38
50,"50204",2519,1823,1804,24,19,"UPyD",61
21,"21061",5089,3657,3635,33,22,"UPyD",63
25,"25111",116,70,70,0,0,"UPyD",0
37,"37086",105,75,72,3,3,"UPyD",1
1,"1041",159,116,113,1,3,"UPyD",4
18,"18911",6796,4923,4867,74,56,"UPyD",367
47,"47192",99,84,84,0,0,"UPyD",5
28,"28044",5403,4245,4188,27,57,"UPyD",417
12,"12134",147,107,107,3,0,"UPyD",3
46,"46095",632,505,495,1,10,"UPyD",34
8,"8079",335,255,243,14,12,"UPyD",0
15,"15088",3769,2626,2599,21,27,"UPyD",14
25,"25112",286,202,199,11,3,"UPyD",0
44,"44038",112,94,92,3,2,"UPyD",2
49,"49184",190,135,133,1,2,"UPyD",5
44,"44164",32,25,25,0,0,"UPyD",1
32,"32075",3839,2957,2910,51,47,"UPyD",14
10,"10211",461,341,334,3,7,"UPyD",3
17,"17160",14852,9257,9128,145,129,"UPyD",77
50,"50290",436,334,331,4,3,"UPyD",7
18,"18012",2693,1841,1831,11,10,"UPyD",50
5,"5259",132,115,114,1,1,"UPyD",0
37,"37203",174,148,148,0,0,"UPyD",2
6,"6117",1471,1155,1130,8,25,"UPyD",30
26,"26164",70,42,42,1,0,"UPyD",3
37,"37204",286,216,214,0,2,"UPyD",6
43,"43063",588,358,350,13,8,"UPyD",0
5,"5063",48,39,39,2,0,"UPyD",0
9,"9058",357,278,276,4,2,"UPyD",28
50,"50206",499,386,384,10,2,"UPyD",20
6,"6118",228,181,181,1,0,"UPyD",4
5,"5064",117,94,93,4,1,"UPyD",2
16,"16259",30,26,26,1,0,"UPyD",1
28,"28003",196,154,151,2,3,"UPyD",12
49,"49010",338,271,265,4,6,"UPyD",15
12,"12106",1207,992,969,7,23,"UPyD",42
12,"12137",47,36,35,0,1,"UPyD",0
47,"47114",4107,2877,2834,37,43,"UPyD",137
48,"48053",856,683,680,8,3,"UPyD",5
21,"21064",6331,4390,4352,46,38,"UPyD",143
10,"10091",391,327,324,3,3,"UPyD",20
3,"3105",5322,4218,4124,34,94,"UPyD",156
42,"42008",69,50,50,0,0,"UPyD",0
24,"24181",1652,1303,1288,12,15,"UPyD",23
19,"19114",40,34,34,0,0,"UPyD",1
36,"36038",65661,47940,47214,836,726,"UPyD",920
10,"10214",226,178,176,2,2,"UPyD",2
29,"29051",37991,24498,24095,381,403,"UPyD",1137
15,"15035",11969,8239,8120,192,119,"UPyD",74
24,"24062",151,107,107,0,0,"UPyD",1
42,"42009",97,69,67,2,2,"UPyD",2
9,"9276",420,275,245,5,30,"UPyD",8
9,"9455",48,39,39,0,0,"UPyD",2
5,"5262",378,308,307,2,1,"UPyD",8
13,"13093",4333,3281,3229,43,52,"UPyD",119
42,"42052",17,10,10,0,0,"UPyD",0
9,"9327",34,34,34,0,0,"UPyD",0
24,"24063",453,323,322,2,1,"UPyD",8
18,"18114",678,508,508,6,0,"UPyD",6
44,"44171",186,127,124,3,3,"UPyD",2
8,"8175",3477,2303,2270,39,33,"UPyD",6
19,"19115",41,26,26,1,0,"UPyD",0
47,"47115",306,248,248,2,0,"UPyD",5
12,"12139",344,219,216,0,3,"UPyD",2
3,"3006",479,380,369,2,11,"UPyD",3
24,"24064",1532,1128,1107,17,21,"UPyD",26
47,"47196",43,29,29,0,0,"UPyD",1
50,"50294",77,58,57,0,1,"UPyD",3
49,"49190",81,65,64,2,1,"UPyD",0
22,"22023",474,382,380,4,2,"UPyD",9
34,"34094",64,47,44,1,3,"UPyD",3
16,"16122",259,195,190,2,5,"UPyD",4
37,"37323",549,427,418,6,9,"UPyD",12
9,"9194",2033,1557,1535,28,22,"UPyD",106
25,"25240",1398,976,958,17,18,"UPyD",6
19,"19220",2225,1482,1456,7,26,"UPyD",148
8,"8268",1110,768,755,17,13,"UPyD",2
45,"45135",4437,3621,3550,44,71,"UPyD",119
31,"31067",1982,1400,1363,28,37,"UPyD",14
15,"15009",11109,8179,8014,129,165,"UPyD",85
31,"31250",2887,1827,1802,20,25,"UPyD",24
44,"44173",107,87,77,5,10,"UPyD",1
34,"34139",179,143,143,1,0,"UPyD",0
47,"47010",11275,8800,8701,163,99,"UPyD",947
39,"39047",1987,1495,1482,9,13,"UPyD",31
8,"8269",2613,1840,1814,32,26,"UPyD",2
16,"16123",110,74,73,1,1,"UPyD",4
10,"10218",1184,896,893,0,3,"UPyD",13
40,"40228",539,446,437,2,9,"UPyD",17
19,"19221",56,41,41,2,0,"UPyD",0
19,"19117",1526,1155,1132,26,23,"UPyD",92
37,"37097",47,39,39,1,0,"UPyD",0
28,"28164",2807,2194,2173,10,21,"UPyD",166
37,"37174",1150,942,922,3,20,"UPyD",28
50,"50007",61,45,45,0,0,"UPyD",3
44,"44132",64,57,56,0,1,"UPyD",0
16,"16001",79,66,66,1,0,"UPyD",2
18,"18018",658,520,514,4,6,"UPyD",15
42,"42161",158,119,119,0,0,"UPyD",2
32,"32047",2003,1595,1575,10,20,"UPyD",6
23,"23005",30698,23126,22916,310,210,"UPyD",822
5,"5169",241,218,218,0,0,"UPyD",2
50,"50268",59,46,46,3,0,"UPyD",2
6,"6128",4466,3310,3264,50,46,"UPyD",58
31,"31252",91,60,58,0,2,"UPyD",1
46,"46028",424,352,347,5,5,"UPyD",15
29,"29056",1177,807,794,3,13,"UPyD",26
49,"49194",380,250,247,4,3,"UPyD",8
34,"34234",72,56,55,1,1,"UPyD",7
43,"43143",62,51,50,1,1,"UPyD",0
16,"16002",195,175,172,0,3,"UPyD",1
29,"29028",1253,887,876,8,11,"UPyD",14
33,"33019",3262,2283,2244,12,39,"UPyD",27
5,"5267",102,78,77,1,1,"UPyD",4
17,"17015",12254,7759,7553,143,206,"UPyD",14
47,"47174",302,236,234,3,2,"UPyD",18
32,"32049",863,566,563,7,3,"UPyD",2
24,"24069",53,44,44,0,0,"UPyD",0
9,"9335",62,52,51,1,1,"UPyD",5
12,"12902",2056,1454,1411,14,43,"UPyD",44
34,"34189",59,47,47,3,0,"UPyD",0
39,"39076",3388,2673,2641,22,32,"UPyD",66
3,"3012",1021,870,862,3,8,"UPyD",25
8,"8272",148,97,96,6,1,"UPyD",1
49,"49199",266,214,211,1,3,"UPyD",5
42,"42212",75,45,45,2,0,"UPyD",1
34,"34101",54,44,44,0,0,"UPyD",2
22,"22178",107,92,92,1,0,"UPyD",4
37,"37057",223,190,190,0,0,"UPyD",2
19,"19008",34,25,25,1,0,"UPyD",3
49,"49200",1011,789,771,6,18,"UPyD",9
37,"37215",156,106,106,1,0,"UPyD",2
31,"31254",1956,1495,1476,16,19,"UPyD",27
31,"31071",17,15,15,0,0,"UPyD",0
9,"9199",97,75,74,0,1,"UPyD",5
10,"10102",534,447,440,4,7,"UPyD",3
7,"7043",3522,2384,2345,35,39,"UPyD",39
16,"16219",106,83,82,0,1,"UPyD",1
14,"14060",4843,3857,3787,47,70,"UPyD",73
8,"8182",2802,1871,1852,35,19,"UPyD",9
41,"41075",9987,7904,7809,71,95,"UPyD",175
25,"25247",142,80,78,3,2,"UPyD",1
40,"40901",379,292,288,11,4,"UPyD",13
47,"47203",69,57,56,0,1,"UPyD",2
13,"13002",1576,1143,1134,4,9,"UPyD",18
47,"47204",275,221,219,3,2,"UPyD",6
3,"3115",267,242,242,2,0,"UPyD",4
39,"39078",1407,1041,1033,10,8,"UPyD",13
34,"34240",102,84,83,1,1,"UPyD",2
46,"46032",5583,4342,4287,39,55,"UPyD",314
37,"37180",69,46,46,0,0,"UPyD",2
24,"24073",521,385,382,4,3,"UPyD",17
50,"50215",21,20,19,0,1,"UPyD",1
47,"47041",166,135,133,2,2,"UPyD",5
43,"43146",45,33,30,1,3,"UPyD",0
26,"26180",243,185,181,4,4,"UPyD",9
50,"50216",267,201,194,8,7,"UPyD",1
18,"18024",882,696,688,12,8,"UPyD",14
19,"19123",40,34,34,0,0,"UPyD",0
18,"18123",307,239,238,1,1,"UPyD",4
10,"10105",2599,1869,1835,25,34,"UPyD",56
47,"47205",414,307,298,5,9,"UPyD",14
27,"27044",3089,2167,2125,31,42,"UPyD",10
25,"25152",160,92,90,4,2,"UPyD",0
37,"37219",197,121,120,0,1,"UPyD",3
44,"44142",39,28,28,1,0,"UPyD",1
16,"16227",128,95,94,0,1,"UPyD",0
37,"37182",92,72,72,2,0,"UPyD",3
1,"1013",711,477,474,1,3,"UPyD",5
22,"22081",268,197,196,4,1,"UPyD",15
6,"6091",3854,2961,2906,33,55,"UPyD",52
8,"8185",189,131,126,1,5,"UPyD",0
17,"17081",236,165,162,2,3,"UPyD",0
36,"36049",6608,5189,5097,56,92,"UPyD",57
42,"42065",28,24,24,0,0,"UPyD",0
34,"34067",142,88,88,3,0,"UPyD",2
49,"49205",429,313,309,10,4,"UPyD",8
22,"22040",155,129,127,3,2,"UPyD",5
43,"43073",90,57,57,1,0,"UPyD",0
40,"40100",303,241,231,5,10,"UPyD",12
13,"13071",41043,28435,28183,370,252,"UPyD",1316
31,"31075",96,61,61,0,0,"UPyD",0
25,"25154",126,77,77,2,0,"UPyD",0
46,"46034",1791,1477,1468,8,9,"UPyD",50
45,"45110",1918,1585,1570,10,15,"UPyD",19
3,"3017",380,331,324,7,7,"UPyD",16
9,"9208",252,192,192,6,0,"UPyD",10
4,"4079",45851,31893,31644,430,249,"UPyD",1643
6,"6093",4599,3658,3612,22,46,"UPyD",64
43,"43001",706,481,473,12,8,"UPyD",6
1,"1062",333,236,232,5,4,"UPyD",5
49,"49076",333,260,257,10,3,"UPyD",17
18,"18027",2575,1913,1899,15,14,"UPyD",52
19,"19126",1552,1140,1119,16,21,"UPyD",107
45,"45147",598,484,478,9,6,"UPyD",13
24,"24079",1045,721,710,15,11,"UPyD",13
3,"3018",11899,8855,8720,119,135,"UPyD",368
3,"3019",14914,12087,11927,137,160,"UPyD",654
8,"8188",106,87,86,4,1,"UPyD",0
9,"9211",1489,1137,1121,28,16,"UPyD",34
40,"40196",44,34,34,3,0,"UPyD",0
18,"18127",15897,11597,11483,133,114,"UPyD",675
43,"43075",102,63,63,1,0,"UPyD",0
14,"14004",2016,1560,1543,8,17,"UPyD",27
9,"9347",136,113,109,5,4,"UPyD",7
5,"5080",75,53,53,1,0,"UPyD",4
16,"16012",102,81,80,0,1,"UPyD",0
25,"25252",536,361,352,13,9,"UPyD",0
31,"31169",2285,1621,1590,43,31,"UPyD",12
46,"46181",17153,13332,13184,108,148,"UPyD",343
9,"9483",226,173,171,4,2,"UPyD",7
25,"25036",190,138,134,5,4,"UPyD",0
14,"14005",6334,4262,4206,61,56,"UPyD",84
37,"37338",82,69,67,0,2,"UPyD",1
8,"8096",40650,28247,27784,527,463,"UPyD",349
28,"28104",11704,9455,9361,119,94,"UPyD",1258
44,"44060",42,34,34,0,0,"UPyD",0
47,"47128",57,52,48,1,4,"UPyD",1
6,"6051",1606,1314,1302,10,12,"UPyD",7
46,"46231",2496,1831,1817,16,14,"UPyD",45
31,"31139",172,97,97,1,0,"UPyD",4
3,"3122",40476,29591,29265,341,326,"UPyD",2318
46,"46182",1190,864,855,11,9,"UPyD",55
33,"33003",737,475,471,6,4,"UPyD",7
13,"13009",1573,1265,1255,6,10,"UPyD",29
3,"3021",5594,4630,4517,46,113,"UPyD",117
9,"9485",62,56,56,0,0,"UPyD",1
49,"49210",493,358,356,6,2,"UPyD",4
27,"27007",3015,2426,2374,42,52,"UPyD",11
9,"9350",502,384,376,7,8,"UPyD",24
19,"19302",64,60,60,2,0,"UPyD",1
47,"47210",396,324,321,5,3,"UPyD",10
46,"46037",1146,1007,1003,5,4,"UPyD",36
6,"6144",588,476,464,2,12,"UPyD",18
5,"5083",155,120,113,1,7,"UPyD",12
26,"26102",6158,4794,4716,60,78,"UPyD",233
3,"3124",482,420,415,7,5,"UPyD",5
9,"9215",426,290,287,1,3,"UPyD",7
34,"34903",240,161,160,2,1,"UPyD",3
46,"46013",16111,12469,12328,145,141,"UPyD",1057
44,"44150",30,30,30,0,0,"UPyD",0
27,"27054",1332,1063,1054,12,9,"UPyD",3
13,"13011",5166,3555,3500,31,55,"UPyD",105
47,"47211",45,38,38,1,0,"UPyD",0
6,"6145",929,746,743,5,3,"UPyD",8
15,"15022",6102,4207,4164,52,43,"UPyD",24
39,"39085",6722,5198,5134,60,64,"UPyD",149
36,"36023",8522,6206,6062,64,144,"UPyD",40
43,"43078",841,557,547,7,10,"UPyD",3
19,"19303",56,48,47,1,1,"UPyD",1
15,"15079",1709,1268,1253,14,15,"UPyD",3
41,"41083",1176,915,908,8,7,"UPyD",22
50,"50137",1119,842,834,12,8,"UPyD",17
49,"49219",7742,5643,5562,87,81,"UPyD",213
21,"21021",11825,7657,7574,108,83,"UPyD",338
49,"49220",161,122,118,5,4,"UPyD",4
5,"5085",35,34,34,0,0,"UPyD",2
9,"9082",49,41,41,0,0,"UPyD",2
20,"20004",254,153,153,5,0,"UPyD",0
11,"11011",1685,1231,1216,8,15,"UPyD",36
34,"34120",65774,49378,48608,830,770,"UPyD",2579
46,"46015",7042,5644,5581,53,63,"UPyD",231
50,"50138",49,43,43,2,0,"UPyD",3
44,"44193",99,71,67,0,4,"UPyD",0
48,"48041",721,588,585,9,3,"UPyD",1
13,"13047",5822,4735,4650,52,85,"UPyD",168
19,"19172",76,65,64,1,1,"UPyD",4
36,"36058",5021,3589,3516,54,73,"UPyD",27
22,"22202",146,120,120,1,0,"UPyD",3
22,"22006",319,203,197,5,6,"UPyD",13
5,"5053",94,73,71,0,2,"UPyD",6
8,"8194",24757,15009,14799,245,210,"UPyD",208
37,"37118",141,115,114,3,1,"UPyD",5
47,"47213",122,99,99,1,0,"UPyD",0
44,"44194",128,92,89,1,3,"UPyD",3
15,"15024",4726,3634,3555,51,79,"UPyD",12
3,"3128",3944,2847,2812,16,35,"UPyD",112
22,"22050",100,84,83,0,1,"UPyD",1
17,"17089",5486,3328,3288,43,40,"UPyD",8
22,"22051",108,86,84,2,2,"UPyD",0
46,"46040",1227,1028,1021,13,7,"UPyD",19
44,"44195",103,71,70,0,1,"UPyD",4
50,"50139",372,280,278,3,2,"UPyD",1
8,"8102",27850,18716,18470,373,246,"UPyD",110
39,"39062",1759,1397,1387,9,10,"UPyD",27
28,"28175",780,641,630,8,11,"UPyD",56
20,"20007",300,203,202,2,1,"UPyD",0
16,"16147",78,63,62,1,1,"UPyD",0
6,"6014",6843,4894,4839,30,55,"UPyD",125
33,"33075",305,191,190,0,1,"UPyD",2
49,"49224",161,114,112,2,2,"UPyD",6
17,"17061",175,123,123,4,0,"UPyD",0
44,"44196",152,116,114,2,2,"UPyD",1
5,"5088",34,26,26,0,0,"UPyD",0
50,"50227",105,79,79,2,0,"UPyD",3
27,"27061",1170,917,906,8,11,"UPyD",7
43,"43008",333,206,197,3,9,"UPyD",0
48,"48077",3398,2490,2477,33,13,"UPyD",30
21,"21025",3969,2731,2686,33,45,"UPyD",87
16,"16149",179,140,138,2,2,"UPyD",8
17,"17091",433,288,277,16,11,"UPyD",0
9,"9907",1385,1053,1041,31,12,"UPyD",115
8,"8103",636,453,446,16,7,"UPyD",0
24,"24091",704,502,496,8,6,"UPyD",14
26,"26110",178,149,147,3,2,"UPyD",3
44,"44070",62,47,47,1,0,"UPyD",0
8,"8288",1735,985,957,13,28,"UPyD",6
33,"33008",1934,1474,1459,11,15,"UPyD",13
39,"39012",6666,5148,5061,43,87,"UPyD",131
28,"28062",311,233,226,0,7,"UPyD",25
5,"5186",1670,1306,1287,9,19,"UPyD",66
39,"39090",731,577,572,3,5,"UPyD",7
10,"10122",253,197,191,2,6,"UPyD",10
8,"8104",713,454,441,9,13,"UPyD",0
35,"35005",1170,864,853,7,11,"UPyD",17
28,"28177",9470,7524,7466,87,58,"UPyD",866
31,"31905",2707,1913,1881,32,32,"UPyD",61
44,"44199",52,40,39,0,1,"UPyD",4
31,"31087",163,122,121,3,1,"UPyD",0
24,"24215",169,121,120,1,1,"UPyD",8
24,"24093",388,262,258,1,4,"UPyD",4
28,"28156",958,742,733,12,9,"UPyD",70
26,"26112",270,201,200,0,1,"UPyD",5
25,"25167",253,176,172,0,4,"UPyD",0
23,"23076",831,681,671,5,10,"UPyD",11
34,"34126",284,226,224,3,2,"UPyD",4
50,"50143",608,427,424,5,3,"UPyD",7
47,"47028",31,21,20,0,1,"UPyD",0
33,"33010",1922,1284,1277,14,7,"UPyD",15
23,"23077",668,523,518,2,5,"UPyD",7
16,"16026",104,79,79,1,0,"UPyD",1
28,"28064",143,112,110,1,2,"UPyD",14
30,"30043",24501,19738,19416,230,322,"UPyD",1146
22,"22057",377,283,278,3,5,"UPyD",4
27,"27066",12908,9554,9329,171,225,"UPyD",98
18,"18107",988,769,760,3,9,"UPyD",6
22,"22058",194,138,137,5,1,"UPyD",0
34,"34127",118,77,74,1,3,"UPyD",1
35,"35007",569,392,391,2,1,"UPyD",1
31,"31907",9914,7394,7282,198,112,"UPyD",203
17,"17094",1161,694,683,11,11,"UPyD",3
41,"41012",3115,2314,2271,29,43,"UPyD",62
24,"24217",144,108,107,2,1,"UPyD",4
45,"45053",8208,6763,6663,103,100,"UPyD",320
24,"24095",293,211,208,1,3,"UPyD",2
25,"25907",506,297,292,6,5,"UPyD",0
50,"50056",450,329,328,4,1,"UPyD",24
2,"2014",390,333,326,5,7,"UPyD",2
9,"9093",154,127,125,1,2,"UPyD",9
37,"37240",781,552,540,10,12,"UPyD",26
43,"43085",229,178,171,0,7,"UPyD",1
6,"6023",4572,3301,3261,34,40,"UPyD",65
44,"44163",119,91,91,0,0,"UPyD",1
40,"40124",261,190,183,9,7,"UPyD",4
26,"26117",2152,1682,1655,20,27,"UPyD",46
15,"15031",22951,16018,15696,382,322,"UPyD",330
13,"13022",403,314,314,2,0,"UPyD",10
49,"49183",111,87,87,2,0,"UPyD",5
3,"3034",1343,1140,1126,5,14,"UPyD",20
31,"31091",365,227,224,3,3,"UPyD",0
34,"34004",5790,4354,4262,84,92,"UPyD",199
17,"17096",182,96,94,2,2,"UPyD",1
5,"5191",124,98,98,2,0,"UPyD",5
31,"31182",45,28,28,2,0,"UPyD",0
39,"39094",927,702,691,0,11,"UPyD",13
17,"17007",1778,1137,1113,16,24,"UPyD",0
8,"8202",12206,8265,8129,183,136,"UPyD",46
23,"23040",1538,1319,1311,3,8,"UPyD",18
13,"13023",8731,6818,6732,94,86,"UPyD",150
17,"17008",3745,2262,2195,34,67,"UPyD",2
6,"6025",5083,3898,3851,51,47,"UPyD",77
25,"25909",141,82,78,0,4,"UPyD",0
23,"23084",1046,817,812,4,5,"UPyD",7
43,"43161",17199,10765,10547,197,218,"UPyD",70
34,"34132",128,103,102,2,1,"UPyD",4
28,"28002",2650,2018,1993,24,25,"UPyD",200
31,"31092",676,447,446,6,1,"UPyD",3
46,"46047",551,479,469,10,10,"UPyD",13
8,"8294",1870,1205,1171,22,34,"UPyD",13
16,"16032",304,253,244,2,9,"UPyD",4
22,"22062",189,126,125,2,1,"UPyD",8
46,"46120",1133,889,870,2,19,"UPyD",38
49,"49235",486,344,340,6,4,"UPyD",13
47,"47221",115,102,102,0,0,"UPyD",5
12,"12075",139,106,102,0,4,"UPyD",2
5,"5097",525,378,373,4,5,"UPyD",26
15,"15090",1267,959,953,4,6,"UPyD",4
28,"28160",7496,5680,5613,46,67,"UPyD",540
16,"16158",550,427,423,2,4,"UPyD",6
37,"37244",132,97,95,5,2,"UPyD",7
2,"2018",922,759,754,7,5,"UPyD",14
22,"22218",49,33,33,1,0,"UPyD",3
33,"33014",9318,6380,6320,66,60,"UPyD",207
45,"45059",1758,1465,1437,10,28,"UPyD",44
7,"7001",3450,2544,2470,36,74,"UPyD",53
9,"9190",97,73,72,0,1,"UPyD",1
42,"42097",19,16,16,0,0,"UPyD",1
8,"8205",54870,41064,40491,682,573,"UPyD",492
13,"13026",482,387,384,1,3,"UPyD",3
17,"17099",74,52,50,1,2,"UPyD",0
28,"28182",219,179,178,2,1,"UPyD",16
50,"50150",716,430,427,10,3,"UPyD",9
37,"37358",163,143,139,0,4,"UPyD",6
8,"8297",138,99,99,2,0,"UPyD",1
19,"19322",35,28,27,1,1,"UPyD",0
22,"22114",137,94,94,4,0,"UPyD",1
47,"47223",172,147,147,6,0,"UPyD",6
4,"4100",7918,5465,5425,52,40,"UPyD",280
46,"46049",292,249,245,0,4,"UPyD",4
15,"15036",60838,40345,39667,915,678,"UPyD",605
5,"5195",241,168,164,0,4,"UPyD",12
10,"10011",611,527,519,5,8,"UPyD",8
43,"43163",24903,15475,15241,263,234,"UPyD",147
16,"16036",143,117,115,1,2,"UPyD",0
46,"46195",1975,1631,1631,33,0,"UPyD",37
41,"41017",13878,10053,9926,130,127,"UPyD",750
13,"13027",3582,2770,2715,25,55,"UPyD",60
9,"9374",96,85,81,3,4,"UPyD",10
19,"19040",73,42,42,1,0,"UPyD",2
37,"37011",131,87,86,2,1,"UPyD",3
34,"34011",406,327,327,4,0,"UPyD",6
14,"14023",2084,1809,1787,13,22,"UPyD",29
48,"48089",2878,2120,2089,19,31,"UPyD",19
31,"31005",312,209,206,4,3,"UPyD",3
24,"24104",291,198,196,3,2,"UPyD",6
31,"31097",10461,7152,7029,129,123,"UPyD",121
18,"18046",1960,1327,1312,5,15,"UPyD",28
25,"25175",221,151,150,0,1,"UPyD",2
7,"7004",3669,2511,2453,51,58,"UPyD",61
3,"3041",5811,4325,4269,33,56,"UPyD",97
47,"47225",89,67,66,0,1,"UPyD",2
39,"39099",2987,2416,2391,28,25,"UPyD",54
37,"37248",160,130,130,1,0,"UPyD",5
24,"24228",732,543,529,4,14,"UPyD",25
34,"34096",56,41,39,1,2,"UPyD",1
50,"50035",78,61,56,2,5,"UPyD",0
40,"40087",112,85,83,0,2,"UPyD",1
40,"40135",298,247,242,4,5,"UPyD",4
3,"3904",1416,1104,1096,11,8,"UPyD",20
9,"9105",111,85,81,2,4,"UPyD",7
28,"28119",1911,1527,1514,13,13,"UPyD",154
45,"45173",9133,7147,7035,78,112,"UPyD",410
17,"17013",2774,1884,1859,21,25,"UPyD",7
32,"32010",457,362,356,0,6,"UPyD",5
47,"47226",180,152,148,1,4,"UPyD",7
12,"12079",450,360,353,3,7,"UPyD",17
19,"19005",92,80,79,0,1,"UPyD",3
37,"37212",123,95,92,1,3,"UPyD",4
31,"31098",1762,1285,1262,34,23,"UPyD",47
44,"44046",58,44,44,1,0,"UPyD",0
27,"27035",194,119,119,0,0,"UPyD",0
31,"31069",860,660,647,2,13,"UPyD",7
10,"10098",412,317,313,5,4,"UPyD",4
5,"5199",48,39,39,0,0,"UPyD",1
40,"40138",2195,1758,1725,18,33,"UPyD",112
49,"49109",657,534,529,12,5,"UPyD",8
46,"46198",815,660,654,4,6,"UPyD",23
37,"37363",121,100,99,0,1,"UPyD",3
41,"41020",12710,8954,8882,91,72,"UPyD",180
19,"19255",95,68,68,0,0,"UPyD",1
7,"7007",454,304,300,4,4,"UPyD",9
23,"23095",8882,6668,6628,31,40,"UPyD",163
37,"37016",539,424,420,8,4,"UPyD",14
28,"28120",1259,946,931,11,15,"UPyD",85
8,"8211",32035,23059,22687,453,372,"UPyD",370
35,"35016",291589,181013,177964,2856,3049,"UPyD",6809
44,"44048",77,59,59,0,0,"UPyD",0
27,"27038",1035,817,809,9,8,"UPyD",0
28,"28165",1689,1310,1295,5,15,"UPyD",71
46,"46199",5661,4328,4280,38,48,"UPyD",283
46,"46253",118,105,102,7,3,"UPyD",2
50,"50066",2357,1677,1659,42,18,"UPyD",116
44,"44217",37,28,27,0,1,"UPyD",0
19,"19157",66,56,56,4,0,"UPyD",2
50,"50156",234,186,183,2,3,"UPyD",4
9,"9110",95,68,68,1,0,"UPyD",1
45,"45176",3570,2619,2583,45,36,"UPyD",217
47,"47065",898,762,752,9,10,"UPyD",14
37,"37253",137,115,115,1,0,"UPyD",6
24,"24109",1098,672,663,12,9,"UPyD",11
2,"2028",139,115,115,1,0,"UPyD",3
47,"47229",235,161,161,1,0,"UPyD",1
25,"25180",245,167,165,3,2,"UPyD",0
16,"16043",105,86,86,1,0,"UPyD",0
22,"22077",421,327,323,14,4,"UPyD",6
7,"7009",744,593,576,11,17,"UPyD",10
9,"9382",33,30,30,0,0,"UPyD",1
33,"33020",13542,9300,9173,135,127,"UPyD",315
10,"10143",169,135,131,1,4,"UPyD",0
31,"31193",1312,969,948,33,21,"UPyD",13
25,"25151",641,451,444,20,7,"UPyD",1
32,"32015",995,697,694,9,3,"UPyD",2
28,"28073",11899,8877,8769,112,108,"UPyD",930
18,"18051",1196,857,852,4,5,"UPyD",25
16,"16045",226,177,176,2,1,"UPyD",2
5,"5107",74,54,53,0,1,"UPyD",2
46,"46055",1286,1083,1067,11,16,"UPyD",36
8,"8121",85069,58372,57620,923,752,"UPyD",613
9,"9113",503,397,390,7,7,"UPyD",27
37,"37019",157,114,113,0,1,"UPyD",5
40,"40143",97,72,72,0,0,"UPyD",5
31,"31012",839,577,570,10,7,"UPyD",8
49,"49114",51,34,33,1,1,"UPyD",1
46,"46255",3135,2530,2508,11,22,"UPyD",70
47,"47150",338,273,271,2,2,"UPyD",9
45,"45070",1415,1175,1162,11,13,"UPyD",28
22,"22079",126,97,97,4,0,"UPyD",4
6,"6042",1017,824,820,5,4,"UPyD",4
17,"17200",616,406,393,12,13,"UPyD",1
37,"37143",410,342,338,3,4,"UPyD",9
22,"22080",288,217,217,4,0,"UPyD",7
9,"9386",61,45,45,0,0,"UPyD",3
3,"3048",4747,3878,3817,16,61,"UPyD",83
37,"37021",86,70,68,2,2,"UPyD",2
43,"43097",379,283,278,6,5,"UPyD",2
22,"22233",94,69,69,0,0,"UPyD",5
43,"43170",880,601,592,9,9,"UPyD",2
5,"5007",126,104,102,0,2,"UPyD",1
26,"26010",98,82,79,1,3,"UPyD",3
25,"25003",3853,2367,2340,68,27,"UPyD",10
43,"43024",1459,958,937,17,21,"UPyD",3
43,"43147",528,393,380,7,13,"UPyD",0
4,"4044",1517,1232,1224,8,8,"UPyD",21
41,"41078",2587,1979,1970,15,9,"UPyD",42
45,"45182",1077,873,856,11,17,"UPyD",22
15,"15045",4178,2743,2727,22,16,"UPyD",5
47,"47232",107,77,75,1,2,"UPyD",2
44,"44223",80,55,55,0,0,"UPyD",1
16,"16278",91,69,69,2,0,"UPyD",1
26,"26139",68,55,55,4,0,"UPyD",1
8,"8216",21,14,14,0,0,"UPyD",1
13,"13038",1770,1397,1380,8,17,"UPyD",28
31,"31106",676,534,518,10,16,"UPyD",14
35,"35021",14982,9948,9749,138,199,"UPyD",410
42,"42120",148,91,91,4,0,"UPyD",2
41,"41093",17665,13712,13526,179,186,"UPyD",1028
9,"9249",54,44,42,1,2,"UPyD",1
25,"25094",154,110,107,1,3,"UPyD",0
50,"50218",113,92,92,0,0,"UPyD",0
20,"20033",884,650,641,4,9,"UPyD",2
2,"2033",1955,1565,1536,15,29,"UPyD",55
8,"8217",24130,17554,17319,383,235,"UPyD",320
43,"43074",1697,1150,1120,25,30,"UPyD",5
18,"18159",1051,873,869,4,4,"UPyD",5
41,"41027",4061,2783,2752,28,31,"UPyD",77
48,"48001",5842,4040,4020,23,20,"UPyD",47
5,"5112",125,88,87,0,1,"UPyD",6
13,"13040",933,755,744,4,11,"UPyD",19
5,"5113",90,74,74,0,0,"UPyD",2
26,"26013",350,267,264,5,3,"UPyD",12
19,"19263",34,27,27,0,0,"UPyD",0
45,"45075",205,162,159,4,3,"UPyD",9
48,"48904",3510,2682,2665,26,17,"UPyD",27
25,"25186",231,168,168,3,0,"UPyD",0
21,"21047",1965,1355,1325,17,30,"UPyD",16
50,"50044",259,175,175,0,0,"UPyD",4
50,"50163",3427,2448,2413,62,35,"UPyD",214
24,"24118",132,96,96,2,0,"UPyD",0
22,"22084",524,362,354,11,8,"UPyD",23
5,"5210",105,83,82,2,1,"UPyD",4
37,"37148",451,344,343,3,1,"UPyD",9
15,"15047",2606,1789,1761,33,28,"UPyD",3
39,"39030",1971,1397,1379,20,18,"UPyD",31
32,"32022",1591,1219,1207,9,12,"UPyD",4
19,"19167",136,112,109,4,3,"UPyD",3
47,"47154",168,144,144,7,0,"UPyD",8
31,"31199",161,103,103,1,0,"UPyD",1
28,"28078",39,23,23,1,0,"UPyD",0
29,"29036",670,504,499,4,5,"UPyD",13
29,"29082",29311,20220,20051,223,169,"UPyD",1538
5,"5115",590,458,450,1,8,"UPyD",32
44,"44108",352,228,225,8,3,"UPyD",5
31,"31109",1365,946,934,11,12,"UPyD",20
36,"36054",10862,8201,8087,87,114,"UPyD",58
25,"25007",1363,902,885,36,17,"UPyD",8
8,"8036",172,124,124,4,0,"UPyD",1
8,"8220",2277,1641,1604,44,37,"UPyD",3
7,"7018",389,275,271,0,4,"UPyD",8
25,"25190",271,180,176,12,4,"UPyD",0
26,"26017",380,277,276,3,1,"UPyD",8
37,"37027",242,196,192,2,4,"UPyD",11
49,"49258",127,107,104,0,3,"UPyD",2
37,"37150",43,36,34,0,2,"UPyD",0
48,"48071",6097,4307,4224,61,83,"UPyD",35
28,"28151",3025,2237,2185,9,52,"UPyD",210
28,"28106",72603,53231,52524,681,707,"UPyD",6239
35,"35025",1941,1345,1328,12,17,"UPyD",42
39,"39032",1576,1215,1209,10,6,"UPyD",23
20,"20039",2003,1517,1512,9,5,"UPyD",1
28,"28127",60108,48418,48039,568,379,"UPyD",5586
46,"46261",1706,1388,1366,13,22,"UPyD",49
9,"9125",648,463,460,5,3,"UPyD",29
46,"46062",4589,3794,3752,46,42,"UPyD",118
40,"40155",3083,2333,2280,73,53,"UPyD",234
9,"9351",63,46,44,0,2,"UPyD",2
46,"46110",21420,15810,15671,134,139,"UPyD",1053
18,"18164",1881,1351,1342,16,9,"UPyD",9
44,"44110",57,45,45,0,0,"UPyD",0
48,"48908",242,194,194,1,0,"UPyD",0
13,"13044",2747,1996,1950,20,46,"UPyD",48
19,"19057",79,56,56,0,0,"UPyD",0
18,"18063",1189,795,789,7,6,"UPyD",13
34,"34160",154,119,116,0,3,"UPyD",3
28,"28128",366,280,275,2,5,"UPyD",16
5,"5117",213,183,180,0,3,"UPyD",7
17,"17118",12541,7817,7681,130,136,"UPyD",74
16,"16057",109,82,82,1,0,"UPyD",0
46,"46208",1141,990,978,6,12,"UPyD",23
50,"50252",5345,3860,3792,79,68,"UPyD",112
10,"10156",116,91,91,0,0,"UPyD",1
18,"18165",3942,2819,2776,27,43,"UPyD",132
28,"28129",7219,5536,5461,71,75,"UPyD",663
37,"37379",167,128,125,4,3,"UPyD",10
22,"22247",31,21,20,1,1,"UPyD",0
3,"3057",232,179,178,0,1,"UPyD",3
15,"15051",4780,3333,3289,61,44,"UPyD",18
18,"18033",282,227,226,0,1,"UPyD",2
47,"47131",189,145,145,4,0,"UPyD",6
26,"26021",2758,2190,2163,21,27,"UPyD",75
17,"17088",551,374,363,4,11,"UPyD",1
8,"8100",1934,1437,1401,40,36,"UPyD",2
47,"47212",386,327,325,1,2,"UPyD",7
8,"8224",771,538,528,26,10,"UPyD",0
9,"9259",239,178,177,2,1,"UPyD",7
11,"11040",411,317,309,0,8,"UPyD",9
48,"48008",600,432,428,3,4,"UPyD",2
40,"40017",103,89,88,2,1,"UPyD",11
37,"37156",4319,3280,3233,28,47,"UPyD",137
31,"31113",147,87,85,2,2,"UPyD",0
19,"19269",103,84,83,0,1,"UPyD",1
9,"9261",486,342,338,7,4,"UPyD",12
24,"24125",545,374,373,5,1,"UPyD",9
8,"8040",10538,6916,6804,99,112,"UPyD",46
44,"44234",76,63,63,0,0,"UPyD",6
12,"12096",854,663,653,17,10,"UPyD",4
10,"10036",345,262,251,2,11,"UPyD",3
7,"7023",3541,2414,2365,88,49,"UPyD",47
24,"24127",327,258,255,1,3,"UPyD",8
6,"6059",1959,1476,1466,8,10,"UPyD",53
8,"8132",381,247,241,6,6,"UPyD",0
2,"2007",1139,923,916,0,7,"UPyD",15
45,"45084",2395,1879,1842,21,37,"UPyD",32
27,"27013",3950,3156,3090,39,66,"UPyD",29
37,"37034",91,72,72,0,0,"UPyD",4
10,"10160",235,183,183,1,0,"UPyD",0
8,"8133",157,100,97,2,3,"UPyD",0
18,"18067",704,526,521,1,5,"UPyD",10
28,"28176",10977,8790,8718,68,72,"UPyD",979
24,"24010",8550,6242,6111,100,131,"UPyD",207
49,"49266",83,69,69,1,0,"UPyD",4
33,"33030",921,682,668,4,14,"UPyD",11
40,"40161",38,28,28,0,0,"UPyD",6
6,"6061",1116,1000,989,8,11,"UPyD",10
46,"46903",5210,4037,4000,40,37,"UPyD",377
19,"19271",53,45,45,1,0,"UPyD",0
31,"31025",751,501,495,12,6,"UPyD",5
24,"24130",468,343,337,6,6,"UPyD",21
39,"39037",2061,1609,1586,10,23,"UPyD",30
12,"12098",665,552,539,9,13,"UPyD",2
26,"26026",1344,1108,1096,14,12,"UPyD",26
29,"29089",3343,2514,2489,14,25,"UPyD",48
20,"20045",46542,30907,30536,425,371,"UPyD",835
26,"26153",12,9,8,0,1,"UPyD",0
43,"43034",494,355,344,8,11,"UPyD",0
48,"48012",2036,1630,1616,9,14,"UPyD",4
10,"10040",455,344,334,8,10,"UPyD",6
8,"8043",3067,2044,2023,29,21,"UPyD",18
9,"9407",31,27,27,0,0,"UPyD",1
3,"3062",206,175,175,0,0,"UPyD",4
6,"6063",3079,2467,2454,16,13,"UPyD",43
46,"46213",15621,11361,11164,214,197,"UPyD",740
37,"37160",644,474,464,4,10,"UPyD",8
31,"31117",670,471,467,3,4,"UPyD",0
50,"50257",195,154,154,0,0,"UPyD",2
22,"22253",71,54,54,1,0,"UPyD",0
24,"24014",7677,5352,5289,75,63,"UPyD",142
39,"39038",1465,1065,1047,8,18,"UPyD",36
22,"22103",697,532,523,10,9,"UPyD",22
33,"33032",12060,8627,8491,107,136,"UPyD",206
31,"31118",182,114,114,6,0,"UPyD",4
42,"42142",55,41,38,2,3,"UPyD",1
50,"50258",54,37,37,0,0,"UPyD",3
50,"50173",175,104,104,2,0,"UPyD",3
11,"11902",3578,2400,2376,21,24,"UPyD",42
9,"9012",105,77,74,3,3,"UPyD",1
40,"40025",158,124,124,0,0,"UPyD",7
12,"12101",385,309,296,3,13,"UPyD",3
45,"45089",1615,1238,1221,16,17,"UPyD",32
38,"38004",4522,3034,2975,33,59,"UPyD",74
16,"16197",73,50,50,1,0,"UPyD",0
16,"16152",42,38,37,3,1,"UPyD",2
37,"37162",232,184,182,4,2,"UPyD",2
11,"11017",3219,2403,2388,18,15,"UPyD",34
39,"39039",648,496,493,0,3,"UPyD",9
5,"5125",60,52,52,0,0,"UPyD",2
7,"7028",876,607,595,6,12,"UPyD",10
7,"7029",4090,2921,2866,44,55,"UPyD",66
37,"37163",44,36,36,0,0,"UPyD",4
48,"48015",34932,24209,23966,296,243,"UPyD",375
18,"18071",5589,4268,4205,44,63,"UPyD",305
24,"24136",596,465,463,12,2,"UPyD",8
44,"44241",575,442,427,4,15,"UPyD",6
34,"34046",45,35,34,0,1,"UPyD",0
16,"16068",143,117,116,6,1,"UPyD",3
41,"41903",6653,5134,5070,61,64,"UPyD",153
26,"26160",684,538,528,5,10,"UPyD",12
43,"43110",307,216,214,5,2,"UPyD",0
49,"49137",179,149,147,2,2,"UPyD",5
47,"47165",7036,5328,5258,67,70,"UPyD",278
5,"5026",229,193,192,2,1,"UPyD",0
17,"17035",548,385,379,7,6,"UPyD",1
17,"17095",19245,11212,11067,160,145,"UPyD",114
26,"26161",9,8,8,0,0,"UPyD",0
32,"32037",828,660,654,10,6,"UPyD",3
45,"45201",3439,2353,2317,31,36,"UPyD",155
28,"28022",30019,24469,24279,292,190,"UPyD",2737
32,"32001",4938,3715,3667,50,48,"UPyD",23
40,"40030",520,432,425,9,7,"UPyD",26
31,"31030",155,113,112,3,1,"UPyD",2
45,"45202",3876,3037,2984,13,53,"UPyD",110
19,"19181",69,54,54,5,0,"UPyD",3
50,"50261",246,199,199,4,0,"UPyD",1
37,"37042",45,35,35,1,0,"UPyD",1
44,"44123",117,79,78,2,1,"UPyD",0
25,"25203",8995,5418,5309,116,109,"UPyD",41
39,"39042",5928,4680,4634,44,46,"UPyD",147
46,"46119",856,702,693,0,9,"UPyD",20
7,"7032",19658,12168,11959,238,209,"UPyD",387
31,"31122",4506,3333,3281,76,52,"UPyD",76
21,"21062",1444,1003,991,7,12,"UPyD",12
42,"42152",96,71,69,1,2,"UPyD",3
16,"16203",9839,7520,7342,101,178,"UPyD",346
14,"14049",16358,12577,12478,137,99,"UPyD",348
47,"47084",1230,981,968,19,13,"UPyD",32
22,"22905",312,249,247,4,2,"UPyD",11
19,"19281",25,24,22,3,2,"UPyD",1
40,"40032",394,293,288,6,5,"UPyD",25
41,"41040",9567,7305,7210,93,95,"UPyD",617
34,"34177",170,147,143,2,4,"UPyD",2
19,"19282",210,157,157,0,0,"UPyD",2
12,"12105",866,679,673,6,6,"UPyD",10
9,"9139",104,84,80,3,4,"UPyD",4
22,"22112",9618,6642,6533,205,109,"UPyD",205
50,"50087",31,25,25,0,0,"UPyD",2
10,"10171",376,287,282,0,5,"UPyD",3
37,"37280",84,64,64,0,0,"UPyD",1
17,"17038",343,261,256,2,5,"UPyD",3
29,"29067",420165,273593,271376,3342,2217,"UPyD",19267
4,"4098",1616,1255,1249,7,6,"UPyD",28
5,"5033",184,159,155,3,4,"UPyD",4
15,"15062",6304,4418,4356,44,62,"UPyD",29
50,"50263",235,160,160,1,0,"UPyD",6
44,"44249",58,40,40,1,0,"UPyD",1
29,"29023",1661,1080,1074,15,6,"UPyD",42
10,"10050",1208,1003,983,8,20,"UPyD",10
31,"31124",209,139,138,1,1,"UPyD",1
26,"26122",109,94,92,2,2,"UPyD",7
50,"50179",269,230,229,2,1,"UPyD",4
24,"24143",515,376,373,6,3,"UPyD",2
18,"18178",834,685,683,3,2,"UPyD",8
40,"40034",85,73,73,1,0,"UPyD",6
24,"24144",781,551,541,13,10,"UPyD",12
7,"7034",971,724,708,10,16,"UPyD",10
46,"46146",1718,1395,1374,10,21,"UPyD",60
12,"12007",747,674,660,9,14,"UPyD",6
12,"12138",18762,12489,12231,243,258,"UPyD",313
12,"12108",495,394,389,4,5,"UPyD",21
46,"46073",1119,931,915,14,16,"UPyD",29
36,"36005",8231,5985,5873,84,112,"UPyD",51
18,"18179",583,417,409,7,8,"UPyD",1
26,"26039",44,38,36,1,2,"UPyD",0
44,"44128",84,56,56,3,0,"UPyD",1
10,"10175",1509,1149,1127,4,22,"UPyD",23
29,"29099",958,739,730,5,9,"UPyD",15
22,"22115",415,307,304,2,3,"UPyD",2
47,"47087",376,320,315,7,5,"UPyD",8
49,"49146",330,268,265,6,3,"UPyD",4
12,"12008",236,203,199,4,4,"UPyD",3
19,"19078",58,49,48,0,1,"UPyD",1
29,"29025",34637,22545,22354,268,191,"UPyD",1476
23,"23001",1058,922,920,6,2,"UPyD",12
46,"46074",2656,2071,2053,22,18,"UPyD",120
22,"22116",1571,1127,1114,37,13,"UPyD",47
46,"46220",48981,34657,34242,450,415,"UPyD",2028
18,"18082",912,691,683,8,8,"UPyD",20
36,"36007",1778,1258,1238,2,20,"UPyD",5
18,"18180",655,450,447,1,3,"UPyD",6
28,"28140",2665,2167,2141,26,26,"UPyD",237
34,"34055",288,215,212,4,3,"UPyD",2
48,"48024",1026,845,841,3,4,"UPyD",1
9,"9023",993,771,765,22,6,"UPyD",61
6,"6078",548,457,453,2,4,"UPyD",10
25,"25208",294,174,170,3,4,"UPyD",0
31,"31036",957,631,616,22,15,"UPyD",8
46,"46002",1166,942,915,7,27,"UPyD",46
16,"16039",466,330,326,1,4,"UPyD",4
50,"50239",65,44,44,0,0,"UPyD",2
22,"22069",436,317,315,5,2,"UPyD",11
37,"37285",457,349,347,2,2,"UPyD",2
18,"18083",296,242,242,1,0,"UPyD",9
24,"24149",149,120,118,3,2,"UPyD",5
9,"9024",159,124,123,2,1,"UPyD",3
36,"36008",21702,15366,15037,261,329,"UPyD",182
21,"21068",1009,726,721,10,5,"UPyD",6
45,"45100",205,169,169,0,0,"UPyD",5
22,"22122",62,57,57,3,0,"UPyD",1
10,"10178",797,604,597,5,7,"UPyD",12
25,"25176",341,243,240,7,3,"UPyD",0
24,"24106",340,229,228,6,1,"UPyD",5
36,"36009",5138,3147,3108,24,39,"UPyD",15
31,"31099",68,50,50,0,0,"UPyD",0
39,"39022",985,735,734,5,1,"UPyD",14
34,"34140",113,84,84,2,0,"UPyD",0
25,"25210",1164,799,789,13,10,"UPyD",0
34,"34185",72,48,45,0,3,"UPyD",0
25,"25027",1042,691,665,11,26,"UPyD",0
7,"7040",266127,162699,160491,2698,2208,"UPyD",9144
10,"10180",5446,3957,3917,28,40,"UPyD",66
21,"21069",1778,1245,1242,11,3,"UPyD",34
16,"16085",151,123,122,2,1,"UPyD",6
3,"3076",8373,6319,6222,68,97,"UPyD",261
50,"50184",132,106,106,1,0,"UPyD",3
19,"19289",33,28,28,1,0,"UPyD",3
40,"40043",1842,1494,1469,28,25,"UPyD",61
22,"22124",229,171,170,2,1,"UPyD",7
47,"47091",97,82,80,3,2,"UPyD",1
18,"18085",818,538,532,4,6,"UPyD",8
15,"15040",2891,2160,2129,18,31,"UPyD",3
18,"18151",276,191,188,0,3,"UPyD",3
49,"49110",382,236,233,1,3,"UPyD",5
3,"3077",1411,1146,1130,14,16,"UPyD",32
19,"19190",2499,1829,1785,32,44,"UPyD",64
41,"41048",2296,1749,1726,21,23,"UPyD",57
13,"13066",2444,2094,2065,15,29,"UPyD",36
36,"36011",1939,1189,1172,15,17,"UPyD",6
29,"29029",452,339,336,0,3,"UPyD",8
30,"30001",4763,3992,3956,26,36,"UPyD",166
42,"42017",154,134,130,2,4,"UPyD",10
24,"24031",220,180,176,3,4,"UPyD",3
9,"9155",27,17,17,0,0,"UPyD",0
8,"8149",985,683,671,11,12,"UPyD",1
32,"32050",2663,1991,1974,17,17,"UPyD",5
5,"5040",77,59,59,1,0,"UPyD",2
38,"38018",4397,3216,3163,27,53,"UPyD",42
5,"5139",74,62,59,2,3,"UPyD",4
42,"42018",178,129,124,0,5,"UPyD",2
13,"13067",380,314,312,3,2,"UPyD",4
31,"31041",1397,938,913,26,25,"UPyD",29
37,"37291",261,215,214,1,1,"UPyD",9
7,"7042",10393,6536,6421,96,115,"UPyD",121
34,"34061",116,78,78,2,0,"UPyD",3
11,"11029",5360,3445,3423,27,22,"UPyD",42
24,"24032",134,102,101,1,1,"UPyD",3
50,"50271",283,209,207,4,2,"UPyD",5
21,"21072",10233,7829,7666,124,163,"UPyD",312
39,"39051",73,62,62,2,0,"UPyD",0
18,"18087",187449,138136,136783,1548,1353,"UPyD",10026
12,"12115",234,184,183,2,1,"UPyD",5
3,"3080",1288,1116,1103,6,13,"UPyD",54
50,"50011",131,113,113,8,0,"UPyD",0
13,"13068",1058,801,793,4,8,"UPyD",11
16,"16224",96,69,69,0,0,"UPyD",1
29,"29031",1652,1123,1118,11,5,"UPyD",20
28,"28031",1981,1524,1500,9,24,"UPyD",65
16,"16089",386,310,308,10,2,"UPyD",6
42,"42020",4385,3055,2957,74,98,"UPyD",120
50,"50012",105,93,90,0,3,"UPyD",3
9,"9160",104,75,74,0,1,"UPyD",2
5,"5141",99,90,89,0,1,"UPyD",9
24,"24155",524,428,420,6,8,"UPyD",19
24,"24034",3434,2524,2481,37,43,"UPyD",73
2,"2067",1197,938,924,6,14,"UPyD",37
40,"40049",52,39,39,1,0,"UPyD",0
12,"12117",3674,2846,2794,25,52,"UPyD",48
34,"34196",94,74,73,1,1,"UPyD",0
25,"25216",250,175,173,5,2,"UPyD",1
24,"24156",264,187,186,6,1,"UPyD",4
10,"10064",1549,1229,1209,6,20,"UPyD",14
6,"6089",607,530,529,2,1,"UPyD",12
9,"9162",122,94,93,1,1,"UPyD",6
40,"40051",54,41,40,0,1,"UPyD",1
21,"21074",2752,1981,1968,15,13,"UPyD",23
33,"33022",992,709,696,12,13,"UPyD",7
50,"50246",48,33,33,1,0,"UPyD",0
25,"25093",657,465,455,8,10,"UPyD",0
31,"31227",8257,5987,5884,125,103,"UPyD",73
12,"12118",83,63,62,0,1,"UPyD",2
8,"8153",502,357,350,7,7,"UPyD",2
26,"26181",14,12,12,0,0,"UPyD",0
44,"44266",134,107,105,2,2,"UPyD",3
5,"5045",104,82,82,0,0,"UPyD",5
40,"40052",95,69,69,0,0,"UPyD",3
50,"50274",78,45,45,1,0,"UPyD",1
21,"21075",375,294,291,12,3,"UPyD",0
1,"1014",385,281,274,6,7,"UPyD",7
50,"50189",776,588,576,9,12,"UPyD",5
44,"44267",79,63,61,2,2,"UPyD",2
24,"24037",429,282,277,4,5,"UPyD",5
50,"50015",109,73,73,0,0,"UPyD",2
13,"13072",803,638,633,13,5,"UPyD",23
16,"16094",142,112,111,1,1,"UPyD",4
34,"34068",32,23,23,0,0,"UPyD",1
40,"40053",116,92,90,1,2,"UPyD",7
46,"46058",1787,1460,1441,10,19,"UPyD",39
42,"42174",188,142,138,5,4,"UPyD",6
9,"9298",90,74,74,1,0,"UPyD",4
38,"38024",14851,9589,9399,93,190,"UPyD",129
42,"42025",1305,964,945,15,19,"UPyD",15
31,"31229",46,38,37,0,1,"UPyD",1
50,"50101",922,648,637,8,11,"UPyD",13
27,"27001",2582,1687,1669,31,18,"UPyD",12
1,"1016",461,241,237,2,4,"UPyD",1
8,"8248",5239,3513,3443,71,70,"UPyD",31
49,"49163",235,167,167,0,0,"UPyD",7
41,"41053",20729,16178,15971,142,207,"UPyD",708
8,"8902",3600,2518,2496,57,22,"UPyD",33
16,"16236",964,762,758,10,4,"UPyD",25
8,"8065",1224,796,778,13,18,"UPyD",0
31,"31047",283,208,204,3,4,"UPyD",4
13,"13074",1000,886,878,15,8,"UPyD",7
49,"49029",675,553,542,6,11,"UPyD",13
14,"14065",1846,1509,1492,14,17,"UPyD",29
1,"1018",1395,952,943,7,9,"UPyD",6
28,"28079",2290453,1721837,1705310,17342,16527,"UPyD",166588
6,"6096",254,202,201,0,1,"UPyD",5
46,"46011",7727,5874,5777,75,97,"UPyD",183
10,"10192",910,679,670,3,9,"UPyD",13
5,"5047",4267,3345,3275,34,70,"UPyD",128
16,"16139",346,279,277,2,2,"UPyD",5
46,"46084",1587,1363,1332,7,31,"UPyD",44
8,"8250",7083,4485,4426,72,59,"UPyD",43
28,"28150",2985,2363,2345,21,18,"UPyD",202
41,"41055",15121,11082,10997,98,85,"UPyD",254
13,"13042",953,704,693,5,11,"UPyD",15
21,"21079",749,556,553,6,3,"UPyD",11
25,"25129",175,105,105,3,0,"UPyD",0
20,"20074",11660,8003,7951,31,52,"UPyD",23
7,"7051",4925,2993,2947,66,46,"UPyD",44
47,"47181",170,128,128,1,0,"UPyD",8
22,"22139",86,66,63,2,3,"UPyD",3
50,"50104",379,306,303,4,3,"UPyD",9
26,"26057",52,42,42,0,0,"UPyD",0
43,"43052",1001,669,636,12,33,"UPyD",4
18,"18030",612,457,456,0,1,"UPyD",7
39,"39006",1732,1381,1373,23,8,"UPyD",19
6,"6053",642,466,454,4,12,"UPyD",15
47,"47182",1371,991,982,12,9,"UPyD",29
17,"17148",1546,980,957,24,23,"UPyD",5
22,"22141",129,103,102,3,1,"UPyD",2
2,"2074",6093,4630,4548,57,82,"UPyD",121
42,"42178",144,105,104,3,1,"UPyD",2
28,"28036",2301,1809,1784,13,25,"UPyD",192
10,"10195",7917,6143,6054,36,89,"UPyD",179
37,"37302",337,230,229,5,1,"UPyD",12
41,"41030",527,436,429,6,7,"UPyD",17
21,"21051",272,202,201,5,1,"UPyD",2
45,"45116",682,576,565,0,11,"UPyD",24
43,"43053",190,149,149,2,0,"UPyD",0
8,"8252",24033,16704,16402,368,302,"UPyD",343
15,"15078",78092,56506,55597,1110,909,"UPyD",1071
27,"27008",1458,1130,1115,18,15,"UPyD",3
9,"9172",129,110,109,2,1,"UPyD",8
10,"10196",309,244,244,1,0,"UPyD",7
43,"43127",778,530,524,6,6,"UPyD",2
30,"30011",4687,3776,3726,20,50,"UPyD",143
37,"37072",184,157,155,5,2,"UPyD",4
18,"18001",288,212,212,1,0,"UPyD",3
17,"17057",1010,640,634,19,6,"UPyD",1
6,"6101",489,397,395,5,2,"UPyD",2
50,"50020",868,646,629,5,17,"UPyD",12
5,"5151",100,86,82,1,4,"UPyD",0
9,"9307",119,89,88,1,1,"UPyD",2
24,"24046",1002,704,696,20,8,"UPyD",13
22,"22004",146,97,97,2,0,"UPyD",4
45,"45007",747,641,632,1,9,"UPyD",17
1,"1023",290,236,235,1,1,"UPyD",1
5,"5152",737,618,609,5,9,"UPyD",77
37,"37305",206,153,152,4,1,"UPyD",12
37,"37191",127,86,85,1,1,"UPyD",2
32,"32064",561,439,437,5,2,"UPyD",3
38,"38031",28391,21797,21431,234,366,"UPyD",262
49,"49264",652,439,435,2,4,"UPyD",7
25,"25224",144,93,91,6,2,"UPyD",0
10,"10198",1213,1068,1054,12,14,"UPyD",9
18,"18002",625,505,504,2,1,"UPyD",2
50,"50021",42,34,33,1,1,"UPyD",0
43,"43129",4525,3032,2956,62,76,"UPyD",13
19,"19305",166,130,130,0,0,"UPyD",10
25,"25163",237,147,142,2,5,"UPyD",0
5,"5153",112,89,89,5,0,"UPyD",2
25,"25040",10654,6905,6768,144,137,"UPyD",43
12,"12028",12115,9084,8992,137,92,"UPyD",636
24,"24168",493,397,391,7,6,"UPyD",7
2,"2079",2936,2305,2235,29,70,"UPyD",68
34,"34215",166,146,145,1,1,"UPyD",4
10,"10078",451,349,341,3,8,"UPyD",10
27,"27012",1519,886,880,6,6,"UPyD",5
9,"9310",14,10,9,2,1,"UPyD",1
40,"40065",520,401,393,6,8,"UPyD",28
43,"43056",931,537,515,18,22,"UPyD",0
45,"45010",471,374,372,2,2,"UPyD",15
19,"19136",22,15,15,0,0,"UPyD",0
18,"18905",12975,9260,9209,155,51,"UPyD",708
46,"46162",1230,1045,1027,6,18,"UPyD",17
45,"45121",6553,4720,4653,43,67,"UPyD",317
50,"50198",46,36,36,2,0,"UPyD",3
18,"18168",864,613,605,4,8,"UPyD",21
10,"10201",202,173,171,3,2,"UPyD",1
18,"18101",8990,6659,6556,96,103,"UPyD",477
28,"28040",15089,9976,9852,116,124,"UPyD",950
19,"19208",55,41,41,1,0,"UPyD",0
25,"25042",211,131,127,0,4,"UPyD",0
22,"22151",97,71,71,0,0,"UPyD",4
47,"47025",127,103,103,0,0,"UPyD",0
8,"8257",116,84,81,0,3,"UPyD",0
45,"45011",316,271,268,1,3,"UPyD",6
31,"31238",125,99,98,3,1,"UPyD",4
37,"37195",48,32,32,0,0,"UPyD",0
31,"31056",183,123,122,4,1,"UPyD",2
27,"27015",4587,3465,3409,55,56,"UPyD",12
46,"46236",996,853,844,7,9,"UPyD",24
50,"50285",635,452,445,8,7,"UPyD",20
24,"24171",417,231,231,2,0,"UPyD",3
45,"45012",683,572,566,10,6,"UPyD",13
50,"50024",652,541,531,8,10,"UPyD",7
25,"25043",830,483,467,17,16,"UPyD",5
16,"16248",887,733,710,20,23,"UPyD",11
47,"47105",210,181,179,1,2,"UPyD",6
7,"7059",3011,2077,2012,22,65,"UPyD",44
46,"46237",7261,5405,5350,54,55,"UPyD",381
25,"25227",674,375,372,2,3,"UPyD",1
28,"28041",4006,3190,3154,45,36,"UPyD",371
22,"22156",256,209,203,5,6,"UPyD",15
46,"46091",126,108,108,0,0,"UPyD",1
6,"6109",4006,3435,3372,21,63,"UPyD",38
22,"22012",93,74,74,5,0,"UPyD",3
37,"37081",1000,807,800,5,7,"UPyD",13
16,"16249",2076,1728,1700,11,28,"UPyD",18
49,"49133",344,247,243,3,4,"UPyD",4
50,"50113",653,528,526,9,2,"UPyD",5
50,"50201",466,366,363,7,3,"UPyD",6
2,"2084",362,276,270,2,6,"UPyD",14
44,"44033",307,222,221,5,1,"UPyD",5
19,"19309",37,32,31,0,1,"UPyD",2
46,"46092",304,206,201,1,5,"UPyD",4
49,"49043",304,256,256,6,0,"UPyD",3
10,"10205",2081,1486,1457,19,29,"UPyD",16
37,"37082",869,663,650,3,13,"UPyD",21
42,"42193",17,10,10,0,0,"UPyD",0
43,"43060",3049,2030,1980,62,50,"UPyD",6
6,"6066",1798,1348,1340,7,8,"UPyD",11
17,"17186",3593,2358,2317,33,41,"UPyD",13
25,"25201",119,78,76,3,2,"UPyD",0
31,"31149",2381,1626,1607,7,19,"UPyD",2
37,"37313",581,440,435,7,5,"UPyD",3
37,"37199",157,115,113,0,2,"UPyD",6
16,"16110",98,81,81,3,0,"UPyD",2
22,"22160",219,166,166,5,0,"UPyD",9
28,"28157",605,452,446,2,6,"UPyD",22
39,"39066",895,710,703,6,7,"UPyD",10
13,"13087",22953,16674,16376,298,298,"UPyD",1078
8,"8261",2273,1547,1525,30,22,"UPyD",11
5,"5159",287,216,216,0,0,"UPyD",2
9,"9054",107,80,80,1,0,"UPyD",3
43,"43134",279,208,206,14,2,"UPyD",1
3,"3100",540,448,443,2,5,"UPyD",7
16,"16111",171,130,128,0,2,"UPyD",5
2,"2901",2223,1678,1667,19,11,"UPyD",50
22,"22162",135,107,107,3,0,"UPyD",5
42,"42001",308,242,237,4,5,"UPyD",5
41,"41065",23028,15133,14958,191,175,"UPyD",480
24,"24057",1459,1121,1092,16,29,"UPyD",21
40,"40029",50,43,42,0,1,"UPyD",2
40,"40215",109,94,91,0,3,"UPyD",3
13,"13088",649,531,526,3,5,"UPyD",5
46,"46094",20341,15367,15222,152,145,"UPyD",945
27,"27023",2770,2196,2178,30,18,"UPyD",7
48,"48017",13554,9303,9234,64,69,"UPyD",16
8,"8169",47505,31997,31566,555,431,"UPyD",572
50,"50028",120,86,85,2,1,"UPyD",3
50,"50029",676,527,517,6,10,"UPyD",14
46,"46167",411,312,309,0,3,"UPyD",5
8,"8262",6835,4086,3993,94,93,"UPyD",33
9,"9411",174,104,103,1,1,"UPyD",6
7,"7064",5286,3340,3279,53,61,"UPyD",85
19,"19111",180,147,146,0,1,"UPyD",5
9,"9183",58,47,46,1,1,"UPyD",1
12,"12038",195,135,134,8,1,"UPyD",0
16,"16255",159,123,122,3,1,"UPyD",2
43,"43062",298,227,223,7,4,"UPyD",0
19,"19215",206,170,166,0,4,"UPyD",3
16,"16115",60,45,45,0,0,"UPyD",0
42,"42048",78,63,62,3,1,"UPyD",2
24,"24059",956,592,585,9,7,"UPyD",8
10,"10089",1399,1043,1032,15,11,"UPyD",14
9,"9056",4957,3607,3557,70,50,"UPyD",240
19,"19216",143,112,105,2,7,"UPyD",6
25,"25140",785,472,460,5,12,"UPyD",4
50,"50030",232,164,160,1,4,"UPyD",1
46,"46169",31753,24041,23802,270,239,"UPyD",1762
15,"15089",4354,3255,3216,55,39,"UPyD",18
22,"22019",190,141,138,4,3,"UPyD",10
49,"49185",171,140,140,3,0,"UPyD",5
41,"41067",7055,5368,5295,64,73,"UPyD",201
32,"32077",1234,999,993,23,6,"UPyD",4
43,"43137",1873,1241,1212,27,29,"UPyD",3
47,"47032",161,130,129,3,1,"UPyD",4
8,"8172",19889,13537,13333,267,204,"UPyD",150
44,"44167",41,31,31,1,0,"UPyD",2
8,"8080",42,33,33,2,0,"UPyD",0
19,"19319",4203,3139,3104,28,35,"UPyD",310
24,"24061",1713,1223,1210,34,13,"UPyD",60
27,"27027",2111,1652,1605,21,47,"UPyD",9
43,"43064",2063,1420,1391,37,29,"UPyD",9
22,"22020",110,81,79,3,2,"UPyD",1
27,"27028",78862,57097,55890,1246,1207,"UPyD",883
50,"50207",126,97,95,1,2,"UPyD",3
45,"45132",1916,1487,1473,9,14,"UPyD",88
48,"48054",23712,16643,16439,215,204,"UPyD",345
16,"16263",936,730,719,8,11,"UPyD",29
9,"9326",156,119,114,2,5,"UPyD",11
9,"9059",137122,103909,102353,2008,1556,"UPyD",9756
26,"26078",85,69,69,0,0,"UPyD",3
1,"1044",242,174,173,1,1,"UPyD",2
10,"10093",413,339,332,2,7,"UPyD",5
22,"22170",622,439,430,13,9,"UPyD",17
47,"47059",108,77,76,1,1,"UPyD",2
31,"31156",268,202,201,5,1,"UPyD",9
27,"27029",1525,1243,1221,18,22,"UPyD",4
45,"45022",427,317,314,8,3,"UPyD",9
45,"45133",2803,2241,2199,18,42,"UPyD",76
22,"22022",582,448,438,12,10,"UPyD",14
3,"3106",642,542,535,3,7,"UPyD",7
21,"21005",15205,11006,10909,108,97,"UPyD",266
25,"25143",86,58,58,1,0,"UPyD",0
18,"18015",465,381,379,1,2,"UPyD",4
42,"42053",27,26,25,1,1,"UPyD",1
22,"22172",613,463,452,6,11,"UPyD",24
29,"29052",245,151,151,0,0,"UPyD",3
1,"1047",942,674,655,4,19,"UPyD",20
10,"10094",247,212,211,0,1,"UPyD",0
43,"43066",165,113,112,2,1,"UPyD",0
49,"49189",228,151,150,3,1,"UPyD",4
8,"8084",1134,789,760,14,29,"UPyD",2
12,"12043",620,499,487,2,12,"UPyD",22
22,"22173",247,150,150,3,0,"UPyD",7
41,"41070",5598,4101,4039,79,62,"UPyD",320
21,"21006",3565,2477,2441,29,36,"UPyD",21
37,"37208",92,59,58,0,1,"UPyD",0
36,"36040",2627,1938,1907,24,31,"UPyD",10
19,"19323",50,41,39,0,2,"UPyD",1
9,"9062",52,33,32,1,1,"UPyD",0
42,"42206",10,9,9,1,0,"UPyD",0
40,"40086",738,628,619,12,9,"UPyD",43
13,"13095",94,70,70,1,0,"UPyD",0
6,"6124",1750,1418,1378,17,40,"UPyD",20
46,"46245",478,357,354,1,3,"UPyD",13
37,"37324",415,338,334,2,4,"UPyD",11
27,"27033",723,536,529,10,7,"UPyD",1
37,"37286",231,166,160,2,6,"UPyD",4
39,"39073",9275,6984,6903,83,81,"UPyD",377
42,"42207",49,37,34,0,3,"UPyD",2
5,"5264",68,48,48,1,0,"UPyD",2
5,"5265",87,68,66,2,2,"UPyD",4
18,"18116",2972,2237,2213,19,24,"UPyD",98
45,"45026",269,200,198,2,2,"UPyD",6
24,"24066",561,440,437,5,3,"UPyD",11
50,"50210",39,28,24,0,4,"UPyD",0
46,"46173",1393,1156,1137,10,19,"UPyD",40
43,"43117",150,118,115,1,3,"UPyD",0
16,"16215",285,192,186,2,6,"UPyD",4
25,"25146",227,150,149,0,1,"UPyD",2
16,"16124",1909,1573,1555,14,18,"UPyD",9
39,"39074",6785,5287,5233,50,54,"UPyD",140
6,"6081",1114,870,865,10,5,"UPyD",19
13,"13097",2309,1843,1825,20,18,"UPyD",39
25,"25243",3408,2280,2252,49,28,"UPyD",37
29,"29055",1837,1478,1454,12,24,"UPyD",32
24,"24068",500,357,349,3,8,"UPyD",6
50,"50124",474,375,367,11,8,"UPyD",24
12,"12142",158,122,121,1,1,"UPyD",7
24,"24188",3830,2987,2928,51,59,"UPyD",130
44,"44047",267,162,160,4,2,"UPyD",1
46,"46101",868,720,716,8,4,"UPyD",18
10,"10901",1148,844,839,18,5,"UPyD",11
45,"45138",1185,998,973,5,25,"UPyD",18
12,"12046",236,177,176,4,1,"UPyD",9
22,"22029",130,99,98,6,1,"UPyD",4
12,"12901",3383,2664,2632,34,32,"UPyD",61
3,"3011",7341,5277,5218,72,59,"UPyD",236
31,"31070",2706,1949,1912,34,37,"UPyD",27
5,"5039",58,48,48,0,0,"UPyD",3
42,"42059",23,19,19,1,0,"UPyD",3
16,"16003",147,122,121,0,1,"UPyD",0
5,"5170",63,50,50,0,0,"UPyD",3
8,"8180",26210,17504,17214,366,290,"UPyD",345
49,"49197",187,126,126,3,0,"UPyD",1
44,"44177",120,85,85,1,0,"UPyD",1
40,"40092",132,100,100,0,0,"UPyD",6
4,"4073",389,289,286,4,3,"UPyD",2
42,"42060",33,22,22,0,0,"UPyD",1
1,"1056",256,183,181,1,2,"UPyD",0
32,"32086",2874,2026,2003,18,23,"UPyD",16
13,"13901",945,734,719,6,15,"UPyD",28
3,"3114",1620,1320,1305,10,15,"UPyD",24
36,"36045",24724,17794,17459,237,335,"UPyD",182
8,"8089",33316,22369,22107,437,262,"UPyD",448
33,"33065",1150,791,784,16,7,"UPyD",15
45,"45030",486,378,374,4,4,"UPyD",16
45,"45141",981,815,790,6,25,"UPyD",13
22,"22181",91,57,55,0,2,"UPyD",0
5,"5171",84,74,73,0,1,"UPyD",3
9,"9200",54,35,35,2,0,"UPyD",0
23,"23009",12876,10335,10231,109,104,"UPyD",369
3,"3013",1144,941,926,5,15,"UPyD",28
48,"48063",355,287,287,6,0,"UPyD",0
16,"16129",112,79,74,0,5,"UPyD",1
5,"5902",319,262,262,0,0,"UPyD",11
13,"13001",1372,1087,1067,8,20,"UPyD",11
5,"5172",147,122,122,0,0,"UPyD",4
27,"27042",1888,1427,1407,12,20,"UPyD",3
37,"37331",234,161,161,3,0,"UPyD",1
34,"34103",105,92,92,5,0,"UPyD",3
44,"44051",2783,2144,2089,38,55,"UPyD",53
22,"22184",203,172,167,2,5,"UPyD",9
37,"37104",32,24,23,0,1,"UPyD",0
8,"8275",242,188,186,4,2,"UPyD",1
24,"24074",107,87,87,0,0,"UPyD",1
5,"5076",477,397,385,4,12,"UPyD",38
45,"45033",407,302,295,3,7,"UPyD",3
12,"12051",520,382,376,1,6,"UPyD",1
26,"26092",112,89,88,2,1,"UPyD",2
27,"27043",1422,988,962,10,26,"UPyD",4
10,"10104",5233,3904,3824,30,80,"UPyD",110
11,"11003",1290,952,940,8,12,"UPyD",20
24,"24194",327,237,236,5,1,"UPyD",6
8,"8010",4124,2674,2611,44,63,"UPyD",23
40,"40097",114,96,94,2,2,"UPyD",2
16,"16132",36,31,31,0,0,"UPyD",0
37,"37333",247,160,154,2,6,"UPyD",2
24,"24196",2183,1573,1543,11,30,"UPyD",31
24,"24076",1210,917,907,26,10,"UPyD",37
32,"32090",834,662,657,4,5,"UPyD",1
46,"46033",220,183,181,0,2,"UPyD",4
5,"5142",113,97,96,0,1,"UPyD",2
17,"17050",645,438,425,15,13,"UPyD",1
50,"50188",34,28,27,0,1,"UPyD",0
29,"29061",1045,861,855,7,6,"UPyD",47
24,"24197",784,570,564,7,6,"UPyD",23
16,"16133",4466,3522,3453,51,69,"UPyD",97
47,"47124",435,364,358,5,6,"UPyD",8
14,"14002",10991,8444,8358,106,86,"UPyD",198
21,"21014",4063,3424,3408,27,16,"UPyD",84
37,"37107",11407,8234,8116,123,118,"UPyD",441
45,"45035",307,236,236,3,0,"UPyD",8
25,"25061",75,45,45,0,0,"UPyD",0
8,"8012",1694,1155,1136,32,19,"UPyD",0
40,"40906",1793,1428,1405,32,23,"UPyD",145
21,"21015",728,453,447,6,6,"UPyD",17
5,"5176",237,193,190,4,3,"UPyD",29
19,"19334",50,37,37,0,0,"UPyD",0
3,"3119",15887,12128,11988,122,140,"UPyD",884
11,"11005",4617,3287,3214,26,73,"UPyD",78
50,"50043",258,170,166,2,4,"UPyD",5
22,"22041",175,138,138,1,0,"UPyD",1
6,"6002",4321,3272,3195,32,77,"UPyD",63
47,"47126",49,43,42,1,1,"UPyD",0
8,"8013",1234,834,820,23,14,"UPyD",8
37,"37109",191,142,141,1,1,"UPyD",0
8,"8187",149633,104021,102629,1794,1392,"UPyD",1199
33,"33001",1772,984,971,14,13,"UPyD",14
3,"3120",2329,1810,1785,16,25,"UPyD",59
9,"9345",134,102,102,1,0,"UPyD",4
22,"22189",199,140,138,5,2,"UPyD",4
37,"37223",127,102,101,1,1,"UPyD",1
50,"50219",3704,2672,2625,39,47,"UPyD",207
37,"37110",112,89,88,1,1,"UPyD",5
44,"44059",571,446,434,10,12,"UPyD",15
19,"19127",97,66,66,1,0,"UPyD",1
31,"31168",247,165,163,0,2,"UPyD",4
40,"40104",261,179,178,1,1,"UPyD",6
21,"21017",3581,2416,2389,27,27,"UPyD",49
9,"9075",126,102,101,1,1,"UPyD",3
45,"45038",3125,2401,2374,33,27,"UPyD",168
17,"17175",569,375,369,6,6,"UPyD",0
5,"5178",392,310,304,2,6,"UPyD",3
25,"25063",97,65,64,2,1,"UPyD",0
16,"16902",165,128,126,1,2,"UPyD",4
27,"27050",3236,2475,2438,11,37,"UPyD",14
3,"3020",108,87,86,1,1,"UPyD",5
6,"6095",9330,6974,6873,129,101,"UPyD",150
28,"28171",4148,2972,2929,21,43,"UPyD",186
10,"10111",1453,1052,1046,13,6,"UPyD",50
27,"27051",8224,6048,5953,108,95,"UPyD",91
37,"37225",119,101,95,3,6,"UPyD",6
23,"23063",3960,3073,3037,21,36,"UPyD",23
33,"33002",10837,7667,7588,77,79,"UPyD",104
46,"46036",675,440,431,11,9,"UPyD",16
10,"10112",1582,1299,1284,5,15,"UPyD",10
16,"16014",659,534,528,8,6,"UPyD",12
6,"6143",3308,2625,2595,24,30,"UPyD",51
5,"5179",231,206,204,2,2,"UPyD",4
37,"37339",345,280,279,3,1,"UPyD",4
33,"33071",671,528,523,4,5,"UPyD",7
24,"24082",877,698,690,13,8,"UPyD",18
16,"16140",34,27,27,0,0,"UPyD",0
31,"31079",99,64,63,0,1,"UPyD",1
1,"1020",317,222,220,0,2,"UPyD",1
19,"19018",189,145,138,2,7,"UPyD",2
28,"28057",1419,1084,1074,12,10,"UPyD",120
22,"22197",504,395,390,7,5,"UPyD",6
43,"43151",119,91,89,0,2,"UPyD",0
16,"16141",161,132,131,1,1,"UPyD",0
9,"9077",38,26,25,0,1,"UPyD",0
12,"12059",276,227,227,1,0,"UPyD",2
29,"29066",363,263,260,1,3,"UPyD",9
22,"22199",7259,4980,4861,128,119,"UPyD",201
42,"42031",31,19,19,0,0,"UPyD",0
41,"41082",3448,2827,2796,15,31,"UPyD",62
20,"20003",547,361,359,3,2,"UPyD",1
25,"25254",782,533,531,9,2,"UPyD",1
48,"48072",1009,796,787,3,9,"UPyD",2
42,"42078",1110,829,817,15,12,"UPyD",34
19,"19019",23,18,18,0,0,"UPyD",2
16,"16016",258,178,178,1,0,"UPyD",5
24,"24084",182,133,132,1,1,"UPyD",6
19,"19235",121,92,87,0,5,"UPyD",1
47,"47048",204,168,167,2,1,"UPyD",5
41,"41005",8792,6642,6585,71,57,"UPyD",265
45,"45042",184,154,151,3,3,"UPyD",7
5,"5181",39,26,26,0,0,"UPyD",1
9,"9217",389,273,270,8,3,"UPyD",10
22,"22200",271,198,191,3,7,"UPyD",6
42,"42080",168,115,114,0,1,"UPyD",3
27,"27056",1388,1043,1026,16,17,"UPyD",4
2,"2004",654,554,544,7,10,"UPyD",14
12,"12061",431,324,316,6,8,"UPyD",8
45,"45043",827,679,670,3,9,"UPyD",18
46,"46112",582,475,463,4,12,"UPyD",14
6,"6148",991,826,818,9,8,"UPyD",5
19,"19021",1129,818,800,10,18,"UPyD",44
13,"13013",7141,5682,5564,60,118,"UPyD",240
3,"3025",1252,1054,1044,4,10,"UPyD",32
20,"20005",1341,890,885,4,5,"UPyD",3
46,"46039",2200,1849,1820,12,29,"UPyD",78
17,"17180",8076,4868,4767,81,101,"UPyD",34
19,"19238",42,32,31,1,1,"UPyD",0
27,"27058",3908,2946,2915,28,31,"UPyD",13
39,"39087",43561,33709,33242,404,467,"UPyD",870
42,"42132",159,132,127,4,5,"UPyD",0
25,"25901",315,196,189,3,7,"UPyD",0
40,"40112",2346,1848,1798,35,50,"UPyD",166
35,"35002",21673,14480,14253,172,227,"UPyD",331
26,"26106",78,70,69,0,1,"UPyD",2
45,"45046",2455,1884,1862,11,22,"UPyD",24
37,"37344",259,212,211,5,1,"UPyD",3
50,"50298",5319,4023,3955,72,68,"UPyD",215
40,"40113",438,330,322,4,8,"UPyD",24
19,"19022",673,501,496,4,5,"UPyD",19
44,"44067",132,89,89,0,0,"UPyD",2
24,"24089",106265,77385,76124,1666,1261,"UPyD",5031
6,"6150",860,722,710,2,12,"UPyD",16
16,"16020",20,15,15,0,0,"UPyD",0
31,"31114",384,320,318,37,2,"UPyD",8
50,"50283",73,55,55,1,0,"UPyD",2
5,"5087",144,87,87,0,0,"UPyD",17
41,"41086",15877,10246,10150,146,96,"UPyD",527
25,"25902",581,411,395,15,16,"UPyD",2
25,"25903",261,176,170,9,6,"UPyD",0
42,"42084",27,21,21,0,0,"UPyD",0
41,"41008",1073,884,875,0,9,"UPyD",15
50,"50052",100,82,82,0,0,"UPyD",0
22,"22052",997,776,769,15,7,"UPyD",21
9,"9906",1199,912,903,12,9,"UPyD",67
3,"3130",43,30,29,0,1,"UPyD",0
46,"46042",3376,2873,2819,17,54,"UPyD",41
28,"28061",19624,15082,14905,162,177,"UPyD",1732
33,"33076",12662,8733,8670,120,63,"UPyD",249
45,"45048",388,310,308,2,2,"UPyD",12
3,"3131",181,161,157,1,4,"UPyD",5
6,"6153",20332,15398,15216,239,182,"UPyD",468
27,"27062",681,535,532,7,3,"UPyD",0
50,"50053",756,570,563,14,7,"UPyD",11
13,"13017",307,230,226,0,4,"UPyD",8
18,"18137",1057,875,868,8,7,"UPyD",13
43,"43009",1421,913,897,18,16,"UPyD",2
48,"48078",39866,27311,26995,311,316,"UPyD",509
9,"9358",261,200,199,3,1,"UPyD",9
43,"43010",302,227,223,7,4,"UPyD",0
17,"17092",3520,2273,2228,42,45,"UPyD",13
43,"43157",388,282,270,10,12,"UPyD",1
37,"37348",114,91,90,1,1,"UPyD",2
24,"24092",883,707,702,6,5,"UPyD",10
10,"10123",601,502,492,0,10,"UPyD",3
9,"9224",172,125,125,3,0,"UPyD",3
19,"19031",18,11,11,0,0,"UPyD",0
28,"28111",618,486,479,2,7,"UPyD",28
37,"37237",330,250,242,1,8,"UPyD",5
10,"10001",270,231,229,2,2,"UPyD",4
28,"28063",268,209,203,4,6,"UPyD",16
21,"21027",67,52,52,0,0,"UPyD",0
6,"6156",1190,989,978,9,11,"UPyD",10
45,"45051",1658,1305,1293,20,12,"UPyD",28
2,"2011",730,612,610,3,2,"UPyD",3
47,"47137",27,22,22,2,0,"UPyD",1
10,"10125",925,705,689,3,16,"UPyD",5
14,"14015",2198,1776,1755,16,21,"UPyD",23
45,"45161",11339,7989,7869,95,120,"UPyD",774
41,"41011",15274,11359,11207,145,152,"UPyD",251
41,"41037",3228,2510,2483,27,27,"UPyD",39
44,"44160",473,315,312,8,3,"UPyD",12
10,"10002",396,317,314,5,3,"UPyD",5
40,"40122",551,417,414,9,3,"UPyD",40
44,"44201",526,449,443,9,6,"UPyD",9
45,"45052",2793,2247,2212,38,35,"UPyD",161
6,"6021",971,761,747,6,14,"UPyD",11
5,"5189",478,361,360,3,1,"UPyD",9
45,"45162",773,599,594,3,5,"UPyD",9
40,"40123",168,130,126,3,4,"UPyD",9
23,"23079",3750,3084,3063,19,21,"UPyD",22
43,"43012",3392,2346,2295,48,51,"UPyD",23
47,"47218",983,776,767,7,9,"UPyD",22
6,"6158",13094,9945,9753,131,192,"UPyD",522
49,"49095",318,232,232,5,0,"UPyD",9
41,"41090",3488,2792,2751,22,41,"UPyD",54
17,"17006",1203,759,754,17,5,"UPyD",3
18,"18039",3733,2901,2878,18,23,"UPyD",70
19,"19034",23,23,23,1,0,"UPyD",0
46,"46118",3883,3141,3105,28,36,"UPyD",110
47,"47219",46,36,36,1,0,"UPyD",2
12,"12071",1355,1069,1050,3,19,"UPyD",34
12,"12072",1191,1007,977,17,30,"UPyD",11
49,"49096",188,149,146,2,3,"UPyD",3
17,"17215",1918,1350,1321,40,29,"UPyD",7
50,"50057",1468,1022,1004,17,18,"UPyD",21
28,"28180",5179,4033,3975,18,58,"UPyD",245
40,"40125",99,72,71,3,1,"UPyD",2
16,"16155",549,430,426,2,4,"UPyD",7
10,"10005",551,439,424,4,15,"UPyD",6
47,"47139",1080,845,833,11,12,"UPyD",22
45,"45128",2558,1831,1806,20,25,"UPyD",82
47,"47220",194,143,142,4,1,"UPyD",6
37,"37005",92,65,65,0,0,"UPyD",2
44,"44082",90,67,66,1,1,"UPyD",3
17,"17188",167,124,122,9,2,"UPyD",0
37,"37006",157,108,107,0,1,"UPyD",3
20,"20016",1526,937,932,4,5,"UPyD",4
21,"21031",1309,903,871,9,32,"UPyD",9
35,"35009",19678,13799,13442,155,357,"UPyD",241
49,"49098",242,177,175,4,2,"UPyD",2
16,"16157",229,187,182,2,5,"UPyD",0
9,"9366",99,67,65,1,2,"UPyD",1
11,"11020",163674,106898,106082,1655,816,"UPyD",6138
6,"6162",2964,2415,2390,19,25,"UPyD",51
47,"47057",237,198,198,3,0,"UPyD",14
48,"48085",9893,6960,6885,93,75,"UPyD",82
34,"34006",82,72,72,1,0,"UPyD",4
9,"9098",553,416,410,11,6,"UPyD",15
42,"42095",1575,1136,1106,40,30,"UPyD",71
24,"24222",13915,9939,9751,304,188,"UPyD",758
5,"5096",74,56,56,0,0,"UPyD",1
40,"40127",45,33,33,0,0,"UPyD",1
40,"40128",144,116,116,5,0,"UPyD",7
9,"9230",41,33,33,0,0,"UPyD",2
14,"14020",415,323,319,3,4,"UPyD",5
32,"32004",2071,1145,1142,7,3,"UPyD",4
6,"6902",1688,1325,1313,21,12,"UPyD",19
6,"6027",732,655,645,8,10,"UPyD",18
31,"31184",66,60,59,0,1,"UPyD",0
11,"11021",6838,5102,5049,67,53,"UPyD",134
47,"47222",92,77,77,4,0,"UPyD",2
19,"19038",48,33,33,0,0,"UPyD",0
48,"48086",2087,1432,1420,11,12,"UPyD",13
34,"34009",34,31,31,3,0,"UPyD",0
37,"37245",357,273,272,2,1,"UPyD",0
23,"23087",11474,9197,9123,90,74,"UPyD",265
14,"14021",259993,183200,181402,2936,1798,"UPyD",9823
17,"17191",153,116,114,0,2,"UPyD",0
40,"40130",139,106,106,4,0,"UPyD",1
48,"48087",463,371,370,4,1,"UPyD",0
44,"44209",892,666,649,6,17,"UPyD",11
49,"49101",186,134,129,0,5,"UPyD",6
5,"5034",17,13,13,0,0,"UPyD",1
34,"34010",560,458,451,7,7,"UPyD",17
5,"5228",193,146,145,1,1,"UPyD",2
42,"42098",14,8,8,0,0,"UPyD",1
22,"22066",699,479,464,8,15,"UPyD",23
6,"6030",171,132,131,0,1,"UPyD",1
44,"44087",98,87,87,2,0,"UPyD",0
17,"17011",625,472,467,5,5,"UPyD",1
39,"39097",732,476,470,4,6,"UPyD",3
9,"9235",179,148,142,1,6,"UPyD",9
16,"16160",76,54,53,1,1,"UPyD",0
17,"17100",201,140,135,1,5,"UPyD",0
8,"8206",717,557,547,7,10,"UPyD",1
22,"22221",108,70,69,5,1,"UPyD",6
9,"9103",247,201,200,2,1,"UPyD",5
46,"46196",159,145,144,1,1,"UPyD",2
34,"34135",429,334,329,6,5,"UPyD",11
8,"8298",25338,16982,16690,353,292,"UPyD",65
44,"44089",57,50,49,0,1,"UPyD",1
12,"12077",4683,3476,3414,41,62,"UPyD",108
3,"3040",260,224,220,0,4,"UPyD",5
7,"7003",10671,6262,6149,79,113,"UPyD",244
28,"28005",132097,100509,99506,1069,1003,"UPyD",11650
29,"29070",35228,23374,23146,258,228,"UPyD",1468
50,"50238",114,82,80,0,2,"UPyD",3
42,"42105",54,45,45,0,0,"UPyD",0
5,"5197",114,98,98,1,0,"UPyD",7
8,"8023",6546,4261,4194,86,67,"UPyD",54
14,"14024",1926,1557,1527,14,30,"UPyD",38
47,"47062",185,153,153,5,0,"UPyD",3
45,"45063",504,378,372,3,6,"UPyD",5
39,"39021",536,448,444,1,4,"UPyD",2
22,"22223",92,65,64,3,1,"UPyD",0
16,"16269",494,412,407,5,5,"UPyD",5
11,"11025",4371,3260,3226,34,34,"UPyD",80
18,"18047",5603,3833,3805,67,28,"UPyD",302
2,"2023",636,534,533,6,1,"UPyD",11
17,"17102",571,354,350,7,4,"UPyD",1
9,"9238",1026,612,601,6,11,"UPyD",22
19,"19254",57,50,50,0,0,"UPyD",0
37,"37362",4333,3276,3238,65,38,"UPyD",312
45,"45064",3801,2987,2953,38,34,"UPyD",162
48,"48091",1170,860,851,3,9,"UPyD",1
10,"10138",551,451,443,7,8,"UPyD",11
12,"12045",388,301,286,2,15,"UPyD",2
28,"28006",74554,57439,56890,586,549,"UPyD",6475
19,"19043",92,82,82,1,0,"UPyD",1
25,"25177",379,240,236,2,4,"UPyD",2
50,"50296",417,313,310,6,3,"UPyD",12
8,"8210",4176,2661,2579,54,82,"UPyD",13
50,"50240",1127,799,783,25,16,"UPyD",24
10,"10139",117,98,97,1,1,"UPyD",0
5,"5104",35,29,29,0,0,"UPyD",0
37,"37015",248,169,168,0,1,"UPyD",2
44,"44093",86,64,64,3,0,"UPyD",0
31,"31190",48,34,34,1,0,"UPyD",2
43,"43020",2119,1463,1427,26,36,"UPyD",31
46,"46252",142,108,107,1,1,"UPyD",6
14,"14027",7948,5944,5871,92,73,"UPyD",191
40,"40139",302,243,238,5,5,"UPyD",8
47,"47227",62,52,52,1,0,"UPyD",3
9,"9380",85,71,71,1,0,"UPyD",4
13,"13032",1218,926,922,9,4,"UPyD",11
19,"19256",48,44,43,0,1,"UPyD",0
28,"28050",3576,2706,2663,21,43,"UPyD",284
17,"17105",257,152,146,4,6,"UPyD",0
8,"8118",17077,11817,11598,203,219,"UPyD",111
20,"20027",2809,1929,1918,25,11,"UPyD",6
23,"23096",2678,2298,2276,18,22,"UPyD",30
8,"8302",9271,5981,5892,82,89,"UPyD",59
42,"42111",310,228,222,2,6,"UPyD",6
14,"14028",333,279,277,1,2,"UPyD",8
47,"47148",475,389,384,2,5,"UPyD",14
26,"26005",2251,1602,1580,18,22,"UPyD",63
28,"28072",5232,4065,4007,35,58,"UPyD",464
4,"4003",17244,11933,11840,94,93,"UPyD",280
16,"16169",75,44,44,0,0,"UPyD",3
9,"9243",87,66,64,2,2,"UPyD",6
50,"50067",14124,10049,9870,203,179,"UPyD",480
20,"20028",2204,1400,1379,11,21,"UPyD",9
17,"17198",404,264,259,9,5,"UPyD",1
48,"48095",2367,1593,1577,20,16,"UPyD",17
22,"22229",127,93,89,4,4,"UPyD",2
10,"10183",1022,818,805,5,13,"UPyD",11
46,"46254",1085,847,834,12,13,"UPyD",21
16,"16170",733,552,543,3,9,"UPyD",15
29,"29075",12666,8284,8218,62,66,"UPyD",277
34,"34022",1136,926,908,5,18,"UPyD",17
42,"42115",72,48,48,0,0,"UPyD",4
37,"37367",218,182,176,0,6,"UPyD",3
26,"26007",551,434,422,3,12,"UPyD",13
8,"8304",822,587,578,16,9,"UPyD",3
45,"45069",1791,1409,1389,8,20,"UPyD",29
49,"49113",188,166,161,2,5,"UPyD",3
10,"10144",999,782,773,7,9,"UPyD",16
15,"15042",3249,2341,2303,25,38,"UPyD",7
44,"44220",137,97,96,1,1,"UPyD",3
50,"50244",215,155,155,6,0,"UPyD",7
46,"46128",1649,1322,1292,14,30,"UPyD",43
8,"8305",26208,17810,17506,296,304,"UPyD",136
5,"5205",78,59,58,0,1,"UPyD",7
15,"15043",5491,4033,3971,45,62,"UPyD",8
25,"25002",481,306,302,6,4,"UPyD",0
17,"17109",759,428,414,10,14,"UPyD",1
2,"2030",3180,2499,2456,13,43,"UPyD",71
5,"5206",29,23,21,2,2,"UPyD",1
8,"8306",509,330,324,6,6,"UPyD",4
45,"45181",2276,1788,1764,10,24,"UPyD",42
14,"14031",634,516,514,1,2,"UPyD",4
19,"19260",44,41,41,1,0,"UPyD",2
42,"42118",26,20,20,0,0,"UPyD",0
47,"47231",4272,3268,3243,64,25,"UPyD",314
49,"49115",191,151,149,3,2,"UPyD",1
48,"48901",4370,3156,3124,46,32,"UPyD",32
28,"28010",9309,7304,7229,71,75,"UPyD",920
46,"46256",6734,4902,4858,33,44,"UPyD",218
4,"4007",791,599,599,5,0,"UPyD",12
46,"46257",5579,4546,4512,32,34,"UPyD",118
39,"39027",3213,2506,2473,21,33,"UPyD",70
28,"28011",437,318,315,2,3,"UPyD",16
7,"7013",6525,4528,4409,78,119,"UPyD",85
9,"9248",63,52,52,0,0,"UPyD",6
29,"29079",2500,2016,2000,23,16,"UPyD",41
6,"6045",513,418,412,8,6,"UPyD",10
16,"16048",432,339,337,8,2,"UPyD",10
25,"25004",553,405,400,13,5,"UPyD",0
9,"9388",32,25,24,2,1,"UPyD",4
46,"46203",3669,3002,2964,36,38,"UPyD",68
48,"48902",19232,12809,12633,182,176,"UPyD",163
31,"31105",1619,1306,1284,30,22,"UPyD",9
45,"45073",351,265,261,3,4,"UPyD",2
39,"39028",3513,2760,2718,23,42,"UPyD",114
50,"50247",794,572,567,7,5,"UPyD",38
43,"43099",330,240,236,4,4,"UPyD",0
26,"26140",268,213,207,2,6,"UPyD",5
17,"17202",3799,2398,2366,44,32,"UPyD",19
40,"40149",563,446,434,9,12,"UPyD",21
9,"9389",77,66,66,0,0,"UPyD",5
8,"8033",12476,8513,8378,180,135,"UPyD",71
16,"16050",298,245,238,0,7,"UPyD",4
2,"2034",1419,1153,1146,18,7,"UPyD",24
29,"29081",290,226,226,3,0,"UPyD",9
19,"19051",94,83,83,1,0,"UPyD",0
46,"46132",2124,1845,1817,14,28,"UPyD",74
8,"8125",24559,16065,15798,293,267,"UPyD",249
14,"14034",367,301,292,1,9,"UPyD",3
46,"46059",1310,1076,1058,2,18,"UPyD",32
33,"33024",229816,164603,163179,2100,1424,"UPyD",8323
40,"40150",76,62,62,1,0,"UPyD",3
26,"26142",804,661,648,1,13,"UPyD",20
31,"31016",7377,5149,5072,101,77,"UPyD",88
50,"50248",552,421,407,5,14,"UPyD",25
16,"16177",86,68,68,0,0,"UPyD",0
25,"25006",362,231,228,2,3,"UPyD",0
47,"47071",406,333,329,6,4,"UPyD",27
50,"50073",2265,1773,1756,20,17,"UPyD",43
22,"22085",119,97,94,0,3,"UPyD",1
40,"40009",49,41,41,0,0,"UPyD",0
41,"41028",1880,1479,1458,28,21,"UPyD",133
11,"11035",13266,8794,8668,115,126,"UPyD",271
17,"17204",539,349,347,10,2,"UPyD",2
45,"45186",3217,2573,2527,24,46,"UPyD",44
24,"24081",143,111,110,1,1,"UPyD",3
5,"5147",174,141,135,4,6,"UPyD",9
40,"40198",30,21,20,0,1,"UPyD",0
8,"8903",217,178,176,10,2,"UPyD",0
29,"29009",1525,1126,1109,9,17,"UPyD",24
22,"22243",45,27,27,1,0,"UPyD",0
37,"37375",764,636,627,19,9,"UPyD",19
34,"34157",2471,1936,1912,26,24,"UPyD",53
18,"18061",1109,882,869,1,13,"UPyD",9
45,"45077",554,430,423,7,7,"UPyD",11
19,"19054",184,156,151,2,5,"UPyD",3
17,"17205",198,146,138,3,8,"UPyD",0
44,"44228",121,97,96,2,1,"UPyD",4
28,"28014",31360,23434,23133,203,301,"UPyD",2371
40,"40152",750,615,595,4,20,"UPyD",66
32,"32024",5054,3668,3609,40,59,"UPyD",25
49,"49259",121,88,87,1,1,"UPyD",2
33,"33072",1737,1171,1159,11,12,"UPyD",15
18,"18163",327,246,238,0,8,"UPyD",5
19,"19169",51,35,35,0,0,"UPyD",0
24,"24121",645,511,502,10,9,"UPyD",12
2,"2038",296,254,254,1,0,"UPyD",5
26,"26018",10396,8186,8041,161,145,"UPyD",403
4,"4013",137455,94867,94142,1203,725,"UPyD",4890
50,"50251",8379,6225,6116,110,109,"UPyD",219
14,"14038",31501,23683,23394,336,289,"UPyD",968
5,"5015",100,78,78,0,0,"UPyD",0
23,"23065",1701,1238,1226,10,12,"UPyD",12
10,"10032",1768,1438,1415,9,23,"UPyD",19
8,"8222",1827,1343,1317,21,26,"UPyD",9
19,"19267",22,15,15,0,0,"UPyD",1
10,"10155",1156,829,819,4,10,"UPyD",7
49,"49261",1579,1161,1145,36,16,"UPyD",35
47,"47157",544,462,458,9,4,"UPyD",17
40,"40015",33,30,30,1,0,"UPyD",1
45,"45080",3,3,3,0,0,"UPyD",0
22,"22089",329,246,237,8,9,"UPyD",5
14,"14039",2705,2204,2189,12,15,"UPyD",40
37,"37154",156,130,125,1,5,"UPyD",3
32,"32026",2775,2096,2064,37,32,"UPyD",14
41,"41098",4650,3665,3603,43,62,"UPyD",165
40,"40157",74,51,50,2,1,"UPyD",5
4,"4015",149,115,115,0,0,"UPyD",2
49,"49126",232,175,173,3,2,"UPyD",3
13,"13045",744,615,608,6,7,"UPyD",16
8,"8039",365,264,260,5,4,"UPyD",0
5,"5118",91,66,66,0,0,"UPyD",0
43,"43030",454,321,307,5,14,"UPyD",6
24,"24007",798,582,566,2,16,"UPyD",10
34,"34161",23,20,20,0,0,"UPyD",0
45,"45081",16099,12232,12079,154,153,"UPyD",953
5,"5215",186,138,136,1,2,"UPyD",2
4,"4016",2184,1699,1677,15,22,"UPyD",36
34,"34036",211,159,157,0,2,"UPyD",6
50,"50253",461,381,375,3,6,"UPyD",7
25,"25011",5241,3127,3080,48,47,"UPyD",21
50,"50168",34,26,26,1,0,"UPyD",0
16,"16190",5151,4229,4144,52,85,"UPyD",127
40,"40159",150,111,110,0,1,"UPyD",2
49,"49036",592,410,403,5,7,"UPyD",8
47,"47077",291,232,232,1,0,"UPyD",3
33,"33029",420,243,241,3,2,"UPyD",5
29,"29087",409,306,305,3,1,"UPyD",5
9,"9006",68,40,39,1,1,"UPyD",0
5,"5018",27,24,24,0,0,"UPyD",2
37,"37033",86,64,63,1,1,"UPyD",7
3,"3059",20261,15951,15825,82,126,"UPyD",432
17,"17120",779,501,485,9,16,"UPyD",1
5,"5216",237,195,192,0,3,"UPyD",3
42,"42134",2626,1945,1896,36,49,"UPyD",43
31,"31205",465,335,325,9,10,"UPyD",0
8,"8041",10032,6880,6761,112,119,"UPyD",118
47,"47159",862,704,695,20,9,"UPyD",27
40,"40206",179,136,134,0,2,"UPyD",10
31,"31084",1949,1369,1361,11,8,"UPyD",7
31,"31206",2079,1517,1475,33,42,"UPyD",32
10,"10200",499,368,368,0,0,"UPyD",2
50,"50255",219,150,148,1,2,"UPyD",2
34,"34038",284,228,225,9,3,"UPyD",11
46,"46065",1606,1250,1234,15,16,"UPyD",46
9,"9262",158,139,137,7,2,"UPyD",6
26,"26025",78,69,69,1,0,"UPyD",2
47,"47078",178,159,154,7,5,"UPyD",5
46,"46211",1716,1459,1447,9,12,"UPyD",45
14,"14042",18991,14726,14495,290,231,"UPyD",676
49,"49267",101,77,77,1,0,"UPyD",1
22,"22251",391,288,278,4,10,"UPyD",9
50,"50081",562,410,400,7,10,"UPyD",4
40,"40162",420,320,314,1,6,"UPyD",18
13,"13050",533,427,421,3,6,"UPyD",13
22,"22099",532,411,408,6,3,"UPyD",14
13,"13049",838,654,648,0,6,"UPyD",20
28,"28019",1195,901,888,5,13,"UPyD",47
37,"37271",393,324,318,5,6,"UPyD",8
15,"15083",1198,874,855,8,19,"UPyD",1
44,"44237",450,352,343,5,9,"UPyD",8
15,"15055",4780,3247,3181,70,66,"UPyD",29
6,"6062",638,493,492,3,1,"UPyD",13
37,"37036",74,54,52,0,2,"UPyD",0
25,"25014",264,170,164,11,6,"UPyD",0
46,"46140",379,314,313,0,1,"UPyD",15
26,"26027",169,126,126,1,0,"UPyD",2
42,"42141",124,90,87,1,3,"UPyD",4
16,"16195",545,436,433,6,3,"UPyD",9
24,"24012",291,196,194,2,2,"UPyD",7
44,"44118",183,129,127,2,2,"UPyD",2
44,"44238",2475,1718,1692,50,26,"UPyD",26
48,"48013",81335,54452,53803,771,649,"UPyD",1222
44,"44239",29,25,25,1,0,"UPyD",1
40,"40165",95,72,71,1,1,"UPyD",2
4,"4022",375,296,295,0,1,"UPyD",10
10,"10164",770,557,547,2,10,"UPyD",12
44,"44119",119,84,84,2,0,"UPyD",0
9,"9134",237,164,159,7,5,"UPyD",4
25,"25105",146,90,89,1,1,"UPyD",0
19,"19277",22,17,17,0,0,"UPyD",0
31,"31027",824,611,609,2,2,"UPyD",0
26,"26157",306,268,263,1,5,"UPyD",9
31,"31209",155,105,104,1,1,"UPyD",1
24,"24015",2391,1812,1782,20,30,"UPyD",46
9,"9135",41,29,29,1,0,"UPyD",2
25,"25109",279,183,183,2,0,"UPyD",0
34,"34171",1071,762,753,16,9,"UPyD",45
17,"17004",504,340,337,6,3,"UPyD",1
19,"19143",1610,1287,1268,9,19,"UPyD",82
8,"8046",12603,8826,8663,190,163,"UPyD",83
44,"44240",168,135,132,2,3,"UPyD",6
40,"40168",36,27,27,0,0,"UPyD",2
42,"42145",140,111,111,2,0,"UPyD",3
29,"29092",596,457,454,10,3,"UPyD",6
46,"46069",166,149,148,1,1,"UPyD",6
5,"5025",108,86,86,2,0,"UPyD",2
50,"50084",84,64,64,1,0,"UPyD",0
18,"18174",470,368,363,1,5,"UPyD",2
46,"46142",870,682,673,7,9,"UPyD",36
26,"26030",12,12,12,0,0,"UPyD",0
49,"49004",137,105,105,3,0,"UPyD",2
40,"40170",1383,1091,1072,11,19,"UPyD",73
38,"38006",35862,18726,18500,209,226,"UPyD",321
21,"21060",11685,8026,7932,135,94,"UPyD",293
9,"9410",3181,2079,2049,48,30,"UPyD",68
26,"26031",120,100,100,0,0,"UPyD",0
43,"43905",13621,8120,8011,131,109,"UPyD",164
49,"49273",217,144,144,0,0,"UPyD",1
48,"48016",5214,3782,3736,46,46,"UPyD",87
45,"45091",419,311,309,5,2,"UPyD",16
42,"42149",404,292,286,12,6,"UPyD",17
26,"26032",58,52,52,1,0,"UPyD",1
20,"20907",136,94,94,0,0,"UPyD",0
46,"46070",15946,11979,11874,113,105,"UPyD",979
44,"44244",93,56,56,5,0,"UPyD",1
40,"40171",32,25,25,0,0,"UPyD",1
16,"16070",35,29,29,0,0,"UPyD",0
50,"50001",130,96,96,0,0,"UPyD",1
22,"22110",822,602,588,3,14,"UPyD",11
28,"28001",61,46,45,1,1,"UPyD",0
5,"5027",290,233,230,2,3,"UPyD",16
16,"16202",908,753,744,10,9,"UPyD",15
49,"49007",387,289,289,4,0,"UPyD",3
8,"8048",622,461,454,9,7,"UPyD",1
26,"26033",183,157,156,2,1,"UPyD",3
3,"3068",48,45,45,1,0,"UPyD",0
42,"42004",2383,1776,1740,30,36,"UPyD",84
10,"10047",978,795,780,9,15,"UPyD",18
13,"13056",10945,8173,8070,111,103,"UPyD",543
44,"44245",274,189,184,1,5,"UPyD",4
5,"5128",361,288,280,3,8,"UPyD",15
22,"22111",180,126,125,3,1,"UPyD",8
40,"40173",148,121,120,3,1,"UPyD",11
29,"29095",3431,2660,2607,23,53,"UPyD",72
43,"43112",294,184,181,2,3,"UPyD",0
46,"46217",912,758,751,4,7,"UPyD",25
37,"37045",27,21,21,0,0,"UPyD",6
44,"44246",1591,1030,997,15,33,"UPyD",24
8,"8050",149,112,108,4,4,"UPyD",2
4,"4029",10682,7542,7474,63,68,"UPyD",182
31,"31123",652,379,373,8,6,"UPyD",1
6,"6072",2370,1907,1885,9,22,"UPyD",48
34,"34050",216,170,166,1,4,"UPyD",3
42,"42154",95,73,73,0,0,"UPyD",4
37,"37046",11929,8847,8683,146,164,"UPyD",461
37,"37281",36,34,33,0,1,"UPyD",0
43,"43113",454,321,316,10,5,"UPyD",2
40,"40176",418,344,341,8,3,"UPyD",12
47,"47086",4062,3162,3120,37,42,"UPyD",124
19,"19075",81,53,50,4,3,"UPyD",0
19,"19283",40,33,33,0,0,"UPyD",0
32,"32041",884,576,568,2,8,"UPyD",2
25,"25114",102,82,78,4,4,"UPyD",1
3,"3071",3993,3180,3128,40,52,"UPyD",72
38,"38011",19299,12565,12313,152,252,"UPyD",430
20,"20056",3975,2692,2669,17,23,"UPyD",7
22,"22908",231,167,162,2,5,"UPyD",3
34,"34051",112,92,91,7,1,"UPyD",4
50,"50088",337,273,264,4,9,"UPyD",4
26,"26167",66,51,51,2,0,"UPyD",3
17,"17070",116,78,78,3,0,"UPyD",0
39,"39070",152,118,118,0,0,"UPyD",1
40,"40082",131,111,110,5,1,"UPyD",1
37,"37282",238,169,168,3,1,"UPyD",1
43,"43114",383,238,234,6,4,"UPyD",0
47,"47008",26,17,17,0,0,"UPyD",0
44,"44003",19,19,19,0,0,"UPyD",0
50,"50180",111,91,89,3,2,"UPyD",3
5,"5229",90,79,77,2,2,"UPyD",5
41,"41043",647,457,454,5,3,"UPyD",16
31,"31126",372,247,244,6,3,"UPyD",2
9,"9021",62,33,33,1,0,"UPyD",2
5,"5035",105,87,87,2,0,"UPyD",5
20,"20057",194,122,122,0,0,"UPyD",0
43,"43115",171,112,110,3,2,"UPyD",0
44,"44251",271,218,218,5,0,"UPyD",1
45,"45098",2273,1799,1756,11,43,"UPyD",35
3,"3072",331,284,277,2,7,"UPyD",2
25,"25023",4446,3079,3020,70,59,"UPyD",41
20,"20058",770,549,547,3,2,"UPyD",2
21,"21066",522,440,431,4,9,"UPyD",2
16,"16211",462,317,313,2,4,"UPyD",9
37,"37172",857,584,580,5,4,"UPyD",17
8,"8054",8733,6215,6077,123,138,"UPyD",91
40,"40039",257,188,184,2,4,"UPyD",9
50,"50181",1053,787,760,9,27,"UPyD",30
29,"29100",2442,1834,1824,14,10,"UPyD",74
24,"24148",1759,1362,1348,29,14,"UPyD",45
26,"26170",471,353,348,4,5,"UPyD",11
12,"12010",280,232,229,3,3,"UPyD",3
5,"5230",79,73,73,1,0,"UPyD",5
41,"41045",5505,3946,3889,68,57,"UPyD",200
37,"37249",48,36,36,0,0,"UPyD",0
31,"31220",771,584,572,9,12,"UPyD",11
25,"25025",1307,874,859,32,15,"UPyD",10
50,"50267",648,450,441,8,9,"UPyD",18
24,"24027",1184,853,837,7,16,"UPyD",25
34,"34184",54,37,36,0,1,"UPyD",0
20,"20060",92,83,82,0,1,"UPyD",0
40,"40182",207,155,155,6,0,"UPyD",9
44,"44257",184,132,131,6,1,"UPyD",1
4,"4034",152,106,105,1,1,"UPyD",2
5,"5232",106,84,80,1,4,"UPyD",3
49,"49107",160,113,111,2,2,"UPyD",1
12,"12111",423,375,363,6,12,"UPyD",6
49,"49150",169,129,126,0,3,"UPyD",1
40,"40041",1035,819,799,14,20,"UPyD",54
7,"7006",4964,3234,3157,51,77,"UPyD",52
5,"5135",440,363,360,0,3,"UPyD",23
1,"1003",1199,863,848,2,15,"UPyD",1
19,"19189",136,99,97,0,2,"UPyD",0
31,"31129",405,285,281,1,4,"UPyD",1
47,"47090",2511,1907,1880,23,27,"UPyD",75
46,"46077",7637,5979,5845,64,134,"UPyD",300
46,"46150",1898,1555,1541,8,14,"UPyD",32
19,"19081",43,33,33,0,0,"UPyD",0
9,"9422",24,18,16,0,2,"UPyD",0
5,"5233",246,212,212,2,0,"UPyD",2
50,"50008",5110,3458,3406,56,52,"UPyD",147
23,"23006",4644,3913,3871,36,42,"UPyD",42
37,"37176",136,103,100,1,3,"UPyD",4
41,"41047",9810,7427,7321,99,106,"UPyD",508
10,"10058",994,751,738,13,13,"UPyD",16
43,"43167",390,284,280,12,4,"UPyD",1
40,"40044",160,117,114,4,3,"UPyD",8
19,"19082",91,68,67,1,1,"UPyD",3
20,"20063",7889,5381,5340,48,41,"UPyD",36
25,"25211",701,378,368,5,10,"UPyD",3
34,"34059",462,377,375,5,2,"UPyD",8
9,"9423",34,28,28,1,0,"UPyD",2
3,"3078",528,424,423,2,1,"UPyD",14
19,"19290",872,622,613,7,9,"UPyD",36
19,"19086",1655,1310,1295,10,15,"UPyD",41
34,"34190",59,42,42,4,0,"UPyD",0
43,"43119",739,500,496,5,4,"UPyD",3
47,"47092",123,100,99,2,1,"UPyD",5
49,"49020",323,275,272,1,3,"UPyD",11
40,"40046",99,81,78,2,3,"UPyD",2
18,"18184",2140,1663,1645,18,18,"UPyD",44
14,"14059",713,572,567,5,5,"UPyD",9
10,"10182",146,112,108,0,4,"UPyD",2
15,"15069",7019,5036,4938,85,98,"UPyD",53
48,"48062",317,263,262,1,1,"UPyD",0
44,"44262",141,114,113,2,1,"UPyD",7
40,"40188",120,82,81,0,1,"UPyD",2
25,"25212",233,185,185,8,0,"UPyD",0
19,"19087",22,16,16,0,0,"UPyD",1
9,"9029",186,138,137,4,1,"UPyD",13
49,"49021",14682,10495,10296,194,199,"UPyD",492
47,"47014",55,47,47,0,0,"UPyD",1
49,"49022",319,266,261,3,5,"UPyD",3
45,"45105",426,326,322,2,4,"UPyD",10
37,"37292",101,84,84,2,0,"UPyD",8
46,"46225",360,319,310,5,9,"UPyD",8
43,"43121",636,385,371,6,14,"UPyD",0
9,"9030",135,97,97,2,0,"UPyD",4
31,"31042",2719,2100,2057,27,43,"UPyD",37
42,"42166",68,49,48,1,1,"UPyD",0
5,"5236",147,101,101,0,0,"UPyD",6
50,"50272",12481,8744,8642,176,102,"UPyD",679
39,"39052",17031,13198,13034,187,164,"UPyD",693
19,"19088",98,67,66,0,1,"UPyD",2
45,"45106",7666,6045,5945,92,100,"UPyD",254
38,"38021",1792,1184,1160,6,24,"UPyD",20
8,"8060",167,102,101,0,1,"UPyD",0
10,"10063",175,142,142,1,0,"UPyD",2
46,"46153",445,374,366,7,8,"UPyD",10
48,"48031",370,296,296,1,0,"UPyD",0
42,"42021",101,70,70,1,0,"UPyD",3
10,"10186",1031,906,896,8,10,"UPyD",10
12,"12116",56,45,45,0,0,"UPyD",0
9,"9294",123,96,93,1,3,"UPyD",2
41,"41051",2103,1705,1686,7,19,"UPyD",44
8,"8245",78826,51185,50445,962,740,"UPyD",722
18,"18188",1659,1329,1308,9,21,"UPyD",35
49,"49024",736,551,544,16,7,"UPyD",12
13,"13070",769,653,640,1,13,"UPyD",16
45,"45072",690,535,532,7,3,"UPyD",7
24,"24036",321,190,188,0,2,"UPyD",1
29,"29033",1385,878,868,4,10,"UPyD",18
20,"20068",199,132,129,2,3,"UPyD",1
26,"26051",271,219,214,4,5,"UPyD",4
47,"47016",94,77,77,1,0,"UPyD",9
16,"16092",158,132,132,0,0,"UPyD",0
28,"28147",910,705,698,5,7,"UPyD",46
50,"50100",355,273,266,3,7,"UPyD",7
23,"23015",1476,1189,1179,10,10,"UPyD",20
5,"5239",215,171,170,2,1,"UPyD",7
2,"2069",11624,9091,8907,119,184,"UPyD",317
36,"36017",18554,13573,13378,200,195,"UPyD",79
29,"29034",462,360,357,0,3,"UPyD",6
8,"8093",32,21,20,0,1,"UPyD",0
39,"39054",4265,3338,3276,57,62,"UPyD",110
26,"26183",65,54,54,0,0,"UPyD",4
8,"8247",903,627,608,10,19,"UPyD",4
9,"9430",18,15,15,0,0,"UPyD",1
8,"8154",677,499,488,2,11,"UPyD",5
8,"8063",434,336,333,8,3,"UPyD",1
18,"18094",2398,1882,1868,16,14,"UPyD",59
31,"31046",58,41,41,3,0,"UPyD",0
25,"25034",2471,1622,1592,25,30,"UPyD",0
34,"34202",28,21,21,0,0,"UPyD",1
23,"23016",442,355,354,5,1,"UPyD",2
46,"46228",2434,1881,1859,30,22,"UPyD",128
47,"47017",205,177,176,1,1,"UPyD",2
46,"46180",715,585,581,4,4,"UPyD",27
27,"27048",2404,1939,1909,36,30,"UPyD",6
12,"12056",304,259,254,7,5,"UPyD",9
38,"38025",6649,4858,4778,52,80,"UPyD",82
25,"25035",428,289,284,5,5,"UPyD",3
23,"23018",2415,1791,1781,9,10,"UPyD",19
37,"37067",2938,2306,2267,47,39,"UPyD",222
17,"17052",134,84,83,2,1,"UPyD",1
19,"19198",22,19,19,0,0,"UPyD",2
19,"19095",14,9,8,0,1,"UPyD",0
24,"24039",2157,1738,1727,30,11,"UPyD",51
40,"40055",41,32,31,0,1,"UPyD",2
7,"7049",1482,1046,1037,14,9,"UPyD",21
25,"25220",1076,711,702,10,9,"UPyD",3
28,"28034",356,278,276,1,2,"UPyD",14
20,"20072",4643,2967,2948,46,19,"UPyD",40
33,"33048",169,120,120,1,0,"UPyD",2
44,"44020",23,15,15,0,0,"UPyD",3
9,"9391",383,290,284,7,6,"UPyD",10
5,"5081",44,36,36,0,0,"UPyD",2
42,"42073",84,53,53,0,0,"UPyD",1
37,"37068",386,291,287,6,4,"UPyD",4
42,"42176",30,22,22,0,0,"UPyD",0
46,"46230",14204,10650,10515,112,135,"UPyD",524
19,"19300",746,595,585,3,10,"UPyD",47
22,"22137",1164,850,839,14,11,"UPyD",23
28,"28035",1314,1058,1046,3,12,"UPyD",60
37,"37187",567,449,448,3,1,"UPyD",14
49,"49031",150,128,127,2,1,"UPyD",3
50,"50017",1734,1232,1212,41,20,"UPyD",59
25,"25037",396,275,273,9,2,"UPyD",0
47,"47099",174,153,153,4,0,"UPyD",4
8,"8066",1315,985,965,16,20,"UPyD",8
24,"24163",3706,2760,2714,57,46,"UPyD",168
32,"32060",885,650,641,10,9,"UPyD",5
19,"19055",54,41,37,1,4,"UPyD",1
42,"42030",115,88,86,2,2,"UPyD",3
50,"50018",973,761,755,12,6,"UPyD",10
15,"15077",8677,6349,6269,82,80,"UPyD",21
8,"8067",5657,3772,3671,75,101,"UPyD",11
47,"47021",84,61,61,2,0,"UPyD",5
14,"14067",3821,3105,3082,38,23,"UPyD",104
50,"50105",343,263,259,2,4,"UPyD",2
45,"45115",2600,2140,2105,14,35,"UPyD",87
9,"9041",27,27,27,0,0,"UPyD",0
5,"5212",274,202,197,0,5,"UPyD",6
9,"9306",127,94,94,0,0,"UPyD",3
32,"32062",963,735,729,10,6,"UPyD",0
23,"23024",12634,9916,9673,116,243,"UPyD",327
8,"8068",6554,4323,4255,87,68,"UPyD",60
14,"14068",581,460,457,7,3,"UPyD",7
26,"26059",1137,887,869,9,18,"UPyD",29
31,"31234",148,107,105,6,2,"UPyD",3
44,"44024",24,19,19,0,0,"UPyD",0
8,"8253",134,91,91,2,0,"UPyD",0
7,"7053",1133,863,839,16,24,"UPyD",33
16,"16100",764,660,655,3,5,"UPyD",5
46,"46087",137,105,105,1,0,"UPyD",1
46,"46160",1976,1591,1570,21,21,"UPyD",45
40,"40061",66,53,52,1,1,"UPyD",0
42,"42182",62,53,53,2,0,"UPyD",0
9,"9438",547,440,433,9,7,"UPyD",21
45,"45117",800,679,668,7,11,"UPyD",8
49,"49035",260,231,229,4,2,"UPyD",6
18,"18903",960,761,753,1,8,"UPyD",15
23,"23026",3872,3051,2994,23,57,"UPyD",41
5,"5052",102,91,91,0,0,"UPyD",8
13,"13079",12220,9665,9502,177,163,"UPyD",251
42,"42183",131,95,94,7,1,"UPyD",2
8,"8254",1721,1189,1174,26,15,"UPyD",0
44,"44152",62,50,50,3,0,"UPyD",1
9,"9174",859,645,639,11,6,"UPyD",18
22,"22144",258,203,203,5,0,"UPyD",3
3,"3092",6780,5364,5269,96,95,"UPyD",196
9,"9440",105,80,80,0,0,"UPyD",2
49,"49171",704,568,561,6,7,"UPyD",10
28,"28084",15408,11489,11355,122,134,"UPyD",1297
14,"14071",1025,739,733,8,6,"UPyD",3
23,"23070",4142,2877,2846,20,31,"UPyD",69
47,"47050",3557,2688,2651,50,37,"UPyD",176
9,"9045",283,196,196,4,0,"UPyD",14
7,"7055",7000,4471,4379,67,92,"UPyD",101
33,"33052",758,526,518,2,8,"UPyD",10
16,"16244",735,615,606,3,9,"UPyD",6
44,"44027",168,140,140,2,0,"UPyD",0
5,"5054",1282,979,965,5,14,"UPyD",27
8,"8071",248,172,167,2,5,"UPyD",0
42,"42187",65,51,51,0,0,"UPyD",0
45,"45119",3274,2279,2236,37,43,"UPyD",123
17,"17060",378,240,233,1,7,"UPyD",0
9,"9441",70,59,59,2,0,"UPyD",0
45,"45009",588,430,422,2,8,"UPyD",4
9,"9084",200,147,147,4,0,"UPyD",5
14,"14072",1169,925,922,5,3,"UPyD",7
23,"23029",924,730,727,2,3,"UPyD",12
24,"24211",291,226,224,3,2,"UPyD",5
10,"10079",891,711,706,6,5,"UPyD",26
1,"1030",170,123,120,1,3,"UPyD",3
49,"49174",131,97,97,1,0,"UPyD",2
8,"8072",9910,6326,6235,140,91,"UPyD",78
28,"28085",3794,2980,2933,18,47,"UPyD",209
14,"14073",3009,2246,2224,32,22,"UPyD",41
4,"4089",805,607,597,1,10,"UPyD",9
16,"16246",520,417,407,1,10,"UPyD",3
31,"31146",46,34,34,1,0,"UPyD",1
4,"4056",144,118,118,0,0,"UPyD",3
26,"26065",57,43,43,0,0,"UPyD",1
9,"9442",385,295,289,4,6,"UPyD",14
18,"18004",818,601,594,2,7,"UPyD",9
7,"7058",2803,2100,2046,38,54,"UPyD",36
44,"44156",57,40,38,1,2,"UPyD",0
46,"46163",1811,1487,1463,12,24,"UPyD",97
26,"26066",277,229,228,9,1,"UPyD",4
31,"31085",451,334,327,3,7,"UPyD",3
17,"17062",5994,3686,3614,69,72,"UPyD",12
4,"4058",402,324,322,5,2,"UPyD",2
18,"18005",366,279,277,3,2,"UPyD",1
8,"8258",845,577,555,23,22,"UPyD",1
5,"5156",260,188,185,0,3,"UPyD",13
14,"14074",2387,2002,1995,26,7,"UPyD",41
19,"19106",95,68,66,0,2,"UPyD",1
31,"31147",103,81,80,3,1,"UPyD",4
5,"5252",70,52,51,0,1,"UPyD",5
20,"20902",14148,9874,9798,120,76,"UPyD",208
49,"49041",443,337,334,7,3,"UPyD",7
42,"42191",187,143,141,5,2,"UPyD",3
8,"8259",6362,4482,4420,97,62,"UPyD",24
45,"45124",2183,1868,1823,20,45,"UPyD",52
27,"27017",1138,789,787,6,2,"UPyD",2
48,"48046",12635,9231,9161,61,70,"UPyD",40
8,"8166",1138,726,706,10,20,"UPyD",1
24,"24054",492,359,351,1,8,"UPyD",7
7,"7060",2534,1724,1697,30,27,"UPyD",36
23,"23034",2591,2146,2124,13,22,"UPyD",25
16,"16109",46,34,34,2,0,"UPyD",2
37,"37312",278,232,229,1,3,"UPyD",4
18,"18007",808,602,591,5,11,"UPyD",8
20,"20903",3625,2282,2267,52,15,"UPyD",28
28,"28087",3150,2475,2453,26,22,"UPyD",187
17,"17064",341,253,250,4,3,"UPyD",0
5,"5059",112,91,88,1,3,"UPyD",2
12,"12131",92,78,78,1,0,"UPyD",2
43,"43904",2918,1779,1732,49,47,"UPyD",13
3,"3064",4976,4098,4058,26,40,"UPyD",126
18,"18909",668,536,534,2,2,"UPyD",5
9,"9052",40,31,31,1,0,"UPyD",1
22,"22014",265,192,191,1,1,"UPyD",2
7,"7061",9429,5937,5800,125,137,"UPyD",221
44,"44034",150,117,117,1,0,"UPyD",3
16,"16251",1903,1510,1493,18,17,"UPyD",28
42,"42043",3905,2931,2875,48,56,"UPyD",140
7,"7062",7206,4073,4035,72,38,"UPyD",80
10,"10085",334,244,243,1,1,"UPyD",5
41,"41064",5629,4041,4006,28,35,"UPyD",82
50,"50115",3280,2234,2205,32,29,"UPyD",75
49,"49046",283,240,235,2,5,"UPyD",7
9,"9447",36,33,33,0,0,"UPyD",1
31,"31242",235,157,157,2,0,"UPyD",2
37,"37314",79,61,61,3,0,"UPyD",2
30,"30018",7493,6003,5922,52,81,"UPyD",310
17,"17066",25667,15429,15157,244,272,"UPyD",140
6,"6114",152,122,122,0,0,"UPyD",2
46,"46240",226,188,185,3,3,"UPyD",5
37,"37201",263,196,196,5,0,"UPyD",3
15,"15087",6054,4004,3956,79,48,"UPyD",31
29,"29048",1508,1254,1245,6,9,"UPyD",8
42,"42195",112,74,72,1,2,"UPyD",2
5,"5094",158,124,124,3,0,"UPyD",6
10,"10208",141,118,118,1,0,"UPyD",1
39,"39067",901,628,623,1,5,"UPyD",9
37,"37316",792,565,559,7,6,"UPyD",24
30,"30019",25722,18740,18553,164,187,"UPyD",869
44,"44037",483,349,344,10,5,"UPyD",9
19,"19314",46,41,41,0,0,"UPyD",3
9,"9016",87,55,54,1,1,"UPyD",23
10,"10046",216,185,184,1,1,"UPyD",6
23,"23039",2239,1799,1764,9,35,"UPyD",24
25,"25139",549,358,357,5,1,"UPyD",1
18,"18109",607,461,456,1,5,"UPyD",12
46,"46241",440,336,314,4,22,"UPyD",25
41,"41066",1417,1121,1113,9,8,"UPyD",37
48,"48051",225,157,156,0,1,"UPyD",3
17,"17068",252,156,156,4,0,"UPyD",1
15,"15004",4891,3595,3545,61,50,"UPyD",37
31,"31245",87,59,58,5,1,"UPyD",2
33,"33058",1863,1307,1286,11,21,"UPyD",17
40,"40078",180,143,143,1,0,"UPyD",17
4,"4064",2585,1817,1803,18,14,"UPyD",47
9,"9184",4,4,4,0,0,"UPyD",0
9,"9450",31,26,26,1,0,"UPyD",0
40,"40219",635,519,505,7,14,"UPyD",43
16,"16258",288,215,213,1,2,"UPyD",4
37,"37088",208,173,172,4,1,"UPyD",10
44,"44165",182,140,140,1,0,"UPyD",1
37,"37318",225,167,165,0,2,"UPyD",8
3,"3103",288,248,243,2,5,"UPyD",6
31,"31154",229,133,133,4,0,"UPyD",1
31,"31246",148,101,100,3,1,"UPyD",1
21,"21002",14281,10297,10173,141,124,"UPyD",681
10,"10212",1688,1276,1242,16,34,"UPyD",49
40,"40220",71,57,52,0,5,"UPyD",3
28,"28045",30286,23148,22879,226,269,"UPyD",2651
5,"5193",224,197,197,2,0,"UPyD",4
46,"46024",448,365,358,1,7,"UPyD",13
9,"9325",217,151,148,1,3,"UPyD",4
38,"38043",18628,12966,12763,134,203,"UPyD",310
5,"5163",1762,1400,1380,5,20,"UPyD",49
16,"16118",1454,1221,1211,19,10,"UPyD",19
50,"50031",167,105,103,0,2,"UPyD",3
6,"6119",680,539,534,3,5,"UPyD",7
34,"34092",331,272,267,6,5,"UPyD",5
36,"36037",2727,1923,1896,18,27,"UPyD",15
37,"37319",138,94,94,1,0,"UPyD",8
28,"28046",4208,3297,3272,31,25,"UPyD",329
40,"40081",151,109,107,2,2,"UPyD",3
13,"13092",1924,1655,1635,4,20,"UPyD",15
6,"6120",3508,2772,2741,31,31,"UPyD",53
9,"9372",207,169,165,1,4,"UPyD",12
4,"4066",13570,9018,8963,97,55,"UPyD",122
43,"43065",443,278,270,8,8,"UPyD",0
17,"17162",137,80,78,2,2,"UPyD",0
9,"9060",171,142,142,0,0,"UPyD",5
47,"47195",449,350,346,5,4,"UPyD",11
25,"25142",387,265,264,5,1,"UPyD",1
17,"17071",1064,719,698,33,21,"UPyD",2
39,"39071",463,358,358,2,0,"UPyD",6
26,"26079",690,568,562,5,6,"UPyD",4
8,"8001",8538,5929,5838,120,91,"UPyD",100
16,"16264",505,440,438,6,2,"UPyD",11
38,"38045",4181,2176,2140,13,36,"UPyD",25
34,"34093",101,74,74,1,0,"UPyD",0
4,"4067",657,526,524,1,2,"UPyD",10
40,"40223",241,190,190,2,0,"UPyD",5
10,"10216",1549,1247,1235,15,12,"UPyD",19
28,"28048",489,398,389,3,9,"UPyD",22
28,"28162",2263,1802,1786,32,16,"UPyD",186
10,"10095",346,290,283,3,7,"UPyD",5
19,"19116",16,10,10,0,0,"UPyD",0
45,"45134",1606,1260,1242,10,18,"UPyD",12
26,"26080",529,427,425,2,2,"UPyD",7
40,"40225",1152,931,918,10,13,"UPyD",37
28,"28093",1911,1537,1518,19,19,"UPyD",116
32,"32081",2240,1698,1682,13,16,"UPyD",8
17,"17164",4092,2409,2346,60,63,"UPyD",6
1,"1049",147,115,115,1,0,"UPyD",0
46,"46172",4838,3492,3445,24,47,"UPyD",157
26,"26081",23,17,17,0,0,"UPyD",0
3,"3007",160,131,127,0,4,"UPyD",9
3,"3008",176,142,140,1,2,"UPyD",3
15,"15093",4562,3314,3270,37,44,"UPyD",9
8,"8085",1033,731,720,10,11,"UPyD",0
50,"50295",54,42,41,0,1,"UPyD",3
19,"19003",50,36,35,1,1,"UPyD",2
31,"31158",264,174,173,1,1,"UPyD",1
19,"19004",67,56,56,0,0,"UPyD",4
44,"44045",373,303,301,4,2,"UPyD",7
4,"4070",1649,1267,1255,9,12,"UPyD",10
15,"15010",2009,1468,1441,24,27,"UPyD",9
18,"18017",17990,12070,11962,80,108,"UPyD",400
10,"10219",1408,984,971,11,13,"UPyD",8
44,"44174",435,310,309,3,1,"UPyD",7
19,"19080",90,64,64,0,0,"UPyD",2
28,"28049",59507,46919,46379,488,540,"UPyD",5226
42,"42057",197,133,133,6,0,"UPyD",4
46,"46246",1081,917,904,5,13,"UPyD",20
45,"45027",433,352,349,1,3,"UPyD",8
30,"30025",4780,3901,3874,18,27,"UPyD",139
9,"9064",353,277,277,6,0,"UPyD",17
4,"4071",452,364,363,1,1,"UPyD",7
42,"42209",155,114,110,2,4,"UPyD",5
50,"50036",103,81,80,2,1,"UPyD",1
3,"3010",330,269,266,3,3,"UPyD",14
43,"43142",1155,730,714,20,16,"UPyD",0
19,"19119",93,80,79,2,1,"UPyD",6
49,"49193",503,365,357,4,8,"UPyD",8
1,"1054",959,680,675,8,5,"UPyD",3
46,"46174",1003,854,847,6,7,"UPyD",16
28,"28095",1358,1092,1077,8,15,"UPyD",106
10,"10099",633,458,450,4,8,"UPyD",5
17,"17076",126,77,76,5,1,"UPyD",0
19,"19223",129,94,90,1,4,"UPyD",5
9,"9065",152,137,137,1,0,"UPyD",2
8,"8006",10984,7255,7092,104,163,"UPyD",48
23,"23051",2805,2312,2290,8,22,"UPyD",43
31,"31253",123,102,97,0,5,"UPyD",0
8,"8088",11250,8019,7861,144,158,"UPyD",49
44,"44176",167,131,130,5,1,"UPyD",2
22,"22177",101,79,75,1,4,"UPyD",6
10,"10100",792,554,538,1,16,"UPyD",8
10,"10903",813,620,615,3,5,"UPyD",13
49,"49064",566,372,368,8,4,"UPyD",11
28,"28051",1469,1147,1129,7,18,"UPyD",100
15,"15013",6160,4229,4165,70,64,"UPyD",71
24,"24070",4434,3199,3136,34,63,"UPyD",57
46,"46175",469,406,401,5,5,"UPyD",10
30,"30027",45194,35272,34973,366,299,"UPyD",2960
25,"25150",185,119,113,4,6,"UPyD",0
34,"34237",645,506,498,6,8,"UPyD",8
17,"17168",393,285,281,8,4,"UPyD",2
40,"40234",441,363,355,3,8,"UPyD",10
23,"23053",9431,7160,7128,42,32,"UPyD",81
34,"34146",60,42,40,1,2,"UPyD",3
37,"37216",300,270,266,2,4,"UPyD",16
40,"40001",713,575,562,10,13,"UPyD",42
13,"13902",497,396,394,3,2,"UPyD",15
6,"6132",876,656,648,2,8,"UPyD",11
22,"22035",261,179,176,3,3,"UPyD",1
34,"34238",348,289,287,4,2,"UPyD",8
46,"46176",1965,1423,1405,12,18,"UPyD",76
15,"15014",4239,3151,3104,39,47,"UPyD",13
8,"8274",4887,3326,3279,36,47,"UPyD",17
12,"12050",1418,1183,1156,8,27,"UPyD",11
42,"42215",821,561,545,19,16,"UPyD",6
9,"9068",25,19,19,2,0,"UPyD",0
49,"49201",330,280,278,9,2,"UPyD",9
19,"19330",93,81,81,2,0,"UPyD",3
25,"25058",4390,2696,2650,57,46,"UPyD",6
22,"22182",271,160,150,4,10,"UPyD",9
8,"8090",120,86,86,2,0,"UPyD",0
50,"50040",98,77,76,2,1,"UPyD",2
21,"21012",331,254,246,2,8,"UPyD",1
45,"45143",1302,916,901,6,15,"UPyD",24
29,"29060",775,573,572,1,1,"UPyD",7
33,"33067",802,650,639,12,11,"UPyD",14
17,"17079",62633,40844,40101,670,743,"UPyD",304
12,"12052",627,510,491,9,19,"UPyD",6
42,"42217",38,32,32,0,0,"UPyD",4
9,"9070",38,27,27,3,0,"UPyD",1
1,"1059",183468,127839,125801,1422,2038,"UPyD",4056
23,"23056",3182,2539,2523,20,16,"UPyD",37
44,"44053",111,77,76,2,1,"UPyD",2
16,"16277",128,100,100,3,0,"UPyD",0
5,"5904",149,99,97,0,2,"UPyD",2
23,"23057",823,717,711,4,6,"UPyD",10
49,"49069",414,276,270,1,6,"UPyD",3
31,"31257",827,598,585,16,13,"UPyD",18
17,"17232",159,107,104,0,3,"UPyD",1
6,"6136",1621,1300,1283,11,17,"UPyD",27
37,"37334",86,50,49,0,1,"UPyD",0
18,"18124",387,270,267,0,3,"UPyD",1
8,"8184",52133,33696,33220,656,476,"UPyD",578
45,"45034",1375,1108,1079,18,29,"UPyD",34
9,"9206",65,56,55,2,1,"UPyD",4
19,"19124",420,293,291,3,2,"UPyD",9
10,"10025",408,355,337,4,18,"UPyD",5
42,"42219",45,33,33,1,0,"UPyD",3
44,"44054",125,97,97,2,0,"UPyD",2
28,"28169",1244,971,962,8,9,"UPyD",105
31,"31166",274,183,182,2,1,"UPyD",4
46,"46179",2186,1849,1804,17,45,"UPyD",59
37,"37371",285,190,190,2,0,"UPyD",0
10,"10107",1062,832,821,7,11,"UPyD",8
45,"45146",117,99,98,0,1,"UPyD",1
34,"34107",91,67,67,4,0,"UPyD",5
18,"18025",326,242,238,0,4,"UPyD",5
37,"37335",432,347,346,0,1,"UPyD",3
9,"9478",53,41,41,1,0,"UPyD",2
34,"34108",561,477,465,6,12,"UPyD",16
5,"5079",68,52,50,1,2,"UPyD",4
39,"39081",440,372,369,3,3,"UPyD",1
39,"39003",321,265,261,0,4,"UPyD",1
8,"8278",4668,3033,2949,67,84,"UPyD",7
4,"4080",194,169,168,1,1,"UPyD",4
31,"31076",2314,1843,1823,39,20,"UPyD",45
10,"10027",88,78,78,0,0,"UPyD",1
9,"9390",645,522,518,9,4,"UPyD",19
45,"45074",428,349,343,3,6,"UPyD",9
47,"47044",325,257,252,1,5,"UPyD",14
28,"28170",2503,1744,1727,20,17,"UPyD",77
47,"47127",150,110,108,0,2,"UPyD",3
37,"37336",54,49,47,0,2,"UPyD",0
25,"25251",670,476,473,1,3,"UPyD",0
44,"44185",117,91,90,0,1,"UPyD",1
31,"31260",1263,788,780,11,8,"UPyD",14
34,"34109",62,47,46,0,1,"UPyD",1
30,"30033",9940,7794,7700,79,94,"UPyD",298
8,"8279",149233,101676,100363,1965,1313,"UPyD",1304
6,"6004",1607,1317,1309,10,8,"UPyD",13
49,"49208",428,266,261,1,5,"UPyD",6
19,"19016",74,50,49,0,1,"UPyD",1
1,"1901",2254,1561,1528,24,33,"UPyD",36
37,"37186",109,88,88,2,0,"UPyD",4
42,"42027",87,61,61,4,0,"UPyD",1
43,"43051",8749,5494,5411,78,83,"UPyD",79
25,"25156",761,535,529,15,6,"UPyD",2
29,"29064",584,428,422,4,6,"UPyD",7
50,"50134",134,102,101,3,1,"UPyD",6
49,"49209",568,374,372,1,2,"UPyD",7
23,"23062",1476,1274,1264,2,10,"UPyD",6
19,"19017",87,70,70,0,0,"UPyD",4
34,"34901",1233,955,946,14,9,"UPyD",38
41,"41081",28121,20027,19785,275,242,"UPyD",1108
22,"22195",231,193,189,6,4,"UPyD",20
25,"25064",122,91,88,7,3,"UPyD",0
37,"37226",167,129,127,1,2,"UPyD",3
39,"39005",1319,1048,1026,3,22,"UPyD",32
16,"16903",1097,855,828,9,27,"UPyD",8
2,"2001",731,601,584,6,17,"UPyD",15
47,"47046",124,105,103,0,2,"UPyD",3
23,"23064",1680,1483,1478,8,5,"UPyD",13
30,"30035",17849,12871,12744,133,127,"UPyD",929
40,"40107",113,93,90,3,3,"UPyD",4
16,"16904",508,413,407,10,6,"UPyD",22
39,"39084",873,647,642,4,5,"UPyD",7
6,"6007",1557,1200,1189,4,11,"UPyD",12
18,"18132",3461,2797,2772,19,25,"UPyD",64
24,"24205",995,719,712,9,7,"UPyD",30
19,"19132",105,79,79,0,0,"UPyD",2
43,"43004",6411,4089,4001,92,88,"UPyD",25
13,"13010",910,729,726,8,3,"UPyD",12
50,"50136",617,469,462,4,7,"UPyD",9
46,"46183",5946,4718,4656,35,62,"UPyD",158
4,"4014",162,136,136,0,0,"UPyD",2
17,"17086",1687,1148,1129,14,19,"UPyD",9
16,"16142",118,93,93,1,0,"UPyD",0
31,"31081",335,249,243,8,6,"UPyD",0
14,"14008",2905,2226,2200,18,26,"UPyD",19
11,"11010",6452,4534,4510,61,24,"UPyD",86
18,"18032",248,166,166,2,0,"UPyD",8
6,"6146",1188,951,936,8,15,"UPyD",4
8,"8018",2664,1707,1669,29,38,"UPyD",6
16,"16906",104,83,82,0,1,"UPyD",0
2,"2003",129078,98135,97009,1430,1126,"UPyD",7299
8,"8099",808,533,519,11,14,"UPyD",3
50,"50223",956,751,745,14,6,"UPyD",20
48,"48073",7090,4865,4802,37,63,"UPyD",10
24,"24207",320,274,272,5,2,"UPyD",9
43,"43079",387,259,255,26,4,"UPyD",0
9,"9352",134,107,106,0,1,"UPyD",5
31,"31173",881,754,733,12,21,"UPyD",9
16,"16908",227,181,179,1,2,"UPyD",2
33,"33073",9341,5825,5773,69,52,"UPyD",88
45,"45154",1459,1148,1140,12,8,"UPyD",65
49,"49084",306,234,234,8,0,"UPyD",11
6,"6011",24301,17977,17819,268,158,"UPyD",813
39,"39008",13716,10396,10274,129,122,"UPyD",372
9,"9218",384,285,279,8,6,"UPyD",17
2,"2005",602,490,488,2,2,"UPyD",8
6,"6012",3263,2498,2476,31,22,"UPyD",41
10,"10158",367,307,306,3,1,"UPyD",2
28,"28017",1120,905,888,8,17,"UPyD",99
19,"19135",120,102,100,2,2,"UPyD",3
24,"24210",532,329,328,2,1,"UPyD",11
4,"4087",198,162,159,2,3,"UPyD",5
9,"9354",33,29,29,2,0,"UPyD",3
26,"26107",97,79,79,1,0,"UPyD",6
30,"30038",15057,11640,11555,82,85,"UPyD",527
49,"49222",404,297,294,4,3,"UPyD",5
31,"31902",3722,2670,2632,77,38,"UPyD",94
8,"8195",88,64,64,2,0,"UPyD",0
27,"27059",2320,1783,1763,25,20,"UPyD",8
42,"42083",28,25,25,0,0,"UPyD",1
43,"43032",587,418,413,9,5,"UPyD",0
50,"50225",1638,1079,1062,7,17,"UPyD",23
5,"5249",101,73,71,1,2,"UPyD",3
47,"47186",251279,193705,191693,2746,2012,"UPyD",15394
3,"3129",1188,936,918,10,18,"UPyD",46
9,"9007",66,50,50,0,0,"UPyD",1
17,"17182",257,177,175,2,2,"UPyD",0
35,"35003",4764,2733,2680,34,53,"UPyD",61
8,"8196",18989,12658,12490,253,168,"UPyD",260
3,"3027",150,131,130,1,1,"UPyD",2
28,"28131",12664,9454,9342,100,112,"UPyD",1025
28,"28110",1912,1492,1475,8,17,"UPyD",87
31,"31903",6058,3985,3919,67,66,"UPyD",63
44,"44068",690,544,528,6,16,"UPyD",13
10,"10121",8063,6048,5988,51,60,"UPyD",177
6,"6016",3013,2363,2306,31,57,"UPyD",49
24,"24213",162,134,133,1,1,"UPyD",2
23,"23073",4671,3778,3735,19,43,"UPyD",100
39,"39011",1646,1295,1294,5,1,"UPyD",28
2,"2009",19661,14804,14570,259,234,"UPyD",730
10,"10081",183,143,142,0,1,"UPyD",2
3,"3028",1049,903,895,6,8,"UPyD",17
36,"36061",8729,6747,6640,68,107,"UPyD",44
4,"4090",435,338,335,3,3,"UPyD",4
5,"5089",500,390,375,3,15,"UPyD",31
50,"50228",295,238,236,10,2,"UPyD",7
4,"4091",380,322,318,3,4,"UPyD",5
11,"11015",59476,38207,37898,501,309,"UPyD",1977
22,"22054",1602,1040,982,42,58,"UPyD",93
46,"46188",660,579,576,4,3,"UPyD",24
26,"26111",266,203,200,4,3,"UPyD",10
49,"49091",278,197,197,4,0,"UPyD",7
50,"50054",63,46,46,0,0,"UPyD",0
47,"47216",124,99,98,2,1,"UPyD",4
6,"6155",1911,1384,1363,18,21,"UPyD",26
22,"22207",135,86,79,4,7,"UPyD",0
49,"49226",279,235,233,1,2,"UPyD",6
31,"31178",540,395,392,4,3,"UPyD",7
47,"47053",125,100,99,1,1,"UPyD",9
25,"25905",386,264,258,12,6,"UPyD",0
44,"44074",435,344,337,5,7,"UPyD",10
31,"31088",5358,3655,3592,97,63,"UPyD",129
15,"15028",1485,1130,1118,14,12,"UPyD",4
31,"31179",558,384,384,3,0,"UPyD",4
5,"5188",55,47,47,0,0,"UPyD",0
17,"17093",859,561,552,16,9,"UPyD",0
50,"50055",3592,2520,2473,59,47,"UPyD",138
24,"24094",1466,1023,1006,24,17,"UPyD",43
9,"9225",95,61,61,3,0,"UPyD",2
37,"37238",102,77,76,0,1,"UPyD",11
3,"3133",40056,25746,25554,231,192,"UPyD",1168
43,"43158",109,63,61,5,2,"UPyD",0
41,"41089",6394,4593,4526,57,67,"UPyD",192
42,"42089",54,44,44,3,0,"UPyD",2
25,"25906",235,160,154,3,6,"UPyD",0
9,"9013",48,41,41,1,0,"UPyD",1
16,"16153",1006,856,843,8,13,"UPyD",20
12,"12070",576,473,463,5,10,"UPyD",0
2,"2013",158,123,121,1,2,"UPyD",4
16,"16027",779,619,612,5,7,"UPyD",17
27,"27901",2559,1847,1831,27,16,"UPyD",13
12,"12002",135,101,100,1,1,"UPyD",2
45,"45090",396,335,333,0,2,"UPyD",4
29,"29093",2299,1767,1732,7,35,"UPyD",16
22,"22212",93,79,79,0,0,"UPyD",2
28,"28113",31318,23779,23436,271,343,"UPyD",2987
13,"13021",459,358,355,5,3,"UPyD",6
25,"25169",201,134,134,6,0,"UPyD",1
30,"30901",10113,8265,8194,70,71,"UPyD",426
37,"37126",36,26,26,0,0,"UPyD",0
37,"37352",199,150,142,0,8,"UPyD",4
50,"50232",176,123,120,5,3,"UPyD",6
10,"10004",733,576,565,6,11,"UPyD",12
50,"50175",1088,742,732,10,10,"UPyD",20
10,"10087",1754,1283,1262,4,21,"UPyD",34
31,"31908",997,692,683,9,9,"UPyD",7
22,"22213",3152,2265,2230,62,35,"UPyD",69
45,"45164",191,160,158,0,2,"UPyD",6
34,"34130",228,187,186,6,1,"UPyD",1
40,"40216",753,621,611,15,10,"UPyD",64
43,"43135",327,243,238,2,5,"UPyD",1
37,"37354",4828,3589,3522,76,67,"UPyD",317
25,"25019",4626,2971,2932,54,39,"UPyD",18
50,"50233",120,89,88,2,1,"UPyD",6
47,"47140",132,109,108,1,1,"UPyD",2
28,"28136",618,527,516,2,11,"UPyD",48
8,"8109",200,155,153,1,2,"UPyD",0
23,"23082",1985,1464,1451,9,13,"UPyD",18
3,"3035",672,560,550,0,10,"UPyD",15
9,"9095",88,75,73,2,2,"UPyD",2
20,"20017",8670,5923,5890,27,33,"UPyD",40
41,"41014",2484,1956,1936,13,20,"UPyD",32
26,"26119",223,186,185,2,1,"UPyD",2
22,"22215",137,90,90,1,0,"UPyD",5
3,"3137",719,536,530,3,6,"UPyD",22
45,"45056",2246,1523,1502,16,21,"UPyD",71
4,"4097",299,229,227,0,2,"UPyD",6
33,"33013",466,349,345,4,4,"UPyD",1
19,"19247",171,125,118,6,7,"UPyD",3
50,"50148",365,256,251,2,5,"UPyD",5
44,"44084",63,51,50,0,1,"UPyD",0
37,"37007",467,368,363,6,5,"UPyD",17
50,"50059",790,593,586,12,7,"UPyD",12
41,"41015",5263,3820,3752,34,68,"UPyD",141
17,"17009",4089,2573,2490,59,83,"UPyD",5
44,"44207",187,147,146,5,1,"UPyD",2
21,"21063",2624,2109,2097,13,12,"UPyD",33
25,"25172",1838,1267,1230,35,37,"UPyD",5
44,"44001",69,48,47,0,1,"UPyD",3
39,"39044",3864,2940,2905,44,35,"UPyD",83
13,"13058",4155,3320,3285,24,35,"UPyD",87
35,"35011",23140,15550,15320,199,230,"UPyD",319
24,"24100",760,563,553,14,10,"UPyD",9
21,"21034",1253,875,861,7,14,"UPyD",17
25,"25173",1784,1177,1139,20,38,"UPyD",14
10,"10132",420,293,287,1,6,"UPyD",0
31,"31003",131,101,101,1,0,"UPyD",0
10,"10010",2358,1597,1576,18,21,"UPyD",27
19,"19151",1126,849,830,3,19,"UPyD",43
41,"41016",6950,5194,5120,45,74,"UPyD",340
8,"8296",1683,1227,1203,29,24,"UPyD",9
18,"18913",827,653,646,2,7,"UPyD",16
50,"50292",138,117,115,4,2,"UPyD",1
28,"28047",38404,28739,28436,312,303,"UPyD",3503
7,"7035",1542,1190,1161,19,29,"UPyD",6
17,"17010",327,216,214,6,2,"UPyD",2
8,"8021",76,49,47,1,2,"UPyD",0
42,"42100",31,31,31,0,0,"UPyD",3
24,"24226",223,154,153,1,1,"UPyD",8
40,"40131",48,41,41,0,0,"UPyD",2
31,"31186",299,205,200,3,5,"UPyD",2
44,"44210",754,573,567,3,6,"UPyD",19
37,"37010",963,705,690,5,15,"UPyD",32
45,"45060",204,151,148,1,3,"UPyD",8
32,"32007",1674,1263,1243,4,20,"UPyD",2
26,"26124",860,705,694,3,11,"UPyD",10
17,"17192",145,107,105,4,2,"UPyD",0
6,"6031",490,387,385,8,2,"UPyD",4
31,"31187",122,68,68,2,0,"UPyD",0
5,"5196",69,54,54,2,0,"UPyD",3
9,"9236",41,38,37,0,1,"UPyD",0
50,"50062",1750,1298,1275,22,23,"UPyD",81
42,"42103",626,487,481,3,6,"UPyD",15
40,"40132",75,50,50,1,0,"UPyD",2
8,"8207",1718,1296,1256,28,40,"UPyD",5
6,"6032",76,59,59,1,0,"UPyD",5
32,"32008",7618,5529,5433,83,96,"UPyD",67
11,"11024",6811,5241,5202,58,39,"UPyD",134
47,"47145",658,482,473,7,9,"UPyD",16
50,"50063",76,67,67,0,0,"UPyD",3
26,"26126",32,31,31,1,0,"UPyD",0
10,"10014",1907,1507,1488,14,19,"UPyD",30
8,"8299",444,277,267,5,10,"UPyD",0
26,"26001",211,174,168,3,6,"UPyD",3
31,"31188",185,139,137,2,2,"UPyD",1
28,"28902",453,338,329,3,9,"UPyD",17
9,"9375",42,30,30,1,0,"UPyD",1
8,"8024",409,266,260,4,6,"UPyD",0
3,"3903",2431,1991,1960,18,31,"UPyD",73
18,"18149",5096,3949,3900,36,49,"UPyD",275
15,"15038",2363,1643,1610,29,33,"UPyD",4
6,"6034",190,134,129,3,5,"UPyD",4
28,"28070",139,98,97,0,1,"UPyD",8
47,"47146",236,196,195,4,1,"UPyD",14
50,"50153",1002,757,748,12,9,"UPyD",13
13,"13030",153,123,123,1,0,"UPyD",4
29,"29072",3258,2484,2447,30,37,"UPyD",87
20,"20024",400,238,235,0,3,"UPyD",0
28,"28071",77,57,55,0,2,"UPyD",3
16,"16040",97,76,75,1,1,"UPyD",2
17,"17103",4988,2788,2724,51,64,"UPyD",33
26,"26002",805,617,605,6,12,"UPyD",22
17,"17195",324,220,214,6,6,"UPyD",0
49,"49108",512,387,381,9,6,"UPyD",6
9,"9108",399,287,283,5,4,"UPyD",23
10,"10016",321,266,262,2,4,"UPyD",3
16,"16166",277,210,202,0,8,"UPyD",2
31,"31008",97,64,63,1,1,"UPyD",3
44,"44008",1695,1280,1257,11,23,"UPyD",21
26,"26128",116,94,93,0,1,"UPyD",3
4,"4901",576,427,426,5,1,"UPyD",7
8,"8026",180,144,143,0,1,"UPyD",0
39,"39101",328,251,247,5,4,"UPyD",2
29,"29073",1520,1032,1021,10,11,"UPyD",30
42,"42110",82,58,58,2,0,"UPyD",4
20,"20026",214,172,172,0,0,"UPyD",2
32,"32012",912,763,756,8,7,"UPyD",4
45,"45066",7334,5602,5536,52,66,"UPyD",280
37,"37139",199,167,163,1,4,"UPyD",9
44,"44096",173,139,133,4,6,"UPyD",0
49,"49244",48,30,30,1,0,"UPyD",0
25,"25087",65,41,39,0,2,"UPyD",0
39,"39023",6048,4795,4747,43,48,"UPyD",117
31,"31191",2930,2194,2148,43,46,"UPyD",47
8,"8212",508,366,363,1,3,"UPyD",0
32,"32013",2464,1695,1671,10,24,"UPyD",5
8,"8027",673,527,515,9,12,"UPyD",2
43,"43021",381,218,213,3,5,"UPyD",0
25,"25088",100,74,74,0,0,"UPyD",0
5,"5001",210,180,176,2,4,"UPyD",4
21,"21041",114169,74740,73814,1129,926,"UPyD",3765
8,"8119",6039,3991,3884,74,107,"UPyD",54
44,"44218",37,26,26,2,0,"UPyD",0
19,"19291",1271,925,902,3,23,"UPyD",58
24,"24153",253,201,199,4,2,"UPyD",8
3,"3079",18028,14580,14317,189,263,"UPyD",809
17,"17140",684,476,470,10,6,"UPyD",0
37,"37018",128,89,87,0,2,"UPyD",3
5,"5204",654,521,516,7,5,"UPyD",20
25,"25001",146,76,76,1,0,"UPyD",0
47,"47175",6562,5041,4957,62,84,"UPyD",387
50,"50186",44,30,29,0,1,"UPyD",1
34,"34147",192,139,137,1,2,"UPyD",7
10,"10021",5421,4189,4099,47,90,"UPyD",96
5,"5002",1996,1497,1476,15,21,"UPyD",95
44,"44099",724,519,511,4,8,"UPyD",7
6,"6041",459,406,404,4,2,"UPyD",1
19,"19047",87,71,70,2,1,"UPyD",5
26,"26008",1909,1544,1527,19,17,"UPyD",34
29,"29076",2022,1384,1374,14,10,"UPyD",52
40,"40002",38,31,31,1,0,"UPyD",5
41,"41024",22383,15333,15160,213,173,"UPyD",582
43,"43023",244,179,177,8,2,"UPyD",0
9,"9246",662,469,457,3,12,"UPyD",23
44,"44100",200,147,146,0,1,"UPyD",5
7,"7011",26954,16786,16595,299,191,"UPyD",865
19,"19048",18,12,11,1,1,"UPyD",3
29,"29004",343,281,281,0,0,"UPyD",4
50,"50245",121,80,80,1,0,"UPyD",2
9,"9114",88,75,73,0,2,"UPyD",5
50,"50160",2397,1905,1865,19,40,"UPyD",31
10,"10145",132,112,111,0,1,"UPyD",0
18,"18157",1062,793,783,9,10,"UPyD",33
28,"28123",48429,38681,38187,429,494,"UPyD",4288
40,"40004",534,428,420,3,8,"UPyD",15
44,"44101",60,47,47,1,0,"UPyD",2
28,"28075",5127,3976,3916,42,60,"UPyD",419
31,"31195",186,127,126,1,1,"UPyD",1
47,"47068",41,28,28,0,0,"UPyD",2
40,"40145",1152,933,920,3,13,"UPyD",84
8,"8215",2594,1763,1728,51,35,"UPyD",6
43,"43098",362,251,247,1,4,"UPyD",0
8,"8307",47176,31341,30846,536,495,"UPyD",365
34,"34025",54,42,42,0,0,"UPyD",5
40,"40146",270,222,222,0,0,"UPyD",23
44,"44222",136,99,99,2,0,"UPyD",3
33,"33045",4692,3347,3297,42,50,"UPyD",87
21,"21045",261,200,200,5,0,"UPyD",1
17,"17021",108,86,79,0,7,"UPyD",1
31,"31014",280,197,196,2,1,"UPyD",1
47,"47069",128,108,108,0,0,"UPyD",6
47,"47152",94,65,65,0,0,"UPyD",0
3,"3083",5708,4267,4196,66,71,"UPyD",134
37,"37108",108,95,95,1,0,"UPyD",3
19,"19262",184,137,136,0,1,"UPyD",11
19,"19163",73,59,59,0,0,"UPyD",1
10,"10148",32554,23348,22955,365,393,"UPyD",1067
44,"44224",26,15,15,0,0,"UPyD",0
13,"13039",14349,10928,10776,149,152,"UPyD",410
8,"8124",36292,24541,24210,471,331,"UPyD",421
45,"45184",219,150,148,3,2,"UPyD",0
49,"49118",215,174,173,2,1,"UPyD",7
5,"5208",55,45,45,0,0,"UPyD",4
9,"9250",295,234,230,5,4,"UPyD",14
5,"5010",173,141,134,2,7,"UPyD",2
32,"32020",2958,2300,2283,19,17,"UPyD",1
45,"45037",1730,1325,1304,15,21,"UPyD",42
13,"13006",641,529,519,4,10,"UPyD",11
48,"48068",1577,1224,1213,4,11,"UPyD",1
17,"17203",171,97,94,3,3,"UPyD",0
5,"5209",104,78,78,0,0,"UPyD",1
20,"20034",3192,2035,2030,11,5,"UPyD",15
4,"4010",602,492,491,10,1,"UPyD",6
19,"19052",37,32,31,1,1,"UPyD",1
43,"43173",114,65,64,0,1,"UPyD",1
47,"47153",135,94,93,1,1,"UPyD",3
37,"37373",793,591,589,4,2,"UPyD",21
37,"37025",264,217,216,1,1,"UPyD",10
45,"45112",2022,1470,1423,12,47,"UPyD",31
4,"4011",2814,2283,2263,25,20,"UPyD",47
5,"5114",1418,1195,1182,9,13,"UPyD",90
6,"6050",4277,3500,3457,36,43,"UPyD",77
12,"12090",127,109,107,2,2,"UPyD",3
44,"44107",233,161,154,3,7,"UPyD",1
8,"8189",141,113,111,4,2,"UPyD",0
37,"37112",162,124,124,3,0,"UPyD",1
31,"31261",271,202,201,4,1,"UPyD",6
50,"50277",82,63,63,0,0,"UPyD",4
4,"4012",230,195,195,2,0,"UPyD",2
45,"45187",4187,3581,3512,25,69,"UPyD",123
2,"2036",104,78,78,0,0,"UPyD",0
49,"49121",382,270,270,1,0,"UPyD",12
39,"39031",1227,965,956,4,9,"UPyD",14
46,"46060",9510,7506,7408,52,98,"UPyD",292
44,"44227",81,59,59,0,0,"UPyD",0
41,"41096",6079,4673,4595,47,78,"UPyD",344
46,"46061",331,276,273,3,3,"UPyD",8
47,"47073",141,118,116,1,2,"UPyD",1
20,"20037",100,65,64,2,1,"UPyD",2
44,"44021",114,81,77,1,4,"UPyD",2
30,"30008",13289,9992,9849,86,143,"UPyD",488
18,"18062",9418,6916,6835,62,81,"UPyD",508
33,"33026",9144,6019,5959,87,60,"UPyD",124
40,"40154",23,21,21,1,0,"UPyD",0
8,"8221",11348,8413,8306,109,107,"UPyD",68
8,"8128",557,377,374,16,3,"UPyD",0
19,"19266",278,234,231,4,3,"UPyD",3
50,"50075",89,74,74,1,0,"UPyD",0
9,"9394",805,594,588,13,6,"UPyD",36
34,"34159",375,275,264,8,11,"UPyD",7
49,"49123",557,421,415,5,6,"UPyD",11
25,"25099",1185,720,709,9,11,"UPyD",3
46,"46207",6453,5086,5031,52,55,"UPyD",286
41,"41097",3096,2489,2451,21,38,"UPyD",61
9,"9256",369,254,252,2,2,"UPyD",11
49,"49168",96,78,78,1,0,"UPyD",1
25,"25009",690,479,471,9,8,"UPyD",0
22,"22245",329,261,257,3,4,"UPyD",5
37,"37265",224,192,191,1,1,"UPyD",3
5,"5244",66,45,45,0,0,"UPyD",3
22,"22142",114,91,91,2,0,"UPyD",1
37,"37030",90,71,70,4,1,"UPyD",5
25,"25192",799,543,527,19,16,"UPyD",0
8,"8905",2268,1692,1657,28,35,"UPyD",14
20,"20040",15103,9781,9686,148,95,"UPyD",83
25,"25100",207,125,115,2,10,"UPyD",0
46,"46135",9634,7671,7586,64,85,"UPyD",545
6,"6055",2105,1623,1599,13,24,"UPyD",20
50,"50167",235,191,184,1,7,"UPyD",8
46,"46262",228,161,158,0,3,"UPyD",7
11,"11039",9943,6634,6582,104,52,"UPyD",201
44,"44231",54,38,36,2,2,"UPyD",2
49,"49169",42,34,33,1,1,"UPyD",1
49,"49262",401,317,313,1,4,"UPyD",9
47,"47158",906,716,710,10,6,"UPyD",34
14,"14040",3821,2986,2949,40,37,"UPyD",44
41,"41099",4141,2818,2799,37,19,"UPyD",67
29,"29086",814,538,536,9,2,"UPyD",15
39,"39034",289,209,209,3,0,"UPyD",2
8,"8131",696,483,469,7,14,"UPyD",0
37,"37380",57,45,44,1,1,"UPyD",3
43,"43031",1509,1016,992,20,24,"UPyD",1
7,"7022",11700,7512,7371,128,141,"UPyD",144
10,"10035",1941,1517,1492,15,25,"UPyD",21
50,"50281",76,63,63,2,0,"UPyD",0
28,"28038",4999,3659,3590,32,69,"UPyD",295
9,"9003",205,156,154,4,2,"UPyD",2
4,"4017",1337,965,960,7,5,"UPyD",14
34,"34163",61,56,56,1,0,"UPyD",0
45,"45193",661,557,548,1,9,"UPyD",10
5,"5120",38,28,28,1,0,"UPyD",1
17,"17209",605,469,463,21,6,"UPyD",6
39,"39035",10031,7685,7601,74,84,"UPyD",201
34,"34165",86,67,67,0,0,"UPyD",1
49,"49128",617,480,474,10,6,"UPyD",14
50,"50254",179,136,136,0,0,"UPyD",0
32,"32029",557,426,424,1,2,"UPyD",0
18,"18066",2072,1558,1552,8,6,"UPyD",30
45,"45156",3528,2985,2924,19,61,"UPyD",91
43,"43080",254,175,173,7,2,"UPyD",1
36,"36059",5438,3874,3805,47,69,"UPyD",22
45,"45120",159,125,122,0,3,"UPyD",8
9,"9046",41,30,30,0,0,"UPyD",1
37,"37307",177,132,130,0,2,"UPyD",1
50,"50170",411,316,313,2,3,"UPyD",4
29,"29014",250,152,150,0,2,"UPyD",3
44,"44236",77,48,47,0,1,"UPyD",1
45,"45195",2229,1806,1784,11,22,"UPyD",42
8,"8163",17986,11683,11548,159,135,"UPyD",109
44,"44116",96,68,65,3,3,"UPyD",2
5,"5121",250,181,178,1,3,"UPyD",13
16,"16022",102,76,76,2,0,"UPyD",7
9,"9405",143,106,105,2,1,"UPyD",6
41,"41034",22561,16014,15840,270,174,"UPyD",595
19,"19272",86,67,65,1,2,"UPyD",4
4,"4019",269,210,209,3,1,"UPyD",4
34,"34168",60,56,56,0,0,"UPyD",3
38,"38001",17632,9601,9475,121,126,"UPyD",170
17,"17211",864,628,612,12,16,"UPyD",4
37,"37235",226,194,192,0,2,"UPyD",1
12,"12129",1936,1372,1326,29,46,"UPyD",25
30,"30015",18792,14453,14336,120,117,"UPyD",852
17,"17123",365,274,266,8,8,"UPyD",0
10,"10162",616,505,496,1,9,"UPyD",5
19,"19175",39,31,31,0,0,"UPyD",0
17,"17031",172,94,93,1,1,"UPyD",0
4,"4020",361,265,263,1,2,"UPyD",3
29,"29090",1805,1265,1260,5,5,"UPyD",53
26,"26154",12,12,12,3,0,"UPyD",3
26,"26155",173,134,134,1,0,"UPyD",0
28,"28020",145,102,100,0,2,"UPyD",7
40,"40024",920,712,704,7,8,"UPyD",44
31,"31208",2574,2003,1966,32,37,"UPyD",21
25,"25200",353,225,217,4,8,"UPyD",0
5,"5123",90,69,69,3,0,"UPyD",9
2,"2047",109,94,94,0,0,"UPyD",1
47,"47162",80,62,62,1,0,"UPyD",6
29,"29091",8777,6226,6126,64,100,"UPyD",186
4,"4021",188,157,157,2,0,"UPyD",1
7,"7027",20045,12873,12678,204,195,"UPyD",470
9,"9267",135,118,118,3,0,"UPyD",6
45,"45198",1950,1661,1641,9,20,"UPyD",24
47,"47106",63,52,52,0,0,"UPyD",4
37,"37198",212,176,173,2,3,"UPyD",8
17,"17213",5282,3097,3041,42,56,"UPyD",25
40,"40212",29,22,20,0,2,"UPyD",1
6,"6065",327,262,259,2,3,"UPyD",2
4,"4023",144,116,116,2,0,"UPyD",0
34,"34045",84,75,74,1,1,"UPyD",0
32,"32035",1632,1100,1088,8,12,"UPyD",6
17,"17033",5157,3142,3095,44,47,"UPyD",31
21,"21059",203,166,162,1,4,"UPyD",2
42,"42144",464,343,331,3,12,"UPyD",3
46,"46068",326,292,285,3,7,"UPyD",13
15,"15001",4985,3560,3506,63,54,"UPyD",30
35,"35033",6415,4394,4302,51,92,"UPyD",96
44,"44120",217,126,121,5,5,"UPyD",3
10,"10166",351,246,238,2,8,"UPyD",3
8,"8230",7452,5349,5286,94,63,"UPyD",59
31,"31210",219,169,167,3,2,"UPyD",2
50,"50231",285,231,224,7,7,"UPyD",1
3,"3099",41561,32556,32248,288,308,"UPyD",1341
27,"27021",1936,1295,1271,19,24,"UPyD",5
19,"19067",91,59,59,0,0,"UPyD",1
37,"37276",188,136,135,0,1,"UPyD",1
41,"41038",96442,66696,65945,1021,751,"UPyD",5131
31,"31029",987,693,680,16,13,"UPyD",11
19,"19179",109,77,75,3,2,"UPyD",2
25,"25202",110,62,59,3,3,"UPyD",0
20,"20051",7033,4843,4779,57,64,"UPyD",37
43,"43037",16656,9986,9812,163,174,"UPyD",127
10,"10045",1119,884,859,5,25,"UPyD",13
49,"49180",169,113,107,2,6,"UPyD",3
3,"3066",42697,31279,30833,566,446,"UPyD",2163
12,"12037",20,15,14,1,1,"UPyD",0
31,"31121",79,53,52,2,1,"UPyD",0
29,"29020",3188,2448,2424,30,24,"UPyD",56
26,"26162",116,94,93,2,1,"UPyD",2
6,"6069",3116,2316,2288,46,28,"UPyD",47
49,"49232",95,78,78,1,0,"UPyD",5
45,"45055",1052,886,870,10,16,"UPyD",18
31,"31212",173,117,117,3,0,"UPyD",4
10,"10209",297,217,213,3,4,"UPyD",1
37,"37165",27,20,20,1,0,"UPyD",3
32,"32038",497,360,358,2,2,"UPyD",2
31,"31152",1406,1003,975,23,28,"UPyD",14
8,"8233",1867,1179,1169,29,10,"UPyD",2
34,"34176",146,120,118,2,2,"UPyD",6
12,"12104",6981,5464,5357,54,107,"UPyD",261
49,"49139",195,146,146,0,0,"UPyD",6
17,"17129",126,91,90,3,1,"UPyD",0
9,"9017",96,76,74,0,2,"UPyD",2
31,"31213",114,58,58,0,0,"UPyD",0
4,"4027",260,186,186,0,0,"UPyD",7
16,"16072",161,126,123,0,3,"UPyD",7
45,"45203",2535,1883,1829,21,54,"UPyD",125
3,"3069",2830,2009,1979,22,30,"UPyD",120
32,"32039",1424,1084,1069,10,15,"UPyD",7
5,"5030",43,39,39,0,0,"UPyD",2
37,"37167",164,140,132,6,8,"UPyD",7
49,"49141",397,289,286,7,3,"UPyD",13
44,"44125",78,57,57,1,0,"UPyD",1
31,"31214",95,64,64,1,0,"UPyD",2
50,"50002",166,130,130,2,0,"UPyD",0
50,"50262",1216,916,904,20,12,"UPyD",26
29,"29022",202,142,141,2,1,"UPyD",7
6,"6073",787,563,552,9,11,"UPyD",13
28,"28091",5202,3714,3671,34,43,"UPyD",198
18,"18076",880,676,676,3,0,"UPyD",4
22,"22167",515,417,399,16,18,"UPyD",8
4,"4065",387,320,318,1,2,"UPyD",0
34,"34227",84,69,67,3,2,"UPyD",2
2,"2055",1267,900,884,6,16,"UPyD",27
50,"50178",325,228,225,4,3,"UPyD",0
49,"49143",243,161,157,0,4,"UPyD",2
9,"9275",202,140,139,5,1,"UPyD",3
45,"45095",742,606,585,2,21,"UPyD",14
41,"41042",5902,4572,4509,37,63,"UPyD",113
34,"34179",32,21,21,0,0,"UPyD",1
28,"28137",1626,1231,1222,9,9,"UPyD",124
40,"40177",171,145,145,2,0,"UPyD",3
25,"25021",2693,1632,1605,40,27,"UPyD",6
50,"50236",124,103,103,2,0,"UPyD",0
16,"16206",250,188,188,2,0,"UPyD",1
42,"42051",23,12,11,0,1,"UPyD",0
19,"19001",64,56,56,1,0,"UPyD",0
34,"34229",75,60,60,2,0,"UPyD",4
37,"37206",100,81,80,1,1,"UPyD",4
17,"17133",1336,889,866,14,23,"UPyD",2
10,"10174",177,145,145,2,0,"UPyD",4
29,"29024",414,271,261,6,10,"UPyD",11
40,"40178",104,80,79,1,1,"UPyD",4
7,"7036",25502,17151,16914,294,237,"UPyD",1055
8,"8143",2679,1772,1756,35,16,"UPyD",8
6,"6076",854,639,631,9,8,"UPyD",10
48,"48022",2396,1524,1504,12,20,"UPyD",9
18,"18079",3497,2729,2706,15,23,"UPyD",58
26,"26038",93,71,69,1,2,"UPyD",3
49,"49013",300,230,228,6,2,"UPyD",2
37,"37283",130,104,104,1,0,"UPyD",2
31,"31217",382,256,244,5,12,"UPyD",1
47,"47009",117,88,88,1,0,"UPyD",3
44,"44129",44,34,33,0,1,"UPyD",1
5,"5132",1040,770,753,2,17,"UPyD",22
39,"39046",1442,1071,1050,13,21,"UPyD",15
43,"43042",2071,1504,1485,28,19,"UPyD",16
21,"21067",418,318,312,5,6,"UPyD",6
23,"23002",17740,14007,13858,171,149,"UPyD",622
13,"13062",595,490,480,4,10,"UPyD",23
10,"10054",551,435,428,6,7,"UPyD",5
26,"26040",67,63,62,2,1,"UPyD",4
49,"49014",134,104,102,1,2,"UPyD",2
17,"17223",787,523,514,8,9,"UPyD",1
12,"12110",253,199,195,3,4,"UPyD",1
24,"24025",331,237,237,5,0,"UPyD",8
26,"26041",152,106,104,0,2,"UPyD",2
50,"50182",3704,2551,2515,44,36,"UPyD",250
8,"8239",471,338,333,6,5,"UPyD",3
9,"9149",37,25,25,0,0,"UPyD",2
22,"22117",2585,1880,1848,57,32,"UPyD",67
2,"2060",1232,974,964,10,10,"UPyD",29
37,"37052",274,213,212,1,1,"UPyD",1
49,"49149",422,305,303,6,2,"UPyD",7
5,"5231",172,142,141,0,1,"UPyD",4
16,"16213",39,32,32,1,0,"UPyD",3
1,"1001",2010,1362,1336,26,26,"UPyD",28
13,"13063",3839,2801,2771,31,30,"UPyD",102
19,"19287",153,114,113,2,1,"UPyD",4
42,"42160",288,222,221,2,1,"UPyD",11
9,"9281",159,134,132,5,2,"UPyD",8
45,"45101",3761,3212,3181,19,31,"UPyD",100
9,"9421",269,189,189,5,0,"UPyD",12
20,"20061",4011,2666,2653,23,13,"UPyD",7
8,"8147",17023,11177,10961,184,216,"UPyD",138
17,"17137",3331,2163,2110,39,53,"UPyD",6
41,"41046",3055,2456,2418,23,38,"UPyD",53
44,"44258",75,56,55,0,1,"UPyD",3
18,"18084",3954,3039,3015,50,24,"UPyD",253
40,"40183",148,127,127,0,0,"UPyD",1
15,"15067",8142,6054,5978,73,76,"UPyD",19
40,"40089",248,183,177,3,6,"UPyD",6
50,"50183",369,277,274,5,3,"UPyD",2
20,"20062",995,687,667,5,20,"UPyD",7
43,"43044",3990,2768,2715,72,53,"UPyD",13
47,"47012",134,105,105,0,0,"UPyD",1
24,"24151",514,391,387,6,4,"UPyD",12
50,"50009",122,93,93,0,0,"UPyD",3
42,"42016",25,13,13,0,0,"UPyD",0
24,"24152",481,326,322,5,4,"UPyD",4
45,"45103",457,400,394,0,6,"UPyD",4
6,"6083",45013,31929,31491,527,438,"UPyD",1840
26,"26174",154,122,122,2,0,"UPyD",3
17,"17044",6619,4293,4187,69,106,"UPyD",23
28,"28144",5663,4456,4410,47,46,"UPyD",460
49,"49153",183,141,139,1,2,"UPyD",5
17,"17226",852,539,535,0,4,"UPyD",3
34,"34060",150,123,123,2,0,"UPyD",4
20,"20064",12380,7568,7464,112,104,"UPyD",101
22,"22126",100,81,80,2,1,"UPyD",2
19,"19191",19,15,15,0,0,"UPyD",1
46,"46005",22815,17016,16838,185,178,"UPyD",1035
31,"31040",197,137,135,2,2,"UPyD",1
9,"9027",54,48,43,0,5,"UPyD",1
1,"1006",181,133,127,2,6,"UPyD",4
45,"45104",457,375,370,2,5,"UPyD",8
50,"50095",12558,9029,8910,179,119,"UPyD",246
27,"27040",3421,2718,2693,27,25,"UPyD",5
49,"49065",1212,939,926,3,13,"UPyD",16
30,"30028",6810,5333,5251,44,82,"UPyD",196
37,"37290",143,111,110,1,1,"UPyD",2
5,"5235",136,120,119,2,1,"UPyD",5
42,"42165",424,291,280,6,11,"UPyD",13
22,"22127",483,357,353,9,4,"UPyD",26
29,"29058",1560,1103,1096,5,7,"UPyD",25
19,"19225",879,625,618,9,7,"UPyD",39
44,"44012",389,297,293,5,4,"UPyD",13
2,"2065",517,450,449,4,1,"UPyD",31
44,"44137",215,165,163,5,2,"UPyD",1
25,"25215",399,229,226,4,3,"UPyD",3
49,"49155",105,85,85,0,0,"UPyD",1
34,"34192",103,75,74,1,1,"UPyD",2
38,"38020",14520,9396,9202,121,194,"UPyD",167
31,"31133",48,34,34,3,0,"UPyD",0
31,"31225",40,32,32,0,0,"UPyD",1
1,"1009",1296,876,863,9,13,"UPyD",5
44,"44264",249,196,193,1,3,"UPyD",2
47,"47176",229,157,157,0,0,"UPyD",4
44,"44141",147,99,95,0,4,"UPyD",0
33,"33044",180964,129466,128346,1888,1120,"UPyD",6896
22,"22128",203,164,161,7,3,"UPyD",3
15,"15071",8233,5751,5668,93,83,"UPyD",35
46,"46226",34,34,33,0,1,"UPyD",2
50,"50098",215,150,146,2,4,"UPyD",1
19,"19294",27,26,26,1,0,"UPyD",0
50,"50187",72,45,45,1,0,"UPyD",1
29,"29032",6673,5204,5140,43,64,"UPyD",156
30,"30004",1164,958,952,1,6,"UPyD",15
28,"28032",4469,3412,3369,32,43,"UPyD",399
45,"45108",564,461,456,2,5,"UPyD",6
40,"40191",265,191,190,1,1,"UPyD",14
47,"47177",112,83,79,1,4,"UPyD",3
9,"9033",104,82,80,1,2,"UPyD",11
25,"25032",71,44,42,1,2,"UPyD",0
32,"32054",87289,63027,61875,1263,1152,"UPyD",837
15,"15072",9868,7077,6951,79,126,"UPyD",40
37,"37294",11233,8282,8167,139,115,"UPyD",669
9,"9295",78,54,53,0,1,"UPyD",6
43,"43122",92,65,61,0,4,"UPyD",0
8,"8246",1714,1175,1153,27,22,"UPyD",2
22,"22234",818,609,605,12,4,"UPyD",6
46,"46081",10254,8188,8101,52,87,"UPyD",384
25,"25125",450,297,289,10,8,"UPyD",0
18,"18093",2580,1837,1820,8,17,"UPyD",60
25,"25033",1125,738,718,17,20,"UPyD",4
9,"9163",642,526,518,3,8,"UPyD",20
36,"36050",7602,5424,5339,50,85,"UPyD",42
37,"37062",92,73,73,1,0,"UPyD",6
43,"43123",70216,45627,44828,906,799,"UPyD",517
50,"50275",103,76,76,0,0,"UPyD",0
26,"26053",221,177,173,5,4,"UPyD",8
9,"9297",326,270,266,7,4,"UPyD",16
10,"10189",2728,2108,2063,24,45,"UPyD",36
25,"25126",286,192,189,7,3,"UPyD",1
41,"41052",2967,2305,2288,7,17,"UPyD",42
21,"21077",1690,1335,1321,8,14,"UPyD",10
32,"32056",1861,1378,1369,8,9,"UPyD",5
18,"18192",1581,1331,1318,6,13,"UPyD",23
15,"15074",4254,3246,3219,35,27,"UPyD",12
19,"19297",34,29,29,0,0,"UPyD",1
44,"44225",129,100,98,5,2,"UPyD",1
7,"7015",20783,12244,12016,381,228,"UPyD",265
15,"15046",6949,4641,4539,56,102,"UPyD",26
49,"49207",279,206,204,2,2,"UPyD",8
34,"34069",2330,1769,1749,25,20,"UPyD",63
20,"20071",14488,9499,9419,93,80,"UPyD",58
27,"27002",1835,1455,1437,16,18,"UPyD",9
15,"15075",12042,8639,8486,147,153,"UPyD",140
5,"5241",3145,2303,2273,27,30,"UPyD",122
17,"17234",183,131,128,2,3,"UPyD",0
21,"21078",2865,2085,2066,21,19,"UPyD",43
1,"1017",910,629,621,17,8,"UPyD",6
39,"39056",2387,1857,1835,22,22,"UPyD",46
38,"38026",32174,24822,24431,283,391,"UPyD",362
30,"30007",6115,4651,4603,29,48,"UPyD",183
17,"17145",1593,1090,1068,10,22,"UPyD",3
31,"31138",939,648,646,14,2,"UPyD",6
37,"37299",237,167,165,2,2,"UPyD",1
17,"17115",281,209,207,5,2,"UPyD",0
49,"49120",79,58,58,1,0,"UPyD",0
27,"27003",2064,1531,1516,19,15,"UPyD",4
22,"22044",278,195,191,7,4,"UPyD",6
17,"17054",395,250,247,3,3,"UPyD",3
45,"45002",2500,1771,1756,26,15,"UPyD",46
1,"1019",155,124,124,0,0,"UPyD",2
27,"27005",2792,2101,2076,21,25,"UPyD",16
42,"42028",62,45,43,2,2,"UPyD",0
45,"45113",2094,1589,1555,6,34,"UPyD",37
17,"17902",1330,898,874,11,24,"UPyD",1
42,"42177",78,64,62,4,2,"UPyD",2
40,"40199",110,88,86,3,2,"UPyD",9
50,"50193",635,483,465,3,18,"UPyD",29
48,"48070",559,413,407,1,6,"UPyD",0
9,"9214",724,477,467,4,10,"UPyD",19
8,"8190",281,201,197,3,4,"UPyD",1
46,"46012",930,698,684,9,14,"UPyD",24
42,"42029",164,114,113,1,1,"UPyD",2
8,"8158",2996,2012,1986,19,26,"UPyD",25
12,"12024",146,129,128,1,1,"UPyD",6
45,"45004",603,497,494,6,3,"UPyD",31
32,"32061",1196,976,973,4,3,"UPyD",5
9,"9039",58,50,49,0,1,"UPyD",3
24,"24042",79,68,68,0,0,"UPyD",7
20,"20075",4447,2823,2798,32,25,"UPyD",26
49,"49032",369,295,291,0,4,"UPyD",7
50,"50106",137,107,106,0,1,"UPyD",0
22,"22002",107,85,84,3,1,"UPyD",4
39,"39058",862,586,584,6,2,"UPyD",15
18,"18902",950,769,762,6,7,"UPyD",22
37,"37377",268,209,208,1,1,"UPyD",2
16,"16099",232,180,178,5,2,"UPyD",2
17,"17056",1704,1171,1158,21,13,"UPyD",5
24,"24043",144,77,77,0,0,"UPyD",2
5,"5213",117,94,88,0,6,"UPyD",4
17,"17177",563,398,388,7,10,"UPyD",1
37,"37071",90,80,80,1,0,"UPyD",2
1,"1022",826,615,602,6,13,"UPyD",18
47,"47022",62,54,54,0,0,"UPyD",3
31,"31142",1443,906,899,16,7,"UPyD",7
37,"37303",207,158,152,3,6,"UPyD",11
42,"42032",186,143,141,2,2,"UPyD",4
32,"32063",2127,1469,1444,22,25,"UPyD",16
19,"19202",16,14,14,0,0,"UPyD",0
45,"45006",1524,1128,1110,13,18,"UPyD",19
40,"40203",814,643,631,14,12,"UPyD",59
46,"46111",10589,7823,7710,94,113,"UPyD",468
50,"50048",43,33,33,1,0,"UPyD",3
44,"44025",6168,4326,4150,68,176,"UPyD",95
40,"40062",54,44,44,0,0,"UPyD",10
47,"47102",302,250,248,3,2,"UPyD",1
19,"19304",235,169,166,1,3,"UPyD",8
45,"45008",158,129,127,0,2,"UPyD",1
5,"5246",68,57,56,1,1,"UPyD",0
16,"16243",451,395,388,3,7,"UPyD",8
37,"37192",362,229,221,3,8,"UPyD",13
42,"42033",54,48,48,0,0,"UPyD",1
8,"8161",10991,6841,6709,114,132,"UPyD",67
50,"50224",70,52,49,2,3,"UPyD",0
10,"10117",264,174,174,2,0,"UPyD",2
12,"12063",59,42,41,0,1,"UPyD",2
45,"45118",1980,1412,1390,13,22,"UPyD",43
5,"5247",267,164,164,0,0,"UPyD",5
46,"46161",1454,1192,1179,8,13,"UPyD",46
48,"48042",1401,1116,1099,15,17,"UPyD",22
28,"28153",608,422,406,1,16,"UPyD",51
37,"37074",172,136,135,1,1,"UPyD",5
28,"28154",5232,3910,3860,40,50,"UPyD",379
12,"12127",92,64,61,0,3,"UPyD",1
9,"9175",143,99,98,0,1,"UPyD",1
36,"36026",20494,14048,13798,232,250,"UPyD",203
8,"8255",132,83,82,1,1,"UPyD",0
40,"40160",120,94,92,2,2,"UPyD",1
26,"26150",129,104,104,0,0,"UPyD",0
34,"34079",1391,1088,1077,17,11,"UPyD",60
5,"5184",288,225,224,0,1,"UPyD",5
17,"17152",10378,6239,6156,100,83,"UPyD",52
9,"9355",117,88,87,1,1,"UPyD",0
43,"43131",4495,2842,2814,51,28,"UPyD",32
20,"20081",7346,4957,4925,35,32,"UPyD",22
49,"49173",430,272,272,5,0,"UPyD",4
25,"25134",657,421,416,4,5,"UPyD",0
46,"46187",1339,1096,1083,13,13,"UPyD",25
17,"17090",548,412,404,7,8,"UPyD",1
16,"16148",634,553,547,5,6,"UPyD",7
19,"19061",76,57,55,3,2,"UPyD",2
13,"13082",25643,17973,17798,257,175,"UPyD",867
50,"50110",424,315,314,6,1,"UPyD",7
24,"24170",2006,1410,1394,14,16,"UPyD",30
37,"37078",888,728,714,9,14,"UPyD",31
10,"10202",665,533,523,7,10,"UPyD",13
40,"40069",87,76,75,0,1,"UPyD",4
12,"12032",23406,16895,16721,227,174,"UPyD",550
8,"8227",2372,1591,1549,38,42,"UPyD",5
17,"17002",567,413,401,4,12,"UPyD",3
32,"32068",1631,1187,1174,4,13,"UPyD",2
28,"28155",529,427,416,2,11,"UPyD",19
19,"19209",50,40,39,0,1,"UPyD",1
23,"23031",771,649,646,6,3,"UPyD",8
40,"40210",110,71,67,1,4,"UPyD",4
13,"13083",2529,1837,1795,26,42,"UPyD",56
25,"25135",1077,739,722,18,17,"UPyD",2
48,"48045",5060,3912,3849,31,63,"UPyD",51
38,"38035",8172,4990,4919,62,71,"UPyD",94
23,"23032",598,518,515,0,3,"UPyD",3
46,"46018",689,597,592,12,5,"UPyD",17
10,"10082",1947,1601,1572,10,29,"UPyD",48
2,"2083",246,215,215,0,0,"UPyD",2
47,"47188",125,112,109,3,3,"UPyD",1
38,"38036",6477,4514,4422,40,92,"UPyD",74
18,"18006",4116,2862,2831,25,31,"UPyD",59
46,"46164",11634,8843,8724,90,119,"UPyD",455
10,"10083",105,74,74,0,0,"UPyD",0
14,"14075",624,508,500,8,8,"UPyD",12
9,"9179",45,37,37,0,0,"UPyD",4
9,"9051",181,136,133,2,3,"UPyD",4
44,"44200",41,30,30,0,0,"UPyD",0
42,"42041",36,25,25,4,0,"UPyD",0
31,"31148",99,69,66,2,3,"UPyD",4
31,"31906",2493,1796,1770,57,26,"UPyD",53
12,"12069",53,48,47,0,1,"UPyD",5
26,"26070",203,179,177,3,2,"UPyD",4
38,"38037",13166,8509,8332,65,177,"UPyD",157
19,"19310",13,9,8,0,1,"UPyD",0
24,"24055",747,557,549,11,8,"UPyD",17
39,"39065",272,199,197,2,2,"UPyD",6
34,"34221",190,143,143,3,0,"UPyD",9
28,"28042",1091,814,808,5,6,"UPyD",61
2,"2048",1320,1076,1061,11,15,"UPyD",6
49,"49044",80,63,63,3,0,"UPyD",1
40,"40213",99,75,74,1,1,"UPyD",2
6,"6112",411,330,326,0,4,"UPyD",4
50,"50202",182,125,122,2,3,"UPyD",2
40,"40074",271,221,218,3,3,"UPyD",10
50,"50287",298,214,211,10,3,"UPyD",2
46,"46020",3793,3084,3046,21,38,"UPyD",100
31,"31180",240,174,170,5,4,"UPyD",3
23,"23037",513,430,424,3,6,"UPyD",9
50,"50027",260,209,202,2,7,"UPyD",3
47,"47110",471,386,378,6,8,"UPyD",14
5,"5190",61,48,48,3,0,"UPyD",5
16,"16112",1562,1159,1140,12,19,"UPyD",22
36,"36033",12323,9328,9150,97,178,"UPyD",105
48,"48049",564,446,446,2,0,"UPyD",0
50,"50116",220,154,153,0,1,"UPyD",3
43,"43061",55,31,31,1,0,"UPyD",4
9,"9182",104,81,81,1,0,"UPyD",1
22,"22059",1149,792,764,23,28,"UPyD",28
31,"31151",77,49,49,2,0,"UPyD",1
42,"42045",345,238,234,2,4,"UPyD",2
47,"47191",113,81,80,1,1,"UPyD",6
28,"28089",3531,2786,2753,25,33,"UPyD",317
3,"3101",4648,3694,3607,29,87,"UPyD",60
9,"9318",63,38,38,0,0,"UPyD",3
15,"15059",10658,7889,7728,125,161,"UPyD",57
49,"49138",269,190,189,0,1,"UPyD",4
7,"7030",1576,1150,1135,26,15,"UPyD",14
34,"34175",101,80,80,2,0,"UPyD",2
36,"36034",3684,2686,2651,32,35,"UPyD",25
24,"24177",477,325,319,3,6,"UPyD",8
10,"10169",587,460,450,2,10,"UPyD",12
25,"25047",1048,760,748,24,12,"UPyD",2
26,"26074",128,102,101,0,1,"UPyD",9
49,"49050",558,382,375,3,7,"UPyD",14
8,"8263",20729,13742,13563,232,179,"UPyD",154
27,"27024",1759,1346,1324,17,22,"UPyD",3
37,"37087",779,590,586,18,4,"UPyD",56
39,"39068",663,488,485,4,3,"UPyD",5
42,"42197",90,71,71,0,0,"UPyD",2
10,"10210",599,453,452,3,1,"UPyD",7
5,"5192",96,78,77,1,1,"UPyD",4
10,"10170",269,217,215,4,2,"UPyD",3
49,"49234",439,336,332,5,4,"UPyD",11
23,"23041",519,455,448,2,7,"UPyD",2
38,"38042",3876,2850,2809,24,41,"UPyD",18
12,"12136",2663,2325,2284,33,41,"UPyD",36
10,"10090",552,404,396,3,8,"UPyD",6
34,"34089",173,128,125,5,3,"UPyD",2
19,"19318",36,19,19,1,0,"UPyD",1
8,"8264",3983,2773,2744,30,29,"UPyD",25
8,"8171",2158,1385,1359,27,26,"UPyD",2
15,"15005",23875,15132,14895,356,237,"UPyD",196
8,"8020",4542,3352,3298,77,54,"UPyD",45
17,"17098",311,208,202,4,6,"UPyD",0
45,"45058",409,334,332,2,2,"UPyD",11
47,"47168",32,29,28,1,1,"UPyD",0
33,"33036",11674,8695,8605,104,90,"UPyD",178
44,"44040",206,167,166,5,1,"UPyD",6
46,"46097",890,674,662,2,12,"UPyD",34
44,"44168",194,154,152,4,2,"UPyD",7
3,"3104",26809,20511,20193,317,318,"UPyD",1392
47,"47033",209,170,168,3,2,"UPyD",2
34,"34091",136,105,103,1,2,"UPyD",2
26,"26077",15,15,15,1,0,"UPyD",0
49,"49054",929,690,687,12,3,"UPyD",18
23,"23043",554,411,407,6,4,"UPyD",10
19,"19321",46,29,29,0,0,"UPyD",0
29,"29097",4076,3060,3018,40,42,"UPyD",183
10,"10106",144,123,123,4,0,"UPyD",4
26,"26037",150,129,128,1,1,"UPyD",2
18,"18014",5667,4132,4085,43,47,"UPyD",292
37,"37091",181,127,119,0,8,"UPyD",3
33,"33060",15694,11036,10883,112,153,"UPyD",202
31,"31247",171,121,121,1,0,"UPyD",0
8,"8082",1143,733,723,17,10,"UPyD",7
28,"28025",426,336,332,2,4,"UPyD",9
37,"37321",169,144,144,1,0,"UPyD",1
17,"17163",2478,1729,1681,41,48,"UPyD",2
50,"50121",297,250,245,6,5,"UPyD",3
7,"7002",6305,4188,4073,80,115,"UPyD",71
24,"24182",448,339,333,9,6,"UPyD",6
45,"45023",1936,1476,1456,18,20,"UPyD",93
48,"48055",2620,1954,1934,22,20,"UPyD",16
46,"46171",16753,12565,12399,122,166,"UPyD",814
46,"46244",57805,41885,41595,415,290,"UPyD",2835
15,"15092",6869,4965,4907,53,58,"UPyD",7
5,"5166",235,181,178,1,3,"UPyD",4
29,"29053",1715,1239,1221,7,18,"UPyD",27
16,"16121",270,211,207,1,4,"UPyD",2
36,"36039",14581,11007,10782,167,225,"UPyD",96
17,"17073",1753,1320,1298,18,22,"UPyD",2
23,"23046",2441,2049,2027,13,22,"UPyD",15
5,"5067",85,68,68,0,0,"UPyD",2
8,"8003",6983,5061,4993,53,68,"UPyD",37
5,"5263",175,133,131,0,2,"UPyD",6
43,"43140",2393,1612,1583,23,29,"UPyD",12
31,"31157",3567,2435,2393,32,42,"UPyD",35
25,"25145",88,67,67,2,0,"UPyD",0
49,"49058",341,262,259,4,3,"UPyD",8
48,"48057",5934,4407,4385,27,22,"UPyD",5
42,"42055",183,128,127,4,1,"UPyD",2
12,"12140",1204,975,954,9,21,"UPyD",16
43,"43141",131,71,70,3,1,"UPyD",0
5,"5167",274,230,224,6,6,"UPyD",0
23,"23048",884,691,679,6,12,"UPyD",11
37,"37051",90,72,72,0,0,"UPyD",1
8,"8004",228,176,172,2,4,"UPyD",0
45,"45136",5891,4414,4368,55,46,"UPyD",117
24,"24185",512,414,402,3,12,"UPyD",9
16,"16270",192,156,155,0,1,"UPyD",3
37,"37098",355,267,265,1,2,"UPyD",7
17,"17074",490,345,342,5,3,"UPyD",7
31,"31068",3004,2258,2207,43,51,"UPyD",38
40,"40229",45,37,37,0,0,"UPyD",1
3,"3110",294,239,238,0,1,"UPyD",6
22,"22175",211,158,158,9,0,"UPyD",1
47,"47118",159,122,122,2,0,"UPyD",4
19,"19118",17,13,13,0,0,"UPyD",2
37,"37325",102,77,77,0,0,"UPyD",1
22,"22027",351,251,250,8,1,"UPyD",13
9,"9196",161,111,110,0,1,"UPyD",3
32,"32084",1084,818,805,0,13,"UPyD",0
17,"17167",2818,1886,1858,52,28,"UPyD",1
5,"5266",112,92,89,0,3,"UPyD",1
41,"41072",4083,3073,3046,12,27,"UPyD",34
48,"48092",792,603,600,5,3,"UPyD",2
36,"36043",5188,3435,3390,35,45,"UPyD",29
31,"31160",111,93,93,7,0,"UPyD",0
25,"25055",187,115,115,3,0,"UPyD",0
38,"38016",1250,664,646,3,18,"UPyD",5
19,"19006",873,634,620,1,14,"UPyD",22
30,"30026",15165,10524,10369,80,155,"UPyD",398
47,"47038",128,91,91,0,0,"UPyD",3
15,"15012",3767,2973,2926,51,47,"UPyD",21
25,"25149",1401,1031,1010,17,21,"UPyD",1
19,"19224",119,95,94,0,1,"UPyD",0
32,"32085",10730,7588,7475,100,113,"UPyD",64
45,"45029",233,207,202,4,5,"UPyD",5
3,"3113",4154,3295,3251,24,44,"UPyD",81
25,"25244",350,270,268,9,2,"UPyD",1
12,"12049",471,366,344,10,22,"UPyD",3
34,"34143",181,142,140,3,2,"UPyD",5
23,"23052",1186,1012,997,1,15,"UPyD",15
46,"46102",19880,15358,15179,122,179,"UPyD",852
19,"19007",460,351,345,5,6,"UPyD",14
27,"27039",4363,3410,3346,63,64,"UPyD",20
17,"17077",580,374,372,5,2,"UPyD",1
37,"37329",40,36,36,2,0,"UPyD",2
19,"19329",62,52,50,0,2,"UPyD",2
18,"18021",16026,11376,11219,186,157,"UPyD",871
17,"17078",346,231,226,3,5,"UPyD",1
31,"31192",148,107,104,1,3,"UPyD",3
37,"37140",731,490,475,0,15,"UPyD",34
47,"47013",118,97,97,2,0,"UPyD",3
47,"47121",590,495,490,4,5,"UPyD",9
22,"22032",120,78,73,5,5,"UPyD",6
44,"44178",69,45,44,0,1,"UPyD",0
16,"16274",147,125,125,1,0,"UPyD",0
42,"42113",553,412,404,7,8,"UPyD",17
9,"9289",1540,1127,1117,16,10,"UPyD",42
37,"37102",430,323,322,1,1,"UPyD",9
34,"34102",226,187,185,3,2,"UPyD",5
26,"26089",108356,81446,80090,1450,1356,"UPyD",6217
19,"19009",253,187,184,0,3,"UPyD",1
31,"31072",5098,3764,3698,75,66,"UPyD",84
33,"33066",42885,29326,29013,460,313,"UPyD",1259
18,"18022",12448,8777,8659,111,118,"UPyD",461
22,"22078",468,302,301,8,1,"UPyD",15
5,"5075",100,76,76,1,0,"UPyD",2
46,"46031",10580,7900,7809,87,91,"UPyD",280
11,"11002",4291,3388,3374,19,14,"UPyD",11
22,"22036",101,82,82,1,0,"UPyD",1
26,"26091",165,139,139,0,0,"UPyD",2
5,"5903",171,118,118,0,0,"UPyD",5
5,"5173",62,55,55,1,0,"UPyD",6
19,"19010",15,13,13,1,0,"UPyD",0
37,"37332",78,52,49,0,3,"UPyD",1
28,"28099",1670,1258,1246,9,12,"UPyD",93
47,"47123",456,356,353,10,3,"UPyD",12
14,"14001",3633,3095,3064,25,31,"UPyD",48
44,"44181",82,63,63,3,0,"UPyD",1
34,"34241",20,12,11,0,1,"UPyD",0
37,"37218",81,51,51,1,0,"UPyD",2
19,"19228",39,30,29,0,1,"UPyD",0
16,"16007",1272,1056,1051,7,5,"UPyD",18
5,"5077",205,164,160,2,4,"UPyD",1
13,"13004",1130,937,923,6,14,"UPyD",11
5,"5174",81,71,71,1,0,"UPyD",6
48,"48076",294,226,226,0,0,"UPyD",0
44,"44182",216,173,173,4,0,"UPyD",4
47,"47042",63,50,49,3,1,"UPyD",0
40,"40905",143,103,103,1,0,"UPyD",5
50,"50041",21,13,13,0,0,"UPyD",1
1,"1011",245,189,185,7,4,"UPyD",2
46,"46057",483,357,349,9,8,"UPyD",9
19,"19261",42,31,31,1,0,"UPyD",1
47,"47125",55,46,46,0,0,"UPyD",1
49,"49071",822,558,557,5,1,"UPyD",12
9,"9476",67,52,52,0,0,"UPyD",2
42,"42119",192,124,123,0,1,"UPyD",2
3,"3118",2368,1746,1718,16,28,"UPyD",64
12,"12055",112,79,78,3,1,"UPyD",2
19,"19229",83,71,68,0,3,"UPyD",1
50,"50042",16,14,14,0,0,"UPyD",0
44,"44183",78,49,46,0,3,"UPyD",0
50,"50131",243,185,183,6,2,"UPyD",1
5,"5175",190,149,149,2,0,"UPyD",5
19,"19333",142,86,84,0,2,"UPyD",0
23,"23059",5974,4910,4852,37,58,"UPyD",130
30,"30032",2839,2361,2337,21,24,"UPyD",46
48,"48067",1204,895,892,4,3,"UPyD",0
45,"45036",704,559,537,4,22,"UPyD",13
30,"30006",823,719,711,5,8,"UPyD",25
4,"4009",165,124,122,2,2,"UPyD",4
46,"46107",1998,1650,1623,8,27,"UPyD",54
44,"44105",82,63,63,2,0,"UPyD",0
44,"44184",34,21,21,2,0,"UPyD",0
8,"8094",1500,1102,1071,21,31,"UPyD",7
46,"46035",6470,5115,5047,38,68,"UPyD",274
17,"17174",183,120,117,5,3,"UPyD",1
15,"15018",1211,821,805,11,16,"UPyD",4
16,"16901",793,590,582,2,8,"UPyD",17
42,"42070",45,29,28,0,1,"UPyD",1
22,"22239",90,76,76,2,0,"UPyD",0
16,"16051",166,140,140,1,0,"UPyD",0
28,"28056",782,604,586,6,18,"UPyD",41
6,"6049",1088,847,829,3,18,"UPyD",2
37,"37224",216,190,186,5,4,"UPyD",2
11,"11007",17997,10781,10676,184,105,"UPyD",243
49,"49257",277,180,179,0,1,"UPyD",7
17,"17901",964,628,621,16,7,"UPyD",2
10,"10191",527,421,414,3,7,"UPyD",11
43,"43003",307,187,184,10,3,"UPyD",1
9,"9213",370,260,260,5,0,"UPyD",10
40,"40105",60,51,51,1,0,"UPyD",4
9,"9076",24,15,15,0,0,"UPyD",0
13,"13008",473,362,360,4,2,"UPyD",3
12,"12057",650,530,515,6,15,"UPyD",12
6,"6141",1803,1419,1397,23,22,"UPyD",15
48,"48004",329,240,239,2,1,"UPyD",0
20,"20001",249,167,167,4,0,"UPyD",0
11,"11008",16655,11309,11189,184,120,"UPyD",513
17,"17085",295,212,208,12,4,"UPyD",2
47,"47209",43,33,33,0,0,"UPyD",2
46,"46260",2576,2140,2106,24,34,"UPyD",119
22,"22086",207,149,147,1,2,"UPyD",12
45,"45040",1504,1058,1046,5,12,"UPyD",39
22,"22045",104,83,80,2,3,"UPyD",3
34,"34902",146,121,121,1,0,"UPyD",7
37,"37114",92,75,74,1,1,"UPyD",1
50,"50046",201,155,153,2,2,"UPyD",1
41,"41003",2196,1803,1782,21,21,"UPyD",53
37,"37340",155,121,121,0,0,"UPyD",2
31,"31171",738,521,495,7,26,"UPyD",3
8,"8191",5520,3601,3536,64,65,"UPyD",13
45,"45041",3617,2672,2635,21,37,"UPyD",149
31,"31263",241,135,132,0,3,"UPyD",0
3,"3123",7435,5860,5744,63,116,"UPyD",300
14,"14007",15871,11609,11477,121,132,"UPyD",447
25,"25067",768,498,494,14,4,"UPyD",4
31,"31141",132,100,98,1,2,"UPyD",2
18,"18098",6440,4743,4679,44,64,"UPyD",95
19,"19170",214,139,138,0,1,"UPyD",3
50,"50047",60,34,34,2,0,"UPyD",1
45,"45005",267,223,218,4,5,"UPyD",7
40,"40201",48,48,48,2,0,"UPyD",3
19,"19201",70,52,52,2,0,"UPyD",4
38,"38029",1456,732,715,4,17,"UPyD",11
36,"36056",5087,3883,3830,37,53,"UPyD",13
43,"43152",472,355,351,9,4,"UPyD",0
17,"17207",2357,1636,1584,40,52,"UPyD",0
9,"9216",390,278,272,2,6,"UPyD",17
10,"10115",3622,2872,2800,52,72,"UPyD",86
24,"24086",323,245,243,1,2,"UPyD",2
28,"28107",443,338,333,7,5,"UPyD",40
44,"44192",401,324,322,5,2,"UPyD",10
46,"46038",368,264,260,1,4,"UPyD",6
19,"19020",52,39,39,3,0,"UPyD",0
9,"9001",29,25,25,0,0,"UPyD",1
34,"34074",764,610,597,11,13,"UPyD",18
46,"46014",3092,2449,2420,26,29,"UPyD",148
18,"18134",5528,3751,3679,57,72,"UPyD",234
24,"24087",670,513,513,12,0,"UPyD",13
45,"45045",1313,992,979,12,13,"UPyD",39
19,"19134",22,14,14,0,0,"UPyD",0
40,"40111",72,57,55,0,2,"UPyD",8
47,"47049",94,71,71,1,0,"UPyD",0
20,"20006",277,177,175,6,2,"UPyD",0
46,"46263",333,243,241,2,2,"UPyD",4
37,"37032",530,410,409,4,1,"UPyD",30
50,"50078",278,210,208,2,2,"UPyD",1
13,"13014",565,457,452,3,5,"UPyD",5
34,"34121",208,153,152,0,1,"UPyD",8
44,"44066",121,88,86,0,2,"UPyD",3
21,"21023",2106,1471,1456,7,15,"UPyD",24
16,"16146",96,74,70,0,4,"UPyD",7
33,"33074",3699,2643,2611,30,32,"UPyD",26
5,"5183",165,142,140,0,2,"UPyD",4
43,"43154",136,97,96,6,1,"UPyD",1
8,"8286",2865,1843,1796,30,47,"UPyD",16
22,"22203",92,79,79,0,0,"UPyD",5
49,"49223",770,606,601,8,5,"UPyD",6
18,"18034",510,377,375,2,2,"UPyD",6
22,"22249",110,83,81,0,2,"UPyD",5
50,"50051",886,677,671,9,6,"UPyD",8
6,"6013",283,245,244,1,1,"UPyD",7
22,"22064",184,139,137,3,2,"UPyD",6
25,"25225",603,395,387,7,8,"UPyD",0
43,"43106",878,600,592,17,8,"UPyD",0
36,"36060",30264,21398,21051,344,347,"UPyD",233
46,"46114",565,501,495,3,6,"UPyD",20
22,"22096",301,239,237,8,2,"UPyD",15
16,"16192",54,37,37,1,0,"UPyD",0
48,"48010",427,303,300,2,3,"UPyD",0
26,"26024",273,220,219,2,1,"UPyD",2
45,"45157",2097,1519,1499,15,20,"UPyD",75
40,"40020",200,155,149,2,6,"UPyD",6
46,"46138",338,297,296,1,1,"UPyD",9
43,"43155",22951,14114,13856,326,258,"UPyD",91
17,"17183",261,178,176,2,2,"UPyD",1
5,"5185",109,89,89,1,0,"UPyD",6
50,"50902",97,85,85,1,0,"UPyD",5
6,"6152",1327,983,967,8,16,"UPyD",35
47,"47134",186,155,149,2,6,"UPyD",3
29,"29043",2596,1670,1647,24,23,"UPyD",65
40,"40208",828,650,638,7,12,"UPyD",35
44,"44198",205,160,160,5,0,"UPyD",4
33,"33077",1351,938,931,7,7,"UPyD",10
47,"47052",6207,4812,4761,79,51,"UPyD",427
43,"43156",4120,2811,2741,66,70,"UPyD",6
14,"14013",17006,13114,12958,166,156,"UPyD",506
11,"11901",5576,4433,4398,69,35,"UPyD",113
31,"31177",264,162,158,3,4,"UPyD",6
49,"49269",241,171,170,5,1,"UPyD",5
9,"9223",46,40,40,0,0,"UPyD",2
20,"20010",1392,949,941,8,8,"UPyD",3
19,"19139",32,23,23,0,0,"UPyD",0
9,"9360",37,29,29,0,0,"UPyD",2
3,"3030",522,464,453,6,11,"UPyD",6
36,"36901",4085,3285,3235,21,50,"UPyD",19
48,"48079",470,391,391,2,0,"UPyD",0
45,"45050",508,385,378,0,7,"UPyD",15
14,"14014",2610,2160,2125,19,35,"UPyD",50
42,"42087",48,38,37,1,1,"UPyD",3
20,"20011",1700,1265,1258,11,7,"UPyD",6
6,"6064",900,715,706,2,9,"UPyD",6
17,"17185",2273,1416,1379,32,37,"UPyD",2
9,"9445",46,31,31,1,0,"UPyD",2
40,"40072",170,134,132,1,2,"UPyD",9
51,"51001",58533,32223,31745,498,478,"UPyD",1059
18,"18038",1097,906,900,3,6,"UPyD",20
37,"37002",152,90,89,1,1,"UPyD",4
46,"46117",476,377,373,6,4,"UPyD",34
43,"43011",1013,745,729,21,16,"UPyD",2
48,"48080",10161,6901,6815,95,86,"UPyD",94
33,"33078",159,108,106,1,2,"UPyD",2
39,"39013",561,413,412,2,1,"UPyD",5
16,"16250",94,71,71,0,0,"UPyD",2
28,"28021",418,334,328,4,6,"UPyD",26
22,"22901",792,515,508,13,7,"UPyD",16
9,"9091",746,556,550,8,6,"UPyD",20
14,"14016",1406,1123,1115,9,8,"UPyD",26
5,"5093",431,330,329,1,1,"UPyD",13
37,"37003",134,103,102,0,1,"UPyD",1
48,"48048",547,423,423,5,0,"UPyD",0
39,"39092",1030,753,747,1,6,"UPyD",10
38,"38005",5327,3316,3270,38,46,"UPyD",48
47,"47082",816,664,661,10,3,"UPyD",23
14,"14047",1566,1154,1143,19,11,"UPyD",70
8,"8108",4879,3475,3437,64,38,"UPyD",32
47,"47056",90,69,69,2,0,"UPyD",5
16,"16029",114,80,80,0,0,"UPyD",5
46,"46045",1288,1065,1044,2,21,"UPyD",44
35,"35008",6151,4514,4419,59,95,"UPyD",81
37,"37004",31,23,23,0,0,"UPyD",0
18,"18175",11534,8772,8698,68,74,"UPyD",370
18,"18143",949,722,704,2,18,"UPyD",26
22,"22903",672,555,547,6,8,"UPyD",10
34,"34223",233,175,175,2,0,"UPyD",3
9,"9228",168,143,143,3,0,"UPyD",6
10,"10128",5805,4456,4336,50,120,"UPyD",90
26,"26073",100,85,84,1,1,"UPyD",1
19,"19110",73,59,57,4,2,"UPyD",2
34,"34087",108,88,87,1,1,"UPyD",2
49,"49006",168,124,122,2,2,"UPyD",5
47,"47083",80,61,59,3,2,"UPyD",3
16,"16071",25,23,23,0,0,"UPyD",0
22,"22163",431,353,344,5,9,"UPyD",35
33,"33035",11413,8105,8035,104,70,"UPyD",311
42,"42093",56,39,38,0,1,"UPyD",1
50,"50058",80,65,64,0,1,"UPyD",2
22,"22214",131,101,100,2,1,"UPyD",1
37,"37242",99,73,72,0,1,"UPyD",1
10,"10007",680,537,519,5,18,"UPyD",6
37,"37355",187,142,140,2,2,"UPyD",7
8,"8049",1340,839,816,10,23,"UPyD",2
25,"25077",474,281,277,5,4,"UPyD",0
34,"34049",421,313,311,4,2,"UPyD",7
25,"25204",1313,888,881,21,7,"UPyD",0
50,"50068",2082,1514,1481,18,33,"UPyD",27
6,"6026",865,671,665,4,6,"UPyD",9
3,"3138",3218,2403,2388,22,15,"UPyD",55
34,"34005",899,707,698,8,9,"UPyD",20
18,"18177",463,285,281,4,4,"UPyD",2
14,"14050",2418,1983,1966,23,17,"UPyD",26
17,"17037",105,66,66,2,0,"UPyD",0
50,"50235",2371,1723,1701,36,22,"UPyD",79
13,"13025",321,257,254,1,3,"UPyD",1
43,"43162",4143,2892,2833,59,59,"UPyD",54
41,"41041",9646,7901,7791,58,110,"UPyD",275
22,"22907",1444,1034,1018,12,16,"UPyD",51
36,"36003",9876,7155,7007,100,148,"UPyD",108
20,"20054",476,350,348,1,2,"UPyD",0
31,"31063",96,77,75,0,2,"UPyD",1
44,"44002",62,47,47,1,0,"UPyD",2
10,"10172",728,531,522,3,9,"UPyD",14
39,"39095",2292,1824,1801,24,23,"UPyD",26
29,"29068",6209,4025,3983,41,42,"UPyD",126
24,"24224",665,490,484,8,6,"UPyD",11
20,"20019",10105,6640,6555,73,85,"UPyD",51
31,"31094",123,100,97,3,3,"UPyD",2
19,"19249",38,32,32,0,0,"UPyD",0
9,"9231",77,42,42,0,0,"UPyD",1
42,"42155",188,121,120,0,1,"UPyD",3
16,"16173",249,189,188,0,1,"UPyD",2
20,"20032",8949,6189,6117,55,72,"UPyD",57
9,"9415",290,192,192,4,0,"UPyD",15
8,"8031",2289,1619,1599,34,20,"UPyD",6
5,"5065",498,424,422,7,2,"UPyD",25
46,"46025",2495,1962,1941,24,21,"UPyD",134
47,"47060",262,220,218,1,2,"UPyD",12
22,"22220",192,138,136,5,2,"UPyD",7
44,"44041",67,56,51,1,5,"UPyD",0
19,"19250",25,23,22,0,1,"UPyD",0
43,"43090",1142,644,636,7,8,"UPyD",8
8,"8022",12437,7598,7445,169,153,"UPyD",18
50,"50265",63,46,46,1,0,"UPyD",4
25,"25912",899,643,640,6,3,"UPyD",6
34,"34053",222,177,172,4,5,"UPyD",3
50,"50237",103,76,75,0,1,"UPyD",4
11,"11023",9209,6979,6929,81,50,"UPyD",179
45,"45170",257,186,183,0,3,"UPyD",2
40,"40083",88,72,72,1,0,"UPyD",3
36,"36006",11387,8911,8727,72,184,"UPyD",66
5,"5066",480,397,392,5,5,"UPyD",10
37,"37012",155,124,120,1,4,"UPyD",4
46,"46147",16527,11836,11716,105,120,"UPyD",491
31,"31096",127,112,110,2,2,"UPyD",0
25,"25174",438,289,283,4,6,"UPyD",0
28,"28069",51,35,33,1,2,"UPyD",1
16,"16038",50,40,40,0,0,"UPyD",2
40,"40134",769,628,620,19,8,"UPyD",40
3,"3902",9578,7085,7007,65,78,"UPyD",312
46,"46051",8122,6432,6378,57,54,"UPyD",257
10,"10136",289,229,228,0,1,"UPyD",6
44,"44212",45,35,35,0,0,"UPyD",0
6,"6033",1387,1075,1068,6,7,"UPyD",15
2,"2022",431,346,343,1,3,"UPyD",2
46,"46197",1902,1559,1554,15,5,"UPyD",36
25,"25082",265,156,155,8,1,"UPyD",0
37,"37361",91,67,62,0,5,"UPyD",0
29,"29071",915,601,598,4,3,"UPyD",9
44,"44256",37,35,35,9,0,"UPyD",1
32,"32009",10752,7778,7684,120,94,"UPyD",80
5,"5198",80,65,65,1,0,"UPyD",2
8,"8300",5621,4021,3933,94,88,"UPyD",48
43,"43165",624,471,459,6,12,"UPyD",2
22,"22225",2784,1839,1805,42,34,"UPyD",59
17,"17194",93,55,55,1,0,"UPyD",1
7,"7005",6331,4128,4058,76,70,"UPyD",139
8,"8055",476,312,304,11,8,"UPyD",4
29,"29901",41445,27372,27158,295,214,"UPyD",1800
17,"17224",355,246,241,10,5,"UPyD",1
26,"26083",303,234,234,1,0,"UPyD",4
43,"43093",3924,2507,2445,62,62,"UPyD",18
50,"50065",59,37,37,2,0,"UPyD",0
24,"24229",473,348,344,8,4,"UPyD",9
8,"8117",2424,1685,1661,45,24,"UPyD",2
11,"11026",4834,3736,3691,27,45,"UPyD",145
20,"20025",1174,814,803,4,11,"UPyD",1
8,"8025",1460,990,963,14,27,"UPyD",8
50,"50154",129,98,97,1,1,"UPyD",5
49,"49018",341,281,279,5,2,"UPyD",6
32,"32048",1004,687,671,48,16,"UPyD",3
26,"26084",5999,4440,4399,56,41,"UPyD",343
47,"47199",84,61,60,1,1,"UPyD",1
5,"5072",91,72,72,1,0,"UPyD",4
47,"47064",30,21,21,1,0,"UPyD",0
16,"16167",357,318,315,5,3,"UPyD",7
29,"29902",2577,1689,1665,20,24,"UPyD",36
22,"22075",150,103,101,7,2,"UPyD",2
17,"17196",209,139,138,6,1,"UPyD",0
26,"26004",82,64,64,1,0,"UPyD",3
37,"37252",127,92,92,0,0,"UPyD",0
34,"34019",139,108,108,5,0,"UPyD",5
37,"37017",249,200,199,0,1,"UPyD",8
9,"9381",38,30,30,0,0,"UPyD",1
50,"50155",119,91,91,1,0,"UPyD",6
46,"46224",179,131,128,0,3,"UPyD",3
45,"45067",2385,1923,1878,19,45,"UPyD",61
47,"47228",481,385,383,3,2,"UPyD",12
5,"5234",58,49,49,0,0,"UPyD",3
48,"48094",3299,2398,2377,15,21,"UPyD",14
19,"19257",3595,2593,2543,48,50,"UPyD",105
31,"31101",1305,892,874,15,18,"UPyD",9
3,"3045",233,204,203,2,1,"UPyD",8
35,"35017",22331,13463,13144,217,319,"UPyD",278
17,"17197",144,103,102,3,1,"UPyD",1
8,"8058",1699,1089,1061,25,28,"UPyD",9
14,"14058",8116,6274,6215,76,59,"UPyD",224
8,"8008",193,119,114,5,5,"UPyD",0
5,"5901",289,197,196,4,1,"UPyD",13
33,"33027",929,617,613,5,4,"UPyD",12
46,"46079",381,304,299,3,5,"UPyD",10
40,"40141",881,658,647,9,11,"UPyD",40
47,"47093",865,658,642,11,16,"UPyD",19
5,"5074",755,639,638,5,1,"UPyD",26
40,"40047",47,37,36,0,1,"UPyD",2
8,"8029",3389,2542,2514,45,28,"UPyD",12
3,"3046",1530,1136,1121,11,15,"UPyD",73
9,"9258",190,159,159,5,0,"UPyD",7
8,"8213",6188,4031,3970,113,61,"UPyD",17
13,"13035",1043,794,770,10,24,"UPyD",17
29,"29003",1133,902,900,5,2,"UPyD",21
9,"9384",310,223,218,3,5,"UPyD",8
26,"26048",29,27,26,1,1,"UPyD",4
19,"19258",103,81,81,0,0,"UPyD",0
23,"23099",4649,3638,3594,39,44,"UPyD",97
46,"46201",83,50,49,0,1,"UPyD",1
39,"39026",1825,1383,1371,12,12,"UPyD",22
33,"33021",4932,3544,3502,45,42,"UPyD",74
11,"11030",22528,14741,14557,195,184,"UPyD",652
16,"16172",413,330,318,1,12,"UPyD",6
31,"31194",308,212,210,6,2,"UPyD",6
47,"47067",198,159,156,5,3,"UPyD",5
16,"16046",262,191,191,1,0,"UPyD",10
46,"46056",203,164,160,2,4,"UPyD",4
44,"44221",377,305,297,6,8,"UPyD",10
47,"47230",318,266,259,2,7,"UPyD",14
49,"49249",78,63,63,0,0,"UPyD",1
46,"46129",553,430,423,4,7,"UPyD",13
42,"42117",146,115,111,1,4,"UPyD",5
8,"8122",1755,1063,1034,17,29,"UPyD",8
46,"46202",15578,11811,11676,110,135,"UPyD",784
17,"17110",1359,930,917,12,13,"UPyD",5
47,"47132",45,40,40,0,0,"UPyD",2
37,"37169",196,137,136,1,1,"UPyD",4
50,"50070",70,42,41,0,1,"UPyD",0
20,"20080",8104,5497,5454,52,43,"UPyD",61
32,"32018",1351,1100,1092,9,8,"UPyD",1
19,"19049",19,11,11,0,0,"UPyD",0
11,"11004",87610,53062,52639,828,423,"UPyD",2576
17,"17201",131,89,89,2,0,"UPyD",0
1,"1060",223,181,178,1,3,"UPyD",6
40,"40005",34,32,31,1,1,"UPyD",0
37,"37258",206,151,149,2,2,"UPyD",2
45,"45183",2189,1537,1514,10,23,"UPyD",103
47,"47096",139,109,107,0,2,"UPyD",3
44,"44102",30,29,28,0,1,"UPyD",0
37,"37296",385,311,308,3,3,"UPyD",4
49,"49026",236,189,184,3,5,"UPyD",4
37,"37259",44,32,32,3,0,"UPyD",0
37,"37024",101,80,80,0,0,"UPyD",2
26,"26012",17,15,15,1,0,"UPyD",0
43,"43172",378,268,266,8,2,"UPyD",0
46,"46258",2792,2196,2164,14,32,"UPyD",92
24,"24116",451,297,294,5,3,"UPyD",12
3,"3051",356,314,311,2,3,"UPyD",2
12,"12088",55,51,51,2,0,"UPyD",0
29,"29006",721,516,508,5,8,"UPyD",14
10,"10149",434,323,319,1,4,"UPyD",7
16,"16280",205,177,175,1,2,"UPyD",3
3,"3084",593,518,513,2,5,"UPyD",6
42,"42121",77,56,56,1,0,"UPyD",0
22,"22042",115,93,91,1,2,"UPyD",4
8,"8901",249,180,180,2,0,"UPyD",3
36,"36051",14288,10228,10079,124,149,"UPyD",66
31,"31167",859,600,593,11,7,"UPyD",8
17,"17114",22610,14079,13811,263,268,"UPyD",31
5,"5012",156,134,132,1,2,"UPyD",3
17,"17023",26941,17098,16799,344,299,"UPyD",141
31,"31198",38,33,33,0,0,"UPyD",0
24,"24161",307,231,228,1,3,"UPyD",6
46,"46156",2065,1746,1721,14,25,"UPyD",29
50,"50191",505,395,390,4,5,"UPyD",6
42,"42026",25,16,16,0,0,"UPyD",0
22,"22242",75,53,52,0,1,"UPyD",0
13,"13041",298,225,225,1,0,"UPyD",6
8,"8035",12099,7838,7735,123,103,"UPyD",60
37,"37026",201,176,176,3,0,"UPyD",0
4,"4081",367,312,309,0,3,"UPyD",2
41,"41095",40097,27969,27731,354,238,"UPyD",1696
5,"5145",57,41,41,0,0,"UPyD",1
9,"9302",116,87,87,3,0,"UPyD",3
47,"47019",93,69,68,0,1,"UPyD",1
18,"18162",947,726,721,8,5,"UPyD",10
37,"37262",81,66,64,2,2,"UPyD",2
3,"3053",7082,5754,5664,60,90,"UPyD",244
34,"34071",186,160,160,1,0,"UPyD",4
42,"42125",73,65,64,4,1,"UPyD",3
9,"9392",51,42,42,1,0,"UPyD",0
11,"11036",725,484,482,10,2,"UPyD",7
50,"50074",6516,4378,4222,77,156,"UPyD",208
17,"17147",8385,5401,5325,105,76,"UPyD",12
26,"26101",46,35,34,0,1,"UPyD",0
44,"44061",89,55,55,1,0,"UPyD",2
49,"49079",110,93,92,2,1,"UPyD",2
2,"2037",22380,15942,15724,203,218,"UPyD",638
45,"45188",2883,2180,2151,30,29,"UPyD",137
15,"15049",1211,851,843,7,8,"UPyD",2
16,"16055",698,485,481,8,4,"UPyD",25
43,"43102",517,377,366,2,11,"UPyD",1
43,"43175",590,419,411,8,8,"UPyD",1
44,"44109",123,86,84,2,2,"UPyD",1
37,"37376",2373,1720,1700,23,20,"UPyD",75
3,"3055",5128,4121,4076,43,45,"UPyD",116
49,"49260",814,653,644,6,9,"UPyD",15
25,"25191",353,234,227,5,7,"UPyD",1
7,"7019",230,165,164,1,1,"UPyD",3
17,"17903",893,565,556,14,9,"UPyD",8
30,"30010",6804,5691,5647,36,44,"UPyD",179
50,"50019",79,57,55,1,2,"UPyD",2
6,"6054",5468,4305,4185,35,120,"UPyD",79
22,"22088",171,133,128,5,5,"UPyD",3
4,"4051",476,406,400,3,6,"UPyD",16
34,"34073",184,153,152,7,1,"UPyD",4
10,"10114",926,670,652,8,18,"UPyD",14
49,"49033",761,563,556,9,7,"UPyD",15
50,"50077",254,189,188,4,1,"UPyD",7
8,"8017",2740,1800,1768,38,32,"UPyD",5
50,"50076",113,89,89,0,0,"UPyD",2
48,"48909",194,163,163,0,0,"UPyD",0
31,"31202",4247,3014,2957,69,57,"UPyD",63
40,"40031",515,410,404,7,6,"UPyD",38
8,"8223",1855,1178,1155,19,23,"UPyD",9
37,"37378",118,85,85,3,0,"UPyD",5
44,"44112",473,353,350,4,3,"UPyD",5
23,"23025",2845,2292,2271,17,21,"UPyD",19
42,"42079",32,25,25,0,0,"UPyD",1
8,"8283",5862,3712,3618,72,94,"UPyD",13
3,"3091",256,220,219,1,1,"UPyD",6
17,"17159",639,408,397,3,11,"UPyD",2
34,"34035",122,98,96,0,2,"UPyD",2
41,"41032",4059,3122,3062,22,60,"UPyD",106
13,"13046",786,654,644,2,10,"UPyD",5
7,"7021",255,197,193,1,4,"UPyD",2
21,"21053",3278,2363,2325,20,38,"UPyD",29
44,"44113",79,57,55,0,2,"UPyD",2
19,"19059",84,60,60,0,0,"UPyD",1
17,"17058",177,115,114,2,1,"UPyD",0
19,"19102",122,101,100,0,1,"UPyD",2
50,"50108",50,31,31,0,0,"UPyD",4
39,"39009",3200,2427,2402,24,25,"UPyD",57
11,"11012",103946,68124,67375,856,749,"UPyD",4558
40,"40063",7290,5366,5171,68,195,"UPyD",316
40,"40018",102,88,87,2,1,"UPyD",4
26,"26023",505,386,380,6,6,"UPyD",15
6,"6058",2048,1595,1574,22,21,"UPyD",35
48,"48911",373,300,296,1,4,"UPyD",0
22,"22095",87,61,61,1,0,"UPyD",2
29,"29013",1718,1302,1283,4,19,"UPyD",42
45,"45083",421,353,345,0,8,"UPyD",12
43,"43178",1262,891,870,24,21,"UPyD",12
46,"46137",273,232,229,1,3,"UPyD",2
22,"22149",321,244,241,5,3,"UPyD",11
34,"34122",80,65,62,2,3,"UPyD",3
31,"31155",264,187,183,7,4,"UPyD",5
31,"31135",116,87,86,9,1,"UPyD",2
1,"1028",1106,773,760,8,13,"UPyD",27
42,"42023",78,58,58,1,0,"UPyD",2
17,"17121",230,159,158,7,1,"UPyD",0
37,"37382",202,172,171,3,1,"UPyD",0
3,"3094",8442,6105,6053,70,52,"UPyD",384
19,"19306",42,31,31,1,0,"UPyD",0
40,"40068",39,32,32,0,0,"UPyD",1
43,"43901",8849,5651,5540,179,111,"UPyD",10
2,"2044",1207,908,893,5,15,"UPyD",25
9,"9085",486,348,339,8,9,"UPyD",25
49,"49130",218,159,156,3,3,"UPyD",7
25,"25196",127,87,86,3,1,"UPyD",2
8,"8042",2172,1459,1448,30,11,"UPyD",8
43,"43107",378,255,248,18,7,"UPyD",0
16,"16063",97,81,81,0,0,"UPyD",0
37,"37159",100,77,75,0,2,"UPyD",0
46,"46904",782,659,650,6,9,"UPyD",32
47,"47161",3886,3133,3105,45,28,"UPyD",301
47,"47079",67,56,56,1,0,"UPyD",3
47,"47187",101,82,81,1,1,"UPyD",1
46,"46139",4594,3794,3734,28,60,"UPyD",109
18,"18068",1456,1105,1088,13,17,"UPyD",58
24,"24131",813,583,580,9,3,"UPyD",4
38,"38002",991,716,708,1,8,"UPyD",3
42,"42190",102,71,71,3,0,"UPyD",2
22,"22252",130,98,96,5,2,"UPyD",4
26,"26067",22,19,19,1,0,"UPyD",0
20,"20046",1157,734,729,6,5,"UPyD",4
19,"19176",280,216,216,0,0,"UPyD",11
12,"12099",583,485,465,3,20,"UPyD",2
34,"34169",431,331,329,5,2,"UPyD",12
47,"47080",45,39,39,1,0,"UPyD",0
34,"34042",299,249,246,5,3,"UPyD",8
8,"8228",303,230,227,5,3,"UPyD",1
22,"22254",1175,868,856,14,12,"UPyD",8
43,"43903",2368,1504,1492,22,12,"UPyD",3
12,"12100",1380,1124,1109,11,15,"UPyD",19
19,"19065",126,100,100,3,0,"UPyD",2
5,"5220",386,316,312,0,4,"UPyD",9
45,"45014",4087,2851,2816,36,35,"UPyD",135
17,"17212",129,100,98,4,2,"UPyD",0
33,"33055",1589,1212,1192,16,20,"UPyD",22
5,"5253",95,75,74,0,1,"UPyD",1
10,"10204",489,364,351,3,13,"UPyD",10
37,"37038",808,671,664,6,7,"UPyD",18
46,"46214",15129,11609,11500,116,109,"UPyD",779
43,"43035",280,202,198,0,4,"UPyD",0
13,"13052",6580,4869,4786,76,83,"UPyD",139
37,"37274",123032,90819,89629,1506,1190,"UPyD",7075
47,"47002",30,27,27,1,0,"UPyD",0
10,"10043",866,636,622,1,14,"UPyD",14
33,"33033",10609,7179,7107,91,72,"UPyD",156
17,"17065",316,211,205,6,6,"UPyD",0
19,"19108",117,97,95,0,2,"UPyD",3
22,"22106",25,17,17,0,0,"UPyD",2
20,"20049",4081,2741,2723,30,18,"UPyD",12
9,"9409",138,105,102,0,3,"UPyD",4
40,"40026",114,98,97,2,1,"UPyD",13
45,"45015",624,485,480,2,5,"UPyD",21
50,"50211",277,193,193,1,0,"UPyD",1
18,"18117",535,444,440,2,4,"UPyD",6
42,"42044",62,47,46,0,1,"UPyD",1
12,"12036",668,529,514,6,15,"UPyD",5
44,"44035",122,99,98,3,1,"UPyD",7
49,"49005",156,102,101,2,1,"UPyD",2
40,"40028",106,89,88,1,1,"UPyD",4
8,"8231",19810,12359,12196,244,163,"UPyD",193
18,"18910",832,601,594,6,7,"UPyD",10
19,"19279",66,56,56,0,0,"UPyD",3
24,"24137",1226,920,904,16,16,"UPyD",15
40,"40076",6641,4958,4862,67,96,"UPyD",350
12,"12003",1058,830,813,15,17,"UPyD",21
9,"9055",55,46,44,0,2,"UPyD",2
23,"23038",3273,2658,2638,29,20,"UPyD",108
46,"46021",23273,17264,17091,163,173,"UPyD",1071
8,"8232",1793,1239,1220,20,19,"UPyD",2
35,"35034",6372,2951,2921,33,30,"UPyD",81
28,"28065",118796,93292,92186,919,1106,"UPyD",9796
48,"48083",7021,4722,4656,74,66,"UPyD",44
9,"9365",38,27,27,0,0,"UPyD",0
19,"19071",7346,5380,5294,76,86,"UPyD",514
50,"50176",237,161,160,4,1,"UPyD",3
4,"4026",75,58,58,0,0,"UPyD",0
50,"50086",193,109,109,0,0,"UPyD",4
5,"5258",123,105,104,1,1,"UPyD",2
42,"42151",38,32,29,0,3,"UPyD",5
44,"44064",93,63,62,0,1,"UPyD",1
7,"7031",23371,14443,14213,285,230,"UPyD",712
29,"29021",153,113,113,0,0,"UPyD",2
37,"37278",736,538,529,7,9,"UPyD",45
12,"12004",4354,3145,3083,50,62,"UPyD",58
21,"21001",628,434,428,5,6,"UPyD",13
36,"36002",3154,2381,2358,35,23,"UPyD",13
38,"38041",6780,4905,4813,57,92,"UPyD",113
44,"44263",332,249,243,10,6,"UPyD",8
8,"8244",5746,4044,3940,102,104,"UPyD",76
40,"40126",96,80,78,0,2,"UPyD",3
19,"19182",38,24,22,0,2,"UPyD",3
37,"37279",780,580,571,6,9,"UPyD",18
49,"49052",200,149,144,1,5,"UPyD",3
22,"22165",515,409,403,9,6,"UPyD",8
25,"25141",171,111,107,2,4,"UPyD",0
22,"22906",190,152,147,3,5,"UPyD",0
29,"29096",2880,2012,1971,28,41,"UPyD",65
48,"48019",3741,2613,2595,24,18,"UPyD",41
30,"30020",5989,4533,4487,14,46,"UPyD",73
44,"44039",255,189,189,5,0,"UPyD",6
17,"17190",811,548,532,7,16,"UPyD",1
49,"49009",430,309,309,0,0,"UPyD",7
42,"42007",143,110,110,2,0,"UPyD",2
17,"17161",978,693,687,21,6,"UPyD",3
46,"46242",361,288,280,4,8,"UPyD",7
46,"46072",3711,3006,2932,38,74,"UPyD",118
5,"5227",409,307,305,2,2,"UPyD",10
17,"17220",780,550,545,13,5,"UPyD",2
26,"26166",152,139,136,1,3,"UPyD",1
48,"48021",1460,1024,1012,13,12,"UPyD",4
22,"22113",512,357,353,8,4,"UPyD",14
50,"50003",141,108,108,3,0,"UPyD",4
34,"34063",102,92,91,2,1,"UPyD",1
46,"46016",1097,927,917,12,10,"UPyD",13
17,"17143",134,89,87,2,2,"UPyD",2
31,"31074",430,304,303,10,1,"UPyD",0
8,"8062",863,595,583,8,12,"UPyD",4
28,"28092",148714,112174,110838,1215,1336,"UPyD",11839
38,"38044",2325,1550,1532,7,18,"UPyD",12
40,"40222",190,157,156,1,1,"UPyD",7
6,"6121",3436,2700,2662,35,38,"UPyD",54
25,"25050",3249,2056,1988,40,68,"UPyD",8
13,"13060",291,235,229,0,6,"UPyD",7
19,"19185",40,21,19,0,2,"UPyD",2
42,"42156",30,21,21,0,0,"UPyD",7
3,"3901",1070,826,818,14,8,"UPyD",30
42,"42010",19,15,15,1,0,"UPyD",2
16,"16209",153,129,129,0,0,"UPyD",7
26,"26168",5055,3534,3484,47,50,"UPyD",295
17,"17193",3978,2365,2305,38,60,"UPyD",24
40,"40037",47,35,35,0,0,"UPyD",0
50,"50089",6673,4936,4877,120,59,"UPyD",464
8,"8267",6215,4100,4011,82,89,"UPyD",35
33,"33061",446,260,259,1,1,"UPyD",0
16,"16081",64,46,45,1,1,"UPyD",4
4,"4068",187,137,137,1,0,"UPyD",8
13,"13061",5898,4442,4373,56,69,"UPyD",134
50,"50006",978,758,749,16,9,"UPyD",22
33,"33039",1719,1325,1319,14,6,"UPyD",26
24,"24146",284,223,221,0,2,"UPyD",3
4,"4033",161,120,119,1,1,"UPyD",5
44,"44005",59,43,43,1,0,"UPyD",4
17,"17135",380,273,269,9,4,"UPyD",0
42,"42158",112,79,79,6,0,"UPyD",3
25,"25024",370,221,217,8,4,"UPyD",0
23,"23003",8778,6945,6877,51,68,"UPyD",131
46,"46075",166,148,145,3,3,"UPyD",2
20,"20059",8816,6335,6293,32,42,"UPyD",16
44,"44006",293,220,212,3,8,"UPyD",4
38,"38014",1446,1018,1007,8,11,"UPyD",17
17,"17136",173,124,120,0,4,"UPyD",1
49,"49015",259,213,208,2,5,"UPyD",1
40,"40040",2677,1990,1966,24,24,"UPyD",119
17,"17165",608,414,400,9,14,"UPyD",0
49,"49016",272,216,211,1,5,"UPyD",4
21,"21007",6088,4174,4123,57,51,"UPyD",175
26,"26171",212,171,170,6,1,"UPyD",8
47,"47089",184,139,138,1,1,"UPyD",4
19,"19155",61,52,50,1,2,"UPyD",2
8,"8005",5884,4114,4041,68,73,"UPyD",35
31,"31251",3147,2274,2225,39,49,"UPyD",67
48,"48025",882,652,644,2,8,"UPyD",0
3,"3075",160,139,136,2,3,"UPyD",3
50,"50093",113,84,84,2,0,"UPyD",3
10,"10179",340,262,257,3,5,"UPyD",4
49,"49017",264,189,187,1,2,"UPyD",2
33,"33040",4702,3285,3236,44,49,"UPyD",82
7,"7039",4920,3488,3377,54,111,"UPyD",58
36,"36010",2987,2312,2282,30,30,"UPyD",16
13,"13064",1465,1127,1110,21,17,"UPyD",73
9,"9463",261,205,205,1,0,"UPyD",9
16,"16271",659,568,566,4,2,"UPyD",6
10,"10152",499,424,418,4,6,"UPyD",3
9,"9348",150,122,122,2,0,"UPyD",3
8,"8086",13267,8791,8669,200,122,"UPyD",112
44,"44133",21,16,16,0,0,"UPyD",2
50,"50269",316,186,185,1,1,"UPyD",1
46,"46223",7685,6040,5996,62,44,"UPyD",335
9,"9026",384,296,295,8,1,"UPyD",17
8,"8057",61,41,40,1,1,"UPyD",0
8,"8241",80,61,61,1,0,"UPyD",0
9,"9287",201,159,158,4,1,"UPyD",19
22,"22125",38140,26924,26463,676,461,"UPyD",1796
48,"48027",21610,15409,15274,145,135,"UPyD",200
31,"31131",841,610,594,12,16,"UPyD",11
46,"46078",28197,20643,20415,205,228,"UPyD",1242
46,"46029",20887,16124,15988,144,136,"UPyD",722
5,"5138",326,278,275,2,3,"UPyD",9
44,"44010",189,138,138,2,0,"UPyD",4
21,"21010",14308,8960,8861,154,99,"UPyD",283
26,"26046",1617,1237,1219,14,18,"UPyD",46
40,"40045",123,102,102,0,0,"UPyD",9
17,"17139",1346,899,869,21,30,"UPyD",1
39,"39050",305,207,205,1,2,"UPyD",5
25,"25121",623,406,400,6,6,"UPyD",3
4,"4037",1393,1090,1079,8,11,"UPyD",24
42,"42213",31,24,24,2,0,"UPyD",1
9,"9467",65,49,49,0,0,"UPyD",5
24,"24190",183,134,131,1,3,"UPyD",4
12,"12135",35189,25691,25345,380,346,"UPyD",1086
9,"9043",215,151,151,1,0,"UPyD",8
29,"29039",2822,2091,2074,8,17,"UPyD",58
38,"38052",1344,886,872,5,14,"UPyD",7
45,"45031",2773,2011,1975,25,36,"UPyD",92
26,"26006",1853,1456,1430,15,26,"UPyD",71
47,"47040",67,51,50,0,1,"UPyD",1
50,"50128",36,30,29,0,1,"UPyD",0
29,"29049",3137,2365,2352,19,13,"UPyD",61
50,"50107",953,785,780,13,5,"UPyD",20
8,"8151",504,345,338,6,7,"UPyD",0
48,"48030",626,487,483,0,4,"UPyD",0
19,"19293",1860,1407,1373,16,34,"UPyD",137
9,"9159",57,49,48,0,1,"UPyD",0
13,"13903",564,461,454,2,7,"UPyD",7
9,"9425",561,431,418,3,13,"UPyD",13
1,"1058",1342,877,872,8,5,"UPyD",9
43,"43145",3968,2781,2742,52,39,"UPyD",13
7,"7044",8326,6044,5846,99,198,"UPyD",87
32,"32052",2126,1690,1673,28,17,"UPyD",6
47,"47094",154,129,127,0,2,"UPyD",3
37,"37060",229,179,173,2,6,"UPyD",10
37,"37293",131,108,106,5,2,"UPyD",5
44,"44013",11286,7797,7584,242,213,"UPyD",416
9,"9427",1561,1090,1078,18,12,"UPyD",71
45,"45107",3006,2344,2299,32,45,"UPyD",170
9,"9032",118,68,68,0,0,"UPyD",3
31,"31226",597,339,335,2,4,"UPyD",1
20,"20067",31173,20218,20017,270,201,"UPyD",376
44,"44265",203,169,158,6,11,"UPyD",1
34,"34066",66,55,54,0,1,"UPyD",1
22,"22130",9983,6691,6573,148,118,"UPyD",356
48,"48912",2340,1794,1776,22,18,"UPyD",18
8,"8112",12946,8533,8390,227,143,"UPyD",28
16,"16074",53,42,42,1,0,"UPyD",0
25,"25059",796,580,575,9,5,"UPyD",6
25,"25041",625,432,420,20,12,"UPyD",1
12,"12017",183,143,141,6,2,"UPyD",2
42,"42171",158,99,94,3,5,"UPyD",4
24,"24157",2580,2046,2000,39,46,"UPyD",66
12,"12053",2121,1745,1719,11,26,"UPyD",20
12,"12097",78,59,59,4,0,"UPyD",8
40,"40193",231,188,185,6,3,"UPyD",10
9,"9034",301,250,250,3,0,"UPyD",10
43,"43049",805,555,536,6,19,"UPyD",1
23,"23058",8497,6642,6591,44,51,"UPyD",242
44,"44143",382,292,292,5,0,"UPyD",5
14,"14063",1121,875,866,9,9,"UPyD",8
39,"39080",3627,2743,2693,19,50,"UPyD",55
19,"19091",30,22,22,2,0,"UPyD",0
28,"28033",3581,2712,2691,14,21,"UPyD",237
37,"37063",94,77,76,3,1,"UPyD",7
49,"49027",178,134,127,1,7,"UPyD",2
12,"12018",326,274,265,1,9,"UPyD",2
50,"50014",169,108,108,1,0,"UPyD",0
19,"19298",75,53,52,2,1,"UPyD",3
37,"37297",441,376,369,1,7,"UPyD",19
37,"37184",381,295,289,5,6,"UPyD",8
7,"7047",2161,1447,1407,31,40,"UPyD",45
34,"34028",154,128,126,1,2,"UPyD",4
37,"37372",145,109,109,0,0,"UPyD",5
35,"35022",43892,27289,26876,326,413,"UPyD",426
22,"22236",266,213,213,3,0,"UPyD",4
11,"11006",24221,16564,16470,197,94,"UPyD",397
46,"46131",49087,37846,37477,422,369,"UPyD",1530
19,"19015",104,88,87,0,1,"UPyD",2
26,"26054",381,298,292,2,6,"UPyD",0
19,"19092",437,331,326,4,5,"UPyD",13
22,"22135",200,152,147,5,5,"UPyD",5
25,"25127",226,134,130,2,4,"UPyD",1
50,"50133",126,101,100,1,1,"UPyD",3
9,"9480",106,87,87,0,0,"UPyD",2
23,"23017",1668,1392,1377,10,15,"UPyD",23
18,"18028",992,826,821,4,5,"UPyD",9
18,"18193",13680,9874,9764,130,110,"UPyD",662
47,"47098",607,496,492,9,4,"UPyD",30
48,"48035",379,304,301,0,3,"UPyD",3
5,"5219",45,33,33,0,0,"UPyD",1
46,"46133",686,572,565,1,7,"UPyD",12
9,"9037",122,91,90,2,1,"UPyD",10
48,"48905",2600,1903,1869,14,34,"UPyD",9
8,"8280",116,74,72,3,2,"UPyD",0
26,"26099",1281,1050,1025,19,25,"UPyD",14
31,"31078",2502,1880,1852,33,28,"UPyD",42
46,"46157",3068,2523,2491,17,32,"UPyD",56
38,"38027",5392,3530,3459,41,71,"UPyD",48
5,"5211",484,406,405,3,1,"UPyD",12
48,"48037",727,528,519,2,9,"UPyD",0
40,"40057",1522,1272,1260,19,12,"UPyD",73
12,"12022",367,282,279,4,3,"UPyD",7
10,"10193",1410,1179,1158,16,21,"UPyD",37
43,"43150",1337,994,977,12,17,"UPyD",1
48,"48906",796,625,622,5,3,"UPyD",2
43,"43118",439,318,313,7,5,"UPyD",0
1,"1053",590,341,333,4,8,"UPyD",5
25,"25253",175,132,129,1,3,"UPyD",0
44,"44022",550,387,380,6,7,"UPyD",4
43,"43126",1170,802,783,19,19,"UPyD",12
31,"31140",117,91,89,3,2,"UPyD",2
16,"16239",158,114,112,2,2,"UPyD",2
18,"18901",583,374,368,3,6,"UPyD",12
19,"19200",150,105,105,1,0,"UPyD",3
10,"10194",557,449,440,0,9,"UPyD",21
41,"41056",3697,3041,3008,25,33,"UPyD",75
26,"26058",151,114,109,1,5,"UPyD",10
47,"47100",169,146,144,1,2,"UPyD",2
48,"48039",263,217,216,4,1,"UPyD",0
43,"43111",2096,1305,1281,19,24,"UPyD",30
44,"44023",13,11,11,0,0,"UPyD",1
3,"3090",16226,12224,12116,139,108,"UPyD",750
16,"16240",134,100,98,0,2,"UPyD",7
10,"10072",892,663,655,3,8,"UPyD",5
26,"26019",365,296,295,6,1,"UPyD",18
40,"40200",47,41,39,0,2,"UPyD",0
9,"9437",298,249,247,5,2,"UPyD",8
37,"37189",139,90,90,1,0,"UPyD",2
12,"12025",146,106,105,0,1,"UPyD",0
22,"22246",93,63,62,0,1,"UPyD",2
17,"17178",1075,683,679,15,4,"UPyD",2
25,"25038",1606,1104,1093,19,11,"UPyD",2
48,"48061",773,585,582,6,3,"UPyD",5
34,"34088",219,179,177,4,2,"UPyD",11
24,"24178",83,67,67,2,0,"UPyD",1
12,"12026",946,728,702,16,26,"UPyD",6
8,"8069",3028,2071,2029,36,42,"UPyD",26
16,"16143",20,14,13,1,1,"UPyD",0
5,"5245",344,285,284,5,1,"UPyD",25
47,"47023",2863,2278,2258,38,20,"UPyD",225
48,"48029",8022,5488,5409,83,79,"UPyD",141
21,"21011",3531,2672,2639,15,33,"UPyD",68
7,"7054",19930,11186,11028,196,158,"UPyD",455
19,"19099",337,211,210,6,1,"UPyD",6
12,"12125",235,203,201,1,2,"UPyD",3
39,"39060",6723,5453,5360,56,93,"UPyD",123
50,"50196",110,87,86,4,1,"UPyD",4
31,"31143",105,62,58,2,4,"UPyD",1
34,"34076",632,524,520,13,4,"UPyD",12
14,"14010",4087,3144,3121,15,23,"UPyD",57
37,"37343",56,42,40,0,2,"UPyD",3
22,"22248",119,94,92,3,2,"UPyD",4
10,"10197",143,96,94,1,2,"UPyD",5
25,"25069",471,291,289,9,2,"UPyD",1
47,"47024",283,211,210,1,1,"UPyD",8
38,"38032",13032,8487,8357,101,130,"UPyD",354
7,"7056",4701,3164,3090,55,74,"UPyD",86
49,"49172",594,389,383,0,6,"UPyD",5
50,"50282",88,66,63,3,3,"UPyD",0
43,"43130",196,132,131,7,1,"UPyD",0
31,"31145",173,129,127,2,2,"UPyD",8
48,"48075",1915,1362,1325,15,37,"UPyD",8
31,"31053",595,430,418,6,12,"UPyD",9
4,"4099",5086,4023,3980,26,43,"UPyD",140
22,"22168",22,16,16,0,0,"UPyD",1
22,"22039",920,721,710,12,11,"UPyD",20
25,"25153",215,165,161,0,4,"UPyD",0
26,"26121",33,28,28,0,0,"UPyD",0
6,"6135",1094,898,890,14,8,"UPyD",16
12,"12029",760,619,601,7,18,"UPyD",7
29,"29042",14047,9845,9735,118,110,"UPyD",524
31,"31175",78,55,54,0,1,"UPyD",1
42,"42135",89,59,59,1,0,"UPyD",1
12,"12042",664,549,530,5,19,"UPyD",4
47,"47104",2917,2391,2357,31,34,"UPyD",113
9,"9131",412,332,321,6,11,"UPyD",12
6,"6060",5865,4657,4592,67,65,"UPyD",91
19,"19174",126,88,86,0,2,"UPyD",1
5,"5155",60,44,44,1,0,"UPyD",2
5,"5251",80,58,58,0,0,"UPyD",0
40,"40115",126,98,95,2,3,"UPyD",6
20,"20901",1468,951,947,13,4,"UPyD",12
37,"37309",42,26,25,3,1,"UPyD",1
49,"49131",312,227,225,7,2,"UPyD",6
20,"20008",757,499,499,8,0,"UPyD",0
48,"48913",1231,936,922,10,14,"UPyD",3
9,"9048",1565,1166,1148,20,18,"UPyD",61
42,"42038",42,32,31,3,1,"UPyD",0
22,"22155",89,67,67,2,0,"UPyD",5
8,"8164",873,606,584,13,22,"UPyD",1
16,"16107",161,101,98,1,3,"UPyD",4
37,"37347",481,374,371,6,3,"UPyD",18
45,"45123",2961,2081,2049,30,32,"UPyD",160
9,"9010",35,27,27,1,0,"UPyD",0
50,"50082",108,73,72,0,1,"UPyD",3
16,"16150",120,90,90,0,0,"UPyD",1
3,"3097",973,791,779,6,12,"UPyD",29
19,"19308",67,61,61,0,0,"UPyD",1
17,"17154",93,54,49,1,5,"UPyD",0
16,"16108",68,56,55,0,1,"UPyD",1
13,"13084",973,800,793,6,7,"UPyD",15
43,"43133",5697,3470,3388,76,82,"UPyD",14
9,"9314",113,89,88,4,1,"UPyD",4
50,"50286",90,73,73,2,0,"UPyD",2
44,"44158",1159,904,873,15,31,"UPyD",27
36,"36030",4387,3206,3177,35,29,"UPyD",14
25,"25015",394,264,264,14,0,"UPyD",0
40,"40211",72,65,65,1,0,"UPyD",1
21,"21057",1054,699,697,9,2,"UPyD",5
38,"38048",3884,2615,2587,34,28,"UPyD",40
49,"49059",111,83,82,2,1,"UPyD",5
46,"46044",4301,3284,3169,50,115,"UPyD",155
31,"31058",240,184,179,0,5,"UPyD",10
44,"44159",47,43,43,0,0,"UPyD",3
8,"8167",5703,3896,3831,82,65,"UPyD",63
3,"3098",526,410,400,6,10,"UPyD",17
32,"32071",1614,1121,1112,4,9,"UPyD",6
42,"42042",46,35,33,1,2,"UPyD",0
25,"25230",1665,1164,1140,36,24,"UPyD",2
41,"41902",4682,3136,3101,34,35,"UPyD",60
16,"16066",2402,2064,1997,32,67,"UPyD",42
12,"12034",1509,1125,1097,10,28,"UPyD",16
36,"36031",572,484,479,5,5,"UPyD",8
10,"10206",237,177,174,0,3,"UPyD",3
23,"23035",1066,919,912,3,7,"UPyD",8
9,"9038",123,92,92,0,0,"UPyD",4
4,"4049",4981,3652,3630,34,22,"UPyD",117
37,"37099",104,64,62,1,2,"UPyD",0
30,"30017",11683,9332,9233,95,99,"UPyD",365
38,"38038",161890,99555,97980,1101,1575,"UPyD",3747
46,"46093",2082,1722,1716,9,6,"UPyD",48
24,"24175",1760,1324,1303,29,21,"UPyD",67
4,"4094",206,152,152,0,0,"UPyD",3
37,"37315",99,77,75,3,2,"UPyD",1
9,"9363",1047,798,792,9,6,"UPyD",31
47,"47029",61,54,53,0,1,"UPyD",2
5,"5257",153,105,104,0,1,"UPyD",6
23,"23080",1832,1425,1414,3,11,"UPyD",9
45,"45017",268,215,212,1,3,"UPyD",1
37,"37214",134,94,94,4,0,"UPyD",4
37,"37164",280,217,213,9,4,"UPyD",6
25,"25232",1480,968,959,38,9,"UPyD",2
48,"48050",216,173,172,0,1,"UPyD",0
4,"4062",4604,3711,3654,22,57,"UPyD",77
9,"9270",180,147,143,2,4,"UPyD",6
22,"22109",243,178,178,2,0,"UPyD",10
43,"43906",2050,1332,1298,28,34,"UPyD",5
47,"47004",1261,1047,1031,11,16,"UPyD",19
26,"26088",48,41,41,0,0,"UPyD",0
12,"12083",106,89,88,0,1,"UPyD",2
38,"38007",1844,1209,1188,5,21,"UPyD",20
3,"3125",340,276,275,2,1,"UPyD",2
34,"34034",129,104,104,1,0,"UPyD",4
25,"25068",576,376,364,6,12,"UPyD",0
9,"9449",94,80,80,2,0,"UPyD",8
13,"13089",1906,1610,1553,12,57,"UPyD",40
46,"46022",15090,10922,10840,99,82,"UPyD",565
31,"31001",88,58,58,1,0,"UPyD",0
47,"47031",203,149,149,0,0,"UPyD",1
27,"27009",2354,1812,1782,19,30,"UPyD",6
49,"49066",531,392,386,2,6,"UPyD",7
19,"19121",277,219,217,0,2,"UPyD",3
1,"1042",915,678,661,1,17,"UPyD",5
16,"16116",104,67,66,1,1,"UPyD",0
47,"47085",16967,12618,12472,208,146,"UPyD",565
49,"49008",535,395,394,7,1,"UPyD",9
39,"39043",1321,1082,1072,8,10,"UPyD",10
19,"19112",68,50,50,0,0,"UPyD",1
49,"49053",978,809,796,10,13,"UPyD",16
50,"50291",112,75,73,0,2,"UPyD",0
18,"18043",140,89,87,1,2,"UPyD",5
43,"43015",104,69,68,2,1,"UPyD",0
26,"26165",350,297,294,1,3,"UPyD",9
26,"26075",377,297,289,4,8,"UPyD",4
20,"20055",17856,11885,11791,91,94,"UPyD",70
9,"9019",153,104,104,1,0,"UPyD",1
49,"49142",264,180,179,2,1,"UPyD",2
40,"40080",68,53,52,0,1,"UPyD",2
7,"7902",1071,734,712,22,22,"UPyD",12
19,"19113",519,396,395,4,1,"UPyD",10
30,"30021",8550,6423,6349,44,74,"UPyD",220
8,"8265",1575,1065,1026,38,39,"UPyD",1
34,"34106",121,100,99,2,1,"UPyD",2
42,"42218",86,59,59,0,0,"UPyD",2
30,"30012",9037,7242,7142,62,100,"UPyD",286
31,"31216",3911,2699,2653,82,46,"UPyD",46
19,"19227",95,64,63,1,1,"UPyD",6
9,"9428",124,107,107,1,0,"UPyD",7
22,"22187",295,222,222,3,0,"UPyD",10
32,"32091",1971,1472,1466,12,6,"UPyD",2
48,"48065",3311,2340,2323,23,17,"UPyD",23
21,"21004",1530,1059,1042,9,17,"UPyD",16
7,"7046",13748,8294,8183,183,111,"UPyD",268
42,"42202",33,15,14,1,1,"UPyD",1
50,"50120",53,41,41,0,0,"UPyD",0
50,"50032",330,233,228,3,5,"UPyD",4
46,"46122",2737,2154,2131,18,23,"UPyD",89
9,"9277",130,101,101,1,0,"UPyD",3
28,"28068",10502,7857,7778,68,79,"UPyD",733
29,"29069",80337,50235,49723,690,512,"UPyD",2874
8,"8083",1626,1199,1178,23,21,"UPyD",2
4,"4031",2495,1942,1931,13,11,"UPyD",29
25,"25207",6253,3938,3872,91,66,"UPyD",17
19,"19013",143,110,108,1,2,"UPyD",3
31,"31248",318,190,187,2,3,"UPyD",6
49,"49056",324,251,247,3,4,"UPyD",5
40,"40224",34,25,25,0,0,"UPyD",0
37,"37134",250,192,189,1,3,"UPyD",3
9,"9456",142,110,110,3,0,"UPyD",1
42,"42205",99,70,70,0,0,"UPyD",7
9,"9061",187,146,144,1,2,"UPyD",3
47,"47035",956,778,768,5,10,"UPyD",10
16,"16266",402,334,325,4,9,"UPyD",5
18,"18115",2380,1843,1823,14,20,"UPyD",47
4,"4069",4729,3740,3706,52,34,"UPyD",115
18,"18016",339,254,253,2,1,"UPyD",6
24,"24184",206,111,111,0,0,"UPyD",4
45,"45062",1161,959,928,8,31,"UPyD",16
1,"1051",3662,2242,2210,26,32,"UPyD",22
42,"42054",20,14,14,0,0,"UPyD",0
29,"29054",39904,27540,27307,240,233,"UPyD",1447
33,"33062",452,282,281,3,1,"UPyD",3
3,"3109",2745,2332,2302,18,30,"UPyD",66
34,"34029",832,696,683,11,13,"UPyD",8
44,"44131",26,20,20,0,0,"UPyD",0
42,"42013",45,35,34,1,1,"UPyD",3
50,"50123",428,335,332,9,3,"UPyD",12
50,"50064",469,377,373,5,4,"UPyD",8
50,"50276",148,116,114,3,2,"UPyD",1
33,"33054",1780,1272,1263,8,9,"UPyD",27
26,"26042",852,660,651,11,9,"UPyD",13
28,"28027",1232,937,919,9,18,"UPyD",119
25,"25209",1558,1041,1009,22,32,"UPyD",2
5,"5134",47,37,37,0,0,"UPyD",0
48,"48058",977,706,700,2,6,"UPyD",1
42,"42208",23,15,15,1,0,"UPyD",1
36,"36042",17897,12635,12437,157,198,"UPyD",165
23,"23049",1942,1514,1486,16,28,"UPyD",28
19,"19325",127,105,102,4,3,"UPyD",2
33,"33063",467,367,363,4,4,"UPyD",5
40,"40088",303,242,238,0,4,"UPyD",12
6,"6127",2922,2306,2279,27,27,"UPyD",51
8,"8179",591,415,405,6,10,"UPyD",2
24,"24230",450,333,327,4,6,"UPyD",14
18,"18010",576,464,458,4,6,"UPyD",16
44,"44175",138,111,111,4,0,"UPyD",2
15,"15020",4187,2802,2781,18,21,"UPyD",7
29,"29065",207,151,149,1,2,"UPyD",0
31,"31170",46,40,39,3,1,"UPyD",0
21,"21009",916,622,608,6,14,"UPyD",14
37,"37264",78,52,52,0,0,"UPyD",0
45,"45139",231,198,194,0,4,"UPyD",5
37,"37100",89,77,76,4,1,"UPyD",2
31,"31161",321,251,246,5,5,"UPyD",6
47,"47119",101,78,77,0,1,"UPyD",0
36,"36044",2595,1862,1834,23,28,"UPyD",12
40,"40231",128,102,100,3,2,"UPyD",2
18,"18020",1473,1111,1106,7,5,"UPyD",15
29,"29084",28386,19450,19202,296,248,"UPyD",766
25,"25029",1766,1145,1118,38,27,"UPyD",0
38,"38050",2516,1765,1734,9,31,"UPyD",22
50,"50126",2473,1747,1724,41,23,"UPyD",46
34,"34020",63,44,44,0,0,"UPyD",1
25,"25056",289,168,163,3,5,"UPyD",0
19,"19327",551,459,449,3,10,"UPyD",10
38,"38051",7081,5298,5229,64,69,"UPyD",70
41,"41074",3079,2406,2386,14,20,"UPyD",54
9,"9448",225,188,186,1,2,"UPyD",6
50,"50242",102,82,82,2,0,"UPyD",4
46,"46127",2790,2298,2267,23,31,"UPyD",51
15,"15041",9718,7514,7425,102,89,"UPyD",48
12,"12013",180,131,130,0,1,"UPyD",6
45,"45018",445,332,322,4,10,"UPyD",22
47,"47166",276,226,223,0,3,"UPyD",5
8,"8192",5450,3688,3634,79,54,"UPyD",19
38,"38019",12624,8174,8099,65,75,"UPyD",56
37,"37330",338,272,270,3,2,"UPyD",6
1,"1008",781,566,546,7,20,"UPyD",10
47,"47112",2671,2231,2198,28,33,"UPyD",56
13,"13078",9291,7062,6993,92,69,"UPyD",189
28,"28052",3799,2753,2719,17,34,"UPyD",151
16,"16145",508,421,417,6,4,"UPyD",15
50,"50039",580,450,446,3,4,"UPyD",16
37,"37103",483,354,351,1,3,"UPyD",9
25,"25123",206,140,136,4,4,"UPyD",0
35,"35018",11652,6488,6367,107,121,"UPyD",206
14,"14030",8519,6832,6753,64,79,"UPyD",127
43,"43120",454,287,283,1,4,"UPyD",0
37,"37255",58,47,47,3,0,"UPyD",1
38,"38053",3752,2459,2397,28,62,"UPyD",35
31,"31164",604,462,448,9,14,"UPyD",5
32,"32089",1480,1063,1045,7,18,"UPyD",4
17,"17170",192,135,134,1,1,"UPyD",1
8,"8091",5106,3379,3312,59,67,"UPyD",41
4,"4076",1325,1050,1041,7,9,"UPyD",30
31,"31256",113,64,64,0,0,"UPyD",1
48,"48064",599,490,490,1,0,"UPyD",0
21,"21013",10601,7384,7231,110,153,"UPyD",185
37,"37106",289,199,196,2,3,"UPyD",7
3,"3116",1167,912,904,12,8,"UPyD",28
38,"38901",1389,917,907,16,10,"UPyD",6
16,"16131",154,116,115,0,1,"UPyD",3
14,"14041",3215,2492,2439,45,53,"UPyD",60
25,"25022",119,83,83,0,0,"UPyD",0
46,"46121",116,103,101,0,2,"UPyD",2
14,"14062",1114,889,882,9,7,"UPyD",9
12,"12006",185,160,153,0,7,"UPyD",0
44,"44014",2603,1965,1912,25,53,"UPyD",55
26,"26064",2341,1770,1749,26,21,"UPyD",96
50,"50109",101,79,79,2,0,"UPyD",5
45,"45047",2404,1685,1662,7,23,"UPyD",81
4,"4077",343,313,313,1,0,"UPyD",5
49,"49039",333,243,240,6,3,"UPyD",6
9,"9047",62,48,45,0,3,"UPyD",1
14,"14032",434,377,375,1,2,"UPyD",1
16,"16174",209,170,167,0,3,"UPyD",4
4,"4078",1069,837,832,6,5,"UPyD",4
19,"19050",21,19,19,0,0,"UPyD",0
21,"21055",6320,4819,4760,46,59,"UPyD",128
16,"16193",77,68,67,0,1,"UPyD",0
47,"47178",190,162,161,1,1,"UPyD",9
42,"42068",99,74,74,5,0,"UPyD",3
5,"5905",253,200,198,1,2,"UPyD",10
16,"16062",30,27,27,0,0,"UPyD",0
25,"25250",358,237,234,4,3,"UPyD",0
33,"33069",3611,2615,2597,25,18,"UPyD",58
28,"28054",10459,7798,7698,65,100,"UPyD",800
16,"16010",184,135,133,1,2,"UPyD",4
27,"27047",1851,1293,1273,16,20,"UPyD",11
28,"28055",932,713,707,5,6,"UPyD",19
33,"33046",546,429,421,3,8,"UPyD",4
43,"43124",532,366,358,3,8,"UPyD",2
50,"50171",126,90,89,4,1,"UPyD",5
42,"42024",95,80,73,1,7,"UPyD",5
24,"24199",432,280,278,2,2,"UPyD",8
11,"11034",2381,1807,1784,19,23,"UPyD",46
10,"10026",598,458,447,5,11,"UPyD",27
14,"14033",1289,974,958,18,16,"UPyD",31
9,"9346",95,83,83,1,0,"UPyD",1
41,"41079",9349,7095,7001,71,94,"UPyD",269
49,"49077",210,146,144,1,2,"UPyD",2
40,"40103",157,121,120,0,1,"UPyD",5
44,"44106",173,132,131,8,1,"UPyD",4
26,"26028",135,108,106,2,2,"UPyD",3
42,"42123",172,128,128,3,0,"UPyD",12
9,"9301",625,510,504,11,6,"UPyD",38
9,"9036",32,27,27,2,0,"UPyD",1
22,"22190",120,76,73,4,3,"UPyD",1
8,"8075",3906,2442,2414,31,28,"UPyD",24
37,"37013",133,93,85,5,8,"UPyD",4
9,"9122",93,71,71,4,0,"UPyD",3
28,"28126",59,37,37,0,0,"UPyD",1
16,"16096",279,231,229,7,2,"UPyD",2
34,"34070",182,138,137,1,1,"UPyD",1
39,"39082",1688,1280,1266,9,14,"UPyD",22
36,"36020",2581,1947,1922,27,25,"UPyD",3
1,"1902",776,532,526,6,6,"UPyD",16
19,"19232",89,68,67,0,1,"UPyD",0
17,"17146",2952,1895,1864,49,31,"UPyD",12
35,"35024",12420,6978,6819,131,159,"UPyD",177
8,"8127",2274,1371,1338,23,33,"UPyD",2
46,"46109",6143,4731,4637,40,94,"UPyD",203
17,"17176",141,96,95,3,1,"UPyD",0
50,"50250",58,43,43,4,0,"UPyD",2
8,"8271",74,45,44,3,1,"UPyD",0
37,"37113",439,365,365,7,0,"UPyD",11
6,"6006",4664,3435,3367,50,68,"UPyD",94
14,"14066",5911,4515,4473,54,42,"UPyD",68
30,"30034",1182,956,943,3,13,"UPyD",32
3,"3054",371,321,315,2,6,"UPyD",6
31,"31150",234,163,162,5,1,"UPyD",4
20,"20002",347,237,237,8,0,"UPyD",1
14,"14006",1326,1170,1148,12,22,"UPyD",18
8,"8016",1984,1319,1289,26,30,"UPyD",0
36,"36055",13678,10508,10288,155,220,"UPyD",101
22,"22001",242,177,173,2,4,"UPyD",9
31,"31201",144714,104019,102644,2027,1375,"UPyD",2333
44,"44062",38,34,34,0,0,"UPyD",0
33,"33011",12085,7186,7116,89,70,"UPyD",190
4,"4061",668,541,536,7,5,"UPyD",10
47,"47030",1075,822,801,13,21,"UPyD",38
33,"33049",6806,4629,4581,70,48,"UPyD",99
24,"24122",1424,1001,992,9,9,"UPyD",14
44,"44229",150,108,107,5,1,"UPyD",0
24,"24164",397,215,213,2,2,"UPyD",10
50,"50289",71,59,59,0,0,"UPyD",0
36,"36022",9203,6423,6226,100,197,"UPyD",36
10,"10141",289,209,209,0,0,"UPyD",2
25,"25030",147,101,95,3,6,"UPyD",0
50,"50270",39,30,29,1,1,"UPyD",0
17,"17046",738,510,498,15,12,"UPyD",2
17,"17106",140,105,104,0,1,"UPyD",0
45,"45153",1704,1376,1353,9,23,"UPyD",55
50,"50280",370,296,291,5,5,"UPyD",9
15,"15032",3639,2642,2586,35,56,"UPyD",16
30,"30037",17942,13830,13734,90,96,"UPyD",679
39,"39059",8476,6365,6284,73,81,"UPyD",173
47,"47184",575,447,443,6,4,"UPyD",20
47,"47101",1740,1458,1444,12,14,"UPyD",28
11,"11001",4389,3110,3072,13,38,"UPyD",63
31,"31183",667,516,508,8,8,"UPyD",10
44,"44011",67,47,47,0,0,"UPyD",2
30,"30002",9802,7628,7553,48,75,"UPyD",233
40,"40110",391,303,302,6,1,"UPyD",12
4,"4086",1903,1376,1371,11,5,"UPyD",45
27,"27057",11297,8174,8005,162,169,"UPyD",75
24,"24209",3016,2006,1984,20,22,"UPyD",39
10,"10157",289,218,212,1,6,"UPyD",8
33,"33028",1466,812,806,5,6,"UPyD",14
46,"46209",1984,1606,1594,11,12,"UPyD",36
46,"46088",196,146,140,0,6,"UPyD",4
37,"37304",190,144,142,1,2,"UPyD",1
2,"2041",399,311,304,1,7,"UPyD",9
40,"40174",402,292,290,5,2,"UPyD",4
9,"9044",54,45,45,1,0,"UPyD",4
8,"8070",275,192,191,5,1,"UPyD",0
16,"16909",737,590,585,9,5,"UPyD",15
9,"9904",548,412,407,7,5,"UPyD",20
42,"42185",29,23,23,1,0,"UPyD",0
15,"15081",1139,869,853,9,16,"UPyD",0
9,"9403",98,75,75,0,0,"UPyD",1
16,"16191",1001,867,864,13,3,"UPyD",18
46,"46210",346,300,295,4,5,"UPyD",8
43,"43089",272,193,185,1,8,"UPyD",3
37,"37061",254,187,185,0,2,"UPyD",8
19,"19089",33,22,22,1,0,"UPyD",0
34,"34052",187,147,147,1,0,"UPyD",5
12,"12016",1589,1309,1293,15,16,"UPyD",20
31,"31033",55,34,34,0,0,"UPyD",13
37,"37369",143,103,103,0,0,"UPyD",1
9,"9387",121,92,91,3,1,"UPyD",6
19,"19195",41,30,30,1,0,"UPyD",0
8,"8226",886,667,656,13,11,"UPyD",0
25,"25238",231,158,156,1,2,"UPyD",0
32,"32079",1448,1103,1094,14,9,"UPyD",9
28,"28018",3572,2837,2795,20,42,"UPyD",223
2,"2080",580,450,443,4,7,"UPyD",16
6,"6151",1109,850,846,6,4,"UPyD",22
12,"12031",3748,2751,2687,35,64,"UPyD",121
44,"44250",20,11,11,1,0,"UPyD",0
44,"44004",450,334,332,2,2,"UPyD",4
10,"10161",76,59,59,1,0,"UPyD",1
5,"5218",148,123,117,1,6,"UPyD",0
43,"43902",2761,1836,1811,25,25,"UPyD",5
37,"37049",163,119,119,0,0,"UPyD",8
45,"45085",1511,1111,1100,10,11,"UPyD",34
50,"50071",134,97,96,0,1,"UPyD",1
8,"8073",60247,41448,40843,770,605,"UPyD",779
16,"16247",87,65,62,1,3,"UPyD",1
19,"19024",7736,5738,5646,82,92,"UPyD",600
42,"42085",219,167,167,2,0,"UPyD",2
22,"22206",218,169,167,3,2,"UPyD",5
22,"22102",194,152,149,4,3,"UPyD",5
46,"46050",161,126,123,1,3,"UPyD",13
46,"46123",1808,1440,1410,7,30,"UPyD",32
50,"50111",191,141,138,2,3,"UPyD",2
48,"48914",324,278,276,0,2,"UPyD",0
10,"10163",374,310,308,0,2,"UPyD",1
5,"5187",1833,1385,1361,16,24,"UPyD",47
9,"9908",509,328,321,5,7,"UPyD",18
13,"13018",860,740,727,2,13,"UPyD",9
16,"16151",66,56,56,0,0,"UPyD",3
3,"3132",571,464,461,8,3,"UPyD",13
37,"37273",115,83,83,1,0,"UPyD",0
16,"16163",75,57,57,0,0,"UPyD",3
40,"40164",188,145,142,0,3,"UPyD",6
46,"46116",12587,9821,9724,120,97,"UPyD",768
19,"19107",349,289,288,1,1,"UPyD",5
15,"15056",5873,4205,4150,63,55,"UPyD",31
19,"19188",72,48,48,1,0,"UPyD",0
14,"14044",1585,1279,1265,12,14,"UPyD",31
14,"14055",18619,13802,13607,192,195,"UPyD",421
37,"37349",136,105,104,2,1,"UPyD",3
39,"39091",2026,1636,1628,14,8,"UPyD",22
27,"27065",13035,9432,9254,168,178,"UPyD",51
26,"26113",35,31,31,1,0,"UPyD",0
50,"50230",1295,914,903,13,11,"UPyD",13
45,"45088",2038,1379,1356,14,23,"UPyD",70
44,"44075",329,250,240,4,10,"UPyD",3
49,"49271",221,178,176,2,2,"UPyD",2
27,"27020",3807,3204,3161,33,43,"UPyD",15
50,"50026",459,360,354,5,6,"UPyD",12
49,"49003",896,650,647,11,3,"UPyD",10
5,"5221",398,298,297,10,1,"UPyD",7
50,"50259",89,53,53,1,0,"UPyD",4
5,"5242",692,556,553,18,3,"UPyD",8
14,"14046",4587,3671,3641,35,30,"UPyD",41
49,"49062",142,104,104,1,0,"UPyD",2
26,"26056",440,345,339,4,6,"UPyD",4
50,"50118",2312,1737,1718,22,19,"UPyD",45
16,"16237",116,98,98,3,0,"UPyD",2
22,"22227",225,172,168,3,4,"UPyD",7
1,"1036",15236,10511,10372,141,139,"UPyD",115
32,"32036",1528,1217,1202,13,15,"UPyD",12
25,"25075",122,85,83,0,2,"UPyD",0
26,"26115",20,20,20,4,0,"UPyD",0
20,"20014",1101,660,654,8,6,"UPyD",5
3,"3136",484,393,386,1,7,"UPyD",5
25,"25017",248,160,159,1,1,"UPyD",0
2,"2026",845,723,716,5,7,"UPyD",9
5,"5200",56,43,42,0,1,"UPyD",2
50,"50037",140,110,103,3,7,"UPyD",1
31,"31060",12916,8830,8687,158,143,"UPyD",123
29,"29047",1165,973,969,0,4,"UPyD",25
24,"24219",580,435,431,10,4,"UPyD",8
49,"49047",120,91,90,1,1,"UPyD",3
24,"24902",375,292,289,1,3,"UPyD",2
33,"33034",11390,7583,7501,85,82,"UPyD",194
31,"31243",313,227,223,5,4,"UPyD",5
17,"17158",404,266,264,3,2,"UPyD",0
22,"22076",331,241,235,3,6,"UPyD",12
50,"50038",1583,1194,1174,29,20,"UPyD",37
23,"23008",1552,1280,1266,9,14,"UPyD",5
8,"8007",6338,4165,4050,89,115,"UPyD",23
2,"2063",1537,1252,1242,11,10,"UPyD",20
16,"16188",106,76,76,0,0,"UPyD",0
28,"28114",148,110,110,0,0,"UPyD",15
24,"24221",850,635,619,6,16,"UPyD",14
5,"5161",638,525,522,0,3,"UPyD",16
28,"28023",4350,3425,3392,32,33,"UPyD",341
26,"26060",100,71,71,3,0,"UPyD",4
45,"45019",7033,5207,5110,89,97,"UPyD",358
36,"36035",14551,10675,10469,160,206,"UPyD",198
46,"46152",96,70,70,0,0,"UPyD",1
9,"9337",126,88,87,1,1,"UPyD",2
42,"42094",520,376,362,14,14,"UPyD",21
47,"47066",1114,891,888,10,3,"UPyD",62
24,"24179",331,219,214,4,5,"UPyD",9
25,"25048",1684,1120,1095,29,25,"UPyD",3
8,"8002",202,143,140,4,3,"UPyD",0
42,"42006",166,110,107,3,3,"UPyD",3
47,"47058",199,157,157,3,0,"UPyD",2
28,"28067",3893,2996,2950,26,46,"UPyD",247
50,"50119",997,740,720,13,20,"UPyD",32
50,"50069",68,32,32,0,0,"UPyD",3
9,"9369",460,339,336,4,3,"UPyD",17
31,"31134",195,134,132,3,2,"UPyD",1
26,"26049",189,141,137,1,4,"UPyD",8
12,"12040",116573,84142,83078,1257,1064,"UPyD",5417
1,"1043",2322,1623,1595,12,28,"UPyD",47
47,"47006",196,151,146,1,5,"UPyD",9
26,"26036",16873,12341,12167,190,174,"UPyD",809
3,"3139",21796,15501,15320,160,181,"UPyD",623
49,"49100",322,236,233,1,3,"UPyD",1
9,"9115",96,71,70,4,1,"UPyD",3
17,"17151",174,131,131,6,0,"UPyD",0
37,"37090",59,54,50,0,4,"UPyD",2
28,"28168",1144,821,810,15,11,"UPyD",77
47,"47007",3453,2616,2580,42,36,"UPyD",240
4,"4043",520,439,435,3,4,"UPyD",17
17,"17080",165,115,114,1,1,"UPyD",0
38,"38022",18671,13075,12890,111,185,"UPyD",129
49,"49038",114,81,80,0,1,"UPyD",5
45,"45071",1896,1592,1575,21,17,"UPyD",12
37,"37370",345,261,260,1,1,"UPyD",8
19,"19332",106,76,72,4,4,"UPyD",3
4,"4018",293,250,245,2,5,"UPyD",6
8,"8256",669,498,496,16,2,"UPyD",3
48,"48088",148,110,109,0,1,"UPyD",1
40,"40036",531,440,424,10,16,"UPyD",21
44,"44017",316,232,229,1,3,"UPyD",5
28,"28039",139,103,103,1,0,"UPyD",6
21,"21065",295,212,211,0,1,"UPyD",3
17,"17134",235,149,148,3,1,"UPyD",0
5,"5165",386,292,280,7,12,"UPyD",19
33,"33068",1224,704,703,5,1,"UPyD",5
40,"40021",33,32,32,0,0,"UPyD",6
43,"43025",660,453,446,13,7,"UPyD",0
50,"50045",1289,1011,992,14,19,"UPyD",30
9,"9192",74,55,53,0,2,"UPyD",6
48,"48056",849,610,608,3,2,"UPyD",2
47,"47170",40,30,30,0,0,"UPyD",3
8,"8237",1692,1155,1127,22,28,"UPyD",2
42,"42173",28809,20268,19748,632,520,"UPyD",1027
47,"47026",59,46,46,1,0,"UPyD",0
19,"19041",166,127,127,3,0,"UPyD",11
37,"37360",252,194,194,1,0,"UPyD",5
34,"34012",368,277,275,9,2,"UPyD",17
25,"25913",100,78,78,0,0,"UPyD",0
31,"31219",93,75,73,1,2,"UPyD",2
5,"5102",1850,1487,1475,11,12,"UPyD",28
19,"19154",79,68,67,0,1,"UPyD",0
34,"34056",2147,1557,1535,21,22,"UPyD",82
3,"3074",1752,1479,1466,5,13,"UPyD",60
44,"44019",75,38,37,0,1,"UPyD",0
37,"37298",206,144,140,1,4,"UPyD",2
42,"42012",43,29,29,1,0,"UPyD",1
7,"7038",1962,1504,1480,20,24,"UPyD",21
16,"16082",318,226,226,1,0,"UPyD",3
42,"42175",28,19,19,0,0,"UPyD",0
29,"29035",1717,1280,1270,14,10,"UPyD",12
38,"38047",1819,1269,1239,12,30,"UPyD",17
26,"26082",121,95,95,0,0,"UPyD",2
25,"25189",2085,1348,1327,38,21,"UPyD",7
44,"44007",194,152,145,3,7,"UPyD",1
22,"22119",1433,994,981,14,13,"UPyD",25
42,"42159",40,31,31,1,0,"UPyD",0
31,"31159",1158,864,846,17,18,"UPyD",14
8,"8270",17464,11828,11677,212,151,"UPyD",146
14,"14025",3061,2547,2517,13,30,"UPyD",40
9,"9377",658,509,505,11,4,"UPyD",43
39,"39100",922,718,712,8,6,"UPyD",6
18,"18048",2277,1705,1688,19,17,"UPyD",82
19,"19156",1032,782,762,4,20,"UPyD",32
43,"43166",1521,1002,977,17,25,"UPyD",8
13,"13053",14718,10958,10766,159,192,"UPyD",751
19,"19288",22,21,21,0,0,"UPyD",3
28,"28080",45696,36832,36529,402,303,"UPyD",3791
33,"33043",710,529,528,1,1,"UPyD",7
23,"23010",14447,10777,10704,109,73,"UPyD",295
24,"24154",1068,803,795,6,8,"UPyD",28
6,"6005",1699,1332,1320,19,12,"UPyD",33
9,"9304",197,168,165,1,3,"UPyD",10
28,"28029",538,416,414,4,2,"UPyD",33
31,"31100",298,193,193,2,0,"UPyD",3
44,"44009",805,608,595,18,13,"UPyD",16
1,"1004",1427,1021,996,15,25,"UPyD",23
48,"48093",893,707,695,1,12,"UPyD",5
12,"12082",9741,7555,7408,84,147,"UPyD",221
17,"17206",167,108,107,2,1,"UPyD",0
46,"46158",1037,829,822,9,7,"UPyD",19
8,"8292",1083,775,764,21,11,"UPyD",4
7,"7041",2077,1583,1549,27,34,"UPyD",8
46,"46126",5471,4454,4392,53,62,"UPyD",263
44,"44135",149,110,109,1,1,"UPyD",2
40,"40233",457,350,348,1,2,"UPyD",29
40,"40059",124,104,104,2,0,"UPyD",10
37,"37365",172,152,149,2,3,"UPyD",3
31,"31223",1043,783,771,14,12,"UPyD",8
9,"9466",151,111,110,1,1,"UPyD",7
47,"47111",1005,804,794,5,10,"UPyD",41
37,"37101",185,143,141,1,2,"UPyD",4
11,"11028",32224,20706,20482,359,224,"UPyD",1076
44,"44049",886,652,627,6,25,"UPyD",12
5,"5201",557,444,437,2,7,"UPyD",16
40,"40218",111,81,80,1,1,"UPyD",2
47,"47075",4999,4020,3957,39,63,"UPyD",213
31,"31021",75,52,52,0,0,"UPyD",0
13,"13012",475,322,318,1,4,"UPyD",6
46,"46103",1244,998,972,12,26,"UPyD",40
43,"43136",10163,6312,6197,121,115,"UPyD",25
11,"11038",13815,10849,10756,126,93,"UPyD",391
36,"36001",3138,2060,2049,13,11,"UPyD",9
1,"1057",266,212,212,2,0,"UPyD",5
16,"16189",263,213,211,2,2,"UPyD",4
40,"40142",53,43,41,1,2,"UPyD",3
47,"47076",16922,13030,12899,212,131,"UPyD",1276
36,"36046",4093,3175,3120,31,55,"UPyD",20
46,"46082",4661,3447,3401,46,46,"UPyD",227
17,"17144",217,145,143,4,2,"UPyD",1
23,"23904",3070,2047,2033,19,14,"UPyD",40
42,"42062",36,23,22,0,1,"UPyD",0
16,"16276",32,23,22,1,1,"UPyD",1
32,"32016",1021,781,776,2,5,"UPyD",2
40,"40204",187,139,134,4,5,"UPyD",3
17,"17199",6630,4242,4162,80,80,"UPyD",21
45,"45130",354,287,283,2,4,"UPyD",7
17,"17181",3228,2116,2081,19,35,"UPyD",17
41,"41091",545464,388043,383816,5325,4227,"UPyD",26038
11,"11031",76347,49071,48616,681,455,"UPyD",3629
8,"8030",4849,3466,3422,50,44,"UPyD",26
10,"10185",587,457,450,1,7,"UPyD",5
9,"9247",28,21,20,0,1,"UPyD",0
29,"29077",225,157,157,1,0,"UPyD",6
34,"34077",283,219,216,3,3,"UPyD",8
25,"25206",289,187,184,3,3,"UPyD",0
34,"34104",274,224,224,4,0,"UPyD",0
50,"50060",187,138,136,1,2,"UPyD",5
18,"18023",16072,11594,11488,131,106,"UPyD",527
46,"46170",3464,2944,2908,24,36,"UPyD",115
9,"9473",94,81,81,2,0,"UPyD",0
41,"41077",8817,6520,6375,53,145,"UPyD",142
40,"40192",179,151,150,1,1,"UPyD",7
20,"20044",368,258,257,1,1,"UPyD",1
24,"24169",3205,2317,2282,33,35,"UPyD",49
17,"17210",527,358,349,9,9,"UPyD",1
15,"15007",3702,2670,2642,19,28,"UPyD",6
25,"25226",257,162,158,5,4,"UPyD",0
12,"12087",22,20,20,0,0,"UPyD",0
11,"11032",53183,32205,31982,441,223,"UPyD",984
13,"13081",684,553,527,1,26,"UPyD",1
5,"5207",743,595,591,1,4,"UPyD",24
40,"40207",724,551,540,9,11,"UPyD",71
30,"30014",1686,1400,1387,10,13,"UPyD",33
50,"50005",245,199,195,1,4,"UPyD",6
44,"44029",637,495,490,6,5,"UPyD",9
28,"28101",222,158,158,4,0,"UPyD",14
5,"5078",128,112,111,2,1,"UPyD",2
42,"42107",86,60,59,2,1,"UPyD",0
4,"4001",1139,890,884,6,6,"UPyD",27
42,"42184",76,50,49,0,1,"UPyD",1
16,"16176",61,45,43,0,2,"UPyD",0
41,"41094",6089,4757,4680,47,77,"UPyD",244
34,"34027",1224,875,861,14,14,"UPyD",25
37,"37310",154,115,115,1,0,"UPyD",1
32,"32044",939,774,764,8,10,"UPyD",1
38,"38046",8848,6410,6301,75,109,"UPyD",169
25,"25005",291,194,190,7,4,"UPyD",0
47,"47070",33,30,30,1,0,"UPyD",1
44,"44252",78,63,60,0,3,"UPyD",2
19,"19274",881,652,644,8,8,"UPyD",33
3,"3063",25410,18205,17989,208,216,"UPyD",775
45,"45111",65,47,44,1,3,"UPyD",1
8,"8034",741,542,529,4,13,"UPyD",2
20,"20035",497,346,344,1,2,"UPyD",0
34,"34082",96,79,75,0,4,"UPyD",0
37,"37080",242,187,185,1,2,"UPyD",6
50,"50016",51,30,30,1,0,"UPyD",1
32,"32058",5253,3872,3821,57,51,"UPyD",33
50,"50102",918,722,713,12,9,"UPyD",5
5,"5157",256,187,183,0,4,"UPyD",10
9,"9011",86,56,56,1,0,"UPyD",2
45,"45001",1901,1468,1431,14,37,"UPyD",58
47,"47117",306,231,228,4,3,"UPyD",13
50,"50092",329,273,272,0,1,"UPyD",8
48,"48003",14142,10268,10167,84,101,"UPyD",91
26,"26055",38,32,30,0,2,"UPyD",0
37,"37374",1204,1018,1004,9,14,"UPyD",21
26,"26016",32,27,27,0,0,"UPyD",0
43,"43174",152,104,101,1,3,"UPyD",0
21,"21048",327,226,226,5,0,"UPyD",2
29,"29037",227,170,170,0,0,"UPyD",2
9,"9433",67,46,45,2,1,"UPyD",1
23,"23020",1623,1414,1400,16,14,"UPyD",37
48,"48014",1211,838,834,4,4,"UPyD",15
9,"9025",150,112,110,0,2,"UPyD",1
48,"48910",3063,2122,2104,14,18,"UPyD",22
42,"42131",53,38,37,0,1,"UPyD",0
10,"10188",553,473,468,2,5,"UPyD",10
28,"28083",8037,6078,6025,66,53,"UPyD",732
43,"43055",2002,1404,1374,36,30,"UPyD",5
42,"42081",158,131,131,3,0,"UPyD",2
37,"37028",175,130,125,1,5,"UPyD",5
25,"25008",1187,834,818,15,16,"UPyD",1
9,"9124",1598,1151,1129,19,22,"UPyD",39
31,"31110",97,53,53,3,0,"UPyD",0
11,"11009",636,430,424,2,6,"UPyD",18
50,"50278",207,152,149,4,3,"UPyD",5
45,"45127",739,550,538,5,12,"UPyD",28
1,"1037",625,403,398,6,5,"UPyD",2
26,"26045",13,13,13,0,0,"UPyD",0
5,"5222",155,132,132,1,0,"UPyD",5
50,"50260",42,35,35,1,0,"UPyD",2
42,"42181",453,357,347,7,10,"UPyD",6
19,"19098",22,18,18,0,0,"UPyD",4
20,"20015",1307,980,979,13,1,"UPyD",0
43,"43160",1278,840,812,9,28,"UPyD",1
13,"13055",738,585,578,8,7,"UPyD",11
20,"20906",117,89,89,0,0,"UPyD",1
40,"40075",182,149,146,4,3,"UPyD",8
6,"6084",1105,932,917,5,15,"UPyD",12
8,"8077",33925,23896,23548,381,348,"UPyD",325
8,"8242",243,174,172,5,2,"UPyD",1
48,"48032",5864,4257,4223,32,34,"UPyD",18
49,"49083",67,48,48,1,0,"UPyD",0
24,"24139",2320,1687,1654,16,33,"UPyD",85
20,"20052",1154,849,847,14,2,"UPyD",0
2,"2052",493,417,412,9,5,"UPyD",11
28,"28037",1598,1263,1250,10,13,"UPyD",34
43,"43176",832,575,572,16,3,"UPyD",2
17,"17149",366,254,251,4,3,"UPyD",2
37,"37116",75,55,55,1,0,"UPyD",4
28,"28058",137542,103880,102686,1155,1194,"UPyD",12381
28,"28097",127,94,92,0,2,"UPyD",9
49,"49263",69,54,54,2,0,"UPyD",1
40,"40048",40,30,30,0,0,"UPyD",1
49,"49012",73,43,43,0,0,"UPyD",3
46,"46149",398,307,305,1,2,"UPyD",12
16,"16171",1930,1616,1584,25,32,"UPyD",29
33,"33053",1206,817,811,6,6,"UPyD",15
34,"34217",1089,866,849,19,17,"UPyD",66
29,"29015",31805,22566,22347,272,219,"UPyD",875
31,"31235",189,111,110,0,1,"UPyD",0
45,"45057",222,197,189,0,8,"UPyD",4
49,"49156",265,217,214,6,3,"UPyD",6
42,"42198",24,17,17,0,0,"UPyD",0
41,"41007",12177,8150,8016,126,134,"UPyD",276
18,"18167",1927,1397,1380,13,17,"UPyD",32
46,"46113",2338,1804,1797,14,7,"UPyD",76
47,"47103",277,218,214,1,4,"UPyD",10
31,"31236",1333,887,874,15,13,"UPyD",5
40,"40205",292,221,220,2,1,"UPyD",11
25,"25113",1227,869,856,28,13,"UPyD",1
46,"46105",16708,12164,12040,100,124,"UPyD",402
45,"45021",2399,1834,1804,23,30,"UPyD",60
45,"45144",839,701,691,11,10,"UPyD",22
46,"46145",21751,16601,16397,155,204,"UPyD",713
40,"40903",102,75,75,0,0,"UPyD",2
30,"30030",305669,236235,234391,2112,1844,"UPyD",18974
38,"38010",4054,2642,2599,17,43,"UPyD",27
40,"40904",332,271,268,5,3,"UPyD",14
17,"17172",426,286,283,3,3,"UPyD",1
25,"25122",1956,1281,1256,33,25,"UPyD",2
49,"49025",187,143,142,3,1,"UPyD",4
9,"9340",72,41,41,0,0,"UPyD",1
16,"16245",430,338,329,2,9,"UPyD",15
22,"22250",368,261,255,12,6,"UPyD",10
16,"16104",65,52,52,1,0,"UPyD",3
16,"16078",40954,30382,29933,568,449,"UPyD",2092
13,"13086",209,167,166,0,1,"UPyD",1
17,"17221",4135,2789,2723,49,66,"UPyD",30
36,"36027",4478,3376,3339,29,37,"UPyD",20
50,"50080",41,31,31,1,0,"UPyD",1
38,"38012",2535,1735,1716,11,19,"UPyD",29
5,"5217",69,54,54,0,0,"UPyD",0
31,"31241",164,117,116,4,1,"UPyD",1
30,"30003",23570,16482,16354,169,128,"UPyD",485
5,"5168",3682,2846,2801,43,45,"UPyD",220
50,"50177",355,268,265,4,3,"UPyD",6
6,"6071",257,236,230,1,6,"UPyD",4
42,"42049",141,83,81,1,2,"UPyD",1
42,"42140",17,10,10,0,0,"UPyD",0
15,"15008",5657,4224,4157,62,67,"UPyD",51
45,"45049",394,315,315,6,0,"UPyD",0
20,"20009",11794,7805,7725,103,80,"UPyD",104
28,"28026",5852,4506,4449,40,57,"UPyD",435
16,"16194",298,238,238,1,0,"UPyD",3
37,"37322",2501,1692,1676,32,16,"UPyD",113
45,"45024",1105,870,856,16,14,"UPyD",28
23,"23047",1658,1342,1339,6,3,"UPyD",21
46,"46067",1798,1487,1472,10,15,"UPyD",76
33,"33031",38090,25034,24730,380,304,"UPyD",612
14,"14045",3093,2662,2642,14,20,"UPyD",33
22,"22024",222,144,139,3,5,"UPyD",5
19,"19286",743,566,554,8,12,"UPyD",40
40,"40071",52,45,45,4,0,"UPyD",5
18,"18069",506,375,371,4,4,"UPyD",12
32,"32033",843,595,583,7,12,"UPyD",4
46,"46083",15427,12079,11941,109,138,"UPyD",346
45,"45013",1870,1504,1486,5,18,"UPyD",41
42,"42039",270,172,169,2,3,"UPyD",7
23,"23004",478,416,415,1,1,"UPyD",1
8,"8011",1754,1116,1085,29,31,"UPyD",1
40,"40121",325,266,262,3,4,"UPyD",12
22,"22158",11978,8404,8279,149,125,"UPyD",340
8,"8229",561,404,398,12,6,"UPyD",1
12,"12001",1098,821,817,8,4,"UPyD",15
25,"25137",8404,5264,5167,112,97,"UPyD",20
47,"47081",57,44,44,1,0,"UPyD",0
3,"3102",7346,5827,5751,39,76,"UPyD",136
34,"34083",1888,1355,1338,15,17,"UPyD",45
31,"31119",49,28,28,0,0,"UPyD",0
40,"40073",425,371,367,3,4,"UPyD",19
24,"24187",881,664,659,14,5,"UPyD",19
46,"46165",6962,5390,5322,53,68,"UPyD",268
20,"20078",1146,885,884,6,1,"UPyD",0
17,"17166",503,361,342,10,19,"UPyD",0
9,"9308",70,51,51,0,0,"UPyD",4
19,"19125",54,42,42,2,0,"UPyD",2
37,"37092",1403,1034,1022,12,12,"UPyD",149
24,"24183",900,571,567,10,4,"UPyD",17
8,"8234",3143,2040,2008,45,32,"UPyD",18
15,"15002",21528,15479,15218,314,261,"UPyD",361
40,"40214",243,204,199,0,5,"UPyD",15
6,"6067",2030,1583,1572,16,11,"UPyD",43
3,"3112",684,566,561,4,5,"UPyD",19
19,"19311",87,60,60,0,0,"UPyD",2
19,"19109",53,40,40,1,0,"UPyD",0
14,"14057",6115,5040,4975,71,65,"UPyD",111
23,"23007",3116,2483,2458,15,25,"UPyD",35
14,"14037",3500,2662,2616,29,46,"UPyD",59
47,"47147",129,96,96,0,0,"UPyD",0
37,"37213",97,77,76,0,1,"UPyD",3
37,"37085",4334,3254,3201,69,53,"UPyD",332
12,"12133",64,47,47,0,0,"UPyD",1
29,"29074",818,631,630,3,1,"UPyD",16
16,"16217",113,95,92,0,3,"UPyD",1
26,"26087",222,180,178,5,2,"UPyD",10
12,"12048",293,208,205,2,3,"UPyD",9
37,"37357",283,216,214,0,2,"UPyD",1
16,"16253",340,256,256,4,0,"UPyD",3
23,"23012",4250,3235,3216,19,19,"UPyD",66
33,"33059",5049,3480,3447,37,33,"UPyD",46
42,"42036",52,40,39,2,1,"UPyD",0
42,"42164",1699,1244,1209,13,35,"UPyD",40
25,"25255",468,318,309,9,9,"UPyD",2
33,"33050",653,406,402,0,4,"UPyD",5
20,"20077",5382,3766,3741,42,25,"UPyD",18
46,"46071",488,418,402,10,16,"UPyD",19
5,"5110",710,584,581,1,3,"UPyD",33
29,"29027",2416,1907,1893,15,14,"UPyD",28
12,"12011",4663,3578,3525,28,53,"UPyD",165
8,"8052",148,103,98,1,5,"UPyD",0
17,"17169",2460,1690,1651,34,39,"UPyD",12
36,"36024",17164,12723,12500,163,223,"UPyD",92
9,"9416",61,44,44,0,0,"UPyD",2
40,"40093",88,77,72,0,5,"UPyD",6
8,"8260",17869,11898,11686,215,212,"UPyD",237
15,"15080",1913,1407,1389,15,18,"UPyD",11
36,"36013",2690,1801,1778,11,23,"UPyD",9
31,"31255",100,78,78,1,0,"UPyD",1
3,"3107",2288,1670,1647,15,23,"UPyD",76
25,"25205",563,373,362,12,11,"UPyD",3
6,"6087",2258,1855,1832,24,23,"UPyD",19
50,"50129",258,164,164,0,0,"UPyD",5
5,"5260",114,101,101,1,0,"UPyD",3
42,"42216",27,22,22,0,0,"UPyD",1
36,"36047",2723,1875,1853,27,22,"UPyD",3
45,"45205",6333,4544,4451,58,93,"UPyD",320
48,"48020",276378,191777,190141,2335,1636,"UPyD",4210
12,"12041",115,98,98,2,0,"UPyD",0
9,"9451",244,208,202,1,6,"UPyD",4
24,"24021",1791,1251,1228,14,23,"UPyD",29
46,"46080",1090,860,849,2,11,"UPyD",30
17,"17029",198,136,133,1,3,"UPyD",0
40,"40003",144,123,120,1,3,"UPyD",5
16,"16159",299,204,202,5,2,"UPyD",1
17,"17132",1296,913,900,15,13,"UPyD",4
40,"40221",50,41,41,0,0,"UPyD",5
18,"18908",827,669,660,7,9,"UPyD",21
9,"9414",197,159,159,2,0,"UPyD",9
18,"18013",4392,3268,3223,23,45,"UPyD",111
45,"45131",327,262,258,1,4,"UPyD",9
47,"47095",41,36,36,3,0,"UPyD",2
29,"29088",2784,2019,1975,14,44,"UPyD",46
4,"4055",418,368,367,5,1,"UPyD",6
25,"25249",207,151,150,4,1,"UPyD",1
46,"46089",2116,1653,1627,9,26,"UPyD",65
22,"22909",349,259,252,3,7,"UPyD",2
1,"1052",240,191,191,1,0,"UPyD",0
16,"16242",367,315,313,4,2,"UPyD",6
33,"33070",3481,2557,2521,33,36,"UPyD",58
2,"2061",715,570,565,4,5,"UPyD",26
47,"47011",600,493,489,4,4,"UPyD",4
14,"14053",6040,4455,4376,78,79,"UPyD",108
45,"45065",317,261,258,0,3,"UPyD",1
16,"16185",63,45,44,0,1,"UPyD",0
8,"8076",15925,10435,10242,179,193,"UPyD",121
44,"44050",3183,2208,2154,78,54,"UPyD",84
8,"8009",8932,6188,6088,103,100,"UPyD",41
17,"17173",174,121,119,1,2,"UPyD",0
18,"18185",608,484,479,2,5,"UPyD",11
19,"19002",99,77,76,0,1,"UPyD",1
3,"3096",5863,4550,4457,57,93,"UPyD",225
38,"38013",2823,1856,1843,18,13,"UPyD",18
31,"31249",1926,1376,1361,30,15,"UPyD",8
16,"16162",51,36,36,0,0,"UPyD",0
50,"50266",139,95,94,1,1,"UPyD",0
13,"13028",10536,8503,8331,140,172,"UPyD",413
50,"50209",2559,1685,1661,34,24,"UPyD",111
1,"1032",536,412,400,0,12,"UPyD",6
44,"44090",84,71,71,0,0,"UPyD",1
46,"46148",1400,1131,1114,13,17,"UPyD",59
9,"9458",422,325,316,5,9,"UPyD",30
31,"31230",118,88,85,1,3,"UPyD",0
26,"26098",99,74,73,2,1,"UPyD",2
1,"1063",1803,1290,1284,18,6,"UPyD",22
16,"16212",286,229,226,3,3,"UPyD",3
10,"10190",569,438,435,6,3,"UPyD",5
38,"38039",10198,7548,7429,78,119,"UPyD",149
25,"25234",4572,2707,2648,57,59,"UPyD",12
37,"37327",191,148,148,9,0,"UPyD",14
16,"16234",52,38,36,0,2,"UPyD",1
25,"25049",166,105,102,1,3,"UPyD",0
43,"43048",830,547,530,16,17,"UPyD",2
19,"19053",2172,1602,1587,14,15,"UPyD",50
9,"9419",82,61,61,0,0,"UPyD",3
25,"25044",195,136,134,1,2,"UPyD",0
46,"46100",307,264,255,0,9,"UPyD",10
26,"26020",506,372,364,10,8,"UPyD",12
7,"7057",7102,4702,4611,85,91,"UPyD",122
18,"18176",265,183,181,0,2,"UPyD",5
20,"20904",98,67,66,0,1,"UPyD",0
17,"17024",301,207,204,4,3,"UPyD",0
7,"7050",3099,2008,1979,45,29,"UPyD",50
23,"23054",393,288,286,1,2,"UPyD",1
42,"42061",297,190,188,4,2,"UPyD",12
29,"29008",14069,9934,9859,118,75,"UPyD",339
40,"40136",130,106,106,1,0,"UPyD",3
8,"8240",9104,6355,6262,101,93,"UPyD",49
18,"18904",858,620,612,3,8,"UPyD",17
46,"46155",1072,861,849,4,12,"UPyD",21
20,"20066",467,316,316,0,0,"UPyD",0
50,"50165",1880,1339,1274,49,65,"UPyD",44
8,"8251",4771,3214,3140,57,74,"UPyD",31
16,"16216",358,300,296,2,4,"UPyD",4
9,"9169",96,80,80,1,0,"UPyD",1
9,"9464",44,28,28,0,0,"UPyD",1
4,"4036",246,205,204,1,1,"UPyD",4
6,"6052",3965,3176,3134,33,42,"UPyD",62
5,"5116",131,114,109,0,5,"UPyD",2
31,"31181",168,121,119,3,2,"UPyD",3
24,"24176",336,267,261,3,6,"UPyD",6
44,"44036",27,17,17,0,0,"UPyD",0
46,"46151",717,596,589,3,7,"UPyD",21
25,"25222",69,55,54,0,1,"UPyD",0
1,"1021",473,332,324,3,8,"UPyD",9
15,"15003",1936,1400,1382,19,18,"UPyD",8
19,"19214",94,78,78,2,0,"UPyD",5
13,"13091",570,484,478,0,6,"UPyD",2
45,"45087",8428,6434,6292,74,142,"UPyD",279
47,"47097",345,291,289,7,2,"UPyD",6
5,"5226",92,67,67,0,0,"UPyD",0
47,"47001",51,44,42,2,2,"UPyD",3
9,"9202",26,24,24,1,0,"UPyD",2
19,"19011",286,219,218,3,1,"UPyD",6
31,"31172",375,295,288,11,7,"UPyD",11
49,"49048",162,119,119,2,0,"UPyD",4
50,"50117",131,101,100,1,1,"UPyD",1
38,"38033",3987,2696,2656,23,40,"UPyD",30
3,"3121",20518,14464,14315,137,149,"UPyD",811
47,"47054",673,545,541,8,4,"UPyD",16
9,"9446",13,9,9,0,0,"UPyD",0
49,"49061",141,106,105,1,1,"UPyD",5
23,"23019",1590,1355,1339,7,16,"UPyD",30
45,"45125",2407,1977,1949,22,28,"UPyD",61
47,"47037",194,160,159,1,1,"UPyD",3
9,"9253",108,95,94,4,1,"UPyD",6
34,"34017",960,772,760,15,12,"UPyD",18
14,"14036",3774,2928,2909,51,19,"UPyD",83
37,"37117",1320,948,937,16,11,"UPyD",98
8,"8193",928,565,554,15,11,"UPyD",4
14,"14064",352,265,261,3,4,"UPyD",3
17,"17028",327,220,217,4,3,"UPyD",0
26,"26062",94,78,77,1,1,"UPyD",4
25,"25020",328,216,209,4,7,"UPyD",0
26,"26076",144,124,123,3,1,"UPyD",3
5,"5162",107,71,71,0,0,"UPyD",3
28,"28090",7899,6216,6131,60,85,"UPyD",723
40,"40190",50,41,40,1,1,"UPyD",5
44,"44052",96,60,59,2,1,"UPyD",2
36,"36014",2145,1568,1548,9,20,"UPyD",9
37,"37256",245,191,190,2,1,"UPyD",1
5,"5237",198,157,155,3,2,"UPyD",4
34,"34037",345,256,253,4,3,"UPyD",4
17,"17069",395,276,267,2,9,"UPyD",1
8,"8162",1955,1306,1271,28,35,"UPyD",6
19,"19331",2497,1898,1847,19,51,"UPyD",138
26,"26009",426,318,313,4,5,"UPyD",7
1,"1033",679,537,532,2,5,"UPyD",13
16,"16198",1451,1126,1105,21,21,"UPyD",17
47,"47036",257,212,212,1,0,"UPyD",10
10,"10203",4770,3397,3327,40,70,"UPyD",95
9,"9444",81,54,52,1,2,"UPyD",0
7,"7026",30036,16912,16661,294,251,"UPyD",902
20,"20031",179,114,113,1,1,"UPyD",0
15,"15016",5135,3816,3771,22,45,"UPyD",8
44,"44028",202,159,156,2,3,"UPyD",2
48,"48043",4256,3066,3040,33,26,"UPyD",20
45,"45039",236,197,190,2,7,"UPyD",6
25,"25233",270,207,201,3,6,"UPyD",1
25,"25161",361,222,218,1,4,"UPyD",0
5,"5214",46,23,23,1,0,"UPyD",1
36,"36053",5677,4204,4157,51,47,"UPyD",44
8,"8045",70,42,42,2,0,"UPyD",0
5,"5158",410,333,331,2,2,"UPyD",23
34,"34099",56,49,47,1,2,"UPyD",0
45,"45137",1610,1057,1047,11,10,"UPyD",39
42,"42192",43,36,36,2,0,"UPyD",4
22,"22226",823,640,627,11,13,"UPyD",18
25,"25053",1085,733,727,10,6,"UPyD",6
22,"22188",100,68,66,3,2,"UPyD",2
26,"26149",67,50,49,1,1,"UPyD",0
40,"40194",40248,30946,30365,525,581,"UPyD",2754
50,"50033",81,64,64,0,0,"UPyD",5
14,"14043",7664,5935,5874,53,61,"UPyD",150
44,"44031",124,72,72,0,0,"UPyD",0
9,"9406",242,193,193,2,0,"UPyD",20
11,"11033",19983,12960,12807,199,153,"UPyD",399
8,"8037",1830,1247,1209,40,38,"UPyD",4
43,"43091",142,106,98,5,8,"UPyD",0
37,"37284",334,256,254,1,2,"UPyD",4
47,"47027",2680,2059,2024,23,35,"UPyD",153
23,"23061",7309,5637,5584,60,53,"UPyD",124
49,"49028",119,103,103,1,0,"UPyD",5
41,"41901",2626,2190,2167,24,23,"UPyD",42
20,"20047",494,321,319,2,2,"UPyD",0
33,"33047",1178,939,931,2,8,"UPyD",7
1,"1039",211,164,158,1,6,"UPyD",7
15,"15006",5539,3940,3866,53,74,"UPyD",15
7,"7033",25954,14975,14738,328,237,"UPyD",456
16,"16204",306,235,235,5,0,"UPyD",1
24,"24216",782,582,574,3,8,"UPyD",7
37,"37239",235,208,201,2,7,"UPyD",8
25,"25045",51,33,33,2,0,"UPyD",2
5,"5154",46,35,35,0,0,"UPyD",1
42,"42124",71,50,50,0,0,"UPyD",2
37,"37342",252,216,211,3,5,"UPyD",12
3,"3023",1425,1259,1233,11,26,"UPyD",19
8,"8276",249,188,187,9,1,"UPyD",2
19,"19032",202,11,11,0,0,"UPyD",0
25,"25168",510,385,378,19,7,"UPyD",0
9,"9902",491,363,357,4,6,"UPyD",21
22,"22193",318,266,264,7,2,"UPyD",5
21,"21008",2717,1994,1978,11,16,"UPyD",16
18,"18912",1576,1193,1185,7,8,"UPyD",15
47,"47109",183,151,151,4,0,"UPyD",7
34,"34003",167,132,130,7,2,"UPyD",8
8,"8301",47343,32098,31664,672,434,"UPyD",669
8,"8056",39345,26705,26396,449,309,"UPyD",550
16,"16088",125,103,103,1,0,"UPyD",2
22,"22082",320,231,229,1,2,"UPyD",9
46,"46136",2476,1890,1865,16,25,"UPyD",83
18,"18111",2647,1957,1941,24,16,"UPyD",144
9,"9323",71,44,44,2,0,"UPyD",2
16,"16098",586,480,474,10,6,"UPyD",20
44,"44243",38,27,26,3,1,"UPyD",0
37,"37301",78,58,58,0,0,"UPyD",1
35,"35014",9943,5438,5316,95,122,"UPyD",109
40,"40084",65,53,53,2,0,"UPyD",4
34,"34062",175,126,124,3,2,"UPyD",2
46,"46248",4847,3655,3597,25,58,"UPyD",129
41,"41073",1789,1292,1272,5,20,"UPyD",40
21,"21040",3096,2370,2351,28,19,"UPyD",50
26,"26072",310,270,264,4,6,"UPyD",8
50,"50288",3252,2412,2380,50,32,"UPyD",167
34,"34086",105,89,89,1,0,"UPyD",12
5,"5160",339,290,286,2,4,"UPyD",8
43,"43138",2719,1775,1730,45,45,"UPyD",2
40,"40022",210,154,151,2,3,"UPyD",11
39,"39064",1339,1072,1066,7,6,"UPyD",31
24,"24174",525,393,387,6,6,"UPyD",5
37,"37328",218,155,149,2,6,"UPyD",6
37,"37364",893,653,644,10,9,"UPyD",19
24,"24202",8677,5486,5377,103,109,"UPyD",127
28,"28100",3970,2903,2865,32,38,"UPyD",291
19,"19104",16,12,12,1,0,"UPyD",0
22,"22186",217,173,173,3,0,"UPyD",4
36,"36048",5416,4045,3971,55,74,"UPyD",29
10,"10084",1416,994,972,12,22,"UPyD",11
4,"4057",1454,1081,1071,1,10,"UPyD",33
38,"38008",5430,3844,3772,46,72,"UPyD",57
16,"16025",31,23,23,0,0,"UPyD",0
19,"19066",78,63,62,0,1,"UPyD",1
9,"9057",155,125,124,0,1,"UPyD",3
37,"37350",452,368,364,5,4,"UPyD",9
42,"42058",129,103,101,1,2,"UPyD",2
26,"26063",131,104,102,2,2,"UPyD",2
10,"10124",873,707,707,16,0,"UPyD",8
42,"42088",69,56,56,1,0,"UPyD",1
25,"25242",787,501,490,11,11,"UPyD",0
21,"21042",15246,8640,8572,154,68,"UPyD",237
46,"46090",1668,1488,1452,9,36,"UPyD",52
8,"8051",17397,12178,12002,240,176,"UPyD",114
12,"12020",131,109,107,1,2,"UPyD",4
45,"45142",7974,6294,6178,89,116,"UPyD",270
49,"49067",416,300,300,2,0,"UPyD",2
16,"16126",811,701,692,13,9,"UPyD",11
18,"18906",955,736,731,5,5,"UPyD",11
8,"8044",4247,2763,2712,50,51,"UPyD",18
44,"44077",80,62,62,1,0,"UPyD",1
10,"10199",181,142,140,1,2,"UPyD",7
16,"16205",126,94,93,0,1,"UPyD",1
36,"36025",2442,1531,1516,10,15,"UPyD",9
24,"24180",1196,868,862,22,6,"UPyD",18
46,"46178",4406,3235,3201,22,34,"UPyD",294
37,"37341",52,32,32,0,0,"UPyD",0
37,"37306",316,194,192,1,2,"UPyD",3
30,"30016",149046,103847,102890,1031,957,"UPyD",7121
44,"44260",160,117,115,5,2,"UPyD",2
25,"25051",1710,1060,1044,23,16,"UPyD",3
48,"48097",1359,936,915,9,21,"UPyD",3
25,"25910",118,77,76,3,1,"UPyD",0
45,"45020",1396,1165,1151,15,14,"UPyD",17
47,"47116",426,363,358,0,5,"UPyD",4
10,"10135",1366,1004,998,3,6,"UPyD",6
17,"17171",148,111,109,5,2,"UPyD",0
9,"9361",134,99,98,0,1,"UPyD",3
28,"28053",6035,4854,4783,61,71,"UPyD",600
5,"5140",112,100,99,1,1,"UPyD",4
15,"15061",6105,4391,4307,64,84,"UPyD",10
12,"12027",16914,11657,11452,188,205,"UPyD",380
47,"47130",105,86,85,2,1,"UPyD",5
34,"34041",100,79,78,1,1,"UPyD",1
24,"24003",725,528,520,8,8,"UPyD",4
47,"47015",229,172,170,1,2,"UPyD",4
45,"45094",441,358,353,6,5,"UPyD",11
32,"32040",1587,1226,1219,7,7,"UPyD",7
10,"10902",727,608,599,5,9,"UPyD",5
11,"11016",14611,9848,9774,114,74,"UPyD",250
28,"28094",774,557,551,5,6,"UPyD",56
48,"48066",350,277,277,0,0,"UPyD",1
12,"12009",17124,12273,12098,150,175,"UPyD",455
37,"37209",376,258,253,4,5,"UPyD",22
40,"40181",4413,3439,3361,43,78,"UPyD",351
13,"13094",338,276,275,2,1,"UPyD",3
33,"33051",7576,5379,5335,65,44,"UPyD",94
28,"28096",16844,12441,12308,117,133,"UPyD",1439
7,"7901",642,483,470,5,13,"UPyD",12
49,"49019",256,206,205,5,1,"UPyD",8
49,"49057",125,98,94,1,4,"UPyD",5
43,"43116",494,328,325,5,3,"UPyD",0
28,"28118",72,49,47,1,2,"UPyD",1
28,"28086",4603,3286,3248,29,38,"UPyD",341
44,"44032",18,12,12,0,0,"UPyD",2
26,"26050",114,84,81,1,3,"UPyD",1
16,"16091",86,66,66,1,0,"UPyD",2
31,"31136",438,283,283,10,0,"UPyD",2
25,"25046",438,299,286,6,13,"UPyD",1
16,"16117",1130,871,857,8,14,"UPyD",26
44,"44197",60,37,37,1,0,"UPyD",0
38,"38017",24438,13769,13576,176,193,"UPyD",330
16,"16093",80,57,57,0,0,"UPyD",2
42,"42189",75,58,58,2,0,"UPyD",2
21,"21019",645,464,458,2,6,"UPyD",10
49,"49063",371,291,290,3,1,"UPyD",13
22,"22208",168,136,133,2,3,"UPyD",3
36,"36016",1373,865,853,7,12,"UPyD",3
6,"6147",390,321,319,3,2,"UPyD",6
31,"31228",540,376,364,13,12,"UPyD",11
40,"40091",140,111,109,1,2,"UPyD",9
26,"26095",126,102,102,0,0,"UPyD",5
10,"10184",771,609,597,7,12,"UPyD",9
46,"46259",537,426,424,9,2,"UPyD",26
17,"17228",280,172,170,4,2,"UPyD",1
29,"29016",272,180,179,5,1,"UPyD",5
26,"26035",22,14,14,0,0,"UPyD",1
9,"9128",82,65,63,0,2,"UPyD",2
12,"12039",870,743,736,4,7,"UPyD",13
9,"9303",92,64,64,0,0,"UPyD",1
37,"37054",273,230,229,2,1,"UPyD",4
4,"4002",1146,891,884,1,7,"UPyD",19
41,"41021",20767,14040,13822,240,218,"UPyD",835
42,"42064",92,76,76,0,0,"UPyD",0
31,"31211",25,14,14,2,0,"UPyD",0
18,"18187",587,432,432,0,0,"UPyD",4
16,"16231",47,43,43,0,0,"UPyD",0
4,"4072",339,272,271,0,1,"UPyD",4
37,"37079",77,64,63,1,1,"UPyD",5
42,"42153",19,16,16,0,0,"UPyD",0
19,"19251",41,35,34,0,1,"UPyD",0
8,"8281",4735,3239,3193,57,46,"UPyD",16
29,"29059",2551,1986,1964,11,22,"UPyD",40
43,"43159",89,51,51,2,0,"UPyD",1
7,"7045",1189,843,823,23,20,"UPyD",32
19,"19243",53,39,39,0,0,"UPyD",1
46,"46185",422,360,359,7,1,"UPyD",1
6,"6057",575,481,474,2,7,"UPyD",3
43,"43169",477,377,364,8,13,"UPyD",0
9,"9431",124,102,100,2,2,"UPyD",6
19,"19217",85,57,54,2,3,"UPyD",0
1,"1027",430,283,276,4,7,"UPyD",2
37,"37056",56,47,47,0,0,"UPyD",0
20,"20070",1109,817,815,4,2,"UPyD",2
16,"16102",1320,1016,1007,15,9,"UPyD",16
16,"16272",273,215,215,2,0,"UPyD",3
3,"3070",1962,1582,1552,8,30,"UPyD",42
42,"42056",26,23,22,1,1,"UPyD",0
31,"31215",4618,3384,3315,54,69,"UPyD",71
15,"15015",2840,2006,1964,43,42,"UPyD",23
39,"39061",3458,2673,2644,42,29,"UPyD",97
25,"25062",806,515,497,11,18,"UPyD",2
20,"20041",279,153,151,5,2,"UPyD",0
9,"9050",77,52,52,0,0,"UPyD",3
37,"37267",210,169,165,0,4,"UPyD",6
29,"29040",1934,1344,1332,12,12,"UPyD",46
42,"42050",29,20,20,1,0,"UPyD",1
31,"31239",302,229,224,7,5,"UPyD",0
40,"40158",24,18,17,0,1,"UPyD",1
47,"47020",283,237,232,5,5,"UPyD",4
49,"49068",523,356,353,5,3,"UPyD",5
9,"9417",43,38,38,0,0,"UPyD",2
43,"43092",7051,4294,4220,45,74,"UPyD",60
45,"45179",608,476,471,3,5,"UPyD",17
40,"40185",977,725,712,13,13,"UPyD",30
47,"47055",212,169,168,3,1,"UPyD",5
11,"11027",67042,43386,43065,557,321,"UPyD",2273
8,"8142",127,83,83,4,0,"UPyD",0
37,"37272",162,121,120,1,1,"UPyD",4
43,"43148",89309,59260,58346,1202,914,"UPyD",1017
17,"17225",208,138,134,1,4,"UPyD",2
45,"45122",4828,3816,3746,48,70,"UPyD",287
22,"22090",115,82,82,5,0,"UPyD",0
40,"40180",319,259,255,3,4,"UPyD",11
11,"11037",5640,4337,4285,32,52,"UPyD",69
33,"33056",5278,3576,3540,41,36,"UPyD",71
43,"43067",626,445,431,21,14,"UPyD",0
23,"23055",48167,33913,33612,400,301,"UPyD",1684
37,"37089",74,54,54,2,0,"UPyD",3
17,"17025",1127,775,760,11,15,"UPyD",1
17,"17184",1281,803,787,21,16,"UPyD",1
50,"50903",2234,1622,1597,35,25,"UPyD",106
19,"19326",1125,800,786,10,14,"UPyD",98
44,"44232",408,301,295,5,6,"UPyD",2
29,"29012",9817,7063,6991,51,72,"UPyD",242
47,"47113",166,136,135,1,1,"UPyD",0
48,"48005",93,65,64,0,1,"UPyD",0
9,"9398",92,68,68,2,0,"UPyD",2
46,"46085",11344,8526,8426,87,100,"UPyD",268
10,"10018",1761,1321,1296,17,25,"UPyD",22
42,"42163",53,41,41,0,0,"UPyD",2
43,"43164",298,233,231,4,2,"UPyD",0
40,"40195",946,722,707,13,15,"UPyD",31
42,"42092",89,60,60,0,0,"UPyD",6
42,"42211",92,69,68,0,1,"UPyD",7
8,"8087",158,133,132,6,1,"UPyD",0
21,"21050",12322,8772,8679,99,93,"UPyD",239
48,"48907",351,290,290,1,0,"UPyD",0
40,"40079",236,174,171,0,3,"UPyD",3
43,"43132",365,217,214,8,3,"UPyD",1
9,"9434",1167,916,902,24,14,"UPyD",82
9,"9439",909,720,697,16,23,"UPyD",74
14,"14061",841,700,693,3,7,"UPyD",11
24,"24166",1521,1137,1112,27,25,"UPyD",21
40,"40144",19,17,17,1,0,"UPyD",1
17,"17119",89,65,64,3,1,"UPyD",0
34,"34033",17,15,15,0,0,"UPyD",0
40,"40058",368,306,304,1,2,"UPyD",13
25,"25039",299,189,186,7,3,"UPyD",0
17,"17150",1428,1018,996,24,22,"UPyD",4
8,"8277",134,90,90,4,0,"UPyD",0
8,"8308",145,116,115,1,1,"UPyD",0
40,"40016",63,45,45,0,0,"UPyD",5
37,"37031",399,308,307,5,1,"UPyD",6
38,"38030",1875,1320,1301,11,19,"UPyD",18
26,"26086",18,17,17,0,0,"UPyD",0
16,"16186",521,434,429,2,5,"UPyD",7
10,"10153",331,266,263,1,3,"UPyD",1
1,"1010",2276,1649,1618,27,31,"UPyD",7
48,"48060",3689,2477,2466,12,11,"UPyD",4
37,"37059",132,110,110,2,0,"UPyD",1
5,"5143",81,61,61,0,0,"UPyD",1
16,"16101",160,142,142,0,0,"UPyD",1
28,"28059",4061,3169,3130,38,39,"UPyD",276
44,"44065",60,40,40,0,0,"UPyD",1
37,"37073",583,458,455,7,3,"UPyD",23
24,"24191",112,88,88,1,0,"UPyD",6
19,"19074",81,69,69,0,0,"UPyD",4
28,"28145",2125,1643,1620,15,23,"UPyD",143
8,"8235",3627,2506,2467,35,39,"UPyD",17
48,"48038",1087,826,821,7,5,"UPyD",6
49,"49075",153,128,122,0,6,"UPyD",2
39,"39002",3400,2554,2514,35,40,"UPyD",50
31,"31204",45,35,34,0,1,"UPyD",0
17,"17208",1012,642,622,12,20,"UPyD",3
42,"42019",562,392,383,9,9,"UPyD",14
8,"8053",2850,1788,1772,21,16,"UPyD",8
46,"46250",574266,435877,431619,4626,4258,"UPyD",32417
12,"12012",2747,2196,2135,24,61,"UPyD",58
30,"30009",11961,9992,9880,92,112,"UPyD",433
5,"5073",319,258,254,7,4,"UPyD",11
25,"25132",128,87,85,3,2,"UPyD",0
50,"50297",495260,360632,355561,7046,5071,"UPyD",26352
26,"26061",1552,1119,1099,31,20,"UPyD",43
9,"9133",39,33,33,1,0,"UPyD",2
16,"16125",1734,1367,1350,12,17,"UPyD",45
10,"10176",384,300,293,5,7,"UPyD",12
18,"18183",685,502,500,3,2,"UPyD",13
9,"9334",52,40,39,1,1,"UPyD",1
42,"42011",22,14,14,1,0,"UPyD",3
20,"20038",382,281,280,1,1,"UPyD",0
3,"3088",5381,4056,3988,47,68,"UPyD",224
38,"38028",22003,14876,14589,158,287,"UPyD",314
34,"34072",189,169,166,2,3,"UPyD",7
50,"50122",68,47,45,2,2,"UPyD",1
34,"34032",47,36,36,1,0,"UPyD",6
36,"36021",11798,8742,8574,136,168,"UPyD",112
26,"26178",88,74,73,1,1,"UPyD",1
46,"46038",368,264,260,1,4,"UxV",0
46,"46074",2656,2071,2053,22,18,"UxV",5
46,"46263",333,243,241,2,2,"UxV",0
46,"46200",1915,1625,1595,15,30,"UxV",1
46,"46154",836,684,678,7,6,"UxV",0
46,"46243",149,120,117,0,3,"UxV",0
46,"46127",2790,2298,2267,23,31,"UxV",5
46,"46224",179,131,128,0,3,"UxV",0
46,"46028",424,352,347,5,5,"UxV",0
46,"46120",1133,889,870,2,19,"UxV",3
46,"46174",1003,854,847,6,7,"UxV",1
46,"46131",49087,37846,37477,422,369,"UxV",43
46,"46216",4806,3857,3825,39,32,"UxV",3
46,"46235",21966,16641,16465,167,176,"UxV",13
46,"46201",83,50,49,0,1,"UxV",0
46,"46142",870,682,673,7,9,"UxV",0
46,"46262",228,161,158,0,3,"UxV",0
46,"46191",1952,1554,1528,9,26,"UxV",2
46,"46129",553,430,423,4,7,"UxV",0
46,"46029",20887,16124,15988,144,136,"UxV",48
46,"46171",16753,12565,12399,122,166,"UxV",17
46,"46220",48981,34657,34242,450,415,"UxV",29
46,"46196",159,145,144,1,1,"UxV",0
46,"46153",445,374,366,7,8,"UxV",0
46,"46081",10254,8188,8101,52,87,"UxV",10
46,"46069",166,149,148,1,1,"UxV",0
46,"46050",161,126,123,1,3,"UxV",0
46,"46159",23111,17258,17086,141,172,"UxV",24
46,"46207",6453,5086,5031,52,55,"UxV",7
46,"46192",755,564,554,9,10,"UxV",1
46,"46254",1085,847,834,12,13,"UxV",0
46,"46217",912,758,751,4,7,"UxV",0
46,"46039",2200,1849,1820,12,29,"UxV",0
46,"46046",922,699,694,2,5,"UxV",0
46,"46135",9634,7671,7586,64,85,"UxV",4
46,"46223",7685,6040,5996,62,44,"UxV",21
46,"46179",2186,1849,1804,17,45,"UxV",0
46,"46218",1082,964,936,5,28,"UxV",0
46,"46002",1166,942,915,7,27,"UxV",2
46,"46261",1706,1388,1366,13,22,"UxV",0
46,"46162",1230,1045,1027,6,18,"UxV",0
46,"46193",8494,6662,6580,73,82,"UxV",6
46,"46166",8260,6422,6324,60,98,"UxV",7
46,"46101",868,720,716,8,4,"UxV",1
46,"46007",11576,8929,8848,71,81,"UxV",18
46,"46061",331,276,273,3,3,"UxV",1
46,"46126",5471,4454,4392,53,62,"UxV",6
46,"46161",1454,1192,1179,8,13,"UxV",0
46,"46085",11344,8526,8426,87,100,"UxV",7
46,"46169",31753,24041,23802,270,239,"UxV",28
46,"46098",2556,2072,2057,12,15,"UxV",0
46,"46082",4661,3447,3401,46,46,"UxV",3
46,"46089",2116,1653,1627,9,26,"UxV",3
46,"46208",1141,990,978,6,12,"UxV",0
46,"46021",23273,17264,17091,163,173,"UxV",26
46,"46183",5946,4718,4656,35,62,"UxV",5
46,"46001",863,647,641,5,6,"UxV",0
46,"46252",142,108,107,1,1,"UxV",0
46,"46128",1649,1322,1292,14,30,"UxV",1
46,"46163",1811,1487,1463,12,24,"UxV",9
46,"46042",3376,2873,2819,17,54,"UxV",2
46,"46186",18444,14173,14029,135,144,"UxV",29
46,"46054",11422,8666,8566,82,100,"UxV",4
46,"46016",1097,927,917,12,10,"UxV",0
46,"46056",203,164,160,2,4,"UxV",0
46,"46066",1264,1060,1050,5,10,"UxV",1
46,"46228",2434,1881,1859,30,22,"UxV",2
46,"46147",16527,11836,11716,105,120,"UxV",13
46,"46246",1081,917,904,5,13,"UxV",9
46,"46008",2727,2249,2233,17,16,"UxV",1
46,"46240",226,188,185,3,3,"UxV",0
46,"46113",2338,1804,1797,14,7,"UxV",4
46,"46250",574266,435877,431619,4626,4258,"UxV",713
46,"46107",1998,1650,1623,8,27,"UxV",0
46,"46206",595,497,495,3,2,"UxV",0
46,"46055",1286,1083,1067,11,16,"UxV",2
46,"46079",381,304,299,3,5,"UxV",0
46,"46087",137,105,105,1,0,"UxV",0
46,"46245",478,357,354,1,3,"UxV",0
46,"46048",3484,2915,2875,26,40,"UxV",5
46,"46180",715,585,581,4,4,"UxV",1
46,"46238",13401,10371,10283,96,88,"UxV",6
46,"46118",3883,3141,3105,28,36,"UxV",1
46,"46903",5210,4037,4000,40,37,"UxV",2
46,"46231",2496,1831,1817,16,14,"UxV",3
46,"46213",15621,11361,11164,214,197,"UxV",3
46,"46018",689,597,592,12,5,"UxV",0
46,"46077",7637,5979,5845,64,134,"UxV",0
46,"46136",2476,1890,1865,16,25,"UxV",0
46,"46036",675,440,431,11,9,"UxV",1
46,"46244",57805,41885,41595,415,290,"UxV",99
46,"46012",930,698,684,9,14,"UxV",0
46,"46202",15578,11811,11676,110,135,"UxV",25
46,"46058",1787,1460,1441,10,19,"UxV",2
46,"46003",988,864,847,13,17,"UxV",2
46,"46148",1400,1131,1114,13,17,"UxV",2
46,"46109",6143,4731,4637,40,94,"UxV",5
46,"46094",20341,15367,15222,152,145,"UxV",23
46,"46198",815,660,654,4,6,"UxV",1
46,"46177",4594,3576,3523,29,53,"UxV",3
46,"46167",411,312,309,0,3,"UxV",0
46,"46248",4847,3655,3597,25,58,"UxV",1
46,"46037",1146,1007,1003,5,4,"UxV",2
46,"46143",4278,3309,3266,46,43,"UxV",7
46,"46070",15946,11979,11874,113,105,"UxV",33
46,"46093",2082,1722,1716,9,6,"UxV",2
46,"46119",856,702,693,0,9,"UxV",3
46,"46049",292,249,245,0,4,"UxV",1
46,"46026",1217,1043,1035,2,8,"UxV",1
46,"46041",369,255,255,1,0,"UxV",0
46,"46005",22815,17016,16838,185,178,"UxV",26
46,"46230",14204,10650,10515,112,135,"UxV",41
46,"46052",532,471,463,2,8,"UxV",0
46,"46160",1976,1591,1570,21,21,"UxV",1
46,"46241",440,336,314,4,22,"UxV",0
46,"46110",21420,15810,15671,134,139,"UxV",23
46,"46157",3068,2523,2491,17,32,"UxV",0
46,"46011",7727,5874,5777,75,97,"UxV",7
46,"46165",6962,5390,5322,53,68,"UxV",15
46,"46150",1898,1555,1541,8,14,"UxV",1
46,"46258",2792,2196,2164,14,32,"UxV",4
46,"46225",360,319,310,5,9,"UxV",0
46,"46009",3140,2521,2498,15,23,"UxV",1
46,"46063",1764,1441,1423,15,18,"UxV",1
46,"46023",318,275,267,2,8,"UxV",0
46,"46104",2012,1691,1676,9,15,"UxV",3
46,"46190",48324,34747,34424,431,323,"UxV",40
46,"46047",551,479,469,10,10,"UxV",0
46,"46155",1072,861,849,4,12,"UxV",0
46,"46004",1933,1563,1541,8,22,"UxV",2
46,"46140",379,314,313,0,1,"UxV",0
46,"46132",2124,1845,1817,14,28,"UxV",2
46,"46034",1791,1477,1468,8,9,"UxV",1
46,"46219",143,127,126,1,1,"UxV",0
46,"46080",1090,860,849,2,11,"UxV",1
46,"46040",1227,1028,1021,13,7,"UxV",0
46,"46256",6734,4902,4858,33,44,"UxV",9
46,"46242",361,288,280,4,8,"UxV",1
46,"46024",448,365,358,1,7,"UxV",0
46,"46064",547,463,458,2,5,"UxV",0
46,"46097",890,674,662,2,12,"UxV",2
46,"46137",273,232,229,1,3,"UxV",0
46,"46116",12587,9821,9724,120,97,"UxV",5
46,"46121",116,103,101,0,2,"UxV",0
46,"46146",1718,1395,1374,10,21,"UxV",2
46,"46057",483,357,349,9,8,"UxV",0
46,"46239",457,331,323,2,8,"UxV",1
46,"46122",2737,2154,2131,18,23,"UxV",1
46,"46027",997,869,855,4,14,"UxV",0
46,"46203",3669,3002,2964,36,38,"UxV",5
46,"46195",1975,1631,1631,33,0,"UxV",1
46,"46095",632,505,495,1,10,"UxV",1
46,"46033",220,183,181,0,2,"UxV",0
46,"46114",565,501,495,3,6,"UxV",0
46,"46092",304,206,201,1,5,"UxV",0
46,"46084",1587,1363,1332,7,31,"UxV",0
46,"46044",4301,3284,3169,50,115,"UxV",0
46,"46108",550,446,444,3,2,"UxV",0
46,"46229",1065,840,831,8,9,"UxV",0
46,"46045",1288,1065,1044,2,21,"UxV",2
46,"46904",782,659,650,6,9,"UxV",40
46,"46260",2576,2140,2106,24,34,"UxV",1
46,"46017",32928,24879,24672,267,207,"UxV",45
46,"46204",6906,5426,5357,62,69,"UxV",6
46,"46233",3911,3025,2988,10,37,"UxV",17
46,"46112",582,475,463,4,12,"UxV",0
46,"46197",1902,1559,1554,15,5,"UxV",1
46,"46236",996,853,844,7,9,"UxV",1
46,"46139",4594,3794,3734,28,60,"UxV",1
46,"46065",1606,1250,1234,15,16,"UxV",4
46,"46227",923,787,771,4,16,"UxV",0
46,"46115",515,364,354,1,10,"UxV",0
46,"46075",166,148,145,3,3,"UxV",0
46,"46051",8122,6432,6378,57,54,"UxV",6
46,"46221",350,319,317,3,2,"UxV",1
46,"46043",149,139,139,0,0,"UxV",0
46,"46172",4838,3492,3445,24,47,"UxV",5
46,"46222",378,321,310,1,11,"UxV",0
46,"46010",927,706,699,3,7,"UxV",0
46,"46232",920,730,722,6,8,"UxV",0
46,"46210",346,300,295,4,5,"UxV",0
46,"46020",3793,3084,3046,21,38,"UxV",1
46,"46173",1393,1156,1137,10,19,"UxV",0
46,"46138",338,297,296,1,1,"UxV",0
46,"46211",1716,1459,1447,9,12,"UxV",1
46,"46259",537,426,424,9,2,"UxV",0
46,"46022",15090,10922,10840,99,82,"UxV",14
46,"46181",17153,13332,13184,108,148,"UxV",18
46,"46214",15129,11609,11500,116,109,"UxV",14
46,"46185",422,360,359,7,1,"UxV",0
46,"46249",9650,7288,7191,125,97,"UxV",1
46,"46189",490,400,396,3,4,"UxV",0
46,"46068",326,292,285,3,7,"UxV",0
46,"46125",858,724,710,6,14,"UxV",2
46,"46178",4406,3235,3201,22,34,"UxV",2
46,"46031",10580,7900,7809,87,91,"UxV",12
46,"46188",660,579,576,4,3,"UxV",1
46,"46117",476,377,373,6,4,"UxV",0
46,"46015",7042,5644,5581,53,63,"UxV",10
46,"46158",1037,829,822,9,7,"UxV",0
46,"46152",96,70,70,0,0,"UxV",0
46,"46187",1339,1096,1083,13,13,"UxV",1
46,"46086",80,71,71,3,0,"UxV",0
46,"46199",5661,4328,4280,38,48,"UxV",5
46,"46209",1984,1606,1594,11,12,"UxV",4
46,"46182",1190,864,855,11,9,"UxV",1
46,"46099",987,764,754,2,10,"UxV",0
46,"46215",1451,1185,1169,8,16,"UxV",0
46,"46255",3135,2530,2508,11,22,"UxV",4
46,"46102",19880,15358,15179,122,179,"UxV",17
46,"46134",2326,1691,1664,20,27,"UxV",1
46,"46014",3092,2449,2420,26,29,"UxV",2
46,"46072",3711,3006,2932,38,74,"UxV",0
46,"46032",5583,4342,4287,39,55,"UxV",51
46,"46168",1828,1461,1449,7,12,"UxV",0
46,"46076",651,541,528,2,13,"UxV",0
46,"46253",118,105,102,7,3,"UxV",1
46,"46105",16708,12164,12040,100,124,"UxV",19
46,"46078",28197,20643,20415,205,228,"UxV",27
46,"46067",1798,1487,1472,10,15,"UxV",3
46,"46111",10589,7823,7710,94,113,"UxV",7
46,"46100",307,264,255,0,9,"UxV",0
46,"46130",934,745,734,6,11,"UxV",2
46,"46096",320,267,267,0,0,"UxV",0
46,"46124",768,641,632,10,9,"UxV",0
46,"46019",8671,7195,7109,70,86,"UxV",12
46,"46006",4643,3847,3785,32,62,"UxV",3
46,"46156",2065,1746,1721,14,25,"UxV",1
46,"46083",15427,12079,11941,109,138,"UxV",117
46,"46090",1668,1488,1452,9,36,"UxV",2
46,"46170",3464,2944,2908,24,36,"UxV",3
46,"46212",1598,1233,1218,5,15,"UxV",1
46,"46257",5579,4546,4512,32,34,"UxV",8
46,"46025",2495,1962,1941,24,21,"UxV",5
46,"46071",488,418,402,10,16,"UxV",0
46,"46141",424,338,336,2,2,"UxV",0
46,"46151",717,596,589,3,7,"UxV",0
46,"46053",584,484,461,2,23,"UxV",0
46,"46226",34,34,33,0,1,"UxV",0
46,"46194",15267,11622,11491,110,131,"UxV",21
46,"46164",11634,8843,8724,90,119,"UxV",9
46,"46902",425,333,332,3,1,"UxV",0
46,"46035",6470,5115,5047,38,68,"UxV",8
46,"46205",14277,10882,10764,115,118,"UxV",14
46,"46062",4589,3794,3752,46,42,"UxV",6
46,"46088",196,146,140,0,6,"UxV",1
46,"46030",800,677,662,6,15,"UxV",1
46,"46060",9510,7506,7408,52,98,"UxV",6
46,"46184",26507,20314,20010,263,304,"UxV",11
46,"46013",16111,12469,12328,145,141,"UxV",20
46,"46176",1965,1423,1405,12,18,"UxV",2
46,"46103",1244,998,972,12,26,"UxV",2
46,"46106",1616,1196,1188,6,8,"UxV",1
46,"46123",1808,1440,1410,7,30,"UxV",3
46,"46247",1059,829,823,6,6,"UxV",0
46,"46144",699,547,536,2,11,"UxV",1
46,"46059",1310,1076,1058,2,18,"UxV",0
46,"46234",388,308,307,3,1,"UxV",0
46,"46251",2599,2215,2179,21,36,"UxV",3
46,"46237",7261,5405,5350,54,55,"UxV",13
46,"46073",1119,931,915,14,16,"UxV",0
46,"46145",21751,16601,16397,155,204,"UxV",9
46,"46175",469,406,401,5,5,"UxV",0
46,"46133",686,572,565,1,7,"UxV",0
46,"46091",126,108,108,0,0,"UxV",0
46,"46149",398,307,305,1,2,"UxV",0
