"prov_code","muni_code","censo","votantes","validos","blancos","nulos","siglas","votos"
35,"35017",25447,15415,15079,127,336,"CANARIAS DE",32
35,"35032",3432,2541,2498,19,43,"CANARIAS DE",3
35,"35010",3548,2371,2336,20,35,"CANARIAS DE",4
35,"35009",19832,14305,14036,97,269,"CANARIAS DE",31
35,"35003",5125,2989,2929,21,60,"CANARIAS DE",6
35,"35031",7270,5184,5000,36,184,"CANARIAS DE",11
35,"35028",9705,5552,5478,64,74,"CANARIAS DE",9
35,"35012",10331,5684,5610,32,74,"CANARIAS DE",16
35,"35024",13621,8665,8555,76,110,"CANARIAS DE",14
35,"35030",9205,5602,5501,58,101,"CANARIAS DE",72
35,"35021",14942,10691,10537,80,154,"CANARIAS DE",12
35,"35018",12463,7628,7546,56,82,"CANARIAS DE",4
35,"35013",6609,4997,4881,51,116,"CANARIAS DE",6
35,"35014",11169,6234,6107,59,127,"CANARIAS DE",9
35,"35025",1801,1239,1216,9,23,"CANARIAS DE",5
35,"35006",30302,21967,21625,243,342,"CANARIAS DE",64
35,"35033",6378,4412,4354,24,58,"CANARIAS DE",8
35,"35015",9870,5451,5368,29,83,"CANARIAS DE",16
35,"35008",6109,4631,4542,37,89,"CANARIAS DE",14
35,"35019",32253,19902,19621,126,281,"CANARIAS DE",43
35,"35016",297974,198159,195935,1546,2224,"CANARIAS DE",552
35,"35011",23882,16369,16095,107,274,"CANARIAS DE",54
35,"35026",80806,53749,52665,450,1084,"CANARIAS DE",159
35,"35007",515,332,330,2,2,"CANARIAS DE",0
35,"35002",23129,15904,15675,74,229,"CANARIAS DE",72
35,"35027",10311,7497,7364,58,133,"CANARIAS DE",14
35,"35034",7707,3921,3872,30,49,"CANARIAS DE",9
35,"35004",38814,20869,20641,192,228,"CANARIAS DE",34
35,"35029",4125,2545,2514,34,31,"CANARIAS DE",3
35,"35020",6054,4073,4018,26,55,"CANARIAS DE",3
35,"35023",11680,8467,8295,75,172,"CANARIAS DE",19
35,"35022",48059,30474,30134,219,340,"CANARIAS DE",294
35,"35001",4599,3455,3396,27,59,"CANARIAS DE",6
35,"35005",1071,718,711,6,7,"CANARIAS DE",1
12,"12001",1054,798,786,8,12,"PSOE",224
12,"12071",1280,1002,988,5,14,"PSOE",248
12,"12082",9655,7570,7492,38,78,"PSOE",1537
12,"12127",77,56,56,0,0,"PSOE",25
12,"12009",17430,12600,12501,77,99,"PSOE",2807
12,"12045",354,282,279,2,3,"PSOE",103
12,"12074",784,690,678,9,12,"PSOE",225
12,"12056",285,243,238,3,5,"PSOE",52
12,"12065",192,166,166,0,0,"PSOE",43
12,"12140",1140,961,950,5,11,"PSOE",257
12,"12027",17217,12263,12122,77,141,"PSOE",2403
12,"12132",486,407,398,2,9,"PSOE",85
12,"12116",67,49,49,0,0,"PSOE",12
12,"12091",185,145,141,3,4,"PSOE",29
12,"12028",12566,9902,9830,55,72,"PSOE",1363
12,"12094",851,688,674,2,14,"PSOE",146
12,"12005",8090,6113,6027,57,86,"PSOE",1363
12,"12085",5061,3310,3264,20,46,"PSOE",607
12,"12002",116,98,96,0,2,"PSOE",31
12,"12069",74,50,49,0,1,"PSOE",6
12,"12075",123,94,92,1,2,"PSOE",24
12,"12038",171,121,120,1,1,"PSOE",20
12,"12067",543,442,424,1,18,"PSOE",136
12,"12057",606,495,487,3,8,"PSOE",131
12,"12048",249,196,192,1,4,"PSOE",64
12,"12108",463,395,390,0,5,"PSOE",87
12,"12133",60,49,49,0,0,"PSOE",11
12,"12083",95,82,80,0,2,"PSOE",30
12,"12100",1345,1115,1098,6,17,"PSOE",352
12,"12040",117832,89135,88464,525,671,"PSOE",16985
12,"12020",124,104,103,1,1,"PSOE",7
12,"12011",4587,3530,3480,30,50,"PSOE",1083
12,"12003",991,762,752,10,10,"PSOE",78
12,"12122",805,660,647,4,13,"PSOE",167
12,"12084",17599,13146,13022,98,124,"PSOE",3321
12,"12039",840,726,719,2,7,"PSOE",214
12,"12060",446,367,360,2,7,"PSOE",62
12,"12088",69,58,58,0,0,"PSOE",10
12,"12117",3576,2786,2747,17,39,"PSOE",677
12,"12029",717,572,566,6,6,"PSOE",163
12,"12109",647,531,520,1,11,"PSOE",168
12,"12099",542,434,405,9,29,"PSOE",71
12,"12137",37,26,26,1,0,"PSOE",13
12,"12129",1840,1391,1360,19,31,"PSOE",400
12,"12118",74,60,59,0,1,"PSOE",14
12,"12058",74,60,59,2,1,"PSOE",4
12,"12068",49,34,34,1,0,"PSOE",7
12,"12142",161,124,123,0,1,"PSOE",23
12,"12034",1430,1078,1053,4,25,"PSOE",325
12,"12004",4204,3174,3130,19,44,"PSOE",662
12,"12031",3830,3049,2987,20,62,"PSOE",497
12,"12105",851,666,659,5,7,"PSOE",114
12,"12077",4625,3443,3387,20,56,"PSOE",811
12,"12110",244,173,170,1,3,"PSOE",72
12,"12135",35749,27015,26806,174,209,"PSOE",5976
12,"12018",293,244,235,2,9,"PSOE",66
12,"12079",405,318,312,4,6,"PSOE",73
12,"12121",1127,955,928,6,27,"PSOE",364
12,"12032",23508,17400,17279,89,121,"PSOE",3474
12,"12010",259,216,209,6,7,"PSOE",64
12,"12103",89,69,68,2,1,"PSOE",6
12,"12095",974,789,784,8,5,"PSOE",254
12,"12078",339,250,247,1,3,"PSOE",55
12,"12063",42,35,34,2,1,"PSOE",10
12,"12053",2069,1691,1677,8,14,"PSOE",476
12,"12119",147,100,100,1,0,"PSOE",19
12,"12141",101,80,80,0,0,"PSOE",14
12,"12111",375,314,310,0,4,"PSOE",96
12,"12134",138,97,96,0,1,"PSOE",31
12,"12059",244,190,189,1,1,"PSOE",51
12,"12022",340,273,269,1,4,"PSOE",59
12,"12033",1907,1483,1436,11,47,"PSOE",336
12,"12087",26,18,18,3,0,"PSOE",2
12,"12093",189,147,145,1,2,"PSOE",29
12,"12112",99,81,79,1,2,"PSOE",29
12,"12044",483,438,431,4,7,"PSOE",155
12,"12139",322,239,237,1,2,"PSOE",16
12,"12014",184,140,136,1,4,"PSOE",46
12,"12006",176,140,140,1,0,"PSOE",48
12,"12136",2657,2302,2252,22,50,"PSOE",471
12,"12120",184,155,154,1,1,"PSOE",46
12,"12052",590,464,442,5,22,"PSOE",113
12,"12128",1400,1102,1091,11,11,"PSOE",306
12,"12102",536,452,437,1,15,"PSOE",163
12,"12041",97,77,77,0,0,"PSOE",9
12,"12061",378,275,275,4,0,"PSOE",88
12,"12012",2695,2236,2204,6,32,"PSOE",594
12,"12076",87,70,70,1,0,"PSOE",16
12,"12036",593,448,445,2,3,"PSOE",132
12,"12113",85,69,69,2,0,"PSOE",13
12,"12015",96,83,81,0,2,"PSOE",2
12,"12130",404,339,332,0,7,"PSOE",28
12,"12007",758,672,667,7,5,"PSOE",94
12,"12089",4331,3103,3050,25,53,"PSOE",441
12,"12092",112,84,84,0,0,"PSOE",17
12,"12124",1853,1411,1394,20,17,"PSOE",278
12,"12131",65,53,53,0,0,"PSOE",11
12,"12043",581,470,459,4,11,"PSOE",109
12,"12072",1117,962,937,8,25,"PSOE",289
12,"12064",97,83,82,0,1,"PSOE",23
12,"12138",19064,13610,13456,135,154,"PSOE",2780
12,"12126",24480,18885,18687,115,198,"PSOE",4130
12,"12114",200,150,149,1,1,"PSOE",32
12,"12016",1582,1311,1295,9,16,"PSOE",311
12,"12046",193,154,153,3,1,"PSOE",54
12,"12008",231,192,190,2,2,"PSOE",43
12,"12090",109,94,93,2,1,"PSOE",7
12,"12115",217,169,167,2,2,"PSOE",25
12,"12049",455,348,339,5,9,"PSOE",89
12,"12107",351,313,309,3,4,"PSOE",83
12,"12123",47,32,32,0,0,"PSOE",4
12,"12073",156,132,131,0,1,"PSOE",32
12,"12021",4442,3486,3432,25,54,"PSOE",850
12,"12096",775,587,580,12,7,"PSOE",213
12,"12013",148,119,116,4,3,"PSOE",21
12,"12101",363,282,273,3,9,"PSOE",51
12,"12070",524,418,408,8,10,"PSOE",129
12,"12055",106,79,79,2,0,"PSOE",6
12,"12026",894,697,676,14,21,"PSOE",163
12,"12902",2148,1562,1536,9,26,"PSOE",327
12,"12017",164,133,132,1,1,"PSOE",34
12,"12098",588,479,473,4,6,"PSOE",98
12,"12901",3433,2691,2664,27,27,"PSOE",676
12,"12097",67,55,54,0,1,"PSOE",7
12,"12080",1955,1647,1624,13,23,"PSOE",660
12,"12050",1320,1044,1032,8,12,"PSOE",344
12,"12125",214,185,183,2,2,"PSOE",55
12,"12025",137,106,106,0,0,"PSOE",23
12,"12104",6954,5571,5470,26,101,"PSOE",1219
12,"12042",621,520,512,13,8,"PSOE",89
12,"12024",139,115,113,1,2,"PSOE",31
12,"12037",16,14,14,0,0,"PSOE",4
12,"12051",477,337,335,2,2,"PSOE",28
12,"12106",1170,983,967,16,16,"PSOE",363
12,"12081",611,503,493,3,10,"PSOE",111
12,"12046",193,154,153,3,1,"PP",48
12,"12139",322,239,237,1,2,"PP",109
12,"12033",1907,1483,1436,11,47,"PP",497
12,"12069",74,50,49,0,1,"PP",16
12,"12077",4625,3443,3387,20,56,"PP",1033
12,"12138",19064,13610,13456,135,154,"PP",3706
12,"12020",124,104,103,1,1,"PP",68
12,"12053",2069,1691,1677,8,14,"PP",619
12,"12085",5061,3310,3264,20,46,"PP",1111
12,"12052",590,464,442,5,22,"PP",213
12,"12014",184,140,136,1,4,"PP",50
12,"12092",112,84,84,0,0,"PP",48
12,"12095",974,789,784,8,5,"PP",256
12,"12026",894,697,676,14,21,"PP",319
12,"12103",89,69,68,2,1,"PP",45
12,"12039",840,726,719,2,7,"PP",306
12,"12015",96,83,81,0,2,"PP",33
12,"12057",606,495,487,3,8,"PP",164
12,"12083",95,82,80,0,2,"PP",35
12,"12072",1117,962,937,8,25,"PP",362
12,"12128",1400,1102,1091,11,11,"PP",277
12,"12111",375,314,310,0,4,"PP",113
12,"12117",3576,2786,2747,17,39,"PP",842
12,"12068",49,34,34,1,0,"PP",18
12,"12012",2695,2236,2204,6,32,"PP",758
12,"12055",106,79,79,2,0,"PP",27
12,"12120",184,155,154,1,1,"PP",79
12,"12050",1320,1044,1032,8,12,"PP",358
12,"12080",1955,1647,1624,13,23,"PP",474
12,"12011",4587,3530,3480,30,50,"PP",898
12,"12130",404,339,332,0,7,"PP",249
12,"12121",1127,955,928,6,27,"PP",372
12,"12129",1840,1391,1360,19,31,"PP",333
12,"12141",101,80,80,0,0,"PP",40
12,"12021",4442,3486,3432,25,54,"PP",963
12,"12094",851,688,674,2,14,"PP",126
12,"12025",137,106,106,0,0,"PP",50
12,"12004",4204,3174,3130,19,44,"PP",1080
12,"12101",363,282,273,3,9,"PP",106
12,"12074",784,690,678,9,12,"PP",270
12,"12125",214,185,183,2,2,"PP",79
12,"12119",147,100,100,1,0,"PP",55
12,"12082",9655,7570,7492,38,78,"PP",2827
12,"12901",3433,2691,2664,27,27,"PP",773
12,"12100",1345,1115,1098,6,17,"PP",418
12,"12056",285,243,238,3,5,"PP",73
12,"12079",405,318,312,4,6,"PP",145
12,"12064",97,83,82,0,1,"PP",24
12,"12028",12566,9902,9830,55,72,"PP",3351
12,"12013",148,119,116,4,3,"PP",38
12,"12073",156,132,131,0,1,"PP",58
12,"12002",116,98,96,0,2,"PP",13
12,"12060",446,367,360,2,7,"PP",158
12,"12032",23508,17400,17279,89,121,"PP",5674
12,"12112",99,81,79,1,2,"PP",37
12,"12059",244,190,189,1,1,"PP",66
12,"12126",24480,18885,18687,115,198,"PP",5747
12,"12031",3830,3049,2987,20,62,"PP",854
12,"12001",1054,798,786,8,12,"PP",305
12,"12099",542,434,405,9,29,"PP",190
12,"12076",87,70,70,1,0,"PP",27
12,"12024",139,115,113,1,2,"PP",33
12,"12102",536,452,437,1,15,"PP",141
12,"12034",1430,1078,1053,4,25,"PP",297
12,"12089",4331,3103,3050,25,53,"PP",1229
12,"12018",293,244,235,2,9,"PP",81
12,"12081",611,503,493,3,10,"PP",187
12,"12061",378,275,275,4,0,"PP",91
12,"12114",200,150,149,1,1,"PP",56
12,"12041",97,77,77,0,0,"PP",48
12,"12109",647,531,520,1,11,"PP",155
12,"12071",1280,1002,988,5,14,"PP",389
12,"12096",775,587,580,12,7,"PP",173
12,"12137",37,26,26,1,0,"PP",6
12,"12115",217,169,167,2,2,"PP",88
12,"12075",123,94,92,1,2,"PP",31
12,"12065",192,166,166,0,0,"PP",93
12,"12134",138,97,96,0,1,"PP",30
12,"12010",259,216,209,6,7,"PP",76
12,"12124",1853,1411,1394,20,17,"PP",689
12,"12108",463,395,390,0,5,"PP",145
12,"12118",74,60,59,0,1,"PP",23
12,"12133",60,49,49,0,0,"PP",27
12,"12063",42,35,34,2,1,"PP",4
12,"12127",77,56,56,0,0,"PP",14
12,"12090",109,94,93,2,1,"PP",57
12,"12043",581,470,459,4,11,"PP",176
12,"12113",85,69,69,2,0,"PP",35
12,"12097",67,55,54,0,1,"PP",23
12,"12038",171,121,120,1,1,"PP",67
12,"12058",74,60,59,2,1,"PP",30
12,"12017",164,133,132,1,1,"PP",64
12,"12107",351,313,309,3,4,"PP",122
12,"12140",1140,961,950,5,11,"PP",322
12,"12098",588,479,473,4,6,"PP",206
12,"12088",69,58,58,0,0,"PP",35
12,"12016",1582,1311,1295,9,16,"PP",550
12,"12104",6954,5571,5470,26,101,"PP",1963
12,"12009",17430,12600,12501,77,99,"PP",3784
12,"12022",340,273,269,1,4,"PP",108
12,"12029",717,572,566,6,6,"PP",162
12,"12040",117832,89135,88464,525,671,"PP",26091
12,"12044",483,438,431,4,7,"PP",162
12,"12110",244,173,170,1,3,"PP",50
12,"12902",2148,1562,1536,9,26,"PP",587
12,"12070",524,418,408,8,10,"PP",158
12,"12048",249,196,192,1,4,"PP",77
12,"12078",339,250,247,1,3,"PP",121
12,"12105",851,666,659,5,7,"PP",365
12,"12067",543,442,424,1,18,"PP",169
12,"12005",8090,6113,6027,57,86,"PP",1900
12,"12084",17599,13146,13022,98,124,"PP",4421
12,"12037",16,14,14,0,0,"PP",4
12,"12091",185,145,141,3,4,"PP",61
12,"12027",17217,12263,12122,77,141,"PP",3701
12,"12006",176,140,140,1,0,"PP",42
12,"12007",758,672,667,7,5,"PP",294
12,"12106",1170,983,967,16,16,"PP",226
12,"12093",189,147,145,1,2,"PP",57
12,"12045",354,282,279,2,3,"PP",69
12,"12116",67,49,49,0,0,"PP",26
12,"12003",991,762,752,10,10,"PP",371
12,"12132",486,407,398,2,9,"PP",127
12,"12135",35749,27015,26806,174,209,"PP",7602
12,"12042",621,520,512,13,8,"PP",322
12,"12142",161,124,123,0,1,"PP",69
12,"12051",477,337,335,2,2,"PP",256
12,"12008",231,192,190,2,2,"PP",78
12,"12136",2657,2302,2252,22,50,"PP",1096
12,"12131",65,53,53,0,0,"PP",39
12,"12049",455,348,339,5,9,"PP",70
12,"12123",47,32,32,0,0,"PP",14
12,"12122",805,660,647,4,13,"PP",323
12,"12036",593,448,445,2,3,"PP",194
12,"12087",26,18,18,3,0,"PP",10
13,"13022",351,280,280,2,0,"PP",92
13,"13004",1052,827,816,1,11,"PP",360
13,"13038",1649,1317,1294,15,23,"PP",356
13,"13088",610,501,495,5,6,"PP",167
13,"13039",14383,10833,10684,100,149,"PP",4074
13,"13067",360,298,294,2,4,"PP",90
13,"13003",487,367,363,2,4,"PP",158
13,"13002",1500,1003,993,9,10,"PP",448
13,"13060",269,212,209,1,3,"PP",66
13,"13902",479,374,367,0,7,"PP",119
13,"13018",824,667,662,7,5,"PP",225
13,"13021",436,376,374,0,2,"PP",159
13,"13096",7677,5743,5661,51,82,"PP",2249
13,"13097",2282,1783,1768,12,15,"PP",763
13,"13076",488,415,408,1,7,"PP",209
13,"13053",14389,10624,10521,79,103,"PP",3677
13,"13011",4866,3346,3312,15,34,"PP",1054
13,"13052",6497,4715,4648,71,67,"PP",2085
13,"13033",1653,1395,1378,4,17,"PP",446
13,"13001",1270,985,977,8,8,"PP",343
13,"13089",1728,1410,1381,6,29,"PP",635
13,"13009",1459,1167,1156,4,11,"PP",638
13,"13082",25841,17702,17561,154,141,"PP",7561
13,"13066",2519,2057,2026,14,31,"PP",918
13,"13077",3518,2443,2378,12,65,"PP",847
13,"13065",2888,2004,1970,19,34,"PP",1030
13,"13042",928,696,688,3,8,"PP",302
13,"13054",4970,3911,3866,44,45,"PP",1873
13,"13070",765,612,605,4,7,"PP",237
13,"13041",253,182,180,0,2,"PP",68
13,"13085",2365,2011,1983,6,28,"PP",782
13,"13087",23161,16812,16595,145,217,"PP",5741
13,"13008",441,317,311,2,6,"PP",145
13,"13098",2124,1633,1591,15,42,"PP",721
13,"13043",231,186,185,5,1,"PP",98
13,"13057",1172,980,970,1,10,"PP",467
13,"13025",302,250,246,0,4,"PP",124
13,"13058",4110,3157,3127,28,30,"PP",1235
13,"13050",501,403,399,2,4,"PP",195
13,"13075",213,157,153,1,4,"PP",87
13,"13059",204,156,156,1,0,"PP",57
13,"13051",350,281,278,2,3,"PP",110
13,"13903",539,437,432,4,5,"PP",244
13,"13007",1273,1056,1028,10,28,"PP",355
13,"13035",986,791,784,7,7,"PP",240
13,"13079",12273,9195,9036,79,159,"PP",3254
13,"13023",9003,6578,6517,86,61,"PP",3903
13,"13092",1860,1544,1529,11,15,"PP",743
13,"13056",11354,8732,8634,48,98,"PP",2687
13,"13044",2675,1959,1920,12,39,"PP",751
13,"13055",666,495,490,0,5,"PP",186
13,"13072",775,570,565,5,5,"PP",273
13,"13069",666,518,508,3,10,"PP",186
13,"13037",865,678,667,2,11,"PP",307
13,"13045",679,532,522,7,10,"PP",262
13,"13904",527,411,406,8,5,"PP",161
13,"13049",814,585,579,0,6,"PP",275
13,"13012",411,294,292,0,2,"PP",90
13,"13024",898,643,637,7,6,"PP",272
13,"13005",23330,18245,18030,164,215,"PP",5915
13,"13090",1110,872,849,6,23,"PP",390
13,"13084",908,725,708,5,17,"PP",314
13,"13062",575,471,466,4,5,"PP",197
13,"13091",552,466,459,3,7,"PP",217
13,"13020",4792,3494,3451,26,43,"PP",1076
13,"13017",267,205,203,1,2,"PP",91
13,"13030",143,110,110,0,0,"PP",46
13,"13034",58010,44627,44241,332,386,"PP",18080
13,"13071",39775,28222,28052,175,170,"PP",7728
13,"13016",665,537,529,4,8,"PP",262
13,"13026",452,374,372,1,2,"PP",106
13,"13014",496,404,398,2,6,"PP",162
13,"13015",5494,4146,4106,18,40,"PP",1703
13,"13028",10416,8309,8171,77,138,"PP",3503
13,"13029",86,69,69,0,0,"PP",33
13,"13019",5179,3887,3830,35,57,"PP",1299
13,"13048",515,418,416,3,2,"PP",169
13,"13074",982,843,833,3,10,"PP",350
13,"13031",2455,1940,1914,9,26,"PP",818
13,"13094",308,253,249,3,4,"PP",123
13,"13093",4111,3056,3014,21,42,"PP",1245
13,"13073",542,409,405,0,4,"PP",187
13,"13061",5723,4210,4149,49,61,"PP",1549
13,"13068",1058,787,782,5,5,"PP",299
13,"13046",740,575,570,3,5,"PP",221
13,"13013",7086,5419,5340,45,79,"PP",2326
13,"13083",2453,1729,1690,14,39,"PP",820
13,"13040",892,720,710,3,10,"PP",276
13,"13063",3728,2708,2685,9,23,"PP",1037
13,"13010",887,673,665,0,8,"PP",296
13,"13078",9089,6661,6584,44,77,"PP",2620
13,"13032",1150,878,870,9,8,"PP",322
13,"13086",189,146,146,1,0,"PP",66
13,"13064",1684,1288,1283,13,5,"PP",411
13,"13006",608,487,479,4,8,"PP",202
13,"13095",83,65,65,1,0,"PP",36
13,"13027",3446,2543,2498,15,45,"PP",1056
13,"13081",652,525,508,2,17,"PP",195
13,"13036",800,620,614,3,6,"PP",276
13,"13047",5785,4462,4406,23,56,"PP",1735
13,"13080",350,265,265,1,0,"PP",125
13,"13901",895,676,660,4,16,"PP",274
12,"12033",1907,1483,1436,11,47,"PCPE",6
12,"12117",3576,2786,2747,17,39,"PCPE",5
12,"12056",285,243,238,3,5,"PCPE",0
12,"12096",775,587,580,12,7,"PCPE",2
12,"12065",192,166,166,0,0,"PCPE",0
12,"12053",2069,1691,1677,8,14,"PCPE",0
12,"12012",2695,2236,2204,6,32,"PCPE",7
12,"12006",176,140,140,1,0,"PCPE",2
12,"12004",4204,3174,3130,19,44,"PCPE",2
12,"12037",16,14,14,0,0,"PCPE",0
12,"12108",463,395,390,0,5,"PCPE",0
12,"12129",1840,1391,1360,19,31,"PCPE",1
12,"12082",9655,7570,7492,38,78,"PCPE",14
12,"12022",340,273,269,1,4,"PCPE",0
12,"12104",6954,5571,5470,26,101,"PCPE",7
12,"12076",87,70,70,1,0,"PCPE",0
12,"12036",593,448,445,2,3,"PCPE",0
12,"12138",19064,13610,13456,135,154,"PCPE",14
12,"12073",156,132,131,0,1,"PCPE",1
12,"12048",249,196,192,1,4,"PCPE",0
12,"12077",4625,3443,3387,20,56,"PCPE",1
12,"12137",37,26,26,1,0,"PCPE",0
12,"12102",536,452,437,1,15,"PCPE",0
12,"12071",1280,1002,988,5,14,"PCPE",6
12,"12044",483,438,431,4,7,"PCPE",0
12,"12001",1054,798,786,8,12,"PCPE",0
12,"12050",1320,1044,1032,8,12,"PCPE",2
12,"12013",148,119,116,4,3,"PCPE",2
12,"12040",117832,89135,88464,525,671,"PCPE",154
12,"12021",4442,3486,3432,25,54,"PCPE",8
12,"12084",17599,13146,13022,98,124,"PCPE",20
12,"12026",894,697,676,14,21,"PCPE",0
12,"12083",95,82,80,0,2,"PCPE",0
12,"12072",1117,962,937,8,25,"PCPE",1
12,"12121",1127,955,928,6,27,"PCPE",1
12,"12085",5061,3310,3264,20,46,"PCPE",4
12,"12074",784,690,678,9,12,"PCPE",0
12,"12045",354,282,279,2,3,"PCPE",0
12,"12024",139,115,113,1,2,"PCPE",0
12,"12100",1345,1115,1098,6,17,"PCPE",1
12,"12078",339,250,247,1,3,"PCPE",0
12,"12101",363,282,273,3,9,"PCPE",0
12,"12120",184,155,154,1,1,"PCPE",0
12,"12141",101,80,80,0,0,"PCPE",0
12,"12009",17430,12600,12501,77,99,"PCPE",24
12,"12125",214,185,183,2,2,"PCPE",0
12,"12051",477,337,335,2,2,"PCPE",0
12,"12014",184,140,136,1,4,"PCPE",0
12,"12068",49,34,34,1,0,"PCPE",0
12,"12113",85,69,69,2,0,"PCPE",0
12,"12092",112,84,84,0,0,"PCPE",0
12,"12081",611,503,493,3,10,"PCPE",0
12,"12109",647,531,520,1,11,"PCPE",1
12,"12901",3433,2691,2664,27,27,"PCPE",3
12,"12111",375,314,310,0,4,"PCPE",0
12,"12059",244,190,189,1,1,"PCPE",0
12,"12110",244,173,170,1,3,"PCPE",0
12,"12041",97,77,77,0,0,"PCPE",0
12,"12134",138,97,96,0,1,"PCPE",1
12,"12088",69,58,58,0,0,"PCPE",0
12,"12115",217,169,167,2,2,"PCPE",0
12,"12049",455,348,339,5,9,"PCPE",1
12,"12112",99,81,79,1,2,"PCPE",0
12,"12089",4331,3103,3050,25,53,"PCPE",6
12,"12043",581,470,459,4,11,"PCPE",1
12,"12028",12566,9902,9830,55,72,"PCPE",17
12,"12011",4587,3530,3480,30,50,"PCPE",6
12,"12039",840,726,719,2,7,"PCPE",0
12,"12128",1400,1102,1091,11,11,"PCPE",3
12,"12133",60,49,49,0,0,"PCPE",0
12,"12093",189,147,145,1,2,"PCPE",0
12,"12127",77,56,56,0,0,"PCPE",0
12,"12087",26,18,18,3,0,"PCPE",0
12,"12123",47,32,32,0,0,"PCPE",0
12,"12055",106,79,79,2,0,"PCPE",0
12,"12106",1170,983,967,16,16,"PCPE",1
12,"12095",974,789,784,8,5,"PCPE",1
12,"12097",67,55,54,0,1,"PCPE",0
12,"12038",171,121,120,1,1,"PCPE",0
12,"12046",193,154,153,3,1,"PCPE",0
12,"12063",42,35,34,2,1,"PCPE",0
12,"12094",851,688,674,2,14,"PCPE",1
12,"12107",351,313,309,3,4,"PCPE",0
12,"12119",147,100,100,1,0,"PCPE",0
12,"12091",185,145,141,3,4,"PCPE",0
12,"12079",405,318,312,4,6,"PCPE",0
12,"12098",588,479,473,4,6,"PCPE",0
12,"12902",2148,1562,1536,9,26,"PCPE",0
12,"12105",851,666,659,5,7,"PCPE",2
12,"12003",991,762,752,10,10,"PCPE",3
12,"12132",486,407,398,2,9,"PCPE",0
12,"12061",378,275,275,4,0,"PCPE",3
12,"12042",621,520,512,13,8,"PCPE",0
12,"12090",109,94,93,2,1,"PCPE",0
12,"12016",1582,1311,1295,9,16,"PCPE",2
12,"12005",8090,6113,6027,57,86,"PCPE",9
12,"12032",23508,17400,17279,89,121,"PCPE",30
12,"12135",35749,27015,26806,174,209,"PCPE",57
12,"12136",2657,2302,2252,22,50,"PCPE",1
12,"12064",97,83,82,0,1,"PCPE",0
12,"12015",96,83,81,0,2,"PCPE",0
12,"12069",74,50,49,0,1,"PCPE",0
12,"12018",293,244,235,2,9,"PCPE",1
12,"12075",123,94,92,1,2,"PCPE",0
12,"12140",1140,961,950,5,11,"PCPE",1
12,"12067",543,442,424,1,18,"PCPE",1
12,"12099",542,434,405,9,29,"PCPE",0
12,"12126",24480,18885,18687,115,198,"PCPE",41
12,"12027",17217,12263,12122,77,141,"PCPE",13
12,"12103",89,69,68,2,1,"PCPE",0
12,"12057",606,495,487,3,8,"PCPE",0
12,"12060",446,367,360,2,7,"PCPE",0
12,"12010",259,216,209,6,7,"PCPE",0
12,"12070",524,418,408,8,10,"PCPE",0
12,"12031",3830,3049,2987,20,62,"PCPE",5
12,"12029",717,572,566,6,6,"PCPE",4
12,"12122",805,660,647,4,13,"PCPE",0
12,"12020",124,104,103,1,1,"PCPE",0
12,"12052",590,464,442,5,22,"PCPE",0
12,"12142",161,124,123,0,1,"PCPE",0
12,"12131",65,53,53,0,0,"PCPE",1
12,"12025",137,106,106,0,0,"PCPE",0
12,"12034",1430,1078,1053,4,25,"PCPE",2
12,"12017",164,133,132,1,1,"PCPE",0
12,"12116",67,49,49,0,0,"PCPE",0
12,"12058",74,60,59,2,1,"PCPE",0
12,"12114",200,150,149,1,1,"PCPE",0
12,"12080",1955,1647,1624,13,23,"PCPE",0
12,"12118",74,60,59,0,1,"PCPE",1
12,"12130",404,339,332,0,7,"PCPE",0
12,"12007",758,672,667,7,5,"PCPE",0
12,"12124",1853,1411,1394,20,17,"PCPE",0
12,"12002",116,98,96,0,2,"PCPE",1
12,"12008",231,192,190,2,2,"PCPE",0
12,"12139",322,239,237,1,2,"PCPE",0
11,"11022",48778,26546,26333,277,213,"PSOE",7711
11,"11013",2324,1687,1653,16,34,"PSOE",748
11,"11007",18036,10832,10678,181,154,"PSOE",3204
11,"11035",13569,9000,8908,93,92,"PSOE",3023
11,"11003",1270,907,899,12,8,"PSOE",444
11,"11040",398,326,317,3,9,"PSOE",166
11,"11030",22796,15377,15222,145,155,"PSOE",3976
11,"11016",14880,9945,9848,124,97,"PSOE",2828
11,"11011",1688,1239,1205,14,34,"PSOE",449
11,"11019",1830,1413,1371,5,42,"PSOE",534
11,"11902",3619,2431,2410,17,21,"PSOE",1041
11,"11027",68010,46675,46322,400,353,"PSOE",9129
11,"11033",20773,13487,13333,171,154,"PSOE",4486
11,"11031",76452,51850,51456,568,394,"PSOE",11978
11,"11026",4804,3581,3511,31,70,"PSOE",1331
11,"11020",165400,113865,113092,1184,773,"PSOE",30086
11,"11002",4287,3245,3238,15,7,"PSOE",1363
11,"11017",3207,2389,2362,28,27,"PSOE",1062
11,"11025",4370,3174,3123,29,51,"PSOE",1739
11,"11041",9856,7043,6967,85,76,"PSOE",2571
11,"11015",62337,40342,40012,407,330,"PSOE",10249
11,"11008",17460,11800,11615,151,185,"PSOE",3610
11,"11038",13803,10593,10441,121,152,"PSOE",3653
11,"11037",5678,4491,4426,20,65,"PSOE",1047
11,"11001",4377,2949,2900,17,49,"PSOE",1556
11,"11012",100460,72741,72128,590,613,"PSOE",13762
11,"11042",1189,877,868,5,9,"PSOE",444
11,"11023",9354,6990,6928,86,62,"PSOE",3053
11,"11036",694,439,437,13,2,"PSOE",192
11,"11006",24504,16649,16486,176,163,"PSOE",7050
11,"11039",10044,6684,6623,98,61,"PSOE",2329
11,"11005",4560,3203,3143,21,60,"PSOE",1537
11,"11021",6777,4826,4779,52,47,"PSOE",2023
11,"11010",6420,4423,4362,63,61,"PSOE",1780
11,"11034",2345,1606,1594,10,12,"PSOE",925
11,"11009",602,426,422,5,4,"PSOE",138
11,"11018",1485,1109,1090,10,19,"PSOE",440
11,"11004",88617,55218,54733,581,485,"PSOE",14190
11,"11901",5653,4132,4088,84,44,"PSOE",1887
11,"11032",53898,32432,32172,371,260,"PSOE",9886
11,"11029",5433,3112,3067,27,45,"PSOE",1437
11,"11014",16791,11255,11146,166,109,"PSOE",3075
11,"11024",6735,5114,5065,33,49,"PSOE",2227
11,"11028",32532,23191,22981,274,210,"PSOE",6308
12,"12091",185,145,141,3,4,"C's",25
12,"12073",156,132,131,0,1,"C's",14
12,"12128",1400,1102,1091,11,11,"C's",184
12,"12033",1907,1483,1436,11,47,"C's",196
12,"12004",4204,3174,3130,19,44,"C's",427
12,"12100",1345,1115,1098,6,17,"C's",91
12,"12063",42,35,34,2,1,"C's",3
12,"12129",1840,1391,1360,19,31,"C's",120
12,"12016",1582,1311,1295,9,16,"C's",130
12,"12092",112,84,84,0,0,"C's",5
12,"12132",486,407,398,2,9,"C's",38
12,"12002",116,98,96,0,2,"C's",3
12,"12077",4625,3443,3387,20,56,"C's",527
12,"12104",6954,5571,5470,26,101,"C's",800
12,"12119",147,100,100,1,0,"C's",10
12,"12109",647,531,520,1,11,"C's",80
12,"12137",37,26,26,1,0,"C's",0
12,"12037",16,14,14,0,0,"C's",1
12,"12039",840,726,719,2,7,"C's",60
12,"12067",543,442,424,1,18,"C's",29
12,"12099",542,434,405,9,29,"C's",47
12,"12036",593,448,445,2,3,"C's",34
12,"12141",101,80,80,0,0,"C's",14
12,"12061",378,275,275,4,0,"C's",23
12,"12001",1054,798,786,8,12,"C's",65
12,"12081",611,503,493,3,10,"C's",66
12,"12031",3830,3049,2987,20,62,"C's",476
12,"12088",69,58,58,0,0,"C's",2
12,"12097",67,55,54,0,1,"C's",5
12,"12108",463,395,390,0,5,"C's",51
12,"12046",193,154,153,3,1,"C's",14
12,"12070",524,418,408,8,10,"C's",19
12,"12094",851,688,674,2,14,"C's",97
12,"12102",536,452,437,1,15,"C's",57
12,"12093",189,147,145,1,2,"C's",9
12,"12010",259,216,209,6,7,"C's",23
12,"12115",217,169,167,2,2,"C's",32
12,"12087",26,18,18,3,0,"C's",1
12,"12105",851,666,659,5,7,"C's",66
12,"12011",4587,3530,3480,30,50,"C's",374
12,"12090",109,94,93,2,1,"C's",14
12,"12005",8090,6113,6027,57,86,"C's",855
12,"12142",161,124,123,0,1,"C's",24
12,"12052",590,464,442,5,22,"C's",40
12,"12043",581,470,459,4,11,"C's",53
12,"12051",477,337,335,2,2,"C's",13
12,"12136",2657,2302,2252,22,50,"C's",298
12,"12083",95,82,80,0,2,"C's",6
12,"12076",87,70,70,1,0,"C's",9
12,"12120",184,155,154,1,1,"C's",7
12,"12014",184,140,136,1,4,"C's",10
12,"12059",244,190,189,1,1,"C's",14
12,"12060",446,367,360,2,7,"C's",30
12,"12058",74,60,59,2,1,"C's",11
12,"12107",351,313,309,3,4,"C's",38
12,"12040",117832,89135,88464,525,671,"C's",16277
12,"12057",606,495,487,3,8,"C's",44
12,"12042",621,520,512,13,8,"C's",42
12,"12127",77,56,56,0,0,"C's",2
12,"12056",285,243,238,3,5,"C's",22
12,"12003",991,762,752,10,10,"C's",97
12,"12009",17430,12600,12501,77,99,"C's",2223
12,"12111",375,314,310,0,4,"C's",20
12,"12034",1430,1078,1053,4,25,"C's",128
12,"12140",1140,961,950,5,11,"C's",91
12,"12025",137,106,106,0,0,"C's",1
12,"12069",74,50,49,0,1,"C's",17
12,"12018",293,244,235,2,9,"C's",26
12,"12113",85,69,69,2,0,"C's",6
12,"12055",106,79,79,2,0,"C's",10
12,"12049",455,348,339,5,9,"C's",41
12,"12117",3576,2786,2747,17,39,"C's",398
12,"12068",49,34,34,1,0,"C's",3
12,"12089",4331,3103,3050,25,53,"C's",501
12,"12044",483,438,431,4,7,"C's",25
12,"12045",354,282,279,2,3,"C's",20
12,"12032",23508,17400,17279,89,121,"C's",3086
12,"12135",35749,27015,26806,174,209,"C's",4390
12,"12041",97,77,77,0,0,"C's",10
12,"12098",588,479,473,4,6,"C's",64
12,"12020",124,104,103,1,1,"C's",17
12,"12026",894,697,676,14,21,"C's",62
12,"12072",1117,962,937,8,25,"C's",112
12,"12106",1170,983,967,16,16,"C's",100
12,"12131",65,53,53,0,0,"C's",1
12,"12022",340,273,269,1,4,"C's",30
12,"12085",5061,3310,3264,20,46,"C's",617
12,"12064",97,83,82,0,1,"C's",5
12,"12021",4442,3486,3432,25,54,"C's",395
12,"12902",2148,1562,1536,9,26,"C's",222
12,"12133",60,49,49,0,0,"C's",4
12,"12024",139,115,113,1,2,"C's",15
12,"12017",164,133,132,1,1,"C's",14
12,"12130",404,339,332,0,7,"C's",23
12,"12101",363,282,273,3,9,"C's",24
12,"12029",717,572,566,6,6,"C's",52
12,"12038",171,121,120,1,1,"C's",12
12,"12075",123,94,92,1,2,"C's",8
12,"12084",17599,13146,13022,98,124,"C's",1875
12,"12103",89,69,68,2,1,"C's",10
12,"12065",192,166,166,0,0,"C's",11
12,"12078",339,250,247,1,3,"C's",13
12,"12015",96,83,81,0,2,"C's",6
12,"12028",12566,9902,9830,55,72,"C's",2108
12,"12134",138,97,96,0,1,"C's",7
12,"12079",405,318,312,4,6,"C's",41
12,"12012",2695,2236,2204,6,32,"C's",206
12,"12071",1280,1002,988,5,14,"C's",98
12,"12123",47,32,32,0,0,"C's",4
12,"12080",1955,1647,1624,13,23,"C's",154
12,"12007",758,672,667,7,5,"C's",48
12,"12901",3433,2691,2664,27,27,"C's",512
12,"12053",2069,1691,1677,8,14,"C's",156
12,"12095",974,789,784,8,5,"C's",78
12,"12124",1853,1411,1394,20,17,"C's",152
12,"12121",1127,955,928,6,27,"C's",52
12,"12122",805,660,647,4,13,"C's",51
12,"12118",74,60,59,0,1,"C's",10
12,"12074",784,690,678,9,12,"C's",68
12,"12050",1320,1044,1032,8,12,"C's",78
12,"12110",244,173,170,1,3,"C's",12
12,"12082",9655,7570,7492,38,78,"C's",1055
12,"12112",99,81,79,1,2,"C's",9
12,"12138",19064,13610,13456,135,154,"C's",1843
12,"12006",176,140,140,1,0,"C's",11
12,"12125",214,185,183,2,2,"C's",9
12,"12116",67,49,49,0,0,"C's",7
12,"12139",322,239,237,1,2,"C's",16
12,"12096",775,587,580,12,7,"C's",29
12,"12048",249,196,192,1,4,"C's",21
12,"12126",24480,18885,18687,115,198,"C's",2491
12,"12008",231,192,190,2,2,"C's",9
12,"12013",148,119,116,4,3,"C's",14
12,"12114",200,150,149,1,1,"C's",10
12,"12027",17217,12263,12122,77,141,"C's",2049
11,"11008",17460,11800,11615,151,185,"C's",2001
11,"11024",6735,5114,5065,33,49,"C's",583
11,"11014",16791,11255,11146,166,109,"C's",1432
11,"11013",2324,1687,1653,16,34,"C's",189
11,"11011",1688,1239,1205,14,34,"C's",150
11,"11016",14880,9945,9848,124,97,"C's",1316
11,"11002",4287,3245,3238,15,7,"C's",83
11,"11004",88617,55218,54733,581,485,"C's",10026
11,"11005",4560,3203,3143,21,60,"C's",251
11,"11901",5653,4132,4088,84,44,"C's",368
11,"11025",4370,3174,3123,29,51,"C's",192
11,"11036",694,439,437,13,2,"C's",9
11,"11010",6420,4423,4362,63,61,"C's",354
11,"11042",1189,877,868,5,9,"C's",71
11,"11019",1830,1413,1371,5,42,"C's",122
11,"11035",13569,9000,8908,93,92,"C's",1098
11,"11022",48778,26546,26333,277,213,"C's",4382
11,"11001",4377,2949,2900,17,49,"C's",251
11,"11017",3207,2389,2362,28,27,"C's",169
11,"11030",22796,15377,15222,145,155,"C's",2685
11,"11037",5678,4491,4426,20,65,"C's",176
11,"11902",3619,2431,2410,17,21,"C's",189
11,"11027",68010,46675,46322,400,353,"C's",7737
11,"11028",32532,23191,22981,274,210,"C's",2482
11,"11003",1270,907,899,12,8,"C's",63
11,"11038",13803,10593,10441,121,152,"C's",1454
11,"11009",602,426,422,5,4,"C's",42
11,"11023",9354,6990,6928,86,62,"C's",659
11,"11021",6777,4826,4779,52,47,"C's",562
11,"11033",20773,13487,13333,171,154,"C's",1922
11,"11032",53898,32432,32172,371,260,"C's",4547
11,"11031",76452,51850,51456,568,394,"C's",9158
11,"11034",2345,1606,1594,10,12,"C's",131
11,"11018",1485,1109,1090,10,19,"C's",101
11,"11020",165400,113865,113092,1184,773,"C's",18364
11,"11041",9856,7043,6967,85,76,"C's",803
11,"11026",4804,3581,3511,31,70,"C's",513
11,"11007",18036,10832,10678,181,154,"C's",1096
11,"11012",100460,72741,72128,590,613,"C's",9406
11,"11006",24504,16649,16486,176,163,"C's",1934
11,"11040",398,326,317,3,9,"C's",44
11,"11039",10044,6684,6623,98,61,"C's",742
11,"11029",5433,3112,3067,27,45,"C's",159
11,"11015",62337,40342,40012,407,330,"C's",6691
13,"13077",3518,2443,2378,12,65,"PSOE",808
13,"13063",3728,2708,2685,9,23,"PSOE",936
13,"13087",23161,16812,16595,145,217,"PSOE",4610
13,"13025",302,250,246,0,4,"PSOE",100
13,"13043",231,186,185,5,1,"PSOE",63
13,"13026",452,374,372,1,2,"PSOE",146
13,"13056",11354,8732,8634,48,98,"PSOE",2498
13,"13079",12273,9195,9036,79,159,"PSOE",3465
13,"13098",2124,1633,1591,15,42,"PSOE",517
13,"13006",608,487,479,4,8,"PSOE",226
13,"13096",7677,5743,5661,51,82,"PSOE",1890
13,"13076",488,415,408,1,7,"PSOE",158
13,"13094",308,253,249,3,4,"PSOE",78
13,"13054",4970,3911,3866,44,45,"PSOE",1134
13,"13038",1649,1317,1294,15,23,"PSOE",713
13,"13033",1653,1395,1378,4,17,"PSOE",718
13,"13091",552,466,459,3,7,"PSOE",193
13,"13008",441,317,311,2,6,"PSOE",107
13,"13029",86,69,69,0,0,"PSOE",18
13,"13070",765,612,605,4,7,"PSOE",233
13,"13021",436,376,374,0,2,"PSOE",134
13,"13028",10416,8309,8171,77,138,"PSOE",2461
13,"13018",824,667,662,7,5,"PSOE",307
13,"13047",5785,4462,4406,23,56,"PSOE",1542
13,"13904",527,411,406,8,5,"PSOE",150
13,"13081",652,525,508,2,17,"PSOE",245
13,"13030",143,110,110,0,0,"PSOE",40
13,"13040",892,720,710,3,10,"PSOE",254
13,"13014",496,404,398,2,6,"PSOE",189
13,"13068",1058,787,782,5,5,"PSOE",306
13,"13084",908,725,708,5,17,"PSOE",274
13,"13053",14389,10624,10521,79,103,"PSOE",3176
13,"13095",83,65,65,1,0,"PSOE",13
13,"13067",360,298,294,2,4,"PSOE",132
13,"13901",895,676,660,4,16,"PSOE",254
13,"13001",1270,985,977,8,8,"PSOE",488
13,"13007",1273,1056,1028,10,28,"PSOE",412
13,"13023",9003,6578,6517,86,61,"PSOE",1299
13,"13093",4111,3056,3014,21,42,"PSOE",901
13,"13035",986,791,784,7,7,"PSOE",348
13,"13012",411,294,292,0,2,"PSOE",147
13,"13052",6497,4715,4648,71,67,"PSOE",1452
13,"13010",887,673,665,0,8,"PSOE",269
13,"13009",1459,1167,1156,4,11,"PSOE",315
13,"13055",666,495,490,0,5,"PSOE",220
13,"13048",515,418,416,3,2,"PSOE",130
13,"13036",800,620,614,3,6,"PSOE",235
13,"13073",542,409,405,0,4,"PSOE",178
13,"13034",58010,44627,44241,332,386,"PSOE",9218
13,"13069",666,518,508,3,10,"PSOE",246
13,"13031",2455,1940,1914,9,26,"PSOE",678
13,"13046",740,575,570,3,5,"PSOE",273
13,"13057",1172,980,970,1,10,"PSOE",350
13,"13042",928,696,688,3,8,"PSOE",285
13,"13004",1052,827,816,1,11,"PSOE",343
13,"13037",865,678,667,2,11,"PSOE",267
13,"13027",3446,2543,2498,15,45,"PSOE",1041
13,"13024",898,643,637,7,6,"PSOE",264
13,"13049",814,585,579,0,6,"PSOE",184
13,"13086",189,146,146,1,0,"PSOE",60
13,"13074",982,843,833,3,10,"PSOE",329
13,"13017",267,205,203,1,2,"PSOE",83
13,"13066",2519,2057,2026,14,31,"PSOE",740
13,"13050",501,403,399,2,4,"PSOE",125
13,"13902",479,374,367,0,7,"PSOE",155
13,"13080",350,265,265,1,0,"PSOE",103
13,"13085",2365,2011,1983,6,28,"PSOE",803
13,"13020",4792,3494,3451,26,43,"PSOE",1260
13,"13044",2675,1959,1920,12,39,"PSOE",696
13,"13041",253,182,180,0,2,"PSOE",73
13,"13088",610,501,495,5,6,"PSOE",244
13,"13003",487,367,363,2,4,"PSOE",136
13,"13071",39775,28222,28052,175,170,"PSOE",10233
13,"13083",2453,1729,1690,14,39,"PSOE",467
13,"13022",351,280,280,2,0,"PSOE",142
13,"13019",5179,3887,3830,35,57,"PSOE",1108
13,"13011",4866,3346,3312,15,34,"PSOE",1453
13,"13078",9089,6661,6584,44,77,"PSOE",2266
13,"13032",1150,878,870,9,8,"PSOE",358
13,"13059",204,156,156,1,0,"PSOE",60
13,"13075",213,157,153,1,4,"PSOE",40
13,"13097",2282,1783,1768,12,15,"PSOE",652
13,"13072",775,570,565,5,5,"PSOE",182
13,"13089",1728,1410,1381,6,29,"PSOE",511
13,"13061",5723,4210,4149,49,61,"PSOE",1344
13,"13013",7086,5419,5340,45,79,"PSOE",1597
13,"13005",23330,18245,18030,164,215,"PSOE",5358
13,"13065",2888,2004,1970,19,34,"PSOE",589
13,"13062",575,471,466,4,5,"PSOE",165
13,"13058",4110,3157,3127,28,30,"PSOE",1251
13,"13092",1860,1544,1529,11,15,"PSOE",598
13,"13039",14383,10833,10684,100,149,"PSOE",3083
13,"13903",539,437,432,4,5,"PSOE",102
13,"13064",1684,1288,1283,13,5,"PSOE",377
13,"13060",269,212,209,1,3,"PSOE",79
13,"13082",25841,17702,17561,154,141,"PSOE",4716
13,"13016",665,537,529,4,8,"PSOE",149
13,"13051",350,281,278,2,3,"PSOE",113
13,"13090",1110,872,849,6,23,"PSOE",362
13,"13002",1500,1003,993,9,10,"PSOE",358
13,"13045",679,532,522,7,10,"PSOE",167
13,"13015",5494,4146,4106,18,40,"PSOE",1543
13,"13093",4111,3056,3014,21,42,"C's",377
13,"13036",800,620,614,3,6,"C's",38
13,"13046",740,575,570,3,5,"C's",31
13,"13021",436,376,374,0,2,"C's",20
13,"13058",4110,3157,3127,28,30,"C's",321
13,"13901",895,676,660,4,16,"C's",60
13,"13075",213,157,153,1,4,"C's",14
13,"13034",58010,44627,44241,332,386,"C's",7257
13,"13018",824,667,662,7,5,"C's",47
13,"13028",10416,8309,8171,77,138,"C's",990
13,"13073",542,409,405,0,4,"C's",12
13,"13035",986,791,784,7,7,"C's",47
13,"13083",2453,1729,1690,14,39,"C's",179
13,"13025",302,250,246,0,4,"C's",10
13,"13051",350,281,278,2,3,"C's",21
13,"13022",351,280,280,2,0,"C's",18
13,"13084",908,725,708,5,17,"C's",38
13,"13096",7677,5743,5661,51,82,"C's",723
13,"13055",666,495,490,0,5,"C's",24
13,"13014",496,404,398,2,6,"C's",11
13,"13019",5179,3887,3830,35,57,"C's",433
13,"13013",7086,5419,5340,45,79,"C's",709
13,"13015",5494,4146,4106,18,40,"C's",333
13,"13052",6497,4715,4648,71,67,"C's",451
13,"13020",4792,3494,3451,26,43,"C's",338
13,"13072",775,570,565,5,5,"C's",44
13,"13077",3518,2443,2378,12,65,"C's",344
13,"13048",515,418,416,3,2,"C's",17
13,"13086",189,146,146,1,0,"C's",8
13,"13062",575,471,466,4,5,"C's",33
13,"13066",2519,2057,2026,14,31,"C's",161
13,"13904",527,411,406,8,5,"C's",24
13,"13089",1728,1410,1381,6,29,"C's",94
13,"13038",1649,1317,1294,15,23,"C's",79
13,"13030",143,110,110,0,0,"C's",16
13,"13064",1684,1288,1283,13,5,"C's",217
13,"13082",25841,17702,17561,154,141,"C's",2683
13,"13068",1058,787,782,5,5,"C's",68
13,"13078",9089,6661,6584,44,77,"C's",736
13,"13903",539,437,432,4,5,"C's",43
13,"13070",765,612,605,4,7,"C's",57
13,"13079",12273,9195,9036,79,159,"C's",954
13,"13029",86,69,69,0,0,"C's",7
13,"13076",488,415,408,1,7,"C's",13
13,"13047",5785,4462,4406,23,56,"C's",472
13,"13007",1273,1056,1028,10,28,"C's",68
13,"13092",1860,1544,1529,11,15,"C's",78
13,"13023",9003,6578,6517,86,61,"C's",740
13,"13095",83,65,65,1,0,"C's",9
13,"13040",892,720,710,3,10,"C's",59
13,"13088",610,501,495,5,6,"C's",39
13,"13071",39775,28222,28052,175,170,"C's",3262
13,"13006",608,487,479,4,8,"C's",24
13,"13067",360,298,294,2,4,"C's",15
13,"13081",652,525,508,2,17,"C's",19
13,"13087",23161,16812,16595,145,217,"C's",2704
13,"13026",452,374,372,1,2,"C's",17
13,"13053",14389,10624,10521,79,103,"C's",1579
13,"13008",441,317,311,2,6,"C's",22
13,"13069",666,518,508,3,10,"C's",25
13,"13063",3728,2708,2685,9,23,"C's",269
13,"13043",231,186,185,5,1,"C's",11
13,"13057",1172,980,970,1,10,"C's",75
13,"13049",814,585,579,0,6,"C's",57
13,"13017",267,205,203,1,2,"C's",8
13,"13074",982,843,833,3,10,"C's",57
13,"13044",2675,1959,1920,12,39,"C's",219
13,"13050",501,403,399,2,4,"C's",32
13,"13016",665,537,529,4,8,"C's",56
13,"13094",308,253,249,3,4,"C's",24
13,"13009",1459,1167,1156,4,11,"C's",119
13,"13033",1653,1395,1378,4,17,"C's",61
13,"13065",2888,2004,1970,19,34,"C's",135
13,"13061",5723,4210,4149,49,61,"C's",536
13,"13004",1052,827,816,1,11,"C's",45
13,"13042",928,696,688,3,8,"C's",41
13,"13080",350,265,265,1,0,"C's",10
13,"13902",479,374,367,0,7,"C's",49
13,"13039",14383,10833,10684,100,149,"C's",1435
13,"13090",1110,872,849,6,23,"C's",35
13,"13059",204,156,156,1,0,"C's",9
13,"13031",2455,1940,1914,9,26,"C's",179
13,"13002",1500,1003,993,9,10,"C's",88
13,"13003",487,367,363,2,4,"C's",22
13,"13005",23330,18245,18030,164,215,"C's",2606
13,"13085",2365,2011,1983,6,28,"C's",173
13,"13032",1150,878,870,9,8,"C's",77
13,"13037",865,678,667,2,11,"C's",36
13,"13011",4866,3346,3312,15,34,"C's",304
13,"13024",898,643,637,7,6,"C's",43
13,"13060",269,212,209,1,3,"C's",14
13,"13097",2282,1783,1768,12,15,"C's",144
13,"13098",2124,1633,1591,15,42,"C's",181
13,"13041",253,182,180,0,2,"C's",8
13,"13012",411,294,292,0,2,"C's",17
13,"13054",4970,3911,3866,44,45,"C's",427
13,"13056",11354,8732,8634,48,98,"C's",1212
13,"13010",887,673,665,0,8,"C's",37
13,"13001",1270,985,977,8,8,"C's",48
13,"13027",3446,2543,2498,15,45,"C's",180
13,"13045",679,532,522,7,10,"C's",46
13,"13091",552,466,459,3,7,"C's",20
20,"20061",4273,2832,2816,21,16,"EAJ-PNV",1046
20,"20010",1494,1055,1053,4,2,"EAJ-PNV",240
20,"20021",199,110,110,2,0,"EAJ-PNV",35
20,"20062",982,685,684,3,1,"EAJ-PNV",260
20,"20074",11610,8382,8320,43,62,"EAJ-PNV",2436
20,"20042",3251,2170,2152,23,18,"EAJ-PNV",524
20,"20070",1099,749,744,4,5,"EAJ-PNV",266
20,"20027",2816,1842,1833,11,9,"EAJ-PNV",619
20,"20030",21515,15110,15019,108,91,"EAJ-PNV",3327
20,"20035",482,329,328,4,1,"EAJ-PNV",96
20,"20056",4104,2654,2633,12,21,"EAJ-PNV",963
20,"20038",392,284,281,1,3,"EAJ-PNV",111
20,"20072",4731,3132,3123,23,9,"EAJ-PNV",777
20,"20020",129,71,71,0,0,"EAJ-PNV",30
20,"20065",3006,2104,2089,18,15,"EAJ-PNV",499
20,"20054",447,301,297,5,4,"EAJ-PNV",51
20,"20059",8863,6091,6072,30,19,"EAJ-PNV",1999
20,"20043",1740,1157,1152,6,5,"EAJ-PNV",490
20,"20004",252,135,135,2,0,"EAJ-PNV",66
20,"20064",12526,8429,8387,59,42,"EAJ-PNV",1558
20,"20045",46691,32759,32560,222,199,"EAJ-PNV",5013
20,"20003",541,334,334,3,0,"EAJ-PNV",77
20,"20051",6904,5001,4975,31,26,"EAJ-PNV",1379
20,"20079",17835,12650,12587,81,63,"EAJ-PNV",4025
20,"20039",2111,1539,1532,13,7,"EAJ-PNV",588
20,"20040",15321,10260,10176,69,84,"EAJ-PNV",1661
20,"20055",17522,12125,12043,52,82,"EAJ-PNV",2976
20,"20044",368,264,259,0,5,"EAJ-PNV",76
20,"20011",1660,1283,1278,9,5,"EAJ-PNV",346
20,"20071",14818,10095,10057,62,38,"EAJ-PNV",3157
20,"20048",176,104,104,2,0,"EAJ-PNV",17
20,"20002",343,227,226,10,1,"EAJ-PNV",54
20,"20019",10053,6876,6844,72,32,"EAJ-PNV",2144
20,"20037",97,59,59,1,0,"EAJ-PNV",19
20,"20012",144,108,108,3,0,"EAJ-PNV",37
20,"20068",183,117,115,0,2,"EAJ-PNV",32
20,"20022",834,499,494,7,5,"EAJ-PNV",155
20,"20016",1514,885,884,5,1,"EAJ-PNV",380
20,"20023",445,258,258,2,0,"EAJ-PNV",46
20,"20050",263,160,160,4,0,"EAJ-PNV",48
20,"20032",8785,6115,6076,45,39,"EAJ-PNV",1996
20,"20049",4124,2793,2780,22,13,"EAJ-PNV",722
20,"20015",1272,924,921,9,3,"EAJ-PNV",273
20,"20905",141,105,105,0,0,"EAJ-PNV",28
20,"20081",7460,5187,5159,33,28,"EAJ-PNV",1530
20,"20009",11528,7997,7955,57,42,"EAJ-PNV",1345
20,"20058",746,547,546,3,1,"EAJ-PNV",146
20,"20067",30825,21606,21512,113,94,"EAJ-PNV",2648
20,"20008",721,382,376,5,6,"EAJ-PNV",115
20,"20078",1155,866,864,6,2,"EAJ-PNV",153
20,"20046",1167,797,794,4,3,"EAJ-PNV",227
20,"20006",262,161,159,1,2,"EAJ-PNV",64
20,"20077",5243,3792,3777,25,15,"EAJ-PNV",1106
20,"20069",147189,106909,106506,699,403,"EAJ-PNV",22890
20,"20033",864,629,625,3,4,"EAJ-PNV",203
20,"20075",4359,2852,2833,16,19,"EAJ-PNV",717
20,"20904",96,62,62,0,0,"EAJ-PNV",15
20,"20901",1441,982,979,2,3,"EAJ-PNV",317
20,"20080",7900,5517,5487,33,30,"EAJ-PNV",1115
20,"20053",4765,3150,3132,18,18,"EAJ-PNV",503
20,"20026",202,141,129,4,12,"EAJ-PNV",57
20,"20014",1111,635,632,4,3,"EAJ-PNV",147
20,"20017",8580,5807,5770,37,37,"EAJ-PNV",2113
20,"20007",304,209,209,5,0,"EAJ-PNV",37
20,"20034",3157,2145,2141,7,4,"EAJ-PNV",595
20,"20060",89,76,75,2,1,"EAJ-PNV",1
20,"20076",6978,4975,4958,39,17,"EAJ-PNV",1273
20,"20902",14193,10263,10219,56,44,"EAJ-PNV",1333
20,"20903",4247,2846,2826,9,20,"EAJ-PNV",658
20,"20066",461,279,276,3,3,"EAJ-PNV",81
20,"20907",120,85,84,2,1,"EAJ-PNV",25
20,"20057",201,122,121,0,1,"EAJ-PNV",33
20,"20052",1091,797,792,6,5,"EAJ-PNV",234
20,"20047",477,329,329,2,0,"EAJ-PNV",78
20,"20001",242,138,137,1,1,"EAJ-PNV",54
20,"20025",1144,774,767,5,7,"EAJ-PNV",307
20,"20036",13148,9191,9132,85,59,"EAJ-PNV",3126
20,"20906",121,84,84,1,0,"EAJ-PNV",20
20,"20031",180,105,102,1,3,"EAJ-PNV",38
20,"20029",4258,3005,2992,17,13,"EAJ-PNV",1064
20,"20018",11074,7100,7059,29,41,"EAJ-PNV",2607
20,"20024",393,226,226,2,0,"EAJ-PNV",54
20,"20028",2255,1503,1494,17,9,"EAJ-PNV",320
20,"20073",4677,3219,3208,21,11,"EAJ-PNV",616
20,"20063",7990,5449,5415,23,34,"EAJ-PNV",1030
20,"20041",258,148,148,2,0,"EAJ-PNV",50
20,"20013",5427,3901,3875,19,26,"EAJ-PNV",1122
20,"20005",1261,811,805,7,6,"EAJ-PNV",234
1,"1062",314,215,215,3,0,"EAJ-PNV",43
1,"1020",326,232,228,0,4,"EAJ-PNV",77
1,"1033",649,512,508,5,4,"EAJ-PNV",174
1,"1032",522,368,361,0,7,"EAJ-PNV",101
1,"1008",790,548,542,13,6,"EAJ-PNV",146
1,"1028",1077,759,753,6,6,"EAJ-PNV",110
1,"1058",1327,843,833,8,10,"EAJ-PNV",173
1,"1017",869,584,577,4,7,"EAJ-PNV",185
1,"1060",199,162,159,0,3,"EAJ-PNV",40
1,"1030",159,126,123,1,3,"EAJ-PNV",35
1,"1006",176,142,141,1,1,"EAJ-PNV",8
1,"1036",15034,10733,10619,73,114,"EAJ-PNV",2438
1,"1013",711,486,483,3,3,"EAJ-PNV",119
1,"1037",586,425,419,2,6,"EAJ-PNV",142
1,"1046",594,445,435,3,10,"EAJ-PNV",114
1,"1051",3606,2413,2389,21,24,"EAJ-PNV",551
1,"1053",587,367,365,3,2,"EAJ-PNV",108
1,"1054",952,694,688,4,6,"EAJ-PNV",155
1,"1057",245,203,202,0,1,"EAJ-PNV",78
1,"1043",2318,1644,1624,8,20,"EAJ-PNV",217
1,"1002",8139,5961,5878,32,83,"EAJ-PNV",1686
1,"1063",1799,1320,1309,10,11,"EAJ-PNV",328
1,"1021",460,336,332,1,4,"EAJ-PNV",114
1,"1031",1183,907,885,6,22,"EAJ-PNV",131
1,"1061",153,132,132,2,0,"EAJ-PNV",39
1,"1011",237,177,175,7,2,"EAJ-PNV",44
1,"1902",738,537,528,4,9,"EAJ-PNV",114
1,"1901",2344,1688,1669,17,19,"EAJ-PNV",178
1,"1042",901,653,650,11,3,"EAJ-PNV",234
1,"1014",372,292,284,1,8,"EAJ-PNV",69
1,"1027",416,268,268,0,0,"EAJ-PNV",78
1,"1034",165,120,119,1,1,"EAJ-PNV",38
1,"1023",269,197,195,2,2,"EAJ-PNV",52
1,"1019",144,112,111,2,1,"EAJ-PNV",68
1,"1016",439,255,249,3,6,"EAJ-PNV",66
1,"1009",1281,908,898,2,10,"EAJ-PNV",214
1,"1004",1405,1026,1010,7,16,"EAJ-PNV",297
1,"1056",218,141,140,1,1,"EAJ-PNV",70
1,"1010",2275,1729,1717,17,12,"EAJ-PNV",568
1,"1041",153,105,100,1,5,"EAJ-PNV",26
1,"1003",1186,842,833,19,9,"EAJ-PNV",256
1,"1044",236,189,187,1,2,"EAJ-PNV",39
1,"1049",140,108,108,0,0,"EAJ-PNV",37
1,"1059",186354,135873,134633,948,1240,"EAJ-PNV",17643
1,"1018",1370,964,963,4,1,"EAJ-PNV",215
1,"1022",805,593,587,3,6,"EAJ-PNV",78
1,"1001",1984,1426,1405,8,21,"EAJ-PNV",268
1,"1055",836,564,552,8,12,"EAJ-PNV",142
1,"1047",964,713,702,13,11,"EAJ-PNV",111
1,"1052",244,188,186,1,2,"EAJ-PNV",55
1,"1039",202,161,156,0,5,"EAJ-PNV",25
20,"20014",1111,635,632,4,3,"PP",22
20,"20063",7990,5449,5415,23,34,"PP",179
20,"20031",180,105,102,1,3,"PP",1
20,"20069",147189,106909,106506,699,403,"PP",14812
20,"20016",1514,885,884,5,1,"PP",17
20,"20018",11074,7100,7059,29,41,"PP",252
20,"20034",3157,2145,2141,7,4,"PP",86
20,"20058",746,547,546,3,1,"PP",48
20,"20906",121,84,84,1,0,"PP",0
20,"20901",1441,982,979,2,3,"PP",41
20,"20003",541,334,334,3,0,"PP",0
20,"20054",447,301,297,5,4,"PP",1
20,"20077",5243,3792,3777,25,15,"PP",218
20,"20021",199,110,110,2,0,"PP",2
20,"20047",477,329,329,2,0,"PP",10
20,"20036",13148,9191,9132,85,59,"PP",691
20,"20076",6978,4975,4958,39,17,"PP",336
20,"20011",1660,1283,1278,9,5,"PP",35
20,"20039",2111,1539,1532,13,7,"PP",24
20,"20071",14818,10095,10057,62,38,"PP",538
20,"20052",1091,797,792,6,5,"PP",25
20,"20017",8580,5807,5770,37,37,"PP",276
20,"20062",982,685,684,3,1,"PP",26
20,"20053",4765,3150,3132,18,18,"PP",165
20,"20907",120,85,84,2,1,"PP",2
20,"20005",1261,811,805,7,6,"PP",27
20,"20070",1099,749,744,4,5,"PP",7
20,"20013",5427,3901,3875,19,26,"PP",157
20,"20023",445,258,258,2,0,"PP",10
20,"20061",4273,2832,2816,21,16,"PP",93
20,"20015",1272,924,921,9,3,"PP",1
20,"20055",17522,12125,12043,52,82,"PP",741
20,"20043",1740,1157,1152,6,5,"PP",46
20,"20072",4731,3132,3123,23,9,"PP",232
20,"20902",14193,10263,10219,56,44,"PP",1051
20,"20027",2816,1842,1833,11,9,"PP",27
20,"20081",7460,5187,5159,33,28,"PP",188
20,"20064",12526,8429,8387,59,42,"PP",678
20,"20037",97,59,59,1,0,"PP",0
20,"20007",304,209,209,5,0,"PP",2
20,"20904",96,62,62,0,0,"PP",0
20,"20033",864,629,625,3,4,"PP",13
20,"20046",1167,797,794,4,3,"PP",32
20,"20004",252,135,135,2,0,"PP",0
20,"20903",4247,2846,2826,9,20,"PP",144
20,"20059",8863,6091,6072,30,19,"PP",215
20,"20006",262,161,159,1,2,"PP",2
20,"20060",89,76,75,2,1,"PP",0
20,"20020",129,71,71,0,0,"PP",1
20,"20042",3251,2170,2152,23,18,"PP",94
20,"20025",1144,774,767,5,7,"PP",4
20,"20022",834,499,494,7,5,"PP",12
20,"20041",258,148,148,2,0,"PP",3
20,"20068",183,117,115,0,2,"PP",0
20,"20045",46691,32759,32560,222,199,"PP",4045
20,"20026",202,141,129,4,12,"PP",0
20,"20001",242,138,137,1,1,"PP",1
20,"20051",6904,5001,4975,31,26,"PP",336
20,"20010",1494,1055,1053,4,2,"PP",55
20,"20050",263,160,160,4,0,"PP",4
20,"20009",11528,7997,7955,57,42,"PP",597
20,"20057",201,122,121,0,1,"PP",0
20,"20008",721,382,376,5,6,"PP",12
20,"20049",4124,2793,2780,22,13,"PP",132
20,"20038",392,284,281,1,3,"PP",3
20,"20079",17835,12650,12587,81,63,"PP",834
20,"20074",11610,8382,8320,43,62,"PP",336
20,"20035",482,329,328,4,1,"PP",6
20,"20012",144,108,108,3,0,"PP",3
20,"20067",30825,21606,21512,113,94,"PP",1688
20,"20028",2255,1503,1494,17,9,"PP",85
20,"20044",368,264,259,0,5,"PP",5
20,"20048",176,104,104,2,0,"PP",1
20,"20032",8785,6115,6076,45,39,"PP",438
20,"20056",4104,2654,2633,12,21,"PP",112
20,"20029",4258,3005,2992,17,13,"PP",122
20,"20002",343,227,226,10,1,"PP",3
20,"20019",10053,6876,6844,72,32,"PP",429
20,"20024",393,226,226,2,0,"PP",8
20,"20066",461,279,276,3,3,"PP",0
20,"20075",4359,2852,2833,16,19,"PP",170
20,"20065",3006,2104,2089,18,15,"PP",175
20,"20073",4677,3219,3208,21,11,"PP",139
20,"20040",15321,10260,10176,69,84,"PP",591
20,"20030",21515,15110,15019,108,91,"PP",1330
20,"20080",7900,5517,5487,33,30,"PP",406
20,"20905",141,105,105,0,0,"PP",0
20,"20078",1155,866,864,6,2,"PP",15
49,"49087",523,322,319,0,3,"PSOE",57
49,"49100",303,216,215,1,1,"PSOE",73
49,"49142",247,182,180,5,2,"PSOE",51
49,"49096",175,134,127,1,7,"PSOE",40
49,"49125",1400,977,957,10,20,"PSOE",262
49,"49083",52,43,41,1,2,"PSOE",8
49,"49166",1225,945,934,11,11,"PSOE",233
49,"49220",146,116,114,1,2,"PSOE",47
49,"49022",287,230,226,3,4,"PSOE",72
49,"49044",85,56,55,0,1,"PSOE",17
49,"49134",187,115,110,0,5,"PSOE",24
49,"49129",861,626,617,10,9,"PSOE",206
49,"49209",510,347,345,5,2,"PSOE",80
49,"49178",699,503,487,4,16,"PSOE",82
49,"49258",115,96,95,2,1,"PSOE",29
49,"49165",60,59,58,2,1,"PSOE",9
49,"49153",172,124,123,1,1,"PSOE",21
49,"49188",115,92,91,1,1,"PSOE",16
49,"49111",130,96,96,6,0,"PSOE",22
49,"49231",330,216,212,1,4,"PSOE",47
49,"49016",256,185,179,2,6,"PSOE",42
49,"49238",258,202,201,0,1,"PSOE",52
49,"49208",395,255,250,1,5,"PSOE",28
49,"49054",908,668,651,13,17,"PSOE",187
49,"49237",170,120,120,3,0,"PSOE",37
49,"49098",222,167,166,2,1,"PSOE",36
49,"49199",259,203,200,1,3,"PSOE",55
49,"49259",93,70,63,0,7,"PSOE",5
49,"49157",214,167,162,1,5,"PSOE",44
49,"49143",225,161,157,2,4,"PSOE",30
49,"49137",176,140,137,2,3,"PSOE",33
49,"49131",269,186,181,1,5,"PSOE",42
49,"49039",333,259,252,1,7,"PSOE",69
49,"49058",316,252,250,0,2,"PSOE",77
49,"49270",138,100,99,0,1,"PSOE",33
49,"49243",111,97,95,0,2,"PSOE",12
49,"49002",64,48,48,1,0,"PSOE",12
49,"49176",681,446,444,2,2,"PSOE",67
49,"49013",254,172,168,4,4,"PSOE",40
49,"49086",119,98,97,1,1,"PSOE",25
49,"49037",185,156,156,0,0,"PSOE",31
49,"49115",185,140,139,4,1,"PSOE",32
49,"49155",83,64,63,1,1,"PSOE",15
49,"49003",904,631,624,4,7,"PSOE",149
49,"49030",84,69,67,1,2,"PSOE",5
49,"49040",117,99,99,1,0,"PSOE",44
49,"49191",272,215,213,1,2,"PSOE",97
49,"49262",392,268,266,1,2,"PSOE",57
49,"49149",392,275,271,3,4,"PSOE",50
49,"49064",521,343,339,2,4,"PSOE",82
49,"49126",236,158,157,4,1,"PSOE",46
49,"49135",635,450,449,5,1,"PSOE",102
49,"49123",547,414,410,0,4,"PSOE",120
49,"49024",667,464,457,7,7,"PSOE",120
49,"49170",104,70,68,1,2,"PSOE",23
49,"49225",153,95,92,2,3,"PSOE",10
49,"49132",327,242,236,0,6,"PSOE",57
49,"49141",348,251,249,3,2,"PSOE",73
49,"49167",205,147,144,0,3,"PSOE",19
49,"49250",1254,974,952,11,22,"PSOE",228
49,"49068",472,292,289,2,3,"PSOE",57
49,"49261",1546,1171,1154,9,17,"PSOE",300
49,"49005",142,93,93,0,0,"PSOE",24
49,"49032",326,251,250,0,1,"PSOE",61
49,"49128",557,428,424,2,4,"PSOE",112
49,"49108",476,359,352,4,7,"PSOE",74
49,"49091",269,202,202,0,0,"PSOE",63
49,"49036",521,375,371,3,4,"PSOE",79
49,"49042",244,199,195,2,4,"PSOE",28
49,"49235",450,330,321,5,9,"PSOE",78
49,"49010",346,285,282,3,3,"PSOE",67
49,"49018",331,252,245,1,7,"PSOE",90
49,"49151",627,473,467,4,6,"PSOE",127
49,"49026",233,182,179,0,3,"PSOE",48
49,"49239",673,488,476,6,12,"PSOE",197
49,"49205",382,296,294,8,2,"PSOE",50
49,"49006",154,116,112,0,4,"PSOE",29
49,"49014",112,83,82,1,1,"PSOE",17
49,"49244",45,28,28,0,0,"PSOE",8
49,"49031",145,115,113,0,2,"PSOE",25
49,"49120",74,53,51,0,2,"PSOE",17
49,"49138",231,164,163,1,1,"PSOE",40
49,"49035",236,205,200,0,5,"PSOE",45
49,"49252",326,260,255,7,5,"PSOE",69
49,"49197",180,127,123,2,4,"PSOE",23
49,"49249",68,60,59,1,1,"PSOE",6
49,"49271",204,154,154,3,0,"PSOE",52
49,"49019",246,187,181,5,6,"PSOE",53
49,"49093",287,233,231,2,2,"PSOE",74
49,"49203",319,245,236,1,9,"PSOE",72
49,"49011",230,183,180,7,3,"PSOE",18
49,"49183",101,80,80,4,0,"PSOE",11
49,"49004",128,92,88,2,4,"PSOE",25
49,"49221",258,142,135,1,7,"PSOE",28
49,"49055",104,85,85,2,0,"PSOE",28
49,"49050",513,349,348,3,1,"PSOE",53
49,"49139",170,139,136,0,3,"PSOE",41
49,"49175",234,183,182,2,1,"PSOE",61
49,"49052",191,144,139,1,5,"PSOE",42
49,"49154",131,79,78,0,1,"PSOE",44
49,"49192",134,114,114,2,0,"PSOE",47
49,"49180",156,101,101,0,0,"PSOE",21
49,"49146",296,232,228,2,4,"PSOE",56
49,"49095",297,233,231,1,2,"PSOE",54
49,"49257",279,187,184,1,3,"PSOE",53
49,"49103",412,333,330,4,3,"PSOE",54
49,"49185",162,125,121,0,4,"PSOE",21
49,"49265",128,91,91,1,0,"PSOE",26
49,"49112",128,85,85,1,0,"PSOE",19
49,"49047",111,78,77,0,1,"PSOE",14
49,"49099",132,85,85,1,0,"PSOE",27
49,"49062",121,82,81,1,1,"PSOE",24
49,"49034",446,337,333,3,4,"PSOE",80
49,"49057",106,77,76,0,1,"PSOE",19
49,"49053",938,737,729,5,8,"PSOE",225
49,"49172",536,347,341,1,6,"PSOE",60
49,"49219",7519,5407,5331,58,76,"PSOE",1515
49,"49156",237,185,183,2,2,"PSOE",39
49,"49113",172,144,142,1,2,"PSOE",16
49,"49109",626,491,490,4,1,"PSOE",132
49,"49023",977,702,697,9,5,"PSOE",120
49,"49105",155,121,121,0,0,"PSOE",15
49,"49130",180,137,132,5,5,"PSOE",28
49,"49187",1251,956,946,8,10,"PSOE",247
49,"49162",192,140,138,1,2,"PSOE",36
49,"49202",190,138,136,2,2,"PSOE",27
49,"49101",153,106,101,3,5,"PSOE",17
49,"49110",366,215,215,5,0,"PSOE",58
49,"49025",174,128,126,0,2,"PSOE",40
49,"49127",2369,1752,1731,22,21,"PSOE",321
49,"49174",130,95,94,2,1,"PSOE",17
49,"49233",95,60,57,0,3,"PSOE",11
49,"49020",294,226,223,5,3,"PSOE",53
49,"49090",194,148,147,1,1,"PSOE",38
49,"49179",393,265,263,0,2,"PSOE",46
49,"49245",261,178,174,0,4,"PSOE",29
49,"49084",290,241,238,5,3,"PSOE",49
49,"49184",179,117,114,1,3,"PSOE",12
49,"49046",272,209,206,3,3,"PSOE",45
49,"49085",1033,708,701,0,7,"PSOE",193
49,"49124",254,179,176,2,3,"PSOE",40
49,"49275",52483,38405,37981,427,424,"PSOE",7291
49,"49204",64,45,44,0,1,"PSOE",6
49,"49136",324,228,222,4,6,"PSOE",35
49,"49056",295,220,211,4,9,"PSOE",67
49,"49158",215,164,161,3,3,"PSOE",47
49,"49159",276,220,216,2,4,"PSOE",52
49,"49200",950,737,719,9,18,"PSOE",203
49,"49029",623,494,482,4,12,"PSOE",69
49,"49247",454,301,296,3,5,"PSOE",63
49,"49168",90,73,73,2,0,"PSOE",18
49,"49164",158,120,118,1,2,"PSOE",45
49,"49201",306,250,248,4,2,"PSOE",105
49,"49117",458,336,328,3,8,"PSOE",89
49,"49076",325,253,250,2,3,"PSOE",45
49,"49216",162,138,137,0,1,"PSOE",44
49,"49223",766,628,616,5,12,"PSOE",111
49,"49255",426,330,327,4,3,"PSOE",63
49,"49079",105,80,76,2,4,"PSOE",14
49,"49206",854,611,595,6,16,"PSOE",168
49,"49148",249,143,141,0,2,"PSOE",32
49,"49122",773,578,569,7,9,"PSOE",121
49,"49152",532,346,344,9,2,"PSOE",64
49,"49236",76,54,53,0,1,"PSOE",11
49,"49043",300,226,225,2,1,"PSOE",79
49,"49048",134,84,84,0,0,"PSOE",6
49,"49118",206,167,167,0,0,"PSOE",37
49,"49008",468,346,342,6,4,"PSOE",100
49,"49121",372,269,265,4,4,"PSOE",58
49,"49080",692,523,518,6,5,"PSOE",178
49,"49256",256,207,206,2,1,"PSOE",32
49,"49059",93,61,61,0,0,"PSOE",9
49,"49145",235,145,137,2,8,"PSOE",18
49,"49077",189,115,115,0,0,"PSOE",32
49,"49214",707,529,523,7,6,"PSOE",121
49,"49263",54,41,41,0,0,"PSOE",5
49,"49009",400,290,286,4,4,"PSOE",55
49,"49241",256,190,186,0,4,"PSOE",32
49,"49119",236,172,172,0,0,"PSOE",59
49,"49081",1365,1071,1057,7,14,"PSOE",310
49,"49133",306,218,217,1,1,"PSOE",53
49,"49067",372,258,256,3,2,"PSOE",50
49,"49116",389,272,266,4,6,"PSOE",43
49,"49242",455,373,365,8,8,"PSOE",77
49,"49269",230,165,163,4,2,"PSOE",36
49,"49189",202,130,130,5,0,"PSOE",15
49,"49240",218,168,159,3,9,"PSOE",27
49,"49021",14387,10353,10196,117,157,"PSOE",2613
49,"49193",472,323,316,4,7,"PSOE",52
49,"49092",132,92,91,1,1,"PSOE",28
49,"49147",267,190,189,2,1,"PSOE",64
49,"49066",498,336,328,4,8,"PSOE",73
49,"49078",174,143,143,0,0,"PSOE",30
49,"49097",90,47,47,0,0,"PSOE",18
49,"49107",131,98,97,2,1,"PSOE",34
49,"49069",384,243,242,6,1,"PSOE",53
49,"49094",243,149,149,1,0,"PSOE",35
49,"49012",72,47,47,1,0,"PSOE",13
49,"49229",130,98,97,1,1,"PSOE",23
49,"49246",233,190,185,1,5,"PSOE",29
49,"49248",188,145,144,0,1,"PSOE",41
49,"49063",341,274,274,2,0,"PSOE",74
49,"49228",56,43,41,0,2,"PSOE",4
49,"49210",478,365,358,4,7,"PSOE",114
49,"49169",35,29,29,0,0,"PSOE",5
49,"49186",263,189,187,0,2,"PSOE",25
49,"49071",770,505,502,6,3,"PSOE",109
49,"49038",99,74,74,1,0,"PSOE",17
49,"49190",64,49,49,0,0,"PSOE",20
49,"49082",364,306,304,6,2,"PSOE",118
49,"49017",251,169,169,2,0,"PSOE",28
49,"49041",440,315,307,1,8,"PSOE",122
49,"49267",91,75,74,1,1,"PSOE",21
49,"49028",122,103,102,1,1,"PSOE",7
49,"49102",198,148,145,1,3,"PSOE",44
49,"49114",44,31,30,0,1,"PSOE",8
49,"49033",728,530,528,4,2,"PSOE",116
49,"49207",237,156,155,0,1,"PSOE",39
49,"49061",150,113,113,1,0,"PSOE",26
49,"49260",774,597,593,12,4,"PSOE",180
49,"49015",233,189,188,1,1,"PSOE",51
49,"49272",88,73,73,1,0,"PSOE",8
49,"49227",316,259,255,4,4,"PSOE",71
49,"49222",387,294,289,7,5,"PSOE",111
49,"49163",230,166,160,1,6,"PSOE",24
49,"49264",592,395,391,4,4,"PSOE",72
49,"49251",166,126,119,0,7,"PSOE",41
49,"49226",253,203,200,1,3,"PSOE",57
49,"49171",648,507,500,5,7,"PSOE",121
49,"49173",379,229,227,5,2,"PSOE",48
49,"49273",189,120,118,0,2,"PSOE",22
49,"49268",416,307,305,5,2,"PSOE",38
49,"49232",97,74,73,0,1,"PSOE",22
49,"49027",150,116,116,5,0,"PSOE",12
49,"49234",410,336,334,1,2,"PSOE",97
49,"49160",48,36,32,0,4,"PSOE",17
49,"49088",92,70,70,0,0,"PSOE",12
49,"49230",103,82,81,1,1,"PSOE",36
49,"49181",369,274,274,2,0,"PSOE",39
49,"49224",160,109,106,4,3,"PSOE",16
49,"49065",1121,850,835,8,15,"PSOE",218
49,"49266",75,60,60,0,0,"PSOE",18
49,"49104",353,224,223,0,1,"PSOE",62
49,"49194",377,229,228,2,1,"PSOE",61
49,"49075",140,109,106,1,3,"PSOE",40
49,"49150",145,109,104,2,5,"PSOE",43
49,"49177",284,190,189,1,1,"PSOE",50
49,"49007",371,267,254,6,13,"PSOE",79
49,"49002",64,48,48,1,0,"C's",7
49,"49201",306,250,248,4,2,"C's",16
49,"49121",372,269,265,4,4,"C's",30
49,"49257",279,187,184,1,3,"C's",19
49,"49083",52,43,41,1,2,"C's",1
49,"49026",233,182,179,0,3,"C's",13
49,"49152",532,346,344,9,2,"C's",47
49,"49244",45,28,28,0,0,"C's",0
49,"49173",379,229,227,5,2,"C's",8
49,"49160",48,36,32,0,4,"C's",1
49,"49202",190,138,136,2,2,"C's",13
49,"49258",115,96,95,2,1,"C's",10
49,"49122",773,578,569,7,9,"C's",91
49,"49039",333,259,252,1,7,"C's",27
49,"49003",904,631,624,4,7,"C's",84
49,"49187",1251,956,946,8,10,"C's",115
49,"49088",92,70,70,0,0,"C's",5
49,"49162",192,140,138,1,2,"C's",30
49,"49149",392,275,271,3,4,"C's",26
49,"49135",635,450,449,5,1,"C's",55
49,"49245",261,178,174,0,4,"C's",22
49,"49123",547,414,410,0,4,"C's",34
49,"49085",1033,708,701,0,7,"C's",88
49,"49016",256,185,179,2,6,"C's",16
49,"49040",117,99,99,1,0,"C's",2
49,"49028",122,103,102,1,1,"C's",6
49,"49163",230,166,160,1,6,"C's",25
49,"49004",128,92,88,2,4,"C's",9
49,"49246",233,190,185,1,5,"C's",26
49,"49260",774,597,593,12,4,"C's",58
49,"49136",324,228,222,4,6,"C's",27
49,"49005",142,93,93,0,0,"C's",14
49,"49041",440,315,307,1,8,"C's",26
49,"49124",254,179,176,2,3,"C's",14
49,"49234",410,336,334,1,2,"C's",37
49,"49029",623,494,482,4,12,"C's",48
49,"49273",189,120,118,0,2,"C's",6
49,"49180",156,101,101,0,0,"C's",13
49,"49164",158,120,118,1,2,"C's",17
49,"49086",119,98,97,1,1,"C's",12
49,"49099",132,85,85,1,0,"C's",6
49,"49018",331,252,245,1,7,"C's",12
49,"49006",154,116,112,0,4,"C's",15
49,"49125",1400,977,957,10,20,"C's",132
49,"49247",454,301,296,3,5,"C's",25
49,"49042",244,199,195,2,4,"C's",23
49,"49227",316,259,255,4,4,"C's",43
49,"49177",284,190,189,1,1,"C's",15
49,"49205",382,296,294,8,2,"C's",30
49,"49058",316,252,250,0,2,"C's",31
49,"49019",246,187,181,5,6,"C's",32
49,"49165",60,59,58,2,1,"C's",11
49,"49248",188,145,144,0,1,"C's",9
49,"49101",153,106,101,3,5,"C's",13
49,"49126",236,158,157,4,1,"C's",12
49,"49263",54,41,41,0,0,"C's",2
49,"49118",206,167,167,0,0,"C's",18
49,"49139",170,139,136,0,3,"C's",12
49,"49255",426,330,327,4,3,"C's",36
49,"49007",371,267,254,6,13,"C's",19
49,"49166",1225,945,934,11,11,"C's",127
49,"49020",294,226,223,5,3,"C's",16
49,"49008",468,346,342,6,4,"C's",20
49,"49127",2369,1752,1731,22,21,"C's",388
49,"49207",237,156,155,0,1,"C's",19
49,"49167",205,147,144,0,3,"C's",19
49,"49090",194,148,147,1,1,"C's",14
49,"49061",150,113,113,1,0,"C's",13
49,"49250",1254,974,952,11,22,"C's",170
49,"49208",395,255,250,1,5,"C's",28
49,"49128",557,428,424,2,4,"C's",40
49,"49264",592,395,391,4,4,"C's",30
49,"49021",14387,10353,10196,117,157,"C's",1398
49,"49141",348,251,249,3,2,"C's",24
49,"49009",400,290,286,4,4,"C's",31
49,"49095",297,233,231,1,2,"C's",38
49,"49142",247,182,180,5,2,"C's",8
49,"49185",162,125,121,0,4,"C's",39
49,"49047",111,78,77,0,1,"C's",3
49,"49251",166,126,119,0,7,"C's",10
49,"49129",861,626,617,10,9,"C's",39
49,"49078",174,143,143,0,0,"C's",3
49,"49209",510,347,345,5,2,"C's",36
49,"49010",346,285,282,3,3,"C's",43
49,"49062",121,82,81,1,1,"C's",5
49,"49063",341,274,274,2,0,"C's",20
49,"49235",450,330,321,5,9,"C's",35
49,"49048",134,84,84,0,0,"C's",9
49,"49130",180,137,132,5,5,"C's",13
49,"49252",326,260,255,7,5,"C's",28
49,"49169",35,29,29,0,0,"C's",4
49,"49134",187,115,110,0,5,"C's",13
49,"49183",101,80,80,4,0,"C's",12
49,"49170",104,70,68,1,2,"C's",7
49,"49210",478,365,358,4,7,"C's",23
49,"49015",233,189,188,1,1,"C's",11
49,"49191",272,215,213,1,2,"C's",15
49,"49011",230,183,180,7,3,"C's",20
49,"49055",104,85,85,2,0,"C's",8
49,"49050",513,349,348,3,1,"C's",41
49,"49064",521,343,339,2,4,"C's",26
49,"49105",155,121,121,0,0,"C's",14
49,"49145",235,145,137,2,8,"C's",9
49,"49012",72,47,47,1,0,"C's",7
49,"49131",269,186,181,1,5,"C's",26
49,"49214",707,529,523,7,6,"C's",63
49,"49256",256,207,206,2,1,"C's",18
49,"49132",327,242,236,0,6,"C's",18
49,"49052",191,144,139,1,5,"C's",15
49,"49065",1121,850,835,8,15,"C's",70
49,"49171",648,507,500,5,7,"C's",41
49,"49184",179,117,114,1,3,"C's",4
49,"49013",254,172,168,4,4,"C's",19
49,"49037",185,156,156,0,0,"C's",9
49,"49120",74,53,51,0,2,"C's",6
49,"49189",202,130,130,5,0,"C's",3
49,"49230",103,82,81,1,1,"C's",4
49,"49071",770,505,502,6,3,"C's",69
49,"49172",536,347,341,1,6,"C's",21
49,"49159",276,220,216,2,4,"C's",16
49,"49066",498,336,328,4,8,"C's",22
49,"49014",112,83,82,1,1,"C's",10
49,"49133",306,218,217,1,1,"C's",26
49,"49147",267,190,189,2,1,"C's",30
49,"49219",7519,5407,5331,58,76,"C's",709
49,"49231",330,216,212,1,4,"C's",19
49,"49104",353,224,223,0,1,"C's",19
49,"49110",366,215,215,5,0,"C's",16
49,"49148",249,143,141,0,2,"C's",14
49,"49186",263,189,187,0,2,"C's",21
49,"49096",175,134,127,1,7,"C's",5
49,"49190",64,49,49,0,0,"C's",3
49,"49220",146,116,114,1,2,"C's",8
49,"49054",908,668,651,13,17,"C's",91
49,"49097",90,47,47,0,0,"C's",4
49,"49224",160,109,106,4,3,"C's",15
49,"49206",854,611,595,6,16,"C's",47
49,"49236",76,54,53,0,1,"C's",10
49,"49267",91,75,74,1,1,"C's",8
49,"49084",290,241,238,5,3,"C's",26
49,"49176",681,446,444,2,2,"C's",35
49,"49259",93,70,63,0,7,"C's",10
49,"49068",472,292,289,2,3,"C's",14
49,"49188",115,92,91,1,1,"C's",7
49,"49233",95,60,57,0,3,"C's",6
49,"49221",258,142,135,1,7,"C's",14
49,"49237",170,120,120,3,0,"C's",15
49,"49272",88,73,73,1,0,"C's",8
49,"49154",131,79,78,0,1,"C's",3
49,"49179",393,265,263,0,2,"C's",29
49,"49115",185,140,139,4,1,"C's",13
49,"49175",234,183,182,2,1,"C's",14
49,"49056",295,220,211,4,9,"C's",26
49,"49075",140,109,106,1,3,"C's",7
49,"49112",128,85,85,1,0,"C's",2
49,"49222",387,294,289,7,5,"C's",31
49,"49242",455,373,365,8,8,"C's",36
49,"49200",950,737,719,9,18,"C's",65
49,"49266",75,60,60,0,0,"C's",9
49,"49017",251,169,169,2,0,"C's",13
49,"49137",176,140,137,2,3,"C's",16
49,"49265",128,91,91,1,0,"C's",10
49,"49261",1546,1171,1154,9,17,"C's",143
49,"49223",766,628,616,5,12,"C's",44
49,"49194",377,229,228,2,1,"C's",15
49,"49057",106,77,76,0,1,"C's",5
49,"49228",56,43,41,0,2,"C's",3
49,"49193",472,323,316,4,7,"C's",37
49,"49113",172,144,142,1,2,"C's",23
49,"49138",231,164,163,1,1,"C's",7
49,"49275",52483,38405,37981,427,424,"C's",6083
49,"49102",198,148,145,1,3,"C's",13
49,"49262",392,268,266,1,2,"C's",17
49,"49178",699,503,487,4,16,"C's",103
49,"49043",300,226,225,2,1,"C's",18
49,"49035",236,205,200,0,5,"C's",27
49,"49240",218,168,159,3,9,"C's",10
49,"49119",236,172,172,0,0,"C's",14
49,"49059",93,61,61,0,0,"C's",5
49,"49158",215,164,161,3,3,"C's",15
49,"49197",180,127,123,2,4,"C's",13
49,"49076",325,253,250,2,3,"C's",46
49,"49192",134,114,114,2,0,"C's",8
49,"49157",214,167,162,1,5,"C's",11
49,"49023",977,702,697,9,5,"C's",114
49,"49044",85,56,55,0,1,"C's",9
49,"49241",256,190,186,0,4,"C's",30
49,"49225",153,95,92,2,3,"C's",8
49,"49107",131,98,97,2,1,"C's",7
49,"49024",667,464,457,7,7,"C's",58
49,"49022",287,230,226,3,4,"C's",13
49,"49116",389,272,266,4,6,"C's",17
49,"49155",83,64,63,1,1,"C's",9
49,"49199",259,203,200,1,3,"C's",20
49,"49033",728,530,528,4,2,"C's",42
49,"49079",105,80,76,2,4,"C's",1
49,"49143",225,161,157,2,4,"C's",13
49,"49249",68,60,59,1,1,"C's",5
49,"49270",138,100,99,0,1,"C's",9
49,"49025",174,128,126,0,2,"C's",8
49,"49034",446,337,333,3,4,"C's",39
49,"49082",364,306,304,6,2,"C's",17
49,"49168",90,73,73,2,0,"C's",4
49,"49232",97,74,73,0,1,"C's",1
49,"49243",111,97,95,0,2,"C's",6
49,"49146",296,232,228,2,4,"C's",24
49,"49053",938,737,729,5,8,"C's",96
49,"49108",476,359,352,4,7,"C's",33
49,"49036",521,375,371,3,4,"C's",39
49,"49174",130,95,94,2,1,"C's",14
49,"49093",287,233,231,2,2,"C's",42
49,"49080",692,523,518,6,5,"C's",60
49,"49067",372,258,256,3,2,"C's",58
49,"49100",303,216,215,1,1,"C's",17
49,"49156",237,185,183,2,2,"C's",16
49,"49271",204,154,154,3,0,"C's",8
49,"49038",99,74,74,1,0,"C's",8
49,"49077",189,115,115,0,0,"C's",9
49,"49081",1365,1071,1057,7,14,"C's",129
49,"49046",272,209,206,3,3,"C's",23
49,"49114",44,31,30,0,1,"C's",2
49,"49150",145,109,104,2,5,"C's",2
49,"49103",412,333,330,4,3,"C's",33
49,"49098",222,167,166,2,1,"C's",9
49,"49109",626,491,490,4,1,"C's",38
49,"49229",130,98,97,1,1,"C's",7
49,"49181",369,274,274,2,0,"C's",12
49,"49094",243,149,149,1,0,"C's",10
49,"49111",130,96,96,6,0,"C's",7
49,"49032",326,251,250,0,1,"C's",19
49,"49269",230,165,163,4,2,"C's",17
49,"49091",269,202,202,0,0,"C's",15
49,"49268",416,307,305,5,2,"C's",29
49,"49226",253,203,200,1,3,"C's",23
49,"49069",384,243,242,6,1,"C's",12
49,"49216",162,138,137,0,1,"C's",18
49,"49151",627,473,467,4,6,"C's",41
49,"49238",258,202,201,0,1,"C's",24
49,"49117",458,336,328,3,8,"C's",39
49,"49153",172,124,123,1,1,"C's",19
49,"49204",64,45,44,0,1,"C's",1
49,"49030",84,69,67,1,2,"C's",7
49,"49087",523,322,319,0,3,"C's",29
49,"49239",673,488,476,6,12,"C's",36
49,"49092",132,92,91,1,1,"C's",3
49,"49027",150,116,116,5,0,"C's",14
49,"49203",319,245,236,1,9,"C's",29
49,"49031",145,115,113,0,2,"C's",8
24,"24084",162,119,119,1,0,"PCPE",0
24,"24197",770,545,537,6,8,"PCPE",5
24,"24073",481,343,340,3,3,"PCPE",1
24,"24121",655,481,477,0,4,"PCPE",1
24,"24080",218,170,162,3,8,"PCPE",1
24,"24025",300,233,228,0,5,"PCPE",0
24,"24151",492,357,357,1,0,"PCPE",0
24,"24096",124,74,74,0,0,"PCPE",0
24,"24142",25160,18503,18262,205,241,"PCPE",30
24,"24202",8098,5654,5582,51,72,"PCPE",36
24,"24219",527,390,387,2,3,"PCPE",0
24,"24175",1825,1381,1372,13,9,"PCPE",1
24,"24087",645,469,466,11,3,"PCPE",1
24,"24122",1351,965,948,9,17,"PCPE",1
24,"24129",122,85,85,1,0,"PCPE",0
24,"24150",243,175,175,3,0,"PCPE",0
24,"24130",437,319,315,1,4,"PCPE",1
24,"24164",373,190,190,1,0,"PCPE",0
24,"24139",2186,1608,1570,24,38,"PCPE",2
24,"24174",495,362,357,3,5,"PCPE",1
24,"24009",322,161,161,1,0,"PCPE",0
24,"24094",1392,1048,1038,11,10,"PCPE",2
24,"24131",742,499,497,5,2,"PCPE",1
24,"24081",142,97,97,0,0,"PCPE",0
24,"24029",754,545,539,2,6,"PCPE",0
24,"24189",6016,4187,4134,58,53,"PCPE",5
24,"24030",4297,3226,3180,16,46,"PCPE",7
24,"24028",386,304,302,3,2,"PCPE",0
24,"24034",3419,2596,2556,27,40,"PCPE",2
24,"24183",805,528,522,5,6,"PCPE",0
24,"24136",544,391,390,8,1,"PCPE",1
24,"24213",158,117,117,0,0,"PCPE",0
24,"24042",61,48,48,1,0,"PCPE",0
24,"24006",488,351,342,4,9,"PCPE",0
24,"24086",271,200,198,1,2,"PCPE",0
24,"24203",96,73,72,1,1,"PCPE",1
24,"24133",350,259,258,3,1,"PCPE",0
24,"24196",2082,1529,1513,15,16,"PCPE",5
24,"24185",482,357,349,4,8,"PCPE",0
24,"24212",1029,784,774,7,10,"PCPE",4
24,"24134",3465,2628,2583,27,45,"PCPE",3
24,"24153",233,173,172,3,1,"PCPE",0
24,"24168",461,383,379,4,4,"PCPE",0
24,"24162",1671,1314,1303,21,11,"PCPE",4
24,"24125",475,285,282,2,3,"PCPE",0
24,"24017",582,434,433,9,1,"PCPE",0
24,"24092",809,619,609,1,10,"PCPE",2
24,"24154",1010,750,729,7,21,"PCPE",1
24,"24103",292,160,160,1,0,"PCPE",0
24,"24181",1519,1135,1117,10,18,"PCPE",0
24,"24077",227,195,192,1,3,"PCPE",0
24,"24068",464,343,339,5,4,"PCPE",1
24,"24061",1702,1244,1231,13,13,"PCPE",2
24,"24023",268,189,188,2,1,"PCPE",1
24,"24110",1253,932,926,7,6,"PCPE",1
24,"24109",996,667,652,7,15,"PCPE",2
24,"24062",142,105,105,1,0,"PCPE",0
24,"24005",387,267,259,6,8,"PCPE",0
24,"24116",424,276,273,0,3,"PCPE",0
24,"24127",301,239,239,3,0,"PCPE",0
24,"24179",299,202,201,8,1,"PCPE",0
24,"24123",757,499,497,4,2,"PCPE",0
24,"24148",1684,1268,1256,9,12,"PCPE",0
24,"24003",652,442,435,5,7,"PCPE",2
24,"24114",3107,2174,2155,7,19,"PCPE",10
24,"24015",2279,1693,1658,22,35,"PCPE",4
24,"24101",404,264,262,2,2,"PCPE",0
24,"24031",216,169,167,1,2,"PCPE",0
24,"24141",98,76,75,0,1,"PCPE",0
24,"24176",318,244,243,5,1,"PCPE",0
24,"24155",478,380,371,0,9,"PCPE",0
24,"24113",366,282,275,3,7,"PCPE",1
24,"24063",391,260,259,1,1,"PCPE",0
24,"24098",1205,880,874,8,6,"PCPE",3
24,"24199",433,284,281,3,3,"PCPE",0
24,"24082",870,692,682,10,10,"PCPE",1
24,"24152",462,302,301,2,1,"PCPE",0
24,"24027",1214,881,860,8,21,"PCPE",0
24,"24145",655,445,443,8,2,"PCPE",0
24,"24137",1114,811,804,9,7,"PCPE",3
24,"24178",71,58,57,0,1,"PCPE",0
24,"24108",377,279,273,3,6,"PCPE",0
24,"24099",173,133,133,2,0,"PCPE",0
24,"24076",1279,972,953,7,19,"PCPE",1
24,"24014",7474,5375,5321,56,54,"PCPE",4
24,"24165",373,254,250,2,4,"PCPE",0
24,"24071",1006,747,738,9,9,"PCPE",0
24,"24100",769,569,561,4,8,"PCPE",2
24,"24119",702,491,480,6,11,"PCPE",0
24,"24093",380,249,248,3,1,"PCPE",2
24,"24146",271,195,194,0,1,"PCPE",1
24,"24018",177,143,141,0,2,"PCPE",0
24,"24046",953,662,645,6,17,"PCPE",1
24,"24091",657,440,437,2,3,"PCPE",1
24,"24090",348,226,224,1,2,"PCPE",0
24,"24036",301,181,180,0,1,"PCPE",0
24,"24039",2077,1604,1600,39,4,"PCPE",3
24,"24065",2106,1573,1545,16,28,"PCPE",2
24,"24901",908,660,653,4,7,"PCPE",4
24,"24097",225,146,145,1,1,"PCPE",0
24,"24020",463,294,291,5,3,"PCPE",2
24,"24078",388,286,284,4,2,"PCPE",1
24,"24057",1366,1103,1076,11,27,"PCPE",2
24,"24169",2976,2256,2236,12,20,"PCPE",3
24,"24229",427,330,324,8,6,"PCPE",0
24,"24037",369,251,251,0,0,"PCPE",0
24,"24157",2580,2013,1983,25,30,"PCPE",3
24,"24230",423,329,324,2,5,"PCPE",1
24,"24173",943,678,673,3,5,"PCPE",1
24,"24088",1037,804,797,8,7,"PCPE",1
24,"24144",704,487,478,5,9,"PCPE",4
24,"24161",291,218,212,2,6,"PCPE",1
24,"24224",621,452,445,7,7,"PCPE",0
24,"24064",1525,1165,1151,10,14,"PCPE",5
24,"24105",1443,1087,1065,10,22,"PCPE",1
24,"24024",695,496,494,4,2,"PCPE",0
24,"24033",211,154,151,1,3,"PCPE",1
24,"24026",1203,908,898,19,10,"PCPE",0
24,"24041",548,384,381,5,3,"PCPE",0
24,"24171",364,219,217,1,2,"PCPE",0
24,"24011",209,113,112,0,1,"PCPE",0
24,"24021",1688,1213,1189,6,24,"PCPE",0
24,"24207",296,245,241,3,4,"PCPE",0
24,"24038",3107,2383,2354,30,29,"PCPE",8
24,"24191",111,84,84,1,0,"PCPE",1
24,"24124",374,249,246,4,3,"PCPE",0
24,"24112",318,207,207,0,0,"PCPE",0
24,"24002",236,182,180,3,2,"PCPE",0
24,"24050",102,77,77,1,0,"PCPE",0
24,"24106",258,178,173,1,5,"PCPE",0
24,"24008",9319,6964,6852,77,112,"PCPE",10
24,"24083",1077,764,755,4,9,"PCPE",0
24,"24059",887,520,512,8,8,"PCPE",1
24,"24194",292,230,229,1,1,"PCPE",0
24,"24227",1617,1146,1142,14,4,"PCPE",3
24,"24019",359,293,291,3,2,"PCPE",1
24,"24223",2640,2012,2012,53,0,"PCPE",5
24,"24143",514,391,379,4,12,"PCPE",0
24,"24221",790,568,558,6,10,"PCPE",0
24,"24170",1934,1436,1424,13,12,"PCPE",4
24,"24012",297,212,211,4,1,"PCPE",0
24,"24060",615,361,359,0,2,"PCPE",0
24,"24226",204,138,136,0,2,"PCPE",0
24,"24180",1128,825,814,12,11,"PCPE",2
24,"24211",276,210,206,4,4,"PCPE",0
24,"24198",602,411,402,4,9,"PCPE",0
24,"24115",54290,39886,39486,325,400,"PCPE",74
24,"24052",171,109,108,0,1,"PCPE",0
24,"24187",876,642,631,6,11,"PCPE",1
24,"24047",782,533,527,7,6,"PCPE",0
24,"24206",1732,1303,1288,8,15,"PCPE",4
24,"24217",136,110,109,1,1,"PCPE",1
24,"24007",764,578,576,3,2,"PCPE",1
24,"24107",244,184,183,2,1,"PCPE",0
24,"24095",314,246,244,1,2,"PCPE",0
24,"24177",481,328,327,1,1,"PCPE",2
24,"24216",732,533,522,2,11,"PCPE",0
24,"24117",446,333,331,2,2,"PCPE",0
24,"24215",156,119,118,1,1,"PCPE",0
24,"24001",188,108,108,0,0,"PCPE",1
24,"24049",1493,1152,1138,8,14,"PCPE",1
24,"24222",14249,10663,10532,119,131,"PCPE",20
24,"24089",103315,77803,77038,779,765,"PCPE",135
24,"24149",155,123,121,0,2,"PCPE",0
24,"24044",171,125,118,0,7,"PCPE",0
24,"24172",420,218,216,1,2,"PCPE",0
24,"24074",99,77,76,1,1,"PCPE",0
24,"24051",433,308,307,1,1,"PCPE",0
24,"24053",439,303,298,2,5,"PCPE",0
24,"24104",266,180,179,0,1,"PCPE",0
24,"24067",645,383,379,2,4,"PCPE",1
24,"24218",454,331,329,3,2,"PCPE",0
24,"24156",243,169,169,1,0,"PCPE",0
24,"24160",692,506,498,2,8,"PCPE",0
24,"24184",206,121,120,0,1,"PCPE",1
24,"24066",504,367,361,3,6,"PCPE",0
24,"24069",42,36,36,0,0,"PCPE",0
24,"24902",354,273,272,2,1,"PCPE",0
24,"24054",433,308,303,4,5,"PCPE",0
24,"24043",135,69,67,0,2,"PCPE",0
24,"24010",8426,5980,5888,61,92,"PCPE",7
24,"24058",205,137,134,0,3,"PCPE",0
24,"24210",510,347,347,0,0,"PCPE",1
24,"24201",1086,765,757,5,8,"PCPE",3
24,"24214",669,492,490,1,2,"PCPE",0
24,"24120",345,214,214,1,0,"PCPE",0
24,"24167",763,509,504,9,5,"PCPE",0
24,"24040",453,315,309,2,6,"PCPE",0
24,"24070",4159,3206,3162,31,44,"PCPE",11
24,"24163",3929,3076,3044,49,32,"PCPE",6
24,"24190",167,115,115,2,0,"PCPE",0
24,"24159",1832,1407,1391,17,16,"PCPE",2
24,"24022",342,227,227,0,0,"PCPE",0
24,"24209",2790,1907,1884,15,23,"PCPE",5
24,"24056",2910,2102,2068,31,34,"PCPE",7
24,"24225",1020,786,773,6,13,"PCPE",2
24,"24055",705,510,507,6,3,"PCPE",0
24,"24228",666,455,449,2,6,"PCPE",2
24,"24118",127,84,84,1,0,"PCPE",0
24,"24016",478,287,285,1,2,"PCPE",2
24,"24193",384,277,276,4,1,"PCPE",0
24,"24102",655,495,492,2,3,"PCPE",0
24,"24132",628,397,390,6,7,"PCPE",0
24,"24182",420,289,287,6,2,"PCPE",0
24,"24032",111,82,82,1,0,"PCPE",0
24,"24158",323,210,207,0,3,"PCPE",0
24,"24166",1413,1043,1014,7,29,"PCPE",0
24,"24205",967,714,706,9,8,"PCPE",0
24,"24188",3843,2962,2899,48,63,"PCPE",4
24,"24079",922,654,645,9,9,"PCPE",2
24,"24004",469,349,349,6,0,"PCPE",0
46,"46162",1207,962,947,3,15,"PSOE",285
46,"46010",914,725,716,4,9,"PSOE",105
46,"46259",503,410,406,2,4,"PSOE",95
46,"46205",14323,11325,11224,55,101,"PSOE",2400
46,"46052",502,432,431,2,1,"PSOE",110
46,"46160",1912,1523,1514,3,9,"PSOE",369
46,"46092",273,183,183,0,0,"PSOE",25
46,"46004",1924,1582,1559,11,23,"PSOE",250
46,"46095",608,498,493,2,5,"PSOE",127
46,"46140",349,288,284,2,4,"PSOE",43
46,"46176",2025,1431,1416,10,15,"PSOE",307
46,"46038",345,255,255,0,0,"PSOE",57
46,"46068",354,305,297,1,8,"PSOE",70
46,"46082",4947,3843,3814,25,29,"PSOE",536
46,"46051",8347,6500,6442,27,58,"PSOE",1130
46,"46248",4873,3679,3639,18,40,"PSOE",842
46,"46187",1310,1036,1028,6,8,"PSOE",230
46,"46143",4215,3219,3171,27,48,"PSOE",657
46,"46097",959,734,728,6,6,"PSOE",140
46,"46181",17066,12779,12636,96,143,"PSOE",2530
46,"46054",11251,8795,8731,46,64,"PSOE",1891
46,"46197",1956,1556,1543,8,13,"PSOE",247
46,"46057",495,339,337,6,2,"PSOE",80
46,"46226",48,44,44,0,0,"PSOE",22
46,"46221",339,305,303,0,2,"PSOE",77
46,"46141",438,359,348,4,11,"PSOE",57
46,"46174",984,808,794,3,14,"PSOE",285
46,"46165",7115,5626,5576,31,50,"PSOE",987
46,"46253",109,93,93,0,0,"PSOE",26
46,"46191",1970,1557,1533,6,24,"PSOE",345
46,"46106",1543,1177,1167,5,10,"PSOE",306
46,"46009",3144,2579,2552,13,27,"PSOE",570
46,"46250",578668,455375,452638,2701,2737,"PSOE",69961
46,"46043",145,131,131,0,0,"PSOE",16
46,"46067",1736,1457,1382,2,75,"PSOE",323
46,"46062",4652,3650,3583,32,67,"PSOE",823
46,"46119",783,672,666,7,6,"PSOE",178
46,"46129",521,435,434,2,1,"PSOE",108
46,"46242",340,291,285,1,6,"PSOE",38
46,"46246",1066,856,838,7,18,"PSOE",203
46,"46102",19843,15783,15676,102,107,"PSOE",4515
46,"46016",1068,885,874,3,11,"PSOE",290
46,"46225",346,299,290,0,9,"PSOE",56
46,"46186",19033,15061,14950,70,111,"PSOE",3079
46,"46089",2141,1649,1625,14,24,"PSOE",278
46,"46235",21793,16577,16424,118,153,"PSOE",3115
46,"46121",105,92,91,2,1,"PSOE",23
46,"46193",8795,7101,7061,40,40,"PSOE",1495
46,"46212",1612,1234,1214,5,20,"PSOE",258
46,"46145",21946,16629,16495,80,134,"PSOE",3299
46,"46183",6009,4624,4563,18,61,"PSOE",722
46,"46060",9361,7285,7229,30,56,"PSOE",1510
46,"46152",97,76,74,0,2,"PSOE",25
46,"46128",1601,1316,1281,5,35,"PSOE",270
46,"46019",8833,7183,7109,47,74,"PSOE",2308
46,"46064",527,429,423,0,6,"PSOE",86
46,"46202",16767,13171,13058,59,113,"PSOE",1748
46,"46029",20649,15241,15110,113,131,"PSOE",3021
46,"46046",896,697,686,1,11,"PSOE",74
46,"46241",400,324,314,1,10,"PSOE",62
46,"46050",200,160,160,0,0,"PSOE",53
46,"46109",6195,4764,4682,23,82,"PSOE",1066
46,"46045",1261,1066,1041,3,25,"PSOE",133
46,"46151",722,589,583,1,6,"PSOE",111
46,"46084",1576,1314,1298,6,16,"PSOE",306
46,"46188",668,548,538,3,10,"PSOE",83
46,"46230",13944,10746,10646,69,100,"PSOE",2472
46,"46196",153,131,130,0,1,"PSOE",30
46,"46260",2572,2100,2081,10,19,"PSOE",426
46,"46083",15467,11584,11443,79,141,"PSOE",1711
46,"46006",4529,3803,3748,18,55,"PSOE",683
46,"46903",5985,4822,4796,24,26,"PSOE",558
46,"46182",1274,970,966,2,4,"PSOE",179
46,"46184",26467,20888,20675,138,213,"PSOE",4335
46,"46189",471,412,405,2,7,"PSOE",105
46,"46098",2491,1978,1950,14,28,"PSOE",338
46,"46047",525,443,435,2,8,"PSOE",146
46,"46214",15730,12427,12334,56,93,"PSOE",2419
46,"46013",17366,13952,13862,95,90,"PSOE",2010
46,"46210",338,295,283,2,12,"PSOE",56
46,"46024",424,348,340,0,8,"PSOE",104
46,"46008",2673,2201,2189,8,12,"PSOE",447
46,"46088",176,140,138,0,2,"PSOE",29
46,"46159",22905,17498,17373,102,125,"PSOE",3543
46,"46173",1336,1097,1080,9,17,"PSOE",238
46,"46179",2182,1823,1788,13,35,"PSOE",426
46,"46262",232,172,168,0,4,"PSOE",24
46,"46199",5742,4458,4425,34,33,"PSOE",955
46,"46170",3451,2821,2775,16,46,"PSOE",871
46,"46124",788,680,672,0,8,"PSOE",95
46,"46048",3448,2817,2790,8,27,"PSOE",570
46,"46138",345,292,292,0,0,"PSOE",73
46,"46137",268,225,220,3,5,"PSOE",60
46,"46240",209,169,164,1,5,"PSOE",18
46,"46120",1109,919,902,4,17,"PSOE",191
46,"46066",1255,1028,1020,6,8,"PSOE",248
46,"46114",575,488,484,3,4,"PSOE",110
46,"46146",1670,1333,1318,11,15,"PSOE",203
46,"46028",395,346,339,2,7,"PSOE",60
46,"46049",280,242,238,1,4,"PSOE",47
46,"46136",2534,2008,1990,13,18,"PSOE",468
46,"46178",4643,3465,3434,16,31,"PSOE",382
46,"46155",1035,865,846,2,19,"PSOE",227
46,"46234",354,289,287,2,2,"PSOE",92
46,"46056",184,160,158,1,2,"PSOE",38
46,"46030",804,660,635,7,25,"PSOE",179
46,"46001",802,623,615,4,8,"PSOE",162
46,"46216",5039,4207,4188,20,19,"PSOE",482
46,"46147",16843,12206,12099,56,107,"PSOE",2235
46,"46163",1847,1508,1489,8,19,"PSOE",215
46,"46211",1723,1441,1434,13,7,"PSOE",336
46,"46108",480,375,375,2,0,"PSOE",146
46,"46227",915,771,765,5,6,"PSOE",205
46,"46218",1074,930,912,1,18,"PSOE",162
46,"46172",5040,3629,3599,14,30,"PSOE",628
46,"46003",963,841,815,1,26,"PSOE",195
46,"46249",9362,7163,7072,42,91,"PSOE",1931
46,"46074",2690,2158,2145,18,13,"PSOE",412
46,"46093",2117,1721,1710,10,11,"PSOE",434
46,"46126",5555,4619,4574,26,45,"PSOE",896
46,"46206",577,475,468,4,7,"PSOE",154
46,"46002",1175,947,935,5,12,"PSOE",160
46,"46228",2363,1854,1839,16,15,"PSOE",317
46,"46055",1273,1031,1021,4,10,"PSOE",182
46,"46156",2087,1712,1702,9,10,"PSOE",407
46,"46007",11953,9099,9038,65,61,"PSOE",1654
46,"46113",2436,1864,1849,11,15,"PSOE",265
46,"46059",1272,1066,1058,4,8,"PSOE",222
46,"46105",16249,11731,11629,59,102,"PSOE",2978
46,"46104",1956,1567,1543,6,24,"PSOE",360
46,"46135",9655,7845,7810,32,35,"PSOE",1115
46,"46061",337,281,281,3,0,"PSOE",39
46,"46076",587,489,483,2,6,"PSOE",102
46,"46040",1098,914,907,4,7,"PSOE",227
46,"46023",328,294,287,2,7,"PSOE",49
46,"46014",3042,2456,2434,17,22,"PSOE",491
46,"46071",466,383,379,2,4,"PSOE",103
46,"46081",10180,8055,7984,32,71,"PSOE",1432
46,"46123",1838,1466,1447,4,19,"PSOE",250
46,"46904",802,662,654,7,8,"PSOE",128
46,"46213",15476,11377,11246,110,131,"PSOE",2651
46,"46157",2978,2370,2343,19,27,"PSOE",488
46,"46100",289,240,237,1,3,"PSOE",49
46,"46107",1915,1566,1553,2,13,"PSOE",419
46,"46130",907,722,713,6,9,"PSOE",159
46,"46087",127,99,99,1,0,"PSOE",37
46,"46127",2706,2212,2175,10,37,"PSOE",502
46,"46044",4237,3347,3285,25,62,"PSOE",909
46,"46168",1938,1542,1530,11,12,"PSOE",361
46,"46236",975,810,806,4,4,"PSOE",218
46,"46166",8155,6521,6450,41,71,"PSOE",1075
46,"46032",5635,4529,4493,16,36,"PSOE",825
46,"46161",1481,1206,1194,6,12,"PSOE",285
46,"46041",331,254,253,6,1,"PSOE",63
46,"46171",16587,12731,12627,79,104,"PSOE",2556
46,"46110",21260,16194,16084,76,110,"PSOE",3458
46,"46131",49604,37767,37431,266,336,"PSOE",7129
46,"46005",22908,17565,17438,126,127,"PSOE",3973
46,"46034",1776,1441,1430,4,11,"PSOE",233
46,"46164",11777,8893,8798,54,95,"PSOE",1976
46,"46223",7814,6169,6129,33,40,"PSOE",1201
46,"46169",32396,25109,24953,169,156,"PSOE",5567
46,"46022",15481,11422,11347,69,75,"PSOE",2661
46,"46190",48824,36748,36542,238,206,"PSOE",6582
46,"46167",373,286,285,1,1,"PSOE",95
46,"46085",11147,8107,8033,57,74,"PSOE",1756
46,"46133",563,458,455,2,3,"PSOE",210
46,"46063",1757,1399,1384,11,15,"PSOE",294
46,"46116",13153,10566,10518,62,48,"PSOE",1664
46,"46180",682,581,572,1,9,"PSOE",150
46,"46099",922,693,685,0,8,"PSOE",236
46,"46245",516,427,420,3,7,"PSOE",94
46,"46150",1839,1377,1362,10,15,"PSOE",384
46,"46219",125,106,105,2,1,"PSOE",26
46,"46195",1967,1612,1602,9,10,"PSOE",385
46,"46233",3904,2974,2934,15,40,"PSOE",606
46,"46231",2411,1759,1735,11,24,"PSOE",377
46,"46194",15552,11606,11505,69,101,"PSOE",2419
46,"46251",2490,2082,2045,11,37,"PSOE",522
46,"46027",948,795,781,3,14,"PSOE",193
46,"46203",3598,2962,2928,17,34,"PSOE",678
46,"46015",7231,5768,5711,33,57,"PSOE",1197
46,"46037",1119,952,941,2,11,"PSOE",264
46,"46115",403,296,289,1,7,"PSOE",80
46,"46148",1528,1206,1192,15,14,"PSOE",226
46,"46207",6656,5355,5293,42,62,"PSOE",1035
46,"46244",58586,43371,43098,257,273,"PSOE",9171
46,"46017",33050,24762,24580,144,182,"PSOE",4185
46,"46177",4698,3715,3665,16,50,"PSOE",915
46,"46101",858,731,723,4,8,"PSOE",193
46,"46070",16903,13091,12999,64,92,"PSOE",1757
46,"46021",23646,18220,18100,85,120,"PSOE",4402
46,"46020",3784,3064,3012,15,52,"PSOE",676
46,"46134",2357,1811,1797,8,14,"PSOE",323
46,"46902",379,314,313,3,1,"PSOE",120
46,"46229",972,785,774,2,11,"PSOE",200
46,"46035",6786,5382,5338,27,44,"PSOE",1401
46,"46175",459,403,396,1,7,"PSOE",81
46,"46103",1270,1015,998,8,17,"PSOE",190
46,"46118",3795,2987,2962,18,25,"PSOE",923
46,"46091",115,101,100,1,1,"PSOE",4
46,"46232",894,715,712,5,3,"PSOE",270
46,"46261",1720,1386,1369,10,17,"PSOE",330
46,"46144",665,525,520,2,5,"PSOE",107
46,"46247",1024,743,733,2,10,"PSOE",95
46,"46132",2148,1850,1830,12,20,"PSOE",395
46,"46200",1909,1628,1609,5,19,"PSOE",397
46,"46112",552,466,464,1,2,"PSOE",114
46,"46154",811,644,640,4,4,"PSOE",99
46,"46094",20515,15885,15785,125,100,"PSOE",2554
46,"46239",451,353,351,3,2,"PSOE",105
46,"46252",126,95,93,0,2,"PSOE",26
46,"46185",386,325,321,4,4,"PSOE",78
46,"46122",2701,2120,2109,18,11,"PSOE",586
46,"46033",197,169,168,1,1,"PSOE",34
46,"46237",7227,5620,5571,33,49,"PSOE",1222
46,"46217",886,724,712,3,12,"PSOE",181
46,"46080",1025,795,784,4,11,"PSOE",250
46,"46026",1204,1044,1034,4,10,"PSOE",228
46,"46224",170,130,130,0,0,"PSOE",28
46,"46025",2502,2008,1993,6,15,"PSOE",419
46,"46039",2147,1746,1727,9,19,"PSOE",421
46,"46073",1097,903,892,6,11,"PSOE",277
46,"46077",7569,6100,6010,41,90,"PSOE",1312
46,"46158",1024,817,804,5,13,"PSOE",188
46,"46201",67,49,49,0,0,"PSOE",24
46,"46204",6781,5421,5379,15,42,"PSOE",1383
46,"46243",141,122,120,0,2,"PSOE",28
46,"46090",1640,1440,1424,4,16,"PSOE",394
46,"46209",1955,1531,1508,7,23,"PSOE",378
46,"46208",1114,931,922,3,9,"PSOE",240
46,"46086",82,73,73,1,0,"PSOE",14
46,"46117",493,414,411,4,3,"PSOE",71
46,"46036",583,384,381,8,3,"PSOE",51
46,"46018",635,531,522,3,9,"PSOE",142
46,"46012",888,723,703,3,20,"PSOE",128
46,"46078",28126,20975,20850,127,125,"PSOE",4740
46,"46258",2676,2099,2078,9,21,"PSOE",445
46,"46256",6833,5087,5062,37,25,"PSOE",855
46,"46238",13324,10023,9939,50,84,"PSOE",1507
46,"46042",3389,2886,2844,19,42,"PSOE",662
46,"46254",1012,786,775,1,11,"PSOE",228
46,"46072",3625,2993,2931,37,62,"PSOE",614
46,"46058",1779,1430,1409,10,21,"PSOE",452
46,"46125",857,709,701,5,8,"PSOE",215
46,"46263",255,204,202,1,2,"PSOE",87
46,"46220",48393,35859,35571,250,288,"PSOE",5991
46,"46142",797,619,608,2,11,"PSOE",174
46,"46075",149,132,130,2,2,"PSOE",37
46,"46192",767,573,568,1,5,"PSOE",139
46,"46069",161,126,122,0,4,"PSOE",39
46,"46198",846,702,693,1,9,"PSOE",129
46,"46079",326,267,265,2,2,"PSOE",57
46,"46011",7627,5496,5407,39,89,"PSOE",950
46,"46065",1588,1246,1227,5,19,"PSOE",192
46,"46139",4495,3629,3577,26,52,"PSOE",773
46,"46215",1433,1152,1149,4,3,"PSOE",241
46,"46111",10876,8133,8050,35,83,"PSOE",1319
46,"46222",383,322,321,2,1,"PSOE",76
46,"46255",3145,2494,2470,19,24,"PSOE",479
46,"46153",441,358,354,0,4,"PSOE",83
46,"46149",362,288,287,2,1,"PSOE",43
46,"46257",5579,4440,4391,26,49,"PSOE",838
46,"46031",10520,7830,7759,70,71,"PSOE",1675
46,"46053",560,454,451,2,3,"PSOE",148
46,"46096",279,229,225,2,4,"PSOE",41
41,"41074",3033,2362,2341,8,21,"PSOE",950
41,"41086",16102,10743,10665,93,78,"PSOE",4231
41,"41021",21249,15031,14854,152,177,"PSOE",5500
41,"41087",10202,7160,7033,51,127,"PSOE",2280
41,"41039",31674,23240,22982,196,258,"PSOE",7644
41,"41048",2244,1625,1598,22,27,"PSOE",880
41,"41007",12386,8552,8403,90,149,"PSOE",3583
41,"41058",17304,12982,12751,133,231,"PSOE",4339
41,"41008",1063,820,805,3,15,"PSOE",553
41,"41100",1025,770,751,5,19,"PSOE",443
41,"41066",1363,1019,1007,7,12,"PSOE",576
41,"41036",3971,2846,2806,14,40,"PSOE",983
41,"41067",7115,5248,5178,46,70,"PSOE",2064
41,"41093",18487,14687,14594,117,93,"PSOE",2645
41,"41069",29070,20827,20558,355,269,"PSOE",6406
41,"41044",7392,5562,5526,40,36,"PSOE",1629
41,"41030",516,409,395,2,14,"PSOE",182
41,"41070",6021,4504,4456,44,48,"PSOE",997
41,"41052",3006,2264,2209,8,55,"PSOE",1156
41,"41014",2510,1981,1958,8,23,"PSOE",712
41,"41037",3203,2473,2449,18,24,"PSOE",1189
41,"41042",5868,4612,4583,37,29,"PSOE",2030
41,"41002",1469,1085,1061,12,24,"PSOE",490
41,"41061",2218,1769,1742,5,27,"PSOE",303
41,"41050",5158,4123,4078,37,45,"PSOE",1583
41,"41010",4394,3203,3160,19,43,"PSOE",927
41,"41094",6288,4726,4653,36,73,"PSOE",1811
41,"41023",7919,5852,5788,34,64,"PSOE",2692
41,"41085",4086,3223,3178,31,45,"PSOE",1041
41,"41068",13948,10269,10150,75,119,"PSOE",4939
41,"41077",8728,6423,6308,28,115,"PSOE",2864
41,"41025",2041,1456,1430,17,26,"PSOE",493
41,"41011",15395,11527,11341,114,186,"PSOE",5467
41,"41090",3541,2774,2721,17,53,"PSOE",1173
41,"41062",2235,1805,1790,10,15,"PSOE",791
41,"41097",3135,2339,2317,19,22,"PSOE",1368
41,"41005",9057,6781,6693,58,88,"PSOE",2730
41,"41081",29164,21631,21410,218,221,"PSOE",8953
41,"41060",15279,10611,10447,91,164,"PSOE",3989
41,"41054",688,587,570,2,17,"PSOE",264
41,"41080",1270,954,938,8,16,"PSOE",462
41,"41031",1257,838,836,8,2,"PSOE",507
41,"41101",5932,4454,4421,27,33,"PSOE",2023
41,"41057",275,193,191,0,2,"PSOE",88
41,"41095",41137,28987,28731,302,256,"PSOE",11750
41,"41098",4952,3762,3704,24,58,"PSOE",1219
41,"41016",7310,5473,5410,50,63,"PSOE",1519
41,"41047",10086,7758,7663,80,95,"PSOE",1860
41,"41006",2740,1909,1897,13,12,"PSOE",1139
41,"41055",15009,10393,10292,82,101,"PSOE",4381
41,"41901",2676,2222,2190,31,32,"PSOE",1411
41,"41043",636,439,435,3,4,"PSOE",251
41,"41053",21252,16022,15770,121,252,"PSOE",6408
41,"41099",3998,2597,2577,19,20,"PSOE",1324
41,"41017",15052,11074,10964,99,110,"PSOE",2894
41,"41003",2319,1782,1754,8,28,"PSOE",772
41,"41059",33977,26158,25965,230,193,"PSOE",6562
41,"41049",9301,7147,7070,63,77,"PSOE",2800
41,"41026",4325,3551,3516,18,35,"PSOE",1472
41,"41078",2522,1888,1874,5,14,"PSOE",988
41,"41076",2184,1442,1432,19,10,"PSOE",646
41,"41035",1112,887,876,5,11,"PSOE",443
41,"41018",9490,6997,6930,45,67,"PSOE",3355
41,"41001",1597,1262,1248,5,14,"PSOE",546
41,"41020",12872,8820,8723,92,97,"PSOE",4700
41,"41027",3941,2766,2709,28,57,"PSOE",896
41,"41019",4654,3267,3224,34,43,"PSOE",1341
41,"41051",2170,1650,1611,8,39,"PSOE",723
41,"41034",23033,15936,15711,189,225,"PSOE",6451
41,"41092",7749,5715,5647,57,68,"PSOE",3098
41,"41029",13423,9979,9880,84,99,"PSOE",3286
41,"41083",1154,893,888,3,5,"PSOE",501
41,"41009",1229,811,803,5,8,"PSOE",392
41,"41102",14635,10904,10655,148,249,"PSOE",4112
41,"41089",6504,4759,4691,51,68,"PSOE",1913
41,"41091",541928,401177,398212,3487,2965,"PSOE",109232
41,"41056",3691,3069,3042,21,27,"PSOE",1663
41,"41004",56552,40018,39623,515,395,"PSOE",12449
41,"41902",4675,3051,3019,20,32,"PSOE",1552
41,"41032",4019,2943,2875,17,68,"PSOE",1358
41,"41073",1715,1194,1169,9,25,"PSOE",519
41,"41015",5310,3799,3710,38,89,"PSOE",1725
41,"41084",2850,2205,2157,15,48,"PSOE",1119
41,"41075",10225,7387,7283,55,104,"PSOE",2674
41,"41041",9743,7620,7482,39,138,"PSOE",3025
41,"41096",6166,4811,4752,39,59,"PSOE",1208
41,"41903",6747,4926,4854,43,72,"PSOE",2367
41,"41033",5102,3655,3613,25,42,"PSOE",1830
41,"41038",99637,71611,71050,727,561,"PSOE",22278
41,"41045",5749,4121,4066,49,55,"PSOE",1573
41,"41028",1971,1574,1562,11,12,"PSOE",392
41,"41040",10411,7959,7892,53,67,"PSOE",1452
41,"41063",2683,1942,1922,21,20,"PSOE",903
41,"41082",3432,2809,2781,12,28,"PSOE",1403
41,"41013",4842,3491,3461,22,30,"PSOE",1785
41,"41088",518,381,377,0,4,"PSOE",204
41,"41024",22662,15742,15521,137,221,"PSOE",6534
41,"41022",4300,2918,2891,30,27,"PSOE",1369
41,"41046",3017,2416,2381,12,35,"PSOE",1033
41,"41064",5601,3766,3715,42,51,"PSOE",2147
41,"41071",5620,3974,3898,17,76,"PSOE",1688
41,"41065",22868,15933,15784,172,149,"PSOE",6653
41,"41072",4052,3115,3041,18,74,"PSOE",1266
41,"41079",9343,7111,7029,68,82,"PSOE",3313
41,"41012",3286,2268,2235,15,33,"PSOE",974
20,"20001",242,138,137,1,1,"PSE-EE",2
20,"20045",46691,32759,32560,222,199,"PSE-EE",6538
20,"20901",1441,982,979,2,3,"PSE-EE",97
20,"20008",721,382,376,5,6,"PSE-EE",5
20,"20056",4104,2654,2633,12,21,"PSE-EE",99
20,"20023",445,258,258,2,0,"PSE-EE",13
20,"20904",96,62,62,0,0,"PSE-EE",1
20,"20016",1514,885,884,5,1,"PSE-EE",11
20,"20005",1261,811,805,7,6,"PSE-EE",34
20,"20012",144,108,108,3,0,"PSE-EE",5
20,"20068",183,117,115,0,2,"PSE-EE",1
20,"20020",129,71,71,0,0,"PSE-EE",0
20,"20035",482,329,328,4,1,"PSE-EE",15
20,"20038",392,284,281,1,3,"PSE-EE",3
20,"20002",343,227,226,10,1,"PSE-EE",0
20,"20057",201,122,121,0,1,"PSE-EE",1
20,"20050",263,160,160,4,0,"PSE-EE",0
20,"20042",3251,2170,2152,23,18,"PSE-EE",225
20,"20061",4273,2832,2816,21,16,"PSE-EE",185
20,"20076",6978,4975,4958,39,17,"PSE-EE",549
20,"20028",2255,1503,1494,17,9,"PSE-EE",166
20,"20036",13148,9191,9132,85,59,"PSE-EE",713
20,"20069",147189,106909,106506,699,403,"PSE-EE",15062
20,"20014",1111,635,632,4,3,"PSE-EE",28
20,"20058",746,547,546,3,1,"PSE-EE",87
20,"20006",262,161,159,1,2,"PSE-EE",1
20,"20080",7900,5517,5487,33,30,"PSE-EE",1355
20,"20051",6904,5001,4975,31,26,"PSE-EE",679
20,"20903",4247,2846,2826,9,20,"PSE-EE",243
20,"20055",17522,12125,12043,52,82,"PSE-EE",1567
20,"20003",541,334,334,3,0,"PSE-EE",11
20,"20070",1099,749,744,4,5,"PSE-EE",19
20,"20037",97,59,59,1,0,"PSE-EE",0
20,"20026",202,141,129,4,12,"PSE-EE",0
20,"20033",864,629,625,3,4,"PSE-EE",16
20,"20004",252,135,135,2,0,"PSE-EE",8
20,"20015",1272,924,921,9,3,"PSE-EE",11
20,"20044",368,264,259,0,5,"PSE-EE",9
20,"20048",176,104,104,2,0,"PSE-EE",2
20,"20052",1091,797,792,6,5,"PSE-EE",55
20,"20067",30825,21606,21512,113,94,"PSE-EE",4125
20,"20041",258,148,148,2,0,"PSE-EE",1
20,"20063",7990,5449,5415,23,34,"PSE-EE",208
20,"20905",141,105,105,0,0,"PSE-EE",1
20,"20027",2816,1842,1833,11,9,"PSE-EE",71
20,"20019",10053,6876,6844,72,32,"PSE-EE",868
20,"20054",447,301,297,5,4,"PSE-EE",0
20,"20081",7460,5187,5159,33,28,"PSE-EE",565
20,"20053",4765,3150,3132,18,18,"PSE-EE",315
20,"20049",4124,2793,2780,22,13,"PSE-EE",305
20,"20075",4359,2852,2833,16,19,"PSE-EE",282
20,"20025",1144,774,767,5,7,"PSE-EE",16
20,"20060",89,76,75,2,1,"PSE-EE",0
20,"20046",1167,797,794,4,3,"PSE-EE",47
20,"20902",14193,10263,10219,56,44,"PSE-EE",2541
20,"20039",2111,1539,1532,13,7,"PSE-EE",33
20,"20029",4258,3005,2992,17,13,"PSE-EE",176
20,"20031",180,105,102,1,3,"PSE-EE",0
20,"20043",1740,1157,1152,6,5,"PSE-EE",34
20,"20007",304,209,209,5,0,"PSE-EE",2
20,"20011",1660,1283,1278,9,5,"PSE-EE",100
20,"20047",477,329,329,2,0,"PSE-EE",17
20,"20077",5243,3792,3777,25,15,"PSE-EE",591
20,"20906",121,84,84,1,0,"PSE-EE",0
20,"20071",14818,10095,10057,62,38,"PSE-EE",752
20,"20021",199,110,110,2,0,"PSE-EE",6
20,"20073",4677,3219,3208,21,11,"PSE-EE",255
20,"20065",3006,2104,2089,18,15,"PSE-EE",303
20,"20010",1494,1055,1053,4,2,"PSE-EE",78
20,"20034",3157,2145,2141,7,4,"PSE-EE",296
20,"20018",11074,7100,7059,29,41,"PSE-EE",319
20,"20074",11610,8382,8320,43,62,"PSE-EE",713
20,"20030",21515,15110,15019,108,91,"PSE-EE",3138
20,"20078",1155,866,864,6,2,"PSE-EE",23
20,"20022",834,499,494,7,5,"PSE-EE",10
20,"20059",8863,6091,6072,30,19,"PSE-EE",361
20,"20032",8785,6115,6076,45,39,"PSE-EE",758
20,"20024",393,226,226,2,0,"PSE-EE",3
20,"20013",5427,3901,3875,19,26,"PSE-EE",377
20,"20079",17835,12650,12587,81,63,"PSE-EE",1085
20,"20066",461,279,276,3,3,"PSE-EE",1
20,"20064",12526,8429,8387,59,42,"PSE-EE",1331
20,"20062",982,685,684,3,1,"PSE-EE",23
20,"20040",15321,10260,10176,69,84,"PSE-EE",1130
20,"20009",11528,7997,7955,57,42,"PSE-EE",1472
20,"20017",8580,5807,5770,37,37,"PSE-EE",531
20,"20907",120,85,84,2,1,"PSE-EE",0
20,"20072",4731,3132,3123,23,9,"PSE-EE",451
46,"46062",4652,3650,3583,32,67,"PCPE",4
46,"46202",16767,13171,13058,59,113,"PCPE",21
46,"46009",3144,2579,2552,13,27,"PCPE",5
46,"46019",8833,7183,7109,47,74,"PCPE",4
46,"46029",20649,15241,15110,113,131,"PCPE",14
46,"46197",1956,1556,1543,8,13,"PCPE",2
46,"46176",2025,1431,1416,10,15,"PCPE",1
46,"46154",811,644,640,4,4,"PCPE",1
46,"46100",289,240,237,1,3,"PCPE",0
46,"46145",21946,16629,16495,80,134,"PCPE",14
46,"46067",1736,1457,1382,2,75,"PCPE",1
46,"46235",21793,16577,16424,118,153,"PCPE",18
46,"46186",19033,15061,14950,70,111,"PCPE",23
46,"46057",495,339,337,6,2,"PCPE",0
46,"46165",7115,5626,5576,31,50,"PCPE",11
46,"46015",7231,5768,5711,33,57,"PCPE",8
46,"46045",1261,1066,1041,3,25,"PCPE",3
46,"46090",1640,1440,1424,4,16,"PCPE",0
46,"46151",722,589,583,1,6,"PCPE",2
46,"46196",153,131,130,0,1,"PCPE",3
46,"46138",345,292,292,0,0,"PCPE",0
46,"46141",438,359,348,4,11,"PCPE",0
46,"46242",340,291,285,1,6,"PCPE",1
46,"46253",109,93,93,0,0,"PCPE",0
46,"46058",1779,1430,1409,10,21,"PCPE",1
46,"46148",1528,1206,1192,15,14,"PCPE",4
46,"46175",459,403,396,1,7,"PCPE",0
46,"46089",2141,1649,1625,14,24,"PCPE",4
46,"46195",1967,1612,1602,9,10,"PCPE",3
46,"46068",354,305,297,1,8,"PCPE",0
46,"46166",8155,6521,6450,41,71,"PCPE",6
46,"46024",424,348,340,0,8,"PCPE",0
46,"46183",6009,4624,4563,18,61,"PCPE",7
46,"46219",125,106,105,2,1,"PCPE",0
46,"46240",209,169,164,1,5,"PCPE",0
46,"46204",6781,5421,5379,15,42,"PCPE",14
46,"46026",1204,1044,1034,4,10,"PCPE",0
46,"46120",1109,919,902,4,17,"PCPE",0
46,"46159",22905,17498,17373,102,125,"PCPE",32
46,"46014",3042,2456,2434,17,22,"PCPE",5
46,"46052",502,432,431,2,1,"PCPE",1
46,"46128",1601,1316,1281,5,35,"PCPE",3
46,"46094",20515,15885,15785,125,100,"PCPE",17
46,"46193",8795,7101,7061,40,40,"PCPE",8
46,"46224",170,130,130,0,0,"PCPE",0
46,"46037",1119,952,941,2,11,"PCPE",1
46,"46121",105,92,91,2,1,"PCPE",0
46,"46125",857,709,701,5,8,"PCPE",0
46,"46088",176,140,138,0,2,"PCPE",2
46,"46220",48393,35859,35571,250,288,"PCPE",118
46,"46254",1012,786,775,1,11,"PCPE",0
46,"46179",2182,1823,1788,13,35,"PCPE",0
46,"46048",3448,2817,2790,8,27,"PCPE",16
46,"46030",804,660,635,7,25,"PCPE",0
46,"46229",972,785,774,2,11,"PCPE",0
46,"46115",403,296,289,1,7,"PCPE",0
46,"46110",21260,16194,16084,76,110,"PCPE",46
46,"46104",1956,1567,1543,6,24,"PCPE",1
46,"46116",13153,10566,10518,62,48,"PCPE",7
46,"46191",1970,1557,1533,6,24,"PCPE",1
46,"46091",115,101,100,1,1,"PCPE",0
46,"46038",345,255,255,0,0,"PCPE",0
46,"46132",2148,1850,1830,12,20,"PCPE",1
46,"46184",26467,20888,20675,138,213,"PCPE",26
46,"46056",184,160,158,1,2,"PCPE",1
46,"46046",896,697,686,1,11,"PCPE",1
46,"46041",331,254,253,6,1,"PCPE",3
46,"46181",17066,12779,12636,96,143,"PCPE",21
46,"46061",337,281,281,3,0,"PCPE",0
46,"46203",3598,2962,2928,17,34,"PCPE",3
46,"46082",4947,3843,3814,25,29,"PCPE",8
46,"46099",922,693,685,0,8,"PCPE",0
46,"46172",5040,3629,3599,14,30,"PCPE",5
46,"46066",1255,1028,1020,6,8,"PCPE",0
46,"46084",1576,1314,1298,6,16,"PCPE",0
46,"46131",49604,37767,37431,266,336,"PCPE",31
46,"46182",1274,970,966,2,4,"PCPE",2
46,"46144",665,525,520,2,5,"PCPE",0
46,"46174",984,808,794,3,14,"PCPE",4
46,"46035",6786,5382,5338,27,44,"PCPE",5
46,"46005",22908,17565,17438,126,127,"PCPE",32
46,"46072",3625,2993,2931,37,62,"PCPE",1
46,"46034",1776,1441,1430,4,11,"PCPE",1
46,"46081",10180,8055,7984,32,71,"PCPE",13
46,"46143",4215,3219,3171,27,48,"PCPE",4
46,"46147",16843,12206,12099,56,107,"PCPE",10
46,"46155",1035,865,846,2,19,"PCPE",0
46,"46111",10876,8133,8050,35,83,"PCPE",16
46,"46262",232,172,168,0,4,"PCPE",0
46,"46126",5555,4619,4574,26,45,"PCPE",7
46,"46167",373,286,285,1,1,"PCPE",0
46,"46032",5635,4529,4493,16,36,"PCPE",6
46,"46142",797,619,608,2,11,"PCPE",0
46,"46188",668,548,538,3,10,"PCPE",1
46,"46109",6195,4764,4682,23,82,"PCPE",12
46,"46135",9655,7845,7810,32,35,"PCPE",9
46,"46152",97,76,74,0,2,"PCPE",0
46,"46198",846,702,693,1,9,"PCPE",0
46,"46033",197,169,168,1,1,"PCPE",0
46,"46006",4529,3803,3748,18,55,"PCPE",2
46,"46106",1543,1177,1167,5,10,"PCPE",4
46,"46217",886,724,712,3,12,"PCPE",0
46,"46123",1838,1466,1447,4,19,"PCPE",4
46,"46098",2491,1978,1950,14,28,"PCPE",5
46,"46173",1336,1097,1080,9,17,"PCPE",0
46,"46119",783,672,666,7,6,"PCPE",1
46,"46059",1272,1066,1058,4,8,"PCPE",2
46,"46076",587,489,483,2,6,"PCPE",2
46,"46140",349,288,284,2,4,"PCPE",0
46,"46040",1098,914,907,4,7,"PCPE",0
46,"46164",11777,8893,8798,54,95,"PCPE",32
46,"46011",7627,5496,5407,39,89,"PCPE",1
46,"46093",2117,1721,1710,10,11,"PCPE",0
46,"46050",200,160,160,0,0,"PCPE",0
46,"46053",560,454,451,2,3,"PCPE",0
46,"46137",268,225,220,3,5,"PCPE",1
46,"46213",15476,11377,11246,110,131,"PCPE",15
46,"46025",2502,2008,1993,6,15,"PCPE",2
46,"46211",1723,1441,1434,13,7,"PCPE",0
46,"46114",575,488,484,3,4,"PCPE",1
46,"46054",11251,8795,8731,46,64,"PCPE",18
46,"46023",328,294,287,2,7,"PCPE",0
46,"46124",788,680,672,0,8,"PCPE",0
46,"46218",1074,930,912,1,18,"PCPE",1
46,"46169",32396,25109,24953,169,156,"PCPE",48
46,"46230",13944,10746,10646,69,100,"PCPE",12
46,"46118",3795,2987,2962,18,25,"PCPE",1
46,"46212",1612,1234,1214,5,20,"PCPE",0
46,"46136",2534,2008,1990,13,18,"PCPE",3
46,"46107",1915,1566,1553,2,13,"PCPE",2
46,"46226",48,44,44,0,0,"PCPE",0
46,"46168",1938,1542,1530,11,12,"PCPE",0
46,"46013",17366,13952,13862,95,90,"PCPE",14
46,"46092",273,183,183,0,0,"PCPE",1
46,"46228",2363,1854,1839,16,15,"PCPE",1
46,"46250",578668,455375,452638,2701,2737,"PCPE",569
46,"46146",1670,1333,1318,11,15,"PCPE",1
46,"46108",480,375,375,2,0,"PCPE",0
46,"46261",1720,1386,1369,10,17,"PCPE",0
46,"46902",379,314,313,3,1,"PCPE",0
46,"46234",354,289,287,2,2,"PCPE",0
46,"46105",16249,11731,11629,59,102,"PCPE",15
46,"46010",914,725,716,4,9,"PCPE",1
46,"46245",516,427,420,3,7,"PCPE",1
46,"46207",6656,5355,5293,42,62,"PCPE",7
46,"46001",802,623,615,4,8,"PCPE",0
46,"46002",1175,947,935,5,12,"PCPE",2
46,"46065",1588,1246,1227,5,19,"PCPE",4
46,"46222",383,322,321,2,1,"PCPE",1
46,"46133",563,458,455,2,3,"PCPE",1
46,"46208",1114,931,922,3,9,"PCPE",1
46,"46258",2676,2099,2078,9,21,"PCPE",7
46,"46239",451,353,351,3,2,"PCPE",0
46,"46185",386,325,321,4,4,"PCPE",0
46,"46127",2706,2212,2175,10,37,"PCPE",1
46,"46122",2701,2120,2109,18,11,"PCPE",1
46,"46139",4495,3629,3577,26,52,"PCPE",4
46,"46071",466,383,379,2,4,"PCPE",0
46,"46238",13324,10023,9939,50,84,"PCPE",27
46,"46225",346,299,290,0,9,"PCPE",0
46,"46251",2490,2082,2045,11,37,"PCPE",1
46,"46080",1025,795,784,4,11,"PCPE",0
46,"46227",915,771,765,5,6,"PCPE",2
46,"46113",2436,1864,1849,11,15,"PCPE",0
46,"46178",4643,3465,3434,16,31,"PCPE",5
46,"46077",7569,6100,6010,41,90,"PCPE",10
46,"46130",907,722,713,6,9,"PCPE",1
46,"46044",4237,3347,3285,25,62,"PCPE",9
46,"46206",577,475,468,4,7,"PCPE",0
46,"46157",2978,2370,2343,19,27,"PCPE",1
46,"46221",339,305,303,0,2,"PCPE",0
46,"46097",959,734,728,6,6,"PCPE",0
46,"46075",149,132,130,2,2,"PCPE",0
46,"46103",1270,1015,998,8,17,"PCPE",2
46,"46055",1273,1031,1021,4,10,"PCPE",0
46,"46237",7227,5620,5571,33,49,"PCPE",13
46,"46036",583,384,381,8,3,"PCPE",0
46,"46060",9361,7285,7229,30,56,"PCPE",7
46,"46153",441,358,354,0,4,"PCPE",0
46,"46163",1847,1508,1489,8,19,"PCPE",0
46,"46252",126,95,93,0,2,"PCPE",0
46,"46249",9362,7163,7072,42,91,"PCPE",12
46,"46096",279,229,225,2,4,"PCPE",0
46,"46257",5579,4440,4391,26,49,"PCPE",6
46,"46248",4873,3679,3639,18,40,"PCPE",5
46,"46243",141,122,120,0,2,"PCPE",0
46,"46232",894,715,712,5,3,"PCPE",0
46,"46085",11147,8107,8033,57,74,"PCPE",7
46,"46199",5742,4458,4425,34,33,"PCPE",5
46,"46150",1839,1377,1362,10,15,"PCPE",3
46,"46187",1310,1036,1028,6,8,"PCPE",5
46,"46263",255,204,202,1,2,"PCPE",0
46,"46158",1024,817,804,5,13,"PCPE",0
46,"46039",2147,1746,1727,9,19,"PCPE",4
46,"46215",1433,1152,1149,4,3,"PCPE",0
46,"46233",3904,2974,2934,15,40,"PCPE",1
46,"46021",23646,18220,18100,85,120,"PCPE",39
46,"46160",1912,1523,1514,3,9,"PCPE",0
46,"46047",525,443,435,2,8,"PCPE",0
46,"46063",1757,1399,1384,11,15,"PCPE",1
46,"46017",33050,24762,24580,144,182,"PCPE",30
46,"46007",11953,9099,9038,65,61,"PCPE",10
46,"46112",552,466,464,1,2,"PCPE",0
46,"46223",7814,6169,6129,33,40,"PCPE",7
46,"46018",635,531,522,3,9,"PCPE",1
46,"46095",608,498,493,2,5,"PCPE",1
46,"46200",1909,1628,1609,5,19,"PCPE",3
46,"46216",5039,4207,4188,20,19,"PCPE",4
46,"46162",1207,962,947,3,15,"PCPE",0
46,"46043",145,131,131,0,0,"PCPE",0
46,"46209",1955,1531,1508,7,23,"PCPE",3
46,"46027",948,795,781,3,14,"PCPE",0
46,"46904",802,662,654,7,8,"PCPE",1
46,"46031",10520,7830,7759,70,71,"PCPE",13
46,"46189",471,412,405,2,7,"PCPE",0
46,"46051",8347,6500,6442,27,58,"PCPE",5
46,"46201",67,49,49,0,0,"PCPE",0
46,"46079",326,267,265,2,2,"PCPE",0
46,"46244",58586,43371,43098,257,273,"PCPE",73
46,"46012",888,723,703,3,20,"PCPE",0
46,"46003",963,841,815,1,26,"PCPE",0
46,"46102",19843,15783,15676,102,107,"PCPE",28
46,"46210",338,295,283,2,12,"PCPE",0
46,"46205",14323,11325,11224,55,101,"PCPE",18
46,"46259",503,410,406,2,4,"PCPE",0
46,"46156",2087,1712,1702,9,10,"PCPE",0
46,"46171",16587,12731,12627,79,104,"PCPE",26
46,"46069",161,126,122,0,4,"PCPE",0
46,"46078",28126,20975,20850,127,125,"PCPE",36
46,"46083",15467,11584,11443,79,141,"PCPE",26
46,"46087",127,99,99,1,0,"PCPE",0
46,"46177",4698,3715,3665,16,50,"PCPE",10
46,"46028",395,346,339,2,7,"PCPE",1
46,"46231",2411,1759,1735,11,24,"PCPE",1
46,"46241",400,324,314,1,10,"PCPE",0
46,"46190",48824,36748,36542,238,206,"PCPE",60
46,"46214",15730,12427,12334,56,93,"PCPE",18
46,"46192",767,573,568,1,5,"PCPE",2
46,"46101",858,731,723,4,8,"PCPE",1
46,"46247",1024,743,733,2,10,"PCPE",0
46,"46246",1066,856,838,7,18,"PCPE",1
46,"46255",3145,2494,2470,19,24,"PCPE",5
46,"46016",1068,885,874,3,11,"PCPE",0
46,"46086",82,73,73,1,0,"PCPE",0
46,"46161",1481,1206,1194,6,12,"PCPE",1
46,"46049",280,242,238,1,4,"PCPE",0
46,"46117",493,414,411,4,3,"PCPE",0
46,"46074",2690,2158,2145,18,13,"PCPE",4
46,"46064",527,429,423,0,6,"PCPE",0
46,"46042",3389,2886,2844,19,42,"PCPE",1
46,"46020",3784,3064,3012,15,52,"PCPE",4
46,"46129",521,435,434,2,1,"PCPE",1
46,"46134",2357,1811,1797,8,14,"PCPE",2
46,"46073",1097,903,892,6,11,"PCPE",0
46,"46149",362,288,287,2,1,"PCPE",0
46,"46022",15481,11422,11347,69,75,"PCPE",21
46,"46170",3451,2821,2775,16,46,"PCPE",1
46,"46070",16903,13091,12999,64,92,"PCPE",12
46,"46260",2572,2100,2081,10,19,"PCPE",1
46,"46004",1924,1582,1559,11,23,"PCPE",2
46,"46008",2673,2201,2189,8,12,"PCPE",4
46,"46180",682,581,572,1,9,"PCPE",1
46,"46194",15552,11606,11505,69,101,"PCPE",16
46,"46903",5985,4822,4796,24,26,"PCPE",4
46,"46256",6833,5087,5062,37,25,"PCPE",6
46,"46236",975,810,806,4,4,"PCPE",1
41,"41026",4325,3551,3516,18,35,"PP",315
41,"41005",9057,6781,6693,58,88,"PP",1386
41,"41048",2244,1625,1598,22,27,"PP",361
41,"41061",2218,1769,1742,5,27,"PP",155
41,"41030",516,409,395,2,14,"PP",105
41,"41077",8728,6423,6308,28,115,"PP",1134
41,"41073",1715,1194,1169,9,25,"PP",311
41,"41042",5868,4612,4583,37,29,"PP",759
41,"41087",10202,7160,7033,51,127,"PP",2031
41,"41100",1025,770,751,5,19,"PP",187
41,"41001",1597,1262,1248,5,14,"PP",253
41,"41054",688,587,570,2,17,"PP",115
41,"41086",16102,10743,10665,93,78,"PP",2127
41,"41074",3033,2362,2341,8,21,"PP",497
41,"41039",31674,23240,22982,196,258,"PP",7116
41,"41029",13423,9979,9880,84,99,"PP",2472
41,"41093",18487,14687,14594,117,93,"PP",5396
41,"41008",1063,820,805,3,15,"PP",76
41,"41095",41137,28987,28731,302,256,"PP",6134
41,"41097",3135,2339,2317,19,22,"PP",509
41,"41102",14635,10904,10655,148,249,"PP",2223
41,"41047",10086,7758,7663,80,95,"PP",2399
41,"41018",9490,6997,6930,45,67,"PP",986
41,"41088",518,381,377,0,4,"PP",80
41,"41034",23033,15936,15711,189,225,"PP",2981
41,"41010",4394,3203,3160,19,43,"PP",630
41,"41024",22662,15742,15521,137,221,"PP",3737
41,"41019",4654,3267,3224,34,43,"PP",742
41,"41002",1469,1085,1061,12,24,"PP",330
41,"41046",3017,2416,2381,12,35,"PP",314
41,"41037",3203,2473,2449,18,24,"PP",306
41,"41052",3006,2264,2209,8,55,"PP",334
41,"41020",12872,8820,8723,92,97,"PP",1703
41,"41011",15395,11527,11341,114,186,"PP",1979
41,"41045",5749,4121,4066,49,55,"PP",678
41,"41903",6747,4926,4854,43,72,"PP",1089
41,"41006",2740,1909,1897,13,12,"PP",388
41,"41036",3971,2846,2806,14,40,"PP",367
41,"41064",5601,3766,3715,42,51,"PP",651
41,"41068",13948,10269,10150,75,119,"PP",2129
41,"41012",3286,2268,2235,15,33,"PP",600
41,"41090",3541,2774,2721,17,53,"PP",637
41,"41101",5932,4454,4421,27,33,"PP",1229
41,"41013",4842,3491,3461,22,30,"PP",468
41,"41094",6288,4726,4653,36,73,"PP",1240
41,"41041",9743,7620,7482,39,138,"PP",2057
41,"41035",1112,887,876,5,11,"PP",263
41,"41099",3998,2597,2577,19,20,"PP",499
41,"41032",4019,2943,2875,17,68,"PP",698
41,"41040",10411,7959,7892,53,67,"PP",2746
41,"41025",2041,1456,1430,17,26,"PP",438
41,"41031",1257,838,836,8,2,"PP",140
41,"41016",7310,5473,5410,50,63,"PP",1496
41,"41096",6166,4811,4752,39,59,"PP",1379
41,"41017",15052,11074,10964,99,110,"PP",3111
41,"41063",2683,1942,1922,21,20,"PP",267
41,"41044",7392,5562,5526,40,36,"PP",1532
41,"41014",2510,1981,1958,8,23,"PP",184
41,"41089",6504,4759,4691,51,68,"PP",778
41,"41080",1270,954,938,8,16,"PP",258
41,"41067",7115,5248,5178,46,70,"PP",1477
41,"41049",9301,7147,7070,63,77,"PP",1242
41,"41902",4675,3051,3019,20,32,"PP",649
41,"41076",2184,1442,1432,19,10,"PP",322
41,"41051",2170,1650,1611,8,39,"PP",479
41,"41009",1229,811,803,5,8,"PP",223
41,"41058",17304,12982,12751,133,231,"PP",3483
41,"41062",2235,1805,1790,10,15,"PP",106
41,"41028",1971,1574,1562,11,12,"PP",335
41,"41027",3941,2766,2709,28,57,"PP",654
41,"41071",5620,3974,3898,17,76,"PP",702
41,"41098",4952,3762,3704,24,58,"PP",1300
41,"41081",29164,21631,21410,218,221,"PP",3000
41,"41015",5310,3799,3710,38,89,"PP",750
41,"41055",15009,10393,10292,82,101,"PP",2908
41,"41043",636,439,435,3,4,"PP",56
41,"41092",7749,5715,5647,57,68,"PP",969
41,"41075",10225,7387,7283,55,104,"PP",2299
41,"41004",56552,40018,39623,515,395,"PP",8468
41,"41057",275,193,191,0,2,"PP",63
41,"41050",5158,4123,4078,37,45,"PP",1227
41,"41085",4086,3223,3178,31,45,"PP",955
41,"41083",1154,893,888,3,5,"PP",160
41,"41056",3691,3069,3042,21,27,"PP",375
41,"41082",3432,2809,2781,12,28,"PP",539
41,"41078",2522,1888,1874,5,14,"PP",404
41,"41065",22868,15933,15784,172,149,"PP",2752
41,"41007",12386,8552,8403,90,149,"PP",1401
41,"41021",21249,15031,14854,152,177,"PP",2803
41,"41060",15279,10611,10447,91,164,"PP",2751
41,"41070",6021,4504,4456,44,48,"PP",1094
41,"41091",541928,401177,398212,3487,2965,"PP",120523
41,"41066",1363,1019,1007,7,12,"PP",159
41,"41069",29070,20827,20558,355,269,"PP",4961
41,"41053",21252,16022,15770,121,252,"PP",3272
41,"41084",2850,2205,2157,15,48,"PP",513
41,"41901",2676,2222,2190,31,32,"PP",161
41,"41022",4300,2918,2891,30,27,"PP",421
41,"41059",33977,26158,25965,230,193,"PP",6312
41,"41079",9343,7111,7029,68,82,"PP",1171
41,"41038",99637,71611,71050,727,561,"PP",14762
41,"41003",2319,1782,1754,8,28,"PP",543
41,"41023",7919,5852,5788,34,64,"PP",1503
41,"41072",4052,3115,3041,18,74,"PP",314
41,"41033",5102,3655,3613,25,42,"PP",932
29,"29068",6885,4580,4511,43,69,"PACMA",44
29,"29067",424770,295944,294094,2117,1850,"PACMA",4321
29,"29025",39210,26938,26747,160,191,"PACMA",374
29,"29085",151,99,98,1,1,"PACMA",0
29,"29083",2114,1587,1568,10,19,"PACMA",4
29,"29090",1704,1174,1165,10,9,"PACMA",5
29,"29097",4117,2996,2947,43,49,"PACMA",27
29,"29064",506,372,365,2,7,"PACMA",1
29,"29065",194,134,134,1,0,"PACMA",0
29,"29066",346,252,251,2,1,"PACMA",3
29,"29031",1633,1115,1106,6,9,"PACMA",6
29,"29072",3250,2466,2434,11,32,"PACMA",16
29,"29084",27393,19096,18886,192,210,"PACMA",130
29,"29042",14078,9890,9776,75,114,"PACMA",57
29,"29082",31505,23154,22990,127,164,"PACMA",278
29,"29044",811,557,556,3,1,"PACMA",1
29,"29901",43601,30325,30130,188,195,"PACMA",396
29,"29036",636,481,475,3,6,"PACMA",3
29,"29088",2720,1930,1883,21,47,"PACMA",5
29,"29046",2690,1974,1954,17,20,"PACMA",8
29,"29017",6610,5001,4938,25,63,"PACMA",31
29,"29019",888,675,672,0,3,"PACMA",0
29,"29015",31884,23160,22943,188,217,"PACMA",164
29,"29089",3254,2465,2438,10,27,"PACMA",8
29,"29091",8966,6437,6346,57,91,"PACMA",49
29,"29058",1463,986,975,6,11,"PACMA",3
29,"29018",2026,1560,1519,15,41,"PACMA",6
29,"29051",40201,27168,26842,229,326,"PACMA",238
29,"29055",1808,1415,1396,13,19,"PACMA",10
29,"29008",14541,9954,9820,90,134,"PACMA",76
29,"29047",1131,927,914,4,13,"PACMA",2
29,"29028",1249,881,881,4,0,"PACMA",3
29,"29074",785,612,611,4,1,"PACMA",1
29,"29002",1203,855,842,6,13,"PACMA",1
29,"29023",2047,1385,1369,2,16,"PACMA",19
29,"29049",2987,2204,2185,25,19,"PACMA",10
29,"29069",85333,56398,55854,443,544,"PACMA",633
29,"29038",17555,11638,11562,124,76,"PACMA",143
29,"29070",39913,26993,26751,203,242,"PACMA",362
29,"29010",1667,1336,1310,1,26,"PACMA",3
29,"29024",393,271,256,4,15,"PACMA",1
29,"29063",336,255,251,2,4,"PACMA",2
29,"29062",658,564,561,0,3,"PACMA",1
29,"29053",1702,1178,1160,17,18,"PACMA",9
29,"29037",212,166,165,1,1,"PACMA",0
29,"29076",2163,1508,1482,8,26,"PACMA",14
29,"29040",1964,1321,1301,12,20,"PACMA",9
29,"29035",1587,1218,1208,0,10,"PACMA",1
29,"29032",6708,5341,5265,26,76,"PACMA",28
29,"29903",525,394,389,2,5,"PACMA",3
29,"29094",57313,39393,39052,280,341,"PACMA",360
29,"29039",2662,1948,1931,22,17,"PACMA",18
29,"29014",219,138,138,1,0,"PACMA",1
29,"29009",1477,1113,1100,3,13,"PACMA",5
29,"29100",2437,1775,1760,12,15,"PACMA",5
29,"29012",9765,7029,6944,58,85,"PACMA",37
29,"29020",3265,2531,2504,17,27,"PACMA",3
29,"29077",208,156,153,0,3,"PACMA",1
29,"29087",380,283,276,1,7,"PACMA",0
29,"29034",466,361,359,0,2,"PACMA",4
29,"29092",567,423,415,4,8,"PACMA",1
29,"29001",4196,3276,3253,26,23,"PACMA",22
29,"29022",185,143,143,1,0,"PACMA",2
29,"29099",960,741,734,3,7,"PACMA",6
29,"29048",1428,1168,1155,9,13,"PACMA",0
29,"29079",2444,1880,1846,3,34,"PACMA",8
29,"29096",2806,2065,2034,19,31,"PACMA",13
29,"29060",706,524,516,0,8,"PACMA",0
29,"29061",1018,833,820,4,13,"PACMA",3
29,"29003",1002,777,769,1,8,"PACMA",0
29,"29013",1612,1282,1272,6,10,"PACMA",9
29,"29016",253,188,188,1,0,"PACMA",0
29,"29071",938,640,633,6,7,"PACMA",1
29,"29080",6704,4812,4766,44,46,"PACMA",33
29,"29033",1132,808,804,2,4,"PACMA",4
29,"29041",3146,2251,2216,26,35,"PACMA",10
29,"29086",795,497,490,3,7,"PACMA",2
29,"29073",1560,1126,1120,5,6,"PACMA",5
29,"29043",2503,1671,1638,17,33,"PACMA",16
29,"29095",3350,2523,2467,17,56,"PACMA",22
29,"29005",4342,2946,2908,22,38,"PACMA",13
29,"29081",258,205,200,1,5,"PACMA",0
29,"29011",2920,1962,1946,5,16,"PACMA",10
29,"29026",1065,776,766,4,10,"PACMA",0
29,"29027",2343,1737,1722,6,15,"PACMA",7
29,"29030",809,653,651,2,2,"PACMA",2
29,"29902",2560,1735,1709,13,26,"PACMA",16
29,"29059",2590,2100,2058,11,42,"PACMA",5
29,"29045",1685,1232,1223,4,9,"PACMA",15
29,"29021",162,114,107,13,7,"PACMA",1
29,"29057",376,285,284,2,1,"PACMA",5
29,"29029",420,322,315,4,7,"PACMA",4
29,"29054",41888,29228,29022,205,206,"PACMA",324
29,"29006",680,482,474,3,8,"PACMA",0
29,"29052",226,155,152,0,3,"PACMA",0
29,"29904",428,363,360,2,3,"PACMA",0
29,"29050",425,313,309,1,4,"PACMA",4
29,"29056",1107,815,807,8,8,"PACMA",5
29,"29075",12952,8681,8619,55,62,"PACMA",36
29,"29093",2235,1689,1667,12,22,"PACMA",11
29,"29007",27319,19557,19395,179,162,"PACMA",278
29,"29004",328,240,238,2,2,"PACMA",0
29,"29098",1257,991,977,12,14,"PACMA",0
44,"44040",202,160,158,3,2,"PP-PAR",58
44,"44089",46,42,42,0,0,"PP-PAR",27
44,"44029",567,475,467,5,8,"PP-PAR",167
44,"44155",1102,831,825,7,6,"PP-PAR",191
44,"44129",41,34,34,0,0,"PP-PAR",12
44,"44153",1812,1209,1196,15,13,"PP-PAR",428
44,"44249",57,47,47,3,0,"PP-PAR",21
44,"44135",115,89,86,0,3,"PP-PAR",45
44,"44100",187,154,153,0,1,"PP-PAR",37
44,"44207",158,119,115,0,4,"PP-PAR",36
44,"44008",1615,1217,1200,7,17,"PP-PAR",375
44,"44070",55,47,46,1,1,"PP-PAR",33
44,"44138",140,79,77,0,2,"PP-PAR",33
44,"44176",160,127,127,0,0,"PP-PAR",46
44,"44014",2530,2008,1966,17,42,"PP-PAR",583
44,"44056",513,348,341,4,7,"PP-PAR",184
44,"44048",65,51,51,0,0,"PP-PAR",32
44,"44142",36,27,27,5,0,"PP-PAR",10
44,"44068",664,519,515,4,4,"PP-PAR",219
44,"44137",205,159,159,2,0,"PP-PAR",88
44,"44106",159,127,126,3,1,"PP-PAR",44
44,"44108",331,238,234,4,4,"PP-PAR",88
44,"44143",388,310,309,3,1,"PP-PAR",117
44,"44190",72,53,52,0,1,"PP-PAR",33
44,"44007",184,124,120,0,4,"PP-PAR",69
44,"44246",1554,1091,1079,13,12,"PP-PAR",346
44,"44085",52,40,40,4,0,"PP-PAR",32
44,"44077",75,58,57,0,1,"PP-PAR",10
44,"44130",34,24,24,0,0,"PP-PAR",16
44,"44059",541,431,423,7,8,"PP-PAR",193
44,"44178",56,42,42,0,0,"PP-PAR",25
44,"44250",19,12,12,2,0,"PP-PAR",5
44,"44256",39,34,34,1,0,"PP-PAR",15
44,"44042",127,93,92,1,1,"PP-PAR",35
44,"44038",107,83,83,2,0,"PP-PAR",35
44,"44208",34,22,22,0,0,"PP-PAR",11
44,"44195",92,61,61,2,0,"PP-PAR",23
44,"44128",69,50,50,0,0,"PP-PAR",19
44,"44223",75,55,55,2,0,"PP-PAR",27
44,"44020",24,20,19,1,1,"PP-PAR",11
44,"44267",71,50,50,0,0,"PP-PAR",32
44,"44050",3129,2135,2103,30,32,"PP-PAR",790
44,"44004",415,295,291,3,4,"PP-PAR",116
44,"44164",26,22,22,0,0,"PP-PAR",13
44,"44160",478,329,322,5,7,"PP-PAR",142
44,"44171",183,136,135,1,1,"PP-PAR",28
44,"44117",347,278,274,2,4,"PP-PAR",91
44,"44055",69,52,51,3,1,"PP-PAR",24
44,"44220",121,85,82,2,3,"PP-PAR",40
44,"44159",39,34,34,0,0,"PP-PAR",21
44,"44121",60,43,43,0,0,"PP-PAR",26
44,"44144",351,256,252,1,4,"PP-PAR",82
44,"44194",111,79,75,0,4,"PP-PAR",38
44,"44268",28,24,24,0,0,"PP-PAR",8
44,"44198",187,151,148,3,3,"PP-PAR",72
44,"44052",80,55,54,0,1,"PP-PAR",30
44,"44047",221,139,135,0,4,"PP-PAR",76
44,"44212",41,32,32,0,0,"PP-PAR",14
44,"44184",48,30,30,0,0,"PP-PAR",23
44,"44181",78,63,63,1,0,"PP-PAR",34
44,"44062",35,27,26,0,1,"PP-PAR",15
44,"44229",151,108,107,1,1,"PP-PAR",35
44,"44228",99,79,79,1,0,"PP-PAR",39
44,"44261",734,552,542,8,10,"PP-PAR",188
44,"44016",486,361,357,7,4,"PP-PAR",134
44,"44154",261,194,191,3,3,"PP-PAR",87
44,"44158",1170,898,872,12,26,"PP-PAR",309
44,"44092",80,53,52,0,1,"PP-PAR",26
44,"44146",173,157,157,1,0,"PP-PAR",54
44,"44262",137,107,107,1,0,"PP-PAR",42
44,"44169",351,268,266,3,2,"PP-PAR",95
44,"44239",22,20,20,0,0,"PP-PAR",12
44,"44174",430,314,313,2,1,"PP-PAR",129
44,"44147",419,312,307,5,5,"PP-PAR",130
44,"44196",134,102,102,1,0,"PP-PAR",43
44,"44234",62,48,48,1,0,"PP-PAR",16
44,"44231",38,32,32,0,0,"PP-PAR",12
44,"44215",156,105,103,2,2,"PP-PAR",26
44,"44240",161,128,125,0,3,"PP-PAR",51
44,"44054",109,90,90,0,0,"PP-PAR",46
44,"44257",167,120,120,1,0,"PP-PAR",47
44,"44132",61,50,50,1,0,"PP-PAR",29
44,"44258",69,46,46,0,0,"PP-PAR",24
44,"44017",285,221,220,0,1,"PP-PAR",83
44,"44193",82,62,62,1,0,"PP-PAR",26
44,"44148",93,76,76,3,0,"PP-PAR",31
44,"44013",11254,8292,8205,82,87,"PP-PAR",2691
44,"44061",71,57,54,1,3,"PP-PAR",27
44,"44088",30,26,26,2,0,"PP-PAR",16
44,"44026",90,71,71,0,0,"PP-PAR",39
44,"44125",65,39,39,0,0,"PP-PAR",21
44,"44022",490,323,316,9,7,"PP-PAR",108
44,"44071",599,430,424,8,6,"PP-PAR",184
44,"44161",447,324,320,3,4,"PP-PAR",154
44,"44149",99,71,71,3,0,"PP-PAR",30
44,"44113",72,50,50,0,0,"PP-PAR",3
44,"44114",244,186,185,3,1,"PP-PAR",84
44,"44252",85,67,66,0,1,"PP-PAR",43
44,"44167",38,31,31,0,0,"PP-PAR",11
44,"44217",28,20,20,0,0,"PP-PAR",6
44,"44023",18,15,15,0,0,"PP-PAR",11
44,"44141",135,105,104,1,1,"PP-PAR",45
44,"44067",117,80,80,0,0,"PP-PAR",31
44,"44118",165,127,125,2,2,"PP-PAR",62
44,"44049",850,624,613,8,11,"PP-PAR",238
44,"44006",250,188,186,1,2,"PP-PAR",77
44,"44024",27,23,23,0,0,"PP-PAR",16
44,"44041",54,46,46,2,0,"PP-PAR",15
44,"44187",199,148,143,1,5,"PP-PAR",83
44,"44087",81,70,70,3,0,"PP-PAR",28
44,"44213",63,47,47,0,0,"PP-PAR",31
44,"44097",147,89,87,1,2,"PP-PAR",43
44,"44123",105,69,69,1,0,"PP-PAR",34
44,"44011",57,35,35,0,0,"PP-PAR",15
44,"44082",91,68,67,0,1,"PP-PAR",20
44,"44245",250,189,186,1,3,"PP-PAR",89
44,"44151",191,147,145,1,2,"PP-PAR",56
44,"44124",78,58,58,1,0,"PP-PAR",15
44,"44182",194,155,154,3,1,"PP-PAR",63
44,"44189",58,40,40,1,0,"PP-PAR",20
44,"44112",426,293,284,2,9,"PP-PAR",125
44,"44025",6062,4490,4394,48,96,"PP-PAR",1056
44,"44183",77,45,44,0,1,"PP-PAR",13
44,"44227",75,63,63,0,0,"PP-PAR",34
44,"44156",46,33,32,1,1,"PP-PAR",24
44,"44165",184,153,152,1,1,"PP-PAR",71
44,"44018",20,20,20,0,0,"PP-PAR",19
44,"44012",336,279,276,2,3,"PP-PAR",134
44,"44051",2704,2074,2046,32,28,"PP-PAR",806
44,"44224",22,14,14,0,0,"PP-PAR",6
44,"44133",23,17,17,0,0,"PP-PAR",7
44,"44065",55,36,36,1,0,"PP-PAR",24
44,"44005",54,38,37,2,1,"PP-PAR",19
44,"44247",314,230,228,2,2,"PP-PAR",77
44,"44264",253,211,210,2,1,"PP-PAR",67
44,"44251",254,202,194,2,8,"PP-PAR",125
44,"44225",111,76,76,4,0,"PP-PAR",21
44,"44180",71,57,56,1,1,"PP-PAR",29
44,"44036",24,16,16,0,0,"PP-PAR",12
44,"44044",91,70,70,0,0,"PP-PAR",50
44,"44126",334,239,235,7,4,"PP-PAR",91
44,"44199",43,36,36,1,0,"PP-PAR",14
44,"44260",139,100,98,2,2,"PP-PAR",42
44,"44066",110,83,83,1,0,"PP-PAR",26
44,"44116",83,67,65,1,2,"PP-PAR",35
44,"44191",771,595,586,7,9,"PP-PAR",156
44,"44101",59,44,44,0,0,"PP-PAR",18
44,"44119",135,94,90,2,4,"PP-PAR",19
44,"44028",191,150,142,1,8,"PP-PAR",79
44,"44074",430,338,329,5,9,"PP-PAR",141
44,"44063",78,61,61,0,0,"PP-PAR",22
44,"44053",102,79,73,0,6,"PP-PAR",32
44,"44222",137,96,96,0,0,"PP-PAR",49
44,"44200",40,22,22,0,0,"PP-PAR",20
44,"44064",70,51,51,0,0,"PP-PAR",32
44,"44046",48,31,31,2,0,"PP-PAR",11
44,"44226",141,102,100,2,2,"PP-PAR",36
44,"44001",68,50,50,0,0,"PP-PAR",22
44,"44093",76,60,60,0,0,"PP-PAR",19
44,"44115",106,93,92,4,1,"PP-PAR",32
44,"44197",58,34,34,0,0,"PP-PAR",12
44,"44236",59,45,45,0,0,"PP-PAR",26
44,"44173",101,85,84,0,1,"PP-PAR",43
44,"44232",391,286,279,4,7,"PP-PAR",121
44,"44021",107,83,83,2,0,"PP-PAR",33
44,"44084",55,45,45,0,0,"PP-PAR",19
44,"44201",497,414,410,2,4,"PP-PAR",97
44,"44043",108,75,75,1,0,"PP-PAR",28
44,"44211",40,30,30,0,0,"PP-PAR",14
44,"44009",809,586,578,5,8,"PP-PAR",181
44,"44216",26539,19621,19346,248,275,"PP-PAR",7068
44,"44034",138,112,110,2,2,"PP-PAR",54
44,"44039",219,162,160,2,2,"PP-PAR",109
44,"44172",310,216,216,6,0,"PP-PAR",117
44,"44031",99,64,64,0,0,"PP-PAR",28
44,"44206",112,90,88,0,2,"PP-PAR",33
44,"44235",91,71,70,2,1,"PP-PAR",38
44,"44145",1029,768,763,7,5,"PP-PAR",302
44,"44033",279,193,191,2,2,"PP-PAR",92
44,"44221",365,298,296,2,2,"PP-PAR",128
44,"44019",68,49,48,1,1,"PP-PAR",20
44,"44204",25,22,22,0,0,"PP-PAR",8
44,"44002",54,41,41,0,0,"PP-PAR",12
44,"44219",198,141,134,4,7,"PP-PAR",70
44,"44109",110,76,74,1,2,"PP-PAR",23
44,"44099",708,514,510,1,4,"PP-PAR",109
44,"44032",16,13,13,0,0,"PP-PAR",2
44,"44037",453,326,321,5,5,"PP-PAR",132
44,"44035",117,81,81,0,0,"PP-PAR",43
44,"44218",37,26,26,0,0,"PP-PAR",14
44,"44266",118,95,95,0,0,"PP-PAR",64
44,"44243",23,18,18,0,0,"PP-PAR",10
44,"44075",324,256,250,4,6,"PP-PAR",137
44,"44265",188,144,138,2,6,"PP-PAR",83
44,"44192",364,280,278,0,2,"PP-PAR",131
44,"44175",121,91,89,2,2,"PP-PAR",45
44,"44157",65,41,40,0,1,"PP-PAR",14
44,"44076",2234,1759,1729,16,30,"PP-PAR",577
44,"44205",712,474,468,6,6,"PP-PAR",198
44,"44203",10,8,8,0,0,"PP-PAR",5
44,"44060",40,35,35,1,0,"PP-PAR",20
44,"44210",759,597,596,2,1,"PP-PAR",201
44,"44237",408,327,321,2,6,"PP-PAR",136
44,"44090",82,57,57,0,0,"PP-PAR",33
44,"44045",355,290,286,2,4,"PP-PAR",123
44,"44111",92,69,69,0,0,"PP-PAR",13
44,"44120",222,140,138,2,2,"PP-PAR",55
44,"44241",537,408,403,2,5,"PP-PAR",165
44,"44027",161,122,121,4,1,"PP-PAR",44
44,"44103",130,106,106,0,0,"PP-PAR",60
44,"44096",161,141,139,0,2,"PP-PAR",55
44,"44003",19,16,16,0,0,"PP-PAR",9
44,"44110",52,46,44,0,2,"PP-PAR",29
44,"44105",80,62,62,0,0,"PP-PAR",24
44,"44152",67,48,48,1,0,"PP-PAR",35
44,"44010",178,124,121,2,3,"PP-PAR",49
44,"44094",113,102,100,1,2,"PP-PAR",50
44,"44185",104,77,77,0,0,"PP-PAR",48
44,"44238",2345,1743,1729,7,14,"PP-PAR",308
44,"44086",453,355,350,3,5,"PP-PAR",122
44,"44168",191,137,131,3,6,"PP-PAR",66
44,"44244",75,39,39,0,0,"PP-PAR",17
44,"44127",73,51,50,0,1,"PP-PAR",15
44,"44163",128,94,94,0,0,"PP-PAR",37
44,"44230",155,126,126,2,0,"PP-PAR",36
44,"44209",839,640,623,3,17,"PP-PAR",263
44,"44122",1356,971,969,12,2,"PP-PAR",362
44,"44177",111,77,76,1,1,"PP-PAR",23
44,"44102",31,25,25,0,0,"PP-PAR",19
44,"44107",216,162,162,1,0,"PP-PAR",48
44,"44263",369,265,259,2,6,"PP-PAR",84
44,"44080",292,221,218,4,3,"PP-PAR",63
44,"44150",32,21,20,0,1,"PP-PAR",11
44,"44131",26,20,20,0,0,"PP-PAR",6
44,"44179",345,229,227,2,2,"PP-PAR",96
44,"44136",49,42,42,1,0,"PP-PAR",27
23,"23097",6445,4313,4290,30,23,"PSOE",1781
23,"23030",1232,1020,1007,10,13,"PSOE",662
23,"23081",1546,1145,1132,6,13,"PSOE",603
23,"23055",47421,33170,32908,213,262,"PSOE",10550
23,"23034",2558,1987,1977,18,10,"PSOE",1151
23,"23077",637,515,514,3,1,"PSOE",279
23,"23024",12512,9391,9182,79,209,"PSOE",3143
23,"23061",7520,5481,5405,55,76,"PSOE",2522
23,"23033",1356,1080,1065,8,15,"PSOE",483
23,"23027",727,577,576,8,1,"PSOE",332
23,"23072",2002,1593,1582,6,11,"PSOE",813
23,"23069",5385,4406,4318,15,88,"PSOE",1795
23,"23028",6203,4645,4585,33,60,"PSOE",1913
23,"23056",3108,2365,2343,14,22,"PSOE",955
23,"23001",993,826,820,1,6,"PSOE",360
23,"23086",11537,8362,8242,91,120,"PSOE",3610
23,"23002",17450,13199,12986,92,213,"PSOE",5489
23,"23051",2762,2258,2231,9,27,"PSOE",1065
23,"23016",396,323,318,3,5,"PSOE",156
23,"23011",2193,1616,1600,11,16,"PSOE",799
23,"23041",504,396,392,1,4,"PSOE",156
23,"23019",1562,1249,1227,4,22,"PSOE",538
23,"23076",837,672,658,4,14,"PSOE",299
23,"23047",1638,1311,1306,9,5,"PSOE",670
23,"23015",1393,1061,1052,3,9,"PSOE",536
23,"23088",6124,4764,4703,31,61,"PSOE",1765
23,"23026",3636,2724,2685,11,39,"PSOE",1203
23,"23010",14371,10249,10140,65,109,"PSOE",3570
23,"23049",1834,1384,1378,7,6,"PSOE",669
23,"23043",549,401,400,0,1,"PSOE",177
23,"23017",1584,1265,1253,4,12,"PSOE",686
23,"23004",435,350,346,0,4,"PSOE",119
23,"23021",528,452,448,0,4,"PSOE",254
23,"23075",3319,2640,2618,21,22,"PSOE",1260
23,"23099",4734,3509,3459,23,50,"PSOE",1271
23,"23045",2139,1560,1551,9,9,"PSOE",659
23,"23037",516,427,423,1,4,"PSOE",242
23,"23012",4177,3016,2988,22,28,"PSOE",1424
23,"23005",30539,21840,21629,176,211,"PSOE",7803
23,"23065",1601,1222,1207,0,15,"PSOE",584
23,"23079",3733,2994,2981,26,13,"PSOE",1405
23,"23006",4636,3761,3714,25,47,"PSOE",2233
23,"23020",1584,1376,1366,5,10,"PSOE",438
23,"23044",4847,3801,3740,26,61,"PSOE",1348
23,"23040",1489,1226,1211,4,15,"PSOE",447
23,"23095",8737,6303,6268,34,35,"PSOE",2502
23,"23073",4558,3427,3402,11,25,"PSOE",1707
23,"23087",11313,8540,8454,64,86,"PSOE",2452
23,"23082",1924,1420,1413,6,7,"PSOE",622
23,"23092",27765,20688,20560,143,128,"PSOE",6490
23,"23093",3257,2534,2506,21,28,"PSOE",1514
23,"23080",1786,1347,1329,6,18,"PSOE",805
23,"23057",771,648,648,4,0,"PSOE",274
23,"23009",12866,9787,9667,64,120,"PSOE",3343
23,"23059",5856,4498,4450,33,48,"PSOE",2238
23,"23052",1138,977,971,6,6,"PSOE",562
23,"23070",3931,2549,2533,11,16,"PSOE",1089
23,"23025",2813,2186,2163,7,23,"PSOE",972
23,"23048",860,636,630,1,6,"PSOE",205
23,"23018",2326,1678,1668,5,10,"PSOE",929
23,"23007",3102,2381,2369,8,12,"PSOE",1210
23,"23084",953,711,708,6,3,"PSOE",360
23,"23101",388,281,279,0,2,"PSOE",158
23,"23901",1160,978,972,5,6,"PSOE",480
23,"23031",751,662,650,9,12,"PSOE",405
23,"23032",575,461,457,1,4,"PSOE",310
23,"23042",299,220,220,1,0,"PSOE",89
23,"23063",3845,2934,2898,24,36,"PSOE",1435
23,"23035",1095,871,867,8,4,"PSOE",419
23,"23046",2405,1963,1934,3,29,"PSOE",1035
23,"23003",8709,6520,6440,42,80,"PSOE",3169
23,"23091",742,609,607,5,2,"PSOE",298
23,"23094",3852,3097,3061,17,36,"PSOE",1421
23,"23058",8665,6651,6585,47,66,"PSOE",2555
23,"23062",1461,1188,1181,1,7,"PSOE",633
23,"23054",382,276,275,0,1,"PSOE",165
23,"23085",2273,1833,1814,3,19,"PSOE",1061
23,"23905",1861,1351,1345,7,6,"PSOE",608
23,"23060",19157,13567,13438,133,129,"PSOE",5965
23,"23050",91221,67753,67164,549,589,"PSOE",16858
23,"23029",854,631,623,2,8,"PSOE",292
23,"23038",3557,2851,2831,11,20,"PSOE",759
23,"23098",875,728,722,2,6,"PSOE",351
23,"23064",1659,1368,1364,1,4,"PSOE",656
23,"23903",3550,2742,2721,19,21,"PSOE",1114
23,"23039",2220,1658,1626,8,32,"PSOE",765
23,"23067",2489,1869,1847,18,22,"PSOE",605
23,"23053",9526,6783,6736,49,47,"PSOE",2999
23,"23074",3030,2368,2353,12,15,"PSOE",1049
23,"23008",1518,1185,1173,18,12,"PSOE",651
23,"23014",2561,1982,1959,8,23,"PSOE",786
23,"23096",2643,2174,2140,14,34,"PSOE",1279
23,"23090",1316,1077,1071,8,6,"PSOE",444
23,"23904",2852,1784,1764,14,20,"PSOE",853
23,"23066",4376,3530,3508,46,22,"PSOE",1482
23,"23071",1728,1337,1328,7,9,"PSOE",583
23,"23902",2327,1877,1857,9,20,"PSOE",1174
1,"1021",460,336,332,1,4,"PP",63
1,"1013",711,486,483,3,3,"PP",47
1,"1052",244,188,186,1,2,"PP",18
1,"1017",869,584,577,4,7,"PP",77
1,"1034",165,120,119,1,1,"PP",11
1,"1058",1327,843,833,8,10,"PP",54
1,"1901",2344,1688,1669,17,19,"PP",316
1,"1041",153,105,100,1,5,"PP",36
1,"1014",372,292,284,1,8,"PP",65
1,"1047",964,713,702,13,11,"PP",182
1,"1063",1799,1320,1309,10,11,"PP",162
1,"1003",1186,842,833,19,9,"PP",11
1,"1027",416,268,268,0,0,"PP",37
1,"1060",199,162,159,0,3,"PP",60
1,"1010",2275,1729,1717,17,12,"PP",151
1,"1006",176,142,141,1,1,"PP",33
1,"1004",1405,1026,1010,7,16,"PP",121
1,"1023",269,197,195,2,2,"PP",66
1,"1018",1370,964,963,4,1,"PP",123
1,"1044",236,189,187,1,2,"PP",45
1,"1022",805,593,587,3,6,"PP",154
1,"1009",1281,908,898,2,10,"PP",56
1,"1020",326,232,228,0,4,"PP",25
1,"1057",245,203,202,0,1,"PP",22
1,"1061",153,132,132,2,0,"PP",2
1,"1016",439,255,249,3,6,"PP",57
1,"1037",586,425,419,2,6,"PP",65
1,"1001",1984,1426,1405,8,21,"PP",151
1,"1053",587,367,365,3,2,"PP",30
1,"1030",159,126,123,1,3,"PP",40
1,"1043",2318,1644,1624,8,20,"PP",359
1,"1039",202,161,156,0,5,"PP",33
1,"1028",1077,759,753,6,6,"PP",197
1,"1062",314,215,215,3,0,"PP",54
1,"1033",649,512,508,5,4,"PP",100
1,"1032",522,368,361,0,7,"PP",72
1,"1042",901,653,650,11,3,"PP",40
1,"1054",952,694,688,4,6,"PP",50
1,"1031",1183,907,885,6,22,"PP",288
1,"1049",140,108,108,0,0,"PP",14
1,"1008",790,548,542,13,6,"PP",96
1,"1059",186354,135873,134633,948,1240,"PP",27774
1,"1046",594,445,435,3,10,"PP",90
1,"1902",738,537,528,4,9,"PP",110
1,"1036",15034,10733,10619,73,114,"PP",1101
1,"1002",8139,5961,5878,32,83,"PP",501
1,"1056",218,141,140,1,1,"PP",22
1,"1019",144,112,111,2,1,"PP",17
1,"1011",237,177,175,7,2,"PP",73
1,"1051",3606,2413,2389,21,24,"PP",213
1,"1055",836,564,552,8,12,"PP",128
14,"14001",3552,2861,2830,28,31,"PP",867
14,"14007",15200,11064,10926,81,138,"PP",2788
14,"14041",3180,2404,2373,26,31,"PP",378
14,"14065",1861,1461,1446,12,15,"PP",419
14,"14031",597,490,484,0,6,"PP",146
14,"14068",545,410,407,6,3,"PP",88
14,"14021",260189,188939,187558,1934,1381,"PP",65928
14,"14048",1206,967,949,11,18,"PP",196
14,"14062",1052,813,801,4,12,"PP",289
14,"14035",5992,4475,4437,44,38,"PP",1861
14,"14075",581,463,446,6,17,"PP",98
14,"14012",6190,4574,4488,27,86,"PP",1091
14,"14002",10951,8231,8150,72,81,"PP",1621
14,"14039",2628,2151,2123,11,28,"PP",590
14,"14015",2149,1637,1616,13,21,"PP",491
14,"14049",16357,12206,12029,127,177,"PP",3022
14,"14063",1065,803,797,4,6,"PP",310
14,"14032",425,347,335,3,12,"PP",133
14,"14022",4036,3199,3169,9,30,"PP",435
14,"14043",7574,5571,5510,46,61,"PP",1226
14,"14009",2779,1941,1934,13,7,"PP",496
14,"14036",3767,2911,2857,53,54,"PP",519
14,"14026",2073,1437,1421,13,16,"PP",403
14,"14016",1364,1047,1045,3,2,"PP",301
14,"14070",1343,1026,1008,9,18,"PP",466
14,"14060",4854,3695,3633,43,62,"PP",834
14,"14008",2871,2053,2034,11,19,"PP",643
14,"14003",1265,981,970,6,11,"PP",313
14,"14064",331,252,244,2,8,"PP",82
14,"14006",1331,1166,1137,7,29,"PP",483
14,"14013",16845,12599,12414,146,185,"PP",4485
14,"14033",1285,980,963,11,17,"PP",188
14,"14023",2041,1742,1717,13,25,"PP",781
14,"14058",7973,5860,5791,49,69,"PP",1718
14,"14044",1624,1285,1267,9,18,"PP",258
14,"14047",1654,1221,1211,17,10,"PP",288
14,"14071",937,651,642,2,9,"PP",177
14,"14034",318,260,252,2,8,"PP",101
14,"14024",1920,1522,1488,10,34,"PP",318
14,"14051",1401,1095,1077,5,18,"PP",399
14,"14038",32236,22982,22773,209,209,"PP",8089
14,"14029",4206,3170,3135,32,35,"PP",956
14,"14004",2036,1502,1488,6,14,"PP",549
14,"14014",2570,2104,2075,8,29,"PP",533
14,"14055",18572,13587,13410,167,177,"PP",4518
14,"14059",699,559,552,5,7,"PP",184
14,"14050",2399,1886,1864,11,22,"PP",538
14,"14053",6050,4498,4427,56,71,"PP",1038
14,"14045",3055,2486,2451,13,35,"PP",538
14,"14072",1079,834,830,5,4,"PP",159
14,"14052",9447,6250,6201,49,49,"PP",1944
14,"14005",6358,4379,4272,56,107,"PP",799
14,"14025",2950,2460,2425,10,35,"PP",402
14,"14056",23613,17016,16804,128,212,"PP",4086
14,"14011",584,477,476,3,1,"PP",189
14,"14020",391,278,274,3,4,"PP",86
14,"14066",5890,4366,4322,29,44,"PP",1011
14,"14067",3874,3033,2986,29,47,"PP",863
14,"14017",10869,8130,8029,72,101,"PP",1879
14,"14073",2900,2068,2041,15,27,"PP",460
14,"14074",2303,1940,1929,13,11,"PP",526
14,"14040",3792,3036,3010,23,26,"PP",580
14,"14046",4484,3540,3487,22,53,"PP",422
14,"14057",6152,4973,4903,56,70,"PP",1213
14,"14061",756,606,592,2,14,"PP",151
14,"14042",18921,14842,14653,184,189,"PP",3631
14,"14037",3344,2476,2442,20,34,"PP",750
14,"14018",3710,2882,2846,28,36,"PP",831
14,"14054",13665,10923,10678,103,245,"PP",3704
14,"14030",8580,6619,6542,66,77,"PP",1295
14,"14028",320,246,244,2,2,"PP",74
14,"14010",4051,3003,2968,17,35,"PP",775
14,"14027",7908,6085,6008,57,77,"PP",1227
14,"14019",6479,5131,5076,46,55,"PP",1069
14,"14069",7536,5574,5495,48,79,"PP",1618
49,"49058",316,252,250,0,2,"PP",119
49,"49129",861,626,617,10,9,"PP",245
49,"49231",330,216,212,1,4,"PP",118
49,"49248",188,145,144,0,1,"PP",74
49,"49036",521,375,371,3,4,"PP",162
49,"49032",326,251,250,0,1,"PP",151
49,"49054",908,668,651,13,17,"PP",278
49,"49039",333,259,252,1,7,"PP",98
49,"49186",263,189,187,0,2,"PP",117
49,"49239",673,488,476,6,12,"PP",170
49,"49170",104,70,68,1,2,"PP",29
49,"49126",236,158,157,4,1,"PP",76
49,"49052",191,144,139,1,5,"PP",70
49,"49160",48,36,32,0,4,"PP",6
49,"49142",247,182,180,5,2,"PP",72
49,"49258",115,96,95,2,1,"PP",39
49,"49090",194,148,147,1,1,"PP",76
49,"49128",557,428,424,2,4,"PP",189
49,"49166",1225,945,934,11,11,"PP",300
49,"49164",158,120,118,1,2,"PP",40
49,"49162",192,140,138,1,2,"PP",56
49,"49018",331,252,245,1,7,"PP",122
49,"49102",198,148,145,1,3,"PP",61
49,"49154",131,79,78,0,1,"PP",27
49,"49255",426,330,327,4,3,"PP",191
49,"49159",276,220,216,2,4,"PP",91
49,"49145",235,145,137,2,8,"PP",88
49,"49043",300,226,225,2,1,"PP",85
49,"49075",140,109,106,1,3,"PP",57
49,"49222",387,294,289,7,5,"PP",63
49,"49249",68,60,59,1,1,"PP",42
49,"49226",253,203,200,1,3,"PP",87
49,"49098",222,167,166,2,1,"PP",103
49,"49107",131,98,97,2,1,"PP",41
49,"49012",72,47,47,1,0,"PP",20
49,"49193",472,323,316,4,7,"PP",165
49,"49118",206,167,167,0,0,"PP",91
49,"49219",7519,5407,5331,58,76,"PP",1959
49,"49259",93,70,63,0,7,"PP",47
49,"49256",256,207,206,2,1,"PP",123
49,"49010",346,285,282,3,3,"PP",82
49,"49042",244,199,195,2,4,"PP",112
49,"49117",458,336,328,3,8,"PP",142
49,"49063",341,274,274,2,0,"PP",139
49,"49252",326,260,255,7,5,"PP",108
49,"49113",172,144,142,1,2,"PP",95
49,"49167",205,147,144,0,3,"PP",78
49,"49123",547,414,410,0,4,"PP",176
49,"49053",938,737,729,5,8,"PP",288
49,"49047",111,78,77,0,1,"PP",44
49,"49046",272,209,206,3,3,"PP",112
49,"49200",950,737,719,9,18,"PP",322
49,"49155",83,64,63,1,1,"PP",38
49,"49183",101,80,80,4,0,"PP",48
49,"49240",218,168,159,3,9,"PP",89
49,"49245",261,178,174,0,4,"PP",75
49,"49191",272,215,213,1,2,"PP",73
49,"49050",513,349,348,3,1,"PP",205
49,"49207",237,156,155,0,1,"PP",72
49,"49100",303,216,215,1,1,"PP",86
49,"49236",76,54,53,0,1,"PP",32
49,"49065",1121,850,835,8,15,"PP",477
49,"49064",521,343,339,2,4,"PP",174
49,"49172",536,347,341,1,6,"PP",239
49,"49273",189,120,118,0,2,"PP",75
49,"49007",371,267,254,6,13,"PP",93
49,"49238",258,202,201,0,1,"PP",97
49,"49268",416,307,305,5,2,"PP",207
49,"49061",150,113,113,1,0,"PP",46
49,"49250",1254,974,952,11,22,"PP",415
49,"49021",14387,10353,10196,117,157,"PP",3848
49,"49025",174,128,126,0,2,"PP",59
49,"49093",287,233,231,2,2,"PP",95
49,"49263",54,41,41,0,0,"PP",34
49,"49040",117,99,99,1,0,"PP",40
49,"49085",1033,708,701,0,7,"PP",304
49,"49019",246,187,181,5,6,"PP",69
49,"49192",134,114,114,2,0,"PP",44
49,"49141",348,251,249,3,2,"PP",110
49,"49121",372,269,265,4,4,"PP",119
49,"49177",284,190,189,1,1,"PP",85
49,"49079",105,80,76,2,4,"PP",47
49,"49133",306,218,217,1,1,"PP",106
49,"49173",379,229,227,5,2,"PP",142
49,"49067",372,258,256,3,2,"PP",118
49,"49244",45,28,28,0,0,"PP",18
49,"49014",112,83,82,1,1,"PP",44
49,"49179",393,265,263,0,2,"PP",160
49,"49157",214,167,162,1,5,"PP",71
49,"49229",130,98,97,1,1,"PP",49
49,"49176",681,446,444,2,2,"PP",322
49,"49269",230,165,163,4,2,"PP",87
49,"49027",150,116,116,5,0,"PP",69
49,"49110",366,215,215,5,0,"PP",96
49,"49174",130,95,94,2,1,"PP",51
49,"49105",155,121,121,0,0,"PP",72
49,"49080",692,523,518,6,5,"PP",215
49,"49015",233,189,188,1,1,"PP",110
49,"49271",204,154,154,3,0,"PP",69
49,"49108",476,359,352,4,7,"PP",186
49,"49122",773,578,569,7,9,"PP",212
49,"49148",249,143,141,0,2,"PP",52
49,"49006",154,116,112,0,4,"PP",42
49,"49197",180,127,123,2,4,"PP",56
49,"49016",256,185,179,2,6,"PP",88
49,"49033",728,530,528,4,2,"PP",291
49,"49221",258,142,135,1,7,"PP",64
49,"49056",295,220,211,4,9,"PP",91
49,"49004",128,92,88,2,4,"PP",38
49,"49112",128,85,85,1,0,"PP",42
49,"49150",145,109,104,2,5,"PP",52
49,"49163",230,166,160,1,6,"PP",81
49,"49137",176,140,137,2,3,"PP",70
49,"49131",269,186,181,1,5,"PP",85
49,"49188",115,92,91,1,1,"PP",49
49,"49149",392,275,271,3,4,"PP",160
49,"49175",234,183,182,2,1,"PP",90
49,"49062",121,82,81,1,1,"PP",40
49,"49189",202,130,130,5,0,"PP",97
49,"49247",454,301,296,3,5,"PP",156
49,"49257",279,187,184,1,3,"PP",67
49,"49071",770,505,502,6,3,"PP",274
49,"49205",382,296,294,8,2,"PP",178
49,"49235",450,330,321,5,9,"PP",119
49,"49125",1400,977,957,10,20,"PP",323
49,"49091",269,202,202,0,0,"PP",90
49,"49104",353,224,223,0,1,"PP",128
49,"49223",766,628,616,5,12,"PP",409
49,"49165",60,59,58,2,1,"PP",29
49,"49022",287,230,226,3,4,"PP",85
49,"49187",1251,956,946,8,10,"PP",458
49,"49035",236,205,200,0,5,"PP",83
49,"49031",145,115,113,0,2,"PP",74
49,"49076",325,253,250,2,3,"PP",126
49,"49139",170,139,136,0,3,"PP",58
49,"49059",93,61,61,0,0,"PP",37
49,"49101",153,106,101,3,5,"PP",56
49,"49044",85,56,55,0,1,"PP",23
49,"49109",626,491,490,4,1,"PP",283
49,"49158",215,164,161,3,3,"PP",65
49,"49055",104,85,85,2,0,"PP",36
49,"49241",256,190,186,0,4,"PP",116
49,"49214",707,529,523,7,6,"PP",252
49,"49225",153,95,92,2,3,"PP",53
49,"49024",667,464,457,7,7,"PP",223
49,"49260",774,597,593,12,4,"PP",272
49,"49264",592,395,391,4,4,"PP",234
49,"49115",185,140,139,4,1,"PP",70
49,"49199",259,203,200,1,3,"PP",79
49,"49008",468,346,342,6,4,"PP",173
49,"49136",324,228,222,4,6,"PP",135
49,"49210",478,365,358,4,7,"PP",132
49,"49227",316,259,255,4,4,"PP",98
49,"49242",455,373,365,8,8,"PP",193
49,"49216",162,138,137,0,1,"PP",50
49,"49034",446,337,333,3,4,"PP",159
49,"49116",389,272,266,4,6,"PP",155
49,"49082",364,306,304,6,2,"PP",119
49,"49208",395,255,250,1,5,"PP",175
49,"49005",142,93,93,0,0,"PP",49
49,"49261",1546,1171,1154,9,17,"PP",399
49,"49168",90,73,73,2,0,"PP",43
49,"49194",377,229,228,2,1,"PP",102
49,"49169",35,29,29,0,0,"PP",12
49,"49184",179,117,114,1,3,"PP",91
49,"49185",162,125,121,0,4,"PP",51
49,"49030",84,69,67,1,2,"PP",48
49,"49204",64,45,44,0,1,"PP",35
49,"49190",64,49,49,0,0,"PP",24
49,"49002",64,48,48,1,0,"PP",20
49,"49023",977,702,697,9,5,"PP",355
49,"49114",44,31,30,0,1,"PP",14
49,"49130",180,137,132,5,5,"PP",63
49,"49011",230,183,180,7,3,"PP",103
49,"49143",225,161,157,2,4,"PP",94
49,"49267",91,75,74,1,1,"PP",35
49,"49088",92,70,70,0,0,"PP",45
49,"49243",111,97,95,0,2,"PP",66
49,"49181",369,274,274,2,0,"PP",206
49,"49041",440,315,307,1,8,"PP",111
49,"49096",175,134,127,1,7,"PP",54
49,"49233",95,60,57,0,3,"PP",38
49,"49135",635,450,449,5,1,"PP",200
49,"49111",130,96,96,6,0,"PP",50
49,"49127",2369,1752,1731,22,21,"PP",572
49,"49237",170,120,120,3,0,"PP",53
49,"49077",189,115,115,0,0,"PP",62
49,"49230",103,82,81,1,1,"PP",31
49,"49069",384,243,242,6,1,"PP",154
49,"49120",74,53,51,0,2,"PP",23
49,"49234",410,336,334,1,2,"PP",160
49,"49224",160,109,106,4,3,"PP",48
49,"49201",306,250,248,4,2,"PP",100
49,"49094",243,149,149,1,0,"PP",70
49,"49037",185,156,156,0,0,"PP",95
49,"49038",99,74,74,1,0,"PP",38
49,"49009",400,290,286,4,4,"PP",160
49,"49103",412,333,330,4,3,"PP",200
49,"49266",75,60,60,0,0,"PP",30
49,"49084",290,241,238,5,3,"PP",94
49,"49202",190,138,136,2,2,"PP",64
49,"49206",854,611,595,6,16,"PP",294
49,"49057",106,77,76,0,1,"PP",41
49,"49209",510,347,345,5,2,"PP",188
49,"49251",166,126,119,0,7,"PP",50
49,"49246",233,190,185,1,5,"PP",107
49,"49151",627,473,467,4,6,"PP",168
49,"49132",327,242,236,0,6,"PP",138
49,"49275",52483,38405,37981,427,424,"PP",13808
49,"49262",392,268,266,1,2,"PP",136
49,"49152",532,346,344,9,2,"PP",160
49,"49078",174,143,143,0,0,"PP",74
49,"49081",1365,1071,1057,7,14,"PP",440
49,"49138",231,164,163,1,1,"PP",94
49,"49203",319,245,236,1,9,"PP",125
49,"49232",97,74,73,0,1,"PP",38
49,"49153",172,124,123,1,1,"PP",56
49,"49220",146,116,114,1,2,"PP",43
49,"49083",52,43,41,1,2,"PP",28
49,"49272",88,73,73,1,0,"PP",48
49,"49147",267,190,189,2,1,"PP",82
49,"49068",472,292,289,2,3,"PP",190
49,"49086",119,98,97,1,1,"PP",47
49,"49119",236,172,172,0,0,"PP",50
49,"49092",132,92,91,1,1,"PP",49
49,"49156",237,185,183,2,2,"PP",103
49,"49124",254,179,176,2,3,"PP",78
49,"49178",699,503,487,4,16,"PP",145
49,"49171",648,507,500,5,7,"PP",248
49,"49003",904,631,624,4,7,"PP",323
49,"49146",296,232,228,2,4,"PP",101
49,"49097",90,47,47,0,0,"PP",21
49,"49265",128,91,91,1,0,"PP",46
49,"49028",122,103,102,1,1,"PP",73
49,"49066",498,336,328,4,8,"PP",192
49,"49095",297,233,231,1,2,"PP",98
49,"49013",254,172,168,4,4,"PP",76
49,"49228",56,43,41,0,2,"PP",30
49,"49020",294,226,223,5,3,"PP",97
49,"49017",251,169,169,2,0,"PP",105
49,"49048",134,84,84,0,0,"PP",56
49,"49180",156,101,101,0,0,"PP",47
49,"49099",132,85,85,1,0,"PP",43
49,"49134",187,115,110,0,5,"PP",48
49,"49026",233,182,179,0,3,"PP",97
49,"49029",623,494,482,4,12,"PP",298
49,"49087",523,322,319,0,3,"PP",210
49,"49270",138,100,99,0,1,"PP",36
44,"44001",68,50,50,0,0,"PSOE",6
44,"44084",55,45,45,0,0,"PSOE",14
44,"44039",219,162,160,2,2,"PSOE",23
44,"44172",310,216,216,6,0,"PSOE",56
44,"44005",54,38,37,2,1,"PSOE",6
44,"44167",38,31,31,0,0,"PSOE",12
44,"44264",253,211,210,2,1,"PSOE",64
44,"44100",187,154,153,0,1,"PSOE",54
44,"44126",334,239,235,7,4,"PSOE",62
44,"44040",202,160,158,3,2,"PSOE",60
44,"44085",52,40,40,4,0,"PSOE",1
44,"44247",314,230,228,2,2,"PSOE",70
44,"44180",71,57,56,1,1,"PSOE",14
44,"44265",188,144,138,2,6,"PSOE",18
44,"44027",161,122,121,4,1,"PSOE",48
44,"44067",117,80,80,0,0,"PSOE",18
44,"44249",57,47,47,3,0,"PSOE",10
44,"44014",2530,2008,1966,17,42,"PSOE",545
44,"44041",54,46,46,2,0,"PSOE",12
44,"44002",54,41,41,0,0,"PSOE",14
44,"44127",73,51,50,0,1,"PSOE",21
44,"44003",19,16,16,0,0,"PSOE",4
44,"44087",81,70,70,3,0,"PSOE",26
44,"44196",134,102,102,1,0,"PSOE",37
44,"44182",194,155,154,3,1,"PSOE",43
44,"44028",191,150,142,1,8,"PSOE",32
44,"44169",351,268,266,3,2,"PSOE",98
44,"44143",388,310,309,3,1,"PSOE",109
44,"44222",137,96,96,0,0,"PSOE",22
44,"44128",69,50,50,0,0,"PSOE",15
44,"44210",759,597,596,2,1,"PSOE",203
44,"44266",118,95,95,0,0,"PSOE",19
44,"44108",331,238,234,4,4,"PSOE",46
44,"44103",130,106,106,0,0,"PSOE",21
44,"44171",183,136,135,1,1,"PSOE",17
44,"44055",69,52,51,3,1,"PSOE",13
44,"44183",77,45,44,0,1,"PSOE",16
44,"44017",285,221,220,0,1,"PSOE",63
44,"44004",415,295,291,3,4,"PSOE",57
44,"44251",254,202,194,2,8,"PSOE",42
44,"44129",41,34,34,0,0,"PSOE",11
44,"44175",121,91,89,2,2,"PSOE",26
44,"44144",351,256,252,1,4,"PSOE",105
44,"44133",23,17,17,0,0,"PSOE",2
44,"44258",69,46,46,0,0,"PSOE",12
44,"44089",46,42,42,0,0,"PSOE",2
44,"44211",40,30,30,0,0,"PSOE",8
44,"44252",85,67,66,0,1,"PSOE",9
44,"44145",1029,768,763,7,5,"PSOE",192
44,"44044",91,70,70,0,0,"PSOE",9
44,"44225",111,76,76,4,0,"PSOE",18
44,"44006",250,188,186,1,2,"PSOE",68
44,"44238",2345,1743,1729,7,14,"PSOE",817
44,"44191",771,595,586,7,9,"PSOE",157
44,"44185",104,77,77,0,0,"PSOE",10
44,"44261",734,552,542,8,10,"PSOE",203
44,"44130",34,24,24,0,0,"PSOE",1
44,"44256",39,34,34,1,0,"PSOE",6
44,"44131",26,20,20,0,0,"PSOE",4
44,"44059",541,431,423,7,8,"PSOE",88
44,"44049",850,624,613,8,11,"PSOE",171
44,"44173",101,85,84,0,1,"PSOE",16
44,"44200",40,22,22,0,0,"PSOE",1
44,"44239",22,20,20,0,0,"PSOE",1
44,"44045",355,290,286,2,4,"PSOE",77
44,"44092",80,53,52,0,1,"PSOE",15
44,"44060",40,35,35,1,0,"PSOE",6
44,"44213",63,47,47,0,0,"PSOE",8
44,"44007",184,124,120,0,4,"PSOE",31
44,"44132",61,50,50,1,0,"PSOE",16
44,"44257",167,120,120,1,0,"PSOE",31
44,"44227",75,63,63,0,0,"PSOE",19
44,"44050",3129,2135,2103,30,32,"PSOE",504
44,"44046",48,31,31,2,0,"PSOE",15
44,"44189",58,40,40,1,0,"PSOE",14
44,"44147",419,312,307,5,5,"PSOE",60
44,"44148",93,76,76,3,0,"PSOE",22
44,"44093",76,60,60,0,0,"PSOE",23
44,"44201",497,414,410,2,4,"PSOE",164
44,"44008",1615,1217,1200,7,17,"PSOE",446
44,"44216",26539,19621,19346,248,275,"PSOE",3889
44,"44165",184,153,152,1,1,"PSOE",40
44,"44009",809,586,578,5,8,"PSOE",162
44,"44113",72,50,50,0,0,"PSOE",11
44,"44268",28,24,24,0,0,"PSOE",9
44,"44176",160,127,127,0,0,"PSOE",56
44,"44077",75,58,57,0,1,"PSOE",34
44,"44109",110,76,74,1,2,"PSOE",30
44,"44022",490,323,316,9,7,"PSOE",97
44,"44094",113,102,100,1,2,"PSOE",19
44,"44217",28,20,20,0,0,"PSOE",9
44,"44010",178,124,121,2,3,"PSOE",33
44,"44048",65,51,51,0,0,"PSOE",13
44,"44195",92,61,61,2,0,"PSOE",17
44,"44036",24,16,16,0,0,"PSOE",1
44,"44221",365,298,296,2,2,"PSOE",62
44,"44135",115,89,86,0,3,"PSOE",28
44,"44063",78,61,61,0,0,"PSOE",9
44,"44163",128,94,94,0,0,"PSOE",32
44,"44136",49,42,42,1,0,"PSOE",10
44,"44033",279,193,191,2,2,"PSOE",58
44,"44177",111,77,76,1,1,"PSOE",23
44,"44011",57,35,35,0,0,"PSOE",13
44,"44178",56,42,42,0,0,"PSOE",5
44,"44262",137,107,107,1,0,"PSOE",22
44,"44154",261,194,191,3,3,"PSOE",28
44,"44151",191,147,145,1,2,"PSOE",39
44,"44230",155,126,126,2,0,"PSOE",49
44,"44024",27,23,23,0,0,"PSOE",2
44,"44064",70,51,51,0,0,"PSOE",8
44,"44164",26,22,22,0,0,"PSOE",3
44,"44245",250,189,186,1,3,"PSOE",46
44,"44250",19,12,12,2,0,"PSOE",2
44,"44219",198,141,134,4,7,"PSOE",25
44,"44012",336,279,276,2,3,"PSOE",58
44,"44137",205,159,159,2,0,"PSOE",16
44,"44179",345,229,227,2,2,"PSOE",52
44,"44051",2704,2074,2046,32,28,"PSOE",604
44,"44138",140,79,77,0,2,"PSOE",21
44,"44220",121,85,82,2,3,"PSOE",10
44,"44026",90,71,71,0,0,"PSOE",12
44,"44237",408,327,321,2,6,"PSOE",100
44,"44194",111,79,75,0,4,"PSOE",15
44,"44061",71,57,54,1,3,"PSOE",13
44,"44228",99,79,79,1,0,"PSOE",18
44,"44031",99,64,64,0,0,"PSOE",24
44,"44184",48,30,30,0,0,"PSOE",1
44,"44018",20,20,20,0,0,"PSOE",1
44,"44071",599,430,424,8,6,"PSOE",74
44,"44013",11254,8292,8205,82,87,"PSOE",1846
44,"44105",80,62,62,0,0,"PSOE",22
44,"44198",187,151,148,3,3,"PSOE",45
44,"44141",135,105,104,1,1,"PSOE",19
44,"44110",52,46,44,0,2,"PSOE",9
44,"44066",110,83,83,1,0,"PSOE",43
44,"44260",139,100,98,2,2,"PSOE",25
44,"44204",25,22,22,0,0,"PSOE",11
44,"44142",36,27,27,5,0,"PSOE",2
44,"44146",173,157,157,1,0,"PSOE",79
44,"44019",68,49,48,1,1,"PSOE",9
44,"44244",75,39,39,0,0,"PSOE",10
44,"44053",102,79,73,0,6,"PSOE",20
44,"44181",78,63,63,1,0,"PSOE",10
44,"44016",486,361,357,7,4,"PSOE",113
44,"44209",839,640,623,3,17,"PSOE",178
44,"44119",135,94,90,2,4,"PSOE",34
44,"44068",664,519,515,4,4,"PSOE",146
44,"44054",109,90,90,0,0,"PSOE",16
44,"44155",1102,831,825,7,6,"PSOE",311
44,"44107",216,162,162,1,0,"PSOE",47
44,"44223",75,55,55,2,0,"PSOE",10
44,"44102",31,25,25,0,0,"PSOE",1
44,"44042",127,93,92,1,1,"PSOE",31
44,"44124",78,58,58,1,0,"PSOE",20
44,"44034",138,112,110,2,2,"PSOE",22
44,"44029",567,475,467,5,8,"PSOE",160
44,"44156",46,33,32,1,1,"PSOE",2
44,"44116",83,67,65,1,2,"PSOE",7
44,"44120",222,140,138,2,2,"PSOE",34
44,"44224",22,14,14,0,0,"PSOE",5
44,"44197",58,34,34,0,0,"PSOE",10
44,"44047",221,139,135,0,4,"PSOE",24
44,"44035",117,81,81,0,0,"PSOE",13
44,"44207",158,119,115,0,4,"PSOE",52
44,"44232",391,286,279,4,7,"PSOE",79
44,"44117",347,278,274,2,4,"PSOE",101
44,"44074",430,338,329,5,9,"PSOE",97
44,"44158",1170,898,872,12,26,"PSOE",251
44,"44157",65,41,40,0,1,"PSOE",22
44,"44150",32,21,20,0,1,"PSOE",6
44,"44153",1812,1209,1196,15,13,"PSOE",325
44,"44023",18,15,15,0,0,"PSOE",1
44,"44056",513,348,341,4,7,"PSOE",79
44,"44234",62,48,48,1,0,"PSOE",13
44,"44161",447,324,320,3,4,"PSOE",78
44,"44052",80,55,54,0,1,"PSOE",14
44,"44114",244,186,185,3,1,"PSOE",32
44,"44106",159,127,126,3,1,"PSOE",35
44,"44122",1356,971,969,12,2,"PSOE",250
44,"44187",199,148,143,1,5,"PSOE",20
44,"44125",65,39,39,0,0,"PSOE",7
44,"44096",161,141,139,0,2,"PSOE",37
44,"44240",161,128,125,0,3,"PSOE",41
44,"44111",92,69,69,0,0,"PSOE",25
44,"44192",364,280,278,0,2,"PSOE",81
44,"44097",147,89,87,1,2,"PSOE",27
44,"44020",24,20,19,1,1,"PSOE",3
44,"44174",430,314,313,2,1,"PSOE",78
44,"44226",141,102,100,2,2,"PSOE",34
44,"44065",55,36,36,1,0,"PSOE",3
44,"44021",107,83,83,2,0,"PSOE",22
44,"44215",156,105,103,2,2,"PSOE",25
44,"44121",60,43,43,0,0,"PSOE",5
44,"44236",59,45,45,0,0,"PSOE",6
44,"44193",82,62,62,1,0,"PSOE",15
44,"44118",165,127,125,2,2,"PSOE",39
44,"44025",6062,4490,4394,48,96,"PSOE",1262
44,"44160",478,329,322,5,7,"PSOE",48
44,"44246",1554,1091,1079,13,12,"PSOE",244
44,"44099",708,514,510,1,4,"PSOE",220
44,"44241",537,408,403,2,5,"PSOE",85
44,"44206",112,90,88,0,2,"PSOE",20
44,"44229",151,108,107,1,1,"PSOE",21
44,"44267",71,50,50,0,0,"PSOE",7
44,"44076",2234,1759,1729,16,30,"PSOE",605
44,"44032",16,13,13,0,0,"PSOE",8
44,"44037",453,326,321,5,5,"PSOE",57
44,"44090",82,57,57,0,0,"PSOE",12
44,"44149",99,71,71,3,0,"PSOE",17
44,"44235",91,71,70,2,1,"PSOE",14
44,"44208",34,22,22,0,0,"PSOE",5
44,"44168",191,137,131,3,6,"PSOE",22
44,"44115",106,93,92,4,1,"PSOE",26
44,"44199",43,36,36,1,0,"PSOE",6
44,"44231",38,32,32,0,0,"PSOE",4
44,"44082",91,68,67,0,1,"PSOE",22
44,"44075",324,256,250,4,6,"PSOE",48
44,"44243",23,18,18,0,0,"PSOE",2
44,"44112",426,293,284,2,9,"PSOE",73
44,"44038",107,83,83,2,0,"PSOE",23
44,"44088",30,26,26,2,0,"PSOE",6
44,"44123",105,69,69,1,0,"PSOE",18
44,"44218",37,26,26,0,0,"PSOE",1
44,"44152",67,48,48,1,0,"PSOE",3
44,"44043",108,75,75,1,0,"PSOE",14
44,"44086",453,355,350,3,5,"PSOE",85
44,"44159",39,34,34,0,0,"PSOE",3
44,"44101",59,44,44,0,0,"PSOE",12
44,"44062",35,27,26,0,1,"PSOE",9
44,"44190",72,53,52,0,1,"PSOE",9
44,"44070",55,47,46,1,1,"PSOE",6
44,"44263",369,265,259,2,6,"PSOE",68
44,"44212",41,32,32,0,0,"PSOE",4
44,"44203",10,8,8,0,0,"PSOE",3
44,"44205",712,474,468,6,6,"PSOE",144
44,"44080",292,221,218,4,3,"PSOE",80
1,"1019",144,112,111,2,1,"PSE-EE (PSO",3
1,"1057",245,203,202,0,1,"PSE-EE (PSO",10
1,"1901",2344,1688,1669,17,19,"PSE-EE (PSO",315
1,"1047",964,713,702,13,11,"PSE-EE (PSO",92
1,"1039",202,161,156,0,5,"PSE-EE (PSO",30
1,"1011",237,177,175,7,2,"PSE-EE (PSO",17
1,"1022",805,593,587,3,6,"PSE-EE (PSO",135
1,"1020",326,232,228,0,4,"PSE-EE (PSO",6
1,"1046",594,445,435,3,10,"PSE-EE (PSO",40
1,"1018",1370,964,963,4,1,"PSE-EE (PSO",73
1,"1061",153,132,132,2,0,"PSE-EE (PSO",6
1,"1014",372,292,284,1,8,"PSE-EE (PSO",33
1,"1902",738,537,528,4,9,"PSE-EE (PSO",63
1,"1023",269,197,195,2,2,"PSE-EE (PSO",10
1,"1009",1281,908,898,2,10,"PSE-EE (PSO",73
1,"1055",836,564,552,8,12,"PSE-EE (PSO",56
1,"1027",416,268,268,0,0,"PSE-EE (PSO",14
1,"1001",1984,1426,1405,8,21,"PSE-EE (PSO",196
1,"1032",522,368,361,0,7,"PSE-EE (PSO",56
1,"1037",586,425,419,2,6,"PSE-EE (PSO",21
1,"1042",901,653,650,11,3,"PSE-EE (PSO",22
1,"1010",2275,1729,1717,17,12,"PSE-EE (PSO",98
1,"1003",1186,842,833,19,9,"PSE-EE (PSO",10
1,"1062",314,215,215,3,0,"PSE-EE (PSO",26
1,"1033",649,512,508,5,4,"PSE-EE (PSO",73
1,"1043",2318,1644,1624,8,20,"PSE-EE (PSO",279
1,"1059",186354,135873,134633,948,1240,"PSE-EE (PSO",20605
1,"1016",439,255,249,3,6,"PSE-EE (PSO",14
1,"1063",1799,1320,1309,10,11,"PSE-EE (PSO",96
1,"1044",236,189,187,1,2,"PSE-EE (PSO",23
1,"1028",1077,759,753,6,6,"PSE-EE (PSO",92
1,"1051",3606,2413,2389,21,24,"PSE-EE (PSO",211
1,"1056",218,141,140,1,1,"PSE-EE (PSO",0
1,"1052",244,188,186,1,2,"PSE-EE (PSO",41
1,"1006",176,142,141,1,1,"PSE-EE (PSO",15
1,"1036",15034,10733,10619,73,114,"PSE-EE (PSO",1426
1,"1013",711,486,483,3,3,"PSE-EE (PSO",16
1,"1017",869,584,577,4,7,"PSE-EE (PSO",55
1,"1008",790,548,542,13,6,"PSE-EE (PSO",37
1,"1021",460,336,332,1,4,"PSE-EE (PSO",26
1,"1002",8139,5961,5878,32,83,"PSE-EE (PSO",575
1,"1034",165,120,119,1,1,"PSE-EE (PSO",12
1,"1031",1183,907,885,6,22,"PSE-EE (PSO",82
1,"1054",952,694,688,4,6,"PSE-EE (PSO",51
1,"1053",587,367,365,3,2,"PSE-EE (PSO",15
1,"1004",1405,1026,1010,7,16,"PSE-EE (PSO",65
1,"1041",153,105,100,1,5,"PSE-EE (PSO",3
1,"1060",199,162,159,0,3,"PSE-EE (PSO",11
1,"1030",159,126,123,1,3,"PSE-EE (PSO",10
1,"1049",140,108,108,0,0,"PSE-EE (PSO",6
1,"1058",1327,843,833,8,10,"PSE-EE (PSO",50
20,"20013",5427,3901,3875,19,26,"C's",78
20,"20005",1261,811,805,7,6,"C's",12
20,"20041",258,148,148,2,0,"C's",5
20,"20073",4677,3219,3208,21,11,"C's",66
20,"20017",8580,5807,5770,37,37,"C's",102
20,"20016",1514,885,884,5,1,"C's",8
20,"20051",6904,5001,4975,31,26,"C's",94
20,"20015",1272,924,921,9,3,"C's",5
20,"20031",180,105,102,1,3,"C's",0
20,"20003",541,334,334,3,0,"C's",1
20,"20903",4247,2846,2826,9,20,"C's",103
20,"20027",2816,1842,1833,11,9,"C's",15
20,"20043",1740,1157,1152,6,5,"C's",14
20,"20904",96,62,62,0,0,"C's",0
20,"20018",11074,7100,7059,29,41,"C's",82
20,"20028",2255,1503,1494,17,9,"C's",33
20,"20036",13148,9191,9132,85,59,"C's",377
20,"20058",746,547,546,3,1,"C's",18
20,"20032",8785,6115,6076,45,39,"C's",157
20,"20081",7460,5187,5159,33,28,"C's",106
20,"20014",1111,635,632,4,3,"C's",7
20,"20068",183,117,115,0,2,"C's",0
20,"20052",1091,797,792,6,5,"C's",12
20,"20019",10053,6876,6844,72,32,"C's",174
20,"20905",141,105,105,0,0,"C's",0
20,"20902",14193,10263,10219,56,44,"C's",486
20,"20069",147189,106909,106506,699,403,"C's",6348
20,"20012",144,108,108,3,0,"C's",0
20,"20038",392,284,281,1,3,"C's",1
20,"20009",11528,7997,7955,57,42,"C's",272
20,"20080",7900,5517,5487,33,30,"C's",196
20,"20023",445,258,258,2,0,"C's",4
20,"20002",343,227,226,10,1,"C's",4
20,"20045",46691,32759,32560,222,199,"C's",1962
20,"20067",30825,21606,21512,113,94,"C's",811
20,"20024",393,226,226,2,0,"C's",2
20,"20035",482,329,328,4,1,"C's",2
20,"20065",3006,2104,2089,18,15,"C's",50
20,"20006",262,161,159,1,2,"C's",1
20,"20054",447,301,297,5,4,"C's",1
20,"20039",2111,1539,1532,13,7,"C's",9
20,"20053",4765,3150,3132,18,18,"C's",69
20,"20021",199,110,110,2,0,"C's",2
20,"20059",8863,6091,6072,30,19,"C's",67
20,"20063",7990,5449,5415,23,34,"C's",84
20,"20007",304,209,209,5,0,"C's",1
20,"20026",202,141,129,4,12,"C's",1
20,"20907",120,85,84,2,1,"C's",0
20,"20057",201,122,121,0,1,"C's",2
20,"20022",834,499,494,7,5,"C's",3
20,"20066",461,279,276,3,3,"C's",0
20,"20070",1099,749,744,4,5,"C's",4
20,"20044",368,264,259,0,5,"C's",3
20,"20076",6978,4975,4958,39,17,"C's",108
20,"20056",4104,2654,2633,12,21,"C's",34
20,"20037",97,59,59,1,0,"C's",2
20,"20075",4359,2852,2833,16,19,"C's",78
20,"20048",176,104,104,2,0,"C's",1
20,"20074",11610,8382,8320,43,62,"C's",97
20,"20004",252,135,135,2,0,"C's",3
20,"20046",1167,797,794,4,3,"C's",26
20,"20033",864,629,625,3,4,"C's",6
20,"20034",3157,2145,2141,7,4,"C's",41
20,"20071",14818,10095,10057,62,38,"C's",218
20,"20078",1155,866,864,6,2,"C's",6
20,"20030",21515,15110,15019,108,91,"C's",416
20,"20029",4258,3005,2992,17,13,"C's",48
20,"20906",121,84,84,1,0,"C's",1
20,"20901",1441,982,979,2,3,"C's",16
20,"20064",12526,8429,8387,59,42,"C's",242
20,"20050",263,160,160,4,0,"C's",0
20,"20061",4273,2832,2816,21,16,"C's",33
20,"20011",1660,1283,1278,9,5,"C's",4
20,"20008",721,382,376,5,6,"C's",1
20,"20040",15321,10260,10176,69,84,"C's",255
20,"20077",5243,3792,3777,25,15,"C's",99
20,"20072",4731,3132,3123,23,9,"C's",122
20,"20020",129,71,71,0,0,"C's",0
20,"20079",17835,12650,12587,81,63,"C's",362
20,"20055",17522,12125,12043,52,82,"C's",220
20,"20025",1144,774,767,5,7,"C's",3
20,"20049",4124,2793,2780,22,13,"C's",47
20,"20001",242,138,137,1,1,"C's",0
20,"20060",89,76,75,2,1,"C's",0
20,"20010",1494,1055,1053,4,2,"C's",25
20,"20047",477,329,329,2,0,"C's",3
20,"20042",3251,2170,2152,23,18,"C's",40
20,"20062",982,685,684,3,1,"C's",8
44,"44237",408,327,321,2,6,"C's",30
44,"44034",138,112,110,2,2,"C's",13
44,"44229",151,108,107,1,1,"C's",21
44,"44165",184,153,152,1,1,"C's",15
44,"44109",110,76,74,1,2,"C's",7
44,"44040",202,160,158,3,2,"C's",12
44,"44031",99,64,64,0,0,"C's",8
44,"44048",65,51,51,0,0,"C's",1
44,"44244",75,39,39,0,0,"C's",6
44,"44087",81,70,70,3,0,"C's",1
44,"44049",850,624,613,8,11,"C's",87
44,"44045",355,290,286,2,4,"C's",31
44,"44066",110,83,83,1,0,"C's",5
44,"44159",39,34,34,0,0,"C's",1
44,"44024",27,23,23,0,0,"C's",4
44,"44149",99,71,71,3,0,"C's",4
44,"44146",173,157,157,1,0,"C's",9
44,"44022",490,323,316,9,7,"C's",28
44,"44212",41,32,32,0,0,"C's",8
44,"44157",65,41,40,0,1,"C's",0
44,"44027",161,122,121,4,1,"C's",4
44,"44064",70,51,51,0,0,"C's",5
44,"44220",121,85,82,2,3,"C's",16
44,"44148",93,76,76,3,0,"C's",11
44,"44243",23,18,18,0,0,"C's",4
44,"44210",759,597,596,2,1,"C's",59
44,"44258",69,46,46,0,0,"C's",6
44,"44168",191,137,131,3,6,"C's",21
44,"44038",107,83,83,2,0,"C's",5
44,"44161",447,324,320,3,4,"C's",40
44,"44153",1812,1209,1196,15,13,"C's",158
44,"44261",734,552,542,8,10,"C's",48
44,"44185",104,77,77,0,0,"C's",5
44,"44163",128,94,94,0,0,"C's",6
44,"44093",76,60,60,0,0,"C's",3
44,"44097",147,89,87,1,2,"C's",8
44,"44082",91,68,67,0,1,"C's",15
44,"44239",22,20,20,0,0,"C's",3
44,"44096",161,141,139,0,2,"C's",8
44,"44158",1170,898,872,12,26,"C's",153
44,"44114",244,186,185,3,1,"C's",26
44,"44067",117,80,80,0,0,"C's",7
44,"44009",809,586,578,5,8,"C's",90
44,"44118",165,127,125,2,2,"C's",12
44,"44004",415,295,291,3,4,"C's",26
44,"44012",336,279,276,2,3,"C's",42
44,"44120",222,140,138,2,2,"C's",12
44,"44136",49,42,42,1,0,"C's",2
44,"44025",6062,4490,4394,48,96,"C's",591
44,"44112",426,293,284,2,9,"C's",33
44,"44200",40,22,22,0,0,"C's",0
44,"44164",26,22,22,0,0,"C's",3
44,"44036",24,16,16,0,0,"C's",1
44,"44042",127,93,92,1,1,"C's",9
44,"44033",279,193,191,2,2,"C's",14
44,"44193",82,62,62,1,0,"C's",3
44,"44240",161,128,125,0,3,"C's",15
44,"44216",26539,19621,19346,248,275,"C's",3687
44,"44077",75,58,57,0,1,"C's",5
44,"44062",35,27,26,0,1,"C's",1
44,"44141",135,105,104,1,1,"C's",15
44,"44260",139,100,98,2,2,"C's",14
44,"44106",159,127,126,3,1,"C's",8
44,"44152",67,48,48,1,0,"C's",9
44,"44008",1615,1217,1200,7,17,"C's",132
44,"44232",391,286,279,4,7,"C's",32
44,"44023",18,15,15,0,0,"C's",3
44,"44080",292,221,218,4,3,"C's",13
44,"44059",541,431,423,7,8,"C's",88
44,"44094",113,102,100,1,2,"C's",19
44,"44234",62,48,48,1,0,"C's",7
44,"44028",191,150,142,1,8,"C's",15
44,"44086",453,355,350,3,5,"C's",53
44,"44041",54,46,46,2,0,"C's",2
44,"44222",137,96,96,0,0,"C's",11
44,"44213",63,47,47,0,0,"C's",5
44,"44154",261,194,191,3,3,"C's",33
44,"44209",839,640,623,3,17,"C's",78
44,"44195",92,61,61,2,0,"C's",12
44,"44266",118,95,95,0,0,"C's",9
44,"44050",3129,2135,2103,30,32,"C's",382
44,"44010",178,124,121,2,3,"C's",21
44,"44265",188,144,138,2,6,"C's",22
44,"44003",19,16,16,0,0,"C's",1
44,"44219",198,141,134,4,7,"C's",17
44,"44143",388,310,309,3,1,"C's",33
44,"44084",55,45,45,0,0,"C's",7
44,"44189",58,40,40,1,0,"C's",3
44,"44223",75,55,55,2,0,"C's",1
44,"44128",69,50,50,0,0,"C's",8
44,"44055",69,52,51,3,1,"C's",5
44,"44016",486,361,357,7,4,"C's",54
44,"44065",55,36,36,1,0,"C's",5
44,"44207",158,119,115,0,4,"C's",6
44,"44117",347,278,274,2,4,"C's",38
44,"44071",599,430,424,8,6,"C's",44
44,"44039",219,162,160,2,2,"C's",13
44,"44085",52,40,40,4,0,"C's",0
44,"44180",71,57,56,1,1,"C's",11
44,"44194",111,79,75,0,4,"C's",7
44,"44056",513,348,341,4,7,"C's",35
44,"44264",253,211,210,2,1,"C's",35
44,"44013",11254,8292,8205,82,87,"C's",1532
44,"44208",34,22,22,0,0,"C's",4
44,"44251",254,202,194,2,8,"C's",21
44,"44238",2345,1743,1729,7,14,"C's",190
44,"44247",314,230,228,2,2,"C's",22
44,"44002",54,41,41,0,0,"C's",1
44,"44110",52,46,44,0,2,"C's",3
44,"44044",91,70,70,0,0,"C's",4
44,"44074",430,338,329,5,9,"C's",48
44,"44019",68,49,48,1,1,"C's",13
44,"44131",26,20,20,0,0,"C's",2
44,"44090",82,57,57,0,0,"C's",5
44,"44226",141,102,100,2,2,"C's",8
44,"44007",184,124,120,0,4,"C's",13
44,"44107",216,162,162,1,0,"C's",18
44,"44092",80,53,52,0,1,"C's",6
44,"44108",331,238,234,4,4,"C's",30
44,"44230",155,126,126,2,0,"C's",9
44,"44046",48,31,31,2,0,"C's",1
44,"44017",285,221,220,0,1,"C's",38
44,"44054",109,90,90,0,0,"C's",6
44,"44236",59,45,45,0,0,"C's",4
44,"44169",351,268,266,3,2,"C's",34
44,"44201",497,414,410,2,4,"C's",54
44,"44227",75,63,63,0,0,"C's",6
44,"44175",121,91,89,2,2,"C's",3
44,"44206",112,90,88,0,2,"C's",13
44,"44160",478,329,322,5,7,"C's",65
44,"44076",2234,1759,1729,16,30,"C's",209
44,"44225",111,76,76,4,0,"C's",15
44,"44215",156,105,103,2,2,"C's",18
44,"44121",60,43,43,0,0,"C's",3
44,"44184",48,30,30,0,0,"C's",2
44,"44005",54,38,37,2,1,"C's",8
44,"44089",46,42,42,0,0,"C's",9
44,"44203",10,8,8,0,0,"C's",0
44,"44176",160,127,127,0,0,"C's",5
44,"44129",41,34,34,0,0,"C's",4
44,"44105",80,62,62,0,0,"C's",7
44,"44018",20,20,20,0,0,"C's",0
44,"44052",80,55,54,0,1,"C's",2
44,"44172",310,216,216,6,0,"C's",12
44,"44256",39,34,34,1,0,"C's",8
44,"44221",365,298,296,2,2,"C's",29
44,"44268",28,24,24,0,0,"C's",2
44,"44217",28,20,20,0,0,"C's",2
44,"44014",2530,2008,1966,17,42,"C's",223
44,"44191",771,595,586,7,9,"C's",65
44,"44150",32,21,20,0,1,"C's",1
44,"44249",57,47,47,3,0,"C's",4
44,"44235",91,71,70,2,1,"C's",4
44,"44063",78,61,61,0,0,"C's",7
44,"44177",111,77,76,1,1,"C's",6
44,"44011",57,35,35,0,0,"C's",3
44,"44119",135,94,90,2,4,"C's",10
44,"44088",30,26,26,2,0,"C's",2
44,"44231",38,32,32,0,0,"C's",5
44,"44196",134,102,102,1,0,"C's",3
44,"44218",37,26,26,0,0,"C's",4
44,"44192",364,280,278,0,2,"C's",34
44,"44147",419,312,307,5,5,"C's",38
44,"44187",199,148,143,1,5,"C's",21
44,"44021",107,83,83,2,0,"C's",6
44,"44151",191,147,145,1,2,"C's",6
44,"44245",250,189,186,1,3,"C's",17
44,"44132",61,50,50,1,0,"C's",1
44,"44171",183,136,135,1,1,"C's",13
44,"44070",55,47,46,1,1,"C's",4
44,"44130",34,24,24,0,0,"C's",6
44,"44123",105,69,69,1,0,"C's",5
44,"44137",205,159,159,2,0,"C's",31
44,"44026",90,71,71,0,0,"C's",8
44,"44061",71,57,54,1,3,"C's",6
44,"44125",65,39,39,0,0,"C's",8
44,"44035",117,81,81,0,0,"C's",10
44,"44051",2704,2074,2046,32,28,"C's",268
44,"44246",1554,1091,1079,13,12,"C's",187
44,"44173",101,85,84,0,1,"C's",8
44,"44167",38,31,31,0,0,"C's",4
44,"44100",187,154,153,0,1,"C's",12
44,"44198",187,151,148,3,3,"C's",16
44,"44127",73,51,50,0,1,"C's",6
44,"44102",31,25,25,0,0,"C's",2
44,"44001",68,50,50,0,0,"C's",7
44,"44101",59,44,44,0,0,"C's",5
44,"44135",115,89,86,0,3,"C's",7
44,"44262",137,107,107,1,0,"C's",26
44,"44006",250,188,186,1,2,"C's",14
44,"44032",16,13,13,0,0,"C's",1
44,"44204",25,22,22,0,0,"C's",0
44,"44103",130,106,106,0,0,"C's",11
44,"44126",334,239,235,7,4,"C's",21
44,"44181",78,63,63,1,0,"C's",11
44,"44115",106,93,92,4,1,"C's",1
44,"44068",664,519,515,4,4,"C's",61
44,"44113",72,50,50,0,0,"C's",0
44,"44116",83,67,65,1,2,"C's",12
44,"44267",71,50,50,0,0,"C's",6
44,"44155",1102,831,825,7,6,"C's",57
44,"44138",140,79,77,0,2,"C's",10
44,"44029",567,475,467,5,8,"C's",47
44,"44178",56,42,42,0,0,"C's",9
44,"44174",430,314,313,2,1,"C's",69
44,"44199",43,36,36,1,0,"C's",8
44,"44060",40,35,35,1,0,"C's",4
44,"44075",324,256,250,4,6,"C's",32
44,"44145",1029,768,763,7,5,"C's",109
44,"44144",351,256,252,1,4,"C's",19
44,"44205",712,474,468,6,6,"C's",61
44,"44142",36,27,27,5,0,"C's",0
44,"44183",77,45,44,0,1,"C's",9
44,"44211",40,30,30,0,0,"C's",3
44,"44250",19,12,12,2,0,"C's",0
44,"44197",58,34,34,0,0,"C's",4
44,"44053",102,79,73,0,6,"C's",15
44,"44020",24,20,19,1,1,"C's",2
44,"44190",72,53,52,0,1,"C's",5
44,"44182",194,155,154,3,1,"C's",28
44,"44228",99,79,79,1,0,"C's",16
44,"44037",453,326,321,5,5,"C's",39
44,"44122",1356,971,969,12,2,"C's",145
44,"44263",369,265,259,2,6,"C's",37
44,"44043",108,75,75,1,0,"C's",18
44,"44111",92,69,69,0,0,"C's",11
44,"44133",23,17,17,0,0,"C's",5
44,"44156",46,33,32,1,1,"C's",2
44,"44252",85,67,66,0,1,"C's",7
44,"44257",167,120,120,1,0,"C's",17
44,"44047",221,139,135,0,4,"C's",7
44,"44241",537,408,403,2,5,"C's",65
44,"44224",22,14,14,0,0,"C's",1
44,"44124",78,58,58,1,0,"C's",8
44,"44099",708,514,510,1,4,"C's",34
44,"44179",345,229,227,2,2,"C's",18
11,"11037",5678,4491,4426,20,65,"PP",423
11,"11019",1830,1413,1371,5,42,"PP",431
11,"11001",4377,2949,2900,17,49,"PP",678
11,"11902",3619,2431,2410,17,21,"PP",815
11,"11008",17460,11800,11615,151,185,"PP",2880
11,"11030",22796,15377,15222,145,155,"PP",4706
11,"11029",5433,3112,3067,27,45,"PP",622
11,"11005",4560,3203,3143,21,60,"PP",645
11,"11020",165400,113865,113092,1184,773,"PP",32348
11,"11012",100460,72741,72128,590,613,"PP",21502
11,"11024",6735,5114,5065,33,49,"PP",1238
11,"11031",76452,51850,51456,568,394,"PP",14641
11,"11003",1270,907,899,12,8,"PP",273
11,"11036",694,439,437,13,2,"PP",149
11,"11011",1688,1239,1205,14,34,"PP",329
11,"11023",9354,6990,6928,86,62,"PP",1223
11,"11017",3207,2389,2362,28,27,"PP",500
11,"11015",62337,40342,40012,407,330,"PP",11508
11,"11026",4804,3581,3511,31,70,"PP",1113
11,"11035",13569,9000,8908,93,92,"PP",2666
11,"11042",1189,877,868,5,9,"PP",255
11,"11034",2345,1606,1594,10,12,"PP",317
11,"11010",6420,4423,4362,63,61,"PP",939
11,"11039",10044,6684,6623,98,61,"PP",2290
11,"11004",88617,55218,54733,581,485,"PP",16845
11,"11014",16791,11255,11146,166,109,"PP",3069
11,"11025",4370,3174,3123,29,51,"PP",554
11,"11027",68010,46675,46322,400,353,"PP",14909
11,"11032",53898,32432,32172,371,260,"PP",7775
11,"11901",5653,4132,4088,84,44,"PP",875
11,"11021",6777,4826,4779,52,47,"PP",1032
11,"11018",1485,1109,1090,10,19,"PP",418
11,"11041",9856,7043,6967,85,76,"PP",2167
11,"11038",13803,10593,10441,121,152,"PP",3474
11,"11006",24504,16649,16486,176,163,"PP",4210
11,"11022",48778,26546,26333,277,213,"PP",7200
11,"11007",18036,10832,10678,181,154,"PP",3303
11,"11040",398,326,317,3,9,"PP",67
11,"11009",602,426,422,5,4,"PP",160
11,"11016",14880,9945,9848,124,97,"PP",3209
11,"11028",32532,23191,22981,274,210,"PP",3229
11,"11033",20773,13487,13333,171,154,"PP",3528
11,"11002",4287,3245,3238,15,7,"PP",194
11,"11013",2324,1687,1653,16,34,"PP",345
23,"23034",2558,1987,1977,18,10,"PACMA",7
23,"23045",2139,1560,1551,9,9,"PACMA",6
23,"23025",2813,2186,2163,7,23,"PACMA",13
23,"23008",1518,1185,1173,18,12,"PACMA",7
23,"23075",3319,2640,2618,21,22,"PACMA",8
23,"23073",4558,3427,3402,11,25,"PACMA",13
23,"23072",2002,1593,1582,6,11,"PACMA",8
23,"23026",3636,2724,2685,11,39,"PACMA",6
23,"23021",528,452,448,0,4,"PACMA",1
23,"23047",1638,1311,1306,9,5,"PACMA",6
23,"23070",3931,2549,2533,11,16,"PACMA",8
23,"23050",91221,67753,67164,549,589,"PACMA",757
23,"23011",2193,1616,1600,11,16,"PACMA",6
23,"23032",575,461,457,1,4,"PACMA",2
23,"23024",12512,9391,9182,79,209,"PACMA",84
23,"23903",3550,2742,2721,19,21,"PACMA",4
23,"23049",1834,1384,1378,7,6,"PACMA",0
23,"23046",2405,1963,1934,3,29,"PACMA",7
23,"23038",3557,2851,2831,11,20,"PACMA",25
23,"23077",637,515,514,3,1,"PACMA",0
23,"23905",1861,1351,1345,7,6,"PACMA",1
23,"23031",751,662,650,9,12,"PACMA",5
23,"23084",953,711,708,6,3,"PACMA",0
23,"23086",11537,8362,8242,91,120,"PACMA",76
23,"23076",837,672,658,4,14,"PACMA",6
23,"23012",4177,3016,2988,22,28,"PACMA",7
23,"23007",3102,2381,2369,8,12,"PACMA",10
23,"23097",6445,4313,4290,30,23,"PACMA",21
23,"23044",4847,3801,3740,26,61,"PACMA",18
23,"23016",396,323,318,3,5,"PACMA",0
23,"23904",2852,1784,1764,14,20,"PACMA",0
23,"23063",3845,2934,2898,24,36,"PACMA",4
23,"23028",6203,4645,4585,33,60,"PACMA",22
23,"23043",549,401,400,0,1,"PACMA",1
23,"23018",2326,1678,1668,5,10,"PACMA",8
23,"23090",1316,1077,1071,8,6,"PACMA",4
23,"23054",382,276,275,0,1,"PACMA",1
23,"23098",875,728,722,2,6,"PACMA",0
23,"23066",4376,3530,3508,46,22,"PACMA",15
23,"23056",3108,2365,2343,14,22,"PACMA",12
23,"23088",6124,4764,4703,31,61,"PACMA",26
23,"23094",3852,3097,3061,17,36,"PACMA",13
23,"23058",8665,6651,6585,47,66,"PACMA",43
23,"23095",8737,6303,6268,34,35,"PACMA",44
23,"23020",1584,1376,1366,5,10,"PACMA",7
23,"23082",1924,1420,1413,6,7,"PACMA",1
23,"23080",1786,1347,1329,6,18,"PACMA",2
23,"23060",19157,13567,13438,133,129,"PACMA",83
23,"23091",742,609,607,5,2,"PACMA",1
23,"23079",3733,2994,2981,26,13,"PACMA",6
23,"23087",11313,8540,8454,64,86,"PACMA",63
23,"23002",17450,13199,12986,92,213,"PACMA",90
23,"23048",860,636,630,1,6,"PACMA",1
23,"23017",1584,1265,1253,4,12,"PACMA",4
23,"23033",1356,1080,1065,8,15,"PACMA",3
23,"23099",4734,3509,3459,23,50,"PACMA",22
23,"23901",1160,978,972,5,6,"PACMA",0
23,"23015",1393,1061,1052,3,9,"PACMA",5
23,"23041",504,396,392,1,4,"PACMA",1
23,"23069",5385,4406,4318,15,88,"PACMA",23
23,"23001",993,826,820,1,6,"PACMA",1
23,"23003",8709,6520,6440,42,80,"PACMA",26
23,"23065",1601,1222,1207,0,15,"PACMA",5
23,"23902",2327,1877,1857,9,20,"PACMA",4
23,"23062",1461,1188,1181,1,7,"PACMA",1
23,"23055",47421,33170,32908,213,262,"PACMA",245
23,"23061",7520,5481,5405,55,76,"PACMA",36
23,"23096",2643,2174,2140,14,34,"PACMA",5
23,"23040",1489,1226,1211,4,15,"PACMA",2
23,"23005",30539,21840,21629,176,211,"PACMA",177
23,"23037",516,427,423,1,4,"PACMA",2
23,"23092",27765,20688,20560,143,128,"PACMA",123
23,"23053",9526,6783,6736,49,47,"PACMA",25
23,"23101",388,281,279,0,2,"PACMA",0
23,"23006",4636,3761,3714,25,47,"PACMA",9
23,"23030",1232,1020,1007,10,13,"PACMA",2
23,"23039",2220,1658,1626,8,32,"PACMA",6
23,"23027",727,577,576,8,1,"PACMA",1
23,"23009",12866,9787,9667,64,120,"PACMA",55
23,"23052",1138,977,971,6,6,"PACMA",2
23,"23029",854,631,623,2,8,"PACMA",0
23,"23067",2489,1869,1847,18,22,"PACMA",5
23,"23085",2273,1833,1814,3,19,"PACMA",8
23,"23093",3257,2534,2506,21,28,"PACMA",6
23,"23019",1562,1249,1227,4,22,"PACMA",4
23,"23057",771,648,648,4,0,"PACMA",0
23,"23010",14371,10249,10140,65,109,"PACMA",93
23,"23074",3030,2368,2353,12,15,"PACMA",7
23,"23081",1546,1145,1132,6,13,"PACMA",4
23,"23071",1728,1337,1328,7,9,"PACMA",4
23,"23042",299,220,220,1,0,"PACMA",0
23,"23014",2561,1982,1959,8,23,"PACMA",15
23,"23059",5856,4498,4450,33,48,"PACMA",25
23,"23064",1659,1368,1364,1,4,"PACMA",3
23,"23051",2762,2258,2231,9,27,"PACMA",12
23,"23035",1095,871,867,8,4,"PACMA",3
23,"23004",435,350,346,0,4,"PACMA",3
46,"46123",1838,1466,1447,4,19,"PACMA",20
46,"46115",403,296,289,1,7,"PACMA",1
46,"46014",3042,2456,2434,17,22,"PACMA",22
46,"46186",19033,15061,14950,70,111,"PACMA",153
46,"46158",1024,817,804,5,13,"PACMA",2
46,"46029",20649,15241,15110,113,131,"PACMA",91
46,"46224",170,130,130,0,0,"PACMA",0
46,"46203",3598,2962,2928,17,34,"PACMA",17
46,"46249",9362,7163,7072,42,91,"PACMA",46
46,"46206",577,475,468,4,7,"PACMA",2
46,"46196",153,131,130,0,1,"PACMA",1
46,"46153",441,358,354,0,4,"PACMA",1
46,"46090",1640,1440,1424,4,16,"PACMA",7
46,"46229",972,785,774,2,11,"PACMA",3
46,"46223",7814,6169,6129,33,40,"PACMA",59
46,"46042",3389,2886,2844,19,42,"PACMA",11
46,"46110",21260,16194,16084,76,110,"PACMA",194
46,"46228",2363,1854,1839,16,15,"PACMA",17
46,"46109",6195,4764,4682,23,82,"PACMA",37
46,"46004",1924,1582,1559,11,23,"PACMA",23
46,"46061",337,281,281,3,0,"PACMA",2
46,"46062",4652,3650,3583,32,67,"PACMA",23
46,"46247",1024,743,733,2,10,"PACMA",8
46,"46233",3904,2974,2934,15,40,"PACMA",21
46,"46128",1601,1316,1281,5,35,"PACMA",7
46,"46244",58586,43371,43098,257,273,"PACMA",461
46,"46024",424,348,340,0,8,"PACMA",1
46,"46191",1970,1557,1533,6,24,"PACMA",10
46,"46130",907,722,713,6,9,"PACMA",4
46,"46100",289,240,237,1,3,"PACMA",5
46,"46089",2141,1649,1625,14,24,"PACMA",9
46,"46135",9655,7845,7810,32,35,"PACMA",64
46,"46019",8833,7183,7109,47,74,"PACMA",53
46,"46052",502,432,431,2,1,"PACMA",0
46,"46159",22905,17498,17373,102,125,"PACMA",187
46,"46234",354,289,287,2,2,"PACMA",1
46,"46072",3625,2993,2931,37,62,"PACMA",8
46,"46034",1776,1441,1430,4,11,"PACMA",19
46,"46239",451,353,351,3,2,"PACMA",2
46,"46114",575,488,484,3,4,"PACMA",4
46,"46018",635,531,522,3,9,"PACMA",3
46,"46165",7115,5626,5576,31,50,"PACMA",74
46,"46105",16249,11731,11629,59,102,"PACMA",73
46,"46121",105,92,91,2,1,"PACMA",0
46,"46201",67,49,49,0,0,"PACMA",1
46,"46258",2676,2099,2078,9,21,"PACMA",10
46,"46047",525,443,435,2,8,"PACMA",5
46,"46163",1847,1508,1489,8,19,"PACMA",8
46,"46131",49604,37767,37431,266,336,"PACMA",369
46,"46138",345,292,292,0,0,"PACMA",2
46,"46161",1481,1206,1194,6,12,"PACMA",15
46,"46006",4529,3803,3748,18,55,"PACMA",26
46,"46181",17066,12779,12636,96,143,"PACMA",117
46,"46044",4237,3347,3285,25,62,"PACMA",13
46,"46064",527,429,423,0,6,"PACMA",1
46,"46043",145,131,131,0,0,"PACMA",1
46,"46255",3145,2494,2470,19,24,"PACMA",22
46,"46235",21793,16577,16424,118,153,"PACMA",111
46,"46125",857,709,701,5,8,"PACMA",2
46,"46096",279,229,225,2,4,"PACMA",0
46,"46066",1255,1028,1020,6,8,"PACMA",14
46,"46136",2534,2008,1990,13,18,"PACMA",16
46,"46253",109,93,93,0,0,"PACMA",2
46,"46119",783,672,666,7,6,"PACMA",2
46,"46198",846,702,693,1,9,"PACMA",10
46,"46248",4873,3679,3639,18,40,"PACMA",18
46,"46205",14323,11325,11224,55,101,"PACMA",88
46,"46107",1915,1566,1553,2,13,"PACMA",21
46,"46038",345,255,255,0,0,"PACMA",2
46,"46170",3451,2821,2775,16,46,"PACMA",13
46,"46129",521,435,434,2,1,"PACMA",2
46,"46167",373,286,285,1,1,"PACMA",0
46,"46030",804,660,635,7,25,"PACMA",0
46,"46166",8155,6521,6450,41,71,"PACMA",40
46,"46263",255,204,202,1,2,"PACMA",2
46,"46143",4215,3219,3171,27,48,"PACMA",29
46,"46209",1955,1531,1508,7,23,"PACMA",17
46,"46001",802,623,615,4,8,"PACMA",1
46,"46168",1938,1542,1530,11,12,"PACMA",13
46,"46148",1528,1206,1192,15,14,"PACMA",7
46,"46005",22908,17565,17438,126,127,"PACMA",195
46,"46102",19843,15783,15676,102,107,"PACMA",208
46,"46076",587,489,483,2,6,"PACMA",3
46,"46046",896,697,686,1,11,"PACMA",2
46,"46059",1272,1066,1058,4,8,"PACMA",8
46,"46101",858,731,723,4,8,"PACMA",3
46,"46217",886,724,712,3,12,"PACMA",1
46,"46120",1109,919,902,4,17,"PACMA",6
46,"46176",2025,1431,1416,10,15,"PACMA",15
46,"46009",3144,2579,2552,13,27,"PACMA",23
46,"46155",1035,865,846,2,19,"PACMA",3
46,"46157",2978,2370,2343,19,27,"PACMA",15
46,"46262",232,172,168,0,4,"PACMA",0
46,"46041",331,254,253,6,1,"PACMA",0
46,"46083",15467,11584,11443,79,141,"PACMA",155
46,"46174",984,808,794,3,14,"PACMA",7
46,"46122",2701,2120,2109,18,11,"PACMA",17
46,"46187",1310,1036,1028,6,8,"PACMA",6
46,"46225",346,299,290,0,9,"PACMA",1
46,"46172",5040,3629,3599,14,30,"PACMA",58
46,"46077",7569,6100,6010,41,90,"PACMA",26
46,"46067",1736,1457,1382,2,75,"PACMA",6
46,"46039",2147,1746,1727,9,19,"PACMA",11
46,"46152",97,76,74,0,2,"PACMA",0
46,"46150",1839,1377,1362,10,15,"PACMA",7
46,"46197",1956,1556,1543,8,13,"PACMA",13
46,"46183",6009,4624,4563,18,61,"PACMA",41
46,"46078",28126,20975,20850,127,125,"PACMA",259
46,"46002",1175,947,935,5,12,"PACMA",5
46,"46055",1273,1031,1021,4,10,"PACMA",14
46,"46017",33050,24762,24580,144,182,"PACMA",296
46,"46057",495,339,337,6,2,"PACMA",1
46,"46220",48393,35859,35571,250,288,"PACMA",338
46,"46095",608,498,493,2,5,"PACMA",6
46,"46171",16587,12731,12627,79,104,"PACMA",154
46,"46214",15730,12427,12334,56,93,"PACMA",138
46,"46084",1576,1314,1298,6,16,"PACMA",19
46,"46243",141,122,120,0,2,"PACMA",1
46,"46016",1068,885,874,3,11,"PACMA",4
46,"46117",493,414,411,4,3,"PACMA",6
46,"46074",2690,2158,2145,18,13,"PACMA",23
46,"46069",161,126,122,0,4,"PACMA",2
46,"46088",176,140,138,0,2,"PACMA",1
46,"46144",665,525,520,2,5,"PACMA",0
46,"46091",115,101,100,1,1,"PACMA",2
46,"46219",125,106,105,2,1,"PACMA",0
46,"46204",6781,5421,5379,15,42,"PACMA",28
46,"46011",7627,5496,5407,39,89,"PACMA",71
46,"46216",5039,4207,4188,20,19,"PACMA",47
46,"46132",2148,1850,1830,12,20,"PACMA",8
46,"46162",1207,962,947,3,15,"PACMA",4
46,"46246",1066,856,838,7,18,"PACMA",3
46,"46048",3448,2817,2790,8,27,"PACMA",16
46,"46040",1098,914,907,4,7,"PACMA",4
46,"46139",4495,3629,3577,26,52,"PACMA",26
46,"46903",5985,4822,4796,24,26,"PACMA",66
46,"46184",26467,20888,20675,138,213,"PACMA",170
46,"46212",1612,1234,1214,5,20,"PACMA",10
46,"46177",4698,3715,3665,16,50,"PACMA",36
46,"46173",1336,1097,1080,9,17,"PACMA",7
46,"46085",11147,8107,8033,57,74,"PACMA",74
46,"46049",280,242,238,1,4,"PACMA",2
46,"46199",5742,4458,4425,34,33,"PACMA",36
46,"46082",4947,3843,3814,25,29,"PACMA",21
46,"46210",338,295,283,2,12,"PACMA",2
46,"46231",2411,1759,1735,11,24,"PACMA",12
46,"46116",13153,10566,10518,62,48,"PACMA",133
46,"46154",811,644,640,4,4,"PACMA",5
46,"46093",2117,1721,1710,10,11,"PACMA",8
46,"46141",438,359,348,4,11,"PACMA",1
46,"46012",888,723,703,3,20,"PACMA",6
46,"46063",1757,1399,1384,11,15,"PACMA",10
46,"46087",127,99,99,1,0,"PACMA",0
46,"46133",563,458,455,2,3,"PACMA",1
46,"46054",11251,8795,8731,46,64,"PACMA",89
46,"46013",17366,13952,13862,95,90,"PACMA",140
46,"46221",339,305,303,0,2,"PACMA",2
46,"46134",2357,1811,1797,8,14,"PACMA",19
46,"46213",15476,11377,11246,110,131,"PACMA",78
46,"46026",1204,1044,1034,4,10,"PACMA",3
46,"46035",6786,5382,5338,27,44,"PACMA",54
46,"46222",383,322,321,2,1,"PACMA",4
46,"46032",5635,4529,4493,16,36,"PACMA",46
46,"46081",10180,8055,7984,32,71,"PACMA",71
46,"46179",2182,1823,1788,13,35,"PACMA",9
46,"46211",1723,1441,1434,13,7,"PACMA",9
46,"46257",5579,4440,4391,26,49,"PACMA",49
46,"46092",273,183,183,0,0,"PACMA",4
46,"46097",959,734,728,6,6,"PACMA",7
46,"46071",466,383,379,2,4,"PACMA",0
46,"46180",682,581,572,1,9,"PACMA",11
46,"46245",516,427,420,3,7,"PACMA",7
46,"46037",1119,952,941,2,11,"PACMA",11
46,"46050",200,160,160,0,0,"PACMA",3
46,"46149",362,288,287,2,1,"PACMA",2
46,"46065",1588,1246,1227,5,19,"PACMA",6
46,"46020",3784,3064,3012,15,52,"PACMA",28
46,"46126",5555,4619,4574,26,45,"PACMA",38
46,"46241",400,324,314,1,10,"PACMA",5
46,"46182",1274,970,966,2,4,"PACMA",12
46,"46156",2087,1712,1702,9,10,"PACMA",10
46,"46145",21946,16629,16495,80,134,"PACMA",189
46,"46086",82,73,73,1,0,"PACMA",0
46,"46226",48,44,44,0,0,"PACMA",0
46,"46192",767,573,568,1,5,"PACMA",5
46,"46202",16767,13171,13058,59,113,"PACMA",139
46,"46902",379,314,313,3,1,"PACMA",1
46,"46237",7227,5620,5571,33,49,"PACMA",70
46,"46118",3795,2987,2962,18,25,"PACMA",14
46,"46188",668,548,538,3,10,"PACMA",7
46,"46207",6656,5355,5293,42,62,"PACMA",56
46,"46236",975,810,806,4,4,"PACMA",7
46,"46178",4643,3465,3434,16,31,"PACMA",36
46,"46028",395,346,339,2,7,"PACMA",1
46,"46250",578668,455375,452638,2701,2737,"PACMA",4826
46,"46025",2502,2008,1993,6,15,"PACMA",28
46,"46260",2572,2100,2081,10,19,"PACMA",17
46,"46230",13944,10746,10646,69,100,"PACMA",118
46,"46240",209,169,164,1,5,"PACMA",3
46,"46251",2490,2082,2045,11,37,"PACMA",18
46,"46027",948,795,781,3,14,"PACMA",9
46,"46060",9361,7285,7229,30,56,"PACMA",65
46,"46008",2673,2201,2189,8,12,"PACMA",14
46,"46045",1261,1066,1041,3,25,"PACMA",9
46,"46021",23646,18220,18100,85,120,"PACMA",183
46,"46218",1074,930,912,1,18,"PACMA",14
46,"46112",552,466,464,1,2,"PACMA",1
46,"46073",1097,903,892,6,11,"PACMA",5
46,"46259",503,410,406,2,4,"PACMA",2
46,"46003",963,841,815,1,26,"PACMA",6
46,"46127",2706,2212,2175,10,37,"PACMA",14
46,"46146",1670,1333,1318,11,15,"PACMA",17
46,"46254",1012,786,775,1,11,"PACMA",5
46,"46068",354,305,297,1,8,"PACMA",1
46,"46193",8795,7101,7061,40,40,"PACMA",81
46,"46215",1433,1152,1149,4,3,"PACMA",16
46,"46238",13324,10023,9939,50,84,"PACMA",88
46,"46140",349,288,284,2,4,"PACMA",1
46,"46200",1909,1628,1609,5,19,"PACMA",10
46,"46160",1912,1523,1514,3,9,"PACMA",11
46,"46142",797,619,608,2,11,"PACMA",1
46,"46053",560,454,451,2,3,"PACMA",5
46,"46058",1779,1430,1409,10,21,"PACMA",11
46,"46015",7231,5768,5711,33,57,"PACMA",38
46,"46103",1270,1015,998,8,17,"PACMA",1
46,"46256",6833,5087,5062,37,25,"PACMA",59
46,"46106",1543,1177,1167,5,10,"PACMA",8
46,"46098",2491,1978,1950,14,28,"PACMA",11
46,"46208",1114,931,922,3,9,"PACMA",5
46,"46023",328,294,287,2,7,"PACMA",8
46,"46175",459,403,396,1,7,"PACMA",1
46,"46124",788,680,672,0,8,"PACMA",3
46,"46010",914,725,716,4,9,"PACMA",5
46,"46137",268,225,220,3,5,"PACMA",3
46,"46056",184,160,158,1,2,"PACMA",0
46,"46031",10520,7830,7759,70,71,"PACMA",77
46,"46079",326,267,265,2,2,"PACMA",1
46,"46242",340,291,285,1,6,"PACMA",0
46,"46108",480,375,375,2,0,"PACMA",5
46,"46080",1025,795,784,4,11,"PACMA",0
46,"46022",15481,11422,11347,69,75,"PACMA",130
46,"46111",10876,8133,8050,35,83,"PACMA",65
46,"46051",8347,6500,6442,27,58,"PACMA",46
46,"46094",20515,15885,15785,125,100,"PACMA",198
46,"46195",1967,1612,1602,9,10,"PACMA",21
46,"46164",11777,8893,8798,54,95,"PACMA",76
46,"46904",802,662,654,7,8,"PACMA",5
46,"46099",922,693,685,0,8,"PACMA",7
46,"46232",894,715,712,5,3,"PACMA",3
46,"46033",197,169,168,1,1,"PACMA",2
46,"46036",583,384,381,8,3,"PACMA",0
46,"46169",32396,25109,24953,169,156,"PACMA",287
46,"46104",1956,1567,1543,6,24,"PACMA",13
46,"46147",16843,12206,12099,56,107,"PACMA",111
46,"46261",1720,1386,1369,10,17,"PACMA",7
46,"46075",149,132,130,2,2,"PACMA",0
46,"46194",15552,11606,11505,69,101,"PACMA",111
46,"46113",2436,1864,1849,11,15,"PACMA",16
46,"46007",11953,9099,9038,65,61,"PACMA",98
46,"46227",915,771,765,5,6,"PACMA",1
46,"46185",386,325,321,4,4,"PACMA",3
46,"46252",126,95,93,0,2,"PACMA",0
46,"46190",48824,36748,36542,238,206,"PACMA",385
46,"46070",16903,13091,12999,64,92,"PACMA",154
46,"46189",471,412,405,2,7,"PACMA",5
46,"46151",722,589,583,1,6,"PACMA",3
3,"3011",7729,5651,5595,29,56,"PSOE",1320
3,"3093",19661,15155,14988,84,167,"PSOE",3446
3,"3058",4947,4015,3978,21,37,"PSOE",741
3,"3127",352,279,277,1,2,"PSOE",94
3,"3014",237548,173040,172027,866,1013,"PSOE",32762
3,"3091",247,217,215,1,2,"PSOE",43
3,"3089",9599,7100,6980,39,120,"PSOE",1777
3,"3080",1299,1065,1036,3,29,"PSOE",182
3,"3028",1006,833,823,1,10,"PSOE",189
3,"3078",486,398,397,3,1,"PSOE",77
3,"3130",47,30,30,0,0,"PSOE",4
3,"3113",4254,3159,3120,17,39,"PSOE",1008
3,"3006",497,401,393,4,8,"PSOE",42
3,"3082",12542,8709,8597,48,112,"PSOE",1667
3,"3106",596,503,501,1,2,"PSOE",120
3,"3069",3060,2187,2168,9,19,"PSOE",414
3,"3026",1224,970,949,6,21,"PSOE",218
3,"3068",46,41,40,0,1,"PSOE",4
3,"3112",653,522,517,2,5,"PSOE",108
3,"3085",270,226,225,1,1,"PSOE",37
3,"3102",7271,5762,5687,46,75,"PSOE",1174
3,"3131",175,159,153,0,6,"PSOE",23
3,"3005",7753,6158,6118,38,40,"PSOE",1253
3,"3129",1187,991,984,8,7,"PSOE",130
3,"3024",3904,3109,3060,17,49,"PSOE",955
3,"3118",2452,1732,1714,9,18,"PSOE",286
3,"3088",5498,4078,4030,42,48,"PSOE",862
3,"3136",446,361,361,2,0,"PSOE",77
3,"3083",5607,4160,4106,36,54,"PSOE",1196
3,"3121",21269,14932,14795,78,137,"PSOE",2721
3,"3111",5411,4044,3967,14,77,"PSOE",883
3,"3074",1706,1400,1382,3,18,"PSOE",326
3,"3008",167,132,131,0,1,"PSOE",39
3,"3101",4765,3708,3659,13,49,"PSOE",636
3,"3036",91,80,79,2,1,"PSOE",8
3,"3076",8485,6251,6194,37,57,"PSOE",1560
3,"3139",22357,15787,15624,101,163,"PSOE",3516
3,"3135",214,176,174,0,2,"PSOE",69
3,"3004",585,455,454,1,1,"PSOE",113
3,"3114",1568,1216,1203,8,13,"PSOE",319
3,"3100",508,446,442,1,4,"PSOE",83
3,"3003",455,393,388,3,5,"PSOE",47
3,"3059",20538,15653,15522,79,131,"PSOE",2708
3,"3120",2416,1814,1783,13,31,"PSOE",434
3,"3116",1159,892,886,2,6,"PSOE",141
3,"3105",5387,4089,4017,21,72,"PSOE",839
3,"3097",990,817,811,8,6,"PSOE",145
3,"3137",653,516,515,5,1,"PSOE",104
3,"3051",350,310,305,1,5,"PSOE",74
3,"3086",153,134,134,1,0,"PSOE",27
3,"3012",1072,862,849,3,13,"PSOE",252
3,"3037",352,296,293,3,3,"PSOE",57
3,"3065",166944,126831,126024,773,807,"PSOE",27992
3,"3073",236,202,202,1,0,"PSOE",61
3,"3034",1367,1095,1079,4,16,"PSOE",247
3,"3081",1433,1130,1118,5,12,"PSOE",195
3,"3022",142,120,120,2,0,"PSOE",8
3,"3138",3154,2406,2378,10,28,"PSOE",510
3,"3124",469,400,394,5,6,"PSOE",82
3,"3035",663,543,538,1,5,"PSOE",138
3,"3902",10213,7091,6997,52,94,"PSOE",1530
3,"3098",507,403,394,3,9,"PSOE",133
3,"3119",16534,12466,12363,69,103,"PSOE",2323
3,"3018",12212,9129,9040,64,89,"PSOE",1869
3,"3090",17087,12723,12602,69,121,"PSOE",2539
3,"3092",6749,5398,5342,40,56,"PSOE",807
3,"3109",2850,2301,2275,11,26,"PSOE",786
3,"3133",41763,26236,26039,134,197,"PSOE",5362
3,"3094",9033,6702,6657,32,45,"PSOE",950
3,"3015",12544,9478,9388,58,90,"PSOE",2092
3,"3125",346,263,262,0,1,"PSOE",45
3,"3050",18601,13710,13610,61,100,"PSOE",2288
3,"3132",536,426,423,0,3,"PSOE",126
3,"3061",1057,828,816,2,12,"PSOE",148
3,"3029",242,186,183,1,3,"PSOE",48
3,"3002",3610,2714,2682,18,32,"PSOE",661
3,"3053",7196,5800,5736,37,64,"PSOE",826
3,"3047",9161,6622,6534,35,88,"PSOE",1391
3,"3062",213,176,175,0,1,"PSOE",32
3,"3027",159,135,132,0,3,"PSOE",33
3,"3038",358,292,285,2,7,"PSOE",67
3,"3075",156,139,139,0,0,"PSOE",12
3,"3095",4602,3628,3605,27,23,"PSOE",757
3,"3040",257,222,222,0,0,"PSOE",35
3,"3032",106,90,89,1,1,"PSOE",17
3,"3033",113,97,97,2,0,"PSOE",11
3,"3122",42227,31379,31186,160,193,"PSOE",6376
3,"3001",337,289,286,3,3,"PSOE",19
3,"3128",4097,2972,2942,12,30,"PSOE",432
3,"3079",18235,14578,14388,114,190,"PSOE",2853
3,"3007",168,142,138,0,4,"PSOE",23
3,"3044",4512,3639,3586,16,53,"PSOE",801
3,"3071",3980,3134,3106,28,28,"PSOE",502
3,"3021",5627,4691,4613,23,78,"PSOE",960
3,"3030",513,432,424,0,8,"PSOE",141
3,"3901",1129,855,853,5,2,"PSOE",151
3,"3016",94,79,79,0,0,"PSOE",19
3,"3043",2900,2516,2483,18,33,"PSOE",643
3,"3031",41486,28059,27851,152,208,"PSOE",6201
3,"3096",5811,4539,4492,19,47,"PSOE",904
3,"3057",191,148,148,2,0,"PSOE",26
3,"3099",42365,31612,31259,220,353,"PSOE",6018
3,"3020",102,79,79,0,0,"PSOE",18
3,"3064",5040,3887,3834,16,53,"PSOE",941
3,"3045",216,182,179,1,3,"PSOE",57
3,"3084",543,478,476,4,2,"PSOE",125
3,"3060",108,92,90,1,2,"PSOE",16
3,"3134",148,132,132,2,0,"PSOE",31
3,"3048",4858,3785,3735,25,50,"PSOE",676
3,"3039",85,61,59,0,2,"PSOE",10
3,"3023",1410,1221,1201,8,20,"PSOE",298
3,"3123",7472,5748,5680,38,68,"PSOE",1349
3,"3140",26176,19795,19509,155,286,"PSOE",3799
3,"3025",1270,1003,996,3,7,"PSOE",297
3,"3903",2482,1945,1926,16,19,"PSOE",551
3,"3063",26383,19376,19255,105,121,"PSOE",4226
3,"3107",2459,1807,1791,5,16,"PSOE",339
3,"3117",370,325,322,0,3,"PSOE",45
3,"3042",1367,1045,1033,5,12,"PSOE",167
3,"3052",969,804,794,6,10,"PSOE",141
3,"3010",325,278,276,0,2,"PSOE",55
3,"3103",278,240,237,1,3,"PSOE",59
3,"3054",338,274,268,4,6,"PSOE",93
3,"3013",1114,914,906,5,8,"PSOE",255
3,"3104",27134,21080,20902,156,178,"PSOE",4705
3,"3017",376,317,312,3,5,"PSOE",65
3,"3049",12082,9341,9236,69,105,"PSOE",2002
3,"3904",1393,1065,1057,8,8,"PSOE",338
3,"3055",5168,3949,3899,13,50,"PSOE",685
3,"3066",42291,31010,30781,190,229,"PSOE",7592
3,"3056",8737,6809,6731,33,78,"PSOE",1573
3,"3019",15261,11921,11804,98,117,"PSOE",2695
3,"3110",289,239,239,1,0,"PSOE",30
3,"3070",2038,1526,1499,5,27,"PSOE",358
3,"3077",1374,1139,1126,11,13,"PSOE",269
3,"3009",46817,36581,36258,240,323,"PSOE",7897
3,"3041",5945,4393,4344,28,49,"PSOE",760
3,"3072",351,288,287,2,1,"PSOE",62
3,"3115",248,219,219,2,0,"PSOE",44
3,"3067",98,82,81,1,1,"PSOE",17
3,"3046",1594,1185,1178,9,7,"PSOE",227
46,"46229",972,785,774,2,11,"C's",82
46,"46052",502,432,431,2,1,"C's",56
46,"46239",451,353,351,3,2,"C's",28
46,"46166",8155,6521,6450,41,71,"C's",944
46,"46003",963,841,815,1,26,"C's",73
46,"46105",16249,11731,11629,59,102,"C's",1449
46,"46004",1924,1582,1559,11,23,"C's",229
46,"46062",4652,3650,3583,32,67,"C's",380
46,"46089",2141,1649,1625,14,24,"C's",161
46,"46132",2148,1850,1830,12,20,"C's",190
46,"46158",1024,817,804,5,13,"C's",64
46,"46143",4215,3219,3171,27,48,"C's",308
46,"46161",1481,1206,1194,6,12,"C's",134
46,"46029",20649,15241,15110,113,131,"C's",2448
46,"46038",345,255,255,0,0,"C's",23
46,"46049",280,242,238,1,4,"C's",8
46,"46214",15730,12427,12334,56,93,"C's",2245
46,"46033",197,169,168,1,1,"C's",15
46,"46011",7627,5496,5407,39,89,"C's",811
46,"46009",3144,2579,2552,13,27,"C's",376
46,"46097",959,734,728,6,6,"C's",178
46,"46082",4947,3843,3814,25,29,"C's",692
46,"46085",11147,8107,8033,57,74,"C's",938
46,"46186",19033,15061,14950,70,111,"C's",2706
46,"46109",6195,4764,4682,23,82,"C's",600
46,"46115",403,296,289,1,7,"C's",25
46,"46041",331,254,253,6,1,"C's",32
46,"46054",11251,8795,8731,46,64,"C's",1163
46,"46129",521,435,434,2,1,"C's",30
46,"46084",1576,1314,1298,6,16,"C's",105
46,"46248",4873,3679,3639,18,40,"C's",484
46,"46142",797,619,608,2,11,"C's",66
46,"46134",2357,1811,1797,8,14,"C's",265
46,"46124",788,680,672,0,8,"C's",74
46,"46043",145,131,131,0,0,"C's",21
46,"46077",7569,6100,6010,41,90,"C's",497
46,"46258",2676,2099,2078,9,21,"C's",174
46,"46209",1955,1531,1508,7,23,"C's",152
46,"46157",2978,2370,2343,19,27,"C's",230
46,"46135",9655,7845,7810,32,35,"C's",1426
46,"46119",783,672,666,7,6,"C's",53
46,"46067",1736,1457,1382,2,75,"C's",225
46,"46175",459,403,396,1,7,"C's",28
46,"46137",268,225,220,3,5,"C's",19
46,"46014",3042,2456,2434,17,22,"C's",354
46,"46169",32396,25109,24953,169,156,"C's",3803
46,"46031",10520,7830,7759,70,71,"C's",916
46,"46173",1336,1097,1080,9,17,"C's",124
46,"46263",255,204,202,1,2,"C's",10
46,"46090",1640,1440,1424,4,16,"C's",131
46,"46191",1970,1557,1533,6,24,"C's",134
46,"46208",1114,931,922,3,9,"C's",75
46,"46092",273,183,183,0,0,"C's",10
46,"46243",141,122,120,0,2,"C's",11
46,"46218",1074,930,912,1,18,"C's",90
46,"46210",338,295,283,2,12,"C's",39
46,"46051",8347,6500,6442,27,58,"C's",935
46,"46053",560,454,451,2,3,"C's",41
46,"46079",326,267,265,2,2,"C's",19
46,"46222",383,322,321,2,1,"C's",33
46,"46125",857,709,701,5,8,"C's",56
46,"46081",10180,8055,7984,32,71,"C's",1168
46,"46249",9362,7163,7072,42,91,"C's",1103
46,"46120",1109,919,902,4,17,"C's",109
46,"46219",125,106,105,2,1,"C's",13
46,"46013",17366,13952,13862,95,90,"C's",2712
46,"46216",5039,4207,4188,20,19,"C's",858
46,"46253",109,93,93,0,0,"C's",13
46,"46107",1915,1566,1553,2,13,"C's",140
46,"46185",386,325,321,4,4,"C's",17
46,"46055",1273,1031,1021,4,10,"C's",158
46,"46144",665,525,520,2,5,"C's",54
46,"46147",16843,12206,12099,56,107,"C's",1670
46,"46093",2117,1721,1710,10,11,"C's",150
46,"46044",4237,3347,3285,25,62,"C's",484
46,"46163",1847,1508,1489,8,19,"C's",245
46,"46152",97,76,74,0,2,"C's",12
46,"46168",1938,1542,1530,11,12,"C's",217
46,"46172",5040,3629,3599,14,30,"C's",518
46,"46159",22905,17498,17373,102,125,"C's",2634
46,"46104",1956,1567,1543,6,24,"C's",100
46,"46167",373,286,285,1,1,"C's",16
46,"46207",6656,5355,5293,42,62,"C's",738
46,"46008",2673,2201,2189,8,12,"C's",183
46,"46141",438,359,348,4,11,"C's",21
46,"46184",26467,20888,20675,138,213,"C's",2786
46,"46095",608,498,493,2,5,"C's",76
46,"46244",58586,43371,43098,257,273,"C's",7428
46,"46110",21260,16194,16084,76,110,"C's",2277
46,"46205",14323,11325,11224,55,101,"C's",1834
46,"46130",907,722,713,6,9,"C's",56
46,"46196",153,131,130,0,1,"C's",14
46,"46213",15476,11377,11246,110,131,"C's",1911
46,"46026",1204,1044,1034,4,10,"C's",95
46,"46046",896,697,686,1,11,"C's",108
46,"46020",3784,3064,3012,15,52,"C's",278
46,"46903",5985,4822,4796,24,26,"C's",1251
46,"46190",48824,36748,36542,238,206,"C's",7102
46,"46111",10876,8133,8050,35,83,"C's",1457
46,"46257",5579,4440,4391,26,49,"C's",393
46,"46024",424,348,340,0,8,"C's",34
46,"46102",19843,15783,15676,102,107,"C's",1891
46,"46021",23646,18220,18100,85,120,"C's",2884
46,"46076",587,489,483,2,6,"C's",23
46,"46247",1024,743,733,2,10,"C's",80
46,"46078",28126,20975,20850,127,125,"C's",2984
46,"46902",379,314,313,3,1,"C's",63
46,"46091",115,101,100,1,1,"C's",16
46,"46025",2502,2008,1993,6,15,"C's",272
46,"46146",1670,1333,1318,11,15,"C's",164
46,"46232",894,715,712,5,3,"C's",66
46,"46138",345,292,292,0,0,"C's",29
46,"46006",4529,3803,3748,18,55,"C's",431
46,"46072",3625,2993,2931,37,62,"C's",349
46,"46047",525,443,435,2,8,"C's",38
46,"46016",1068,885,874,3,11,"C's",56
46,"46200",1909,1628,1609,5,19,"C's",163
46,"46069",161,126,122,0,4,"C's",9
46,"46170",3451,2821,2775,16,46,"C's",358
46,"46252",126,95,93,0,2,"C's",2
46,"46117",493,414,411,4,3,"C's",63
46,"46094",20515,15885,15785,125,100,"C's",2749
46,"46056",184,160,158,1,2,"C's",6
46,"46045",1261,1066,1041,3,25,"C's",89
46,"46171",16587,12731,12627,79,104,"C's",1845
46,"46019",8833,7183,7109,47,74,"C's",660
46,"46001",802,623,615,4,8,"C's",39
46,"46153",441,358,354,0,4,"C's",25
46,"46064",527,429,423,0,6,"C's",59
46,"46010",914,725,716,4,9,"C's",99
46,"46154",811,644,640,4,4,"C's",146
46,"46215",1433,1152,1149,4,3,"C's",70
46,"46236",975,810,806,4,4,"C's",64
46,"46156",2087,1712,1702,9,10,"C's",196
46,"46204",6781,5421,5379,15,42,"C's",829
46,"46116",13153,10566,10518,62,48,"C's",2019
46,"46112",552,466,464,1,2,"C's",36
46,"46206",577,475,468,4,7,"C's",47
46,"46211",1723,1441,1434,13,7,"C's",206
46,"46034",1776,1441,1430,4,11,"C's",205
46,"46057",495,339,337,6,2,"C's",25
46,"46005",22908,17565,17438,126,127,"C's",2675
46,"46183",6009,4624,4563,18,61,"C's",677
46,"46255",3145,2494,2470,19,24,"C's",272
46,"46096",279,229,225,2,4,"C's",27
46,"46101",858,731,723,4,8,"C's",55
46,"46122",2701,2120,2109,18,11,"C's",224
46,"46904",802,662,654,7,8,"C's",77
46,"46148",1528,1206,1192,15,14,"C's",226
46,"46234",354,289,287,2,2,"C's",27
46,"46181",17066,12779,12636,96,143,"C's",1706
46,"46086",82,73,73,1,0,"C's",1
46,"46226",48,44,44,0,0,"C's",2
46,"46262",232,172,168,0,4,"C's",28
46,"46042",3389,2886,2844,19,42,"C's",281
46,"46231",2411,1759,1735,11,24,"C's",119
46,"46195",1967,1612,1602,9,10,"C's",210
46,"46224",170,130,130,0,0,"C's",21
46,"46194",15552,11606,11505,69,101,"C's",1861
46,"46088",176,140,138,0,2,"C's",6
46,"46007",11953,9099,9038,65,61,"C's",1564
46,"46240",209,169,164,1,5,"C's",27
46,"46087",127,99,99,1,0,"C's",4
46,"46140",349,288,284,2,4,"C's",55
46,"46221",339,305,303,0,2,"C's",20
46,"46164",11777,8893,8798,54,95,"C's",1389
46,"46058",1779,1430,1409,10,21,"C's",131
46,"46201",67,49,49,0,0,"C's",3
46,"46002",1175,947,935,5,12,"C's",82
46,"46197",1956,1556,1543,8,13,"C's",159
46,"46246",1066,856,838,7,18,"C's",84
46,"46103",1270,1015,998,8,17,"C's",105
46,"46160",1912,1523,1514,3,9,"C's",119
46,"46176",2025,1431,1416,10,15,"C's",209
46,"46039",2147,1746,1727,9,19,"C's",182
46,"46114",575,488,484,3,4,"C's",64
46,"46238",13324,10023,9939,50,84,"C's",1100
46,"46250",578668,455375,452638,2701,2737,"C's",74505
46,"46260",2572,2100,2081,10,19,"C's",313
46,"46212",1612,1234,1214,5,20,"C's",119
46,"46193",8795,7101,7061,40,40,"C's",1130
46,"46151",722,589,583,1,6,"C's",70
46,"46199",5742,4458,4425,34,33,"C's",658
46,"46237",7227,5620,5571,33,49,"C's",910
46,"46100",289,240,237,1,3,"C's",24
46,"46220",48393,35859,35571,250,288,"C's",4797
46,"46040",1098,914,907,4,7,"C's",54
46,"46162",1207,962,947,3,15,"C's",77
46,"46145",21946,16629,16495,80,134,"C's",2319
46,"46133",563,458,455,2,3,"C's",24
46,"46241",400,324,314,1,10,"C's",41
46,"46177",4698,3715,3665,16,50,"C's",469
46,"46068",354,305,297,1,8,"C's",48
46,"46179",2182,1823,1788,13,35,"C's",205
46,"46012",888,723,703,3,20,"C's",114
46,"46030",804,660,635,7,25,"C's",51
46,"46063",1757,1399,1384,11,15,"C's",145
46,"46150",1839,1377,1362,10,15,"C's",92
46,"46198",846,702,693,1,9,"C's",56
46,"46188",668,548,538,3,10,"C's",67
46,"46245",516,427,420,3,7,"C's",40
46,"46074",2690,2158,2145,18,13,"C's",362
46,"46174",984,808,794,3,14,"C's",47
46,"46061",337,281,281,3,0,"C's",49
46,"46217",886,724,712,3,12,"C's",84
46,"46113",2436,1864,1849,11,15,"C's",267
46,"46060",9361,7285,7229,30,56,"C's",1059
46,"46242",340,291,285,1,6,"C's",39
46,"46050",200,160,160,0,0,"C's",16
46,"46230",13944,10746,10646,69,100,"C's",1608
46,"46059",1272,1066,1058,4,8,"C's",68
46,"46203",3598,2962,2928,17,34,"C's",343
46,"46048",3448,2817,2790,8,27,"C's",266
46,"46036",583,384,381,8,3,"C's",61
46,"46066",1255,1028,1020,6,8,"C's",142
46,"46182",1274,970,966,2,4,"C's",137
46,"46018",635,531,522,3,9,"C's",50
46,"46235",21793,16577,16424,118,153,"C's",1942
46,"46227",915,771,765,5,6,"C's",63
46,"46128",1601,1316,1281,5,35,"C's",143
46,"46080",1025,795,784,4,11,"C's",60
46,"46256",6833,5087,5062,37,25,"C's",659
46,"46017",33050,24762,24580,144,182,"C's",3793
46,"46225",346,299,290,0,9,"C's",24
46,"46106",1543,1177,1167,5,10,"C's",92
46,"46178",4643,3465,3434,16,31,"C's",713
46,"46202",16767,13171,13058,59,113,"C's",2628
46,"46126",5555,4619,4574,26,45,"C's",703
46,"46223",7814,6169,6129,33,40,"C's",951
46,"46131",49604,37767,37431,266,336,"C's",5316
46,"46098",2491,1978,1950,14,28,"C's",194
46,"46037",1119,952,941,2,11,"C's",89
46,"46165",7115,5626,5576,31,50,"C's",804
46,"46261",1720,1386,1369,10,17,"C's",125
46,"46121",105,92,91,2,1,"C's",9
46,"46027",948,795,781,3,14,"C's",91
46,"46099",922,693,685,0,8,"C's",74
46,"46015",7231,5768,5711,33,57,"C's",851
46,"46136",2534,2008,1990,13,18,"C's",258
46,"46127",2706,2212,2175,10,37,"C's",219
46,"46139",4495,3629,3577,26,52,"C's",414
46,"46028",395,346,339,2,7,"C's",39
46,"46228",2363,1854,1839,16,15,"C's",270
46,"46192",767,573,568,1,5,"C's",67
46,"46259",503,410,406,2,4,"C's",63
46,"46075",149,132,130,2,2,"C's",15
46,"46149",362,288,287,2,1,"C's",34
46,"46071",466,383,379,2,4,"C's",36
46,"46035",6786,5382,5338,27,44,"C's",734
46,"46032",5635,4529,4493,16,36,"C's",653
46,"46108",480,375,375,2,0,"C's",24
46,"46123",1838,1466,1447,4,19,"C's",180
46,"46180",682,581,572,1,9,"C's",64
46,"46023",328,294,287,2,7,"C's",25
46,"46022",15481,11422,11347,69,75,"C's",1613
46,"46254",1012,786,775,1,11,"C's",58
46,"46070",16903,13091,12999,64,92,"C's",2852
46,"46073",1097,903,892,6,11,"C's",76
46,"46155",1035,865,846,2,19,"C's",77
46,"46065",1588,1246,1227,5,19,"C's",179
46,"46189",471,412,405,2,7,"C's",30
46,"46233",3904,2974,2934,15,40,"C's",387
46,"46083",15467,11584,11443,79,141,"C's",1529
46,"46187",1310,1036,1028,6,8,"C's",102
46,"46251",2490,2082,2045,11,37,"C's",204
46,"46118",3795,2987,2962,18,25,"C's",281
23,"23074",3030,2368,2353,12,15,"C's",168
23,"23903",3550,2742,2721,19,21,"C's",208
23,"23055",47421,33170,32908,213,262,"C's",4440
23,"23048",860,636,630,1,6,"C's",54
23,"23047",1638,1311,1306,9,5,"C's",87
23,"23092",27765,20688,20560,143,128,"C's",2867
23,"23011",2193,1616,1600,11,16,"C's",131
23,"23014",2561,1982,1959,8,23,"C's",136
23,"23095",8737,6303,6268,34,35,"C's",471
23,"23067",2489,1869,1847,18,22,"C's",120
23,"23006",4636,3761,3714,25,47,"C's",254
23,"23029",854,631,623,2,8,"C's",25
23,"23046",2405,1963,1934,3,29,"C's",127
23,"23004",435,350,346,0,4,"C's",11
23,"23061",7520,5481,5405,55,76,"C's",469
23,"23005",30539,21840,21629,176,211,"C's",2721
23,"23030",1232,1020,1007,10,13,"C's",25
23,"23054",382,276,275,0,1,"C's",5
23,"23057",771,648,648,4,0,"C's",34
23,"23075",3319,2640,2618,21,22,"C's",193
23,"23018",2326,1678,1668,5,10,"C's",92
23,"23904",2852,1784,1764,14,20,"C's",132
23,"23901",1160,978,972,5,6,"C's",61
23,"23905",1861,1351,1345,7,6,"C's",123
23,"23084",953,711,708,6,3,"C's",35
23,"23026",3636,2724,2685,11,39,"C's",195
23,"23093",3257,2534,2506,21,28,"C's",162
23,"23098",875,728,722,2,6,"C's",25
23,"23002",17450,13199,12986,92,213,"C's",1610
23,"23060",19157,13567,13438,133,129,"C's",1601
23,"23020",1584,1376,1366,5,10,"C's",100
23,"23065",1601,1222,1207,0,15,"C's",104
23,"23052",1138,977,971,6,6,"C's",39
23,"23064",1659,1368,1364,1,4,"C's",59
23,"23050",91221,67753,67164,549,589,"C's",10068
23,"23096",2643,2174,2140,14,34,"C's",131
23,"23076",837,672,658,4,14,"C's",36
23,"23059",5856,4498,4450,33,48,"C's",542
23,"23021",528,452,448,0,4,"C's",25
23,"23090",1316,1077,1071,8,6,"C's",49
23,"23039",2220,1658,1626,8,32,"C's",127
23,"23024",12512,9391,9182,79,209,"C's",1028
23,"23072",2002,1593,1582,6,11,"C's",116
23,"23062",1461,1188,1181,1,7,"C's",51
23,"23056",3108,2365,2343,14,22,"C's",177
23,"23088",6124,4764,4703,31,61,"C's",326
23,"23080",1786,1347,1329,6,18,"C's",67
23,"23003",8709,6520,6440,42,80,"C's",473
23,"23012",4177,3016,2988,22,28,"C's",229
23,"23008",1518,1185,1173,18,12,"C's",58
23,"23077",637,515,514,3,1,"C's",21
23,"23094",3852,3097,3061,17,36,"C's",209
23,"23097",6445,4313,4290,30,23,"C's",493
23,"23049",1834,1384,1378,7,6,"C's",88
23,"23032",575,461,457,1,4,"C's",19
23,"23034",2558,1987,1977,18,10,"C's",115
23,"23016",396,323,318,3,5,"C's",15
23,"23058",8665,6651,6585,47,66,"C's",716
23,"23038",3557,2851,2831,11,20,"C's",401
23,"23079",3733,2994,2981,26,13,"C's",208
23,"23091",742,609,607,5,2,"C's",25
23,"23027",727,577,576,8,1,"C's",41
23,"23082",1924,1420,1413,6,7,"C's",94
23,"23015",1393,1061,1052,3,9,"C's",74
23,"23010",14371,10249,10140,65,109,"C's",1221
23,"23081",1546,1145,1132,6,13,"C's",97
23,"23001",993,826,820,1,6,"C's",42
23,"23040",1489,1226,1211,4,15,"C's",71
23,"23066",4376,3530,3508,46,22,"C's",325
23,"23041",504,396,392,1,4,"C's",32
23,"23017",1584,1265,1253,4,12,"C's",78
23,"23053",9526,6783,6736,49,47,"C's",252
23,"23086",11537,8362,8242,91,120,"C's",925
23,"23099",4734,3509,3459,23,50,"C's",309
23,"23071",1728,1337,1328,7,9,"C's",124
23,"23033",1356,1080,1065,8,15,"C's",97
23,"23031",751,662,650,9,12,"C's",33
23,"23009",12866,9787,9667,64,120,"C's",1177
23,"23069",5385,4406,4318,15,88,"C's",341
23,"23019",1562,1249,1227,4,22,"C's",82
23,"23070",3931,2549,2533,11,16,"C's",290
23,"23035",1095,871,867,8,4,"C's",48
23,"23025",2813,2186,2163,7,23,"C's",135
23,"23073",4558,3427,3402,11,25,"C's",257
23,"23063",3845,2934,2898,24,36,"C's",172
23,"23007",3102,2381,2369,8,12,"C's",170
23,"23037",516,427,423,1,4,"C's",22
23,"23085",2273,1833,1814,3,19,"C's",97
23,"23051",2762,2258,2231,9,27,"C's",137
23,"23087",11313,8540,8454,64,86,"C's",918
23,"23043",549,401,400,0,1,"C's",21
23,"23044",4847,3801,3740,26,61,"C's",310
23,"23042",299,220,220,1,0,"C's",13
23,"23101",388,281,279,0,2,"C's",14
23,"23045",2139,1560,1551,9,9,"C's",61
23,"23028",6203,4645,4585,33,60,"C's",443
23,"23902",2327,1877,1857,9,20,"C's",78
14,"14002",10951,8231,8150,72,81,"PSOE",3943
14,"14040",3792,3036,3010,23,26,"PSOE",612
14,"14009",2779,1941,1934,13,7,"PSOE",902
14,"14063",1065,803,797,4,6,"PSOE",346
14,"14001",3552,2861,2830,28,31,"PSOE",1191
14,"14015",2149,1637,1616,13,21,"PSOE",600
14,"14021",260189,188939,187558,1934,1381,"PSOE",39894
14,"14041",3180,2404,2373,26,31,"PSOE",675
14,"14044",1624,1285,1267,9,18,"PSOE",746
14,"14016",1364,1047,1045,3,2,"PSOE",509
14,"14006",1331,1166,1137,7,29,"PSOE",378
14,"14060",4854,3695,3633,43,62,"PSOE",1710
14,"14068",545,410,407,6,3,"PSOE",201
14,"14058",7973,5860,5791,49,69,"PSOE",2227
14,"14008",2871,2053,2034,11,19,"PSOE",973
14,"14048",1206,967,949,11,18,"PSOE",500
14,"14013",16845,12599,12414,146,185,"PSOE",3961
14,"14066",5890,4366,4322,29,44,"PSOE",1467
14,"14043",7574,5571,5510,46,61,"PSOE",2828
14,"14030",8580,6619,6542,66,77,"PSOE",2788
14,"14056",23613,17016,16804,128,212,"PSOE",7189
14,"14011",584,477,476,3,1,"PSOE",223
14,"14012",6190,4574,4488,27,86,"PSOE",2013
14,"14023",2041,1742,1717,13,25,"PSOE",683
14,"14014",2570,2104,2075,8,29,"PSOE",971
14,"14042",18921,14842,14653,184,189,"PSOE",4658
14,"14049",16357,12206,12029,127,177,"PSOE",4605
14,"14062",1052,813,801,4,12,"PSOE",375
14,"14036",3767,2911,2857,53,54,"PSOE",1392
14,"14026",2073,1437,1421,13,16,"PSOE",667
14,"14017",10869,8130,8029,72,101,"PSOE",3772
14,"14061",756,606,592,2,14,"PSOE",306
14,"14065",1861,1461,1446,12,15,"PSOE",528
14,"14032",425,347,335,3,12,"PSOE",158
14,"14033",1285,980,963,11,17,"PSOE",475
14,"14031",597,490,484,0,6,"PSOE",236
14,"14059",699,559,552,5,7,"PSOE",227
14,"14004",2036,1502,1488,6,14,"PSOE",654
14,"14067",3874,3033,2986,29,47,"PSOE",1101
14,"14020",391,278,274,3,4,"PSOE",134
14,"14073",2900,2068,2041,15,27,"PSOE",1029
14,"14051",1401,1095,1077,5,18,"PSOE",497
14,"14072",1079,834,830,5,4,"PSOE",425
14,"14052",9447,6250,6201,49,49,"PSOE",2418
14,"14025",2950,2460,2425,10,35,"PSOE",925
14,"14075",581,463,446,6,17,"PSOE",243
14,"14028",320,246,244,2,2,"PSOE",130
14,"14039",2628,2151,2123,11,28,"PSOE",1039
14,"14007",15200,11064,10926,81,138,"PSOE",4614
14,"14022",4036,3199,3169,9,30,"PSOE",1282
14,"14005",6358,4379,4272,56,107,"PSOE",1460
14,"14069",7536,5574,5495,48,79,"PSOE",2558
14,"14057",6152,4973,4903,56,70,"PSOE",1603
14,"14071",937,651,642,2,9,"PSOE",346
14,"14035",5992,4475,4437,44,38,"PSOE",1769
14,"14053",6050,4498,4427,56,71,"PSOE",1740
14,"14027",7908,6085,6008,57,77,"PSOE",2000
14,"14029",4206,3170,3135,32,35,"PSOE",1435
14,"14045",3055,2486,2451,13,35,"PSOE",1385
14,"14019",6479,5131,5076,46,55,"PSOE",1984
14,"14054",13665,10923,10678,103,245,"PSOE",3779
14,"14064",331,252,244,2,8,"PSOE",122
14,"14047",1654,1221,1211,17,10,"PSOE",497
14,"14024",1920,1522,1488,10,34,"PSOE",718
14,"14070",1343,1026,1008,9,18,"PSOE",389
14,"14037",3344,2476,2442,20,34,"PSOE",1176
14,"14074",2303,1940,1929,13,11,"PSOE",956
14,"14003",1265,981,970,6,11,"PSOE",481
14,"14038",32236,22982,22773,209,209,"PSOE",7041
14,"14034",318,260,252,2,8,"PSOE",98
14,"14055",18572,13587,13410,167,177,"PSOE",4419
14,"14050",2399,1886,1864,11,22,"PSOE",567
14,"14018",3710,2882,2846,28,36,"PSOE",1027
14,"14046",4484,3540,3487,22,53,"PSOE",1158
14,"14010",4051,3003,2968,17,35,"PSOE",1500
39,"39066",868,697,688,7,9,"PP",227
39,"39074",6905,5370,5288,52,82,"PP",2313
39,"39062",1824,1400,1392,14,8,"PP",728
39,"39006",1728,1353,1337,12,16,"PP",691
39,"39101",292,206,202,2,4,"PP",40
39,"39048",1697,1372,1361,10,11,"PP",579
39,"39044",3833,2889,2860,26,29,"PP",988
39,"39013",515,378,375,1,3,"PP",234
39,"39021",495,399,391,4,8,"PP",199
39,"39045",376,284,276,1,8,"PP",144
39,"39034",286,180,179,4,1,"PP",99
39,"39075",137597,102862,102053,819,809,"PP",39839
39,"39039",572,397,396,1,1,"PP",204
39,"39008",13932,10600,10506,92,94,"PP",3212
39,"39072",343,213,213,1,0,"PP",146
39,"39035",9587,7315,7214,56,101,"PP",2648
39,"39068",659,486,479,2,7,"PP",184
39,"39087",42262,32560,32124,234,436,"PP",9706
39,"39027",3139,2493,2439,30,54,"PP",1008
39,"39009",3223,2395,2370,22,25,"PP",959
39,"39088",71,51,51,0,0,"PP",11
39,"39007",434,298,297,1,1,"PP",138
39,"39043",1468,1167,1151,10,16,"PP",601
39,"39077",246,186,182,0,4,"PP",88
39,"39005",1396,1089,1084,4,5,"PP",501
39,"39055",1118,838,826,6,12,"PP",448
39,"39004",1539,1177,1160,12,17,"PP",461
39,"39078",1413,1045,1032,10,13,"PP",394
39,"39053",219,135,135,1,0,"PP",67
39,"39069",1968,1586,1555,12,31,"PP",466
39,"39097",713,409,400,10,9,"PP",207
39,"39102",2281,1647,1631,13,16,"PP",714
39,"39020",23612,16515,16334,125,181,"PP",4091
39,"39098",1422,1078,1074,11,4,"PP",581
39,"39046",1402,1015,985,11,30,"PP",300
39,"39061",3488,2746,2722,29,24,"PP",1265
39,"39065",256,202,200,6,2,"PP",74
39,"39058",831,594,592,6,2,"PP",179
39,"39041",1764,1416,1395,10,21,"PP",518
39,"39051",67,62,61,1,1,"PP",24
39,"39091",1947,1572,1552,9,20,"PP",772
39,"39081",435,349,342,3,7,"PP",232
39,"39070",146,111,109,3,2,"PP",47
39,"39012",6693,5213,5131,44,82,"PP",1642
39,"39073",9806,7636,7574,42,62,"PP",2653
39,"39082",1658,1212,1202,15,10,"PP",677
39,"39014",898,655,644,8,11,"PP",235
39,"39030",1894,1314,1290,9,24,"PP",479
39,"39011",1602,1211,1202,13,9,"PP",617
39,"39083",1139,747,739,6,8,"PP",283
39,"39079",8951,6734,6657,54,77,"PP",2762
39,"39028",3733,2918,2877,17,41,"PP",1142
39,"39042",5968,4614,4572,33,42,"PP",1927
39,"39099",3117,2446,2406,23,40,"PP",884
39,"39063",973,725,720,7,5,"PP",328
39,"39031",1235,873,863,5,10,"PP",418
39,"39064",1349,1036,1016,6,20,"PP",494
39,"39054",4472,3478,3441,45,37,"PP",1011
39,"39017",571,385,377,2,8,"PP",228
39,"39036",983,774,770,8,4,"PP",322
39,"39076",3491,2696,2662,24,34,"PP",949
39,"39016",23860,18608,18405,149,203,"PP",6274
39,"39086",357,260,258,1,2,"PP",116
39,"39003",299,219,217,0,2,"PP",92
39,"39090",756,564,550,4,14,"PP",220
39,"39010",639,509,505,5,4,"PP",188
39,"39032",1476,1117,1100,8,17,"PP",578
39,"39040",4290,3337,3309,22,28,"PP",1334
39,"39023",6316,4900,4827,37,73,"PP",1496
39,"39026",1751,1303,1295,9,8,"PP",614
39,"39092",916,668,663,4,5,"PP",292
39,"39015",862,650,643,6,7,"PP",360
39,"39071",405,277,272,2,5,"PP",184
39,"39047",1978,1463,1448,15,15,"PP",579
39,"39018",4211,3389,3329,27,60,"PP",803
39,"39038",1463,1039,1030,6,9,"PP",374
39,"39019",2098,1669,1646,24,23,"PP",580
39,"39052",18086,14014,13852,124,162,"PP",4920
39,"39080",3552,2734,2701,17,33,"PP",1104
39,"39022",987,735,730,7,5,"PP",394
39,"39001",2127,1651,1631,17,20,"PP",669
39,"39025",8693,6696,6583,58,113,"PP",2138
39,"39085",6834,5319,5265,37,54,"PP",1844
39,"39100",869,628,617,12,11,"PP",313
39,"39057",2321,1773,1746,13,27,"PP",631
39,"39096",702,477,474,3,3,"PP",247
39,"39094",854,644,637,9,7,"PP",294
39,"39002",3313,2430,2391,17,39,"PP",831
39,"39049",330,251,248,1,3,"PP",103
39,"39024",1882,1452,1438,14,14,"PP",516
39,"39059",8057,6049,5972,50,77,"PP",2444
39,"39095",2268,1812,1789,9,23,"PP",603
39,"39067",813,569,561,5,8,"PP",254
39,"39060",6705,5437,5339,46,98,"PP",1655
39,"39037",2003,1570,1547,8,23,"PP",730
39,"39084",843,608,604,5,4,"PP",364
39,"39050",276,173,170,0,3,"PP",92
39,"39093",307,232,232,1,0,"PP",99
39,"39029",624,507,503,4,4,"PP",245
39,"39033",578,432,432,5,0,"PP",141
39,"39089",149,104,103,1,1,"PP",54
39,"39056",2326,1805,1775,17,30,"PP",705
39,"39062",1824,1400,1392,14,8,"PSOE",207
39,"39023",6316,4900,4827,37,73,"PSOE",1585
39,"39042",5968,4614,4572,33,42,"PSOE",917
39,"39036",983,774,770,8,4,"PSOE",170
39,"39011",1602,1211,1202,13,9,"PSOE",167
39,"39043",1468,1167,1151,10,16,"PSOE",161
39,"39046",1402,1015,985,11,30,"PSOE",340
39,"39021",495,399,391,4,8,"PSOE",104
39,"39014",898,655,644,8,11,"PSOE",161
39,"39004",1539,1177,1160,12,17,"PSOE",342
39,"39007",434,298,297,1,1,"PSOE",70
39,"39006",1728,1353,1337,12,16,"PSOE",245
39,"39055",1118,838,826,6,12,"PSOE",125
39,"39073",9806,7636,7574,42,62,"PSOE",1355
39,"39059",8057,6049,5972,50,77,"PSOE",1477
39,"39072",343,213,213,1,0,"PSOE",27
39,"39090",756,564,550,4,14,"PSOE",102
39,"39054",4472,3478,3441,45,37,"PSOE",866
39,"39024",1882,1452,1438,14,14,"PSOE",369
39,"39100",869,628,617,12,11,"PSOE",117
39,"39010",639,509,505,5,4,"PSOE",167
39,"39016",23860,18608,18405,149,203,"PSOE",4168
39,"39089",149,104,103,1,1,"PSOE",22
39,"39066",868,697,688,7,9,"PSOE",185
39,"39034",286,180,179,4,1,"PSOE",47
39,"39044",3833,2889,2860,26,29,"PSOE",619
39,"39020",23612,16515,16334,125,181,"PSOE",3749
39,"39041",1764,1416,1395,10,21,"PSOE",342
39,"39063",973,725,720,7,5,"PSOE",178
39,"39051",67,62,61,1,1,"PSOE",13
39,"39069",1968,1586,1555,12,31,"PSOE",477
39,"39082",1658,1212,1202,15,10,"PSOE",208
39,"39102",2281,1647,1631,13,16,"PSOE",370
39,"39015",862,650,643,6,7,"PSOE",119
39,"39057",2321,1773,1746,13,27,"PSOE",465
39,"39068",659,486,479,2,7,"PSOE",108
39,"39078",1413,1045,1032,10,13,"PSOE",263
39,"39008",13932,10600,10506,92,94,"PSOE",2556
39,"39084",843,608,604,5,4,"PSOE",95
39,"39085",6834,5319,5265,37,54,"PSOE",1246
39,"39040",4290,3337,3309,22,28,"PSOE",692
39,"39060",6705,5437,5339,46,98,"PSOE",1367
39,"39038",1463,1039,1030,6,9,"PSOE",246
39,"39033",578,432,432,5,0,"PSOE",156
39,"39095",2268,1812,1789,9,23,"PSOE",589
39,"39009",3223,2395,2370,22,25,"PSOE",523
39,"39053",219,135,135,1,0,"PSOE",36
39,"39018",4211,3389,3329,27,60,"PSOE",951
39,"39096",702,477,474,3,3,"PSOE",116
39,"39067",813,569,561,5,8,"PSOE",168
39,"39048",1697,1372,1361,10,11,"PSOE",248
39,"39075",137597,102862,102053,819,809,"PSOE",19893
39,"39056",2326,1805,1775,17,30,"PSOE",391
39,"39001",2127,1651,1631,17,20,"PSOE",310
39,"39028",3733,2918,2877,17,41,"PSOE",471
39,"39029",624,507,503,4,4,"PSOE",74
39,"39002",3313,2430,2391,17,39,"PSOE",742
39,"39079",8951,6734,6657,54,77,"PSOE",1857
39,"39017",571,385,377,2,8,"PSOE",62
39,"39035",9587,7315,7214,56,101,"PSOE",1838
39,"39080",3552,2734,2701,17,33,"PSOE",671
39,"39005",1396,1089,1084,4,5,"PSOE",204
39,"39031",1235,873,863,5,10,"PSOE",159
39,"39037",2003,1570,1547,8,23,"PSOE",321
39,"39026",1751,1303,1295,9,8,"PSOE",270
39,"39074",6905,5370,5288,52,82,"PSOE",928
39,"39064",1349,1036,1016,6,20,"PSOE",231
39,"39093",307,232,232,1,0,"PSOE",49
39,"39092",916,668,663,4,5,"PSOE",208
39,"39098",1422,1078,1074,11,4,"PSOE",182
39,"39081",435,349,342,3,7,"PSOE",47
39,"39065",256,202,200,6,2,"PSOE",50
39,"39088",71,51,51,0,0,"PSOE",25
39,"39052",18086,14014,13852,124,162,"PSOE",2350
39,"39094",854,644,637,9,7,"PSOE",134
39,"39087",42262,32560,32124,234,436,"PSOE",9064
39,"39097",713,409,400,10,9,"PSOE",104
39,"39013",515,378,375,1,3,"PSOE",69
39,"39047",1978,1463,1448,15,15,"PSOE",299
39,"39058",831,594,592,6,2,"PSOE",234
39,"39076",3491,2696,2662,24,34,"PSOE",684
39,"39049",330,251,248,1,3,"PSOE",86
39,"39071",405,277,272,2,5,"PSOE",50
39,"39019",2098,1669,1646,24,23,"PSOE",344
39,"39027",3139,2493,2439,30,54,"PSOE",540
39,"39099",3117,2446,2406,23,40,"PSOE",578
39,"39083",1139,747,739,6,8,"PSOE",241
39,"39077",246,186,182,0,4,"PSOE",60
39,"39012",6693,5213,5131,44,82,"PSOE",1229
39,"39101",292,206,202,2,4,"PSOE",94
39,"39022",987,735,730,7,5,"PSOE",135
39,"39032",1476,1117,1100,8,17,"PSOE",244
39,"39039",572,397,396,1,1,"PSOE",105
39,"39070",146,111,109,3,2,"PSOE",21
39,"39091",1947,1572,1552,9,20,"PSOE",352
39,"39025",8693,6696,6583,58,113,"PSOE",2016
39,"39086",357,260,258,1,2,"PSOE",65
39,"39045",376,284,276,1,8,"PSOE",61
39,"39003",299,219,217,0,2,"PSOE",73
39,"39061",3488,2746,2722,29,24,"PSOE",333
39,"39050",276,173,170,0,3,"PSOE",31
39,"39030",1894,1314,1290,9,24,"PSOE",242
14,"14005",6358,4379,4272,56,107,"C´s",383
14,"14002",10951,8231,8150,72,81,"C´s",595
14,"14023",2041,1742,1717,13,25,"C´s",140
14,"14003",1265,981,970,6,11,"C´s",83
14,"14042",18921,14842,14653,184,189,"C´s",1782
14,"14056",23613,17016,16804,128,212,"C´s",1930
14,"14047",1654,1221,1211,17,10,"C´s",192
14,"14031",597,490,484,0,6,"C´s",38
14,"14036",3767,2911,2857,53,54,"C´s",227
14,"14026",2073,1437,1421,13,16,"C´s",139
14,"14074",2303,1940,1929,13,11,"C´s",128
14,"14033",1285,980,963,11,17,"C´s",96
14,"14021",260189,188939,187558,1934,1381,"C´s",27691
14,"14061",756,606,592,2,14,"C´s",33
14,"14041",3180,2404,2373,26,31,"C´s",179
14,"14043",7574,5571,5510,46,61,"C´s",480
14,"14007",15200,11064,10926,81,138,"C´s",1219
14,"14060",4854,3695,3633,43,62,"C´s",293
14,"14066",5890,4366,4322,29,44,"C´s",462
14,"14016",1364,1047,1045,3,2,"C´s",45
14,"14035",5992,4475,4437,44,38,"C´s",334
14,"14030",8580,6619,6542,66,77,"C´s",589
14,"14004",2036,1502,1488,6,14,"C´s",119
14,"14040",3792,3036,3010,23,26,"C´s",247
14,"14011",584,477,476,3,1,"C´s",27
14,"14045",3055,2486,2451,13,35,"C´s",207
14,"14013",16845,12599,12414,146,185,"C´s",1475
14,"14057",6152,4973,4903,56,70,"C´s",460
14,"14017",10869,8130,8029,72,101,"C´s",811
14,"14067",3874,3033,2986,29,47,"C´s",311
14,"14065",1861,1461,1446,12,15,"C´s",163
14,"14024",1920,1522,1488,10,34,"C´s",124
14,"14018",3710,2882,2846,28,36,"C´s",258
14,"14051",1401,1095,1077,5,18,"C´s",70
14,"14052",9447,6250,6201,49,49,"C´s",616
14,"14010",4051,3003,2968,17,35,"C´s",208
14,"14055",18572,13587,13410,167,177,"C´s",1841
14,"14049",16357,12206,12029,127,177,"C´s",1235
14,"14064",331,252,244,2,8,"C´s",17
14,"14025",2950,2460,2425,10,35,"C´s",120
14,"14054",13665,10923,10678,103,245,"C´s",1379
14,"14059",699,559,552,5,7,"C´s",60
14,"14062",1052,813,801,4,12,"C´s",53
14,"14053",6050,4498,4427,56,71,"C´s",421
14,"14044",1624,1285,1267,9,18,"C´s",105
14,"14001",3552,2861,2830,28,31,"C´s",156
14,"14046",4484,3540,3487,22,53,"C´s",146
14,"14063",1065,803,797,4,6,"C´s",57
14,"14028",320,246,244,2,2,"C´s",9
14,"14072",1079,834,830,5,4,"C´s",62
14,"14006",1331,1166,1137,7,29,"C´s",122
14,"14070",1343,1026,1008,9,18,"C´s",75
14,"14015",2149,1637,1616,13,21,"C´s",166
14,"14022",4036,3199,3169,9,30,"C´s",170
14,"14027",7908,6085,6008,57,77,"C´s",476
14,"14075",581,463,446,6,17,"C´s",21
14,"14032",425,347,335,3,12,"C´s",25
14,"14071",937,651,642,2,9,"C´s",39
14,"14068",545,410,407,6,3,"C´s",37
14,"14034",318,260,252,2,8,"C´s",20
14,"14020",391,278,274,3,4,"C´s",13
14,"14012",6190,4574,4488,27,86,"C´s",273
14,"14069",7536,5574,5495,48,79,"C´s",454
14,"14029",4206,3170,3135,32,35,"C´s",246
14,"14039",2628,2151,2123,11,28,"C´s",174
14,"14048",1206,967,949,11,18,"C´s",62
14,"14058",7973,5860,5791,49,69,"C´s",725
14,"14073",2900,2068,2041,15,27,"C´s",167
14,"14050",2399,1886,1864,11,22,"C´s",114
14,"14008",2871,2053,2034,11,19,"C´s",127
14,"14009",2779,1941,1934,13,7,"C´s",154
14,"14037",3344,2476,2442,20,34,"C´s",221
14,"14038",32236,22982,22773,209,209,"C´s",3446
14,"14014",2570,2104,2075,8,29,"C´s",129
14,"14019",6479,5131,5076,46,55,"C´s",384
41,"41073",1715,1194,1169,9,25,"C´s",123
41,"41008",1063,820,805,3,15,"C´s",49
41,"41091",541928,401177,398212,3487,2965,"C´s",55276
41,"41043",636,439,435,3,4,"C´s",27
41,"41059",33977,26158,25965,230,193,"C´s",4709
41,"41010",4394,3203,3160,19,43,"C´s",444
41,"41022",4300,2918,2891,30,27,"C´s",206
41,"41076",2184,1442,1432,19,10,"C´s",64
41,"41049",9301,7147,7070,63,77,"C´s",665
41,"41033",5102,3655,3613,25,42,"C´s",402
41,"41058",17304,12982,12751,133,231,"C´s",1731
41,"41054",688,587,570,2,17,"C´s",72
41,"41077",8728,6423,6308,28,115,"C´s",612
41,"41903",6747,4926,4854,43,72,"C´s",536
41,"41002",1469,1085,1061,12,24,"C´s",62
41,"41047",10086,7758,7663,80,95,"C´s",1347
41,"41086",16102,10743,10665,93,78,"C´s",1449
41,"41048",2244,1625,1598,22,27,"C´s",138
41,"41097",3135,2339,2317,19,22,"C´s",166
41,"41023",7919,5852,5788,34,64,"C´s",517
41,"41067",7115,5248,5178,46,70,"C´s",478
41,"41070",6021,4504,4456,44,48,"C´s",860
41,"41055",15009,10393,10292,82,101,"C´s",1052
41,"41068",13948,10269,10150,75,119,"C´s",964
41,"41046",3017,2416,2381,12,35,"C´s",178
41,"41050",5158,4123,4078,37,45,"C´s",416
41,"41007",12386,8552,8403,90,149,"C´s",857
41,"41005",9057,6781,6693,58,88,"C´s",800
41,"41093",18487,14687,14594,117,93,"C´s",2842
41,"41003",2319,1782,1754,8,28,"C´s",152
41,"41092",7749,5715,5647,57,68,"C´s",492
41,"41062",2235,1805,1790,10,15,"C´s",61
41,"41040",10411,7959,7892,53,67,"C´s",1705
41,"41060",15279,10611,10447,91,164,"C´s",1301
41,"41090",3541,2774,2721,17,53,"C´s",237
41,"41028",1971,1574,1562,11,12,"C´s",283
41,"41080",1270,954,938,8,16,"C´s",71
41,"41069",29070,20827,20558,355,269,"C´s",2628
41,"41020",12872,8820,8723,92,97,"C´s",608
41,"41061",2218,1769,1742,5,27,"C´s",54
41,"41066",1363,1019,1007,7,12,"C´s",56
41,"41035",1112,887,876,5,11,"C´s",54
41,"41036",3971,2846,2806,14,40,"C´s",173
41,"41045",5749,4121,4066,49,55,"C´s",431
41,"41063",2683,1942,1922,21,20,"C´s",130
41,"41017",15052,11074,10964,99,110,"C´s",2092
41,"41089",6504,4759,4691,51,68,"C´s",602
41,"41087",10202,7160,7033,51,127,"C´s",988
41,"41001",1597,1262,1248,5,14,"C´s",113
41,"41053",21252,16022,15770,121,252,"C´s",2182
41,"41100",1025,770,751,5,19,"C´s",44
41,"41074",3033,2362,2341,8,21,"C´s",132
41,"41039",31674,23240,22982,196,258,"C´s",3317
41,"41026",4325,3551,3516,18,35,"C´s",209
41,"41009",1229,811,803,5,8,"C´s",72
41,"41034",23033,15936,15711,189,225,"C´s",1874
41,"41096",6166,4811,4752,39,59,"C´s",749
41,"41078",2522,1888,1874,5,14,"C´s",87
41,"41018",9490,6997,6930,45,67,"C´s",587
41,"41084",2850,2205,2157,15,48,"C´s",125
41,"41082",3432,2809,2781,12,28,"C´s",205
41,"41083",1154,893,888,3,5,"C´s",56
41,"41902",4675,3051,3019,20,32,"C´s",226
41,"41013",4842,3491,3461,22,30,"C´s",127
41,"41044",7392,5562,5526,40,36,"C´s",943
41,"41032",4019,2943,2875,17,68,"C´s",265
41,"41006",2740,1909,1897,13,12,"C´s",106
41,"41072",4052,3115,3041,18,74,"C´s",135
41,"41098",4952,3762,3704,24,58,"C´s",396
41,"41011",15395,11527,11341,114,186,"C´s",827
41,"41021",21249,15031,14854,152,177,"C´s",1802
41,"41051",2170,1650,1611,8,39,"C´s",96
41,"41099",3998,2597,2577,19,20,"C´s",239
41,"41064",5601,3766,3715,42,51,"C´s",278
41,"41101",5932,4454,4421,27,33,"C´s",275
41,"41052",3006,2264,2209,8,55,"C´s",173
41,"41029",13423,9979,9880,84,99,"C´s",1432
41,"41102",14635,10904,10655,148,249,"C´s",1321
41,"41085",4086,3223,3178,31,45,"C´s",429
41,"41014",2510,1981,1958,8,23,"C´s",98
41,"41042",5868,4612,4583,37,29,"C´s",246
41,"41030",516,409,395,2,14,"C´s",30
41,"41031",1257,838,836,8,2,"C´s",54
41,"41081",29164,21631,21410,218,221,"C´s",2504
41,"41056",3691,3069,3042,21,27,"C´s",238
41,"41019",4654,3267,3224,34,43,"C´s",335
41,"41094",6288,4726,4653,36,73,"C´s",601
41,"41075",10225,7387,7283,55,104,"C´s",713
41,"41901",2676,2222,2190,31,32,"C´s",104
41,"41015",5310,3799,3710,38,89,"C´s",492
41,"41037",3203,2473,2449,18,24,"C´s",133
41,"41025",2041,1456,1430,17,26,"C´s",123
41,"41024",22662,15742,15521,137,221,"C´s",1813
41,"41004",56552,40018,39623,515,395,"C´s",5882
41,"41016",7310,5473,5410,50,63,"C´s",916
41,"41041",9743,7620,7482,39,138,"C´s",951
41,"41088",518,381,377,0,4,"C´s",19
41,"41079",9343,7111,7029,68,82,"C´s",876
41,"41071",5620,3974,3898,17,76,"C´s",312
41,"41038",99637,71611,71050,727,561,"C´s",11266
41,"41057",275,193,191,0,2,"C´s",8
41,"41012",3286,2268,2235,15,33,"C´s",231
41,"41027",3941,2766,2709,28,57,"C´s",273
41,"41095",41137,28987,28731,302,256,"C´s",4109
41,"41065",22868,15933,15784,172,149,"C´s",1879
3,"3006",497,401,393,4,8,"PP",133
3,"3125",346,263,262,0,1,"PP",98
3,"3901",1129,855,853,5,2,"PP",229
3,"3114",1568,1216,1203,8,13,"PP",510
3,"3036",91,80,79,2,1,"PP",24
3,"3058",4947,4015,3978,21,37,"PP",1985
3,"3014",237548,173040,172027,866,1013,"PP",55562
3,"3082",12542,8709,8597,48,112,"PP",2757
3,"3004",585,455,454,1,1,"PP",151
3,"3081",1433,1130,1118,5,12,"PP",361
3,"3051",350,310,305,1,5,"PP",125
3,"3102",7271,5762,5687,46,75,"PP",1585
3,"3122",42227,31379,31186,160,193,"PP",8090
3,"3061",1057,828,816,2,12,"PP",396
3,"3104",27134,21080,20902,156,178,"PP",5715
3,"3034",1367,1095,1079,4,16,"PP",413
3,"3105",5387,4089,4017,21,72,"PP",1715
3,"3903",2482,1945,1926,16,19,"PP",674
3,"3097",990,817,811,8,6,"PP",240
3,"3116",1159,892,886,2,6,"PP",343
3,"3137",653,516,515,5,1,"PP",157
3,"3136",446,361,361,2,0,"PP",136
3,"3047",9161,6622,6534,35,88,"PP",1908
3,"3093",19661,15155,14988,84,167,"PP",4428
3,"3032",106,90,89,1,1,"PP",30
3,"3134",148,132,132,2,0,"PP",42
3,"3131",175,159,153,0,6,"PP",56
3,"3055",5168,3949,3899,13,50,"PP",1846
3,"3059",20538,15653,15522,79,131,"PP",5711
3,"3046",1594,1185,1178,9,7,"PP",398
3,"3020",102,79,79,0,0,"PP",27
3,"3008",167,132,131,0,1,"PP",67
3,"3027",159,135,132,0,3,"PP",51
3,"3084",543,478,476,4,2,"PP",174
3,"3118",2452,1732,1714,9,18,"PP",753
3,"3026",1224,970,949,6,21,"PP",272
3,"3094",9033,6702,6657,32,45,"PP",2177
3,"3101",4765,3708,3659,13,49,"PP",884
3,"3053",7196,5800,5736,37,64,"PP",1999
3,"3124",469,400,394,5,6,"PP",122
3,"3139",22357,15787,15624,101,163,"PP",4603
3,"3074",1706,1400,1382,3,18,"PP",609
3,"3099",42365,31612,31259,220,353,"PP",14476
3,"3092",6749,5398,5342,40,56,"PP",1423
3,"3001",337,289,286,3,3,"PP",142
3,"3091",247,217,215,1,2,"PP",117
3,"3083",5607,4160,4106,36,54,"PP",1109
3,"3012",1072,862,849,3,13,"PP",317
3,"3077",1374,1139,1126,11,13,"PP",440
3,"3119",16534,12466,12363,69,103,"PP",4079
3,"3050",18601,13710,13610,61,100,"PP",4455
3,"3007",168,142,138,0,4,"PP",43
3,"3042",1367,1045,1033,5,12,"PP",394
3,"3023",1410,1221,1201,8,20,"PP",434
3,"3130",47,30,30,0,0,"PP",13
3,"3129",1187,991,984,8,7,"PP",396
3,"3123",7472,5748,5680,38,68,"PP",1925
3,"3063",26383,19376,19255,105,121,"PP",4973
3,"3018",12212,9129,9040,64,89,"PP",2858
3,"3073",236,202,202,1,0,"PP",75
3,"3095",4602,3628,3605,27,23,"PP",980
3,"3080",1299,1065,1036,3,29,"PP",543
3,"3117",370,325,322,0,3,"PP",113
3,"3069",3060,2187,2168,9,19,"PP",782
3,"3109",2850,2301,2275,11,26,"PP",878
3,"3048",4858,3785,3735,25,50,"PP",1521
3,"3078",486,398,397,3,1,"PP",203
3,"3039",85,61,59,0,2,"PP",20
3,"3138",3154,2406,2378,10,28,"PP",786
3,"3028",1006,833,823,1,10,"PP",300
3,"3045",216,182,179,1,3,"PP",69
3,"3017",376,317,312,3,5,"PP",60
3,"3107",2459,1807,1791,5,16,"PP",513
3,"3110",289,239,239,1,0,"PP",84
3,"3121",21269,14932,14795,78,137,"PP",5002
3,"3096",5811,4539,4492,19,47,"PP",1397
3,"3060",108,92,90,1,2,"PP",31
3,"3079",18235,14578,14388,114,190,"PP",4429
3,"3022",142,120,120,2,0,"PP",54
3,"3033",113,97,97,2,0,"PP",41
3,"3112",653,522,517,2,5,"PP",236
3,"3067",98,82,81,1,1,"PP",38
3,"3089",9599,7100,6980,39,120,"PP",2290
3,"3062",213,176,175,0,1,"PP",84
3,"3009",46817,36581,36258,240,323,"PP",8538
3,"3072",351,288,287,2,1,"PP",72
3,"3029",242,186,183,1,3,"PP",63
3,"3021",5627,4691,4613,23,78,"PP",1714
3,"3111",5411,4044,3967,14,77,"PP",1743
3,"3085",270,226,225,1,1,"PP",91
3,"3076",8485,6251,6194,37,57,"PP",2436
3,"3066",42291,31010,30781,190,229,"PP",8930
3,"3015",12544,9478,9388,58,90,"PP",3632
3,"3135",214,176,174,0,2,"PP",35
3,"3088",5498,4078,4030,42,48,"PP",1277
3,"3070",2038,1526,1499,5,27,"PP",631
3,"3024",3904,3109,3060,17,49,"PP",1261
3,"3071",3980,3134,3106,28,28,"PP",1016
3,"3052",969,804,794,6,10,"PP",369
3,"3068",46,41,40,0,1,"PP",26
3,"3106",596,503,501,1,2,"PP",208
3,"3040",257,222,222,0,0,"PP",75
3,"3132",536,426,423,0,3,"PP",110
3,"3075",156,139,139,0,0,"PP",66
3,"3037",352,296,293,3,3,"PP",85
3,"3005",7753,6158,6118,38,40,"PP",2729
3,"3031",41486,28059,27851,152,208,"PP",9725
3,"3127",352,279,277,1,2,"PP",109
3,"3019",15261,11921,11804,98,117,"PP",4108
3,"3128",4097,2972,2942,12,30,"PP",1106
3,"3904",1393,1065,1057,8,8,"PP",322
3,"3044",4512,3639,3586,16,53,"PP",1616
3,"3057",191,148,148,2,0,"PP",53
3,"3100",508,446,442,1,4,"PP",134
3,"3064",5040,3887,3834,16,53,"PP",1580
3,"3030",513,432,424,0,8,"PP",101
3,"3003",455,393,388,3,5,"PP",175
3,"3011",7729,5651,5595,29,56,"PP",1642
3,"3043",2900,2516,2483,18,33,"PP",741
3,"3035",663,543,538,1,5,"PP",169
3,"3115",248,219,219,2,0,"PP",81
3,"3025",1270,1003,996,3,7,"PP",439
3,"3098",507,403,394,3,9,"PP",97
3,"3902",10213,7091,6997,52,94,"PP",3090
3,"3054",338,274,268,4,6,"PP",96
3,"3041",5945,4393,4344,28,49,"PP",1433
3,"3140",26176,19795,19509,155,286,"PP",6022
3,"3049",12082,9341,9236,69,105,"PP",4035
3,"3120",2416,1814,1783,13,31,"PP",686
3,"3056",8737,6809,6731,33,78,"PP",1873
3,"3016",94,79,79,0,0,"PP",32
3,"3113",4254,3159,3120,17,39,"PP",1100
3,"3013",1114,914,906,5,8,"PP",380
3,"3086",153,134,134,1,0,"PP",38
3,"3002",3610,2714,2682,18,32,"PP",939
3,"3038",358,292,285,2,7,"PP",98
3,"3065",166944,126831,126024,773,807,"PP",40435
3,"3090",17087,12723,12602,69,121,"PP",3820
3,"3103",278,240,237,1,3,"PP",77
3,"3010",325,278,276,0,2,"PP",87
3,"3133",41763,26236,26039,134,197,"PP",9484
23,"23012",4177,3016,2988,22,28,"PP",948
23,"23019",1562,1249,1227,4,22,"PP",327
23,"23011",2193,1616,1600,11,16,"PP",290
23,"23046",2405,1963,1934,3,29,"PP",454
23,"23067",2489,1869,1847,18,22,"PP",510
23,"23096",2643,2174,2140,14,34,"PP",367
23,"23086",11537,8362,8242,91,120,"PP",1958
23,"23075",3319,2640,2618,21,22,"PP",769
23,"23087",11313,8540,8454,64,86,"PP",2465
23,"23055",47421,33170,32908,213,262,"PP",9528
23,"23085",2273,1833,1814,3,19,"PP",400
23,"23009",12866,9787,9667,64,120,"PP",3677
23,"23064",1659,1368,1364,1,4,"PP",562
23,"23044",4847,3801,3740,26,61,"PP",1139
23,"23076",837,672,658,4,14,"PP",231
23,"23026",3636,2724,2685,11,39,"PP",1029
23,"23045",2139,1560,1551,9,9,"PP",323
23,"23003",8709,6520,6440,42,80,"PP",2162
23,"23010",14371,10249,10140,65,109,"PP",3631
23,"23001",993,826,820,1,6,"PP",321
23,"23027",727,577,576,8,1,"PP",171
23,"23091",742,609,607,5,2,"PP",241
23,"23079",3733,2994,2981,26,13,"PP",1002
23,"23018",2326,1678,1668,5,10,"PP",307
23,"23047",1638,1311,1306,9,5,"PP",336
23,"23058",8665,6651,6585,47,66,"PP",2017
23,"23014",2561,1982,1959,8,23,"PP",591
23,"23030",1232,1020,1007,10,13,"PP",262
23,"23006",4636,3761,3714,25,47,"PP",842
23,"23056",3108,2365,2343,14,22,"PP",535
23,"23034",2558,1987,1977,18,10,"PP",566
23,"23081",1546,1145,1132,6,13,"PP",263
23,"23038",3557,2851,2831,11,20,"PP",1133
23,"23015",1393,1061,1052,3,9,"PP",303
23,"23062",1461,1188,1181,1,7,"PP",424
23,"23059",5856,4498,4450,33,48,"PP",1060
23,"23017",1584,1265,1253,4,12,"PP",364
23,"23095",8737,6303,6268,34,35,"PP",2432
23,"23004",435,350,346,0,4,"PP",173
23,"23053",9526,6783,6736,49,47,"PP",1086
23,"23082",1924,1420,1413,6,7,"PP",535
23,"23077",637,515,514,3,1,"PP",164
23,"23035",1095,871,867,8,4,"PP",305
23,"23060",19157,13567,13438,133,129,"PP",3857
23,"23094",3852,3097,3061,17,36,"PP",546
23,"23061",7520,5481,5405,55,76,"PP",1773
23,"23070",3931,2549,2533,11,16,"PP",855
23,"23065",1601,1222,1207,0,15,"PP",400
23,"23073",4558,3427,3402,11,25,"PP",1001
23,"23025",2813,2186,2163,7,23,"PP",838
23,"23088",6124,4764,4703,31,61,"PP",913
23,"23074",3030,2368,2353,12,15,"PP",733
23,"23021",528,452,448,0,4,"PP",111
23,"23063",3845,2934,2898,24,36,"PP",748
23,"23002",17450,13199,12986,92,213,"PP",3882
23,"23098",875,728,722,2,6,"PP",275
23,"23093",3257,2534,2506,21,28,"PP",461
23,"23057",771,648,648,4,0,"PP",109
23,"23052",1138,977,971,6,6,"PP",307
23,"23005",30539,21840,21629,176,211,"PP",7156
23,"23007",3102,2381,2369,8,12,"PP",676
23,"23049",1834,1384,1378,7,6,"PP",246
23,"23054",382,276,275,0,1,"PP",77
23,"23084",953,711,708,6,3,"PP",254
23,"23042",299,220,220,1,0,"PP",98
23,"23043",549,401,400,0,1,"PP",159
23,"23024",12512,9391,9182,79,209,"PP",2968
23,"23032",575,461,457,1,4,"PP",70
23,"23008",1518,1185,1173,18,12,"PP",233
23,"23033",1356,1080,1065,8,15,"PP",415
23,"23071",1728,1337,1328,7,9,"PP",466
23,"23029",854,631,623,2,8,"PP",276
23,"23031",751,662,650,9,12,"PP",82
23,"23903",3550,2742,2721,19,21,"PP",879
23,"23050",91221,67753,67164,549,589,"PP",25684
23,"23069",5385,4406,4318,15,88,"PP",1512
23,"23092",27765,20688,20560,143,128,"PP",6587
23,"23066",4376,3530,3508,46,22,"PP",1197
23,"23040",1489,1226,1211,4,15,"PP",271
23,"23097",6445,4313,4290,30,23,"PP",1402
23,"23028",6203,4645,4585,33,60,"PP",1369
23,"23902",2327,1877,1857,9,20,"PP",428
23,"23039",2220,1658,1626,8,32,"PP",536
23,"23072",2002,1593,1582,6,11,"PP",486
23,"23041",504,396,392,1,4,"PP",155
23,"23901",1160,978,972,5,6,"PP",336
23,"23016",396,323,318,3,5,"PP",85
23,"23020",1584,1376,1366,5,10,"PP",333
23,"23080",1786,1347,1329,6,18,"PP",363
23,"23090",1316,1077,1071,8,6,"PP",472
23,"23101",388,281,279,0,2,"PP",65
23,"23099",4734,3509,3459,23,50,"PP",1300
23,"23905",1861,1351,1345,7,6,"PP",459
23,"23037",516,427,423,1,4,"PP",114
23,"23048",860,636,630,1,6,"PP",301
23,"23051",2762,2258,2231,9,27,"PP",779
23,"23904",2852,1784,1764,14,20,"PP",549
32,"32082",1259,905,887,6,18,"C´s",36
32,"32062",832,646,644,7,2,"C´s",14
32,"32071",1496,1013,1004,1,9,"C´s",31
32,"32013",2213,1447,1431,8,16,"C´s",100
32,"32037",742,544,532,8,12,"C´s",26
32,"32018",1261,956,945,3,11,"C´s",34
32,"32030",1015,702,689,3,13,"C´s",17
32,"32054",87290,63653,62823,671,830,"C´s",6628
32,"32040",1472,1112,1089,9,23,"C´s",60
32,"32085",10709,7489,7403,81,86,"C´s",544
32,"32079",1343,1000,987,9,13,"C´s",71
32,"32078",1243,876,869,6,7,"C´s",42
32,"32063",1939,1329,1314,16,15,"C´s",80
32,"32009",10783,7555,7468,60,87,"C´s",652
32,"32028",1643,1195,1174,18,21,"C´s",54
32,"32046",1179,840,832,5,8,"C´s",47
32,"32086",2671,1731,1712,10,19,"C´s",104
32,"32021",956,664,662,2,2,"C´s",27
32,"32002",2016,1474,1460,11,14,"C´s",102
32,"32084",925,657,650,3,7,"C´s",43
32,"32074",1064,731,719,4,12,"C´s",37
32,"32057",575,414,412,5,2,"C´s",22
32,"32032",8101,5993,5881,74,112,"C´s",497
32,"32060",845,609,598,6,11,"C´s",38
32,"32059",1849,1357,1339,16,18,"C´s",62
32,"32055",1310,952,936,7,16,"C´s",51
32,"32027",1072,765,747,3,18,"C´s",36
32,"32010",394,299,298,0,1,"C´s",15
32,"32068",1424,974,969,8,5,"C´s",39
32,"32051",1458,1141,1137,4,4,"C´s",53
32,"32022",1377,963,951,7,12,"C´s",44
32,"32029",480,349,346,5,3,"C´s",11
32,"32025",1094,821,809,3,12,"C´s",53
32,"32087",1798,1421,1397,7,24,"C´s",90
32,"32050",2455,1874,1855,17,19,"C´s",72
32,"32049",775,502,495,5,7,"C´s",22
32,"32017",1272,862,849,5,13,"C´s",54
32,"32008",8188,5923,5845,44,78,"C´s",701
32,"32020",2625,1997,1974,10,23,"C´s",73
32,"32061",1093,852,840,3,12,"C´s",36
32,"32083",860,580,574,4,6,"C´s",34
32,"32069",4333,3324,3261,25,63,"C´s",221
32,"32066",567,435,434,2,1,"C´s",10
32,"32031",1079,826,812,5,14,"C´s",53
32,"32041",772,511,505,5,6,"C´s",23
32,"32064",526,397,395,1,2,"C´s",30
32,"32007",1527,1078,1070,7,8,"C´s",42
32,"32019",11529,8038,7906,78,132,"C´s",622
32,"32034",1141,880,873,4,7,"C´s",21
32,"32004",1826,900,897,8,3,"C´s",36
32,"32045",2484,1820,1795,19,25,"C´s",100
32,"32077",1188,813,796,8,17,"C´s",45
32,"32016",825,559,556,3,3,"C´s",22
32,"32035",1484,944,938,7,6,"C´s",57
32,"32058",5209,3808,3750,27,58,"C´s",426
32,"32047",1818,1345,1329,3,16,"C´s",84
32,"32006",1571,1140,1127,10,13,"C´s",53
32,"32042",1585,1120,1104,13,16,"C´s",58
32,"32073",1332,976,965,4,11,"C´s",41
32,"32053",1447,1140,1128,12,12,"C´s",40
32,"32072",3833,2799,2761,26,38,"C´s",179
32,"32056",1610,1159,1146,9,13,"C´s",43
32,"32005",869,676,671,7,5,"C´s",34
32,"32012",811,535,533,3,2,"C´s",26
32,"32075",4188,3257,3206,43,51,"C´s",292
32,"32048",906,573,564,6,9,"C´s",18
32,"32065",669,494,482,3,12,"C´s",32
32,"32089",1332,917,904,5,13,"C´s",38
32,"32014",1170,855,845,7,10,"C´s",40
32,"32076",2121,1509,1489,12,20,"C´s",70
32,"32067",1300,838,824,15,14,"C´s",50
32,"32023",1217,884,877,6,7,"C´s",31
32,"32080",333,266,265,0,1,"C´s",12
32,"32033",750,504,500,4,4,"C´s",38
32,"32011",934,559,548,5,11,"C´s",19
32,"32052",1904,1450,1426,6,24,"C´s",77
32,"32026",2736,2039,1998,25,41,"C´s",153
32,"32070",566,335,330,3,5,"C´s",21
32,"32091",1909,1389,1375,8,14,"C´s",34
32,"32044",900,658,647,5,11,"C´s",55
32,"32081",2097,1566,1553,6,13,"C´s",125
32,"32039",1275,989,976,5,13,"C´s",45
32,"32015",899,586,581,5,5,"C´s",25
32,"32088",1632,1062,1042,8,20,"C´s",69
32,"32092",528,337,334,4,3,"C´s",19
32,"32036",1369,1053,1040,5,13,"C´s",70
32,"32003",886,661,653,6,8,"C´s",21
32,"32043",2555,1824,1793,15,31,"C´s",91
32,"32090",791,558,556,2,2,"C´s",34
32,"32038",456,299,297,2,2,"C´s",20
32,"32024",4839,3424,3368,35,56,"C´s",266
32,"32001",4978,3644,3607,31,37,"C´s",237
47,"47019",86,67,65,1,2,"PACMA",0
47,"47168",31,28,27,0,1,"PACMA",0
47,"47182",1342,1037,1023,16,14,"PACMA",3
47,"47065",863,681,671,4,10,"PACMA",0
47,"47195",461,348,348,3,0,"PACMA",2
47,"47152",86,64,64,1,0,"PACMA",0
47,"47164",377,309,307,2,2,"PACMA",1
47,"47106",50,41,41,0,0,"PACMA",0
47,"47005",548,426,421,4,5,"PACMA",2
47,"47128",60,51,49,1,2,"PACMA",0
47,"47218",995,760,754,6,6,"PACMA",4
47,"47037",174,146,141,2,5,"PACMA",0
47,"47227",64,52,52,0,0,"PACMA",0
47,"47033",199,154,153,3,1,"PACMA",0
47,"47179",398,299,295,3,4,"PACMA",0
47,"47223",158,129,125,3,4,"PACMA",1
47,"47175",6575,4991,4937,51,54,"PACMA",29
47,"47030",1006,785,770,10,15,"PACMA",3
47,"47208",59,38,37,3,1,"PACMA",0
47,"47101",1720,1404,1388,10,16,"PACMA",1
47,"47022",57,50,46,0,4,"PACMA",0
47,"47155",3239,2400,2374,27,26,"PACMA",37
47,"47085",16668,12248,12132,133,116,"PACMA",70
47,"47001",55,51,50,2,1,"PACMA",0
47,"47111",1009,794,789,4,5,"PACMA",5
47,"47080",30,22,22,0,0,"PACMA",0
47,"47134",164,126,119,4,7,"PACMA",0
47,"47172",148,120,120,1,0,"PACMA",0
47,"47170",36,30,29,2,1,"PACMA",0
47,"47229",215,151,150,1,1,"PACMA",0
47,"47008",24,18,18,0,0,"PACMA",0
47,"47133",2665,2140,2118,25,22,"PACMA",23
47,"47023",2999,2457,2445,20,12,"PACMA",13
47,"47204",260,199,193,2,6,"PACMA",1
47,"47003",228,180,179,3,1,"PACMA",0
47,"47079",62,51,51,0,0,"PACMA",0
47,"47014",50,45,45,0,0,"PACMA",0
47,"47046",121,93,93,0,0,"PACMA",0
47,"47173",883,686,675,4,11,"PACMA",2
47,"47219",42,36,34,2,2,"PACMA",0
47,"47105",192,164,163,0,1,"PACMA",0
47,"47129",879,700,688,6,12,"PACMA",4
47,"47132",45,37,35,0,2,"PACMA",0
47,"47200",82,64,64,1,0,"PACMA",0
47,"47016",71,58,57,0,1,"PACMA",0
47,"47089",153,122,120,2,2,"PACMA",0
47,"47004",1199,946,938,11,8,"PACMA",1
47,"47171",418,333,332,9,1,"PACMA",0
47,"47139",1047,790,785,7,5,"PACMA",0
47,"47059",97,71,71,0,0,"PACMA",0
47,"47230",302,243,241,0,2,"PACMA",0
47,"47135",84,76,76,2,0,"PACMA",0
47,"47169",68,57,57,0,0,"PACMA",0
47,"47213",115,83,83,0,0,"PACMA",0
47,"47186",246602,193774,192412,1384,1362,"PACMA",1050
47,"47057",248,194,194,2,0,"PACMA",3
47,"47068",36,27,27,0,0,"PACMA",0
47,"47180",83,64,64,1,0,"PACMA",0
47,"47109",171,131,130,1,1,"PACMA",0
47,"47040",63,52,51,1,1,"PACMA",0
47,"47090",2418,1805,1776,17,29,"PACMA",8
47,"47178",175,146,146,1,0,"PACMA",1
47,"47181",168,135,134,0,1,"PACMA",0
47,"47212",388,322,322,3,0,"PACMA",2
47,"47113",156,121,121,0,0,"PACMA",0
47,"47187",89,57,56,2,1,"PACMA",0
47,"47189",152,128,128,0,0,"PACMA",0
47,"47082",803,641,633,5,8,"PACMA",2
47,"47138",237,180,176,1,4,"PACMA",0
47,"47141",134,102,101,1,1,"PACMA",0
47,"47147",119,91,91,0,0,"PACMA",0
47,"47176",224,139,135,5,4,"PACMA",0
47,"47061",258,216,214,2,2,"PACMA",0
47,"47067",178,126,126,3,0,"PACMA",0
47,"47097",331,268,263,1,5,"PACMA",0
47,"47110",455,363,357,3,6,"PACMA",1
47,"47029",57,48,47,1,1,"PACMA",0
47,"47162",73,61,61,0,0,"PACMA",0
47,"47153",108,74,73,1,1,"PACMA",0
47,"47055",202,170,168,1,2,"PACMA",0
47,"47207",277,216,212,3,4,"PACMA",0
47,"47196",35,26,26,1,0,"PACMA",0
47,"47091",89,67,66,0,1,"PACMA",0
47,"47024",262,206,205,2,1,"PACMA",0
47,"47188",112,85,85,0,0,"PACMA",0
47,"47228",445,359,357,4,2,"PACMA",1
47,"47205",385,281,274,7,7,"PACMA",0
47,"47074",150,125,125,1,0,"PACMA",0
47,"47117",297,219,216,4,3,"PACMA",0
47,"47165",6987,5301,5115,63,186,"PACMA",9
47,"47104",2857,2313,2253,19,60,"PACMA",3
47,"47073",120,98,97,1,1,"PACMA",0
47,"47119",90,75,75,1,0,"PACMA",0
47,"47174",275,222,218,2,4,"PACMA",2
47,"47118",161,119,118,0,1,"PACMA",0
47,"47060",262,218,214,0,4,"PACMA",1
47,"47048",190,140,138,0,2,"PACMA",0
47,"47093",817,654,642,9,12,"PACMA",4
47,"47183",130,105,105,0,0,"PACMA",0
47,"47032",153,120,118,0,2,"PACMA",1
47,"47166",265,203,199,3,4,"PACMA",0
47,"47011",568,469,464,1,5,"PACMA",1
47,"47198",66,47,47,0,0,"PACMA",1
47,"47099",152,128,127,1,1,"PACMA",1
47,"47193",1583,1313,1294,12,19,"PACMA",5
47,"47102",286,229,224,1,5,"PACMA",0
47,"47096",135,108,107,2,1,"PACMA",0
47,"47122",2034,1666,1635,21,31,"PACMA",7
47,"47066",1255,1005,996,7,9,"PACMA",6
47,"47215",54,47,46,1,1,"PACMA",0
47,"47088",110,87,87,0,0,"PACMA",0
47,"47035",930,745,739,10,6,"PACMA",0
47,"47095",39,36,35,0,1,"PACMA",0
47,"47058",206,149,149,2,0,"PACMA",1
47,"47199",80,59,59,2,0,"PACMA",0
47,"47123",469,395,386,4,9,"PACMA",2
47,"47041",149,124,123,2,1,"PACMA",0
47,"47150",278,217,214,2,3,"PACMA",0
47,"47224",91,74,74,1,0,"PACMA",0
47,"47197",888,693,687,10,6,"PACMA",0
47,"47064",31,29,28,2,1,"PACMA",0
47,"47210",372,289,286,1,3,"PACMA",0
47,"47071",417,348,344,2,4,"PACMA",2
47,"47038",108,82,82,0,0,"PACMA",0
47,"47100",140,119,117,2,2,"PACMA",1
47,"47010",13613,10963,10895,108,68,"PACMA",82
47,"47013",99,74,73,0,1,"PACMA",0
47,"47231",4384,3457,3432,33,25,"PACMA",18
47,"47185",98,79,79,0,0,"PACMA",0
47,"47053",116,96,96,1,0,"PACMA",0
47,"47098",583,488,487,6,1,"PACMA",2
47,"47036",229,184,179,2,5,"PACMA",0
47,"47039",188,149,148,1,1,"PACMA",0
47,"47002",25,23,23,0,0,"PACMA",0
47,"47075",4871,3802,3763,30,39,"PACMA",13
47,"47144",78,66,65,2,1,"PACMA",2
47,"47214",1420,1111,1093,9,18,"PACMA",0
47,"47063",101,82,81,2,1,"PACMA",0
47,"47114",4074,2868,2826,20,42,"PACMA",7
47,"47167",242,201,197,3,4,"PACMA",0
47,"47087",379,318,314,4,4,"PACMA",1
47,"47203",67,54,54,0,0,"PACMA",0
47,"47017",201,161,158,3,3,"PACMA",2
47,"47049",100,78,78,1,0,"PACMA",0
47,"47220",166,124,124,1,0,"PACMA",1
47,"47190",93,80,78,4,2,"PACMA",0
47,"47226",161,128,127,1,1,"PACMA",0
47,"47009",106,80,80,1,0,"PACMA",0
47,"47045",768,586,580,0,6,"PACMA",0
47,"47192",105,80,79,1,1,"PACMA",0
47,"47160",430,334,329,5,5,"PACMA",0
47,"47157",515,442,441,3,1,"PACMA",4
47,"47007",3748,2869,2835,24,34,"PACMA",24
47,"47184",576,463,462,2,1,"PACMA",2
47,"47131",178,132,131,3,1,"PACMA",0
47,"47086",3926,3065,3028,27,37,"PACMA",15
47,"47126",49,36,36,0,0,"PACMA",0
47,"47044",330,291,287,0,4,"PACMA",4
47,"47094",132,103,101,1,2,"PACMA",1
47,"47012",118,95,95,0,0,"PACMA",1
47,"47070",41,32,32,1,0,"PACMA",0
47,"47125",59,43,43,1,0,"PACMA",0
47,"47006",190,145,144,1,1,"PACMA",1
47,"47115",287,238,237,4,1,"PACMA",0
47,"47092",110,93,92,0,1,"PACMA",1
47,"47077",247,190,189,2,1,"PACMA",0
47,"47103",259,211,211,4,0,"PACMA",0
47,"47151",27,22,21,0,1,"PACMA",0
47,"47054",638,501,496,6,5,"PACMA",0
47,"47177",107,78,76,0,2,"PACMA",1
47,"47124",399,329,328,4,1,"PACMA",0
47,"47217",1896,1436,1420,20,16,"PACMA",16
47,"47025",120,97,97,2,0,"PACMA",0
47,"47121",553,436,428,5,8,"PACMA",0
47,"47191",110,74,74,0,0,"PACMA",1
47,"47031",186,145,144,1,1,"PACMA",0
47,"47116",413,330,324,1,6,"PACMA",0
47,"47137",29,28,28,1,0,"PACMA",0
47,"47084",1171,911,898,15,13,"PACMA",3
47,"47069",127,113,111,0,2,"PACMA",0
47,"47158",906,686,668,3,18,"PACMA",2
47,"47221",109,91,91,0,0,"PACMA",0
47,"47020",278,230,227,1,3,"PACMA",0
47,"47209",42,30,30,1,0,"PACMA",0
47,"47146",260,205,204,1,1,"PACMA",5
47,"47076",17375,13778,13684,111,94,"PACMA",89
47,"47206",95,81,81,0,0,"PACMA",0
47,"47081",47,40,40,0,0,"PACMA",0
47,"47026",49,40,40,0,0,"PACMA",0
47,"47042",54,41,41,3,0,"PACMA",0
47,"47052",6584,5222,5163,41,59,"PACMA",42
47,"47078",164,129,124,1,5,"PACMA",0
47,"47222",80,68,68,3,0,"PACMA",0
47,"47148",439,336,335,2,1,"PACMA",0
47,"47047",202,157,157,3,0,"PACMA",1
47,"47194",301,242,239,1,3,"PACMA",2
47,"47156",169,137,135,1,2,"PACMA",0
47,"47149",43,33,32,1,1,"PACMA",1
47,"47018",35,31,28,0,3,"PACMA",0
47,"47216",115,101,99,2,2,"PACMA",0
47,"47027",2746,2120,2095,8,25,"PACMA",11
47,"47159",828,654,646,0,8,"PACMA",0
47,"47021",76,65,65,1,0,"PACMA",0
47,"47062",163,131,131,0,0,"PACMA",1
47,"47140",119,101,100,1,1,"PACMA",0
47,"47127",135,98,96,1,2,"PACMA",0
47,"47225",81,61,60,2,1,"PACMA",1
47,"47083",80,62,61,2,1,"PACMA",0
47,"47163",299,236,235,6,1,"PACMA",1
47,"47161",3903,3200,3183,25,17,"PACMA",14
47,"47028",33,20,20,0,0,"PACMA",0
47,"47232",99,75,74,0,1,"PACMA",0
47,"47154",155,128,127,0,1,"PACMA",0
47,"47112",2592,2063,2043,20,20,"PACMA",5
47,"47211",49,39,37,1,2,"PACMA",0
47,"47051",338,274,272,0,2,"PACMA",2
47,"47034",76,59,58,1,1,"PACMA",0
47,"47015",199,151,151,0,0,"PACMA",0
47,"47145",611,451,449,4,2,"PACMA",0
47,"47130",99,78,78,1,0,"PACMA",0
47,"47056",82,58,57,0,1,"PACMA",1
47,"47050",3757,2829,2812,29,17,"PACMA",19
47,"47142",148,114,113,0,1,"PACMA",0
47,"47143",127,99,99,0,0,"PACMA",1
47,"47043",302,239,239,3,0,"PACMA",0
45,"45188",2783,2161,2127,9,34,"PP",655
45,"45176",3665,2747,2712,15,35,"PP",781
45,"45099",3512,2514,2459,9,55,"PP",824
45,"45170",235,183,176,4,7,"PP",100
45,"45001",1852,1395,1355,9,40,"PP",493
45,"45130",319,258,252,1,6,"PP",122
45,"45179",546,406,403,3,3,"PP",188
45,"45161",13474,9618,9496,63,122,"PP",2572
45,"45063",428,320,310,2,10,"PP",138
45,"45147",581,475,469,4,6,"PP",168
45,"45152",597,476,476,2,0,"PP",156
45,"45026",225,171,169,1,2,"PP",67
45,"45186",3083,2369,2341,14,28,"PP",918
45,"45157",2125,1531,1509,14,22,"PP",649
45,"45204",643,519,513,0,6,"PP",210
45,"45172",719,559,556,2,3,"PP",237
45,"45121",6766,4860,4798,30,62,"PP",2002
45,"45194",67,50,49,0,1,"PP",21
45,"45017",262,221,219,0,2,"PP",75
45,"45015",622,461,455,2,6,"PP",165
45,"45089",1516,1157,1139,6,18,"PP",307
45,"45092",233,197,194,0,3,"PP",114
45,"45009",545,336,333,1,3,"PP",194
45,"45118",2002,1470,1456,3,14,"PP",569
45,"45061",2457,1718,1699,7,19,"PP",633
45,"45158",2534,1885,1868,8,17,"PP",822
45,"45003",572,431,423,1,8,"PP",199
45,"45096",1015,832,817,7,15,"PP",305
45,"45087",8345,6184,6091,34,93,"PP",2618
45,"45148",307,229,219,1,10,"PP",122
45,"45168",62226,48889,48446,327,443,"PP",18619
45,"45190",483,397,387,2,10,"PP",162
45,"45127",708,524,519,1,5,"PP",251
45,"45103",397,325,322,0,3,"PP",179
45,"45040",1396,871,862,4,9,"PP",381
45,"45091",407,301,299,2,2,"PP",98
45,"45107",3238,2628,2597,15,31,"PP",912
45,"45013",1786,1428,1412,7,16,"PP",744
45,"45076",574,382,378,1,4,"PP",162
45,"45129",136,100,97,0,3,"PP",37
45,"45136",5859,4249,4177,24,72,"PP",1914
45,"45149",573,486,484,0,2,"PP",230
45,"45005",241,207,205,2,2,"PP",85
45,"45038",3335,2525,2490,8,35,"PP",896
45,"45043",793,663,655,1,8,"PP",329
45,"45901",769,577,571,1,6,"PP",256
45,"45140",1093,885,876,4,9,"PP",303
45,"45104",440,345,341,1,4,"PP",82
45,"45018",495,352,348,0,4,"PP",99
45,"45068",173,138,135,0,3,"PP",38
45,"45002",2549,1810,1784,7,26,"PP",679
45,"45192",2503,2164,2141,7,23,"PP",935
45,"45059",1723,1413,1388,4,25,"PP",749
45,"45097",1047,877,869,3,8,"PP",368
45,"45075",146,108,105,0,3,"PP",40
45,"45077",542,428,423,0,5,"PP",169
45,"45030",482,364,361,4,3,"PP",134
45,"45083",465,393,388,5,5,"PP",193
45,"45035",298,225,221,2,4,"PP",64
45,"45081",17646,13309,13166,72,143,"PP",4435
45,"45052",2914,2389,2372,23,17,"PP",765
45,"45166",1629,1345,1332,5,13,"PP",484
45,"45154",1483,1114,1107,5,7,"PP",375
45,"45011",288,246,241,1,5,"PP",122
45,"45122",5164,4112,4067,18,45,"PP",1597
45,"45072",670,499,499,2,0,"PP",216
45,"45098",2186,1686,1649,10,37,"PP",1083
45,"45145",2539,1830,1811,11,19,"PP",744
45,"45046",2421,1815,1796,8,19,"PP",650
45,"45079",367,285,285,3,0,"PP",124
45,"45101",3761,3090,3048,15,42,"PP",1589
45,"45029",205,169,169,0,0,"PP",65
45,"45115",2563,2089,2048,5,41,"PP",811
45,"45086",503,375,369,3,6,"PP",161
45,"45008",142,114,114,2,0,"PP",60
45,"45180",2725,2060,2028,7,32,"PP",945
45,"45139",172,135,133,0,2,"PP",55
45,"45201",3450,2212,2173,14,39,"PP",612
45,"45146",108,85,85,0,0,"PP",60
45,"45051",1594,1264,1248,6,16,"PP",474
45,"45193",626,543,530,2,13,"PP",281
45,"45039",226,197,193,1,4,"PP",101
45,"45093",151,117,117,0,0,"PP",76
45,"45205",6745,4708,4657,35,51,"PP",1390
45,"45141",897,735,727,4,8,"PP",315
45,"45031",2723,1935,1896,10,39,"PP",767
45,"45073",307,238,235,0,3,"PP",114
45,"45067",2324,1871,1841,13,30,"PP",979
45,"45042",190,145,145,0,0,"PP",68
45,"45132",2096,1631,1616,7,15,"PP",836
45,"45084",2280,1777,1747,12,30,"PP",643
45,"45112",1939,1302,1268,6,34,"PP",530
45,"45198",1832,1521,1508,6,13,"PP",725
45,"45023",2160,1669,1654,9,15,"PP",542
45,"45095",697,529,520,1,9,"PP",257
45,"45159",86,75,72,1,3,"PP",41
45,"45133",2818,2184,2146,19,38,"PP",853
45,"45175",665,541,532,5,9,"PP",276
45,"45151",586,444,437,1,7,"PP",169
45,"45184",201,124,123,1,1,"PP",20
45,"45105",405,284,279,3,5,"PP",117
45,"45109",2913,2295,2218,16,77,"PP",1155
45,"45183",2253,1581,1569,8,12,"PP",490
45,"45203",2574,1938,1908,10,30,"PP",607
45,"45150",454,366,364,1,2,"PP",123
45,"45174",309,247,247,1,0,"PP",137
45,"45016",4179,3290,3268,30,22,"PP",1127
45,"45014",3984,2824,2802,24,22,"PP",786
45,"45195",2161,1709,1686,12,23,"PP",565
45,"45036",658,500,496,2,4,"PP",254
45,"45137",1623,1106,1093,9,13,"PP",301
45,"45199",2963,2055,2027,5,28,"PP",625
45,"45088",2102,1438,1423,4,15,"PP",450
45,"45200",4627,3678,3588,29,90,"PP",1327
45,"45123",3075,2261,2222,11,39,"PP",565
45,"45012",670,521,506,4,15,"PP",236
45,"45094",395,312,308,0,4,"PP",142
45,"45050",471,354,351,2,3,"PP",131
45,"45189",597,467,458,2,9,"PP",173
45,"45047",2563,1775,1751,13,24,"PP",691
45,"45156",3441,2863,2825,13,38,"PP",1013
45,"45160",1111,908,895,6,13,"PP",438
45,"45181",2313,1755,1728,12,27,"PP",748
45,"45106",7524,5882,5784,55,98,"PP",2340
45,"45074",412,327,322,0,5,"PP",156
45,"45090",376,299,295,4,4,"PP",126
45,"45048",360,281,277,1,4,"PP",133
45,"45055",1032,857,841,2,16,"PP",381
45,"45164",186,160,160,0,0,"PP",86
45,"45144",794,643,640,2,3,"PP",242
45,"45165",62857,46607,46141,313,466,"PP",17876
45,"45108",521,415,414,2,1,"PP",196
45,"45202",3905,2962,2920,12,42,"PP",1283
45,"45064",3839,2915,2884,19,31,"PP",920
45,"45080",6,6,6,0,0,"PP",4
45,"45173",9477,7145,7061,40,84,"PP",3024
45,"45153",1613,1263,1248,11,15,"PP",544
45,"45187",4078,3405,3353,14,52,"PP",1298
45,"45100",197,166,164,2,2,"PP",56
45,"45041",3725,2698,2665,18,33,"PP",948
45,"45019",7356,5539,5484,35,55,"PP",1619
45,"45113",1948,1409,1386,14,23,"PP",733
45,"45117",754,610,602,2,8,"PP",217
45,"45085",1501,1086,1067,6,19,"PP",541
45,"45143",1180,924,912,3,12,"PP",370
45,"45135",4302,3509,3453,21,56,"PP",1273
45,"45138",1110,903,887,6,16,"PP",412
45,"45032",436,317,313,0,4,"PP",88
45,"45053",8045,6446,6370,44,76,"PP",2389
45,"45028",3680,2919,2880,23,39,"PP",1080
45,"45078",1392,1187,1179,8,8,"PP",554
45,"45004",568,436,430,1,6,"PP",160
45,"45027",362,275,270,0,5,"PP",122
45,"45196",1388,1066,1054,13,12,"PP",400
45,"45025",1198,921,910,2,11,"PP",267
45,"45171",1382,1090,1075,4,15,"PP",441
45,"45033",351,253,247,3,6,"PP",113
45,"45034",1360,1098,1083,4,15,"PP",413
45,"45056",2210,1384,1370,11,14,"PP",408
45,"45037",1635,1216,1202,4,14,"PP",479
45,"45111",60,47,47,0,0,"PP",19
45,"45119",3348,2306,2264,14,42,"PP",761
45,"45062",1121,910,894,10,16,"PP",494
45,"45128",2498,1794,1774,7,20,"PP",580
45,"45114",595,461,457,1,4,"PP",184
45,"45069",1876,1446,1428,8,18,"PP",637
45,"45020",1313,1062,1046,5,16,"PP",537
45,"45054",3995,2997,2968,8,29,"PP",1358
45,"45191",549,477,475,0,2,"PP",194
45,"45007",697,566,560,1,6,"PP",152
45,"45182",1045,854,844,3,10,"PP",352
45,"45082",1246,1046,1036,9,10,"PP",449
45,"45169",193,136,136,1,0,"PP",56
45,"45060",179,131,129,1,2,"PP",22
45,"45045",1316,945,935,1,10,"PP",375
45,"45116",694,531,523,2,8,"PP",250
45,"45162",683,515,510,0,5,"PP",250
45,"45163",8338,6270,6142,57,128,"PP",2268
45,"45167",1458,1197,1187,5,10,"PP",545
45,"45134",1600,1214,1200,4,14,"PP",533
45,"45155",371,297,296,1,1,"PP",115
45,"45185",7734,6057,5973,27,84,"PP",2082
45,"45058",384,304,301,4,3,"PP",137
45,"45071",1863,1550,1530,8,20,"PP",504
45,"45197",1921,1500,1480,12,20,"PP",590
45,"45021",2459,1862,1833,21,29,"PP",648
45,"45066",7589,5716,5637,30,79,"PP",2599
45,"45142",7858,6249,6164,57,85,"PP",2677
45,"45049",435,330,326,0,4,"PP",164
45,"45024",1075,828,824,5,4,"PP",447
45,"45022",392,297,293,8,4,"PP",143
45,"45125",2329,1920,1898,10,22,"PP",727
45,"45177",2142,1757,1731,11,26,"PP",740
45,"45120",134,105,105,1,0,"PP",43
45,"45124",2156,1750,1712,16,38,"PP",770
45,"45102",3629,2685,2644,15,41,"PP",1091
45,"45057",221,187,182,0,5,"PP",97
45,"45006",1425,1022,1013,4,9,"PP",347
45,"45065",276,227,223,0,4,"PP",95
45,"45131",287,242,242,0,0,"PP",105
45,"45070",1461,1223,1202,7,21,"PP",520
45,"45010",436,335,333,2,2,"PP",116
45,"45126",260,169,167,1,2,"PP",49
45,"45110",1799,1394,1380,4,14,"PP",617
52,"52001",53255,28182,27819,299,363,"C's",4356
52,"52001",53255,28182,27819,299,363,"PSOE",6889
52,"52001",53255,28182,27819,299,363,"PP",12309
24,"24062",142,105,105,1,0,"C's",5
24,"24113",366,282,275,3,7,"C's",35
24,"24030",4297,3226,3180,16,46,"C's",281
24,"24083",1077,764,755,4,9,"C's",51
24,"24202",8098,5654,5582,51,72,"C's",429
24,"24141",98,76,75,0,1,"C's",8
24,"24214",669,492,490,1,2,"C's",27
24,"24076",1279,972,953,7,19,"C's",131
24,"24116",424,276,273,0,3,"C's",35
24,"24159",1832,1407,1391,17,16,"C's",159
24,"24094",1392,1048,1038,11,10,"C's",118
24,"24087",645,469,466,11,3,"C's",58
24,"24182",420,289,287,6,2,"C's",34
24,"24041",548,384,381,5,3,"C's",34
24,"24189",6016,4187,4134,58,53,"C's",884
24,"24006",488,351,342,4,9,"C's",45
24,"24185",482,357,349,4,8,"C's",54
24,"24034",3419,2596,2556,27,40,"C's",264
24,"24152",462,302,301,2,1,"C's",20
24,"24226",204,138,136,0,2,"C's",10
24,"24223",2640,2012,2012,53,0,"C's",174
24,"24042",61,48,48,1,0,"C's",2
24,"24099",173,133,133,2,0,"C's",8
24,"24165",373,254,250,2,4,"C's",28
24,"24121",655,481,477,0,4,"C's",47
24,"24180",1128,825,814,12,11,"C's",110
24,"24061",1702,1244,1231,13,13,"C's",188
24,"24019",359,293,291,3,2,"C's",24
24,"24091",657,440,437,2,3,"C's",43
24,"24029",754,545,539,2,6,"C's",34
24,"24063",391,260,259,1,1,"C's",38
24,"24011",209,113,112,0,1,"C's",5
24,"24198",602,411,402,4,9,"C's",31
24,"24084",162,119,119,1,0,"C's",15
24,"24109",996,667,652,7,15,"C's",43
24,"24044",171,125,118,0,7,"C's",8
24,"24193",384,277,276,4,1,"C's",32
24,"24096",124,74,74,0,0,"C's",9
24,"24134",3465,2628,2583,27,45,"C's",216
24,"24167",763,509,504,9,5,"C's",66
24,"24127",301,239,239,3,0,"C's",26
24,"24132",628,397,390,6,7,"C's",29
24,"24228",666,455,449,2,6,"C's",55
24,"24176",318,244,243,5,1,"C's",31
24,"24114",3107,2174,2155,7,19,"C's",151
24,"24018",177,143,141,0,2,"C's",8
24,"24001",188,108,108,0,0,"C's",10
24,"24163",3929,3076,3044,49,32,"C's",604
24,"24016",478,287,285,1,2,"C's",21
24,"24081",142,97,97,0,0,"C's",8
24,"24143",514,391,379,4,12,"C's",16
24,"24164",373,190,190,1,0,"C's",25
24,"24145",655,445,443,8,2,"C's",49
24,"24137",1114,811,804,9,7,"C's",59
24,"24218",454,331,329,3,2,"C's",41
24,"24213",158,117,117,0,0,"C's",13
24,"24105",1443,1087,1065,10,22,"C's",183
24,"24082",870,692,682,10,10,"C's",66
24,"24106",258,178,173,1,5,"C's",31
24,"24005",387,267,259,6,8,"C's",15
24,"24022",342,227,227,0,0,"C's",18
24,"24110",1253,932,926,7,6,"C's",62
24,"24184",206,121,120,0,1,"C's",11
24,"24162",1671,1314,1303,21,11,"C's",197
24,"24008",9319,6964,6852,77,112,"C's",923
24,"24201",1086,765,757,5,8,"C's",87
24,"24221",790,568,558,6,10,"C's",66
24,"24123",757,499,497,4,2,"C's",26
24,"24199",433,284,281,3,3,"C's",27
24,"24197",770,545,537,6,8,"C's",57
24,"24209",2790,1907,1884,15,23,"C's",162
24,"24097",225,146,145,1,1,"C's",20
24,"24101",404,264,262,2,2,"C's",25
24,"24032",111,82,82,1,0,"C's",2
24,"24175",1825,1381,1372,13,9,"C's",246
24,"24066",504,367,361,3,6,"C's",36
24,"24205",967,714,706,9,8,"C's",81
24,"24219",527,390,387,2,3,"C's",33
24,"24095",314,246,244,1,2,"C's",31
24,"24125",475,285,282,2,3,"C's",28
24,"24079",922,654,645,9,9,"C's",86
24,"24156",243,169,169,1,0,"C's",14
24,"24173",943,678,673,3,5,"C's",71
24,"24179",299,202,201,8,1,"C's",23
24,"24086",271,200,198,1,2,"C's",14
24,"24215",156,119,118,1,1,"C's",11
24,"24070",4159,3206,3162,31,44,"C's",201
24,"24206",1732,1303,1288,8,15,"C's",108
24,"24040",453,315,309,2,6,"C's",27
24,"24060",615,361,359,0,2,"C's",39
24,"24196",2082,1529,1513,15,16,"C's",114
24,"24191",111,84,84,1,0,"C's",7
24,"24144",704,487,478,5,9,"C's",54
24,"24150",243,175,175,3,0,"C's",17
24,"24107",244,184,183,2,1,"C's",12
24,"24078",388,286,284,4,2,"C's",33
24,"24183",805,528,522,5,6,"C's",56
24,"24080",218,170,162,3,8,"C's",21
24,"24216",732,533,522,2,11,"C's",49
24,"24002",236,182,180,3,2,"C's",17
24,"24139",2186,1608,1570,24,38,"C's",161
24,"24047",782,533,527,7,6,"C's",68
24,"24038",3107,2383,2354,30,29,"C's",199
24,"24046",953,662,645,6,17,"C's",46
24,"24119",702,491,480,6,11,"C's",40
24,"24059",887,520,512,8,8,"C's",23
24,"24071",1006,747,738,9,9,"C's",57
24,"24142",25160,18503,18262,205,241,"C's",3039
24,"24021",1688,1213,1189,6,24,"C's",109
24,"24049",1493,1152,1138,8,14,"C's",83
24,"24050",102,77,77,1,0,"C's",6
24,"24108",377,279,273,3,6,"C's",15
24,"24168",461,383,379,4,4,"C's",44
24,"24077",227,195,192,1,3,"C's",19
24,"24090",348,226,224,1,2,"C's",20
24,"24053",439,303,298,2,5,"C's",30
24,"24104",266,180,179,0,1,"C's",17
24,"24230",423,329,324,2,5,"C's",28
24,"24151",492,357,357,1,0,"C's",33
24,"24190",167,115,115,2,0,"C's",9
24,"24212",1029,784,774,7,10,"C's",87
24,"24003",652,442,435,5,7,"C's",30
24,"24017",582,434,433,9,1,"C's",18
24,"24124",374,249,246,4,3,"C's",18
24,"24172",420,218,216,1,2,"C's",5
24,"24166",1413,1043,1014,7,29,"C's",99
24,"24027",1214,881,860,8,21,"C's",95
24,"24122",1351,965,948,9,17,"C's",72
24,"24194",292,230,229,1,1,"C's",16
24,"24207",296,245,241,3,4,"C's",28
24,"24068",464,343,339,5,4,"C's",22
24,"24149",155,123,121,0,2,"C's",8
24,"24188",3843,2962,2899,48,63,"C's",406
24,"24074",99,77,76,1,1,"C's",6
24,"24004",469,349,349,6,0,"C's",40
24,"24055",705,510,507,6,3,"C's",52
24,"24093",380,249,248,3,1,"C's",19
24,"24131",742,499,497,5,2,"C's",30
24,"24178",71,58,57,0,1,"C's",5
24,"24225",1020,786,773,6,13,"C's",92
24,"24010",8426,5980,5888,61,92,"C's",776
24,"24028",386,304,302,3,2,"C's",29
24,"24014",7474,5375,5321,56,54,"C's",473
24,"24169",2976,2256,2236,12,20,"C's",97
24,"24025",300,233,228,0,5,"C's",27
24,"24069",42,36,36,0,0,"C's",0
24,"24901",908,660,653,4,7,"C's",52
24,"24015",2279,1693,1658,22,35,"C's",199
24,"24100",769,569,561,4,8,"C's",72
24,"24039",2077,1604,1600,39,4,"C's",219
24,"24089",103315,77803,77038,779,765,"C's",12317
24,"24227",1617,1146,1142,14,4,"C's",164
24,"24211",276,210,206,4,4,"C's",19
24,"24031",216,169,167,1,2,"C's",15
24,"24174",495,362,357,3,5,"C's",19
24,"24133",350,259,258,3,1,"C's",23
24,"24217",136,110,109,1,1,"C's",19
24,"24148",1684,1268,1256,9,12,"C's",140
24,"24098",1205,880,874,8,6,"C's",82
24,"24210",510,347,347,0,0,"C's",25
24,"24120",345,214,214,1,0,"C's",23
24,"24224",621,452,445,7,7,"C's",29
24,"24161",291,218,212,2,6,"C's",26
24,"24102",655,495,492,2,3,"C's",41
24,"24153",233,173,172,3,1,"C's",18
24,"24902",354,273,272,2,1,"C's",16
24,"24155",478,380,371,0,9,"C's",38
24,"24181",1519,1135,1117,10,18,"C's",78
24,"24007",764,578,576,3,2,"C's",39
24,"24065",2106,1573,1545,16,28,"C's",228
24,"24112",318,207,207,0,0,"C's",16
24,"24171",364,219,217,1,2,"C's",12
24,"24009",322,161,161,1,0,"C's",11
24,"24092",809,619,609,1,10,"C's",33
24,"24222",14249,10663,10532,119,131,"C's",2063
24,"24154",1010,750,729,7,21,"C's",82
24,"24020",463,294,291,5,3,"C's",58
24,"24157",2580,2013,1983,25,30,"C's",264
24,"24052",171,109,108,0,1,"C's",9
24,"24057",1366,1103,1076,11,27,"C's",97
24,"24054",433,308,303,4,5,"C's",30
24,"24160",692,506,498,2,8,"C's",60
24,"24203",96,73,72,1,1,"C's",0
24,"24136",544,391,390,8,1,"C's",36
24,"24115",54290,39886,39486,325,400,"C's",4891
24,"24043",135,69,67,0,2,"C's",5
24,"24026",1203,908,898,19,10,"C's",102
24,"24229",427,330,324,8,6,"C's",32
24,"24118",127,84,84,1,0,"C's",8
24,"24158",323,210,207,0,3,"C's",25
24,"24187",876,642,631,6,11,"C's",67
24,"24073",481,343,340,3,3,"C's",33
24,"24033",211,154,151,1,3,"C's",17
24,"24117",446,333,331,2,2,"C's",31
24,"24024",695,496,494,4,2,"C's",45
24,"24129",122,85,85,1,0,"C's",12
24,"24036",301,181,180,0,1,"C's",15
24,"24056",2910,2102,2068,31,34,"C's",208
24,"24146",271,195,194,0,1,"C's",12
24,"24088",1037,804,797,8,7,"C's",70
24,"24130",437,319,315,1,4,"C's",53
24,"24177",481,328,327,1,1,"C's",48
24,"24051",433,308,307,1,1,"C's",22
24,"24067",645,383,379,2,4,"C's",48
24,"24170",1934,1436,1424,13,12,"C's",97
24,"24064",1525,1165,1151,10,14,"C's",131
24,"24037",369,251,251,0,0,"C's",14
24,"24023",268,189,188,2,1,"C's",18
24,"24103",292,160,160,1,0,"C's",4
24,"24012",297,212,211,4,1,"C's",33
24,"24058",205,137,134,0,3,"C's",6
47,"47166",265,203,199,3,4,"SAIn",0
47,"47197",888,693,687,10,6,"SAIn",0
47,"47110",455,363,357,3,6,"SAIn",0
47,"47132",45,37,35,0,2,"SAIn",0
47,"47134",164,126,119,4,7,"SAIn",0
47,"47177",107,78,76,0,2,"SAIn",0
47,"47057",248,194,194,2,0,"SAIn",0
47,"47070",41,32,32,1,0,"SAIn",0
47,"47040",63,52,51,1,1,"SAIn",0
47,"47044",330,291,287,0,4,"SAIn",0
47,"47191",110,74,74,0,0,"SAIn",0
47,"47047",202,157,157,3,0,"SAIn",0
47,"47151",27,22,21,0,1,"SAIn",0
47,"47125",59,43,43,1,0,"SAIn",0
47,"47038",108,82,82,0,0,"SAIn",0
47,"47104",2857,2313,2253,19,60,"SAIn",2
47,"47064",31,29,28,2,1,"SAIn",0
47,"47113",156,121,121,0,0,"SAIn",0
47,"47141",134,102,101,1,1,"SAIn",0
47,"47053",116,96,96,1,0,"SAIn",0
47,"47145",611,451,449,4,2,"SAIn",0
47,"47018",35,31,28,0,3,"SAIn",0
47,"47122",2034,1666,1635,21,31,"SAIn",0
47,"47139",1047,790,785,7,5,"SAIn",0
47,"47015",199,151,151,0,0,"SAIn",0
47,"47221",109,91,91,0,0,"SAIn",0
47,"47195",461,348,348,3,0,"SAIn",0
47,"47126",49,36,36,0,0,"SAIn",0
47,"47030",1006,785,770,10,15,"SAIn",0
47,"47162",73,61,61,0,0,"SAIn",0
47,"47225",81,61,60,2,1,"SAIn",0
47,"47099",152,128,127,1,1,"SAIn",0
47,"47054",638,501,496,6,5,"SAIn",1
47,"47031",186,145,144,1,1,"SAIn",0
47,"47106",50,41,41,0,0,"SAIn",0
47,"47170",36,30,29,2,1,"SAIn",0
47,"47048",190,140,138,0,2,"SAIn",0
47,"47114",4074,2868,2826,20,42,"SAIn",0
47,"47174",275,222,218,2,4,"SAIn",0
47,"47149",43,33,32,1,1,"SAIn",0
47,"47172",148,120,120,1,0,"SAIn",0
47,"47066",1255,1005,996,7,9,"SAIn",1
47,"47194",301,242,239,1,3,"SAIn",0
47,"47105",192,164,163,0,1,"SAIn",0
47,"47035",930,745,739,10,6,"SAIn",0
47,"47019",86,67,65,1,2,"SAIn",0
47,"47100",140,119,117,2,2,"SAIn",0
47,"47028",33,20,20,0,0,"SAIn",0
47,"47087",379,318,314,4,4,"SAIn",0
47,"47119",90,75,75,1,0,"SAIn",0
47,"47182",1342,1037,1023,16,14,"SAIn",0
47,"47097",331,268,263,1,5,"SAIn",0
47,"47045",768,586,580,0,6,"SAIn",0
47,"47080",30,22,22,0,0,"SAIn",0
47,"47168",31,28,27,0,1,"SAIn",0
47,"47003",228,180,179,3,1,"SAIn",0
47,"47041",149,124,123,2,1,"SAIn",0
47,"47205",385,281,274,7,7,"SAIn",0
47,"47061",258,216,214,2,2,"SAIn",0
47,"47220",166,124,124,1,0,"SAIn",0
47,"47161",3903,3200,3183,25,17,"SAIn",5
47,"47156",169,137,135,1,2,"SAIn",0
47,"47062",163,131,131,0,0,"SAIn",0
47,"47010",13613,10963,10895,108,68,"SAIn",7
47,"47111",1009,794,789,4,5,"SAIn",0
47,"47224",91,74,74,1,0,"SAIn",0
47,"47219",42,36,34,2,2,"SAIn",0
47,"47192",105,80,79,1,1,"SAIn",0
47,"47109",171,131,130,1,1,"SAIn",0
47,"47089",153,122,120,2,2,"SAIn",0
47,"47164",377,309,307,2,2,"SAIn",0
47,"47207",277,216,212,3,4,"SAIn",0
47,"47055",202,170,168,1,2,"SAIn",2
47,"47200",82,64,64,1,0,"SAIn",0
47,"47074",150,125,125,1,0,"SAIn",0
47,"47229",215,151,150,1,1,"SAIn",0
47,"47186",246602,193774,192412,1384,1362,"SAIn",208
47,"47093",817,654,642,9,12,"SAIn",0
47,"47124",399,329,328,4,1,"SAIn",0
47,"47049",100,78,78,1,0,"SAIn",0
47,"47184",576,463,462,2,1,"SAIn",0
47,"47020",278,230,227,1,3,"SAIn",0
47,"47158",906,686,668,3,18,"SAIn",0
47,"47001",55,51,50,2,1,"SAIn",0
47,"47138",237,180,176,1,4,"SAIn",0
47,"47050",3757,2829,2812,29,17,"SAIn",2
47,"47178",175,146,146,1,0,"SAIn",0
47,"47084",1171,911,898,15,13,"SAIn",0
47,"47009",106,80,80,1,0,"SAIn",0
47,"47196",35,26,26,1,0,"SAIn",0
47,"47121",553,436,428,5,8,"SAIn",1
47,"47204",260,199,193,2,6,"SAIn",0
47,"47012",118,95,95,0,0,"SAIn",0
47,"47199",80,59,59,2,0,"SAIn",0
47,"47091",89,67,66,0,1,"SAIn",0
47,"47188",112,85,85,0,0,"SAIn",0
47,"47029",57,48,47,1,1,"SAIn",0
47,"47117",297,219,216,4,3,"SAIn",0
47,"47017",201,161,158,3,3,"SAIn",1
47,"47176",224,139,135,5,4,"SAIn",0
47,"47079",62,51,51,0,0,"SAIn",0
47,"47033",199,154,153,3,1,"SAIn",0
47,"47228",445,359,357,4,2,"SAIn",0
47,"47212",388,322,322,3,0,"SAIn",0
47,"47127",135,98,96,1,2,"SAIn",0
47,"47208",59,38,37,3,1,"SAIn",0
47,"47068",36,27,27,0,0,"SAIn",0
47,"47051",338,274,272,0,2,"SAIn",0
47,"47098",583,488,487,6,1,"SAIn",0
47,"47159",828,654,646,0,8,"SAIn",0
47,"47088",110,87,87,0,0,"SAIn",0
47,"47085",16668,12248,12132,133,116,"SAIn",10
47,"47036",229,184,179,2,5,"SAIn",0
47,"47027",2746,2120,2095,8,25,"SAIn",1
47,"47133",2665,2140,2118,25,22,"SAIn",2
47,"47090",2418,1805,1776,17,29,"SAIn",4
47,"47147",119,91,91,0,0,"SAIn",0
47,"47143",127,99,99,0,0,"SAIn",0
47,"47023",2999,2457,2445,20,12,"SAIn",1
47,"47218",995,760,754,6,6,"SAIn",0
47,"47063",101,82,81,2,1,"SAIn",0
47,"47152",86,64,64,1,0,"SAIn",0
47,"47155",3239,2400,2374,27,26,"SAIn",0
47,"47165",6987,5301,5115,63,186,"SAIn",3
47,"47007",3748,2869,2835,24,34,"SAIn",0
47,"47008",24,18,18,0,0,"SAIn",0
47,"47183",130,105,105,0,0,"SAIn",0
47,"47198",66,47,47,0,0,"SAIn",0
47,"47067",178,126,126,3,0,"SAIn",0
47,"47130",99,78,78,1,0,"SAIn",0
47,"47004",1199,946,938,11,8,"SAIn",0
47,"47227",64,52,52,0,0,"SAIn",0
47,"47123",469,395,386,4,9,"SAIn",0
47,"47167",242,201,197,3,4,"SAIn",0
47,"47129",879,700,688,6,12,"SAIn",0
47,"47153",108,74,73,1,1,"SAIn",0
47,"47037",174,146,141,2,5,"SAIn",0
47,"47046",121,93,93,0,0,"SAIn",0
47,"47069",127,113,111,0,2,"SAIn",0
47,"47052",6584,5222,5163,41,59,"SAIn",2
47,"47160",430,334,329,5,5,"SAIn",0
47,"47021",76,65,65,1,0,"SAIn",0
47,"47026",49,40,40,0,0,"SAIn",0
47,"47112",2592,2063,2043,20,20,"SAIn",0
47,"47157",515,442,441,3,1,"SAIn",0
47,"47154",155,128,127,0,1,"SAIn",0
47,"47016",71,58,57,0,1,"SAIn",0
47,"47086",3926,3065,3028,27,37,"SAIn",1
47,"47118",161,119,118,0,1,"SAIn",2
47,"47230",302,243,241,0,2,"SAIn",1
47,"47024",262,206,205,2,1,"SAIn",0
47,"47135",84,76,76,2,0,"SAIn",0
47,"47211",49,39,37,1,2,"SAIn",0
47,"47190",93,80,78,4,2,"SAIn",0
47,"47148",439,336,335,2,1,"SAIn",0
47,"47150",278,217,214,2,3,"SAIn",0
47,"47102",286,229,224,1,5,"SAIn",0
47,"47203",67,54,54,0,0,"SAIn",1
47,"47128",60,51,49,1,2,"SAIn",0
47,"47223",158,129,125,3,4,"SAIn",0
47,"47096",135,108,107,2,1,"SAIn",0
47,"47231",4384,3457,3432,33,25,"SAIn",1
47,"47076",17375,13778,13684,111,94,"SAIn",5
47,"47131",178,132,131,3,1,"SAIn",0
47,"47071",417,348,344,2,4,"SAIn",1
47,"47082",803,641,633,5,8,"SAIn",0
47,"47115",287,238,237,4,1,"SAIn",0
47,"47005",548,426,421,4,5,"SAIn",0
47,"47171",418,333,332,9,1,"SAIn",0
47,"47078",164,129,124,1,5,"SAIn",0
47,"47210",372,289,286,1,3,"SAIn",0
47,"47094",132,103,101,1,2,"SAIn",0
47,"47185",98,79,79,0,0,"SAIn",0
47,"47213",115,83,83,0,0,"SAIn",0
47,"47217",1896,1436,1420,20,16,"SAIn",1
47,"47193",1583,1313,1294,12,19,"SAIn",0
47,"47173",883,686,675,4,11,"SAIn",0
47,"47175",6575,4991,4937,51,54,"SAIn",1
47,"47013",99,74,73,0,1,"SAIn",0
47,"47206",95,81,81,0,0,"SAIn",0
47,"47032",153,120,118,0,2,"SAIn",0
47,"47214",1420,1111,1093,9,18,"SAIn",0
47,"47179",398,299,295,3,4,"SAIn",0
47,"47075",4871,3802,3763,30,39,"SAIn",3
47,"47142",148,114,113,0,1,"SAIn",0
47,"47083",80,62,61,2,1,"SAIn",0
47,"47222",80,68,68,3,0,"SAIn",0
47,"47065",863,681,671,4,10,"SAIn",0
47,"47169",68,57,57,0,0,"SAIn",1
47,"47081",47,40,40,0,0,"SAIn",0
47,"47216",115,101,99,2,2,"SAIn",0
47,"47043",302,239,239,3,0,"SAIn",0
47,"47002",25,23,23,0,0,"SAIn",0
47,"47095",39,36,35,0,1,"SAIn",0
47,"47144",78,66,65,2,1,"SAIn",0
47,"47025",120,97,97,2,0,"SAIn",0
47,"47116",413,330,324,1,6,"SAIn",0
47,"47014",50,45,45,0,0,"SAIn",0
47,"47140",119,101,100,1,1,"SAIn",0
47,"47189",152,128,128,0,0,"SAIn",0
47,"47059",97,71,71,0,0,"SAIn",0
47,"47103",259,211,211,4,0,"SAIn",0
47,"47226",161,128,127,1,1,"SAIn",0
47,"47181",168,135,134,0,1,"SAIn",0
47,"47187",89,57,56,2,1,"SAIn",0
47,"47146",260,205,204,1,1,"SAIn",0
47,"47034",76,59,58,1,1,"SAIn",0
47,"47039",188,149,148,1,1,"SAIn",0
47,"47011",568,469,464,1,5,"SAIn",0
47,"47163",299,236,235,6,1,"SAIn",0
47,"47060",262,218,214,0,4,"SAIn",0
47,"47092",110,93,92,0,1,"SAIn",0
47,"47006",190,145,144,1,1,"SAIn",0
47,"47137",29,28,28,1,0,"SAIn",0
47,"47232",99,75,74,0,1,"SAIn",0
47,"47073",120,98,97,1,1,"SAIn",0
47,"47180",83,64,64,1,0,"SAIn",0
47,"47077",247,190,189,2,1,"SAIn",0
47,"47056",82,58,57,0,1,"SAIn",0
47,"47022",57,50,46,0,4,"SAIn",0
47,"47042",54,41,41,3,0,"SAIn",0
47,"47209",42,30,30,1,0,"SAIn",0
47,"47215",54,47,46,1,1,"SAIn",0
47,"47058",206,149,149,2,0,"SAIn",0
47,"47101",1720,1404,1388,10,16,"SAIn",0
31,"31001",90,74,74,5,0,"PSOE",5
31,"31061",56,50,50,1,0,"PSOE",6
31,"31213",105,70,70,0,0,"PSOE",3
31,"31193",1414,1103,1094,12,9,"PSOE",104
31,"31031",221,141,140,0,1,"PSOE",6
31,"31041",1583,1125,1110,14,15,"PSOE",152
31,"31011",697,494,491,5,3,"PSOE",34
31,"31092",662,458,455,4,3,"PSOE",32
31,"31183",681,581,578,10,3,"PSOE",53
31,"31214",93,70,69,0,1,"PSOE",7
31,"31173",873,704,680,3,24,"PSOE",208
31,"31093",293,210,206,2,4,"PSOE",32
31,"31184",61,43,43,2,0,"PSOE",0
31,"31245",83,54,54,1,0,"PSOE",4
31,"31235",166,111,111,0,0,"PSOE",17
31,"31246",140,108,103,2,5,"PSOE",18
31,"31012",814,579,570,4,9,"PSOE",122
31,"31032",1733,1295,1285,26,10,"PSOE",435
31,"31002",424,312,310,7,2,"PSOE",14
31,"31063",88,72,68,2,4,"PSOE",6
31,"31124",210,162,162,2,0,"PSOE",7
31,"31164",582,464,457,3,7,"PSOE",151
31,"31134",178,132,130,1,2,"PSOE",19
31,"31094",112,82,82,1,0,"PSOE",19
31,"31023",6826,5609,5591,77,18,"PSOE",563
31,"31073",315,214,212,3,2,"PSOE",14
31,"31185",501,345,342,4,3,"PSOE",16
31,"31247",152,112,109,0,3,"PSOE",4
31,"31155",253,191,189,3,2,"PSOE",56
31,"31013",661,439,437,1,2,"PSOE",39
31,"31175",72,50,49,0,1,"PSOE",8
31,"31003",124,95,95,2,0,"PSOE",10
31,"31064",1447,1161,1145,11,16,"PSOE",369
31,"31044",290,223,220,1,3,"PSOE",5
31,"31216",3882,2829,2810,31,19,"PSOE",423
31,"31128",370,265,265,2,0,"PSOE",32
31,"31186",302,211,209,2,2,"PSOE",16
31,"31125",275,194,191,2,3,"PSOE",22
31,"31108",1878,1487,1475,14,12,"PSOE",388
31,"31004",35,22,22,1,0,"PSOE",0
31,"31034",40,29,29,1,0,"PSOE",1
31,"31248",295,174,168,2,6,"PSOE",23
31,"31024",102,52,52,0,0,"PSOE",0
31,"31095",76,66,64,1,2,"PSOE",11
31,"31055",259,177,173,2,4,"PSOE",9
31,"31065",1892,1420,1396,14,24,"PSOE",370
31,"31258",7841,5961,5927,56,34,"PSOE",758
31,"31146",35,30,30,2,0,"PSOE",4
31,"31085",471,353,351,3,2,"PSOE",29
31,"31096",115,95,92,2,3,"PSOE",14
31,"31035",63,45,43,1,2,"PSOE",12
31,"31187",111,70,70,1,0,"PSOE",3
31,"31259",485,325,324,3,1,"PSOE",26
31,"31066",867,647,638,8,9,"PSOE",199
31,"31005",296,205,204,0,1,"PSOE",30
31,"31137",208,93,93,3,0,"PSOE",4
31,"31167",827,624,615,13,9,"PSOE",74
31,"31110",90,65,65,2,0,"PSOE",18
31,"31046",60,38,38,0,0,"PSOE",4
31,"31219",88,63,62,0,1,"PSOE",16
31,"31036",921,664,657,5,7,"PSOE",159
31,"31157",3546,2423,2399,32,24,"PSOE",570
31,"31097",10436,7461,7395,96,66,"PSOE",982
31,"31188",227,173,173,2,0,"PSOE",13
31,"31208",2569,2016,1992,21,24,"PSOE",699
31,"31178",495,364,364,4,0,"PSOE",116
31,"31260",1245,859,857,15,2,"PSOE",87
31,"31026",147,128,128,1,0,"PSOE",37
31,"31037",86,64,64,0,0,"PSOE",2
31,"31077",5384,4055,3999,49,56,"PSOE",917
31,"31006",1952,1423,1400,14,23,"PSOE",387
31,"31067",1938,1424,1415,15,9,"PSOE",376
31,"31098",1918,1489,1483,23,6,"PSOE",111
31,"31158",252,181,178,2,3,"PSOE",7
31,"31017",361,248,246,4,2,"PSOE",15
31,"31172",367,293,286,6,7,"PSOE",27
31,"31220",752,607,603,3,4,"PSOE",156
31,"31231",115,81,81,1,0,"PSOE",22
31,"31224",914,668,659,6,9,"PSOE",199
31,"31139",159,102,101,3,1,"PSOE",9
31,"31234",144,107,107,2,0,"PSOE",16
31,"31048",169,123,123,1,0,"PSOE",9
31,"31149",2338,1534,1525,16,9,"PSOE",73
31,"31007",136,94,93,1,1,"PSOE",7
31,"31068",2893,2172,2138,27,34,"PSOE",620
31,"31008",80,57,54,0,3,"PSOE",9
31,"31109",1562,1184,1177,6,7,"PSOE",105
31,"31160",107,81,80,0,1,"PSOE",8
31,"31190",44,36,36,1,0,"PSOE",3
31,"31129",393,265,261,2,4,"PSOE",27
31,"31099",63,52,52,1,0,"PSOE",9
31,"31038",1348,1017,1005,13,12,"PSOE",177
31,"31130",310,214,213,7,1,"PSOE",18
31,"31039",83,58,57,0,1,"PSOE",11
31,"31018",409,312,311,9,1,"PSOE",48
31,"31201",147803,110800,110079,1040,721,"PSOE",13997
31,"31222",63,41,41,5,0,"PSOE",7
31,"31022",526,344,341,3,3,"PSOE",13
31,"31181",150,116,116,0,0,"PSOE",11
31,"31253",129,112,112,0,0,"PSOE",9
31,"31043",38,30,30,0,0,"PSOE",2
31,"31100",264,186,186,2,0,"PSOE",13
31,"31120",394,264,263,5,1,"PSOE",18
31,"31131",871,664,658,13,6,"PSOE",39
31,"31029",925,662,648,6,14,"PSOE",104
31,"31009",690,508,504,5,4,"PSOE",72
31,"31191",3018,2324,2297,23,27,"PSOE",444
31,"31050",6058,3902,3850,64,52,"PSOE",287
31,"31040",194,130,128,1,2,"PSOE",9
31,"31070",2652,1907,1888,16,19,"PSOE",515
31,"31223",995,752,742,6,10,"PSOE",193
31,"31192",159,132,131,0,1,"PSOE",9
31,"31010",5721,3986,3946,27,40,"PSOE",585
31,"31182",37,27,27,0,0,"PSOE",0
31,"31101",1390,1031,1028,11,3,"PSOE",76
31,"31145",171,133,133,0,0,"PSOE",21
31,"31020",454,235,232,2,3,"PSOE",0
31,"31264",179,117,115,5,2,"PSOE",3
31,"31105",1535,1208,1187,18,21,"PSOE",308
31,"31162",47,29,27,0,2,"PSOE",5
31,"31014",274,197,197,4,0,"PSOE",13
31,"31051",253,176,176,2,0,"PSOE",44
31,"31042",2744,2081,2053,19,28,"PSOE",881
31,"31112",94,67,66,0,1,"PSOE",1
31,"31176",2856,2077,2040,33,37,"PSOE",575
31,"31072",5288,3916,3846,32,70,"PSOE",1027
31,"31021",64,42,42,0,0,"PSOE",11
31,"31163",2017,1479,1447,15,32,"PSOE",382
31,"31225",36,29,29,0,0,"PSOE",8
31,"31102",146,66,66,1,0,"PSOE",3
31,"31106",689,565,559,1,6,"PSOE",157
31,"31197",70,60,59,0,1,"PSOE",11
31,"31204",37,33,33,2,0,"PSOE",1
31,"31133",44,30,30,1,0,"PSOE",3
31,"31194",315,218,217,2,1,"PSOE",10
31,"31104",1876,1355,1338,10,17,"PSOE",358
31,"31174",110,75,73,0,2,"PSOE",9
31,"31262",206,180,180,2,0,"PSOE",7
31,"31256",109,70,70,0,0,"PSOE",2
31,"31144",804,482,479,2,3,"PSOE",20
31,"31016",7642,5866,5822,52,44,"PSOE",1097
31,"31103",46,32,32,1,0,"PSOE",3
31,"31053",532,395,391,4,4,"PSOE",82
31,"31198",36,29,29,0,0,"PSOE",1
31,"31195",180,129,128,0,1,"PSOE",6
31,"31226",585,346,344,1,2,"PSOE",31
31,"31083",56,41,39,0,2,"PSOE",1
31,"31114",362,272,269,6,3,"PSOE",31
31,"31227",8226,6191,6109,53,82,"PSOE",1065
31,"31165",2794,2057,2025,31,32,"PSOE",569
31,"31171",693,510,500,6,10,"PSOE",146
31,"31230",107,86,85,0,1,"PSOE",16
31,"31135",102,67,62,0,5,"PSOE",5
31,"31206",2095,1529,1513,19,16,"PSOE",190
31,"31115",166,108,108,2,0,"PSOE",2
31,"31142",1411,972,964,11,8,"PSOE",226
31,"31199",150,101,101,3,0,"PSOE",7
31,"31196",39,34,34,0,0,"PSOE",3
31,"31027",838,595,589,7,6,"PSOE",12
31,"31078",2447,1889,1861,25,28,"PSOE",544
31,"31241",134,94,89,0,5,"PSOE",9
31,"31136",444,320,318,6,2,"PSOE",19
31,"31045",504,397,392,9,5,"PSOE",60
31,"31239",310,223,220,5,3,"PSOE",11
31,"31076",2407,2005,1986,28,19,"PSOE",137
31,"31251",3110,2347,2327,19,20,"PSOE",469
31,"31075",101,68,67,1,1,"PSOE",3
31,"31903",6593,4699,4660,28,39,"PSOE",874
31,"31058",215,153,153,2,0,"PSOE",7
31,"31203",40,29,29,0,0,"PSOE",9
31,"31119",40,22,22,0,0,"PSOE",2
31,"31200",764,558,546,11,12,"PSOE",93
31,"31015",2001,1468,1449,18,19,"PSOE",356
31,"31086",12987,10342,10270,114,72,"PSOE",895
31,"31117",620,390,385,1,5,"PSOE",6
31,"31121",64,45,45,2,0,"PSOE",2
31,"31168",248,192,191,0,1,"PSOE",10
31,"31240",531,355,351,6,4,"PSOE",18
31,"31242",253,165,164,1,1,"PSOE",9
31,"31177",262,171,170,3,1,"PSOE",20
31,"31232",25152,18432,18220,199,212,"PSOE",3482
31,"31249",1885,1350,1331,20,19,"PSOE",534
31,"31107",1707,1303,1294,12,9,"PSOE",229
31,"31161",344,273,270,4,3,"PSOE",48
31,"31060",13723,10036,9970,78,66,"PSOE",1470
31,"31127",143,97,97,2,0,"PSOE",0
31,"31147",98,76,76,2,0,"PSOE",5
31,"31088",5574,4194,4156,46,38,"PSOE",624
31,"31169",2217,1508,1489,15,19,"PSOE",552
31,"31059",191,142,141,1,1,"PSOE",20
31,"31049",704,488,486,1,2,"PSOE",17
31,"31908",1008,709,704,11,5,"PSOE",51
31,"31057",1812,1375,1360,17,15,"PSOE",425
31,"31047",261,191,187,6,4,"PSOE",41
31,"31138",934,649,647,5,2,"PSOE",52
31,"31179",509,361,355,5,6,"PSOE",94
31,"31071",17,17,17,0,0,"PSOE",6
31,"31261",235,187,187,3,0,"PSOE",34
31,"31122",4719,3671,3654,42,17,"PSOE",382
31,"31152",1347,999,990,16,9,"PSOE",210
31,"31211",25,12,12,2,0,"PSOE",0
31,"31028",211,133,133,0,0,"PSOE",11
31,"31205",427,330,326,7,4,"PSOE",97
31,"31263",236,142,142,2,0,"PSOE",4
31,"31907",10677,8568,8523,97,45,"PSOE",928
31,"31265",86,61,61,0,0,"PSOE",4
31,"31236",1324,943,933,12,10,"PSOE",48
31,"31210",199,146,145,2,1,"PSOE",19
31,"31221",1211,844,825,4,19,"PSOE",84
31,"31159",1134,867,864,9,3,"PSOE",66
31,"31123",654,430,419,7,11,"PSOE",33
31,"31116",65,51,51,1,0,"PSOE",1
31,"31170",49,39,39,1,0,"PSOE",7
31,"31141",109,70,66,1,4,"PSOE",2
31,"31111",96,75,75,2,0,"PSOE",7
31,"31062",1088,866,853,4,13,"PSOE",290
31,"31113",137,86,85,1,1,"PSOE",12
31,"31202",4326,3045,3001,41,44,"PSOE",578
31,"31255",102,75,74,2,1,"PSOE",14
31,"31233",96,72,71,0,1,"PSOE",12
31,"31901",15475,11855,11771,121,84,"PSOE",1813
31,"31215",4649,3412,3359,35,53,"PSOE",1042
31,"31019",1809,1295,1288,23,7,"PSOE",126
31,"31154",227,127,125,3,2,"PSOE",9
31,"31118",165,122,121,2,1,"PSOE",13
31,"31151",67,48,48,1,0,"PSOE",5
31,"31054",460,308,304,7,4,"PSOE",28
31,"31257",866,657,648,8,9,"PSOE",114
31,"31252",87,68,68,0,0,"PSOE",1
31,"31030",145,107,107,3,0,"PSOE",8
31,"31052",88,65,64,0,1,"PSOE",7
31,"31902",4346,3247,3228,23,19,"PSOE",293
31,"31166",260,186,186,2,0,"PSOE",13
31,"31081",342,239,239,2,0,"PSOE",12
31,"31087",169,131,127,2,4,"PSOE",5
31,"31189",1170,739,731,10,8,"PSOE",97
31,"31074",394,301,298,5,3,"PSOE",32
31,"31132",146,115,113,1,2,"PSOE",8
31,"31237",195,156,156,1,0,"PSOE",18
31,"31025",768,560,560,5,0,"PSOE",39
31,"31238",110,96,94,2,2,"PSOE",13
31,"31243",314,236,234,5,2,"PSOE",25
31,"31079",76,53,53,0,0,"PSOE",7
31,"31033",49,29,29,1,0,"PSOE",1
31,"31056",179,137,133,0,4,"PSOE",15
31,"31229",50,40,40,0,0,"PSOE",1
31,"31090",146,81,80,3,1,"PSOE",1
31,"31207",271,194,190,0,4,"PSOE",19
31,"31244",156,87,84,1,3,"PSOE",4
31,"31906",2553,1945,1930,21,15,"PSOE",290
31,"31905",2847,2108,2093,11,15,"PSOE",437
31,"31143",98,59,58,1,1,"PSOE",5
31,"31209",157,108,108,0,0,"PSOE",7
31,"31080",510,412,411,8,1,"PSOE",66
31,"31089",242,188,185,1,3,"PSOE",21
31,"31126",357,235,232,0,3,"PSOE",18
31,"31180",216,173,173,5,0,"PSOE",20
31,"31250",2832,1921,1899,20,22,"PSOE",156
31,"31091",347,217,217,0,0,"PSOE",13
31,"31153",2172,1463,1448,10,15,"PSOE",116
31,"31084",1935,1389,1380,19,9,"PSOE",40
31,"31217",337,233,230,1,3,"PSOE",29
31,"31150",213,154,152,1,2,"PSOE",10
31,"31148",93,70,70,3,0,"PSOE",19
31,"31228",496,382,381,2,1,"PSOE",63
31,"31156",252,193,193,0,0,"PSOE",14
31,"31082",615,398,393,6,5,"PSOE",23
31,"31904",1559,1095,1084,8,11,"PSOE",149
31,"31212",151,118,118,7,0,"PSOE",21
31,"31069",847,643,636,4,7,"PSOE",113
31,"31254",1920,1473,1458,7,15,"PSOE",445
31,"31140",116,82,82,2,0,"PSOE",2
3,"3106",596,503,501,1,2,"C's",34
3,"3026",1224,970,949,6,21,"C's",112
3,"3122",42227,31379,31186,160,193,"C's",6047
3,"3003",455,393,388,3,5,"C's",30
3,"3140",26176,19795,19509,155,286,"C's",3558
3,"3039",85,61,59,0,2,"C's",4
3,"3116",1159,892,886,2,6,"C's",128
3,"3099",42365,31612,31259,220,353,"C's",4501
3,"3034",1367,1095,1079,4,16,"C's",186
3,"3085",270,226,225,1,1,"C's",23
3,"3069",3060,2187,2168,9,19,"C's",344
3,"3024",3904,3109,3060,17,49,"C's",417
3,"3046",1594,1185,1178,9,7,"C's",196
3,"3074",1706,1400,1382,3,18,"C's",250
3,"3043",2900,2516,2483,18,33,"C's",358
3,"3050",18601,13710,13610,61,100,"C's",2671
3,"3081",1433,1130,1118,5,12,"C's",118
3,"3031",41486,28059,27851,152,208,"C's",4747
3,"3066",42291,31010,30781,190,229,"C's",5252
3,"3053",7196,5800,5736,37,64,"C's",1189
3,"3037",352,296,293,3,3,"C's",40
3,"3059",20538,15653,15522,79,131,"C's",2611
3,"3097",990,817,811,8,6,"C's",78
3,"3080",1299,1065,1036,3,29,"C's",156
3,"3091",247,217,215,1,2,"C's",14
3,"3114",1568,1216,1203,8,13,"C's",130
3,"3086",153,134,134,1,0,"C's",13
3,"3090",17087,12723,12602,69,121,"C's",2404
3,"3047",9161,6622,6534,35,88,"C's",1217
3,"3119",16534,12466,12363,69,103,"C's",2306
3,"3073",236,202,202,1,0,"C's",11
3,"3005",7753,6158,6118,38,40,"C's",888
3,"3061",1057,828,816,2,12,"C's",128
3,"3105",5387,4089,4017,21,72,"C's",588
3,"3902",10213,7091,6997,52,94,"C's",1266
3,"3056",8737,6809,6731,33,78,"C's",942
3,"3123",7472,5748,5680,38,68,"C's",907
3,"3112",653,522,517,2,5,"C's",50
3,"3127",352,279,277,1,2,"C's",13
3,"3055",5168,3949,3899,13,50,"C's",662
3,"3063",26383,19376,19255,105,121,"C's",3280
3,"3100",508,446,442,1,4,"C's",46
3,"3129",1187,991,984,8,7,"C's",161
3,"3132",536,426,423,0,3,"C's",40
3,"3007",168,142,138,0,4,"C's",17
3,"3042",1367,1045,1033,5,12,"C's",159
3,"3044",4512,3639,3586,16,53,"C's",560
3,"3015",12544,9478,9388,58,90,"C's",1593
3,"3098",507,403,394,3,9,"C's",34
3,"3088",5498,4078,4030,42,48,"C's",724
3,"3016",94,79,79,0,0,"C's",6
3,"3128",4097,2972,2942,12,30,"C's",553
3,"3082",12542,8709,8597,48,112,"C's",1445
3,"3011",7729,5651,5595,29,56,"C's",1113
3,"3118",2452,1732,1714,9,18,"C's",286
3,"3094",9033,6702,6657,32,45,"C's",1457
3,"3006",497,401,393,4,8,"C's",33
3,"3032",106,90,89,1,1,"C's",8
3,"3062",213,176,175,0,1,"C's",17
3,"3107",2459,1807,1791,5,16,"C's",285
3,"3035",663,543,538,1,5,"C's",42
3,"3027",159,135,132,0,3,"C's",17
3,"3045",216,182,179,1,3,"C's",15
3,"3136",446,361,361,2,0,"C's",21
3,"3064",5040,3887,3834,16,53,"C's",654
3,"3137",653,516,515,5,1,"C's",42
3,"3001",337,289,286,3,3,"C's",22
3,"3109",2850,2301,2275,11,26,"C's",233
3,"3012",1072,862,849,3,13,"C's",117
3,"3077",1374,1139,1126,11,13,"C's",180
3,"3020",102,79,79,0,0,"C's",11
3,"3134",148,132,132,2,0,"C's",14
3,"3060",108,92,90,1,2,"C's",0
3,"3017",376,317,312,3,5,"C's",40
3,"3023",1410,1221,1201,8,20,"C's",117
3,"3135",214,176,174,0,2,"C's",4
3,"3070",2038,1526,1499,5,27,"C's",193
3,"3025",1270,1003,996,3,7,"C's",133
3,"3133",41763,26236,26039,134,197,"C's",3875
3,"3083",5607,4160,4106,36,54,"C's",582
3,"3029",242,186,183,1,3,"C's",19
3,"3018",12212,9129,9040,64,89,"C's",1301
3,"3078",486,398,397,3,1,"C's",57
3,"3075",156,139,139,0,0,"C's",20
3,"3021",5627,4691,4613,23,78,"C's",702
3,"3058",4947,4015,3978,21,37,"C's",547
3,"3096",5811,4539,4492,19,47,"C's",751
3,"3903",2482,1945,1926,16,19,"C's",313
3,"3008",167,132,131,0,1,"C's",7
3,"3054",338,274,268,4,6,"C's",18
3,"3115",248,219,219,2,0,"C's",25
3,"3125",346,263,262,0,1,"C's",24
3,"3028",1006,833,823,1,10,"C's",62
3,"3036",91,80,79,2,1,"C's",13
3,"3002",3610,2714,2682,18,32,"C's",371
3,"3049",12082,9341,9236,69,105,"C's",1214
3,"3019",15261,11921,11804,98,117,"C's",1770
3,"3102",7271,5762,5687,46,75,"C's",666
3,"3051",350,310,305,1,5,"C's",29
3,"3079",18235,14578,14388,114,190,"C's",2587
3,"3110",289,239,239,1,0,"C's",15
3,"3095",4602,3628,3605,27,23,"C's",433
3,"3065",166944,126831,126024,773,807,"C's",23134
3,"3068",46,41,40,0,1,"C's",7
3,"3124",469,400,394,5,6,"C's",16
3,"3072",351,288,287,2,1,"C's",34
3,"3014",237548,173040,172027,866,1013,"C's",32600
3,"3089",9599,7100,6980,39,120,"C's",1033
3,"3139",22357,15787,15624,101,163,"C's",2618
3,"3009",46817,36581,36258,240,323,"C's",5601
3,"3040",257,222,222,0,0,"C's",28
3,"3004",585,455,454,1,1,"C's",53
3,"3138",3154,2406,2378,10,28,"C's",384
3,"3030",513,432,424,0,8,"C's",52
3,"3084",543,478,476,4,2,"C's",48
3,"3033",113,97,97,2,0,"C's",15
3,"3904",1393,1065,1057,8,8,"C's",168
3,"3057",191,148,148,2,0,"C's",24
3,"3041",5945,4393,4344,28,49,"C's",660
3,"3104",27134,21080,20902,156,178,"C's",3818
3,"3120",2416,1814,1783,13,31,"C's",237
3,"3103",278,240,237,1,3,"C's",19
3,"3117",370,325,322,0,3,"C's",39
3,"3038",358,292,285,2,7,"C's",33
3,"3052",969,804,794,6,10,"C's",129
3,"3076",8485,6251,6194,37,57,"C's",883
3,"3101",4765,3708,3659,13,49,"C's",416
3,"3067",98,82,81,1,1,"C's",5
3,"3131",175,159,153,0,6,"C's",17
3,"3111",5411,4044,3967,14,77,"C's",566
3,"3901",1129,855,853,5,2,"C's",138
3,"3071",3980,3134,3106,28,28,"C's",385
3,"3093",19661,15155,14988,84,167,"C's",2635
3,"3121",21269,14932,14795,78,137,"C's",2760
3,"3130",47,30,30,0,0,"C's",4
3,"3113",4254,3159,3120,17,39,"C's",382
3,"3010",325,278,276,0,2,"C's",36
3,"3013",1114,914,906,5,8,"C's",100
3,"3048",4858,3785,3735,25,50,"C's",518
3,"3022",142,120,120,2,0,"C's",11
3,"3092",6749,5398,5342,40,56,"C's",769
35,"35015",9870,5451,5368,29,83,"CCa-PNC",604
35,"35021",14942,10691,10537,80,154,"CCa-PNC",188
35,"35005",1071,718,711,6,7,"CCa-PNC",9
35,"35029",4125,2545,2514,34,31,"CCa-PNC",501
35,"35020",6054,4073,4018,26,55,"CCa-PNC",169
35,"35013",6609,4997,4881,51,116,"CCa-PNC",116
35,"35033",6378,4412,4354,24,58,"CCa-PNC",97
35,"35004",38814,20869,20641,192,228,"CCa-PNC",1961
35,"35031",7270,5184,5000,36,184,"CCa-PNC",110
35,"35030",9205,5602,5501,58,101,"CCa-PNC",864
35,"35002",23129,15904,15675,74,229,"CCa-PNC",654
35,"35016",297974,198159,195935,1546,2224,"CCa-PNC",3434
35,"35017",25447,15415,15079,127,336,"CCa-PNC",1419
35,"35025",1801,1239,1216,9,23,"CCa-PNC",13
35,"35003",5125,2989,2929,21,60,"CCa-PNC",217
35,"35012",10331,5684,5610,32,74,"CCa-PNC",109
35,"35024",13621,8665,8555,76,110,"CCa-PNC",1895
35,"35006",30302,21967,21625,243,342,"CCa-PNC",907
35,"35032",3432,2541,2498,19,43,"CCa-PNC",44
35,"35011",23882,16369,16095,107,274,"CCa-PNC",632
35,"35034",7707,3921,3872,30,49,"CCa-PNC",317
35,"35007",515,332,330,2,2,"CCa-PNC",64
35,"35014",11169,6234,6107,59,127,"CCa-PNC",392
35,"35027",10311,7497,7364,58,133,"CCa-PNC",288
35,"35023",11680,8467,8295,75,172,"CCa-PNC",490
35,"35022",48059,30474,30134,219,340,"CCa-PNC",917
35,"35009",19832,14305,14036,97,269,"CCa-PNC",639
35,"35018",12463,7628,7546,56,82,"CCa-PNC",670
35,"35001",4599,3455,3396,27,59,"CCa-PNC",76
35,"35028",9705,5552,5478,64,74,"CCa-PNC",294
35,"35008",6109,4631,4542,37,89,"CCa-PNC",327
35,"35010",3548,2371,2336,20,35,"CCa-PNC",611
35,"35026",80806,53749,52665,450,1084,"CCa-PNC",2164
35,"35019",32253,19902,19621,126,281,"CCa-PNC",563
47,"47112",2592,2063,2043,20,20,"PP",1084
47,"47162",73,61,61,0,0,"PP",32
47,"47014",50,45,45,0,0,"PP",26
47,"47163",299,236,235,6,1,"PP",73
47,"47031",186,145,144,1,1,"PP",87
47,"47004",1199,946,938,11,8,"PP",367
47,"47186",246602,193774,192412,1384,1362,"PP",69558
47,"47191",110,74,74,0,0,"PP",32
47,"47063",101,82,81,2,1,"PP",42
47,"47056",82,58,57,0,1,"PP",34
47,"47049",100,78,78,1,0,"PP",42
47,"47199",80,59,59,2,0,"PP",31
47,"47030",1006,785,770,10,15,"PP",340
47,"47151",27,22,21,0,1,"PP",15
47,"47145",611,451,449,4,2,"PP",229
47,"47177",107,78,76,0,2,"PP",30
47,"47089",153,122,120,2,2,"PP",77
47,"47206",95,81,81,0,0,"PP",31
47,"47188",112,85,85,0,0,"PP",51
47,"47044",330,291,287,0,4,"PP",99
47,"47001",55,51,50,2,1,"PP",35
47,"47018",35,31,28,0,3,"PP",22
47,"47224",91,74,74,1,0,"PP",36
47,"47097",331,268,263,1,5,"PP",95
47,"47092",110,93,92,0,1,"PP",51
47,"47070",41,32,32,1,0,"PP",24
47,"47111",1009,794,789,4,5,"PP",288
47,"47036",229,184,179,2,5,"PP",79
47,"47109",171,131,130,1,1,"PP",45
47,"47165",6987,5301,5115,63,186,"PP",2411
47,"47164",377,309,307,2,2,"PP",165
47,"47209",42,30,30,1,0,"PP",10
47,"47098",583,488,487,6,1,"PP",209
47,"47137",29,28,28,1,0,"PP",18
47,"47060",262,218,214,0,4,"PP",98
47,"47142",148,114,113,0,1,"PP",57
47,"47071",417,348,344,2,4,"PP",137
47,"47146",260,205,204,1,1,"PP",55
47,"47172",148,120,120,1,0,"PP",44
47,"47121",553,436,428,5,8,"PP",174
47,"47175",6575,4991,4937,51,54,"PP",1438
47,"47135",84,76,76,2,0,"PP",35
47,"47011",568,469,464,1,5,"PP",262
47,"47200",82,64,64,1,0,"PP",39
47,"47180",83,64,64,1,0,"PP",26
47,"47085",16668,12248,12132,133,116,"PP",4377
47,"47090",2418,1805,1776,17,29,"PP",758
47,"47131",178,132,131,3,1,"PP",59
47,"47003",228,180,179,3,1,"PP",108
47,"47029",57,48,47,1,1,"PP",28
47,"47116",413,330,324,1,6,"PP",172
47,"47066",1255,1005,996,7,9,"PP",373
47,"47210",372,289,286,1,3,"PP",151
47,"47144",78,66,65,2,1,"PP",38
47,"47158",906,686,668,3,18,"PP",199
47,"47032",153,120,118,0,2,"PP",89
47,"47110",455,363,357,3,6,"PP",126
47,"47055",202,170,168,1,2,"PP",67
47,"47173",883,686,675,4,11,"PP",195
47,"47106",50,41,41,0,0,"PP",27
47,"47091",89,67,66,0,1,"PP",24
47,"47156",169,137,135,1,2,"PP",71
47,"47147",119,91,91,0,0,"PP",65
47,"47010",13613,10963,10895,108,68,"PP",3218
47,"47024",262,206,205,2,1,"PP",87
47,"47083",80,62,61,2,1,"PP",28
47,"47222",80,68,68,3,0,"PP",35
47,"47065",863,681,671,4,10,"PP",313
47,"47039",188,149,148,1,1,"PP",56
47,"47168",31,28,27,0,1,"PP",21
47,"47052",6584,5222,5163,41,59,"PP",1333
47,"47025",120,97,97,2,0,"PP",60
47,"47205",385,281,274,7,7,"PP",149
47,"47005",548,426,421,4,5,"PP",197
47,"47081",47,40,40,0,0,"PP",12
47,"47203",67,54,54,0,0,"PP",35
47,"47037",174,146,141,2,5,"PP",85
47,"47013",99,74,73,0,1,"PP",26
47,"47022",57,50,46,0,4,"PP",36
47,"47045",768,586,580,0,6,"PP",170
47,"47217",1896,1436,1420,20,16,"PP",472
47,"47115",287,238,237,4,1,"PP",139
47,"47084",1171,911,898,15,13,"PP",407
47,"47016",71,58,57,0,1,"PP",33
47,"47190",93,80,78,4,2,"PP",52
47,"47002",25,23,23,0,0,"PP",15
47,"47122",2034,1666,1635,21,31,"PP",684
47,"47128",60,51,49,1,2,"PP",41
47,"47026",49,40,40,0,0,"PP",28
47,"47113",156,121,121,0,0,"PP",52
47,"47193",1583,1313,1294,12,19,"PP",423
47,"47105",192,164,163,0,1,"PP",64
47,"47073",120,98,97,1,1,"PP",63
47,"47017",201,161,158,3,3,"PP",115
47,"47006",190,145,144,1,1,"PP",44
47,"47123",469,395,386,4,9,"PP",167
47,"47020",278,230,227,1,3,"PP",129
47,"47129",879,700,688,6,12,"PP",263
47,"47167",242,201,197,3,4,"PP",98
47,"47221",109,91,91,0,0,"PP",55
47,"47114",4074,2868,2826,20,42,"PP",1203
47,"47213",115,83,83,0,0,"PP",43
47,"47176",224,139,135,5,4,"PP",78
47,"47067",178,126,126,3,0,"PP",81
47,"47153",108,74,73,1,1,"PP",52
47,"47132",45,37,35,0,2,"PP",27
47,"47228",445,359,357,4,2,"PP",162
47,"47124",399,329,328,4,1,"PP",144
47,"47068",36,27,27,0,0,"PP",17
47,"47064",31,29,28,2,1,"PP",14
47,"47101",1720,1404,1388,10,16,"PP",513
47,"47080",30,22,22,0,0,"PP",12
47,"47028",33,20,20,0,0,"PP",15
47,"47104",2857,2313,2253,19,60,"PP",1132
47,"47197",888,693,687,10,6,"PP",345
47,"47095",39,36,35,0,1,"PP",22
47,"47048",190,140,138,0,2,"PP",79
47,"47169",68,57,57,0,0,"PP",43
47,"47078",164,129,124,1,5,"PP",68
47,"47057",248,194,194,2,0,"PP",110
47,"47149",43,33,32,1,1,"PP",12
47,"47093",817,654,642,9,12,"PP",272
47,"47099",152,128,127,1,1,"PP",75
47,"47212",388,322,322,3,0,"PP",174
47,"47043",302,239,239,3,0,"PP",118
47,"47232",99,75,74,0,1,"PP",33
47,"47040",63,52,51,1,1,"PP",34
47,"47178",175,146,146,1,0,"PP",73
47,"47218",995,760,754,6,6,"PP",210
47,"47187",89,57,56,2,1,"PP",32
47,"47134",164,126,119,4,7,"PP",61
47,"47033",199,154,153,3,1,"PP",75
47,"47102",286,229,224,1,5,"PP",101
47,"47184",576,463,462,2,1,"PP",243
47,"47179",398,299,295,3,4,"PP",131
47,"47126",49,36,36,0,0,"PP",25
47,"47230",302,243,241,0,2,"PP",112
47,"47185",98,79,79,0,0,"PP",32
47,"47161",3903,3200,3183,25,17,"PP",1488
47,"47027",2746,2120,2095,8,25,"PP",636
47,"47196",35,26,26,1,0,"PP",22
47,"47088",110,87,87,0,0,"PP",50
47,"47119",90,75,75,1,0,"PP",43
47,"47053",116,96,96,1,0,"PP",39
47,"47208",59,38,37,3,1,"PP",15
47,"47059",97,71,71,0,0,"PP",32
47,"47211",49,39,37,1,2,"PP",24
47,"47139",1047,790,785,7,5,"PP",335
47,"47127",135,98,96,1,2,"PP",50
47,"47041",149,124,123,2,1,"PP",64
47,"47159",828,654,646,0,8,"PP",252
47,"47157",515,442,441,3,1,"PP",168
47,"47154",155,128,127,0,1,"PP",63
47,"47054",638,501,496,6,5,"PP",266
47,"47183",130,105,105,0,0,"PP",61
47,"47192",105,80,79,1,1,"PP",42
47,"47214",1420,1111,1093,9,18,"PP",533
47,"47079",62,51,51,0,0,"PP",34
47,"47051",338,274,272,0,2,"PP",110
47,"47148",439,336,335,2,1,"PP",158
47,"47231",4384,3457,3432,33,25,"PP",990
47,"47198",66,47,47,0,0,"PP",28
47,"47015",199,151,151,0,0,"PP",77
47,"47181",168,135,134,0,1,"PP",57
47,"47226",161,128,127,1,1,"PP",45
47,"47195",461,348,348,3,0,"PP",98
47,"47125",59,43,43,1,0,"PP",27
47,"47023",2999,2457,2445,20,12,"PP",831
47,"47096",135,108,107,2,1,"PP",53
47,"47138",237,180,176,1,4,"PP",80
47,"47219",42,36,34,2,2,"PP",12
47,"47100",140,119,117,2,2,"PP",59
47,"47103",259,211,211,4,0,"PP",83
47,"47223",158,129,125,3,4,"PP",49
47,"47141",134,102,101,1,1,"PP",75
47,"47207",277,216,212,3,4,"PP",116
47,"47082",803,641,633,5,8,"PP",321
47,"47035",930,745,739,10,6,"PP",354
47,"47216",115,101,99,2,2,"PP",67
47,"47050",3757,2829,2812,29,17,"PP",855
47,"47227",64,52,52,0,0,"PP",22
47,"47182",1342,1037,1023,16,14,"PP",400
47,"47038",108,82,82,0,0,"PP",39
47,"47189",152,128,128,0,0,"PP",78
47,"47140",119,101,100,1,1,"PP",67
47,"47034",76,59,58,1,1,"PP",38
47,"47117",297,219,216,4,3,"PP",98
47,"47130",99,78,78,1,0,"PP",36
47,"47042",54,41,41,3,0,"PP",19
47,"47152",86,64,64,1,0,"PP",19
47,"47094",132,103,101,1,2,"PP",52
47,"47007",3748,2869,2835,24,34,"PP",790
47,"47170",36,30,29,2,1,"PP",13
47,"47160",430,334,329,5,5,"PP",165
47,"47171",418,333,332,9,1,"PP",175
47,"47225",81,61,60,2,1,"PP",36
47,"47229",215,151,150,1,1,"PP",81
47,"47069",127,113,111,0,2,"PP",56
47,"47143",127,99,99,0,0,"PP",67
47,"47021",76,65,65,1,0,"PP",27
47,"47008",24,18,18,0,0,"PP",14
47,"47019",86,67,65,1,2,"PP",41
47,"47047",202,157,157,3,0,"PP",98
47,"47204",260,199,193,2,6,"PP",102
47,"47075",4871,3802,3763,30,39,"PP",1776
47,"47062",163,131,131,0,0,"PP",98
47,"47061",258,216,214,2,2,"PP",85
47,"47087",379,318,314,4,4,"PP",124
47,"47077",247,190,189,2,1,"PP",123
47,"47012",118,95,95,0,0,"PP",51
47,"47086",3926,3065,3028,27,37,"PP",1193
47,"47074",150,125,125,1,0,"PP",37
47,"47220",166,124,124,1,0,"PP",64
47,"47150",278,217,214,2,3,"PP",100
47,"47046",121,93,93,0,0,"PP",43
47,"47076",17375,13778,13684,111,94,"PP",4095
47,"47155",3239,2400,2374,27,26,"PP",701
47,"47133",2665,2140,2118,25,22,"PP",601
47,"47009",106,80,80,1,0,"PP",35
47,"47118",161,119,118,0,1,"PP",59
47,"47215",54,47,46,1,1,"PP",27
47,"47058",206,149,149,2,0,"PP",67
47,"47166",265,203,199,3,4,"PP",106
47,"47174",275,222,218,2,4,"PP",76
47,"47194",301,242,239,1,3,"PP",71
31,"31263",236,142,142,2,0,"UPN-PP",13
31,"31154",227,127,125,3,2,"UPN-PP",21
31,"31144",804,482,479,2,3,"UPN-PP",80
31,"31053",532,395,391,4,4,"UPN-PP",131
31,"31040",194,130,128,1,2,"UPN-PP",37
31,"31229",50,40,40,0,0,"UPN-PP",13
31,"31065",1892,1420,1396,14,24,"UPN-PP",542
31,"31009",690,508,504,5,4,"UPN-PP",129
31,"31122",4719,3671,3654,42,17,"UPN-PP",760
31,"31135",102,67,62,0,5,"UPN-PP",40
31,"31008",80,57,54,0,3,"UPN-PP",24
31,"31108",1878,1487,1475,14,12,"UPN-PP",646
31,"31061",56,50,50,1,0,"UPN-PP",32
31,"31224",914,668,659,6,9,"UPN-PP",277
31,"31196",39,34,34,0,0,"UPN-PP",10
31,"31164",582,464,457,3,7,"UPN-PP",180
31,"31036",921,664,657,5,7,"UPN-PP",187
31,"31115",166,108,108,2,0,"UPN-PP",22
31,"31001",90,74,74,5,0,"UPN-PP",15
31,"31007",136,94,93,1,1,"UPN-PP",41
31,"31199",150,101,101,3,0,"UPN-PP",35
31,"31013",661,439,437,1,2,"UPN-PP",124
31,"31068",2893,2172,2138,27,34,"UPN-PP",663
31,"31046",60,38,38,0,0,"UPN-PP",26
31,"31072",5288,3916,3846,32,70,"UPN-PP",1452
31,"31907",10677,8568,8523,97,45,"UPN-PP",2053
31,"31012",814,579,570,4,9,"UPN-PP",178
31,"31044",290,223,220,1,3,"UPN-PP",40
31,"31254",1920,1473,1458,7,15,"UPN-PP",463
31,"31064",1447,1161,1145,11,16,"UPN-PP",420
31,"31206",2095,1529,1513,19,16,"UPN-PP",441
31,"31071",17,17,17,0,0,"UPN-PP",8
31,"31088",5574,4194,4156,46,38,"UPN-PP",1064
31,"31011",697,494,491,5,3,"UPN-PP",160
31,"31231",115,81,81,1,0,"UPN-PP",34
31,"31047",261,191,187,6,4,"UPN-PP",69
31,"31215",4649,3412,3359,35,53,"UPN-PP",1143
31,"31253",129,112,112,0,0,"UPN-PP",4
31,"31096",115,95,92,2,3,"UPN-PP",38
31,"31242",253,165,164,1,1,"UPN-PP",60
31,"31205",427,330,326,7,4,"UPN-PP",90
31,"31189",1170,739,731,10,8,"UPN-PP",108
31,"31197",70,60,59,0,1,"UPN-PP",14
31,"31143",98,59,58,1,1,"UPN-PP",28
31,"31078",2447,1889,1861,25,28,"UPN-PP",571
31,"31152",1347,999,990,16,9,"UPN-PP",362
31,"31179",509,361,355,5,6,"UPN-PP",129
31,"31234",144,107,107,2,0,"UPN-PP",35
31,"31169",2217,1508,1489,15,19,"UPN-PP",555
31,"31131",871,664,658,13,6,"UPN-PP",258
31,"31057",1812,1375,1360,17,15,"UPN-PP",526
31,"31226",585,346,344,1,2,"UPN-PP",43
31,"31050",6058,3902,3850,64,52,"UPN-PP",879
31,"31010",5721,3986,3946,27,40,"UPN-PP",632
31,"31070",2652,1907,1888,16,19,"UPN-PP",558
31,"31185",501,345,342,4,3,"UPN-PP",130
31,"31171",693,510,500,6,10,"UPN-PP",117
31,"31906",2553,1945,1930,21,15,"UPN-PP",404
31,"31148",93,70,70,3,0,"UPN-PP",17
31,"31227",8226,6191,6109,53,82,"UPN-PP",1284
31,"31250",2832,1921,1899,20,22,"UPN-PP",227
31,"31233",96,72,71,0,1,"UPN-PP",36
31,"31051",253,176,176,2,0,"UPN-PP",53
31,"31177",262,171,170,3,1,"UPN-PP",51
31,"31198",36,29,29,0,0,"UPN-PP",4
31,"31041",1583,1125,1110,14,15,"UPN-PP",272
31,"31110",90,65,65,2,0,"UPN-PP",15
31,"31240",531,355,351,6,4,"UPN-PP",32
31,"31091",347,217,217,0,0,"UPN-PP",24
31,"31244",156,87,84,1,3,"UPN-PP",16
31,"31034",40,29,29,1,0,"UPN-PP",5
31,"31062",1088,866,853,4,13,"UPN-PP",264
31,"31098",1918,1489,1483,23,6,"UPN-PP",385
31,"31118",165,122,121,2,1,"UPN-PP",24
31,"31213",105,70,70,0,0,"UPN-PP",7
31,"31138",934,649,647,5,2,"UPN-PP",68
31,"31182",37,27,27,0,0,"UPN-PP",8
31,"31151",67,48,48,1,0,"UPN-PP",18
31,"31120",394,264,263,5,1,"UPN-PP",82
31,"31073",315,214,212,3,2,"UPN-PP",32
31,"31113",137,86,85,1,1,"UPN-PP",30
31,"31063",88,72,68,2,4,"UPN-PP",32
31,"31028",211,133,133,0,0,"UPN-PP",30
31,"31031",221,141,140,0,1,"UPN-PP",23
31,"31077",5384,4055,3999,49,56,"UPN-PP",1525
31,"31094",112,82,82,1,0,"UPN-PP",45
31,"31228",496,382,381,2,1,"UPN-PP",93
31,"31067",1938,1424,1415,15,9,"UPN-PP",447
31,"31241",134,94,89,0,5,"UPN-PP",33
31,"31157",3546,2423,2399,32,24,"UPN-PP",813
31,"31052",88,65,64,0,1,"UPN-PP",21
31,"31172",367,293,286,6,7,"UPN-PP",100
31,"31033",49,29,29,1,0,"UPN-PP",7
31,"31128",370,265,265,2,0,"UPN-PP",71
31,"31264",179,117,115,5,2,"UPN-PP",20
31,"31006",1952,1423,1400,14,23,"UPN-PP",497
31,"31104",1876,1355,1338,10,17,"UPN-PP",404
31,"31902",4346,3247,3228,23,19,"UPN-PP",749
31,"31112",94,67,66,0,1,"UPN-PP",19
31,"31173",873,704,680,3,24,"UPN-PP",313
31,"31142",1411,972,964,11,8,"UPN-PP",355
31,"31239",310,223,220,5,3,"UPN-PP",72
31,"31236",1324,943,933,12,10,"UPN-PP",289
31,"31237",195,156,156,1,0,"UPN-PP",64
31,"31032",1733,1295,1285,26,10,"UPN-PP",383
31,"31004",35,22,22,1,0,"UPN-PP",10
31,"31125",275,194,191,2,3,"UPN-PP",66
31,"31035",63,45,43,1,2,"UPN-PP",17
31,"31257",866,657,648,8,9,"UPN-PP",176
31,"31054",460,308,304,7,4,"UPN-PP",52
31,"31079",76,53,53,0,0,"UPN-PP",22
31,"31191",3018,2324,2297,23,27,"UPN-PP",660
31,"31114",362,272,269,6,3,"UPN-PP",60
31,"31249",1885,1350,1331,20,19,"UPN-PP",379
31,"31134",178,132,130,1,2,"UPN-PP",44
31,"31020",454,235,232,2,3,"UPN-PP",12
31,"31136",444,320,318,6,2,"UPN-PP",64
31,"31905",2847,2108,2093,11,15,"UPN-PP",465
31,"31109",1562,1184,1177,6,7,"UPN-PP",340
31,"31039",83,58,57,0,1,"UPN-PP",13
31,"31140",116,82,82,2,0,"UPN-PP",26
31,"31219",88,63,62,0,1,"UPN-PP",25
31,"31014",274,197,197,4,0,"UPN-PP",77
31,"31103",46,32,32,1,0,"UPN-PP",21
31,"31209",157,108,108,0,0,"UPN-PP",29
31,"31058",215,153,153,2,0,"UPN-PP",41
31,"31107",1707,1303,1294,12,9,"UPN-PP",753
31,"31251",3110,2347,2327,19,20,"UPN-PP",702
31,"31222",63,41,41,5,0,"UPN-PP",4
31,"31230",107,86,85,0,1,"UPN-PP",31
31,"31904",1559,1095,1084,8,11,"UPN-PP",206
31,"31195",180,129,128,0,1,"UPN-PP",26
31,"31181",150,116,116,0,0,"UPN-PP",37
31,"31162",47,29,27,0,2,"UPN-PP",6
31,"31216",3882,2829,2810,31,19,"UPN-PP",840
31,"31211",25,12,12,2,0,"UPN-PP",8
31,"31261",235,187,187,3,0,"UPN-PP",58
31,"31105",1535,1208,1187,18,21,"UPN-PP",564
31,"31023",6826,5609,5591,77,18,"UPN-PP",1711
31,"31021",64,42,42,0,0,"UPN-PP",9
31,"31183",681,581,578,10,3,"UPN-PP",196
31,"31168",248,192,191,0,1,"UPN-PP",76
31,"31017",361,248,246,4,2,"UPN-PP",58
31,"31208",2569,2016,1992,21,24,"UPN-PP",502
31,"31262",206,180,180,2,0,"UPN-PP",45
31,"31186",302,211,209,2,2,"UPN-PP",38
31,"31038",1348,1017,1005,13,12,"UPN-PP",352
31,"31139",159,102,101,3,1,"UPN-PP",38
31,"31027",838,595,589,7,6,"UPN-PP",46
31,"31119",40,22,22,0,0,"UPN-PP",7
31,"31026",147,128,128,1,0,"UPN-PP",43
31,"31145",171,133,133,0,0,"UPN-PP",78
31,"31147",98,76,76,2,0,"UPN-PP",30
31,"31043",38,30,30,0,0,"UPN-PP",12
31,"31220",752,607,603,3,4,"UPN-PP",249
31,"31025",768,560,560,5,0,"UPN-PP",143
31,"31049",704,488,486,1,2,"UPN-PP",76
31,"31141",109,70,66,1,4,"UPN-PP",33
31,"31235",166,111,111,0,0,"UPN-PP",26
31,"31256",109,70,70,0,0,"UPN-PP",14
31,"31165",2794,2057,2025,31,32,"UPN-PP",710
31,"31069",847,643,636,4,7,"UPN-PP",257
31,"31101",1390,1031,1028,11,3,"UPN-PP",282
31,"31155",253,191,189,3,2,"UPN-PP",52
31,"31048",169,123,123,1,0,"UPN-PP",79
31,"31123",654,430,419,7,11,"UPN-PP",95
31,"31153",2172,1463,1448,10,15,"UPN-PP",138
31,"31045",504,397,392,9,5,"UPN-PP",93
31,"31016",7642,5866,5822,52,44,"UPN-PP",662
31,"31066",867,647,638,8,9,"UPN-PP",248
31,"31130",310,214,213,7,1,"UPN-PP",52
31,"31117",620,390,385,1,5,"UPN-PP",11
31,"31247",152,112,109,0,3,"UPN-PP",34
31,"31156",252,193,193,0,0,"UPN-PP",41
31,"31074",394,301,298,5,3,"UPN-PP",60
31,"31214",93,70,69,0,1,"UPN-PP",14
31,"31203",40,29,29,0,0,"UPN-PP",11
31,"31097",10436,7461,7395,96,66,"UPN-PP",2393
31,"31188",227,173,173,2,0,"UPN-PP",49
31,"31080",510,412,411,8,1,"UPN-PP",122
31,"31090",146,81,80,3,1,"UPN-PP",18
31,"31193",1414,1103,1094,12,9,"UPN-PP",295
31,"31187",111,70,70,1,0,"UPN-PP",7
31,"31030",145,107,107,3,0,"UPN-PP",21
31,"31093",293,210,206,2,4,"UPN-PP",46
31,"31174",110,75,73,0,2,"UPN-PP",26
31,"31022",526,344,341,3,3,"UPN-PP",21
31,"31255",102,75,74,2,1,"UPN-PP",30
31,"31178",495,364,364,4,0,"UPN-PP",112
31,"31158",252,181,178,2,3,"UPN-PP",55
31,"31037",86,64,64,0,0,"UPN-PP",2
31,"31085",471,353,351,3,2,"UPN-PP",41
31,"31116",65,51,51,1,0,"UPN-PP",32
31,"31166",260,186,186,2,0,"UPN-PP",89
31,"31167",827,624,615,13,9,"UPN-PP",196
31,"31127",143,97,97,2,0,"UPN-PP",31
31,"31204",37,33,33,2,0,"UPN-PP",20
31,"31003",124,95,95,2,0,"UPN-PP",16
31,"31212",151,118,118,7,0,"UPN-PP",58
31,"31111",96,75,75,2,0,"UPN-PP",15
31,"31202",4326,3045,3001,41,44,"UPN-PP",1127
31,"31908",1008,709,704,11,5,"UPN-PP",95
31,"31129",393,265,261,2,4,"UPN-PP",13
31,"31126",357,235,232,0,3,"UPN-PP",42
31,"31190",44,36,36,1,0,"UPN-PP",14
31,"31002",424,312,310,7,2,"UPN-PP",107
31,"31194",315,218,217,2,1,"UPN-PP",52
31,"31252",87,68,68,0,0,"UPN-PP",23
31,"31210",199,146,145,2,1,"UPN-PP",47
31,"31223",995,752,742,6,10,"UPN-PP",209
31,"31055",259,177,173,2,4,"UPN-PP",19
31,"31018",409,312,311,9,1,"UPN-PP",93
31,"31150",213,154,152,1,2,"UPN-PP",26
31,"31184",61,43,43,2,0,"UPN-PP",18
31,"31170",49,39,39,1,0,"UPN-PP",11
31,"31081",342,239,239,2,0,"UPN-PP",30
31,"31163",2017,1479,1447,15,32,"UPN-PP",543
31,"31029",925,662,648,6,14,"UPN-PP",263
31,"31159",1134,867,864,9,3,"UPN-PP",284
31,"31099",63,52,52,1,0,"UPN-PP",23
31,"31161",344,273,270,4,3,"UPN-PP",50
31,"31060",13723,10036,9970,78,66,"UPN-PP",2145
31,"31075",101,68,67,1,1,"UPN-PP",12
31,"31137",208,93,93,3,0,"UPN-PP",21
31,"31087",169,131,127,2,4,"UPN-PP",22
31,"31121",64,45,45,2,0,"UPN-PP",16
31,"31175",72,50,49,0,1,"UPN-PP",22
31,"31243",314,236,234,5,2,"UPN-PP",57
31,"31124",210,162,162,2,0,"UPN-PP",79
31,"31092",662,458,455,4,3,"UPN-PP",127
31,"31133",44,30,30,1,0,"UPN-PP",5
31,"31201",147803,110800,110079,1040,721,"UPN-PP",35033
31,"31005",296,205,204,0,1,"UPN-PP",72
31,"31059",191,142,141,1,1,"UPN-PP",32
31,"31207",271,194,190,0,4,"UPN-PP",48
31,"31245",83,54,54,1,0,"UPN-PP",24
31,"31217",337,233,230,1,3,"UPN-PP",102
31,"31083",56,41,39,0,2,"UPN-PP",13
31,"31106",689,565,559,1,6,"UPN-PP",194
31,"31095",76,66,64,1,2,"UPN-PP",10
31,"31221",1211,844,825,4,19,"UPN-PP",166
31,"31132",146,115,113,1,2,"UPN-PP",40
31,"31160",107,81,80,0,1,"UPN-PP",32
31,"31192",159,132,131,0,1,"UPN-PP",34
31,"31102",146,66,66,1,0,"UPN-PP",11
31,"31076",2407,2005,1986,28,19,"UPN-PP",988
31,"31019",1809,1295,1288,23,7,"UPN-PP",227
31,"31225",36,29,29,0,0,"UPN-PP",9
31,"31084",1935,1389,1380,19,9,"UPN-PP",162
31,"31260",1245,859,857,15,2,"UPN-PP",287
31,"31089",242,188,185,1,3,"UPN-PP",83
31,"31258",7841,5961,5927,56,34,"UPN-PP",1034
31,"31086",12987,10342,10270,114,72,"UPN-PP",2807
31,"31901",15475,11855,11771,121,84,"UPN-PP",3019
31,"31232",25152,18432,18220,199,212,"UPN-PP",5983
31,"31246",140,108,103,2,5,"UPN-PP",29
31,"31100",264,186,186,2,0,"UPN-PP",82
31,"31259",485,325,324,3,1,"UPN-PP",41
31,"31176",2856,2077,2040,33,37,"UPN-PP",628
31,"31146",35,30,30,2,0,"UPN-PP",17
31,"31149",2338,1534,1525,16,9,"UPN-PP",161
31,"31015",2001,1468,1449,18,19,"UPN-PP",510
31,"31056",179,137,133,0,4,"UPN-PP",44
31,"31248",295,174,168,2,6,"UPN-PP",53
31,"31903",6593,4699,4660,28,39,"UPN-PP",744
31,"31180",216,173,173,5,0,"UPN-PP",65
31,"31238",110,96,94,2,2,"UPN-PP",14
31,"31200",764,558,546,11,12,"UPN-PP",109
31,"31082",615,398,393,6,5,"UPN-PP",55
31,"31265",86,61,61,0,0,"UPN-PP",11
31,"31024",102,52,52,0,0,"UPN-PP",5
31,"31042",2744,2081,2053,19,28,"UPN-PP",705
18,"18035",1255,964,958,4,6,"PP",385
18,"18120",270,218,216,2,2,"PP",46
18,"18126",1497,1094,1087,7,7,"PP",173
18,"18161",220,184,184,1,0,"PP",65
18,"18018",640,490,488,0,2,"PP",138
18,"18047",5888,4028,4000,32,28,"PP",1011
18,"18032",239,178,175,0,3,"PP",73
18,"18114",634,457,452,2,5,"PP",123
18,"18177",427,259,258,3,1,"PP",118
18,"18119",1729,1353,1340,13,13,"PP",446
18,"18015",443,338,337,0,1,"PP",110
18,"18171",2123,1640,1616,14,24,"PP",320
18,"18071",5583,4221,4176,33,45,"PP",964
18,"18168",809,589,588,5,1,"PP",169
18,"18034",510,391,391,1,0,"PP",93
18,"18914",1658,1304,1290,8,14,"PP",224
18,"18074",273,217,213,2,4,"PP",83
18,"18159",1009,811,802,3,9,"PP",119
18,"18157",1123,836,823,8,13,"PP",287
18,"18167",1897,1321,1313,8,8,"PP",376
18,"18152",938,687,681,1,6,"PP",110
18,"18023",15738,11242,11146,92,96,"PP",3667
18,"18065",625,503,500,1,3,"PP",38
18,"18029",1833,1252,1243,9,9,"PP",273
18,"18100",7769,5715,5637,57,78,"PP",1384
18,"18054",868,630,627,2,3,"PP",246
18,"18072",666,481,474,4,7,"PP",109
18,"18158",8408,5604,5542,38,62,"PP",990
18,"18053",1667,1084,1078,9,6,"PP",331
18,"18083",266,210,207,1,3,"PP",82
18,"18163",324,239,235,1,4,"PP",92
18,"18085",729,489,484,2,5,"PP",152
18,"18012",2330,1670,1660,15,10,"PP",653
18,"18037",530,411,408,1,3,"PP",152
18,"18095",1959,1486,1474,5,12,"PP",359
18,"18109",599,421,419,2,2,"PP",181
18,"18187",561,418,417,1,1,"PP",84
18,"18069",493,366,363,3,3,"PP",127
18,"18154",1016,716,716,2,0,"PP",311
18,"18178",743,571,571,2,0,"PP",199
18,"18141",414,282,277,1,5,"PP",184
18,"18134",5811,4002,3946,25,56,"PP",1206
18,"18173",8978,6319,6251,50,68,"PP",1578
18,"18028",945,790,781,2,9,"PP",333
18,"18040",225,142,141,0,1,"PP",38
18,"18911",7392,5359,5301,44,58,"PP",1361
18,"18912",1488,1021,1007,7,14,"PP",235
18,"18123",293,228,227,2,1,"PP",66
18,"18076",815,577,576,0,1,"PP",131
18,"18101",9263,6971,6912,55,59,"PP",2132
18,"18174",442,354,348,2,6,"PP",128
18,"18096",342,260,259,1,1,"PP",72
18,"18179",546,378,377,1,1,"PP",141
18,"18147",3734,2416,2386,10,30,"PP",638
18,"18044",179,116,116,0,0,"PP",40
18,"18003",14022,10417,10330,82,87,"PP",2925
18,"18192",1529,1216,1208,3,8,"PP",359
18,"18133",2187,1731,1722,7,9,"PP",802
18,"18049",617,456,451,3,5,"PP",141
18,"18153",8580,6314,6260,39,54,"PP",1638
18,"18904",779,570,565,1,5,"PP",143
18,"18905",14500,10137,10058,82,79,"PP",2459
18,"18006",4161,2816,2788,29,28,"PP",1093
18,"18143",979,781,776,2,5,"PP",144
18,"18088",1556,1113,1108,5,5,"PP",209
18,"18182",1919,1356,1347,3,9,"PP",404
18,"18048",2390,1824,1806,8,18,"PP",326
18,"18136",1875,1477,1470,7,7,"PP",316
18,"18013",4236,3108,3052,19,56,"PP",1119
18,"18906",917,681,673,2,8,"PP",300
18,"18057",5263,3968,3937,33,31,"PP",1077
18,"18025",294,216,214,0,2,"PP",52
18,"18043",129,95,95,0,0,"PP",39
18,"18062",10298,7584,7512,67,72,"PP",2141
18,"18903",892,650,645,1,5,"PP",248
18,"18051",1149,825,823,7,2,"PP",213
18,"18184",2158,1659,1634,4,25,"PP",453
18,"18121",132,101,100,1,1,"PP",32
18,"18024",855,660,653,8,7,"PP",193
18,"18189",772,599,595,7,4,"PP",169
18,"18144",782,596,588,3,8,"PP",185
18,"18188",1642,1249,1234,8,15,"PP",329
18,"18132",3312,2582,2556,14,26,"PP",422
18,"18098",6167,4367,4342,22,25,"PP",1360
18,"18145",10432,7829,7767,56,62,"PP",2533
18,"18907",1859,1482,1475,5,7,"PP",535
18,"18039",3544,2544,2511,34,33,"PP",729
18,"18111",2743,2046,2033,14,13,"PP",454
18,"18002",561,446,444,1,2,"PP",98
18,"18042",414,342,341,0,1,"PP",100
18,"18004",724,511,505,3,6,"PP",232
18,"18089",15132,10489,10402,64,87,"PP",3741
18,"18046",1867,1225,1215,8,10,"PP",376
18,"18087",184873,138280,137516,836,764,"PP",52715
18,"18185",556,461,461,1,0,"PP",160
18,"18107",971,719,711,6,8,"PP",199
18,"18103",760,596,593,6,3,"PP",202
18,"18078",739,593,590,4,3,"PP",153
18,"18112",131,88,86,1,2,"PP",29
18,"18117",513,402,396,4,6,"PP",101
18,"18901",512,359,357,1,2,"PP",122
18,"18122",16171,11670,11508,106,162,"PP",3742
18,"18194",2152,1487,1477,6,10,"PP",307
18,"18082",867,626,621,4,5,"PP",222
18,"18045",1149,803,789,10,14,"PP",199
18,"18059",4153,3074,3039,23,35,"PP",659
18,"18170",336,227,225,1,2,"PP",59
18,"18001",256,178,177,2,1,"PP",56
18,"18193",14194,10280,10196,91,84,"PP",2893
18,"18115",2548,1872,1854,16,18,"PP",425
18,"18148",819,671,666,1,5,"PP",272
18,"18108",858,672,667,0,5,"PP",217
18,"18038",1066,836,826,2,10,"PP",214
18,"18151",260,196,196,0,0,"PP",33
18,"18030",584,428,426,3,2,"PP",140
18,"18909",589,462,459,0,3,"PP",186
18,"18102",8424,5783,5716,41,67,"PP",1256
18,"18050",1711,1271,1256,5,15,"PP",338
18,"18017",18172,12077,11954,101,123,"PP",4302
18,"18149",5177,3946,3902,29,44,"PP",1411
18,"18137",1005,758,758,6,0,"PP",347
18,"18063",1191,770,767,6,3,"PP",238
18,"18033",294,220,219,1,1,"PP",72
18,"18084",4215,3179,3143,24,36,"PP",1034
18,"18011",4321,3136,3119,10,17,"PP",922
18,"18067",711,517,516,0,1,"PP",177
18,"18068",1566,1234,1214,5,20,"PP",402
18,"18116",2882,2245,2215,19,30,"PP",799
18,"18175",11624,8549,8467,41,82,"PP",2471
18,"18180",631,448,447,2,1,"PP",61
18,"18056",3545,2716,2687,25,29,"PP",730
18,"18010",563,463,459,4,4,"PP",100
18,"18099",1581,1271,1249,10,22,"PP",326
18,"18124",393,274,271,1,3,"PP",152
18,"18064",379,308,308,1,0,"PP",116
18,"18061",1059,822,816,1,6,"PP",315
18,"18162",951,744,734,0,10,"PP",296
18,"18066",2108,1546,1540,4,6,"PP",295
18,"18020",1469,1046,1032,7,14,"PP",308
18,"18127",16586,11998,11897,97,101,"PP",2632
18,"18150",6730,4858,4814,28,44,"PP",1283
18,"18005",375,266,265,2,1,"PP",38
18,"18016",323,239,237,0,2,"PP",75
18,"18165",4135,2944,2915,23,29,"PP",603
18,"18908",805,633,620,2,13,"PP",154
18,"18105",4548,3169,3139,19,30,"PP",625
18,"18014",6372,4620,4566,44,54,"PP",1333
18,"18086",355,285,283,0,2,"PP",35
18,"18183",660,468,465,3,3,"PP",168
18,"18902",847,680,674,10,6,"PP",192
18,"18181",223,159,157,0,2,"PP",122
18,"18140",43567,29155,28932,194,223,"PP",8749
18,"18027",2562,1846,1827,19,19,"PP",328
18,"18097",956,703,691,1,12,"PP",219
18,"18021",17451,12420,12305,101,115,"PP",3345
18,"18093",2752,1873,1858,10,15,"PP",659
18,"18176",258,179,178,3,1,"PP",19
18,"18094",2389,1853,1832,22,21,"PP",739
18,"18007",785,527,523,3,4,"PP",125
18,"18910",803,573,569,5,4,"PP",223
18,"18128",344,251,248,0,3,"PP",103
18,"18146",970,734,727,6,7,"PP",215
18,"18079",3465,2671,2645,16,26,"PP",368
18,"18138",2482,1721,1712,8,9,"PP",311
18,"18164",1831,1273,1260,11,13,"PP",498
18,"18135",4583,3045,2998,14,47,"PP",800
18,"18022",13306,9165,9091,51,74,"PP",1874
18,"18036",3768,2904,2882,18,22,"PP",1065
18,"18913",818,617,603,2,14,"PP",321
18,"18070",283,223,218,0,5,"PP",80
18,"18089",15132,10489,10402,64,87,"PCPE",7
18,"18069",493,366,363,3,3,"PCPE",2
18,"18012",2330,1670,1660,15,10,"PCPE",4
18,"18175",11624,8549,8467,41,82,"PCPE",7
18,"18906",917,681,673,2,8,"PCPE",2
18,"18083",266,210,207,1,3,"PCPE",0
18,"18105",4548,3169,3139,19,30,"PCPE",6
18,"18064",379,308,308,1,0,"PCPE",0
18,"18910",803,573,569,5,4,"PCPE",1
18,"18035",1255,964,958,4,6,"PCPE",1
18,"18068",1566,1234,1214,5,20,"PCPE",1
18,"18168",809,589,588,5,1,"PCPE",1
18,"18045",1149,803,789,10,14,"PCPE",0
18,"18904",779,570,565,1,5,"PCPE",1
18,"18159",1009,811,802,3,9,"PCPE",1
18,"18028",945,790,781,2,9,"PCPE",0
18,"18116",2882,2245,2215,19,30,"PCPE",3
18,"18114",634,457,452,2,5,"PCPE",1
18,"18063",1191,770,767,6,3,"PCPE",1
18,"18194",2152,1487,1477,6,10,"PCPE",1
18,"18094",2389,1853,1832,22,21,"PCPE",3
18,"18006",4161,2816,2788,29,28,"PCPE",3
18,"18042",414,342,341,0,1,"PCPE",0
18,"18161",220,184,184,1,0,"PCPE",0
18,"18067",711,517,516,0,1,"PCPE",0
18,"18903",892,650,645,1,5,"PCPE",1
18,"18189",772,599,595,7,4,"PCPE",1
18,"18072",666,481,474,4,7,"PCPE",0
18,"18164",1831,1273,1260,11,13,"PCPE",3
18,"18170",336,227,225,1,2,"PCPE",0
18,"18121",132,101,100,1,1,"PCPE",1
18,"18908",805,633,620,2,13,"PCPE",2
18,"18098",6167,4367,4342,22,25,"PCPE",4
18,"18167",1897,1321,1313,8,8,"PCPE",3
18,"18187",561,418,417,1,1,"PCPE",1
18,"18136",1875,1477,1470,7,7,"PCPE",3
18,"18184",2158,1659,1634,4,25,"PCPE",2
18,"18901",512,359,357,1,2,"PCPE",1
18,"18140",43567,29155,28932,194,223,"PCPE",32
18,"18084",4215,3179,3143,24,36,"PCPE",0
18,"18193",14194,10280,10196,91,84,"PCPE",13
18,"18119",1729,1353,1340,13,13,"PCPE",2
18,"18157",1123,836,823,8,13,"PCPE",1
18,"18066",2108,1546,1540,4,6,"PCPE",10
18,"18154",1016,716,716,2,0,"PCPE",0
18,"18913",818,617,603,2,14,"PCPE",0
18,"18096",342,260,259,1,1,"PCPE",0
18,"18144",782,596,588,3,8,"PCPE",0
18,"18030",584,428,426,3,2,"PCPE",4
18,"18112",131,88,86,1,2,"PCPE",0
18,"18047",5888,4028,4000,32,28,"PCPE",8
18,"18102",8424,5783,5716,41,67,"PCPE",19
18,"18022",13306,9165,9091,51,74,"PCPE",16
18,"18188",1642,1249,1234,8,15,"PCPE",0
18,"18176",258,179,178,3,1,"PCPE",0
18,"18173",8978,6319,6251,50,68,"PCPE",9
18,"18141",414,282,277,1,5,"PCPE",2
18,"18097",956,703,691,1,12,"PCPE",1
18,"18163",324,239,235,1,4,"PCPE",0
18,"18174",442,354,348,2,6,"PCPE",0
18,"18185",556,461,461,1,0,"PCPE",0
18,"18101",9263,6971,6912,55,59,"PCPE",12
18,"18117",513,402,396,4,6,"PCPE",1
18,"18048",2390,1824,1806,8,18,"PCPE",4
18,"18086",355,285,283,0,2,"PCPE",0
18,"18120",270,218,216,2,2,"PCPE",0
18,"18153",8580,6314,6260,39,54,"PCPE",9
18,"18192",1529,1216,1208,3,8,"PCPE",2
18,"18912",1488,1021,1007,7,14,"PCPE",0
18,"18133",2187,1731,1722,7,9,"PCPE",1
18,"18182",1919,1356,1347,3,9,"PCPE",2
18,"18143",979,781,776,2,5,"PCPE",1
18,"18013",4236,3108,3052,19,56,"PCPE",7
18,"18056",3545,2716,2687,25,29,"PCPE",9
18,"18095",1959,1486,1474,5,12,"PCPE",1
18,"18050",1711,1271,1256,5,15,"PCPE",2
18,"18181",223,159,157,0,2,"PCPE",0
18,"18178",743,571,571,2,0,"PCPE",2
18,"18078",739,593,590,4,3,"PCPE",0
18,"18017",18172,12077,11954,101,123,"PCPE",8
18,"18085",729,489,484,2,5,"PCPE",0
18,"18004",724,511,505,3,6,"PCPE",0
18,"18059",4153,3074,3039,23,35,"PCPE",9
18,"18027",2562,1846,1827,19,19,"PCPE",1
18,"18171",2123,1640,1616,14,24,"PCPE",1
18,"18044",179,116,116,0,0,"PCPE",1
18,"18051",1149,825,823,7,2,"PCPE",0
18,"18011",4321,3136,3119,10,17,"PCPE",4
18,"18180",631,448,447,2,1,"PCPE",0
18,"18132",3312,2582,2556,14,26,"PCPE",3
18,"18179",546,378,377,1,1,"PCPE",0
18,"18023",15738,11242,11146,92,96,"PCPE",29
18,"18152",938,687,681,1,6,"PCPE",1
18,"18036",3768,2904,2882,18,22,"PCPE",3
18,"18016",323,239,237,0,2,"PCPE",0
18,"18150",6730,4858,4814,28,44,"PCPE",7
18,"18158",8408,5604,5542,38,62,"PCPE",8
18,"18015",443,338,337,0,1,"PCPE",0
18,"18071",5583,4221,4176,33,45,"PCPE",13
18,"18149",5177,3946,3902,29,44,"PCPE",5
18,"18177",427,259,258,3,1,"PCPE",0
18,"18049",617,456,451,3,5,"PCPE",0
18,"18054",868,630,627,2,3,"PCPE",0
18,"18032",239,178,175,0,3,"PCPE",0
18,"18126",1497,1094,1087,7,7,"PCPE",1
18,"18029",1833,1252,1243,9,9,"PCPE",1
18,"18905",14500,10137,10058,82,79,"PCPE",8
18,"18124",393,274,271,1,3,"PCPE",1
18,"18146",970,734,727,6,7,"PCPE",4
18,"18037",530,411,408,1,3,"PCPE",0
18,"18127",16586,11998,11897,97,101,"PCPE",28
18,"18108",858,672,667,0,5,"PCPE",0
18,"18043",129,95,95,0,0,"PCPE",0
18,"18079",3465,2671,2645,16,26,"PCPE",10
18,"18007",785,527,523,3,4,"PCPE",1
18,"18103",760,596,593,6,3,"PCPE",0
18,"18033",294,220,219,1,1,"PCPE",0
18,"18907",1859,1482,1475,5,7,"PCPE",1
18,"18074",273,217,213,2,4,"PCPE",0
18,"18123",293,228,227,2,1,"PCPE",1
18,"18165",4135,2944,2915,23,29,"PCPE",2
18,"18914",1658,1304,1290,8,14,"PCPE",4
18,"18100",7769,5715,5637,57,78,"PCPE",17
18,"18002",561,446,444,1,2,"PCPE",0
18,"18151",260,196,196,0,0,"PCPE",0
18,"18183",660,468,465,3,3,"PCPE",0
18,"18024",855,660,653,8,7,"PCPE",2
18,"18082",867,626,621,4,5,"PCPE",3
18,"18138",2482,1721,1712,8,9,"PCPE",2
18,"18135",4583,3045,2998,14,47,"PCPE",3
18,"18088",1556,1113,1108,5,5,"PCPE",0
18,"18111",2743,2046,2033,14,13,"PCPE",3
18,"18014",6372,4620,4566,44,54,"PCPE",9
18,"18057",5263,3968,3937,33,31,"PCPE",7
18,"18145",10432,7829,7767,56,62,"PCPE",7
18,"18020",1469,1046,1032,7,14,"PCPE",1
18,"18122",16171,11670,11508,106,162,"PCPE",10
18,"18046",1867,1225,1215,8,10,"PCPE",1
18,"18087",184873,138280,137516,836,764,"PCPE",128
18,"18147",3734,2416,2386,10,30,"PCPE",3
18,"18107",971,719,711,6,8,"PCPE",0
18,"18053",1667,1084,1078,9,6,"PCPE",2
18,"18099",1581,1271,1249,10,22,"PCPE",1
18,"18034",510,391,391,1,0,"PCPE",1
18,"18076",815,577,576,0,1,"PCPE",0
18,"18148",819,671,666,1,5,"PCPE",0
18,"18010",563,463,459,4,4,"PCPE",2
18,"18038",1066,836,826,2,10,"PCPE",1
18,"18134",5811,4002,3946,25,56,"PCPE",8
18,"18025",294,216,214,0,2,"PCPE",9
18,"18911",7392,5359,5301,44,58,"PCPE",7
18,"18005",375,266,265,2,1,"PCPE",2
18,"18093",2752,1873,1858,10,15,"PCPE",5
18,"18040",225,142,141,0,1,"PCPE",1
18,"18909",589,462,459,0,3,"PCPE",0
18,"18137",1005,758,758,6,0,"PCPE",1
18,"18001",256,178,177,2,1,"PCPE",1
18,"18062",10298,7584,7512,67,72,"PCPE",11
18,"18039",3544,2544,2511,34,33,"PCPE",5
18,"18128",344,251,248,0,3,"PCPE",0
18,"18003",14022,10417,10330,82,87,"PCPE",15
18,"18061",1059,822,816,1,6,"PCPE",0
18,"18021",17451,12420,12305,101,115,"PCPE",21
18,"18109",599,421,419,2,2,"PCPE",0
18,"18070",283,223,218,0,5,"PCPE",0
18,"18162",951,744,734,0,10,"PCPE",0
18,"18902",847,680,674,10,6,"PCPE",1
18,"18115",2548,1872,1854,16,18,"PCPE",3
18,"18065",625,503,500,1,3,"PCPE",4
18,"18018",640,490,488,0,2,"PCPE",0
31,"31257",866,657,648,8,9,"C´s",55
31,"31237",195,156,156,1,0,"C´s",7
31,"31254",1920,1473,1458,7,15,"C´s",89
31,"31231",115,81,81,1,0,"C´s",10
31,"31174",110,75,73,0,2,"C´s",5
31,"31234",144,107,107,2,0,"C´s",4
31,"31258",7841,5961,5927,56,34,"C´s",290
31,"31192",159,132,131,0,1,"C´s",7
31,"31082",615,398,393,6,5,"C´s",5
31,"31202",4326,3045,3001,41,44,"C´s",248
31,"31173",873,704,680,3,24,"C´s",37
31,"31064",1447,1161,1145,11,16,"C´s",62
31,"31167",827,624,615,13,9,"C´s",34
31,"31142",1411,972,964,11,8,"C´s",41
31,"31081",342,239,239,2,0,"C´s",2
31,"31038",1348,1017,1005,13,12,"C´s",52
31,"31122",4719,3671,3654,42,17,"C´s",261
31,"31074",394,301,298,5,3,"C´s",7
31,"31100",264,186,186,2,0,"C´s",13
31,"31034",40,29,29,1,0,"C´s",1
31,"31138",934,649,647,5,2,"C´s",11
31,"31169",2217,1508,1489,15,19,"C´s",81
31,"31162",47,29,27,0,2,"C´s",1
31,"31110",90,65,65,2,0,"C´s",3
31,"31246",140,108,103,2,5,"C´s",5
31,"31206",2095,1529,1513,19,16,"C´s",71
31,"31026",147,128,128,1,0,"C´s",11
31,"31131",871,664,658,13,6,"C´s",69
31,"31172",367,293,286,6,7,"C´s",39
31,"31054",460,308,304,7,4,"C´s",9
31,"31902",4346,3247,3228,23,19,"C´s",396
31,"31112",94,67,66,0,1,"C´s",1
31,"31041",1583,1125,1110,14,15,"C´s",114
31,"31191",3018,2324,2297,23,27,"C´s",186
31,"31144",804,482,479,2,3,"C´s",18
31,"31092",662,458,455,4,3,"C´s",9
31,"31095",76,66,64,1,2,"C´s",2
31,"31153",2172,1463,1448,10,15,"C´s",46
31,"31094",112,82,82,1,0,"C´s",0
31,"31135",102,67,62,0,5,"C´s",3
31,"31145",171,133,133,0,0,"C´s",14
31,"31189",1170,739,731,10,8,"C´s",20
31,"31182",37,27,27,0,0,"C´s",1
31,"31028",211,133,133,0,0,"C´s",1
31,"31036",921,664,657,5,7,"C´s",29
31,"31130",310,214,213,7,1,"C´s",8
31,"31085",471,353,351,3,2,"C´s",6
31,"31073",315,214,212,3,2,"C´s",6
31,"31164",582,464,457,3,7,"C´s",24
31,"31908",1008,709,704,11,5,"C´s",29
31,"31093",293,210,206,2,4,"C´s",2
31,"31022",526,344,341,3,3,"C´s",3
31,"31047",261,191,187,6,4,"C´s",8
31,"31906",2553,1945,1930,21,15,"C´s",162
31,"31118",165,122,121,2,1,"C´s",5
31,"31108",1878,1487,1475,14,12,"C´s",88
31,"31179",509,361,355,5,6,"C´s",21
31,"31213",105,70,70,0,0,"C´s",2
31,"31152",1347,999,990,16,9,"C´s",46
31,"31042",2744,2081,2053,19,28,"C´s",135
31,"31139",159,102,101,3,1,"C´s",7
31,"31155",253,191,189,3,2,"C´s",10
31,"31091",347,217,217,0,0,"C´s",3
31,"31227",8226,6191,6109,53,82,"C´s",334
31,"31077",5384,4055,3999,49,56,"C´s",453
31,"31157",3546,2423,2399,32,24,"C´s",162
31,"31066",867,647,638,8,9,"C´s",31
31,"31209",157,108,108,0,0,"C´s",2
31,"31007",136,94,93,1,1,"C´s",6
31,"31199",150,101,101,3,0,"C´s",1
31,"31168",248,192,191,0,1,"C´s",15
31,"31051",253,176,176,2,0,"C´s",12
31,"31011",697,494,491,5,3,"C´s",30
31,"31002",424,312,310,7,2,"C´s",20
31,"31120",394,264,263,5,1,"C´s",11
31,"31014",274,197,197,4,0,"C´s",10
31,"31156",252,193,193,0,0,"C´s",7
31,"31166",260,186,186,2,0,"C´s",18
31,"31264",179,117,115,5,2,"C´s",2
31,"31244",156,87,84,1,3,"C´s",4
31,"31115",166,108,108,2,0,"C´s",2
31,"31261",235,187,187,3,0,"C´s",20
31,"31104",1876,1355,1338,10,17,"C´s",58
31,"31236",1324,943,933,12,10,"C´s",41
31,"31148",93,70,70,3,0,"C´s",8
31,"31043",38,30,30,0,0,"C´s",3
31,"31024",102,52,52,0,0,"C´s",0
31,"31247",152,112,109,0,3,"C´s",3
31,"31207",271,194,190,0,4,"C´s",4
31,"31063",88,72,68,2,4,"C´s",2
31,"31096",115,95,92,2,3,"C´s",1
31,"31147",98,76,76,2,0,"C´s",6
31,"31154",227,127,125,3,2,"C´s",7
31,"31251",3110,2347,2327,19,20,"C´s",188
31,"31220",752,607,603,3,4,"C´s",40
31,"31017",361,248,246,4,2,"C´s",13
31,"31195",180,129,128,0,1,"C´s",4
31,"31006",1952,1423,1400,14,23,"C´s",89
31,"31121",64,45,45,2,0,"C´s",2
31,"31219",88,63,62,0,1,"C´s",5
31,"31005",296,205,204,0,1,"C´s",9
31,"31087",169,131,127,2,4,"C´s",4
31,"31165",2794,2057,2025,31,32,"C´s",132
31,"31178",495,364,364,4,0,"C´s",22
31,"31010",5721,3986,3946,27,40,"C´s",167
31,"31027",838,595,589,7,6,"C´s",13
31,"31215",4649,3412,3359,35,53,"C´s",388
31,"31901",15475,11855,11771,121,84,"C´s",822
31,"31013",661,439,437,1,2,"C´s",13
31,"31114",362,272,269,6,3,"C´s",21
31,"31113",137,86,85,1,1,"C´s",4
31,"31214",93,70,69,0,1,"C´s",5
31,"31249",1885,1350,1331,20,19,"C´s",82
31,"31230",107,86,85,0,1,"C´s",4
31,"31228",496,382,381,2,1,"C´s",48
31,"31061",56,50,50,1,0,"C´s",0
31,"31125",275,194,191,2,3,"C´s",11
31,"31098",1918,1489,1483,23,6,"C´s",141
31,"31079",76,53,53,0,0,"C´s",4
31,"31044",290,223,220,1,3,"C´s",3
31,"31040",194,130,128,1,2,"C´s",9
31,"31067",1938,1424,1415,15,9,"C´s",81
31,"31029",925,662,648,6,14,"C´s",38
31,"31076",2407,2005,1986,28,19,"C´s",194
31,"31161",344,273,270,4,3,"C´s",8
31,"31080",510,412,411,8,1,"C´s",10
31,"31229",50,40,40,0,0,"C´s",6
31,"31158",252,181,178,2,3,"C´s",7
31,"31160",107,81,80,0,1,"C´s",0
31,"31032",1733,1295,1285,26,10,"C´s",88
31,"31009",690,508,504,5,4,"C´s",15
31,"31150",213,154,152,1,2,"C´s",8
31,"31252",87,68,68,0,0,"C´s",1
31,"31107",1707,1303,1294,12,9,"C´s",100
31,"31057",1812,1375,1360,17,15,"C´s",104
31,"31200",764,558,546,11,12,"C´s",24
31,"31201",147803,110800,110079,1040,721,"C´s",7377
31,"31235",166,111,111,0,0,"C´s",8
31,"31053",532,395,391,4,4,"C´s",19
31,"31083",56,41,39,0,2,"C´s",1
31,"31232",25152,18432,18220,199,212,"C´s",2299
31,"31124",210,162,162,2,0,"C´s",12
31,"31250",2832,1921,1899,20,22,"C´s",91
31,"31020",454,235,232,2,3,"C´s",2
31,"31033",49,29,29,1,0,"C´s",1
31,"31037",86,64,64,0,0,"C´s",0
31,"31030",145,107,107,3,0,"C´s",2
31,"31208",2569,2016,1992,21,24,"C´s",153
31,"31128",370,265,265,2,0,"C´s",8
31,"31248",295,174,168,2,6,"C´s",7
31,"31256",109,70,70,0,0,"C´s",2
31,"31025",768,560,560,5,0,"C´s",15
31,"31052",88,65,64,0,1,"C´s",7
31,"31205",427,330,326,7,4,"C´s",17
31,"31242",253,165,164,1,1,"C´s",9
31,"31012",814,579,570,4,9,"C´s",28
31,"31255",102,75,74,2,1,"C´s",2
31,"31001",90,74,74,5,0,"C´s",2
31,"31224",914,668,659,6,9,"C´s",17
31,"31099",63,52,52,1,0,"C´s",1
31,"31185",501,345,342,4,3,"C´s",11
31,"31018",409,312,311,9,1,"C´s",17
31,"31078",2447,1889,1861,25,28,"C´s",176
31,"31221",1211,844,825,4,19,"C´s",19
31,"31226",585,346,344,1,2,"C´s",5
31,"31127",143,97,97,2,0,"C´s",8
31,"31116",65,51,51,1,0,"C´s",5
31,"31016",7642,5866,5822,52,44,"C´s",293
31,"31097",10436,7461,7395,96,66,"C´s",513
31,"31175",72,50,49,0,1,"C´s",1
31,"31109",1562,1184,1177,6,7,"C´s",73
31,"31194",315,218,217,2,1,"C´s",11
31,"31123",654,430,419,7,11,"C´s",12
31,"31245",83,54,54,1,0,"C´s",1
31,"31003",124,95,95,2,0,"C´s",2
31,"31183",681,581,578,10,3,"C´s",41
31,"31071",17,17,17,0,0,"C´s",0
31,"31072",5288,3916,3846,32,70,"C´s",415
31,"31129",393,265,261,2,4,"C´s",4
31,"31056",179,137,133,0,4,"C´s",4
31,"31217",337,233,230,1,3,"C´s",4
31,"31259",485,325,324,3,1,"C´s",5
31,"31065",1892,1420,1396,14,24,"C´s",69
31,"31117",620,390,385,1,5,"C´s",0
31,"31212",151,118,118,7,0,"C´s",8
31,"31171",693,510,500,6,10,"C´s",18
31,"31111",96,75,75,2,0,"C´s",3
31,"31055",259,177,173,2,4,"C´s",0
31,"31203",40,29,29,0,0,"C´s",1
31,"31090",146,81,80,3,1,"C´s",1
31,"31239",310,223,220,5,3,"C´s",5
31,"31070",2652,1907,1888,16,19,"C´s",178
31,"31177",262,171,170,3,1,"C´s",7
31,"31004",35,22,22,1,0,"C´s",0
31,"31046",60,38,38,0,0,"C´s",1
31,"31198",36,29,29,0,0,"C´s",1
31,"31907",10677,8568,8523,97,45,"C´s",733
31,"31181",150,116,116,0,0,"C´s",3
31,"31216",3882,2829,2810,31,19,"C´s",183
31,"31253",129,112,112,0,0,"C´s",2
31,"31262",206,180,180,2,0,"C´s",5
31,"31240",531,355,351,6,4,"C´s",6
31,"31008",80,57,54,0,3,"C´s",4
31,"31102",146,66,66,1,0,"C´s",2
31,"31048",169,123,123,1,0,"C´s",14
31,"31035",63,45,43,1,2,"C´s",1
31,"31143",98,59,58,1,1,"C´s",2
31,"31187",111,70,70,1,0,"C´s",4
31,"31904",1559,1095,1084,8,11,"C´s",49
31,"31101",1390,1031,1028,11,3,"C´s",55
31,"31225",36,29,29,0,0,"C´s",2
31,"31263",236,142,142,2,0,"C´s",0
31,"31105",1535,1208,1187,18,21,"C´s",75
31,"31075",101,68,67,1,1,"C´s",4
31,"31069",847,643,636,4,7,"C´s",24
31,"31223",995,752,742,6,10,"C´s",35
31,"31260",1245,859,857,15,2,"C´s",35
31,"31180",216,173,173,5,0,"C´s",11
31,"31088",5574,4194,4156,46,38,"C´s",397
31,"31050",6058,3902,3850,64,52,"C´s",121
31,"31243",314,236,234,5,2,"C´s",17
31,"31186",302,211,209,2,2,"C´s",12
31,"31140",116,82,82,2,0,"C´s",2
31,"31103",46,32,32,1,0,"C´s",1
31,"31133",44,30,30,1,0,"C´s",1
31,"31184",61,43,43,2,0,"C´s",2
31,"31265",86,61,61,0,0,"C´s",7
31,"31233",96,72,71,0,1,"C´s",10
31,"31176",2856,2077,2040,33,37,"C´s",186
31,"31141",109,70,66,1,4,"C´s",7
31,"31134",178,132,130,1,2,"C´s",2
31,"31211",25,12,12,2,0,"C´s",0
31,"31045",504,397,392,9,5,"C´s",23
31,"31159",1134,867,864,9,3,"C´s",33
31,"31086",12987,10342,10270,114,72,"C´s",1050
31,"31015",2001,1468,1449,18,19,"C´s",107
31,"31204",37,33,33,2,0,"C´s",0
31,"31039",83,58,57,0,1,"C´s",0
31,"31136",444,320,318,6,2,"C´s",8
31,"31084",1935,1389,1380,19,9,"C´s",17
31,"31031",221,141,140,0,1,"C´s",1
31,"31059",191,142,141,1,1,"C´s",3
31,"31197",70,60,59,0,1,"C´s",2
31,"31188",227,173,173,2,0,"C´s",10
31,"31905",2847,2108,2093,11,15,"C´s",179
31,"31241",134,94,89,0,5,"C´s",5
31,"31132",146,115,113,1,2,"C´s",10
31,"31060",13723,10036,9970,78,66,"C´s",559
31,"31222",63,41,41,5,0,"C´s",0
31,"31023",6826,5609,5591,77,18,"C´s",747
31,"31106",689,565,559,1,6,"C´s",71
31,"31146",35,30,30,2,0,"C´s",0
31,"31119",40,22,22,0,0,"C´s",0
31,"31193",1414,1103,1094,12,9,"C´s",37
31,"31170",49,39,39,1,0,"C´s",1
31,"31019",1809,1295,1288,23,7,"C´s",66
31,"31126",357,235,232,0,3,"C´s",3
31,"31238",110,96,94,2,2,"C´s",7
31,"31196",39,34,34,0,0,"C´s",0
31,"31151",67,48,48,1,0,"C´s",1
31,"31163",2017,1479,1447,15,32,"C´s",117
31,"31137",208,93,93,3,0,"C´s",4
31,"31049",704,488,486,1,2,"C´s",3
31,"31903",6593,4699,4660,28,39,"C´s",287
31,"31062",1088,866,853,4,13,"C´s",62
31,"31068",2893,2172,2138,27,34,"C´s",215
31,"31089",242,188,185,1,3,"C´s",15
31,"31058",215,153,153,2,0,"C´s",10
31,"31190",44,36,36,1,0,"C´s",3
31,"31149",2338,1534,1525,16,9,"C´s",13
31,"31210",199,146,145,2,1,"C´s",5
31,"31021",64,42,42,0,0,"C´s",0
47,"47194",301,242,239,1,3,"C's",24
47,"47103",259,211,211,4,0,"C's",25
47,"47139",1047,790,785,7,5,"C's",108
47,"47182",1342,1037,1023,16,14,"C's",140
47,"47086",3926,3065,3028,27,37,"C's",377
47,"47156",169,137,135,1,2,"C's",15
47,"47025",120,97,97,2,0,"C's",7
47,"47047",202,157,157,3,0,"C's",16
47,"47001",55,51,50,2,1,"C's",7
47,"47174",275,222,218,2,4,"C's",29
47,"47083",80,62,61,2,1,"C's",9
47,"47162",73,61,61,0,0,"C's",13
47,"47013",99,74,73,0,1,"C's",5
47,"47078",164,129,124,1,5,"C's",18
47,"47015",199,151,151,0,0,"C's",14
47,"47097",331,268,263,1,5,"C's",28
47,"47021",76,65,65,1,0,"C's",12
47,"47038",108,82,82,0,0,"C's",4
47,"47140",119,101,100,1,1,"C's",4
47,"47004",1199,946,938,11,8,"C's",95
47,"47196",35,26,26,1,0,"C's",2
47,"47044",330,291,287,0,4,"C's",48
47,"47088",110,87,87,0,0,"C's",5
47,"47222",80,68,68,3,0,"C's",5
47,"47151",27,22,21,0,1,"C's",3
47,"47082",803,641,633,5,8,"C's",87
47,"47029",57,48,47,1,1,"C's",3
47,"47104",2857,2313,2253,19,60,"C's",328
47,"47213",115,83,83,0,0,"C's",4
47,"47028",33,20,20,0,0,"C's",1
47,"47173",883,686,675,4,11,"C's",89
47,"47164",377,309,307,2,2,"C's",22
47,"47080",30,22,22,0,0,"C's",4
47,"47105",192,164,163,0,1,"C's",26
47,"47128",60,51,49,1,2,"C's",3
47,"47011",568,469,464,1,5,"C's",57
47,"47067",178,126,126,3,0,"C's",10
47,"47111",1009,794,789,4,5,"C's",123
47,"47018",35,31,28,0,3,"C's",0
47,"47188",112,85,85,0,0,"C's",10
47,"47074",150,125,125,1,0,"C's",8
47,"47045",768,586,580,0,6,"C's",71
47,"47227",64,52,52,0,0,"C's",7
47,"47219",42,36,34,2,2,"C's",4
47,"47098",583,488,487,6,1,"C's",94
47,"47216",115,101,99,2,2,"C's",17
47,"47117",297,219,216,4,3,"C's",49
47,"47012",118,95,95,0,0,"C's",12
47,"47119",90,75,75,1,0,"C's",7
47,"47161",3903,3200,3183,25,17,"C's",712
47,"47014",50,45,45,0,0,"C's",5
47,"47148",439,336,335,2,1,"C's",58
47,"47137",29,28,28,1,0,"C's",2
47,"47127",135,98,96,1,2,"C's",9
47,"47204",260,199,193,2,6,"C's",13
47,"47075",4871,3802,3763,30,39,"C's",690
47,"47231",4384,3457,3432,33,25,"C's",835
47,"47054",638,501,496,6,5,"C's",64
47,"47089",153,122,120,2,2,"C's",16
47,"47005",548,426,421,4,5,"C's",51
47,"47095",39,36,35,0,1,"C's",4
47,"47203",67,54,54,0,0,"C's",8
47,"47181",168,135,134,0,1,"C's",24
47,"47101",1720,1404,1388,10,16,"C's",144
47,"47034",76,59,58,1,1,"C's",2
47,"47003",228,180,179,3,1,"C's",11
47,"47063",101,82,81,2,1,"C's",9
47,"47166",265,203,199,3,4,"C's",32
47,"47006",190,145,144,1,1,"C's",13
47,"47094",132,103,101,1,2,"C's",1
47,"47046",121,93,93,0,0,"C's",11
47,"47076",17375,13778,13684,111,94,"C's",2660
47,"47190",93,80,78,4,2,"C's",8
47,"47049",100,78,78,1,0,"C's",7
47,"47131",178,132,131,3,1,"C's",15
47,"47179",398,299,295,3,4,"C's",43
47,"47069",127,113,111,0,2,"C's",10
47,"47009",106,80,80,1,0,"C's",15
47,"47134",164,126,119,4,7,"C's",13
47,"47064",31,29,28,2,1,"C's",2
47,"47077",247,190,189,2,1,"C's",21
47,"47142",148,114,113,0,1,"C's",18
47,"47185",98,79,79,0,0,"C's",15
47,"47132",45,37,35,0,2,"C's",2
47,"47200",82,64,64,1,0,"C's",3
47,"47100",140,119,117,2,2,"C's",7
47,"47007",3748,2869,2835,24,34,"C's",642
47,"47106",50,41,41,0,0,"C's",2
47,"47051",338,274,272,0,2,"C's",49
47,"47020",278,230,227,1,3,"C's",22
47,"47068",36,27,27,0,0,"C's",1
47,"47114",4074,2868,2826,20,42,"C's",459
47,"47130",99,78,78,1,0,"C's",21
47,"47121",553,436,428,5,8,"C's",28
47,"47214",1420,1111,1093,9,18,"C's",120
47,"47165",6987,5301,5115,63,186,"C's",991
47,"47019",86,67,65,1,2,"C's",4
47,"47154",155,128,127,0,1,"C's",9
47,"47229",215,151,150,1,1,"C's",7
47,"47223",158,129,125,3,4,"C's",17
47,"47220",166,124,124,1,0,"C's",23
47,"47178",175,146,146,1,0,"C's",22
47,"47169",68,57,57,0,0,"C's",8
47,"47002",25,23,23,0,0,"C's",2
47,"47207",277,216,212,3,4,"C's",26
47,"47084",1171,911,898,15,13,"C's",93
47,"47184",576,463,462,2,1,"C's",63
47,"47141",134,102,101,1,1,"C's",4
47,"47040",63,52,51,1,1,"C's",2
47,"47199",80,59,59,2,0,"C's",5
47,"47093",817,654,642,9,12,"C's",73
47,"47055",202,170,168,1,2,"C's",15
47,"47091",89,67,66,0,1,"C's",1
47,"47110",455,363,357,3,6,"C's",37
47,"47144",78,66,65,2,1,"C's",3
47,"47209",42,30,30,1,0,"C's",4
47,"47193",1583,1313,1294,12,19,"C's",258
47,"47189",152,128,128,0,0,"C's",19
47,"47159",828,654,646,0,8,"C's",85
47,"47052",6584,5222,5163,41,59,"C's",1244
47,"47024",262,206,205,2,1,"C's",23
47,"47058",206,149,149,2,0,"C's",17
47,"47150",278,217,214,2,3,"C's",25
47,"47183",130,105,105,0,0,"C's",9
47,"47030",1006,785,770,10,15,"C's",87
47,"47053",116,96,96,1,0,"C's",10
47,"47062",163,131,131,0,0,"C's",22
47,"47070",41,32,32,1,0,"C's",5
47,"47163",299,236,235,6,1,"C's",30
47,"47168",31,28,27,0,1,"C's",3
47,"47037",174,146,141,2,5,"C's",13
47,"47225",81,61,60,2,1,"C's",8
47,"47010",13613,10963,10895,108,68,"C's",3171
47,"47208",59,38,37,3,1,"C's",4
47,"47171",418,333,332,9,1,"C's",57
47,"47195",461,348,348,3,0,"C's",40
47,"47113",156,121,121,0,0,"C's",6
47,"47133",2665,2140,2118,25,22,"C's",505
47,"47087",379,318,314,4,4,"C's",50
47,"47112",2592,2063,2043,20,20,"C's",273
47,"47092",110,93,92,0,1,"C's",17
47,"47118",161,119,118,0,1,"C's",6
47,"47226",161,128,127,1,1,"C's",8
47,"47170",36,30,29,2,1,"C's",5
47,"47224",91,74,74,1,0,"C's",5
47,"47155",3239,2400,2374,27,26,"C's",447
47,"47079",62,51,51,0,0,"C's",10
47,"47099",152,128,127,1,1,"C's",18
47,"47211",49,39,37,1,2,"C's",6
47,"47081",47,40,40,0,0,"C's",6
47,"47026",49,40,40,0,0,"C's",5
47,"47073",120,98,97,1,1,"C's",6
47,"47221",109,91,91,0,0,"C's",10
47,"47116",413,330,324,1,6,"C's",32
47,"47085",16668,12248,12132,133,116,"C's",2021
47,"47158",906,686,668,3,18,"C's",91
47,"47071",417,348,344,2,4,"C's",61
47,"47160",430,334,329,5,5,"C's",35
47,"47218",995,760,754,6,6,"C's",90
47,"47147",119,91,91,0,0,"C's",2
47,"47191",110,74,74,0,0,"C's",11
47,"47172",148,120,120,1,0,"C's",13
47,"47039",188,149,148,1,1,"C's",8
47,"47065",863,681,671,4,10,"C's",57
47,"47217",1896,1436,1420,20,16,"C's",255
47,"47027",2746,2120,2095,8,25,"C's",370
47,"47145",611,451,449,4,2,"C's",72
47,"47149",43,33,32,1,1,"C's",5
47,"47228",445,359,357,4,2,"C's",60
47,"47096",135,108,107,2,1,"C's",17
47,"47043",302,239,239,3,0,"C's",20
47,"47157",515,442,441,3,1,"C's",68
47,"47056",82,58,57,0,1,"C's",10
47,"47198",66,47,47,0,0,"C's",4
47,"47036",229,184,179,2,5,"C's",24
47,"47123",469,395,386,4,9,"C's",49
47,"47215",54,47,46,1,1,"C's",3
47,"47212",388,322,322,3,0,"C's",38
47,"47109",171,131,130,1,1,"C's",17
47,"47138",237,180,176,1,4,"C's",18
47,"47048",190,140,138,0,2,"C's",25
47,"47232",99,75,74,0,1,"C's",12
47,"47035",930,745,739,10,6,"C's",51
47,"47032",153,120,118,0,2,"C's",11
47,"47129",879,700,688,6,12,"C's",97
47,"47206",95,81,81,0,0,"C's",6
47,"47176",224,139,135,5,4,"C's",11
47,"47066",1255,1005,996,7,9,"C's",194
47,"47192",105,80,79,1,1,"C's",6
47,"47122",2034,1666,1635,21,31,"C's",194
47,"47008",24,18,18,0,0,"C's",0
47,"47187",89,57,56,2,1,"C's",8
47,"47050",3757,2829,2812,29,17,"C's",555
47,"47125",59,43,43,1,0,"C's",4
47,"47152",86,64,64,1,0,"C's",4
47,"47143",127,99,99,0,0,"C's",7
47,"47210",372,289,286,1,3,"C's",25
47,"47197",888,693,687,10,6,"C's",60
47,"47167",242,201,197,3,4,"C's",26
47,"47022",57,50,46,0,4,"C's",5
47,"47057",248,194,194,2,0,"C's",26
47,"47175",6575,4991,4937,51,54,"C's",837
47,"47146",260,205,204,1,1,"C's",32
47,"47016",71,58,57,0,1,"C's",3
47,"47031",186,145,144,1,1,"C's",16
47,"47061",258,216,214,2,2,"C's",12
47,"47090",2418,1805,1776,17,29,"C's",215
47,"47124",399,329,328,4,1,"C's",41
47,"47153",108,74,73,1,1,"C's",0
47,"47177",107,78,76,0,2,"C's",11
47,"47102",286,229,224,1,5,"C's",17
47,"47017",201,161,158,3,3,"C's",15
47,"47180",83,64,64,1,0,"C's",15
47,"47060",262,218,214,0,4,"C's",27
47,"47126",49,36,36,0,0,"C's",5
47,"47023",2999,2457,2445,20,12,"C's",583
47,"47041",149,124,123,2,1,"C's",9
47,"47135",84,76,76,2,0,"C's",13
47,"47186",246602,193774,192412,1384,1362,"C's",32412
47,"47205",385,281,274,7,7,"C's",47
47,"47059",97,71,71,0,0,"C's",8
47,"47115",287,238,237,4,1,"C's",31
47,"47042",54,41,41,3,0,"C's",1
47,"47230",302,243,241,0,2,"C's",37
47,"47033",199,154,153,3,1,"C's",27
48,"48903",1838,1400,1385,4,15,"PSE-EE (PSO",55
48,"48024",1003,775,771,5,4,"PSE-EE (PSO",6
48,"48060",3645,2277,2274,7,3,"PSE-EE (PSO",54
48,"48070",545,378,374,2,4,"PSE-EE (PSO",2
48,"48011",9692,6891,6843,56,48,"PSE-EE (PSO",881
48,"48912",2308,1787,1746,27,41,"PSE-EE (PSO",194
48,"48013",79984,56928,56516,383,412,"PSE-EE (PSO",11473
48,"48056",978,733,732,7,1,"PSE-EE (PSO",12
48,"48062",300,241,240,1,1,"PSE-EE (PSO",3
48,"48016",5260,3856,3827,22,29,"PSE-EE (PSO",337
48,"48906",775,579,574,0,5,"PSE-EE (PSO",15
48,"48044",62989,46989,46783,385,206,"PSE-EE (PSO",3671
48,"48083",6950,5128,5097,33,31,"PSE-EE (PSO",880
48,"48901",4775,3602,3573,35,29,"PSE-EE (PSO",577
48,"48027",22033,15929,15825,113,104,"PSE-EE (PSO",1491
48,"48076",314,237,237,4,0,"PSE-EE (PSO",7
48,"48913",1251,933,917,13,16,"PSE-EE (PSO",56
48,"48068",1551,1178,1163,16,15,"PSE-EE (PSO",30
48,"48909",207,165,165,1,0,"PSE-EE (PSO",0
48,"48077",3367,2438,2423,17,15,"PSE-EE (PSO",116
48,"48026",1134,861,853,7,8,"PSE-EE (PSO",8
48,"48071",6118,4467,4412,32,55,"PSE-EE (PSO",684
48,"48036",24144,17085,16954,117,131,"PSE-EE (PSO",1954
48,"48074",3333,2467,2428,20,39,"PSE-EE (PSO",193
48,"48003",14338,10497,10414,76,83,"PSE-EE (PSO",1004
48,"48064",603,463,459,7,4,"PSE-EE (PSO",5
48,"48015",33690,24299,24160,168,139,"PSE-EE (PSO",4580
48,"48043",4403,3214,3186,28,28,"PSE-EE (PSO",164
48,"48057",5749,4093,4081,20,12,"PSE-EE (PSO",84
48,"48914",330,275,275,1,0,"PSE-EE (PSO",2
48,"48092",837,619,619,13,0,"PSE-EE (PSO",36
48,"48034",12902,9684,9613,79,71,"PSE-EE (PSO",2175
48,"48069",12765,8985,8910,58,75,"PSE-EE (PSO",512
48,"48028",715,553,551,4,2,"PSE-EE (PSO",1
48,"48045",5149,3940,3885,35,55,"PSE-EE (PSO",415
48,"48040",1299,896,884,5,12,"PSE-EE (PSO",28
48,"48046",12617,9037,8967,56,70,"PSE-EE (PSO",556
48,"48049",548,433,431,0,2,"PSE-EE (PSO",2
48,"48055",2662,1961,1938,16,23,"PSE-EE (PSO",131
48,"48084",22577,15689,15540,108,149,"PSE-EE (PSO",3373
48,"48005",117,76,76,0,0,"PSE-EE (PSO",4
48,"48032",5735,4173,4151,32,22,"PSE-EE (PSO",387
48,"48050",198,153,150,0,3,"PSE-EE (PSO",2
48,"48082",37673,27006,26811,201,195,"PSE-EE (PSO",4738
48,"48059",402,317,314,1,3,"PSE-EE (PSO",4
48,"48058",972,691,687,4,4,"PSE-EE (PSO",52
48,"48033",215,160,159,0,1,"PSE-EE (PSO",1
48,"48079",425,322,321,4,1,"PSE-EE (PSO",5
48,"48054",24135,17493,17374,124,119,"PSE-EE (PSO",2103
48,"48065",3315,2447,2433,19,14,"PSE-EE (PSO",226
48,"48061",762,584,581,4,3,"PSE-EE (PSO",12
48,"48080",9971,7148,7086,71,62,"PSE-EE (PSO",1378
48,"48012",2041,1571,1553,11,18,"PSE-EE (PSO",38
48,"48031",340,245,242,0,3,"PSE-EE (PSO",0
48,"48052",1559,1215,1211,0,4,"PSE-EE (PSO",19
48,"48075",1975,1440,1421,12,19,"PSE-EE (PSO",49
48,"48053",900,676,670,8,6,"PSE-EE (PSO",30
48,"48017",13290,8908,8856,42,52,"PSE-EE (PSO",378
48,"48009",786,614,609,3,5,"PSE-EE (PSO",17
48,"48047",161,112,112,0,0,"PSE-EE (PSO",0
48,"48025",883,642,639,3,3,"PSE-EE (PSO",8
48,"48087",429,346,343,1,3,"PSE-EE (PSO",27
48,"48007",365,241,239,0,2,"PSE-EE (PSO",0
48,"48019",3594,2569,2544,16,25,"PSE-EE (PSO",283
48,"48073",6952,4476,4435,43,41,"PSE-EE (PSO",138
48,"48002",7851,5767,5713,41,54,"PSE-EE (PSO",807
48,"48063",373,289,288,1,1,"PSE-EE (PSO",4
48,"48051",220,169,168,0,1,"PSE-EE (PSO",24
48,"48008",617,433,424,6,9,"PSE-EE (PSO",11
48,"48038",1122,834,824,0,10,"PSE-EE (PSO",19
48,"48097",1303,907,898,10,9,"PSE-EE (PSO",91
48,"48089",3266,2425,2406,23,19,"PSE-EE (PSO",159
48,"48095",2352,1658,1647,6,11,"PSE-EE (PSO",258
48,"48020",274076,193807,192607,1471,1200,"PSE-EE (PSO",24837
48,"48014",1218,870,866,8,4,"PSE-EE (PSO",45
48,"48021",1352,952,946,8,6,"PSE-EE (PSO",65
48,"48041",704,558,555,4,3,"PSE-EE (PSO",12
48,"48904",3504,2671,2650,18,21,"PSE-EE (PSO",201
48,"48035",412,313,312,4,1,"PSE-EE (PSO",2
48,"48018",875,553,553,3,0,"PSE-EE (PSO",13
48,"48039",243,201,201,2,0,"PSE-EE (PSO",4
48,"48066",346,256,256,1,0,"PSE-EE (PSO",0
48,"48093",900,673,664,4,9,"PSE-EE (PSO",18
48,"48001",5832,4191,4166,37,25,"PSE-EE (PSO",537
48,"48037",678,518,509,2,9,"PSE-EE (PSO",32
48,"48907",355,283,282,2,1,"PSE-EE (PSO",5
48,"48029",8332,6155,6119,35,36,"PSE-EE (PSO",974
48,"48088",135,97,96,0,1,"PSE-EE (PSO",1
48,"48030",608,454,453,4,1,"PSE-EE (PSO",3
48,"48006",289,246,245,3,1,"PSE-EE (PSO",4
48,"48067",1161,837,834,2,3,"PSE-EE (PSO",22
48,"48910",2948,2126,2115,17,11,"PSE-EE (PSO",339
48,"48911",382,291,286,2,5,"PSE-EE (PSO",3
48,"48902",19124,13344,13227,93,117,"PSE-EE (PSO",2064
48,"48072",974,728,723,5,5,"PSE-EE (PSO",23
48,"48004",334,229,227,1,2,"PSE-EE (PSO",3
48,"48081",1883,1412,1398,12,14,"PSE-EE (PSO",64
48,"48042",1384,1111,1091,7,20,"PSE-EE (PSO",63
48,"48010",457,311,307,1,4,"PSE-EE (PSO",5
48,"48086",2073,1519,1504,15,15,"PSE-EE (PSO",115
48,"48908",245,200,199,1,1,"PSE-EE (PSO",7
48,"48915",362,238,238,2,0,"PSE-EE (PSO",3
48,"48090",6022,4544,4483,23,61,"PSE-EE (PSO",702
48,"48022",2355,1476,1468,9,8,"PSE-EE (PSO",133
48,"48085",10301,7458,7407,50,51,"PSE-EE (PSO",488
48,"48096",6608,5071,5011,43,60,"PSE-EE (PSO",566
48,"48905",2565,1882,1847,2,35,"PSE-EE (PSO",163
48,"48023",594,470,468,4,2,"PSE-EE (PSO",10
48,"48094",3193,2210,2200,18,10,"PSE-EE (PSO",84
48,"48091",1134,821,812,7,9,"PSE-EE (PSO",51
48,"48048",562,399,394,3,5,"PSE-EE (PSO",12
48,"48078",38742,28064,27837,231,227,"PSE-EE (PSO",5938
34,"34047",1803,1402,1380,15,22,"PSOE",247
34,"34086",105,91,88,1,3,"PSOE",16
34,"34175",89,75,74,1,1,"PSOE",5
34,"34131",59,50,48,0,2,"PSOE",2
34,"34068",25,24,24,1,0,"PSOE",3
34,"34091",123,97,95,1,2,"PSOE",28
34,"34125",88,69,68,1,1,"PSOE",4
34,"34072",160,142,140,1,2,"PSOE",31
34,"34081",61,50,49,0,1,"PSOE",5
34,"34048",76,64,64,1,0,"PSOE",16
34,"34059",422,348,341,6,7,"PSOE",120
34,"34003",163,127,125,0,2,"PSOE",8
34,"34218",469,353,349,2,4,"PSOE",51
34,"34020",53,39,39,0,0,"PSOE",9
34,"34017",920,763,745,2,18,"PSOE",202
34,"34903",198,128,127,1,1,"PSOE",22
34,"34057",476,339,334,3,5,"PSOE",67
34,"34229",67,55,55,1,0,"PSOE",7
34,"34243",326,263,258,2,5,"PSOE",64
34,"34158",290,190,188,3,2,"PSOE",60
34,"34176",134,102,100,2,2,"PSOE",9
34,"34205",59,45,45,0,0,"PSOE",8
34,"34246",64,49,47,1,2,"PSOE",11
34,"34079",1601,1285,1269,11,16,"PSOE",290
34,"34010",570,437,429,5,8,"PSOE",107
34,"34245",311,213,209,4,4,"PSOE",54
34,"34216",67,52,51,0,1,"PSOE",3
34,"34103",96,78,77,2,1,"PSOE",15
34,"34096",57,46,46,3,0,"PSOE",10
34,"34217",1200,954,934,6,20,"PSOE",186
34,"34222",120,82,82,2,0,"PSOE",3
34,"34139",168,126,124,6,2,"PSOE",17
34,"34076",597,494,490,3,4,"PSOE",111
34,"34051",102,90,88,1,2,"PSOE",3
34,"34167",114,89,89,0,0,"PSOE",18
34,"34211",180,151,149,3,2,"PSOE",18
34,"34019",125,103,101,1,2,"PSOE",23
34,"34165",66,59,59,0,0,"PSOE",2
34,"34058",184,167,167,0,0,"PSOE",51
34,"34006",80,69,66,1,3,"PSOE",5
34,"34123",1668,1346,1319,20,27,"PSOE",381
34,"34121",192,155,154,2,1,"PSOE",20
34,"34015",39,32,31,1,1,"PSOE",4
34,"34089",157,124,122,1,2,"PSOE",9
34,"34106",114,94,94,2,0,"PSOE",9
34,"34213",58,43,42,2,1,"PSOE",4
34,"34152",124,102,99,1,3,"PSOE",26
34,"34170",62,49,49,0,0,"PSOE",4
34,"34902",140,115,114,0,1,"PSOE",19
34,"34005",858,670,651,6,19,"PSOE",140
34,"34114",212,147,146,2,1,"PSOE",14
34,"34208",53,41,41,1,0,"PSOE",4
34,"34179",29,22,20,0,2,"PSOE",2
34,"34073",187,150,149,0,1,"PSOE",43
34,"34224",45,31,31,0,0,"PSOE",12
34,"34141",182,148,147,4,1,"PSOE",30
34,"34099",61,51,50,0,1,"PSOE",8
34,"34029",727,596,582,4,14,"PSOE",130
34,"34134",53,37,37,2,0,"PSOE",6
34,"34180",68,56,56,2,0,"PSOE",9
34,"34011",398,326,326,3,0,"PSOE",104
34,"34184",55,46,42,0,4,"PSOE",5
34,"34189",57,45,45,1,0,"PSOE",7
34,"34149",20,15,15,0,0,"PSOE",1
34,"34104",247,203,199,0,4,"PSOE",40
34,"34031",29,28,28,1,0,"PSOE",4
34,"34171",982,720,710,7,10,"PSOE",138
34,"34087",127,109,108,1,1,"PSOE",17
34,"34018",209,169,166,3,3,"PSOE",33
34,"34074",719,552,545,8,7,"PSOE",178
34,"34012",362,277,272,4,5,"PSOE",68
34,"34242",95,74,73,1,1,"PSOE",22
34,"34135",391,296,291,4,5,"PSOE",51
34,"34056",2003,1502,1487,12,15,"PSOE",304
34,"34904",319,241,240,3,1,"PSOE",71
34,"34027",1096,786,781,11,5,"PSOE",232
34,"34185",65,46,44,2,2,"PSOE",7
34,"34227",76,62,62,1,0,"PSOE",4
34,"34080",5626,3906,3835,39,71,"PSOE",963
34,"34060",137,113,112,1,1,"PSOE",20
34,"34032",41,32,31,0,1,"PSOE",2
34,"34132",115,93,92,0,1,"PSOE",20
34,"34049",369,280,274,1,6,"PSOE",62
34,"34220",144,129,128,0,1,"PSOE",30
34,"34098",780,587,582,2,5,"PSOE",139
34,"34140",107,63,62,0,1,"PSOE",9
34,"34223",219,159,158,1,1,"PSOE",16
34,"34093",90,72,70,0,2,"PSOE",2
34,"34033",18,17,17,0,0,"PSOE",1
34,"34110",91,78,78,2,0,"PSOE",23
34,"34186",51,45,45,0,0,"PSOE",10
34,"34024",32,19,19,0,0,"PSOE",3
34,"34066",58,45,45,0,0,"PSOE",3
34,"34082",84,71,71,0,0,"PSOE",16
34,"34157",2460,1872,1836,26,36,"PSOE",398
34,"34001",35,28,28,2,0,"PSOE",5
34,"34116",62,41,41,0,0,"PSOE",6
34,"34037",310,218,217,4,1,"PSOE",41
34,"34237",597,472,465,5,7,"PSOE",121
34,"34241",18,13,12,2,1,"PSOE",1
34,"34137",28,24,24,1,0,"PSOE",13
34,"34233",131,116,116,1,0,"PSOE",14
34,"34159",363,277,269,4,8,"PSOE",87
34,"34025",61,44,44,1,0,"PSOE",6
34,"34067",129,95,95,0,0,"PSOE",22
34,"34022",1095,915,909,8,6,"PSOE",318
34,"34108",537,453,446,5,7,"PSOE",173
34,"34146",55,42,42,0,0,"PSOE",5
34,"34127",95,64,64,2,0,"PSOE",9
34,"34230",15,12,12,0,0,"PSOE",2
34,"34210",102,90,89,0,1,"PSOE",20
34,"34238",341,279,276,1,3,"PSOE",97
34,"34168",55,51,51,1,0,"PSOE",11
34,"34009",33,29,26,1,3,"PSOE",1
34,"34071",172,140,139,4,1,"PSOE",22
34,"34028",144,121,119,1,2,"PSOE",12
34,"34109",59,48,47,0,1,"PSOE",0
34,"34004",5626,4226,4178,41,48,"PSOE",910
34,"34113",37,36,36,0,0,"PSOE",5
34,"34129",179,139,137,2,2,"PSOE",19
34,"34061",108,80,80,0,0,"PSOE",2
34,"34154",76,54,52,0,2,"PSOE",6
34,"34050",202,160,160,0,0,"PSOE",41
34,"34178",113,92,91,5,1,"PSOE",6
34,"34045",77,65,65,2,0,"PSOE",17
34,"34160",143,112,110,1,2,"PSOE",47
34,"34202",31,20,19,0,1,"PSOE",1
34,"34236",162,126,126,1,0,"PSOE",22
34,"34232",748,601,586,11,15,"PSOE",200
34,"34133",107,85,82,0,3,"PSOE",7
34,"34130",213,175,172,2,3,"PSOE",56
34,"34102",205,172,170,1,2,"PSOE",36
34,"34046",43,31,29,0,2,"PSOE",10
34,"34070",160,117,115,2,2,"PSOE",33
34,"34215",163,148,148,2,0,"PSOE",44
34,"34042",300,247,244,4,3,"PSOE",59
34,"34204",47,39,39,2,0,"PSOE",7
34,"34120",64404,49403,48884,379,519,"PSOE",12190
34,"34055",280,204,202,2,2,"PSOE",46
34,"34034",126,93,93,1,0,"PSOE",29
34,"34143",172,127,126,3,1,"PSOE",29
34,"34063",86,80,79,1,1,"PSOE",25
34,"34174",205,162,162,4,0,"PSOE",22
34,"34038",277,202,202,3,0,"PSOE",17
34,"34083",1773,1259,1244,8,15,"PSOE",250
34,"34112",47,38,38,0,0,"PSOE",5
34,"34088",231,192,190,2,2,"PSOE",44
34,"34041",89,71,71,1,0,"PSOE",9
34,"34053",209,170,168,4,2,"PSOE",42
34,"34094",61,42,40,1,2,"PSOE",5
34,"34156",49,42,41,3,1,"PSOE",2
34,"34234",72,57,55,0,2,"PSOE",6
34,"34199",1248,955,937,18,18,"PSOE",250
34,"34201",193,163,161,2,2,"PSOE",34
34,"34077",349,253,246,0,7,"PSOE",71
34,"34147",167,120,120,1,0,"PSOE",17
34,"34228",81,66,66,0,0,"PSOE",20
34,"34221",179,135,132,3,3,"PSOE",32
34,"34052",178,148,147,3,1,"PSOE",14
34,"34107",81,49,49,3,0,"PSOE",5
34,"34126",279,218,218,2,0,"PSOE",26
34,"34124",61,47,46,0,1,"PSOE",11
34,"34122",84,66,65,0,1,"PSOE",18
34,"34062",176,111,111,3,0,"PSOE",13
34,"34214",186,150,149,1,1,"PSOE",44
34,"34023",5265,3948,3918,38,30,"PSOE",1099
34,"34231",232,167,167,4,0,"PSOE",22
34,"34206",879,688,680,3,8,"PSOE",265
34,"34163",49,40,40,0,0,"PSOE",11
34,"34101",54,42,42,0,0,"PSOE",10
34,"34069",2285,1711,1692,25,19,"PSOE",566
34,"34177",179,149,148,1,1,"PSOE",33
34,"34161",23,14,14,0,0,"PSOE",4
34,"34136",182,121,120,1,1,"PSOE",28
34,"34100",142,116,115,5,1,"PSOE",25
34,"34901",1126,881,865,6,16,"PSOE",202
34,"34084",140,110,108,1,2,"PSOE",18
34,"34036",216,167,165,1,2,"PSOE",62
34,"34182",792,632,620,3,12,"PSOE",191
34,"34225",4903,3830,3784,41,46,"PSOE",1112
34,"34240",90,71,70,2,1,"PSOE",13
34,"34190",56,40,40,3,0,"PSOE",4
34,"34196",91,70,69,1,1,"PSOE",8
34,"34155",135,105,104,1,1,"PSOE",47
34,"34039",61,46,45,0,1,"PSOE",4
34,"34092",297,236,231,2,5,"PSOE",68
34,"34151",167,111,111,3,0,"PSOE",18
34,"34181",453,343,337,3,6,"PSOE",140
34,"34169",404,302,300,2,2,"PSOE",46
34,"34035",113,90,89,1,1,"PSOE",28
34,"34192",93,76,76,0,0,"PSOE",11
17,"17193",4216,2807,2768,26,39,"unio.cat",36
17,"17049",3125,2251,2233,7,18,"unio.cat",38
17,"17088",535,372,369,0,3,"unio.cat",5
17,"17204",562,385,384,7,1,"unio.cat",7
17,"17105",255,170,170,2,0,"unio.cat",6
17,"17026",536,381,380,6,1,"unio.cat",11
17,"17153",186,140,140,0,0,"unio.cat",6
17,"17203",154,110,110,0,0,"unio.cat",4
17,"17050",649,499,495,3,4,"unio.cat",6
17,"17186",3771,2742,2712,18,30,"unio.cat",31
17,"17046",719,499,492,2,7,"unio.cat",9
17,"17177",563,359,354,3,5,"unio.cat",11
17,"17206",141,89,87,0,2,"unio.cat",5
17,"17062",5970,3695,3657,31,38,"unio.cat",46
17,"17196",214,151,151,2,0,"unio.cat",1
17,"17073",1875,1466,1460,11,6,"unio.cat",20
17,"17031",172,109,109,3,0,"unio.cat",0
17,"17184",1258,893,887,6,6,"unio.cat",17
17,"17215",2066,1588,1577,12,11,"unio.cat",21
17,"17185",2293,1547,1527,12,20,"unio.cat",25
17,"17035",544,400,399,4,1,"unio.cat",10
17,"17019",1779,1279,1261,13,18,"unio.cat",26
17,"17055",152,125,125,0,0,"unio.cat",1
17,"17134",234,163,161,2,2,"unio.cat",0
17,"17182",262,191,191,2,0,"unio.cat",1
17,"17095",19593,12648,12554,81,94,"unio.cat",178
17,"17172",452,308,307,1,1,"unio.cat",5
17,"17136",175,133,132,1,1,"unio.cat",0
17,"17140",674,498,495,5,3,"unio.cat",9
17,"17217",348,268,266,0,2,"unio.cat",3
17,"17109",693,443,435,2,8,"unio.cat",11
17,"17068",245,173,172,0,1,"unio.cat",3
17,"17142",2561,1962,1950,13,12,"unio.cat",38
17,"17216",165,112,110,0,2,"unio.cat",0
17,"17048",6269,4072,4044,24,28,"unio.cat",70
17,"17195",338,256,251,2,5,"unio.cat",8
17,"17001",585,417,413,2,4,"unio.cat",4
17,"17005",401,263,260,5,3,"unio.cat",5
17,"17040",538,392,391,4,1,"unio.cat",5
17,"17037",104,65,65,0,0,"unio.cat",0
17,"17144",210,141,141,2,0,"unio.cat",2
17,"17074",507,345,341,1,4,"unio.cat",3
17,"17014",61,47,47,1,0,"unio.cat",1
17,"17100",199,142,140,7,2,"unio.cat",5
17,"17218",588,448,445,3,3,"unio.cat",11
17,"17027",2826,1993,1973,10,20,"unio.cat",19
17,"17028",303,213,213,4,0,"unio.cat",6
17,"17202",3803,2471,2449,13,22,"unio.cat",47
17,"17139",1382,972,963,9,9,"unio.cat",21
17,"17145",1488,1003,986,9,17,"unio.cat",16
17,"17079",64159,44230,43902,271,328,"unio.cat",909
17,"17038",369,255,253,2,2,"unio.cat",5
17,"17007",1730,1235,1224,4,11,"unio.cat",28
17,"17181",3380,2272,2251,15,21,"unio.cat",47
17,"17183",274,186,186,3,0,"unio.cat",5
17,"17063",166,115,113,0,2,"unio.cat",2
17,"17174",176,102,102,3,0,"unio.cat",1
17,"17187",621,468,464,6,4,"unio.cat",5
17,"17114",23020,15151,15024,105,127,"unio.cat",269
17,"17147",8112,5475,5422,43,53,"unio.cat",116
17,"17175",579,366,360,4,6,"unio.cat",5
17,"17060",424,277,274,3,3,"unio.cat",14
17,"17110",1325,953,945,5,8,"unio.cat",9
17,"17171",163,123,122,0,1,"unio.cat",4
17,"17141",5869,3688,3653,38,35,"unio.cat",73
17,"17102",576,397,395,4,2,"unio.cat",11
17,"17107",268,189,188,2,1,"unio.cat",3
17,"17165",653,445,443,2,2,"unio.cat",12
17,"17009",4042,2770,2738,18,32,"unio.cat",61
17,"17025",1124,834,827,3,7,"unio.cat",7
17,"17180",8300,5429,5368,42,61,"unio.cat",80
17,"17098",311,224,221,2,3,"unio.cat",8
17,"17167",2697,1876,1852,24,24,"unio.cat",36
17,"17029",203,131,131,2,0,"unio.cat",2
17,"17117",14280,9297,9223,75,74,"unio.cat",162
17,"17137",3411,2391,2369,15,22,"unio.cat",39
17,"17099",80,60,59,0,1,"unio.cat",2
17,"17169",2475,1733,1724,11,9,"unio.cat",14
17,"17189",1524,1126,1114,4,12,"unio.cat",16
17,"17066",26551,16275,16166,140,109,"unio.cat",314
17,"17030",645,430,428,7,2,"unio.cat",12
17,"17003",102,71,71,0,0,"unio.cat",3
17,"17173",180,141,139,2,2,"unio.cat",2
17,"17070",109,82,82,1,0,"unio.cat",6
17,"17034",6874,4509,4477,32,32,"unio.cat",59
17,"17138",944,668,663,4,5,"unio.cat",16
17,"17211",839,646,639,3,7,"unio.cat",11
17,"17097",199,149,148,5,1,"unio.cat",2
17,"17210",551,378,376,2,2,"unio.cat",6
17,"17118",12824,8557,8477,57,80,"unio.cat",110
17,"17011",646,463,462,7,1,"unio.cat",5
17,"17208",997,679,671,12,8,"unio.cat",21
17,"17178",1063,690,685,5,5,"unio.cat",15
17,"17148",1535,1056,1045,12,11,"unio.cat",13
17,"17155",14500,9167,9080,43,87,"unio.cat",132
17,"17151",174,124,123,3,1,"unio.cat",2
17,"17071",1131,810,803,8,7,"unio.cat",6
17,"17209",625,480,477,2,3,"unio.cat",4
17,"17223",807,528,520,6,8,"unio.cat",8
17,"17115",277,195,195,0,0,"unio.cat",2
17,"17164",3996,2555,2543,23,12,"unio.cat",49
17,"17205",212,166,166,2,0,"unio.cat",4
17,"17213",5372,3549,3517,17,32,"unio.cat",54
17,"17032",1713,1036,1020,13,16,"unio.cat",19
17,"17157",126,104,102,1,2,"unio.cat",4
17,"17120",792,530,518,3,12,"unio.cat",7
17,"17225",213,142,142,1,0,"unio.cat",3
17,"17149",363,267,264,0,3,"unio.cat",1
17,"17061",162,119,119,1,0,"unio.cat",2
17,"17080",141,98,98,0,0,"unio.cat",8
17,"17222",109,85,85,1,0,"unio.cat",3
17,"17101",543,364,362,3,2,"unio.cat",6
17,"17084",236,160,160,7,0,"unio.cat",13
17,"17188",165,126,126,0,0,"unio.cat",1
17,"17013",2787,1941,1926,17,15,"unio.cat",26
17,"17002",556,429,419,1,10,"unio.cat",12
17,"17081",244,165,163,0,2,"unio.cat",2
17,"17176",122,91,91,2,0,"unio.cat",3
17,"17135",355,263,258,2,5,"unio.cat",1
17,"17096",178,115,114,0,1,"unio.cat",3
17,"17158",464,284,281,0,3,"unio.cat",9
17,"17041",215,146,145,2,1,"unio.cat",2
17,"17154",92,62,62,0,0,"unio.cat",0
17,"17146",2979,2030,2009,14,21,"unio.cat",29
17,"17085",293,223,221,1,2,"unio.cat",4
17,"17121",221,157,156,1,1,"unio.cat",3
17,"17123",357,275,273,3,2,"unio.cat",2
17,"17227",128,95,95,0,0,"unio.cat",0
17,"17023",27347,18842,18610,118,232,"unio.cat",276
17,"17170",172,118,117,2,1,"unio.cat",0
17,"17159",627,439,434,2,5,"unio.cat",7
17,"17086",1744,1181,1170,10,11,"unio.cat",15
17,"17015",12525,8550,8470,59,80,"unio.cat",141
17,"17212",139,108,106,1,2,"unio.cat",9
17,"17111",873,643,641,12,2,"unio.cat",7
17,"17119",68,59,59,0,0,"unio.cat",0
17,"17004",510,371,368,0,3,"unio.cat",3
17,"17228",295,211,210,1,1,"unio.cat",7
17,"17064",325,219,214,1,5,"unio.cat",7
17,"17076",123,90,88,2,2,"unio.cat",2
17,"17047",4837,2997,2973,39,24,"unio.cat",33
17,"17116",348,243,240,4,3,"unio.cat",5
17,"17051",219,157,155,3,2,"unio.cat",5
17,"17160",14740,9853,9795,68,58,"unio.cat",158
17,"17087",222,169,169,3,0,"unio.cat",1
17,"17124",1638,1096,1083,10,13,"unio.cat",24
17,"17230",463,343,339,2,4,"unio.cat",8
17,"17012",1142,763,757,6,6,"unio.cat",10
17,"17125",129,88,86,0,2,"unio.cat",2
17,"17016",724,519,515,8,4,"unio.cat",15
17,"17168",374,273,272,1,1,"unio.cat",1
17,"17191",146,114,113,1,1,"unio.cat",7
17,"17214",706,471,468,4,3,"unio.cat",13
17,"17036",2736,1857,1839,16,18,"unio.cat",40
17,"17052",124,83,83,1,0,"unio.cat",0
17,"17065",335,250,249,2,1,"unio.cat",16
17,"17226",856,572,557,5,15,"unio.cat",19
17,"17077",555,386,383,5,3,"unio.cat",2
17,"17207",2373,1691,1673,18,18,"unio.cat",35
17,"17018",477,347,343,3,4,"unio.cat",8
17,"17006",1131,730,728,9,2,"unio.cat",23
17,"17192",145,108,108,1,0,"unio.cat",9
17,"17054",375,249,249,2,0,"unio.cat",5
17,"17162",147,91,90,0,1,"unio.cat",0
17,"17232",149,98,98,1,0,"unio.cat",0
17,"17089",5490,3630,3591,20,39,"unio.cat",69
17,"17126",308,252,250,2,2,"unio.cat",0
17,"17220",811,563,555,3,8,"unio.cat",11
17,"17075",334,234,227,5,7,"unio.cat",7
17,"17078",330,225,225,5,0,"unio.cat",7
17,"17090",542,410,408,3,2,"unio.cat",6
17,"17163",2609,1904,1890,18,14,"unio.cat",29
17,"17128",302,224,223,4,1,"unio.cat",6
17,"17197",137,105,105,2,0,"unio.cat",0
17,"17233",2287,1682,1664,21,18,"unio.cat",28
17,"17194",78,54,52,2,2,"unio.cat",1
17,"17042",414,288,286,2,2,"unio.cat",2
17,"17221",4182,2882,2859,18,23,"unio.cat",48
17,"17234",183,124,124,1,0,"unio.cat",3
17,"17152",10727,6804,6758,46,46,"unio.cat",120
17,"17198",430,282,281,4,1,"unio.cat",3
17,"17067",697,500,495,7,5,"unio.cat",7
17,"17129",137,99,99,1,0,"unio.cat",0
17,"17008",3636,2423,2395,15,28,"unio.cat",43
17,"17020",3590,2531,2510,28,21,"unio.cat",37
17,"17091",411,282,273,5,9,"unio.cat",14
17,"17043",158,119,117,1,2,"unio.cat",5
17,"17039",1764,1229,1217,20,12,"unio.cat",27
17,"17056",1706,1200,1193,10,7,"unio.cat",27
17,"17199",6845,4527,4483,32,44,"unio.cat",90
17,"17021",135,86,86,2,0,"unio.cat",3
17,"17901",989,696,686,7,10,"unio.cat",19
17,"17112",192,141,139,1,2,"unio.cat",6
17,"17161",990,737,734,7,3,"unio.cat",11
17,"17033",5293,3509,3476,28,33,"unio.cat",43
17,"17130",328,246,245,2,1,"unio.cat",7
17,"17069",378,270,267,4,3,"unio.cat",5
17,"17022",6926,4626,4587,47,39,"unio.cat",79
17,"17092",3508,2373,2347,13,26,"unio.cat",51
17,"17103",4942,3150,3129,19,21,"unio.cat",36
17,"17010",330,247,246,5,1,"unio.cat",2
17,"17150",1407,1074,1060,12,14,"unio.cat",18
17,"17143",146,109,107,1,2,"unio.cat",6
17,"17057",960,708,699,8,9,"unio.cat",13
17,"17044",6767,4737,4694,36,43,"unio.cat",93
17,"17093",893,590,585,6,5,"unio.cat",8
17,"17200",618,425,422,4,3,"unio.cat",3
17,"17132",1311,923,913,10,10,"unio.cat",21
17,"17082",410,273,268,3,5,"unio.cat",6
17,"17902",1353,957,947,9,10,"unio.cat",24
17,"17166",516,386,378,2,8,"unio.cat",3
17,"17903",897,647,638,0,9,"unio.cat",16
17,"17201",128,93,92,1,1,"unio.cat",2
17,"17058",180,132,131,1,1,"unio.cat",4
17,"17224",314,214,213,3,1,"unio.cat",4
17,"17106",139,108,106,0,2,"unio.cat",4
17,"17094",1049,646,641,3,5,"unio.cat",12
17,"17133",1268,887,877,6,10,"unio.cat",27
17,"17083",2935,2059,2042,17,17,"unio.cat",18
17,"17190",842,592,590,10,2,"unio.cat",13
17,"17024",279,176,176,2,0,"unio.cat",8
18,"18028",945,790,781,2,9,"PSOE",301
18,"18154",1016,716,716,2,0,"PSOE",327
18,"18136",1875,1477,1470,7,7,"PSOE",848
18,"18145",10432,7829,7767,56,62,"PSOE",1782
18,"18903",892,650,645,1,5,"PSOE",296
18,"18072",666,481,474,4,7,"PSOE",211
18,"18001",256,178,177,2,1,"PSOE",95
18,"18045",1149,803,789,10,14,"PSOE",454
18,"18004",724,511,505,3,6,"PSOE",216
18,"18906",917,681,673,2,8,"PSOE",233
18,"18123",293,228,227,2,1,"PSOE",106
18,"18070",283,223,218,0,5,"PSOE",70
18,"18158",8408,5604,5542,38,62,"PSOE",2642
18,"18124",393,274,271,1,3,"PSOE",76
18,"18910",803,573,569,5,4,"PSOE",225
18,"18180",631,448,447,2,1,"PSOE",211
18,"18003",14022,10417,10330,82,87,"PSOE",2792
18,"18116",2882,2245,2215,19,30,"PSOE",752
18,"18011",4321,3136,3119,10,17,"PSOE",1070
18,"18033",294,220,219,1,1,"PSOE",118
18,"18049",617,456,451,3,5,"PSOE",185
18,"18152",938,687,681,1,6,"PSOE",470
18,"18174",442,354,348,2,6,"PSOE",150
18,"18147",3734,2416,2386,10,30,"PSOE",872
18,"18068",1566,1234,1214,5,20,"PSOE",302
18,"18905",14500,10137,10058,82,79,"PSOE",2932
18,"18175",11624,8549,8467,41,82,"PSOE",3026
18,"18143",979,781,776,2,5,"PSOE",282
18,"18010",563,463,459,4,4,"PSOE",190
18,"18035",1255,964,958,4,6,"PSOE",397
18,"18170",336,227,225,1,2,"PSOE",113
18,"18194",2152,1487,1477,6,10,"PSOE",752
18,"18120",270,218,216,2,2,"PSOE",139
18,"18082",867,626,621,4,5,"PSOE",229
18,"18053",1667,1084,1078,9,6,"PSOE",471
18,"18111",2743,2046,2033,14,13,"PSOE",591
18,"18063",1191,770,767,6,3,"PSOE",414
18,"18151",260,196,196,0,0,"PSOE",84
18,"18184",2158,1659,1634,4,25,"PSOE",716
18,"18179",546,378,377,1,1,"PSOE",169
18,"18085",729,489,484,2,5,"PSOE",236
18,"18093",2752,1873,1858,10,15,"PSOE",753
18,"18162",951,744,734,0,10,"PSOE",311
18,"18137",1005,758,758,6,0,"PSOE",289
18,"18167",1897,1321,1313,8,8,"PSOE",614
18,"18042",414,342,341,0,1,"PSOE",115
18,"18144",782,596,588,3,8,"PSOE",135
18,"18149",5177,3946,3902,29,44,"PSOE",942
18,"18101",9263,6971,6912,55,59,"PSOE",1593
18,"18084",4215,3179,3143,24,36,"PSOE",750
18,"18161",220,184,184,1,0,"PSOE",70
18,"18014",6372,4620,4566,44,54,"PSOE",1130
18,"18020",1469,1046,1032,7,14,"PSOE",501
18,"18016",323,239,237,0,2,"PSOE",119
18,"18043",129,95,95,0,0,"PSOE",15
18,"18141",414,282,277,1,5,"PSOE",56
18,"18006",4161,2816,2788,29,28,"PSOE",1054
18,"18012",2330,1670,1660,15,10,"PSOE",715
18,"18913",818,617,603,2,14,"PSOE",162
18,"18105",4548,3169,3139,19,30,"PSOE",1637
18,"18061",1059,822,816,1,6,"PSOE",263
18,"18165",4135,2944,2915,23,29,"PSOE",1090
18,"18034",510,391,391,1,0,"PSOE",141
18,"18018",640,490,488,0,2,"PSOE",216
18,"18173",8978,6319,6251,50,68,"PSOE",2326
18,"18074",273,217,213,2,4,"PSOE",110
18,"18100",7769,5715,5637,57,78,"PSOE",2667
18,"18127",16586,11998,11897,97,101,"PSOE",3788
18,"18182",1919,1356,1347,3,9,"PSOE",691
18,"18050",1711,1271,1256,5,15,"PSOE",470
18,"18056",3545,2716,2687,25,29,"PSOE",1138
18,"18109",599,421,419,2,2,"PSOE",158
18,"18107",971,719,711,6,8,"PSOE",396
18,"18188",1642,1249,1234,8,15,"PSOE",620
18,"18911",7392,5359,5301,44,58,"PSOE",1500
18,"18005",375,266,265,2,1,"PSOE",156
18,"18133",2187,1731,1722,7,9,"PSOE",595
18,"18079",3465,2671,2645,16,26,"PSOE",1348
18,"18176",258,179,178,3,1,"PSOE",107
18,"18097",956,703,691,1,12,"PSOE",267
18,"18908",805,633,620,2,13,"PSOE",291
18,"18047",5888,4028,4000,32,28,"PSOE",1020
18,"18163",324,239,235,1,4,"PSOE",81
18,"18083",266,210,207,1,3,"PSOE",80
18,"18189",772,599,595,7,4,"PSOE",152
18,"18017",18172,12077,11954,101,123,"PSOE",3053
18,"18071",5583,4221,4176,33,45,"PSOE",1482
18,"18153",8580,6314,6260,39,54,"PSOE",1612
18,"18037",530,411,408,1,3,"PSOE",146
18,"18025",294,216,214,0,2,"PSOE",106
18,"18115",2548,1872,1854,16,18,"PSOE",733
18,"18069",493,366,363,3,3,"PSOE",145
18,"18078",739,593,590,4,3,"PSOE",275
18,"18095",1959,1486,1474,5,12,"PSOE",587
18,"18040",225,142,141,0,1,"PSOE",42
18,"18187",561,418,417,1,1,"PSOE",228
18,"18112",131,88,86,1,2,"PSOE",35
18,"18134",5811,4002,3946,25,56,"PSOE",1048
18,"18157",1123,836,823,8,13,"PSOE",220
18,"18039",3544,2544,2511,34,33,"PSOE",1204
18,"18076",815,577,576,0,1,"PSOE",352
18,"18089",15132,10489,10402,64,87,"PSOE",3689
18,"18168",809,589,588,5,1,"PSOE",170
18,"18901",512,359,357,1,2,"PSOE",94
18,"18048",2390,1824,1806,8,18,"PSOE",759
18,"18086",355,285,283,0,2,"PSOE",189
18,"18132",3312,2582,2556,14,26,"PSOE",1365
18,"18185",556,461,461,1,0,"PSOE",139
18,"18022",13306,9165,9091,51,74,"PSOE",2764
18,"18030",584,428,426,3,2,"PSOE",182
18,"18032",239,178,175,0,3,"PSOE",32
18,"18064",379,308,308,1,0,"PSOE",144
18,"18087",184873,138280,137516,836,764,"PSOE",28029
18,"18177",427,259,258,3,1,"PSOE",108
18,"18023",15738,11242,11146,92,96,"PSOE",3766
18,"18193",14194,10280,10196,91,84,"PSOE",2543
18,"18114",634,457,452,2,5,"PSOE",198
18,"18902",847,680,674,10,6,"PSOE",320
18,"18912",1488,1021,1007,7,14,"PSOE",578
18,"18126",1497,1094,1087,7,7,"PSOE",394
18,"18904",779,570,565,1,5,"PSOE",275
18,"18024",855,660,653,8,7,"PSOE",248
18,"18015",443,338,337,0,1,"PSOE",162
18,"18059",4153,3074,3039,23,35,"PSOE",1157
18,"18150",6730,4858,4814,28,44,"PSOE",1631
18,"18907",1859,1482,1475,5,7,"PSOE",672
18,"18148",819,671,666,1,5,"PSOE",240
18,"18013",4236,3108,3052,19,56,"PSOE",1127
18,"18051",1149,825,823,7,2,"PSOE",475
18,"18146",970,734,727,6,7,"PSOE",334
18,"18098",6167,4367,4342,22,25,"PSOE",1854
18,"18171",2123,1640,1616,14,24,"PSOE",689
18,"18178",743,571,571,2,0,"PSOE",282
18,"18088",1556,1113,1108,5,5,"PSOE",489
18,"18192",1529,1216,1208,3,8,"PSOE",541
18,"18119",1729,1353,1340,13,13,"PSOE",508
18,"18140",43567,29155,28932,194,223,"PSOE",9028
18,"18914",1658,1304,1290,8,14,"PSOE",621
18,"18099",1581,1271,1249,10,22,"PSOE",433
18,"18027",2562,1846,1827,19,19,"PSOE",785
18,"18138",2482,1721,1712,8,9,"PSOE",729
18,"18029",1833,1252,1243,9,9,"PSOE",681
18,"18159",1009,811,802,3,9,"PSOE",326
18,"18128",344,251,248,0,3,"PSOE",70
18,"18102",8424,5783,5716,41,67,"PSOE",2697
18,"18103",760,596,593,6,3,"PSOE",308
18,"18054",868,630,627,2,3,"PSOE",187
18,"18066",2108,1546,1540,4,6,"PSOE",783
18,"18121",132,101,100,1,1,"PSOE",40
18,"18181",223,159,157,0,2,"PSOE",30
18,"18096",342,260,259,1,1,"PSOE",158
18,"18057",5263,3968,3937,33,31,"PSOE",1086
18,"18036",3768,2904,2882,18,22,"PSOE",604
18,"18021",17451,12420,12305,101,115,"PSOE",3220
18,"18002",561,446,444,1,2,"PSOE",299
18,"18117",513,402,396,4,6,"PSOE",180
18,"18046",1867,1225,1215,8,10,"PSOE",520
18,"18062",10298,7584,7512,67,72,"PSOE",2097
18,"18135",4583,3045,2998,14,47,"PSOE",1521
18,"18038",1066,836,826,2,10,"PSOE",410
18,"18909",589,462,459,0,3,"PSOE",230
18,"18094",2389,1853,1832,22,21,"PSOE",590
18,"18067",711,517,516,0,1,"PSOE",262
18,"18108",858,672,667,0,5,"PSOE",290
18,"18007",785,527,523,3,4,"PSOE",305
18,"18065",625,503,500,1,3,"PSOE",146
18,"18183",660,468,465,3,3,"PSOE",206
18,"18164",1831,1273,1260,11,13,"PSOE",438
18,"18044",179,116,116,0,0,"PSOE",47
18,"18122",16171,11670,11508,106,162,"PSOE",4666
17,"17014",61,47,47,1,0,"PSC-PSOE",7
17,"17154",92,62,62,0,0,"PSC-PSOE",8
17,"17193",4216,2807,2768,26,39,"PSC-PSOE",362
17,"17058",180,132,131,1,1,"PSC-PSOE",6
17,"17074",507,345,341,1,4,"PSC-PSOE",35
17,"17143",146,109,107,1,2,"PSC-PSOE",4
17,"17096",178,115,114,0,1,"PSC-PSOE",0
17,"17170",172,118,117,2,1,"PSC-PSOE",4
17,"17060",424,277,274,3,3,"PSC-PSOE",14
17,"17062",5970,3695,3657,31,38,"PSC-PSOE",571
17,"17001",585,417,413,2,4,"PSC-PSOE",34
17,"17041",215,146,145,2,1,"PSC-PSOE",20
17,"17227",128,95,95,0,0,"PSC-PSOE",5
17,"17230",463,343,339,2,4,"PSC-PSOE",38
17,"17105",255,170,170,2,0,"PSC-PSOE",8
17,"17182",262,191,191,2,0,"PSC-PSOE",52
17,"17148",1535,1056,1045,12,11,"PSC-PSOE",111
17,"17196",214,151,151,2,0,"PSC-PSOE",10
17,"17191",146,114,113,1,1,"PSC-PSOE",5
17,"17066",26551,16275,16166,140,109,"PSC-PSOE",2323
17,"17011",646,463,462,7,1,"PSC-PSOE",41
17,"17116",348,243,240,4,3,"PSC-PSOE",11
17,"17126",308,252,250,2,2,"PSC-PSOE",5
17,"17151",174,124,123,3,1,"PSC-PSOE",9
17,"17078",330,225,225,5,0,"PSC-PSOE",5
17,"17202",3803,2471,2449,13,22,"PSC-PSOE",343
17,"17185",2293,1547,1527,12,20,"PSC-PSOE",156
17,"17112",192,141,139,1,2,"PSC-PSOE",6
17,"17012",1142,763,757,6,6,"PSC-PSOE",68
17,"17159",627,439,434,2,5,"PSC-PSOE",31
17,"17139",1382,972,963,9,9,"PSC-PSOE",105
17,"17117",14280,9297,9223,75,74,"PSC-PSOE",1680
17,"17009",4042,2770,2738,18,32,"PSC-PSOE",201
17,"17165",653,445,443,2,2,"PSC-PSOE",37
17,"17110",1325,953,945,5,8,"PSC-PSOE",155
17,"17161",990,737,734,7,3,"PSC-PSOE",38
17,"17194",78,54,52,2,2,"PSC-PSOE",0
17,"17073",1875,1466,1460,11,6,"PSC-PSOE",63
17,"17200",618,425,422,4,3,"PSC-PSOE",38
17,"17211",839,646,639,3,7,"PSC-PSOE",42
17,"17089",5490,3630,3591,20,39,"PSC-PSOE",451
17,"17146",2979,2030,2009,14,21,"PSC-PSOE",241
17,"17180",8300,5429,5368,42,61,"PSC-PSOE",545
17,"17063",166,115,113,0,2,"PSC-PSOE",3
17,"17050",649,499,495,3,4,"PSC-PSOE",20
17,"17048",6269,4072,4044,24,28,"PSC-PSOE",660
17,"17042",414,288,286,2,2,"PSC-PSOE",21
17,"17085",293,223,221,1,2,"PSC-PSOE",12
17,"17049",3125,2251,2233,7,18,"PSC-PSOE",254
17,"17065",335,250,249,2,1,"PSC-PSOE",1
17,"17178",1063,690,685,5,5,"PSC-PSOE",60
17,"17101",543,364,362,3,2,"PSC-PSOE",51
17,"17033",5293,3509,3476,28,33,"PSC-PSOE",452
17,"17034",6874,4509,4477,32,32,"PSC-PSOE",608
17,"17220",811,563,555,3,8,"PSC-PSOE",27
17,"17173",180,141,139,2,2,"PSC-PSOE",12
17,"17024",279,176,176,2,0,"PSC-PSOE",7
17,"17160",14740,9853,9795,68,58,"PSC-PSOE",1786
17,"17137",3411,2391,2369,15,22,"PSC-PSOE",176
17,"17102",576,397,395,4,2,"PSC-PSOE",30
17,"17172",452,308,307,1,1,"PSC-PSOE",19
17,"17218",588,448,445,3,3,"PSC-PSOE",15
17,"17111",873,643,641,12,2,"PSC-PSOE",22
17,"17125",129,88,86,0,2,"PSC-PSOE",3
17,"17195",338,256,251,2,5,"PSC-PSOE",19
17,"17222",109,85,85,1,0,"PSC-PSOE",2
17,"17166",516,386,378,2,8,"PSC-PSOE",13
17,"17114",23020,15151,15024,105,127,"PSC-PSOE",1946
17,"17075",334,234,227,5,7,"PSC-PSOE",8
17,"17162",147,91,90,0,1,"PSC-PSOE",4
17,"17184",1258,893,887,6,6,"PSC-PSOE",29
17,"17025",1124,834,827,3,7,"PSC-PSOE",57
17,"17013",2787,1941,1926,17,15,"PSC-PSOE",349
17,"17051",219,157,155,3,2,"PSC-PSOE",3
17,"17094",1049,646,641,3,5,"PSC-PSOE",49
17,"17044",6767,4737,4694,36,43,"PSC-PSOE",442
17,"17204",562,385,384,7,1,"PSC-PSOE",51
17,"17052",124,83,83,1,0,"PSC-PSOE",5
17,"17135",355,263,258,2,5,"PSC-PSOE",23
17,"17037",104,65,65,0,0,"PSC-PSOE",3
17,"17030",645,430,428,7,2,"PSC-PSOE",35
17,"17035",544,400,399,4,1,"PSC-PSOE",20
17,"17136",175,133,132,1,1,"PSC-PSOE",5
17,"17100",199,142,140,7,2,"PSC-PSOE",3
17,"17903",897,647,638,0,9,"PSC-PSOE",34
17,"17003",102,71,71,0,0,"PSC-PSOE",5
17,"17046",719,499,492,2,7,"PSC-PSOE",51
17,"17128",302,224,223,4,1,"PSC-PSOE",13
17,"17007",1730,1235,1224,4,11,"PSC-PSOE",66
17,"17186",3771,2742,2712,18,30,"PSC-PSOE",416
17,"17023",27347,18842,18610,118,232,"PSC-PSOE",3516
17,"17190",842,592,590,10,2,"PSC-PSOE",42
17,"17019",1779,1279,1261,13,18,"PSC-PSOE",127
17,"17055",152,125,125,0,0,"PSC-PSOE",9
17,"17118",12824,8557,8477,57,80,"PSC-PSOE",1256
17,"17095",19593,12648,12554,81,94,"PSC-PSOE",2419
17,"17076",123,90,88,2,2,"PSC-PSOE",3
17,"17119",68,59,59,0,0,"PSC-PSOE",2
17,"17206",141,89,87,0,2,"PSC-PSOE",2
17,"17134",234,163,161,2,2,"PSC-PSOE",8
17,"17225",213,142,142,1,0,"PSC-PSOE",8
17,"17039",1764,1229,1217,20,12,"PSC-PSOE",138
17,"17068",245,173,172,0,1,"PSC-PSOE",9
17,"17129",137,99,99,1,0,"PSC-PSOE",2
17,"17056",1706,1200,1193,10,7,"PSC-PSOE",73
17,"17032",1713,1036,1020,13,16,"PSC-PSOE",118
17,"17080",141,98,98,0,0,"PSC-PSOE",7
17,"17189",1524,1126,1114,4,12,"PSC-PSOE",98
17,"17099",80,60,59,0,1,"PSC-PSOE",1
17,"17153",186,140,140,0,0,"PSC-PSOE",4
17,"17142",2561,1962,1950,13,12,"PSC-PSOE",214
17,"17138",944,668,663,4,5,"PSC-PSOE",163
17,"17081",244,165,163,0,2,"PSC-PSOE",12
17,"17232",149,98,98,1,0,"PSC-PSOE",5
17,"17203",154,110,110,0,0,"PSC-PSOE",5
17,"17057",960,708,699,8,9,"PSC-PSOE",57
17,"17006",1131,730,728,9,2,"PSC-PSOE",51
17,"17192",145,108,108,1,0,"PSC-PSOE",6
17,"17092",3508,2373,2347,13,26,"PSC-PSOE",404
17,"17902",1353,957,947,9,10,"PSC-PSOE",64
17,"17098",311,224,221,2,3,"PSC-PSOE",23
17,"17109",693,443,435,2,8,"PSC-PSOE",18
17,"17141",5869,3688,3653,38,35,"PSC-PSOE",484
17,"17031",172,109,109,3,0,"PSC-PSOE",6
17,"17215",2066,1588,1577,12,11,"PSC-PSOE",160
17,"17093",893,590,585,6,5,"PSC-PSOE",42
17,"17086",1744,1181,1170,10,11,"PSC-PSOE",222
17,"17123",357,275,273,3,2,"PSC-PSOE",6
17,"17147",8112,5475,5422,43,53,"PSC-PSOE",738
17,"17144",210,141,141,2,0,"PSC-PSOE",9
17,"17015",12525,8550,8470,59,80,"PSC-PSOE",550
17,"17155",14500,9167,9080,43,87,"PSC-PSOE",1702
17,"17234",183,124,124,1,0,"PSC-PSOE",9
17,"17152",10727,6804,6758,46,46,"PSC-PSOE",1048
17,"17205",212,166,166,2,0,"PSC-PSOE",11
17,"17168",374,273,272,1,1,"PSC-PSOE",18
17,"17103",4942,3150,3129,19,21,"PSC-PSOE",507
17,"17145",1488,1003,986,9,17,"PSC-PSOE",94
17,"17008",3636,2423,2395,15,28,"PSC-PSOE",228
17,"17087",222,169,169,3,0,"PSC-PSOE",6
17,"17171",163,123,122,0,1,"PSC-PSOE",10
17,"17175",579,366,360,4,6,"PSC-PSOE",77
17,"17198",430,282,281,4,1,"PSC-PSOE",27
17,"17188",165,126,126,0,0,"PSC-PSOE",3
17,"17207",2373,1691,1673,18,18,"PSC-PSOE",52
17,"17181",3380,2272,2251,15,21,"PSC-PSOE",239
17,"17177",563,359,354,3,5,"PSC-PSOE",18
17,"17208",997,679,671,12,8,"PSC-PSOE",36
17,"17097",199,149,148,5,1,"PSC-PSOE",4
17,"17038",369,255,253,2,2,"PSC-PSOE",5
17,"17018",477,347,343,3,4,"PSC-PSOE",33
17,"17021",135,86,86,2,0,"PSC-PSOE",8
17,"17061",162,119,119,1,0,"PSC-PSOE",2
17,"17040",538,392,391,4,1,"PSC-PSOE",15
17,"17077",555,386,383,5,3,"PSC-PSOE",38
17,"17169",2475,1733,1724,11,9,"PSC-PSOE",233
17,"17233",2287,1682,1664,21,18,"PSC-PSOE",127
17,"17004",510,371,368,0,3,"PSC-PSOE",24
17,"17027",2826,1993,1973,10,20,"PSC-PSOE",181
17,"17183",274,186,186,3,0,"PSC-PSOE",8
17,"17201",128,93,92,1,1,"PSC-PSOE",3
17,"17199",6845,4527,4483,32,44,"PSC-PSOE",433
17,"17036",2736,1857,1839,16,18,"PSC-PSOE",200
17,"17071",1131,810,803,8,7,"PSC-PSOE",32
17,"17132",1311,923,913,10,10,"PSC-PSOE",62
17,"17082",410,273,268,3,5,"PSC-PSOE",10
17,"17070",109,82,82,1,0,"PSC-PSOE",3
17,"17163",2609,1904,1890,18,14,"PSC-PSOE",105
17,"17174",176,102,102,3,0,"PSC-PSOE",1
17,"17216",165,112,110,0,2,"PSC-PSOE",8
17,"17121",221,157,156,1,1,"PSC-PSOE",4
17,"17069",378,270,267,4,3,"PSC-PSOE",8
17,"17150",1407,1074,1060,12,14,"PSC-PSOE",84
17,"17022",6926,4626,4587,47,39,"PSC-PSOE",715
17,"17133",1268,887,877,6,10,"PSC-PSOE",41
17,"17115",277,195,195,0,0,"PSC-PSOE",10
17,"17213",5372,3549,3517,17,32,"PSC-PSOE",423
17,"17124",1638,1096,1083,10,13,"PSC-PSOE",145
17,"17106",139,108,106,0,2,"PSC-PSOE",8
17,"17209",625,480,477,2,3,"PSC-PSOE",42
17,"17164",3996,2555,2543,23,12,"PSC-PSOE",306
17,"17187",621,468,464,6,4,"PSC-PSOE",43
17,"17158",464,284,281,0,3,"PSC-PSOE",31
17,"17054",375,249,249,2,0,"PSC-PSOE",30
17,"17210",551,378,376,2,2,"PSC-PSOE",22
17,"17212",139,108,106,1,2,"PSC-PSOE",1
17,"17226",856,572,557,5,15,"PSC-PSOE",78
17,"17224",314,214,213,3,1,"PSC-PSOE",11
17,"17120",792,530,518,3,12,"PSC-PSOE",39
17,"17090",542,410,408,3,2,"PSC-PSOE",17
17,"17901",989,696,686,7,10,"PSC-PSOE",53
17,"17214",706,471,468,4,3,"PSC-PSOE",26
17,"17140",674,498,495,5,3,"PSC-PSOE",58
17,"17157",126,104,102,1,2,"PSC-PSOE",3
17,"17010",330,247,246,5,1,"PSC-PSOE",10
17,"17197",137,105,105,2,0,"PSC-PSOE",8
17,"17221",4182,2882,2859,18,23,"PSC-PSOE",423
17,"17067",697,500,495,7,5,"PSC-PSOE",45
17,"17026",536,381,380,6,1,"PSC-PSOE",18
17,"17088",535,372,369,0,3,"PSC-PSOE",13
17,"17228",295,211,210,1,1,"PSC-PSOE",10
17,"17064",325,219,214,1,5,"PSC-PSOE",15
17,"17091",411,282,273,5,9,"PSC-PSOE",15
17,"17083",2935,2059,2042,17,17,"PSC-PSOE",298
17,"17079",64159,44230,43902,271,328,"PSC-PSOE",5530
17,"17107",268,189,188,2,1,"PSC-PSOE",4
17,"17223",807,528,520,6,8,"PSC-PSOE",56
17,"17047",4837,2997,2973,39,24,"PSC-PSOE",324
17,"17029",203,131,131,2,0,"PSC-PSOE",5
17,"17028",303,213,213,4,0,"PSC-PSOE",4
17,"17149",363,267,264,0,3,"PSC-PSOE",10
17,"17167",2697,1876,1852,24,24,"PSC-PSOE",236
17,"17043",158,119,117,1,2,"PSC-PSOE",1
17,"17002",556,429,419,1,10,"PSC-PSOE",18
17,"17020",3590,2531,2510,28,21,"PSC-PSOE",161
17,"17016",724,519,515,8,4,"PSC-PSOE",34
17,"17130",328,246,245,2,1,"PSC-PSOE",6
17,"17217",348,268,266,0,2,"PSC-PSOE",15
17,"17084",236,160,160,7,0,"PSC-PSOE",12
17,"17005",401,263,260,5,3,"PSC-PSOE",21
17,"17176",122,91,91,2,0,"PSC-PSOE",3
48,"48010",457,311,307,1,4,"EAJ-PNV",151
48,"48057",5749,4093,4081,20,12,"EAJ-PNV",1627
48,"48047",161,112,112,0,0,"EAJ-PNV",32
48,"48053",900,676,670,8,6,"EAJ-PNV",325
48,"48012",2041,1571,1553,11,18,"EAJ-PNV",684
48,"48027",22033,15929,15825,113,104,"EAJ-PNV",4899
48,"48045",5149,3940,3885,35,55,"EAJ-PNV",1567
48,"48906",775,579,574,0,5,"EAJ-PNV",276
48,"48091",1134,821,812,7,9,"EAJ-PNV",281
48,"48093",900,673,664,4,9,"EAJ-PNV",252
48,"48069",12765,8985,8910,58,75,"EAJ-PNV",3710
48,"48054",24135,17493,17374,124,119,"EAJ-PNV",4760
48,"48052",1559,1215,1211,0,4,"EAJ-PNV",407
48,"48084",22577,15689,15540,108,149,"EAJ-PNV",2946
48,"48011",9692,6891,6843,56,48,"EAJ-PNV",1766
48,"48050",198,153,150,0,3,"EAJ-PNV",57
48,"48035",412,313,312,4,1,"EAJ-PNV",153
48,"48081",1883,1412,1398,12,14,"EAJ-PNV",640
48,"48021",1352,952,946,8,6,"EAJ-PNV",429
48,"48048",562,399,394,3,5,"EAJ-PNV",172
48,"48071",6118,4467,4412,32,55,"EAJ-PNV",1413
48,"48096",6608,5071,5011,43,60,"EAJ-PNV",1918
48,"48023",594,470,468,4,2,"EAJ-PNV",195
48,"48078",38742,28064,27837,231,227,"EAJ-PNV",5439
48,"48907",355,283,282,2,1,"EAJ-PNV",145
48,"48095",2352,1658,1647,6,11,"EAJ-PNV",388
48,"48077",3367,2438,2423,17,15,"EAJ-PNV",1014
48,"48002",7851,5767,5713,41,54,"EAJ-PNV",1453
48,"48060",3645,2277,2274,7,3,"EAJ-PNV",984
48,"48022",2355,1476,1468,9,8,"EAJ-PNV",694
48,"48080",9971,7148,7086,71,62,"EAJ-PNV",1745
48,"48026",1134,861,853,7,8,"EAJ-PNV",304
48,"48059",402,317,314,1,3,"EAJ-PNV",145
48,"48915",362,238,238,2,0,"EAJ-PNV",82
48,"48065",3315,2447,2433,19,14,"EAJ-PNV",849
48,"48008",617,433,424,6,9,"EAJ-PNV",234
48,"48088",135,97,96,0,1,"EAJ-PNV",21
48,"48001",5832,4191,4166,37,25,"EAJ-PNV",903
48,"48901",4775,3602,3573,35,29,"EAJ-PNV",1051
48,"48009",786,614,609,3,5,"EAJ-PNV",240
48,"48006",289,246,245,3,1,"EAJ-PNV",96
48,"48025",883,642,639,3,3,"EAJ-PNV",300
48,"48090",6022,4544,4483,23,61,"EAJ-PNV",1579
48,"48068",1551,1178,1163,16,15,"EAJ-PNV",649
48,"48043",4403,3214,3186,28,28,"EAJ-PNV",1255
48,"48041",704,558,555,4,3,"EAJ-PNV",286
48,"48913",1251,933,917,13,16,"EAJ-PNV",372
48,"48902",19124,13344,13227,93,117,"EAJ-PNV",3642
48,"48904",3504,2671,2650,18,21,"EAJ-PNV",1156
48,"48028",715,553,551,4,2,"EAJ-PNV",229
48,"48024",1003,775,771,5,4,"EAJ-PNV",370
48,"48066",346,256,256,1,0,"EAJ-PNV",153
48,"48031",340,245,242,0,3,"EAJ-PNV",127
48,"48049",548,433,431,0,2,"EAJ-PNV",220
48,"48070",545,378,374,2,4,"EAJ-PNV",111
48,"48051",220,169,168,0,1,"EAJ-PNV",55
48,"48033",215,160,159,0,1,"EAJ-PNV",78
48,"48079",425,322,321,4,1,"EAJ-PNV",125
48,"48017",13290,8908,8856,42,52,"EAJ-PNV",3789
48,"48042",1384,1111,1091,7,20,"EAJ-PNV",525
48,"48003",14338,10497,10414,76,83,"EAJ-PNV",3485
48,"48085",10301,7458,7407,50,51,"EAJ-PNV",2326
48,"48020",274076,193807,192607,1471,1200,"EAJ-PNV",52690
48,"48082",37673,27006,26811,201,195,"EAJ-PNV",5926
48,"48032",5735,4173,4151,32,22,"EAJ-PNV",1201
48,"48086",2073,1519,1504,15,15,"EAJ-PNV",511
48,"48063",373,289,288,1,1,"EAJ-PNV",122
48,"48087",429,346,343,1,3,"EAJ-PNV",182
48,"48097",1303,907,898,10,9,"EAJ-PNV",265
48,"48040",1299,896,884,5,12,"EAJ-PNV",407
48,"48037",678,518,509,2,9,"EAJ-PNV",229
48,"48013",79984,56928,56516,383,412,"EAJ-PNV",10130
48,"48007",365,241,239,0,2,"EAJ-PNV",102
48,"48015",33690,24299,24160,168,139,"EAJ-PNV",5991
48,"48038",1122,834,824,0,10,"EAJ-PNV",404
48,"48911",382,291,286,2,5,"EAJ-PNV",79
48,"48039",243,201,201,2,0,"EAJ-PNV",96
48,"48058",972,691,687,4,4,"EAJ-PNV",222
48,"48055",2662,1961,1938,16,23,"EAJ-PNV",670
48,"48074",3333,2467,2428,20,39,"EAJ-PNV",788
48,"48067",1161,837,834,2,3,"EAJ-PNV",326
48,"48036",24144,17085,16954,117,131,"EAJ-PNV",4959
48,"48076",314,237,237,4,0,"EAJ-PNV",136
48,"48914",330,275,275,1,0,"EAJ-PNV",144
48,"48030",608,454,453,4,1,"EAJ-PNV",222
48,"48909",207,165,165,1,0,"EAJ-PNV",56
48,"48905",2565,1882,1847,2,35,"EAJ-PNV",763
48,"48903",1838,1400,1385,4,15,"EAJ-PNV",696
48,"48072",974,728,723,5,5,"EAJ-PNV",250
48,"48029",8332,6155,6119,35,36,"EAJ-PNV",1204
48,"48089",3266,2425,2406,23,19,"EAJ-PNV",909
48,"48908",245,200,199,1,1,"EAJ-PNV",84
48,"48092",837,619,619,13,0,"EAJ-PNV",303
48,"48046",12617,9037,8967,56,70,"EAJ-PNV",3472
48,"48005",117,76,76,0,0,"EAJ-PNV",24
48,"48004",334,229,227,1,2,"EAJ-PNV",96
48,"48083",6950,5128,5097,33,31,"EAJ-PNV",1113
48,"48061",762,584,581,4,3,"EAJ-PNV",271
48,"48034",12902,9684,9613,79,71,"EAJ-PNV",1041
48,"48014",1218,870,866,8,4,"EAJ-PNV",293
48,"48044",62989,46989,46783,385,206,"EAJ-PNV",13818
48,"48073",6952,4476,4435,43,41,"EAJ-PNV",1462
48,"48019",3594,2569,2544,16,25,"EAJ-PNV",742
48,"48018",875,553,553,3,0,"EAJ-PNV",220
48,"48094",3193,2210,2200,18,10,"EAJ-PNV",876
48,"48016",5260,3856,3827,22,29,"EAJ-PNV",1086
48,"48912",2308,1787,1746,27,41,"EAJ-PNV",585
48,"48910",2948,2126,2115,17,11,"EAJ-PNV",556
48,"48062",300,241,240,1,1,"EAJ-PNV",119
48,"48056",978,733,732,7,1,"EAJ-PNV",330
48,"48064",603,463,459,7,4,"EAJ-PNV",177
48,"48075",1975,1440,1421,12,19,"EAJ-PNV",623
34,"34061",108,80,80,0,0,"C's",19
34,"34158",290,190,188,3,2,"C's",21
34,"34113",37,36,36,0,0,"C's",3
34,"34038",277,202,202,3,0,"C's",24
34,"34091",123,97,95,1,2,"C's",9
34,"34234",72,57,55,0,2,"C's",5
34,"34103",96,78,77,2,1,"C's",6
34,"34053",209,170,168,4,2,"C's",11
34,"34143",172,127,126,3,1,"C's",15
34,"34068",25,24,24,1,0,"C's",0
34,"34224",45,31,31,0,0,"C's",1
34,"34134",53,37,37,2,0,"C's",1
34,"34099",61,51,50,0,1,"C's",0
34,"34159",363,277,269,4,8,"C's",23
34,"34215",163,148,148,2,0,"C's",19
34,"34037",310,218,217,4,1,"C's",26
34,"34084",140,110,108,1,2,"C's",14
34,"34170",62,49,49,0,0,"C's",7
34,"34025",61,44,44,1,0,"C's",8
34,"34041",89,71,71,1,0,"C's",13
34,"34127",95,64,64,2,0,"C's",4
34,"34123",1668,1346,1319,20,27,"C's",154
34,"34034",126,93,93,1,0,"C's",8
34,"34022",1095,915,909,8,6,"C's",79
34,"34116",62,41,41,0,0,"C's",1
34,"34227",76,62,62,1,0,"C's",10
34,"34204",47,39,39,2,0,"C's",2
34,"34205",59,45,45,0,0,"C's",6
34,"34009",33,29,26,1,3,"C's",2
34,"34045",77,65,65,2,0,"C's",4
34,"34004",5626,4226,4178,41,48,"C's",608
34,"34171",982,720,710,7,10,"C's",67
34,"34130",213,175,172,2,3,"C's",14
34,"34903",198,128,127,1,1,"C's",7
34,"34063",86,80,79,1,1,"C's",4
34,"34089",157,124,122,1,2,"C's",15
34,"34088",231,192,190,2,2,"C's",31
34,"34180",68,56,56,2,0,"C's",10
34,"34020",53,39,39,0,0,"C's",5
34,"34010",570,437,429,5,8,"C's",58
34,"34106",114,94,94,2,0,"C's",19
34,"34157",2460,1872,1836,26,36,"C's",241
34,"34028",144,121,119,1,2,"C's",7
34,"34228",81,66,66,0,0,"C's",7
34,"34185",65,46,44,2,2,"C's",4
34,"34210",102,90,89,0,1,"C's",11
34,"34231",232,167,167,4,0,"C's",23
34,"34029",727,596,582,4,14,"C's",58
34,"34001",35,28,28,2,0,"C's",1
34,"34066",58,45,45,0,0,"C's",13
34,"34079",1601,1285,1269,11,16,"C's",251
34,"34232",748,601,586,11,15,"C's",48
34,"34058",184,167,167,0,0,"C's",14
34,"34176",134,102,100,2,2,"C's",21
34,"34184",55,46,42,0,4,"C's",1
34,"34154",76,54,52,0,2,"C's",1
34,"34120",64404,49403,48884,379,519,"C's",7697
34,"34131",59,50,48,0,2,"C's",2
34,"34169",404,302,300,2,2,"C's",35
34,"34094",61,42,40,1,2,"C's",7
34,"34104",247,203,199,0,4,"C's",24
34,"34108",537,453,446,5,7,"C's",44
34,"34101",54,42,42,0,0,"C's",4
34,"34003",163,127,125,0,2,"C's",15
34,"34230",15,12,12,0,0,"C's",2
34,"34233",131,116,116,1,0,"C's",9
34,"34076",597,494,490,3,4,"C's",60
34,"34059",422,348,341,6,7,"C's",23
34,"34121",192,155,154,2,1,"C's",15
34,"34035",113,90,89,1,1,"C's",2
34,"34124",61,47,46,0,1,"C's",3
34,"34135",391,296,291,4,5,"C's",33
34,"34149",20,15,15,0,0,"C's",3
34,"34240",90,71,70,2,1,"C's",9
34,"34146",55,42,42,0,0,"C's",3
34,"34902",140,115,114,0,1,"C's",11
34,"34122",84,66,65,0,1,"C's",15
34,"34019",125,103,101,1,2,"C's",23
34,"34147",167,120,120,1,0,"C's",20
34,"34005",858,670,651,6,19,"C's",65
34,"34178",113,92,91,5,1,"C's",11
34,"34086",105,91,88,1,3,"C's",18
34,"34060",137,113,112,1,1,"C's",11
34,"34036",216,167,165,1,2,"C's",15
34,"34077",349,253,246,0,7,"C's",46
34,"34218",469,353,349,2,4,"C's",44
34,"34017",920,763,745,2,18,"C's",81
34,"34033",18,17,17,0,0,"C's",3
34,"34236",162,126,126,1,0,"C's",11
34,"34167",114,89,89,0,0,"C's",11
34,"34241",18,13,12,2,1,"C's",3
34,"34070",160,117,115,2,2,"C's",3
34,"34141",182,148,147,4,1,"C's",19
34,"34189",57,45,45,1,0,"C's",9
34,"34100",142,116,115,5,1,"C's",22
34,"34109",59,48,47,0,1,"C's",5
34,"34137",28,24,24,1,0,"C's",1
34,"34018",209,169,166,3,3,"C's",33
34,"34031",29,28,28,1,0,"C's",4
34,"34011",398,326,326,3,0,"C's",38
34,"34006",80,69,66,1,3,"C's",12
34,"34168",55,51,51,1,0,"C's",6
34,"34092",297,236,231,2,5,"C's",18
34,"34151",167,111,111,3,0,"C's",15
34,"34139",168,126,124,6,2,"C's",10
34,"34238",341,279,276,1,3,"C's",23
34,"34074",719,552,545,8,7,"C's",69
34,"34163",49,40,40,0,0,"C's",2
34,"34140",107,63,62,0,1,"C's",8
34,"34098",780,587,582,2,5,"C's",124
34,"34174",205,162,162,4,0,"C's",13
34,"34052",178,148,147,3,1,"C's",15
34,"34039",61,46,45,0,1,"C's",3
34,"34243",326,263,258,2,5,"C's",20
34,"34129",179,139,137,2,2,"C's",12
34,"34032",41,32,31,0,1,"C's",5
34,"34102",205,172,170,1,2,"C's",36
34,"34179",29,22,20,0,2,"C's",3
34,"34202",31,20,19,0,1,"C's",3
34,"34057",476,339,334,3,5,"C's",51
34,"34114",212,147,146,2,1,"C's",16
34,"34051",102,90,88,1,2,"C's",19
34,"34056",2003,1502,1487,12,15,"C's",239
34,"34213",58,43,42,2,1,"C's",3
34,"34069",2285,1711,1692,25,19,"C's",194
34,"34245",311,213,209,4,4,"C's",16
34,"34208",53,41,41,1,0,"C's",6
34,"34050",202,160,160,0,0,"C's",7
34,"34136",182,121,120,1,1,"C's",6
34,"34216",67,52,51,0,1,"C's",7
34,"34055",280,204,202,2,2,"C's",19
34,"34904",319,241,240,3,1,"C's",26
34,"34047",1803,1402,1380,15,22,"C's",209
34,"34225",4903,3830,3784,41,46,"C's",574
34,"34175",89,75,74,1,1,"C's",13
34,"34220",144,129,128,0,1,"C's",34
34,"34126",279,218,218,2,0,"C's",20
34,"34161",23,14,14,0,0,"C's",0
34,"34214",186,150,149,1,1,"C's",18
34,"34246",64,49,47,1,2,"C's",7
34,"34199",1248,955,937,18,18,"C's",110
34,"34067",129,95,95,0,0,"C's",9
34,"34096",57,46,46,3,0,"C's",4
34,"34156",49,42,41,3,1,"C's",5
34,"34112",47,38,38,0,0,"C's",6
34,"34042",300,247,244,4,3,"C's",31
34,"34177",179,149,148,1,1,"C's",11
34,"34192",93,76,76,0,0,"C's",3
34,"34024",32,19,19,0,0,"C's",3
34,"34181",453,343,337,3,6,"C's",35
34,"34071",172,140,139,4,1,"C's",8
34,"34023",5265,3948,3918,38,30,"C's",551
34,"34012",362,277,272,4,5,"C's",30
34,"34080",5626,3906,3835,39,71,"C's",570
34,"34229",67,55,55,1,0,"C's",2
34,"34015",39,32,31,1,1,"C's",3
34,"34046",43,31,29,0,2,"C's",0
34,"34211",180,151,149,3,2,"C's",19
34,"34093",90,72,70,0,2,"C's",11
34,"34165",66,59,59,0,0,"C's",3
34,"34062",176,111,111,3,0,"C's",10
34,"34196",91,70,69,1,1,"C's",12
34,"34083",1773,1259,1244,8,15,"C's",174
34,"34048",76,64,64,1,0,"C's",6
34,"34073",187,150,149,0,1,"C's",17
34,"34087",127,109,108,1,1,"C's",13
34,"34217",1200,954,934,6,20,"C's",202
34,"34027",1096,786,781,11,5,"C's",66
34,"34081",61,50,49,0,1,"C's",9
34,"34201",193,163,161,2,2,"C's",22
34,"34107",81,49,49,3,0,"C's",4
34,"34132",115,93,92,0,1,"C's",10
34,"34237",597,472,465,5,7,"C's",43
34,"34222",120,82,82,2,0,"C's",10
34,"34242",95,74,73,1,1,"C's",6
34,"34072",160,142,140,1,2,"C's",7
34,"34182",792,632,620,3,12,"C's",64
34,"34155",135,105,104,1,1,"C's",7
34,"34152",124,102,99,1,3,"C's",7
34,"34186",51,45,45,0,0,"C's",6
34,"34221",179,135,132,3,3,"C's",10
34,"34125",88,69,68,1,1,"C's",7
34,"34901",1126,881,865,6,16,"C's",85
34,"34133",107,85,82,0,3,"C's",2
34,"34223",219,159,158,1,1,"C's",13
34,"34110",91,78,78,2,0,"C's",3
34,"34082",84,71,71,0,0,"C's",8
34,"34206",879,688,680,3,8,"C's",59
34,"34190",56,40,40,3,0,"C's",5
34,"34049",369,280,274,1,6,"C's",32
34,"34160",143,112,110,1,2,"C's",7
34,"34098",780,587,582,2,5,"PP",174
34,"34238",341,279,276,1,3,"PP",117
34,"34161",23,14,14,0,0,"PP",10
34,"34087",127,109,108,1,1,"PP",59
34,"34028",144,121,119,1,2,"PP",68
34,"34037",310,218,217,4,1,"PP",117
34,"34047",1803,1402,1380,15,22,"PP",776
34,"34003",163,127,125,0,2,"PP",78
34,"34224",45,31,31,0,0,"PP",17
34,"34082",84,71,71,0,0,"PP",40
34,"34171",982,720,710,7,10,"PP",352
34,"34241",18,13,12,2,1,"PP",6
34,"34101",54,42,42,0,0,"PP",23
34,"34109",59,48,47,0,1,"PP",33
34,"34168",55,51,51,1,0,"PP",26
34,"34022",1095,915,909,8,6,"PP",380
34,"34903",198,128,127,1,1,"PP",84
34,"34055",280,204,202,2,2,"PP",112
34,"34146",55,42,42,0,0,"PP",23
34,"34120",64404,49403,48884,379,519,"PP",17656
34,"34149",20,15,15,0,0,"PP",8
34,"34034",126,93,93,1,0,"PP",38
34,"34070",160,117,115,2,2,"PP",60
34,"34019",125,103,101,1,2,"PP",43
34,"34143",172,127,126,3,1,"PP",71
34,"34170",62,49,49,0,0,"PP",36
34,"34208",53,41,41,1,0,"PP",26
34,"34228",81,66,66,0,0,"PP",29
34,"34006",80,69,66,1,3,"PP",41
34,"34233",131,116,116,1,0,"PP",82
34,"34001",35,28,28,2,0,"PP",11
34,"34057",476,339,334,3,5,"PP",150
34,"34156",49,42,41,3,1,"PP",29
34,"34154",76,54,52,0,2,"PP",36
34,"34042",300,247,244,4,3,"PP",117
34,"34174",205,162,162,4,0,"PP",107
34,"34088",231,192,190,2,2,"PP",71
34,"34093",90,72,70,0,2,"PP",51
34,"34035",113,90,89,1,1,"PP",48
34,"34104",247,203,199,0,4,"PP",129
34,"34041",89,71,71,1,0,"PP",38
34,"34232",748,601,586,11,15,"PP",262
34,"34050",202,160,160,0,0,"PP",92
34,"34245",311,213,209,4,4,"PP",122
34,"34005",858,670,651,6,19,"PP",327
34,"34215",163,148,148,2,0,"PP",59
34,"34079",1601,1285,1269,11,16,"PP",454
34,"34157",2460,1872,1836,26,36,"PP",856
34,"34017",920,763,745,2,18,"PP",362
34,"34018",209,169,166,3,3,"PP",65
34,"34059",422,348,341,6,7,"PP",158
34,"34052",178,148,147,3,1,"PP",79
34,"34009",33,29,26,1,3,"PP",20
34,"34025",61,44,44,1,0,"PP",26
34,"34096",57,46,46,3,0,"PP",21
34,"34092",297,236,231,2,5,"PP",130
34,"34205",59,45,45,0,0,"PP",27
34,"34071",172,140,139,4,1,"PP",88
34,"34178",113,92,91,5,1,"PP",57
34,"34201",193,163,161,2,2,"PP",84
34,"34225",4903,3830,3784,41,46,"PP",952
34,"34091",123,97,95,1,2,"PP",44
34,"34230",15,12,12,0,0,"PP",6
34,"34204",47,39,39,2,0,"PP",28
34,"34039",61,46,45,0,1,"PP",37
34,"34134",53,37,37,2,0,"PP",19
34,"34223",219,159,158,1,1,"PP",115
34,"34181",453,343,337,3,6,"PP",82
34,"34231",232,167,167,4,0,"PP",102
34,"34229",67,55,55,1,0,"PP",33
34,"34069",2285,1711,1692,25,19,"PP",540
34,"34122",84,66,65,0,1,"PP",27
34,"34049",369,280,274,1,6,"PP",129
34,"34216",67,52,51,0,1,"PP",36
34,"34114",212,147,146,2,1,"PP",108
34,"34147",167,120,120,1,0,"PP",71
34,"34159",363,277,269,4,8,"PP",93
34,"34066",58,45,45,0,0,"PP",23
34,"34012",362,277,272,4,5,"PP",126
34,"34061",108,80,80,0,0,"PP",41
34,"34086",105,91,88,1,3,"PP",34
34,"34116",62,41,41,0,0,"PP",30
34,"34217",1200,954,934,6,20,"PP",301
34,"34176",134,102,100,2,2,"PP",61
34,"34904",319,241,240,3,1,"PP",99
34,"34027",1096,786,781,11,5,"PP",318
34,"34242",95,74,73,1,1,"PP",38
34,"34113",37,36,36,0,0,"PP",23
34,"34123",1668,1346,1319,20,27,"PP",597
34,"34108",537,453,446,5,7,"PP",166
34,"34189",57,45,45,1,0,"PP",25
34,"34246",64,49,47,1,2,"PP",25
34,"34112",47,38,38,0,0,"PP",25
34,"34214",186,150,149,1,1,"PP",60
34,"34067",129,95,95,0,0,"PP",39
34,"34177",179,149,148,1,1,"PP",80
34,"34051",102,90,88,1,2,"PP",55
34,"34004",5626,4226,4178,41,48,"PP",1727
34,"34169",404,302,300,2,2,"PP",176
34,"34024",32,19,19,0,0,"PP",12
34,"34240",90,71,70,2,1,"PP",35
34,"34068",25,24,24,1,0,"PP",14
34,"34076",597,494,490,3,4,"PP",272
34,"34140",107,63,62,0,1,"PP",39
34,"34190",56,40,40,3,0,"PP",27
34,"34121",192,155,154,2,1,"PP",110
34,"34185",65,46,44,2,2,"PP",15
34,"34084",140,110,108,1,2,"PP",72
34,"34045",77,65,65,2,0,"PP",41
34,"34160",143,112,110,1,2,"PP",28
34,"34103",96,78,77,2,1,"PP",47
34,"34131",59,50,48,0,2,"PP",43
34,"34163",49,40,40,0,0,"PP",23
34,"34011",398,326,326,3,0,"PP",148
34,"34060",137,113,112,1,1,"PP",58
34,"34089",157,124,122,1,2,"PP",67
34,"34141",182,148,147,4,1,"PP",76
34,"34099",61,51,50,0,1,"PP",39
34,"34236",162,126,126,1,0,"PP",86
34,"34053",209,170,168,4,2,"PP",95
34,"34077",349,253,246,0,7,"PP",84
34,"34046",43,31,29,0,2,"PP",16
34,"34107",81,49,49,3,0,"PP",33
34,"34058",184,167,167,0,0,"PP",83
34,"34056",2003,1502,1487,12,15,"PP",661
34,"34220",144,129,128,0,1,"PP",49
34,"34036",216,167,165,1,2,"PP",46
34,"34218",469,353,349,2,4,"PP",220
34,"34130",213,175,172,2,3,"PP",73
34,"34031",29,28,28,1,0,"PP",18
34,"34100",142,116,115,5,1,"PP",47
34,"34062",176,111,111,3,0,"PP",70
34,"34074",719,552,545,8,7,"PP",223
34,"34132",115,93,92,0,1,"PP",45
34,"34129",179,139,137,2,2,"PP",94
34,"34182",792,632,620,3,12,"PP",282
34,"34032",41,32,31,0,1,"PP",16
34,"34033",18,17,17,0,0,"PP",12
34,"34180",68,56,56,2,0,"PP",27
34,"34155",135,105,104,1,1,"PP",36
34,"34136",182,121,120,1,1,"PP",77
34,"34048",76,64,64,1,0,"PP",29
34,"34243",326,263,258,2,5,"PP",150
34,"34211",180,151,149,3,2,"PP",104
34,"34202",31,20,19,0,1,"PP",12
34,"34151",167,111,111,3,0,"PP",58
34,"34102",205,172,170,1,2,"PP",83
34,"34179",29,22,20,0,2,"PP",15
34,"34080",5626,3906,3835,39,71,"PP",1513
34,"34133",107,85,82,0,3,"PP",64
34,"34125",88,69,68,1,1,"PP",47
34,"34901",1126,881,865,6,16,"PP",464
34,"34192",93,76,76,0,0,"PP",54
34,"34199",1248,955,937,18,18,"PP",345
34,"34127",95,64,64,2,0,"PP",39
34,"34237",597,472,465,5,7,"PP",250
34,"34015",39,32,31,1,1,"PP",20
34,"34158",290,190,188,3,2,"PP",65
34,"34029",727,596,582,4,14,"PP",352
34,"34137",28,24,24,1,0,"PP",8
34,"34094",61,42,40,1,2,"PP",24
34,"34186",51,45,45,0,0,"PP",29
34,"34073",187,150,149,0,1,"PP",68
34,"34081",61,50,49,0,1,"PP",30
34,"34221",179,135,132,3,3,"PP",56
34,"34126",279,218,218,2,0,"PP",133
34,"34106",114,94,94,2,0,"PP",53
34,"34234",72,57,55,0,2,"PP",33
34,"34023",5265,3948,3918,38,30,"PP",1114
34,"34210",102,90,89,0,1,"PP",50
34,"34124",61,47,46,0,1,"PP",29
34,"34184",55,46,42,0,4,"PP",28
34,"34063",86,80,79,1,1,"PP",43
34,"34175",89,75,74,1,1,"PP",47
34,"34010",570,437,429,5,8,"PP",217
34,"34020",53,39,39,0,0,"PP",21
34,"34196",91,70,69,1,1,"PP",39
34,"34206",879,688,680,3,8,"PP",288
34,"34227",76,62,62,1,0,"PP",38
34,"34083",1773,1259,1244,8,15,"PP",567
34,"34152",124,102,99,1,3,"PP",53
34,"34139",168,126,124,6,2,"PP",76
34,"34072",160,142,140,1,2,"PP",90
34,"34213",58,43,42,2,1,"PP",22
34,"34902",140,115,114,0,1,"PP",73
34,"34110",91,78,78,2,0,"PP",29
34,"34167",114,89,89,0,0,"PP",49
34,"34165",66,59,59,0,0,"PP",49
34,"34038",277,202,202,3,0,"PP",130
34,"34222",120,82,82,2,0,"PP",62
34,"34135",391,296,291,4,5,"PP",149
18,"18001",256,178,177,2,1,"C´s",13
18,"18014",6372,4620,4566,44,54,"C´s",956
18,"18193",14194,10280,10196,91,84,"C´s",1794
18,"18151",260,196,196,0,0,"C´s",20
18,"18082",867,626,621,4,5,"C´s",67
18,"18123",293,228,227,2,1,"C´s",25
18,"18051",1149,825,823,7,2,"C´s",55
18,"18124",393,274,271,1,3,"C´s",17
18,"18140",43567,29155,28932,194,223,"C´s",3741
18,"18070",283,223,218,0,5,"C´s",22
18,"18128",344,251,248,0,3,"C´s",20
18,"18040",225,142,141,0,1,"C´s",8
18,"18167",1897,1321,1313,8,8,"C´s",77
18,"18111",2743,2046,2033,14,13,"C´s",351
18,"18053",1667,1084,1078,9,6,"C´s",98
18,"18002",561,446,444,1,2,"C´s",17
18,"18152",938,687,681,1,6,"C´s",32
18,"18083",266,210,207,1,3,"C´s",13
18,"18097",956,703,691,1,12,"C´s",91
18,"18071",5583,4221,4176,33,45,"C´s",585
18,"18084",4215,3179,3143,24,36,"C´s",521
18,"18168",809,589,588,5,1,"C´s",106
18,"18153",8580,6314,6260,39,54,"C´s",1025
18,"18901",512,359,357,1,2,"C´s",37
18,"18126",1497,1094,1087,7,7,"C´s",90
18,"18185",556,461,461,1,0,"C´s",53
18,"18054",868,630,627,2,3,"C´s",81
18,"18003",14022,10417,10330,82,87,"C´s",1795
18,"18016",323,239,237,0,2,"C´s",15
18,"18170",336,227,225,1,2,"C´s",16
18,"18182",1919,1356,1347,3,9,"C´s",118
18,"18042",414,342,341,0,1,"C´s",41
18,"18085",729,489,484,2,5,"C´s",36
18,"18099",1581,1271,1249,10,22,"C´s",158
18,"18004",724,511,505,3,6,"C´s",19
18,"18913",818,617,603,2,14,"C´s",61
18,"18069",493,366,363,3,3,"C´s",20
18,"18043",129,95,95,0,0,"C´s",5
18,"18127",16586,11998,11897,97,101,"C´s",1899
18,"18134",5811,4002,3946,25,56,"C´s",564
18,"18062",10298,7584,7512,67,72,"C´s",1380
18,"18056",3545,2716,2687,25,29,"C´s",241
18,"18022",13306,9165,9091,51,74,"C´s",1507
18,"18086",355,285,283,0,2,"C´s",11
18,"18044",179,116,116,0,0,"C´s",14
18,"18171",2123,1640,1616,14,24,"C´s",89
18,"18057",5263,3968,3937,33,31,"C´s",774
18,"18144",782,596,588,3,8,"C´s",90
18,"18018",640,490,488,0,2,"C´s",41
18,"18048",2390,1824,1806,8,18,"C´s",269
18,"18105",4548,3169,3139,19,30,"C´s",216
18,"18005",375,266,265,2,1,"C´s",21
18,"18115",2548,1872,1854,16,18,"C´s",153
18,"18173",8978,6319,6251,50,68,"C´s",619
18,"18023",15738,11242,11146,92,96,"C´s",1762
18,"18020",1469,1046,1032,7,14,"C´s",88
18,"18180",631,448,447,2,1,"C´s",47
18,"18006",4161,2816,2788,29,28,"C´s",217
18,"18132",3312,2582,2556,14,26,"C´s",156
18,"18012",2330,1670,1660,15,10,"C´s",135
18,"18184",2158,1659,1634,4,25,"C´s",97
18,"18087",184873,138280,137516,836,764,"C´s",22132
18,"18905",14500,10137,10058,82,79,"C´s",1958
18,"18133",2187,1731,1722,7,9,"C´s",125
18,"18045",1149,803,789,10,14,"C´s",62
18,"18078",739,593,590,4,3,"C´s",25
18,"18117",513,402,396,4,6,"C´s",27
18,"18037",530,411,408,1,3,"C´s",48
18,"18088",1556,1113,1108,5,5,"C´s",35
18,"18007",785,527,523,3,4,"C´s",38
18,"18072",666,481,474,4,7,"C´s",59
18,"18146",970,734,727,6,7,"C´s",53
18,"18046",1867,1225,1215,8,10,"C´s",123
18,"18175",11624,8549,8467,41,82,"C´s",1241
18,"18102",8424,5783,5716,41,67,"C´s",487
18,"18089",15132,10489,10402,64,87,"C´s",1156
18,"18161",220,184,184,1,0,"C´s",16
18,"18074",273,217,213,2,4,"C´s",9
18,"18910",803,573,569,5,4,"C´s",39
18,"18114",634,457,452,2,5,"C´s",31
18,"18906",917,681,673,2,8,"C´s",45
18,"18147",3734,2416,2386,10,30,"C´s",256
18,"18109",599,421,419,2,2,"C´s",42
18,"18047",5888,4028,4000,32,28,"C´s",661
18,"18010",563,463,459,4,4,"C´s",45
18,"18135",4583,3045,2998,14,47,"C´s",248
18,"18120",270,218,216,2,2,"C´s",10
18,"18148",819,671,666,1,5,"C´s",55
18,"18011",4321,3136,3119,10,17,"C´s",372
18,"18063",1191,770,767,6,3,"C´s",63
18,"18176",258,179,178,3,1,"C´s",6
18,"18076",815,577,576,0,1,"C´s",34
18,"18093",2752,1873,1858,10,15,"C´s",202
18,"18036",3768,2904,2882,18,22,"C´s",536
18,"18158",8408,5604,5542,38,62,"C´s",438
18,"18908",805,633,620,2,13,"C´s",67
18,"18907",1859,1482,1475,5,7,"C´s",111
18,"18107",971,719,711,6,8,"C´s",37
18,"18181",223,159,157,0,2,"C´s",1
18,"18145",10432,7829,7767,56,62,"C´s",1500
18,"18094",2389,1853,1832,22,21,"C´s",183
18,"18049",617,456,451,3,5,"C´s",40
18,"18064",379,308,308,1,0,"C´s",23
18,"18189",772,599,595,7,4,"C´s",71
18,"18136",1875,1477,1470,7,7,"C´s",70
18,"18112",131,88,86,1,2,"C´s",5
18,"18024",855,660,653,8,7,"C´s",56
18,"18164",1831,1273,1260,11,13,"C´s",145
18,"18909",589,462,459,0,3,"C´s",14
18,"18098",6167,4367,4342,22,25,"C´s",537
18,"18122",16171,11670,11508,106,162,"C´s",1368
18,"18108",858,672,667,0,5,"C´s",44
18,"18013",4236,3108,3052,19,56,"C´s",293
18,"18137",1005,758,758,6,0,"C´s",55
18,"18038",1066,836,826,2,10,"C´s",46
18,"18050",1711,1271,1256,5,15,"C´s",131
18,"18025",294,216,214,0,2,"C´s",22
18,"18165",4135,2944,2915,23,29,"C´s",415
18,"18902",847,680,674,10,6,"C´s",49
18,"18121",132,101,100,1,1,"C´s",7
18,"18911",7392,5359,5301,44,58,"C´s",1041
18,"18162",951,744,734,0,10,"C´s",46
18,"18103",760,596,593,6,3,"C´s",44
18,"18027",2562,1846,1827,19,19,"C´s",152
18,"18017",18172,12077,11954,101,123,"C´s",2045
18,"18138",2482,1721,1712,8,9,"C´s",98
18,"18179",546,378,377,1,1,"C´s",15
18,"18904",779,570,565,1,5,"C´s",48
18,"18096",342,260,259,1,1,"C´s",6
18,"18015",443,338,337,0,1,"C´s",18
18,"18912",1488,1021,1007,7,14,"C´s",78
18,"18141",414,282,277,1,5,"C´s",14
18,"18065",625,503,500,1,3,"C´s",23
18,"18033",294,220,219,1,1,"C´s",6
18,"18029",1833,1252,1243,9,9,"C´s",128
18,"18194",2152,1487,1477,6,10,"C´s",146
18,"18116",2882,2245,2215,19,30,"C´s",196
18,"18067",711,517,516,0,1,"C´s",25
18,"18143",979,781,776,2,5,"C´s",51
18,"18154",1016,716,716,2,0,"C´s",30
18,"18095",1959,1486,1474,5,12,"C´s",173
18,"18177",427,259,258,3,1,"C´s",12
18,"18192",1529,1216,1208,3,8,"C´s",94
18,"18035",1255,964,958,4,6,"C´s",58
18,"18032",239,178,175,0,3,"C´s",24
18,"18119",1729,1353,1340,13,13,"C´s",158
18,"18068",1566,1234,1214,5,20,"C´s",193
18,"18039",3544,2544,2511,34,33,"C´s",288
18,"18059",4153,3074,3039,23,35,"C´s",353
18,"18034",510,391,391,1,0,"C´s",16
18,"18187",561,418,417,1,1,"C´s",23
18,"18030",584,428,426,3,2,"C´s",36
18,"18028",945,790,781,2,9,"C´s",39
18,"18101",9263,6971,6912,55,59,"C´s",1208
18,"18163",324,239,235,1,4,"C´s",17
18,"18157",1123,836,823,8,13,"C´s",107
18,"18079",3465,2671,2645,16,26,"C´s",169
18,"18174",442,354,348,2,6,"C´s",32
18,"18183",660,468,465,3,3,"C´s",42
18,"18150",6730,4858,4814,28,44,"C´s",616
18,"18066",2108,1546,1540,4,6,"C´s",93
18,"18178",743,571,571,2,0,"C´s",39
18,"18021",17451,12420,12305,101,115,"C´s",2331
18,"18188",1642,1249,1234,8,15,"C´s",111
18,"18159",1009,811,802,3,9,"C´s",36
18,"18061",1059,822,816,1,6,"C´s",55
18,"18914",1658,1304,1290,8,14,"C´s",107
18,"18149",5177,3946,3902,29,44,"C´s",746
18,"18100",7769,5715,5637,57,78,"C´s",539
18,"18903",892,650,645,1,5,"C´s",36
34,"34202",31,20,19,0,1,"SAIn",0
34,"34179",29,22,20,0,2,"SAIn",0
34,"34058",184,167,167,0,0,"SAIn",0
34,"34184",55,46,42,0,4,"SAIn",0
34,"34001",35,28,28,2,0,"SAIn",0
34,"34018",209,169,166,3,3,"SAIn",0
34,"34028",144,121,119,1,2,"SAIn",1
34,"34096",57,46,46,3,0,"SAIn",0
34,"34006",80,69,66,1,3,"SAIn",0
34,"34243",326,263,258,2,5,"SAIn",0
34,"34104",247,203,199,0,4,"SAIn",0
34,"34070",160,117,115,2,2,"SAIn",0
34,"34216",67,52,51,0,1,"SAIn",0
34,"34027",1096,786,781,11,5,"SAIn",0
34,"34041",89,71,71,1,0,"SAIn",0
34,"34015",39,32,31,1,1,"SAIn",0
34,"34149",20,15,15,0,0,"SAIn",0
34,"34050",202,160,160,0,0,"SAIn",0
34,"34178",113,92,91,5,1,"SAIn",0
34,"34106",114,94,94,2,0,"SAIn",0
34,"34141",182,148,147,4,1,"SAIn",0
34,"34042",300,247,244,4,3,"SAIn",0
34,"34237",597,472,465,5,7,"SAIn",0
34,"34082",84,71,71,0,0,"SAIn",0
34,"34196",91,70,69,1,1,"SAIn",0
34,"34011",398,326,326,3,0,"SAIn",0
34,"34217",1200,954,934,6,20,"SAIn",0
34,"34003",163,127,125,0,2,"SAIn",0
34,"34177",179,149,148,1,1,"SAIn",0
34,"34004",5626,4226,4178,41,48,"SAIn",1
34,"34124",61,47,46,0,1,"SAIn",0
34,"34161",23,14,14,0,0,"SAIn",0
34,"34133",107,85,82,0,3,"SAIn",0
34,"34012",362,277,272,4,5,"SAIn",0
34,"34103",96,78,77,2,1,"SAIn",0
34,"34222",120,82,82,2,0,"SAIn",0
34,"34229",67,55,55,1,0,"SAIn",0
34,"34123",1668,1346,1319,20,27,"SAIn",0
34,"34182",792,632,620,3,12,"SAIn",0
34,"34901",1126,881,865,6,16,"SAIn",0
34,"34220",144,129,128,0,1,"SAIn",0
34,"34025",61,44,44,1,0,"SAIn",0
34,"34242",95,74,73,1,1,"SAIn",0
34,"34052",178,148,147,3,1,"SAIn",0
34,"34131",59,50,48,0,2,"SAIn",0
34,"34143",172,127,126,3,1,"SAIn",0
34,"34165",66,59,59,0,0,"SAIn",0
34,"34228",81,66,66,0,0,"SAIn",0
34,"34093",90,72,70,0,2,"SAIn",0
34,"34205",59,45,45,0,0,"SAIn",0
34,"34230",15,12,12,0,0,"SAIn",0
34,"34062",176,111,111,3,0,"SAIn",0
34,"34116",62,41,41,0,0,"SAIn",0
34,"34240",90,71,70,2,1,"SAIn",0
34,"34063",86,80,79,1,1,"SAIn",0
34,"34101",54,42,42,0,0,"SAIn",0
34,"34174",205,162,162,4,0,"SAIn",0
34,"34039",61,46,45,0,1,"SAIn",0
34,"34086",105,91,88,1,3,"SAIn",0
34,"34110",91,78,78,2,0,"SAIn",0
34,"34122",84,66,65,0,1,"SAIn",0
34,"34208",53,41,41,1,0,"SAIn",0
34,"34094",61,42,40,1,2,"SAIn",0
34,"34204",47,39,39,2,0,"SAIn",0
34,"34057",476,339,334,3,5,"SAIn",0
34,"34192",93,76,76,0,0,"SAIn",0
34,"34246",64,49,47,1,2,"SAIn",0
34,"34189",57,45,45,1,0,"SAIn",0
34,"34158",290,190,188,3,2,"SAIn",0
34,"34047",1803,1402,1380,15,22,"SAIn",3
34,"34154",76,54,52,0,2,"SAIn",0
34,"34022",1095,915,909,8,6,"SAIn",0
34,"34126",279,218,218,2,0,"SAIn",0
34,"34031",29,28,28,1,0,"SAIn",0
34,"34180",68,56,56,2,0,"SAIn",0
34,"34113",37,36,36,0,0,"SAIn",0
34,"34035",113,90,89,1,1,"SAIn",1
34,"34171",982,720,710,7,10,"SAIn",0
34,"34080",5626,3906,3835,39,71,"SAIn",0
34,"34049",369,280,274,1,6,"SAIn",0
34,"34159",363,277,269,4,8,"SAIn",1
34,"34048",76,64,64,1,0,"SAIn",0
34,"34009",33,29,26,1,3,"SAIn",0
34,"34120",64404,49403,48884,379,519,"SAIn",44
34,"34186",51,45,45,0,0,"SAIn",0
34,"34181",453,343,337,3,6,"SAIn",0
34,"34076",597,494,490,3,4,"SAIn",0
34,"34045",77,65,65,2,0,"SAIn",0
34,"34125",88,69,68,1,1,"SAIn",0
34,"34132",115,93,92,0,1,"SAIn",0
34,"34155",135,105,104,1,1,"SAIn",0
34,"34073",187,150,149,0,1,"SAIn",0
34,"34140",107,63,62,0,1,"SAIn",0
34,"34066",58,45,45,0,0,"SAIn",0
34,"34245",311,213,209,4,4,"SAIn",1
34,"34102",205,172,170,1,2,"SAIn",0
34,"34211",180,151,149,3,2,"SAIn",0
34,"34069",2285,1711,1692,25,19,"SAIn",4
34,"34029",727,596,582,4,14,"SAIn",0
34,"34232",748,601,586,11,15,"SAIn",1
34,"34170",62,49,49,0,0,"SAIn",0
34,"34221",179,135,132,3,3,"SAIn",0
34,"34199",1248,955,937,18,18,"SAIn",1
34,"34190",56,40,40,3,0,"SAIn",0
34,"34130",213,175,172,2,3,"SAIn",0
34,"34146",55,42,42,0,0,"SAIn",0
34,"34225",4903,3830,3784,41,46,"SAIn",1
34,"34137",28,24,24,1,0,"SAIn",0
34,"34168",55,51,51,1,0,"SAIn",0
34,"34074",719,552,545,8,7,"SAIn",0
34,"34233",131,116,116,1,0,"SAIn",0
34,"34051",102,90,88,1,2,"SAIn",0
34,"34079",1601,1285,1269,11,16,"SAIn",0
34,"34231",232,167,167,4,0,"SAIn",0
34,"34092",297,236,231,2,5,"SAIn",0
34,"34129",179,139,137,2,2,"SAIn",0
34,"34136",182,121,120,1,1,"SAIn",0
34,"34127",95,64,64,2,0,"SAIn",0
34,"34156",49,42,41,3,1,"SAIn",0
34,"34185",65,46,44,2,2,"SAIn",0
34,"34059",422,348,341,6,7,"SAIn",1
34,"34098",780,587,582,2,5,"SAIn",1
34,"34088",231,192,190,2,2,"SAIn",0
34,"34238",341,279,276,1,3,"SAIn",0
34,"34023",5265,3948,3918,38,30,"SAIn",1
34,"34215",163,148,148,2,0,"SAIn",0
34,"34053",209,170,168,4,2,"SAIn",0
34,"34072",160,142,140,1,2,"SAIn",0
34,"34100",142,116,115,5,1,"SAIn",0
34,"34904",319,241,240,3,1,"SAIn",0
34,"34038",277,202,202,3,0,"SAIn",0
34,"34234",72,57,55,0,2,"SAIn",0
34,"34206",879,688,680,3,8,"SAIn",0
34,"34010",570,437,429,5,8,"SAIn",0
34,"34067",129,95,95,0,0,"SAIn",0
34,"34061",108,80,80,0,0,"SAIn",0
34,"34107",81,49,49,3,0,"SAIn",0
34,"34017",920,763,745,2,18,"SAIn",2
34,"34005",858,670,651,6,19,"SAIn",0
34,"34034",126,93,93,1,0,"SAIn",0
34,"34236",162,126,126,1,0,"SAIn",0
34,"34068",25,24,24,1,0,"SAIn",0
34,"34201",193,163,161,2,2,"SAIn",0
34,"34081",61,50,49,0,1,"SAIn",0
34,"34108",537,453,446,5,7,"SAIn",0
34,"34139",168,126,124,6,2,"SAIn",0
34,"34087",127,109,108,1,1,"SAIn",0
34,"34135",391,296,291,4,5,"SAIn",0
34,"34056",2003,1502,1487,12,15,"SAIn",1
34,"34214",186,150,149,1,1,"SAIn",0
34,"34091",123,97,95,1,2,"SAIn",0
34,"34055",280,204,202,2,2,"SAIn",2
34,"34032",41,32,31,0,1,"SAIn",0
34,"34152",124,102,99,1,3,"SAIn",0
34,"34147",167,120,120,1,0,"SAIn",0
34,"34218",469,353,349,2,4,"SAIn",0
34,"34157",2460,1872,1836,26,36,"SAIn",0
34,"34071",172,140,139,4,1,"SAIn",0
34,"34019",125,103,101,1,2,"SAIn",0
34,"34151",167,111,111,3,0,"SAIn",0
34,"34176",134,102,100,2,2,"SAIn",0
34,"34224",45,31,31,0,0,"SAIn",1
34,"34109",59,48,47,0,1,"SAIn",0
34,"34213",58,43,42,2,1,"SAIn",0
34,"34121",192,155,154,2,1,"SAIn",0
34,"34020",53,39,39,0,0,"SAIn",0
34,"34167",114,89,89,0,0,"SAIn",0
34,"34169",404,302,300,2,2,"SAIn",0
34,"34099",61,51,50,0,1,"SAIn",0
34,"34077",349,253,246,0,7,"SAIn",0
34,"34134",53,37,37,2,0,"SAIn",0
34,"34223",219,159,158,1,1,"SAIn",0
34,"34227",76,62,62,1,0,"SAIn",0
34,"34112",47,38,38,0,0,"SAIn",0
34,"34903",198,128,127,1,1,"SAIn",0
34,"34060",137,113,112,1,1,"SAIn",0
34,"34046",43,31,29,0,2,"SAIn",0
34,"34902",140,115,114,0,1,"SAIn",0
34,"34084",140,110,108,1,2,"SAIn",0
34,"34160",143,112,110,1,2,"SAIn",0
34,"34037",310,218,217,4,1,"SAIn",0
34,"34089",157,124,122,1,2,"SAIn",0
34,"34175",89,75,74,1,1,"SAIn",0
34,"34163",49,40,40,0,0,"SAIn",0
34,"34114",212,147,146,2,1,"SAIn",0
34,"34033",18,17,17,0,0,"SAIn",0
34,"34241",18,13,12,2,1,"SAIn",0
34,"34024",32,19,19,0,0,"SAIn",0
34,"34210",102,90,89,0,1,"SAIn",0
34,"34083",1773,1259,1244,8,15,"SAIn",0
34,"34036",216,167,165,1,2,"SAIn",2
15,"15068",5096,3518,3476,39,42,"PP",1490
15,"15002",22929,16941,16742,205,199,"PP",4813
15,"15031",23321,17319,17152,218,167,"PP",4326
15,"15081",1042,819,814,12,5,"PP",556
15,"15003",1818,1326,1302,18,24,"PP",703
15,"15901",3595,2401,2374,30,27,"PP",878
15,"15013",6126,4315,4257,43,58,"PP",1562
15,"15018",1156,817,806,7,11,"PP",192
15,"15054",32177,22065,21778,349,287,"PP",6444
15,"15067",8073,6067,6000,45,67,"PP",1865
15,"15079",1562,1092,1075,16,17,"PP",543
15,"15059",10406,7710,7553,91,157,"PP",3403
15,"15027",1540,1224,1203,6,21,"PP",549
15,"15056",5757,4167,4108,43,59,"PP",1669
15,"15082",15162,11273,11134,135,139,"PP",3890
15,"15055",4618,3208,3159,49,49,"PP",962
15,"15022",5817,4026,3981,29,45,"PP",1584
15,"15029",5761,3994,3928,47,66,"PP",1731
15,"15092",6523,4518,4449,54,69,"PP",1935
15,"15071",7965,5559,5483,37,76,"PP",2122
15,"15072",9626,7024,6920,52,104,"PP",2227
15,"15006",5353,3534,3469,49,65,"PP",1551
15,"15009",10780,8075,7957,70,118,"PP",2921
15,"15066",4039,2950,2894,34,56,"PP",1465
15,"15038",2236,1556,1530,18,26,"PP",712
15,"15017",19380,14272,14098,156,174,"PP",3861
15,"15061",5646,3945,3894,35,51,"PP",1843
15,"15089",4317,3238,3188,24,50,"PP",1435
15,"15043",5147,3834,3764,36,70,"PP",1516
15,"15064",2207,1680,1650,22,30,"PP",633
15,"15016",4806,3291,3222,21,69,"PP",1201
15,"15050",1843,1089,1070,19,19,"PP",407
15,"15030",200245,148692,147426,1699,1266,"PP",46705
15,"15007",3352,2469,2453,24,16,"PP",1170
15,"15086",2918,2109,2077,19,32,"PP",1154
15,"15034",2897,1931,1909,14,22,"PP",601
15,"15090",1182,868,861,13,7,"PP",490
15,"15070",9117,6514,6390,98,124,"PP",1575
15,"15083",1100,809,795,5,14,"PP",447
15,"15028",1415,1085,1070,10,15,"PP",265
15,"15069",6785,5107,5032,54,75,"PP",1574
15,"15065",7345,5517,5412,46,105,"PP",2199
15,"15037",4087,2775,2733,18,42,"PP",1153
15,"15001",4805,3466,3419,45,47,"PP",1458
15,"15088",3550,2398,2372,18,26,"PP",1138
15,"15020",3844,2651,2629,17,22,"PP",1002
15,"15035",11517,8305,8192,144,113,"PP",2178
15,"15093",4265,2856,2814,35,42,"PP",1390
15,"15010",1913,1355,1338,21,17,"PP",697
15,"15023",6481,4658,4595,44,63,"PP",1658
15,"15076",2649,1827,1802,24,25,"PP",716
15,"15041",9627,7409,7291,79,118,"PP",3082
15,"15012",3666,2787,2721,40,66,"PP",1325
15,"15011",15463,11105,10890,92,215,"PP",3927
15,"15049",1099,765,755,12,10,"PP",347
15,"15080",1760,1215,1197,11,18,"PP",587
15,"15033",2489,1953,1931,13,22,"PP",856
15,"15042",3060,2170,2127,21,43,"PP",961
15,"15044",1309,955,941,5,14,"PP",485
15,"15902",4660,3352,3296,30,56,"PP",1616
15,"15019",25902,18111,17866,232,245,"PP",6142
15,"15087",5804,3942,3901,49,41,"PP",1551
15,"15032",3455,2438,2391,26,47,"PP",1270
15,"15077",8303,5648,5544,57,104,"PP",2849
15,"15051",4651,3343,3297,38,46,"PP",1000
15,"15046",6345,4625,4532,53,93,"PP",2191
15,"15015",2840,2126,2100,21,26,"PP",785
15,"15078",78093,58164,57487,673,677,"PP",20065
15,"15005",24459,16742,16482,215,260,"PP",4802
15,"15008",5650,4239,4175,42,64,"PP",1678
15,"15040",2763,2050,2017,10,33,"PP",894
15,"15084",3312,2361,2326,28,35,"PP",1387
15,"15062",5936,4047,3993,31,54,"PP",1898
15,"15045",3803,2382,2354,15,28,"PP",1290
15,"15014",4034,2809,2757,34,52,"PP",1311
15,"15048",4855,3582,3534,41,48,"PP",1388
15,"15053",7783,5386,5314,47,72,"PP",2038
15,"15004",4855,3594,3535,28,59,"PP",1183
15,"15052",4351,3122,3063,26,59,"PP",1278
15,"15074",4061,2983,2947,24,36,"PP",1516
15,"15058",27623,21002,20788,257,214,"PP",6822
15,"15085",3346,2365,2311,26,54,"PP",1167
15,"15075",12279,9076,8952,117,124,"PP",3084
15,"15021",5099,3673,3611,43,62,"PP",1329
15,"15060",5780,4245,4167,48,78,"PP",1479
15,"15036",58409,40932,40506,484,426,"PP",13220
15,"15073",21884,14792,14587,149,205,"PP",5778
15,"15025",1069,662,654,5,8,"PP",304
15,"15091",1119,807,784,12,23,"PP",383
15,"15047",2463,1669,1633,21,36,"PP",702
15,"15024",4412,3325,3278,35,47,"PP",1399
15,"15039",1271,935,917,8,18,"PP",457
15,"15057",12169,8853,8729,88,124,"PP",3461
4,"4060",466,361,358,2,3,"PSOE",99
4,"4062",4528,3610,3579,20,31,"PSOE",1471
4,"4903",4345,2896,2875,35,21,"PSOE",731
4,"4052",12246,8393,8353,84,40,"PSOE",2092
4,"4009",169,127,126,0,1,"PSOE",33
4,"4100",8712,5545,5482,30,63,"PSOE",1408
4,"4065",366,290,288,2,2,"PSOE",154
4,"4068",195,158,158,0,0,"PSOE",58
4,"4091",342,280,278,4,2,"PSOE",180
4,"4018",274,245,242,0,3,"PSOE",118
4,"4093",1872,1265,1252,10,13,"PSOE",463
4,"4066",13573,8651,8570,65,81,"PSOE",2770
4,"4078",1095,784,779,7,5,"PSOE",275
4,"4075",5152,3772,3715,19,57,"PSOE",1392
4,"4904",1759,1185,1172,15,13,"PSOE",252
4,"4097",254,196,194,0,2,"PSOE",75
4,"4043",546,466,462,3,4,"PSOE",152
4,"4067",584,432,424,0,8,"PSOE",233
4,"4044",1555,1253,1243,9,10,"PSOE",390
4,"4051",440,373,372,0,1,"PSOE",141
4,"4010",579,469,464,2,5,"PSOE",255
4,"4069",4692,3641,3607,29,34,"PSOE",1236
4,"4064",2779,2032,2009,8,23,"PSOE",441
4,"4019",251,199,198,0,1,"PSOE",105
4,"4063",1099,847,835,2,12,"PSOE",359
4,"4092",2852,2192,2168,13,24,"PSOE",821
4,"4102",13729,8987,8878,114,109,"PSOE",2711
4,"4030",1140,828,826,8,2,"PSOE",376
4,"4087",189,140,139,1,1,"PSOE",43
4,"4061",618,495,491,5,4,"PSOE",270
4,"4045",1777,1402,1392,9,10,"PSOE",817
4,"4048",1503,1104,1096,7,8,"PSOE",496
4,"4059",1100,752,745,7,7,"PSOE",434
4,"4070",1623,1233,1229,7,4,"PSOE",504
4,"4017",1301,881,876,5,5,"PSOE",371
4,"4098",1537,1157,1147,8,10,"PSOE",531
4,"4050",830,597,594,3,3,"PSOE",246
4,"4014",153,118,118,0,0,"PSOE",91
4,"4029",8887,6103,6048,53,55,"PSOE",2593
4,"4038",3066,2169,2150,20,19,"PSOE",770
4,"4053",12333,9124,9040,66,84,"PSOE",2745
4,"4101",4283,2969,2950,22,19,"PSOE",1189
4,"4056",147,123,120,0,3,"PSOE",33
4,"4071",398,327,326,2,1,"PSOE",163
4,"4902",45373,28425,28220,249,205,"PSOE",5851
4,"4001",1083,812,796,6,16,"PSOE",364
4,"4031",2359,1791,1786,7,5,"PSOE",861
4,"4047",2278,1906,1891,13,15,"PSOE",737
4,"4057",1337,941,933,2,8,"PSOE",444
4,"4076",1296,1005,993,7,12,"PSOE",465
4,"4080",226,185,182,2,3,"PSOE",45
4,"4074",2829,1965,1945,24,20,"PSOE",645
4,"4034",173,108,108,3,0,"PSOE",23
4,"4033",139,100,97,3,3,"PSOE",51
4,"4084",337,264,261,1,3,"PSOE",96
4,"4054",363,297,292,1,5,"PSOE",113
4,"4024",3036,2325,2308,18,17,"PSOE",798
4,"4072",311,247,244,14,3,"PSOE",54
4,"4028",226,198,197,0,1,"PSOE",119
4,"4022",348,243,242,1,1,"PSOE",118
4,"4073",332,231,230,2,1,"PSOE",84
4,"4023",139,104,102,1,2,"PSOE",22
4,"4901",539,388,386,0,2,"PSOE",177
4,"4032",5606,3789,3770,19,19,"PSOE",1391
4,"4082",306,210,209,0,1,"PSOE",58
4,"4058",369,292,291,2,1,"PSOE",112
4,"4096",274,208,206,0,2,"PSOE",97
4,"4041",318,241,241,6,0,"PSOE",66
4,"4055",372,315,315,0,0,"PSOE",167
4,"4079",50800,33862,33629,200,233,"PSOE",6866
4,"4036",228,176,175,2,1,"PSOE",70
4,"4007",736,553,551,0,2,"PSOE",260
4,"4083",1790,1384,1379,8,5,"PSOE",632
4,"4037",1312,1019,1000,6,19,"PSOE",441
4,"4103",1478,1051,1037,6,14,"PSOE",432
4,"4086",1792,1271,1258,8,13,"PSOE",425
4,"4016",2146,1584,1564,8,20,"PSOE",507
4,"4005",577,438,432,1,6,"PSOE",168
4,"4085",395,302,298,0,4,"PSOE",110
4,"4035",8375,6079,6031,28,48,"PSOE",2385
4,"4020",292,208,207,1,1,"PSOE",85
4,"4006",7016,4823,4786,33,37,"PSOE",1700
4,"4012",191,170,169,1,1,"PSOE",71
4,"4090",309,242,242,1,0,"PSOE",109
4,"4011",2798,2244,2220,14,24,"PSOE",927
4,"4094",209,141,141,1,0,"PSOE",30
4,"4015",130,98,98,1,0,"PSOE",34
4,"4008",501,420,415,3,5,"PSOE",127
4,"4002",1063,765,760,1,5,"PSOE",379
4,"4099",4988,3784,3714,26,70,"PSOE",1254
4,"4049",5280,3658,3623,20,35,"PSOE",1251
4,"4089",746,536,528,6,8,"PSOE",170
4,"4077",303,277,274,2,3,"PSOE",81
4,"4021",187,148,141,1,7,"PSOE",56
4,"4027",249,163,163,1,0,"PSOE",42
4,"4095",726,466,463,2,3,"PSOE",184
4,"4088",2475,1717,1703,10,14,"PSOE",761
4,"4081",356,290,290,2,0,"PSOE",190
4,"4013",141116,95203,94625,669,578,"PSOE",22678
4,"4046",862,658,656,6,2,"PSOE",254
4,"4004",421,314,312,2,2,"PSOE",129
4,"4003",17365,10931,10830,57,101,"PSOE",3160
4,"4026",70,60,60,0,0,"PSOE",10
9,"9001",27,26,26,0,0,"SAIn",0
9,"9902",461,347,339,1,8,"SAIn",0
9,"9362",204,168,164,0,4,"SAIn",0
9,"9197",148,108,104,1,4,"SAIn",0
9,"9410",3051,2169,2153,18,16,"SAIn",1
9,"9155",26,20,20,1,0,"SAIn",0
9,"9038",118,97,94,0,3,"SAIn",0
9,"9115",92,69,68,0,1,"SAIn",0
9,"9236",38,32,32,0,0,"SAIn",0
9,"9903",3251,2359,2340,24,19,"SAIn",2
9,"9441",74,66,66,0,0,"SAIn",0
9,"9321",1640,1250,1237,5,13,"SAIn",1
9,"9117",77,61,57,0,4,"SAIn",0
9,"9003",192,148,146,2,2,"SAIn",0
9,"9363",974,730,725,3,5,"SAIn",1
9,"9130",79,63,62,1,1,"SAIn",0
9,"9039",58,38,38,0,0,"SAIn",0
9,"9198",108,86,85,2,1,"SAIn",1
9,"9238",932,576,569,6,7,"SAIn",0
9,"9442",380,287,282,2,5,"SAIn",1
9,"9160",90,71,70,0,1,"SAIn",0
9,"9323",64,47,47,0,0,"SAIn",0
9,"9029",168,134,132,3,2,"SAIn",0
9,"9392",53,40,40,0,0,"SAIn",0
9,"9337",115,84,82,0,2,"SAIn",0
9,"9173",123,93,93,1,0,"SAIn",0
9,"9041",28,28,28,1,0,"SAIn",0
9,"9904",482,389,384,5,5,"SAIn",1
9,"9443",183,132,129,1,3,"SAIn",0
9,"9365",31,20,20,0,0,"SAIn",0
9,"9076",23,14,14,0,0,"SAIn",0
9,"9006",61,41,41,0,0,"SAIn",0
9,"9119",46,27,27,0,0,"SAIn",0
9,"9239",53,44,42,1,2,"SAIn",0
9,"9409",109,87,87,0,0,"SAIn",0
9,"9174",809,575,565,10,10,"SAIn",0
9,"9338",219,173,171,1,2,"SAIn",0
9,"9366",90,64,63,1,1,"SAIn",0
9,"9279",177,130,130,0,0,"SAIn",0
9,"9444",72,48,48,2,0,"SAIn",0
9,"9007",59,41,41,0,0,"SAIn",0
9,"9326",148,115,113,2,2,"SAIn",0
9,"9120",39,35,35,0,0,"SAIn",1
9,"9241",201,156,155,3,1,"SAIn",0
9,"9345",124,92,92,0,0,"SAIn",0
9,"9906",1223,952,947,9,5,"SAIn",2
9,"9432",189,143,140,1,3,"SAIn",0
9,"9200",48,37,36,0,1,"SAIn",0
9,"9091",732,516,512,7,4,"SAIn",0
9,"9340",76,49,49,0,0,"SAIn",0
9,"9044",46,38,37,0,1,"SAIn",0
9,"9163",602,479,472,5,7,"SAIn",0
9,"9056",4931,3634,3602,35,32,"SAIn",4
9,"9368",22,14,14,1,0,"SAIn",0
9,"9242",81,65,63,2,2,"SAIn",0
9,"9907",1420,1120,1115,13,5,"SAIn",0
9,"9369",442,331,328,1,3,"SAIn",0
9,"9411",149,111,111,0,0,"SAIn",0
9,"9122",96,66,66,0,0,"SAIn",0
9,"9009",163,130,128,2,2,"SAIn",0
9,"9078",41,35,33,0,2,"SAIn",0
9,"9010",32,23,23,2,0,"SAIn",0
9,"9201",30,17,17,0,0,"SAIn",0
9,"9256",362,261,255,2,6,"SAIn",0
9,"9281",147,109,107,0,2,"SAIn",0
9,"9164",165,121,121,1,0,"SAIn",0
9,"9079",46,40,37,0,3,"SAIn",0
9,"9123",40,35,35,0,0,"SAIn",0
9,"9434",1221,985,970,10,15,"SAIn",0
9,"9202",24,22,22,1,0,"SAIn",0
9,"9372",221,190,189,1,1,"SAIn",0
9,"9166",97,79,78,3,1,"SAIn",0
9,"9124",1520,1113,1096,9,17,"SAIn",0
9,"9412",803,552,550,2,2,"SAIn",2
9,"9329",123,86,86,1,0,"SAIn",0
9,"9011",69,49,49,0,0,"SAIn",0
9,"9082",40,35,35,0,0,"SAIn",0
9,"9908",469,314,309,2,5,"SAIn",0
9,"9303",92,72,71,0,1,"SAIn",0
9,"9046",30,26,26,0,0,"SAIn",0
9,"9244",47,26,26,1,0,"SAIn",0
9,"9167",59,42,42,2,0,"SAIn",0
9,"9258",173,139,136,4,3,"SAIn",0
9,"9272",294,206,203,1,3,"SAIn",2
9,"9051",168,133,132,1,1,"SAIn",0
9,"9358",249,191,191,1,0,"SAIn",1
9,"9246",622,458,455,5,3,"SAIn",0
9,"9330",1523,1166,1148,15,18,"SAIn",1
9,"9047",56,45,45,2,0,"SAIn",0
9,"9387",118,96,95,0,1,"SAIn",0
9,"9403",96,78,76,1,2,"SAIn",1
9,"9373",440,285,282,3,3,"SAIn",1
9,"9374",90,79,77,2,2,"SAIn",0
9,"9448",216,180,178,1,2,"SAIn",0
9,"9012",93,68,66,1,2,"SAIn",2
9,"9127",55,40,40,0,0,"SAIn",0
9,"9449",87,72,71,1,1,"SAIn",1
9,"9048",1484,1120,1106,4,14,"SAIn",0
9,"9013",47,41,41,0,0,"SAIn",0
9,"9083",37,33,33,0,0,"SAIn",0
9,"9209",4511,3368,3301,37,67,"SAIn",5
9,"9288",91,70,69,1,1,"SAIn",0
9,"9024",156,117,114,0,3,"SAIn",0
9,"9247",23,19,19,0,0,"SAIn",0
9,"9430",24,19,19,0,0,"SAIn",0
9,"9050",72,54,54,0,0,"SAIn",0
9,"9415",267,166,165,0,1,"SAIn",0
9,"9375",35,27,27,0,0,"SAIn",0
9,"9317",16,14,14,0,0,"SAIn",0
9,"9169",99,83,81,0,2,"SAIn",0
9,"9289",1466,1027,1013,6,14,"SAIn",1
9,"9014",213,127,126,1,1,"SAIn",0
9,"9085",475,352,350,2,2,"SAIn",0
9,"9223",46,39,39,0,0,"SAIn",1
9,"9248",78,57,57,0,0,"SAIn",0
9,"9428",107,87,87,0,0,"SAIn",0
9,"9211",1462,1086,1070,11,16,"SAIn",1
9,"9334",48,39,38,0,1,"SAIn",0
9,"9377",625,478,471,5,7,"SAIn",1
9,"9170",203,152,149,1,3,"SAIn",0
9,"9181",302,231,225,3,6,"SAIn",0
9,"9416",52,39,39,0,0,"SAIn",0
9,"9016",85,64,64,2,0,"SAIn",0
9,"9026",397,314,311,1,3,"SAIn",2
9,"9216",385,283,280,8,3,"SAIn",0
9,"9175",129,92,92,0,0,"SAIn",1
9,"9294",111,88,86,0,2,"SAIn",0
9,"9129",105,87,87,0,0,"SAIn",0
9,"9086",687,475,471,0,4,"SAIn",0
9,"9172",125,102,102,2,0,"SAIn",0
9,"9335",87,72,71,0,1,"SAIn",0
9,"9391",361,264,263,2,1,"SAIn",0
9,"9213",320,223,220,4,3,"SAIn",1
9,"9417",40,30,30,0,0,"SAIn",0
9,"9074",788,609,598,8,11,"SAIn",0
9,"9140",128,88,87,0,1,"SAIn",0
9,"9265",38,31,31,0,0,"SAIn",0
9,"9378",31,21,21,1,0,"SAIn",0
9,"9103",221,185,184,2,1,"SAIn",0
9,"9088",66,44,42,1,2,"SAIn",0
9,"9250",273,218,218,4,0,"SAIn",0
9,"9054",100,73,72,3,1,"SAIn",0
9,"9017",89,67,62,0,5,"SAIn",1
9,"9277",119,101,100,0,1,"SAIn",0
9,"9355",101,75,73,0,2,"SAIn",0
9,"9309",306,216,211,2,5,"SAIn",0
9,"9225",84,57,56,1,1,"SAIn",0
9,"9251",371,273,271,3,2,"SAIn",0
9,"9018",24702,18365,18158,174,207,"SAIn",9
9,"9141",610,499,493,4,6,"SAIn",4
9,"9380",78,59,57,0,2,"SAIn",0
9,"9131",460,381,373,5,8,"SAIn",0
9,"9090",57,51,51,1,0,"SAIn",0
9,"9055",52,39,38,0,1,"SAIn",0
9,"9419",78,45,44,0,1,"SAIn",0
9,"9253",111,96,94,1,2,"SAIn",1
9,"9030",109,76,76,3,0,"SAIn",0
9,"9065",147,124,123,2,1,"SAIn",0
9,"9456",129,90,90,2,0,"SAIn",0
9,"9019",147,103,102,1,1,"SAIn",0
9,"9381",32,23,22,0,1,"SAIn",0
9,"9421",237,172,172,2,0,"SAIn",0
9,"9043",189,132,132,2,0,"SAIn",0
9,"9267",115,101,100,3,1,"SAIn",0
9,"9463",262,206,206,3,0,"SAIn",0
9,"9429",56,41,41,0,0,"SAIn",0
9,"9132",173,132,130,0,2,"SAIn",0
9,"9464",36,24,24,0,0,"SAIn",0
9,"9298",82,62,62,0,0,"SAIn",0
9,"9268",95,73,72,0,1,"SAIn",0
9,"9144",52,40,40,0,0,"SAIn",0
9,"9382",33,30,29,1,1,"SAIn",0
9,"9133",40,34,34,0,0,"SAIn",0
9,"9388",36,31,30,1,1,"SAIn",1
9,"9255",86,66,62,0,4,"SAIn",0
9,"9422",18,10,10,0,0,"SAIn",0
9,"9458",466,380,377,3,3,"SAIn",0
9,"9020",262,187,180,2,7,"SAIn",0
9,"9228",163,138,138,0,0,"SAIn",0
9,"9384",293,199,194,0,5,"SAIn",0
9,"9134",228,152,152,2,0,"SAIn",0
9,"9093",154,133,128,1,5,"SAIn",0
9,"9057",144,116,115,0,1,"SAIn",0
9,"9480",110,89,88,1,1,"SAIn",0
9,"9389",77,56,56,0,0,"SAIn",0
9,"9301",616,513,506,5,7,"SAIn",0
9,"9423",27,25,25,0,0,"SAIn",0
9,"9021",56,33,31,0,2,"SAIn",0
9,"9302",116,87,87,0,0,"SAIn",0
9,"9104",54,43,43,0,0,"SAIn",0
9,"9109",1068,698,669,10,29,"SAIn",1
9,"9191",39,32,30,0,2,"SAIn",0
9,"9135",41,33,33,1,0,"SAIn",0
9,"9068",29,23,22,0,1,"SAIn",0
9,"9901",374,268,261,3,7,"SAIn",0
9,"9022",67,57,57,1,0,"SAIn",1
9,"9398",75,54,54,1,0,"SAIn",0
9,"9257",92,80,78,4,2,"SAIn",0
9,"9386",58,44,43,2,1,"SAIn",0
9,"9192",55,47,46,0,1,"SAIn",0
9,"9424",32,26,26,1,0,"SAIn",0
9,"9059",136713,106605,105601,976,1004,"SAIn",400
9,"9219",27590,19903,19724,166,179,"SAIn",7
9,"9230",38,31,31,0,0,"SAIn",0
9,"9451",238,199,198,1,1,"SAIn",0
9,"9066",65,51,51,0,0,"SAIn",0
9,"9482",34,29,28,0,1,"SAIn",0
9,"9262",161,129,129,0,0,"SAIn",0
9,"9151",458,364,363,3,1,"SAIn",0
9,"9070",34,31,30,3,1,"SAIn",0
9,"9400",317,258,256,3,2,"SAIn",0
9,"9346",93,71,69,0,2,"SAIn",0
9,"9023",1096,848,840,9,8,"SAIn",2
9,"9433",60,52,51,0,1,"SAIn",0
9,"9136",192,151,147,2,4,"SAIn",0
9,"9137",167,128,128,1,0,"SAIn",0
9,"9231",70,49,49,3,0,"SAIn",0
9,"9304",202,166,163,1,3,"SAIn",0
9,"9425",514,369,366,2,3,"SAIn",0
9,"9060",148,123,123,0,0,"SAIn",0
9,"9259",233,184,184,3,0,"SAIn",1
9,"9221",445,337,335,1,2,"SAIn",2
9,"9179",43,35,34,0,1,"SAIn",0
9,"9152",263,193,192,0,1,"SAIn",0
9,"9418",82,63,62,3,1,"SAIn",0
9,"9229",201,146,145,0,1,"SAIn",0
9,"9036",38,31,30,2,1,"SAIn",0
9,"9274",1098,880,872,9,8,"SAIn",0
9,"9347",141,113,109,4,4,"SAIn",0
9,"9176",61,45,44,0,1,"SAIn",0
9,"9180",136,102,100,2,2,"SAIn",0
9,"9427",1428,1014,1003,12,11,"SAIn",2
9,"9348",146,116,114,1,2,"SAIn",0
9,"9114",87,67,67,0,0,"SAIn",0
9,"9162",143,108,108,0,0,"SAIn",1
9,"9061",166,124,123,1,1,"SAIn",0
9,"9154",142,104,104,2,0,"SAIn",0
9,"9025",125,86,79,1,7,"SAIn",0
9,"9467",66,46,46,3,0,"SAIn",0
9,"9390",611,478,477,3,1,"SAIn",0
9,"9235",160,124,123,0,1,"SAIn",0
9,"9406",252,196,195,1,1,"SAIn",1
9,"9139",101,75,73,2,2,"SAIn",0
9,"9471",151,117,117,0,0,"SAIn",0
9,"9077",36,26,26,1,0,"SAIn",0
9,"9307",113,91,91,0,0,"SAIn",0
9,"9052",31,22,21,1,1,"SAIn",0
9,"9105",107,88,86,0,2,"SAIn",1
9,"9350",480,358,347,5,11,"SAIn",0
9,"9182",78,63,61,2,2,"SAIn",0
9,"9308",67,43,43,1,0,"SAIn",0
9,"9276",387,280,273,2,7,"SAIn",1
9,"9395",136,96,95,0,1,"SAIn",0
9,"9189",130,88,86,2,2,"SAIn",0
9,"9063",213,184,182,2,2,"SAIn",0
9,"9102",37,31,31,0,0,"SAIn",0
9,"9407",27,23,23,1,0,"SAIn",0
9,"9190",91,56,55,0,1,"SAIn",0
9,"9472",55,40,40,0,0,"SAIn",0
9,"9226",66,55,53,0,2,"SAIn",0
9,"9027",47,44,41,0,3,"SAIn",0
9,"9273",53,41,40,1,1,"SAIn",0
9,"9327",25,22,22,0,0,"SAIn",0
9,"9351",60,46,45,1,1,"SAIn",0
9,"9045",267,186,183,2,3,"SAIn",0
9,"9113",464,383,376,6,7,"SAIn",0
9,"9064",332,275,275,3,0,"SAIn",0
9,"9148",86,73,69,5,4,"SAIn",1
9,"9183",51,37,37,0,0,"SAIn",0
9,"9195",57,42,42,2,0,"SAIn",0
9,"9408",41,34,34,1,0,"SAIn",0
9,"9473",85,62,61,1,1,"SAIn",0
9,"9178",52,36,36,1,0,"SAIn",0
9,"9314",95,80,79,1,1,"SAIn",2
9,"9446",12,7,7,0,0,"SAIn",0
9,"9905",391,308,308,5,0,"SAIn",0
9,"9184",5,4,4,0,0,"SAIn",0
9,"9297",323,265,261,5,4,"SAIn",0
9,"9270",163,122,121,1,1,"SAIn",0
9,"9353",73,57,56,0,1,"SAIn",0
9,"9476",63,46,46,0,0,"SAIn",0
9,"9143",27,20,20,0,0,"SAIn",0
9,"9394",727,558,552,8,6,"SAIn",0
9,"9227",119,97,95,0,2,"SAIn",0
9,"9287",208,170,168,2,2,"SAIn",0
9,"9032",108,73,73,0,0,"SAIn",1
9,"9478",45,38,38,0,0,"SAIn",0
9,"9396",152,118,118,1,0,"SAIn",1
9,"9159",56,48,48,1,0,"SAIn",0
9,"9311",60,52,50,0,2,"SAIn",0
9,"9269",39,33,32,0,1,"SAIn",0
9,"9332",140,107,107,1,0,"SAIn",0
9,"9224",157,122,122,0,0,"SAIn",0
9,"9033",89,75,75,0,0,"SAIn",0
9,"9208",211,139,136,3,3,"SAIn",1
9,"9035",313,243,240,0,3,"SAIn",0
9,"9280",27,17,17,0,0,"SAIn",0
9,"9483",212,161,161,1,0,"SAIn",0
9,"9405",128,89,89,0,0,"SAIn",0
9,"9084",189,150,148,7,2,"SAIn",0
9,"9450",27,21,20,1,1,"SAIn",0
9,"9283",46,29,28,0,1,"SAIn",0
9,"9194",2024,1550,1530,17,20,"SAIn",0
9,"9037",113,96,96,0,0,"SAIn",0
9,"9292",92,72,70,0,2,"SAIn",0
9,"9067",442,308,303,9,5,"SAIn",1
9,"9110",80,49,49,1,0,"SAIn",0
9,"9094",51,42,41,0,1,"SAIn",5
9,"9343",97,70,69,0,1,"SAIn",0
9,"9214",684,452,446,6,6,"SAIn",0
9,"9075",111,83,83,1,0,"SAIn",0
9,"9413",447,333,333,5,0,"SAIn",0
9,"9360",30,27,27,0,0,"SAIn",0
9,"9316",104,83,80,1,3,"SAIn",0
9,"9232",151,125,124,2,1,"SAIn",0
9,"9128",82,66,66,0,0,"SAIn",0
9,"9168",296,233,231,1,2,"SAIn",0
9,"9217",361,265,261,4,4,"SAIn",0
9,"9275",192,138,137,1,1,"SAIn",0
9,"9100",59,51,50,0,1,"SAIn",0
9,"9447",42,38,38,0,0,"SAIn",0
9,"9034",280,237,233,5,4,"SAIn",0
9,"9315",379,269,267,2,2,"SAIn",0
9,"9356",42,31,31,0,0,"SAIn",0
9,"9220",76,62,61,2,1,"SAIn",0
9,"9455",44,34,33,0,1,"SAIn",0
9,"9431",119,99,98,0,1,"SAIn",0
9,"9325",195,125,123,2,2,"SAIn",0
9,"9312",98,83,82,0,1,"SAIn",0
9,"9177",1117,830,825,5,5,"SAIn",3
9,"9215",377,264,260,0,4,"SAIn",0
9,"9243",75,56,54,1,2,"SAIn",0
9,"9196",154,108,107,1,1,"SAIn",0
9,"9108",378,290,287,2,3,"SAIn",0
9,"9354",33,30,30,1,0,"SAIn",0
9,"9072",307,240,239,1,1,"SAIn",0
9,"9071",45,34,34,0,0,"SAIn",0
9,"9439",1005,823,816,9,7,"SAIn",2
9,"9437",286,227,226,5,1,"SAIn",0
9,"9445",44,32,32,1,0,"SAIn",0
9,"9454",47,34,34,0,0,"SAIn",0
9,"9306",113,91,91,1,0,"SAIn",0
9,"9112",113,75,73,2,2,"SAIn",0
9,"9485",55,43,43,1,0,"SAIn",0
9,"9328",77,55,55,1,0,"SAIn",0
9,"9218",360,272,271,2,1,"SAIn",0
9,"9440",96,78,78,0,0,"SAIn",0
9,"9098",516,396,388,6,8,"SAIn",0
9,"9062",51,44,44,1,0,"SAIn",0
9,"9352",116,97,97,0,0,"SAIn",0
9,"9073",926,753,748,10,5,"SAIn",2
9,"9414",201,148,147,1,1,"SAIn",0
9,"9295",60,37,37,0,0,"SAIn",0
9,"9149",34,25,24,0,1,"SAIn",0
9,"9199",91,65,65,2,0,"SAIn",0
9,"9125",596,435,433,3,2,"SAIn",0
9,"9318",61,38,38,0,0,"SAIn",0
9,"9095",86,62,62,0,0,"SAIn",0
9,"9249",47,37,37,1,0,"SAIn",0
9,"9460",177,135,135,2,0,"SAIn",2
9,"9266",91,72,70,0,2,"SAIn",0
9,"9466",134,99,99,0,0,"SAIn",1
9,"9438",544,446,444,3,2,"SAIn",0
9,"9261",463,339,330,8,9,"SAIn",0
9,"9339",128,103,103,0,0,"SAIn",0
9,"9310",13,9,8,0,1,"SAIn",0
9,"9361",117,96,96,0,0,"SAIn",0
9,"9058",393,293,289,2,4,"SAIn",0
9,"9138",90,73,72,0,1,"SAIn",0
9,"9206",61,52,50,3,2,"SAIn",0
9,"9101",79,59,59,0,0,"SAIn",0
41,"41044",7392,5562,5526,40,36,"PACMA",50
41,"41098",4952,3762,3704,24,58,"PACMA",47
41,"41083",1154,893,888,3,5,"PACMA",4
41,"41055",15009,10393,10292,82,101,"PACMA",38
41,"41086",16102,10743,10665,93,78,"PACMA",126
41,"41042",5868,4612,4583,37,29,"PACMA",18
41,"41014",2510,1981,1958,8,23,"PACMA",4
41,"41038",99637,71611,71050,727,561,"PACMA",902
41,"41066",1363,1019,1007,7,12,"PACMA",4
41,"41903",6747,4926,4854,43,72,"PACMA",39
41,"41074",3033,2362,2341,8,21,"PACMA",7
41,"41064",5601,3766,3715,42,51,"PACMA",28
41,"41008",1063,820,805,3,15,"PACMA",4
41,"41058",17304,12982,12751,133,231,"PACMA",152
41,"41013",4842,3491,3461,22,30,"PACMA",6
41,"41090",3541,2774,2721,17,53,"PACMA",10
41,"41057",275,193,191,0,2,"PACMA",1
41,"41032",4019,2943,2875,17,68,"PACMA",11
41,"41063",2683,1942,1922,21,20,"PACMA",10
41,"41070",6021,4504,4456,44,48,"PACMA",57
41,"41065",22868,15933,15784,172,149,"PACMA",84
41,"41045",5749,4121,4066,49,55,"PACMA",45
41,"41901",2676,2222,2190,31,32,"PACMA",5
41,"41046",3017,2416,2381,12,35,"PACMA",12
41,"41041",9743,7620,7482,39,138,"PACMA",41
41,"41053",21252,16022,15770,121,252,"PACMA",86
41,"41100",1025,770,751,5,19,"PACMA",1
41,"41085",4086,3223,3178,31,45,"PACMA",21
41,"41040",10411,7959,7892,53,67,"PACMA",86
41,"41049",9301,7147,7070,63,77,"PACMA",59
41,"41033",5102,3655,3613,25,42,"PACMA",15
41,"41076",2184,1442,1432,19,10,"PACMA",1
41,"41047",10086,7758,7663,80,95,"PACMA",82
41,"41011",15395,11527,11341,114,186,"PACMA",44
41,"41005",9057,6781,6693,58,88,"PACMA",54
41,"41091",541928,401177,398212,3487,2965,"PACMA",4019
41,"41056",3691,3069,3042,21,27,"PACMA",19
41,"41080",1270,954,938,8,16,"PACMA",2
41,"41092",7749,5715,5647,57,68,"PACMA",23
41,"41028",1971,1574,1562,11,12,"PACMA",19
41,"41037",3203,2473,2449,18,24,"PACMA",4
41,"41050",5158,4123,4078,37,45,"PACMA",20
41,"41902",4675,3051,3019,20,32,"PACMA",22
41,"41016",7310,5473,5410,50,63,"PACMA",43
41,"41081",29164,21631,21410,218,221,"PACMA",209
41,"41096",6166,4811,4752,39,59,"PACMA",39
41,"41002",1469,1085,1061,12,24,"PACMA",5
41,"41068",13948,10269,10150,75,119,"PACMA",26
41,"41087",10202,7160,7033,51,127,"PACMA",61
41,"41097",3135,2339,2317,19,22,"PACMA",5
41,"41101",5932,4454,4421,27,33,"PACMA",16
41,"41073",1715,1194,1169,9,25,"PACMA",2
41,"41048",2244,1625,1598,22,27,"PACMA",2
41,"41069",29070,20827,20558,355,269,"PACMA",136
41,"41093",18487,14687,14594,117,93,"PACMA",139
41,"41039",31674,23240,22982,196,258,"PACMA",168
41,"41001",1597,1262,1248,5,14,"PACMA",3
41,"41061",2218,1769,1742,5,27,"PACMA",2
41,"41043",636,439,435,3,4,"PACMA",2
41,"41089",6504,4759,4691,51,68,"PACMA",38
41,"41072",4052,3115,3041,18,74,"PACMA",20
41,"41020",12872,8820,8723,92,97,"PACMA",26
41,"41006",2740,1909,1897,13,12,"PACMA",7
41,"41036",3971,2846,2806,14,40,"PACMA",15
41,"41031",1257,838,836,8,2,"PACMA",2
41,"41071",5620,3974,3898,17,76,"PACMA",10
41,"41067",7115,5248,5178,46,70,"PACMA",34
41,"41052",3006,2264,2209,8,55,"PACMA",14
41,"41079",9343,7111,7029,68,82,"PACMA",54
41,"41012",3286,2268,2235,15,33,"PACMA",23
41,"41019",4654,3267,3224,34,43,"PACMA",31
41,"41051",2170,1650,1611,8,39,"PACMA",12
41,"41099",3998,2597,2577,19,20,"PACMA",17
41,"41009",1229,811,803,5,8,"PACMA",4
41,"41018",9490,6997,6930,45,67,"PACMA",42
41,"41024",22662,15742,15521,137,221,"PACMA",156
41,"41095",41137,28987,28731,302,256,"PACMA",255
41,"41082",3432,2809,2781,12,28,"PACMA",13
41,"41021",21249,15031,14854,152,177,"PACMA",177
41,"41062",2235,1805,1790,10,15,"PACMA",2
41,"41075",10225,7387,7283,55,104,"PACMA",64
41,"41023",7919,5852,5788,34,64,"PACMA",29
41,"41078",2522,1888,1874,5,14,"PACMA",4
41,"41084",2850,2205,2157,15,48,"PACMA",13
41,"41017",15052,11074,10964,99,110,"PACMA",113
41,"41059",33977,26158,25965,230,193,"PACMA",315
41,"41004",56552,40018,39623,515,395,"PACMA",575
41,"41029",13423,9979,9880,84,99,"PACMA",127
41,"41015",5310,3799,3710,38,89,"PACMA",26
41,"41027",3941,2766,2709,28,57,"PACMA",18
41,"41054",688,587,570,2,17,"PACMA",2
41,"41026",4325,3551,3516,18,35,"PACMA",15
41,"41094",6288,4726,4653,36,73,"PACMA",44
41,"41025",2041,1456,1430,17,26,"PACMA",12
41,"41007",12386,8552,8403,90,149,"PACMA",68
41,"41010",4394,3203,3160,19,43,"PACMA",38
41,"41077",8728,6423,6308,28,115,"PACMA",40
41,"41030",516,409,395,2,14,"PACMA",10
41,"41088",518,381,377,0,4,"PACMA",2
41,"41022",4300,2918,2891,30,27,"PACMA",14
41,"41003",2319,1782,1754,8,28,"PACMA",16
41,"41034",23033,15936,15711,189,225,"PACMA",177
41,"41035",1112,887,876,5,11,"PACMA",2
41,"41102",14635,10904,10655,148,249,"PACMA",73
41,"41060",15279,10611,10447,91,164,"PACMA",71
9,"9127",55,40,40,0,0,"PP",26
9,"9235",160,124,123,0,1,"PP",48
9,"9467",66,46,46,3,0,"PP",26
9,"9170",203,152,149,1,3,"PP",72
9,"9460",177,135,135,2,0,"PP",77
9,"9316",104,83,80,1,3,"PP",48
9,"9274",1098,880,872,9,8,"PP",336
9,"9443",183,132,129,1,3,"PP",77
9,"9110",80,49,49,1,0,"PP",29
9,"9473",85,62,61,1,1,"PP",40
9,"9117",77,61,57,0,4,"PP",38
9,"9036",38,31,30,2,1,"PP",15
9,"9323",64,47,47,0,0,"PP",24
9,"9283",46,29,28,0,1,"PP",18
9,"9261",463,339,330,8,9,"PP",122
9,"9010",32,23,23,2,0,"PP",16
9,"9076",23,14,14,0,0,"PP",9
9,"9448",216,180,178,1,2,"PP",123
9,"9318",61,38,38,0,0,"PP",17
9,"9045",267,186,183,2,3,"PP",90
9,"9478",45,38,38,0,0,"PP",15
9,"9288",91,70,69,1,1,"PP",38
9,"9063",213,184,182,2,2,"PP",104
9,"9265",38,31,31,0,0,"PP",21
9,"9073",926,753,748,10,5,"PP",251
9,"9044",46,38,37,0,1,"PP",14
9,"9466",134,99,99,0,0,"PP",69
9,"9374",90,79,77,2,2,"PP",34
9,"9060",148,123,123,0,0,"PP",75
9,"9256",362,261,255,2,6,"PP",130
9,"9458",466,380,377,3,3,"PP",85
9,"9446",12,7,7,0,0,"PP",4
9,"9109",1068,698,669,10,29,"PP",160
9,"9218",360,272,271,2,1,"PP",116
9,"9904",482,389,384,5,5,"PP",169
9,"9022",67,57,57,1,0,"PP",26
9,"9450",27,21,20,1,1,"PP",10
9,"9078",41,35,33,0,2,"PP",13
9,"9176",61,45,44,0,1,"PP",27
9,"9351",60,46,45,1,1,"PP",24
9,"9125",596,435,433,3,2,"PP",251
9,"9414",201,148,147,1,1,"PP",72
9,"9425",514,369,366,2,3,"PP",125
9,"9480",110,89,88,1,1,"PP",51
9,"9221",445,337,335,1,2,"PP",103
9,"9052",31,22,21,1,1,"PP",14
9,"9906",1223,952,947,9,5,"PP",443
9,"9227",119,97,95,0,2,"PP",39
9,"9026",397,314,311,1,3,"PP",118
9,"9017",89,67,62,0,5,"PP",27
9,"9325",195,125,123,2,2,"PP",73
9,"9180",136,102,100,2,2,"PP",40
9,"9270",163,122,121,1,1,"PP",58
9,"9259",233,184,184,3,0,"PP",90
9,"9408",41,34,34,1,0,"PP",24
9,"9220",76,62,61,2,1,"PP",27
9,"9067",442,308,303,9,5,"PP",173
9,"9360",30,27,27,0,0,"PP",12
9,"9009",163,130,128,2,2,"PP",50
9,"9122",96,66,66,0,0,"PP",44
9,"9395",136,96,95,0,1,"PP",52
9,"9144",52,40,40,0,0,"PP",25
9,"9169",99,83,81,0,2,"PP",39
9,"9391",361,264,263,2,1,"PP",147
9,"9332",140,107,107,1,0,"PP",49
9,"9327",25,22,22,0,0,"PP",6
9,"9201",30,17,17,0,0,"PP",9
9,"9244",47,26,26,1,0,"PP",13
9,"9418",82,63,62,3,1,"PP",44
9,"9464",36,24,24,0,0,"PP",15
9,"9433",60,52,51,0,1,"PP",17
9,"9177",1117,830,825,5,5,"PP",327
9,"9128",82,66,66,0,0,"PP",23
9,"9482",34,29,28,0,1,"PP",15
9,"9154",142,104,104,2,0,"PP",51
9,"9268",95,73,72,0,1,"PP",32
9,"9380",78,59,57,0,2,"PP",32
9,"9314",95,80,79,1,1,"PP",29
9,"9054",100,73,72,3,1,"PP",31
9,"9375",35,27,27,0,0,"PP",12
9,"9208",211,139,136,3,3,"PP",77
9,"9048",1484,1120,1106,4,14,"PP",467
9,"9417",40,30,30,0,0,"PP",28
9,"9137",167,128,128,1,0,"PP",62
9,"9019",147,103,102,1,1,"PP",50
9,"9143",27,20,20,0,0,"PP",15
9,"9133",40,34,34,0,0,"PP",13
9,"9280",27,17,17,0,0,"PP",13
9,"9189",130,88,86,2,2,"PP",45
9,"9354",33,30,30,1,0,"PP",18
9,"9112",113,75,73,2,2,"PP",38
9,"9249",47,37,37,1,0,"PP",17
9,"9903",3251,2359,2340,24,19,"PP",930
9,"9140",128,88,87,0,1,"PP",41
9,"9160",90,71,70,0,1,"PP",39
9,"9141",610,499,493,4,6,"PP",187
9,"9388",36,31,30,1,1,"PP",6
9,"9396",152,118,118,1,0,"PP",74
9,"9330",1523,1166,1148,15,18,"PP",477
9,"9338",219,173,171,1,2,"PP",53
9,"9368",22,14,14,1,0,"PP",11
9,"9309",306,216,211,2,5,"PP",111
9,"9352",116,97,97,0,0,"PP",47
9,"9343",97,70,69,0,1,"PP",50
9,"9430",24,19,19,0,0,"PP",7
9,"9239",53,44,42,1,2,"PP",30
9,"9018",24702,18365,18158,174,207,"PP",6306
9,"9014",213,127,126,1,1,"PP",56
9,"9329",123,86,86,1,0,"PP",27
9,"9266",91,72,70,0,2,"PP",33
9,"9398",75,54,54,1,0,"PP",26
9,"9131",460,381,373,5,8,"PP",104
9,"9066",65,51,51,0,0,"PP",16
9,"9195",57,42,42,2,0,"PP",16
9,"9394",727,558,552,8,6,"PP",209
9,"9162",143,108,108,0,0,"PP",38
9,"9007",59,41,41,0,0,"PP",29
9,"9306",113,91,91,1,0,"PP",52
9,"9335",87,72,71,0,1,"PP",24
9,"9438",544,446,444,3,2,"PP",182
9,"9012",93,68,66,1,2,"PP",26
9,"9059",136713,106605,105601,976,1004,"PP",38751
9,"9373",440,285,282,3,3,"PP",207
9,"9083",37,33,33,0,0,"PP",21
9,"9055",52,39,38,0,1,"PP",19
9,"9047",56,45,45,2,0,"PP",24
9,"9194",2024,1550,1530,17,20,"PP",663
9,"9340",76,49,49,0,0,"PP",35
9,"9445",44,32,32,1,0,"PP",15
9,"9105",107,88,86,0,2,"PP",37
9,"9027",47,44,41,0,3,"PP",14
9,"9152",263,193,192,0,1,"PP",101
9,"9198",108,86,85,2,1,"PP",33
9,"9020",262,187,180,2,7,"PP",101
9,"9134",228,152,152,2,0,"PP",43
9,"9003",192,148,146,2,2,"PP",56
9,"9276",387,280,273,2,7,"PP",42
9,"9098",516,396,388,6,8,"PP",153
9,"9405",128,89,89,0,0,"PP",54
9,"9050",72,54,54,0,0,"PP",24
9,"9310",13,9,8,0,1,"PP",1
9,"9328",77,55,55,1,0,"PP",30
9,"9302",116,87,87,0,0,"PP",45
9,"9072",307,240,239,1,1,"PP",78
9,"9029",168,134,132,3,2,"PP",41
9,"9439",1005,823,816,9,7,"PP",265
9,"9114",87,67,67,0,0,"PP",34
9,"9372",221,190,189,1,1,"PP",77
9,"9166",97,79,78,3,1,"PP",56
9,"9075",111,83,83,1,0,"PP",37
9,"9065",147,124,123,2,1,"PP",57
9,"9409",109,87,87,0,0,"PP",26
9,"9132",173,132,130,0,2,"PP",64
9,"9200",48,37,36,0,1,"PP",17
9,"9262",161,129,129,0,0,"PP",74
9,"9181",302,231,225,3,6,"PP",141
9,"9441",74,66,66,0,0,"PP",56
9,"9175",129,92,92,0,0,"PP",69
9,"9432",189,143,140,1,3,"PP",55
9,"9321",1640,1250,1237,5,13,"PP",502
9,"9151",458,364,363,3,1,"PP",135
9,"9224",157,122,122,0,0,"PP",74
9,"9429",56,41,41,0,0,"PP",21
9,"9182",78,63,61,2,2,"PP",40
9,"9384",293,199,194,0,5,"PP",106
9,"9086",687,475,471,0,4,"PP",202
9,"9056",4931,3634,3602,35,32,"PP",1540
9,"9016",85,64,64,2,0,"PP",24
9,"9163",602,479,472,5,7,"PP",199
9,"9077",36,26,26,1,0,"PP",15
9,"9250",273,218,218,4,0,"PP",99
9,"9281",147,109,107,0,2,"PP",43
9,"9485",55,43,43,1,0,"PP",35
9,"9449",87,72,71,1,1,"PP",46
9,"9179",43,35,34,0,1,"PP",16
9,"9033",89,75,75,0,0,"PP",44
9,"9173",123,93,93,1,0,"PP",52
9,"9251",371,273,271,3,2,"PP",130
9,"9088",66,44,42,1,2,"PP",18
9,"9084",189,150,148,7,2,"PP",79
9,"9191",39,32,30,0,2,"PP",20
9,"9415",267,166,165,0,1,"PP",94
9,"9037",113,96,96,0,0,"PP",17
9,"9392",53,40,40,0,0,"PP",15
9,"9102",37,31,31,0,0,"PP",16
9,"9183",51,37,37,0,0,"PP",22
9,"9064",332,275,275,3,0,"PP",114
9,"9061",166,124,123,1,1,"PP",101
9,"9211",1462,1086,1070,11,16,"PP",555
9,"9315",379,269,267,2,2,"PP",87
9,"9120",39,35,35,0,0,"PP",14
9,"9090",57,51,51,1,0,"PP",34
9,"9124",1520,1113,1096,9,17,"PP",426
9,"9476",63,46,46,0,0,"PP",24
9,"9043",189,132,132,2,0,"PP",69
9,"9129",105,87,87,0,0,"PP",25
9,"9298",82,62,62,0,0,"PP",42
9,"9255",86,66,62,0,4,"PP",30
9,"9275",192,138,137,1,1,"PP",80
9,"9216",385,283,280,8,3,"PP",124
9,"9071",45,34,34,0,0,"PP",14
9,"9178",52,36,36,1,0,"PP",24
9,"9358",249,191,191,1,0,"PP",115
9,"9400",317,258,256,3,2,"PP",86
9,"9136",192,151,147,2,4,"PP",67
9,"9382",33,30,29,1,1,"PP",21
9,"9074",788,609,598,8,11,"PP",200
9,"9032",108,73,73,0,0,"PP",22
9,"9094",51,42,41,0,1,"PP",20
9,"9228",163,138,138,0,0,"PP",74
9,"9269",39,33,32,0,1,"PP",18
9,"9025",125,86,79,1,7,"PP",44
9,"9164",165,121,121,1,0,"PP",65
9,"9389",77,56,56,0,0,"PP",36
9,"9454",47,34,34,0,0,"PP",12
9,"9103",221,185,184,2,1,"PP",82
9,"9312",98,83,82,0,1,"PP",43
9,"9337",115,84,82,0,2,"PP",33
9,"9041",28,28,28,1,0,"PP",12
9,"9455",44,34,33,0,1,"PP",26
9,"9226",66,55,53,0,2,"PP",29
9,"9413",447,333,333,5,0,"PP",163
9,"9225",84,57,56,1,1,"PP",23
9,"9091",732,516,512,7,4,"PP",294
9,"9410",3051,2169,2153,18,16,"PP",586
9,"9246",622,458,455,5,3,"PP",197
9,"9350",480,358,347,5,11,"PP",218
9,"9006",61,41,41,0,0,"PP",20
9,"9253",111,96,94,1,2,"PP",38
9,"9901",374,268,261,3,7,"PP",120
9,"9241",201,156,155,3,1,"PP",43
9,"9307",113,91,91,0,0,"PP",27
9,"9348",146,116,114,1,2,"PP",60
9,"9184",5,4,4,0,0,"PP",2
9,"9294",111,88,86,0,2,"PP",29
9,"9135",41,33,33,1,0,"PP",19
9,"9423",27,25,25,0,0,"PP",19
9,"9339",128,103,103,0,0,"PP",46
9,"9229",201,146,145,0,1,"PP",78
9,"9902",461,347,339,1,8,"PP",154
9,"9001",27,26,26,0,0,"PP",11
9,"9197",148,108,104,1,4,"PP",51
9,"9407",27,23,23,1,0,"PP",7
9,"9172",125,102,102,2,0,"PP",56
9,"9362",204,168,164,0,4,"PP",54
9,"9308",67,43,43,1,0,"PP",24
9,"9242",81,65,63,2,2,"PP",40
9,"9013",47,41,41,0,0,"PP",25
9,"9412",803,552,550,2,2,"PP",260
9,"9046",30,26,26,0,0,"PP",12
9,"9068",29,23,22,0,1,"PP",8
9,"9390",611,478,477,3,1,"PP",213
9,"9258",173,139,136,4,3,"PP",82
9,"9213",320,223,220,4,3,"PP",97
9,"9148",86,73,69,5,4,"PP",27
9,"9190",91,56,55,0,1,"PP",25
9,"9472",55,40,40,0,0,"PP",22
9,"9301",616,513,506,5,7,"PP",187
9,"9093",154,133,128,1,5,"PP",51
9,"9123",40,35,35,0,0,"PP",17
9,"9030",109,76,76,3,0,"PP",41
9,"9155",26,20,20,1,0,"PP",10
9,"9289",1466,1027,1013,6,14,"PP",459
9,"9051",168,133,132,1,1,"PP",79
9,"9428",107,87,87,0,0,"PP",44
9,"9437",286,227,226,5,1,"PP",103
9,"9287",208,170,168,2,2,"PP",45
9,"9456",129,90,90,2,0,"PP",40
9,"9215",377,264,260,0,4,"PP",117
9,"9440",96,78,78,0,0,"PP",40
9,"9079",46,40,37,0,3,"PP",31
9,"9011",69,49,49,0,0,"PP",26
9,"9366",90,64,63,1,1,"PP",29
9,"9236",38,32,32,0,0,"PP",30
9,"9217",361,265,261,4,4,"PP",126
9,"9444",72,48,48,2,0,"PP",37
9,"9243",75,56,54,1,2,"PP",26
9,"9021",56,33,31,0,2,"PP",12
9,"9273",53,41,40,1,1,"PP",21
9,"9101",79,59,59,0,0,"PP",42
9,"9463",262,206,206,3,0,"PP",89
9,"9483",212,161,161,1,0,"PP",74
9,"9387",118,96,95,0,1,"PP",30
9,"9035",313,243,240,0,3,"PP",87
9,"9159",56,48,48,1,0,"PP",38
9,"9471",151,117,117,0,0,"PP",49
9,"9024",156,117,114,0,3,"PP",63
9,"9057",144,116,115,0,1,"PP",42
9,"9421",237,172,172,2,0,"PP",71
9,"9377",625,478,471,5,7,"PP",241
9,"9104",54,43,43,0,0,"PP",33
9,"9149",34,25,24,0,1,"PP",16
9,"9257",92,80,78,4,2,"PP",51
9,"9334",48,39,38,0,1,"PP",16
9,"9304",202,166,163,1,3,"PP",100
9,"9113",464,383,376,6,7,"PP",128
9,"9907",1420,1120,1115,13,5,"PP",338
9,"9247",23,19,19,0,0,"PP",16
9,"9347",141,113,109,4,4,"PP",43
9,"9034",280,237,233,5,4,"PP",117
9,"9345",124,92,92,0,0,"PP",36
9,"9427",1428,1014,1003,12,11,"PP",548
9,"9209",4511,3368,3301,37,67,"PP",1494
9,"9353",73,57,56,0,1,"PP",20
9,"9138",90,73,72,0,1,"PP",46
9,"9431",119,99,98,0,1,"PP",54
9,"9424",32,26,26,1,0,"PP",18
9,"9115",92,69,68,0,1,"PP",44
9,"9023",1096,848,840,9,8,"PP",257
9,"9451",238,199,198,1,1,"PP",63
9,"9292",92,72,70,0,2,"PP",29
9,"9223",46,39,39,0,0,"PP",22
9,"9295",60,37,37,0,0,"PP",29
9,"9363",974,730,725,3,5,"PP",467
9,"9905",391,308,308,5,0,"PP",128
9,"9303",92,72,71,0,1,"PP",44
9,"9232",151,125,124,2,1,"PP",62
9,"9365",31,20,20,0,0,"PP",13
9,"9419",78,45,44,0,1,"PP",38
9,"9199",91,65,65,2,0,"PP",38
9,"9062",51,44,44,1,0,"PP",15
9,"9406",252,196,195,1,1,"PP",51
9,"9346",93,71,69,0,2,"PP",35
9,"9378",31,21,21,1,0,"PP",5
9,"9139",101,75,73,2,2,"PP",26
9,"9381",32,23,22,0,1,"PP",16
9,"9434",1221,985,970,10,15,"PP",299
9,"9168",296,233,231,1,2,"PP",78
9,"9326",148,115,113,2,2,"PP",35
9,"9416",52,39,39,0,0,"PP",11
9,"9082",40,35,35,0,0,"PP",29
9,"9192",55,47,46,0,1,"PP",8
9,"9119",46,27,27,0,0,"PP",11
9,"9206",61,52,50,3,2,"PP",32
9,"9070",34,31,30,3,1,"PP",10
9,"9361",117,96,96,0,0,"PP",57
9,"9039",58,38,38,0,0,"PP",29
9,"9238",932,576,569,6,7,"PP",218
9,"9277",119,101,100,0,1,"PP",26
9,"9196",154,108,107,1,1,"PP",40
9,"9908",469,314,309,2,5,"PP",132
9,"9108",378,290,287,2,3,"PP",95
9,"9248",78,57,57,0,0,"PP",28
9,"9411",149,111,111,0,0,"PP",46
9,"9038",118,97,94,0,3,"PP",37
9,"9311",60,52,50,0,2,"PP",12
9,"9297",323,265,261,5,4,"PP",140
9,"9442",380,287,282,2,5,"PP",127
9,"9355",101,75,73,0,2,"PP",60
9,"9317",16,14,14,0,0,"PP",5
9,"9386",58,44,43,2,1,"PP",29
9,"9095",86,62,62,0,0,"PP",46
9,"9447",42,38,38,0,0,"PP",18
9,"9058",393,293,289,2,4,"PP",94
9,"9085",475,352,350,2,2,"PP",123
9,"9272",294,206,203,1,3,"PP",93
9,"9219",27590,19903,19724,166,179,"PP",5403
9,"9202",24,22,22,1,0,"PP",18
9,"9174",809,575,565,10,10,"PP",265
9,"9403",96,78,76,1,2,"PP",44
9,"9369",442,331,328,1,3,"PP",124
9,"9279",177,130,130,0,0,"PP",74
9,"9100",59,51,50,0,1,"PP",35
9,"9356",42,31,31,0,0,"PP",16
9,"9267",115,101,100,3,1,"PP",67
9,"9167",59,42,42,2,0,"PP",27
9,"9230",38,31,31,0,0,"PP",24
9,"9130",79,63,62,1,1,"PP",40
9,"9231",70,49,49,3,0,"PP",23
9,"9422",18,10,10,0,0,"PP",8
9,"9214",684,452,446,6,6,"PP",175
1,"1031",1183,907,885,6,22,"C's",66
1,"1058",1327,843,833,8,10,"C's",25
1,"1061",153,132,132,2,0,"C's",6
1,"1016",439,255,249,3,6,"C's",9
1,"1902",738,537,528,4,9,"C's",31
1,"1028",1077,759,753,6,6,"C's",46
1,"1014",372,292,284,1,8,"C's",23
1,"1060",199,162,159,0,3,"C's",12
1,"1056",218,141,140,1,1,"C's",3
1,"1027",416,268,268,0,0,"C's",14
1,"1037",586,425,419,2,6,"C's",13
1,"1004",1405,1026,1010,7,16,"C's",34
1,"1009",1281,908,898,2,10,"C's",17
1,"1010",2275,1729,1717,17,12,"C's",35
1,"1051",3606,2413,2389,21,24,"C's",74
1,"1041",153,105,100,1,5,"C's",7
1,"1023",269,197,195,2,2,"C's",8
1,"1043",2318,1644,1624,8,20,"C's",132
1,"1049",140,108,108,0,0,"C's",4
1,"1901",2344,1688,1669,17,19,"C's",117
1,"1034",165,120,119,1,1,"C's",4
1,"1055",836,564,552,8,12,"C's",29
1,"1001",1984,1426,1405,8,21,"C's",81
1,"1021",460,336,332,1,4,"C's",19
1,"1013",711,486,483,3,3,"C's",15
1,"1006",176,142,141,1,1,"C's",18
1,"1003",1186,842,833,19,9,"C's",0
1,"1022",805,593,587,3,6,"C's",36
1,"1008",790,548,542,13,6,"C's",31
1,"1019",144,112,111,2,1,"C's",1
1,"1044",236,189,187,1,2,"C's",6
1,"1032",522,368,361,0,7,"C's",14
1,"1039",202,161,156,0,5,"C's",10
1,"1033",649,512,508,5,4,"C's",23
1,"1062",314,215,215,3,0,"C's",13
1,"1052",244,188,186,1,2,"C's",2
1,"1020",326,232,228,0,4,"C's",9
1,"1036",15034,10733,10619,73,114,"C's",305
1,"1002",8139,5961,5878,32,83,"C's",156
1,"1054",952,694,688,4,6,"C's",14
1,"1017",869,584,577,4,7,"C's",13
1,"1053",587,367,365,3,2,"C's",12
1,"1011",237,177,175,7,2,"C's",12
1,"1030",159,126,123,1,3,"C's",0
1,"1057",245,203,202,0,1,"C's",8
1,"1046",594,445,435,3,10,"C's",22
1,"1042",901,653,650,11,3,"C's",4
1,"1059",186354,135873,134633,948,1240,"C's",8753
1,"1047",964,713,702,13,11,"C's",74
1,"1018",1370,964,963,4,1,"C's",35
1,"1063",1799,1320,1309,10,11,"C's",73
8,"8097",1027,736,731,7,5,"PACMA",14
8,"8107",11472,8147,8097,45,50,"PACMA",119
8,"8111",216,185,185,0,0,"PACMA",0
8,"8086",13550,9448,9395,66,53,"PACMA",115
8,"8224",816,598,595,7,3,"PACMA",10
8,"8235",3683,2612,2595,22,17,"PACMA",28
8,"8192",5696,4093,4069,38,24,"PACMA",44
8,"8285",10260,6893,6843,56,50,"PACMA",69
8,"8137",265,206,205,1,1,"PACMA",1
8,"8034",766,542,538,3,4,"PACMA",5
8,"8069",3168,2333,2324,17,9,"PACMA",24
8,"8049",1288,860,841,9,19,"PACMA",4
8,"8305",27328,19226,19083,116,143,"PACMA",257
8,"8018",2654,1834,1819,16,15,"PACMA",20
8,"8079",339,254,248,2,6,"PACMA",2
8,"8068",6729,4765,4739,23,26,"PACMA",63
8,"8125",25024,18070,17966,99,104,"PACMA",232
8,"8306",517,360,354,2,6,"PACMA",9
8,"8163",18590,12816,12750,72,66,"PACMA",172
8,"8217",24985,19385,19317,130,68,"PACMA",232
8,"8065",1179,837,831,8,6,"PACMA",11
8,"8272",157,98,97,0,1,"PACMA",0
8,"8259",6623,4921,4885,33,36,"PACMA",48
8,"8003",7118,5140,5108,28,32,"PACMA",63
8,"8084",1135,795,790,6,5,"PACMA",14
8,"8115",3817,2835,2814,18,21,"PACMA",47
8,"8197",7605,5331,5317,31,14,"PACMA",51
8,"8117",2453,1741,1727,23,14,"PACMA",14
8,"8046",13243,9747,9693,74,54,"PACMA",103
8,"8307",48233,34249,34071,209,178,"PACMA",388
8,"8295",10850,7651,7617,33,34,"PACMA",103
8,"8045",72,42,39,0,3,"PACMA",0
8,"8199",665,466,464,6,2,"PACMA",3
8,"8027",690,527,524,3,3,"PACMA",3
8,"8170",447,293,291,11,2,"PACMA",3
8,"8238",14478,11302,11252,85,50,"PACMA",141
8,"8042",2233,1668,1653,8,15,"PACMA",23
8,"8124",36750,26968,26842,140,126,"PACMA",338
8,"8074",10587,7309,7274,51,35,"PACMA",84
8,"8108",5014,3757,3740,21,17,"PACMA",42
8,"8282",6517,5027,5017,40,10,"PACMA",55
8,"8264",4288,3045,3030,30,15,"PACMA",24
8,"8205",59169,45410,45231,357,179,"PACMA",436
8,"8113",52051,34906,34729,229,177,"PACMA",352
8,"8288",1632,1061,1053,4,8,"PACMA",19
8,"8050",141,107,104,0,3,"PACMA",1
8,"8075",3875,2709,2695,12,14,"PACMA",47
8,"8194",25539,16628,16553,77,75,"PACMA",257
8,"8308",131,99,97,0,2,"PACMA",0
8,"8118",17516,12878,12820,79,58,"PACMA",189
8,"8061",1485,1045,1040,5,5,"PACMA",10
8,"8287",1044,806,792,7,14,"PACMA",9
8,"8202",12615,8911,8831,70,80,"PACMA",96
8,"8250",7046,4908,4878,33,30,"PACMA",53
8,"8256",644,516,512,1,4,"PACMA",14
8,"8038",1488,987,981,10,6,"PACMA",6
8,"8203",2422,1602,1591,11,11,"PACMA",25
8,"8251",4970,3505,3480,14,25,"PACMA",54
8,"8126",8709,6454,6425,34,29,"PACMA",97
8,"8216",25,17,17,0,0,"PACMA",0
8,"8058",1742,1210,1194,7,16,"PACMA",17
8,"8292",1083,796,791,4,5,"PACMA",14
8,"8215",2576,1766,1751,30,15,"PACMA",23
8,"8296",1787,1358,1351,9,7,"PACMA",13
8,"8121",86293,61426,61070,450,356,"PACMA",791
8,"8083",1674,1287,1275,8,12,"PACMA",9
8,"8183",4524,3125,3103,21,22,"PACMA",29
8,"8188",117,81,81,2,0,"PACMA",0
8,"8159",14049,10329,10284,51,45,"PACMA",131
8,"8048",583,426,424,5,2,"PACMA",2
8,"8249",266,223,220,2,3,"PACMA",7
8,"8039",354,259,259,0,0,"PACMA",2
8,"8253",133,85,85,1,0,"PACMA",2
8,"8182",2803,2039,2034,16,5,"PACMA",20
8,"8030",5095,3727,3712,27,15,"PACMA",49
8,"8144",715,493,489,9,4,"PACMA",3
8,"8187",152527,112013,111491,638,522,"PACMA",1556
8,"8007",6505,4532,4495,28,37,"PACMA",70
8,"8247",958,716,714,7,2,"PACMA",5
8,"8122",1683,1117,1106,10,11,"PACMA",18
8,"8008",187,118,118,1,0,"PACMA",2
8,"8152",114,84,82,1,2,"PACMA",0
8,"8112",12909,8671,8616,50,55,"PACMA",90
8,"8103",631,431,431,3,0,"PACMA",3
8,"8035",12448,8482,8443,54,39,"PACMA",111
8,"8090",129,103,102,2,1,"PACMA",0
8,"8905",2305,1789,1774,17,15,"PACMA",16
8,"8176",158,113,113,1,0,"PACMA",0
8,"8240",9354,6996,6953,34,43,"PACMA",53
8,"8168",375,235,234,0,1,"PACMA",7
8,"8269",2646,1871,1860,17,11,"PACMA",15
8,"8134",803,560,554,5,6,"PACMA",14
8,"8119",6182,4517,4492,35,25,"PACMA",71
8,"8106",7216,5220,5176,38,44,"PACMA",66
8,"8273",2309,1706,1689,12,17,"PACMA",14
8,"8284",12067,7855,7792,66,63,"PACMA",105
8,"8022",12230,7792,7717,60,75,"PACMA",81
8,"8073",61659,45611,45356,239,255,"PACMA",510
8,"8139",171,133,132,0,1,"PACMA",0
8,"8219",15355,11458,11403,86,55,"PACMA",125
8,"8128",564,378,377,1,1,"PACMA",2
8,"8136",11416,8425,8388,63,37,"PACMA",142
8,"8025",1486,1087,1083,13,4,"PACMA",18
8,"8177",40,25,25,1,0,"PACMA",0
8,"8009",9136,6613,6578,40,35,"PACMA",95
8,"8262",6855,4522,4491,46,31,"PACMA",67
8,"8158",3105,2166,2145,18,21,"PACMA",43
8,"8178",430,317,315,4,2,"PACMA",4
8,"8263",20974,15086,15001,93,85,"PACMA",193
8,"8185",194,132,132,0,0,"PACMA",3
8,"8212",495,350,347,3,3,"PACMA",1
8,"8011",1760,1230,1217,10,13,"PACMA",18
8,"8085",985,712,704,1,8,"PACMA",9
8,"8014",1953,1438,1429,13,9,"PACMA",21
8,"8133",128,76,75,0,1,"PACMA",0
8,"8067",5723,3896,3874,39,22,"PACMA",39
8,"8089",33935,24504,24392,150,112,"PACMA",309
8,"8123",19114,14573,14509,81,64,"PACMA",168
8,"8267",6435,4571,4542,24,29,"PACMA",69
8,"8191",5287,3732,3712,31,20,"PACMA",31
8,"8294",1971,1357,1349,8,8,"PACMA",27
8,"8257",110,87,87,0,0,"PACMA",0
8,"8053",2805,1789,1775,10,14,"PACMA",24
8,"8094",1548,1143,1133,12,10,"PACMA",17
8,"8015",155841,109156,108536,726,620,"PACMA",1477
8,"8127",2224,1439,1429,8,10,"PACMA",23
8,"8225",93,71,71,2,0,"PACMA",1
8,"8258",835,602,597,5,5,"PACMA",2
8,"8001",8825,6810,6760,24,50,"PACMA",114
8,"8142",132,105,104,1,1,"PACMA",2
8,"8060",143,100,99,0,1,"PACMA",0
8,"8120",6815,5071,5045,34,26,"PACMA",43
8,"8138",4229,2832,2816,19,16,"PACMA",23
8,"8218",8045,5643,5613,54,30,"PACMA",50
8,"8289",4304,3166,3151,19,15,"PACMA",51
8,"8036",159,113,112,1,1,"PACMA",0
8,"8222",1878,1452,1443,16,9,"PACMA",14
8,"8299",395,256,255,3,1,"PACMA",4
8,"8088",11840,8684,8627,55,57,"PACMA",97
8,"8237",1642,1165,1160,4,5,"PACMA",13
8,"8161",11145,7658,7621,45,37,"PACMA",120
8,"8300",5682,4328,4312,21,16,"PACMA",56
8,"8047",3978,2640,2614,21,26,"PACMA",11
8,"8055",512,366,364,2,2,"PACMA",6
8,"8044",4150,2957,2932,19,25,"PACMA",30
8,"8037",1856,1364,1351,20,13,"PACMA",20
8,"8130",96,66,66,0,0,"PACMA",1
8,"8033",12803,9236,9179,79,57,"PACMA",127
8,"8260",18306,13492,13423,60,69,"PACMA",184
8,"8070",267,196,193,2,3,"PACMA",1
8,"8026",187,155,155,1,0,"PACMA",1
8,"8231",20495,13961,13885,91,76,"PACMA",194
8,"8072",10240,6957,6935,40,22,"PACMA",108
8,"8005",6165,4458,4434,23,24,"PACMA",47
8,"8206",731,568,559,9,9,"PACMA",3
8,"8071",241,168,164,3,4,"PACMA",3
8,"8286",2904,2009,1997,17,12,"PACMA",32
8,"8093",26,19,19,0,0,"PACMA",0
8,"8141",4590,3173,3150,39,23,"PACMA",20
8,"8278",4764,3372,3358,16,14,"PACMA",25
8,"8261",2319,1638,1632,4,6,"PACMA",17
8,"8057",59,42,41,2,1,"PACMA",0
8,"8210",4296,2825,2806,22,19,"PACMA",58
8,"8105",9613,7103,7047,46,56,"PACMA",108
8,"8232",1797,1276,1266,14,10,"PACMA",12
8,"8062",951,676,674,5,2,"PACMA",4
8,"8029",3438,2645,2632,25,13,"PACMA",29
8,"8903",213,167,167,0,0,"PACMA",0
8,"8302",9209,6571,6524,65,47,"PACMA",103
8,"8172",20384,14738,14684,85,54,"PACMA",157
8,"8196",19247,14101,14047,75,54,"PACMA",152
8,"8184",53690,37794,37636,200,158,"PACMA",511
8,"8268",1011,702,699,2,3,"PACMA",13
8,"8002",202,142,139,0,3,"PACMA",2
8,"8095",71,50,50,0,0,"PACMA",2
8,"8066",1364,1029,1025,10,4,"PACMA",15
8,"8091",5253,3817,3795,23,22,"PACMA",56
8,"8102",28304,19929,19821,170,108,"PACMA",185
8,"8301",48496,35956,35788,200,168,"PACMA",465
8,"8298",26426,17862,17784,113,78,"PACMA",124
8,"8131",699,520,516,4,4,"PACMA",6
8,"8080",38,28,27,0,1,"PACMA",1
8,"8140",4769,3344,3335,25,9,"PACMA",32
8,"8181",7896,5774,5724,41,50,"PACMA",83
8,"8193",942,637,633,9,4,"PACMA",12
8,"8020",4876,3702,3678,25,24,"PACMA",46
8,"8104",682,445,443,4,2,"PACMA",7
8,"8081",345,255,255,1,0,"PACMA",4
8,"8297",138,100,99,1,1,"PACMA",1
8,"8151",463,336,333,11,3,"PACMA",2
8,"8096",42411,30717,30550,204,167,"PACMA",356
8,"8160",330,217,217,0,0,"PACMA",3
8,"8266",43128,32806,32660,195,146,"PACMA",410
8,"8076",16173,11553,11473,73,80,"PACMA",169
8,"8012",1676,1175,1170,24,5,"PACMA",5
8,"8064",1853,1323,1315,9,8,"PACMA",8
8,"8290",1490,1163,1155,5,8,"PACMA",17
8,"8904",10563,7474,7437,32,37,"PACMA",116
8,"8132",379,259,256,3,3,"PACMA",3
8,"8304",814,578,573,1,5,"PACMA",4
8,"8031",2308,1648,1637,10,11,"PACMA",16
8,"8056",41996,30076,29974,178,102,"PACMA",405
8,"8265",1548,1115,1108,8,7,"PACMA",9
8,"8164",911,651,644,2,7,"PACMA",5
8,"8100",1992,1496,1485,21,11,"PACMA",9
8,"8236",1525,1077,1067,3,10,"PACMA",6
8,"8040",10701,7420,7383,43,37,"PACMA",92
8,"8229",535,383,379,3,4,"PACMA",3
8,"8221",12391,9503,9456,49,47,"PACMA",89
8,"8098",2387,1668,1662,11,6,"PACMA",19
8,"8148",2238,1592,1580,7,12,"PACMA",23
8,"8239",451,324,324,5,0,"PACMA",2
8,"8129",456,322,320,3,2,"PACMA",1
8,"8207",1840,1418,1410,17,8,"PACMA",8
8,"8248",5402,3848,3815,27,33,"PACMA",57
8,"8043",3190,2216,2201,12,15,"PACMA",23
8,"8010",4196,2876,2852,16,24,"PACMA",20
8,"8153",536,432,431,6,1,"PACMA",6
8,"8226",879,683,680,3,3,"PACMA",3
8,"8101",174802,123863,123197,643,666,"PACMA",1465
8,"8244",5821,4484,4451,32,33,"PACMA",48
8,"8211",32990,25446,25282,173,164,"PACMA",313
8,"8201",436,299,298,1,1,"PACMA",0
8,"8214",6841,5018,4994,49,24,"PACMA",69
8,"8227",2329,1625,1607,13,18,"PACMA",20
8,"8019",1141245,824778,820790,5063,3988,"PACMA",8929
8,"8041",10314,7291,7238,46,53,"PACMA",96
8,"8223",1850,1279,1263,10,16,"PACMA",15
8,"8166",1000,680,674,4,6,"PACMA",3
8,"8246",1682,1157,1152,8,5,"PACMA",13
8,"8143",2686,1892,1881,19,11,"PACMA",8
8,"8283",5983,4032,4007,31,25,"PACMA",51
8,"8051",17873,13126,13048,66,78,"PACMA",152
8,"8016",1822,1229,1214,12,15,"PACMA",8
8,"8078",216,135,135,2,0,"PACMA",1
8,"8146",1297,958,954,16,4,"PACMA",10
8,"8165",1657,1181,1175,8,6,"PACMA",18
8,"8063",448,363,363,8,0,"PACMA",2
8,"8174",394,306,300,3,6,"PACMA",2
8,"8243",160,117,117,6,0,"PACMA",0
8,"8209",6773,4845,4822,31,23,"PACMA",62
8,"8195",82,64,64,0,0,"PACMA",0
8,"8150",258,189,185,0,4,"PACMA",4
8,"8190",258,179,177,2,2,"PACMA",0
8,"8233",1876,1247,1237,11,10,"PACMA",8
8,"8901",232,171,171,6,0,"PACMA",0
8,"8171",2099,1396,1389,20,7,"PACMA",0
8,"8145",2585,1927,1915,10,12,"PACMA",24
8,"8234",3187,2331,2322,11,9,"PACMA",30
8,"8116",582,421,418,4,3,"PACMA",3
8,"8169",47915,35543,35390,211,153,"PACMA",476
8,"8198",4391,3167,3138,17,29,"PACMA",44
8,"8114",18335,13196,13092,66,104,"PACMA",111
8,"8052",139,94,94,2,0,"PACMA",1
8,"8032",1973,1410,1403,6,7,"PACMA",18
8,"8147",17001,12422,12333,62,89,"PACMA",167
8,"8028",1031,724,721,6,3,"PACMA",9
8,"8155",6736,4779,4734,45,45,"PACMA",81
8,"8006",11427,7789,7727,46,62,"PACMA",92
8,"8902",3756,2758,2741,18,17,"PACMA",37
8,"8200",61275,45027,44785,276,242,"PACMA",601
8,"8280",101,67,67,3,0,"PACMA",0
8,"8189",126,95,94,2,1,"PACMA",0
8,"8135",6733,5230,5205,45,25,"PACMA",68
8,"8281",4841,3577,3553,18,24,"PACMA",57
8,"8167",5879,4463,4448,42,15,"PACMA",69
8,"8082",1150,788,783,6,5,"PACMA",13
8,"8271",69,47,46,0,1,"PACMA",0
8,"8220",2358,1783,1770,18,13,"PACMA",3
8,"8109",214,174,173,0,1,"PACMA",0
8,"8242",216,172,170,0,2,"PACMA",5
8,"8276",233,169,169,3,0,"PACMA",0
8,"8213",6296,4308,4294,47,14,"PACMA",51
8,"8180",26616,19621,19542,90,79,"PACMA",225
8,"8179",579,427,425,6,2,"PACMA",3
8,"8156",10923,8013,7964,50,49,"PACMA",111
8,"8275",254,202,202,4,0,"PACMA",0
8,"8023",6715,4669,4633,25,36,"PACMA",62
8,"8154",694,535,529,3,6,"PACMA",5
8,"8099",749,514,513,4,1,"PACMA",1
8,"8054",9013,6747,6702,38,45,"PACMA",85
8,"8274",4702,3349,3323,35,26,"PACMA",29
8,"8077",34550,26102,25983,152,119,"PACMA",303
8,"8087",159,131,130,2,1,"PACMA",0
8,"8279",152985,110533,110039,684,494,"PACMA",1475
8,"8021",69,52,51,3,1,"PACMA",0
8,"8254",1746,1261,1257,13,4,"PACMA",11
8,"8291",4524,3226,3206,24,20,"PACMA",44
8,"8204",3058,2282,2262,17,20,"PACMA",34
8,"8059",342,224,223,3,1,"PACMA",2
8,"8245",78581,55798,55530,345,268,"PACMA",759
8,"8110",13392,9211,9142,67,69,"PACMA",107
8,"8252",24521,18605,18514,110,91,"PACMA",257
8,"8208",5736,4318,4295,23,23,"PACMA",68
8,"8004",233,181,181,2,0,"PACMA",0
8,"8162",2028,1451,1442,8,9,"PACMA",19
8,"8175",3371,2243,2232,25,11,"PACMA",25
8,"8024",381,270,269,3,1,"PACMA",4
8,"8228",296,207,204,3,3,"PACMA",0
8,"8149",996,662,660,7,2,"PACMA",4
8,"8017",2756,1888,1876,7,12,"PACMA",22
8,"8277",162,132,132,0,0,"PACMA",1
8,"8293",226,162,162,0,0,"PACMA",0
8,"8157",8361,6311,6277,38,34,"PACMA",100
8,"8013",1219,873,867,10,6,"PACMA",8
8,"8241",76,59,59,0,0,"PACMA",0
8,"8230",7611,5590,5560,40,30,"PACMA",85
8,"8270",18399,12948,12869,83,79,"PACMA",166
8,"8255",140,90,90,1,0,"PACMA",2
8,"8092",3768,2621,2600,31,21,"PACMA",11
8,"8303",278,206,205,2,1,"PACMA",3
8,"8001",8825,6810,6760,24,50,"ERC-CATSÍ",576
8,"8191",5287,3732,3712,31,20,"ERC-CATSÍ",814
8,"8224",816,598,595,7,3,"ERC-CATSÍ",175
8,"8280",101,67,67,3,0,"ERC-CATSÍ",25
8,"8156",10923,8013,7964,50,49,"ERC-CATSÍ",1085
8,"8090",129,103,102,2,1,"ERC-CATSÍ",32
8,"8068",6729,4765,4739,23,26,"ERC-CATSÍ",800
8,"8192",5696,4093,4069,38,24,"ERC-CATSÍ",1127
8,"8012",1676,1175,1170,24,5,"ERC-CATSÍ",391
8,"8258",835,602,597,5,5,"ERC-CATSÍ",253
8,"8225",93,71,71,2,0,"ERC-CATSÍ",9
8,"8058",1742,1210,1194,7,16,"ERC-CATSÍ",171
8,"8124",36750,26968,26842,140,126,"ERC-CATSÍ",2581
8,"8069",3168,2333,2324,17,9,"ERC-CATSÍ",527
8,"8157",8361,6311,6277,38,34,"ERC-CATSÍ",799
8,"8292",1083,796,791,4,5,"ERC-CATSÍ",184
8,"8091",5253,3817,3795,23,22,"ERC-CATSÍ",751
8,"8102",28304,19929,19821,170,108,"ERC-CATSÍ",4243
8,"8025",1486,1087,1083,13,4,"ERC-CATSÍ",229
8,"8226",879,683,680,3,3,"ERC-CATSÍ",215
8,"8002",202,142,139,0,3,"ERC-CATSÍ",39
8,"8293",226,162,162,0,0,"ERC-CATSÍ",48
8,"8259",6623,4921,4885,33,36,"ERC-CATSÍ",1174
8,"8092",3768,2621,2600,31,21,"ERC-CATSÍ",766
8,"8193",942,637,633,9,4,"ERC-CATSÍ",156
8,"8158",3105,2166,2145,18,21,"ERC-CATSÍ",445
8,"8003",7118,5140,5108,28,32,"ERC-CATSÍ",1091
8,"8194",25539,16628,16553,77,75,"ERC-CATSÍ",1224
8,"8227",2329,1625,1607,13,18,"ERC-CATSÍ",358
8,"8014",1953,1438,1429,13,9,"ERC-CATSÍ",370
8,"8159",14049,10329,10284,51,45,"ERC-CATSÍ",1378
8,"8260",18306,13492,13423,60,69,"ERC-CATSÍ",1310
8,"8071",241,168,164,3,4,"ERC-CATSÍ",50
8,"8238",14478,11302,11252,85,50,"ERC-CATSÍ",2274
8,"8170",447,293,291,11,2,"ERC-CATSÍ",86
8,"8093",26,19,19,0,0,"ERC-CATSÍ",6
8,"8294",1971,1357,1349,8,8,"ERC-CATSÍ",351
8,"8027",690,527,524,3,3,"ERC-CATSÍ",130
8,"8126",8709,6454,6425,34,29,"ERC-CATSÍ",1027
8,"8015",155841,109156,108536,726,620,"ERC-CATSÍ",10696
8,"8004",233,181,181,2,0,"ERC-CATSÍ",58
8,"8127",2224,1439,1429,8,10,"ERC-CATSÍ",303
8,"8072",10240,6957,6935,40,22,"ERC-CATSÍ",1281
8,"8195",82,64,64,0,0,"ERC-CATSÍ",16
8,"8295",10850,7651,7617,33,34,"ERC-CATSÍ",905
8,"8228",296,207,204,3,3,"ERC-CATSÍ",43
8,"8262",6855,4522,4491,46,31,"ERC-CATSÍ",951
8,"8016",1822,1229,1214,12,15,"ERC-CATSÍ",305
8,"8005",6165,4458,4434,23,24,"ERC-CATSÍ",951
8,"8116",582,421,418,4,3,"ERC-CATSÍ",119
8,"8161",11145,7658,7621,45,37,"ERC-CATSÍ",1097
8,"8196",19247,14101,14047,75,54,"ERC-CATSÍ",1009
8,"8150",258,189,185,0,4,"ERC-CATSÍ",51
8,"8296",1787,1358,1351,9,7,"ERC-CATSÍ",271
8,"8229",535,383,379,3,4,"ERC-CATSÍ",123
8,"8207",1840,1418,1410,17,8,"ERC-CATSÍ",521
8,"8095",71,50,50,0,0,"ERC-CATSÍ",11
8,"8128",564,378,377,1,1,"ERC-CATSÍ",107
8,"8285",10260,6893,6843,56,50,"ERC-CATSÍ",1819
8,"8006",11427,7789,7727,46,62,"ERC-CATSÍ",1768
8,"8208",5736,4318,4295,23,23,"ERC-CATSÍ",641
8,"8017",2756,1888,1876,7,12,"ERC-CATSÍ",489
8,"8029",3438,2645,2632,25,13,"ERC-CATSÍ",552
8,"8129",456,322,320,3,2,"ERC-CATSÍ",101
8,"8197",7605,5331,5317,31,14,"ERC-CATSÍ",966
8,"8096",42411,30717,30550,204,167,"ERC-CATSÍ",4450
8,"8263",20974,15086,15001,93,85,"ERC-CATSÍ",2038
8,"8118",17516,12878,12820,79,58,"ERC-CATSÍ",2652
8,"8231",20495,13961,13885,91,76,"ERC-CATSÍ",1913
8,"8018",2654,1834,1819,16,15,"ERC-CATSÍ",395
8,"8198",4391,3167,3138,17,29,"ERC-CATSÍ",803
8,"8308",131,99,97,0,2,"ERC-CATSÍ",14
8,"8007",6505,4532,4495,28,37,"ERC-CATSÍ",1334
8,"8297",138,100,99,1,1,"ERC-CATSÍ",18
8,"8264",4288,3045,3030,30,15,"ERC-CATSÍ",578
8,"8064",1853,1323,1315,9,8,"ERC-CATSÍ",392
8,"8253",133,85,85,1,0,"ERC-CATSÍ",17
8,"8209",6773,4845,4822,31,23,"ERC-CATSÍ",677
8,"8220",2358,1783,1770,18,13,"ERC-CATSÍ",617
8,"8163",18590,12816,12750,72,66,"ERC-CATSÍ",1804
8,"8210",4296,2825,2806,22,19,"ERC-CATSÍ",679
8,"8130",96,66,66,0,0,"ERC-CATSÍ",20
8,"8298",26426,17862,17784,113,78,"ERC-CATSÍ",4911
8,"8097",1027,736,731,7,5,"ERC-CATSÍ",216
8,"8142",132,105,104,1,1,"ERC-CATSÍ",23
8,"8131",699,520,516,4,4,"ERC-CATSÍ",154
8,"8031",2308,1648,1637,10,11,"ERC-CATSÍ",381
8,"8008",187,118,118,1,0,"ERC-CATSÍ",58
8,"8065",1179,837,831,8,6,"ERC-CATSÍ",217
8,"8199",665,466,464,6,2,"ERC-CATSÍ",105
8,"8164",911,651,644,2,7,"ERC-CATSÍ",186
8,"8203",2422,1602,1591,11,11,"ERC-CATSÍ",353
8,"8043",3190,2216,2201,12,15,"ERC-CATSÍ",251
8,"8109",214,174,173,0,1,"ERC-CATSÍ",80
8,"8299",395,256,255,3,1,"ERC-CATSÍ",83
8,"8098",2387,1668,1662,11,6,"ERC-CATSÍ",302
8,"8099",749,514,513,4,1,"ERC-CATSÍ",145
8,"8300",5682,4328,4312,21,16,"ERC-CATSÍ",682
8,"8009",9136,6613,6578,40,35,"ERC-CATSÍ",1394
8,"8010",4196,2876,2852,16,24,"ERC-CATSÍ",817
8,"8233",1876,1247,1237,11,10,"ERC-CATSÍ",460
8,"8200",61275,45027,44785,276,242,"ERC-CATSÍ",3641
8,"8165",1657,1181,1175,8,6,"ERC-CATSÍ",207
8,"8267",6435,4571,4542,24,29,"ERC-CATSÍ",735
8,"8132",379,259,256,3,3,"ERC-CATSÍ",61
8,"8110",13392,9211,9142,67,69,"ERC-CATSÍ",1409
8,"8166",1000,680,674,4,6,"ERC-CATSÍ",174
8,"8133",128,76,75,0,1,"ERC-CATSÍ",11
8,"8201",436,299,298,1,1,"ERC-CATSÍ",97
8,"8301",48496,35956,35788,200,168,"ERC-CATSÍ",2259
8,"8034",766,542,538,3,4,"ERC-CATSÍ",204
8,"8081",345,255,255,1,0,"ERC-CATSÍ",74
8,"8235",3683,2612,2595,22,17,"ERC-CATSÍ",733
8,"8202",12615,8911,8831,70,80,"ERC-CATSÍ",1790
8,"8122",1683,1117,1106,10,11,"ERC-CATSÍ",307
8,"8011",1760,1230,1217,10,13,"ERC-CATSÍ",465
8,"8067",5723,3896,3874,39,22,"ERC-CATSÍ",1048
8,"8904",10563,7474,7437,32,37,"ERC-CATSÍ",258
8,"8045",72,42,39,0,3,"ERC-CATSÍ",15
8,"8134",803,560,554,5,6,"ERC-CATSÍ",147
8,"8145",2585,1927,1915,10,12,"ERC-CATSÍ",388
8,"8101",174802,123863,123197,643,666,"ERC-CATSÍ",9000
8,"8167",5879,4463,4448,42,15,"ERC-CATSÍ",338
8,"8035",12448,8482,8443,54,39,"ERC-CATSÍ",1763
8,"8302",9209,6571,6524,65,47,"ERC-CATSÍ",548
8,"8247",958,716,714,7,2,"ERC-CATSÍ",236
8,"8905",2305,1789,1774,17,15,"ERC-CATSÍ",360
8,"8057",59,42,41,2,1,"ERC-CATSÍ",12
8,"8135",6733,5230,5205,45,25,"ERC-CATSÍ",472
8,"8284",12067,7855,7792,66,63,"ERC-CATSÍ",1193
8,"8106",7216,5220,5176,38,44,"ERC-CATSÍ",1055
8,"8021",69,52,51,3,1,"ERC-CATSÍ",10
8,"8146",1297,958,954,16,4,"ERC-CATSÍ",149
8,"8113",52051,34906,34729,229,177,"ERC-CATSÍ",7579
8,"8303",278,206,205,2,1,"ERC-CATSÍ",65
8,"8139",171,133,132,0,1,"ERC-CATSÍ",42
8,"8047",3978,2640,2614,21,26,"ERC-CATSÍ",564
8,"8270",18399,12948,12869,83,79,"ERC-CATSÍ",2038
8,"8036",159,113,112,1,1,"ERC-CATSÍ",33
8,"8070",267,196,193,2,3,"ERC-CATSÍ",63
8,"8013",1219,873,867,10,6,"ERC-CATSÍ",185
8,"8136",11416,8425,8388,63,37,"ERC-CATSÍ",544
8,"8237",1642,1165,1160,4,5,"ERC-CATSÍ",330
8,"8304",814,578,573,1,5,"ERC-CATSÍ",173
8,"8103",631,431,431,3,0,"ERC-CATSÍ",142
8,"8205",59169,45410,45231,357,179,"ERC-CATSÍ",8329
8,"8147",17001,12422,12333,62,89,"ERC-CATSÍ",1979
8,"8041",10314,7291,7238,46,53,"ERC-CATSÍ",490
8,"8242",216,172,170,0,2,"ERC-CATSÍ",37
8,"8271",69,47,46,0,1,"ERC-CATSÍ",18
8,"8282",6517,5027,5017,40,10,"ERC-CATSÍ",1107
8,"8249",266,223,220,2,3,"ERC-CATSÍ",68
8,"8275",254,202,202,4,0,"ERC-CATSÍ",66
8,"8137",265,206,205,1,1,"ERC-CATSÍ",53
8,"8038",1488,987,981,10,6,"ERC-CATSÍ",264
8,"8239",451,324,324,5,0,"ERC-CATSÍ",70
8,"8305",27328,19226,19083,116,143,"ERC-CATSÍ",4153
8,"8250",7046,4908,4878,33,30,"ERC-CATSÍ",437
8,"8104",682,445,443,4,2,"ERC-CATSÍ",165
8,"8206",731,568,559,9,9,"ERC-CATSÍ",156
8,"8283",5983,4032,4007,31,25,"ERC-CATSÍ",1088
8,"8272",157,98,97,0,1,"ERC-CATSÍ",30
8,"8105",9613,7103,7047,46,56,"ERC-CATSÍ",345
8,"8050",141,107,104,0,3,"ERC-CATSÍ",31
8,"8306",517,360,354,2,6,"ERC-CATSÍ",62
8,"8083",1674,1287,1275,8,12,"ERC-CATSÍ",506
8,"8039",354,259,259,0,0,"ERC-CATSÍ",72
8,"8028",1031,724,721,6,3,"ERC-CATSÍ",82
8,"8176",158,113,113,1,0,"ERC-CATSÍ",35
8,"8214",6841,5018,4994,49,24,"ERC-CATSÍ",1162
8,"8168",375,235,234,0,1,"ERC-CATSÍ",47
8,"8073",61659,45611,45356,239,255,"ERC-CATSÍ",3161
8,"8307",48233,34249,34071,209,178,"ERC-CATSÍ",5418
8,"8084",1135,795,790,6,5,"ERC-CATSÍ",204
8,"8902",3756,2758,2741,18,17,"ERC-CATSÍ",443
8,"8241",76,59,59,0,0,"ERC-CATSÍ",15
8,"8240",9354,6996,6953,34,43,"ERC-CATSÍ",1668
8,"8117",2453,1741,1727,23,14,"ERC-CATSÍ",446
8,"8033",12803,9236,9179,79,57,"ERC-CATSÍ",2013
8,"8174",394,306,300,3,6,"ERC-CATSÍ",101
8,"8212",495,350,347,3,3,"ERC-CATSÍ",97
8,"8140",4769,3344,3335,25,9,"ERC-CATSÍ",637
8,"8219",15355,11458,11403,86,55,"ERC-CATSÍ",2395
8,"8107",11472,8147,8097,45,50,"ERC-CATSÍ",992
8,"8074",10587,7309,7274,51,35,"ERC-CATSÍ",919
8,"8190",258,179,177,2,2,"ERC-CATSÍ",62
8,"8151",463,336,333,11,3,"ERC-CATSÍ",89
8,"8144",715,493,489,9,4,"ERC-CATSÍ",142
8,"8286",2904,2009,1997,17,12,"ERC-CATSÍ",241
8,"8089",33935,24504,24392,150,112,"ERC-CATSÍ",2157
8,"8141",4590,3173,3150,39,23,"ERC-CATSÍ",889
8,"8268",1011,702,699,2,3,"ERC-CATSÍ",180
8,"8019",1141245,824778,820790,5063,3988,"ERC-CATSÍ",124715
8,"8052",139,94,94,2,0,"ERC-CATSÍ",20
8,"8119",6182,4517,4492,35,25,"ERC-CATSÍ",565
8,"8042",2233,1668,1653,8,15,"ERC-CATSÍ",271
8,"8053",2805,1789,1775,10,14,"ERC-CATSÍ",303
8,"8152",114,84,82,1,2,"ERC-CATSÍ",36
8,"8108",5014,3757,3740,21,17,"ERC-CATSÍ",461
8,"8901",232,171,171,6,0,"ERC-CATSÍ",56
8,"8287",1044,806,792,7,14,"ERC-CATSÍ",224
8,"8276",233,169,169,3,0,"ERC-CATSÍ",50
8,"8221",12391,9503,9456,49,47,"ERC-CATSÍ",1685
8,"8254",1746,1261,1257,13,4,"ERC-CATSÍ",521
8,"8032",1973,1410,1403,6,7,"ERC-CATSÍ",297
8,"8232",1797,1276,1266,14,10,"ERC-CATSÍ",352
8,"8236",1525,1077,1067,3,10,"ERC-CATSÍ",370
8,"8251",4970,3505,3480,14,25,"ERC-CATSÍ",512
8,"8061",1485,1045,1040,5,5,"ERC-CATSÍ",142
8,"8120",6815,5071,5045,34,26,"ERC-CATSÍ",963
8,"8277",162,132,132,0,0,"ERC-CATSÍ",34
8,"8143",2686,1892,1881,19,11,"ERC-CATSÍ",307
8,"8180",26616,19621,19542,90,79,"ERC-CATSÍ",1372
8,"8903",213,167,167,0,0,"ERC-CATSÍ",61
8,"8211",32990,25446,25282,173,164,"ERC-CATSÍ",2794
8,"8281",4841,3577,3553,18,24,"ERC-CATSÍ",873
8,"8177",40,25,25,1,0,"ERC-CATSÍ",10
8,"8044",4150,2957,2932,19,25,"ERC-CATSÍ",614
8,"8245",78581,55798,55530,345,268,"ERC-CATSÍ",2809
8,"8121",86293,61426,61070,450,356,"ERC-CATSÍ",8512
8,"8077",34550,26102,25983,152,119,"ERC-CATSÍ",2253
8,"8048",583,426,424,5,2,"ERC-CATSÍ",129
8,"8204",3058,2282,2262,17,20,"ERC-CATSÍ",365
8,"8234",3187,2331,2322,11,9,"ERC-CATSÍ",577
8,"8185",194,132,132,0,0,"ERC-CATSÍ",24
8,"8037",1856,1364,1351,20,13,"ERC-CATSÍ",434
8,"8179",579,427,425,6,2,"ERC-CATSÍ",110
8,"8111",216,185,185,0,0,"ERC-CATSÍ",45
8,"8063",448,363,363,8,0,"ERC-CATSÍ",124
8,"8290",1490,1163,1155,5,8,"ERC-CATSÍ",375
8,"8115",3817,2835,2814,18,21,"ERC-CATSÍ",340
8,"8023",6715,4669,4633,25,36,"ERC-CATSÍ",892
8,"8078",216,135,135,2,0,"ERC-CATSÍ",43
8,"8123",19114,14573,14509,81,64,"ERC-CATSÍ",2912
8,"8257",110,87,87,0,0,"ERC-CATSÍ",16
8,"8187",152527,112013,111491,638,522,"ERC-CATSÍ",15539
8,"8079",339,254,248,2,6,"ERC-CATSÍ",94
8,"8246",1682,1157,1152,8,5,"ERC-CATSÍ",377
8,"8291",4524,3226,3206,24,20,"ERC-CATSÍ",577
8,"8288",1632,1061,1053,4,8,"ERC-CATSÍ",164
8,"8046",13243,9747,9693,74,54,"ERC-CATSÍ",2268
8,"8269",2646,1871,1860,17,11,"ERC-CATSÍ",584
8,"8138",4229,2832,2816,19,16,"ERC-CATSÍ",889
8,"8218",8045,5643,5613,54,30,"ERC-CATSÍ",907
8,"8273",2309,1706,1689,12,17,"ERC-CATSÍ",522
8,"8188",117,81,81,2,0,"ERC-CATSÍ",29
8,"8026",187,155,155,1,0,"ERC-CATSÍ",41
8,"8162",2028,1451,1442,8,9,"ERC-CATSÍ",297
8,"8184",53690,37794,37636,200,158,"ERC-CATSÍ",3895
8,"8076",16173,11553,11473,73,80,"ERC-CATSÍ",1639
8,"8062",951,676,674,5,2,"ERC-CATSÍ",192
8,"8085",985,712,704,1,8,"ERC-CATSÍ",201
8,"8080",38,28,27,0,1,"ERC-CATSÍ",7
8,"8255",140,90,90,1,0,"ERC-CATSÍ",30
8,"8215",2576,1766,1751,30,15,"ERC-CATSÍ",492
8,"8055",512,366,364,2,2,"ERC-CATSÍ",125
8,"8114",18335,13196,13092,66,104,"ERC-CATSÍ",1581
8,"8181",7896,5774,5724,41,50,"ERC-CATSÍ",1086
8,"8182",2803,2039,2034,16,5,"ERC-CATSÍ",233
8,"8217",24985,19385,19317,130,68,"ERC-CATSÍ",1859
8,"8230",7611,5590,5560,40,30,"ERC-CATSÍ",895
8,"8155",6736,4779,4734,45,45,"ERC-CATSÍ",687
8,"8252",24521,18605,18514,110,91,"ERC-CATSÍ",1414
8,"8160",330,217,217,0,0,"ERC-CATSÍ",75
8,"8020",4876,3702,3678,25,24,"ERC-CATSÍ",764
8,"8056",41996,30076,29974,178,102,"ERC-CATSÍ",2688
8,"8030",5095,3727,3712,27,15,"ERC-CATSÍ",745
8,"8213",6296,4308,4294,47,14,"ERC-CATSÍ",858
8,"8216",25,17,17,0,0,"ERC-CATSÍ",6
8,"8171",2099,1396,1389,20,7,"ERC-CATSÍ",503
8,"8274",4702,3349,3323,35,26,"ERC-CATSÍ",552
8,"8279",152985,110533,110039,684,494,"ERC-CATSÍ",14225
8,"8112",12909,8671,8616,50,55,"ERC-CATSÍ",2076
8,"8049",1288,860,841,9,19,"ERC-CATSÍ",290
8,"8222",1878,1452,1443,16,9,"ERC-CATSÍ",395
8,"8054",9013,6747,6702,38,45,"ERC-CATSÍ",1004
8,"8040",10701,7420,7383,43,37,"ERC-CATSÍ",1680
8,"8244",5821,4484,4451,32,33,"ERC-CATSÍ",706
8,"8149",996,662,660,7,2,"ERC-CATSÍ",242
8,"8183",4524,3125,3103,21,22,"ERC-CATSÍ",916
8,"8178",430,317,315,4,2,"ERC-CATSÍ",75
8,"8223",1850,1279,1263,10,16,"ERC-CATSÍ",397
8,"8088",11840,8684,8627,55,57,"ERC-CATSÍ",2086
8,"8086",13550,9448,9395,66,53,"ERC-CATSÍ",1272
8,"8087",159,131,130,2,1,"ERC-CATSÍ",30
8,"8256",644,516,512,1,4,"ERC-CATSÍ",108
8,"8051",17873,13126,13048,66,78,"ERC-CATSÍ",2373
8,"8175",3371,2243,2232,25,11,"ERC-CATSÍ",692
8,"8125",25024,18070,17966,99,104,"ERC-CATSÍ",1754
8,"8153",536,432,431,6,1,"ERC-CATSÍ",145
8,"8243",160,117,117,6,0,"ERC-CATSÍ",31
8,"8169",47915,35543,35390,211,153,"ERC-CATSÍ",2499
8,"8189",126,95,94,2,1,"ERC-CATSÍ",24
8,"8060",143,100,99,0,1,"ERC-CATSÍ",18
8,"8289",4304,3166,3151,19,15,"ERC-CATSÍ",774
8,"8266",43128,32806,32660,195,146,"ERC-CATSÍ",3596
8,"8075",3875,2709,2695,12,14,"ERC-CATSÍ",484
8,"8265",1548,1115,1108,8,7,"ERC-CATSÍ",416
8,"8172",20384,14738,14684,85,54,"ERC-CATSÍ",2475
8,"8154",694,535,529,3,6,"ERC-CATSÍ",96
8,"8278",4764,3372,3358,16,14,"ERC-CATSÍ",991
8,"8248",5402,3848,3815,27,33,"ERC-CATSÍ",737
8,"8022",12230,7792,7717,60,75,"ERC-CATSÍ",2269
8,"8024",381,270,269,3,1,"ERC-CATSÍ",74
8,"8059",342,224,223,3,1,"ERC-CATSÍ",67
8,"8094",1548,1143,1133,12,10,"ERC-CATSÍ",277
8,"8082",1150,788,783,6,5,"ERC-CATSÍ",93
8,"8148",2238,1592,1580,7,12,"ERC-CATSÍ",188
8,"8066",1364,1029,1025,10,4,"ERC-CATSÍ",194
8,"8261",2319,1638,1632,4,6,"ERC-CATSÍ",284
8,"8100",1992,1496,1485,21,11,"ERC-CATSÍ",438
8,"8248",5402,3848,3815,27,33,"PP",337
8,"8193",942,637,633,9,4,"PP",69
8,"8058",1742,1210,1194,7,16,"PP",109
8,"8121",86293,61426,61070,450,356,"PP",7271
8,"8270",18399,12948,12869,83,79,"PP",1643
8,"8037",1856,1364,1351,20,13,"PP",63
8,"8006",11427,7789,7727,46,62,"PP",792
8,"8208",5736,4318,4295,23,23,"PP",421
8,"8254",1746,1261,1257,13,4,"PP",33
8,"8106",7216,5220,5176,38,44,"PP",521
8,"8263",20974,15086,15001,93,85,"PP",1676
8,"8211",32990,25446,25282,173,164,"PP",2929
8,"8040",10701,7420,7383,43,37,"PP",753
8,"8113",52051,34906,34729,229,177,"PP",3042
8,"8041",10314,7291,7238,46,53,"PP",979
8,"8061",1485,1045,1040,5,5,"PP",109
8,"8136",11416,8425,8388,63,37,"PP",1112
8,"8201",436,299,298,1,1,"PP",25
8,"8206",731,568,559,9,9,"PP",28
8,"8139",171,133,132,0,1,"PP",1
8,"8025",1486,1087,1083,13,4,"PP",104
8,"8098",2387,1668,1662,11,6,"PP",168
8,"8026",187,155,155,1,0,"PP",7
8,"8198",4391,3167,3138,17,29,"PP",231
8,"8084",1135,795,790,6,5,"PP",65
8,"8227",2329,1625,1607,13,18,"PP",98
8,"8215",2576,1766,1751,30,15,"PP",107
8,"8004",233,181,181,2,0,"PP",0
8,"8190",258,179,177,2,2,"PP",14
8,"8298",26426,17862,17784,113,78,"PP",1173
8,"8042",2233,1668,1653,8,15,"PP",217
8,"8043",3190,2216,2201,12,15,"PP",242
8,"8307",48233,34249,34071,209,178,"PP",3027
8,"8150",258,189,185,0,4,"PP",7
8,"8064",1853,1323,1315,9,8,"PP",63
8,"8057",59,42,41,2,1,"PP",0
8,"8047",3978,2640,2614,21,26,"PP",271
8,"8091",5253,3817,3795,23,22,"PP",299
8,"8274",4702,3349,3323,35,26,"PP",234
8,"8292",1083,796,791,4,5,"PP",68
8,"8185",194,132,132,0,0,"PP",16
8,"8097",1027,736,731,7,5,"PP",26
8,"8234",3187,2331,2322,11,9,"PP",203
8,"8187",152527,112013,111491,638,522,"PP",10642
8,"8108",5014,3757,3740,21,17,"PP",553
8,"8294",1971,1357,1349,8,8,"PP",87
8,"8117",2453,1741,1727,23,14,"PP",115
8,"8036",159,113,112,1,1,"PP",4
8,"8260",18306,13492,13423,60,69,"PP",1476
8,"8115",3817,2835,2814,18,21,"PP",288
8,"8122",1683,1117,1106,10,11,"PP",98
8,"8051",17873,13126,13048,66,78,"PP",1053
8,"8082",1150,788,783,6,5,"PP",98
8,"8090",129,103,102,2,1,"PP",3
8,"8011",1760,1230,1217,10,13,"PP",62
8,"8124",36750,26968,26842,140,126,"PP",2609
8,"8229",535,383,379,3,4,"PP",23
8,"8032",1973,1410,1403,6,7,"PP",121
8,"8249",266,223,220,2,3,"PP",10
8,"8116",582,421,418,4,3,"PP",18
8,"8239",451,324,324,5,0,"PP",26
8,"8171",2099,1396,1389,20,7,"PP",76
8,"8243",160,117,117,6,0,"PP",6
8,"8160",330,217,217,0,0,"PP",8
8,"8284",12067,7855,7792,66,63,"PP",750
8,"8017",2756,1888,1876,7,12,"PP",120
8,"8024",381,270,269,3,1,"PP",14
8,"8134",803,560,554,5,6,"PP",39
8,"8268",1011,702,699,2,3,"PP",58
8,"8175",3371,2243,2232,25,11,"PP",158
8,"8237",1642,1165,1160,4,5,"PP",63
8,"8038",1488,987,981,10,6,"PP",53
8,"8062",951,676,674,5,2,"PP",64
8,"8277",162,132,132,0,0,"PP",10
8,"8095",71,50,50,0,0,"PP",3
8,"8285",10260,6893,6843,56,50,"PP",335
8,"8055",512,366,364,2,2,"PP",17
8,"8154",694,535,529,3,6,"PP",46
8,"8177",40,25,25,1,0,"PP",2
8,"8147",17001,12422,12333,62,89,"PP",1048
8,"8016",1822,1229,1214,12,15,"PP",77
8,"8054",9013,6747,6702,38,45,"PP",651
8,"8018",2654,1834,1819,16,15,"PP",108
8,"8021",69,52,51,3,1,"PP",3
8,"8174",394,306,300,3,6,"PP",17
8,"8063",448,363,363,8,0,"PP",11
8,"8158",3105,2166,2145,18,21,"PP",151
8,"8231",20495,13961,13885,91,76,"PP",1375
8,"8275",254,202,202,4,0,"PP",6
8,"8059",342,224,223,3,1,"PP",11
8,"8027",690,527,524,3,3,"PP",30
8,"8276",233,169,169,3,0,"PP",7
8,"8182",2803,2039,2034,16,5,"PP",194
8,"8015",155841,109156,108536,726,620,"PP",15981
8,"8049",1288,860,841,9,19,"PP",64
8,"8218",8045,5643,5613,54,30,"PP",416
8,"8230",7611,5590,5560,40,30,"PP",685
8,"8031",2308,1648,1637,10,11,"PP",154
8,"8179",579,427,425,6,2,"PP",24
8,"8020",4876,3702,3678,25,24,"PP",277
8,"8142",132,105,104,1,1,"PP",0
8,"8269",2646,1871,1860,17,11,"PP",101
8,"8176",158,113,113,1,0,"PP",22
8,"8083",1674,1287,1275,8,12,"PP",30
8,"8028",1031,724,721,6,3,"PP",93
8,"8196",19247,14101,14047,75,54,"PP",1557
8,"8180",26616,19621,19542,90,79,"PP",2248
8,"8299",395,256,255,3,1,"PP",14
8,"8056",41996,30076,29974,178,102,"PP",4614
8,"8112",12909,8671,8616,50,55,"PP",637
8,"8280",101,67,67,3,0,"PP",4
8,"8157",8361,6311,6277,38,34,"PP",619
8,"8080",38,28,27,0,1,"PP",2
8,"8102",28304,19929,19821,170,108,"PP",1857
8,"8088",11840,8684,8627,55,57,"PP",618
8,"8143",2686,1892,1881,19,11,"PP",198
8,"8069",3168,2333,2324,17,9,"PP",231
8,"8013",1219,873,867,10,6,"PP",61
8,"8296",1787,1358,1351,9,7,"PP",138
8,"8033",12803,9236,9179,79,57,"PP",829
8,"8192",5696,4093,4069,38,24,"PP",241
8,"8164",911,651,644,2,7,"PP",33
8,"8118",17516,12878,12820,79,58,"PP",1201
8,"8282",6517,5027,5017,40,10,"PP",439
8,"8148",2238,1592,1580,7,12,"PP",199
8,"8085",985,712,704,1,8,"PP",48
8,"8067",5723,3896,3874,39,22,"PP",273
8,"8194",25539,16628,16553,77,75,"PP",2329
8,"8074",10587,7309,7274,51,35,"PP",892
8,"8271",69,47,46,0,1,"PP",1
8,"8224",816,598,595,7,3,"PP",37
8,"8060",143,100,99,0,1,"PP",13
8,"8034",766,542,538,3,4,"PP",35
8,"8144",715,493,489,9,4,"PP",44
8,"8305",27328,19226,19083,116,143,"PP",1551
8,"8283",5983,4032,4007,31,25,"PP",257
8,"8195",82,64,64,0,0,"PP",3
8,"8228",296,207,204,3,3,"PP",16
8,"8257",110,87,87,0,0,"PP",3
8,"8250",7046,4908,4878,33,30,"PP",621
8,"8149",996,662,660,7,2,"PP",36
8,"8302",9209,6571,6524,65,47,"PP",741
8,"8035",12448,8482,8443,54,39,"PP",864
8,"8094",1548,1143,1133,12,10,"PP",82
8,"8221",12391,9503,9456,49,47,"PP",1064
8,"8135",6733,5230,5205,45,25,"PP",631
8,"8207",1840,1418,1410,17,8,"PP",46
8,"8306",517,360,354,2,6,"PP",32
8,"8161",11145,7658,7621,45,37,"PP",836
8,"8039",354,259,259,0,0,"PP",14
8,"8273",2309,1706,1689,12,17,"PP",102
8,"8073",61659,45611,45356,239,255,"PP",5614
8,"8109",214,174,173,0,1,"PP",10
8,"8128",564,378,377,1,1,"PP",20
8,"8244",5821,4484,4451,32,33,"PP",374
8,"8009",9136,6613,6578,40,35,"PP",679
8,"8252",24521,18605,18514,110,91,"PP",2159
8,"8022",12230,7792,7717,60,75,"PP",529
8,"8256",644,516,512,1,4,"PP",44
8,"8044",4150,2957,2932,19,25,"PP",289
8,"8133",128,76,75,0,1,"PP",10
8,"8019",1141245,824778,820790,5063,3988,"PP",104324
8,"8264",4288,3045,3030,30,15,"PP",330
8,"8092",3768,2621,2600,31,21,"PP",192
8,"8014",1953,1438,1429,13,9,"PP",99
8,"8100",1992,1496,1485,21,11,"PP",73
8,"8111",216,185,185,0,0,"PP",11
8,"8052",139,94,94,2,0,"PP",5
8,"8216",25,17,17,0,0,"PP",0
8,"8096",42411,30717,30550,204,167,"PP",3188
8,"8272",157,98,97,0,1,"PP",1
8,"8104",682,445,443,4,2,"PP",31
8,"8163",18590,12816,12750,72,66,"PP",1717
8,"8152",114,84,82,1,2,"PP",3
8,"8308",131,99,97,0,2,"PP",3
8,"8086",13550,9448,9395,66,53,"PP",928
8,"8261",2319,1638,1632,4,6,"PP",204
8,"8232",1797,1276,1266,14,10,"PP",73
8,"8287",1044,806,792,7,14,"PP",41
8,"8199",665,466,464,6,2,"PP",49
8,"8008",187,118,118,1,0,"PP",7
8,"8168",375,235,234,0,1,"PP",61
8,"8046",13243,9747,9693,74,54,"PP",790
8,"8005",6165,4458,4434,23,24,"PP",419
8,"8210",4296,2825,2806,22,19,"PP",167
8,"8050",141,107,104,0,3,"PP",4
8,"8146",1297,958,954,16,4,"PP",99
8,"8266",43128,32806,32660,195,146,"PP",3709
8,"8165",1657,1181,1175,8,6,"PP",76
8,"8120",6815,5071,5045,34,26,"PP",509
8,"8103",631,431,431,3,0,"PP",40
8,"8902",3756,2758,2741,18,17,"PP",269
8,"8087",159,131,130,2,1,"PP",7
8,"8255",140,90,90,1,0,"PP",0
8,"8267",6435,4571,4542,24,29,"PP",323
8,"8181",7896,5774,5724,41,50,"PP",568
8,"8281",4841,3577,3553,18,24,"PP",301
8,"8223",1850,1279,1263,10,16,"PP",81
8,"8099",749,514,513,4,1,"PP",25
8,"8166",1000,680,674,4,6,"PP",50
8,"8114",18335,13196,13092,66,104,"PP",1333
8,"8159",14049,10329,10284,51,45,"PP",984
8,"8286",2904,2009,1997,17,12,"PP",225
8,"8068",6729,4765,4739,23,26,"PP",516
8,"8003",7118,5140,5108,28,32,"PP",578
8,"8903",213,167,167,0,0,"PP",4
8,"8205",59169,45410,45231,357,179,"PP",4957
8,"8304",814,578,573,1,5,"PP",20
8,"8301",48496,35956,35788,200,168,"PP",4174
8,"8045",72,42,39,0,3,"PP",0
8,"8904",10563,7474,7437,32,37,"PP",960
8,"8079",339,254,248,2,6,"PP",10
8,"8279",152985,110533,110039,684,494,"PP",11014
8,"8202",12615,8911,8831,70,80,"PP",732
8,"8235",3683,2612,2595,22,17,"PP",175
8,"8184",53690,37794,37636,200,158,"PP",4182
8,"8191",5287,3732,3712,31,20,"PP",274
8,"8071",241,168,164,3,4,"PP",9
8,"8156",10923,8013,7964,50,49,"PP",820
8,"8183",4524,3125,3103,21,22,"PP",138
8,"8138",4229,2832,2816,19,16,"PP",179
8,"8265",1548,1115,1108,8,7,"PP",48
8,"8247",958,716,714,7,2,"PP",24
8,"8001",8825,6810,6760,24,50,"PP",790
8,"8288",1632,1061,1053,4,8,"PP",111
8,"8251",4970,3505,3480,14,25,"PP",296
8,"8291",4524,3226,3206,24,20,"PP",267
8,"8214",6841,5018,4994,49,24,"PP",449
8,"8155",6736,4779,4734,45,45,"PP",390
8,"8048",583,426,424,5,2,"PP",28
8,"8178",430,317,315,4,2,"PP",28
8,"8169",47915,35543,35390,211,153,"PP",3916
8,"8010",4196,2876,2852,16,24,"PP",182
8,"8189",126,95,94,2,1,"PP",3
8,"8253",133,85,85,1,0,"PP",0
8,"8162",2028,1451,1442,8,9,"PP",132
8,"8226",879,683,680,3,3,"PP",44
8,"8070",267,196,193,2,3,"PP",13
8,"8204",3058,2282,2262,17,20,"PP",118
8,"8151",463,336,333,11,3,"PP",26
8,"8129",456,322,320,3,2,"PP",11
8,"8137",265,206,205,1,1,"PP",10
8,"8217",24985,19385,19317,130,68,"PP",2023
8,"8213",6296,4308,4294,47,14,"PP",303
8,"8188",117,81,81,2,0,"PP",4
8,"8105",9613,7103,7047,46,56,"PP",868
8,"8030",5095,3727,3712,27,15,"PP",351
8,"8131",699,520,516,4,4,"PP",22
8,"8107",11472,8147,8097,45,50,"PP",1014
8,"8119",6182,4517,4492,35,25,"PP",464
8,"8141",4590,3173,3150,39,23,"PP",226
8,"8093",26,19,19,0,0,"PP",0
8,"8170",447,293,291,11,2,"PP",13
8,"8089",33935,24504,24392,150,112,"PP",2907
8,"8262",6855,4522,4491,46,31,"PP",392
8,"8222",1878,1452,1443,16,9,"PP",89
8,"8066",1364,1029,1025,10,4,"PP",118
8,"8081",345,255,255,1,0,"PP",8
8,"8293",226,162,162,0,0,"PP",6
8,"8905",2305,1789,1774,17,15,"PP",128
8,"8233",1876,1247,1237,11,10,"PP",42
8,"8225",93,71,71,2,0,"PP",4
8,"8065",1179,837,831,8,6,"PP",70
8,"8110",13392,9211,9142,67,69,"PP",896
8,"8258",835,602,597,5,5,"PP",19
8,"8127",2224,1439,1429,8,10,"PP",135
8,"8172",20384,14738,14684,85,54,"PP",1477
8,"8167",5879,4463,4448,42,15,"PP",410
8,"8125",25024,18070,17966,99,104,"PP",1815
8,"8123",19114,14573,14509,81,64,"PP",1046
8,"8290",1490,1163,1155,5,8,"PP",62
8,"8200",61275,45027,44785,276,242,"PP",4807
8,"8132",379,259,256,3,3,"PP",14
8,"8241",76,59,59,0,0,"PP",5
8,"8219",15355,11458,11403,86,55,"PP",999
8,"8212",495,350,347,3,3,"PP",24
8,"8242",216,172,170,0,2,"PP",7
8,"8203",2422,1602,1591,11,11,"PP",135
8,"8238",14478,11302,11252,85,50,"PP",1007
8,"8278",4764,3372,3358,16,14,"PP",135
8,"8078",216,135,135,2,0,"PP",6
8,"8901",232,171,171,6,0,"PP",5
8,"8220",2358,1783,1770,18,13,"PP",64
8,"8023",6715,4669,4633,25,36,"PP",479
8,"8240",9354,6996,6953,34,43,"PP",449
8,"8076",16173,11553,11473,73,80,"PP",1157
8,"8246",1682,1157,1152,8,5,"PP",41
8,"8130",96,66,66,0,0,"PP",12
8,"8012",1676,1175,1170,24,5,"PP",68
8,"8145",2585,1927,1915,10,12,"PP",124
8,"8140",4769,3344,3335,25,9,"PP",241
8,"8126",8709,6454,6425,34,29,"PP",592
8,"8072",10240,6957,6935,40,22,"PP",738
8,"8289",4304,3166,3151,19,15,"PP",192
8,"8029",3438,2645,2632,25,13,"PP",267
8,"8153",536,432,431,6,1,"PP",24
8,"8077",34550,26102,25983,152,119,"PP",3889
8,"8300",5682,4328,4312,21,16,"PP",418
8,"8297",138,100,99,1,1,"PP",13
8,"8236",1525,1077,1067,3,10,"PP",114
8,"8245",78581,55798,55530,345,268,"PP",7525
8,"8295",10850,7651,7617,33,34,"PP",819
8,"8209",6773,4845,4822,31,23,"PP",650
8,"8101",174802,123863,123197,643,666,"PP",17085
8,"8002",202,142,139,0,3,"PP",6
8,"8197",7605,5331,5317,31,14,"PP",717
8,"8007",6505,4532,4495,28,37,"PP",303
8,"8053",2805,1789,1775,10,14,"PP",171
8,"8075",3875,2709,2695,12,14,"PP",351
8,"8259",6623,4921,4885,33,36,"PP",397
8,"8303",278,206,205,2,1,"PP",10
4,"4071",398,327,326,2,1,"C´s",20
4,"4050",830,597,594,3,3,"C´s",46
4,"4087",189,140,139,1,1,"C´s",19
4,"4083",1790,1384,1379,8,5,"C´s",94
4,"4099",4988,3784,3714,26,70,"C´s",500
4,"4066",13573,8651,8570,65,81,"C´s",856
4,"4096",274,208,206,0,2,"C´s",15
4,"4080",226,185,182,2,3,"C´s",17
4,"4038",3066,2169,2150,20,19,"C´s",243
4,"4098",1537,1157,1147,8,10,"C´s",119
4,"4010",579,469,464,2,5,"C´s",59
4,"4035",8375,6079,6031,28,48,"C´s",623
4,"4097",254,196,194,0,2,"C´s",12
4,"4068",195,158,158,0,0,"C´s",18
4,"4064",2779,2032,2009,8,23,"C´s",306
4,"4065",366,290,288,2,2,"C´s",10
4,"4081",356,290,290,2,0,"C´s",16
4,"4029",8887,6103,6048,53,55,"C´s",594
4,"4043",546,466,462,3,4,"C´s",28
4,"4028",226,198,197,0,1,"C´s",4
4,"4069",4692,3641,3607,29,34,"C´s",470
4,"4037",1312,1019,1000,6,19,"C´s",62
4,"4015",130,98,98,1,0,"C´s",11
4,"4059",1100,752,745,7,7,"C´s",64
4,"4052",12246,8393,8353,84,40,"C´s",1701
4,"4079",50800,33862,33629,200,233,"C´s",6263
4,"4027",249,163,163,1,0,"C´s",21
4,"4003",17365,10931,10830,57,101,"C´s",1315
4,"4036",228,176,175,2,1,"C´s",19
4,"4063",1099,847,835,2,12,"C´s",76
4,"4078",1095,784,779,7,5,"C´s",64
4,"4094",209,141,141,1,0,"C´s",7
4,"4095",726,466,463,2,3,"C´s",57
4,"4072",311,247,244,14,3,"C´s",20
4,"4056",147,123,120,0,3,"C´s",7
4,"4051",440,373,372,0,1,"C´s",59
4,"4103",1478,1051,1037,6,14,"C´s",95
4,"4090",309,242,242,1,0,"C´s",19
4,"4019",251,199,198,0,1,"C´s",16
4,"4018",274,245,242,0,3,"C´s",11
4,"4030",1140,828,826,8,2,"C´s",59
4,"4067",584,432,424,0,8,"C´s",9
4,"4020",292,208,207,1,1,"C´s",14
4,"4033",139,100,97,3,3,"C´s",12
4,"4904",1759,1185,1172,15,13,"C´s",134
4,"4055",372,315,315,0,0,"C´s",14
4,"4070",1623,1233,1229,7,4,"C´s",92
4,"4073",332,231,230,2,1,"C´s",24
4,"4100",8712,5545,5482,30,63,"C´s",960
4,"4088",2475,1717,1703,10,14,"C´s",150
4,"4062",4528,3610,3579,20,31,"C´s",294
4,"4075",5152,3772,3715,19,57,"C´s",426
4,"4032",5606,3789,3770,19,19,"C´s",581
4,"4045",1777,1402,1392,9,10,"C´s",105
4,"4102",13729,8987,8878,114,109,"C´s",1145
4,"4046",862,658,656,6,2,"C´s",78
4,"4012",191,170,169,1,1,"C´s",17
4,"4023",139,104,102,1,2,"C´s",11
4,"4053",12333,9124,9040,66,84,"C´s",1397
4,"4001",1083,812,796,6,16,"C´s",78
4,"4004",421,314,312,2,2,"C´s",35
4,"4101",4283,2969,2950,22,19,"C´s",459
4,"4077",303,277,274,2,3,"C´s",12
4,"4031",2359,1791,1786,7,5,"C´s",140
4,"4902",45373,28425,28220,249,205,"C´s",4349
4,"4074",2829,1965,1945,24,20,"C´s",238
4,"4017",1301,881,876,5,5,"C´s",107
4,"4013",141116,95203,94625,669,578,"C´s",15448
4,"4009",169,127,126,0,1,"C´s",11
4,"4901",539,388,386,0,2,"C´s",38
4,"4024",3036,2325,2308,18,17,"C´s",350
4,"4054",363,297,292,1,5,"C´s",12
4,"4060",466,361,358,2,3,"C´s",51
4,"4034",173,108,108,3,0,"C´s",5
4,"4058",369,292,291,2,1,"C´s",29
4,"4047",2278,1906,1891,13,15,"C´s",194
4,"4086",1792,1271,1258,8,13,"C´s",140
4,"4026",70,60,60,0,0,"C´s",4
4,"4048",1503,1104,1096,7,8,"C´s",98
4,"4076",1296,1005,993,7,12,"C´s",82
4,"4016",2146,1584,1564,8,20,"C´s",224
4,"4085",395,302,298,0,4,"C´s",15
4,"4011",2798,2244,2220,14,24,"C´s",198
4,"4044",1555,1253,1243,9,10,"C´s",142
4,"4061",618,495,491,5,4,"C´s",45
4,"4049",5280,3658,3623,20,35,"C´s",461
4,"4002",1063,765,760,1,5,"C´s",73
4,"4089",746,536,528,6,8,"C´s",60
4,"4082",306,210,209,0,1,"C´s",17
4,"4093",1872,1265,1252,10,13,"C´s",123
4,"4021",187,148,141,1,7,"C´s",15
4,"4041",318,241,241,6,0,"C´s",21
4,"4091",342,280,278,4,2,"C´s",12
4,"4014",153,118,118,0,0,"C´s",5
4,"4022",348,243,242,1,1,"C´s",18
4,"4057",1337,941,933,2,8,"C´s",111
4,"4008",501,420,415,3,5,"C´s",32
4,"4084",337,264,261,1,3,"C´s",35
4,"4007",736,553,551,0,2,"C´s",46
4,"4006",7016,4823,4786,33,37,"C´s",701
4,"4092",2852,2192,2168,13,24,"C´s",264
4,"4005",577,438,432,1,6,"C´s",39
4,"4903",4345,2896,2875,35,21,"C´s",305
33,"33070",3347,2473,2441,31,32,"PSOE",630
33,"33015",1561,1042,1031,8,11,"PSOE",254
33,"33029",363,199,198,1,1,"PSOE",88
33,"33053",1157,767,762,12,5,"PSOE",326
33,"33055",1511,1150,1129,9,21,"PSOE",381
33,"33028",1289,685,682,9,3,"PSOE",235
33,"33011",11373,6279,6214,104,65,"PSOE",1499
33,"33019",3094,2079,2054,15,25,"PSOE",592
33,"33052",730,517,512,1,5,"PSOE",208
33,"33038",2298,1690,1675,12,15,"PSOE",527
33,"33062",409,242,239,1,3,"PSOE",84
33,"33072",1601,1012,1002,4,10,"PSOE",322
33,"33027",849,544,543,8,1,"PSOE",216
33,"33012",5230,3595,3568,27,27,"PSOE",944
33,"33040",4564,3125,3091,28,34,"PSOE",917
33,"33010",1828,1220,1215,16,5,"PSOE",402
33,"33022",906,604,599,3,5,"PSOE",229
33,"33059",4702,3228,3185,42,43,"PSOE",768
33,"33049",6388,4229,4182,48,47,"PSOE",1368
33,"33074",3523,2422,2390,36,32,"PSOE",828
33,"33057",1593,1134,1123,17,11,"PSOE",382
33,"33009",899,606,601,4,5,"PSOE",165
33,"33020",13297,9527,9445,86,82,"PSOE",2633
33,"33008",1808,1268,1247,6,21,"PSOE",421
33,"33060",14750,10307,10206,82,101,"PSOE",3357
33,"33067",785,608,598,5,10,"PSOE",233
33,"33061",379,194,190,1,4,"PSOE",75
33,"33043",682,465,460,2,5,"PSOE",185
33,"33001",1622,867,852,16,15,"PSOE",266
33,"33003",665,386,384,7,2,"PSOE",125
33,"33068",1114,627,623,2,4,"PSOE",264
33,"33004",67136,48699,48354,389,345,"PSOE",11009
33,"33051",7167,4810,4772,57,38,"PSOE",1286
33,"33071",617,459,452,8,7,"PSOE",239
33,"33075",275,161,155,2,6,"PSOE",58
33,"33044",178724,130938,130010,1254,928,"PSOE",23083
33,"33033",9943,6851,6803,61,48,"PSOE",2000
33,"33054",1688,1159,1146,8,13,"PSOE",352
33,"33065",1109,743,735,16,8,"PSOE",148
33,"33050",603,374,357,0,17,"PSOE",127
33,"33024",227211,166618,165475,1240,1143,"PSOE",36277
33,"33032",11483,8036,7921,82,115,"PSOE",2534
33,"33030",899,689,687,10,2,"PSOE",133
33,"33002",10122,7056,6977,55,79,"PSOE",2050
33,"33005",1479,945,932,12,13,"PSOE",341
33,"33066",43034,29901,29610,261,291,"PSOE",6622
33,"33076",12270,8265,8203,89,62,"PSOE",1717
33,"33046",508,375,365,4,10,"PSOE",102
33,"33042",4316,3143,3105,35,38,"PSOE",669
33,"33034",10693,6796,6725,72,71,"PSOE",1898
33,"33025",9261,6116,6062,58,54,"PSOE",1590
33,"33063",419,330,326,1,4,"PSOE",102
33,"33041",7270,5138,5093,53,45,"PSOE",1385
33,"33035",11299,8048,7981,67,67,"PSOE",1824
33,"33056",5015,3435,3405,32,30,"PSOE",806
33,"33045",4503,3249,3216,26,33,"PSOE",1067
33,"33073",8631,5015,4948,47,67,"PSOE",1483
33,"33016",19201,14177,14074,115,103,"PSOE",2731
33,"33013",456,336,331,6,5,"PSOE",95
33,"33006",1556,1043,1036,17,7,"PSOE",340
33,"33023",3315,2295,2267,35,28,"PSOE",682
33,"33064",231,181,179,4,2,"PSOE",66
33,"33047",1126,868,861,12,7,"PSOE",237
33,"33026",8621,5600,5555,71,45,"PSOE",1371
33,"33007",1524,991,980,10,11,"PSOE",356
33,"33069",3513,2577,2554,15,23,"PSOE",766
33,"33039",1672,1261,1257,14,4,"PSOE",419
33,"33037",34841,24271,24054,200,217,"PSOE",6176
33,"33036",11572,8208,8133,80,75,"PSOE",2517
33,"33031",35453,23848,23595,242,253,"PSOE",6172
33,"33017",3180,2196,2168,30,28,"PSOE",681
33,"33048",156,99,99,2,0,"PSOE",37
33,"33058",1821,1319,1305,10,14,"PSOE",436
33,"33014",9101,6398,6352,46,46,"PSOE",1490
33,"33018",2896,2068,2041,18,27,"PSOE",456
33,"33021",4576,3133,3090,33,43,"PSOE",980
33,"33077",1220,849,840,11,9,"PSOE",202
33,"33078",147,98,98,0,0,"PSOE",33
33,"33001",1622,867,852,16,15,"C's",54
33,"33071",617,459,452,8,7,"C's",24
33,"33021",4576,3133,3090,33,43,"C's",332
33,"33061",379,194,190,1,4,"C's",20
33,"33051",7167,4810,4772,57,38,"C's",587
33,"33004",67136,48699,48354,389,345,"C's",6271
33,"33011",11373,6279,6214,104,65,"C's",622
33,"33043",682,465,460,2,5,"C's",22
33,"33005",1479,945,932,12,13,"C's",59
33,"33032",11483,8036,7921,82,115,"C's",695
33,"33072",1601,1012,1002,4,10,"C's",79
33,"33062",409,242,239,1,3,"C's",13
33,"33055",1511,1150,1129,9,21,"C's",124
33,"33012",5230,3595,3568,27,27,"C's",350
33,"33069",3513,2577,2554,15,23,"C's",254
33,"33066",43034,29901,29610,261,291,"C's",4728
33,"33073",8631,5015,4948,47,67,"C's",524
33,"33022",906,604,599,3,5,"C's",24
33,"33002",10122,7056,6977,55,79,"C's",522
33,"33063",419,330,326,1,4,"C's",12
33,"33077",1220,849,840,11,9,"C's",44
33,"33036",11572,8208,8133,80,75,"C's",998
33,"33006",1556,1043,1036,17,7,"C's",50
33,"33056",5015,3435,3405,32,30,"C's",454
33,"33033",9943,6851,6803,61,48,"C's",613
33,"33046",508,375,365,4,10,"C's",14
33,"33030",899,689,687,10,2,"C's",57
33,"33074",3523,2422,2390,36,32,"C's",173
33,"33047",1126,868,861,12,7,"C's",61
33,"33003",665,386,384,7,2,"C's",26
33,"33050",603,374,357,0,17,"C's",24
33,"33054",1688,1159,1146,8,13,"C's",133
33,"33007",1524,991,980,10,11,"C's",60
33,"33059",4702,3228,3185,42,43,"C's",248
33,"33024",227211,166618,165475,1240,1143,"C's",25437
33,"33028",1289,685,682,9,3,"C's",40
33,"33014",9101,6398,6352,46,46,"C's",742
33,"33044",178724,130938,130010,1254,928,"C's",22624
33,"33025",9261,6116,6062,58,54,"C's",782
33,"33064",231,181,179,4,2,"C's",18
33,"33017",3180,2196,2168,30,28,"C's",169
33,"33038",2298,1690,1675,12,15,"C's",178
33,"33034",10693,6796,6725,72,71,"C's",681
33,"33075",275,161,155,2,6,"C's",11
33,"33035",11299,8048,7981,67,67,"C's",1318
33,"33029",363,199,198,1,1,"C's",7
33,"33040",4564,3125,3091,28,34,"C's",337
33,"33076",12270,8265,8203,89,62,"C's",1241
33,"33039",1672,1261,1257,14,4,"C's",140
33,"33065",1109,743,735,16,8,"C's",84
33,"33015",1561,1042,1031,8,11,"C's",85
33,"33060",14750,10307,10206,82,101,"C's",647
33,"33049",6388,4229,4182,48,47,"C's",403
33,"33023",3315,2295,2267,35,28,"C's",212
33,"33067",785,608,598,5,10,"C's",46
33,"33070",3347,2473,2441,31,32,"C's",233
33,"33026",8621,5600,5555,71,45,"C's",676
33,"33020",13297,9527,9445,86,82,"C's",1061
33,"33057",1593,1134,1123,17,11,"C's",101
33,"33019",3094,2079,2054,15,25,"C's",193
33,"33037",34841,24271,24054,200,217,"C's",1972
33,"33010",1828,1220,1215,16,5,"C's",111
33,"33053",1157,767,762,12,5,"C's",38
33,"33031",35453,23848,23595,242,253,"C's",2149
33,"33027",849,544,543,8,1,"C's",27
33,"33009",899,606,601,4,5,"C's",70
33,"33048",156,99,99,2,0,"C's",3
33,"33058",1821,1319,1305,10,14,"C's",76
33,"33068",1114,627,623,2,4,"C's",46
33,"33078",147,98,98,0,0,"C's",6
33,"33018",2896,2068,2041,18,27,"C's",175
33,"33052",730,517,512,1,5,"C's",50
33,"33041",7270,5138,5093,53,45,"C's",506
33,"33008",1808,1268,1247,6,21,"C's",89
33,"33016",19201,14177,14074,115,103,"C's",2032
33,"33042",4316,3143,3105,35,38,"C's",483
33,"33013",456,336,331,6,5,"C's",29
33,"33045",4503,3249,3216,26,33,"C's",287
4,"4102",13729,8987,8878,114,109,"PP",3736
4,"4080",226,185,182,2,3,"PP",80
4,"4101",4283,2969,2950,22,19,"PP",889
4,"4083",1790,1384,1379,8,5,"PP",447
4,"4081",356,290,290,2,0,"PP",60
4,"4097",254,196,194,0,2,"PP",59
4,"4068",195,158,158,0,0,"PP",68
4,"4095",726,466,463,2,3,"PP",158
4,"4094",209,141,141,1,0,"PP",99
4,"4067",584,432,424,0,8,"PP",116
4,"4049",5280,3658,3623,20,35,"PP",1351
4,"4038",3066,2169,2150,20,19,"PP",707
4,"4009",169,127,126,0,1,"PP",58
4,"4079",50800,33862,33629,200,233,"PP",13102
4,"4028",226,198,197,0,1,"PP",45
4,"4072",311,247,244,14,3,"PP",125
4,"4051",440,373,372,0,1,"PP",130
4,"4041",318,241,241,6,0,"PP",97
4,"4084",337,264,261,1,3,"PP",108
4,"4050",830,597,594,3,3,"PP",207
4,"4070",1623,1233,1229,7,4,"PP",494
4,"4093",1872,1265,1252,10,13,"PP",472
4,"4031",2359,1791,1786,7,5,"PP",568
4,"4090",309,242,242,1,0,"PP",77
4,"4904",1759,1185,1172,15,13,"PP",676
4,"4098",1537,1157,1147,8,10,"PP",366
4,"4023",139,104,102,1,2,"PP",53
4,"4075",5152,3772,3715,19,57,"PP",1500
4,"4020",292,208,207,1,1,"PP",91
4,"4103",1478,1051,1037,6,14,"PP",409
4,"4052",12246,8393,8353,84,40,"PP",2317
4,"4054",363,297,292,1,5,"PP",132
4,"4010",579,469,464,2,5,"PP",97
4,"4061",618,495,491,5,4,"PP",108
4,"4019",251,199,198,0,1,"PP",52
4,"4065",366,290,288,2,2,"PP",102
4,"4078",1095,784,779,7,5,"PP",197
4,"4002",1063,765,760,1,5,"PP",212
4,"4071",398,327,326,2,1,"PP",80
4,"4017",1301,881,876,5,5,"PP",300
4,"4043",546,466,462,3,4,"PP",233
4,"4086",1792,1271,1258,8,13,"PP",582
4,"4005",577,438,432,1,6,"PP",177
4,"4053",12333,9124,9040,66,84,"PP",3887
4,"4029",8887,6103,6048,53,55,"PP",1990
4,"4047",2278,1906,1891,13,15,"PP",773
4,"4100",8712,5545,5482,30,63,"PP",2106
4,"4062",4528,3610,3579,20,31,"PP",1409
4,"4903",4345,2896,2875,35,21,"PP",1533
4,"4044",1555,1253,1243,9,10,"PP",488
4,"4057",1337,941,933,2,8,"PP",259
4,"4901",539,388,386,0,2,"PP",124
4,"4099",4988,3784,3714,26,70,"PP",1497
4,"4060",466,361,358,2,3,"PP",170
4,"4027",249,163,163,1,0,"PP",75
4,"4074",2829,1965,1945,24,20,"PP",614
4,"4018",274,245,242,0,3,"PP",74
4,"4055",372,315,315,0,0,"PP",102
4,"4076",1296,1005,993,7,12,"PP",269
4,"4014",153,118,118,0,0,"PP",14
4,"4066",13573,8651,8570,65,81,"PP",3895
4,"4091",342,280,278,4,2,"PP",56
4,"4048",1503,1104,1096,7,8,"PP",346
4,"4096",274,208,206,0,2,"PP",69
4,"4056",147,123,120,0,3,"PP",71
4,"4073",332,231,230,2,1,"PP",99
4,"4036",228,176,175,2,1,"PP",74
4,"4001",1083,812,796,6,16,"PP",249
4,"4089",746,536,528,6,8,"PP",229
4,"4088",2475,1717,1703,10,14,"PP",541
4,"4082",306,210,209,0,1,"PP",102
4,"4058",369,292,291,2,1,"PP",88
4,"4012",191,170,169,1,1,"PP",68
4,"4013",141116,95203,94625,669,578,"PP",34111
4,"4011",2798,2244,2220,14,24,"PP",643
4,"4034",173,108,108,3,0,"PP",59
4,"4069",4692,3641,3607,29,34,"PP",1299
4,"4026",70,60,60,0,0,"PP",42
4,"4030",1140,828,826,8,2,"PP",295
4,"4046",862,658,656,6,2,"PP",222
4,"4024",3036,2325,2308,18,17,"PP",734
4,"4007",736,553,551,0,2,"PP",139
4,"4064",2779,2032,2009,8,23,"PP",848
4,"4015",130,98,98,1,0,"PP",33
4,"4021",187,148,141,1,7,"PP",59
4,"4092",2852,2192,2168,13,24,"PP",831
4,"4033",139,100,97,3,3,"PP",25
4,"4085",395,302,298,0,4,"PP",153
4,"4035",8375,6079,6031,28,48,"PP",2276
4,"4902",45373,28425,28220,249,205,"PP",13200
4,"4077",303,277,274,2,3,"PP",165
4,"4087",189,140,139,1,1,"PP",50
4,"4022",348,243,242,1,1,"PP",68
4,"4037",1312,1019,1000,6,19,"PP",351
4,"4006",7016,4823,4786,33,37,"PP",1872
4,"4045",1777,1402,1392,9,10,"PP",273
4,"4063",1099,847,835,2,12,"PP",322
4,"4032",5606,3789,3770,19,19,"PP",1146
4,"4003",17365,10931,10830,57,101,"PP",4844
4,"4004",421,314,312,2,2,"PP",96
4,"4016",2146,1584,1564,8,20,"PP",626
4,"4059",1100,752,745,7,7,"PP",187
4,"4008",501,420,415,3,5,"PP",230
4,"4098",1537,1157,1147,8,10,"PCPE",2
4,"4083",1790,1384,1379,8,5,"PCPE",2
4,"4902",45373,28425,28220,249,205,"PCPE",27
4,"4052",12246,8393,8353,84,40,"PCPE",5
4,"4053",12333,9124,9040,66,84,"PCPE",4
4,"4081",356,290,290,2,0,"PCPE",0
4,"4070",1623,1233,1229,7,4,"PCPE",4
4,"4100",8712,5545,5482,30,63,"PCPE",3
4,"4084",337,264,261,1,3,"PCPE",0
4,"4101",4283,2969,2950,22,19,"PCPE",2
4,"4089",746,536,528,6,8,"PCPE",2
4,"4077",303,277,274,2,3,"PCPE",0
4,"4082",306,210,209,0,1,"PCPE",0
4,"4901",539,388,386,0,2,"PCPE",0
4,"4061",618,495,491,5,4,"PCPE",0
4,"4056",147,123,120,0,3,"PCPE",1
4,"4055",372,315,315,0,0,"PCPE",1
4,"4086",1792,1271,1258,8,13,"PCPE",0
4,"4047",2278,1906,1891,13,15,"PCPE",2
4,"4087",189,140,139,1,1,"PCPE",0
4,"4075",5152,3772,3715,19,57,"PCPE",8
4,"4103",1478,1051,1037,6,14,"PCPE",2
4,"4073",332,231,230,2,1,"PCPE",0
4,"4085",395,302,298,0,4,"PCPE",0
4,"4003",17365,10931,10830,57,101,"PCPE",8
4,"4076",1296,1005,993,7,12,"PCPE",4
4,"4054",363,297,292,1,5,"PCPE",1
4,"4019",251,199,198,0,1,"PCPE",0
4,"4045",1777,1402,1392,9,10,"PCPE",2
4,"4007",736,553,551,0,2,"PCPE",0
4,"4004",421,314,312,2,2,"PCPE",1
4,"4092",2852,2192,2168,13,24,"PCPE",4
4,"4080",226,185,182,2,3,"PCPE",0
4,"4102",13729,8987,8878,114,109,"PCPE",9
4,"4044",1555,1253,1243,9,10,"PCPE",3
4,"4038",3066,2169,2150,20,19,"PCPE",5
4,"4058",369,292,291,2,1,"PCPE",0
4,"4072",311,247,244,14,3,"PCPE",0
4,"4024",3036,2325,2308,18,17,"PCPE",3
4,"4006",7016,4823,4786,33,37,"PCPE",10
4,"4071",398,327,326,2,1,"PCPE",1
4,"4091",342,280,278,4,2,"PCPE",0
4,"4904",1759,1185,1172,15,13,"PCPE",1
4,"4097",254,196,194,0,2,"PCPE",0
4,"4048",1503,1104,1096,7,8,"PCPE",2
4,"4009",169,127,126,0,1,"PCPE",0
4,"4046",862,658,656,6,2,"PCPE",1
4,"4057",1337,941,933,2,8,"PCPE",1
4,"4041",318,241,241,6,0,"PCPE",0
4,"4011",2798,2244,2220,14,24,"PCPE",1
4,"4029",8887,6103,6048,53,55,"PCPE",3
4,"4012",191,170,169,1,1,"PCPE",0
4,"4049",5280,3658,3623,20,35,"PCPE",3
4,"4043",546,466,462,3,4,"PCPE",0
4,"4030",1140,828,826,8,2,"PCPE",5
4,"4027",249,163,163,1,0,"PCPE",0
4,"4074",2829,1965,1945,24,20,"PCPE",1
4,"4031",2359,1791,1786,7,5,"PCPE",0
4,"4026",70,60,60,0,0,"PCPE",0
4,"4032",5606,3789,3770,19,19,"PCPE",4
4,"4017",1301,881,876,5,5,"PCPE",2
4,"4028",226,198,197,0,1,"PCPE",0
4,"4015",130,98,98,1,0,"PCPE",0
4,"4064",2779,2032,2009,8,23,"PCPE",1
4,"4094",209,141,141,1,0,"PCPE",0
4,"4088",2475,1717,1703,10,14,"PCPE",3
4,"4079",50800,33862,33629,200,233,"PCPE",41
4,"4903",4345,2896,2875,35,21,"PCPE",2
4,"4050",830,597,594,3,3,"PCPE",2
4,"4033",139,100,97,3,3,"PCPE",0
4,"4001",1083,812,796,6,16,"PCPE",3
4,"4036",228,176,175,2,1,"PCPE",0
4,"4014",153,118,118,0,0,"PCPE",0
4,"4078",1095,784,779,7,5,"PCPE",1
4,"4013",141116,95203,94625,669,578,"PCPE",79
4,"4010",579,469,464,2,5,"PCPE",1
4,"4059",1100,752,745,7,7,"PCPE",1
4,"4093",1872,1265,1252,10,13,"PCPE",3
4,"4090",309,242,242,1,0,"PCPE",0
4,"4099",4988,3784,3714,26,70,"PCPE",7
4,"4051",440,373,372,0,1,"PCPE",0
4,"4062",4528,3610,3579,20,31,"PCPE",5
4,"4035",8375,6079,6031,28,48,"PCPE",5
4,"4060",466,361,358,2,3,"PCPE",0
4,"4005",577,438,432,1,6,"PCPE",2
4,"4063",1099,847,835,2,12,"PCPE",0
4,"4021",187,148,141,1,7,"PCPE",0
4,"4023",139,104,102,1,2,"PCPE",0
4,"4067",584,432,424,0,8,"PCPE",0
4,"4008",501,420,415,3,5,"PCPE",0
4,"4016",2146,1584,1564,8,20,"PCPE",1
4,"4069",4692,3641,3607,29,34,"PCPE",6
4,"4022",348,243,242,1,1,"PCPE",1
4,"4066",13573,8651,8570,65,81,"PCPE",8
4,"4065",366,290,288,2,2,"PCPE",0
4,"4037",1312,1019,1000,6,19,"PCPE",1
4,"4068",195,158,158,0,0,"PCPE",0
4,"4095",726,466,463,2,3,"PCPE",0
4,"4002",1063,765,760,1,5,"PCPE",0
4,"4020",292,208,207,1,1,"PCPE",1
4,"4096",274,208,206,0,2,"PCPE",0
4,"4034",173,108,108,3,0,"PCPE",0
4,"4018",274,245,242,0,3,"PCPE",0
15,"15001",4805,3466,3419,45,47,"PSdeG-PSOE",616
15,"15011",15463,11105,10890,92,215,"PSdeG-PSOE",1967
15,"15014",4034,2809,2757,34,52,"PSdeG-PSOE",594
15,"15901",3595,2401,2374,30,27,"PSdeG-PSOE",609
15,"15074",4061,2983,2947,24,36,"PSdeG-PSOE",495
15,"15042",3060,2170,2127,21,43,"PSdeG-PSOE",455
15,"15087",5804,3942,3901,49,41,"PSdeG-PSOE",902
15,"15067",8073,6067,6000,45,67,"PSdeG-PSOE",1109
15,"15082",15162,11273,11134,135,139,"PSdeG-PSOE",1795
15,"15005",24459,16742,16482,215,260,"PSdeG-PSOE",3434
15,"15046",6345,4625,4532,53,93,"PSdeG-PSOE",825
15,"15056",5757,4167,4108,43,59,"PSdeG-PSOE",1102
15,"15051",4651,3343,3297,38,46,"PSdeG-PSOE",708
15,"15064",2207,1680,1650,22,30,"PSdeG-PSOE",477
15,"15002",22929,16941,16742,205,199,"PSdeG-PSOE",3038
15,"15036",58409,40932,40506,484,426,"PSdeG-PSOE",7890
15,"15033",2489,1953,1931,13,22,"PSdeG-PSOE",355
15,"15068",5096,3518,3476,39,42,"PSdeG-PSOE",783
15,"15065",7345,5517,5412,46,105,"PSdeG-PSOE",1069
15,"15085",3346,2365,2311,26,54,"PSdeG-PSOE",447
15,"15902",4660,3352,3296,30,56,"PSdeG-PSOE",713
15,"15055",4618,3208,3159,49,49,"PSdeG-PSOE",800
15,"15037",4087,2775,2733,18,42,"PSdeG-PSOE",618
15,"15054",32177,22065,21778,349,287,"PSdeG-PSOE",3991
15,"15069",6785,5107,5032,54,75,"PSdeG-PSOE",1098
15,"15028",1415,1085,1070,10,15,"PSdeG-PSOE",274
15,"15034",2897,1931,1909,14,22,"PSdeG-PSOE",855
15,"15076",2649,1827,1802,24,25,"PSdeG-PSOE",299
15,"15038",2236,1556,1530,18,26,"PSdeG-PSOE",337
15,"15003",1818,1326,1302,18,24,"PSdeG-PSOE",297
15,"15013",6126,4315,4257,43,58,"PSdeG-PSOE",866
15,"15086",2918,2109,2077,19,32,"PSdeG-PSOE",374
15,"15017",19380,14272,14098,156,174,"PSdeG-PSOE",2940
15,"15035",11517,8305,8192,144,113,"PSdeG-PSOE",1639
15,"15059",10406,7710,7553,91,157,"PSdeG-PSOE",1587
15,"15024",4412,3325,3278,35,47,"PSdeG-PSOE",911
15,"15029",5761,3994,3928,47,66,"PSdeG-PSOE",1080
15,"15004",4855,3594,3535,28,59,"PSdeG-PSOE",763
15,"15089",4317,3238,3188,24,50,"PSdeG-PSOE",624
15,"15077",8303,5648,5544,57,104,"PSdeG-PSOE",1320
15,"15032",3455,2438,2391,26,47,"PSdeG-PSOE",390
15,"15015",2840,2126,2100,21,26,"PSdeG-PSOE",417
15,"15062",5936,4047,3993,31,54,"PSdeG-PSOE",746
15,"15007",3352,2469,2453,24,16,"PSdeG-PSOE",678
15,"15008",5650,4239,4175,42,64,"PSdeG-PSOE",895
15,"15080",1760,1215,1197,11,18,"PSdeG-PSOE",363
15,"15039",1271,935,917,8,18,"PSdeG-PSOE",187
15,"15088",3550,2398,2372,18,26,"PSdeG-PSOE",482
15,"15075",12279,9076,8952,117,124,"PSdeG-PSOE",1685
15,"15019",25902,18111,17866,232,245,"PSdeG-PSOE",3977
15,"15049",1099,765,755,12,10,"PSdeG-PSOE",89
15,"15090",1182,868,861,13,7,"PSdeG-PSOE",124
15,"15093",4265,2856,2814,35,42,"PSdeG-PSOE",562
15,"15078",78093,58164,57487,673,677,"PSdeG-PSOE",10169
15,"15052",4351,3122,3063,26,59,"PSdeG-PSOE",1054
15,"15012",3666,2787,2721,40,66,"PSdeG-PSOE",523
15,"15081",1042,819,814,12,5,"PSdeG-PSOE",104
15,"15071",7965,5559,5483,37,76,"PSdeG-PSOE",1218
15,"15009",10780,8075,7957,70,118,"PSdeG-PSOE",1769
15,"15016",4806,3291,3222,21,69,"PSdeG-PSOE",1306
15,"15041",9627,7409,7291,79,118,"PSdeG-PSOE",1544
15,"15031",23321,17319,17152,218,167,"PSdeG-PSOE",4119
15,"15066",4039,2950,2894,34,56,"PSdeG-PSOE",577
15,"15092",6523,4518,4449,54,69,"PSdeG-PSOE",1195
15,"15047",2463,1669,1633,21,36,"PSdeG-PSOE",461
15,"15058",27623,21002,20788,257,214,"PSdeG-PSOE",3682
15,"15006",5353,3534,3469,49,65,"PSdeG-PSOE",723
15,"15048",4855,3582,3534,41,48,"PSdeG-PSOE",763
15,"15023",6481,4658,4595,44,63,"PSdeG-PSOE",1084
15,"15040",2763,2050,2017,10,33,"PSdeG-PSOE",487
15,"15079",1562,1092,1075,16,17,"PSdeG-PSOE",251
15,"15045",3803,2382,2354,15,28,"PSdeG-PSOE",436
15,"15073",21884,14792,14587,149,205,"PSdeG-PSOE",2406
15,"15050",1843,1089,1070,19,19,"PSdeG-PSOE",350
15,"15027",1540,1224,1203,6,21,"PSdeG-PSOE",240
15,"15070",9117,6514,6390,98,124,"PSdeG-PSOE",1781
15,"15022",5817,4026,3981,29,45,"PSdeG-PSOE",789
15,"15021",5099,3673,3611,43,62,"PSdeG-PSOE",850
15,"15057",12169,8853,8729,88,124,"PSdeG-PSOE",1686
15,"15025",1069,662,654,5,8,"PSdeG-PSOE",199
15,"15084",3312,2361,2326,28,35,"PSdeG-PSOE",442
15,"15043",5147,3834,3764,36,70,"PSdeG-PSOE",793
15,"15061",5646,3945,3894,35,51,"PSdeG-PSOE",975
15,"15072",9626,7024,6920,52,104,"PSdeG-PSOE",1536
15,"15030",200245,148692,147426,1699,1266,"PSdeG-PSOE",28927
15,"15083",1100,809,795,5,14,"PSdeG-PSOE",136
15,"15018",1156,817,806,7,11,"PSdeG-PSOE",324
15,"15091",1119,807,784,12,23,"PSdeG-PSOE",135
15,"15010",1913,1355,1338,21,17,"PSdeG-PSOE",258
15,"15060",5780,4245,4167,48,78,"PSdeG-PSOE",1044
15,"15020",3844,2651,2629,17,22,"PSdeG-PSOE",591
15,"15053",7783,5386,5314,47,72,"PSdeG-PSOE",1139
15,"15044",1309,955,941,5,14,"PSdeG-PSOE",204
29,"29903",525,394,389,2,5,"PSOE",192
29,"29087",380,283,276,1,7,"PSOE",85
29,"29069",85333,56398,55854,443,544,"PSOE",15171
29,"29026",1065,776,766,4,10,"PSOE",300
29,"29024",393,271,256,4,15,"PSOE",124
29,"29090",1704,1174,1165,10,9,"PSOE",431
29,"29088",2720,1930,1883,21,47,"PSOE",899
29,"29041",3146,2251,2216,26,35,"PSOE",684
29,"29046",2690,1974,1954,17,20,"PSOE",940
29,"29035",1587,1218,1208,0,10,"PSOE",605
29,"29020",3265,2531,2504,17,27,"PSOE",698
29,"29033",1132,808,804,2,4,"PSOE",366
29,"29099",960,741,734,3,7,"PSOE",366
29,"29057",376,285,284,2,1,"PSOE",163
29,"29039",2662,1948,1931,22,17,"PSOE",538
29,"29065",194,134,134,1,0,"PSOE",45
29,"29010",1667,1336,1310,1,26,"PSOE",698
29,"29016",253,188,188,1,0,"PSOE",59
29,"29084",27393,19096,18886,192,210,"PSOE",5801
29,"29032",6708,5341,5265,26,76,"PSOE",1995
29,"29066",346,252,251,2,1,"PSOE",91
29,"29070",39913,26993,26751,203,242,"PSOE",6597
29,"29072",3250,2466,2434,11,32,"PSOE",1053
29,"29079",2444,1880,1846,3,34,"PSOE",958
29,"29001",4196,3276,3253,26,23,"PSOE",1438
29,"29027",2343,1737,1722,6,15,"PSOE",626
29,"29081",258,205,200,1,5,"PSOE",77
29,"29025",39210,26938,26747,160,191,"PSOE",5530
29,"29052",226,155,152,0,3,"PSOE",60
29,"29073",1560,1126,1120,5,6,"PSOE",434
29,"29007",27319,19557,19395,179,162,"PSOE",4034
29,"29055",1808,1415,1396,13,19,"PSOE",570
29,"29021",162,114,107,13,7,"PSOE",32
29,"29030",809,653,651,2,2,"PSOE",332
29,"29038",17555,11638,11562,124,76,"PSOE",3906
29,"29037",212,166,165,1,1,"PSOE",54
29,"29059",2590,2100,2058,11,42,"PSOE",679
29,"29092",567,423,415,4,8,"PSOE",164
29,"29074",785,612,611,4,1,"PSOE",307
29,"29095",3350,2523,2467,17,56,"PSOE",1122
29,"29008",14541,9954,9820,90,134,"PSOE",3029
29,"29028",1249,881,881,4,0,"PSOE",436
29,"29061",1018,833,820,4,13,"PSOE",197
29,"29076",2163,1508,1482,8,26,"PSOE",649
29,"29045",1685,1232,1223,4,9,"PSOE",408
29,"29068",6885,4580,4511,43,69,"PSOE",1360
29,"29051",40201,27168,26842,229,326,"PSOE",6459
29,"29043",2503,1671,1638,17,33,"PSOE",674
29,"29023",2047,1385,1369,2,16,"PSOE",239
29,"29080",6704,4812,4766,44,46,"PSOE",1782
29,"29093",2235,1689,1667,12,22,"PSOE",751
29,"29031",1633,1115,1106,6,9,"PSOE",515
29,"29075",12952,8681,8619,55,62,"PSOE",2372
29,"29003",1002,777,769,1,8,"PSOE",373
29,"29062",658,564,561,0,3,"PSOE",294
29,"29005",4342,2946,2908,22,38,"PSOE",1021
29,"29012",9765,7029,6944,58,85,"PSOE",2993
29,"29049",2987,2204,2185,25,19,"PSOE",1054
29,"29018",2026,1560,1519,15,41,"PSOE",642
29,"29096",2806,2065,2034,19,31,"PSOE",981
29,"29015",31884,23160,22943,188,217,"PSOE",7732
29,"29011",2920,1962,1946,5,16,"PSOE",1061
29,"29004",328,240,238,2,2,"PSOE",111
29,"29054",41888,29228,29022,205,206,"PSOE",6121
29,"29034",466,361,359,0,2,"PSOE",125
29,"29009",1477,1113,1100,3,13,"PSOE",497
29,"29086",795,497,490,3,7,"PSOE",215
29,"29006",680,482,474,3,8,"PSOE",225
29,"29094",57313,39393,39052,280,341,"PSOE",11379
29,"29047",1131,927,914,4,13,"PSOE",403
29,"29083",2114,1587,1568,10,19,"PSOE",778
29,"29002",1203,855,842,6,13,"PSOE",354
29,"29098",1257,991,977,12,14,"PSOE",501
29,"29044",811,557,556,3,1,"PSOE",225
29,"29060",706,524,516,0,8,"PSOE",173
29,"29071",938,640,633,6,7,"PSOE",252
29,"29040",1964,1321,1301,12,20,"PSOE",509
29,"29082",31505,23154,22990,127,164,"PSOE",4326
29,"29067",424770,295944,294094,2117,1850,"PSOE",68143
29,"29042",14078,9890,9776,75,114,"PSOE",2802
29,"29036",636,481,475,3,6,"PSOE",245
29,"29019",888,675,672,0,3,"PSOE",166
29,"29077",208,156,153,0,3,"PSOE",81
29,"29014",219,138,138,1,0,"PSOE",54
29,"29056",1107,815,807,8,8,"PSOE",354
29,"29022",185,143,143,1,0,"PSOE",63
29,"29100",2437,1775,1760,12,15,"PSOE",937
29,"29053",1702,1178,1160,17,18,"PSOE",289
29,"29029",420,322,315,4,7,"PSOE",112
29,"29058",1463,986,975,6,11,"PSOE",463
29,"29091",8966,6437,6346,57,91,"PSOE",1716
29,"29050",425,313,309,1,4,"PSOE",126
29,"29048",1428,1168,1155,9,13,"PSOE",521
29,"29064",506,372,365,2,7,"PSOE",158
29,"29013",1612,1282,1272,6,10,"PSOE",520
29,"29017",6610,5001,4938,25,63,"PSOE",2219
29,"29063",336,255,251,2,4,"PSOE",70
29,"29089",3254,2465,2438,10,27,"PSOE",880
29,"29902",2560,1735,1709,13,26,"PSOE",957
29,"29097",4117,2996,2947,43,49,"PSOE",1453
29,"29904",428,363,360,2,3,"PSOE",274
29,"29085",151,99,98,1,1,"PSOE",46
29,"29901",43601,30325,30130,188,195,"PSOE",6316
29,"29089",3254,2465,2438,10,27,"PP",375
29,"29087",380,283,276,1,7,"PP",43
29,"29013",1612,1282,1272,6,10,"PP",246
29,"29053",1702,1178,1160,17,18,"PP",397
29,"29010",1667,1336,1310,1,26,"PP",337
29,"29092",567,423,415,4,8,"PP",69
29,"29085",151,99,98,1,1,"PP",36
29,"29012",9765,7029,6944,58,85,"PP",1676
29,"29084",27393,19096,18886,192,210,"PP",5622
29,"29081",258,205,200,1,5,"PP",95
29,"29028",1249,881,881,4,0,"PP",164
29,"29094",57313,39393,39052,280,341,"PP",12760
29,"29041",3146,2251,2216,26,35,"PP",429
29,"29074",785,612,611,4,1,"PP",159
29,"29001",4196,3276,3253,26,23,"PP",512
29,"29054",41888,29228,29022,205,206,"PP",10502
29,"29052",226,155,152,0,3,"PP",54
29,"29017",6610,5001,4938,25,63,"PP",1016
29,"29007",27319,19557,19395,179,162,"PP",5540
29,"29036",636,481,475,3,6,"PP",85
29,"29095",3350,2523,2467,17,56,"PP",478
29,"29060",706,524,516,0,8,"PP",277
29,"29097",4117,2996,2947,43,49,"PP",599
29,"29035",1587,1218,1208,0,10,"PP",203
29,"29043",2503,1671,1638,17,33,"PP",416
29,"29903",525,394,389,2,5,"PP",106
29,"29004",328,240,238,2,2,"PP",86
29,"29090",1704,1174,1165,10,9,"PP",439
29,"29021",162,114,107,13,7,"PP",39
29,"29006",680,482,474,3,8,"PP",154
29,"29033",1132,808,804,2,4,"PP",250
29,"29091",8966,6437,6346,57,91,"PP",2165
29,"29008",14541,9954,9820,90,134,"PP",3255
29,"29048",1428,1168,1155,9,13,"PP",107
29,"29082",31505,23154,22990,127,164,"PP",6988
29,"29038",17555,11638,11562,124,76,"PP",2557
29,"29904",428,363,360,2,3,"PP",22
29,"29073",1560,1126,1120,5,6,"PP",223
29,"29096",2806,2065,2034,19,31,"PP",347
29,"29020",3265,2531,2504,17,27,"PP",436
29,"29055",1808,1415,1396,13,19,"PP",342
29,"29100",2437,1775,1760,12,15,"PP",353
29,"29046",2690,1974,1954,17,20,"PP",466
29,"29031",1633,1115,1106,6,9,"PP",139
29,"29067",424770,295944,294094,2117,1850,"PP",83648
29,"29099",960,741,734,3,7,"PP",209
29,"29022",185,143,143,1,0,"PP",21
29,"29029",420,322,315,4,7,"PP",112
29,"29044",811,557,556,3,1,"PP",224
29,"29901",43601,30325,30130,188,195,"PP",9584
29,"29037",212,166,165,1,1,"PP",76
29,"29063",336,255,251,2,4,"PP",108
29,"29080",6704,4812,4766,44,46,"PP",1137
29,"29069",85333,56398,55854,443,544,"PP",17278
29,"29079",2444,1880,1846,3,34,"PP",412
29,"29011",2920,1962,1946,5,16,"PP",382
29,"29023",2047,1385,1369,2,16,"PP",558
29,"29068",6885,4580,4511,43,69,"PP",1344
29,"29050",425,313,309,1,4,"PP",84
29,"29056",1107,815,807,8,8,"PP",264
29,"29098",1257,991,977,12,14,"PP",236
29,"29018",2026,1560,1519,15,41,"PP",333
29,"29047",1131,927,914,4,13,"PP",111
29,"29030",809,653,651,2,2,"PP",36
29,"29057",376,285,284,2,1,"PP",72
29,"29024",393,271,256,4,15,"PP",56
29,"29051",40201,27168,26842,229,326,"PP",9427
29,"29040",1964,1321,1301,12,20,"PP",414
29,"29039",2662,1948,1931,22,17,"PP",382
29,"29003",1002,777,769,1,8,"PP",186
29,"29045",1685,1232,1223,4,9,"PP",434
29,"29032",6708,5341,5265,26,76,"PP",1085
29,"29902",2560,1735,1709,13,26,"PP",311
29,"29016",253,188,188,1,0,"PP",83
29,"29065",194,134,134,1,0,"PP",61
29,"29027",2343,1737,1722,6,15,"PP",610
29,"29076",2163,1508,1482,8,26,"PP",280
29,"29034",466,361,359,0,2,"PP",173
29,"29071",938,640,633,6,7,"PP",203
29,"29009",1477,1113,1100,3,13,"PP",148
29,"29005",4342,2946,2908,22,38,"PP",1002
29,"29025",39210,26938,26747,160,191,"PP",7722
29,"29075",12952,8681,8619,55,62,"PP",2995
29,"29077",208,156,153,0,3,"PP",44
29,"29049",2987,2204,2185,25,19,"PP",420
29,"29015",31884,23160,22943,188,217,"PP",7402
29,"29064",506,372,365,2,7,"PP",127
29,"29066",346,252,251,2,1,"PP",74
29,"29070",39913,26993,26751,203,242,"PP",6931
29,"29058",1463,986,975,6,11,"PP",240
29,"29026",1065,776,766,4,10,"PP",225
29,"29088",2720,1930,1883,21,47,"PP",461
29,"29083",2114,1587,1568,10,19,"PP",490
29,"29072",3250,2466,2434,11,32,"PP",614
29,"29019",888,675,672,0,3,"PP",219
29,"29093",2235,1689,1667,12,22,"PP",472
29,"29042",14078,9890,9776,75,114,"PP",3040
29,"29062",658,564,561,0,3,"PP",212
29,"29014",219,138,138,1,0,"PP",35
29,"29086",795,497,490,3,7,"PP",158
29,"29061",1018,833,820,4,13,"PP",170
29,"29059",2590,2100,2058,11,42,"PP",323
29,"29002",1203,855,842,6,13,"PP",260
45,"45166",1629,1345,1332,5,13,"C's",129
45,"45038",3335,2525,2490,8,35,"C's",525
45,"45124",2156,1750,1712,16,38,"C's",131
45,"45063",428,320,310,2,10,"C's",18
45,"45069",1876,1446,1428,8,18,"C's",122
45,"45142",7858,6249,6164,57,85,"C's",716
45,"45081",17646,13309,13166,72,143,"C's",2747
45,"45093",151,117,117,0,0,"C's",7
45,"45029",205,169,169,0,0,"C's",17
45,"45148",307,229,219,1,10,"C's",13
45,"45112",1939,1302,1268,6,34,"C's",139
45,"45186",3083,2369,2341,14,28,"C's",168
45,"45017",262,221,219,0,2,"C's",17
45,"45128",2498,1794,1774,7,20,"C's",263
45,"45055",1032,857,841,2,16,"C's",59
45,"45136",5859,4249,4177,24,72,"C's",443
45,"45046",2421,1815,1796,8,19,"C's",155
45,"45164",186,160,160,0,0,"C's",20
45,"45174",309,247,247,1,0,"C's",22
45,"45065",276,227,223,0,4,"C's",7
45,"45015",622,461,455,2,6,"C's",68
45,"45020",1313,1062,1046,5,16,"C's",68
45,"45011",288,246,241,1,5,"C's",24
45,"45026",225,171,169,1,2,"C's",12
45,"45193",626,543,530,2,13,"C's",39
45,"45121",6766,4860,4798,30,62,"C's",813
45,"45192",2503,2164,2141,7,23,"C's",188
45,"45115",2563,2089,2048,5,41,"C's",238
45,"45027",362,275,270,0,5,"C's",17
45,"45096",1015,832,817,7,15,"C's",58
45,"45125",2329,1920,1898,10,22,"C's",181
45,"45185",7734,6057,5973,27,84,"C's",716
45,"45099",3512,2514,2459,9,55,"C's",363
45,"45009",545,336,333,1,3,"C's",16
45,"45122",5164,4112,4067,18,45,"C's",730
45,"45118",2002,1470,1456,3,14,"C's",164
45,"45156",3441,2863,2825,13,38,"C's",354
45,"45001",1852,1395,1355,9,40,"C's",166
45,"45083",465,393,388,5,5,"C's",51
45,"45051",1594,1264,1248,6,16,"C's",122
45,"45150",454,366,364,1,2,"C's",22
45,"45034",1360,1098,1083,4,15,"C's",118
45,"45087",8345,6184,6091,34,93,"C's",811
45,"45006",1425,1022,1013,4,9,"C's",75
45,"45073",307,238,235,0,3,"C's",5
45,"45132",2096,1631,1616,7,15,"C's",296
45,"45104",440,345,341,1,4,"C's",19
45,"45042",190,145,145,0,0,"C's",15
45,"45054",3995,2997,2968,8,29,"C's",449
45,"45168",62226,48889,48446,327,443,"C's",8099
45,"45005",241,207,205,2,2,"C's",12
45,"45080",6,6,6,0,0,"C's",1
45,"45129",136,100,97,0,3,"C's",10
45,"45079",367,285,285,3,0,"C's",21
45,"45056",2210,1384,1370,11,14,"C's",230
45,"45085",1501,1086,1067,6,19,"C's",128
45,"45202",3905,2962,2920,12,42,"C's",312
45,"45090",376,299,295,4,4,"C's",22
45,"45138",1110,903,887,6,16,"C's",91
45,"45031",2723,1935,1896,10,39,"C's",212
45,"45179",546,406,403,3,3,"C's",34
45,"45007",697,566,560,1,6,"C's",42
45,"45110",1799,1394,1380,4,14,"C's",87
45,"45068",173,138,135,0,3,"C's",9
45,"45057",221,187,182,0,5,"C's",8
45,"45032",436,317,313,0,4,"C's",54
45,"45177",2142,1757,1731,11,26,"C's",159
45,"45144",794,643,640,2,3,"C's",44
45,"45155",371,297,296,1,1,"C's",16
45,"45089",1516,1157,1139,6,18,"C's",130
45,"45183",2253,1581,1569,8,12,"C's",301
45,"45078",1392,1187,1179,8,8,"C's",89
45,"45205",6745,4708,4657,35,51,"C's",893
45,"45037",1635,1216,1202,4,14,"C's",103
45,"45103",397,325,322,0,3,"C's",9
45,"45061",2457,1718,1699,7,19,"C's",165
45,"45196",1388,1066,1054,13,12,"C's",135
45,"45201",3450,2212,2173,14,39,"C's",401
45,"45160",1111,908,895,6,13,"C's",108
45,"45197",1921,1500,1480,12,20,"C's",101
45,"45101",3761,3090,3048,15,42,"C's",313
45,"45113",1948,1409,1386,14,23,"C's",107
45,"45133",2818,2184,2146,19,38,"C's",258
45,"45053",8045,6446,6370,44,76,"C's",715
45,"45077",542,428,423,0,5,"C's",59
45,"45067",2324,1871,1841,13,30,"C's",161
45,"45071",1863,1550,1530,8,20,"C's",94
45,"45072",670,499,499,2,0,"C's",47
45,"45075",146,108,105,0,3,"C's",19
45,"45127",708,524,519,1,5,"C's",65
45,"45076",574,382,378,1,4,"C's",35
45,"45023",2160,1669,1654,9,15,"C's",283
45,"45022",392,297,293,8,4,"C's",16
45,"45013",1786,1428,1412,7,16,"C's",131
45,"45107",3238,2628,2597,15,31,"C's",509
45,"45165",62857,46607,46141,313,466,"C's",7235
45,"45003",572,431,423,1,8,"C's",54
45,"45066",7589,5716,5637,30,79,"C's",823
45,"45105",405,284,279,3,5,"C's",34
45,"45109",2913,2295,2218,16,77,"C's",179
45,"45146",108,85,85,0,0,"C's",1
45,"45203",2574,1938,1908,10,30,"C's",273
45,"45019",7356,5539,5484,35,55,"C's",886
45,"45191",549,477,475,0,2,"C's",34
45,"45184",201,124,123,1,1,"C's",13
45,"45094",395,312,308,0,4,"C's",21
45,"45097",1047,877,869,3,8,"C's",93
45,"45195",2161,1709,1686,12,23,"C's",131
45,"45139",172,135,133,0,2,"C's",2
45,"45147",581,475,469,4,6,"C's",57
45,"45064",3839,2915,2884,19,31,"C's",395
45,"45074",412,327,322,0,5,"C's",31
45,"45172",719,559,556,2,3,"C's",123
45,"45176",3665,2747,2712,15,35,"C's",621
45,"45033",351,253,247,3,6,"C's",12
45,"45189",597,467,458,2,9,"C's",64
45,"45143",1180,924,912,3,12,"C's",99
45,"45047",2563,1775,1751,13,24,"C's",340
45,"45059",1723,1413,1388,4,25,"C's",159
45,"45095",697,529,520,1,9,"C's",47
45,"45171",1382,1090,1075,4,15,"C's",129
45,"45131",287,242,242,0,0,"C's",15
45,"45060",179,131,129,1,2,"C's",14
45,"45004",568,436,430,1,6,"C's",50
45,"45187",4078,3405,3353,14,52,"C's",247
45,"45199",2963,2055,2027,5,28,"C's",388
45,"45154",1483,1114,1107,5,7,"C's",214
45,"45152",597,476,476,2,0,"C's",39
45,"45092",233,197,194,0,3,"C's",12
45,"45116",694,531,523,2,8,"C's",54
45,"45018",495,352,348,0,4,"C's",49
45,"45190",483,397,387,2,10,"C's",26
45,"45002",2549,1810,1784,7,26,"C's",177
45,"45135",4302,3509,3453,21,56,"C's",322
45,"45043",793,663,655,1,8,"C's",60
45,"45159",86,75,72,1,3,"C's",9
45,"45035",298,225,221,2,4,"C's",23
45,"45025",1198,921,910,2,11,"C's",125
45,"45041",3725,2698,2665,18,33,"C's",463
45,"45086",503,375,369,3,6,"C's",29
45,"45141",897,735,727,4,8,"C's",51
45,"45012",670,521,506,4,15,"C's",57
45,"45117",754,610,602,2,8,"C's",36
45,"45123",3075,2261,2222,11,39,"C's",453
45,"45170",235,183,176,4,7,"C's",9
45,"45024",1075,828,824,5,4,"C's",59
45,"45182",1045,854,844,3,10,"C's",62
45,"45130",319,258,252,1,6,"C's",20
45,"45145",2539,1830,1811,11,19,"C's",290
45,"45028",3680,2919,2880,23,39,"C's",270
45,"45158",2534,1885,1868,8,17,"C's",194
45,"45175",665,541,532,5,9,"C's",23
45,"45045",1316,945,935,1,10,"C's",111
45,"45070",1461,1223,1202,7,21,"C's",120
45,"45050",471,354,351,2,3,"C's",41
45,"45167",1458,1197,1187,5,10,"C's",114
45,"45052",2914,2389,2372,23,17,"C's",489
45,"45181",2313,1755,1728,12,27,"C's",180
45,"45091",407,301,299,2,2,"C's",41
45,"45039",226,197,193,1,4,"C's",26
45,"45157",2125,1531,1509,14,22,"C's",208
45,"45036",658,500,496,2,4,"C's",29
45,"45108",521,415,414,2,1,"C's",29
45,"45198",1832,1521,1508,6,13,"C's",147
45,"45102",3629,2685,2644,15,41,"C's",343
45,"45163",8338,6270,6142,57,128,"C's",1096
45,"45188",2783,2161,2127,9,34,"C's",294
45,"45058",384,304,301,4,3,"C's",14
45,"45030",482,364,361,4,3,"C's",26
45,"45098",2186,1686,1649,10,37,"C's",118
45,"45194",67,50,49,0,1,"C's",3
45,"45010",436,335,333,2,2,"C's",19
45,"45200",4627,3678,3588,29,90,"C's",346
45,"45119",3348,2306,2264,14,42,"C's",343
45,"45149",573,486,484,0,2,"C's",30
45,"45151",586,444,437,1,7,"C's",32
45,"45049",435,330,326,0,4,"C's",33
45,"45100",197,166,164,2,2,"C's",18
45,"45134",1600,1214,1200,4,14,"C's",87
45,"45082",1246,1046,1036,9,10,"C's",73
45,"45040",1396,871,862,4,9,"C's",59
45,"45021",2459,1862,1833,21,29,"C's",241
45,"45062",1121,910,894,10,16,"C's",68
45,"45008",142,114,114,2,0,"C's",4
45,"45173",9477,7145,7061,40,84,"C's",1073
45,"45111",60,47,47,0,0,"C's",1
45,"45169",193,136,136,1,0,"C's",18
45,"45137",1623,1106,1093,9,13,"C's",105
45,"45014",3984,2824,2802,24,22,"C's",315
45,"45161",13474,9618,9496,63,122,"C's",2156
45,"45114",595,461,457,1,4,"C's",39
45,"45084",2280,1777,1747,12,30,"C's",128
45,"45016",4179,3290,3268,30,22,"C's",550
45,"45901",769,577,571,1,6,"C's",48
45,"45204",643,519,513,0,6,"C's",85
45,"45162",683,515,510,0,5,"C's",35
45,"45140",1093,885,876,4,9,"C's",71
45,"45120",134,105,105,1,0,"C's",10
45,"45088",2102,1438,1423,4,15,"C's",211
45,"45048",360,281,277,1,4,"C's",22
45,"45153",1613,1263,1248,11,15,"C's",153
45,"45106",7524,5882,5784,55,98,"C's",512
45,"45126",260,169,167,1,2,"C's",17
45,"45180",2725,2060,2028,7,32,"C's",314
5,"5176",234,190,187,2,3,"PSOE",32
5,"5096",79,57,57,0,0,"PSOE",21
5,"5132",992,678,672,2,6,"PSOE",150
5,"5190",55,42,42,2,0,"PSOE",3
5,"5235",124,111,110,1,1,"PSOE",37
5,"5134",48,40,40,0,0,"PSOE",10
5,"5109",454,378,362,3,16,"PSOE",91
5,"5149",105,76,75,0,1,"PSOE",11
5,"5241",3081,2143,2115,17,28,"PSOE",443
5,"5092",155,120,120,0,0,"PSOE",18
5,"5045",95,70,70,0,0,"PSOE",14
5,"5133",67,55,55,1,0,"PSOE",15
5,"5002",1954,1471,1450,9,21,"PSOE",348
5,"5178",371,295,289,0,6,"PSOE",48
5,"5213",101,83,83,0,0,"PSOE",14
5,"5124",107,83,81,1,2,"PSOE",11
5,"5126",70,59,59,0,0,"PSOE",9
5,"5182",801,559,546,9,13,"PSOE",112
5,"5064",103,87,87,1,0,"PSOE",12
5,"5077",161,137,136,2,1,"PSOE",43
5,"5048",120,104,103,0,1,"PSOE",29
5,"5106",36,27,27,0,0,"PSOE",2
5,"5163",1756,1351,1345,1,6,"PSOE",285
5,"5212",233,157,155,1,2,"PSOE",27
5,"5121",241,186,185,3,1,"PSOE",35
5,"5198",73,59,59,0,0,"PSOE",4
5,"5249",107,82,82,0,0,"PSOE",12
5,"5108",51,30,30,0,0,"PSOE",12
5,"5162",87,60,60,2,0,"PSOE",14
5,"5247",250,147,146,1,1,"PSOE",33
5,"5029",123,92,89,0,3,"PSOE",18
5,"5122",144,115,113,1,2,"PSOE",29
5,"5027",269,220,218,2,2,"PSOE",25
5,"5021",1932,1478,1456,12,22,"PSOE",284
5,"5007",113,74,74,1,0,"PSOE",5
5,"5219",39,28,28,0,0,"PSOE",5
5,"5234",51,46,46,1,0,"PSOE",6
5,"5193",194,163,163,1,0,"PSOE",46
5,"5016",6335,4873,4775,39,98,"PSOE",908
5,"5171",73,58,57,2,1,"PSOE",4
5,"5138",311,241,239,3,2,"PSOE",36
5,"5083",145,108,100,2,8,"PSOE",12
5,"5158",371,289,287,1,2,"PSOE",57
5,"5239",207,163,162,1,1,"PSOE",32
5,"5024",231,169,163,5,6,"PSOE",30
5,"5175",159,130,130,0,0,"PSOE",17
5,"5151",93,70,70,1,0,"PSOE",12
5,"5222",159,126,126,0,0,"PSOE",21
5,"5107",64,39,39,1,0,"PSOE",3
5,"5221",353,270,264,3,6,"PSOE",69
5,"5254",196,166,166,0,0,"PSOE",39
5,"5170",52,46,46,0,0,"PSOE",9
5,"5210",85,72,72,1,0,"PSOE",10
5,"5041",1001,772,765,10,7,"PSOE",98
5,"5055",576,476,467,0,9,"PSOE",126
5,"5128",350,289,284,4,5,"PSOE",89
5,"5157",240,170,167,1,3,"PSOE",56
5,"5214",38,27,26,0,1,"PSOE",5
5,"5069",74,58,58,0,0,"PSOE",4
5,"5001",194,153,152,1,1,"PSOE",36
5,"5125",57,45,44,0,1,"PSOE",8
5,"5018",29,21,21,0,0,"PSOE",6
5,"5168",3565,2740,2711,17,29,"PSOE",494
5,"5114",1359,1131,1115,5,16,"PSOE",517
5,"5197",98,90,90,0,0,"PSOE",12
5,"5220",382,298,294,1,4,"PSOE",47
5,"5236",128,85,84,0,1,"PSOE",17
5,"5057",2470,1977,1953,14,24,"PSOE",786
5,"5042",155,126,125,0,1,"PSOE",26
5,"5070",32,26,26,0,0,"PSOE",11
5,"5204",611,473,471,1,2,"PSOE",114
5,"5230",65,56,54,1,2,"PSOE",3
5,"5035",107,84,84,1,0,"PSOE",32
5,"5087",137,93,93,0,0,"PSOE",7
5,"5135",425,325,322,1,3,"PSOE",70
5,"5166",188,135,134,1,1,"PSOE",13
5,"5053",86,58,58,0,0,"PSOE",4
5,"5131",105,70,69,1,1,"PSOE",9
5,"5140",116,97,96,0,1,"PSOE",16
5,"5144",79,62,60,2,2,"PSOE",19
5,"5005",187,150,149,0,1,"PSOE",30
5,"5019",44606,34903,34564,285,339,"PSOE",5187
5,"5102",1807,1431,1412,7,19,"PSOE",369
5,"5062",184,155,154,2,1,"PSOE",23
5,"5037",261,165,163,3,2,"PSOE",27
5,"5192",100,82,81,1,1,"PSOE",13
5,"5231",160,126,124,1,2,"PSOE",41
5,"5267",100,65,64,0,1,"PSOE",12
5,"5099",497,398,381,3,17,"PSOE",165
5,"5164",27,19,19,1,0,"PSOE",4
5,"5112",97,72,70,1,2,"PSOE",6
5,"5017",85,75,75,0,0,"PSOE",11
5,"5067",83,66,59,1,7,"PSOE",10
5,"5013",876,733,723,2,10,"PSOE",157
5,"5116",118,95,93,1,2,"PSOE",11
5,"5085",38,29,29,0,0,"PSOE",2
5,"5160",323,263,260,1,3,"PSOE",34
5,"5051",181,152,147,3,5,"PSOE",29
5,"5104",34,23,22,1,1,"PSOE",3
5,"5905",214,150,150,1,0,"PSOE",14
5,"5211",465,375,373,2,2,"PSOE",85
5,"5143",66,55,55,1,0,"PSOE",7
5,"5100",285,229,228,0,1,"PSOE",48
5,"5086",82,66,64,1,2,"PSOE",12
5,"5208",40,34,34,0,0,"PSOE",6
5,"5216",224,155,155,2,0,"PSOE",15
5,"5118",84,57,57,0,0,"PSOE",11
5,"5047",4199,3287,3244,7,43,"PSOE",1151
5,"5056",96,73,73,0,0,"PSOE",12
5,"5075",107,67,67,0,0,"PSOE",11
5,"5043",84,67,67,0,0,"PSOE",23
5,"5251",68,40,40,0,0,"PSOE",9
5,"5105",349,279,270,3,9,"PSOE",60
5,"5072",87,70,69,1,1,"PSOE",7
5,"5115",532,392,386,2,6,"PSOE",56
5,"5012",135,110,108,0,2,"PSOE",23
5,"5265",82,70,70,0,0,"PSOE",8
5,"5183",140,114,113,1,1,"PSOE",18
5,"5025",96,73,72,1,1,"PSOE",10
5,"5127",650,539,535,4,4,"PSOE",139
5,"5036",123,97,97,0,0,"PSOE",6
5,"5093",417,313,311,1,2,"PSOE",50
5,"5159",254,175,174,2,1,"PSOE",4
5,"5217",58,45,45,0,0,"PSOE",9
5,"5054",1238,953,933,1,20,"PSOE",251
5,"5120",35,26,26,0,0,"PSOE",6
5,"5147",162,119,116,0,3,"PSOE",7
5,"5218",121,97,95,0,2,"PSOE",23
5,"5022",1611,1279,1271,4,8,"PSOE",170
5,"5155",52,37,37,0,0,"PSOE",7
5,"5103",78,56,56,0,0,"PSOE",6
5,"5046",45,38,38,1,0,"PSOE",14
5,"5136",97,74,73,5,1,"PSOE",18
5,"5904",133,92,91,1,1,"PSOE",13
5,"5245",348,293,288,0,5,"PSOE",50
5,"5263",172,137,137,0,0,"PSOE",17
5,"5196",53,39,39,0,0,"PSOE",18
5,"5095",266,220,218,0,2,"PSOE",54
5,"5023",173,153,153,5,0,"PSOE",45
5,"5199",39,32,32,0,0,"PSOE",1
5,"5153",108,78,77,3,1,"PSOE",11
5,"5185",94,80,80,1,0,"PSOE",10
5,"5074",693,543,540,1,3,"PSOE",134
5,"5052",99,89,88,0,1,"PSOE",5
5,"5256",116,92,92,1,0,"PSOE",28
5,"5194",138,122,121,5,1,"PSOE",28
5,"5233",226,179,177,0,2,"PSOE",34
5,"5065",469,388,385,6,3,"PSOE",65
5,"5060",120,99,99,1,0,"PSOE",15
5,"5130",95,82,82,0,0,"PSOE",30
5,"5902",288,227,227,0,0,"PSOE",50
5,"5227",373,250,248,0,2,"PSOE",60
5,"5152",690,561,558,3,3,"PSOE",107
5,"5206",29,22,21,0,1,"PSOE",5
5,"5079",70,54,54,0,0,"PSOE",2
5,"5015",87,66,65,1,1,"PSOE",18
5,"5061",253,198,196,4,2,"PSOE",47
5,"5252",64,45,45,0,0,"PSOE",3
5,"5209",83,63,63,0,0,"PSOE",11
5,"5246",60,42,42,0,0,"PSOE",13
5,"5188",45,38,38,0,0,"PSOE",7
5,"5066",458,365,364,3,1,"PSOE",106
5,"5097",474,324,317,3,7,"PSOE",83
5,"5145",52,41,41,0,0,"PSOE",9
5,"5215",169,126,122,2,4,"PSOE",21
5,"5040",68,45,45,0,0,"PSOE",6
5,"5161",586,483,473,2,10,"PSOE",106
5,"5058",78,55,55,2,0,"PSOE",6
5,"5026",197,170,169,1,1,"PSOE",23
5,"5033",174,139,138,0,1,"PSOE",25
5,"5089",478,377,365,0,12,"PSOE",81
5,"5141",95,86,86,2,0,"PSOE",17
5,"5237",164,131,126,1,5,"PSOE",6
5,"5139",76,66,66,0,0,"PSOE",2
5,"5148",27,17,17,0,0,"PSOE",2
5,"5073",297,243,238,4,5,"PSOE",29
5,"5172",123,104,102,2,2,"PSOE",28
5,"5165",380,291,283,5,8,"PSOE",45
5,"5063",34,24,24,0,0,"PSOE",1
5,"5191",126,104,104,1,0,"PSOE",22
5,"5207",697,553,548,0,5,"PSOE",200
5,"5240",3393,2354,2335,9,19,"PSOE",515
5,"5244",51,38,38,0,0,"PSOE",3
5,"5082",528,437,427,5,10,"PSOE",111
5,"5173",60,45,45,0,0,"PSOE",3
5,"5242",681,538,527,10,11,"PSOE",82
5,"5238",787,565,556,4,9,"PSOE",168
5,"5090",84,69,68,1,1,"PSOE",14
5,"5174",69,55,55,1,0,"PSOE",11
5,"5225",372,316,315,5,1,"PSOE",48
5,"5187",1755,1409,1395,11,14,"PSOE",324
5,"5088",33,24,24,0,0,"PSOE",3
5,"5259",125,107,106,3,1,"PSOE",23
5,"5119",33,20,20,0,0,"PSOE",2
5,"5167",265,209,199,0,10,"PSOE",81
5,"5101",316,240,238,1,2,"PSOE",38
5,"5010",149,119,118,1,1,"PSOE",21
5,"5044",259,180,180,0,0,"PSOE",29
5,"5076",481,401,387,5,14,"PSOE",58
5,"5169",226,178,176,1,2,"PSOE",28
5,"5205",75,58,58,0,0,"PSOE",14
5,"5258",113,98,97,0,1,"PSOE",24
5,"5080",59,42,40,0,2,"PSOE",6
5,"5201",529,439,431,2,8,"PSOE",119
5,"5186",1572,1240,1222,9,18,"PSOE",221
5,"5253",88,70,70,0,0,"PSOE",6
5,"5142",104,88,82,1,6,"PSOE",12
5,"5014",5422,4137,4084,30,53,"PSOE",1016
5,"5200",49,28,28,0,0,"PSOE",7
5,"5049",399,301,291,1,10,"PSOE",62
5,"5177",160,128,128,1,0,"PSOE",56
5,"5228",179,126,126,0,0,"PSOE",6
5,"5261",42,26,26,0,0,"PSOE",2
5,"5264",62,43,42,1,1,"PSOE",4
5,"5078",115,100,99,3,1,"PSOE",11
5,"5257",140,98,98,0,0,"PSOE",16
5,"5229",84,67,67,0,0,"PSOE",10
5,"5262",358,278,277,1,1,"PSOE",97
5,"5081",39,33,31,0,2,"PSOE",6
5,"5195",224,162,161,1,1,"PSOE",34
5,"5232",98,83,81,1,2,"PSOE",10
5,"5260",104,84,83,1,1,"PSOE",14
5,"5189",443,340,336,3,4,"PSOE",76
5,"5034",15,12,12,1,0,"PSOE",0
5,"5038",116,87,85,0,2,"PSOE",1
5,"5008",227,180,176,2,4,"PSOE",48
5,"5129",129,78,78,0,0,"PSOE",4
5,"5154",36,30,30,0,0,"PSOE",7
5,"5117",201,178,174,2,4,"PSOE",25
5,"5030",46,37,37,0,0,"PSOE",7
5,"5903",157,108,107,0,1,"PSOE",32
5,"5084",74,56,56,1,0,"PSOE",15
5,"5094",140,110,110,0,0,"PSOE",10
5,"5123",96,69,66,2,3,"PSOE",8
5,"5156",249,163,161,0,2,"PSOE",22
5,"5243",88,61,61,1,0,"PSOE",13
5,"5179",215,184,180,0,4,"PSOE",14
5,"5059",109,79,76,1,3,"PSOE",15
5,"5039",56,43,42,0,1,"PSOE",4
5,"5901",273,187,185,5,2,"PSOE",28
5,"5181",43,31,31,1,0,"PSOE",9
5,"5226",77,57,57,0,0,"PSOE",4
5,"5110",721,559,552,3,7,"PSOE",78
5,"5224",106,87,86,0,1,"PSOE",7
5,"5113",78,58,58,1,0,"PSOE",6
5,"5184",250,197,192,0,5,"PSOE",41
5,"5180",88,68,68,1,0,"PSOE",3
5,"5266",102,89,89,0,0,"PSOE",11
44,"44027",161,122,121,4,1,"PCPE",0
44,"44210",759,597,596,2,1,"PCPE",0
44,"44038",107,83,83,2,0,"PCPE",0
44,"44132",61,50,50,1,0,"PCPE",0
44,"44143",388,310,309,3,1,"PCPE",4
44,"44008",1615,1217,1200,7,17,"PCPE",2
44,"44249",57,47,47,3,0,"PCPE",0
44,"44130",34,24,24,0,0,"PCPE",0
44,"44171",183,136,135,1,1,"PCPE",0
44,"44035",117,81,81,0,0,"PCPE",0
44,"44125",65,39,39,0,0,"PCPE",0
44,"44071",599,430,424,8,6,"PCPE",0
44,"44076",2234,1759,1729,16,30,"PCPE",1
44,"44046",48,31,31,2,0,"PCPE",0
44,"44101",59,44,44,0,0,"PCPE",0
44,"44219",198,141,134,4,7,"PCPE",0
44,"44247",314,230,228,2,2,"PCPE",0
44,"44088",30,26,26,2,0,"PCPE",0
44,"44152",67,48,48,1,0,"PCPE",0
44,"44060",40,35,35,1,0,"PCPE",0
44,"44063",78,61,61,0,0,"PCPE",0
44,"44229",151,108,107,1,1,"PCPE",0
44,"44267",71,50,50,0,0,"PCPE",0
44,"44050",3129,2135,2103,30,32,"PCPE",3
44,"44216",26539,19621,19346,248,275,"PCPE",19
44,"44012",336,279,276,2,3,"PCPE",0
44,"44154",261,194,191,3,3,"PCPE",0
44,"44203",10,8,8,0,0,"PCPE",0
44,"44061",71,57,54,1,3,"PCPE",0
44,"44025",6062,4490,4394,48,96,"PCPE",4
44,"44023",18,15,15,0,0,"PCPE",0
44,"44103",130,106,106,0,0,"PCPE",0
44,"44145",1029,768,763,7,5,"PCPE",0
44,"44200",40,22,22,0,0,"PCPE",0
44,"44251",254,202,194,2,8,"PCPE",0
44,"44036",24,16,16,0,0,"PCPE",0
44,"44112",426,293,284,2,9,"PCPE",0
44,"44163",128,94,94,0,0,"PCPE",0
44,"44059",541,431,423,7,8,"PCPE",0
44,"44127",73,51,50,0,1,"PCPE",0
44,"44065",55,36,36,1,0,"PCPE",0
44,"44165",184,153,152,1,1,"PCPE",0
44,"44224",22,14,14,0,0,"PCPE",0
44,"44252",85,67,66,0,1,"PCPE",0
44,"44182",194,155,154,3,1,"PCPE",0
44,"44029",567,475,467,5,8,"PCPE",1
44,"44114",244,186,185,3,1,"PCPE",0
44,"44102",31,25,25,0,0,"PCPE",0
44,"44128",69,50,50,0,0,"PCPE",0
44,"44039",219,162,160,2,2,"PCPE",0
44,"44068",664,519,515,4,4,"PCPE",0
44,"44017",285,221,220,0,1,"PCPE",1
44,"44250",19,12,12,2,0,"PCPE",0
44,"44157",65,41,40,0,1,"PCPE",0
44,"44234",62,48,48,1,0,"PCPE",0
44,"44263",369,265,259,2,6,"PCPE",0
44,"44092",80,53,52,0,1,"PCPE",0
44,"44105",80,62,62,0,0,"PCPE",0
44,"44141",135,105,104,1,1,"PCPE",1
44,"44011",57,35,35,0,0,"PCPE",0
44,"44090",82,57,57,0,0,"PCPE",0
44,"44085",52,40,40,4,0,"PCPE",0
44,"44177",111,77,76,1,1,"PCPE",0
44,"44113",72,50,50,0,0,"PCPE",0
44,"44207",158,119,115,0,4,"PCPE",0
44,"44148",93,76,76,3,0,"PCPE",0
44,"44151",191,147,145,1,2,"PCPE",0
44,"44155",1102,831,825,7,6,"PCPE",3
44,"44032",16,13,13,0,0,"PCPE",0
44,"44212",41,32,32,0,0,"PCPE",0
44,"44042",127,93,92,1,1,"PCPE",1
44,"44064",70,51,51,0,0,"PCPE",0
44,"44048",65,51,51,0,0,"PCPE",0
44,"44262",137,107,107,1,0,"PCPE",0
44,"44146",173,157,157,1,0,"PCPE",0
44,"44192",364,280,278,0,2,"PCPE",0
44,"44006",250,188,186,1,2,"PCPE",0
44,"44195",92,61,61,2,0,"PCPE",0
44,"44136",49,42,42,1,0,"PCPE",0
44,"44109",110,76,74,1,2,"PCPE",0
44,"44220",121,85,82,2,3,"PCPE",1
44,"44034",138,112,110,2,2,"PCPE",0
44,"44044",91,70,70,0,0,"PCPE",0
44,"44070",55,47,46,1,1,"PCPE",0
44,"44122",1356,971,969,12,2,"PCPE",1
44,"44028",191,150,142,1,8,"PCPE",0
44,"44173",101,85,84,0,1,"PCPE",0
44,"44240",161,128,125,0,3,"PCPE",0
44,"44232",391,286,279,4,7,"PCPE",0
44,"44107",216,162,162,1,0,"PCPE",1
44,"44137",205,159,159,2,0,"PCPE",0
44,"44206",112,90,88,0,2,"PCPE",1
44,"44174",430,314,313,2,1,"PCPE",0
44,"44227",75,63,63,0,0,"PCPE",0
44,"44005",54,38,37,2,1,"PCPE",0
44,"44197",58,34,34,0,0,"PCPE",0
44,"44118",165,127,125,2,2,"PCPE",0
44,"44218",37,26,26,0,0,"PCPE",0
44,"44228",99,79,79,1,0,"PCPE",0
44,"44033",279,193,191,2,2,"PCPE",1
44,"44208",34,22,22,0,0,"PCPE",0
44,"44243",23,18,18,0,0,"PCPE",0
44,"44031",99,64,64,0,0,"PCPE",0
44,"44211",40,30,30,0,0,"PCPE",0
44,"44133",23,17,17,0,0,"PCPE",0
44,"44190",72,53,52,0,1,"PCPE",0
44,"44184",48,30,30,0,0,"PCPE",0
44,"44175",121,91,89,2,2,"PCPE",0
44,"44167",38,31,31,0,0,"PCPE",0
44,"44120",222,140,138,2,2,"PCPE",0
44,"44021",107,83,83,2,0,"PCPE",0
44,"44014",2530,2008,1966,17,42,"PCPE",1
44,"44019",68,49,48,1,1,"PCPE",0
44,"44209",839,640,623,3,17,"PCPE",0
44,"44111",92,69,69,0,0,"PCPE",0
44,"44225",111,76,76,4,0,"PCPE",0
44,"44080",292,221,218,4,3,"PCPE",0
44,"44110",52,46,44,0,2,"PCPE",0
44,"44045",355,290,286,2,4,"PCPE",0
44,"44196",134,102,102,1,0,"PCPE",0
44,"44043",108,75,75,1,0,"PCPE",0
44,"44189",58,40,40,1,0,"PCPE",0
44,"44040",202,160,158,3,2,"PCPE",0
44,"44062",35,27,26,0,1,"PCPE",0
44,"44266",118,95,95,0,0,"PCPE",0
44,"44131",26,20,20,0,0,"PCPE",0
44,"44135",115,89,86,0,3,"PCPE",0
44,"44086",453,355,350,3,5,"PCPE",0
44,"44054",109,90,90,0,0,"PCPE",0
44,"44097",147,89,87,1,2,"PCPE",0
44,"44223",75,55,55,2,0,"PCPE",0
44,"44169",351,268,266,3,2,"PCPE",0
44,"44179",345,229,227,2,2,"PCPE",0
44,"44245",250,189,186,1,3,"PCPE",0
44,"44121",60,43,43,0,0,"PCPE",0
44,"44231",38,32,32,0,0,"PCPE",0
44,"44093",76,60,60,0,0,"PCPE",0
44,"44201",497,414,410,2,4,"PCPE",1
44,"44246",1554,1091,1079,13,12,"PCPE",1
44,"44164",26,22,22,0,0,"PCPE",0
44,"44123",105,69,69,1,0,"PCPE",0
44,"44001",68,50,50,0,0,"PCPE",0
44,"44009",809,586,578,5,8,"PCPE",2
44,"44258",69,46,46,0,0,"PCPE",0
44,"44084",55,45,45,0,0,"PCPE",0
44,"44096",161,141,139,0,2,"PCPE",0
44,"44077",75,58,57,0,1,"PCPE",1
44,"44124",78,58,58,1,0,"PCPE",0
44,"44117",347,278,274,2,4,"PCPE",0
44,"44056",513,348,341,4,7,"PCPE",0
44,"44002",54,41,41,0,0,"PCPE",0
44,"44268",28,24,24,0,0,"PCPE",0
44,"44217",28,20,20,0,0,"PCPE",0
44,"44149",99,71,71,3,0,"PCPE",1
44,"44260",139,100,98,2,2,"PCPE",0
44,"44264",253,211,210,2,1,"PCPE",4
44,"44100",187,154,153,0,1,"PCPE",0
44,"44153",1812,1209,1196,15,13,"PCPE",3
44,"44237",408,327,321,2,6,"PCPE",0
44,"44199",43,36,36,1,0,"PCPE",0
44,"44094",113,102,100,1,2,"PCPE",1
44,"44185",104,77,77,0,0,"PCPE",0
44,"44230",155,126,126,2,0,"PCPE",0
44,"44187",199,148,143,1,5,"PCPE",0
44,"44159",39,34,34,0,0,"PCPE",0
44,"44024",27,23,23,0,0,"PCPE",0
44,"44075",324,256,250,4,6,"PCPE",0
44,"44222",137,96,96,0,0,"PCPE",0
44,"44049",850,624,613,8,11,"PCPE",0
44,"44235",91,71,70,2,1,"PCPE",0
44,"44205",712,474,468,6,6,"PCPE",0
44,"44158",1170,898,872,12,26,"PCPE",1
44,"44047",221,139,135,0,4,"PCPE",1
44,"44004",415,295,291,3,4,"PCPE",3
44,"44257",167,120,120,1,0,"PCPE",1
44,"44108",331,238,234,4,4,"PCPE",0
44,"44172",310,216,216,6,0,"PCPE",0
44,"44215",156,105,103,2,2,"PCPE",0
44,"44010",178,124,121,2,3,"PCPE",0
44,"44144",351,256,252,1,4,"PCPE",0
44,"44194",111,79,75,0,4,"PCPE",0
44,"44198",187,151,148,3,3,"PCPE",0
44,"44129",41,34,34,0,0,"PCPE",0
44,"44180",71,57,56,1,1,"PCPE",0
44,"44183",77,45,44,0,1,"PCPE",0
44,"44022",490,323,316,9,7,"PCPE",1
44,"44138",140,79,77,0,2,"PCPE",0
44,"44168",191,137,131,3,6,"PCPE",0
44,"44026",90,71,71,0,0,"PCPE",0
44,"44067",117,80,80,0,0,"PCPE",0
44,"44066",110,83,83,1,0,"PCPE",0
44,"44074",430,338,329,5,9,"PCPE",1
44,"44176",160,127,127,0,0,"PCPE",1
44,"44126",334,239,235,7,4,"PCPE",0
44,"44052",80,55,54,0,1,"PCPE",0
44,"44221",365,298,296,2,2,"PCPE",1
44,"44241",537,408,403,2,5,"PCPE",0
44,"44013",11254,8292,8205,82,87,"PCPE",14
44,"44018",20,20,20,0,0,"PCPE",0
44,"44099",708,514,510,1,4,"PCPE",0
44,"44147",419,312,307,5,5,"PCPE",1
44,"44020",24,20,19,1,1,"PCPE",0
44,"44150",32,21,20,0,1,"PCPE",0
44,"44082",91,68,67,0,1,"PCPE",0
44,"44238",2345,1743,1729,7,14,"PCPE",1
44,"44181",78,63,63,1,0,"PCPE",0
44,"44003",19,16,16,0,0,"PCPE",0
44,"44178",56,42,42,0,0,"PCPE",0
44,"44089",46,42,42,0,0,"PCPE",0
44,"44160",478,329,322,5,7,"PCPE",0
44,"44193",82,62,62,1,0,"PCPE",0
44,"44055",69,52,51,3,1,"PCPE",0
44,"44213",63,47,47,0,0,"PCPE",0
44,"44156",46,33,32,1,1,"PCPE",0
44,"44236",59,45,45,0,0,"PCPE",0
44,"44256",39,34,34,1,0,"PCPE",0
44,"44051",2704,2074,2046,32,28,"PCPE",3
44,"44041",54,46,46,2,0,"PCPE",0
44,"44261",734,552,542,8,10,"PCPE",0
44,"44161",447,324,320,3,4,"PCPE",0
44,"44191",771,595,586,7,9,"PCPE",0
44,"44087",81,70,70,3,0,"PCPE",0
44,"44226",141,102,100,2,2,"PCPE",0
44,"44204",25,22,22,0,0,"PCPE",1
44,"44119",135,94,90,2,4,"PCPE",1
44,"44053",102,79,73,0,6,"PCPE",1
44,"44116",83,67,65,1,2,"PCPE",0
44,"44007",184,124,120,0,4,"PCPE",0
44,"44239",22,20,20,0,0,"PCPE",0
44,"44142",36,27,27,5,0,"PCPE",0
44,"44265",188,144,138,2,6,"PCPE",0
44,"44115",106,93,92,4,1,"PCPE",0
44,"44037",453,326,321,5,5,"PCPE",0
44,"44244",75,39,39,0,0,"PCPE",0
44,"44106",159,127,126,3,1,"PCPE",0
44,"44016",486,361,357,7,4,"PCPE",0
24,"24144",704,487,478,5,9,"PACMA",1
24,"24113",366,282,275,3,7,"PACMA",2
24,"24078",388,286,284,4,2,"PACMA",2
24,"24181",1519,1135,1117,10,18,"PACMA",1
24,"24042",61,48,48,1,0,"PACMA",0
24,"24176",318,244,243,5,1,"PACMA",2
24,"24180",1128,825,814,12,11,"PACMA",5
24,"24073",481,343,340,3,3,"PACMA",1
24,"24169",2976,2256,2236,12,20,"PACMA",10
24,"24026",1203,908,898,19,10,"PACMA",3
24,"24057",1366,1103,1076,11,27,"PACMA",4
24,"24066",504,367,361,3,6,"PACMA",0
24,"24028",386,304,302,3,2,"PACMA",1
24,"24168",461,383,379,4,4,"PACMA",2
24,"24015",2279,1693,1658,22,35,"PACMA",5
24,"24158",323,210,207,0,3,"PACMA",0
24,"24185",482,357,349,4,8,"PACMA",0
24,"24136",544,391,390,8,1,"PACMA",1
24,"24212",1029,784,774,7,10,"PACMA",4
24,"24155",478,380,371,0,9,"PACMA",3
24,"24049",1493,1152,1138,8,14,"PACMA",2
24,"24116",424,276,273,0,3,"PACMA",0
24,"24080",218,170,162,3,8,"PACMA",0
24,"24177",481,328,327,1,1,"PACMA",0
24,"24060",615,361,359,0,2,"PACMA",0
24,"24090",348,226,224,1,2,"PACMA",0
24,"24098",1205,880,874,8,6,"PACMA",4
24,"24205",967,714,706,9,8,"PACMA",5
24,"24044",171,125,118,0,7,"PACMA",1
24,"24219",527,390,387,2,3,"PACMA",1
24,"24214",669,492,490,1,2,"PACMA",1
24,"24187",876,642,631,6,11,"PACMA",3
24,"24081",142,97,97,0,0,"PACMA",0
24,"24070",4159,3206,3162,31,44,"PACMA",16
24,"24154",1010,750,729,7,21,"PACMA",2
24,"24039",2077,1604,1600,39,4,"PACMA",4
24,"24091",657,440,437,2,3,"PACMA",1
24,"24069",42,36,36,0,0,"PACMA",0
24,"24193",384,277,276,4,1,"PACMA",4
24,"24032",111,82,82,1,0,"PACMA",0
24,"24010",8426,5980,5888,61,92,"PACMA",32
24,"24043",135,69,67,0,2,"PACMA",0
24,"24150",243,175,175,3,0,"PACMA",0
24,"24021",1688,1213,1189,6,24,"PACMA",6
24,"24087",645,469,466,11,3,"PACMA",1
24,"24156",243,169,169,1,0,"PACMA",0
24,"24034",3419,2596,2556,27,40,"PACMA",7
24,"24064",1525,1165,1151,10,14,"PACMA",4
24,"24145",655,445,443,8,2,"PACMA",0
24,"24171",364,219,217,1,2,"PACMA",0
24,"24079",922,654,645,9,9,"PACMA",2
24,"24089",103315,77803,77038,779,765,"PACMA",562
24,"24146",271,195,194,0,1,"PACMA",0
24,"24153",233,173,172,3,1,"PACMA",2
24,"24902",354,273,272,2,1,"PACMA",1
24,"24067",645,383,379,2,4,"PACMA",0
24,"24088",1037,804,797,8,7,"PACMA",3
24,"24092",809,619,609,1,10,"PACMA",0
24,"24217",136,110,109,1,1,"PACMA",2
24,"24006",488,351,342,4,9,"PACMA",3
24,"24002",236,182,180,3,2,"PACMA",0
24,"24125",475,285,282,2,3,"PACMA",1
24,"24222",14249,10663,10532,119,131,"PACMA",99
24,"24016",478,287,285,1,2,"PACMA",3
24,"24225",1020,786,773,6,13,"PACMA",5
24,"24197",770,545,537,6,8,"PACMA",4
24,"24001",188,108,108,0,0,"PACMA",0
24,"24030",4297,3226,3180,16,46,"PACMA",11
24,"24215",156,119,118,1,1,"PACMA",0
24,"24018",177,143,141,0,2,"PACMA",0
24,"24133",350,259,258,3,1,"PACMA",3
24,"24191",111,84,84,1,0,"PACMA",0
24,"24159",1832,1407,1391,17,16,"PACMA",5
24,"24019",359,293,291,3,2,"PACMA",2
24,"24127",301,239,239,3,0,"PACMA",0
24,"24134",3465,2628,2583,27,45,"PACMA",9
24,"24063",391,260,259,1,1,"PACMA",1
24,"24012",297,212,211,4,1,"PACMA",0
24,"24164",373,190,190,1,0,"PACMA",0
24,"24053",439,303,298,2,5,"PACMA",1
24,"24055",705,510,507,6,3,"PACMA",1
24,"24005",387,267,259,6,8,"PACMA",1
24,"24110",1253,932,926,7,6,"PACMA",2
24,"24054",433,308,303,4,5,"PACMA",0
24,"24148",1684,1268,1256,9,12,"PACMA",10
24,"24095",314,246,244,1,2,"PACMA",5
24,"24074",99,77,76,1,1,"PACMA",0
24,"24027",1214,881,860,8,21,"PACMA",4
24,"24211",276,210,206,4,4,"PACMA",1
24,"24086",271,200,198,1,2,"PACMA",0
24,"24004",469,349,349,6,0,"PACMA",1
24,"24033",211,154,151,1,3,"PACMA",0
24,"24117",446,333,331,2,2,"PACMA",1
24,"24105",1443,1087,1065,10,22,"PACMA",21
24,"24084",162,119,119,1,0,"PACMA",0
24,"24082",870,692,682,10,10,"PACMA",3
24,"24099",173,133,133,2,0,"PACMA",0
24,"24162",1671,1314,1303,21,11,"PACMA",12
24,"24137",1114,811,804,9,7,"PACMA",7
24,"24188",3843,2962,2899,48,63,"PACMA",18
24,"24175",1825,1381,1372,13,9,"PACMA",8
24,"24031",216,169,167,1,2,"PACMA",0
24,"24050",102,77,77,1,0,"PACMA",0
24,"24172",420,218,216,1,2,"PACMA",0
24,"24025",300,233,228,0,5,"PACMA",0
24,"24119",702,491,480,6,11,"PACMA",3
24,"24210",510,347,347,0,0,"PACMA",1
24,"24051",433,308,307,1,1,"PACMA",4
24,"24170",1934,1436,1424,13,12,"PACMA",8
24,"24046",953,662,645,6,17,"PACMA",4
24,"24003",652,442,435,5,7,"PACMA",1
24,"24036",301,181,180,0,1,"PACMA",0
24,"24020",463,294,291,5,3,"PACMA",1
24,"24131",742,499,497,5,2,"PACMA",2
24,"24163",3929,3076,3044,49,32,"PACMA",26
24,"24151",492,357,357,1,0,"PACMA",1
24,"24022",342,227,227,0,0,"PACMA",3
24,"24203",96,73,72,1,1,"PACMA",0
24,"24094",1392,1048,1038,11,10,"PACMA",8
24,"24102",655,495,492,2,3,"PACMA",2
24,"24108",377,279,273,3,6,"PACMA",0
24,"24071",1006,747,738,9,9,"PACMA",0
24,"24224",621,452,445,7,7,"PACMA",1
24,"24202",8098,5654,5582,51,72,"PACMA",17
24,"24047",782,533,527,7,6,"PACMA",2
24,"24037",369,251,251,0,0,"PACMA",0
24,"24149",155,123,121,0,2,"PACMA",1
24,"24221",790,568,558,6,10,"PACMA",1
24,"24161",291,218,212,2,6,"PACMA",1
24,"24207",296,245,241,3,4,"PACMA",0
24,"24122",1351,965,948,9,17,"PACMA",1
24,"24058",205,137,134,0,3,"PACMA",0
24,"24096",124,74,74,0,0,"PACMA",2
24,"24173",943,678,673,3,5,"PACMA",1
24,"24123",757,499,497,4,2,"PACMA",0
24,"24041",548,384,381,5,3,"PACMA",5
24,"24196",2082,1529,1513,15,16,"PACMA",6
24,"24174",495,362,357,3,5,"PACMA",1
24,"24182",420,289,287,6,2,"PACMA",0
24,"24152",462,302,301,2,1,"PACMA",0
24,"24068",464,343,339,5,4,"PACMA",1
24,"24011",209,113,112,0,1,"PACMA",0
24,"24038",3107,2383,2354,30,29,"PACMA",10
24,"24107",244,184,183,2,1,"PACMA",0
24,"24143",514,391,379,4,12,"PACMA",0
24,"24040",453,315,309,2,6,"PACMA",3
24,"24061",1702,1244,1231,13,13,"PACMA",10
24,"24112",318,207,207,0,0,"PACMA",0
24,"24120",345,214,214,1,0,"PACMA",1
24,"24201",1086,765,757,5,8,"PACMA",6
24,"24097",225,146,145,1,1,"PACMA",0
24,"24206",1732,1303,1288,8,15,"PACMA",4
24,"24160",692,506,498,2,8,"PACMA",2
24,"24029",754,545,539,2,6,"PACMA",0
24,"24229",427,330,324,8,6,"PACMA",1
24,"24083",1077,764,755,4,9,"PACMA",4
24,"24017",582,434,433,9,1,"PACMA",3
24,"24141",98,76,75,0,1,"PACMA",0
24,"24184",206,121,120,0,1,"PACMA",0
24,"24093",380,249,248,3,1,"PACMA",4
24,"24157",2580,2013,1983,25,30,"PACMA",10
24,"24124",374,249,246,4,3,"PACMA",0
24,"24132",628,397,390,6,7,"PACMA",1
24,"24194",292,230,229,1,1,"PACMA",1
24,"24052",171,109,108,0,1,"PACMA",1
24,"24121",655,481,477,0,4,"PACMA",0
24,"24227",1617,1146,1142,14,4,"PACMA",13
24,"24129",122,85,85,1,0,"PACMA",0
24,"24104",266,180,179,0,1,"PACMA",0
24,"24009",322,161,161,1,0,"PACMA",0
24,"24065",2106,1573,1545,16,28,"PACMA",8
24,"24109",996,667,652,7,15,"PACMA",1
24,"24024",695,496,494,4,2,"PACMA",0
24,"24209",2790,1907,1884,15,23,"PACMA",3
24,"24179",299,202,201,8,1,"PACMA",1
24,"24062",142,105,105,1,0,"PACMA",0
24,"24130",437,319,315,1,4,"PACMA",3
24,"24059",887,520,512,8,8,"PACMA",0
24,"24189",6016,4187,4134,58,53,"PACMA",53
24,"24226",204,138,136,0,2,"PACMA",1
24,"24114",3107,2174,2155,7,19,"PACMA",16
24,"24223",2640,2012,2012,53,0,"PACMA",8
24,"24178",71,58,57,0,1,"PACMA",0
24,"24183",805,528,522,5,6,"PACMA",2
24,"24014",7474,5375,5321,56,54,"PACMA",28
24,"24901",908,660,653,4,7,"PACMA",3
24,"24218",454,331,329,3,2,"PACMA",2
24,"24199",433,284,281,3,3,"PACMA",2
24,"24230",423,329,324,2,5,"PACMA",2
24,"24198",602,411,402,4,9,"PACMA",1
24,"24115",54290,39886,39486,325,400,"PACMA",279
24,"24076",1279,972,953,7,19,"PACMA",7
24,"24190",167,115,115,2,0,"PACMA",0
24,"24023",268,189,188,2,1,"PACMA",1
24,"24008",9319,6964,6852,77,112,"PACMA",30
24,"24103",292,160,160,1,0,"PACMA",0
24,"24166",1413,1043,1014,7,29,"PACMA",7
24,"24007",764,578,576,3,2,"PACMA",1
24,"24167",763,509,504,9,5,"PACMA",4
24,"24213",158,117,117,0,0,"PACMA",0
24,"24056",2910,2102,2068,31,34,"PACMA",16
24,"24216",732,533,522,2,11,"PACMA",1
24,"24139",2186,1608,1570,24,38,"PACMA",9
24,"24101",404,264,262,2,2,"PACMA",1
24,"24106",258,178,173,1,5,"PACMA",0
24,"24228",666,455,449,2,6,"PACMA",3
24,"24100",769,569,561,4,8,"PACMA",0
24,"24077",227,195,192,1,3,"PACMA",0
24,"24118",127,84,84,1,0,"PACMA",0
24,"24165",373,254,250,2,4,"PACMA",0
24,"24142",25160,18503,18262,205,241,"PACMA",177
32,"32061",1093,852,840,3,12,"PSdeG-PSOE",261
32,"32026",2736,2039,1998,25,41,"PSdeG-PSOE",622
32,"32045",2484,1820,1795,19,25,"PSdeG-PSOE",505
32,"32066",567,435,434,2,1,"PSdeG-PSOE",69
32,"32055",1310,952,936,7,16,"PSdeG-PSOE",176
32,"32041",772,511,505,5,6,"PSdeG-PSOE",100
32,"32033",750,504,500,4,4,"PSdeG-PSOE",102
32,"32042",1585,1120,1104,13,16,"PSdeG-PSOE",269
32,"32090",791,558,556,2,2,"PSdeG-PSOE",63
32,"32072",3833,2799,2761,26,38,"PSdeG-PSOE",718
32,"32058",5209,3808,3750,27,58,"PSdeG-PSOE",710
32,"32003",886,661,653,6,8,"PSdeG-PSOE",147
32,"32068",1424,974,969,8,5,"PSdeG-PSOE",259
32,"32036",1369,1053,1040,5,13,"PSdeG-PSOE",138
32,"32057",575,414,412,5,2,"PSdeG-PSOE",199
32,"32021",956,664,662,2,2,"PSdeG-PSOE",255
32,"32013",2213,1447,1431,8,16,"PSdeG-PSOE",237
32,"32091",1909,1389,1375,8,14,"PSdeG-PSOE",446
32,"32044",900,658,647,5,11,"PSdeG-PSOE",126
32,"32059",1849,1357,1339,16,18,"PSdeG-PSOE",319
32,"32062",832,646,644,7,2,"PSdeG-PSOE",121
32,"32037",742,544,532,8,12,"PSdeG-PSOE",102
32,"32054",87290,63653,62823,671,830,"PSdeG-PSOE",14574
32,"32027",1072,765,747,3,18,"PSdeG-PSOE",206
32,"32018",1261,956,945,3,11,"PSdeG-PSOE",383
32,"32078",1243,876,869,6,7,"PSdeG-PSOE",166
32,"32006",1571,1140,1127,10,13,"PSdeG-PSOE",188
32,"32014",1170,855,845,7,10,"PSdeG-PSOE",131
32,"32011",934,559,548,5,11,"PSdeG-PSOE",26
32,"32022",1377,963,951,7,12,"PSdeG-PSOE",245
32,"32047",1818,1345,1329,3,16,"PSdeG-PSOE",197
32,"32005",869,676,671,7,5,"PSdeG-PSOE",126
32,"32056",1610,1159,1146,9,13,"PSdeG-PSOE",270
32,"32024",4839,3424,3368,35,56,"PSdeG-PSOE",728
32,"32038",456,299,297,2,2,"PSdeG-PSOE",86
32,"32077",1188,813,796,8,17,"PSdeG-PSOE",221
32,"32046",1179,840,832,5,8,"PSdeG-PSOE",183
32,"32088",1632,1062,1042,8,20,"PSdeG-PSOE",352
32,"32039",1275,989,976,5,13,"PSdeG-PSOE",175
32,"32035",1484,944,938,7,6,"PSdeG-PSOE",170
32,"32015",899,586,581,5,5,"PSdeG-PSOE",121
32,"32089",1332,917,904,5,13,"PSdeG-PSOE",203
32,"32065",669,494,482,3,12,"PSdeG-PSOE",140
32,"32052",1904,1450,1426,6,24,"PSdeG-PSOE",249
32,"32063",1939,1329,1314,16,15,"PSdeG-PSOE",350
32,"32085",10709,7489,7403,81,86,"PSdeG-PSOE",1769
32,"32048",906,573,564,6,9,"PSdeG-PSOE",218
32,"32069",4333,3324,3261,25,63,"PSdeG-PSOE",919
32,"32030",1015,702,689,3,13,"PSdeG-PSOE",319
32,"32080",333,266,265,0,1,"PSdeG-PSOE",29
32,"32008",8188,5923,5845,44,78,"PSdeG-PSOE",1390
32,"32029",480,349,346,5,3,"PSdeG-PSOE",67
32,"32025",1094,821,809,3,12,"PSdeG-PSOE",163
32,"32053",1447,1140,1128,12,12,"PSdeG-PSOE",186
32,"32019",11529,8038,7906,78,132,"PSdeG-PSOE",1891
32,"32040",1472,1112,1089,9,23,"PSdeG-PSOE",206
32,"32002",2016,1474,1460,11,14,"PSdeG-PSOE",480
32,"32012",811,535,533,3,2,"PSdeG-PSOE",132
32,"32049",775,502,495,5,7,"PSdeG-PSOE",152
32,"32001",4978,3644,3607,31,37,"PSdeG-PSOE",513
32,"32087",1798,1421,1397,7,24,"PSdeG-PSOE",256
32,"32043",2555,1824,1793,15,31,"PSdeG-PSOE",369
32,"32016",825,559,556,3,3,"PSdeG-PSOE",283
32,"32070",566,335,330,3,5,"PSdeG-PSOE",98
32,"32082",1259,905,887,6,18,"PSdeG-PSOE",231
32,"32007",1527,1078,1070,7,8,"PSdeG-PSOE",232
32,"32010",394,299,298,0,1,"PSdeG-PSOE",67
32,"32020",2625,1997,1974,10,23,"PSdeG-PSOE",403
32,"32067",1300,838,824,15,14,"PSdeG-PSOE",184
32,"32074",1064,731,719,4,12,"PSdeG-PSOE",192
32,"32034",1141,880,873,4,7,"PSdeG-PSOE",230
32,"32086",2671,1731,1712,10,19,"PSdeG-PSOE",391
32,"32084",925,657,650,3,7,"PSdeG-PSOE",162
32,"32079",1343,1000,987,9,13,"PSdeG-PSOE",278
32,"32028",1643,1195,1174,18,21,"PSdeG-PSOE",162
32,"32076",2121,1509,1489,12,20,"PSdeG-PSOE",297
32,"32092",528,337,334,4,3,"PSdeG-PSOE",58
32,"32081",2097,1566,1553,6,13,"PSdeG-PSOE",405
32,"32017",1272,862,849,5,13,"PSdeG-PSOE",192
32,"32064",526,397,395,1,2,"PSdeG-PSOE",56
32,"32004",1826,900,897,8,3,"PSdeG-PSOE",58
32,"32073",1332,976,965,4,11,"PSdeG-PSOE",302
32,"32032",8101,5993,5881,74,112,"PSdeG-PSOE",1152
32,"32031",1079,826,812,5,14,"PSdeG-PSOE",140
32,"32023",1217,884,877,6,7,"PSdeG-PSOE",297
32,"32050",2455,1874,1855,17,19,"PSdeG-PSOE",356
32,"32060",845,609,598,6,11,"PSdeG-PSOE",218
32,"32075",4188,3257,3206,43,51,"PSdeG-PSOE",656
32,"32071",1496,1013,1004,1,9,"PSdeG-PSOE",254
32,"32009",10783,7555,7468,60,87,"PSdeG-PSOE",2090
32,"32083",860,580,574,4,6,"PSdeG-PSOE",131
32,"32051",1458,1141,1137,4,4,"PSdeG-PSOE",230
10,"10112",1583,1203,1176,7,27,"PP",541
10,"10106",134,111,111,1,0,"PP",44
10,"10161",75,53,53,0,0,"PP",23
10,"10010",2322,1446,1431,12,15,"PP",447
10,"10217",533,431,427,1,4,"PP",220
10,"10177",1703,1331,1296,10,35,"PP",373
10,"10193",1421,1150,1130,10,20,"PP",541
10,"10209",296,195,193,1,2,"PP",56
10,"10136",318,234,234,4,0,"PP",87
10,"10173",581,432,426,4,6,"PP",151
10,"10030",477,316,304,1,12,"PP",137
10,"10201",176,146,145,0,1,"PP",54
10,"10153",318,238,231,3,7,"PP",113
10,"10056",591,456,452,5,4,"PP",159
10,"10211",454,352,339,2,13,"PP",114
10,"10006",1275,1024,1004,7,20,"PP",371
10,"10149",435,315,307,1,8,"PP",122
10,"10002",368,278,275,0,3,"PP",86
10,"10205",2034,1413,1386,5,27,"PP",381
10,"10088",205,117,117,0,0,"PP",54
10,"10116",3784,2839,2801,21,38,"PP",720
10,"10080",368,276,272,1,4,"PP",102
10,"10141",268,190,189,2,1,"PP",87
10,"10027",78,66,66,0,0,"PP",21
10,"10110",2298,1682,1638,10,44,"PP",654
10,"10187",443,316,311,1,5,"PP",99
10,"10039",427,295,290,0,5,"PP",128
10,"10014",1874,1430,1401,11,29,"PP",520
10,"10199",166,120,119,3,1,"PP",41
10,"10203",4600,3268,3215,14,53,"PP",1269
10,"10175",1434,1054,1028,7,26,"PP",363
10,"10120",176,125,125,2,0,"PP",60
10,"10042",85,70,70,0,0,"PP",24
10,"10054",545,427,426,6,1,"PP",150
10,"10070",720,548,540,0,8,"PP",251
10,"10207",502,352,349,5,3,"PP",144
10,"10084",1370,934,906,7,28,"PP",304
10,"10162",579,483,476,0,7,"PP",140
10,"10052",193,127,126,1,1,"PP",80
10,"10195",7768,5818,5723,58,95,"PP",2526
10,"10064",1490,1142,1119,9,23,"PP",473
10,"10055",719,554,546,3,8,"PP",277
10,"10174",175,141,139,0,2,"PP",61
10,"10099",592,417,413,7,4,"PP",125
10,"10185",572,433,427,5,6,"PP",157
10,"10902",730,546,536,2,10,"PP",205
10,"10132",400,258,256,0,2,"PP",71
10,"10075",256,178,177,1,1,"PP",51
10,"10022",435,371,366,1,5,"PP",141
10,"10004",713,551,543,1,8,"PP",199
10,"10115",3578,2857,2811,20,46,"PP",933
10,"10905",651,458,456,0,2,"PP",161
10,"10072",862,644,639,2,5,"PP",171
10,"10046",201,176,173,2,3,"PP",51
10,"10130",1761,1322,1308,5,14,"PP",376
10,"10076",820,608,595,3,13,"PP",181
10,"10031",167,138,137,1,1,"PP",64
10,"10097",106,79,79,0,0,"PP",32
10,"10197",134,94,93,0,1,"PP",45
10,"10091",378,304,304,0,0,"PP",121
10,"10213",571,483,478,1,5,"PP",226
10,"10128",5752,4219,4146,39,73,"PP",1367
10,"10053",289,231,224,1,7,"PP",114
10,"10140",1114,860,848,6,12,"PP",388
10,"10015",687,500,491,2,9,"PP",169
10,"10127",4724,3529,3463,15,66,"PP",1087
10,"10102",531,413,410,4,3,"PP",142
10,"10122",231,166,163,0,3,"PP",61
10,"10060",973,620,607,5,13,"PP",214
10,"10020",1619,1240,1214,9,26,"PP",408
10,"10008",1331,1052,1047,6,5,"PP",438
10,"10073",715,536,530,3,6,"PP",207
10,"10040",443,344,342,4,2,"PP",108
10,"10024",687,538,533,6,5,"PP",241
10,"10021",5198,3960,3878,40,82,"PP",927
10,"10189",2656,2006,1971,10,35,"PP",631
10,"10003",557,401,396,2,5,"PP",187
10,"10192",841,592,584,0,8,"PP",282
10,"10142",824,620,616,5,4,"PP",161
10,"10069",831,647,637,2,10,"PP",229
10,"10200",417,308,305,0,3,"PP",138
10,"10216",1543,1200,1192,9,8,"PP",478
10,"10017",841,606,589,4,17,"PP",297
10,"10005",537,411,398,3,13,"PP",167
10,"10148",32985,23666,23394,189,272,"PP",7827
10,"10038",86,70,70,0,0,"PP",42
10,"10124",862,692,678,7,14,"PP",204
10,"10058",1025,747,737,5,10,"PP",211
10,"10079",901,703,695,2,8,"PP",318
10,"10204",442,345,342,5,3,"PP",145
10,"10178",781,567,562,1,5,"PP",245
10,"10183",993,763,761,4,2,"PP",278
10,"10186",994,830,816,4,14,"PP",328
10,"10138",544,445,437,2,8,"PP",95
10,"10904",750,522,520,5,2,"PP",174
10,"10077",689,511,504,2,7,"PP",154
10,"10063",179,145,145,1,0,"PP",69
10,"10092",301,238,236,2,2,"PP",63
10,"10170",263,204,202,2,2,"PP",94
10,"10117",260,127,127,0,0,"PP",35
10,"10013",282,228,223,2,5,"PP",104
10,"10180",4159,2765,2734,12,31,"PP",991
10,"10034",350,263,262,1,1,"PP",111
10,"10147",1275,985,937,6,48,"PP",235
10,"10089",1376,1004,988,2,16,"PP",208
10,"10114",968,721,711,4,10,"PP",106
10,"10061",1664,1143,1131,8,12,"PP",311
10,"10082",1893,1528,1484,13,44,"PP",476
10,"10103",454,342,338,1,4,"PP",105
10,"10134",565,395,393,1,2,"PP",212
10,"10101",185,147,147,1,0,"PP",58
10,"10191",532,417,415,12,2,"PP",159
10,"10050",1062,853,846,5,7,"PP",416
10,"10078",414,325,319,3,6,"PP",113
10,"10156",96,71,70,1,1,"PP",18
10,"10176",374,274,268,1,6,"PP",60
10,"10144",996,755,748,3,7,"PP",268
10,"10188",500,381,373,2,8,"PP",123
10,"10068",746,601,586,3,15,"PP",208
10,"10121",7970,5884,5816,33,68,"PP",2074
10,"10206",212,161,160,3,1,"PP",51
10,"10219",1290,860,843,1,17,"PP",298
10,"10168",320,240,237,0,3,"PP",100
10,"10119",630,461,455,2,6,"PP",107
10,"10025",402,341,328,2,13,"PP",108
10,"10096",3443,2503,2464,14,39,"PP",668
10,"10107",1033,825,815,11,10,"PP",249
10,"10164",742,513,508,1,5,"PP",181
10,"10044",1451,1100,1087,7,13,"PP",253
10,"10065",205,154,154,1,0,"PP",30
10,"10129",363,272,266,4,6,"PP",74
10,"10171",340,262,261,1,1,"PP",93
10,"10208",124,100,98,1,2,"PP",32
10,"10901",1184,851,835,2,16,"PP",290
10,"10036",327,247,244,2,3,"PP",75
10,"10109",1804,1233,1212,2,21,"PP",460
10,"10094",232,203,203,3,0,"PP",53
10,"10210",551,380,373,1,7,"PP",123
10,"10041",1056,823,811,4,12,"PP",325
10,"10035",1880,1390,1372,6,18,"PP",365
10,"10202",621,495,478,2,17,"PP",155
10,"10083",90,69,69,0,0,"PP",24
10,"10194",536,441,433,5,8,"PP",185
10,"10043",814,594,590,2,4,"PP",173
10,"10011",570,450,443,2,7,"PP",108
10,"10146",1509,1018,1004,4,14,"PP",364
10,"10059",369,258,255,0,3,"PP",89
10,"10032",1705,1296,1277,10,19,"PP",523
10,"10066",158,128,127,1,1,"PP",52
10,"10029",418,345,341,1,4,"PP",85
10,"10154",184,138,134,1,4,"PP",53
10,"10026",646,507,494,5,13,"PP",156
10,"10152",470,361,357,3,4,"PP",134
10,"10143",158,121,121,0,0,"PP",44
10,"10019",1510,1134,1121,8,13,"PP",445
10,"10037",76403,58422,57811,329,611,"PP",21116
10,"10165",259,212,209,0,3,"PP",101
10,"10166",307,220,219,0,1,"PP",109
10,"10159",323,235,232,2,3,"PP",93
10,"10126",1572,1123,1107,3,16,"PP",476
10,"10047",972,783,777,1,6,"PP",166
10,"10158",335,252,251,0,1,"PP",63
10,"10182",129,95,95,0,0,"PP",41
10,"10033",430,304,301,1,3,"PP",156
10,"10123",585,480,468,1,12,"PP",134
10,"10105",2519,1745,1714,11,31,"PP",674
10,"10062",413,345,341,3,4,"PP",52
10,"10163",356,302,299,1,3,"PP",156
10,"10104",5169,3766,3703,21,63,"PP",1440
10,"10023",846,647,637,1,10,"PP",190
10,"10057",150,112,111,0,1,"PP",23
10,"10218",1143,828,814,2,14,"PP",265
10,"10085",335,248,244,1,4,"PP",105
10,"10167",306,240,237,0,3,"PP",110
10,"10135",1329,981,958,1,23,"PP",395
10,"10212",1691,1303,1280,8,23,"PP",293
10,"10184",778,620,610,6,10,"PP",255
10,"10131",12850,9036,8977,44,59,"PP",3419
10,"10095",350,269,267,1,2,"PP",88
10,"10157",273,209,205,1,4,"PP",79
10,"10045",1031,786,781,11,5,"PP",265
10,"10087",1701,1233,1215,7,18,"PP",442
10,"10160",225,172,170,0,2,"PP",40
10,"10071",144,100,100,2,0,"PP",38
10,"10081",179,133,129,0,4,"PP",56
10,"10016",329,262,259,1,3,"PP",68
10,"10145",126,101,100,1,1,"PP",41
10,"10048",245,163,161,1,2,"PP",98
10,"10155",1140,856,842,3,14,"PP",291
10,"10179",301,247,247,0,0,"PP",97
10,"10172",718,501,493,2,8,"PP",166
10,"10086",329,259,256,1,3,"PP",122
10,"10001",285,226,225,2,1,"PP",60
10,"10198",1160,1022,1009,6,13,"PP",524
10,"10093",406,333,324,2,9,"PP",63
10,"10049",3849,3185,3111,27,74,"PP",1022
10,"10133",1210,1007,989,2,18,"PP",140
10,"10215",442,320,320,0,0,"PP",94
10,"10098",385,294,286,0,8,"PP",126
10,"10169",544,430,423,0,7,"PP",202
10,"10214",208,172,170,0,2,"PP",93
10,"10090",522,386,382,5,4,"PP",148
10,"10196",306,234,233,1,1,"PP",96
10,"10018",1722,1255,1240,6,15,"PP",294
10,"10051",440,318,314,1,4,"PP",154
10,"10113",2354,1800,1778,20,22,"PP",479
10,"10007",646,488,478,3,10,"PP",237
10,"10118",289,257,257,1,0,"PP",91
10,"10903",819,629,624,7,5,"PP",170
10,"10125",903,648,638,2,10,"PP",233
10,"10151",213,163,161,0,2,"PP",74
10,"10028",98,72,71,0,1,"PP",27
10,"10009",270,173,170,1,3,"PP",76
10,"10012",599,494,489,1,5,"PP",146
10,"10111",1364,995,978,9,17,"PP",339
10,"10181",694,571,558,7,13,"PP",171
10,"10100",795,602,595,4,7,"PP",163
10,"10139",111,84,83,0,1,"PP",37
10,"10190",561,401,397,2,4,"PP",135
10,"10108",218,122,120,0,2,"PP",60
10,"10150",354,301,295,4,6,"PP",79
10,"10137",399,344,343,4,1,"PP",133
10,"10067",10486,7796,7692,54,104,"PP",2859
5,"5187",1755,1409,1395,11,14,"PACMA",11
5,"5107",64,39,39,1,0,"PACMA",0
5,"5236",128,85,84,0,1,"PACMA",0
5,"5904",133,92,91,1,1,"PACMA",0
5,"5225",372,316,315,5,1,"PACMA",0
5,"5044",259,180,180,0,0,"PACMA",1
5,"5261",42,26,26,0,0,"PACMA",0
5,"5015",87,66,65,1,1,"PACMA",0
5,"5053",86,58,58,0,0,"PACMA",0
5,"5058",78,55,55,2,0,"PACMA",0
5,"5070",32,26,26,0,0,"PACMA",0
5,"5171",73,58,57,2,1,"PACMA",0
5,"5036",123,97,97,0,0,"PACMA",0
5,"5242",681,538,527,10,11,"PACMA",2
5,"5266",102,89,89,0,0,"PACMA",0
5,"5140",116,97,96,0,1,"PACMA",0
5,"5194",138,122,121,5,1,"PACMA",1
5,"5158",371,289,287,1,2,"PACMA",0
5,"5199",39,32,32,0,0,"PACMA",0
5,"5166",188,135,134,1,1,"PACMA",0
5,"5019",44606,34903,34564,285,339,"PACMA",252
5,"5210",85,72,72,1,0,"PACMA",0
5,"5170",52,46,46,0,0,"PACMA",0
5,"5222",159,126,126,0,0,"PACMA",0
5,"5267",100,65,64,0,1,"PACMA",0
5,"5183",140,114,113,1,1,"PACMA",0
5,"5156",249,163,161,0,2,"PACMA",2
5,"5182",801,559,546,9,13,"PACMA",3
5,"5013",876,733,723,2,10,"PACMA",2
5,"5126",70,59,59,0,0,"PACMA",0
5,"5212",233,157,155,1,2,"PACMA",1
5,"5149",105,76,75,0,1,"PACMA",0
5,"5109",454,378,362,3,16,"PACMA",0
5,"5132",992,678,672,2,6,"PACMA",5
5,"5186",1572,1240,1222,9,18,"PACMA",1
5,"5235",124,111,110,1,1,"PACMA",0
5,"5172",123,104,102,2,2,"PACMA",0
5,"5195",224,162,161,1,1,"PACMA",0
5,"5200",49,28,28,0,0,"PACMA",0
5,"5054",1238,953,933,1,20,"PACMA",5
5,"5103",78,56,56,0,0,"PACMA",0
5,"5191",126,104,104,1,0,"PACMA",0
5,"5192",100,82,81,1,1,"PACMA",0
5,"5160",323,263,260,1,3,"PACMA",0
5,"5061",253,198,196,4,2,"PACMA",1
5,"5124",107,83,81,1,2,"PACMA",0
5,"5244",51,38,38,0,0,"PACMA",0
5,"5258",113,98,97,0,1,"PACMA",0
5,"5197",98,90,90,0,0,"PACMA",1
5,"5133",67,55,55,1,0,"PACMA",0
5,"5165",380,291,283,5,8,"PACMA",1
5,"5018",29,21,21,0,0,"PACMA",0
5,"5164",27,19,19,1,0,"PACMA",0
5,"5131",105,70,69,1,1,"PACMA",0
5,"5196",53,39,39,0,0,"PACMA",2
5,"5169",226,178,176,1,2,"PACMA",0
5,"5002",1954,1471,1450,9,21,"PACMA",7
5,"5902",288,227,227,0,0,"PACMA",3
5,"5092",155,120,120,0,0,"PACMA",0
5,"5057",2470,1977,1953,14,24,"PACMA",2
5,"5233",226,179,177,0,2,"PACMA",0
5,"5048",120,104,103,0,1,"PACMA",1
5,"5162",87,60,60,2,0,"PACMA",0
5,"5083",145,108,100,2,8,"PACMA",1
5,"5016",6335,4873,4775,39,98,"PACMA",14
5,"5135",425,325,322,1,3,"PACMA",0
5,"5184",250,197,192,0,5,"PACMA",1
5,"5115",532,392,386,2,6,"PACMA",0
5,"5209",83,63,63,0,0,"PACMA",0
5,"5217",58,45,45,0,0,"PACMA",0
5,"5047",4199,3287,3244,7,43,"PACMA",14
5,"5014",5422,4137,4084,30,53,"PACMA",30
5,"5093",417,313,311,1,2,"PACMA",1
5,"5112",97,72,70,1,2,"PACMA",1
5,"5080",59,42,40,0,2,"PACMA",0
5,"5097",474,324,317,3,7,"PACMA",0
5,"5116",118,95,93,1,2,"PACMA",0
5,"5085",38,29,29,0,0,"PACMA",0
5,"5188",45,38,38,0,0,"PACMA",0
5,"5226",77,57,57,0,0,"PACMA",0
5,"5033",174,139,138,0,1,"PACMA",0
5,"5045",95,70,70,0,0,"PACMA",0
5,"5224",106,87,86,0,1,"PACMA",0
5,"5207",697,553,548,0,5,"PACMA",0
5,"5079",70,54,54,0,0,"PACMA",0
5,"5176",234,190,187,2,3,"PACMA",0
5,"5082",528,437,427,5,10,"PACMA",1
5,"5055",576,476,467,0,9,"PACMA",1
5,"5215",169,126,122,2,4,"PACMA",0
5,"5147",162,119,116,0,3,"PACMA",0
5,"5129",129,78,78,0,0,"PACMA",0
5,"5177",160,128,128,1,0,"PACMA",0
5,"5089",478,377,365,0,12,"PACMA",2
5,"5069",74,58,58,0,0,"PACMA",0
5,"5130",95,82,82,0,0,"PACMA",0
5,"5229",84,67,67,0,0,"PACMA",1
5,"5220",382,298,294,1,4,"PACMA",1
5,"5240",3393,2354,2335,9,19,"PACMA",23
5,"5148",27,17,17,0,0,"PACMA",0
5,"5251",68,40,40,0,0,"PACMA",0
5,"5198",73,59,59,0,0,"PACMA",0
5,"5237",164,131,126,1,5,"PACMA",0
5,"5101",316,240,238,1,2,"PACMA",0
5,"5087",137,93,93,0,0,"PACMA",0
5,"5127",650,539,535,4,4,"PACMA",0
5,"5230",65,56,54,1,2,"PACMA",0
5,"5075",107,67,67,0,0,"PACMA",0
5,"5040",68,45,45,0,0,"PACMA",0
5,"5221",353,270,264,3,6,"PACMA",1
5,"5247",250,147,146,1,1,"PACMA",1
5,"5052",99,89,88,0,1,"PACMA",0
5,"5253",88,70,70,0,0,"PACMA",0
5,"5214",38,27,26,0,1,"PACMA",0
5,"5903",157,108,107,0,1,"PACMA",0
5,"5084",74,56,56,1,0,"PACMA",0
5,"5037",261,165,163,3,2,"PACMA",0
5,"5066",458,365,364,3,1,"PACMA",0
5,"5145",52,41,41,0,0,"PACMA",0
5,"5094",140,110,110,0,0,"PACMA",0
5,"5163",1756,1351,1345,1,6,"PACMA",4
5,"5206",29,22,21,0,1,"PACMA",0
5,"5259",125,107,106,3,1,"PACMA",0
5,"5128",350,289,284,4,5,"PACMA",2
5,"5263",172,137,137,0,0,"PACMA",2
5,"5081",39,33,31,0,2,"PACMA",0
5,"5042",155,126,125,0,1,"PACMA",0
5,"5121",241,186,185,3,1,"PACMA",4
5,"5181",43,31,31,1,0,"PACMA",0
5,"5063",34,24,24,0,0,"PACMA",0
5,"5901",273,187,185,5,2,"PACMA",0
5,"5008",227,180,176,2,4,"PACMA",0
5,"5051",181,152,147,3,5,"PACMA",0
5,"5153",108,78,77,3,1,"PACMA",0
5,"5043",84,67,67,0,0,"PACMA",0
5,"5074",693,543,540,1,3,"PACMA",0
5,"5090",84,69,68,1,1,"PACMA",0
5,"5056",96,73,73,0,0,"PACMA",0
5,"5178",371,295,289,0,6,"PACMA",0
5,"5035",107,84,84,1,0,"PACMA",1
5,"5139",76,66,66,0,0,"PACMA",0
5,"5264",62,43,42,1,1,"PACMA",1
5,"5134",48,40,40,0,0,"PACMA",0
5,"5216",224,155,155,2,0,"PACMA",0
5,"5252",64,45,45,0,0,"PACMA",0
5,"5010",149,119,118,1,1,"PACMA",0
5,"5265",82,70,70,0,0,"PACMA",0
5,"5119",33,20,20,0,0,"PACMA",0
5,"5238",787,565,556,4,9,"PACMA",0
5,"5120",35,26,26,0,0,"PACMA",0
5,"5144",79,62,60,2,2,"PACMA",0
5,"5088",33,24,24,0,0,"PACMA",0
5,"5102",1807,1431,1412,7,19,"PACMA",4
5,"5205",75,58,58,0,0,"PACMA",0
5,"5012",135,110,108,0,2,"PACMA",0
5,"5005",187,150,149,0,1,"PACMA",0
5,"5041",1001,772,765,10,7,"PACMA",5
5,"5227",373,250,248,0,2,"PACMA",0
5,"5022",1611,1279,1271,4,8,"PACMA",1
5,"5017",85,75,75,0,0,"PACMA",1
5,"5168",3565,2740,2711,17,29,"PACMA",14
5,"5077",161,137,136,2,1,"PACMA",0
5,"5095",266,220,218,0,2,"PACMA",1
5,"5026",197,170,169,1,1,"PACMA",2
5,"5141",95,86,86,2,0,"PACMA",0
5,"5117",201,178,174,2,4,"PACMA",0
5,"5201",529,439,431,2,8,"PACMA",1
5,"5125",57,45,44,0,1,"PACMA",1
5,"5211",465,375,373,2,2,"PACMA",1
5,"5185",94,80,80,1,0,"PACMA",0
5,"5027",269,220,218,2,2,"PACMA",1
5,"5086",82,66,64,1,2,"PACMA",0
5,"5046",45,38,38,1,0,"PACMA",0
5,"5241",3081,2143,2115,17,28,"PACMA",22
5,"5113",78,58,58,1,0,"PACMA",0
5,"5021",1932,1478,1456,12,22,"PACMA",8
5,"5024",231,169,163,5,6,"PACMA",0
5,"5208",40,34,34,0,0,"PACMA",0
5,"5105",349,279,270,3,9,"PACMA",0
5,"5204",611,473,471,1,2,"PACMA",1
5,"5096",79,57,57,0,0,"PACMA",0
5,"5161",586,483,473,2,10,"PACMA",10
5,"5106",36,27,27,0,0,"PACMA",0
5,"5136",97,74,73,5,1,"PACMA",0
5,"5190",55,42,42,2,0,"PACMA",0
5,"5174",69,55,55,1,0,"PACMA",0
5,"5114",1359,1131,1115,5,16,"PACMA",2
5,"5213",101,83,83,0,0,"PACMA",1
5,"5099",497,398,381,3,17,"PACMA",0
5,"5180",88,68,68,1,0,"PACMA",0
5,"5231",160,126,124,1,2,"PACMA",1
5,"5159",254,175,174,2,1,"PACMA",2
5,"5025",96,73,72,1,1,"PACMA",0
5,"5030",46,37,37,0,0,"PACMA",3
5,"5110",721,559,552,3,7,"PACMA",0
5,"5152",690,561,558,3,3,"PACMA",2
5,"5059",109,79,76,1,3,"PACMA",1
5,"5218",121,97,95,0,2,"PACMA",0
5,"5243",88,61,61,1,0,"PACMA",0
5,"5062",184,155,154,2,1,"PACMA",0
5,"5155",52,37,37,0,0,"PACMA",0
5,"5256",116,92,92,1,0,"PACMA",0
5,"5142",104,88,82,1,6,"PACMA",0
5,"5143",66,55,55,1,0,"PACMA",0
5,"5118",84,57,57,0,0,"PACMA",0
5,"5122",144,115,113,1,2,"PACMA",0
5,"5245",348,293,288,0,5,"PACMA",1
5,"5073",297,243,238,4,5,"PACMA",2
5,"5179",215,184,180,0,4,"PACMA",0
5,"5239",207,163,162,1,1,"PACMA",0
5,"5228",179,126,126,0,0,"PACMA",0
5,"5108",51,30,30,0,0,"PACMA",0
5,"5064",103,87,87,1,0,"PACMA",0
5,"5193",194,163,163,1,0,"PACMA",0
5,"5154",36,30,30,0,0,"PACMA",0
5,"5065",469,388,385,6,3,"PACMA",3
5,"5001",194,153,152,1,1,"PACMA",0
5,"5173",60,45,45,0,0,"PACMA",0
5,"5246",60,42,42,0,0,"PACMA",0
5,"5262",358,278,277,1,1,"PACMA",0
5,"5060",120,99,99,1,0,"PACMA",0
5,"5072",87,70,69,1,1,"PACMA",0
5,"5151",93,70,70,1,0,"PACMA",0
5,"5007",113,74,74,1,0,"PACMA",0
5,"5076",481,401,387,5,14,"PACMA",3
5,"5257",140,98,98,0,0,"PACMA",1
5,"5232",98,83,81,1,2,"PACMA",0
5,"5189",443,340,336,3,4,"PACMA",0
5,"5157",240,170,167,1,3,"PACMA",0
5,"5104",34,23,22,1,1,"PACMA",0
5,"5138",311,241,239,3,2,"PACMA",0
5,"5039",56,43,42,0,1,"PACMA",0
5,"5078",115,100,99,3,1,"PACMA",1
5,"5234",51,46,46,1,0,"PACMA",0
5,"5123",96,69,66,2,3,"PACMA",0
5,"5219",39,28,28,0,0,"PACMA",1
5,"5038",116,87,85,0,2,"PACMA",0
5,"5249",107,82,82,0,0,"PACMA",0
5,"5049",399,301,291,1,10,"PACMA",5
5,"5100",285,229,228,0,1,"PACMA",0
5,"5254",196,166,166,0,0,"PACMA",0
5,"5260",104,84,83,1,1,"PACMA",0
5,"5175",159,130,130,0,0,"PACMA",0
5,"5905",214,150,150,1,0,"PACMA",0
5,"5023",173,153,153,5,0,"PACMA",0
5,"5029",123,92,89,0,3,"PACMA",0
5,"5167",265,209,199,0,10,"PACMA",0
5,"5067",83,66,59,1,7,"PACMA",0
5,"5034",15,12,12,1,0,"PACMA",0
18,"18101",9263,6971,6912,55,59,"PACMA",68
18,"18051",1149,825,823,7,2,"PACMA",3
18,"18014",6372,4620,4566,44,54,"PACMA",35
18,"18076",815,577,576,0,1,"PACMA",0
18,"18086",355,285,283,0,2,"PACMA",0
18,"18904",779,570,565,1,5,"PACMA",1
18,"18159",1009,811,802,3,9,"PACMA",2
18,"18178",743,571,571,2,0,"PACMA",0
18,"18011",4321,3136,3119,10,17,"PACMA",32
18,"18017",18172,12077,11954,101,123,"PACMA",102
18,"18043",129,95,95,0,0,"PACMA",2
18,"18134",5811,4002,3946,25,56,"PACMA",31
18,"18154",1016,716,716,2,0,"PACMA",0
18,"18040",225,142,141,0,1,"PACMA",0
18,"18177",427,259,258,3,1,"PACMA",2
18,"18096",342,260,259,1,1,"PACMA",0
18,"18084",4215,3179,3143,24,36,"PACMA",29
18,"18112",131,88,86,1,2,"PACMA",0
18,"18182",1919,1356,1347,3,9,"PACMA",5
18,"18038",1066,836,826,2,10,"PACMA",4
18,"18189",772,599,595,7,4,"PACMA",8
18,"18094",2389,1853,1832,22,21,"PACMA",9
18,"18905",14500,10137,10058,82,79,"PACMA",151
18,"18054",868,630,627,2,3,"PACMA",1
18,"18109",599,421,419,2,2,"PACMA",5
18,"18111",2743,2046,2033,14,13,"PACMA",16
18,"18042",414,342,341,0,1,"PACMA",0
18,"18057",5263,3968,3937,33,31,"PACMA",37
18,"18023",15738,11242,11146,92,96,"PACMA",52
18,"18074",273,217,213,2,4,"PACMA",0
18,"18114",634,457,452,2,5,"PACMA",1
18,"18099",1581,1271,1249,10,22,"PACMA",5
18,"18914",1658,1304,1290,8,14,"PACMA",7
18,"18103",760,596,593,6,3,"PACMA",3
18,"18039",3544,2544,2511,34,33,"PACMA",9
18,"18015",443,338,337,0,1,"PACMA",0
18,"18901",512,359,357,1,2,"PACMA",4
18,"18181",223,159,157,0,2,"PACMA",0
18,"18124",393,274,271,1,3,"PACMA",1
18,"18183",660,468,465,3,3,"PACMA",1
18,"18093",2752,1873,1858,10,15,"PACMA",7
18,"18126",1497,1094,1087,7,7,"PACMA",7
18,"18157",1123,836,823,8,13,"PACMA",8
18,"18070",283,223,218,0,5,"PACMA",0
18,"18148",819,671,666,1,5,"PACMA",6
18,"18184",2158,1659,1634,4,25,"PACMA",12
18,"18006",4161,2816,2788,29,28,"PACMA",8
18,"18908",805,633,620,2,13,"PACMA",1
18,"18133",2187,1731,1722,7,9,"PACMA",8
18,"18069",493,366,363,3,3,"PACMA",0
18,"18032",239,178,175,0,3,"PACMA",1
18,"18173",8978,6319,6251,50,68,"PACMA",54
18,"18005",375,266,265,2,1,"PACMA",1
18,"18185",556,461,461,1,0,"PACMA",5
18,"18018",640,490,488,0,2,"PACMA",3
18,"18033",294,220,219,1,1,"PACMA",0
18,"18136",1875,1477,1470,7,7,"PACMA",3
18,"18146",970,734,727,6,7,"PACMA",4
18,"18909",589,462,459,0,3,"PACMA",0
18,"18137",1005,758,758,6,0,"PACMA",3
18,"18192",1529,1216,1208,3,8,"PACMA",2
18,"18912",1488,1021,1007,7,14,"PACMA",1
18,"18153",8580,6314,6260,39,54,"PACMA",61
18,"18145",10432,7829,7767,56,62,"PACMA",89
18,"18003",14022,10417,10330,82,87,"PACMA",113
18,"18187",561,418,417,1,1,"PACMA",3
18,"18152",938,687,681,1,6,"PACMA",1
18,"18163",324,239,235,1,4,"PACMA",1
18,"18147",3734,2416,2386,10,30,"PACMA",10
18,"18079",3465,2671,2645,16,26,"PACMA",5
18,"18056",3545,2716,2687,25,29,"PACMA",9
18,"18085",729,489,484,2,5,"PACMA",1
18,"18907",1859,1482,1475,5,7,"PACMA",1
18,"18001",256,178,177,2,1,"PACMA",0
18,"18047",5888,4028,4000,32,28,"PACMA",48
18,"18050",1711,1271,1256,5,15,"PACMA",10
18,"18025",294,216,214,0,2,"PACMA",1
18,"18089",15132,10489,10402,64,87,"PACMA",54
18,"18903",892,650,645,1,5,"PACMA",5
18,"18180",631,448,447,2,1,"PACMA",2
18,"18127",16586,11998,11897,97,101,"PACMA",121
18,"18105",4548,3169,3139,19,30,"PACMA",10
18,"18082",867,626,621,4,5,"PACMA",0
18,"18158",8408,5604,5542,38,62,"PACMA",38
18,"18044",179,116,116,0,0,"PACMA",0
18,"18117",513,402,396,4,6,"PACMA",1
18,"18121",132,101,100,1,1,"PACMA",0
18,"18135",4583,3045,2998,14,47,"PACMA",12
18,"18083",266,210,207,1,3,"PACMA",0
18,"18036",3768,2904,2882,18,22,"PACMA",24
18,"18037",530,411,408,1,3,"PACMA",2
18,"18132",3312,2582,2556,14,26,"PACMA",8
18,"18071",5583,4221,4176,33,45,"PACMA",33
18,"18063",1191,770,767,6,3,"PACMA",0
18,"18141",414,282,277,1,5,"PACMA",0
18,"18016",323,239,237,0,2,"PACMA",0
18,"18098",6167,4367,4342,22,25,"PACMA",20
18,"18174",442,354,348,2,6,"PACMA",0
18,"18024",855,660,653,8,7,"PACMA",2
18,"18115",2548,1872,1854,16,18,"PACMA",12
18,"18068",1566,1234,1214,5,20,"PACMA",6
18,"18013",4236,3108,3052,19,56,"PACMA",9
18,"18170",336,227,225,1,2,"PACMA",1
18,"18072",666,481,474,4,7,"PACMA",4
18,"18102",8424,5783,5716,41,67,"PACMA",30
18,"18034",510,391,391,1,0,"PACMA",0
18,"18012",2330,1670,1660,15,10,"PACMA",4
18,"18007",785,527,523,3,4,"PACMA",0
18,"18906",917,681,673,2,8,"PACMA",0
18,"18910",803,573,569,5,4,"PACMA",0
18,"18119",1729,1353,1340,13,13,"PACMA",3
18,"18108",858,672,667,0,5,"PACMA",2
18,"18049",617,456,451,3,5,"PACMA",1
18,"18030",584,428,426,3,2,"PACMA",0
18,"18029",1833,1252,1243,9,9,"PACMA",3
18,"18179",546,378,377,1,1,"PACMA",1
18,"18062",10298,7584,7512,67,72,"PACMA",95
18,"18165",4135,2944,2915,23,29,"PACMA",24
18,"18048",2390,1824,1806,8,18,"PACMA",13
18,"18100",7769,5715,5637,57,78,"PACMA",30
18,"18027",2562,1846,1827,19,19,"PACMA",7
18,"18066",2108,1546,1540,4,6,"PACMA",2
18,"18059",4153,3074,3039,23,35,"PACMA",13
18,"18087",184873,138280,137516,836,764,"PACMA",1126
18,"18064",379,308,308,1,0,"PACMA",0
18,"18002",561,446,444,1,2,"PACMA",0
18,"18168",809,589,588,5,1,"PACMA",4
18,"18010",563,463,459,4,4,"PACMA",1
18,"18143",979,781,776,2,5,"PACMA",7
18,"18053",1667,1084,1078,9,6,"PACMA",6
18,"18045",1149,803,789,10,14,"PACMA",3
18,"18140",43567,29155,28932,194,223,"PACMA",223
18,"18107",971,719,711,6,8,"PACMA",4
18,"18020",1469,1046,1032,7,14,"PACMA",1
18,"18061",1059,822,816,1,6,"PACMA",2
18,"18161",220,184,184,1,0,"PACMA",2
18,"18149",5177,3946,3902,29,44,"PACMA",32
18,"18065",625,503,500,1,3,"PACMA",1
18,"18175",11624,8549,8467,41,82,"PACMA",60
18,"18913",818,617,603,2,14,"PACMA",6
18,"18122",16171,11670,11508,106,162,"PACMA",90
18,"18021",17451,12420,12305,101,115,"PACMA",127
18,"18171",2123,1640,1616,14,24,"PACMA",2
18,"18902",847,680,674,10,6,"PACMA",1
18,"18194",2152,1487,1477,6,10,"PACMA",6
18,"18176",258,179,178,3,1,"PACMA",1
18,"18144",782,596,588,3,8,"PACMA",6
18,"18022",13306,9165,9091,51,74,"PACMA",91
18,"18035",1255,964,958,4,6,"PACMA",1
18,"18116",2882,2245,2215,19,30,"PACMA",11
18,"18028",945,790,781,2,9,"PACMA",1
18,"18120",270,218,216,2,2,"PACMA",1
18,"18162",951,744,734,0,10,"PACMA",6
18,"18150",6730,4858,4814,28,44,"PACMA",48
18,"18138",2482,1721,1712,8,9,"PACMA",2
18,"18167",1897,1321,1313,8,8,"PACMA",3
18,"18164",1831,1273,1260,11,13,"PACMA",1
18,"18078",739,593,590,4,3,"PACMA",0
18,"18088",1556,1113,1108,5,5,"PACMA",0
18,"18095",1959,1486,1474,5,12,"PACMA",10
18,"18067",711,517,516,0,1,"PACMA",1
18,"18193",14194,10280,10196,91,84,"PACMA",127
18,"18097",956,703,691,1,12,"PACMA",1
18,"18128",344,251,248,0,3,"PACMA",1
18,"18151",260,196,196,0,0,"PACMA",0
18,"18911",7392,5359,5301,44,58,"PACMA",61
18,"18123",293,228,227,2,1,"PACMA",2
18,"18046",1867,1225,1215,8,10,"PACMA",7
18,"18004",724,511,505,3,6,"PACMA",0
18,"18188",1642,1249,1234,8,15,"PACMA",5
45,"45204",643,519,513,0,6,"PSOE",140
45,"45161",13474,9618,9496,63,122,"PSOE",1704
45,"45081",17646,13309,13166,72,143,"PSOE",2818
45,"45154",1483,1114,1107,5,7,"PSOE",254
45,"45084",2280,1777,1747,12,30,"PSOE",677
45,"45168",62226,48889,48446,327,443,"PSOE",10376
45,"45089",1516,1157,1139,6,18,"PSOE",420
45,"45077",542,428,423,0,5,"PSOE",125
45,"45105",405,284,279,3,5,"PSOE",100
45,"45037",1635,1216,1202,4,14,"PSOE",450
45,"45134",1600,1214,1200,4,14,"PSOE",364
45,"45079",367,285,285,3,0,"PSOE",76
45,"45162",683,515,510,0,5,"PSOE",180
45,"45072",670,499,499,2,0,"PSOE",158
45,"45120",134,105,105,1,0,"PSOE",41
45,"45156",3441,2863,2825,13,38,"PSOE",924
45,"45031",2723,1935,1896,10,39,"PSOE",525
45,"45174",309,247,247,1,0,"PSOE",73
45,"45092",233,197,194,0,3,"PSOE",59
45,"45149",573,486,484,0,2,"PSOE",159
45,"45112",1939,1302,1268,6,34,"PSOE",431
45,"45197",1921,1500,1480,12,20,"PSOE",683
45,"45136",5859,4249,4177,24,72,"PSOE",1215
45,"45190",483,397,387,2,10,"PSOE",144
45,"45016",4179,3290,3268,30,22,"PSOE",819
45,"45160",1111,908,895,6,13,"PSOE",206
45,"45104",440,345,341,1,4,"PSOE",164
45,"45129",136,100,97,0,3,"PSOE",27
45,"45144",794,643,640,2,3,"PSOE",242
45,"45176",3665,2747,2712,15,35,"PSOE",547
45,"45022",392,297,293,8,4,"PSOE",87
45,"45038",3335,2525,2490,8,35,"PSOE",388
45,"45018",495,352,348,0,4,"PSOE",73
45,"45015",622,461,455,2,6,"PSOE",134
45,"45124",2156,1750,1712,16,38,"PSOE",614
45,"45199",2963,2055,2027,5,28,"PSOE",412
45,"45103",397,325,322,0,3,"PSOE",123
45,"45033",351,253,247,3,6,"PSOE",100
45,"45114",595,461,457,1,4,"PSOE",187
45,"45057",221,187,182,0,5,"PSOE",62
45,"45048",360,281,277,1,4,"PSOE",95
45,"45195",2161,1709,1686,12,23,"PSOE",754
45,"45109",2913,2295,2218,16,77,"PSOE",615
45,"45076",574,382,378,1,4,"PSOE",116
45,"45153",1613,1263,1248,11,15,"PSOE",340
45,"45113",1948,1409,1386,14,23,"PSOE",410
45,"45188",2783,2161,2127,9,34,"PSOE",723
45,"45201",3450,2212,2173,14,39,"PSOE",522
45,"45135",4302,3509,3453,21,56,"PSOE",1024
45,"45165",62857,46607,46141,313,466,"PSOE",11766
45,"45071",1863,1550,1530,8,20,"PSOE",632
45,"45001",1852,1395,1355,9,40,"PSOE",473
45,"45017",262,221,219,0,2,"PSOE",94
45,"45093",151,117,117,0,0,"PSOE",24
45,"45194",67,50,49,0,1,"PSOE",22
45,"45185",7734,6057,5973,27,84,"PSOE",2170
45,"45181",2313,1755,1728,12,27,"PSOE",658
45,"45029",205,169,169,0,0,"PSOE",67
45,"45151",586,444,437,1,7,"PSOE",151
45,"45108",521,415,414,2,1,"PSOE",173
45,"45164",186,160,160,0,0,"PSOE",38
45,"45173",9477,7145,7061,40,84,"PSOE",1756
45,"45191",549,477,475,0,2,"PSOE",197
45,"45028",3680,2919,2880,23,39,"PSOE",1110
45,"45158",2534,1885,1868,8,17,"PSOE",560
45,"45073",307,238,235,0,3,"PSOE",65
45,"45060",179,131,129,1,2,"PSOE",75
45,"45184",201,124,123,1,1,"PSOE",55
45,"45157",2125,1531,1509,14,22,"PSOE",278
45,"45137",1623,1106,1093,9,13,"PSOE",447
45,"45125",2329,1920,1898,10,22,"PSOE",671
45,"45047",2563,1775,1751,13,24,"PSOE",278
45,"45117",754,610,602,2,8,"PSOE",298
45,"45085",1501,1086,1067,6,19,"PSOE",200
45,"45069",1876,1446,1428,8,18,"PSOE",444
45,"45139",172,135,133,0,2,"PSOE",70
45,"45167",1458,1197,1187,5,10,"PSOE",370
45,"45205",6745,4708,4657,35,51,"PSOE",1168
45,"45152",597,476,476,2,0,"PSOE",216
45,"45024",1075,828,824,5,4,"PSOE",259
45,"45127",708,524,519,1,5,"PSOE",76
45,"45013",1786,1428,1412,7,16,"PSOE",404
45,"45111",60,47,47,0,0,"PSOE",23
45,"45099",3512,2514,2459,9,55,"PSOE",651
45,"45035",298,225,221,2,4,"PSOE",69
45,"45074",412,327,322,0,5,"PSOE",94
45,"45070",1461,1223,1202,7,21,"PSOE",342
45,"45131",287,242,242,0,0,"PSOE",87
45,"45116",694,531,523,2,8,"PSOE",175
45,"45067",2324,1871,1841,13,30,"PSOE",494
45,"45034",1360,1098,1083,4,15,"PSOE",304
45,"45059",1723,1413,1388,4,25,"PSOE",377
45,"45172",719,559,556,2,3,"PSOE",150
45,"45002",2549,1810,1784,7,26,"PSOE",578
45,"45042",190,145,145,0,0,"PSOE",39
45,"45088",2102,1438,1423,4,15,"PSOE",459
45,"45177",2142,1757,1731,11,26,"PSOE",569
45,"45063",428,320,310,2,10,"PSOE",117
45,"45140",1093,885,876,4,9,"PSOE",405
45,"45051",1594,1264,1248,6,16,"PSOE",511
45,"45075",146,108,105,0,3,"PSOE",23
45,"45019",7356,5539,5484,35,55,"PSOE",1612
45,"45039",226,197,193,1,4,"PSOE",47
45,"45007",697,566,560,1,6,"PSOE",276
45,"45203",2574,1938,1908,10,30,"PSOE",610
45,"45065",276,227,223,0,4,"PSOE",92
45,"45053",8045,6446,6370,44,76,"PSOE",2342
45,"45040",1396,871,862,4,9,"PSOE",242
45,"45004",568,436,430,1,6,"PSOE",133
45,"45142",7858,6249,6164,57,85,"PSOE",1771
45,"45101",3761,3090,3048,15,42,"PSOE",714
45,"45064",3839,2915,2884,19,31,"PSOE",675
45,"45052",2914,2389,2372,23,17,"PSOE",526
45,"45011",288,246,241,1,5,"PSOE",77
45,"45062",1121,910,894,10,16,"PSOE",257
45,"45032",436,317,313,0,4,"PSOE",100
45,"45159",86,75,72,1,3,"PSOE",20
45,"45020",1313,1062,1046,5,16,"PSOE",338
45,"45078",1392,1187,1179,8,8,"PSOE",430
45,"45041",3725,2698,2665,18,33,"PSOE",620
45,"45005",241,207,205,2,2,"PSOE",60
45,"45087",8345,6184,6091,34,93,"PSOE",1738
45,"45083",465,393,388,5,5,"PSOE",79
45,"45091",407,301,299,2,2,"PSOE",117
45,"45115",2563,2089,2048,5,41,"PSOE",792
45,"45066",7589,5716,5637,30,79,"PSOE",1317
45,"45147",581,475,469,4,6,"PSOE",142
45,"45055",1032,857,841,2,16,"PSOE",312
45,"45026",225,171,169,1,2,"PSOE",73
45,"45010",436,335,333,2,2,"PSOE",162
45,"45003",572,431,423,1,8,"PSOE",124
45,"45132",2096,1631,1616,7,15,"PSOE",249
45,"45068",173,138,135,0,3,"PSOE",63
45,"45198",1832,1521,1508,6,13,"PSOE",512
45,"45096",1015,832,817,7,15,"PSOE",200
45,"45080",6,6,6,0,0,"PSOE",1
45,"45023",2160,1669,1654,9,15,"PSOE",378
45,"45056",2210,1384,1370,11,14,"PSOE",379
45,"45095",697,529,520,1,9,"PSOE",179
45,"45128",2498,1794,1774,7,20,"PSOE",631
45,"45027",362,275,270,0,5,"PSOE",98
45,"45145",2539,1830,1811,11,19,"PSOE",407
45,"45141",897,735,727,4,8,"PSOE",263
45,"45171",1382,1090,1075,4,15,"PSOE",357
45,"45121",6766,4860,4798,30,62,"PSOE",1178
45,"45036",658,500,496,2,4,"PSOE",155
45,"45021",2459,1862,1833,21,29,"PSOE",580
45,"45050",471,354,351,2,3,"PSOE",101
45,"45200",4627,3678,3588,29,90,"PSOE",1443
45,"45090",376,299,295,4,4,"PSOE",131
45,"45126",260,169,167,1,2,"PSOE",62
45,"45045",1316,945,935,1,10,"PSOE",297
45,"45166",1629,1345,1332,5,13,"PSOE",582
45,"45102",3629,2685,2644,15,41,"PSOE",736
45,"45155",371,297,296,1,1,"PSOE",134
45,"45110",1799,1394,1380,4,14,"PSOE",618
45,"45148",307,229,219,1,10,"PSOE",74
45,"45130",319,258,252,1,6,"PSOE",86
45,"45094",395,312,308,0,4,"PSOE",91
45,"45186",3083,2369,2341,14,28,"PSOE",523
45,"45107",3238,2628,2597,15,31,"PSOE",556
45,"45189",597,467,458,2,9,"PSOE",104
45,"45025",1198,921,910,2,11,"PSOE",328
45,"45193",626,543,530,2,13,"PSOE",129
45,"45123",3075,2261,2222,11,39,"PSOE",544
45,"45082",1246,1046,1036,9,10,"PSOE",372
45,"45196",1388,1066,1054,13,12,"PSOE",405
45,"45179",546,406,403,3,3,"PSOE",130
45,"45030",482,364,361,4,3,"PSOE",120
45,"45097",1047,877,869,3,8,"PSOE",351
45,"45118",2002,1470,1456,3,14,"PSOE",457
45,"45901",769,577,571,1,6,"PSOE",176
45,"45058",384,304,301,4,3,"PSOE",87
45,"45182",1045,854,844,3,10,"PSOE",301
45,"45014",3984,2824,2802,24,22,"PSOE",1045
45,"45133",2818,2184,2146,19,38,"PSOE",704
45,"45169",193,136,136,1,0,"PSOE",49
45,"45100",197,166,164,2,2,"PSOE",75
45,"45138",1110,903,887,6,16,"PSOE",292
45,"45163",8338,6270,6142,57,128,"PSOE",1520
45,"45054",3995,2997,2968,8,29,"PSOE",799
45,"45170",235,183,176,4,7,"PSOE",41
45,"45008",142,114,114,2,0,"PSOE",43
45,"45006",1425,1022,1013,4,9,"PSOE",446
45,"45146",108,85,85,0,0,"PSOE",18
45,"45183",2253,1581,1569,8,12,"PSOE",292
45,"45143",1180,924,912,3,12,"PSOE",247
45,"45009",545,336,333,1,3,"PSOE",85
45,"45119",3348,2306,2264,14,42,"PSOE",527
45,"45180",2725,2060,2028,7,32,"PSOE",443
45,"45012",670,521,506,4,15,"PSOE",99
45,"45187",4078,3405,3353,14,52,"PSOE",1333
45,"45106",7524,5882,5784,55,98,"PSOE",1728
45,"45043",793,663,655,1,8,"PSOE",206
45,"45046",2421,1815,1796,8,19,"PSOE",745
45,"45098",2186,1686,1649,10,37,"PSOE",262
45,"45192",2503,2164,2141,7,23,"PSOE",815
45,"45122",5164,4112,4067,18,45,"PSOE",888
45,"45175",665,541,532,5,9,"PSOE",194
45,"45202",3905,2962,2920,12,42,"PSOE",939
45,"45049",435,330,326,0,4,"PSOE",93
45,"45086",503,375,369,3,6,"PSOE",121
45,"45061",2457,1718,1699,7,19,"PSOE",618
45,"45150",454,366,364,1,2,"PSOE",197
42,"42119",164,97,97,2,0,"PP",62
42,"42088",71,53,53,0,0,"PP",34
42,"42125",81,66,66,2,0,"PP",24
42,"42116",47,33,33,0,0,"PP",15
42,"42083",25,23,21,0,2,"PP",11
42,"42110",63,46,46,0,0,"PP",22
42,"42103",583,467,459,5,8,"PP",240
42,"42142",52,33,33,0,0,"PP",16
42,"42193",16,11,11,0,0,"PP",8
42,"42090",93,70,69,1,1,"PP",38
42,"42164",1614,1208,1190,9,18,"PP",507
42,"42019",516,367,363,4,4,"PP",156
42,"42003",66,59,57,1,2,"PP",19
42,"42093",40,29,29,3,0,"PP",19
42,"42027",76,56,56,0,0,"PP",24
42,"42086",38,29,29,1,0,"PP",17
42,"42041",35,25,25,0,0,"PP",9
42,"42154",97,78,78,1,0,"PP",26
42,"42139",22,16,16,0,0,"PP",9
42,"42050",31,18,18,0,0,"PP",12
42,"42145",137,121,121,3,0,"PP",55
42,"42124",64,44,44,0,0,"PP",25
42,"42191",187,135,132,2,3,"PP",55
42,"42026",24,20,20,0,0,"PP",11
42,"42128",39,37,37,1,0,"PP",18
42,"42129",692,522,516,4,6,"PP",204
42,"42054",20,14,14,0,0,"PP",3
42,"42001",279,219,215,2,4,"PP",78
42,"42025",1216,884,873,11,11,"PP",351
42,"42037",34,17,17,1,0,"PP",10
42,"42030",95,77,76,3,1,"PP",51
42,"42020",4288,3087,3044,42,43,"PP",1122
42,"42016",18,13,13,0,0,"PP",8
42,"42172",29,25,25,2,0,"PP",17
42,"42004",2296,1767,1748,32,19,"PP",810
42,"42095",1762,1319,1303,15,16,"PP",395
42,"42153",14,14,14,1,0,"PP",11
42,"42035",782,566,562,4,4,"PP",274
42,"42131",50,32,32,0,0,"PP",19
42,"42118",23,16,16,0,0,"PP",15
42,"42007",117,86,86,2,0,"PP",56
42,"42065",22,20,19,0,1,"PP",9
42,"42176",29,23,23,0,0,"PP",17
42,"42215",786,555,552,8,3,"PP",243
42,"42206",8,5,5,0,0,"PP",4
42,"42178",117,81,79,2,2,"PP",49
42,"42068",85,62,61,2,1,"PP",31
42,"42096",281,181,178,8,3,"PP",92
42,"42175",23,18,18,0,0,"PP",13
42,"42033",50,43,43,0,0,"PP",31
42,"42084",26,21,21,0,0,"PP",18
42,"42056",22,19,19,0,0,"PP",12
42,"42058",112,97,92,1,5,"PP",52
42,"42055",165,127,127,3,0,"PP",61
42,"42087",45,38,37,0,1,"PP",11
42,"42046",51,43,43,1,0,"PP",9
42,"42051",21,15,15,0,0,"PP",10
42,"42042",47,38,38,2,0,"PP",19
42,"42105",49,42,42,0,0,"PP",31
42,"42060",34,23,21,0,2,"PP",16
42,"42152",82,59,59,1,0,"PP",33
42,"42089",55,46,46,1,0,"PP",20
42,"42070",35,27,25,0,2,"PP",6
42,"42064",85,74,74,0,0,"PP",27
42,"42218",80,54,54,1,0,"PP",25
42,"42021",85,53,53,1,0,"PP",34
42,"42100",32,31,31,1,0,"PP",17
42,"42208",21,14,14,2,0,"PP",7
42,"42181",419,318,312,3,6,"PP",79
42,"42061",292,221,219,2,2,"PP",72
42,"42022",214,171,171,2,0,"PP",110
42,"42085",191,136,136,2,0,"PP",92
42,"42057",175,106,104,1,2,"PP",57
42,"42044",53,49,47,3,2,"PP",24
42,"42011",17,10,10,0,0,"PP",6
42,"42134",2642,1961,1938,24,23,"PP",702
42,"42187",63,55,54,1,1,"PP",40
42,"42053",26,21,21,1,0,"PP",15
42,"42015",32,25,25,0,0,"PP",18
42,"42092",65,42,41,1,1,"PP",29
42,"42023",66,53,53,0,0,"PP",28
42,"42024",87,68,67,0,1,"PP",37
42,"42012",37,29,29,0,0,"PP",12
42,"42108",12,10,10,0,0,"PP",8
42,"42182",57,45,45,1,0,"PP",35
42,"42216",25,21,21,0,0,"PP",11
42,"42045",312,218,214,1,4,"PP",110
42,"42028",70,49,49,0,0,"PP",19
42,"42008",57,38,38,0,0,"PP",25
42,"42120",148,98,98,1,0,"PP",44
42,"42211",83,67,67,1,0,"PP",36
42,"42212",69,54,54,3,0,"PP",24
42,"42155",173,105,104,1,1,"PP",77
42,"42167",259,195,194,2,1,"PP",85
42,"42177",71,55,54,1,1,"PP",24
42,"42111",307,221,220,1,1,"PP",110
42,"42075",87,63,63,1,0,"PP",35
42,"42151",35,31,29,2,2,"PP",8
42,"42207",41,33,33,1,0,"PP",15
42,"42094",608,470,463,9,7,"PP",161
42,"42156",30,21,21,0,0,"PP",11
42,"42189",64,50,50,2,0,"PP",24
42,"42197",76,61,59,1,2,"PP",32
42,"42043",3796,2833,2792,26,41,"PP",1343
42,"42157",13,10,10,1,0,"PP",9
42,"42171",128,78,78,1,0,"PP",49
42,"42190",94,71,71,1,0,"PP",24
42,"42048",67,53,51,1,2,"PP",26
42,"42107",74,51,48,1,3,"PP",26
42,"42194",176,127,126,2,1,"PP",57
42,"42071",169,111,109,2,2,"PP",52
42,"42165",408,289,282,7,7,"PP",108
42,"42049",120,75,73,1,2,"PP",48
42,"42031",26,19,19,0,0,"PP",14
42,"42209",146,111,108,3,3,"PP",51
42,"42115",63,46,46,0,0,"PP",31
42,"42195",100,60,60,3,0,"PP",31
42,"42192",41,31,31,1,0,"PP",8
42,"42201",23,23,22,0,1,"PP",9
42,"42219",43,32,32,0,0,"PP",13
42,"42149",393,300,293,1,7,"PP",104
42,"42162",2363,1690,1672,21,18,"PP",857
42,"42205",93,64,63,0,1,"PP",26
42,"42036",50,39,38,0,1,"PP",7
42,"42159",38,33,32,1,1,"PP",18
42,"42135",75,53,53,1,0,"PP",23
42,"42073",72,56,56,0,0,"PP",29
42,"42017",142,115,114,1,1,"PP",31
42,"42080",155,113,110,0,3,"PP",63
42,"42130",60,51,50,3,1,"PP",29
42,"42168",109,88,88,1,0,"PP",37
42,"42217",31,25,25,0,0,"PP",5
42,"42173",29201,21456,21181,272,275,"PP",6446
42,"42059",20,14,14,0,0,"PP",7
42,"42009",80,65,64,2,1,"PP",36
42,"42163",49,37,37,0,0,"PP",18
42,"42123",165,119,119,4,0,"PP",60
42,"42010",18,14,14,0,0,"PP",7
42,"42160",261,205,203,1,2,"PP",72
42,"42121",64,48,48,1,0,"PP",22
42,"42185",25,21,21,0,0,"PP",13
42,"42076",219,176,173,4,3,"PP",77
42,"42081",143,111,106,2,5,"PP",56
42,"42148",10,10,10,0,0,"PP",8
42,"42063",49,37,37,1,0,"PP",19
42,"42069",1529,1078,1066,10,12,"PP",380
42,"42213",29,18,18,1,0,"PP",11
42,"42132",143,118,117,0,1,"PP",61
42,"42198",22,17,17,0,0,"PP",9
42,"42062",25,16,15,0,1,"PP",8
42,"42039",233,148,146,2,2,"PP",56
42,"42034",31,22,22,0,0,"PP",12
42,"42141",111,79,79,0,0,"PP",38
42,"42174",180,149,148,1,1,"PP",33
42,"42196",11,10,10,0,0,"PP",6
42,"42161",140,106,106,2,0,"PP",60
42,"42183",111,79,78,2,1,"PP",56
42,"42052",15,13,13,0,0,"PP",9
42,"42006",164,121,118,8,3,"PP",52
42,"42144",442,357,352,5,5,"PP",136
42,"42158",110,78,78,1,0,"PP",30
42,"42032",148,117,117,0,0,"PP",76
42,"42082",9,8,8,1,0,"PP",4
42,"42202",24,12,11,0,1,"PP",9
42,"42188",50,44,43,0,1,"PP",18
42,"42166",60,40,40,0,0,"PP",23
42,"42140",16,10,10,1,0,"PP",9
42,"42014",66,43,43,2,0,"PP",25
42,"42097",21,14,14,0,0,"PP",1
42,"42106",15,9,9,0,0,"PP",6
42,"42098",11,6,6,0,0,"PP",2
42,"42117",148,113,111,3,2,"PP",50
42,"42038",36,27,27,2,0,"PP",18
42,"42013",35,28,28,0,0,"PP",13
42,"42127",40,27,27,1,0,"PP",17
42,"42018",152,116,114,0,2,"PP",66
42,"42078",1031,752,744,6,8,"PP",343
42,"42079",27,17,17,1,0,"PP",12
42,"42113",512,390,386,3,4,"PP",214
42,"42184",59,45,44,2,1,"PP",18
42,"42200",84,60,60,2,0,"PP",40
42,"42029",143,106,106,0,0,"PP",63
42,"42204",56,39,38,0,1,"PP",13
36,"36015",4205,2941,2885,32,56,"C's",155
36,"36028",4139,3094,3045,22,49,"C's",201
36,"36004",10178,7351,7224,69,127,"C's",555
36,"36019",1625,1127,1119,12,8,"C's",62
36,"36022",9056,6635,6514,48,121,"C's",446
36,"36026",20203,14399,14189,144,210,"C's",1430
36,"36040",2600,1907,1869,13,38,"C's",127
36,"36003",9979,7496,7401,81,95,"C's",797
36,"36016",1173,724,716,7,8,"C's",31
36,"36050",7562,5567,5457,44,110,"C's",420
36,"36027",4452,3328,3274,23,54,"C's",245
36,"36041",13428,9842,9710,96,132,"C's",1129
36,"36014",1980,1464,1442,7,22,"C's",88
36,"36023",8420,6287,6180,55,107,"C's",578
36,"36057",236957,177555,175758,1730,1797,"C's",17500
36,"36002",3151,2290,2255,19,35,"C's",135
36,"36010",2862,2195,2177,18,18,"C's",151
36,"36038",66390,49943,49439,522,504,"C's",5352
36,"36046",4055,3189,3139,30,50,"C's",259
36,"36056",5108,3856,3783,34,73,"C's",284
36,"36029",16129,12262,12078,101,184,"C's",969
36,"36045",24570,18613,18365,184,248,"C's",1282
36,"36005",8120,5839,5747,64,92,"C's",452
36,"36017",17866,13133,12910,137,223,"C's",836
36,"36042",17922,12993,12760,116,233,"C's",1186
36,"36039",15350,11581,11349,119,232,"C's",1058
36,"36901",4095,3344,3293,22,51,"C's",232
36,"36053",5693,4321,4265,41,56,"C's",326
36,"36044",2556,1786,1747,13,39,"C's",140
36,"36018",3272,2288,2262,17,26,"C's",159
36,"36036",2511,1923,1892,17,31,"C's",125
36,"36058",4992,3495,3441,48,54,"C's",231
36,"36037",2607,1862,1838,16,24,"C's",112
36,"36043",4736,3347,3297,22,50,"C's",244
36,"36048",5348,3970,3892,44,78,"C's",282
36,"36047",2492,1719,1704,16,15,"C's",57
36,"36051",14272,10230,10072,95,158,"C's",1006
36,"36006",11537,8885,8740,79,145,"C's",613
36,"36032",3655,2745,2699,21,46,"C's",168
36,"36008",21736,16270,16094,160,176,"C's",1202
36,"36030",4220,3041,2994,32,47,"C's",194
36,"36049",6761,5193,5069,54,124,"C's",484
36,"36060",30350,22032,21753,193,279,"C's",2079
36,"36033",12347,9515,9336,76,179,"C's",728
36,"36020",2351,1748,1721,20,27,"C's",116
36,"36055",13643,10361,10145,106,216,"C's",1078
36,"36024",16433,12239,12016,115,223,"C's",1056
36,"36031",558,464,454,9,10,"C's",37
36,"36012",3735,2818,2777,21,41,"C's",140
36,"36009",4908,3167,3114,25,53,"C's",183
36,"36034",3477,2499,2470,15,29,"C's",148
36,"36001",2593,1968,1952,6,16,"C's",120
36,"36011",1842,1185,1169,9,16,"C's",53
36,"36035",14430,10832,10680,86,152,"C's",1192
36,"36013",2412,1602,1586,12,16,"C's",95
36,"36021",12033,9035,8879,99,156,"C's",880
36,"36007",1689,1168,1148,12,20,"C's",70
36,"36061",8651,6594,6445,58,149,"C's",500
36,"36052",7298,5298,5175,37,123,"C's",377
36,"36059",4937,3379,3318,46,61,"C's",244
36,"36054",10996,8116,7965,84,151,"C's",616
36,"36025",2292,1396,1389,9,7,"C's",134
41,"41029",13423,9979,9880,84,99,"PCOE",8
41,"41027",3941,2766,2709,28,57,"PCOE",2
41,"41087",10202,7160,7033,51,127,"PCOE",5
41,"41102",14635,10904,10655,148,249,"PCOE",17
41,"41016",7310,5473,5410,50,63,"PCOE",8
41,"41055",15009,10393,10292,82,101,"PCOE",11
41,"41046",3017,2416,2381,12,35,"PCOE",0
41,"41015",5310,3799,3710,38,89,"PCOE",5
41,"41078",2522,1888,1874,5,14,"PCOE",5
41,"41061",2218,1769,1742,5,27,"PCOE",0
41,"41074",3033,2362,2341,8,21,"PCOE",0
41,"41002",1469,1085,1061,12,24,"PCOE",1
41,"41035",1112,887,876,5,11,"PCOE",1
41,"41022",4300,2918,2891,30,27,"PCOE",2
41,"41089",6504,4759,4691,51,68,"PCOE",3
41,"41017",15052,11074,10964,99,110,"PCOE",7
41,"41023",7919,5852,5788,34,64,"PCOE",6
41,"41033",5102,3655,3613,25,42,"PCOE",6
41,"41063",2683,1942,1922,21,20,"PCOE",0
41,"41081",29164,21631,21410,218,221,"PCOE",28
41,"41059",33977,26158,25965,230,193,"PCOE",24
41,"41092",7749,5715,5647,57,68,"PCOE",9
41,"41013",4842,3491,3461,22,30,"PCOE",2
41,"41025",2041,1456,1430,17,26,"PCOE",1
41,"41903",6747,4926,4854,43,72,"PCOE",4
41,"41034",23033,15936,15711,189,225,"PCOE",20
41,"41019",4654,3267,3224,34,43,"PCOE",6
41,"41053",21252,16022,15770,121,252,"PCOE",36
41,"41100",1025,770,751,5,19,"PCOE",0
41,"41003",2319,1782,1754,8,28,"PCOE",0
41,"41014",2510,1981,1958,8,23,"PCOE",0
41,"41032",4019,2943,2875,17,68,"PCOE",4
41,"41083",1154,893,888,3,5,"PCOE",1
41,"41009",1229,811,803,5,8,"PCOE",1
41,"41006",2740,1909,1897,13,12,"PCOE",1
41,"41080",1270,954,938,8,16,"PCOE",0
41,"41093",18487,14687,14594,117,93,"PCOE",5
41,"41057",275,193,191,0,2,"PCOE",1
41,"41024",22662,15742,15521,137,221,"PCOE",24
41,"41067",7115,5248,5178,46,70,"PCOE",2
41,"41095",41137,28987,28731,302,256,"PCOE",33
41,"41901",2676,2222,2190,31,32,"PCOE",1
41,"41073",1715,1194,1169,9,25,"PCOE",2
41,"41070",6021,4504,4456,44,48,"PCOE",4
41,"41007",12386,8552,8403,90,149,"PCOE",12
41,"41096",6166,4811,4752,39,59,"PCOE",3
41,"41071",5620,3974,3898,17,76,"PCOE",5
41,"41028",1971,1574,1562,11,12,"PCOE",0
41,"41088",518,381,377,0,4,"PCOE",0
41,"41038",99637,71611,71050,727,561,"PCOE",89
41,"41084",2850,2205,2157,15,48,"PCOE",4
41,"41086",16102,10743,10665,93,78,"PCOE",20
41,"41072",4052,3115,3041,18,74,"PCOE",0
41,"41902",4675,3051,3019,20,32,"PCOE",1
41,"41012",3286,2268,2235,15,33,"PCOE",3
41,"41098",4952,3762,3704,24,58,"PCOE",1
41,"41058",17304,12982,12751,133,231,"PCOE",26
41,"41050",5158,4123,4078,37,45,"PCOE",5
41,"41026",4325,3551,3516,18,35,"PCOE",1
41,"41101",5932,4454,4421,27,33,"PCOE",5
41,"41051",2170,1650,1611,8,39,"PCOE",0
41,"41056",3691,3069,3042,21,27,"PCOE",0
41,"41043",636,439,435,3,4,"PCOE",0
41,"41011",15395,11527,11341,114,186,"PCOE",13
41,"41037",3203,2473,2449,18,24,"PCOE",1
41,"41047",10086,7758,7663,80,95,"PCOE",4
41,"41045",5749,4121,4066,49,55,"PCOE",6
41,"41060",15279,10611,10447,91,164,"PCOE",8
41,"41048",2244,1625,1598,22,27,"PCOE",1
41,"41054",688,587,570,2,17,"PCOE",0
41,"41090",3541,2774,2721,17,53,"PCOE",1
41,"41065",22868,15933,15784,172,149,"PCOE",10
41,"41077",8728,6423,6308,28,115,"PCOE",7
41,"41066",1363,1019,1007,7,12,"PCOE",0
41,"41001",1597,1262,1248,5,14,"PCOE",1
41,"41068",13948,10269,10150,75,119,"PCOE",6
41,"41076",2184,1442,1432,19,10,"PCOE",1
41,"41010",4394,3203,3160,19,43,"PCOE",4
41,"41020",12872,8820,8723,92,97,"PCOE",9
41,"41031",1257,838,836,8,2,"PCOE",2
41,"41049",9301,7147,7070,63,77,"PCOE",6
41,"41030",516,409,395,2,14,"PCOE",0
41,"41040",10411,7959,7892,53,67,"PCOE",5
41,"41044",7392,5562,5526,40,36,"PCOE",6
41,"41075",10225,7387,7283,55,104,"PCOE",4
41,"41041",9743,7620,7482,39,138,"PCOE",5
41,"41005",9057,6781,6693,58,88,"PCOE",15
41,"41085",4086,3223,3178,31,45,"PCOE",4
41,"41082",3432,2809,2781,12,28,"PCOE",2
41,"41052",3006,2264,2209,8,55,"PCOE",0
41,"41036",3971,2846,2806,14,40,"PCOE",3
41,"41021",21249,15031,14854,152,177,"PCOE",15
41,"41091",541928,401177,398212,3487,2965,"PCOE",371
41,"41069",29070,20827,20558,355,269,"PCOE",24
41,"41099",3998,2597,2577,19,20,"PCOE",2
41,"41039",31674,23240,22982,196,258,"PCOE",20
41,"41079",9343,7111,7029,68,82,"PCOE",11
41,"41004",56552,40018,39623,515,395,"PCOE",37
41,"41094",6288,4726,4653,36,73,"PCOE",3
41,"41018",9490,6997,6930,45,67,"PCOE",9
41,"41008",1063,820,805,3,15,"PCOE",1
41,"41097",3135,2339,2317,19,22,"PCOE",2
41,"41042",5868,4612,4583,37,29,"PCOE",5
41,"41064",5601,3766,3715,42,51,"PCOE",1
41,"41062",2235,1805,1790,10,15,"PCOE",0
42,"42056",22,19,19,0,0,"PSOE",1
42,"42058",112,97,92,1,5,"PSOE",18
42,"42029",143,106,106,0,0,"PSOE",22
42,"42042",47,38,38,2,0,"PSOE",1
42,"42193",16,11,11,0,0,"PSOE",0
42,"42092",65,42,41,1,1,"PSOE",2
42,"42097",21,14,14,0,0,"PSOE",6
42,"42022",214,171,171,2,0,"PSOE",18
42,"42189",64,50,50,2,0,"PSOE",10
42,"42045",312,218,214,1,4,"PSOE",44
42,"42187",63,55,54,1,1,"PSOE",2
42,"42111",307,221,220,1,1,"PSOE",56
42,"42151",35,31,29,2,2,"PSOE",10
42,"42031",26,19,19,0,0,"PSOE",1
42,"42034",31,22,22,0,0,"PSOE",3
42,"42007",117,86,86,2,0,"PSOE",10
42,"42100",32,31,31,1,0,"PSOE",8
42,"42087",45,38,37,0,1,"PSOE",6
42,"42086",38,29,29,1,0,"PSOE",5
42,"42084",26,21,21,0,0,"PSOE",2
42,"42108",12,10,10,0,0,"PSOE",1
42,"42142",52,33,33,0,0,"PSOE",5
42,"42088",71,53,53,0,0,"PSOE",8
42,"42008",57,38,38,0,0,"PSOE",5
42,"42044",53,49,47,3,2,"PSOE",2
42,"42010",18,14,14,0,0,"PSOE",1
42,"42018",152,116,114,0,2,"PSOE",17
42,"42134",2642,1961,1938,24,23,"PSOE",465
42,"42131",50,32,32,0,0,"PSOE",9
42,"42046",51,43,43,1,0,"PSOE",7
42,"42188",50,44,43,0,1,"PSOE",10
42,"42184",59,45,44,2,1,"PSOE",10
42,"42130",60,51,50,3,1,"PSOE",4
42,"42125",81,66,66,2,0,"PSOE",29
42,"42021",85,53,53,1,0,"PSOE",4
42,"42149",393,300,293,1,7,"PSOE",72
42,"42020",4288,3087,3044,42,43,"PSOE",779
42,"42011",17,10,10,0,0,"PSOE",2
42,"42185",25,21,21,0,0,"PSOE",5
42,"42161",140,106,106,2,0,"PSOE",18
42,"42156",30,21,21,0,0,"PSOE",5
42,"42164",1614,1208,1190,9,18,"PSOE",276
42,"42145",137,121,121,3,0,"PSOE",33
42,"42204",56,39,38,0,1,"PSOE",7
42,"42009",80,65,64,2,1,"PSOE",3
42,"42004",2296,1767,1748,32,19,"PSOE",419
42,"42106",15,9,9,0,0,"PSOE",0
42,"42090",93,70,69,1,1,"PSOE",15
42,"42107",74,51,48,1,3,"PSOE",6
42,"42157",13,10,10,1,0,"PSOE",0
42,"42201",23,23,22,0,1,"PSOE",9
42,"42196",11,10,10,0,0,"PSOE",2
42,"42093",40,29,29,3,0,"PSOE",0
42,"42200",84,60,60,2,0,"PSOE",9
42,"42191",187,135,132,2,3,"PSOE",39
42,"42035",782,566,562,4,4,"PSOE",144
42,"42015",32,25,25,0,0,"PSOE",1
42,"42115",63,46,46,0,0,"PSOE",1
42,"42019",516,367,363,4,4,"PSOE",63
42,"42128",39,37,37,1,0,"PSOE",8
42,"42001",279,219,215,2,4,"PSOE",69
42,"42016",18,13,13,0,0,"PSOE",1
42,"42158",110,78,78,1,0,"PSOE",19
42,"42048",67,53,51,1,2,"PSOE",8
42,"42119",164,97,97,2,0,"PSOE",6
42,"42165",408,289,282,7,7,"PSOE",77
42,"42177",71,55,54,1,1,"PSOE",15
42,"42135",75,53,53,1,0,"PSOE",11
42,"42139",22,16,16,0,0,"PSOE",1
42,"42012",37,29,29,0,0,"PSOE",4
42,"42192",41,31,31,1,0,"PSOE",11
42,"42206",8,5,5,0,0,"PSOE",0
42,"42162",2363,1690,1672,21,18,"PSOE",345
42,"42013",35,28,28,0,0,"PSOE",5
42,"42055",165,127,127,3,0,"PSOE",33
42,"42144",442,357,352,5,5,"PSOE",92
42,"42036",50,39,38,0,1,"PSOE",15
42,"42041",35,25,25,0,0,"PSOE",6
42,"42003",66,59,57,1,2,"PSOE",14
42,"42140",16,10,10,1,0,"PSOE",0
42,"42160",261,205,203,1,2,"PSOE",45
42,"42085",191,136,136,2,0,"PSOE",26
42,"42132",143,118,117,0,1,"PSOE",31
42,"42208",21,14,14,2,0,"PSOE",1
42,"42030",95,77,76,3,1,"PSOE",4
42,"42006",164,121,118,8,3,"PSOE",8
42,"42095",1762,1319,1303,15,16,"PSOE",296
42,"42053",26,21,21,1,0,"PSOE",2
42,"42026",24,20,20,0,0,"PSOE",4
42,"42118",23,16,16,0,0,"PSOE",0
42,"42178",117,81,79,2,2,"PSOE",14
42,"42043",3796,2833,2792,26,41,"PSOE",510
42,"42049",120,75,73,1,2,"PSOE",8
42,"42153",14,14,14,1,0,"PSOE",2
42,"42209",146,111,108,3,3,"PSOE",23
42,"42205",93,64,63,0,1,"PSOE",15
42,"42195",100,60,60,3,0,"PSOE",13
42,"42073",72,56,56,0,0,"PSOE",5
42,"42027",76,56,56,0,0,"PSOE",11
42,"42103",583,467,459,5,8,"PSOE",93
42,"42096",281,181,178,8,3,"PSOE",26
42,"42182",57,45,45,1,0,"PSOE",3
42,"42116",47,33,33,0,0,"PSOE",11
42,"42028",70,49,49,0,0,"PSOE",10
42,"42141",111,79,79,0,0,"PSOE",19
42,"42211",83,67,67,1,0,"PSOE",8
42,"42120",148,98,98,1,0,"PSOE",23
42,"42183",111,79,78,2,1,"PSOE",3
42,"42069",1529,1078,1066,10,12,"PSOE",265
42,"42105",49,42,42,0,0,"PSOE",1
42,"42075",87,63,63,1,0,"PSOE",8
42,"42121",64,48,48,1,0,"PSOE",13
42,"42163",49,37,37,0,0,"PSOE",8
42,"42017",142,115,114,1,1,"PSOE",37
42,"42033",50,43,43,0,0,"PSOE",5
42,"42167",259,195,194,2,1,"PSOE",50
42,"42117",148,113,111,3,2,"PSOE",11
42,"42032",148,117,117,0,0,"PSOE",22
42,"42070",35,27,25,0,2,"PSOE",12
42,"42052",15,13,13,0,0,"PSOE",0
42,"42098",11,6,6,0,0,"PSOE",2
42,"42212",69,54,54,3,0,"PSOE",3
42,"42060",34,23,21,0,2,"PSOE",1
42,"42197",76,61,59,1,2,"PSOE",16
42,"42076",219,176,173,4,3,"PSOE",40
42,"42152",82,59,59,1,0,"PSOE",12
42,"42194",176,127,126,2,1,"PSOE",36
42,"42014",66,43,43,2,0,"PSOE",6
42,"42057",175,106,104,1,2,"PSOE",16
42,"42123",165,119,119,4,0,"PSOE",10
42,"42089",55,46,46,1,0,"PSOE",13
42,"42198",22,17,17,0,0,"PSOE",3
42,"42181",419,318,312,3,6,"PSOE",129
42,"42124",64,44,44,0,0,"PSOE",9
42,"42171",128,78,78,1,0,"PSOE",13
42,"42071",169,111,109,2,2,"PSOE",21
42,"42023",66,53,53,0,0,"PSOE",12
42,"42215",786,555,552,8,3,"PSOE",186
42,"42154",97,78,78,1,0,"PSOE",23
42,"42172",29,25,25,2,0,"PSOE",1
42,"42166",60,40,40,0,0,"PSOE",7
42,"42110",63,46,46,0,0,"PSOE",7
42,"42062",25,16,15,0,1,"PSOE",3
42,"42079",27,17,17,1,0,"PSOE",1
42,"42024",87,68,67,0,1,"PSOE",12
42,"42216",25,21,21,0,0,"PSOE",6
42,"42050",31,18,18,0,0,"PSOE",0
42,"42063",49,37,37,1,0,"PSOE",8
42,"42155",173,105,104,1,1,"PSOE",10
42,"42051",21,15,15,0,0,"PSOE",0
42,"42159",38,33,32,1,1,"PSOE",5
42,"42080",155,113,110,0,3,"PSOE",22
42,"42059",20,14,14,0,0,"PSOE",3
42,"42127",40,27,27,1,0,"PSOE",6
42,"42037",34,17,17,1,0,"PSOE",1
42,"42173",29201,21456,21181,272,275,"PSOE",5500
42,"42025",1216,884,873,11,11,"PSOE",283
42,"42064",85,74,74,0,0,"PSOE",30
42,"42168",109,88,88,1,0,"PSOE",25
42,"42207",41,33,33,1,0,"PSOE",2
42,"42174",180,149,148,1,1,"PSOE",46
42,"42217",31,25,25,0,0,"PSOE",13
42,"42094",608,470,463,9,7,"PSOE",78
42,"42202",24,12,11,0,1,"PSOE",1
42,"42081",143,111,106,2,5,"PSOE",31
42,"42213",29,18,18,1,0,"PSOE",2
42,"42038",36,27,27,2,0,"PSOE",1
42,"42218",80,54,54,1,0,"PSOE",4
42,"42113",512,390,386,3,4,"PSOE",80
42,"42082",9,8,8,1,0,"PSOE",0
42,"42061",292,221,219,2,2,"PSOE",45
42,"42190",94,71,71,1,0,"PSOE",24
42,"42078",1031,752,744,6,8,"PSOE",154
42,"42148",10,10,10,0,0,"PSOE",0
42,"42039",233,148,146,2,2,"PSOE",47
42,"42065",22,20,19,0,1,"PSOE",1
42,"42175",23,18,18,0,0,"PSOE",1
42,"42129",692,522,516,4,6,"PSOE",146
42,"42054",20,14,14,0,0,"PSOE",7
42,"42176",29,23,23,0,0,"PSOE",1
42,"42219",43,32,32,0,0,"PSOE",7
42,"42083",25,23,21,0,2,"PSOE",4
42,"42068",85,62,61,2,1,"PSOE",8
19,"19009",261,193,190,5,3,"C's",13
19,"19293",1868,1379,1364,9,15,"C's",302
19,"19008",37,28,28,0,0,"C's",0
19,"19156",983,743,735,5,8,"C's",92
19,"19190",2405,1852,1833,14,19,"C's",235
19,"19001",53,36,36,1,0,"C's",3
19,"19301",38,30,30,0,0,"C's",0
19,"19031",15,10,9,0,1,"C's",0
19,"19103",255,205,201,0,4,"C's",33
19,"19286",725,557,551,1,6,"C's",111
19,"19013",128,106,106,0,0,"C's",6
19,"19327",431,348,342,3,6,"C's",39
19,"19325",128,89,88,0,1,"C's",14
19,"19150",126,94,93,0,1,"C's",4
19,"19110",57,46,45,2,1,"C's",3
19,"19271",47,30,30,0,0,"C's",0
19,"19188",50,34,32,1,2,"C's",5
19,"19257",3446,2532,2499,36,33,"C's",310
19,"19142",260,189,186,2,3,"C's",21
19,"19226",48,35,35,0,0,"C's",3
19,"19233",91,71,71,1,0,"C's",4
19,"19258",97,73,73,1,0,"C's",7
19,"19240",52,38,37,0,1,"C's",2
19,"19210",21,19,19,2,0,"C's",0
19,"19294",23,19,19,1,0,"C's",1
19,"19227",74,49,49,0,0,"C's",1
19,"19108",112,90,90,1,0,"C's",16
19,"19053",2024,1479,1464,13,15,"C's",143
19,"19167",132,106,103,0,3,"C's",13
19,"19178",39,25,25,0,0,"C's",1
19,"19080",73,51,50,0,1,"C's",5
19,"19322",31,26,26,0,0,"C's",2
19,"19157",57,45,45,0,0,"C's",4
19,"19132",93,74,74,0,0,"C's",10
19,"19047",67,60,60,1,0,"C's",4
19,"19255",78,61,61,0,0,"C's",2
19,"19329",58,49,49,0,0,"C's",8
19,"19061",56,47,47,0,0,"C's",8
19,"19331",2611,2010,1982,18,28,"C's",335
19,"19033",64,49,49,3,0,"C's",9
19,"19223",110,76,76,3,0,"C's",5
19,"19212",727,562,551,8,11,"C's",78
19,"19111",158,123,121,0,2,"C's",7
19,"19252",67,58,58,0,0,"C's",1
19,"19124",382,256,253,0,3,"C's",37
19,"19116",13,11,11,0,0,"C's",1
19,"19288",23,22,22,0,0,"C's",2
19,"19145",48,42,42,2,0,"C's",9
19,"19224",93,80,80,0,0,"C's",7
19,"19228",29,21,20,0,1,"C's",1
19,"19121",257,209,208,0,1,"C's",21
19,"19299",95,74,74,1,0,"C's",16
19,"19016",64,42,42,0,0,"C's",1
19,"19246",46,36,36,0,0,"C's",4
19,"19230",504,383,376,4,7,"C's",104
19,"19015",81,68,68,0,0,"C's",7
19,"19250",21,16,15,0,1,"C's",2
19,"19022",632,477,468,3,9,"C's",76
19,"19208",43,31,31,0,0,"C's",2
19,"19148",45,37,37,1,0,"C's",4
19,"19280",3451,2620,2581,14,39,"C's",574
19,"19183",83,74,73,0,1,"C's",3
19,"19304",220,161,161,1,0,"C's",20
19,"19232",79,60,59,1,1,"C's",5
19,"19090",97,77,77,1,0,"C's",1
19,"19106",92,67,64,0,3,"C's",6
19,"19254",49,36,36,1,0,"C's",6
19,"19281",22,18,18,0,0,"C's",3
19,"19024",8143,6017,5944,33,73,"C's",1460
19,"19265",136,104,104,0,0,"C's",15
19,"19251",42,29,28,0,1,"C's",0
19,"19138",272,197,196,0,1,"C's",18
19,"19260",41,38,38,1,0,"C's",1
19,"19034",22,18,18,0,0,"C's",5
19,"19171",4884,3824,3778,24,46,"C's",625
19,"19189",120,91,90,2,1,"C's",8
19,"19135",105,82,82,0,0,"C's",10
19,"19049",12,11,11,0,0,"C's",3
19,"19099",299,206,205,1,1,"C's",11
19,"19221",50,35,35,0,0,"C's",1
19,"19259",28,18,18,0,0,"C's",2
19,"19217",59,39,37,0,2,"C's",1
19,"19308",65,54,54,0,0,"C's",5
19,"19163",61,44,43,1,1,"C's",2
19,"19046",21452,16321,16151,91,170,"C's",3243
19,"19152",589,448,439,2,9,"C's",31
19,"19087",18,17,17,0,0,"C's",1
19,"19268",36,26,25,0,1,"C's",3
19,"19155",66,54,53,0,1,"C's",7
19,"19296",30,21,21,0,0,"C's",1
19,"19170",193,140,140,0,0,"C's",16
19,"19220",2305,1613,1600,9,13,"C's",340
19,"19098",21,20,20,0,0,"C's",3
19,"19256",44,35,35,0,0,"C's",2
19,"19310",11,7,7,0,0,"C's",0
19,"19203",31,25,25,0,0,"C's",3
19,"19298",64,49,49,0,0,"C's",10
19,"19044",309,248,246,3,2,"C's",20
19,"19011",254,191,191,2,0,"C's",17
19,"19104",18,13,13,1,0,"C's",0
19,"19088",84,68,68,0,0,"C's",5
19,"19332",93,68,68,0,0,"C's",8
19,"19166",158,125,124,0,1,"C's",11
19,"19176",237,181,181,0,0,"C's",20
19,"19134",26,18,18,0,0,"C's",1
19,"19244",81,61,59,2,2,"C's",8
19,"19231",12,8,8,1,0,"C's",1
19,"19113",471,365,365,2,0,"C's",32
19,"19319",4425,3336,3304,21,32,"C's",814
19,"19196",106,86,80,0,6,"C's",12
19,"19191",13,12,12,0,0,"C's",0
19,"19305",162,129,128,1,1,"C's",6
19,"19118",13,10,10,0,0,"C's",0
19,"19089",28,17,17,0,0,"C's",0
19,"19175",34,26,26,1,0,"C's",0
19,"19122",93,72,72,3,0,"C's",5
19,"19054",190,165,163,3,2,"C's",19
19,"19130",59955,47034,46504,383,530,"C's",8666
19,"19060",150,115,114,1,1,"C's",14
19,"19074",73,63,63,0,0,"C's",10
19,"19048",17,10,10,1,0,"C's",1
19,"19168",297,227,224,2,3,"C's",24
19,"19057",72,53,52,0,1,"C's",0
19,"19172",55,44,44,0,0,"C's",3
19,"19274",895,673,664,8,9,"C's",98
19,"19317",141,107,103,0,4,"C's",8
19,"19287",144,109,109,0,0,"C's",10
19,"19154",66,52,51,0,1,"C's",2
19,"19097",17,13,13,0,0,"C's",1
19,"19245",1179,913,893,6,20,"C's",92
19,"19330",71,64,64,0,0,"C's",6
19,"19272",72,59,59,1,0,"C's",5
19,"19173",47,40,37,0,3,"C's",3
19,"19139",31,23,23,1,0,"C's",0
19,"19234",46,38,38,0,0,"C's",3
19,"19160",899,601,597,2,4,"C's",77
19,"19023",117,101,99,1,2,"C's",17
19,"19004",66,51,50,1,1,"C's",6
19,"19147",46,34,33,0,1,"C's",0
19,"19076",31,20,20,0,0,"C's",0
19,"19041",160,133,132,0,1,"C's",15
19,"19174",111,79,78,0,1,"C's",6
19,"19187",50,46,44,0,2,"C's",4
19,"19125",45,40,40,0,0,"C's",5
19,"19269",100,80,79,0,1,"C's",2
19,"19006",768,545,538,0,7,"C's",79
19,"19211",394,297,291,1,6,"C's",33
19,"19324",179,136,135,0,1,"C's",9
19,"19303",46,39,38,0,1,"C's",1
19,"19219",13,9,9,0,0,"C's",0
19,"19199",19,16,16,1,0,"C's",3
19,"19270",22,18,18,0,0,"C's",1
19,"19066",61,49,47,0,2,"C's",3
19,"19003",41,37,35,0,2,"C's",2
19,"19136",18,15,15,0,0,"C's",0
19,"19285",25,16,16,2,0,"C's",1
19,"19126",1620,1242,1216,5,26,"C's",287
19,"19086",1495,1158,1149,7,9,"C's",128
19,"19027",148,116,115,1,1,"C's",4
19,"19300",762,628,624,3,4,"C's",150
19,"19055",53,34,33,2,1,"C's",0
19,"19102",101,84,84,0,0,"C's",4
19,"19314",52,35,34,1,1,"C's",6
19,"19216",134,97,97,0,0,"C's",11
19,"19052",27,18,18,1,0,"C's",3
19,"19213",72,53,51,0,2,"C's",3
19,"19040",51,41,41,0,0,"C's",4
19,"19186",81,63,63,1,0,"C's",1
19,"19225",835,645,638,2,7,"C's",127
19,"19169",43,36,36,0,0,"C's",0
19,"19091",29,20,20,0,0,"C's",1
19,"19198",17,10,10,0,0,"C's",1
19,"19151",1075,779,764,5,15,"C's",104
19,"19129",29,25,25,0,0,"C's",5
19,"19306",28,20,20,0,0,"C's",1
19,"19092",417,316,312,4,4,"C's",38
19,"19165",48,40,40,0,0,"C's",3
19,"19058",6786,5451,5415,29,36,"C's",1283
19,"19901",41,37,36,1,1,"C's",1
19,"19161",218,151,151,1,0,"C's",18
19,"19050",15,13,13,0,0,"C's",2
19,"19081",31,21,21,0,0,"C's",1
19,"19261",38,25,25,0,0,"C's",3
19,"19010",9,9,9,0,0,"C's",2
19,"19038",28,23,23,0,0,"C's",4
19,"19307",25,23,23,1,0,"C's",1
19,"19117",1580,1183,1167,11,16,"C's",207
19,"19002",73,56,54,0,2,"C's",2
19,"19114",39,26,26,0,0,"C's",2
19,"19071",7746,5748,5678,34,70,"C's",1476
19,"19039",60,55,54,1,1,"C's",2
19,"19143",1733,1371,1352,9,19,"C's",199
19,"19153",23,22,22,0,0,"C's",1
19,"19277",18,12,12,0,0,"C's",0
19,"19237",47,35,34,1,1,"C's",5
19,"19184",75,48,46,0,2,"C's",5
19,"19204",154,106,106,3,0,"C's",12
19,"19282",161,115,112,0,3,"C's",7
19,"19096",93,66,66,0,0,"C's",5
19,"19249",31,27,27,0,0,"C's",0
19,"19017",69,56,56,0,0,"C's",3
19,"19120",104,92,92,1,0,"C's",5
19,"19007",479,364,360,2,4,"C's",43
19,"19037",146,113,113,1,0,"C's",17
19,"19019",19,17,16,0,1,"C's",1
19,"19018",163,122,119,2,3,"C's",14
19,"19283",29,23,23,0,0,"C's",1
19,"19202",13,12,12,0,0,"C's",1
19,"19119",81,71,71,0,0,"C's",12
19,"19279",57,54,54,0,0,"C's",2
19,"19243",43,36,36,0,0,"C's",3
19,"19075",63,37,36,0,1,"C's",4
19,"19291",1215,883,868,0,15,"C's",118
19,"19222",115,87,86,1,1,"C's",9
19,"19042",26,25,25,0,0,"C's",4
19,"19239",100,70,69,1,1,"C's",11
19,"19333",121,86,83,2,3,"C's",8
19,"19082",85,62,62,0,0,"C's",9
19,"19218",52,35,34,0,1,"C's",4
19,"19045",145,119,117,1,2,"C's",8
19,"19195",40,30,26,1,4,"C's",2
19,"19005",95,71,69,1,2,"C's",4
19,"19105",2332,1809,1794,11,15,"C's",366
19,"19059",79,60,59,0,1,"C's",7
19,"19321",38,26,26,0,0,"C's",0
19,"19284",10,8,8,0,0,"C's",0
19,"19235",97,63,62,0,1,"C's",2
19,"19197",25,20,20,0,0,"C's",1
19,"19290",853,568,560,3,8,"C's",72
19,"19021",1051,788,774,7,14,"C's",90
19,"19070",79,59,59,0,0,"C's",2
19,"19051",70,65,65,0,0,"C's",4
19,"19266",241,201,199,2,2,"C's",37
19,"19215",165,142,141,0,1,"C's",10
19,"19043",80,74,72,0,2,"C's",7
19,"19182",39,28,27,0,1,"C's",0
19,"19200",75,53,53,1,0,"C's",6
19,"19238",42,32,31,2,1,"C's",2
19,"19159",94,77,77,0,0,"C's",6
19,"19201",59,51,51,1,0,"C's",9
19,"19264",38,29,29,0,0,"C's",3
19,"19064",73,62,62,0,0,"C's",8
19,"19107",302,262,260,0,2,"C's",19
19,"19020",43,27,26,2,1,"C's",4
19,"19318",25,19,19,0,0,"C's",2
19,"19127",89,56,56,0,0,"C's",5
19,"19181",55,37,37,0,0,"C's",3
19,"19036",271,230,229,1,1,"C's",31
19,"19179",72,52,52,1,0,"C's",1
19,"19263",27,17,15,0,2,"C's",0
19,"19112",57,49,49,0,0,"C's",4
19,"19229",69,60,60,1,0,"C's",7
19,"19194",98,68,66,0,2,"C's",5
19,"19311",83,58,57,0,1,"C's",9
19,"19248",83,66,66,1,0,"C's",7
19,"19247",148,106,102,1,4,"C's",10
19,"19334",36,30,29,0,1,"C's",2
19,"19065",127,103,102,1,1,"C's",8
19,"19323",42,33,33,0,0,"C's",3
19,"19289",28,21,21,0,0,"C's",2
19,"19192",1723,1354,1342,9,12,"C's",166
19,"19067",70,51,50,2,1,"C's",1
19,"19109",43,32,32,3,0,"C's",3
19,"19297",31,21,21,1,0,"C's",0
19,"19079",8,7,7,0,0,"C's",0
19,"19242",93,66,62,2,4,"C's",7
19,"19133",86,73,73,1,0,"C's",9
19,"19262",139,111,109,0,2,"C's",7
19,"19177",78,60,57,1,3,"C's",5
19,"19309",26,22,22,0,0,"C's",2
19,"19214",74,54,54,0,0,"C's",4
19,"19115",24,14,14,1,0,"C's",2
19,"19032",175,131,124,1,7,"C's",7
19,"19185",31,18,18,0,0,"C's",1
19,"19073",24,19,19,0,0,"C's",4
19,"19193",23,22,21,0,1,"C's",3
19,"19095",12,10,10,0,0,"C's",2
19,"19123",44,38,38,0,0,"C's",5
19,"19209",40,28,27,1,1,"C's",3
19,"19146",42,34,34,0,0,"C's",1
19,"19326",1749,1248,1237,5,11,"C's",359
19,"19302",58,45,45,1,0,"C's",2
19,"19241",46,35,35,1,0,"C's",2
19,"19335",54,45,45,0,0,"C's",3
19,"19278",29,28,28,2,0,"C's",1
19,"19267",19,12,12,0,0,"C's",3
19,"19078",53,44,44,0,0,"C's",3
19,"19162",65,49,49,0,0,"C's",5
51,"51001",59213,33213,32720,413,493,"PSOE",7599
1,"1011",237,177,175,7,2,"EH Bildu",3
1,"1009",1281,908,898,2,10,"EH Bildu",198
1,"1044",236,189,187,1,2,"EH Bildu",33
1,"1018",1370,964,963,4,1,"EH Bildu",246
1,"1027",416,268,268,0,0,"EH Bildu",50
1,"1006",176,142,141,1,1,"EH Bildu",8
1,"1028",1077,759,753,6,6,"EH Bildu",78
1,"1019",144,112,111,2,1,"EH Bildu",11
1,"1004",1405,1026,1010,7,16,"EH Bildu",193
1,"1036",15034,10733,10619,73,114,"EH Bildu",1859
1,"1053",587,367,365,3,2,"EH Bildu",82
1,"1023",269,197,195,2,2,"EH Bildu",24
1,"1034",165,120,119,1,1,"EH Bildu",22
1,"1013",711,486,483,3,3,"EH Bildu",135
1,"1010",2275,1729,1717,17,12,"EH Bildu",347
1,"1057",245,203,202,0,1,"EH Bildu",58
1,"1051",3606,2413,2389,21,24,"EH Bildu",538
1,"1003",1186,842,833,19,9,"EH Bildu",395
1,"1039",202,161,156,0,5,"EH Bildu",10
1,"1059",186354,135873,134633,948,1240,"EH Bildu",13476
1,"1022",805,593,587,3,6,"EH Bildu",42
1,"1021",460,336,332,1,4,"EH Bildu",25
1,"1042",901,653,650,11,3,"EH Bildu",152
1,"1058",1327,843,833,8,10,"EH Bildu",284
1,"1017",869,584,577,4,7,"EH Bildu",122
1,"1014",372,292,284,1,8,"EH Bildu",23
1,"1037",586,425,419,2,6,"EH Bildu",79
1,"1056",218,141,140,1,1,"EH Bildu",23
1,"1054",952,694,688,4,6,"EH Bildu",224
1,"1008",790,548,542,13,6,"EH Bildu",93
1,"1041",153,105,100,1,5,"EH Bildu",7
1,"1060",199,162,159,0,3,"EH Bildu",9
1,"1046",594,445,435,3,10,"EH Bildu",40
1,"1902",738,537,528,4,9,"EH Bildu",48
1,"1001",1984,1426,1405,8,21,"EH Bildu",173
1,"1901",2344,1688,1669,17,19,"EH Bildu",123
1,"1052",244,188,186,1,2,"EH Bildu",34
1,"1033",649,512,508,5,4,"EH Bildu",46
1,"1002",8139,5961,5878,32,83,"EH Bildu",1034
1,"1062",314,215,215,3,0,"EH Bildu",13
1,"1063",1799,1320,1309,10,11,"EH Bildu",282
1,"1047",964,713,702,13,11,"EH Bildu",22
1,"1032",522,368,361,0,7,"EH Bildu",33
1,"1031",1183,907,885,6,22,"EH Bildu",105
1,"1043",2318,1644,1624,8,20,"EH Bildu",151
1,"1016",439,255,249,3,6,"EH Bildu",36
1,"1061",153,132,132,2,0,"EH Bildu",42
1,"1030",159,126,123,1,3,"EH Bildu",11
1,"1020",326,232,228,0,4,"EH Bildu",58
1,"1055",836,564,552,8,12,"EH Bildu",59
1,"1049",140,108,108,0,0,"EH Bildu",20
19,"19157",57,45,45,0,0,"PSOE",11
19,"19078",53,44,44,0,0,"PSOE",24
19,"19317",141,107,103,0,4,"PSOE",22
19,"19022",632,477,468,3,9,"PSOE",82
19,"19210",21,19,19,2,0,"PSOE",1
19,"19132",93,74,74,0,0,"PSOE",13
19,"19096",93,66,66,0,0,"PSOE",16
19,"19319",4425,3336,3304,21,32,"PSOE",560
19,"19008",37,28,28,0,0,"PSOE",4
19,"19098",21,20,20,0,0,"PSOE",5
19,"19176",237,181,181,0,0,"PSOE",27
19,"19036",271,230,229,1,1,"PSOE",67
19,"19135",105,82,82,0,0,"PSOE",23
19,"19257",3446,2532,2499,36,33,"PSOE",514
19,"19002",73,56,54,0,2,"PSOE",26
19,"19178",39,25,25,0,0,"PSOE",8
19,"19224",93,80,80,0,0,"PSOE",6
19,"19104",18,13,13,1,0,"PSOE",5
19,"19202",13,12,12,0,0,"PSOE",2
19,"19011",254,191,191,2,0,"PSOE",73
19,"19091",29,20,20,0,0,"PSOE",7
19,"19192",1723,1354,1342,9,12,"PSOE",400
19,"19215",165,142,141,0,1,"PSOE",26
19,"19118",13,10,10,0,0,"PSOE",7
19,"19112",57,49,49,0,0,"PSOE",5
19,"19020",43,27,26,2,1,"PSOE",3
19,"19175",34,26,26,1,0,"PSOE",3
19,"19073",24,19,19,0,0,"PSOE",5
19,"19248",83,66,66,1,0,"PSOE",15
19,"19307",25,23,23,1,0,"PSOE",1
19,"19254",49,36,36,1,0,"PSOE",6
19,"19219",13,9,9,0,0,"PSOE",7
19,"19332",93,68,68,0,0,"PSOE",16
19,"19130",59955,47034,46504,383,530,"PSOE",10000
19,"19301",38,30,30,0,0,"PSOE",6
19,"19242",93,66,62,2,4,"PSOE",2
19,"19217",59,39,37,0,2,"PSOE",13
19,"19039",60,55,54,1,1,"PSOE",14
19,"19119",81,71,71,0,0,"PSOE",17
19,"19001",53,36,36,1,0,"PSOE",3
19,"19227",74,49,49,0,0,"PSOE",15
19,"19122",93,72,72,3,0,"PSOE",16
19,"19266",241,201,199,2,2,"PSOE",33
19,"19097",17,13,13,0,0,"PSOE",0
19,"19246",46,36,36,0,0,"PSOE",14
19,"19270",22,18,18,0,0,"PSOE",1
19,"19181",55,37,37,0,0,"PSOE",6
19,"19005",95,71,69,1,2,"PSOE",13
19,"19059",79,60,59,0,1,"PSOE",8
19,"19199",19,16,16,1,0,"PSOE",8
19,"19123",44,38,38,0,0,"PSOE",5
19,"19076",31,20,20,0,0,"PSOE",1
19,"19045",145,119,117,1,2,"PSOE",16
19,"19090",97,77,77,1,0,"PSOE",31
19,"19124",382,256,253,0,3,"PSOE",62
19,"19024",8143,6017,5944,33,73,"PSOE",1218
19,"19033",64,49,49,3,0,"PSOE",13
19,"19244",81,61,59,2,2,"PSOE",6
19,"19282",161,115,112,0,3,"PSOE",11
19,"19103",255,205,201,0,4,"PSOE",70
19,"19046",21452,16321,16151,91,170,"PSOE",3841
19,"19054",190,165,163,3,2,"PSOE",42
19,"19006",768,545,538,0,7,"PSOE",159
19,"19262",139,111,109,0,2,"PSOE",21
19,"19333",121,86,83,2,3,"PSOE",28
19,"19151",1075,779,764,5,15,"PSOE",194
19,"19303",46,39,38,0,1,"PSOE",10
19,"19114",39,26,26,0,0,"PSOE",13
19,"19228",29,21,20,0,1,"PSOE",8
19,"19153",23,22,22,0,0,"PSOE",7
19,"19258",97,73,73,1,0,"PSOE",14
19,"19161",218,151,151,1,0,"PSOE",44
19,"19125",45,40,40,0,0,"PSOE",7
19,"19150",126,94,93,0,1,"PSOE",26
19,"19263",27,17,15,0,2,"PSOE",2
19,"19271",47,30,30,0,0,"PSOE",7
19,"19259",28,18,18,0,0,"PSOE",6
19,"19185",31,18,18,0,0,"PSOE",3
19,"19286",725,557,551,1,6,"PSOE",96
19,"19156",983,743,735,5,8,"PSOE",200
19,"19214",74,54,54,0,0,"PSOE",19
19,"19018",163,122,119,2,3,"PSOE",17
19,"19139",31,23,23,1,0,"PSOE",6
19,"19004",66,51,50,1,1,"PSOE",3
19,"19167",132,106,103,0,3,"PSOE",17
19,"19027",148,116,115,1,1,"PSOE",37
19,"19264",38,29,29,0,0,"PSOE",9
19,"19234",46,38,38,0,0,"PSOE",14
19,"19165",48,40,40,0,0,"PSOE",12
19,"19268",36,26,25,0,1,"PSOE",10
19,"19269",100,80,79,0,1,"PSOE",30
19,"19239",100,70,69,1,1,"PSOE",19
19,"19222",115,87,86,1,1,"PSOE",20
19,"19171",4884,3824,3778,24,46,"PSOE",1131
19,"19284",10,8,8,0,0,"PSOE",5
19,"19152",589,448,439,2,9,"PSOE",144
19,"19129",29,25,25,0,0,"PSOE",2
19,"19265",136,104,104,0,0,"PSOE",14
19,"19016",64,42,42,0,0,"PSOE",16
19,"19311",83,58,57,0,1,"PSOE",11
19,"19099",299,206,205,1,1,"PSOE",70
19,"19240",52,38,37,0,1,"PSOE",12
19,"19166",158,125,124,0,1,"PSOE",22
19,"19252",67,58,58,0,0,"PSOE",16
19,"19121",257,209,208,0,1,"PSOE",73
19,"19082",85,62,62,0,0,"PSOE",16
19,"19174",111,79,78,0,1,"PSOE",12
19,"19296",30,21,21,0,0,"PSOE",4
19,"19220",2305,1613,1600,9,13,"PSOE",270
19,"19277",18,12,12,0,0,"PSOE",4
19,"19196",106,86,80,0,6,"PSOE",16
19,"19290",853,568,560,3,8,"PSOE",108
19,"19136",18,15,15,0,0,"PSOE",7
19,"19245",1179,913,893,6,20,"PSOE",286
19,"19255",78,61,61,0,0,"PSOE",20
19,"19278",29,28,28,2,0,"PSOE",5
19,"19304",220,161,161,1,0,"PSOE",49
19,"19309",26,22,22,0,0,"PSOE",1
19,"19322",31,26,26,0,0,"PSOE",8
19,"19126",1620,1242,1216,5,26,"PSOE",207
19,"19159",94,77,77,0,0,"PSOE",13
19,"19040",51,41,41,0,0,"PSOE",17
19,"19115",24,14,14,1,0,"PSOE",1
19,"19145",48,42,42,2,0,"PSOE",2
19,"19160",899,601,597,2,4,"PSOE",118
19,"19243",43,36,36,0,0,"PSOE",9
19,"19133",86,73,73,1,0,"PSOE",32
19,"19023",117,101,99,1,2,"PSOE",15
19,"19209",40,28,27,1,1,"PSOE",9
19,"19053",2024,1479,1464,13,15,"PSOE",386
19,"19009",261,193,190,5,3,"PSOE",67
19,"19218",52,35,34,0,1,"PSOE",8
19,"19134",26,18,18,0,0,"PSOE",2
19,"19327",431,348,342,3,6,"PSOE",44
19,"19226",48,35,35,0,0,"PSOE",14
19,"19274",895,673,664,8,9,"PSOE",192
19,"19065",127,103,102,1,1,"PSOE",22
19,"19071",7746,5748,5678,34,70,"PSOE",895
19,"19042",26,25,25,0,0,"PSOE",9
19,"19088",84,68,68,0,0,"PSOE",12
19,"19089",28,17,17,0,0,"PSOE",13
19,"19231",12,8,8,1,0,"PSOE",0
19,"19081",31,21,21,0,0,"PSOE",1
19,"19223",110,76,76,3,0,"PSOE",22
19,"19142",260,189,186,2,3,"PSOE",67
19,"19051",70,65,65,0,0,"PSOE",18
19,"19281",22,18,18,0,0,"PSOE",7
19,"19232",79,60,59,1,1,"PSOE",12
19,"19184",75,48,46,0,2,"PSOE",8
19,"19241",46,35,35,1,0,"PSOE",2
19,"19308",65,54,54,0,0,"PSOE",19
19,"19330",71,64,64,0,0,"PSOE",25
19,"19057",72,53,52,0,1,"PSOE",14
19,"19055",53,34,33,2,1,"PSOE",7
19,"19168",297,227,224,2,3,"PSOE",62
19,"19163",61,44,43,1,1,"PSOE",9
19,"19044",309,248,246,3,2,"PSOE",45
19,"19079",8,7,7,0,0,"PSOE",0
19,"19201",59,51,51,1,0,"PSOE",7
19,"19331",2611,2010,1982,18,28,"PSOE",584
19,"19221",50,35,35,0,0,"PSOE",9
19,"19297",31,21,21,1,0,"PSOE",1
19,"19031",15,10,9,0,1,"PSOE",2
19,"19075",63,37,36,0,1,"PSOE",10
19,"19048",17,10,10,1,0,"PSOE",1
19,"19127",89,56,56,0,0,"PSOE",12
19,"19169",43,36,36,0,0,"PSOE",15
19,"19260",41,38,38,1,0,"PSOE",18
19,"19298",64,49,49,0,0,"PSOE",16
19,"19310",11,7,7,0,0,"PSOE",2
19,"19230",504,383,376,4,7,"PSOE",57
19,"19198",17,10,10,0,0,"PSOE",4
19,"19187",50,46,44,0,2,"PSOE",15
19,"19049",12,11,11,0,0,"PSOE",3
19,"19037",146,113,113,1,0,"PSOE",21
19,"19146",42,34,34,0,0,"PSOE",13
19,"19901",41,37,36,1,1,"PSOE",10
19,"19288",23,22,22,0,0,"PSOE",9
19,"19041",160,133,132,0,1,"PSOE",50
19,"19092",417,316,312,4,4,"PSOE",82
19,"19299",95,74,74,1,0,"PSOE",23
19,"19170",193,140,140,0,0,"PSOE",32
19,"19061",56,47,47,0,0,"PSOE",10
19,"19208",43,31,31,0,0,"PSOE",5
19,"19188",50,34,32,1,2,"PSOE",3
19,"19038",28,23,23,0,0,"PSOE",3
19,"19105",2332,1809,1794,11,15,"PSOE",340
19,"19066",61,49,47,0,2,"PSOE",2
19,"19060",150,115,114,1,1,"PSOE",20
19,"19110",57,46,45,2,1,"PSOE",7
19,"19314",52,35,34,1,1,"PSOE",8
19,"19047",67,60,60,1,0,"PSOE",13
19,"19003",41,37,35,0,2,"PSOE",11
19,"19300",762,628,624,3,4,"PSOE",74
19,"19043",80,74,72,0,2,"PSOE",25
19,"19111",158,123,121,0,2,"PSOE",40
19,"19019",19,17,16,0,1,"PSOE",2
19,"19321",38,26,26,0,0,"PSOE",14
19,"19193",23,22,21,0,1,"PSOE",10
19,"19052",27,18,18,1,0,"PSOE",8
19,"19280",3451,2620,2581,14,39,"PSOE",537
19,"19194",98,68,66,0,2,"PSOE",23
19,"19213",72,53,51,0,2,"PSOE",12
19,"19173",47,40,37,0,3,"PSOE",10
19,"19186",81,63,63,1,0,"PSOE",25
19,"19190",2405,1852,1833,14,19,"PSOE",486
19,"19225",835,645,638,2,7,"PSOE",167
19,"19279",57,54,54,0,0,"PSOE",13
19,"19324",179,136,135,0,1,"PSOE",48
19,"19172",55,44,44,0,0,"PSOE",7
19,"19302",58,45,45,1,0,"PSOE",13
19,"19064",73,62,62,0,0,"PSOE",12
19,"19203",31,25,25,0,0,"PSOE",6
19,"19235",97,63,62,0,1,"PSOE",29
19,"19120",104,92,92,1,0,"PSOE",20
19,"19323",42,33,33,0,0,"PSOE",12
19,"19195",40,30,26,1,4,"PSOE",9
19,"19249",31,27,27,0,0,"PSOE",6
19,"19010",9,9,9,0,0,"PSOE",2
19,"19237",47,35,34,1,1,"PSOE",4
19,"19211",394,297,291,1,6,"PSOE",63
19,"19325",128,89,88,0,1,"PSOE",10
19,"19305",162,129,128,1,1,"PSOE",36
19,"19021",1051,788,774,7,14,"PSOE",232
19,"19050",15,13,13,0,0,"PSOE",6
19,"19261",38,25,25,0,0,"PSOE",4
19,"19058",6786,5451,5415,29,36,"PSOE",1010
19,"19106",92,67,64,0,3,"PSOE",21
19,"19334",36,30,29,0,1,"PSOE",11
19,"19289",28,21,21,0,0,"PSOE",0
19,"19326",1749,1248,1237,5,11,"PSOE",178
19,"19013",128,106,106,0,0,"PSOE",42
19,"19155",66,54,53,0,1,"PSOE",14
19,"19102",101,84,84,0,0,"PSOE",31
19,"19229",69,60,60,1,0,"PSOE",17
19,"19329",58,49,49,0,0,"PSOE",11
19,"19080",73,51,50,0,1,"PSOE",10
19,"19306",28,20,20,0,0,"PSOE",1
19,"19293",1868,1379,1364,9,15,"PSOE",251
19,"19318",25,19,19,0,0,"PSOE",12
19,"19108",112,90,90,1,0,"PSOE",15
19,"19250",21,16,15,0,1,"PSOE",5
19,"19267",19,12,12,0,0,"PSOE",3
19,"19148",45,37,37,1,0,"PSOE",6
19,"19113",471,365,365,2,0,"PSOE",144
19,"19335",54,45,45,0,0,"PSOE",23
19,"19256",44,35,35,0,0,"PSOE",7
19,"19147",46,34,33,0,1,"PSOE",9
19,"19007",479,364,360,2,4,"PSOE",102
19,"19162",65,49,49,0,0,"PSOE",15
19,"19189",120,91,90,2,1,"PSOE",16
19,"19032",175,131,124,1,7,"PSOE",41
19,"19182",39,28,27,0,1,"PSOE",8
19,"19247",148,106,102,1,4,"PSOE",22
19,"19116",13,11,11,0,0,"PSOE",1
19,"19183",83,74,73,0,1,"PSOE",30
19,"19138",272,197,196,0,1,"PSOE",69
19,"19233",91,71,71,1,0,"PSOE",14
19,"19200",75,53,53,1,0,"PSOE",13
19,"19017",69,56,56,0,0,"PSOE",17
19,"19216",134,97,97,0,0,"PSOE",23
19,"19238",42,32,31,2,1,"PSOE",6
19,"19287",144,109,109,0,0,"PSOE",24
19,"19143",1733,1371,1352,9,19,"PSOE",358
19,"19086",1495,1158,1149,7,9,"PSOE",394
19,"19197",25,20,20,0,0,"PSOE",11
19,"19179",72,52,52,1,0,"PSOE",20
19,"19154",66,52,51,0,1,"PSOE",5
19,"19117",1580,1183,1167,11,16,"PSOE",365
19,"19095",12,10,10,0,0,"PSOE",1
19,"19034",22,18,18,0,0,"PSOE",4
19,"19177",78,60,57,1,3,"PSOE",23
19,"19070",79,59,59,0,0,"PSOE",18
19,"19251",42,29,28,0,1,"PSOE",11
19,"19015",81,68,68,0,0,"PSOE",23
19,"19204",154,106,106,3,0,"PSOE",39
19,"19087",18,17,17,0,0,"PSOE",7
19,"19212",727,562,551,8,11,"PSOE",114
19,"19283",29,23,23,0,0,"PSOE",10
19,"19074",73,63,63,0,0,"PSOE",11
19,"19294",23,19,19,1,0,"PSOE",5
19,"19191",13,12,12,0,0,"PSOE",5
19,"19291",1215,883,868,0,15,"PSOE",221
19,"19285",25,16,16,2,0,"PSOE",8
19,"19272",72,59,59,1,0,"PSOE",18
19,"19107",302,262,260,0,2,"PSOE",83
19,"19109",43,32,32,3,0,"PSOE",0
19,"19067",70,51,50,2,1,"PSOE",20
31,"31186",302,211,209,2,2,"GBAI",24
31,"31901",15475,11855,11771,121,84,"GBAI",1084
31,"31132",146,115,113,1,2,"GBAI",9
31,"31159",1134,867,864,9,3,"GBAI",114
31,"31179",509,361,355,5,6,"GBAI",12
31,"31111",96,75,75,2,0,"GBAI",16
31,"31106",689,565,559,1,6,"GBAI",7
31,"31011",697,494,491,5,3,"GBAI",34
31,"31021",64,42,42,0,0,"GBAI",4
31,"31231",115,81,81,1,0,"GBAI",1
31,"31100",264,186,186,2,0,"GBAI",24
31,"31196",39,34,34,0,0,"GBAI",0
31,"31016",7642,5866,5822,52,44,"GBAI",483
31,"31140",116,82,82,2,0,"GBAI",32
31,"31019",1809,1295,1288,23,7,"GBAI",124
31,"31059",191,142,141,1,1,"GBAI",18
31,"31185",501,345,342,4,3,"GBAI",57
31,"31048",169,123,123,1,0,"GBAI",3
31,"31265",86,61,61,0,0,"GBAI",14
31,"31245",83,54,54,1,0,"GBAI",10
31,"31033",49,29,29,1,0,"GBAI",3
31,"31098",1918,1489,1483,23,6,"GBAI",167
31,"31102",146,66,66,1,0,"GBAI",14
31,"31162",47,29,27,0,2,"GBAI",5
31,"31126",357,235,232,0,3,"GBAI",43
31,"31078",2447,1889,1861,25,28,"GBAI",21
31,"31088",5574,4194,4156,46,38,"GBAI",240
31,"31105",1535,1208,1187,18,21,"GBAI",13
31,"31183",681,581,578,10,3,"GBAI",86
31,"31136",444,320,318,6,2,"GBAI",29
31,"31205",427,330,326,7,4,"GBAI",11
31,"31063",88,72,68,2,4,"GBAI",4
31,"31087",169,131,127,2,4,"GBAI",25
31,"31905",2847,2108,2093,11,15,"GBAI",75
31,"31006",1952,1423,1400,14,23,"GBAI",22
31,"31155",253,191,189,3,2,"GBAI",10
31,"31152",1347,999,990,16,9,"GBAI",71
31,"31094",112,82,82,1,0,"GBAI",4
31,"31075",101,68,67,1,1,"GBAI",6
31,"31184",61,43,43,2,0,"GBAI",6
31,"31157",3546,2423,2399,32,24,"GBAI",116
31,"31083",56,41,39,0,2,"GBAI",4
31,"31122",4719,3671,3654,42,17,"GBAI",436
31,"31216",3882,2829,2810,31,19,"GBAI",215
31,"31115",166,108,108,2,0,"GBAI",32
31,"31023",6826,5609,5591,77,18,"GBAI",446
31,"31095",76,66,64,1,2,"GBAI",8
31,"31044",290,223,220,1,3,"GBAI",50
31,"31219",88,63,62,0,1,"GBAI",4
31,"31024",102,52,52,0,0,"GBAI",9
31,"31125",275,194,191,2,3,"GBAI",18
31,"31208",2569,2016,1992,21,24,"GBAI",49
31,"31175",72,50,49,0,1,"GBAI",4
31,"31165",2794,2057,2025,31,32,"GBAI",49
31,"31119",40,22,22,0,0,"GBAI",5
31,"31239",310,223,220,5,3,"GBAI",69
31,"31025",768,560,560,5,0,"GBAI",84
31,"31146",35,30,30,2,0,"GBAI",0
31,"31197",70,60,59,0,1,"GBAI",5
31,"31082",615,398,393,6,5,"GBAI",94
31,"31123",654,430,419,7,11,"GBAI",74
31,"31051",253,176,176,2,0,"GBAI",8
31,"31168",248,192,191,0,1,"GBAI",21
31,"31054",460,308,304,7,4,"GBAI",67
31,"31030",145,107,107,3,0,"GBAI",20
31,"31065",1892,1420,1396,14,24,"GBAI",24
31,"31001",90,74,74,5,0,"GBAI",13
31,"31191",3018,2324,2297,23,27,"GBAI",147
31,"31028",211,133,133,0,0,"GBAI",21
31,"31120",394,264,263,5,1,"GBAI",31
31,"31262",206,180,180,2,0,"GBAI",33
31,"31029",925,662,648,6,14,"GBAI",45
31,"31130",310,214,213,7,1,"GBAI",31
31,"31022",526,344,341,3,3,"GBAI",118
31,"31908",1008,709,704,11,5,"GBAI",196
31,"31244",156,87,84,1,3,"GBAI",27
31,"31193",1414,1103,1094,12,9,"GBAI",121
31,"31221",1211,844,825,4,19,"GBAI",157
31,"31096",115,95,92,2,3,"GBAI",2
31,"31147",98,76,76,2,0,"GBAI",6
31,"31027",838,595,589,7,6,"GBAI",179
31,"31066",867,647,638,8,9,"GBAI",19
31,"31101",1390,1031,1028,11,3,"GBAI",95
31,"31189",1170,739,731,10,8,"GBAI",102
31,"31108",1878,1487,1475,14,12,"GBAI",27
31,"31182",37,27,27,0,0,"GBAI",2
31,"31104",1876,1355,1338,10,17,"GBAI",50
31,"31202",4326,3045,3001,41,44,"GBAI",91
31,"31060",13723,10036,9970,78,66,"GBAI",887
31,"31097",10436,7461,7395,96,66,"GBAI",583
31,"31038",1348,1017,1005,13,12,"GBAI",98
31,"31124",210,162,162,2,0,"GBAI",11
31,"31148",93,70,70,3,0,"GBAI",2
31,"31258",7841,5961,5927,56,34,"GBAI",715
31,"31176",2856,2077,2040,33,37,"GBAI",20
31,"31206",2095,1529,1513,19,16,"GBAI",139
31,"31092",662,458,455,4,3,"GBAI",93
31,"31112",94,67,66,0,1,"GBAI",18
31,"31058",215,153,153,2,0,"GBAI",32
31,"31139",159,102,101,3,1,"GBAI",10
31,"31213",105,70,70,0,0,"GBAI",18
31,"31081",342,239,239,2,0,"GBAI",81
31,"31251",3110,2347,2327,19,20,"GBAI",162
31,"31067",1938,1424,1415,15,9,"GBAI",48
31,"31061",56,50,50,1,0,"GBAI",1
31,"31041",1583,1125,1110,14,15,"GBAI",90
31,"31150",213,154,152,1,2,"GBAI",16
31,"31153",2172,1463,1448,10,15,"GBAI",372
31,"31232",25152,18432,18220,199,212,"GBAI",317
31,"31214",93,70,69,0,1,"GBAI",12
31,"31042",2744,2081,2053,19,28,"GBAI",23
31,"31093",293,210,206,2,4,"GBAI",30
31,"31215",4649,3412,3359,35,53,"GBAI",35
31,"31076",2407,2005,1986,28,19,"GBAI",167
31,"31260",1245,859,857,15,2,"GBAI",73
31,"31013",661,439,437,1,2,"GBAI",54
31,"31906",2553,1945,1930,21,15,"GBAI",127
31,"31073",315,214,212,3,2,"GBAI",28
31,"31127",143,97,97,2,0,"GBAI",17
31,"31192",159,132,131,0,1,"GBAI",10
31,"31003",124,95,95,2,0,"GBAI",16
31,"31074",394,301,298,5,3,"GBAI",31
31,"31195",180,129,128,0,1,"GBAI",27
31,"31247",152,112,109,0,3,"GBAI",23
31,"31121",64,45,45,2,0,"GBAI",3
31,"31084",1935,1389,1380,19,9,"GBAI",287
31,"31138",934,649,647,5,2,"GBAI",155
31,"31227",8226,6191,6109,53,82,"GBAI",418
31,"31037",86,64,64,0,0,"GBAI",28
31,"31144",804,482,479,2,3,"GBAI",95
31,"31254",1920,1473,1458,7,15,"GBAI",35
31,"31128",370,265,265,2,0,"GBAI",26
31,"31091",347,217,217,0,0,"GBAI",62
31,"31145",171,133,133,0,0,"GBAI",5
31,"31071",17,17,17,0,0,"GBAI",0
31,"31034",40,29,29,1,0,"GBAI",4
31,"31166",260,186,186,2,0,"GBAI",11
31,"31004",35,22,22,1,0,"GBAI",5
31,"31035",63,45,43,1,2,"GBAI",4
31,"31217",337,233,230,1,3,"GBAI",4
31,"31207",271,194,190,0,4,"GBAI",17
31,"31113",137,86,85,1,1,"GBAI",11
31,"31234",144,107,107,2,0,"GBAI",8
31,"31904",1559,1095,1084,8,11,"GBAI",130
31,"31064",1447,1161,1145,11,16,"GBAI",28
31,"31032",1733,1295,1285,26,10,"GBAI",16
31,"31103",46,32,32,1,0,"GBAI",1
31,"31015",2001,1468,1449,18,19,"GBAI",56
31,"31259",485,325,324,3,1,"GBAI",107
31,"31201",147803,110800,110079,1040,721,"GBAI",10691
31,"31264",179,117,115,5,2,"GBAI",25
31,"31107",1707,1303,1294,12,9,"GBAI",27
31,"31167",827,624,615,13,9,"GBAI",46
31,"31141",109,70,66,1,4,"GBAI",6
31,"31050",6058,3902,3850,64,52,"GBAI",862
31,"31046",60,38,38,0,0,"GBAI",0
31,"31137",208,93,93,3,0,"GBAI",24
31,"31026",147,128,128,1,0,"GBAI",13
31,"31043",38,30,30,0,0,"GBAI",9
31,"31154",227,127,125,3,2,"GBAI",22
31,"31250",2832,1921,1899,20,22,"GBAI",398
31,"31178",495,364,364,4,0,"GBAI",10
31,"31017",361,248,246,4,2,"GBAI",53
31,"31903",6593,4699,4660,28,39,"GBAI",273
31,"31135",102,67,62,0,5,"GBAI",5
31,"31212",151,118,118,7,0,"GBAI",6
31,"31257",866,657,648,8,9,"GBAI",51
31,"31007",136,94,93,1,1,"GBAI",4
31,"31240",531,355,351,6,4,"GBAI",99
31,"31230",107,86,85,0,1,"GBAI",8
31,"31118",165,122,121,2,1,"GBAI",32
31,"31172",367,293,286,6,7,"GBAI",17
31,"31002",424,312,310,7,2,"GBAI",42
31,"31187",111,70,70,1,0,"GBAI",24
31,"31085",471,353,351,3,2,"GBAI",39
31,"31156",252,193,193,0,0,"GBAI",27
31,"31204",37,33,33,2,0,"GBAI",2
31,"31129",393,265,261,2,4,"GBAI",65
31,"31149",2338,1534,1525,16,9,"GBAI",340
31,"31169",2217,1508,1489,15,19,"GBAI",17
31,"31068",2893,2172,2138,27,34,"GBAI",32
31,"31052",88,65,64,0,1,"GBAI",4
31,"31005",296,205,204,0,1,"GBAI",8
31,"31249",1885,1350,1331,20,19,"GBAI",25
31,"31045",504,397,392,9,5,"GBAI",29
31,"31117",620,390,385,1,5,"GBAI",78
31,"31053",532,395,391,4,4,"GBAI",28
31,"31079",76,53,53,0,0,"GBAI",1
31,"31009",690,508,504,5,4,"GBAI",49
31,"31134",178,132,130,1,2,"GBAI",23
31,"31237",195,156,156,1,0,"GBAI",17
31,"31047",261,191,187,6,4,"GBAI",20
31,"31080",510,412,411,8,1,"GBAI",36
31,"31226",585,346,344,1,2,"GBAI",102
31,"31164",582,464,457,3,7,"GBAI",6
31,"31198",36,29,29,0,0,"GBAI",4
31,"31161",344,273,270,4,3,"GBAI",24
31,"31040",194,130,128,1,2,"GBAI",18
31,"31209",157,108,108,0,0,"GBAI",8
31,"31252",87,68,68,0,0,"GBAI",9
31,"31020",454,235,232,2,3,"GBAI",50
31,"31070",2652,1907,1888,16,19,"GBAI",21
31,"31133",44,30,30,1,0,"GBAI",4
31,"31248",295,174,168,2,6,"GBAI",35
31,"31224",914,668,659,6,9,"GBAI",19
31,"31902",4346,3247,3228,23,19,"GBAI",357
31,"31158",252,181,178,2,3,"GBAI",27
31,"31235",166,111,111,0,0,"GBAI",8
31,"31225",36,29,29,0,0,"GBAI",3
31,"31261",235,187,187,3,0,"GBAI",10
31,"31200",764,558,546,11,12,"GBAI",40
31,"31018",409,312,311,9,1,"GBAI",22
31,"31174",110,75,73,0,2,"GBAI",4
31,"31211",25,12,12,2,0,"GBAI",2
31,"31256",109,70,70,0,0,"GBAI",17
31,"31222",63,41,41,5,0,"GBAI",9
31,"31907",10677,8568,8523,97,45,"GBAI",1002
31,"31199",150,101,101,3,0,"GBAI",23
31,"31031",221,141,140,0,1,"GBAI",33
31,"31203",40,29,29,0,0,"GBAI",4
31,"31086",12987,10342,10270,114,72,"GBAI",911
31,"31233",96,72,71,0,1,"GBAI",0
31,"31255",102,75,74,2,1,"GBAI",4
31,"31246",140,108,103,2,5,"GBAI",11
31,"31036",921,664,657,5,7,"GBAI",51
31,"31116",65,51,51,1,0,"GBAI",1
31,"31253",129,112,112,0,0,"GBAI",24
31,"31236",1324,943,933,12,10,"GBAI",168
31,"31223",995,752,742,6,10,"GBAI",31
31,"31062",1088,866,853,4,13,"GBAI",9
31,"31012",814,579,570,4,9,"GBAI",32
31,"31131",871,664,658,13,6,"GBAI",81
31,"31056",179,137,133,0,4,"GBAI",7
31,"31228",496,382,381,2,1,"GBAI",28
31,"31238",110,96,94,2,2,"GBAI",9
31,"31263",236,142,142,2,0,"GBAI",33
31,"31072",5288,3916,3846,32,70,"GBAI",39
31,"31210",199,146,145,2,1,"GBAI",30
31,"31151",67,48,48,1,0,"GBAI",2
31,"31069",847,643,636,4,7,"GBAI",30
31,"31194",315,218,217,2,1,"GBAI",42
31,"31089",242,188,185,1,3,"GBAI",9
31,"31242",253,165,164,1,1,"GBAI",18
31,"31160",107,81,80,0,1,"GBAI",10
31,"31114",362,272,269,6,3,"GBAI",14
31,"31077",5384,4055,3999,49,56,"GBAI",52
31,"31220",752,607,603,3,4,"GBAI",9
31,"31099",63,52,52,1,0,"GBAI",6
31,"31163",2017,1479,1447,15,32,"GBAI",45
31,"31090",146,81,80,3,1,"GBAI",35
31,"31039",83,58,57,0,1,"GBAI",6
31,"31177",262,171,170,3,1,"GBAI",16
31,"31110",90,65,65,2,0,"GBAI",1
31,"31181",150,116,116,0,0,"GBAI",9
31,"31243",314,236,234,5,2,"GBAI",18
31,"31241",134,94,89,0,5,"GBAI",10
31,"31010",5721,3986,3946,27,40,"GBAI",668
31,"31229",50,40,40,0,0,"GBAI",3
31,"31014",274,197,197,4,0,"GBAI",9
31,"31170",49,39,39,1,0,"GBAI",3
31,"31049",704,488,486,1,2,"GBAI",74
31,"31190",44,36,36,1,0,"GBAI",5
31,"31055",259,177,173,2,4,"GBAI",68
31,"31057",1812,1375,1360,17,15,"GBAI",7
31,"31008",80,57,54,0,3,"GBAI",4
31,"31142",1411,972,964,11,8,"GBAI",29
31,"31109",1562,1184,1177,6,7,"GBAI",112
31,"31188",227,173,173,2,0,"GBAI",16
31,"31173",873,704,680,3,24,"GBAI",6
31,"31180",216,173,173,5,0,"GBAI",9
31,"31143",98,59,58,1,1,"GBAI",8
31,"31171",693,510,500,6,10,"GBAI",33
39,"39019",2098,1669,1646,24,23,"PCPE",2
39,"39048",1697,1372,1361,10,11,"PCPE",3
39,"39052",18086,14014,13852,124,162,"PCPE",15
39,"39029",624,507,503,4,4,"PCPE",0
39,"39047",1978,1463,1448,15,15,"PCPE",1
39,"39074",6905,5370,5288,52,82,"PCPE",4
39,"39041",1764,1416,1395,10,21,"PCPE",0
39,"39086",357,260,258,1,2,"PCPE",2
39,"39017",571,385,377,2,8,"PCPE",0
39,"39081",435,349,342,3,7,"PCPE",0
39,"39058",831,594,592,6,2,"PCPE",0
39,"39054",4472,3478,3441,45,37,"PCPE",5
39,"39005",1396,1089,1084,4,5,"PCPE",1
39,"39068",659,486,479,2,7,"PCPE",0
39,"39031",1235,873,863,5,10,"PCPE",0
39,"39037",2003,1570,1547,8,23,"PCPE",3
39,"39016",23860,18608,18405,149,203,"PCPE",21
39,"39064",1349,1036,1016,6,20,"PCPE",1
39,"39097",713,409,400,10,9,"PCPE",0
39,"39102",2281,1647,1631,13,16,"PCPE",2
39,"39040",4290,3337,3309,22,28,"PCPE",2
39,"39082",1658,1212,1202,15,10,"PCPE",1
39,"39091",1947,1572,1552,9,20,"PCPE",1
39,"39027",3139,2493,2439,30,54,"PCPE",5
39,"39093",307,232,232,1,0,"PCPE",0
39,"39042",5968,4614,4572,33,42,"PCPE",3
39,"39028",3733,2918,2877,17,41,"PCPE",2
39,"39066",868,697,688,7,9,"PCPE",0
39,"39021",495,399,391,4,8,"PCPE",0
39,"39071",405,277,272,2,5,"PCPE",0
39,"39018",4211,3389,3329,27,60,"PCPE",8
39,"39045",376,284,276,1,8,"PCPE",1
39,"39032",1476,1117,1100,8,17,"PCPE",1
39,"39053",219,135,135,1,0,"PCPE",0
39,"39063",973,725,720,7,5,"PCPE",1
39,"39043",1468,1167,1151,10,16,"PCPE",0
39,"39024",1882,1452,1438,14,14,"PCPE",1
39,"39056",2326,1805,1775,17,30,"PCPE",6
39,"39007",434,298,297,1,1,"PCPE",0
39,"39013",515,378,375,1,3,"PCPE",0
39,"39080",3552,2734,2701,17,33,"PCPE",1
39,"39078",1413,1045,1032,10,13,"PCPE",7
39,"39096",702,477,474,3,3,"PCPE",1
39,"39044",3833,2889,2860,26,29,"PCPE",8
39,"39006",1728,1353,1337,12,16,"PCPE",2
39,"39084",843,608,604,5,4,"PCPE",0
39,"39072",343,213,213,1,0,"PCPE",0
39,"39023",6316,4900,4827,37,73,"PCPE",4
39,"39049",330,251,248,1,3,"PCPE",1
39,"39004",1539,1177,1160,12,17,"PCPE",1
39,"39067",813,569,561,5,8,"PCPE",1
39,"39069",1968,1586,1555,12,31,"PCPE",7
39,"39099",3117,2446,2406,23,40,"PCPE",2
39,"39077",246,186,182,0,4,"PCPE",0
39,"39085",6834,5319,5265,37,54,"PCPE",8
39,"39050",276,173,170,0,3,"PCPE",0
39,"39034",286,180,179,4,1,"PCPE",0
39,"39092",916,668,663,4,5,"PCPE",0
39,"39065",256,202,200,6,2,"PCPE",0
39,"39060",6705,5437,5339,46,98,"PCPE",6
39,"39001",2127,1651,1631,17,20,"PCPE",5
39,"39011",1602,1211,1202,13,9,"PCPE",0
39,"39088",71,51,51,0,0,"PCPE",0
39,"39038",1463,1039,1030,6,9,"PCPE",1
39,"39100",869,628,617,12,11,"PCPE",1
39,"39070",146,111,109,3,2,"PCPE",1
39,"39075",137597,102862,102053,819,809,"PCPE",104
39,"39033",578,432,432,5,0,"PCPE",1
39,"39087",42262,32560,32124,234,436,"PCPE",96
39,"39076",3491,2696,2662,24,34,"PCPE",3
39,"39098",1422,1078,1074,11,4,"PCPE",5
39,"39025",8693,6696,6583,58,113,"PCPE",6
39,"39055",1118,838,826,6,12,"PCPE",1
39,"39020",23612,16515,16334,125,181,"PCPE",23
39,"39026",1751,1303,1295,9,8,"PCPE",1
39,"39073",9806,7636,7574,42,62,"PCPE",8
39,"39036",983,774,770,8,4,"PCPE",0
39,"39009",3223,2395,2370,22,25,"PCPE",0
39,"39030",1894,1314,1290,9,24,"PCPE",2
39,"39083",1139,747,739,6,8,"PCPE",2
39,"39003",299,219,217,0,2,"PCPE",0
39,"39051",67,62,61,1,1,"PCPE",0
39,"39022",987,735,730,7,5,"PCPE",1
39,"39008",13932,10600,10506,92,94,"PCPE",12
39,"39059",8057,6049,5972,50,77,"PCPE",6
39,"39101",292,206,202,2,4,"PCPE",0
39,"39015",862,650,643,6,7,"PCPE",0
39,"39095",2268,1812,1789,9,23,"PCPE",0
39,"39002",3313,2430,2391,17,39,"PCPE",2
39,"39062",1824,1400,1392,14,8,"PCPE",1
39,"39012",6693,5213,5131,44,82,"PCPE",5
39,"39094",854,644,637,9,7,"PCPE",1
39,"39035",9587,7315,7214,56,101,"PCPE",7
39,"39010",639,509,505,5,4,"PCPE",0
39,"39061",3488,2746,2722,29,24,"PCPE",2
39,"39057",2321,1773,1746,13,27,"PCPE",4
39,"39046",1402,1015,985,11,30,"PCPE",2
39,"39090",756,564,550,4,14,"PCPE",0
39,"39079",8951,6734,6657,54,77,"PCPE",12
39,"39039",572,397,396,1,1,"PCPE",1
39,"39089",149,104,103,1,1,"PCPE",0
39,"39014",898,655,644,8,11,"PCPE",1
19,"19227",74,49,49,0,0,"PACMA",0
19,"19130",59955,47034,46504,383,530,"PACMA",308
19,"19001",53,36,36,1,0,"PACMA",0
19,"19249",31,27,27,0,0,"PACMA",0
19,"19090",97,77,77,1,0,"PACMA",0
19,"19240",52,38,37,0,1,"PACMA",0
19,"19116",13,11,11,0,0,"PACMA",0
19,"19296",30,21,21,0,0,"PACMA",0
19,"19284",10,8,8,0,0,"PACMA",0
19,"19261",38,25,25,0,0,"PACMA",0
19,"19252",67,58,58,0,0,"PACMA",0
19,"19117",1580,1183,1167,11,16,"PACMA",8
19,"19133",86,73,73,1,0,"PACMA",0
19,"19220",2305,1613,1600,9,13,"PACMA",40
19,"19153",23,22,22,0,0,"PACMA",0
19,"19098",21,20,20,0,0,"PACMA",0
19,"19169",43,36,36,0,0,"PACMA",0
19,"19178",39,25,25,0,0,"PACMA",0
19,"19235",97,63,62,0,1,"PACMA",0
19,"19050",15,13,13,0,0,"PACMA",0
19,"19267",19,12,12,0,0,"PACMA",0
19,"19046",21452,16321,16151,91,170,"PACMA",217
19,"19143",1733,1371,1352,9,19,"PACMA",10
19,"19002",73,56,54,0,2,"PACMA",0
19,"19279",57,54,54,0,0,"PACMA",0
19,"19049",12,11,11,0,0,"PACMA",0
19,"19007",479,364,360,2,4,"PACMA",1
19,"19047",67,60,60,1,0,"PACMA",0
19,"19254",49,36,36,1,0,"PACMA",0
19,"19024",8143,6017,5944,33,73,"PACMA",62
19,"19157",57,45,45,0,0,"PACMA",0
19,"19185",31,18,18,0,0,"PACMA",0
19,"19225",835,645,638,2,7,"PACMA",9
19,"19109",43,32,32,3,0,"PACMA",0
19,"19263",27,17,15,0,2,"PACMA",0
19,"19233",91,71,71,1,0,"PACMA",0
19,"19182",39,28,27,0,1,"PACMA",1
19,"19231",12,8,8,1,0,"PACMA",0
19,"19167",132,106,103,0,3,"PACMA",0
19,"19044",309,248,246,3,2,"PACMA",1
19,"19053",2024,1479,1464,13,15,"PACMA",3
19,"19103",255,205,201,0,4,"PACMA",0
19,"19003",41,37,35,0,2,"PACMA",0
19,"19120",104,92,92,1,0,"PACMA",0
19,"19092",417,316,312,4,4,"PACMA",1
19,"19226",48,35,35,0,0,"PACMA",0
19,"19162",65,49,49,0,0,"PACMA",1
19,"19293",1868,1379,1364,9,15,"PACMA",13
19,"19054",190,165,163,3,2,"PACMA",2
19,"19112",57,49,49,0,0,"PACMA",0
19,"19280",3451,2620,2581,14,39,"PACMA",38
19,"19009",261,193,190,5,3,"PACMA",1
19,"19277",18,12,12,0,0,"PACMA",0
19,"19175",34,26,26,1,0,"PACMA",0
19,"19006",768,545,538,0,7,"PACMA",0
19,"19136",18,15,15,0,0,"PACMA",0
19,"19232",79,60,59,1,1,"PACMA",0
19,"19228",29,21,20,0,1,"PACMA",0
19,"19042",26,25,25,0,0,"PACMA",0
19,"19011",254,191,191,2,0,"PACMA",1
19,"19245",1179,913,893,6,20,"PACMA",4
19,"19055",53,34,33,2,1,"PACMA",0
19,"19188",50,34,32,1,2,"PACMA",0
19,"19215",165,142,141,0,1,"PACMA",2
19,"19089",28,17,17,0,0,"PACMA",0
19,"19255",78,61,61,0,0,"PACMA",0
19,"19308",65,54,54,0,0,"PACMA",0
19,"19150",126,94,93,0,1,"PACMA",0
19,"19013",128,106,106,0,0,"PACMA",0
19,"19309",26,22,22,0,0,"PACMA",0
19,"19217",59,39,37,0,2,"PACMA",1
19,"19305",162,129,128,1,1,"PACMA",0
19,"19297",31,21,21,1,0,"PACMA",0
19,"19058",6786,5451,5415,29,36,"PACMA",47
19,"19107",302,262,260,0,2,"PACMA",1
19,"19229",69,60,60,1,0,"PACMA",0
19,"19106",92,67,64,0,3,"PACMA",1
19,"19148",45,37,37,1,0,"PACMA",0
19,"19268",36,26,25,0,1,"PACMA",0
19,"19264",38,29,29,0,0,"PACMA",0
19,"19045",145,119,117,1,2,"PACMA",0
19,"19177",78,60,57,1,3,"PACMA",1
19,"19174",111,79,78,0,1,"PACMA",0
19,"19183",83,74,73,0,1,"PACMA",0
19,"19230",504,383,376,4,7,"PACMA",13
19,"19306",28,20,20,0,0,"PACMA",0
19,"19059",79,60,59,0,1,"PACMA",0
19,"19298",64,49,49,0,0,"PACMA",0
19,"19269",100,80,79,0,1,"PACMA",0
19,"19221",50,35,35,0,0,"PACMA",0
19,"19256",44,35,35,0,0,"PACMA",1
19,"19135",105,82,82,0,0,"PACMA",0
19,"19010",9,9,9,0,0,"PACMA",0
19,"19270",22,18,18,0,0,"PACMA",0
19,"19179",72,52,52,1,0,"PACMA",0
19,"19051",70,65,65,0,0,"PACMA",0
19,"19184",75,48,46,0,2,"PACMA",0
19,"19132",93,74,74,0,0,"PACMA",0
19,"19299",95,74,74,1,0,"PACMA",0
19,"19034",22,18,18,0,0,"PACMA",0
19,"19266",241,201,199,2,2,"PACMA",0
19,"19060",150,115,114,1,1,"PACMA",0
19,"19216",134,97,97,0,0,"PACMA",2
19,"19300",762,628,624,3,4,"PACMA",3
19,"19259",28,18,18,0,0,"PACMA",0
19,"19096",93,66,66,0,0,"PACMA",0
19,"19017",69,56,56,0,0,"PACMA",0
19,"19181",55,37,37,0,0,"PACMA",0
19,"19061",56,47,47,0,0,"PACMA",0
19,"19048",17,10,10,1,0,"PACMA",0
19,"19154",66,52,51,0,1,"PACMA",0
19,"19097",17,13,13,0,0,"PACMA",0
19,"19287",144,109,109,0,0,"PACMA",0
19,"19194",98,68,66,0,2,"PACMA",0
19,"19111",158,123,121,0,2,"PACMA",0
19,"19123",44,38,38,0,0,"PACMA",0
19,"19091",29,20,20,0,0,"PACMA",0
19,"19134",26,18,18,0,0,"PACMA",0
19,"19247",148,106,102,1,4,"PACMA",1
19,"19005",95,71,69,1,2,"PACMA",0
19,"19234",46,38,38,0,0,"PACMA",0
19,"19155",66,54,53,0,1,"PACMA",1
19,"19191",13,12,12,0,0,"PACMA",0
19,"19218",52,35,34,0,1,"PACMA",0
19,"19065",127,103,102,1,1,"PACMA",0
19,"19310",11,7,7,0,0,"PACMA",0
19,"19302",58,45,45,1,0,"PACMA",0
19,"19142",260,189,186,2,3,"PACMA",6
19,"19274",895,673,664,8,9,"PACMA",6
19,"19257",3446,2532,2499,36,33,"PACMA",10
19,"19219",13,9,9,0,0,"PACMA",0
19,"19038",28,23,23,0,0,"PACMA",0
19,"19095",12,10,10,0,0,"PACMA",0
19,"19156",983,743,735,5,8,"PACMA",8
19,"19223",110,76,76,3,0,"PACMA",2
19,"19303",46,39,38,0,1,"PACMA",0
19,"19113",471,365,365,2,0,"PACMA",0
19,"19224",93,80,80,0,0,"PACMA",0
19,"19262",139,111,109,0,2,"PACMA",0
19,"19099",299,206,205,1,1,"PACMA",0
19,"19110",57,46,45,2,1,"PACMA",1
19,"19197",25,20,20,0,0,"PACMA",0
19,"19271",47,30,30,0,0,"PACMA",0
19,"19278",29,28,28,2,0,"PACMA",0
19,"19102",101,84,84,0,0,"PACMA",0
19,"19114",39,26,26,0,0,"PACMA",0
19,"19021",1051,788,774,7,14,"PACMA",12
19,"19321",38,26,26,0,0,"PACMA",0
19,"19159",94,77,77,0,0,"PACMA",0
19,"19172",55,44,44,0,0,"PACMA",0
19,"19145",48,42,42,2,0,"PACMA",0
19,"19067",70,51,50,2,1,"PACMA",0
19,"19238",42,32,31,2,1,"PACMA",0
19,"19186",81,63,63,1,0,"PACMA",0
19,"19070",79,59,59,0,0,"PACMA",0
19,"19004",66,51,50,1,1,"PACMA",0
19,"19301",38,30,30,0,0,"PACMA",0
19,"19198",17,10,10,0,0,"PACMA",0
19,"19008",37,28,28,0,0,"PACMA",1
19,"19160",899,601,597,2,4,"PACMA",7
19,"19173",47,40,37,0,3,"PACMA",1
19,"19023",117,101,99,1,2,"PACMA",0
19,"19187",50,46,44,0,2,"PACMA",0
19,"19019",19,17,16,0,1,"PACMA",0
19,"19323",42,33,33,0,0,"PACMA",0
19,"19139",31,23,23,1,0,"PACMA",0
19,"19071",7746,5748,5678,34,70,"PACMA",64
19,"19199",19,16,16,1,0,"PACMA",0
19,"19324",179,136,135,0,1,"PACMA",0
19,"19161",218,151,151,1,0,"PACMA",0
19,"19147",46,34,33,0,1,"PACMA",0
19,"19294",23,19,19,1,0,"PACMA",0
19,"19265",136,104,104,0,0,"PACMA",0
19,"19200",75,53,53,1,0,"PACMA",0
19,"19105",2332,1809,1794,11,15,"PACMA",16
19,"19307",25,23,23,1,0,"PACMA",0
19,"19281",22,18,18,0,0,"PACMA",0
19,"19311",83,58,57,0,1,"PACMA",0
19,"19043",80,74,72,0,2,"PACMA",0
19,"19027",148,116,115,1,1,"PACMA",0
19,"19073",24,19,19,0,0,"PACMA",0
19,"19118",13,10,10,0,0,"PACMA",0
19,"19241",46,35,35,1,0,"PACMA",0
19,"19176",237,181,181,0,0,"PACMA",0
19,"19325",128,89,88,0,1,"PACMA",1
19,"19163",61,44,43,1,1,"PACMA",0
19,"19189",120,91,90,2,1,"PACMA",0
19,"19282",161,115,112,0,3,"PACMA",0
19,"19242",93,66,62,2,4,"PACMA",0
19,"19074",73,63,63,0,0,"PACMA",0
19,"19201",59,51,51,1,0,"PACMA",0
19,"19031",15,10,9,0,1,"PACMA",0
19,"19283",29,23,23,0,0,"PACMA",0
19,"19057",72,53,52,0,1,"PACMA",0
19,"19075",63,37,36,0,1,"PACMA",0
19,"19326",1749,1248,1237,5,11,"PACMA",16
19,"19190",2405,1852,1833,14,19,"PACMA",6
19,"19119",81,71,71,0,0,"PACMA",0
19,"19032",175,131,124,1,7,"PACMA",0
19,"19202",13,12,12,0,0,"PACMA",0
19,"19165",48,40,40,0,0,"PACMA",1
19,"19203",31,25,25,0,0,"PACMA",0
19,"19151",1075,779,764,5,15,"PACMA",5
19,"19146",42,34,34,0,0,"PACMA",0
19,"19108",112,90,90,1,0,"PACMA",2
19,"19327",431,348,342,3,6,"PACMA",0
19,"19166",158,125,124,0,1,"PACMA",2
19,"19244",81,61,59,2,2,"PACMA",1
19,"19015",81,68,68,0,0,"PACMA",0
19,"19329",58,49,49,0,0,"PACMA",1
19,"19076",31,20,20,0,0,"PACMA",0
19,"19016",64,42,42,0,0,"PACMA",1
19,"19192",1723,1354,1342,9,12,"PACMA",8
19,"19121",257,209,208,0,1,"PACMA",0
19,"19204",154,106,106,3,0,"PACMA",1
19,"19152",589,448,439,2,9,"PACMA",1
19,"19033",64,49,49,3,0,"PACMA",0
19,"19237",47,35,34,1,1,"PACMA",0
19,"19285",25,16,16,2,0,"PACMA",0
19,"19314",52,35,34,1,1,"PACMA",0
19,"19258",97,73,73,1,0,"PACMA",0
19,"19078",53,44,44,0,0,"PACMA",0
19,"19079",8,7,7,0,0,"PACMA",0
19,"19208",43,31,31,0,0,"PACMA",0
19,"19330",71,64,64,0,0,"PACMA",0
19,"19168",297,227,224,2,3,"PACMA",0
19,"19122",93,72,72,3,0,"PACMA",0
19,"19286",725,557,551,1,6,"PACMA",5
19,"19193",23,22,21,0,1,"PACMA",0
19,"19036",271,230,229,1,1,"PACMA",0
19,"19018",163,122,119,2,3,"PACMA",0
19,"19209",40,28,27,1,1,"PACMA",0
19,"19246",46,36,36,0,0,"PACMA",0
19,"19138",272,197,196,0,1,"PACMA",1
19,"19331",2611,2010,1982,18,28,"PACMA",14
19,"19080",73,51,50,0,1,"PACMA",0
19,"19272",72,59,59,1,0,"PACMA",0
19,"19317",141,107,103,0,4,"PACMA",0
19,"19332",93,68,68,0,0,"PACMA",0
19,"19260",41,38,38,1,0,"PACMA",0
19,"19037",146,113,113,1,0,"PACMA",2
19,"19222",115,87,86,1,1,"PACMA",0
19,"19210",21,19,19,2,0,"PACMA",0
19,"19243",43,36,36,0,0,"PACMA",0
19,"19064",73,62,62,0,0,"PACMA",0
19,"19288",23,22,22,0,0,"PACMA",0
19,"19124",382,256,253,0,3,"PACMA",0
19,"19195",40,30,26,1,4,"PACMA",0
19,"19318",25,19,19,0,0,"PACMA",0
19,"19081",31,21,21,0,0,"PACMA",0
19,"19020",43,27,26,2,1,"PACMA",0
19,"19319",4425,3336,3304,21,32,"PACMA",58
19,"19170",193,140,140,0,0,"PACMA",1
19,"19333",121,86,83,2,3,"PACMA",0
19,"19248",83,66,66,1,0,"PACMA",0
19,"19196",106,86,80,0,6,"PACMA",0
19,"19066",61,49,47,0,2,"PACMA",0
19,"19125",45,40,40,0,0,"PACMA",1
19,"19289",28,21,21,0,0,"PACMA",0
19,"19211",394,297,291,1,6,"PACMA",1
19,"19082",85,62,62,0,0,"PACMA",1
19,"19304",220,161,161,1,0,"PACMA",2
19,"19126",1620,1242,1216,5,26,"PACMA",20
19,"19039",60,55,54,1,1,"PACMA",0
19,"19171",4884,3824,3778,24,46,"PACMA",37
19,"19212",727,562,551,8,11,"PACMA",1
19,"19334",36,30,29,0,1,"PACMA",0
19,"19250",21,16,15,0,1,"PACMA",0
19,"19290",853,568,560,3,8,"PACMA",15
19,"19335",54,45,45,0,0,"PACMA",0
19,"19052",27,18,18,1,0,"PACMA",0
19,"19086",1495,1158,1149,7,9,"PACMA",2
19,"19291",1215,883,868,0,15,"PACMA",2
19,"19127",89,56,56,0,0,"PACMA",0
19,"19322",31,26,26,0,0,"PACMA",0
19,"19040",51,41,41,0,0,"PACMA",0
19,"19115",24,14,14,1,0,"PACMA",0
19,"19022",632,477,468,3,9,"PACMA",3
19,"19251",42,29,28,0,1,"PACMA",0
19,"19213",72,53,51,0,2,"PACMA",0
19,"19901",41,37,36,1,1,"PACMA",0
19,"19087",18,17,17,0,0,"PACMA",0
19,"19214",74,54,54,0,0,"PACMA",0
19,"19041",160,133,132,0,1,"PACMA",3
19,"19239",100,70,69,1,1,"PACMA",0
19,"19088",84,68,68,0,0,"PACMA",0
19,"19104",18,13,13,1,0,"PACMA",0
19,"19129",29,25,25,0,0,"PACMA",0
2,"2017",845,611,607,1,4,"C's",34
2,"2078",922,698,691,6,7,"C's",52
2,"2024",3416,2694,2666,33,28,"C's",405
2,"2085",321,268,266,4,2,"C's",21
2,"2074",5998,4415,4363,20,52,"C's",463
2,"2015",1444,1196,1179,7,17,"C's",104
2,"2014",368,300,295,1,5,"C's",14
2,"2076",334,269,268,3,1,"C's",12
2,"2061",641,534,530,7,4,"C's",33
2,"2043",1250,1020,1006,8,14,"C's",73
2,"2901",2202,1571,1563,16,8,"C's",178
2,"2068",343,265,262,2,3,"C's",27
2,"2023",576,479,468,2,11,"C's",31
2,"2054",390,305,302,3,3,"C's",27
2,"2039",1002,824,819,8,5,"C's",88
2,"2013",132,105,104,0,1,"C's",17
2,"2049",838,610,607,3,3,"C's",34
2,"2044",1128,806,798,2,8,"C's",83
2,"2016",581,445,441,0,4,"C's",49
2,"2086",2603,1797,1783,8,14,"C's",91
2,"2006",588,482,476,2,6,"C's",31
2,"2004",621,504,500,5,4,"C's",38
2,"2019",2412,1991,1959,13,32,"C's",153
2,"2062",414,324,319,0,5,"C's",31
2,"2082",105,88,88,1,0,"C's",8
2,"2063",1471,1161,1156,6,5,"C's",109
2,"2064",379,317,316,1,1,"C's",18
2,"2003",131959,101091,100433,730,658,"C's",18480
2,"2059",317,242,241,0,1,"C's",12
2,"2050",103,87,87,0,0,"C's",1
2,"2027",310,251,251,0,0,"C's",28
2,"2010",1798,1491,1463,10,28,"C's",148
2,"2060",1302,1007,1003,8,4,"C's",114
2,"2051",1690,1227,1211,12,16,"C's",119
2,"2030",3059,2405,2377,11,28,"C's",244
2,"2031",574,447,440,1,7,"C's",29
2,"2041",350,274,272,1,2,"C's",15
2,"2002",494,406,397,0,9,"C's",29
2,"2009",19686,14909,14719,148,190,"C's",2188
2,"2029",3306,2563,2533,17,30,"C's",403
2,"2025",7502,5918,5785,41,133,"C's",974
2,"2046",1135,936,917,15,19,"C's",83
2,"2069",11544,8969,8824,62,145,"C's",1438
2,"2021",1037,823,816,3,7,"C's",79
2,"2084",325,228,221,2,7,"C's",18
2,"2071",1056,890,884,7,6,"C's",58
2,"2080",532,419,410,0,9,"C's",23
2,"2042",850,698,693,2,5,"C's",46
2,"2020",451,381,376,3,5,"C's",24
2,"2036",96,72,72,1,0,"C's",1
2,"2007",1050,824,811,7,13,"C's",27
2,"2047",120,91,90,0,1,"C's",0
2,"2026",847,705,697,7,8,"C's",41
2,"2037",22886,15400,15266,111,134,"C's",2219
2,"2018",832,670,663,5,7,"C's",70
2,"2012",1833,1595,1575,17,20,"C's",140
2,"2081",18334,14121,13932,116,189,"C's",1794
2,"2053",2996,2370,2332,15,38,"C's",222
2,"2058",348,244,239,2,5,"C's",14
2,"2066",238,206,205,1,1,"C's",7
2,"2070",411,337,330,1,7,"C's",12
2,"2065",475,403,402,2,1,"C's",20
2,"2022",368,279,278,0,1,"C's",25
2,"2072",1560,1118,1098,4,20,"C's",82
2,"2035",1989,1607,1582,13,25,"C's",212
2,"2057",2043,1593,1568,24,25,"C's",125
2,"2032",281,217,216,1,1,"C's",8
2,"2075",1684,1406,1397,10,9,"C's",115
2,"2038",284,230,230,1,0,"C's",19
2,"2079",2887,2312,2285,24,27,"C's",221
2,"2077",55,41,41,0,0,"C's",1
2,"2067",1189,909,896,4,13,"C's",81
2,"2033",1920,1551,1518,6,33,"C's",132
2,"2048",1251,1013,1004,9,9,"C's",97
2,"2055",1157,757,753,9,4,"C's",56
2,"2001",660,521,510,4,11,"C's",29
2,"2083",217,194,194,0,0,"C's",8
2,"2011",643,517,515,0,2,"C's",12
2,"2008",1227,923,909,9,14,"C's",81
2,"2056",1729,1348,1323,10,25,"C's",101
2,"2028",132,103,102,0,1,"C's",2
2,"2005",568,441,434,4,7,"C's",52
2,"2034",1395,1131,1126,10,5,"C's",88
2,"2040",586,507,505,1,2,"C's",44
2,"2073",4914,3777,3730,42,47,"C's",399
2,"2045",3706,3046,3009,17,37,"C's",303
2,"2052",473,399,398,3,1,"C's",39
48,"48057",5749,4093,4081,20,12,"PP",75
48,"48911",382,291,286,2,5,"PP",2
48,"48083",6950,5128,5097,33,31,"PP",275
48,"48079",425,322,321,4,1,"PP",10
48,"48073",6952,4476,4435,43,41,"PP",184
48,"48037",678,518,509,2,9,"PP",12
48,"48902",19124,13344,13227,93,117,"PP",1018
48,"48034",12902,9684,9613,79,71,"PP",1684
48,"48064",603,463,459,7,4,"PP",6
48,"48078",38742,28064,27837,231,227,"PP",3211
48,"48904",3504,2671,2650,18,21,"PP",227
48,"48038",1122,834,824,0,10,"PP",34
48,"48013",79984,56928,56516,383,412,"PP",6764
48,"48019",3594,2569,2544,16,25,"PP",173
48,"48018",875,553,553,3,0,"PP",4
48,"48093",900,673,664,4,9,"PP",38
48,"48033",215,160,159,0,1,"PP",4
48,"48901",4775,3602,3573,35,29,"PP",282
48,"48049",548,433,431,0,2,"PP",8
48,"48910",2948,2126,2115,17,11,"PP",222
48,"48011",9692,6891,6843,56,48,"PP",481
48,"48026",1134,861,853,7,8,"PP",7
48,"48086",2073,1519,1504,15,15,"PP",73
48,"48072",974,728,723,5,5,"PP",13
48,"48095",2352,1658,1647,6,11,"PP",161
48,"48041",704,558,555,4,3,"PP",9
48,"48005",117,76,76,0,0,"PP",2
48,"48003",14338,10497,10414,76,83,"PP",511
48,"48044",62989,46989,46783,385,206,"PP",10169
48,"48045",5149,3940,3885,35,55,"PP",197
48,"48907",355,283,282,2,1,"PP",3
48,"48909",207,165,165,1,0,"PP",0
48,"48008",617,433,424,6,9,"PP",19
48,"48908",245,200,199,1,1,"PP",3
48,"48084",22577,15689,15540,108,149,"PP",1534
48,"48914",330,275,275,1,0,"PP",1
48,"48906",775,579,574,0,5,"PP",12
48,"48014",1218,870,866,8,4,"PP",75
48,"48027",22033,15929,15825,113,104,"PP",1479
48,"48903",1838,1400,1385,4,15,"PP",161
48,"48088",135,97,96,0,1,"PP",3
48,"48077",3367,2438,2423,17,15,"PP",177
48,"48065",3315,2447,2433,19,14,"PP",133
48,"48089",3266,2425,2406,23,19,"PP",123
48,"48032",5735,4173,4151,32,22,"PP",315
48,"48063",373,289,288,1,1,"PP",4
48,"48075",1975,1440,1421,12,19,"PP",70
48,"48070",545,378,374,2,4,"PP",3
48,"48059",402,317,314,1,3,"PP",7
48,"48066",346,256,256,1,0,"PP",5
48,"48068",1551,1178,1163,16,15,"PP",15
48,"48042",1384,1111,1091,7,20,"PP",108
48,"48020",274076,193807,192607,1471,1200,"PP",29488
48,"48025",883,642,639,3,3,"PP",12
48,"48023",594,470,468,4,2,"PP",20
48,"48096",6608,5071,5011,43,60,"PP",265
48,"48092",837,619,619,13,0,"PP",31
48,"48028",715,553,551,4,2,"PP",11
48,"48047",161,112,112,0,0,"PP",1
48,"48091",1134,821,812,7,9,"PP",32
48,"48035",412,313,312,4,1,"PP",2
48,"48051",220,169,168,0,1,"PP",17
48,"48024",1003,775,771,5,4,"PP",14
48,"48058",972,691,687,4,4,"PP",25
48,"48062",300,241,240,1,1,"PP",3
48,"48006",289,246,245,3,1,"PP",0
48,"48071",6118,4467,4412,32,55,"PP",213
48,"48081",1883,1412,1398,12,14,"PP",61
48,"48054",24135,17493,17374,124,119,"PP",1992
48,"48004",334,229,227,1,2,"PP",0
48,"48053",900,676,670,8,6,"PP",90
48,"48905",2565,1882,1847,2,35,"PP",96
48,"48912",2308,1787,1746,27,41,"PP",70
48,"48007",365,241,239,0,2,"PP",0
48,"48090",6022,4544,4483,23,61,"PP",294
48,"48052",1559,1215,1211,0,4,"PP",26
48,"48043",4403,3214,3186,28,28,"PP",222
48,"48017",13290,8908,8856,42,52,"PP",219
48,"48074",3333,2467,2428,20,39,"PP",197
48,"48001",5832,4191,4166,37,25,"PP",394
48,"48069",12765,8985,8910,58,75,"PP",711
48,"48061",762,584,581,4,3,"PP",28
48,"48021",1352,952,946,8,6,"PP",33
48,"48015",33690,24299,24160,168,139,"PP",2645
48,"48048",562,399,394,3,5,"PP",8
48,"48040",1299,896,884,5,12,"PP",28
48,"48010",457,311,307,1,4,"PP",0
48,"48097",1303,907,898,10,9,"PP",57
48,"48046",12617,9037,8967,56,70,"PP",402
48,"48060",3645,2277,2274,7,3,"PP",65
48,"48016",5260,3856,3827,22,29,"PP",425
48,"48076",314,237,237,4,0,"PP",8
48,"48067",1161,837,834,2,3,"PP",11
48,"48087",429,346,343,1,3,"PP",27
48,"48050",198,153,150,0,3,"PP",6
48,"48056",978,733,732,7,1,"PP",14
48,"48009",786,614,609,3,5,"PP",21
48,"48022",2355,1476,1468,9,8,"PP",78
48,"48913",1251,933,917,13,16,"PP",40
48,"48002",7851,5767,5713,41,54,"PP",239
48,"48915",362,238,238,2,0,"PP",5
48,"48012",2041,1571,1553,11,18,"PP",47
48,"48039",243,201,201,2,0,"PP",7
48,"48030",608,454,453,4,1,"PP",10
48,"48094",3193,2210,2200,18,10,"PP",58
48,"48036",24144,17085,16954,117,131,"PP",1348
48,"48082",37673,27006,26811,201,195,"PP",2513
48,"48085",10301,7458,7407,50,51,"PP",415
48,"48031",340,245,242,0,3,"PP",2
48,"48055",2662,1961,1938,16,23,"PP",66
48,"48029",8332,6155,6119,35,36,"PP",590
48,"48080",9971,7148,7086,71,62,"PP",475
19,"19219",13,9,9,0,0,"PP",0
19,"19061",56,47,47,0,0,"PP",22
19,"19333",121,86,83,2,3,"PP",28
19,"19252",67,58,58,0,0,"PP",33
19,"19160",899,601,597,2,4,"PP",199
19,"19027",148,116,115,1,1,"PP",44
19,"19191",13,12,12,0,0,"PP",3
19,"19049",12,11,11,0,0,"PP",3
19,"19326",1749,1248,1237,5,11,"PP",359
19,"19319",4425,3336,3304,21,32,"PP",921
19,"19145",48,42,42,2,0,"PP",27
19,"19132",93,74,74,0,0,"PP",45
19,"19159",94,77,77,0,0,"PP",48
19,"19033",64,49,49,3,0,"PP",18
19,"19106",92,67,64,0,3,"PP",27
19,"19190",2405,1852,1833,14,19,"PP",633
19,"19118",13,10,10,0,0,"PP",0
19,"19271",47,30,30,0,0,"PP",22
19,"19264",38,29,29,0,0,"PP",11
19,"19138",272,197,196,0,1,"PP",58
19,"19174",111,79,78,0,1,"PP",38
19,"19257",3446,2532,2499,36,33,"PP",1166
19,"19259",28,18,18,0,0,"PP",4
19,"19097",17,13,13,0,0,"PP",10
19,"19221",50,35,35,0,0,"PP",24
19,"19074",73,63,63,0,0,"PP",13
19,"19196",106,86,80,0,6,"PP",37
19,"19054",190,165,163,3,2,"PP",85
19,"19290",853,568,560,3,8,"PP",184
19,"19229",69,60,60,1,0,"PP",27
19,"19246",46,36,36,0,0,"PP",11
19,"19181",55,37,37,0,0,"PP",24
19,"19104",18,13,13,1,0,"PP",6
19,"19202",13,12,12,0,0,"PP",5
19,"19120",104,92,92,1,0,"PP",49
19,"19150",126,94,93,0,1,"PP",52
19,"19040",51,41,41,0,0,"PP",9
19,"19071",7746,5748,5678,34,70,"PP",1844
19,"19311",83,58,57,0,1,"PP",31
19,"19265",136,104,104,0,0,"PP",63
19,"19216",134,97,97,0,0,"PP",29
19,"19016",64,42,42,0,0,"PP",15
19,"19004",66,51,50,1,1,"PP",37
19,"19245",1179,913,893,6,20,"PP",395
19,"19167",132,106,103,0,3,"PP",58
19,"19073",24,19,19,0,0,"PP",6
19,"19017",69,56,56,0,0,"PP",24
19,"19042",26,25,25,0,0,"PP",5
19,"19200",75,53,53,1,0,"PP",19
19,"19266",241,201,199,2,2,"PP",113
19,"19189",120,91,90,2,1,"PP",43
19,"19297",31,21,21,1,0,"PP",19
19,"19126",1620,1242,1216,5,26,"PP",385
19,"19008",37,28,28,0,0,"PP",10
19,"19291",1215,883,868,0,15,"PP",335
19,"19287",144,109,109,0,0,"PP",69
19,"19053",2024,1479,1464,13,15,"PP",663
19,"19230",504,383,376,4,7,"PP",86
19,"19208",43,31,31,0,0,"PP",19
19,"19296",30,21,21,0,0,"PP",13
19,"19048",17,10,10,1,0,"PP",5
19,"19007",479,364,360,2,4,"PP",162
19,"19286",725,557,551,1,6,"PP",199
19,"19139",31,23,23,1,0,"PP",12
19,"19001",53,36,36,1,0,"PP",27
19,"19193",23,22,21,0,1,"PP",5
19,"19261",38,25,25,0,0,"PP",16
19,"19269",100,80,79,0,1,"PP",20
19,"19032",175,131,124,1,7,"PP",44
19,"19284",10,8,8,0,0,"PP",2
19,"19065",127,103,102,1,1,"PP",45
19,"19248",83,66,66,1,0,"PP",30
19,"19267",19,12,12,0,0,"PP",6
19,"19242",93,66,62,2,4,"PP",44
19,"19239",100,70,69,1,1,"PP",32
19,"19124",382,256,253,0,3,"PP",90
19,"19307",25,23,23,1,0,"PP",18
19,"19244",81,61,59,2,2,"PP",40
19,"19047",67,60,60,1,0,"PP",17
19,"19096",93,66,66,0,0,"PP",30
19,"19249",31,27,27,0,0,"PP",21
19,"19039",60,55,54,1,1,"PP",29
19,"19043",80,74,72,0,2,"PP",37
19,"19175",34,26,26,1,0,"PP",20
19,"19188",50,34,32,1,2,"PP",19
19,"19172",55,44,44,0,0,"PP",22
19,"19279",57,54,54,0,0,"PP",36
19,"19034",22,18,18,0,0,"PP",8
19,"19329",58,49,49,0,0,"PP",26
19,"19052",27,18,18,1,0,"PP",3
19,"19067",70,51,50,2,1,"PP",14
19,"19122",93,72,72,3,0,"PP",30
19,"19086",1495,1158,1149,7,9,"PP",454
19,"19111",158,123,121,0,2,"PP",65
19,"19222",115,87,86,1,1,"PP",40
19,"19335",54,45,45,0,0,"PP",14
19,"19036",271,230,229,1,1,"PP",103
19,"19198",17,10,10,0,0,"PP",4
19,"19243",43,36,36,0,0,"PP",14
19,"19282",161,115,112,0,3,"PP",83
19,"19013",128,106,106,0,0,"PP",28
19,"19003",41,37,35,0,2,"PP",4
19,"19293",1868,1379,1364,9,15,"PP",358
19,"19186",81,63,63,1,0,"PP",30
19,"19015",81,68,68,0,0,"PP",27
19,"19310",11,7,7,0,0,"PP",2
19,"19280",3451,2620,2581,14,39,"PP",668
19,"19258",97,73,73,1,0,"PP",42
19,"19050",15,13,13,0,0,"PP",3
19,"19005",95,71,69,1,2,"PP",26
19,"19009",261,193,190,5,3,"PP",82
19,"19203",31,25,25,0,0,"PP",7
19,"19178",39,25,25,0,0,"PP",9
19,"19166",158,125,124,0,1,"PP",56
19,"19116",13,11,11,0,0,"PP",6
19,"19006",768,545,538,0,7,"PP",189
19,"19130",59955,47034,46504,383,530,"PP",17187
19,"19184",75,48,46,0,2,"PP",30
19,"19113",471,365,365,2,0,"PP",131
19,"19060",150,115,114,1,1,"PP",15
19,"19044",309,248,246,3,2,"PP",144
19,"19232",79,60,59,1,1,"PP",37
19,"19254",49,36,36,1,0,"PP",17
19,"19299",95,74,74,1,0,"PP",28
19,"19148",45,37,37,1,0,"PP",22
19,"19105",2332,1809,1794,11,15,"PP",609
19,"19110",57,46,45,2,1,"PP",24
19,"19224",93,80,80,0,0,"PP",65
19,"19308",65,54,54,0,0,"PP",24
19,"19168",297,227,224,2,3,"PP",92
19,"19176",237,181,181,0,0,"PP",123
19,"19185",31,18,18,0,0,"PP",8
19,"19057",72,53,52,0,1,"PP",12
19,"19076",31,20,20,0,0,"PP",19
19,"19306",28,20,20,0,0,"PP",17
19,"19079",8,7,7,0,0,"PP",7
19,"19283",29,23,23,0,0,"PP",10
19,"19115",24,14,14,1,0,"PP",10
19,"19018",163,122,119,2,3,"PP",72
19,"19301",38,30,30,0,0,"PP",22
19,"19332",93,68,68,0,0,"PP",31
19,"19087",18,17,17,0,0,"PP",8
19,"19075",63,37,36,0,1,"PP",20
19,"19218",52,35,34,0,1,"PP",13
19,"19195",40,30,26,1,4,"PP",9
19,"19023",117,101,99,1,2,"PP",46
19,"19277",18,12,12,0,0,"PP",4
19,"19211",394,297,291,1,6,"PP",147
19,"19302",58,45,45,1,0,"PP",22
19,"19183",83,74,73,0,1,"PP",25
19,"19037",146,113,113,1,0,"PP",60
19,"19059",79,60,59,0,1,"PP",39
19,"19210",21,19,19,2,0,"PP",15
19,"19010",9,9,9,0,0,"PP",2
19,"19095",12,10,10,0,0,"PP",6
19,"19089",28,17,17,0,0,"PP",1
19,"19152",589,448,439,2,9,"PP",174
19,"19240",52,38,37,0,1,"PP",12
19,"19227",74,49,49,0,0,"PP",21
19,"19154",66,52,51,0,1,"PP",42
19,"19070",79,59,59,0,0,"PP",32
19,"19020",43,27,26,2,1,"PP",14
19,"19220",2305,1613,1600,9,13,"PP",386
19,"19212",727,562,551,8,11,"PP",268
19,"19262",139,111,109,0,2,"PP",64
19,"19066",61,49,47,0,2,"PP",32
19,"19021",1051,788,774,7,14,"PP",315
19,"19334",36,30,29,0,1,"PP",11
19,"19325",128,89,88,0,1,"PP",55
19,"19011",254,191,191,2,0,"PP",62
19,"19300",762,628,624,3,4,"PP",191
19,"19031",15,10,9,0,1,"PP",5
19,"19092",417,316,312,4,4,"PP",142
19,"19289",28,21,21,0,0,"PP",10
19,"19019",19,17,16,0,1,"PP",9
19,"19225",835,645,638,2,7,"PP",181
19,"19103",255,205,201,0,4,"PP",76
19,"19091",29,20,20,0,0,"PP",12
19,"19022",632,477,468,3,9,"PP",237
19,"19177",78,60,57,1,3,"PP",18
19,"19268",36,26,25,0,1,"PP",6
19,"19119",81,71,71,0,0,"PP",27
19,"19251",42,29,28,0,1,"PP",16
19,"19182",39,28,27,0,1,"PP",6
19,"19260",41,38,38,1,0,"PP",13
19,"19156",983,743,735,5,8,"PP",354
19,"19163",61,44,43,1,1,"PP",18
19,"19192",1723,1354,1342,9,12,"PP",645
19,"19214",74,54,54,0,0,"PP",26
19,"19318",25,19,19,0,0,"PP",4
19,"19081",31,21,21,0,0,"PP",17
19,"19170",193,140,140,0,0,"PP",60
19,"19157",57,45,45,0,0,"PP",18
19,"19204",154,106,106,3,0,"PP",33
19,"19223",110,76,76,3,0,"PP",34
19,"19121",257,209,208,0,1,"PP",85
19,"19288",23,22,22,0,0,"PP",11
19,"19024",8143,6017,5944,33,73,"PP",1558
19,"19250",21,16,15,0,1,"PP",6
19,"19064",73,62,62,0,0,"PP",36
19,"19199",19,16,16,1,0,"PP",2
19,"19135",105,82,82,0,0,"PP",43
19,"19102",101,84,84,0,0,"PP",39
19,"19055",53,34,33,2,1,"PP",18
19,"19294",23,19,19,1,0,"PP",6
19,"19217",59,39,37,0,2,"PP",18
19,"19136",18,15,15,0,0,"PP",6
19,"19078",53,44,44,0,0,"PP",7
19,"19114",39,26,26,0,0,"PP",9
19,"19314",52,35,34,1,1,"PP",16
19,"19263",27,17,15,0,2,"PP",10
19,"19146",42,34,34,0,0,"PP",9
19,"19215",165,142,141,0,1,"PP",94
19,"19235",97,63,62,0,1,"PP",18
19,"19129",29,25,25,0,0,"PP",14
19,"19274",895,673,664,8,9,"PP",207
19,"19098",21,20,20,0,0,"PP",6
19,"19238",42,32,31,2,1,"PP",17
19,"19155",66,54,53,0,1,"PP",17
19,"19233",91,71,71,1,0,"PP",24
19,"19123",44,38,38,0,0,"PP",18
19,"19317",141,107,103,0,4,"PP",46
19,"19256",44,35,35,0,0,"PP",23
19,"19226",48,35,35,0,0,"PP",10
19,"19285",25,16,16,2,0,"PP",4
19,"19321",38,26,26,0,0,"PP",8
19,"19143",1733,1371,1352,9,19,"PP",559
19,"19125",45,40,40,0,0,"PP",19
19,"19303",46,39,38,0,1,"PP",25
19,"19179",72,52,52,1,0,"PP",24
19,"19169",43,36,36,0,0,"PP",9
19,"19002",73,56,54,0,2,"PP",22
19,"19281",22,18,18,0,0,"PP",5
19,"19133",86,73,73,1,0,"PP",24
19,"19099",299,206,205,1,1,"PP",73
19,"19038",28,23,23,0,0,"PP",14
19,"19088",84,68,68,0,0,"PP",40
19,"19278",29,28,28,2,0,"PP",20
19,"19134",26,18,18,0,0,"PP",9
19,"19327",431,348,342,3,6,"PP",241
19,"19058",6786,5451,5415,29,36,"PP",1627
19,"19112",57,49,49,0,0,"PP",31
19,"19080",73,51,50,0,1,"PP",28
19,"19153",23,22,22,0,0,"PP",1
19,"19082",85,62,62,0,0,"PP",15
19,"19234",46,38,38,0,0,"PP",14
19,"19109",43,32,32,3,0,"PP",25
19,"19305",162,129,128,1,1,"PP",66
19,"19323",42,33,33,0,0,"PP",11
19,"19197",25,20,20,0,0,"PP",1
19,"19209",40,28,27,1,1,"PP",12
19,"19147",46,34,33,0,1,"PP",14
19,"19304",220,161,161,1,0,"PP",38
19,"19237",47,35,34,1,1,"PP",12
19,"19142",260,189,186,2,3,"PP",44
19,"19162",65,49,49,0,0,"PP",15
19,"19171",4884,3824,3778,24,46,"PP",966
19,"19187",50,46,44,0,2,"PP",22
19,"19228",29,21,20,0,1,"PP",1
19,"19330",71,64,64,0,0,"PP",24
19,"19309",26,22,22,0,0,"PP",11
19,"19194",98,68,66,0,2,"PP",26
19,"19041",160,133,132,0,1,"PP",22
19,"19046",21452,16321,16151,91,170,"PP",4114
19,"19201",59,51,51,1,0,"PP",25
19,"19108",112,90,90,1,0,"PP",29
19,"19213",72,53,51,0,2,"PP",32
19,"19165",48,40,40,0,0,"PP",11
19,"19298",64,49,49,0,0,"PP",10
19,"19117",1580,1183,1167,11,16,"PP",278
19,"19107",302,262,260,0,2,"PP",125
19,"19241",46,35,35,1,0,"PP",24
19,"19090",97,77,77,1,0,"PP",30
19,"19127",89,56,56,0,0,"PP",37
19,"19045",145,119,117,1,2,"PP",88
19,"19161",218,151,151,1,0,"PP",50
19,"19331",2611,2010,1982,18,28,"PP",637
19,"19151",1075,779,764,5,15,"PP",289
19,"19231",12,8,8,1,0,"PP",5
19,"19173",47,40,37,0,3,"PP",16
19,"19272",72,59,59,1,0,"PP",24
19,"19255",78,61,61,0,0,"PP",30
19,"19051",70,65,65,0,0,"PP",37
19,"19901",41,37,36,1,1,"PP",17
19,"19324",179,136,135,0,1,"PP",70
19,"19270",22,18,18,0,0,"PP",8
19,"19247",148,106,102,1,4,"PP",36
19,"19322",31,26,26,0,0,"PP",14
33,"33063",419,330,326,1,4,"IU-UPeC-IAS",10
33,"33030",899,689,687,10,2,"IU-UPeC-IAS",84
33,"33052",730,517,512,1,5,"IU-UPeC-IAS",25
33,"33066",43034,29901,29610,261,291,"IU-UPeC-IAS",2185
33,"33031",35453,23848,23595,242,253,"IU-UPeC-IAS",3613
33,"33018",2896,2068,2041,18,27,"IU-UPeC-IAS",125
33,"33010",1828,1220,1215,16,5,"IU-UPeC-IAS",88
33,"33045",4503,3249,3216,26,33,"IU-UPeC-IAS",197
33,"33055",1511,1150,1129,9,21,"IU-UPeC-IAS",37
33,"33035",11299,8048,7981,67,67,"IU-UPeC-IAS",574
33,"33044",178724,130938,130010,1254,928,"IU-UPeC-IAS",8408
33,"33072",1601,1012,1002,4,10,"IU-UPeC-IAS",173
33,"33050",603,374,357,0,17,"IU-UPeC-IAS",23
33,"33019",3094,2079,2054,15,25,"IU-UPeC-IAS",104
33,"33014",9101,6398,6352,46,46,"IU-UPeC-IAS",687
33,"33062",409,242,239,1,3,"IU-UPeC-IAS",32
33,"33020",13297,9527,9445,86,82,"IU-UPeC-IAS",850
33,"33043",682,465,460,2,5,"IU-UPeC-IAS",20
33,"33041",7270,5138,5093,53,45,"IU-UPeC-IAS",376
33,"33029",363,199,198,1,1,"IU-UPeC-IAS",15
33,"33046",508,375,365,4,10,"IU-UPeC-IAS",7
33,"33039",1672,1261,1257,14,4,"IU-UPeC-IAS",82
33,"33048",156,99,99,2,0,"IU-UPeC-IAS",7
33,"33022",906,604,599,3,5,"IU-UPeC-IAS",92
33,"33037",34841,24271,24054,200,217,"IU-UPeC-IAS",3797
33,"33040",4564,3125,3091,28,34,"IU-UPeC-IAS",205
33,"33058",1821,1319,1305,10,14,"IU-UPeC-IAS",282
33,"33015",1561,1042,1031,8,11,"IU-UPeC-IAS",187
33,"33023",3315,2295,2267,35,28,"IU-UPeC-IAS",120
33,"33065",1109,743,735,16,8,"IU-UPeC-IAS",45
33,"33054",1688,1159,1146,8,13,"IU-UPeC-IAS",53
33,"33025",9261,6116,6062,58,54,"IU-UPeC-IAS",556
33,"33008",1808,1268,1247,6,21,"IU-UPeC-IAS",43
33,"33017",3180,2196,2168,30,28,"IU-UPeC-IAS",92
33,"33053",1157,767,762,12,5,"IU-UPeC-IAS",110
33,"33049",6388,4229,4182,48,47,"IU-UPeC-IAS",226
33,"33036",11572,8208,8133,80,75,"IU-UPeC-IAS",431
33,"33004",67136,48699,48354,389,345,"IU-UPeC-IAS",4362
33,"33032",11483,8036,7921,82,115,"IU-UPeC-IAS",1248
33,"33024",227211,166618,165475,1240,1143,"IU-UPeC-IAS",13546
33,"33067",785,608,598,5,10,"IU-UPeC-IAS",68
33,"33047",1126,868,861,12,7,"IU-UPeC-IAS",18
33,"33027",849,544,543,8,1,"IU-UPeC-IAS",24
33,"33006",1556,1043,1036,17,7,"IU-UPeC-IAS",166
33,"33071",617,459,452,8,7,"IU-UPeC-IAS",12
33,"33073",8631,5015,4948,47,67,"IU-UPeC-IAS",205
33,"33078",147,98,98,0,0,"IU-UPeC-IAS",6
33,"33028",1289,685,682,9,3,"IU-UPeC-IAS",40
33,"33060",14750,10307,10206,82,101,"IU-UPeC-IAS",1657
33,"33016",19201,14177,14074,115,103,"IU-UPeC-IAS",1403
33,"33012",5230,3595,3568,27,27,"IU-UPeC-IAS",165
33,"33001",1622,867,852,16,15,"IU-UPeC-IAS",22
33,"33003",665,386,384,7,2,"IU-UPeC-IAS",20
33,"33070",3347,2473,2441,31,32,"IU-UPeC-IAS",123
33,"33042",4316,3143,3105,35,38,"IU-UPeC-IAS",249
33,"33005",1479,945,932,12,13,"IU-UPeC-IAS",60
33,"33056",5015,3435,3405,32,30,"IU-UPeC-IAS",197
33,"33034",10693,6796,6725,72,71,"IU-UPeC-IAS",281
33,"33075",275,161,155,2,6,"IU-UPeC-IAS",9
33,"33061",379,194,190,1,4,"IU-UPeC-IAS",6
33,"33057",1593,1134,1123,17,11,"IU-UPeC-IAS",97
33,"33021",4576,3133,3090,33,43,"IU-UPeC-IAS",154
33,"33051",7167,4810,4772,57,38,"IU-UPeC-IAS",277
33,"33077",1220,849,840,11,9,"IU-UPeC-IAS",29
33,"33026",8621,5600,5555,71,45,"IU-UPeC-IAS",561
33,"33009",899,606,601,4,5,"IU-UPeC-IAS",27
33,"33076",12270,8265,8203,89,62,"IU-UPeC-IAS",367
33,"33013",456,336,331,6,5,"IU-UPeC-IAS",29
33,"33011",11373,6279,6214,104,65,"IU-UPeC-IAS",500
33,"33059",4702,3228,3185,42,43,"IU-UPeC-IAS",133
33,"33064",231,181,179,4,2,"IU-UPeC-IAS",11
33,"33068",1114,627,623,2,4,"IU-UPeC-IAS",29
33,"33002",10122,7056,6977,55,79,"IU-UPeC-IAS",849
33,"33038",2298,1690,1675,12,15,"IU-UPeC-IAS",217
33,"33007",1524,991,980,10,11,"IU-UPeC-IAS",82
33,"33069",3513,2577,2554,15,23,"IU-UPeC-IAS",165
33,"33074",3523,2422,2390,36,32,"IU-UPeC-IAS",91
33,"33033",9943,6851,6803,61,48,"IU-UPeC-IAS",850
39,"39098",1422,1078,1074,11,4,"C's",132
39,"39082",1658,1212,1202,15,10,"C's",133
39,"39034",286,180,179,4,1,"C's",12
39,"39042",5968,4614,4572,33,42,"C's",809
39,"39041",1764,1416,1395,10,21,"C's",181
39,"39036",983,774,770,8,4,"C's",101
39,"39071",405,277,272,2,5,"C's",18
39,"39093",307,232,232,1,0,"C's",23
39,"39012",6693,5213,5131,44,82,"C's",736
39,"39014",898,655,644,8,11,"C's",81
39,"39044",3833,2889,2860,26,29,"C's",467
39,"39067",813,569,561,5,8,"C's",54
39,"39017",571,385,377,2,8,"C's",34
39,"39076",3491,2696,2662,24,34,"C's",413
39,"39087",42262,32560,32124,234,436,"C's",4144
39,"39007",434,298,297,1,1,"C's",29
39,"39058",831,594,592,6,2,"C's",43
39,"39088",71,51,51,0,0,"C's",3
39,"39084",843,608,604,5,4,"C's",55
39,"39051",67,62,61,1,1,"C's",7
39,"39002",3313,2430,2391,17,39,"C's",336
39,"39024",1882,1452,1438,14,14,"C's",172
39,"39028",3733,2918,2877,17,41,"C's",580
39,"39019",2098,1669,1646,24,23,"C's",266
39,"39065",256,202,200,6,2,"C's",25
39,"39085",6834,5319,5265,37,54,"C's",919
39,"39018",4211,3389,3329,27,60,"C's",513
39,"39015",862,650,643,6,7,"C's",80
39,"39055",1118,838,826,6,12,"C's",107
39,"39086",357,260,258,1,2,"C's",24
39,"39099",3117,2446,2406,23,40,"C's",302
39,"39026",1751,1303,1295,9,8,"C's",141
39,"39054",4472,3478,3441,45,37,"C's",586
39,"39095",2268,1812,1789,9,23,"C's",207
39,"39072",343,213,213,1,0,"C's",11
39,"39020",23612,16515,16334,125,181,"C's",2244
39,"39064",1349,1036,1016,6,20,"C's",115
39,"39027",3139,2493,2439,30,54,"C's",356
39,"39010",639,509,505,5,4,"C's",48
39,"39039",572,397,396,1,1,"C's",30
39,"39097",713,409,400,10,9,"C's",45
39,"39009",3223,2395,2370,22,25,"C's",337
39,"39031",1235,873,863,5,10,"C's",133
39,"39003",299,219,217,0,2,"C's",11
39,"39037",2003,1570,1547,8,23,"C's",179
39,"39075",137597,102862,102053,819,809,"C's",17248
39,"39070",146,111,109,3,2,"C's",9
39,"39043",1468,1167,1151,10,16,"C's",171
39,"39001",2127,1651,1631,17,20,"C's",184
39,"39046",1402,1015,985,11,30,"C's",88
39,"39089",149,104,103,1,1,"C's",11
39,"39048",1697,1372,1361,10,11,"C's",192
39,"39081",435,349,342,3,7,"C's",19
39,"39077",246,186,182,0,4,"C's",12
39,"39008",13932,10600,10506,92,94,"C's",1714
39,"39025",8693,6696,6583,58,113,"C's",813
39,"39068",659,486,479,2,7,"C's",68
39,"39049",330,251,248,1,3,"C's",25
39,"39061",3488,2746,2722,29,24,"C's",503
39,"39069",1968,1586,1555,12,31,"C's",200
39,"39062",1824,1400,1392,14,8,"C's",221
39,"39022",987,735,730,7,5,"C's",93
39,"39035",9587,7315,7214,56,101,"C's",955
39,"39100",869,628,617,12,11,"C's",76
39,"39021",495,399,391,4,8,"C's",26
39,"39005",1396,1089,1084,4,5,"C's",171
39,"39096",702,477,474,3,3,"C's",58
39,"39006",1728,1353,1337,12,16,"C's",193
39,"39053",219,135,135,1,0,"C's",12
39,"39038",1463,1039,1030,6,9,"C's",127
39,"39045",376,284,276,1,8,"C's",12
39,"39090",756,564,550,4,14,"C's",72
39,"39013",515,378,375,1,3,"C's",31
39,"39092",916,668,663,4,5,"C's",48
39,"39023",6316,4900,4827,37,73,"C's",647
39,"39060",6705,5437,5339,46,98,"C's",740
39,"39102",2281,1647,1631,13,16,"C's",216
39,"39083",1139,747,739,6,8,"C's",55
39,"39040",4290,3337,3309,22,28,"C's",529
39,"39066",868,697,688,7,9,"C's",90
39,"39101",292,206,202,2,4,"C's",10
39,"39063",973,725,720,7,5,"C's",67
39,"39074",6905,5370,5288,52,82,"C's",828
39,"39080",3552,2734,2701,17,33,"C's",372
39,"39011",1602,1211,1202,13,9,"C's",203
39,"39016",23860,18608,18405,149,203,"C's",3144
39,"39033",578,432,432,5,0,"C's",51
39,"39032",1476,1117,1100,8,17,"C's",108
39,"39047",1978,1463,1448,15,15,"C's",262
39,"39091",1947,1572,1552,9,20,"C's",160
39,"39029",624,507,503,4,4,"C's",75
39,"39059",8057,6049,5972,50,77,"C's",706
39,"39050",276,173,170,0,3,"C's",17
39,"39052",18086,14014,13852,124,162,"C's",2809
39,"39094",854,644,637,9,7,"C's",80
39,"39079",8951,6734,6657,54,77,"C's",883
39,"39056",2326,1805,1775,17,30,"C's",271
39,"39004",1539,1177,1160,12,17,"C's",111
39,"39078",1413,1045,1032,10,13,"C's",143
39,"39057",2321,1773,1746,13,27,"C's",233
39,"39030",1894,1314,1290,9,24,"C's",162
39,"39073",9806,7636,7574,42,62,"C's",1616
48,"48910",2948,2126,2115,17,11,"PACMA",8
48,"48068",1551,1178,1163,16,15,"PACMA",4
48,"48058",972,691,687,4,4,"PACMA",2
48,"48056",978,733,732,7,1,"PACMA",6
48,"48026",1134,861,853,7,8,"PACMA",2
48,"48064",603,463,459,7,4,"PACMA",1
48,"48020",274076,193807,192607,1471,1200,"PACMA",1378
48,"48091",1134,821,812,7,9,"PACMA",3
48,"48001",5832,4191,4166,37,25,"PACMA",28
48,"48094",3193,2210,2200,18,10,"PACMA",11
48,"48025",883,642,639,3,3,"PACMA",3
48,"48018",875,553,553,3,0,"PACMA",3
48,"48901",4775,3602,3573,35,29,"PACMA",30
48,"48085",10301,7458,7407,50,51,"PACMA",72
48,"48004",334,229,227,1,2,"PACMA",2
48,"48083",6950,5128,5097,33,31,"PACMA",29
48,"48079",425,322,321,4,1,"PACMA",2
48,"48052",1559,1215,1211,0,4,"PACMA",2
48,"48078",38742,28064,27837,231,227,"PACMA",194
48,"48017",13290,8908,8856,42,52,"PACMA",35
48,"48044",62989,46989,46783,385,206,"PACMA",278
48,"48005",117,76,76,0,0,"PACMA",0
48,"48911",382,291,286,2,5,"PACMA",0
48,"48024",1003,775,771,5,4,"PACMA",5
48,"48006",289,246,245,3,1,"PACMA",0
48,"48904",3504,2671,2650,18,21,"PACMA",14
48,"48909",207,165,165,1,0,"PACMA",0
48,"48086",2073,1519,1504,15,15,"PACMA",10
48,"48090",6022,4544,4483,23,61,"PACMA",27
48,"48088",135,97,96,0,1,"PACMA",0
48,"48050",198,153,150,0,3,"PACMA",0
48,"48913",1251,933,917,13,16,"PACMA",8
48,"48007",365,241,239,0,2,"PACMA",0
48,"48019",3594,2569,2544,16,25,"PACMA",9
48,"48903",1838,1400,1385,4,15,"PACMA",11
48,"48082",37673,27006,26811,201,195,"PACMA",160
48,"48066",346,256,256,1,0,"PACMA",2
48,"48022",2355,1476,1468,9,8,"PACMA",5
48,"48037",678,518,509,2,9,"PACMA",3
48,"48080",9971,7148,7086,71,62,"PACMA",46
48,"48060",3645,2277,2274,7,3,"PACMA",6
48,"48008",617,433,424,6,9,"PACMA",2
48,"48043",4403,3214,3186,28,28,"PACMA",17
48,"48084",22577,15689,15540,108,149,"PACMA",110
48,"48905",2565,1882,1847,2,35,"PACMA",5
48,"48067",1161,837,834,2,3,"PACMA",0
48,"48040",1299,896,884,5,12,"PACMA",4
48,"48097",1303,907,898,10,9,"PACMA",7
48,"48032",5735,4173,4151,32,22,"PACMA",18
48,"48012",2041,1571,1553,11,18,"PACMA",11
48,"48069",12765,8985,8910,58,75,"PACMA",59
48,"48038",1122,834,824,0,10,"PACMA",3
48,"48033",215,160,159,0,1,"PACMA",0
48,"48034",12902,9684,9613,79,71,"PACMA",60
48,"48041",704,558,555,4,3,"PACMA",3
48,"48912",2308,1787,1746,27,41,"PACMA",15
48,"48039",243,201,201,2,0,"PACMA",0
48,"48049",548,433,431,0,2,"PACMA",3
48,"48027",22033,15929,15825,113,104,"PACMA",92
48,"48906",775,579,574,0,5,"PACMA",2
48,"48045",5149,3940,3885,35,55,"PACMA",23
48,"48054",24135,17493,17374,124,119,"PACMA",135
48,"48076",314,237,237,4,0,"PACMA",0
48,"48908",245,200,199,1,1,"PACMA",0
48,"48023",594,470,468,4,2,"PACMA",1
48,"48063",373,289,288,1,1,"PACMA",3
48,"48087",429,346,343,1,3,"PACMA",0
48,"48062",300,241,240,1,1,"PACMA",1
48,"48002",7851,5767,5713,41,54,"PACMA",35
48,"48010",457,311,307,1,4,"PACMA",0
48,"48915",362,238,238,2,0,"PACMA",1
48,"48072",974,728,723,5,5,"PACMA",2
48,"48029",8332,6155,6119,35,36,"PACMA",43
48,"48035",412,313,312,4,1,"PACMA",1
48,"48074",3333,2467,2428,20,39,"PACMA",13
48,"48028",715,553,551,4,2,"PACMA",2
48,"48071",6118,4467,4412,32,55,"PACMA",36
48,"48092",837,619,619,13,0,"PACMA",3
48,"48009",786,614,609,3,5,"PACMA",2
48,"48095",2352,1658,1647,6,11,"PACMA",7
48,"48061",762,584,581,4,3,"PACMA",3
48,"48003",14338,10497,10414,76,83,"PACMA",69
48,"48046",12617,9037,8967,56,70,"PACMA",42
48,"48021",1352,952,946,8,6,"PACMA",4
48,"48048",562,399,394,3,5,"PACMA",1
48,"48073",6952,4476,4435,43,41,"PACMA",4
48,"48057",5749,4093,4081,20,12,"PACMA",4
48,"48036",24144,17085,16954,117,131,"PACMA",123
48,"48047",161,112,112,0,0,"PACMA",0
48,"48014",1218,870,866,8,4,"PACMA",6
48,"48055",2662,1961,1938,16,23,"PACMA",6
48,"48093",900,673,664,4,9,"PACMA",1
48,"48042",1384,1111,1091,7,20,"PACMA",8
48,"48070",545,378,374,2,4,"PACMA",0
48,"48914",330,275,275,1,0,"PACMA",0
48,"48013",79984,56928,56516,383,412,"PACMA",460
48,"48089",3266,2425,2406,23,19,"PACMA",19
48,"48907",355,283,282,2,1,"PACMA",0
48,"48902",19124,13344,13227,93,117,"PACMA",85
48,"48077",3367,2438,2423,17,15,"PACMA",24
48,"48030",608,454,453,4,1,"PACMA",0
48,"48065",3315,2447,2433,19,14,"PACMA",12
48,"48031",340,245,242,0,3,"PACMA",2
48,"48051",220,169,168,0,1,"PACMA",1
48,"48075",1975,1440,1421,12,19,"PACMA",6
48,"48053",900,676,670,8,6,"PACMA",3
48,"48011",9692,6891,6843,56,48,"PACMA",52
48,"48059",402,317,314,1,3,"PACMA",0
48,"48016",5260,3856,3827,22,29,"PACMA",26
48,"48081",1883,1412,1398,12,14,"PACMA",6
48,"48015",33690,24299,24160,168,139,"PACMA",201
48,"48096",6608,5071,5011,43,60,"PACMA",33
6,"6109",3957,3258,3177,22,81,"PSOE",1623
6,"6044",28899,20862,20681,153,181,"PSOE",7215
6,"6077",347,276,272,3,4,"PSOE",138
6,"6057",573,471,466,1,5,"PSOE",204
6,"6070",7753,5773,5645,52,128,"PSOE",2485
6,"6004",1604,1265,1248,10,17,"PSOE",672
6,"6024",1181,955,942,5,13,"PSOE",403
6,"6096",226,188,182,1,6,"PSOE",38
6,"6023",4362,3200,3168,11,32,"PSOE",1604
6,"6086",1233,884,874,3,10,"PSOE",391
6,"6073",745,507,497,5,10,"PSOE",182
6,"6059",1858,1361,1342,12,19,"PSOE",515
6,"6126",2183,1594,1582,9,12,"PSOE",818
6,"6110",151,107,104,0,3,"PSOE",43
6,"6097",2390,1814,1798,7,16,"PSOE",793
6,"6141",1741,1246,1223,13,23,"PSOE",580
6,"6046",1248,989,978,4,11,"PSOE",482
6,"6060",5798,4346,4261,23,85,"PSOE",1837
6,"6159",2339,1429,1407,14,22,"PSOE",758
6,"6056",481,401,399,2,2,"PSOE",190
6,"6082",382,312,306,3,6,"PSOE",143
6,"6045",499,378,378,4,0,"PSOE",187
6,"6143",3338,2548,2508,23,40,"PSOE",1308
6,"6104",677,533,529,6,4,"PSOE",297
6,"6152",1322,964,951,1,13,"PSOE",394
6,"6161",315,236,231,1,5,"PSOE",117
6,"6134",545,325,323,3,2,"PSOE",151
6,"6089",598,491,488,3,3,"PSOE",226
6,"6007",1483,1076,1068,6,8,"PSOE",646
6,"6061",1092,899,890,6,9,"PSOE",523
6,"6136",1578,1182,1168,8,14,"PSOE",568
6,"6078",510,414,407,1,7,"PSOE",125
6,"6093",4472,3476,3416,22,60,"PSOE",1617
6,"6064",841,672,671,6,1,"PSOE",309
6,"6009",206,156,156,1,0,"PSOE",63
6,"6054",5442,4185,4098,32,87,"PSOE",1627
6,"6033",1330,1037,1025,10,12,"PSOE",445
6,"6036",5085,3797,3739,29,58,"PSOE",1583
6,"6068",453,349,344,3,5,"PSOE",176
6,"6127",2893,2188,2158,13,30,"PSOE",863
6,"6115",1260,867,853,7,14,"PSOE",329
6,"6058",2055,1512,1494,14,18,"PSOE",725
6,"6090",877,661,642,7,19,"PSOE",281
6,"6084",1100,857,842,4,15,"PSOE",341
6,"6030",172,138,138,0,0,"PSOE",60
6,"6901",2114,1648,1625,28,23,"PSOE",652
6,"6066",1776,1260,1245,2,15,"PSOE",744
6,"6006",4595,3365,3318,27,47,"PSOE",1500
6,"6021",928,668,656,9,12,"PSOE",233
6,"6147",362,285,281,0,4,"PSOE",152
6,"6020",1822,1435,1406,12,29,"PSOE",566
6,"6080",1931,1498,1480,9,18,"PSOE",673
6,"6903",2017,1509,1475,11,34,"PSOE",575
6,"6125",1754,1327,1304,7,23,"PSOE",587
6,"6047",855,664,654,2,10,"PSOE",280
6,"6001",696,526,521,1,5,"PSOE",196
6,"6117",1417,1044,1031,3,13,"PSOE",404
6,"6157",453,316,315,0,1,"PSOE",132
6,"6053",607,459,450,2,9,"PSOE",241
6,"6063",3038,2413,2391,15,22,"PSOE",1217
6,"6072",2334,1813,1792,20,21,"PSOE",741
6,"6153",20417,15129,14934,112,195,"PSOE",5731
6,"6050",4124,3178,3110,30,68,"PSOE",1102
6,"6113",2725,2091,2054,9,37,"PSOE",783
6,"6032",66,54,54,2,0,"PSOE",7
6,"6144",562,450,447,3,3,"PSOE",212
6,"6041",460,378,375,3,3,"PSOE",160
6,"6121",3383,2518,2483,21,35,"PSOE",995
6,"6151",1094,809,801,8,8,"PSOE",409
6,"6051",1573,1235,1222,6,13,"PSOE",585
6,"6114",148,116,116,0,0,"PSOE",79
6,"6150",806,658,650,6,8,"PSOE",265
6,"6154",2798,2001,1975,17,26,"PSOE",927
6,"6100",938,776,763,2,13,"PSOE",327
6,"6028",4253,3716,3631,30,85,"PSOE",1627
6,"6129",591,466,462,3,4,"PSOE",220
6,"6015",116673,82152,81388,677,764,"PSOE",19859
6,"6092",582,402,392,3,10,"PSOE",198
6,"6002",4335,3084,3006,33,78,"PSOE",1051
6,"6083",46111,32608,32276,235,332,"PSOE",10171
6,"6146",1094,848,837,5,11,"PSOE",494
6,"6049",1021,747,733,2,14,"PSOE",307
6,"6034",174,126,125,2,1,"PSOE",43
6,"6155",1890,1337,1315,15,22,"PSOE",573
6,"6160",3154,2324,2292,12,32,"PSOE",1044
6,"6003",830,656,647,6,9,"PSOE",291
6,"6124",1739,1309,1287,15,22,"PSOE",620
6,"6107",1591,1114,1107,4,7,"PSOE",651
6,"6094",1483,1025,1014,6,11,"PSOE",642
6,"6017",274,229,228,1,1,"PSOE",63
6,"6075",477,401,389,2,12,"PSOE",251
6,"6156",1169,903,898,2,5,"PSOE",419
6,"6095",9493,6973,6839,97,134,"PSOE",3015
6,"6111",507,360,359,2,1,"PSOE",202
6,"6128",4445,3137,3116,36,21,"PSOE",1184
6,"6116",1607,1168,1149,10,19,"PSOE",516
6,"6108",2299,1714,1683,13,31,"PSOE",652
6,"6103",4781,3519,3459,40,60,"PSOE",1490
6,"6085",3427,2563,2524,21,39,"PSOE",1055
6,"6099",1148,768,749,5,19,"PSOE",429
6,"6148",973,739,730,5,9,"PSOE",352
6,"6105",631,448,443,0,5,"PSOE",170
6,"6135",1103,904,888,9,16,"PSOE",323
6,"6162",2938,2278,2239,17,39,"PSOE",979
6,"6027",681,586,576,1,10,"PSOE",201
6,"6038",801,558,551,5,7,"PSOE",272
6,"6081",1078,850,839,4,11,"PSOE",396
6,"6071",247,208,203,0,5,"PSOE",114
6,"6069",3079,2164,2137,21,27,"PSOE",1070
6,"6037",1768,1176,1160,5,16,"PSOE",489
6,"6118",206,165,164,1,1,"PSOE",92
6,"6131",1074,887,885,2,2,"PSOE",482
6,"6132",855,634,627,4,7,"PSOE",269
6,"6091",3782,2728,2690,32,38,"PSOE",1131
6,"6079",645,502,488,1,14,"PSOE",249
6,"6120",3393,2635,2600,14,35,"PSOE",1236
6,"6087",2127,1612,1592,16,20,"PSOE",709
6,"6042",1012,711,703,3,8,"PSOE",292
6,"6138",1059,795,773,3,22,"PSOE",415
6,"6065",309,257,247,0,10,"PSOE",100
6,"6123",4644,3420,3357,22,63,"PSOE",1403
6,"6088",12639,8992,8885,68,107,"PSOE",3217
6,"6106",428,295,293,2,2,"PSOE",119
6,"6119",701,519,514,1,5,"PSOE",241
6,"6016",2978,2258,2235,14,23,"PSOE",1103
6,"6142",276,215,207,0,8,"PSOE",132
6,"6012",3280,2358,2343,12,15,"PSOE",1056
6,"6112",393,335,333,0,2,"PSOE",132
6,"6031",466,321,316,2,5,"PSOE",154
6,"6062",612,450,441,4,9,"PSOE",189
6,"6039",1838,1546,1517,9,29,"PSOE",963
6,"6005",1717,1271,1258,10,13,"PSOE",736
6,"6101",466,386,382,0,4,"PSOE",146
6,"6008",634,562,558,1,4,"PSOE",326
6,"6026",837,632,623,2,9,"PSOE",252
6,"6013",265,230,224,1,6,"PSOE",140
6,"6035",957,700,690,4,10,"PSOE",226
6,"6158",13305,9965,9802,91,163,"PSOE",3293
6,"6139",553,442,436,1,6,"PSOE",217
6,"6018",761,543,539,3,4,"PSOE",256
6,"6145",916,717,711,9,6,"PSOE",353
6,"6055",2058,1557,1527,21,30,"PSOE",639
6,"6040",1002,758,754,4,4,"PSOE",444
6,"6140",633,493,482,6,11,"PSOE",152
6,"6122",6651,4654,4553,29,101,"PSOE",1847
6,"6133",1775,1351,1334,9,17,"PSOE",652
6,"6010",1111,877,863,7,14,"PSOE",369
6,"6052",4051,3071,3009,31,62,"PSOE",988
6,"6025",5126,3833,3783,37,50,"PSOE",1750
6,"6137",987,811,805,4,6,"PSOE",387
6,"6043",673,542,535,5,7,"PSOE",198
6,"6102",1055,843,830,3,13,"PSOE",409
6,"6149",10342,8013,7897,70,116,"PSOE",3020
6,"6074",4814,3717,3659,37,58,"PSOE",1313
6,"6902",1672,1239,1224,6,15,"PSOE",512
6,"6029",1213,892,875,8,17,"PSOE",499
6,"6048",848,716,700,0,16,"PSOE",348
6,"6098",545,408,402,1,6,"PSOE",217
6,"6067",1984,1408,1377,9,31,"PSOE",575
6,"6019",2090,1519,1488,11,31,"PSOE",693
6,"6022",2660,2159,2140,12,19,"PSOE",1026
6,"6014",6688,4651,4586,22,65,"PSOE",1462
6,"6076",837,632,624,2,8,"PSOE",247
6,"6011",24721,17683,17506,172,177,"PSOE",4897
6,"6130",195,174,170,0,4,"PSOE",91
50,"50261",215,159,159,1,0,"PSOE",65
50,"50206",466,379,376,2,3,"PSOE",79
50,"50164",395,263,260,2,3,"PSOE",56
50,"50286",77,54,54,0,0,"PSOE",15
50,"50094",1626,1197,1178,22,19,"PSOE",321
50,"50075",81,59,59,1,0,"PSOE",10
50,"50024",589,461,459,4,2,"PSOE",205
50,"50150",660,402,402,3,0,"PSOE",111
50,"50236",104,82,82,2,0,"PSOE",27
50,"50160",2245,1661,1648,10,13,"PSOE",625
50,"50120",49,36,36,3,0,"PSOE",11
50,"50191",476,327,325,3,2,"PSOE",93
50,"50271",256,187,184,4,3,"PSOE",51
50,"50227",108,79,79,1,0,"PSOE",17
50,"50234",245,198,193,9,5,"PSOE",29
50,"50288",3371,2566,2547,26,19,"PSOE",439
50,"50085",176,131,129,3,2,"PSOE",35
50,"50128",28,24,24,0,0,"PSOE",6
50,"50122",68,54,54,2,0,"PSOE",8
50,"50106",135,105,104,0,1,"PSOE",36
50,"50063",61,57,57,0,0,"PSOE",33
50,"50083",90,72,72,1,0,"PSOE",21
50,"50037",139,92,91,1,1,"PSOE",23
50,"50028",78,53,53,2,0,"PSOE",15
50,"50266",129,85,85,1,0,"PSOE",27
50,"50067",14055,10236,10109,123,127,"PSOE",2401
50,"50089",8144,6285,6249,50,36,"PSOE",857
50,"50068",1998,1388,1378,17,10,"PSOE",486
50,"50244",205,157,157,3,0,"PSOE",37
50,"50221",33,20,20,0,0,"PSOE",7
50,"50283",72,55,54,0,1,"PSOE",13
50,"50179",257,207,207,2,0,"PSOE",74
50,"50193",647,514,506,1,8,"PSOE",91
50,"50105",304,228,228,3,0,"PSOE",68
50,"50013",224,187,186,3,1,"PSOE",75
50,"50047",50,32,32,1,0,"PSOE",12
50,"50202",158,96,92,1,4,"PSOE",35
50,"50136",579,420,413,0,7,"PSOE",87
50,"50058",72,51,51,0,0,"PSOE",10
50,"50044",232,156,156,1,0,"PSOE",56
50,"50019",54,41,41,0,0,"PSOE",14
50,"50065",53,42,42,0,0,"PSOE",8
50,"50213",98,77,72,0,5,"PSOE",10
50,"50137",1025,793,786,6,7,"PSOE",268
50,"50022",543,410,398,8,12,"PSOE",115
50,"50232",171,120,118,0,2,"PSOE",27
50,"50045",1255,944,934,6,10,"PSOE",264
50,"50092",298,256,251,3,5,"PSOE",84
50,"50231",260,213,210,7,3,"PSOE",65
50,"50169",362,264,262,0,2,"PSOE",76
50,"50031",161,90,88,1,2,"PSOE",31
50,"50199",341,242,241,4,1,"PSOE",81
50,"50072",174,124,122,2,2,"PSOE",26
50,"50901",137,101,101,0,0,"PSOE",23
50,"50214",27,16,16,1,0,"PSOE",2
50,"50163",3655,2766,2740,34,26,"PSOE",383
50,"50293",423,282,280,5,2,"PSOE",102
50,"50004",534,406,401,0,5,"PSOE",142
50,"50285",648,473,469,3,4,"PSOE",118
50,"50257",178,139,137,0,2,"PSOE",44
50,"50180",120,97,96,0,1,"PSOE",22
50,"50005",234,178,178,1,0,"PSOE",38
50,"50211",252,187,186,0,1,"PSOE",52
50,"50073",2148,1649,1622,9,27,"PSOE",431
50,"50025",4547,3335,3295,45,40,"PSOE",835
50,"50084",79,56,56,1,0,"PSOE",17
50,"50256",84,46,46,0,0,"PSOE",5
50,"50219",4098,3010,2980,27,30,"PSOE",545
50,"50078",244,192,189,1,3,"PSOE",74
50,"50111",186,152,151,1,1,"PSOE",28
50,"50032",273,190,189,0,1,"PSOE",48
50,"50262",1187,931,930,13,1,"PSOE",321
50,"50241",593,426,418,1,8,"PSOE",117
50,"50185",132,110,110,1,0,"PSOE",16
50,"50277",55,43,43,1,0,"PSOE",4
50,"50033",75,65,65,0,0,"PSOE",11
50,"50036",103,79,79,0,0,"PSOE",26
50,"50172",196,138,136,0,2,"PSOE",30
50,"50040",92,75,75,0,0,"PSOE",27
50,"50017",1772,1301,1293,7,8,"PSOE",244
50,"50188",30,23,19,0,4,"PSOE",3
50,"50289",52,39,39,1,0,"PSOE",12
50,"50144",36,28,28,0,0,"PSOE",7
50,"50182",3352,2437,2409,26,28,"PSOE",317
50,"50095",12366,8938,8856,94,82,"PSOE",3344
50,"50053",688,535,522,6,13,"PSOE",217
50,"50223",915,747,741,8,6,"PSOE",348
50,"50014",146,99,99,1,0,"PSOE",23
50,"50108",47,37,37,0,0,"PSOE",10
50,"50055",3612,2533,2490,34,43,"PSOE",587
50,"50119",930,698,691,7,7,"PSOE",221
50,"50126",2388,1726,1708,22,18,"PSOE",460
50,"50156",214,173,170,2,3,"PSOE",60
50,"50130",395,252,252,1,0,"PSOE",78
50,"50034",838,572,569,5,3,"PSOE",185
50,"50264",158,111,111,0,0,"PSOE",50
50,"50173",210,141,140,2,1,"PSOE",27
50,"50201",443,335,330,2,5,"PSOE",112
50,"50281",80,57,56,0,1,"PSOE",5
50,"50276",129,108,107,0,1,"PSOE",32
50,"50109",105,78,77,3,1,"PSOE",8
50,"50239",64,47,47,1,0,"PSOE",7
50,"50225",1568,996,985,2,11,"PSOE",271
50,"50087",28,19,19,0,0,"PSOE",3
50,"50012",108,86,83,1,3,"PSOE",26
50,"50060",176,138,136,0,2,"PSOE",27
50,"50174",92,70,70,0,0,"PSOE",17
50,"50001",115,81,80,0,1,"PSOE",11
50,"50250",55,44,44,0,0,"PSOE",10
50,"50081",512,376,372,6,4,"PSOE",119
50,"50252",5178,3746,3711,36,35,"PSOE",931
50,"50253",423,328,327,1,1,"PSOE",85
50,"50129",245,164,164,1,0,"PSOE",50
50,"50165",1815,1333,1316,27,17,"PSOE",391
50,"50195",53,38,38,0,0,"PSOE",8
50,"50294",73,58,58,0,0,"PSOE",16
50,"50209",2560,1787,1774,12,13,"PSOE",389
50,"50082",89,58,57,0,1,"PSOE",16
50,"50216",236,189,186,4,3,"PSOE",47
50,"50168",28,23,23,0,0,"PSOE",5
50,"50278",198,145,144,1,1,"PSOE",40
50,"50088",305,234,229,11,5,"PSOE",84
50,"50166",260,192,189,2,3,"PSOE",45
50,"50237",103,73,73,2,0,"PSOE",12
50,"50143",569,414,411,4,3,"PSOE",95
50,"50100",333,263,261,5,2,"PSOE",94
50,"50007",46,37,37,1,0,"PSOE",5
50,"50079",254,186,184,3,2,"PSOE",53
50,"50268",47,40,39,0,1,"PSOE",5
50,"50902",87,78,78,1,0,"PSOE",18
50,"50076",81,64,64,0,0,"PSOE",22
50,"50197",92,71,71,2,0,"PSOE",15
50,"50115",3248,2277,2262,31,15,"PSOE",697
50,"50248",521,407,406,1,1,"PSOE",125
50,"50238",97,74,73,0,1,"PSOE",13
50,"50066",2613,1956,1951,21,5,"PSOE",265
50,"50098",181,129,127,2,2,"PSOE",46
50,"50146",190,137,137,5,0,"PSOE",54
50,"50008",5085,3617,3574,30,43,"PSOE",978
50,"50015",98,63,63,0,0,"PSOE",33
50,"50269",288,185,183,0,2,"PSOE",46
50,"50050",98,59,59,3,0,"PSOE",26
50,"50132",755,573,564,7,9,"PSOE",103
50,"50117",125,91,90,1,1,"PSOE",18
50,"50270",38,24,24,2,0,"PSOE",6
50,"50290",387,288,287,4,1,"PSOE",97
50,"50009",106,78,77,1,1,"PSOE",9
50,"50110",369,258,257,0,1,"PSOE",94
50,"50192",236,185,183,2,2,"PSOE",64
50,"50124",417,312,312,9,0,"PSOE",57
50,"50061",207,174,168,1,6,"PSOE",66
50,"50175",1025,745,739,6,6,"PSOE",248
50,"50114",124,94,94,2,0,"PSOE",31
50,"50139",319,239,238,2,1,"PSOE",68
50,"50121",276,227,225,4,2,"PSOE",81
50,"50133",117,88,88,3,0,"PSOE",32
50,"50051",828,640,637,8,3,"PSOE",300
50,"50118",2179,1575,1564,7,11,"PSOE",592
50,"50003",126,93,92,3,1,"PSOE",30
50,"50254",181,130,129,2,1,"PSOE",40
50,"50291",100,69,69,0,0,"PSOE",17
50,"50140",165,106,106,0,0,"PSOE",22
50,"50148",324,240,236,0,4,"PSOE",82
50,"50104",351,283,282,3,1,"PSOE",100
50,"50041",12,10,10,0,0,"PSOE",5
50,"50010",69,57,57,0,0,"PSOE",2
50,"50190",708,542,539,3,3,"PSOE",203
50,"50258",56,34,34,1,0,"PSOE",8
50,"50038",1511,1167,1159,13,8,"PSOE",429
50,"50204",2457,1830,1816,14,14,"PSOE",817
50,"50018",948,717,712,6,5,"PSOE",314
50,"50116",190,142,140,1,2,"PSOE",36
50,"50272",12913,9500,9415,80,85,"PSOE",2017
50,"50159",670,511,501,5,10,"PSOE",171
50,"50042",16,13,13,0,0,"PSOE",3
50,"50200",509,406,404,6,2,"PSOE",178
50,"50086",184,128,128,1,0,"PSOE",55
50,"50177",315,251,249,3,2,"PSOE",71
50,"50235",2323,1687,1675,7,12,"PSOE",353
50,"50184",113,82,82,0,0,"PSOE",18
50,"50135",95,63,63,0,0,"PSOE",23
50,"50279",87,62,62,1,0,"PSOE",40
50,"50171",108,70,69,0,1,"PSOE",19
50,"50218",113,90,89,1,1,"PSOE",19
50,"50222",1647,1135,1118,8,17,"PSOE",428
50,"50178",302,197,196,9,1,"PSOE",52
50,"50091",48,32,32,1,0,"PSOE",6
50,"50181",1003,750,737,9,13,"PSOE",189
50,"50161",117,76,76,0,0,"PSOE",13
50,"50215",23,15,15,0,0,"PSOE",2
50,"50240",1034,749,737,10,12,"PSOE",242
50,"50212",41,37,37,0,0,"PSOE",13
50,"50267",605,424,420,4,4,"PSOE",150
50,"50102",863,665,654,6,11,"PSOE",209
50,"50287",274,197,195,4,2,"PSOE",51
50,"50147",788,577,576,4,1,"PSOE",212
50,"50054",59,45,45,0,0,"PSOE",13
50,"50247",827,624,615,10,9,"PSOE",118
50,"50023",223,175,173,3,2,"PSOE",39
50,"50194",84,52,52,0,0,"PSOE",12
50,"50162",147,110,110,2,0,"PSOE",44
50,"50292",132,103,103,0,0,"PSOE",20
50,"50176",228,158,157,0,1,"PSOE",53
50,"50220",46,32,32,0,0,"PSOE",12
50,"50151",650,504,503,7,1,"PSOE",180
50,"50265",62,41,41,0,0,"PSOE",6
50,"50183",338,255,255,0,0,"PSOE",67
50,"50282",70,48,48,0,0,"PSOE",6
50,"50228",270,211,210,5,1,"PSOE",39
50,"50141",114,85,84,0,1,"PSOE",12
50,"50203",1043,811,802,15,9,"PSOE",177
50,"50260",35,32,32,0,0,"PSOE",4
50,"50153",941,737,734,7,3,"PSOE",306
50,"50056",406,325,324,2,1,"PSOE",64
50,"50167",232,194,193,0,1,"PSOE",40
50,"50134",128,88,88,5,0,"PSOE",21
50,"50090",156,112,111,0,1,"PSOE",15
50,"50123",465,349,344,2,5,"PSOE",150
50,"50217",455,334,334,1,0,"PSOE",145
50,"50187",70,38,38,0,0,"PSOE",6
50,"50039",507,400,398,3,2,"PSOE",116
50,"50273",31,18,18,0,0,"PSOE",5
50,"50057",1396,980,972,8,8,"PSOE",248
50,"50259",89,61,61,1,0,"PSOE",12
50,"50246",41,29,29,0,0,"PSOE",6
50,"50295",45,39,39,0,0,"PSOE",12
50,"50263",197,123,121,6,2,"PSOE",44
50,"50280",340,260,258,0,2,"PSOE",82
50,"50020",822,560,555,5,5,"PSOE",145
50,"50006",939,712,701,8,11,"PSOE",226
50,"50157",301,211,207,2,4,"PSOE",76
50,"50043",257,172,171,1,1,"PSOE",51
50,"50099",3087,2233,2216,15,17,"PSOE",823
50,"50107",944,772,767,16,5,"PSOE",209
50,"50154",119,92,91,0,1,"PSOE",8
50,"50030",225,156,156,2,0,"PSOE",32
50,"50208",1802,1349,1332,16,17,"PSOE",424
50,"50113",618,506,496,4,10,"PSOE",223
50,"50233",114,81,81,1,0,"PSOE",15
50,"50131",237,168,167,2,1,"PSOE",46
50,"50210",40,32,31,0,1,"PSOE",10
50,"50170",378,286,283,2,3,"PSOE",116
50,"50196",108,83,82,1,1,"PSOE",44
50,"50096",39,17,17,0,0,"PSOE",4
50,"50027",227,177,176,1,1,"PSOE",63
50,"50046",176,123,123,7,0,"PSOE",19
50,"50070",60,29,29,1,0,"PSOE",17
50,"50296",398,297,293,2,4,"PSOE",106
50,"50059",780,572,567,6,5,"PSOE",168
50,"50125",371,260,258,3,2,"PSOE",80
50,"50243",340,259,254,1,5,"PSOE",83
50,"50052",90,71,71,0,0,"PSOE",12
50,"50298",5353,4051,4013,32,38,"PSOE",1108
50,"50249",312,235,233,1,2,"PSOE",28
50,"50074",6397,4512,4408,38,104,"PSOE",1277
50,"50011",127,96,96,2,0,"PSOE",46
50,"50245",90,60,60,1,0,"PSOE",16
50,"50152",1457,1032,1018,11,14,"PSOE",298
50,"50080",32,25,25,0,0,"PSOE",3
50,"50029",627,469,468,4,1,"PSOE",239
50,"50002",148,105,102,0,3,"PSOE",26
50,"50071",131,90,90,0,0,"PSOE",10
50,"50255",214,163,163,0,0,"PSOE",119
50,"50242",92,81,79,1,2,"PSOE",19
50,"50077",226,175,174,5,1,"PSOE",72
50,"50048",35,23,23,0,0,"PSOE",3
50,"50155",102,78,78,0,0,"PSOE",20
50,"50149",36,23,23,0,0,"PSOE",3
50,"50021",32,25,25,3,0,"PSOE",0
50,"50016",52,37,37,0,0,"PSOE",11
50,"50064",440,350,349,5,1,"PSOE",145
50,"50284",151,115,113,0,2,"PSOE",45
50,"50297",499531,377882,375565,3049,2317,"PSOE",76042
50,"50274",71,50,49,1,1,"PSOE",11
50,"50903",2225,1686,1669,21,17,"PSOE",303
50,"50275",110,73,72,0,1,"PSOE",14
50,"50142",30,21,21,0,0,"PSOE",5
50,"50138",46,41,41,0,0,"PSOE",5
50,"50062",1810,1407,1389,12,18,"PSOE",337
50,"50230",1176,853,849,11,4,"PSOE",281
50,"50189",712,574,559,4,15,"PSOE",146
50,"50101",879,615,609,5,6,"PSOE",220
50,"50207",109,88,88,1,0,"PSOE",24
50,"50069",76,53,52,0,1,"PSOE",14
50,"50205",91,69,65,1,4,"PSOE",26
50,"50229",64,42,42,0,0,"PSOE",7
50,"50251",8300,6228,6167,62,61,"PSOE",1335
50,"50186",41,29,29,0,0,"PSOE",10
50,"50035",74,53,52,0,1,"PSOE",1
50,"50198",56,30,30,0,0,"PSOE",10
50,"50093",94,73,73,1,0,"PSOE",17
50,"50224",69,55,55,1,0,"PSOE",6
50,"50026",442,358,353,6,5,"PSOE",114
45,"45038",3335,2525,2490,8,35,"PACMA",36
45,"45100",197,166,164,2,2,"PACMA",0
45,"45199",2963,2055,2027,5,28,"PACMA",41
45,"45150",454,366,364,1,2,"PACMA",0
45,"45112",1939,1302,1268,6,34,"PACMA",2
45,"45059",1723,1413,1388,4,25,"PACMA",7
45,"45006",1425,1022,1013,4,9,"PACMA",4
45,"45198",1832,1521,1508,6,13,"PACMA",9
45,"45045",1316,945,935,1,10,"PACMA",10
45,"45067",2324,1871,1841,13,30,"PACMA",6
45,"45130",319,258,252,1,6,"PACMA",1
45,"45194",67,50,49,0,1,"PACMA",0
45,"45087",8345,6184,6091,34,93,"PACMA",33
45,"45160",1111,908,895,6,13,"PACMA",3
45,"45124",2156,1750,1712,16,38,"PACMA",18
45,"45146",108,85,85,0,0,"PACMA",0
45,"45064",3839,2915,2884,19,31,"PACMA",25
45,"45108",521,415,414,2,1,"PACMA",2
45,"45089",1516,1157,1139,6,18,"PACMA",2
45,"45079",367,285,285,3,0,"PACMA",2
45,"45158",2534,1885,1868,8,17,"PACMA",12
45,"45034",1360,1098,1083,4,15,"PACMA",5
45,"45051",1594,1264,1248,6,16,"PACMA",5
45,"45144",794,643,640,2,3,"PACMA",5
45,"45136",5859,4249,4177,24,72,"PACMA",15
45,"45202",3905,2962,2920,12,42,"PACMA",13
45,"45125",2329,1920,1898,10,22,"PACMA",12
45,"45173",9477,7145,7061,40,84,"PACMA",54
45,"45186",3083,2369,2341,14,28,"PACMA",10
45,"45120",134,105,105,1,0,"PACMA",0
45,"45170",235,183,176,4,7,"PACMA",2
45,"45081",17646,13309,13166,72,143,"PACMA",164
45,"45004",568,436,430,1,6,"PACMA",4
45,"45083",465,393,388,5,5,"PACMA",7
45,"45030",482,364,361,4,3,"PACMA",0
45,"45071",1863,1550,1530,8,20,"PACMA",5
45,"45047",2563,1775,1751,13,24,"PACMA",24
45,"45133",2818,2184,2146,19,38,"PACMA",9
45,"45085",1501,1086,1067,6,19,"PACMA",10
45,"45009",545,336,333,1,3,"PACMA",1
45,"45023",2160,1669,1654,9,15,"PACMA",14
45,"45187",4078,3405,3353,14,52,"PACMA",14
45,"45179",546,406,403,3,3,"PACMA",1
45,"45061",2457,1718,1699,7,19,"PACMA",13
45,"45024",1075,828,824,5,4,"PACMA",1
45,"45201",3450,2212,2173,14,39,"PACMA",30
45,"45053",8045,6446,6370,44,76,"PACMA",32
45,"45069",1876,1446,1428,8,18,"PACMA",9
45,"45205",6745,4708,4657,35,51,"PACMA",57
45,"45140",1093,885,876,4,9,"PACMA",2
45,"45029",205,169,169,0,0,"PACMA",0
45,"45128",2498,1794,1774,7,20,"PACMA",13
45,"45174",309,247,247,1,0,"PACMA",0
45,"45026",225,171,169,1,2,"PACMA",0
45,"45072",670,499,499,2,0,"PACMA",5
45,"45048",360,281,277,1,4,"PACMA",0
45,"45139",172,135,133,0,2,"PACMA",1
45,"45177",2142,1757,1731,11,26,"PACMA",5
45,"45183",2253,1581,1569,8,12,"PACMA",36
45,"45103",397,325,322,0,3,"PACMA",0
45,"45191",549,477,475,0,2,"PACMA",1
45,"45203",2574,1938,1908,10,30,"PACMA",29
45,"45005",241,207,205,2,2,"PACMA",2
45,"45017",262,221,219,0,2,"PACMA",5
45,"45015",622,461,455,2,6,"PACMA",13
45,"45168",62226,48889,48446,327,443,"PACMA",382
45,"45084",2280,1777,1747,12,30,"PACMA",2
45,"45027",362,275,270,0,5,"PACMA",0
45,"45137",1623,1106,1093,9,13,"PACMA",4
45,"45162",683,515,510,0,5,"PACMA",4
45,"45057",221,187,182,0,5,"PACMA",1
45,"45025",1198,921,910,2,11,"PACMA",9
45,"45032",436,317,313,0,4,"PACMA",1
45,"45159",86,75,72,1,3,"PACMA",0
45,"45049",435,330,326,0,4,"PACMA",3
45,"45008",142,114,114,2,0,"PACMA",0
45,"45156",3441,2863,2825,13,38,"PACMA",8
45,"45148",307,229,219,1,10,"PACMA",0
45,"45035",298,225,221,2,4,"PACMA",0
45,"45042",190,145,145,0,0,"PACMA",0
45,"45050",471,354,351,2,3,"PACMA",4
45,"45127",708,524,519,1,5,"PACMA",4
45,"45078",1392,1187,1179,8,8,"PACMA",14
45,"45065",276,227,223,0,4,"PACMA",0
45,"45018",495,352,348,0,4,"PACMA",3
45,"45099",3512,2514,2459,9,55,"PACMA",27
45,"45182",1045,854,844,3,10,"PACMA",1
45,"45075",146,108,105,0,3,"PACMA",2
45,"45172",719,559,556,2,3,"PACMA",0
45,"45153",1613,1263,1248,11,15,"PACMA",4
45,"45063",428,320,310,2,10,"PACMA",0
45,"45098",2186,1686,1649,10,37,"PACMA",5
45,"45052",2914,2389,2372,23,17,"PACMA",26
45,"45031",2723,1935,1896,10,39,"PACMA",24
45,"45157",2125,1531,1509,14,22,"PACMA",15
45,"45163",8338,6270,6142,57,128,"PACMA",34
45,"45188",2783,2161,2127,9,34,"PACMA",32
45,"45109",2913,2295,2218,16,77,"PACMA",14
45,"45011",288,246,241,1,5,"PACMA",0
45,"45036",658,500,496,2,4,"PACMA",0
45,"45093",151,117,117,0,0,"PACMA",0
45,"45056",2210,1384,1370,11,14,"PACMA",17
45,"45077",542,428,423,0,5,"PACMA",3
45,"45082",1246,1046,1036,9,10,"PACMA",1
45,"45164",186,160,160,0,0,"PACMA",0
45,"45147",581,475,469,4,6,"PACMA",10
45,"45122",5164,4112,4067,18,45,"PACMA",32
45,"45012",670,521,506,4,15,"PACMA",3
45,"45076",574,382,378,1,4,"PACMA",2
45,"45041",3725,2698,2665,18,33,"PACMA",30
45,"45151",586,444,437,1,7,"PACMA",0
45,"45175",665,541,532,5,9,"PACMA",1
45,"45189",597,467,458,2,9,"PACMA",14
45,"45193",626,543,530,2,13,"PACMA",2
45,"45101",3761,3090,3048,15,42,"PACMA",8
45,"45058",384,304,301,4,3,"PACMA",1
45,"45185",7734,6057,5973,27,84,"PACMA",27
45,"45092",233,197,194,0,3,"PACMA",0
45,"45007",697,566,560,1,6,"PACMA",9
45,"45165",62857,46607,46141,313,466,"PACMA",437
45,"45060",179,131,129,1,2,"PACMA",0
45,"45126",260,169,167,1,2,"PACMA",1
45,"45040",1396,871,862,4,9,"PACMA",0
45,"45003",572,431,423,1,8,"PACMA",0
45,"45113",1948,1409,1386,14,23,"PACMA",4
45,"45116",694,531,523,2,8,"PACMA",2
45,"45152",597,476,476,2,0,"PACMA",3
45,"45066",7589,5716,5637,30,79,"PACMA",39
45,"45022",392,297,293,8,4,"PACMA",1
45,"45149",573,486,484,0,2,"PACMA",3
45,"45001",1852,1395,1355,9,40,"PACMA",3
45,"45094",395,312,308,0,4,"PACMA",2
45,"45154",1483,1114,1107,5,7,"PACMA",13
45,"45106",7524,5882,5784,55,98,"PACMA",32
45,"45002",2549,1810,1784,7,26,"PACMA",11
45,"45190",483,397,387,2,10,"PACMA",4
45,"45037",1635,1216,1202,4,14,"PACMA",5
45,"45054",3995,2997,2968,8,29,"PACMA",14
45,"45121",6766,4860,4798,30,62,"PACMA",39
45,"45195",2161,1709,1686,12,23,"PACMA",7
45,"45111",60,47,47,0,0,"PACMA",1
45,"45097",1047,877,869,3,8,"PACMA",0
45,"45134",1600,1214,1200,4,14,"PACMA",4
45,"45181",2313,1755,1728,12,27,"PACMA",7
45,"45141",897,735,727,4,8,"PACMA",4
45,"45117",754,610,602,2,8,"PACMA",1
45,"45010",436,335,333,2,2,"PACMA",1
45,"45142",7858,6249,6164,57,85,"PACMA",42
45,"45171",1382,1090,1075,4,15,"PACMA",6
45,"45074",412,327,322,0,5,"PACMA",1
45,"45115",2563,2089,2048,5,41,"PACMA",8
45,"45095",697,529,520,1,9,"PACMA",3
45,"45013",1786,1428,1412,7,16,"PACMA",5
45,"45091",407,301,299,2,2,"PACMA",1
45,"45021",2459,1862,1833,21,29,"PACMA",22
45,"45070",1461,1223,1202,7,21,"PACMA",13
45,"45132",2096,1631,1616,7,15,"PACMA",3
45,"45033",351,253,247,3,6,"PACMA",1
45,"45196",1388,1066,1054,13,12,"PACMA",2
45,"45161",13474,9618,9496,63,122,"PACMA",173
45,"45901",769,577,571,1,6,"PACMA",9
45,"45096",1015,832,817,7,15,"PACMA",6
45,"45105",405,284,279,3,5,"PACMA",2
45,"45138",1110,903,887,6,16,"PACMA",10
45,"45019",7356,5539,5484,35,55,"PACMA",45
45,"45104",440,345,341,1,4,"PACMA",3
45,"45169",193,136,136,1,0,"PACMA",4
45,"45068",173,138,135,0,3,"PACMA",2
45,"45055",1032,857,841,2,16,"PACMA",4
45,"45166",1629,1345,1332,5,13,"PACMA",2
45,"45073",307,238,235,0,3,"PACMA",0
45,"45088",2102,1438,1423,4,15,"PACMA",22
45,"45192",2503,2164,2141,7,23,"PACMA",4
45,"45090",376,299,295,4,4,"PACMA",0
45,"45039",226,197,193,1,4,"PACMA",1
45,"45107",3238,2628,2597,15,31,"PACMA",20
45,"45046",2421,1815,1796,8,19,"PACMA",6
45,"45043",793,663,655,1,8,"PACMA",2
45,"45184",201,124,123,1,1,"PACMA",4
45,"45080",6,6,6,0,0,"PACMA",0
45,"45118",2002,1470,1456,3,14,"PACMA",24
45,"45086",503,375,369,3,6,"PACMA",2
45,"45102",3629,2685,2644,15,41,"PACMA",16
45,"45197",1921,1500,1480,12,20,"PACMA",2
45,"45114",595,461,457,1,4,"PACMA",1
45,"45145",2539,1830,1811,11,19,"PACMA",26
45,"45204",643,519,513,0,6,"PACMA",5
45,"45014",3984,2824,2802,24,22,"PACMA",19
45,"45167",1458,1197,1187,5,10,"PACMA",6
45,"45200",4627,3678,3588,29,90,"PACMA",17
45,"45062",1121,910,894,10,16,"PACMA",4
45,"45016",4179,3290,3268,30,22,"PACMA",47
45,"45110",1799,1394,1380,4,14,"PACMA",1
45,"45131",287,242,242,0,0,"PACMA",0
45,"45180",2725,2060,2028,7,32,"PACMA",9
45,"45176",3665,2747,2712,15,35,"PACMA",45
45,"45129",136,100,97,0,3,"PACMA",0
45,"45135",4302,3509,3453,21,56,"PACMA",18
45,"45155",371,297,296,1,1,"PACMA",1
45,"45028",3680,2919,2880,23,39,"PACMA",24
45,"45123",3075,2261,2222,11,39,"PACMA",27
45,"45020",1313,1062,1046,5,16,"PACMA",5
45,"45143",1180,924,912,3,12,"PACMA",4
45,"45119",3348,2306,2264,14,42,"PACMA",38
2,"2069",11544,8969,8824,62,145,"PSOE",2011
2,"2071",1056,890,884,7,6,"PSOE",334
2,"2002",494,406,397,0,9,"PSOE",149
2,"2081",18334,14121,13932,116,189,"PSOE",4124
2,"2008",1227,923,909,9,14,"PSOE",355
2,"2018",832,670,663,5,7,"PSOE",236
2,"2068",343,265,262,2,3,"PSOE",111
2,"2057",2043,1593,1568,24,25,"PSOE",691
2,"2017",845,611,607,1,4,"PSOE",270
2,"2006",588,482,476,2,6,"PSOE",178
2,"2041",350,274,272,1,2,"PSOE",63
2,"2056",1729,1348,1323,10,25,"PSOE",529
2,"2015",1444,1196,1179,7,17,"PSOE",474
2,"2072",1560,1118,1098,4,20,"PSOE",450
2,"2021",1037,823,816,3,7,"PSOE",244
2,"2014",368,300,295,1,5,"PSOE",121
2,"2047",120,91,90,0,1,"PSOE",20
2,"2035",1989,1607,1582,13,25,"PSOE",561
2,"2064",379,317,316,1,1,"PSOE",142
2,"2067",1189,909,896,4,13,"PSOE",340
2,"2059",317,242,241,0,1,"PSOE",124
2,"2034",1395,1131,1126,10,5,"PSOE",381
2,"2038",284,230,230,1,0,"PSOE",66
2,"2007",1050,824,811,7,13,"PSOE",399
2,"2043",1250,1020,1006,8,14,"PSOE",416
2,"2005",568,441,434,4,7,"PSOE",132
2,"2022",368,279,278,0,1,"PSOE",70
2,"2051",1690,1227,1211,12,16,"PSOE",304
2,"2049",838,610,607,3,3,"PSOE",304
2,"2011",643,517,515,0,2,"PSOE",248
2,"2058",348,244,239,2,5,"PSOE",124
2,"2040",586,507,505,1,2,"PSOE",189
2,"2083",217,194,194,0,0,"PSOE",86
2,"2065",475,403,402,2,1,"PSOE",138
2,"2036",96,72,72,1,0,"PSOE",22
2,"2029",3306,2563,2533,17,30,"PSOE",715
2,"2045",3706,3046,3009,17,37,"PSOE",791
2,"2062",414,324,319,0,5,"PSOE",135
2,"2061",641,534,530,7,4,"PSOE",177
2,"2078",922,698,691,6,7,"PSOE",221
2,"2075",1684,1406,1397,10,9,"PSOE",512
2,"2077",55,41,41,0,0,"PSOE",10
2,"2023",576,479,468,2,11,"PSOE",154
2,"2012",1833,1595,1575,17,20,"PSOE",791
2,"2037",22886,15400,15266,111,134,"PSOE",4801
2,"2027",310,251,251,0,0,"PSOE",85
2,"2079",2887,2312,2285,24,27,"PSOE",620
2,"2001",660,521,510,4,11,"PSOE",179
2,"2048",1251,1013,1004,9,9,"PSOE",343
2,"2046",1135,936,917,15,19,"PSOE",313
2,"2024",3416,2694,2666,33,28,"PSOE",821
2,"2074",5998,4415,4363,20,52,"PSOE",1569
2,"2050",103,87,87,0,0,"PSOE",22
2,"2070",411,337,330,1,7,"PSOE",228
2,"2060",1302,1007,1003,8,4,"PSOE",266
2,"2080",532,419,410,0,9,"PSOE",167
2,"2032",281,217,216,1,1,"PSOE",87
2,"2042",850,698,693,2,5,"PSOE",299
2,"2003",131959,101091,100433,730,658,"PSOE",22306
2,"2010",1798,1491,1463,10,28,"PSOE",530
2,"2039",1002,824,819,8,5,"PSOE",313
2,"2054",390,305,302,3,3,"PSOE",87
2,"2030",3059,2405,2377,11,28,"PSOE",1070
2,"2026",847,705,697,7,8,"PSOE",298
2,"2019",2412,1991,1959,13,32,"PSOE",884
2,"2025",7502,5918,5785,41,133,"PSOE",1206
2,"2082",105,88,88,1,0,"PSOE",30
2,"2031",574,447,440,1,7,"PSOE",186
2,"2066",238,206,205,1,1,"PSOE",91
2,"2076",334,269,268,3,1,"PSOE",122
2,"2009",19686,14909,14719,148,190,"PSOE",4116
2,"2013",132,105,104,0,1,"PSOE",22
2,"2020",451,381,376,3,5,"PSOE",158
2,"2901",2202,1571,1563,16,8,"PSOE",613
2,"2063",1471,1161,1156,6,5,"PSOE",534
2,"2028",132,103,102,0,1,"PSOE",63
2,"2073",4914,3777,3730,42,47,"PSOE",1190
2,"2033",1920,1551,1518,6,33,"PSOE",462
2,"2016",581,445,441,0,4,"PSOE",168
2,"2004",621,504,500,5,4,"PSOE",191
2,"2085",321,268,266,4,2,"PSOE",108
2,"2052",473,399,398,3,1,"PSOE",154
2,"2086",2603,1797,1783,8,14,"PSOE",769
2,"2053",2996,2370,2332,15,38,"PSOE",940
2,"2084",325,228,221,2,7,"PSOE",91
2,"2044",1128,806,798,2,8,"PSOE",342
2,"2055",1157,757,753,9,4,"PSOE",320
26,"26021",2819,2113,2077,23,36,"PSOE",525
26,"26045",12,12,12,0,0,"PSOE",7
26,"26039",38,35,35,0,0,"PSOE",9
26,"26068",82,68,66,0,2,"PSOE",19
26,"26089",110513,85146,84302,712,844,"PSOE",17783
26,"26087",208,157,154,4,3,"PSOE",27
26,"26132",111,88,88,1,0,"PSOE",27
26,"26177",309,266,264,2,2,"PSOE",74
26,"26056",425,357,353,6,4,"PSOE",121
26,"26049",174,127,121,0,6,"PSOE",9
26,"26147",30,26,26,0,0,"PSOE",9
26,"26096",244,199,197,3,2,"PSOE",38
26,"26102",6128,4673,4585,42,88,"PSOE",1232
26,"26173",6,6,6,1,0,"PSOE",2
26,"26105",2187,1722,1696,16,26,"PSOE",529
26,"26003",416,336,330,2,6,"PSOE",84
26,"26041",134,97,94,1,3,"PSOE",21
26,"26101",46,34,34,0,0,"PSOE",10
26,"26018",10469,8216,8110,71,106,"PSOE",2509
26,"26124",824,664,659,8,5,"PSOE",226
26,"26123",130,111,108,0,3,"PSOE",24
26,"26149",61,48,48,0,0,"PSOE",15
26,"26006",1809,1420,1410,14,10,"PSOE",448
26,"26025",85,71,71,1,0,"PSOE",24
26,"26092",108,83,82,0,1,"PSOE",20
26,"26061",1548,1179,1160,14,19,"PSOE",276
26,"26108",268,207,205,5,2,"PSOE",44
26,"26098",94,72,71,1,1,"PSOE",8
26,"26073",98,83,83,0,0,"PSOE",21
26,"26093",57,44,44,0,0,"PSOE",16
26,"26007",523,406,401,2,5,"PSOE",98
26,"26111",248,195,192,1,3,"PSOE",61
26,"26120",1457,1144,1133,9,11,"PSOE",315
26,"26181",15,13,13,0,0,"PSOE",1
26,"26146",101,78,77,0,1,"PSOE",23
26,"26118",61,49,49,1,0,"PSOE",7
26,"26036",16990,12136,11984,98,152,"PSOE",2701
26,"26100",52,43,43,0,0,"PSOE",18
26,"26075",334,268,264,2,4,"PSOE",104
26,"26076",128,111,110,2,1,"PSOE",32
26,"26081",16,14,14,0,0,"PSOE",2
26,"26080",475,392,388,6,4,"PSOE",86
26,"26072",289,259,258,2,1,"PSOE",89
26,"26020",483,356,344,2,12,"PSOE",89
26,"26148",171,147,145,0,2,"PSOE",44
26,"26170",448,346,344,8,2,"PSOE",79
26,"26126",31,29,29,0,0,"PSOE",5
26,"26144",194,150,148,2,2,"PSOE",21
26,"26164",61,41,41,0,0,"PSOE",11
26,"26179",42,34,33,0,1,"PSOE",12
26,"26053",208,161,160,1,1,"PSOE",38
26,"26135",167,120,119,0,1,"PSOE",23
26,"26171",179,136,126,1,10,"PSOE",26
26,"26103",789,626,616,3,10,"PSOE",181
26,"26004",68,53,53,1,0,"PSOE",6
26,"26095",101,78,77,1,1,"PSOE",31
26,"26158",265,220,217,4,3,"PSOE",50
26,"26119",202,163,162,4,1,"PSOE",71
26,"26034",660,522,513,1,9,"PSOE",174
26,"26083",289,213,213,1,0,"PSOE",52
26,"26110",162,135,134,0,1,"PSOE",31
26,"26130",203,167,166,1,1,"PSOE",34
26,"26131",34,33,33,1,0,"PSOE",5
26,"26154",11,8,8,0,0,"PSOE",0
26,"26051",254,202,201,2,1,"PSOE",32
26,"26160",715,569,567,3,2,"PSOE",153
26,"26033",172,143,142,2,1,"PSOE",49
26,"26128",104,80,79,0,1,"PSOE",28
26,"26035",16,12,12,0,0,"PSOE",3
26,"26015",193,151,149,0,2,"PSOE",21
26,"26011",7336,5309,5255,57,54,"PSOE",1444
26,"26094",85,71,68,0,3,"PSOE",8
26,"26152",31,24,23,0,1,"PSOE",4
26,"26043",373,284,282,4,2,"PSOE",85
26,"26046",1594,1221,1209,3,12,"PSOE",298
26,"26040",68,62,62,0,0,"PSOE",11
26,"26121",27,21,21,0,0,"PSOE",9
26,"26028",133,112,111,0,1,"PSOE",17
26,"26155",162,138,137,0,1,"PSOE",59
26,"26002",840,615,608,6,7,"PSOE",194
26,"26169",64,60,60,0,0,"PSOE",13
26,"26044",51,46,45,0,1,"PSOE",14
26,"26012",23,23,23,0,0,"PSOE",2
26,"26032",53,40,40,0,0,"PSOE",18
26,"26016",28,24,24,1,0,"PSOE",10
26,"26030",12,12,12,0,0,"PSOE",1
26,"26065",50,40,40,0,0,"PSOE",2
26,"26109",85,76,74,1,2,"PSOE",30
26,"26122",119,104,102,2,2,"PSOE",19
26,"26140",260,221,218,1,3,"PSOE",41
26,"26162",121,106,106,2,0,"PSOE",26
26,"26078",83,68,68,0,0,"PSOE",24
26,"26175",52,44,44,2,0,"PSOE",14
26,"26183",65,50,50,0,0,"PSOE",10
26,"26153",12,11,10,0,1,"PSOE",4
26,"26106",88,78,78,0,0,"PSOE",19
26,"26070",186,154,153,1,1,"PSOE",37
26,"26054",324,255,254,3,1,"PSOE",100
26,"26084",6630,5015,4952,27,63,"PSOE",869
26,"26042",836,645,635,5,10,"PSOE",223
26,"26062",90,73,71,0,2,"PSOE",6
26,"26079",639,536,527,2,9,"PSOE",118
26,"26058",150,114,113,0,1,"PSOE",16
26,"26176",54,46,43,1,3,"PSOE",5
26,"26172",30,25,25,0,0,"PSOE",10
26,"26138",4600,3374,3325,28,49,"PSOE",852
26,"26143",217,178,177,0,1,"PSOE",39
26,"26099",1259,1038,1024,7,14,"PSOE",320
26,"26115",17,14,14,0,0,"PSOE",3
26,"26165",364,315,311,1,4,"PSOE",98
26,"26063",122,97,96,0,1,"PSOE",16
26,"26145",245,202,201,3,1,"PSOE",43
26,"26091",166,141,138,0,3,"PSOE",19
26,"26069",240,201,199,0,2,"PSOE",43
26,"26161",7,7,7,0,0,"PSOE",0
26,"26019",351,282,281,1,1,"PSOE",92
26,"26024",236,183,183,0,0,"PSOE",56
26,"26060",85,67,67,1,0,"PSOE",15
26,"26112",243,192,191,1,1,"PSOE",45
26,"26142",780,618,613,1,5,"PSOE",173
26,"26077",27,25,25,0,0,"PSOE",3
26,"26008",1862,1442,1425,7,17,"PSOE",506
26,"26141",112,85,83,1,2,"PSOE",7
26,"26139",54,46,46,0,0,"PSOE",6
26,"26055",42,33,33,0,0,"PSOE",6
26,"26017",383,302,301,4,1,"PSOE",107
26,"26136",103,73,72,1,1,"PSOE",12
26,"26113",37,34,32,0,2,"PSOE",3
26,"26057",51,47,45,0,2,"PSOE",12
26,"26180",221,182,179,0,3,"PSOE",36
26,"26166",142,131,128,1,3,"PSOE",11
26,"26150",117,98,98,1,0,"PSOE",26
26,"26129",971,768,757,2,11,"PSOE",237
26,"26074",105,86,85,1,1,"PSOE",21
26,"26050",117,86,86,0,0,"PSOE",14
26,"26022",198,159,158,0,1,"PSOE",12
26,"26005",2343,1607,1590,19,17,"PSOE",351
26,"26038",95,66,65,0,1,"PSOE",24
26,"26107",92,75,75,0,0,"PSOE",18
26,"26066",265,217,209,3,8,"PSOE",33
26,"26088",36,32,31,0,1,"PSOE",7
26,"26010",98,78,78,1,0,"PSOE",20
26,"26086",15,15,15,0,0,"PSOE",1
26,"26026",1323,1070,1060,8,10,"PSOE",342
26,"26052",158,125,125,0,0,"PSOE",21
26,"26127",215,182,179,2,3,"PSOE",62
26,"26134",87,65,65,1,0,"PSOE",14
26,"26047",1969,1614,1596,14,18,"PSOE",595
26,"26117",2168,1695,1662,19,33,"PSOE",491
26,"26071",8477,6115,6029,51,86,"PSOE",1440
26,"26009",414,326,319,3,7,"PSOE",78
26,"26001",197,163,155,3,8,"PSOE",57
26,"26023",468,358,355,4,3,"PSOE",99
26,"26157",296,236,232,3,4,"PSOE",48
26,"26031",106,81,81,0,0,"PSOE",36
26,"26114",80,71,71,2,0,"PSOE",27
26,"26027",157,127,127,1,0,"PSOE",37
26,"26174",147,122,112,0,10,"PSOE",24
26,"26014",466,319,319,0,0,"PSOE",124
26,"26168",5318,3853,3802,36,51,"PSOE",711
26,"26125",2708,2013,1988,22,25,"PSOE",625
26,"26163",143,117,117,2,0,"PSOE",43
26,"26013",356,264,262,3,2,"PSOE",69
26,"26178",80,64,63,1,1,"PSOE",19
26,"26059",1117,850,840,9,10,"PSOE",216
26,"26082",109,92,89,0,3,"PSOE",24
26,"26067",23,20,20,0,0,"PSOE",4
26,"26029",37,31,31,0,0,"PSOE",7
26,"26037",131,111,111,1,0,"PSOE",31
26,"26064",2278,1736,1715,17,21,"PSOE",469
26,"26151",446,380,375,1,5,"PSOE",142
26,"26104",14,9,9,0,0,"PSOE",2
26,"26167",59,45,45,1,0,"PSOE",5
26,"26048",22,22,21,0,1,"PSOE",3
47,"47210",372,289,286,1,3,"FE de las J",0
47,"47048",190,140,138,0,2,"FE de las J",0
47,"47114",4074,2868,2826,20,42,"FE de las J",4
47,"47024",262,206,205,2,1,"FE de las J",0
47,"47061",258,216,214,2,2,"FE de las J",1
47,"47039",188,149,148,1,1,"FE de las J",0
47,"47153",108,74,73,1,1,"FE de las J",0
47,"47123",469,395,386,4,9,"FE de las J",0
47,"47232",99,75,74,0,1,"FE de las J",0
47,"47192",105,80,79,1,1,"FE de las J",0
47,"47011",568,469,464,1,5,"FE de las J",0
47,"47177",107,78,76,0,2,"FE de las J",0
47,"47169",68,57,57,0,0,"FE de las J",0
47,"47111",1009,794,789,4,5,"FE de las J",0
47,"47103",259,211,211,4,0,"FE de las J",0
47,"47001",55,51,50,2,1,"FE de las J",0
47,"47110",455,363,357,3,6,"FE de las J",0
47,"47080",30,22,22,0,0,"FE de las J",0
47,"47014",50,45,45,0,0,"FE de las J",0
47,"47191",110,74,74,0,0,"FE de las J",0
47,"47082",803,641,633,5,8,"FE de las J",2
47,"47129",879,700,688,6,12,"FE de las J",0
47,"47083",80,62,61,2,1,"FE de las J",0
47,"47056",82,58,57,0,1,"FE de las J",0
47,"47054",638,501,496,6,5,"FE de las J",0
47,"47145",611,451,449,4,2,"FE de las J",2
47,"47173",883,686,675,4,11,"FE de las J",0
47,"47127",135,98,96,1,2,"FE de las J",0
47,"47195",461,348,348,3,0,"FE de las J",1
47,"47116",413,330,324,1,6,"FE de las J",1
47,"47217",1896,1436,1420,20,16,"FE de las J",3
47,"47092",110,93,92,0,1,"FE de las J",1
47,"47016",71,58,57,0,1,"FE de las J",0
47,"47030",1006,785,770,10,15,"FE de las J",0
47,"47099",152,128,127,1,1,"FE de las J",0
47,"47086",3926,3065,3028,27,37,"FE de las J",5
47,"47212",388,322,322,3,0,"FE de las J",1
47,"47166",265,203,199,3,4,"FE de las J",1
47,"47203",67,54,54,0,0,"FE de las J",0
47,"47225",81,61,60,2,1,"FE de las J",0
47,"47008",24,18,18,0,0,"FE de las J",0
47,"47139",1047,790,785,7,5,"FE de las J",0
47,"47219",42,36,34,2,2,"FE de las J",1
47,"47076",17375,13778,13684,111,94,"FE de las J",18
47,"47040",63,52,51,1,1,"FE de las J",0
47,"47049",100,78,78,1,0,"FE de las J",1
47,"47119",90,75,75,1,0,"FE de las J",0
47,"47185",98,79,79,0,0,"FE de las J",3
47,"47204",260,199,193,2,6,"FE de las J",0
47,"47164",377,309,307,2,2,"FE de las J",0
47,"47029",57,48,47,1,1,"FE de las J",0
47,"47091",89,67,66,0,1,"FE de las J",0
47,"47140",119,101,100,1,1,"FE de las J",0
47,"47009",106,80,80,1,0,"FE de las J",0
47,"47063",101,82,81,2,1,"FE de las J",0
47,"47088",110,87,87,0,0,"FE de las J",0
47,"47021",76,65,65,1,0,"FE de las J",0
47,"47067",178,126,126,3,0,"FE de las J",1
47,"47222",80,68,68,3,0,"FE de las J",0
47,"47077",247,190,189,2,1,"FE de las J",0
47,"47221",109,91,91,0,0,"FE de las J",0
47,"47004",1199,946,938,11,8,"FE de las J",1
47,"47047",202,157,157,3,0,"FE de las J",4
47,"47036",229,184,179,2,5,"FE de las J",1
47,"47071",417,348,344,2,4,"FE de las J",0
47,"47025",120,97,97,2,0,"FE de las J",0
47,"47197",888,693,687,10,6,"FE de las J",1
47,"47188",112,85,85,0,0,"FE de las J",0
47,"47231",4384,3457,3432,33,25,"FE de las J",6
47,"47089",153,122,120,2,2,"FE de las J",0
47,"47059",97,71,71,0,0,"FE de las J",0
47,"47143",127,99,99,0,0,"FE de las J",0
47,"47045",768,586,580,0,6,"FE de las J",0
47,"47132",45,37,35,0,2,"FE de las J",0
47,"47028",33,20,20,0,0,"FE de las J",0
47,"47002",25,23,23,0,0,"FE de las J",0
47,"47084",1171,911,898,15,13,"FE de las J",1
47,"47031",186,145,144,1,1,"FE de las J",0
47,"47034",76,59,58,1,1,"FE de las J",0
47,"47118",161,119,118,0,1,"FE de las J",0
47,"47151",27,22,21,0,1,"FE de las J",0
47,"47206",95,81,81,0,0,"FE de las J",0
47,"47229",215,151,150,1,1,"FE de las J",0
47,"47128",60,51,49,1,2,"FE de las J",0
47,"47138",237,180,176,1,4,"FE de las J",1
47,"47158",906,686,668,3,18,"FE de las J",1
47,"47133",2665,2140,2118,25,22,"FE de las J",3
47,"47037",174,146,141,2,5,"FE de las J",0
47,"47146",260,205,204,1,1,"FE de las J",1
47,"47003",228,180,179,3,1,"FE de las J",0
47,"47144",78,66,65,2,1,"FE de las J",1
47,"47179",398,299,295,3,4,"FE de las J",0
47,"47178",175,146,146,1,0,"FE de las J",1
47,"47149",43,33,32,1,1,"FE de las J",0
47,"47044",330,291,287,0,4,"FE de las J",0
47,"47156",169,137,135,1,2,"FE de las J",2
47,"47199",80,59,59,2,0,"FE de las J",0
47,"47126",49,36,36,0,0,"FE de las J",0
47,"47055",202,170,168,1,2,"FE de las J",0
47,"47209",42,30,30,1,0,"FE de las J",0
47,"47227",64,52,52,0,0,"FE de las J",0
47,"47182",1342,1037,1023,16,14,"FE de las J",1
47,"47019",86,67,65,1,2,"FE de las J",0
47,"47070",41,32,32,1,0,"FE de las J",0
47,"47216",115,101,99,2,2,"FE de las J",5
47,"47018",35,31,28,0,3,"FE de las J",2
47,"47207",277,216,212,3,4,"FE de las J",0
47,"47214",1420,1111,1093,9,18,"FE de las J",4
47,"47042",54,41,41,3,0,"FE de las J",0
47,"47075",4871,3802,3763,30,39,"FE de las J",6
47,"47098",583,488,487,6,1,"FE de las J",0
47,"47205",385,281,274,7,7,"FE de las J",1
47,"47213",115,83,83,0,0,"FE de las J",0
47,"47112",2592,2063,2043,20,20,"FE de las J",1
47,"47137",29,28,28,1,0,"FE de las J",0
47,"47161",3903,3200,3183,25,17,"FE de las J",3
47,"47154",155,128,127,0,1,"FE de las J",0
47,"47068",36,27,27,0,0,"FE de las J",0
47,"47175",6575,4991,4937,51,54,"FE de las J",4
47,"47226",161,128,127,1,1,"FE de las J",0
47,"47160",430,334,329,5,5,"FE de las J",0
47,"47181",168,135,134,0,1,"FE de las J",1
47,"47064",31,29,28,2,1,"FE de las J",0
47,"47113",156,121,121,0,0,"FE de las J",0
47,"47172",148,120,120,1,0,"FE de las J",1
47,"47117",297,219,216,4,3,"FE de las J",0
47,"47085",16668,12248,12132,133,116,"FE de las J",19
47,"47193",1583,1313,1294,12,19,"FE de las J",0
47,"47078",164,129,124,1,5,"FE de las J",0
47,"47032",153,120,118,0,2,"FE de las J",1
47,"47141",134,102,101,1,1,"FE de las J",0
47,"47218",995,760,754,6,6,"FE de las J",0
47,"47052",6584,5222,5163,41,59,"FE de las J",11
47,"47012",118,95,95,0,0,"FE de las J",0
47,"47006",190,145,144,1,1,"FE de las J",0
47,"47168",31,28,27,0,1,"FE de las J",1
47,"47053",116,96,96,1,0,"FE de las J",0
47,"47074",150,125,125,1,0,"FE de las J",0
47,"47081",47,40,40,0,0,"FE de las J",0
47,"47090",2418,1805,1776,17,29,"FE de las J",2
47,"47100",140,119,117,2,2,"FE de las J",0
47,"47026",49,40,40,0,0,"FE de las J",1
47,"47051",338,274,272,0,2,"FE de las J",1
47,"47142",148,114,113,0,1,"FE de las J",1
47,"47135",84,76,76,2,0,"FE de las J",0
47,"47027",2746,2120,2095,8,25,"FE de las J",2
47,"47033",199,154,153,3,1,"FE de las J",0
47,"47050",3757,2829,2812,29,17,"FE de las J",2
47,"47122",2034,1666,1635,21,31,"FE de las J",0
47,"47176",224,139,135,5,4,"FE de las J",0
47,"47183",130,105,105,0,0,"FE de las J",0
47,"47094",132,103,101,1,2,"FE de las J",0
47,"47174",275,222,218,2,4,"FE de las J",1
47,"47104",2857,2313,2253,19,60,"FE de las J",6
47,"47109",171,131,130,1,1,"FE de las J",0
47,"47020",278,230,227,1,3,"FE de las J",0
47,"47211",49,39,37,1,2,"FE de las J",0
47,"47189",152,128,128,0,0,"FE de las J",0
47,"47065",863,681,671,4,10,"FE de las J",0
47,"47060",262,218,214,0,4,"FE de las J",0
47,"47155",3239,2400,2374,27,26,"FE de las J",8
47,"47097",331,268,263,1,5,"FE de las J",0
47,"47106",50,41,41,0,0,"FE de las J",0
47,"47038",108,82,82,0,0,"FE de las J",0
47,"47165",6987,5301,5115,63,186,"FE de las J",4
47,"47230",302,243,241,0,2,"FE de las J",1
47,"47066",1255,1005,996,7,9,"FE de las J",1
47,"47184",576,463,462,2,1,"FE de las J",1
47,"47223",158,129,125,3,4,"FE de las J",0
47,"47096",135,108,107,2,1,"FE de las J",0
47,"47115",287,238,237,4,1,"FE de las J",1
47,"47069",127,113,111,0,2,"FE de las J",0
47,"47058",206,149,149,2,0,"FE de las J",2
47,"47131",178,132,131,3,1,"FE de las J",0
47,"47171",418,333,332,9,1,"FE de las J",1
47,"47015",199,151,151,0,0,"FE de las J",0
47,"47095",39,36,35,0,1,"FE de las J",0
47,"47041",149,124,123,2,1,"FE de las J",1
47,"47159",828,654,646,0,8,"FE de las J",0
47,"47073",120,98,97,1,1,"FE de las J",0
47,"47057",248,194,194,2,0,"FE de las J",0
47,"47167",242,201,197,3,4,"FE de las J",0
47,"47198",66,47,47,0,0,"FE de las J",0
47,"47147",119,91,91,0,0,"FE de las J",0
47,"47013",99,74,73,0,1,"FE de las J",0
47,"47010",13613,10963,10895,108,68,"FE de las J",11
47,"47162",73,61,61,0,0,"FE de las J",0
47,"47134",164,126,119,4,7,"FE de las J",0
47,"47194",301,242,239,1,3,"FE de las J",1
47,"47035",930,745,739,10,6,"FE de las J",2
47,"47121",553,436,428,5,8,"FE de las J",1
47,"47102",286,229,224,1,5,"FE de las J",0
47,"47208",59,38,37,3,1,"FE de las J",0
47,"47079",62,51,51,0,0,"FE de las J",0
47,"47046",121,93,93,0,0,"FE de las J",0
47,"47220",166,124,124,1,0,"FE de las J",0
47,"47148",439,336,335,2,1,"FE de las J",0
47,"47196",35,26,26,1,0,"FE de las J",0
47,"47093",817,654,642,9,12,"FE de las J",1
47,"47007",3748,2869,2835,24,34,"FE de las J",6
47,"47228",445,359,357,4,2,"FE de las J",0
47,"47190",93,80,78,4,2,"FE de las J",0
47,"47200",82,64,64,1,0,"FE de las J",0
47,"47150",278,217,214,2,3,"FE de las J",0
47,"47125",59,43,43,1,0,"FE de las J",1
47,"47023",2999,2457,2445,20,12,"FE de las J",3
47,"47005",548,426,421,4,5,"FE de las J",1
47,"47215",54,47,46,1,1,"FE de las J",0
47,"47163",299,236,235,6,1,"FE de las J",0
47,"47017",201,161,158,3,3,"FE de las J",0
47,"47152",86,64,64,1,0,"FE de las J",0
47,"47043",302,239,239,3,0,"FE de las J",0
47,"47224",91,74,74,1,0,"FE de las J",0
47,"47087",379,318,314,4,4,"FE de las J",2
47,"47022",57,50,46,0,4,"FE de las J",0
47,"47101",1720,1404,1388,10,16,"FE de las J",0
47,"47124",399,329,328,4,1,"FE de las J",1
47,"47186",246602,193774,192412,1384,1362,"FE de las J",209
47,"47130",99,78,78,1,0,"FE de las J",0
47,"47105",192,164,163,0,1,"FE de las J",1
47,"47187",89,57,56,2,1,"FE de las J",0
47,"47170",36,30,29,2,1,"FE de las J",0
47,"47157",515,442,441,3,1,"FE de las J",0
47,"47062",163,131,131,0,0,"FE de las J",1
47,"47180",83,64,64,1,0,"FE de las J",0
6,"6130",195,174,170,0,4,"PACMA",0
6,"6011",24721,17683,17506,172,177,"PACMA",113
6,"6125",1754,1327,1304,7,23,"PACMA",4
6,"6029",1213,892,875,8,17,"PACMA",1
6,"6112",393,335,333,0,2,"PACMA",2
6,"6064",841,672,671,6,1,"PACMA",0
6,"6128",4445,3137,3116,36,21,"PACMA",10
6,"6150",806,658,650,6,8,"PACMA",1
6,"6134",545,325,323,3,2,"PACMA",1
6,"6001",696,526,521,1,5,"PACMA",0
6,"6056",481,401,399,2,2,"PACMA",2
6,"6102",1055,843,830,3,13,"PACMA",2
6,"6151",1094,809,801,8,8,"PACMA",0
6,"6141",1741,1246,1223,13,23,"PACMA",2
6,"6058",2055,1512,1494,14,18,"PACMA",3
6,"6005",1717,1271,1258,10,13,"PACMA",6
6,"6086",1233,884,874,3,10,"PACMA",2
6,"6087",2127,1612,1592,16,20,"PACMA",4
6,"6023",4362,3200,3168,11,32,"PACMA",11
6,"6124",1739,1309,1287,15,22,"PACMA",2
6,"6117",1417,1044,1031,3,13,"PACMA",7
6,"6038",801,558,551,5,7,"PACMA",2
6,"6002",4335,3084,3006,33,78,"PACMA",16
6,"6018",761,543,539,3,4,"PACMA",4
6,"6114",148,116,116,0,0,"PACMA",1
6,"6152",1322,964,951,1,13,"PACMA",3
6,"6106",428,295,293,2,2,"PACMA",3
6,"6030",172,138,138,0,0,"PACMA",0
6,"6105",631,448,443,0,5,"PACMA",1
6,"6007",1483,1076,1068,6,8,"PACMA",4
6,"6111",507,360,359,2,1,"PACMA",0
6,"6126",2183,1594,1582,9,12,"PACMA",4
6,"6022",2660,2159,2140,12,19,"PACMA",9
6,"6015",116673,82152,81388,677,764,"PACMA",661
6,"6031",466,321,316,2,5,"PACMA",2
6,"6009",206,156,156,1,0,"PACMA",0
6,"6138",1059,795,773,3,22,"PACMA",6
6,"6161",315,236,231,1,5,"PACMA",2
6,"6076",837,632,624,2,8,"PACMA",3
6,"6046",1248,989,978,4,11,"PACMA",0
6,"6050",4124,3178,3110,30,68,"PACMA",9
6,"6054",5442,4185,4098,32,87,"PACMA",11
6,"6143",3338,2548,2508,23,40,"PACMA",7
6,"6024",1181,955,942,5,13,"PACMA",1
6,"6060",5798,4346,4261,23,85,"PACMA",7
6,"6090",877,661,642,7,19,"PACMA",3
6,"6096",226,188,182,1,6,"PACMA",0
6,"6098",545,408,402,1,6,"PACMA",0
6,"6159",2339,1429,1407,14,22,"PACMA",2
6,"6078",510,414,407,1,7,"PACMA",2
6,"6160",3154,2324,2292,12,32,"PACMA",7
6,"6016",2978,2258,2235,14,23,"PACMA",6
6,"6132",855,634,627,4,7,"PACMA",2
6,"6902",1672,1239,1224,6,15,"PACMA",6
6,"6051",1573,1235,1222,6,13,"PACMA",3
6,"6131",1074,887,885,2,2,"PACMA",0
6,"6091",3782,2728,2690,32,38,"PACMA",2
6,"6084",1100,857,842,4,15,"PACMA",1
6,"6082",382,312,306,3,6,"PACMA",1
6,"6067",1984,1408,1377,9,31,"PACMA",8
6,"6063",3038,2413,2391,15,22,"PACMA",10
6,"6075",477,401,389,2,12,"PACMA",4
6,"6008",634,562,558,1,4,"PACMA",1
6,"6021",928,668,656,9,12,"PACMA",0
6,"6003",830,656,647,6,9,"PACMA",0
6,"6040",1002,758,754,4,4,"PACMA",5
6,"6107",1591,1114,1107,4,7,"PACMA",7
6,"6042",1012,711,703,3,8,"PACMA",2
6,"6103",4781,3519,3459,40,60,"PACMA",15
6,"6073",745,507,497,5,10,"PACMA",2
6,"6045",499,378,378,4,0,"PACMA",0
6,"6057",573,471,466,1,5,"PACMA",0
6,"6115",1260,867,853,7,14,"PACMA",3
6,"6043",673,542,535,5,7,"PACMA",2
6,"6080",1931,1498,1480,9,18,"PACMA",10
6,"6014",6688,4651,4586,22,65,"PACMA",14
6,"6081",1078,850,839,4,11,"PACMA",1
6,"6074",4814,3717,3659,37,58,"PACMA",17
6,"6122",6651,4654,4553,29,101,"PACMA",31
6,"6145",916,717,711,9,6,"PACMA",0
6,"6013",265,230,224,1,6,"PACMA",1
6,"6123",4644,3420,3357,22,63,"PACMA",21
6,"6028",4253,3716,3631,30,85,"PACMA",6
6,"6901",2114,1648,1625,28,23,"PACMA",9
6,"6099",1148,768,749,5,19,"PACMA",1
6,"6153",20417,15129,14934,112,195,"PACMA",94
6,"6085",3427,2563,2524,21,39,"PACMA",6
6,"6162",2938,2278,2239,17,39,"PACMA",3
6,"6033",1330,1037,1025,10,12,"PACMA",1
6,"6069",3079,2164,2137,21,27,"PACMA",6
6,"6035",957,700,690,4,10,"PACMA",4
6,"6101",466,386,382,0,4,"PACMA",1
6,"6137",987,811,805,4,6,"PACMA",2
6,"6049",1021,747,733,2,14,"PACMA",5
6,"6070",7753,5773,5645,52,128,"PACMA",21
6,"6048",848,716,700,0,16,"PACMA",0
6,"6061",1092,899,890,6,9,"PACMA",1
6,"6006",4595,3365,3318,27,47,"PACMA",8
6,"6140",633,493,482,6,11,"PACMA",0
6,"6097",2390,1814,1798,7,16,"PACMA",1
6,"6147",362,285,281,0,4,"PACMA",1
6,"6903",2017,1509,1475,11,34,"PACMA",7
6,"6088",12639,8992,8885,68,107,"PACMA",54
6,"6104",677,533,529,6,4,"PACMA",3
6,"6083",46111,32608,32276,235,332,"PACMA",226
6,"6017",274,229,228,1,1,"PACMA",0
6,"6113",2725,2091,2054,9,37,"PACMA",8
6,"6139",553,442,436,1,6,"PACMA",0
6,"6004",1604,1265,1248,10,17,"PACMA",4
6,"6044",28899,20862,20681,153,181,"PACMA",108
6,"6110",151,107,104,0,3,"PACMA",0
6,"6142",276,215,207,0,8,"PACMA",1
6,"6144",562,450,447,3,3,"PACMA",1
6,"6108",2299,1714,1683,13,31,"PACMA",11
6,"6079",645,502,488,1,14,"PACMA",1
6,"6120",3393,2635,2600,14,35,"PACMA",12
6,"6065",309,257,247,0,10,"PACMA",1
6,"6148",973,739,730,5,9,"PACMA",3
6,"6027",681,586,576,1,10,"PACMA",2
6,"6047",855,664,654,2,10,"PACMA",0
6,"6032",66,54,54,2,0,"PACMA",1
6,"6095",9493,6973,6839,97,134,"PACMA",40
6,"6154",2798,2001,1975,17,26,"PACMA",2
6,"6116",1607,1168,1149,10,19,"PACMA",0
6,"6135",1103,904,888,9,16,"PACMA",2
6,"6109",3957,3258,3177,22,81,"PACMA",7
6,"6020",1822,1435,1406,12,29,"PACMA",2
6,"6072",2334,1813,1792,20,21,"PACMA",7
6,"6066",1776,1260,1245,2,15,"PACMA",0
6,"6129",591,466,462,3,4,"PACMA",3
6,"6093",4472,3476,3416,22,60,"PACMA",13
6,"6034",174,126,125,2,1,"PACMA",0
6,"6156",1169,903,898,2,5,"PACMA",3
6,"6053",607,459,450,2,9,"PACMA",2
6,"6089",598,491,488,3,3,"PACMA",1
6,"6094",1483,1025,1014,6,11,"PACMA",2
6,"6118",206,165,164,1,1,"PACMA",0
6,"6077",347,276,272,3,4,"PACMA",0
6,"6092",582,402,392,3,10,"PACMA",0
6,"6041",460,378,375,3,3,"PACMA",0
6,"6012",3280,2358,2343,12,15,"PACMA",6
6,"6133",1775,1351,1334,9,17,"PACMA",9
6,"6039",1838,1546,1517,9,29,"PACMA",0
6,"6158",13305,9965,9802,91,163,"PACMA",68
6,"6157",453,316,315,0,1,"PACMA",0
6,"6036",5085,3797,3739,29,58,"PACMA",8
6,"6155",1890,1337,1315,15,22,"PACMA",7
6,"6149",10342,8013,7897,70,116,"PACMA",38
6,"6100",938,776,763,2,13,"PACMA",4
6,"6019",2090,1519,1488,11,31,"PACMA",8
6,"6026",837,632,623,2,9,"PACMA",0
6,"6136",1578,1182,1168,8,14,"PACMA",4
6,"6071",247,208,203,0,5,"PACMA",1
6,"6025",5126,3833,3783,37,50,"PACMA",19
6,"6119",701,519,514,1,5,"PACMA",0
6,"6010",1111,877,863,7,14,"PACMA",2
6,"6146",1094,848,837,5,11,"PACMA",0
6,"6059",1858,1361,1342,12,19,"PACMA",7
6,"6121",3383,2518,2483,21,35,"PACMA",8
6,"6127",2893,2188,2158,13,30,"PACMA",4
6,"6062",612,450,441,4,9,"PACMA",0
6,"6055",2058,1557,1527,21,30,"PACMA",7
6,"6052",4051,3071,3009,31,62,"PACMA",18
6,"6068",453,349,344,3,5,"PACMA",1
6,"6037",1768,1176,1160,5,16,"PACMA",2
2,"2048",1251,1013,1004,9,9,"PP",450
2,"2023",576,479,468,2,11,"PP",228
2,"2019",2412,1991,1959,13,32,"PP",665
2,"2086",2603,1797,1783,8,14,"PP",734
2,"2015",1444,1196,1179,7,17,"PP",468
2,"2003",131959,101091,100433,730,658,"PP",36149
2,"2018",832,670,663,5,7,"PP",291
2,"2050",103,87,87,0,0,"PP",45
2,"2068",343,265,262,2,3,"PP",86
2,"2046",1135,936,917,15,19,"PP",359
2,"2070",411,337,330,1,7,"PP",58
2,"2083",217,194,194,0,0,"PP",86
2,"2017",845,611,607,1,4,"PP",253
2,"2901",2202,1571,1563,16,8,"PP",621
2,"2033",1920,1551,1518,6,33,"PP",655
2,"2024",3416,2694,2666,33,28,"PP",871
2,"2004",621,504,500,5,4,"PP",215
2,"2077",55,41,41,0,0,"PP",21
2,"2037",22886,15400,15266,111,134,"PP",5491
2,"2071",1056,890,884,7,6,"PP",407
2,"2051",1690,1227,1211,12,16,"PP",704
2,"2010",1798,1491,1463,10,28,"PP",598
2,"2029",3306,2563,2533,17,30,"PP",850
2,"2080",532,419,410,0,9,"PP",158
2,"2022",368,279,278,0,1,"PP",154
2,"2078",922,698,691,6,7,"PP",227
2,"2040",586,507,505,1,2,"PP",209
2,"2069",11544,8969,8824,62,145,"PP",3979
2,"2085",321,268,266,4,2,"PP",120
2,"2014",368,300,295,1,5,"PP",101
2,"2054",390,305,302,3,3,"PP",158
2,"2028",132,103,102,0,1,"PP",31
2,"2057",2043,1593,1568,24,25,"PP",385
2,"2002",494,406,397,0,9,"PP",188
2,"2072",1560,1118,1098,4,20,"PP",365
2,"2038",284,230,230,1,0,"PP",122
2,"2042",850,698,693,2,5,"PP",246
2,"2030",3059,2405,2377,11,28,"PP",704
2,"2053",2996,2370,2332,15,38,"PP",774
2,"2049",838,610,607,3,3,"PP",204
2,"2060",1302,1007,1003,8,4,"PP",480
2,"2062",414,324,319,0,5,"PP",128
2,"2064",379,317,316,1,1,"PP",125
2,"2035",1989,1607,1582,13,25,"PP",562
2,"2011",643,517,515,0,2,"PP",224
2,"2013",132,105,104,0,1,"PP",50
2,"2043",1250,1020,1006,8,14,"PP",429
2,"2081",18334,14121,13932,116,189,"PP",5592
2,"2016",581,445,441,0,4,"PP",170
2,"2059",317,242,241,0,1,"PP",78
2,"2005",568,441,434,4,7,"PP",201
2,"2047",120,91,90,0,1,"PP",67
2,"2025",7502,5918,5785,41,133,"PP",2392
2,"2058",348,244,239,2,5,"PP",64
2,"2056",1729,1348,1323,10,25,"PP",574
2,"2021",1037,823,816,3,7,"PP",362
2,"2032",281,217,216,1,1,"PP",66
2,"2052",473,399,398,3,1,"PP",152
2,"2084",325,228,221,2,7,"PP",91
2,"2036",96,72,72,1,0,"PP",39
2,"2061",641,534,530,7,4,"PP",263
2,"2034",1395,1131,1126,10,5,"PP",391
2,"2063",1471,1161,1156,6,5,"PP",418
2,"2076",334,269,268,3,1,"PP",115
2,"2044",1128,806,798,2,8,"PP",276
2,"2012",1833,1595,1575,17,20,"PP",473
2,"2026",847,705,697,7,8,"PP",220
2,"2020",451,381,376,3,5,"PP",157
2,"2067",1189,909,896,4,13,"PP",331
2,"2039",1002,824,819,8,5,"PP",328
2,"2082",105,88,88,1,0,"PP",27
2,"2001",660,521,510,4,11,"PP",249
2,"2008",1227,923,909,9,14,"PP",343
2,"2027",310,251,251,0,0,"PP",118
2,"2007",1050,824,811,7,13,"PP",245
2,"2041",350,274,272,1,2,"PP",165
2,"2045",3706,3046,3009,17,37,"PP",756
2,"2075",1684,1406,1397,10,9,"PP",603
2,"2074",5998,4415,4363,20,52,"PP",1653
2,"2009",19686,14909,14719,148,190,"PP",4954
2,"2006",588,482,476,2,6,"PP",225
2,"2055",1157,757,753,9,4,"PP",269
2,"2066",238,206,205,1,1,"PP",86
2,"2073",4914,3777,3730,42,47,"PP",1300
2,"2031",574,447,440,1,7,"PP",167
2,"2065",475,403,402,2,1,"PP",183
2,"2079",2887,2312,2285,24,27,"PP",561
47,"47042",54,41,41,3,0,"PSOE",10
47,"47032",153,120,118,0,2,"PSOE",9
47,"47075",4871,3802,3763,30,39,"PSOE",716
47,"47190",93,80,78,4,2,"PSOE",9
47,"47097",331,268,263,1,5,"PSOE",105
47,"47216",115,101,99,2,2,"PSOE",1
47,"47030",1006,785,770,10,15,"PSOE",150
47,"47227",64,52,52,0,0,"PSOE",16
47,"47210",372,289,286,1,3,"PSOE",67
47,"47085",16668,12248,12132,133,116,"PSOE",3111
47,"47052",6584,5222,5163,41,59,"PSOE",1053
47,"47218",995,760,754,6,6,"PSOE",218
47,"47066",1255,1005,996,7,9,"PSOE",195
47,"47091",89,67,66,0,1,"PSOE",20
47,"47196",35,26,26,1,0,"PSOE",0
47,"47144",78,66,65,2,1,"PSOE",8
47,"47231",4384,3457,3432,33,25,"PSOE",651
47,"47125",59,43,43,1,0,"PSOE",5
47,"47156",169,137,135,1,2,"PSOE",31
47,"47139",1047,790,785,7,5,"PSOE",219
47,"47162",73,61,61,0,0,"PSOE",7
47,"47171",418,333,332,9,1,"PSOE",56
47,"47044",330,291,287,0,4,"PSOE",80
47,"47065",863,681,671,4,10,"PSOE",239
47,"47102",286,229,224,1,5,"PSOE",82
47,"47043",302,239,239,3,0,"PSOE",76
47,"47189",152,128,128,0,0,"PSOE",26
47,"47195",461,348,348,3,0,"PSOE",112
47,"47222",80,68,68,3,0,"PSOE",22
47,"47230",302,243,241,0,2,"PSOE",57
47,"47126",49,36,36,0,0,"PSOE",0
47,"47094",132,103,101,1,2,"PSOE",30
47,"47020",278,230,227,1,3,"PSOE",61
47,"47103",259,211,211,4,0,"PSOE",78
47,"47003",228,180,179,3,1,"PSOE",44
47,"47164",377,309,307,2,2,"PSOE",90
47,"47181",168,135,134,0,1,"PSOE",27
47,"47135",84,76,76,2,0,"PSOE",24
47,"47027",2746,2120,2095,8,25,"PSOE",556
47,"47017",201,161,158,3,3,"PSOE",8
47,"47014",50,45,45,0,0,"PSOE",10
47,"47116",413,330,324,1,6,"PSOE",76
47,"47053",116,96,96,1,0,"PSOE",14
47,"47193",1583,1313,1294,12,19,"PSOE",273
47,"47133",2665,2140,2118,25,22,"PSOE",381
47,"47067",178,126,126,3,0,"PSOE",19
47,"47185",98,79,79,0,0,"PSOE",13
47,"47176",224,139,135,5,4,"PSOE",28
47,"47232",99,75,74,0,1,"PSOE",19
47,"47161",3903,3200,3183,25,17,"PSOE",426
47,"47213",115,83,83,0,0,"PSOE",33
47,"47214",1420,1111,1093,9,18,"PSOE",272
47,"47172",148,120,120,1,0,"PSOE",20
47,"47009",106,80,80,1,0,"PSOE",19
47,"47163",299,236,235,6,1,"PSOE",75
47,"47122",2034,1666,1635,21,31,"PSOE",423
47,"47225",81,61,60,2,1,"PSOE",10
47,"47057",248,194,194,2,0,"PSOE",18
47,"47155",3239,2400,2374,27,26,"PSOE",497
47,"47221",109,91,91,0,0,"PSOE",17
47,"47207",277,216,212,3,4,"PSOE",55
47,"47029",57,48,47,1,1,"PSOE",9
47,"47010",13613,10963,10895,108,68,"PSOE",1627
47,"47078",164,129,124,1,5,"PSOE",27
47,"47061",258,216,214,2,2,"PSOE",78
47,"47113",156,121,121,0,0,"PSOE",52
47,"47175",6575,4991,4937,51,54,"PSOE",1235
47,"47137",29,28,28,1,0,"PSOE",2
47,"47199",80,59,59,2,0,"PSOE",9
47,"47188",112,85,85,0,0,"PSOE",20
47,"47079",62,51,51,0,0,"PSOE",4
47,"47182",1342,1037,1023,16,14,"PSOE",302
47,"47056",82,58,57,0,1,"PSOE",9
47,"47055",202,170,168,1,2,"PSOE",52
47,"47197",888,693,687,10,6,"PSOE",200
47,"47118",161,119,118,0,1,"PSOE",29
47,"47138",237,180,176,1,4,"PSOE",52
47,"47015",199,151,151,0,0,"PSOE",39
47,"47018",35,31,28,0,3,"PSOE",0
47,"47134",164,126,119,4,7,"PSOE",36
47,"47064",31,29,28,2,1,"PSOE",2
47,"47174",275,222,218,2,4,"PSOE",46
47,"47004",1199,946,938,11,8,"PSOE",382
47,"47211",49,39,37,1,2,"PSOE",2
47,"47191",110,74,74,0,0,"PSOE",10
47,"47154",155,128,127,0,1,"PSOE",24
47,"47070",41,32,32,1,0,"PSOE",1
47,"47173",883,686,675,4,11,"PSOE",222
47,"47212",388,322,322,3,0,"PSOE",77
47,"47168",31,28,27,0,1,"PSOE",1
47,"47054",638,501,496,6,5,"PSOE",91
47,"47037",174,146,141,2,5,"PSOE",32
47,"47068",36,27,27,0,0,"PSOE",6
47,"47008",24,18,18,0,0,"PSOE",0
47,"47040",63,52,51,1,1,"PSOE",8
47,"47073",120,98,97,1,1,"PSOE",26
47,"47158",906,686,668,3,18,"PSOE",233
47,"47087",379,318,314,4,4,"PSOE",68
47,"47112",2592,2063,2043,20,20,"PSOE",450
47,"47046",121,93,93,0,0,"PSOE",30
47,"47081",47,40,40,0,0,"PSOE",16
47,"47038",108,82,82,0,0,"PSOE",27
47,"47166",265,203,199,3,4,"PSOE",47
47,"47167",242,201,197,3,4,"PSOE",58
47,"47170",36,30,29,2,1,"PSOE",6
47,"47204",260,199,193,2,6,"PSOE",55
47,"47179",398,299,295,3,4,"PSOE",63
47,"47047",202,157,157,3,0,"PSOE",21
47,"47150",278,217,214,2,3,"PSOE",43
47,"47123",469,395,386,4,9,"PSOE",66
47,"47159",828,654,646,0,8,"PSOE",195
47,"47049",100,78,78,1,0,"PSOE",17
47,"47026",49,40,40,0,0,"PSOE",2
47,"47131",178,132,131,3,1,"PSOE",42
47,"47119",90,75,75,1,0,"PSOE",19
47,"47152",86,64,64,1,0,"PSOE",21
47,"47001",55,51,50,2,1,"PSOE",2
47,"47080",30,22,22,0,0,"PSOE",3
47,"47178",175,146,146,1,0,"PSOE",27
47,"47109",171,131,130,1,1,"PSOE",38
47,"47183",130,105,105,0,0,"PSOE",26
47,"47089",153,122,120,2,2,"PSOE",13
47,"47117",297,219,216,4,3,"PSOE",41
47,"47077",247,190,189,2,1,"PSOE",27
47,"47132",45,37,35,0,2,"PSOE",2
47,"47024",262,206,205,2,1,"PSOE",62
47,"47147",119,91,91,0,0,"PSOE",18
47,"47180",83,64,64,1,0,"PSOE",13
47,"47129",879,700,688,6,12,"PSOE",209
47,"47143",127,99,99,0,0,"PSOE",13
47,"47228",445,359,357,4,2,"PSOE",90
47,"47105",192,164,163,0,1,"PSOE",49
47,"47035",930,745,739,10,6,"PSOE",235
47,"47160",430,334,329,5,5,"PSOE",60
47,"47051",338,274,272,0,2,"PSOE",48
47,"47169",68,57,57,0,0,"PSOE",2
47,"47069",127,113,111,0,2,"PSOE",41
47,"47229",215,151,150,1,1,"PSOE",38
47,"47149",43,33,32,1,1,"PSOE",0
47,"47115",287,238,237,4,1,"PSOE",46
47,"47110",455,363,357,3,6,"PSOE",117
47,"47082",803,641,633,5,8,"PSOE",117
47,"47099",152,128,127,1,1,"PSOE",26
47,"47224",91,74,74,1,0,"PSOE",17
47,"47106",50,41,41,0,0,"PSOE",5
47,"47090",2418,1805,1776,17,29,"PSOE",487
47,"47104",2857,2313,2253,19,60,"PSOE",507
47,"47041",149,124,123,2,1,"PSOE",24
47,"47058",206,149,149,2,0,"PSOE",32
47,"47128",60,51,49,1,2,"PSOE",0
47,"47153",108,74,73,1,1,"PSOE",16
47,"47088",110,87,87,0,0,"PSOE",21
47,"47071",417,348,344,2,4,"PSOE",38
47,"47006",190,145,144,1,1,"PSOE",30
47,"47084",1171,911,898,15,13,"PSOE",282
47,"47127",135,98,96,1,2,"PSOE",14
47,"47100",140,119,117,2,2,"PSOE",41
47,"47034",76,59,58,1,1,"PSOE",10
47,"47002",25,23,23,0,0,"PSOE",2
47,"47140",119,101,100,1,1,"PSOE",21
47,"47226",161,128,127,1,1,"PSOE",54
47,"47111",1009,794,789,4,5,"PSOE",248
47,"47048",190,140,138,0,2,"PSOE",20
47,"47219",42,36,34,2,2,"PSOE",15
47,"47165",6987,5301,5115,63,186,"PSOE",687
47,"47086",3926,3065,3028,27,37,"PSOE",1020
47,"47217",1896,1436,1420,20,16,"PSOE",298
47,"47063",101,82,81,2,1,"PSOE",8
47,"47141",134,102,101,1,1,"PSOE",17
47,"47198",66,47,47,0,0,"PSOE",9
47,"47076",17375,13778,13684,111,94,"PSOE",2844
47,"47206",95,81,81,0,0,"PSOE",29
47,"47203",67,54,54,0,0,"PSOE",6
47,"47011",568,469,464,1,5,"PSOE",109
47,"47157",515,442,441,3,1,"PSOE",127
47,"47146",260,205,204,1,1,"PSOE",63
47,"47223",158,129,125,3,4,"PSOE",38
47,"47060",262,218,214,0,4,"PSOE",45
47,"47039",188,149,148,1,1,"PSOE",68
47,"47209",42,30,30,1,0,"PSOE",2
47,"47012",118,95,95,0,0,"PSOE",19
47,"47208",59,38,37,3,1,"PSOE",2
47,"47093",817,654,642,9,12,"PSOE",146
47,"47186",246602,193774,192412,1384,1362,"PSOE",40626
47,"47145",611,451,449,4,2,"PSOE",55
47,"47031",186,145,144,1,1,"PSOE",32
47,"47177",107,78,76,0,2,"PSOE",18
47,"47192",105,80,79,1,1,"PSOE",12
47,"47074",150,125,125,1,0,"PSOE",44
47,"47142",148,114,113,0,1,"PSOE",25
47,"47184",576,463,462,2,1,"PSOE",76
47,"47114",4074,2868,2826,20,42,"PSOE",679
47,"47148",439,336,335,2,1,"PSOE",84
47,"47083",80,62,61,2,1,"PSOE",4
47,"47095",39,36,35,0,1,"PSOE",3
47,"47028",33,20,20,0,0,"PSOE",2
47,"47215",54,47,46,1,1,"PSOE",5
47,"47023",2999,2457,2445,20,12,"PSOE",360
47,"47096",135,108,107,2,1,"PSOE",26
47,"47062",163,131,131,0,0,"PSOE",7
47,"47005",548,426,421,4,5,"PSOE",110
47,"47016",71,58,57,0,1,"PSOE",13
47,"47025",120,97,97,2,0,"PSOE",21
47,"47050",3757,2829,2812,29,17,"PSOE",645
47,"47187",89,57,56,2,1,"PSOE",7
47,"47013",99,74,73,0,1,"PSOE",32
47,"47205",385,281,274,7,7,"PSOE",43
47,"47021",76,65,65,1,0,"PSOE",13
47,"47045",768,586,580,0,6,"PSOE",198
47,"47130",99,78,78,1,0,"PSOE",12
47,"47200",82,64,64,1,0,"PSOE",3
47,"47098",583,488,487,6,1,"PSOE",98
47,"47092",110,93,92,0,1,"PSOE",12
47,"47220",166,124,124,1,0,"PSOE",21
47,"47022",57,50,46,0,4,"PSOE",3
47,"47007",3748,2869,2835,24,34,"PSOE",556
47,"47121",553,436,428,5,8,"PSOE",184
47,"47019",86,67,65,1,2,"PSOE",11
47,"47033",199,154,153,3,1,"PSOE",31
47,"47194",301,242,239,1,3,"PSOE",38
47,"47036",229,184,179,2,5,"PSOE",59
47,"47101",1720,1404,1388,10,16,"PSOE",500
47,"47124",399,329,328,4,1,"PSOE",92
47,"47059",97,71,71,0,0,"PSOE",10
47,"47151",27,22,21,0,1,"PSOE",1
2,"2013",132,105,104,0,1,"PCPE",0
2,"2061",641,534,530,7,4,"PCPE",1
2,"2079",2887,2312,2285,24,27,"PCPE",3
2,"2031",574,447,440,1,7,"PCPE",0
2,"2070",411,337,330,1,7,"PCPE",0
2,"2071",1056,890,884,7,6,"PCPE",0
2,"2046",1135,936,917,15,19,"PCPE",1
2,"2033",1920,1551,1518,6,33,"PCPE",1
2,"2073",4914,3777,3730,42,47,"PCPE",1
2,"2059",317,242,241,0,1,"PCPE",0
2,"2021",1037,823,816,3,7,"PCPE",0
2,"2045",3706,3046,3009,17,37,"PCPE",4
2,"2034",1395,1131,1126,10,5,"PCPE",0
2,"2060",1302,1007,1003,8,4,"PCPE",0
2,"2055",1157,757,753,9,4,"PCPE",0
2,"2053",2996,2370,2332,15,38,"PCPE",2
2,"2011",643,517,515,0,2,"PCPE",0
2,"2008",1227,923,909,9,14,"PCPE",1
2,"2012",1833,1595,1575,17,20,"PCPE",0
2,"2025",7502,5918,5785,41,133,"PCPE",2
2,"2027",310,251,251,0,0,"PCPE",0
2,"2042",850,698,693,2,5,"PCPE",0
2,"2026",847,705,697,7,8,"PCPE",0
2,"2022",368,279,278,0,1,"PCPE",0
2,"2067",1189,909,896,4,13,"PCPE",2
2,"2024",3416,2694,2666,33,28,"PCPE",3
2,"2068",343,265,262,2,3,"PCPE",2
2,"2041",350,274,272,1,2,"PCPE",0
2,"2007",1050,824,811,7,13,"PCPE",0
2,"2077",55,41,41,0,0,"PCPE",0
2,"2036",96,72,72,1,0,"PCPE",0
2,"2076",334,269,268,3,1,"PCPE",0
2,"2050",103,87,87,0,0,"PCPE",0
2,"2064",379,317,316,1,1,"PCPE",0
2,"2001",660,521,510,4,11,"PCPE",0
2,"2083",217,194,194,0,0,"PCPE",0
2,"2009",19686,14909,14719,148,190,"PCPE",12
2,"2029",3306,2563,2533,17,30,"PCPE",6
2,"2035",1989,1607,1582,13,25,"PCPE",0
2,"2003",131959,101091,100433,730,658,"PCPE",154
2,"2054",390,305,302,3,3,"PCPE",0
2,"2040",586,507,505,1,2,"PCPE",0
2,"2004",621,504,500,5,4,"PCPE",0
2,"2044",1128,806,798,2,8,"PCPE",0
2,"2018",832,670,663,5,7,"PCPE",0
2,"2019",2412,1991,1959,13,32,"PCPE",3
2,"2072",1560,1118,1098,4,20,"PCPE",2
2,"2039",1002,824,819,8,5,"PCPE",0
2,"2038",284,230,230,1,0,"PCPE",0
2,"2028",132,103,102,0,1,"PCPE",0
2,"2052",473,399,398,3,1,"PCPE",0
2,"2043",1250,1020,1006,8,14,"PCPE",0
2,"2056",1729,1348,1323,10,25,"PCPE",0
2,"2078",922,698,691,6,7,"PCPE",1
2,"2062",414,324,319,0,5,"PCPE",0
2,"2066",238,206,205,1,1,"PCPE",1
2,"2014",368,300,295,1,5,"PCPE",0
2,"2049",838,610,607,3,3,"PCPE",0
2,"2030",3059,2405,2377,11,28,"PCPE",3
2,"2005",568,441,434,4,7,"PCPE",1
2,"2081",18334,14121,13932,116,189,"PCPE",10
2,"2017",845,611,607,1,4,"PCPE",0
2,"2047",120,91,90,0,1,"PCPE",0
2,"2048",1251,1013,1004,9,9,"PCPE",0
2,"2063",1471,1161,1156,6,5,"PCPE",0
2,"2075",1684,1406,1397,10,9,"PCPE",2
2,"2065",475,403,402,2,1,"PCPE",0
2,"2020",451,381,376,3,5,"PCPE",0
2,"2023",576,479,468,2,11,"PCPE",0
2,"2074",5998,4415,4363,20,52,"PCPE",3
2,"2015",1444,1196,1179,7,17,"PCPE",0
2,"2084",325,228,221,2,7,"PCPE",0
2,"2058",348,244,239,2,5,"PCPE",0
2,"2016",581,445,441,0,4,"PCPE",0
2,"2069",11544,8969,8824,62,145,"PCPE",7
2,"2086",2603,1797,1783,8,14,"PCPE",0
2,"2006",588,482,476,2,6,"PCPE",1
2,"2080",532,419,410,0,9,"PCPE",0
2,"2057",2043,1593,1568,24,25,"PCPE",0
2,"2051",1690,1227,1211,12,16,"PCPE",0
2,"2037",22886,15400,15266,111,134,"PCPE",17
2,"2010",1798,1491,1463,10,28,"PCPE",0
2,"2002",494,406,397,0,9,"PCPE",0
2,"2032",281,217,216,1,1,"PCPE",0
2,"2085",321,268,266,4,2,"PCPE",0
2,"2082",105,88,88,1,0,"PCPE",0
2,"2901",2202,1571,1563,16,8,"PCPE",0
5,"5015",87,66,65,1,1,"PP",25
5,"5216",224,155,155,2,0,"PP",95
5,"5239",207,163,162,1,1,"PP",78
5,"5057",2470,1977,1953,14,24,"PP",780
5,"5083",145,108,100,2,8,"PP",59
5,"5214",38,27,26,0,1,"PP",9
5,"5120",35,26,26,0,0,"PP",15
5,"5148",27,17,17,0,0,"PP",10
5,"5090",84,69,68,1,1,"PP",37
5,"5082",528,437,427,5,10,"PP",219
5,"5096",79,57,57,0,0,"PP",18
5,"5002",1954,1471,1450,9,21,"PP",527
5,"5121",241,186,185,3,1,"PP",83
5,"5245",348,293,288,0,5,"PP",135
5,"5135",425,325,322,1,3,"PP",185
5,"5155",52,37,37,0,0,"PP",13
5,"5154",36,30,30,0,0,"PP",17
5,"5101",316,240,238,1,2,"PP",148
5,"5213",101,83,83,0,0,"PP",53
5,"5151",93,70,70,1,0,"PP",42
5,"5045",95,70,70,0,0,"PP",46
5,"5132",992,678,672,2,6,"PP",324
5,"5206",29,22,21,0,1,"PP",5
5,"5049",399,301,291,1,10,"PP",112
5,"5061",253,198,196,4,2,"PP",55
5,"5017",85,75,75,0,0,"PP",44
5,"5207",697,553,548,0,5,"PP",232
5,"5078",115,100,99,3,1,"PP",63
5,"5181",43,31,31,1,0,"PP",18
5,"5067",83,66,59,1,7,"PP",32
5,"5232",98,83,81,1,2,"PP",48
5,"5039",56,43,42,0,1,"PP",27
5,"5211",465,375,373,2,2,"PP",215
5,"5193",194,163,163,1,0,"PP",88
5,"5219",39,28,28,0,0,"PP",16
5,"5225",372,316,315,5,1,"PP",183
5,"5188",45,38,38,0,0,"PP",25
5,"5094",140,110,110,0,0,"PP",79
5,"5252",64,45,45,0,0,"PP",36
5,"5047",4199,3287,3244,7,43,"PP",1200
5,"5170",52,46,46,0,0,"PP",21
5,"5070",32,26,26,0,0,"PP",10
5,"5257",140,98,98,0,0,"PP",40
5,"5143",66,55,55,1,0,"PP",30
5,"5044",259,180,180,0,0,"PP",138
5,"5190",55,42,42,2,0,"PP",20
5,"5052",99,89,88,0,1,"PP",62
5,"5116",118,95,93,1,2,"PP",67
5,"5191",126,104,104,1,0,"PP",36
5,"5183",140,114,113,1,1,"PP",84
5,"5055",576,476,467,0,9,"PP",241
5,"5141",95,86,86,2,0,"PP",50
5,"5158",371,289,287,1,2,"PP",163
5,"5076",481,401,387,5,14,"PP",177
5,"5171",73,58,57,2,1,"PP",39
5,"5221",353,270,264,3,6,"PP",95
5,"5127",650,539,535,4,4,"PP",253
5,"5013",876,733,723,2,10,"PP",272
5,"5108",51,30,30,0,0,"PP",11
5,"5222",159,126,126,0,0,"PP",72
5,"5133",67,55,55,1,0,"PP",25
5,"5147",162,119,116,0,3,"PP",75
5,"5905",214,150,150,1,0,"PP",96
5,"5224",106,87,86,0,1,"PP",50
5,"5014",5422,4137,4084,30,53,"PP",1594
5,"5161",586,483,473,2,10,"PP",248
5,"5128",350,289,284,4,5,"PP",88
5,"5204",611,473,471,1,2,"PP",212
5,"5159",254,175,174,2,1,"PP",134
5,"5180",88,68,68,1,0,"PP",55
5,"5092",155,120,120,0,0,"PP",74
5,"5194",138,122,121,5,1,"PP",55
5,"5007",113,74,74,1,0,"PP",62
5,"5174",69,55,55,1,0,"PP",31
5,"5149",105,76,75,0,1,"PP",45
5,"5035",107,84,84,1,0,"PP",36
5,"5118",84,57,57,0,0,"PP",38
5,"5227",373,250,248,0,2,"PP",104
5,"5246",60,42,42,0,0,"PP",26
5,"5113",78,58,58,1,0,"PP",34
5,"5265",82,70,70,0,0,"PP",35
5,"5230",65,56,54,1,2,"PP",39
5,"5024",231,169,163,5,6,"PP",76
5,"5144",79,62,60,2,2,"PP",31
5,"5021",1932,1478,1456,12,22,"PP",689
5,"5195",224,162,161,1,1,"PP",77
5,"5262",358,278,277,1,1,"PP",111
5,"5022",1611,1279,1271,4,8,"PP",812
5,"5175",159,130,130,0,0,"PP",65
5,"5058",78,55,55,2,0,"PP",27
5,"5074",693,543,540,1,3,"PP",280
5,"5235",124,111,110,1,1,"PP",51
5,"5122",144,115,113,1,2,"PP",67
5,"5041",1001,772,765,10,7,"PP",417
5,"5124",107,83,81,1,2,"PP",56
5,"5102",1807,1431,1412,7,19,"PP",710
5,"5085",38,29,29,0,0,"PP",23
5,"5240",3393,2354,2335,9,19,"PP",1108
5,"5172",123,104,102,2,2,"PP",51
5,"5236",128,85,84,0,1,"PP",34
5,"5177",160,128,128,1,0,"PP",43
5,"5254",196,166,166,0,0,"PP",81
5,"5152",690,561,558,3,3,"PP",350
5,"5056",96,73,73,0,0,"PP",44
5,"5129",129,78,78,0,0,"PP",55
5,"5086",82,66,64,1,2,"PP",48
5,"5125",57,45,44,0,1,"PP",27
5,"5215",169,126,122,2,4,"PP",72
5,"5139",76,66,66,0,0,"PP",39
5,"5256",116,92,92,1,0,"PP",40
5,"5043",84,67,67,0,0,"PP",28
5,"5126",70,59,59,0,0,"PP",45
5,"5162",87,60,60,2,0,"PP",20
5,"5087",137,93,93,0,0,"PP",59
5,"5229",84,67,67,0,0,"PP",46
5,"5130",95,82,82,0,0,"PP",28
5,"5036",123,97,97,0,0,"PP",74
5,"5054",1238,953,933,1,20,"PP",355
5,"5072",87,70,69,1,1,"PP",49
5,"5019",44606,34903,34564,285,339,"PP",14125
5,"5242",681,538,527,10,11,"PP",374
5,"5178",371,295,289,0,6,"PP",178
5,"5040",68,45,45,0,0,"PP",31
5,"5123",96,69,66,2,3,"PP",35
5,"5030",46,37,37,0,0,"PP",6
5,"5179",215,184,180,0,4,"PP",143
5,"5243",88,61,61,1,0,"PP",33
5,"5012",135,110,108,0,2,"PP",68
5,"5088",33,24,24,0,0,"PP",16
5,"5160",323,263,260,1,3,"PP",182
5,"5100",285,229,228,0,1,"PP",92
5,"5001",194,153,152,1,1,"PP",80
5,"5231",160,126,124,1,2,"PP",66
5,"5089",478,377,365,0,12,"PP",179
5,"5037",261,165,163,3,2,"PP",105
5,"5138",311,241,239,3,2,"PP",154
5,"5077",161,137,136,2,1,"PP",68
5,"5142",104,88,82,1,6,"PP",50
5,"5244",51,38,38,0,0,"PP",27
5,"5218",121,97,95,0,2,"PP",55
5,"5200",49,28,28,0,0,"PP",17
5,"5063",34,24,24,0,0,"PP",21
5,"5029",123,92,89,0,3,"PP",56
5,"5016",6335,4873,4775,39,98,"PP",2353
5,"5033",174,139,138,0,1,"PP",93
5,"5264",62,43,42,1,1,"PP",19
5,"5027",269,220,218,2,2,"PP",107
5,"5201",529,439,431,2,8,"PP",220
5,"5060",120,99,99,1,0,"PP",66
5,"5153",108,78,77,3,1,"PP",41
5,"5069",74,58,58,0,0,"PP",43
5,"5260",104,84,83,1,1,"PP",53
5,"5220",382,298,294,1,4,"PP",168
5,"5165",380,291,283,5,8,"PP",121
5,"5134",48,40,40,0,0,"PP",30
5,"5066",458,365,364,3,1,"PP",105
5,"5099",497,398,381,3,17,"PP",152
5,"5168",3565,2740,2711,17,29,"PP",1271
5,"5064",103,87,87,1,0,"PP",67
5,"5131",105,70,69,1,1,"PP",52
5,"5079",70,54,54,0,0,"PP",35
5,"5182",801,559,546,9,13,"PP",297
5,"5048",120,104,103,0,1,"PP",57
5,"5258",113,98,97,0,1,"PP",44
5,"5205",75,58,58,0,0,"PP",33
5,"5238",787,565,556,4,9,"PP",244
5,"5080",59,42,40,0,2,"PP",22
5,"5209",83,63,63,0,0,"PP",45
5,"5034",15,12,12,1,0,"PP",5
5,"5186",1572,1240,1222,9,18,"PP",617
5,"5062",184,155,154,2,1,"PP",97
5,"5167",265,209,199,0,10,"PP",58
5,"5046",45,38,38,1,0,"PP",20
5,"5903",157,108,107,0,1,"PP",40
5,"5263",172,137,137,0,0,"PP",93
5,"5259",125,107,106,3,1,"PP",63
5,"5184",250,197,192,0,5,"PP",102
5,"5042",155,126,125,0,1,"PP",88
5,"5081",39,33,31,0,2,"PP",23
5,"5210",85,72,72,1,0,"PP",49
5,"5103",78,56,56,0,0,"PP",39
5,"5166",188,135,134,1,1,"PP",89
5,"5110",721,559,552,3,7,"PP",221
5,"5241",3081,2143,2115,17,28,"PP",924
5,"5097",474,324,317,3,7,"PP",155
5,"5189",443,340,336,3,4,"PP",163
5,"5059",109,79,76,1,3,"PP",30
5,"5228",179,126,126,0,0,"PP",109
5,"5008",227,180,176,2,4,"PP",92
5,"5212",233,157,155,1,2,"PP",104
5,"5018",29,21,21,0,0,"PP",9
5,"5251",68,40,40,0,0,"PP",24
5,"5169",226,178,176,1,2,"PP",123
5,"5105",349,279,270,3,9,"PP",91
5,"5163",1756,1351,1345,1,6,"PP",653
5,"5112",97,72,70,1,2,"PP",38
5,"5196",53,39,39,0,0,"PP",11
5,"5237",164,131,126,1,5,"PP",101
5,"5187",1755,1409,1395,11,14,"PP",535
5,"5038",116,87,85,0,2,"PP",69
5,"5073",297,243,238,4,5,"PP",142
5,"5053",86,58,58,0,0,"PP",41
5,"5106",36,27,27,0,0,"PP",15
5,"5247",250,147,146,1,1,"PP",78
5,"5093",417,313,311,1,2,"PP",157
5,"5115",532,392,386,2,6,"PP",224
5,"5226",77,57,57,0,0,"PP",49
5,"5904",133,92,91,1,1,"PP",52
5,"5109",454,378,362,3,16,"PP",191
5,"5233",226,179,177,0,2,"PP",112
5,"5173",60,45,45,0,0,"PP",27
5,"5234",51,46,46,1,0,"PP",31
5,"5104",34,23,22,1,1,"PP",12
5,"5176",234,190,187,2,3,"PP",87
5,"5136",97,74,73,5,1,"PP",32
5,"5253",88,70,70,0,0,"PP",43
5,"5164",27,19,19,1,0,"PP",12
5,"5217",58,45,45,0,0,"PP",33
5,"5156",249,163,161,0,2,"PP",82
5,"5249",107,82,82,0,0,"PP",24
5,"5198",73,59,59,0,0,"PP",43
5,"5084",74,56,56,1,0,"PP",28
5,"5199",39,32,32,0,0,"PP",25
5,"5051",181,152,147,3,5,"PP",74
5,"5267",100,65,64,0,1,"PP",25
5,"5901",273,187,185,5,2,"PP",94
5,"5157",240,170,167,1,3,"PP",75
5,"5010",149,119,118,1,1,"PP",82
5,"5114",1359,1131,1115,5,16,"PP",425
5,"5266",102,89,89,0,0,"PP",66
5,"5107",64,39,39,1,0,"PP",29
5,"5902",288,227,227,0,0,"PP",124
5,"5065",469,388,385,6,3,"PP",204
5,"5192",100,82,81,1,1,"PP",40
5,"5140",116,97,96,0,1,"PP",67
5,"5005",187,150,149,0,1,"PP",65
5,"5117",201,178,174,2,4,"PP",124
5,"5075",107,67,67,0,0,"PP",37
5,"5185",94,80,80,1,0,"PP",52
5,"5261",42,26,26,0,0,"PP",20
5,"5208",40,34,34,0,0,"PP",19
5,"5026",197,170,169,1,1,"PP",93
5,"5145",52,41,41,0,0,"PP",23
5,"5197",98,90,90,0,0,"PP",52
5,"5023",173,153,153,5,0,"PP",90
5,"5119",33,20,20,0,0,"PP",14
5,"5095",266,220,218,0,2,"PP",119
5,"5025",96,73,72,1,1,"PP",55
10,"10185",572,433,427,5,6,"PSOE",179
10,"10024",687,538,533,6,5,"PSOE",108
10,"10076",820,608,595,3,13,"PSOE",262
10,"10068",746,601,586,3,15,"PSOE",205
10,"10152",470,361,357,3,4,"PSOE",154
10,"10026",646,507,494,5,13,"PSOE",149
10,"10018",1722,1255,1240,6,15,"PSOE",631
10,"10193",1421,1150,1130,10,20,"PSOE",342
10,"10031",167,138,137,1,1,"PSOE",41
10,"10213",571,483,478,1,5,"PSOE",180
10,"10129",363,272,266,4,6,"PSOE",114
10,"10038",86,70,70,0,0,"PSOE",22
10,"10058",1025,747,737,5,10,"PSOE",348
10,"10134",565,395,393,1,2,"PSOE",134
10,"10100",795,602,595,4,7,"PSOE",280
10,"10098",385,294,286,0,8,"PSOE",85
10,"10146",1509,1018,1004,4,14,"PSOE",427
10,"10138",544,445,437,2,8,"PSOE",219
10,"10095",350,269,267,1,2,"PSOE",121
10,"10055",719,554,546,3,8,"PSOE",125
10,"10048",245,163,161,1,2,"PSOE",36
10,"10047",972,783,777,1,6,"PSOE",349
10,"10002",368,278,275,0,3,"PSOE",108
10,"10189",2656,2006,1971,10,35,"PSOE",785
10,"10136",318,234,234,4,0,"PSOE",85
10,"10165",259,212,209,0,3,"PSOE",77
10,"10156",96,71,70,1,1,"PSOE",31
10,"10108",218,122,120,0,2,"PSOE",39
10,"10205",2034,1413,1386,5,27,"PSOE",571
10,"10169",544,430,423,0,7,"PSOE",147
10,"10056",591,456,452,5,4,"PSOE",184
10,"10904",750,522,520,5,2,"PSOE",188
10,"10061",1664,1143,1131,8,12,"PSOE",561
10,"10201",176,146,145,0,1,"PSOE",67
10,"10063",179,145,145,1,0,"PSOE",41
10,"10067",10486,7796,7692,54,104,"PSOE",2527
10,"10145",126,101,100,1,1,"PSOE",52
10,"10139",111,84,83,0,1,"PSOE",29
10,"10085",335,248,244,1,4,"PSOE",74
10,"10080",368,276,272,1,4,"PSOE",124
10,"10195",7768,5818,5723,58,95,"PSOE",1672
10,"10154",184,138,134,1,4,"PSOE",53
10,"10183",993,763,761,4,2,"PSOE",306
10,"10120",176,125,125,2,0,"PSOE",34
10,"10196",306,234,233,1,1,"PSOE",93
10,"10083",90,69,69,0,0,"PSOE",12
10,"10197",134,94,93,0,1,"PSOE",31
10,"10128",5752,4219,4146,39,73,"PSOE",1719
10,"10014",1874,1430,1401,11,29,"PSOE",605
10,"10084",1370,934,906,7,28,"PSOE",378
10,"10116",3784,2839,2801,21,38,"PSOE",1103
10,"10071",144,100,100,2,0,"PSOE",41
10,"10150",354,301,295,4,6,"PSOE",169
10,"10065",205,154,154,1,0,"PSOE",60
10,"10001",285,226,225,2,1,"PSOE",114
10,"10161",75,53,53,0,0,"PSOE",21
10,"10125",903,648,638,2,10,"PSOE",285
10,"10088",205,117,117,0,0,"PSOE",28
10,"10903",819,629,624,7,5,"PSOE",288
10,"10149",435,315,307,1,8,"PSOE",105
10,"10079",901,703,695,2,8,"PSOE",212
10,"10092",301,238,236,2,2,"PSOE",129
10,"10902",730,546,536,2,10,"PSOE",261
10,"10005",537,411,398,3,13,"PSOE",161
10,"10192",841,592,584,0,8,"PSOE",212
10,"10200",417,308,305,0,3,"PSOE",139
10,"10034",350,263,262,1,1,"PSOE",117
10,"10104",5169,3766,3703,21,63,"PSOE",1185
10,"10158",335,252,251,0,1,"PSOE",159
10,"10008",1331,1052,1047,6,5,"PSOE",381
10,"10110",2298,1682,1638,10,44,"PSOE",522
10,"10044",1451,1100,1087,7,13,"PSOE",548
10,"10102",531,413,410,4,3,"PSOE",203
10,"10007",646,488,478,3,10,"PSOE",175
10,"10062",413,345,341,3,4,"PSOE",171
10,"10054",545,427,426,6,1,"PSOE",163
10,"10046",201,176,173,2,3,"PSOE",71
10,"10006",1275,1024,1004,7,20,"PSOE",484
10,"10010",2322,1446,1431,12,15,"PSOE",655
10,"10186",994,830,816,4,14,"PSOE",335
10,"10174",175,141,139,0,2,"PSOE",49
10,"10176",374,274,268,1,6,"PSOE",119
10,"10188",500,381,373,2,8,"PSOE",183
10,"10184",778,620,610,6,10,"PSOE",209
10,"10009",270,173,170,1,3,"PSOE",73
10,"10091",378,304,304,0,0,"PSOE",95
10,"10016",329,262,259,1,3,"PSOE",110
10,"10050",1062,853,846,5,7,"PSOE",337
10,"10041",1056,823,811,4,12,"PSOE",323
10,"10053",289,231,224,1,7,"PSOE",84
10,"10155",1140,856,842,3,14,"PSOE",321
10,"10089",1376,1004,988,2,16,"PSOE",496
10,"10107",1033,825,815,11,10,"PSOE",371
10,"10123",585,480,468,1,12,"PSOE",247
10,"10217",533,431,427,1,4,"PSOE",149
10,"10096",3443,2503,2464,14,39,"PSOE",927
10,"10209",296,195,193,1,2,"PSOE",93
10,"10218",1143,828,814,2,14,"PSOE",444
10,"10043",814,594,590,2,4,"PSOE",280
10,"10019",1510,1134,1121,8,13,"PSOE",330
10,"10148",32985,23666,23394,189,272,"PSOE",6484
10,"10124",862,692,678,7,14,"PSOE",323
10,"10164",742,513,508,1,5,"PSOE",224
10,"10204",442,345,342,5,3,"PSOE",94
10,"10135",1329,981,958,1,23,"PSOE",412
10,"10066",158,128,127,1,1,"PSOE",52
10,"10142",824,620,616,5,4,"PSOE",278
10,"10122",231,166,163,0,3,"PSOE",57
10,"10003",557,401,396,2,5,"PSOE",126
10,"10130",1761,1322,1308,5,14,"PSOE",547
10,"10162",579,483,476,0,7,"PSOE",244
10,"10203",4600,3268,3215,14,53,"PSOE",1152
10,"10094",232,203,203,3,0,"PSOE",116
10,"10190",561,401,397,2,4,"PSOE",162
10,"10082",1893,1528,1484,13,44,"PSOE",638
10,"10199",166,120,119,3,1,"PSOE",39
10,"10143",158,121,121,0,0,"PSOE",61
10,"10030",477,316,304,1,12,"PSOE",111
10,"10052",193,127,126,1,1,"PSOE",20
10,"10004",713,551,543,1,8,"PSOE",266
10,"10163",356,302,299,1,3,"PSOE",109
10,"10013",282,228,223,2,5,"PSOE",78
10,"10180",4159,2765,2734,12,31,"PSOE",971
10,"10115",3578,2857,2811,20,46,"PSOE",949
10,"10901",1184,851,835,2,16,"PSOE",308
10,"10131",12850,9036,8977,44,59,"PSOE",2383
10,"10179",301,247,247,0,0,"PSOE",80
10,"10112",1583,1203,1176,7,27,"PSOE",450
10,"10140",1114,860,848,6,12,"PSOE",296
10,"10212",1691,1303,1280,8,23,"PSOE",434
10,"10037",76403,58422,57811,329,611,"PSOE",13187
10,"10151",213,163,161,0,2,"PSOE",72
10,"10141",268,190,189,2,1,"PSOE",81
10,"10109",1804,1233,1212,2,21,"PSOE",472
10,"10170",263,204,202,2,2,"PSOE",66
10,"10042",85,70,70,0,0,"PSOE",29
10,"10182",129,95,95,0,0,"PSOE",28
10,"10210",551,380,373,1,7,"PSOE",205
10,"10022",435,371,366,1,5,"PSOE",150
10,"10059",369,258,255,0,3,"PSOE",146
10,"10157",273,209,205,1,4,"PSOE",58
10,"10214",208,172,170,0,2,"PSOE",48
10,"10093",406,333,324,2,9,"PSOE",193
10,"10147",1275,985,937,6,48,"PSOE",433
10,"10070",720,548,540,0,8,"PSOE",186
10,"10033",430,304,301,1,3,"PSOE",130
10,"10045",1031,786,781,11,5,"PSOE",316
10,"10057",150,112,111,0,1,"PSOE",64
10,"10060",973,620,607,5,13,"PSOE",252
10,"10160",225,172,170,0,2,"PSOE",96
10,"10072",862,644,639,2,5,"PSOE",342
10,"10081",179,133,129,0,4,"PSOE",35
10,"10106",134,111,111,1,0,"PSOE",45
10,"10036",327,247,244,2,3,"PSOE",120
10,"10207",502,352,349,5,3,"PSOE",132
10,"10167",306,240,237,0,3,"PSOE",106
10,"10168",320,240,237,0,3,"PSOE",98
10,"10905",651,458,456,0,2,"PSOE",148
10,"10187",443,316,311,1,5,"PSOE",114
10,"10027",78,66,66,0,0,"PSOE",34
10,"10077",689,511,504,2,7,"PSOE",204
10,"10023",846,647,637,1,10,"PSOE",352
10,"10101",185,147,147,1,0,"PSOE",59
10,"10216",1543,1200,1192,9,8,"PSOE",454
10,"10111",1364,995,978,9,17,"PSOE",347
10,"10099",592,417,413,7,4,"PSOE",208
10,"10021",5198,3960,3878,40,82,"PSOE",1636
10,"10132",400,258,256,0,2,"PSOE",150
10,"10075",256,178,177,1,1,"PSOE",59
10,"10177",1703,1331,1296,10,35,"PSOE",465
10,"10166",307,220,219,0,1,"PSOE",65
10,"10153",318,238,231,3,7,"PSOE",55
10,"10078",414,325,319,3,6,"PSOE",128
10,"10090",522,386,382,5,4,"PSOE",155
10,"10097",106,79,79,0,0,"PSOE",26
10,"10015",687,500,491,2,9,"PSOE",178
10,"10133",1210,1007,989,2,18,"PSOE",611
10,"10178",781,567,562,1,5,"PSOE",181
10,"10173",581,432,426,4,6,"PSOE",146
10,"10181",694,571,558,7,13,"PSOE",255
10,"10137",399,344,343,4,1,"PSOE",164
10,"10035",1880,1390,1372,6,18,"PSOE",646
10,"10028",98,72,71,0,1,"PSOE",28
10,"10114",968,721,711,4,10,"PSOE",344
10,"10215",442,320,320,0,0,"PSOE",158
10,"10117",260,127,127,0,0,"PSOE",78
10,"10194",536,441,433,5,8,"PSOE",134
10,"10073",715,536,530,3,6,"PSOE",227
10,"10191",532,417,415,12,2,"PSOE",120
10,"10127",4724,3529,3463,15,66,"PSOE",1218
10,"10017",841,606,589,4,17,"PSOE",229
10,"10029",418,345,341,1,4,"PSOE",183
10,"10087",1701,1233,1215,7,18,"PSOE",529
10,"10064",1490,1142,1119,9,23,"PSOE",485
10,"10175",1434,1054,1028,7,26,"PSOE",375
10,"10172",718,501,493,2,8,"PSOE",175
10,"10039",427,295,290,0,5,"PSOE",92
10,"10105",2519,1745,1714,11,31,"PSOE",599
10,"10119",630,461,455,2,6,"PSOE",199
10,"10069",831,647,637,2,10,"PSOE",265
10,"10198",1160,1022,1009,6,13,"PSOE",384
10,"10103",454,342,338,1,4,"PSOE",171
10,"10159",323,235,232,2,3,"PSOE",111
10,"10121",7970,5884,5816,33,68,"PSOE",2235
10,"10025",402,341,328,2,13,"PSOE",132
10,"10020",1619,1240,1214,9,26,"PSOE",567
10,"10208",124,100,98,1,2,"PSOE",54
10,"10171",340,262,261,1,1,"PSOE",145
10,"10202",621,495,478,2,17,"PSOE",192
10,"10012",599,494,489,1,5,"PSOE",241
10,"10219",1290,860,843,1,17,"PSOE",341
10,"10113",2354,1800,1778,20,22,"PSOE",712
10,"10011",570,450,443,2,7,"PSOE",261
10,"10086",329,259,256,1,3,"PSOE",94
10,"10144",996,755,748,3,7,"PSOE",286
10,"10206",212,161,160,3,1,"PSOE",58
10,"10032",1705,1296,1277,10,19,"PSOE",477
10,"10049",3849,3185,3111,27,74,"PSOE",1386
10,"10126",1572,1123,1107,3,16,"PSOE",451
10,"10051",440,318,314,1,4,"PSOE",127
10,"10211",454,352,339,2,13,"PSOE",173
10,"10118",289,257,257,1,0,"PSOE",119
10,"10040",443,344,342,4,2,"PSOE",140
6,"6001",696,526,521,1,5,"PP",215
6,"6014",6688,4651,4586,22,65,"PP",1941
6,"6082",382,312,306,3,6,"PP",88
6,"6901",2114,1648,1625,28,23,"PP",577
6,"6055",2058,1557,1527,21,30,"PP",605
6,"6149",10342,8013,7897,70,116,"PP",2643
6,"6042",1012,711,703,3,8,"PP",196
6,"6087",2127,1612,1592,16,20,"PP",567
6,"6096",226,188,182,1,6,"PP",101
6,"6002",4335,3084,3006,33,78,"PP",1063
6,"6033",1330,1037,1025,10,12,"PP",407
6,"6902",1672,1239,1224,6,15,"PP",384
6,"6123",4644,3420,3357,22,63,"PP",930
6,"6060",5798,4346,4261,23,85,"PP",1369
6,"6150",806,658,650,6,8,"PP",156
6,"6110",151,107,104,0,3,"PP",43
6,"6155",1890,1337,1315,15,22,"PP",352
6,"6137",987,811,805,4,6,"PP",226
6,"6083",46111,32608,32276,235,332,"PP",9754
6,"6003",830,656,647,6,9,"PP",200
6,"6124",1739,1309,1287,15,22,"PP",415
6,"6057",573,471,466,1,5,"PP",230
6,"6043",673,542,535,5,7,"PP",174
6,"6084",1100,857,842,4,15,"PP",378
6,"6138",1059,795,773,3,22,"PP",185
6,"6129",591,466,462,3,4,"PP",151
6,"6044",28899,20862,20681,153,181,"PP",7338
6,"6125",1754,1327,1304,7,23,"PP",493
6,"6004",1604,1265,1248,10,17,"PP",369
6,"6139",553,442,436,1,6,"PP",131
6,"6022",2660,2159,2140,12,19,"PP",647
6,"6098",545,408,402,1,6,"PP",138
6,"6085",3427,2563,2524,21,39,"PP",573
6,"6045",499,378,378,4,0,"PP",147
6,"6099",1148,768,749,5,19,"PP",198
6,"6058",2055,1512,1494,14,18,"PP",424
6,"6112",393,335,333,0,2,"PP",125
6,"6076",837,632,624,2,8,"PP",214
6,"6032",66,54,54,2,0,"PP",22
6,"6117",1417,1044,1031,3,13,"PP",454
6,"6126",2183,1594,1582,9,12,"PP",484
6,"6086",1233,884,874,3,10,"PP",298
6,"6127",2893,2188,2158,13,30,"PP",896
6,"6140",633,493,482,6,11,"PP",280
6,"6005",1717,1271,1258,10,13,"PP",292
6,"6019",2090,1519,1488,11,31,"PP",399
6,"6113",2725,2091,2054,9,37,"PP",671
6,"6010",1111,877,863,7,14,"PP",213
6,"6006",4595,3365,3318,27,47,"PP",820
6,"6078",510,414,407,1,7,"PP",234
6,"6118",206,165,164,1,1,"PP",56
6,"6047",855,664,654,2,10,"PP",233
6,"6029",1213,892,875,8,17,"PP",199
6,"6132",855,634,627,4,7,"PP",136
6,"6128",4445,3137,3116,36,21,"PP",1081
6,"6020",1822,1435,1406,12,29,"PP",502
6,"6146",1094,848,837,5,11,"PP",195
6,"6074",4814,3717,3659,37,58,"PP",1177
6,"6142",276,215,207,0,8,"PP",41
6,"6101",466,386,382,0,4,"PP",186
6,"6007",1483,1076,1068,6,8,"PP",259
6,"6021",928,668,656,9,12,"PP",343
6,"6088",12639,8992,8885,68,107,"PP",2890
6,"6048",848,716,700,0,16,"PP",264
6,"6008",634,562,558,1,4,"PP",154
6,"6030",172,138,138,0,0,"PP",64
6,"6062",612,450,441,4,9,"PP",175
6,"6039",1838,1546,1517,9,29,"PP",331
6,"6120",3393,2635,2600,14,35,"PP",850
6,"6157",453,316,315,0,1,"PP",142
6,"6053",607,459,450,2,9,"PP",95
6,"6130",195,174,170,0,4,"PP",49
6,"6089",598,491,488,3,3,"PP",173
6,"6009",206,156,156,1,0,"PP",58
6,"6090",877,661,642,7,19,"PP",215
6,"6144",562,450,447,3,3,"PP",111
6,"6103",4781,3519,3459,40,60,"PP",1125
6,"6067",1984,1408,1377,9,31,"PP",549
6,"6041",460,378,375,3,3,"PP",135
6,"6135",1103,904,888,9,16,"PP",405
6,"6131",1074,887,885,2,2,"PP",159
6,"6122",6651,4654,4553,29,101,"PP",1552
6,"6064",841,672,671,6,1,"PP",143
6,"6037",1768,1176,1160,5,16,"PP",480
6,"6050",4124,3178,3110,30,68,"PP",1291
6,"6091",3782,2728,2690,32,38,"PP",1086
6,"6145",916,717,711,9,6,"PP",264
6,"6069",3079,2164,2137,21,27,"PP",626
6,"6051",1573,1235,1222,6,13,"PP",512
6,"6114",148,116,116,0,0,"PP",31
6,"6079",645,502,488,1,14,"PP",177
6,"6066",1776,1260,1245,2,15,"PP",361
6,"6073",745,507,497,5,10,"PP",104
6,"6015",116673,82152,81388,677,764,"PP",32184
6,"6011",24721,17683,17506,172,177,"PP",7215
6,"6092",582,402,392,3,10,"PP",135
6,"6034",174,126,125,2,1,"PP",56
6,"6095",9493,6973,6839,97,134,"PP",1787
6,"6065",309,257,247,0,10,"PP",122
6,"6133",1775,1351,1334,9,17,"PP",518
6,"6052",4051,3071,3009,31,62,"PP",1355
6,"6093",4472,3476,3416,22,60,"PP",1208
6,"6106",428,295,293,2,2,"PP",97
6,"6054",5442,4185,4098,32,87,"PP",1623
6,"6036",5085,3797,3739,29,58,"PP",1198
6,"6035",957,700,690,4,10,"PP",354
6,"6012",3280,2358,2343,12,15,"PP",738
6,"6107",1591,1114,1107,4,7,"PP",289
6,"6018",761,543,539,3,4,"PP",131
6,"6134",545,325,323,3,2,"PP",124
6,"6071",247,208,203,0,5,"PP",76
6,"6161",315,236,231,1,5,"PP",74
6,"6026",837,632,623,2,9,"PP",271
6,"6148",973,739,730,5,9,"PP",172
6,"6013",265,230,224,1,6,"PP",37
6,"6094",1483,1025,1014,6,11,"PP",258
6,"6024",1181,955,942,5,13,"PP",373
6,"6160",3154,2324,2292,12,32,"PP",793
6,"6017",274,229,228,1,1,"PP",129
6,"6108",2299,1714,1683,13,31,"PP",508
6,"6027",681,586,576,1,10,"PP",274
6,"6162",2938,2278,2239,17,39,"PP",810
6,"6072",2334,1813,1792,20,21,"PP",682
6,"6059",1858,1361,1342,12,19,"PP",457
6,"6109",3957,3258,3177,22,81,"PP",914
6,"6068",453,349,344,3,5,"PP",117
6,"6046",1248,989,978,4,11,"PP",357
6,"6141",1741,1246,1223,13,23,"PP",449
6,"6105",631,448,443,0,5,"PP",149
6,"6156",1169,903,898,2,5,"PP",338
6,"6121",3383,2518,2483,21,35,"PP",905
6,"6056",481,401,399,2,2,"PP",144
6,"6111",507,360,359,2,1,"PP",88
6,"6102",1055,843,830,3,13,"PP",308
6,"6070",7753,5773,5645,52,128,"PP",1467
6,"6159",2339,1429,1407,14,22,"PP",301
6,"6016",2978,2258,2235,14,23,"PP",695
6,"6100",938,776,763,2,13,"PP",342
6,"6049",1021,747,733,2,14,"PP",280
6,"6116",1607,1168,1149,10,19,"PP",401
6,"6031",466,321,316,2,5,"PP",130
6,"6903",2017,1509,1475,11,34,"PP",529
6,"6075",477,401,389,2,12,"PP",87
6,"6025",5126,3833,3783,37,50,"PP",1072
6,"6147",362,285,281,0,4,"PP",51
6,"6061",1092,899,890,6,9,"PP",258
6,"6153",20417,15129,14934,112,195,"PP",5066
6,"6038",801,558,551,5,7,"PP",189
6,"6028",4253,3716,3631,30,85,"PP",1414
6,"6152",1322,964,951,1,13,"PP",295
6,"6023",4362,3200,3168,11,32,"PP",942
6,"6115",1260,867,853,7,14,"PP",290
6,"6063",3038,2413,2391,15,22,"PP",813
6,"6154",2798,2001,1975,17,26,"PP",735
6,"6097",2390,1814,1798,7,16,"PP",603
6,"6040",1002,758,754,4,4,"PP",200
6,"6080",1931,1498,1480,9,18,"PP",467
6,"6081",1078,850,839,4,11,"PP",208
6,"6119",701,519,514,1,5,"PP",187
6,"6136",1578,1182,1168,8,14,"PP",331
6,"6143",3338,2548,2508,23,40,"PP",614
6,"6158",13305,9965,9802,91,163,"PP",3149
6,"6151",1094,809,801,8,8,"PP",198
6,"6077",347,276,272,3,4,"PP",58
6,"6104",677,533,529,6,4,"PP",123
26,"26057",51,47,45,0,2,"PP",19
26,"26043",373,284,282,4,2,"PP",107
26,"26168",5318,3853,3802,36,51,"PP",1161
26,"26101",46,34,34,0,0,"PP",17
26,"26035",16,12,12,0,0,"PP",5
26,"26007",523,406,401,2,5,"PP",124
26,"26060",85,67,67,1,0,"PP",29
26,"26068",82,68,66,0,2,"PP",23
26,"26018",10469,8216,8110,71,106,"PP",2598
26,"26110",162,135,134,0,1,"PP",70
26,"26013",356,264,262,3,2,"PP",84
26,"26118",61,49,49,1,0,"PP",21
26,"26017",383,302,301,4,1,"PP",76
26,"26066",265,217,209,3,8,"PP",110
26,"26045",12,12,12,0,0,"PP",4
26,"26065",50,40,40,0,0,"PP",26
26,"26072",289,259,258,2,1,"PP",105
26,"26022",198,159,158,0,1,"PP",122
26,"26161",7,7,7,0,0,"PP",7
26,"26106",88,78,78,0,0,"PP",31
26,"26111",248,195,192,1,3,"PP",51
26,"26040",68,62,62,0,0,"PP",38
26,"26032",53,40,40,0,0,"PP",8
26,"26074",105,86,85,1,1,"PP",42
26,"26019",351,282,281,1,1,"PP",109
26,"26006",1809,1420,1410,14,10,"PP",588
26,"26121",27,21,21,0,0,"PP",10
26,"26128",104,80,79,0,1,"PP",29
26,"26016",28,24,24,1,0,"PP",11
26,"26178",80,64,63,1,1,"PP",22
26,"26115",17,14,14,0,0,"PP",10
26,"26008",1862,1442,1425,7,17,"PP",638
26,"26177",309,266,264,2,2,"PP",133
26,"26113",37,34,32,0,2,"PP",27
26,"26033",172,143,142,2,1,"PP",48
26,"26053",208,161,160,1,1,"PP",71
26,"26094",85,71,68,0,3,"PP",46
26,"26108",268,207,205,5,2,"PP",100
26,"26162",121,106,106,2,0,"PP",34
26,"26055",42,33,33,0,0,"PP",17
26,"26179",42,34,33,0,1,"PP",14
26,"26181",15,13,13,0,0,"PP",11
26,"26044",51,46,45,0,1,"PP",20
26,"26100",52,43,43,0,0,"PP",18
26,"26070",186,154,153,1,1,"PP",93
26,"26145",245,202,201,3,1,"PP",109
26,"26058",150,114,113,0,1,"PP",58
26,"26172",30,25,25,0,0,"PP",9
26,"26131",34,33,33,1,0,"PP",21
26,"26025",85,71,71,1,0,"PP",30
26,"26105",2187,1722,1696,16,26,"PP",574
26,"26079",639,536,527,2,9,"PP",299
26,"26096",244,199,197,3,2,"PP",77
26,"26063",122,97,96,0,1,"PP",53
26,"26049",174,127,121,0,6,"PP",65
26,"26075",334,268,264,2,4,"PP",109
26,"26099",1259,1038,1024,7,14,"PP",432
26,"26169",64,60,60,0,0,"PP",38
26,"26084",6630,5015,4952,27,63,"PP",1954
26,"26132",111,88,88,1,0,"PP",38
26,"26064",2278,1736,1715,17,21,"PP",625
26,"26155",162,138,137,0,1,"PP",55
26,"26080",475,392,388,6,4,"PP",223
26,"26031",106,81,81,0,0,"PP",36
26,"26125",2708,2013,1988,22,25,"PP",850
26,"26093",57,44,44,0,0,"PP",16
26,"26077",27,25,25,0,0,"PP",20
26,"26160",715,569,567,3,2,"PP",274
26,"26166",142,131,128,1,3,"PP",91
26,"26069",240,201,199,0,2,"PP",115
26,"26081",16,14,14,0,0,"PP",10
26,"26092",108,83,82,0,1,"PP",44
26,"26152",31,24,23,0,1,"PP",17
26,"26086",15,15,15,0,0,"PP",13
26,"26041",134,97,94,1,3,"PP",61
26,"26109",85,76,74,1,2,"PP",31
26,"26037",131,111,111,1,0,"PP",45
26,"26122",119,104,102,2,2,"PP",37
26,"26078",83,68,68,0,0,"PP",26
26,"26174",147,122,112,0,10,"PP",58
26,"26082",109,92,89,0,3,"PP",43
26,"26002",840,615,608,6,7,"PP",258
26,"26135",167,120,119,0,1,"PP",63
26,"26136",103,73,72,1,1,"PP",29
26,"26124",824,664,659,8,5,"PP",322
26,"26119",202,163,162,4,1,"PP",41
26,"26042",836,645,635,5,10,"PP",242
26,"26067",23,20,20,0,0,"PP",9
26,"26026",1323,1070,1060,8,10,"PP",528
26,"26034",660,522,513,1,9,"PP",189
26,"26123",130,111,108,0,3,"PP",57
26,"26083",289,213,213,1,0,"PP",102
26,"26071",8477,6115,6029,51,86,"PP",2001
26,"26051",254,202,201,2,1,"PP",104
26,"26142",780,618,613,1,5,"PP",269
26,"26164",61,41,41,0,0,"PP",16
26,"26089",110513,85146,84302,712,844,"PP",30202
26,"26087",208,157,154,4,3,"PP",82
26,"26023",468,358,355,4,3,"PP",171
26,"26091",166,141,138,0,3,"PP",102
26,"26012",23,23,23,0,0,"PP",15
26,"26130",203,167,166,1,1,"PP",88
26,"26103",789,626,616,3,10,"PP",274
26,"26036",16990,12136,11984,98,152,"PP",4796
26,"26129",971,768,757,2,11,"PP",349
26,"26020",483,356,344,2,12,"PP",178
26,"26052",158,125,125,0,0,"PP",69
26,"26134",87,65,65,1,0,"PP",40
26,"26004",68,53,53,1,0,"PP",39
26,"26061",1548,1179,1160,14,19,"PP",438
26,"26011",7336,5309,5255,57,54,"PP",2019
26,"26154",11,8,8,0,0,"PP",3
26,"26003",416,336,330,2,6,"PP",203
26,"26015",193,151,149,0,2,"PP",97
26,"26047",1969,1614,1596,14,18,"PP",694
26,"26029",37,31,31,0,0,"PP",19
26,"26144",194,150,148,2,2,"PP",106
26,"26126",31,29,29,0,0,"PP",21
26,"26021",2819,2113,2077,23,36,"PP",1029
26,"26005",2343,1607,1590,19,17,"PP",702
26,"26050",117,86,86,0,0,"PP",45
26,"26171",179,136,126,1,10,"PP",76
26,"26001",197,163,155,3,8,"PP",70
26,"26183",65,50,50,0,0,"PP",20
26,"26163",143,117,117,2,0,"PP",42
26,"26146",101,78,77,0,1,"PP",34
26,"26150",117,98,98,1,0,"PP",51
26,"26127",215,182,179,2,3,"PP",81
26,"26030",12,12,12,0,0,"PP",8
26,"26158",265,220,217,4,3,"PP",139
26,"26054",324,255,254,3,1,"PP",114
26,"26176",54,46,43,1,3,"PP",33
26,"26088",36,32,31,0,1,"PP",16
26,"26048",22,22,21,0,1,"PP",12
26,"26010",98,78,78,1,0,"PP",48
26,"26149",61,48,48,0,0,"PP",11
26,"26114",80,71,71,2,0,"PP",29
26,"26138",4600,3374,3325,28,49,"PP",1431
26,"26153",12,11,10,0,1,"PP",2
26,"26076",128,111,110,2,1,"PP",56
26,"26173",6,6,6,1,0,"PP",3
26,"26024",236,183,183,0,0,"PP",80
26,"26147",30,26,26,0,0,"PP",6
26,"26104",14,9,9,0,0,"PP",5
26,"26056",425,357,353,6,4,"PP",145
26,"26102",6128,4673,4585,42,88,"PP",1898
26,"26059",1117,850,840,9,10,"PP",372
26,"26170",448,346,344,8,2,"PP",181
26,"26095",101,78,77,1,1,"PP",21
26,"26175",52,44,44,2,0,"PP",22
26,"26073",98,83,83,0,0,"PP",30
26,"26148",171,147,145,0,2,"PP",50
26,"26046",1594,1221,1209,3,12,"PP",546
26,"26167",59,45,45,1,0,"PP",26
26,"26098",94,72,71,1,1,"PP",29
26,"26028",133,112,111,0,1,"PP",65
26,"26180",221,182,179,0,3,"PP",96
26,"26139",54,46,46,0,0,"PP",30
26,"26107",92,75,75,0,0,"PP",35
26,"26009",414,326,319,3,7,"PP",134
26,"26027",157,127,127,1,0,"PP",58
26,"26143",217,178,177,0,1,"PP",63
26,"26014",466,319,319,0,0,"PP",124
26,"26151",446,380,375,1,5,"PP",150
26,"26062",90,73,71,0,2,"PP",43
26,"26112",243,192,191,1,1,"PP",103
26,"26039",38,35,35,0,0,"PP",18
26,"26157",296,236,232,3,4,"PP",129
26,"26038",95,66,65,0,1,"PP",21
26,"26120",1457,1144,1133,9,11,"PP",505
26,"26141",112,85,83,1,2,"PP",52
26,"26165",364,315,311,1,4,"PP",137
26,"26140",260,221,218,1,3,"PP",97
26,"26117",2168,1695,1662,19,33,"PP",696
51,"51001",59213,33213,32720,413,493,"C's",4378
36,"36030",4220,3041,2994,32,47,"PCPE",5
36,"36013",2412,1602,1586,12,16,"PCPE",2
36,"36059",4937,3379,3318,46,61,"PCPE",9
36,"36051",14272,10230,10072,95,158,"PCPE",23
36,"36054",10996,8116,7965,84,151,"PCPE",13
36,"36022",9056,6635,6514,48,121,"PCPE",35
36,"36044",2556,1786,1747,13,39,"PCPE",5
36,"36015",4205,2941,2885,32,56,"PCPE",8
36,"36003",9979,7496,7401,81,95,"PCPE",16
36,"36026",20203,14399,14189,144,210,"PCPE",26
36,"36027",4452,3328,3274,23,54,"PCPE",12
36,"36060",30350,22032,21753,193,279,"PCPE",47
36,"36048",5348,3970,3892,44,78,"PCPE",5
36,"36025",2292,1396,1389,9,7,"PCPE",2
36,"36014",1980,1464,1442,7,22,"PCPE",6
36,"36042",17922,12993,12760,116,233,"PCPE",36
36,"36009",4908,3167,3114,25,53,"PCPE",2
36,"36029",16129,12262,12078,101,184,"PCPE",34
36,"36007",1689,1168,1148,12,20,"PCPE",0
36,"36032",3655,2745,2699,21,46,"PCPE",0
36,"36004",10178,7351,7224,69,127,"PCPE",16
36,"36024",16433,12239,12016,115,223,"PCPE",14
36,"36039",15350,11581,11349,119,232,"PCPE",28
36,"36052",7298,5298,5175,37,123,"PCPE",5
36,"36035",14430,10832,10680,86,152,"PCPE",24
36,"36045",24570,18613,18365,184,248,"PCPE",49
36,"36018",3272,2288,2262,17,26,"PCPE",4
36,"36016",1173,724,716,7,8,"PCPE",2
36,"36047",2492,1719,1704,16,15,"PCPE",1
36,"36011",1842,1185,1169,9,16,"PCPE",6
36,"36050",7562,5567,5457,44,110,"PCPE",14
36,"36038",66390,49943,49439,522,504,"PCPE",110
36,"36046",4055,3189,3139,30,50,"PCPE",8
36,"36008",21736,16270,16094,160,176,"PCPE",38
36,"36010",2862,2195,2177,18,18,"PCPE",8
36,"36041",13428,9842,9710,96,132,"PCPE",24
36,"36037",2607,1862,1838,16,24,"PCPE",2
36,"36023",8420,6287,6180,55,107,"PCPE",11
36,"36017",17866,13133,12910,137,223,"PCPE",26
36,"36021",12033,9035,8879,99,156,"PCPE",22
36,"36053",5693,4321,4265,41,56,"PCPE",14
36,"36056",5108,3856,3783,34,73,"PCPE",13
36,"36040",2600,1907,1869,13,38,"PCPE",3
36,"36006",11537,8885,8740,79,145,"PCPE",20
36,"36901",4095,3344,3293,22,51,"PCPE",4
36,"36043",4736,3347,3297,22,50,"PCPE",7
36,"36019",1625,1127,1119,12,8,"PCPE",1
36,"36055",13643,10361,10145,106,216,"PCPE",28
36,"36002",3151,2290,2255,19,35,"PCPE",4
36,"36058",4992,3495,3441,48,54,"PCPE",7
36,"36020",2351,1748,1721,20,27,"PCPE",0
36,"36036",2511,1923,1892,17,31,"PCPE",5
36,"36061",8651,6594,6445,58,149,"PCPE",6
36,"36001",2593,1968,1952,6,16,"PCPE",4
36,"36012",3735,2818,2777,21,41,"PCPE",4
36,"36005",8120,5839,5747,64,92,"PCPE",16
36,"36028",4139,3094,3045,22,49,"PCPE",4
36,"36031",558,464,454,9,10,"PCPE",2
36,"36034",3477,2499,2470,15,29,"PCPE",6
36,"36049",6761,5193,5069,54,124,"PCPE",6
36,"36057",236957,177555,175758,1730,1797,"PCPE",484
36,"36033",12347,9515,9336,76,179,"PCPE",22
24,"24021",1688,1213,1189,6,24,"PP",430
24,"24180",1128,825,814,12,11,"PP",403
24,"24097",225,146,145,1,1,"PP",66
24,"24165",373,254,250,2,4,"PP",119
24,"24065",2106,1573,1545,16,28,"PP",558
24,"24212",1029,784,774,7,10,"PP",335
24,"24134",3465,2628,2583,27,45,"PP",612
24,"24017",582,434,433,9,1,"PP",224
24,"24230",423,329,324,2,5,"PP",157
24,"24156",243,169,169,1,0,"PP",93
24,"24142",25160,18503,18262,205,241,"PP",4908
24,"24077",227,195,192,1,3,"PP",94
24,"24090",348,226,224,1,2,"PP",120
24,"24066",504,367,361,3,6,"PP",212
24,"24160",692,506,498,2,8,"PP",231
24,"24062",142,105,105,1,0,"PP",36
24,"24145",655,445,443,8,2,"PP",138
24,"24018",177,143,141,0,2,"PP",98
24,"24119",702,491,480,6,11,"PP",169
24,"24206",1732,1303,1288,8,15,"PP",394
24,"24029",754,545,539,2,6,"PP",141
24,"24224",621,452,445,7,7,"PP",209
24,"24057",1366,1103,1076,11,27,"PP",390
24,"24092",809,619,609,1,10,"PP",292
24,"24071",1006,747,738,9,9,"PP",274
24,"24054",433,308,303,4,5,"PP",174
24,"24041",548,384,381,5,3,"PP",152
24,"24052",171,109,108,0,1,"PP",36
24,"24032",111,82,82,1,0,"PP",36
24,"24100",769,569,561,4,8,"PP",231
24,"24076",1279,972,953,7,19,"PP",299
24,"24123",757,499,497,4,2,"PP",221
24,"24094",1392,1048,1038,11,10,"PP",410
24,"24152",462,302,301,2,1,"PP",166
24,"24174",495,362,357,3,5,"PP",158
24,"24003",652,442,435,5,7,"PP",212
24,"24130",437,319,315,1,4,"PP",141
24,"24146",271,195,194,0,1,"PP",114
24,"24188",3843,2962,2899,48,63,"PP",1174
24,"24153",233,173,172,3,1,"PP",75
24,"24159",1832,1407,1391,17,16,"PP",765
24,"24222",14249,10663,10532,119,131,"PP",2851
24,"24171",364,219,217,1,2,"PP",104
24,"24088",1037,804,797,8,7,"PP",374
24,"24068",464,343,339,5,4,"PP",88
24,"24104",266,180,179,0,1,"PP",82
24,"24073",481,343,340,3,3,"PP",157
24,"24215",156,119,118,1,1,"PP",79
24,"24149",155,123,121,0,2,"PP",75
24,"24121",655,481,477,0,4,"PP",186
24,"24203",96,73,72,1,1,"PP",49
24,"24127",301,239,239,3,0,"PP",128
24,"24070",4159,3206,3162,31,44,"PP",599
24,"24129",122,85,85,1,0,"PP",42
24,"24002",236,182,180,3,2,"PP",76
24,"24157",2580,2013,1983,25,30,"PP",860
24,"24074",99,77,76,1,1,"PP",47
24,"24173",943,678,673,3,5,"PP",350
24,"24014",7474,5375,5321,56,54,"PP",1729
24,"24114",3107,2174,2155,7,19,"PP",557
24,"24213",158,117,117,0,0,"PP",72
24,"24093",380,249,248,3,1,"PP",115
24,"24096",124,74,74,0,0,"PP",30
24,"24031",216,169,167,1,2,"PP",75
24,"24191",111,84,84,1,0,"PP",40
24,"24133",350,259,258,3,1,"PP",129
24,"24067",645,383,379,2,4,"PP",209
24,"24107",244,184,183,2,1,"PP",69
24,"24034",3419,2596,2556,27,40,"PP",600
24,"24116",424,276,273,0,3,"PP",122
24,"24184",206,121,120,0,1,"PP",45
24,"24193",384,277,276,4,1,"PP",105
24,"24172",420,218,216,1,2,"PP",120
24,"24112",318,207,207,0,0,"PP",41
24,"24154",1010,750,729,7,21,"PP",294
24,"24179",299,202,201,8,1,"PP",69
24,"24136",544,391,390,8,1,"PP",219
24,"24178",71,58,57,0,1,"PP",36
24,"24109",996,667,652,7,15,"PP",203
24,"24022",342,227,227,0,0,"PP",105
24,"24006",488,351,342,4,9,"PP",159
24,"24042",61,48,48,1,0,"PP",30
24,"24069",42,36,36,0,0,"PP",30
24,"24143",514,391,379,4,12,"PP",134
24,"24061",1702,1244,1231,13,13,"PP",408
24,"24120",345,214,214,1,0,"PP",114
24,"24016",478,287,285,1,2,"PP",131
24,"24086",271,200,198,1,2,"PP",130
24,"24227",1617,1146,1142,14,4,"PP",461
24,"24175",1825,1381,1372,13,9,"PP",510
24,"24902",354,273,272,2,1,"PP",136
24,"24081",142,97,97,0,0,"PP",75
24,"24198",602,411,402,4,9,"PP",77
24,"24155",478,380,371,0,9,"PP",155
24,"24182",420,289,287,6,2,"PP",133
24,"24037",369,251,251,0,0,"PP",139
24,"24183",805,528,522,5,6,"PP",212
24,"24196",2082,1529,1513,15,16,"PP",457
24,"24001",188,108,108,0,0,"PP",50
24,"24064",1525,1165,1151,10,14,"PP",301
24,"24087",645,469,466,11,3,"PP",269
24,"24106",258,178,173,1,5,"PP",88
24,"24139",2186,1608,1570,24,38,"PP",707
24,"24030",4297,3226,3180,16,46,"PP",1040
24,"24033",211,154,151,1,3,"PP",79
24,"24055",705,510,507,6,3,"PP",246
24,"24005",387,267,259,6,8,"PP",142
24,"24901",908,660,653,4,7,"PP",214
24,"24058",205,137,134,0,3,"PP",77
24,"24122",1351,965,948,9,17,"PP",396
24,"24131",742,499,497,5,2,"PP",286
24,"24046",953,662,645,6,17,"PP",256
24,"24079",922,654,645,9,9,"PP",293
24,"24163",3929,3076,3044,49,32,"PP",1056
24,"24166",1413,1043,1014,7,29,"PP",414
24,"24118",127,84,84,1,0,"PP",20
24,"24169",2976,2256,2236,12,20,"PP",555
24,"24056",2910,2102,2068,31,34,"PP",698
24,"24125",475,285,282,2,3,"PP",139
24,"24181",1519,1135,1117,10,18,"PP",517
24,"24012",297,212,211,4,1,"PP",97
24,"24059",887,520,512,8,8,"PP",170
24,"24063",391,260,259,1,1,"PP",144
24,"24187",876,642,631,6,11,"PP",307
24,"24167",763,509,504,9,5,"PP",182
24,"24036",301,181,180,0,1,"PP",59
24,"24194",292,230,229,1,1,"PP",28
24,"24217",136,110,109,1,1,"PP",51
24,"24108",377,279,273,3,6,"PP",153
24,"24124",374,249,246,4,3,"PP",123
24,"24099",173,133,133,2,0,"PP",63
24,"24113",366,282,275,3,7,"PP",144
24,"24164",373,190,190,1,0,"PP",82
24,"24010",8426,5980,5888,61,92,"PP",2511
24,"24210",510,347,347,0,0,"PP",129
24,"24004",469,349,349,6,0,"PP",169
24,"24199",433,284,281,3,3,"PP",108
24,"24137",1114,811,804,9,7,"PP",219
24,"24040",453,315,309,2,6,"PP",120
24,"24091",657,440,437,2,3,"PP",193
24,"24028",386,304,302,3,2,"PP",109
24,"24117",446,333,331,2,2,"PP",231
24,"24053",439,303,298,2,5,"PP",164
24,"24115",54290,39886,39486,325,400,"PP",11739
24,"24102",655,495,492,2,3,"PP",188
24,"24211",276,210,206,4,4,"PP",99
24,"24024",695,496,494,4,2,"PP",261
24,"24168",461,383,379,4,4,"PP",169
24,"24011",209,113,112,0,1,"PP",9
24,"24150",243,175,175,3,0,"PP",92
24,"24229",427,330,324,8,6,"PP",181
24,"24060",615,361,359,0,2,"PP",151
24,"24007",764,578,576,3,2,"PP",143
24,"24219",527,390,387,2,3,"PP",185
24,"24177",481,328,327,1,1,"PP",170
24,"24144",704,487,478,5,9,"PP",204
24,"24008",9319,6964,6852,77,112,"PP",3150
24,"24218",454,331,329,3,2,"PP",154
24,"24044",171,125,118,0,7,"PP",58
24,"24020",463,294,291,5,3,"PP",103
24,"24009",322,161,161,1,0,"PP",67
24,"24019",359,293,291,3,2,"PP",79
24,"24190",167,115,115,2,0,"PP",58
24,"24158",323,210,207,0,3,"PP",98
24,"24078",388,286,284,4,2,"PP",120
24,"24185",482,357,349,4,8,"PP",139
24,"24027",1214,881,860,8,21,"PP",267
24,"24151",492,357,357,1,0,"PP",180
24,"24221",790,568,558,6,10,"PP",275
24,"24047",782,533,527,7,6,"PP",264
24,"24201",1086,765,757,5,8,"PP",301
24,"24205",967,714,706,9,8,"PP",324
24,"24080",218,170,162,3,8,"PP",75
24,"24084",162,119,119,1,0,"PP",53
24,"24051",433,308,307,1,1,"PP",158
24,"24105",1443,1087,1065,10,22,"PP",366
24,"24162",1671,1314,1303,21,11,"PP",395
24,"24049",1493,1152,1138,8,14,"PP",433
24,"24101",404,264,262,2,2,"PP",68
24,"24026",1203,908,898,19,10,"PP",512
24,"24132",628,397,390,6,7,"PP",173
24,"24176",318,244,243,5,1,"PP",135
24,"24015",2279,1693,1658,22,35,"PP",822
24,"24082",870,692,682,10,10,"PP",199
24,"24189",6016,4187,4134,58,53,"PP",1352
24,"24228",666,455,449,2,6,"PP",236
24,"24083",1077,764,755,4,9,"PP",221
24,"24170",1934,1436,1424,13,12,"PP",413
24,"24095",314,246,244,1,2,"PP",116
24,"24039",2077,1604,1600,39,4,"PP",725
24,"24197",770,545,537,6,8,"PP",223
24,"24103",292,160,160,1,0,"PP",101
24,"24043",135,69,67,0,2,"PP",21
24,"24226",204,138,136,0,2,"PP",84
24,"24023",268,189,188,2,1,"PP",92
24,"24141",98,76,75,0,1,"PP",35
24,"24209",2790,1907,1884,15,23,"PP",761
24,"24050",102,77,77,1,0,"PP",46
24,"24216",732,533,522,2,11,"PP",305
24,"24025",300,233,228,0,5,"PP",137
24,"24225",1020,786,773,6,13,"PP",340
24,"24110",1253,932,926,7,6,"PP",221
24,"24161",291,218,212,2,6,"PP",105
24,"24038",3107,2383,2354,30,29,"PP",725
24,"24202",8098,5654,5582,51,72,"PP",1301
24,"24223",2640,2012,2012,53,0,"PP",776
24,"24148",1684,1268,1256,9,12,"PP",641
24,"24207",296,245,241,3,4,"PP",100
24,"24098",1205,880,874,8,6,"PP",227
24,"24214",669,492,490,1,2,"PP",201
24,"24089",103315,77803,77038,779,765,"PP",28248
44,"44086",453,355,350,3,5,"PACMA",0
44,"44128",69,50,50,0,0,"PACMA",0
44,"44090",82,57,57,0,0,"PACMA",0
44,"44171",183,136,135,1,1,"PACMA",0
44,"44008",1615,1217,1200,7,17,"PACMA",1
44,"44149",99,71,71,3,0,"PACMA",0
44,"44199",43,36,36,1,0,"PACMA",1
44,"44231",38,32,32,0,0,"PACMA",0
44,"44076",2234,1759,1729,16,30,"PACMA",3
44,"44227",75,63,63,0,0,"PACMA",0
44,"44247",314,230,228,2,2,"PACMA",0
44,"44151",191,147,145,1,2,"PACMA",2
44,"44064",70,51,51,0,0,"PACMA",1
44,"44041",54,46,46,2,0,"PACMA",1
44,"44125",65,39,39,0,0,"PACMA",0
44,"44070",55,47,46,1,1,"PACMA",0
44,"44141",135,105,104,1,1,"PACMA",0
44,"44172",310,216,216,6,0,"PACMA",0
44,"44258",69,46,46,0,0,"PACMA",0
44,"44082",91,68,67,0,1,"PACMA",0
44,"44029",567,475,467,5,8,"PACMA",1
44,"44110",52,46,44,0,2,"PACMA",0
44,"44130",34,24,24,0,0,"PACMA",0
44,"44206",112,90,88,0,2,"PACMA",0
44,"44241",537,408,403,2,5,"PACMA",1
44,"44173",101,85,84,0,1,"PACMA",0
44,"44168",191,137,131,3,6,"PACMA",1
44,"44080",292,221,218,4,3,"PACMA",0
44,"44042",127,93,92,1,1,"PACMA",0
44,"44184",48,30,30,0,0,"PACMA",0
44,"44101",59,44,44,0,0,"PACMA",0
44,"44059",541,431,423,7,8,"PACMA",0
44,"44195",92,61,61,2,0,"PACMA",1
44,"44067",117,80,80,0,0,"PACMA",2
44,"44112",426,293,284,2,9,"PACMA",0
44,"44021",107,83,83,2,0,"PACMA",0
44,"44077",75,58,57,0,1,"PACMA",0
44,"44096",161,141,139,0,2,"PACMA",0
44,"44217",28,20,20,0,0,"PACMA",0
44,"44137",205,159,159,2,0,"PACMA",0
44,"44016",486,361,357,7,4,"PACMA",0
44,"44105",80,62,62,0,0,"PACMA",0
44,"44266",118,95,95,0,0,"PACMA",1
44,"44196",134,102,102,1,0,"PACMA",1
44,"44192",364,280,278,0,2,"PACMA",0
44,"44092",80,53,52,0,1,"PACMA",0
44,"44267",71,50,50,0,0,"PACMA",0
44,"44046",48,31,31,2,0,"PACMA",0
44,"44085",52,40,40,4,0,"PACMA",0
44,"44093",76,60,60,0,0,"PACMA",0
44,"44087",81,70,70,3,0,"PACMA",0
44,"44034",138,112,110,2,2,"PACMA",0
44,"44013",11254,8292,8205,82,87,"PACMA",64
44,"44051",2704,2074,2046,32,28,"PACMA",16
44,"44224",22,14,14,0,0,"PACMA",0
44,"44100",187,154,153,0,1,"PACMA",2
44,"44001",68,50,50,0,0,"PACMA",1
44,"44260",139,100,98,2,2,"PACMA",1
44,"44052",80,55,54,0,1,"PACMA",0
44,"44252",85,67,66,0,1,"PACMA",0
44,"44135",115,89,86,0,3,"PACMA",0
44,"44240",161,128,125,0,3,"PACMA",0
44,"44268",28,24,24,0,0,"PACMA",0
44,"44208",34,22,22,0,0,"PACMA",0
44,"44163",128,94,94,0,0,"PACMA",0
44,"44044",91,70,70,0,0,"PACMA",1
44,"44063",78,61,61,0,0,"PACMA",0
44,"44153",1812,1209,1196,15,13,"PACMA",3
44,"44238",2345,1743,1729,7,14,"PACMA",18
44,"44154",261,194,191,3,3,"PACMA",0
44,"44045",355,290,286,2,4,"PACMA",1
44,"44136",49,42,42,1,0,"PACMA",0
44,"44053",102,79,73,0,6,"PACMA",0
44,"44142",36,27,27,5,0,"PACMA",1
44,"44113",72,50,50,0,0,"PACMA",0
44,"44156",46,33,32,1,1,"PACMA",0
44,"44175",121,91,89,2,2,"PACMA",1
44,"44111",92,69,69,0,0,"PACMA",1
44,"44068",664,519,515,4,4,"PACMA",1
44,"44146",173,157,157,1,0,"PACMA",0
44,"44075",324,256,250,4,6,"PACMA",0
44,"44025",6062,4490,4394,48,96,"PACMA",23
44,"44174",430,314,313,2,1,"PACMA",0
44,"44060",40,35,35,1,0,"PACMA",0
44,"44143",388,310,309,3,1,"PACMA",2
44,"44164",26,22,22,0,0,"PACMA",0
44,"44038",107,83,83,2,0,"PACMA",0
44,"44178",56,42,42,0,0,"PACMA",0
44,"44048",65,51,51,0,0,"PACMA",0
44,"44005",54,38,37,2,1,"PACMA",0
44,"44127",73,51,50,0,1,"PACMA",0
44,"44193",82,62,62,1,0,"PACMA",0
44,"44031",99,64,64,0,0,"PACMA",0
44,"44144",351,256,252,1,4,"PACMA",3
44,"44198",187,151,148,3,3,"PACMA",0
44,"44148",93,76,76,3,0,"PACMA",0
44,"44203",10,8,8,0,0,"PACMA",0
44,"44216",26539,19621,19346,248,275,"PACMA",113
44,"44062",35,27,26,0,1,"PACMA",0
44,"44109",110,76,74,1,2,"PACMA",0
44,"44126",334,239,235,7,4,"PACMA",0
44,"44183",77,45,44,0,1,"PACMA",1
44,"44047",221,139,135,0,4,"PACMA",0
44,"44032",16,13,13,0,0,"PACMA",0
44,"44066",110,83,83,1,0,"PACMA",1
44,"44006",250,188,186,1,2,"PACMA",0
44,"44167",38,31,31,0,0,"PACMA",0
44,"44145",1029,768,763,7,5,"PACMA",1
44,"44027",161,122,121,4,1,"PACMA",0
44,"44243",23,18,18,0,0,"PACMA",0
44,"44229",151,108,107,1,1,"PACMA",0
44,"44114",244,186,185,3,1,"PACMA",0
44,"44226",141,102,100,2,2,"PACMA",0
44,"44230",155,126,126,2,0,"PACMA",1
44,"44207",158,119,115,0,4,"PACMA",0
44,"44089",46,42,42,0,0,"PACMA",0
44,"44099",708,514,510,1,4,"PACMA",4
44,"44119",135,94,90,2,4,"PACMA",1
44,"44102",31,25,25,0,0,"PACMA",0
44,"44097",147,89,87,1,2,"PACMA",0
44,"44115",106,93,92,4,1,"PACMA",0
44,"44169",351,268,266,3,2,"PACMA",1
44,"44050",3129,2135,2103,30,32,"PACMA",7
44,"44251",254,202,194,2,8,"PACMA",0
44,"44245",250,189,186,1,3,"PACMA",1
44,"44236",59,45,45,0,0,"PACMA",0
44,"44159",39,34,34,0,0,"PACMA",0
44,"44223",75,55,55,2,0,"PACMA",0
44,"44071",599,430,424,8,6,"PACMA",1
44,"44161",447,324,320,3,4,"PACMA",2
44,"44019",68,49,48,1,1,"PACMA",0
44,"44124",78,58,58,1,0,"PACMA",2
44,"44108",331,238,234,4,4,"PACMA",0
44,"44220",121,85,82,2,3,"PACMA",1
44,"44152",67,48,48,1,0,"PACMA",0
44,"44264",253,211,210,2,1,"PACMA",1
44,"44234",62,48,48,1,0,"PACMA",0
44,"44026",90,71,71,0,0,"PACMA",0
44,"44055",69,52,51,3,1,"PACMA",0
44,"44190",72,53,52,0,1,"PACMA",1
44,"44043",108,75,75,1,0,"PACMA",0
44,"44265",188,144,138,2,6,"PACMA",0
44,"44012",336,279,276,2,3,"PACMA",0
44,"44120",222,140,138,2,2,"PACMA",0
44,"44194",111,79,75,0,4,"PACMA",0
44,"44177",111,77,76,1,1,"PACMA",1
44,"44225",111,76,76,4,0,"PACMA",0
44,"44191",771,595,586,7,9,"PACMA",2
44,"44040",202,160,158,3,2,"PACMA",2
44,"44132",61,50,50,1,0,"PACMA",0
44,"44157",65,41,40,0,1,"PACMA",0
44,"44010",178,124,121,2,3,"PACMA",1
44,"44239",22,20,20,0,0,"PACMA",0
44,"44221",365,298,296,2,2,"PACMA",1
44,"44179",345,229,227,2,2,"PACMA",3
44,"44074",430,338,329,5,9,"PACMA",0
44,"44180",71,57,56,1,1,"PACMA",0
44,"44155",1102,831,825,7,6,"PACMA",5
44,"44187",199,148,143,1,5,"PACMA",1
44,"44182",194,155,154,3,1,"PACMA",1
44,"44218",37,26,26,0,0,"PACMA",0
44,"44147",419,312,307,5,5,"PACMA",3
44,"44117",347,278,274,2,4,"PACMA",0
44,"44228",99,79,79,1,0,"PACMA",0
44,"44094",113,102,100,1,2,"PACMA",0
44,"44022",490,323,316,9,7,"PACMA",1
44,"44035",117,81,81,0,0,"PACMA",0
44,"44018",20,20,20,0,0,"PACMA",0
44,"44212",41,32,32,0,0,"PACMA",0
44,"44215",156,105,103,2,2,"PACMA",0
44,"44017",285,221,220,0,1,"PACMA",0
44,"44061",71,57,54,1,3,"PACMA",2
44,"44122",1356,971,969,12,2,"PACMA",1
44,"44103",130,106,106,0,0,"PACMA",0
44,"44211",40,30,30,0,0,"PACMA",0
44,"44249",57,47,47,3,0,"PACMA",1
44,"44235",91,71,70,2,1,"PACMA",0
44,"44138",140,79,77,0,2,"PACMA",0
44,"44210",759,597,596,2,1,"PACMA",1
44,"44002",54,41,41,0,0,"PACMA",0
44,"44106",159,127,126,3,1,"PACMA",1
44,"44219",198,141,134,4,7,"PACMA",0
44,"44007",184,124,120,0,4,"PACMA",0
44,"44037",453,326,321,5,5,"PACMA",1
44,"44056",513,348,341,4,7,"PACMA",1
44,"44244",75,39,39,0,0,"PACMA",0
44,"44204",25,22,22,0,0,"PACMA",0
44,"44014",2530,2008,1966,17,42,"PACMA",22
44,"44160",478,329,322,5,7,"PACMA",1
44,"44129",41,34,34,0,0,"PACMA",0
44,"44246",1554,1091,1079,13,12,"PACMA",2
44,"44004",415,295,291,3,4,"PACMA",2
44,"44165",184,153,152,1,1,"PACMA",0
44,"44084",55,45,45,0,0,"PACMA",0
44,"44065",55,36,36,1,0,"PACMA",0
44,"44049",850,624,613,8,11,"PACMA",2
44,"44116",83,67,65,1,2,"PACMA",1
44,"44262",137,107,107,1,0,"PACMA",0
44,"44176",160,127,127,0,0,"PACMA",0
44,"44213",63,47,47,0,0,"PACMA",0
44,"44209",839,640,623,3,17,"PACMA",3
44,"44023",18,15,15,0,0,"PACMA",0
44,"44232",391,286,279,4,7,"PACMA",1
44,"44088",30,26,26,2,0,"PACMA",0
44,"44237",408,327,321,2,6,"PACMA",1
44,"44121",60,43,43,0,0,"PACMA",1
44,"44197",58,34,34,0,0,"PACMA",1
44,"44257",167,120,120,1,0,"PACMA",0
44,"44009",809,586,578,5,8,"PACMA",0
44,"44181",78,63,63,1,0,"PACMA",1
44,"44020",24,20,19,1,1,"PACMA",0
44,"44123",105,69,69,1,0,"PACMA",0
44,"44150",32,21,20,0,1,"PACMA",0
44,"44189",58,40,40,1,0,"PACMA",0
44,"44261",734,552,542,8,10,"PACMA",0
44,"44039",219,162,160,2,2,"PACMA",1
44,"44033",279,193,191,2,2,"PACMA",0
44,"44054",109,90,90,0,0,"PACMA",0
44,"44133",23,17,17,0,0,"PACMA",1
44,"44256",39,34,34,1,0,"PACMA",0
44,"44158",1170,898,872,12,26,"PACMA",4
44,"44024",27,23,23,0,0,"PACMA",0
44,"44118",165,127,125,2,2,"PACMA",0
44,"44263",369,265,259,2,6,"PACMA",2
44,"44250",19,12,12,2,0,"PACMA",0
44,"44003",19,16,16,0,0,"PACMA",0
44,"44036",24,16,16,0,0,"PACMA",0
44,"44201",497,414,410,2,4,"PACMA",2
44,"44131",26,20,20,0,0,"PACMA",1
44,"44107",216,162,162,1,0,"PACMA",0
44,"44011",57,35,35,0,0,"PACMA",0
44,"44205",712,474,468,6,6,"PACMA",0
44,"44222",137,96,96,0,0,"PACMA",0
44,"44028",191,150,142,1,8,"PACMA",0
44,"44200",40,22,22,0,0,"PACMA",0
44,"44185",104,77,77,0,0,"PACMA",0
49,"49134",187,115,110,0,5,"PACMA",0
49,"49041",440,315,307,1,8,"PACMA",1
49,"49004",128,92,88,2,4,"PACMA",1
49,"49275",52483,38405,37981,427,424,"PACMA",248
49,"49136",324,228,222,4,6,"PACMA",0
49,"49133",306,218,217,1,1,"PACMA",1
49,"49129",861,626,617,10,9,"PACMA",2
49,"49047",111,78,77,0,1,"PACMA",1
49,"49075",140,109,106,1,3,"PACMA",0
49,"49022",287,230,226,3,4,"PACMA",0
49,"49173",379,229,227,5,2,"PACMA",0
49,"49065",1121,850,835,8,15,"PACMA",1
49,"49007",371,267,254,6,13,"PACMA",3
49,"49117",458,336,328,3,8,"PACMA",0
49,"49163",230,166,160,1,6,"PACMA",1
49,"49162",192,140,138,1,2,"PACMA",0
49,"49157",214,167,162,1,5,"PACMA",0
49,"49025",174,128,126,0,2,"PACMA",0
49,"49097",90,47,47,0,0,"PACMA",0
49,"49002",64,48,48,1,0,"PACMA",1
49,"49142",247,182,180,5,2,"PACMA",1
49,"49241",256,190,186,0,4,"PACMA",0
49,"49233",95,60,57,0,3,"PACMA",1
49,"49013",254,172,168,4,4,"PACMA",0
49,"49225",153,95,92,2,3,"PACMA",0
49,"49096",175,134,127,1,7,"PACMA",0
49,"49068",472,292,289,2,3,"PACMA",0
49,"49067",372,258,256,3,2,"PACMA",2
49,"49020",294,226,223,5,3,"PACMA",0
49,"49219",7519,5407,5331,58,76,"PACMA",25
49,"49145",235,145,137,2,8,"PACMA",0
49,"49180",156,101,101,0,0,"PACMA",0
49,"49165",60,59,58,2,1,"PACMA",0
49,"49039",333,259,252,1,7,"PACMA",2
49,"49082",364,306,304,6,2,"PACMA",0
49,"49056",295,220,211,4,9,"PACMA",1
49,"49153",172,124,123,1,1,"PACMA",0
49,"49234",410,336,334,1,2,"PACMA",0
49,"49237",170,120,120,3,0,"PACMA",0
49,"49263",54,41,41,0,0,"PACMA",0
49,"49206",854,611,595,6,16,"PACMA",1
49,"49160",48,36,32,0,4,"PACMA",0
49,"49058",316,252,250,0,2,"PACMA",0
49,"49177",284,190,189,1,1,"PACMA",1
49,"49236",76,54,53,0,1,"PACMA",0
49,"49183",101,80,80,4,0,"PACMA",0
49,"49149",392,275,271,3,4,"PACMA",3
49,"49123",547,414,410,0,4,"PACMA",2
49,"49168",90,73,73,2,0,"PACMA",0
49,"49264",592,395,391,4,4,"PACMA",3
49,"49042",244,199,195,2,4,"PACMA",0
49,"49245",261,178,174,0,4,"PACMA",0
49,"49192",134,114,114,2,0,"PACMA",0
49,"49250",1254,974,952,11,22,"PACMA",2
49,"49036",521,375,371,3,4,"PACMA",1
49,"49040",117,99,99,1,0,"PACMA",0
49,"49203",319,245,236,1,9,"PACMA",0
49,"49016",256,185,179,2,6,"PACMA",1
49,"49037",185,156,156,0,0,"PACMA",0
49,"49046",272,209,206,3,3,"PACMA",0
49,"49053",938,737,729,5,8,"PACMA",0
49,"49077",189,115,115,0,0,"PACMA",0
49,"49247",454,301,296,3,5,"PACMA",0
49,"49166",1225,945,934,11,11,"PACMA",1
49,"49178",699,503,487,4,16,"PACMA",4
49,"49092",132,92,91,1,1,"PACMA",0
49,"49251",166,126,119,0,7,"PACMA",0
49,"49125",1400,977,957,10,20,"PACMA",5
49,"49079",105,80,76,2,4,"PACMA",0
49,"49270",138,100,99,0,1,"PACMA",0
49,"49257",279,187,184,1,3,"PACMA",1
49,"49113",172,144,142,1,2,"PACMA",0
49,"49035",236,205,200,0,5,"PACMA",0
49,"49087",523,322,319,0,3,"PACMA",0
49,"49273",189,120,118,0,2,"PACMA",0
49,"49272",88,73,73,1,0,"PACMA",0
49,"49029",623,494,482,4,12,"PACMA",3
49,"49061",150,113,113,1,0,"PACMA",0
49,"49023",977,702,697,9,5,"PACMA",0
49,"49093",287,233,231,2,2,"PACMA",0
49,"49084",290,241,238,5,3,"PACMA",0
49,"49126",236,158,157,4,1,"PACMA",0
49,"49101",153,106,101,3,5,"PACMA",0
49,"49181",369,274,274,2,0,"PACMA",0
49,"49249",68,60,59,1,1,"PACMA",0
49,"49267",91,75,74,1,1,"PACMA",0
49,"49024",667,464,457,7,7,"PACMA",0
49,"49081",1365,1071,1057,7,14,"PACMA",2
49,"49018",331,252,245,1,7,"PACMA",0
49,"49010",346,285,282,3,3,"PACMA",4
49,"49026",233,182,179,0,3,"PACMA",0
49,"49098",222,167,166,2,1,"PACMA",0
49,"49107",131,98,97,2,1,"PACMA",0
49,"49008",468,346,342,6,4,"PACMA",1
49,"49265",128,91,91,1,0,"PACMA",0
49,"49238",258,202,201,0,1,"PACMA",1
49,"49044",85,56,55,0,1,"PACMA",1
49,"49099",132,85,85,1,0,"PACMA",0
49,"49204",64,45,44,0,1,"PACMA",0
49,"49052",191,144,139,1,5,"PACMA",0
49,"49216",162,138,137,0,1,"PACMA",0
49,"49214",707,529,523,7,6,"PACMA",2
49,"49064",521,343,339,2,4,"PACMA",0
49,"49148",249,143,141,0,2,"PACMA",4
49,"49261",1546,1171,1154,9,17,"PACMA",9
49,"49205",382,296,294,8,2,"PACMA",1
49,"49104",353,224,223,0,1,"PACMA",1
49,"49239",673,488,476,6,12,"PACMA",2
49,"49109",626,491,490,4,1,"PACMA",1
49,"49190",64,49,49,0,0,"PACMA",0
49,"49100",303,216,215,1,1,"PACMA",0
49,"49255",426,330,327,4,3,"PACMA",0
49,"49252",326,260,255,7,5,"PACMA",1
49,"49235",450,330,321,5,9,"PACMA",1
49,"49103",412,333,330,4,3,"PACMA",4
49,"49164",158,120,118,1,2,"PACMA",0
49,"49085",1033,708,701,0,7,"PACMA",2
49,"49152",532,346,344,9,2,"PACMA",1
49,"49003",904,631,624,4,7,"PACMA",2
49,"49105",155,121,121,0,0,"PACMA",0
49,"49232",97,74,73,0,1,"PACMA",0
49,"49244",45,28,28,0,0,"PACMA",0
49,"49202",190,138,136,2,2,"PACMA",0
49,"49135",635,450,449,5,1,"PACMA",1
49,"49090",194,148,147,1,1,"PACMA",3
49,"49032",326,251,250,0,1,"PACMA",0
49,"49259",93,70,63,0,7,"PACMA",0
49,"49055",104,85,85,2,0,"PACMA",0
49,"49139",170,139,136,0,3,"PACMA",1
49,"49151",627,473,467,4,6,"PACMA",0
49,"49167",205,147,144,0,3,"PACMA",1
49,"49199",259,203,200,1,3,"PACMA",0
49,"49246",233,190,185,1,5,"PACMA",0
49,"49188",115,92,91,1,1,"PACMA",0
49,"49095",297,233,231,1,2,"PACMA",0
49,"49009",400,290,286,4,4,"PACMA",0
49,"49116",389,272,266,4,6,"PACMA",0
49,"49080",692,523,518,6,5,"PACMA",1
49,"49108",476,359,352,4,7,"PACMA",1
49,"49269",230,165,163,4,2,"PACMA",0
49,"49226",253,203,200,1,3,"PACMA",0
49,"49172",536,347,341,1,6,"PACMA",1
49,"49034",446,337,333,3,4,"PACMA",0
49,"49189",202,130,130,5,0,"PACMA",0
49,"49062",121,82,81,1,1,"PACMA",0
49,"49121",372,269,265,4,4,"PACMA",0
49,"49030",84,69,67,1,2,"PACMA",0
49,"49223",766,628,616,5,12,"PACMA",1
49,"49137",176,140,137,2,3,"PACMA",0
49,"49159",276,220,216,2,4,"PACMA",1
49,"49094",243,149,149,1,0,"PACMA",0
49,"49221",258,142,135,1,7,"PACMA",0
49,"49006",154,116,112,0,4,"PACMA",1
49,"49048",134,84,84,0,0,"PACMA",0
49,"49122",773,578,569,7,9,"PACMA",6
49,"49057",106,77,76,0,1,"PACMA",0
49,"49015",233,189,188,1,1,"PACMA",0
49,"49228",56,43,41,0,2,"PACMA",0
49,"49043",300,226,225,2,1,"PACMA",0
49,"49088",92,70,70,0,0,"PACMA",2
49,"49027",150,116,116,5,0,"PACMA",0
49,"49110",366,215,215,5,0,"PACMA",0
49,"49138",231,164,163,1,1,"PACMA",0
49,"49231",330,216,212,1,4,"PACMA",0
49,"49230",103,82,81,1,1,"PACMA",0
49,"49119",236,172,172,0,0,"PACMA",2
49,"49076",325,253,250,2,3,"PACMA",1
49,"49207",237,156,155,0,1,"PACMA",1
49,"49019",246,187,181,5,6,"PACMA",0
49,"49147",267,190,189,2,1,"PACMA",1
49,"49078",174,143,143,0,0,"PACMA",1
49,"49115",185,140,139,4,1,"PACMA",0
49,"49102",198,148,145,1,3,"PACMA",0
49,"49141",348,251,249,3,2,"PACMA",0
49,"49033",728,530,528,4,2,"PACMA",1
49,"49200",950,737,719,9,18,"PACMA",4
49,"49054",908,668,651,13,17,"PACMA",3
49,"49271",204,154,154,3,0,"PACMA",0
49,"49260",774,597,593,12,4,"PACMA",2
49,"49017",251,169,169,2,0,"PACMA",0
49,"49256",256,207,206,2,1,"PACMA",0
49,"49131",269,186,181,1,5,"PACMA",0
49,"49194",377,229,228,2,1,"PACMA",1
49,"49118",206,167,167,0,0,"PACMA",2
49,"49021",14387,10353,10196,117,157,"PACMA",43
49,"49005",142,93,93,0,0,"PACMA",0
49,"49185",162,125,121,0,4,"PACMA",1
49,"49227",316,259,255,4,4,"PACMA",1
49,"49155",83,64,63,1,1,"PACMA",0
49,"49132",327,242,236,0,6,"PACMA",1
49,"49112",128,85,85,1,0,"PACMA",1
49,"49059",93,61,61,0,0,"PACMA",0
49,"49170",104,70,68,1,2,"PACMA",0
49,"49156",237,185,183,2,2,"PACMA",0
49,"49175",234,183,182,2,1,"PACMA",0
49,"49128",557,428,424,2,4,"PACMA",4
49,"49091",269,202,202,0,0,"PACMA",0
49,"49258",115,96,95,2,1,"PACMA",0
49,"49197",180,127,123,2,4,"PACMA",1
49,"49063",341,274,274,2,0,"PACMA",0
49,"49224",160,109,106,4,3,"PACMA",0
49,"49150",145,109,104,2,5,"PACMA",0
49,"49014",112,83,82,1,1,"PACMA",0
49,"49268",416,307,305,5,2,"PACMA",0
49,"49179",393,265,263,0,2,"PACMA",0
49,"49208",395,255,250,1,5,"PACMA",0
49,"49210",478,365,358,4,7,"PACMA",2
49,"49050",513,349,348,3,1,"PACMA",0
49,"49266",75,60,60,0,0,"PACMA",0
49,"49186",263,189,187,0,2,"PACMA",0
49,"49240",218,168,159,3,9,"PACMA",0
49,"49191",272,215,213,1,2,"PACMA",0
49,"49193",472,323,316,4,7,"PACMA",1
49,"49158",215,164,161,3,3,"PACMA",0
49,"49201",306,250,248,4,2,"PACMA",0
49,"49154",131,79,78,0,1,"PACMA",0
49,"49066",498,336,328,4,8,"PACMA",1
49,"49184",179,117,114,1,3,"PACMA",0
49,"49222",387,294,289,7,5,"PACMA",0
49,"49171",648,507,500,5,7,"PACMA",0
49,"49111",130,96,96,6,0,"PACMA",0
49,"49028",122,103,102,1,1,"PACMA",1
49,"49127",2369,1752,1731,22,21,"PACMA",11
49,"49169",35,29,29,0,0,"PACMA",0
49,"49071",770,505,502,6,3,"PACMA",1
49,"49187",1251,956,946,8,10,"PACMA",0
49,"49086",119,98,97,1,1,"PACMA",0
49,"49143",225,161,157,2,4,"PACMA",3
49,"49242",455,373,365,8,8,"PACMA",0
49,"49243",111,97,95,0,2,"PACMA",0
49,"49176",681,446,444,2,2,"PACMA",0
49,"49124",254,179,176,2,3,"PACMA",1
49,"49248",188,145,144,0,1,"PACMA",1
49,"49012",72,47,47,1,0,"PACMA",0
49,"49146",296,232,228,2,4,"PACMA",0
49,"49229",130,98,97,1,1,"PACMA",2
49,"49038",99,74,74,1,0,"PACMA",0
49,"49220",146,116,114,1,2,"PACMA",0
49,"49011",230,183,180,7,3,"PACMA",2
49,"49174",130,95,94,2,1,"PACMA",1
49,"49262",392,268,266,1,2,"PACMA",2
49,"49120",74,53,51,0,2,"PACMA",0
49,"49083",52,43,41,1,2,"PACMA",0
49,"49031",145,115,113,0,2,"PACMA",0
49,"49114",44,31,30,0,1,"PACMA",0
49,"49130",180,137,132,5,5,"PACMA",0
49,"49069",384,243,242,6,1,"PACMA",0
49,"49209",510,347,345,5,2,"PACMA",1
24,"24092",809,619,609,1,10,"PSOE",166
24,"24133",350,259,258,3,1,"PSOE",65
24,"24191",111,84,84,1,0,"PSOE",25
24,"24073",481,343,340,3,3,"PSOE",77
24,"24083",1077,764,755,4,9,"PSOE",291
24,"24084",162,119,119,1,0,"PSOE",37
24,"24209",2790,1907,1884,15,23,"PSOE",541
24,"24090",348,226,224,1,2,"PSOE",45
24,"24127",301,239,239,3,0,"PSOE",50
24,"24150",243,175,175,3,0,"PSOE",27
24,"24078",388,286,284,4,2,"PSOE",72
24,"24093",380,249,248,3,1,"PSOE",63
24,"24023",268,189,188,2,1,"PSOE",27
24,"24134",3465,2628,2583,27,45,"PSOE",1044
24,"24053",439,303,298,2,5,"PSOE",62
24,"24187",876,642,631,6,11,"PSOE",147
24,"24163",3929,3076,3044,49,32,"PSOE",555
24,"24036",301,181,180,0,1,"PSOE",71
24,"24219",527,390,387,2,3,"PSOE",91
24,"24057",1366,1103,1076,11,27,"PSOE",337
24,"24212",1029,784,774,7,10,"PSOE",215
24,"24178",71,58,57,0,1,"PSOE",7
24,"24180",1128,825,814,12,11,"PSOE",170
24,"24129",122,85,85,1,0,"PSOE",20
24,"24096",124,74,74,0,0,"PSOE",18
24,"24157",2580,2013,1983,25,30,"PSOE",466
24,"24151",492,357,357,1,0,"PSOE",83
24,"24020",463,294,291,5,3,"PSOE",70
24,"24201",1086,765,757,5,8,"PSOE",224
24,"24206",1732,1303,1288,8,15,"PSOE",522
24,"24171",364,219,217,1,2,"PSOE",58
24,"24058",205,137,134,0,3,"PSOE",39
24,"24066",504,367,361,3,6,"PSOE",68
24,"24021",1688,1213,1189,6,24,"PSOE",339
24,"24015",2279,1693,1658,22,35,"PSOE",359
24,"24059",887,520,512,8,8,"PSOE",221
24,"24183",805,528,522,5,6,"PSOE",127
24,"24141",98,76,75,0,1,"PSOE",22
24,"24032",111,82,82,1,0,"PSOE",29
24,"24068",464,343,339,5,4,"PSOE",152
24,"24109",996,667,652,7,15,"PSOE",244
24,"24082",870,692,682,10,10,"PSOE",241
24,"24030",4297,3226,3180,16,46,"PSOE",938
24,"24143",514,391,379,4,12,"PSOE",136
24,"24226",204,138,136,0,2,"PSOE",16
24,"24156",243,169,169,1,0,"PSOE",41
24,"24028",386,304,302,3,2,"PSOE",92
24,"24069",42,36,36,0,0,"PSOE",4
24,"24901",908,660,653,4,7,"PSOE",212
24,"24064",1525,1165,1151,10,14,"PSOE",358
24,"24034",3419,2596,2556,27,40,"PSOE",922
24,"24136",544,391,390,8,1,"PSOE",77
24,"24189",6016,4187,4134,58,53,"PSOE",751
24,"24101",404,264,262,2,2,"PSOE",117
24,"24012",297,212,211,4,1,"PSOE",44
24,"24166",1413,1043,1014,7,29,"PSOE",285
24,"24054",433,308,303,4,5,"PSOE",70
24,"24132",628,397,390,6,7,"PSOE",97
24,"24196",2082,1529,1513,15,16,"PSOE",511
24,"24051",433,308,307,1,1,"PSOE",77
24,"24029",754,545,539,2,6,"PSOE",201
24,"24031",216,169,167,1,2,"PSOE",47
24,"24184",206,121,120,0,1,"PSOE",30
24,"24173",943,678,673,3,5,"PSOE",161
24,"24001",188,108,108,0,0,"PSOE",31
24,"24217",136,110,109,1,1,"PSOE",25
24,"24061",1702,1244,1231,13,13,"PSOE",312
24,"24174",495,362,357,3,5,"PSOE",103
24,"24103",292,160,160,1,0,"PSOE",37
24,"24043",135,69,67,0,2,"PSOE",31
24,"24165",373,254,250,2,4,"PSOE",64
24,"24062",142,105,105,1,0,"PSOE",36
24,"24149",155,123,121,0,2,"PSOE",29
24,"24155",478,380,371,0,9,"PSOE",111
24,"24115",54290,39886,39486,325,400,"PSOE",9899
24,"24159",1832,1407,1391,17,16,"PSOE",272
24,"24119",702,491,480,6,11,"PSOE",141
24,"24218",454,331,329,3,2,"PSOE",60
24,"24065",2106,1573,1545,16,28,"PSOE",387
24,"24102",655,495,492,2,3,"PSOE",194
24,"24207",296,245,241,3,4,"PSOE",62
24,"24121",655,481,477,0,4,"PSOE",112
24,"24902",354,273,272,2,1,"PSOE",86
24,"24139",2186,1608,1570,24,38,"PSOE",425
24,"24006",488,351,342,4,9,"PSOE",87
24,"24005",387,267,259,6,8,"PSOE",62
24,"24098",1205,880,874,8,6,"PSOE",303
24,"24175",1825,1381,1372,13,9,"PSOE",288
24,"24229",427,330,324,8,6,"PSOE",80
24,"24056",2910,2102,2068,31,34,"PSOE",719
24,"24003",652,442,435,5,7,"PSOE",143
24,"24193",384,277,276,4,1,"PSOE",57
24,"24179",299,202,201,8,1,"PSOE",61
24,"24025",300,233,228,0,5,"PSOE",38
24,"24094",1392,1048,1038,11,10,"PSOE",236
24,"24106",258,178,173,1,5,"PSOE",36
24,"24203",96,73,72,1,1,"PSOE",12
24,"24027",1214,881,860,8,21,"PSOE",250
24,"24124",374,249,246,4,3,"PSOE",80
24,"24130",437,319,315,1,4,"PSOE",62
24,"24148",1684,1268,1256,9,12,"PSOE",232
24,"24154",1010,750,729,7,21,"PSOE",207
24,"24037",369,251,251,0,0,"PSOE",47
24,"24221",790,568,558,6,10,"PSOE",121
24,"24104",266,180,179,0,1,"PSOE",43
24,"24198",602,411,402,4,9,"PSOE",233
24,"24194",292,230,229,1,1,"PSOE",160
24,"24199",433,284,281,3,3,"PSOE",66
24,"24211",276,210,206,4,4,"PSOE",66
24,"24125",475,285,282,2,3,"PSOE",76
24,"24038",3107,2383,2354,30,29,"PSOE",738
24,"24087",645,469,466,11,3,"PSOE",58
24,"24079",922,654,645,9,9,"PSOE",120
24,"24188",3843,2962,2899,48,63,"PSOE",703
24,"24095",314,246,244,1,2,"PSOE",61
24,"24052",171,109,108,0,1,"PSOE",43
24,"24168",461,383,379,4,4,"PSOE",103
24,"24214",669,492,490,1,2,"PSOE",172
24,"24018",177,143,141,0,2,"PSOE",12
24,"24049",1493,1152,1138,8,14,"PSOE",380
24,"24137",1114,811,804,9,7,"PSOE",316
24,"24046",953,662,645,6,17,"PSOE",221
24,"24185",482,357,349,4,8,"PSOE",90
24,"24123",757,499,497,4,2,"PSOE",170
24,"24070",4159,3206,3162,31,44,"PSOE",1201
24,"24099",173,133,133,2,0,"PSOE",32
24,"24089",103315,77803,77038,779,765,"PSOE",16658
24,"24080",218,170,162,3,8,"PSOE",34
24,"24116",424,276,273,0,3,"PSOE",67
24,"24169",2976,2256,2236,12,20,"PSOE",812
24,"24131",742,499,497,5,2,"PSOE",98
24,"24113",366,282,275,3,7,"PSOE",66
24,"24216",732,533,522,2,11,"PSOE",105
24,"24039",2077,1604,1600,39,4,"PSOE",382
24,"24213",158,117,117,0,0,"PSOE",22
24,"24190",167,115,115,2,0,"PSOE",34
24,"24158",323,210,207,0,3,"PSOE",53
24,"24071",1006,747,738,9,9,"PSOE",227
24,"24004",469,349,349,6,0,"PSOE",89
24,"24050",102,77,77,1,0,"PSOE",19
24,"24110",1253,932,926,7,6,"PSOE",364
24,"24040",453,315,309,2,6,"PSOE",97
24,"24091",657,440,437,2,3,"PSOE",92
24,"24107",244,184,183,2,1,"PSOE",77
24,"24074",99,77,76,1,1,"PSOE",11
24,"24014",7474,5375,5321,56,54,"PSOE",1649
24,"24210",510,347,347,0,0,"PSOE",118
24,"24145",655,445,443,8,2,"PSOE",178
24,"24205",967,714,706,9,8,"PSOE",150
24,"24215",156,119,118,1,1,"PSOE",13
24,"24042",61,48,48,1,0,"PSOE",12
24,"24044",171,125,118,0,7,"PSOE",26
24,"24142",25160,18503,18262,205,241,"PSOE",4753
24,"24146",271,195,194,0,1,"PSOE",40
24,"24011",209,113,112,0,1,"PSOE",86
24,"24076",1279,972,953,7,19,"PSOE",238
24,"24024",695,496,494,4,2,"PSOE",86
24,"24112",318,207,207,0,0,"PSOE",109
24,"24228",666,455,449,2,6,"PSOE",75
24,"24086",271,200,198,1,2,"PSOE",45
24,"24077",227,195,192,1,3,"PSOE",58
24,"24223",2640,2012,2012,53,0,"PSOE",604
24,"24160",692,506,498,2,8,"PSOE",89
24,"24017",582,434,433,9,1,"PSOE",107
24,"24117",446,333,331,2,2,"PSOE",42
24,"24122",1351,965,948,9,17,"PSOE",300
24,"24118",127,84,84,1,0,"PSOE",34
24,"24120",345,214,214,1,0,"PSOE",28
24,"24153",233,173,172,3,1,"PSOE",44
24,"24181",1519,1135,1117,10,18,"PSOE",393
24,"24016",478,287,285,1,2,"PSOE",99
24,"24227",1617,1146,1142,14,4,"PSOE",239
24,"24176",318,244,243,5,1,"PSOE",43
24,"24144",704,487,478,5,9,"PSOE",110
24,"24164",373,190,190,1,0,"PSOE",51
24,"24172",420,218,216,1,2,"PSOE",43
24,"24002",236,182,180,3,2,"PSOE",65
24,"24167",763,509,504,9,5,"PSOE",137
24,"24161",291,218,212,2,6,"PSOE",31
24,"24224",621,452,445,7,7,"PSOE",119
24,"24088",1037,804,797,8,7,"PSOE",220
24,"24010",8426,5980,5888,61,92,"PSOE",1468
24,"24182",420,289,287,6,2,"PSOE",51
24,"24060",615,361,359,0,2,"PSOE",101
24,"24007",764,578,576,3,2,"PSOE",213
24,"24067",645,383,379,2,4,"PSOE",94
24,"24009",322,161,161,1,0,"PSOE",36
24,"24041",548,384,381,5,3,"PSOE",98
24,"24177",481,328,327,1,1,"PSOE",58
24,"24097",225,146,145,1,1,"PSOE",27
24,"24047",782,533,527,7,6,"PSOE",99
24,"24222",14249,10663,10532,119,131,"PSOE",2311
24,"24152",462,302,301,2,1,"PSOE",55
24,"24055",705,510,507,6,3,"PSOE",136
24,"24162",1671,1314,1303,21,11,"PSOE",338
24,"24105",1443,1087,1065,10,22,"PSOE",249
24,"24230",423,329,324,2,5,"PSOE",71
24,"24202",8098,5654,5582,51,72,"PSOE",1781
24,"24033",211,154,151,1,3,"PSOE",34
24,"24197",770,545,537,6,8,"PSOE",163
24,"24081",142,97,97,0,0,"PSOE",10
24,"24114",3107,2174,2155,7,19,"PSOE",781
24,"24022",342,227,227,0,0,"PSOE",38
24,"24063",391,260,259,1,1,"PSOE",53
24,"24100",769,569,561,4,8,"PSOE",108
24,"24019",359,293,291,3,2,"PSOE",112
24,"24108",377,279,273,3,6,"PSOE",49
24,"24026",1203,908,898,19,10,"PSOE",146
24,"24008",9319,6964,6852,77,112,"PSOE",1340
24,"24170",1934,1436,1424,13,12,"PSOE",476
24,"24225",1020,786,773,6,13,"PSOE",172
4,"4084",337,264,261,1,3,"UPYD",0
4,"4081",356,290,290,2,0,"UPYD",0
4,"4099",4988,3784,3714,26,70,"UPYD",16
4,"4087",189,140,139,1,1,"UPYD",0
4,"4026",70,60,60,0,0,"UPYD",0
4,"4061",618,495,491,5,4,"UPYD",2
4,"4055",372,315,315,0,0,"UPYD",0
4,"4030",1140,828,826,8,2,"UPYD",0
4,"4020",292,208,207,1,1,"UPYD",0
4,"4071",398,327,326,2,1,"UPYD",0
4,"4070",1623,1233,1229,7,4,"UPYD",1
4,"4001",1083,812,796,6,16,"UPYD",3
4,"4054",363,297,292,1,5,"UPYD",0
4,"4008",501,420,415,3,5,"UPYD",0
4,"4012",191,170,169,1,1,"UPYD",0
4,"4033",139,100,97,3,3,"UPYD",0
4,"4002",1063,765,760,1,5,"UPYD",1
4,"4058",369,292,291,2,1,"UPYD",0
4,"4062",4528,3610,3579,20,31,"UPYD",3
4,"4090",309,242,242,1,0,"UPYD",0
4,"4053",12333,9124,9040,66,84,"UPYD",29
4,"4073",332,231,230,2,1,"UPYD",1
4,"4100",8712,5545,5482,30,63,"UPYD",21
4,"4013",141116,95203,94625,669,578,"UPYD",609
4,"4034",173,108,108,3,0,"UPYD",1
4,"4010",579,469,464,2,5,"UPYD",1
4,"4063",1099,847,835,2,12,"UPYD",2
4,"4064",2779,2032,2009,8,23,"UPYD",4
4,"4092",2852,2192,2168,13,24,"UPYD",8
4,"4089",746,536,528,6,8,"UPYD",1
4,"4031",2359,1791,1786,7,5,"UPYD",5
4,"4101",4283,2969,2950,22,19,"UPYD",10
4,"4102",13729,8987,8878,114,109,"UPYD",37
4,"4014",153,118,118,0,0,"UPYD",0
4,"4083",1790,1384,1379,8,5,"UPYD",5
4,"4023",139,104,102,1,2,"UPYD",1
4,"4065",366,290,288,2,2,"UPYD",1
4,"4032",5606,3789,3770,19,19,"UPYD",12
4,"4050",830,597,594,3,3,"UPYD",1
4,"4057",1337,941,933,2,8,"UPYD",4
4,"4074",2829,1965,1945,24,20,"UPYD",8
4,"4093",1872,1265,1252,10,13,"UPYD",8
4,"4005",577,438,432,1,6,"UPYD",4
4,"4075",5152,3772,3715,19,57,"UPYD",11
4,"4072",311,247,244,14,3,"UPYD",1
4,"4015",130,98,98,1,0,"UPYD",0
4,"4056",147,123,120,0,3,"UPYD",0
4,"4022",348,243,242,1,1,"UPYD",1
4,"4011",2798,2244,2220,14,24,"UPYD",4
4,"4094",209,141,141,1,0,"UPYD",0
4,"4080",226,185,182,2,3,"UPYD",1
4,"4003",17365,10931,10830,57,101,"UPYD",32
4,"4046",862,658,656,6,2,"UPYD",1
4,"4044",1555,1253,1243,9,10,"UPYD",3
4,"4091",342,280,278,4,2,"UPYD",0
4,"4085",395,302,298,0,4,"UPYD",3
4,"4082",306,210,209,0,1,"UPYD",1
4,"4901",539,388,386,0,2,"UPYD",0
4,"4016",2146,1584,1564,8,20,"UPYD",8
4,"4037",1312,1019,1000,6,19,"UPYD",2
4,"4036",228,176,175,2,1,"UPYD",0
4,"4066",13573,8651,8570,65,81,"UPYD",17
4,"4067",584,432,424,0,8,"UPYD",3
4,"4095",726,466,463,2,3,"UPYD",1
4,"4007",736,553,551,0,2,"UPYD",4
4,"4004",421,314,312,2,2,"UPYD",0
4,"4045",1777,1402,1392,9,10,"UPYD",2
4,"4902",45373,28425,28220,249,205,"UPYD",209
4,"4017",1301,881,876,5,5,"UPYD",1
4,"4086",1792,1271,1258,8,13,"UPYD",4
4,"4077",303,277,274,2,3,"UPYD",0
4,"4021",187,148,141,1,7,"UPYD",0
4,"4035",8375,6079,6031,28,48,"UPYD",16
4,"4043",546,466,462,3,4,"UPYD",3
4,"4052",12246,8393,8353,84,40,"UPYD",52
4,"4068",195,158,158,0,0,"UPYD",1
4,"4096",274,208,206,0,2,"UPYD",0
4,"4078",1095,784,779,7,5,"UPYD",2
4,"4903",4345,2896,2875,35,21,"UPYD",3
4,"4049",5280,3658,3623,20,35,"UPYD",12
4,"4047",2278,1906,1891,13,15,"UPYD",2
4,"4059",1100,752,745,7,7,"UPYD",0
4,"4097",254,196,194,0,2,"UPYD",1
4,"4028",226,198,197,0,1,"UPYD",0
4,"4103",1478,1051,1037,6,14,"UPYD",1
4,"4069",4692,3641,3607,29,34,"UPYD",9
4,"4060",466,361,358,2,3,"UPYD",0
4,"4024",3036,2325,2308,18,17,"UPYD",6
4,"4009",169,127,126,0,1,"UPYD",2
4,"4088",2475,1717,1703,10,14,"UPYD",4
4,"4006",7016,4823,4786,33,37,"UPYD",12
4,"4019",251,199,198,0,1,"UPYD",0
4,"4018",274,245,242,0,3,"UPYD",0
4,"4048",1503,1104,1096,7,8,"UPYD",2
4,"4029",8887,6103,6048,53,55,"UPYD",49
4,"4098",1537,1157,1147,8,10,"UPYD",1
4,"4076",1296,1005,993,7,12,"UPYD",7
4,"4051",440,373,372,0,1,"UPYD",2
4,"4079",50800,33862,33629,200,233,"UPYD",215
4,"4904",1759,1185,1172,15,13,"UPYD",2
4,"4038",3066,2169,2150,20,19,"UPYD",9
4,"4027",249,163,163,1,0,"UPYD",0
4,"4041",318,241,241,6,0,"UPYD",1
42,"42205",93,64,63,0,1,"C´s",11
42,"42160",261,205,203,1,2,"C´s",21
42,"42068",85,62,61,2,1,"C´s",18
42,"42023",66,53,53,0,0,"C´s",5
42,"42016",18,13,13,0,0,"C´s",1
42,"42171",128,78,78,1,0,"C´s",10
42,"42207",41,33,33,1,0,"C´s",4
42,"42027",76,56,56,0,0,"C´s",9
42,"42178",117,81,79,2,2,"C´s",5
42,"42139",22,16,16,0,0,"C´s",4
42,"42011",17,10,10,0,0,"C´s",2
42,"42083",25,23,21,0,2,"C´s",3
42,"42019",516,367,363,4,4,"C´s",60
42,"42116",47,33,33,0,0,"C´s",3
42,"42162",2363,1690,1672,21,18,"C´s",240
42,"42125",81,66,66,2,0,"C´s",7
42,"42219",43,32,32,0,0,"C´s",3
42,"42001",279,219,215,2,4,"C´s",34
42,"42015",32,25,25,0,0,"C´s",6
42,"42148",10,10,10,0,0,"C´s",2
42,"42054",20,14,14,0,0,"C´s",0
42,"42030",95,77,76,3,1,"C´s",12
42,"42085",191,136,136,2,0,"C´s",7
42,"42079",27,17,17,1,0,"C´s",3
42,"42193",16,11,11,0,0,"C´s",2
42,"42152",82,59,59,1,0,"C´s",9
42,"42022",214,171,171,2,0,"C´s",28
42,"42184",59,45,44,2,1,"C´s",7
42,"42117",148,113,111,3,2,"C´s",18
42,"42118",23,16,16,0,0,"C´s",0
42,"42012",37,29,29,0,0,"C´s",2
42,"42006",164,121,118,8,3,"C´s",22
42,"42164",1614,1208,1190,9,18,"C´s",179
42,"42004",2296,1767,1748,32,19,"C´s",268
42,"42106",15,9,9,0,0,"C´s",2
42,"42035",782,566,562,4,4,"C´s",62
42,"42215",786,555,552,8,3,"C´s",54
42,"42134",2642,1961,1938,24,23,"C´s",314
42,"42071",169,111,109,2,2,"C´s",16
42,"42087",45,38,37,0,1,"C´s",7
42,"42166",60,40,40,0,0,"C´s",7
42,"42073",72,56,56,0,0,"C´s",13
42,"42119",164,97,97,2,0,"C´s",16
42,"42028",70,49,49,0,0,"C´s",3
42,"42183",111,79,78,2,1,"C´s",9
42,"42008",57,38,38,0,0,"C´s",2
42,"42132",143,118,117,0,1,"C´s",11
42,"42157",13,10,10,1,0,"C´s",0
42,"42036",50,39,38,0,1,"C´s",3
42,"42093",40,29,29,3,0,"C´s",4
42,"42172",29,25,25,2,0,"C´s",5
42,"42135",75,53,53,1,0,"C´s",5
42,"42177",71,55,54,1,1,"C´s",9
42,"42084",26,21,21,0,0,"C´s",0
42,"42155",173,105,104,1,1,"C´s",7
42,"42196",11,10,10,0,0,"C´s",1
42,"42058",112,97,92,1,5,"C´s",17
42,"42041",35,25,25,0,0,"C´s",9
42,"42149",393,300,293,1,7,"C´s",50
42,"42154",97,78,78,1,0,"C´s",15
42,"42075",87,63,63,1,0,"C´s",11
42,"42098",11,6,6,0,0,"C´s",1
42,"42048",67,53,51,1,2,"C´s",10
42,"42145",137,121,121,3,0,"C´s",17
42,"42168",109,88,88,1,0,"C´s",8
42,"42156",30,21,21,0,0,"C´s",4
42,"42111",307,221,220,1,1,"C´s",18
42,"42038",36,27,27,2,0,"C´s",3
42,"42100",32,31,31,1,0,"C´s",1
42,"42090",93,70,69,1,1,"C´s",3
42,"42195",100,60,60,3,0,"C´s",4
42,"42209",146,111,108,3,3,"C´s",8
42,"42097",21,14,14,0,0,"C´s",1
42,"42076",219,176,173,4,3,"C´s",14
42,"42110",63,46,46,0,0,"C´s",6
42,"42092",65,42,41,1,1,"C´s",6
42,"42208",21,14,14,2,0,"C´s",3
42,"42007",117,86,86,2,0,"C´s",7
42,"42129",692,522,516,4,6,"C´s",70
42,"42190",94,71,71,1,0,"C´s",11
42,"42200",84,60,60,2,0,"C´s",5
42,"42141",111,79,79,0,0,"C´s",14
42,"42050",31,18,18,0,0,"C´s",4
42,"42187",63,55,54,1,1,"C´s",7
42,"42031",26,19,19,0,0,"C´s",2
42,"42045",312,218,214,1,4,"C´s",32
42,"42020",4288,3087,3044,42,43,"C´s",520
42,"42095",1762,1319,1303,15,16,"C´s",270
42,"42088",71,53,53,0,0,"C´s",7
42,"42003",66,59,57,1,2,"C´s",18
42,"42197",76,61,59,1,2,"C´s",5
42,"42130",60,51,50,3,1,"C´s",9
42,"42188",50,44,43,0,1,"C´s",8
42,"42042",47,38,38,2,0,"C´s",12
42,"42151",35,31,29,2,2,"C´s",9
42,"42192",41,31,31,1,0,"C´s",5
42,"42029",143,106,106,0,0,"C´s",13
42,"42173",29201,21456,21181,272,275,"C´s",3482
42,"42013",35,28,28,0,0,"C´s",3
42,"42182",57,45,45,1,0,"C´s",4
42,"42046",51,43,43,1,0,"C´s",6
42,"42034",31,22,22,0,0,"C´s",3
42,"42055",165,127,127,3,0,"C´s",10
42,"42049",120,75,73,1,2,"C´s",7
42,"42056",22,19,19,0,0,"C´s",4
42,"42174",180,149,148,1,1,"C´s",22
42,"42194",176,127,126,2,1,"C´s",19
42,"42064",85,74,74,0,0,"C´s",4
42,"42018",152,116,114,0,2,"C´s",24
42,"42086",38,29,29,1,0,"C´s",2
42,"42070",35,27,25,0,2,"C´s",0
42,"42124",64,44,44,0,0,"C´s",7
42,"42017",142,115,114,1,1,"C´s",10
42,"42009",80,65,64,2,1,"C´s",12
42,"42010",18,14,14,0,0,"C´s",2
42,"42218",80,54,54,1,0,"C´s",6
42,"42120",148,98,98,1,0,"C´s",11
42,"42198",22,17,17,0,0,"C´s",3
42,"42165",408,289,282,7,7,"C´s",41
42,"42105",49,42,42,0,0,"C´s",9
42,"42115",63,46,46,0,0,"C´s",3
42,"42191",187,135,132,2,3,"C´s",18
42,"42096",281,181,178,8,3,"C´s",15
42,"42176",29,23,23,0,0,"C´s",2
42,"42025",1216,884,873,11,11,"C´s",81
42,"42144",442,357,352,5,5,"C´s",36
42,"42057",175,106,104,1,2,"C´s",14
42,"42189",64,50,50,2,0,"C´s",8
42,"42094",608,470,463,9,7,"C´s",84
42,"42033",50,43,43,0,0,"C´s",4
42,"42039",233,148,146,2,2,"C´s",11
42,"42060",34,23,21,0,2,"C´s",4
42,"42043",3796,2833,2792,26,41,"C´s",394
42,"42159",38,33,32,1,1,"C´s",6
42,"42163",49,37,37,0,0,"C´s",2
42,"42063",49,37,37,1,0,"C´s",6
42,"42052",15,13,13,0,0,"C´s",1
42,"42026",24,20,20,0,0,"C´s",2
42,"42069",1529,1078,1066,10,12,"C´s",114
42,"42037",34,17,17,1,0,"C´s",5
42,"42082",9,8,8,1,0,"C´s",1
42,"42128",39,37,37,1,0,"C´s",4
42,"42181",419,318,312,3,6,"C´s",29
42,"42121",64,48,48,1,0,"C´s",6
42,"42044",53,49,47,3,2,"C´s",15
42,"42053",26,21,21,1,0,"C´s",2
42,"42024",87,68,67,0,1,"C´s",9
42,"42217",31,25,25,0,0,"C´s",4
42,"42175",23,18,18,0,0,"C´s",3
42,"42108",12,10,10,0,0,"C´s",1
42,"42103",583,467,459,5,8,"C´s",71
42,"42089",55,46,46,1,0,"C´s",6
42,"42123",165,119,119,4,0,"C´s",25
42,"42021",85,53,53,1,0,"C´s",10
42,"42211",83,67,67,1,0,"C´s",8
42,"42131",50,32,32,0,0,"C´s",3
42,"42078",1031,752,744,6,8,"C´s",105
42,"42061",292,221,219,2,2,"C´s",42
42,"42107",74,51,48,1,3,"C´s",7
42,"42140",16,10,10,1,0,"C´s",0
42,"42059",20,14,14,0,0,"C´s",4
42,"42032",148,117,117,0,0,"C´s",10
42,"42206",8,5,5,0,0,"C´s",1
42,"42062",25,16,15,0,1,"C´s",0
42,"42161",140,106,106,2,0,"C´s",13
42,"42212",69,54,54,3,0,"C´s",13
42,"42065",22,20,19,0,1,"C´s",3
42,"42014",66,43,43,2,0,"C´s",4
42,"42051",21,15,15,0,0,"C´s",4
42,"42201",23,23,22,0,1,"C´s",2
42,"42202",24,12,11,0,1,"C´s",0
42,"42153",14,14,14,1,0,"C´s",0
42,"42185",25,21,21,0,0,"C´s",2
42,"42204",56,39,38,0,1,"C´s",10
42,"42158",110,78,78,1,0,"C´s",7
42,"42142",52,33,33,0,0,"C´s",8
42,"42080",155,113,110,0,3,"C´s",12
42,"42213",29,18,18,1,0,"C´s",3
42,"42167",259,195,194,2,1,"C´s",27
42,"42113",512,390,386,3,4,"C´s",42
42,"42216",25,21,21,0,0,"C´s",0
42,"42127",40,27,27,1,0,"C´s",2
42,"42081",143,111,106,2,5,"C´s",10
44,"44169",351,268,266,3,2,"IU-CHA-UPeC",2
44,"44013",11254,8292,8205,82,87,"IU-CHA-UPeC",391
44,"44059",541,431,423,7,8,"IU-CHA-UPeC",9
44,"44176",160,127,127,0,0,"IU-CHA-UPeC",4
44,"44112",426,293,284,2,9,"IU-CHA-UPeC",15
44,"44036",24,16,16,0,0,"IU-CHA-UPeC",1
44,"44084",55,45,45,0,0,"IU-CHA-UPeC",1
44,"44231",38,32,32,0,0,"IU-CHA-UPeC",5
44,"44151",191,147,145,1,2,"IU-CHA-UPeC",7
44,"44061",71,57,54,1,3,"IU-CHA-UPeC",0
44,"44021",107,83,83,2,0,"IU-CHA-UPeC",3
44,"44093",76,60,60,0,0,"IU-CHA-UPeC",7
44,"44108",331,238,234,4,4,"IU-CHA-UPeC",4
44,"44094",113,102,100,1,2,"IU-CHA-UPeC",1
44,"44213",63,47,47,0,0,"IU-CHA-UPeC",2
44,"44228",99,79,79,1,0,"IU-CHA-UPeC",1
44,"44241",537,408,403,2,5,"IU-CHA-UPeC",10
44,"44211",40,30,30,0,0,"IU-CHA-UPeC",3
44,"44124",78,58,58,1,0,"IU-CHA-UPeC",7
44,"44189",58,40,40,1,0,"IU-CHA-UPeC",1
44,"44118",165,127,125,2,2,"IU-CHA-UPeC",3
44,"44200",40,22,22,0,0,"IU-CHA-UPeC",0
44,"44221",365,298,296,2,2,"IU-CHA-UPeC",9
44,"44040",202,160,158,3,2,"IU-CHA-UPeC",5
44,"44163",128,94,94,0,0,"IU-CHA-UPeC",5
44,"44173",101,85,84,0,1,"IU-CHA-UPeC",0
44,"44146",173,157,157,1,0,"IU-CHA-UPeC",0
44,"44234",62,48,48,1,0,"IU-CHA-UPeC",0
44,"44223",75,55,55,2,0,"IU-CHA-UPeC",2
44,"44111",92,69,69,0,0,"IU-CHA-UPeC",10
44,"44028",191,150,142,1,8,"IU-CHA-UPeC",3
44,"44074",430,338,329,5,9,"IU-CHA-UPeC",5
44,"44092",80,53,52,0,1,"IU-CHA-UPeC",6
44,"44014",2530,2008,1966,17,42,"IU-CHA-UPeC",197
44,"44133",23,17,17,0,0,"IU-CHA-UPeC",0
44,"44141",135,105,104,1,1,"IU-CHA-UPeC",1
44,"44113",72,50,50,0,0,"IU-CHA-UPeC",12
44,"44137",205,159,159,2,0,"IU-CHA-UPeC",5
44,"44064",70,51,51,0,0,"IU-CHA-UPeC",0
44,"44103",130,106,106,0,0,"IU-CHA-UPeC",1
44,"44099",708,514,510,1,4,"IU-CHA-UPeC",65
44,"44065",55,36,36,1,0,"IU-CHA-UPeC",1
44,"44240",161,128,125,0,3,"IU-CHA-UPeC",6
44,"44038",107,83,83,2,0,"IU-CHA-UPeC",3
44,"44192",364,280,278,0,2,"IU-CHA-UPeC",15
44,"44035",117,81,81,0,0,"IU-CHA-UPeC",2
44,"44045",355,290,286,2,4,"IU-CHA-UPeC",15
44,"44062",35,27,26,0,1,"IU-CHA-UPeC",0
44,"44191",771,595,586,7,9,"IU-CHA-UPeC",111
44,"44212",41,32,32,0,0,"IU-CHA-UPeC",3
44,"44172",310,216,216,6,0,"IU-CHA-UPeC",3
44,"44264",253,211,210,2,1,"IU-CHA-UPeC",11
44,"44026",90,71,71,0,0,"IU-CHA-UPeC",3
44,"44047",221,139,135,0,4,"IU-CHA-UPeC",10
44,"44052",80,55,54,0,1,"IU-CHA-UPeC",3
44,"44044",91,70,70,0,0,"IU-CHA-UPeC",1
44,"44071",599,430,424,8,6,"IU-CHA-UPeC",16
44,"44193",82,62,62,1,0,"IU-CHA-UPeC",1
44,"44157",65,41,40,0,1,"IU-CHA-UPeC",2
44,"44114",244,186,185,3,1,"IU-CHA-UPeC",2
44,"44019",68,49,48,1,1,"IU-CHA-UPeC",1
44,"44003",19,16,16,0,0,"IU-CHA-UPeC",0
44,"44178",56,42,42,0,0,"IU-CHA-UPeC",1
44,"44195",92,61,61,2,0,"IU-CHA-UPeC",4
44,"44090",82,57,57,0,0,"IU-CHA-UPeC",2
44,"44063",78,61,61,0,0,"IU-CHA-UPeC",6
44,"44131",26,20,20,0,0,"IU-CHA-UPeC",4
44,"44235",91,71,70,2,1,"IU-CHA-UPeC",3
44,"44150",32,21,20,0,1,"IU-CHA-UPeC",1
44,"44239",22,20,20,0,0,"IU-CHA-UPeC",1
44,"44145",1029,768,763,7,5,"IU-CHA-UPeC",20
44,"44053",102,79,73,0,6,"IU-CHA-UPeC",3
44,"44182",194,155,154,3,1,"IU-CHA-UPeC",3
44,"44056",513,348,341,4,7,"IU-CHA-UPeC",11
44,"44149",99,71,71,3,0,"IU-CHA-UPeC",3
44,"44190",72,53,52,0,1,"IU-CHA-UPeC",0
44,"44068",664,519,515,4,4,"IU-CHA-UPeC",10
44,"44120",222,140,138,2,2,"IU-CHA-UPeC",13
44,"44196",134,102,102,1,0,"IU-CHA-UPeC",4
44,"44132",61,50,50,1,0,"IU-CHA-UPeC",0
44,"44004",415,295,291,3,4,"IU-CHA-UPeC",23
44,"44088",30,26,26,2,0,"IU-CHA-UPeC",0
44,"44210",759,597,596,2,1,"IU-CHA-UPeC",35
44,"44143",388,310,309,3,1,"IU-CHA-UPeC",8
44,"44219",198,141,134,4,7,"IU-CHA-UPeC",1
44,"44232",391,286,279,4,7,"IU-CHA-UPeC",9
44,"44039",219,162,160,2,2,"IU-CHA-UPeC",2
44,"44060",40,35,35,1,0,"IU-CHA-UPeC",0
44,"44181",78,63,63,1,0,"IU-CHA-UPeC",0
44,"44156",46,33,32,1,1,"IU-CHA-UPeC",1
44,"44258",69,46,46,0,0,"IU-CHA-UPeC",1
44,"44085",52,40,40,4,0,"IU-CHA-UPeC",2
44,"44198",187,151,148,3,3,"IU-CHA-UPeC",8
44,"44165",184,153,152,1,1,"IU-CHA-UPeC",5
44,"44184",48,30,30,0,0,"IU-CHA-UPeC",0
44,"44237",408,327,321,2,6,"IU-CHA-UPeC",6
44,"44247",314,230,228,2,2,"IU-CHA-UPeC",11
44,"44243",23,18,18,0,0,"IU-CHA-UPeC",0
44,"44238",2345,1743,1729,7,14,"IU-CHA-UPeC",73
44,"44229",151,108,107,1,1,"IU-CHA-UPeC",4
44,"44135",115,89,86,0,3,"IU-CHA-UPeC",2
44,"44266",118,95,95,0,0,"IU-CHA-UPeC",1
44,"44185",104,77,77,0,0,"IU-CHA-UPeC",7
44,"44225",111,76,76,4,0,"IU-CHA-UPeC",1
44,"44265",188,144,138,2,6,"IU-CHA-UPeC",7
44,"44002",54,41,41,0,0,"IU-CHA-UPeC",2
44,"44230",155,126,126,2,0,"IU-CHA-UPeC",3
44,"44158",1170,898,872,12,26,"IU-CHA-UPeC",32
44,"44107",216,162,162,1,0,"IU-CHA-UPeC",0
44,"44080",292,221,218,4,3,"IU-CHA-UPeC",11
44,"44049",850,624,613,8,11,"IU-CHA-UPeC",28
44,"44033",279,193,191,2,2,"IU-CHA-UPeC",3
44,"44174",430,314,313,2,1,"IU-CHA-UPeC",11
44,"44007",184,124,120,0,4,"IU-CHA-UPeC",1
44,"44153",1812,1209,1196,15,13,"IU-CHA-UPeC",49
44,"44227",75,63,63,0,0,"IU-CHA-UPeC",1
44,"44075",324,256,250,4,6,"IU-CHA-UPeC",6
44,"44025",6062,4490,4394,48,96,"IU-CHA-UPeC",471
44,"44159",39,34,34,0,0,"IU-CHA-UPeC",4
44,"44250",19,12,12,2,0,"IU-CHA-UPeC",1
44,"44175",121,91,89,2,2,"IU-CHA-UPeC",4
44,"44215",156,105,103,2,2,"IU-CHA-UPeC",2
44,"44201",497,414,410,2,4,"IU-CHA-UPeC",11
44,"44152",67,48,48,1,0,"IU-CHA-UPeC",0
44,"44089",46,42,42,0,0,"IU-CHA-UPeC",0
44,"44008",1615,1217,1200,7,17,"IU-CHA-UPeC",62
44,"44206",112,90,88,0,2,"IU-CHA-UPeC",4
44,"44147",419,312,307,5,5,"IU-CHA-UPeC",18
44,"44267",71,50,50,0,0,"IU-CHA-UPeC",0
44,"44171",183,136,135,1,1,"IU-CHA-UPeC",5
44,"44167",38,31,31,0,0,"IU-CHA-UPeC",0
44,"44148",93,76,76,3,0,"IU-CHA-UPeC",0
44,"44203",10,8,8,0,0,"IU-CHA-UPeC",0
44,"44246",1554,1091,1079,13,12,"IU-CHA-UPeC",60
44,"44268",28,24,24,0,0,"IU-CHA-UPeC",0
44,"44256",39,34,34,1,0,"IU-CHA-UPeC",0
44,"44224",22,14,14,0,0,"IU-CHA-UPeC",0
44,"44041",54,46,46,2,0,"IU-CHA-UPeC",6
44,"44110",52,46,44,0,2,"IU-CHA-UPeC",2
44,"44086",453,355,350,3,5,"IU-CHA-UPeC",16
44,"44168",191,137,131,3,6,"IU-CHA-UPeC",4
44,"44204",25,22,22,0,0,"IU-CHA-UPeC",0
44,"44006",250,188,186,1,2,"IU-CHA-UPeC",3
44,"44106",159,127,126,3,1,"IU-CHA-UPeC",8
44,"44130",34,24,24,0,0,"IU-CHA-UPeC",0
44,"44023",18,15,15,0,0,"IU-CHA-UPeC",0
44,"44037",453,326,321,5,5,"IU-CHA-UPeC",6
44,"44123",105,69,69,1,0,"IU-CHA-UPeC",0
44,"44183",77,45,44,0,1,"IU-CHA-UPeC",0
44,"44222",137,96,96,0,0,"IU-CHA-UPeC",1
44,"44042",127,93,92,1,1,"IU-CHA-UPeC",1
44,"44067",117,80,80,0,0,"IU-CHA-UPeC",4
44,"44127",73,51,50,0,1,"IU-CHA-UPeC",0
44,"44209",839,640,623,3,17,"IU-CHA-UPeC",21
44,"44245",250,189,186,1,3,"IU-CHA-UPeC",5
44,"44050",3129,2135,2103,30,32,"IU-CHA-UPeC",97
44,"44102",31,25,25,0,0,"IU-CHA-UPeC",2
44,"44029",567,475,467,5,8,"IU-CHA-UPeC",29
44,"44082",91,68,67,0,1,"IU-CHA-UPeC",0
44,"44205",712,474,468,6,6,"IU-CHA-UPeC",9
44,"44046",48,31,31,2,0,"IU-CHA-UPeC",0
44,"44142",36,27,27,5,0,"IU-CHA-UPeC",3
44,"44179",345,229,227,2,2,"IU-CHA-UPeC",10
44,"44226",141,102,100,2,2,"IU-CHA-UPeC",4
44,"44066",110,83,83,1,0,"IU-CHA-UPeC",3
44,"44012",336,279,276,2,3,"IU-CHA-UPeC",11
44,"44116",83,67,65,1,2,"IU-CHA-UPeC",5
44,"44022",490,323,316,9,7,"IU-CHA-UPeC",14
44,"44117",347,278,274,2,4,"IU-CHA-UPeC",12
44,"44100",187,154,153,0,1,"IU-CHA-UPeC",10
44,"44105",80,62,62,0,0,"IU-CHA-UPeC",0
44,"44207",158,119,115,0,4,"IU-CHA-UPeC",6
44,"44194",111,79,75,0,4,"IU-CHA-UPeC",4
44,"44208",34,22,22,0,0,"IU-CHA-UPeC",0
44,"44218",37,26,26,0,0,"IU-CHA-UPeC",0
44,"44101",59,44,44,0,0,"IU-CHA-UPeC",3
44,"44155",1102,831,825,7,6,"IU-CHA-UPeC",88
44,"44262",137,107,107,1,0,"IU-CHA-UPeC",1
44,"44001",68,50,50,0,0,"IU-CHA-UPeC",8
44,"44199",43,36,36,1,0,"IU-CHA-UPeC",2
44,"44010",178,124,121,2,3,"IU-CHA-UPeC",1
44,"44077",75,58,57,0,1,"IU-CHA-UPeC",0
44,"44260",139,100,98,2,2,"IU-CHA-UPeC",8
44,"44027",161,122,121,4,1,"IU-CHA-UPeC",3
44,"44164",26,22,22,0,0,"IU-CHA-UPeC",0
44,"44128",69,50,50,0,0,"IU-CHA-UPeC",2
44,"44043",108,75,75,1,0,"IU-CHA-UPeC",4
44,"44177",111,77,76,1,1,"IU-CHA-UPeC",7
44,"44136",49,42,42,1,0,"IU-CHA-UPeC",0
44,"44261",734,552,542,8,10,"IU-CHA-UPeC",21
44,"44197",58,34,34,0,0,"IU-CHA-UPeC",3
44,"44024",27,23,23,0,0,"IU-CHA-UPeC",1
44,"44244",75,39,39,0,0,"IU-CHA-UPeC",0
44,"44154",261,194,191,3,3,"IU-CHA-UPeC",5
44,"44125",65,39,39,0,0,"IU-CHA-UPeC",0
44,"44115",106,93,92,4,1,"IU-CHA-UPeC",0
44,"44034",138,112,110,2,2,"IU-CHA-UPeC",6
44,"44216",26539,19621,19346,248,275,"IU-CHA-UPeC",1012
44,"44070",55,47,46,1,1,"IU-CHA-UPeC",1
44,"44257",167,120,120,1,0,"IU-CHA-UPeC",6
44,"44263",369,265,259,2,6,"IU-CHA-UPeC",16
44,"44009",809,586,578,5,8,"IU-CHA-UPeC",23
44,"44032",16,13,13,0,0,"IU-CHA-UPeC",0
44,"44180",71,57,56,1,1,"IU-CHA-UPeC",0
44,"44252",85,67,66,0,1,"IU-CHA-UPeC",0
44,"44251",254,202,194,2,8,"IU-CHA-UPeC",0
44,"44087",81,70,70,3,0,"IU-CHA-UPeC",3
44,"44119",135,94,90,2,4,"IU-CHA-UPeC",1
44,"44076",2234,1759,1729,16,30,"IU-CHA-UPeC",66
44,"44097",147,89,87,1,2,"IU-CHA-UPeC",1
44,"44016",486,361,357,7,4,"IU-CHA-UPeC",13
44,"44249",57,47,47,3,0,"IU-CHA-UPeC",3
44,"44220",121,85,82,2,3,"IU-CHA-UPeC",1
44,"44017",285,221,220,0,1,"IU-CHA-UPeC",8
44,"44126",334,239,235,7,4,"IU-CHA-UPeC",12
44,"44160",478,329,322,5,7,"IU-CHA-UPeC",13
44,"44048",65,51,51,0,0,"IU-CHA-UPeC",0
44,"44217",28,20,20,0,0,"IU-CHA-UPeC",1
44,"44121",60,43,43,0,0,"IU-CHA-UPeC",1
44,"44005",54,38,37,2,1,"IU-CHA-UPeC",1
44,"44138",140,79,77,0,2,"IU-CHA-UPeC",1
44,"44236",59,45,45,0,0,"IU-CHA-UPeC",1
44,"44051",2704,2074,2046,32,28,"IU-CHA-UPeC",42
44,"44187",199,148,143,1,5,"IU-CHA-UPeC",1
44,"44129",41,34,34,0,0,"IU-CHA-UPeC",0
44,"44031",99,64,64,0,0,"IU-CHA-UPeC",0
44,"44144",351,256,252,1,4,"IU-CHA-UPeC",11
44,"44020",24,20,19,1,1,"IU-CHA-UPeC",1
44,"44096",161,141,139,0,2,"IU-CHA-UPeC",9
44,"44011",57,35,35,0,0,"IU-CHA-UPeC",4
44,"44109",110,76,74,1,2,"IU-CHA-UPeC",4
44,"44161",447,324,320,3,4,"IU-CHA-UPeC",6
44,"44054",109,90,90,0,0,"IU-CHA-UPeC",6
44,"44018",20,20,20,0,0,"IU-CHA-UPeC",0
44,"44055",69,52,51,3,1,"IU-CHA-UPeC",0
44,"44122",1356,971,969,12,2,"IU-CHA-UPeC",59
14,"14056",23613,17016,16804,128,212,"PACMA",122
14,"14021",260189,188939,187558,1934,1381,"PACMA",2008
14,"14002",10951,8231,8150,72,81,"PACMA",36
14,"14068",545,410,407,6,3,"PACMA",4
14,"14066",5890,4366,4322,29,44,"PACMA",27
14,"14046",4484,3540,3487,22,53,"PACMA",18
14,"14005",6358,4379,4272,56,107,"PACMA",21
14,"14025",2950,2460,2425,10,35,"PACMA",19
14,"14032",425,347,335,3,12,"PACMA",0
14,"14022",4036,3199,3169,9,30,"PACMA",12
14,"14058",7973,5860,5791,49,69,"PACMA",30
14,"14008",2871,2053,2034,11,19,"PACMA",14
14,"14026",2073,1437,1421,13,16,"PACMA",2
14,"14042",18921,14842,14653,184,189,"PACMA",98
14,"14023",2041,1742,1717,13,25,"PACMA",7
14,"14012",6190,4574,4488,27,86,"PACMA",15
14,"14057",6152,4973,4903,56,70,"PACMA",25
14,"14009",2779,1941,1934,13,7,"PACMA",7
14,"14031",597,490,484,0,6,"PACMA",0
14,"14047",1654,1221,1211,17,10,"PACMA",5
14,"14004",2036,1502,1488,6,14,"PACMA",8
14,"14007",15200,11064,10926,81,138,"PACMA",51
14,"14071",937,651,642,2,9,"PACMA",2
14,"14011",584,477,476,3,1,"PACMA",0
14,"14050",2399,1886,1864,11,22,"PACMA",9
14,"14048",1206,967,949,11,18,"PACMA",7
14,"14015",2149,1637,1616,13,21,"PACMA",5
14,"14035",5992,4475,4437,44,38,"PACMA",8
14,"14018",3710,2882,2846,28,36,"PACMA",13
14,"14013",16845,12599,12414,146,185,"PACMA",138
14,"14001",3552,2861,2830,28,31,"PACMA",13
14,"14043",7574,5571,5510,46,61,"PACMA",18
14,"14067",3874,3033,2986,29,47,"PACMA",13
14,"14037",3344,2476,2442,20,34,"PACMA",20
14,"14052",9447,6250,6201,49,49,"PACMA",34
14,"14063",1065,803,797,4,6,"PACMA",6
14,"14064",331,252,244,2,8,"PACMA",0
14,"14059",699,559,552,5,7,"PACMA",1
14,"14027",7908,6085,6008,57,77,"PACMA",45
14,"14006",1331,1166,1137,7,29,"PACMA",1
14,"14010",4051,3003,2968,17,35,"PACMA",14
14,"14049",16357,12206,12029,127,177,"PACMA",89
14,"14074",2303,1940,1929,13,11,"PACMA",2
14,"14030",8580,6619,6542,66,77,"PACMA",35
14,"14065",1861,1461,1446,12,15,"PACMA",6
14,"14033",1285,980,963,11,17,"PACMA",9
14,"14029",4206,3170,3135,32,35,"PACMA",15
14,"14051",1401,1095,1077,5,18,"PACMA",4
14,"14060",4854,3695,3633,43,62,"PACMA",16
14,"14040",3792,3036,3010,23,26,"PACMA",13
14,"14014",2570,2104,2075,8,29,"PACMA",8
14,"14017",10869,8130,8029,72,101,"PACMA",45
14,"14020",391,278,274,3,4,"PACMA",0
14,"14072",1079,834,830,5,4,"PACMA",5
14,"14062",1052,813,801,4,12,"PACMA",1
14,"14054",13665,10923,10678,103,245,"PACMA",40
14,"14055",18572,13587,13410,167,177,"PACMA",72
14,"14028",320,246,244,2,2,"PACMA",0
14,"14061",756,606,592,2,14,"PACMA",1
14,"14053",6050,4498,4427,56,71,"PACMA",27
14,"14073",2900,2068,2041,15,27,"PACMA",2
14,"14036",3767,2911,2857,53,54,"PACMA",16
14,"14038",32236,22982,22773,209,209,"PACMA",150
14,"14075",581,463,446,6,17,"PACMA",0
14,"14070",1343,1026,1008,9,18,"PACMA",3
14,"14045",3055,2486,2451,13,35,"PACMA",12
14,"14039",2628,2151,2123,11,28,"PACMA",3
14,"14019",6479,5131,5076,46,55,"PACMA",22
14,"14003",1265,981,970,6,11,"PACMA",4
14,"14034",318,260,252,2,8,"PACMA",1
14,"14069",7536,5574,5495,48,79,"PACMA",18
14,"14044",1624,1285,1267,9,18,"PACMA",8
14,"14016",1364,1047,1045,3,2,"PACMA",4
14,"14024",1920,1522,1488,10,34,"PACMA",9
14,"14041",3180,2404,2373,26,31,"PACMA",7
26,"26124",824,664,659,8,5,"PCPE",0
26,"26073",98,83,83,0,0,"PCPE",1
26,"26103",789,626,616,3,10,"PCPE",2
26,"26161",7,7,7,0,0,"PCPE",0
26,"26166",142,131,128,1,3,"PCPE",0
26,"26179",42,34,33,0,1,"PCPE",0
26,"26111",248,195,192,1,3,"PCPE",1
26,"26061",1548,1179,1160,14,19,"PCPE",0
26,"26003",416,336,330,2,6,"PCPE",0
26,"26060",85,67,67,1,0,"PCPE",0
26,"26089",110513,85146,84302,712,844,"PCPE",130
26,"26177",309,266,264,2,2,"PCPE",0
26,"26181",15,13,13,0,0,"PCPE",0
26,"26059",1117,850,840,9,10,"PCPE",0
26,"26091",166,141,138,0,3,"PCPE",0
26,"26115",17,14,14,0,0,"PCPE",0
26,"26030",12,12,12,0,0,"PCPE",0
26,"26152",31,24,23,0,1,"PCPE",0
26,"26088",36,32,31,0,1,"PCPE",0
26,"26174",147,122,112,0,10,"PCPE",0
26,"26057",51,47,45,0,2,"PCPE",0
26,"26131",34,33,33,1,0,"PCPE",0
26,"26173",6,6,6,1,0,"PCPE",0
26,"26149",61,48,48,0,0,"PCPE",0
26,"26157",296,236,232,3,4,"PCPE",0
26,"26063",122,97,96,0,1,"PCPE",1
26,"26151",446,380,375,1,5,"PCPE",0
26,"26169",64,60,60,0,0,"PCPE",0
26,"26155",162,138,137,0,1,"PCPE",0
26,"26128",104,80,79,0,1,"PCPE",1
26,"26037",131,111,111,1,0,"PCPE",0
26,"26122",119,104,102,2,2,"PCPE",0
26,"26078",83,68,68,0,0,"PCPE",0
26,"26045",12,12,12,0,0,"PCPE",0
26,"26108",268,207,205,5,2,"PCPE",0
26,"26101",46,34,34,0,0,"PCPE",0
26,"26051",254,202,201,2,1,"PCPE",0
26,"26114",80,71,71,2,0,"PCPE",0
26,"26077",27,25,25,0,0,"PCPE",0
26,"26035",16,12,12,0,0,"PCPE",0
26,"26013",356,264,262,3,2,"PCPE",0
26,"26065",50,40,40,0,0,"PCPE",0
26,"26049",174,127,121,0,6,"PCPE",0
26,"26100",52,43,43,0,0,"PCPE",0
26,"26021",2819,2113,2077,23,36,"PCPE",0
26,"26145",245,202,201,3,1,"PCPE",1
26,"26136",103,73,72,1,1,"PCPE",0
26,"26066",265,217,209,3,8,"PCPE",0
26,"26168",5318,3853,3802,36,51,"PCPE",10
26,"26092",108,83,82,0,1,"PCPE",0
26,"26120",1457,1144,1133,9,11,"PCPE",1
26,"26031",106,81,81,0,0,"PCPE",0
26,"26127",215,182,179,2,3,"PCPE",0
26,"26027",157,127,127,1,0,"PCPE",0
26,"26119",202,163,162,4,1,"PCPE",0
26,"26080",475,392,388,6,4,"PCPE",0
26,"26050",117,86,86,0,0,"PCPE",0
26,"26126",31,29,29,0,0,"PCPE",0
26,"26025",85,71,71,1,0,"PCPE",0
26,"26032",53,40,40,0,0,"PCPE",0
26,"26014",466,319,319,0,0,"PCPE",2
26,"26024",236,183,183,0,0,"PCPE",0
26,"26012",23,23,23,0,0,"PCPE",0
26,"26095",101,78,77,1,1,"PCPE",0
26,"26183",65,50,50,0,0,"PCPE",0
26,"26107",92,75,75,0,0,"PCPE",0
26,"26130",203,167,166,1,1,"PCPE",0
26,"26132",111,88,88,1,0,"PCPE",1
26,"26052",158,125,125,0,0,"PCPE",0
26,"26146",101,78,77,0,1,"PCPE",0
26,"26098",94,72,71,1,1,"PCPE",0
26,"26033",172,143,142,2,1,"PCPE",1
26,"26135",167,120,119,0,1,"PCPE",2
26,"26075",334,268,264,2,4,"PCPE",0
26,"26144",194,150,148,2,2,"PCPE",0
26,"26158",265,220,217,4,3,"PCPE",0
26,"26163",143,117,117,2,0,"PCPE",0
26,"26148",171,147,145,0,2,"PCPE",0
26,"26129",971,768,757,2,11,"PCPE",0
26,"26074",105,86,85,1,1,"PCPE",0
26,"26022",198,159,158,0,1,"PCPE",0
26,"26110",162,135,134,0,1,"PCPE",0
26,"26140",260,221,218,1,3,"PCPE",0
26,"26084",6630,5015,4952,27,63,"PCPE",8
26,"26046",1594,1221,1209,3,12,"PCPE",2
26,"26079",639,536,527,2,9,"PCPE",0
26,"26147",30,26,26,0,0,"PCPE",0
26,"26006",1809,1420,1410,14,10,"PCPE",1
26,"26068",82,68,66,0,2,"PCPE",0
26,"26172",30,25,25,0,0,"PCPE",1
26,"26011",7336,5309,5255,57,54,"PCPE",3
26,"26176",54,46,43,1,3,"PCPE",0
26,"26015",193,151,149,0,2,"PCPE",0
26,"26160",715,569,567,3,2,"PCPE",0
26,"26165",364,315,311,1,4,"PCPE",0
26,"26094",85,71,68,0,3,"PCPE",0
26,"26036",16990,12136,11984,98,152,"PCPE",15
26,"26082",109,92,89,0,3,"PCPE",0
26,"26072",289,259,258,2,1,"PCPE",2
26,"26017",383,302,301,4,1,"PCPE",1
26,"26056",425,357,353,6,4,"PCPE",0
26,"26109",85,76,74,1,2,"PCPE",0
26,"26112",243,192,191,1,1,"PCPE",0
26,"26040",68,62,62,0,0,"PCPE",0
26,"26028",133,112,111,0,1,"PCPE",0
26,"26020",483,356,344,2,12,"PCPE",1
26,"26081",16,14,14,0,0,"PCPE",0
26,"26178",80,64,63,1,1,"PCPE",1
26,"26008",1862,1442,1425,7,17,"PCPE",0
26,"26171",179,136,126,1,10,"PCPE",0
26,"26175",52,44,44,2,0,"PCPE",0
26,"26170",448,346,344,8,2,"PCPE",0
26,"26047",1969,1614,1596,14,18,"PCPE",0
26,"26055",42,33,33,0,0,"PCPE",0
26,"26167",59,45,45,1,0,"PCPE",0
26,"26009",414,326,319,3,7,"PCPE",0
26,"26105",2187,1722,1696,16,26,"PCPE",0
26,"26029",37,31,31,0,0,"PCPE",0
26,"26123",130,111,108,0,3,"PCPE",0
26,"26026",1323,1070,1060,8,10,"PCPE",1
26,"26153",12,11,10,0,1,"PCPE",0
26,"26062",90,73,71,0,2,"PCPE",0
26,"26071",8477,6115,6029,51,86,"PCPE",9
26,"26044",51,46,45,0,1,"PCPE",0
26,"26141",112,85,83,1,2,"PCPE",0
26,"26070",186,154,153,1,1,"PCPE",0
26,"26007",523,406,401,2,5,"PCPE",0
26,"26099",1259,1038,1024,7,14,"PCPE",0
26,"26139",54,46,46,0,0,"PCPE",0
26,"26083",289,213,213,1,0,"PCPE",0
26,"26180",221,182,179,0,3,"PCPE",0
26,"26043",373,284,282,4,2,"PCPE",1
26,"26019",351,282,281,1,1,"PCPE",0
26,"26142",780,618,613,1,5,"PCPE",0
26,"26067",23,20,20,0,0,"PCPE",0
26,"26125",2708,2013,1988,22,25,"PCPE",2
26,"26034",660,522,513,1,9,"PCPE",0
26,"26054",324,255,254,3,1,"PCPE",0
26,"26143",217,178,177,0,1,"PCPE",0
26,"26093",57,44,44,0,0,"PCPE",0
26,"26010",98,78,78,1,0,"PCPE",0
26,"26041",134,97,94,1,3,"PCPE",0
26,"26053",208,161,160,1,1,"PCPE",0
26,"26096",244,199,197,3,2,"PCPE",0
26,"26002",840,615,608,6,7,"PCPE",4
26,"26117",2168,1695,1662,19,33,"PCPE",0
26,"26042",836,645,635,5,10,"PCPE",0
26,"26016",28,24,24,1,0,"PCPE",0
26,"26018",10469,8216,8110,71,106,"PCPE",7
26,"26004",68,53,53,1,0,"PCPE",0
26,"26154",11,8,8,0,0,"PCPE",0
26,"26113",37,34,32,0,2,"PCPE",0
26,"26023",468,358,355,4,3,"PCPE",2
26,"26087",208,157,154,4,3,"PCPE",0
26,"26038",95,66,65,0,1,"PCPE",0
26,"26001",197,163,155,3,8,"PCPE",1
26,"26104",14,9,9,0,0,"PCPE",0
26,"26005",2343,1607,1590,19,17,"PCPE",3
26,"26064",2278,1736,1715,17,21,"PCPE",0
26,"26048",22,22,21,0,1,"PCPE",0
26,"26134",87,65,65,1,0,"PCPE",0
26,"26069",240,201,199,0,2,"PCPE",1
26,"26121",27,21,21,0,0,"PCPE",0
26,"26058",150,114,113,0,1,"PCPE",1
26,"26164",61,41,41,0,0,"PCPE",0
26,"26118",61,49,49,1,0,"PCPE",0
26,"26076",128,111,110,2,1,"PCPE",1
26,"26138",4600,3374,3325,28,49,"PCPE",4
26,"26162",121,106,106,2,0,"PCPE",0
26,"26106",88,78,78,0,0,"PCPE",0
26,"26039",38,35,35,0,0,"PCPE",0
26,"26102",6128,4673,4585,42,88,"PCPE",2
26,"26150",117,98,98,1,0,"PCPE",0
26,"26086",15,15,15,0,0,"PCPE",0
42,"42096",281,181,178,8,3,"PACMA",0
42,"42116",47,33,33,0,0,"PACMA",0
42,"42058",112,97,92,1,5,"PACMA",1
42,"42010",18,14,14,0,0,"PACMA",0
42,"42081",143,111,106,2,5,"PACMA",0
42,"42003",66,59,57,1,2,"PACMA",1
42,"42148",10,10,10,0,0,"PACMA",0
42,"42187",63,55,54,1,1,"PACMA",0
42,"42062",25,16,15,0,1,"PACMA",0
42,"42152",82,59,59,1,0,"PACMA",0
42,"42012",37,29,29,0,0,"PACMA",0
42,"42016",18,13,13,0,0,"PACMA",0
42,"42120",148,98,98,1,0,"PACMA",0
42,"42036",50,39,38,0,1,"PACMA",0
42,"42183",111,79,78,2,1,"PACMA",0
42,"42018",152,116,114,0,2,"PACMA",0
42,"42157",13,10,10,1,0,"PACMA",0
42,"42193",16,11,11,0,0,"PACMA",0
42,"42206",8,5,5,0,0,"PACMA",0
42,"42006",164,121,118,8,3,"PACMA",0
42,"42158",110,78,78,1,0,"PACMA",0
42,"42041",35,25,25,0,0,"PACMA",0
42,"42004",2296,1767,1748,32,19,"PACMA",1
42,"42032",148,117,117,0,0,"PACMA",0
42,"42068",85,62,61,2,1,"PACMA",0
42,"42202",24,12,11,0,1,"PACMA",0
42,"42024",87,68,67,0,1,"PACMA",0
42,"42038",36,27,27,2,0,"PACMA",0
42,"42092",65,42,41,1,1,"PACMA",0
42,"42130",60,51,50,3,1,"PACMA",0
42,"42134",2642,1961,1938,24,23,"PACMA",5
42,"42100",32,31,31,1,0,"PACMA",0
42,"42087",45,38,37,0,1,"PACMA",0
42,"42196",11,10,10,0,0,"PACMA",0
42,"42197",76,61,59,1,2,"PACMA",0
42,"42098",11,6,6,0,0,"PACMA",0
42,"42142",52,33,33,0,0,"PACMA",0
42,"42118",23,16,16,0,0,"PACMA",0
42,"42105",49,42,42,0,0,"PACMA",0
42,"42149",393,300,293,1,7,"PACMA",2
42,"42162",2363,1690,1672,21,18,"PACMA",1
42,"42073",72,56,56,0,0,"PACMA",0
42,"42052",15,13,13,0,0,"PACMA",0
42,"42145",137,121,121,3,0,"PACMA",0
42,"42007",117,86,86,2,0,"PACMA",1
42,"42026",24,20,20,0,0,"PACMA",0
42,"42070",35,27,25,0,2,"PACMA",0
42,"42132",143,118,117,0,1,"PACMA",1
42,"42208",21,14,14,2,0,"PACMA",0
42,"42050",31,18,18,0,0,"PACMA",0
42,"42015",32,25,25,0,0,"PACMA",0
42,"42191",187,135,132,2,3,"PACMA",0
42,"42093",40,29,29,3,0,"PACMA",0
42,"42094",608,470,463,9,7,"PACMA",2
42,"42189",64,50,50,2,0,"PACMA",1
42,"42035",782,566,562,4,4,"PACMA",0
42,"42161",140,106,106,2,0,"PACMA",0
42,"42106",15,9,9,0,0,"PACMA",1
42,"42078",1031,752,744,6,8,"PACMA",2
42,"42176",29,23,23,0,0,"PACMA",0
42,"42215",786,555,552,8,3,"PACMA",2
42,"42083",25,23,21,0,2,"PACMA",0
42,"42001",279,219,215,2,4,"PACMA",0
42,"42194",176,127,126,2,1,"PACMA",0
42,"42198",22,17,17,0,0,"PACMA",0
42,"42056",22,19,19,0,0,"PACMA",0
42,"42031",26,19,19,0,0,"PACMA",0
42,"42008",57,38,38,0,0,"PACMA",0
42,"42117",148,113,111,3,2,"PACMA",0
42,"42156",30,21,21,0,0,"PACMA",0
42,"42124",64,44,44,0,0,"PACMA",0
42,"42037",34,17,17,1,0,"PACMA",0
42,"42192",41,31,31,1,0,"PACMA",0
42,"42084",26,21,21,0,0,"PACMA",0
42,"42017",142,115,114,1,1,"PACMA",0
42,"42059",20,14,14,0,0,"PACMA",0
42,"42028",70,49,49,0,0,"PACMA",0
42,"42020",4288,3087,3044,42,43,"PACMA",11
42,"42045",312,218,214,1,4,"PACMA",0
42,"42160",261,205,203,1,2,"PACMA",4
42,"42085",191,136,136,2,0,"PACMA",0
42,"42061",292,221,219,2,2,"PACMA",2
42,"42108",12,10,10,0,0,"PACMA",0
42,"42178",117,81,79,2,2,"PACMA",0
42,"42164",1614,1208,1190,9,18,"PACMA",5
42,"42014",66,43,43,2,0,"PACMA",0
42,"42034",31,22,22,0,0,"PACMA",0
42,"42022",214,171,171,2,0,"PACMA",1
42,"42043",3796,2833,2792,26,41,"PACMA",11
42,"42181",419,318,312,3,6,"PACMA",0
42,"42060",34,23,21,0,2,"PACMA",0
42,"42079",27,17,17,1,0,"PACMA",0
42,"42218",80,54,54,1,0,"PACMA",3
42,"42065",22,20,19,0,1,"PACMA",0
42,"42195",100,60,60,3,0,"PACMA",0
42,"42131",50,32,32,0,0,"PACMA",0
42,"42057",175,106,104,1,2,"PACMA",1
42,"42119",164,97,97,2,0,"PACMA",2
42,"42039",233,148,146,2,2,"PACMA",2
42,"42053",26,21,21,1,0,"PACMA",0
42,"42019",516,367,363,4,4,"PACMA",1
42,"42182",57,45,45,1,0,"PACMA",0
42,"42141",111,79,79,0,0,"PACMA",0
42,"42154",97,78,78,1,0,"PACMA",0
42,"42165",408,289,282,7,7,"PACMA",1
42,"42115",63,46,46,0,0,"PACMA",0
42,"42159",38,33,32,1,1,"PACMA",0
42,"42089",55,46,46,1,0,"PACMA",0
42,"42082",9,8,8,1,0,"PACMA",0
42,"42111",307,221,220,1,1,"PACMA",1
42,"42069",1529,1078,1066,10,12,"PACMA",2
42,"42097",21,14,14,0,0,"PACMA",0
42,"42139",22,16,16,0,0,"PACMA",0
42,"42188",50,44,43,0,1,"PACMA",0
42,"42021",85,53,53,1,0,"PACMA",0
42,"42029",143,106,106,0,0,"PACMA",0
42,"42046",51,43,43,1,0,"PACMA",1
42,"42172",29,25,25,2,0,"PACMA",0
42,"42127",40,27,27,1,0,"PACMA",0
42,"42209",146,111,108,3,3,"PACMA",0
42,"42185",25,21,21,0,0,"PACMA",0
42,"42217",31,25,25,0,0,"PACMA",0
42,"42153",14,14,14,1,0,"PACMA",0
42,"42121",64,48,48,1,0,"PACMA",0
42,"42212",69,54,54,3,0,"PACMA",0
42,"42184",59,45,44,2,1,"PACMA",1
42,"42027",76,56,56,0,0,"PACMA",0
42,"42205",93,64,63,0,1,"PACMA",0
42,"42123",165,119,119,4,0,"PACMA",0
42,"42030",95,77,76,3,1,"PACMA",0
42,"42048",67,53,51,1,2,"PACMA",0
42,"42128",39,37,37,1,0,"PACMA",0
42,"42201",23,23,22,0,1,"PACMA",0
42,"42207",41,33,33,1,0,"PACMA",0
42,"42095",1762,1319,1303,15,16,"PACMA",6
42,"42155",173,105,104,1,1,"PACMA",0
42,"42090",93,70,69,1,1,"PACMA",0
42,"42171",128,78,78,1,0,"PACMA",0
42,"42135",75,53,53,1,0,"PACMA",0
42,"42167",259,195,194,2,1,"PACMA",1
42,"42211",83,67,67,1,0,"PACMA",1
42,"42219",43,32,32,0,0,"PACMA",0
42,"42033",50,43,43,0,0,"PACMA",0
42,"42011",17,10,10,0,0,"PACMA",0
42,"42166",60,40,40,0,0,"PACMA",0
42,"42200",84,60,60,2,0,"PACMA",0
42,"42023",66,53,53,0,0,"PACMA",0
42,"42025",1216,884,873,11,11,"PACMA",0
42,"42009",80,65,64,2,1,"PACMA",0
42,"42190",94,71,71,1,0,"PACMA",0
42,"42075",87,63,63,1,0,"PACMA",0
42,"42071",169,111,109,2,2,"PACMA",1
42,"42049",120,75,73,1,2,"PACMA",0
42,"42051",21,15,15,0,0,"PACMA",0
42,"42163",49,37,37,0,0,"PACMA",0
42,"42175",23,18,18,0,0,"PACMA",0
42,"42177",71,55,54,1,1,"PACMA",0
42,"42042",47,38,38,2,0,"PACMA",0
42,"42013",35,28,28,0,0,"PACMA",0
42,"42174",180,149,148,1,1,"PACMA",1
42,"42103",583,467,459,5,8,"PACMA",1
42,"42055",165,127,127,3,0,"PACMA",2
42,"42063",49,37,37,1,0,"PACMA",0
42,"42110",63,46,46,0,0,"PACMA",0
42,"42168",109,88,88,1,0,"PACMA",0
42,"42144",442,357,352,5,5,"PACMA",1
42,"42204",56,39,38,0,1,"PACMA",0
42,"42140",16,10,10,1,0,"PACMA",0
42,"42216",25,21,21,0,0,"PACMA",1
42,"42107",74,51,48,1,3,"PACMA",0
42,"42064",85,74,74,0,0,"PACMA",0
42,"42129",692,522,516,4,6,"PACMA",0
42,"42113",512,390,386,3,4,"PACMA",1
42,"42044",53,49,47,3,2,"PACMA",0
42,"42213",29,18,18,1,0,"PACMA",0
42,"42125",81,66,66,2,0,"PACMA",0
42,"42054",20,14,14,0,0,"PACMA",0
42,"42173",29201,21456,21181,272,275,"PACMA",98
42,"42151",35,31,29,2,2,"PACMA",0
42,"42080",155,113,110,0,3,"PACMA",1
42,"42086",38,29,29,1,0,"PACMA",1
42,"42088",71,53,53,0,0,"PACMA",0
42,"42076",219,176,173,4,3,"PACMA",1
5,"5257",140,98,98,0,0,"C´s",16
5,"5079",70,54,54,0,0,"C´s",7
5,"5144",79,62,60,2,2,"C´s",5
5,"5075",107,67,67,0,0,"C´s",8
5,"5201",529,439,431,2,8,"C´s",33
5,"5265",82,70,70,0,0,"C´s",15
5,"5033",174,139,138,0,1,"C´s",9
5,"5214",38,27,26,0,1,"C´s",8
5,"5089",478,377,365,0,12,"C´s",55
5,"5049",399,301,291,1,10,"C´s",56
5,"5017",85,75,75,0,0,"C´s",8
5,"5038",116,87,85,0,2,"C´s",3
5,"5252",64,45,45,0,0,"C´s",4
5,"5135",425,325,322,1,3,"C´s",34
5,"5901",273,187,185,5,2,"C´s",20
5,"5165",380,291,283,5,8,"C´s",35
5,"5237",164,131,126,1,5,"C´s",11
5,"5212",233,157,155,1,2,"C´s",13
5,"5108",51,30,30,0,0,"C´s",2
5,"5019",44606,34903,34564,285,339,"C´s",7645
5,"5114",1359,1131,1115,5,16,"C´s",83
5,"5007",113,74,74,1,0,"C´s",3
5,"5218",121,97,95,0,2,"C´s",3
5,"5178",371,295,289,0,6,"C´s",37
5,"5166",188,135,134,1,1,"C´s",17
5,"5170",52,46,46,0,0,"C´s",6
5,"5233",226,179,177,0,2,"C´s",9
5,"5116",118,95,93,1,2,"C´s",5
5,"5081",39,33,31,0,2,"C´s",1
5,"5208",40,34,34,0,0,"C´s",1
5,"5197",98,90,90,0,0,"C´s",12
5,"5154",36,30,30,0,0,"C´s",2
5,"5084",74,56,56,1,0,"C´s",5
5,"5103",78,56,56,0,0,"C´s",3
5,"5232",98,83,81,1,2,"C´s",7
5,"5027",269,220,218,2,2,"C´s",38
5,"5095",266,220,218,0,2,"C´s",9
5,"5043",84,67,67,0,0,"C´s",7
5,"5251",68,40,40,0,0,"C´s",4
5,"5113",78,58,58,1,0,"C´s",11
5,"5238",787,565,556,4,9,"C´s",37
5,"5036",123,97,97,0,0,"C´s",11
5,"5121",241,186,185,3,1,"C´s",26
5,"5140",116,97,96,0,1,"C´s",7
5,"5073",297,243,238,4,5,"C´s",24
5,"5001",194,153,152,1,1,"C´s",17
5,"5260",104,84,83,1,1,"C´s",4
5,"5221",353,270,264,3,6,"C´s",22
5,"5229",84,67,67,0,0,"C´s",7
5,"5061",253,198,196,4,2,"C´s",41
5,"5242",681,538,527,10,11,"C´s",29
5,"5048",120,104,103,0,1,"C´s",6
5,"5044",259,180,180,0,0,"C´s",5
5,"5190",55,42,42,2,0,"C´s",14
5,"5064",103,87,87,1,0,"C´s",7
5,"5125",57,45,44,0,1,"C´s",3
5,"5176",234,190,187,2,3,"C´s",26
5,"5109",454,378,362,3,16,"C´s",36
5,"5246",60,42,42,0,0,"C´s",0
5,"5101",316,240,238,1,2,"C´s",34
5,"5066",458,365,364,3,1,"C´s",34
5,"5124",107,83,81,1,2,"C´s",6
5,"5136",97,74,73,5,1,"C´s",6
5,"5013",876,733,723,2,10,"C´s",80
5,"5062",184,155,154,2,1,"C´s",21
5,"5026",197,170,169,1,1,"C´s",14
5,"5094",140,110,110,0,0,"C´s",15
5,"5183",140,114,113,1,1,"C´s",8
5,"5119",33,20,20,0,0,"C´s",1
5,"5054",1238,953,933,1,20,"C´s",70
5,"5141",95,86,86,2,0,"C´s",6
5,"5076",481,401,387,5,14,"C´s",69
5,"5088",33,24,24,0,0,"C´s",5
5,"5152",690,561,558,3,3,"C´s",60
5,"5046",45,38,38,1,0,"C´s",3
5,"5100",285,229,228,0,1,"C´s",38
5,"5074",693,543,540,1,3,"C´s",86
5,"5211",465,375,373,2,2,"C´s",41
5,"5193",194,163,163,1,0,"C´s",24
5,"5169",226,178,176,1,2,"C´s",12
5,"5168",3565,2740,2711,17,29,"C´s",500
5,"5118",84,57,57,0,0,"C´s",2
5,"5160",323,263,260,1,3,"C´s",16
5,"5142",104,88,82,1,6,"C´s",12
5,"5008",227,180,176,2,4,"C´s",13
5,"5014",5422,4137,4084,30,53,"C´s",557
5,"5053",86,58,58,0,0,"C´s",9
5,"5241",3081,2143,2115,17,28,"C´s",313
5,"5087",137,93,93,0,0,"C´s",10
5,"5216",224,155,155,2,0,"C´s",22
5,"5106",36,27,27,0,0,"C´s",5
5,"5209",83,63,63,0,0,"C´s",2
5,"5217",58,45,45,0,0,"C´s",1
5,"5024",231,169,163,5,6,"C´s",17
5,"5065",469,388,385,6,3,"C´s",66
5,"5239",207,163,162,1,1,"C´s",27
5,"5072",87,70,69,1,1,"C´s",8
5,"5010",149,119,118,1,1,"C´s",5
5,"5174",69,55,55,1,0,"C´s",3
5,"5175",159,130,130,0,0,"C´s",29
5,"5123",96,69,66,2,3,"C´s",11
5,"5110",721,559,552,3,7,"C´s",195
5,"5045",95,70,70,0,0,"C´s",8
5,"5206",29,22,21,0,1,"C´s",6
5,"5262",358,278,277,1,1,"C´s",21
5,"5200",49,28,28,0,0,"C´s",2
5,"5263",172,137,137,0,0,"C´s",12
5,"5107",64,39,39,1,0,"C´s",3
5,"5034",15,12,12,1,0,"C´s",0
5,"5240",3393,2354,2335,9,19,"C´s",269
5,"5145",52,41,41,0,0,"C´s",3
5,"5022",1611,1279,1271,4,8,"C´s",178
5,"5018",29,21,21,0,0,"C´s",2
5,"5147",162,119,116,0,3,"C´s",13
5,"5129",129,78,78,0,0,"C´s",12
5,"5090",84,69,68,1,1,"C´s",12
5,"5181",43,31,31,1,0,"C´s",0
5,"5138",311,241,239,3,2,"C´s",27
5,"5195",224,162,161,1,1,"C´s",23
5,"5056",96,73,73,0,0,"C´s",10
5,"5220",382,298,294,1,4,"C´s",37
5,"5029",123,92,89,0,3,"C´s",8
5,"5105",349,279,270,3,9,"C´s",55
5,"5184",250,197,192,0,5,"C´s",18
5,"5059",109,79,76,1,3,"C´s",7
5,"5035",107,84,84,1,0,"C´s",2
5,"5173",60,45,45,0,0,"C´s",10
5,"5194",138,122,121,5,1,"C´s",16
5,"5264",62,43,42,1,1,"C´s",8
5,"5177",160,128,128,1,0,"C´s",11
5,"5080",59,42,40,0,2,"C´s",4
5,"5259",125,107,106,3,1,"C´s",3
5,"5205",75,58,58,0,0,"C´s",7
5,"5158",371,289,287,1,2,"C´s",37
5,"5005",187,150,149,0,1,"C´s",42
5,"5167",265,209,199,0,10,"C´s",13
5,"5021",1932,1478,1456,12,22,"C´s",174
5,"5096",79,57,57,0,0,"C´s",7
5,"5037",261,165,163,3,2,"C´s",14
5,"5243",88,61,61,1,0,"C´s",9
5,"5231",160,126,124,1,2,"C´s",8
5,"5115",532,392,386,2,6,"C´s",48
5,"5058",78,55,55,2,0,"C´s",9
5,"5086",82,66,64,1,2,"C´s",3
5,"5117",201,178,174,2,4,"C´s",9
5,"5180",88,68,68,1,0,"C´s",6
5,"5120",35,26,26,0,0,"C´s",3
5,"5188",45,38,38,0,0,"C´s",6
5,"5196",53,39,39,0,0,"C´s",5
5,"5133",67,55,55,1,0,"C´s",10
5,"5159",254,175,174,2,1,"C´s",19
5,"5042",155,126,125,0,1,"C´s",7
5,"5063",34,24,24,0,0,"C´s",0
5,"5189",443,340,336,3,4,"C´s",32
5,"5215",169,126,122,2,4,"C´s",4
5,"5015",87,66,65,1,1,"C´s",4
5,"5078",115,100,99,3,1,"C´s",13
5,"5253",88,70,70,0,0,"C´s",8
5,"5040",68,45,45,0,0,"C´s",4
5,"5082",528,437,427,5,10,"C´s",39
5,"5185",94,80,80,1,0,"C´s",13
5,"5130",95,82,82,0,0,"C´s",4
5,"5245",348,293,288,0,5,"C´s",46
5,"5254",196,166,166,0,0,"C´s",28
5,"5039",56,43,42,0,1,"C´s",6
5,"5092",155,120,120,0,0,"C´s",9
5,"5204",611,473,471,1,2,"C´s",69
5,"5902",288,227,227,0,0,"C´s",29
5,"5258",113,98,97,0,1,"C´s",17
5,"5155",52,37,37,0,0,"C´s",4
5,"5023",173,153,153,5,0,"C´s",6
5,"5235",124,111,110,1,1,"C´s",10
5,"5261",42,26,26,0,0,"C´s",3
5,"5213",101,83,83,0,0,"C´s",9
5,"5093",417,313,311,1,2,"C´s",44
5,"5012",135,110,108,0,2,"C´s",13
5,"5151",93,70,70,1,0,"C´s",7
5,"5187",1755,1409,1395,11,14,"C´s",193
5,"5128",350,289,284,4,5,"C´s",22
5,"5127",650,539,535,4,4,"C´s",65
5,"5266",102,89,89,0,0,"C´s",8
5,"5228",179,126,126,0,0,"C´s",6
5,"5060",120,99,99,1,0,"C´s",9
5,"5219",39,28,28,0,0,"C´s",2
5,"5156",249,163,161,0,2,"C´s",23
5,"5041",1001,772,765,10,7,"C´s",131
5,"5085",38,29,29,0,0,"C´s",4
5,"5244",51,38,38,0,0,"C´s",4
5,"5227",373,250,248,0,2,"C´s",22
5,"5249",107,82,82,0,0,"C´s",4
5,"5051",181,152,147,3,5,"C´s",14
5,"5267",100,65,64,0,1,"C´s",8
5,"5067",83,66,59,1,7,"C´s",8
5,"5104",34,23,22,1,1,"C´s",0
5,"5002",1954,1471,1450,9,21,"C´s",189
5,"5163",1756,1351,1345,1,6,"C´s",138
5,"5148",27,17,17,0,0,"C´s",3
5,"5903",157,108,107,0,1,"C´s",16
5,"5222",159,126,126,0,0,"C´s",18
5,"5131",105,70,69,1,1,"C´s",6
5,"5143",66,55,55,1,0,"C´s",3
5,"5157",240,170,167,1,3,"C´s",8
5,"5161",586,483,473,2,10,"C´s",43
5,"5126",70,59,59,0,0,"C´s",1
5,"5134",48,40,40,0,0,"C´s",0
5,"5186",1572,1240,1222,9,18,"C´s",202
5,"5122",144,115,113,1,2,"C´s",11
5,"5179",215,184,180,0,4,"C´s",17
5,"5083",145,108,100,2,8,"C´s",12
5,"5102",1807,1431,1412,7,19,"C´s",157
5,"5070",32,26,26,0,0,"C´s",2
5,"5162",87,60,60,2,0,"C´s",10
5,"5904",133,92,91,1,1,"C´s",2
5,"5230",65,56,54,1,2,"C´s",8
5,"5207",697,553,548,0,5,"C´s",39
5,"5016",6335,4873,4775,39,98,"C´s",712
5,"5226",77,57,57,0,0,"C´s",3
5,"5191",126,104,104,1,0,"C´s",15
5,"5198",73,59,59,0,0,"C´s",9
5,"5236",128,85,84,0,1,"C´s",10
5,"5225",372,316,315,5,1,"C´s",44
5,"5256",116,92,92,1,0,"C´s",15
5,"5192",100,82,81,1,1,"C´s",8
5,"5047",4199,3287,3244,7,43,"C´s",446
5,"5077",161,137,136,2,1,"C´s",10
5,"5097",474,324,317,3,7,"C´s",37
5,"5224",106,87,86,0,1,"C´s",13
5,"5905",214,150,150,1,0,"C´s",13
5,"5099",497,398,381,3,17,"C´s",32
5,"5055",576,476,467,0,9,"C´s",44
5,"5052",99,89,88,0,1,"C´s",14
5,"5234",51,46,46,1,0,"C´s",3
5,"5182",801,559,546,9,13,"C´s",62
5,"5153",108,78,77,3,1,"C´s",8
5,"5132",992,678,672,2,6,"C´s",57
5,"5172",123,104,102,2,2,"C´s",9
5,"5149",105,76,75,0,1,"C´s",10
5,"5171",73,58,57,2,1,"C´s",8
5,"5069",74,58,58,0,0,"C´s",8
5,"5164",27,19,19,1,0,"C´s",2
5,"5199",39,32,32,0,0,"C´s",2
5,"5139",76,66,66,0,0,"C´s",18
5,"5025",96,73,72,1,1,"C´s",3
5,"5210",85,72,72,1,0,"C´s",8
5,"5112",97,72,70,1,2,"C´s",10
5,"5057",2470,1977,1953,14,24,"C´s",194
5,"5247",250,147,146,1,1,"C´s",16
5,"5030",46,37,37,0,0,"C´s",4
45,"45001",1852,1395,1355,9,40,"IU-UPeC",28
45,"45013",1786,1428,1412,7,16,"IU-UPeC",17
45,"45123",3075,2261,2222,11,39,"IU-UPeC",96
45,"45185",7734,6057,5973,27,84,"IU-UPeC",183
45,"45037",1635,1216,1202,4,14,"IU-UPeC",40
45,"45005",241,207,205,2,2,"IU-UPeC",4
45,"45038",3335,2525,2490,8,35,"IU-UPeC",102
45,"45063",428,320,310,2,10,"IU-UPeC",3
45,"45128",2498,1794,1774,7,20,"IU-UPeC",39
45,"45075",146,108,105,0,3,"IU-UPeC",2
45,"45148",307,229,219,1,10,"IU-UPeC",0
45,"45198",1832,1521,1508,6,13,"IU-UPeC",7
45,"45124",2156,1750,1712,16,38,"IU-UPeC",35
45,"45186",3083,2369,2341,14,28,"IU-UPeC",460
45,"45002",2549,1810,1784,7,26,"IU-UPeC",57
45,"45112",1939,1302,1268,6,34,"IU-UPeC",33
45,"45052",2914,2389,2372,23,17,"IU-UPeC",116
45,"45026",225,171,169,1,2,"IU-UPeC",2
45,"45064",3839,2915,2884,19,31,"IU-UPeC",359
45,"45113",1948,1409,1386,14,23,"IU-UPeC",18
45,"45076",574,382,378,1,4,"IU-UPeC",7
45,"45031",2723,1935,1896,10,39,"IU-UPeC",67
45,"45149",573,486,484,0,2,"IU-UPeC",10
45,"45003",572,431,423,1,8,"IU-UPeC",8
45,"45125",2329,1920,1898,10,22,"IU-UPeC",45
45,"45187",4078,3405,3353,14,52,"IU-UPeC",69
45,"45077",542,428,423,0,5,"IU-UPeC",11
45,"45027",362,275,270,0,5,"IU-UPeC",0
45,"45089",1516,1157,1139,6,18,"IU-UPeC",90
45,"45045",1316,945,935,1,10,"IU-UPeC",39
45,"45102",3629,2685,2644,15,41,"IU-UPeC",116
45,"45126",260,169,167,1,2,"IU-UPeC",6
45,"45150",454,366,364,1,2,"IU-UPeC",2
45,"45040",1396,871,862,4,9,"IU-UPeC",22
45,"45114",595,461,457,1,4,"IU-UPeC",13
45,"45090",376,299,295,4,4,"IU-UPeC",1
45,"45004",568,436,430,1,6,"IU-UPeC",21
45,"45127",708,524,519,1,5,"IU-UPeC",19
45,"45175",665,541,532,5,9,"IU-UPeC",1
45,"45163",8338,6270,6142,57,128,"IU-UPeC",270
45,"45078",1392,1187,1179,8,8,"IU-UPeC",15
45,"45046",2421,1815,1796,8,19,"IU-UPeC",55
45,"45151",586,444,437,1,7,"IU-UPeC",3
45,"45091",407,301,299,2,2,"IU-UPeC",6
45,"45115",2563,2089,2048,5,41,"IU-UPeC",45
45,"45021",2459,1862,1833,21,29,"IU-UPeC",62
45,"45189",597,467,458,2,9,"IU-UPeC",13
45,"45201",3450,2212,2173,14,39,"IU-UPeC",120
45,"45156",3441,2863,2825,13,38,"IU-UPeC",205
45,"45164",186,160,160,0,0,"IU-UPeC",0
45,"45190",483,397,387,2,10,"IU-UPeC",10
45,"45116",694,531,523,2,8,"IU-UPeC",4
45,"45080",6,6,6,0,0,"IU-UPeC",0
45,"45055",1032,857,841,2,16,"IU-UPeC",5
45,"45030",482,364,361,4,3,"IU-UPeC",15
45,"45018",495,352,348,0,4,"IU-UPeC",19
45,"45006",1425,1022,1013,4,9,"IU-UPeC",18
45,"45043",793,663,655,1,8,"IU-UPeC",5
45,"45117",754,610,602,2,8,"IU-UPeC",11
45,"45153",1613,1263,1248,11,15,"IU-UPeC",49
45,"45177",2142,1757,1731,11,26,"IU-UPeC",57
45,"45199",2963,2055,2027,5,28,"IU-UPeC",68
45,"45203",2574,1938,1908,10,30,"IU-UPeC",59
45,"45072",670,499,499,2,0,"IU-UPeC",8
45,"45129",136,100,97,0,3,"IU-UPeC",3
45,"45093",151,117,117,0,0,"IU-UPeC",3
45,"45158",2534,1885,1868,8,17,"IU-UPeC",42
45,"45191",549,477,475,0,2,"IU-UPeC",6
45,"45007",697,566,560,1,6,"IU-UPeC",6
45,"45101",3761,3090,3048,15,42,"IU-UPeC",88
45,"45134",1600,1214,1200,4,14,"IU-UPeC",70
45,"45142",7858,6249,6164,57,85,"IU-UPeC",145
45,"45154",1483,1114,1107,5,7,"IU-UPeC",33
45,"45020",1313,1062,1046,5,16,"IU-UPeC",22
45,"45192",2503,2164,2141,7,23,"IU-UPeC",38
45,"45118",2002,1470,1456,3,14,"IU-UPeC",73
45,"45008",142,114,114,2,0,"IU-UPeC",1
45,"45204",643,519,513,0,6,"IU-UPeC",14
45,"45054",3995,2997,2968,8,29,"IU-UPeC",78
45,"45119",3348,2306,2264,14,42,"IU-UPeC",129
45,"45131",287,242,242,0,0,"IU-UPeC",6
45,"45082",1246,1046,1036,9,10,"IU-UPeC",20
45,"45155",371,297,296,1,1,"IU-UPeC",6
45,"45009",545,336,333,1,3,"IU-UPeC",6
45,"45083",465,393,388,5,5,"IU-UPeC",7
45,"45160",1111,908,895,6,13,"IU-UPeC",30
45,"45168",62226,48889,48446,327,443,"IU-UPeC",1937
45,"45120",134,105,105,1,0,"IU-UPeC",3
45,"45144",794,643,640,2,3,"IU-UPeC",12
45,"45067",2324,1871,1841,13,30,"IU-UPeC",29
45,"45014",3984,2824,2802,24,22,"IU-UPeC",120
45,"45010",436,335,333,2,2,"IU-UPeC",11
45,"45059",1723,1413,1388,4,25,"IU-UPeC",19
45,"45047",2563,1775,1751,13,24,"IU-UPeC",58
45,"45157",2125,1531,1509,14,22,"IU-UPeC",77
45,"45084",2280,1777,1747,12,30,"IU-UPeC",65
45,"45133",2818,2184,2146,19,38,"IU-UPeC",86
45,"45034",1360,1098,1083,4,15,"IU-UPeC",55
45,"45145",2539,1830,1811,11,19,"IU-UPeC",55
45,"45048",360,281,277,1,4,"IU-UPeC",7
45,"45182",1045,854,844,3,10,"IU-UPeC",7
45,"45173",9477,7145,7061,40,84,"IU-UPeC",264
45,"45170",235,183,176,4,7,"IU-UPeC",4
45,"45135",4302,3509,3453,21,56,"IU-UPeC",304
45,"45023",2160,1669,1654,9,15,"IU-UPeC",80
45,"45121",6766,4860,4798,30,62,"IU-UPeC",91
45,"45162",683,515,510,0,5,"IU-UPeC",9
45,"45061",2457,1718,1699,7,19,"IU-UPeC",46
45,"45011",288,246,241,1,5,"IU-UPeC",2
45,"45097",1047,877,869,3,8,"IU-UPeC",13
45,"45105",405,284,279,3,5,"IU-UPeC",11
45,"45085",1501,1086,1067,6,19,"IU-UPeC",26
45,"45012",670,521,506,4,15,"IU-UPeC",30
45,"45024",1075,828,824,5,4,"IU-UPeC",9
45,"45122",5164,4112,4067,18,45,"IU-UPeC",161
45,"45062",1121,910,894,10,16,"IU-UPeC",15
45,"45088",2102,1438,1423,4,15,"IU-UPeC",26
45,"45086",503,375,369,3,6,"IU-UPeC",11
45,"45066",7589,5716,5637,30,79,"IU-UPeC",179
45,"45050",471,354,351,2,3,"IU-UPeC",8
45,"45159",86,75,72,1,3,"IU-UPeC",0
45,"45161",13474,9618,9496,63,122,"IU-UPeC",540
45,"45111",60,47,47,0,0,"IU-UPeC",1
45,"45025",1198,921,910,2,11,"IU-UPeC",22
45,"45099",3512,2514,2459,9,55,"IU-UPeC",112
45,"45070",1461,1223,1202,7,21,"IU-UPeC",55
45,"45029",205,169,169,0,0,"IU-UPeC",1
45,"45176",3665,2747,2712,15,35,"IU-UPeC",96
45,"45152",597,476,476,2,0,"IU-UPeC",28
45,"45028",3680,2919,2880,23,39,"IU-UPeC",51
45,"45103",397,325,322,0,3,"IU-UPeC",1
45,"45051",1594,1264,1248,6,16,"IU-UPeC",14
45,"45132",2096,1631,1616,7,15,"IU-UPeC",30
45,"45042",190,145,145,0,0,"IU-UPeC",10
45,"45174",309,247,247,1,0,"IU-UPeC",2
45,"45202",3905,2962,2920,12,42,"IU-UPeC",53
45,"45060",179,131,129,1,2,"IU-UPeC",6
45,"45137",1623,1106,1093,9,13,"IU-UPeC",66
45,"45100",197,166,164,2,2,"IU-UPeC",1
45,"45092",233,197,194,0,3,"IU-UPeC",0
45,"45015",622,461,455,2,6,"IU-UPeC",12
45,"45068",173,138,135,0,3,"IU-UPeC",3
45,"45107",3238,2628,2597,15,31,"IU-UPeC",123
45,"45139",172,135,133,0,2,"IU-UPeC",0
45,"45016",4179,3290,3268,30,22,"IU-UPeC",98
45,"45039",226,197,193,1,4,"IU-UPeC",3
45,"45166",1629,1345,1332,5,13,"IU-UPeC",17
45,"45143",1180,924,912,3,12,"IU-UPeC",51
45,"45019",7356,5539,5484,35,55,"IU-UPeC",265
45,"45195",2161,1709,1686,12,23,"IU-UPeC",34
45,"45017",262,221,219,0,2,"IU-UPeC",6
45,"45036",658,500,496,2,4,"IU-UPeC",5
45,"45065",276,227,223,0,4,"IU-UPeC",0
45,"45138",1110,903,887,6,16,"IU-UPeC",14
45,"45106",7524,5882,5784,55,98,"IU-UPeC",353
45,"45073",307,238,235,0,3,"IU-UPeC",4
45,"45167",1458,1197,1187,5,10,"IU-UPeC",28
45,"45130",319,258,252,1,6,"IU-UPeC",5
45,"45058",384,304,301,4,3,"IU-UPeC",5
45,"45200",4627,3678,3588,29,90,"IU-UPeC",105
45,"45035",298,225,221,2,4,"IU-UPeC",7
45,"45022",392,297,293,8,4,"IU-UPeC",5
45,"45180",2725,2060,2028,7,32,"IU-UPeC",32
45,"45095",697,529,520,1,9,"IU-UPeC",4
45,"45079",367,285,285,3,0,"IU-UPeC",10
45,"45087",8345,6184,6091,34,93,"IU-UPeC",140
45,"45071",1863,1550,1530,8,20,"IU-UPeC",158
45,"45140",1093,885,876,4,9,"IU-UPeC",13
45,"45041",3725,2698,2665,18,33,"IU-UPeC",84
45,"45053",8045,6446,6370,44,76,"IU-UPeC",163
45,"45184",201,124,123,1,1,"IU-UPeC",13
45,"45108",521,415,414,2,1,"IU-UPeC",3
45,"45136",5859,4249,4177,24,72,"IU-UPeC",98
45,"45032",436,317,313,0,4,"IU-UPeC",6
45,"45098",2186,1686,1649,10,37,"IU-UPeC",13
45,"45146",108,85,85,0,0,"IU-UPeC",1
45,"45056",2210,1384,1370,11,14,"IU-UPeC",41
45,"45165",62857,46607,46141,313,466,"IU-UPeC",1483
45,"45104",440,345,341,1,4,"IU-UPeC",25
45,"45069",1876,1446,1428,8,18,"IU-UPeC",57
45,"45094",395,312,308,0,4,"IU-UPeC",9
45,"45169",193,136,136,1,0,"IU-UPeC",1
45,"45171",1382,1090,1075,4,15,"IU-UPeC",19
45,"45081",17646,13309,13166,72,143,"IU-UPeC",475
45,"45109",2913,2295,2218,16,77,"IU-UPeC",32
45,"45179",546,406,403,3,3,"IU-UPeC",13
45,"45181",2313,1755,1728,12,27,"IU-UPeC",18
45,"45193",626,543,530,2,13,"IU-UPeC",10
45,"45033",351,253,247,3,6,"IU-UPeC",2
45,"45057",221,187,182,0,5,"IU-UPeC",4
45,"45183",2253,1581,1569,8,12,"IU-UPeC",47
45,"45074",412,327,322,0,5,"IU-UPeC",4
45,"45205",6745,4708,4657,35,51,"IU-UPeC",161
45,"45147",581,475,469,4,6,"IU-UPeC",17
45,"45110",1799,1394,1380,4,14,"IU-UPeC",8
45,"45141",897,735,727,4,8,"IU-UPeC",33
45,"45188",2783,2161,2127,9,34,"IU-UPeC",70
45,"45196",1388,1066,1054,13,12,"IU-UPeC",7
45,"45172",719,559,556,2,3,"IU-UPeC",3
45,"45194",67,50,49,0,1,"IU-UPeC",0
45,"45096",1015,832,817,7,15,"IU-UPeC",96
45,"45049",435,330,326,0,4,"IU-UPeC",2
45,"45901",769,577,571,1,6,"IU-UPeC",11
45,"45197",1921,1500,1480,12,20,"IU-UPeC",11
10,"10076",820,608,595,3,13,"C's",75
10,"10031",167,138,137,1,1,"C's",16
10,"10107",1033,825,815,11,10,"C's",36
10,"10181",694,571,558,7,13,"C's",40
10,"10168",320,240,237,0,3,"C's",20
10,"10030",477,316,304,1,12,"C's",28
10,"10131",12850,9036,8977,44,59,"C's",1324
10,"10118",289,257,257,1,0,"C's",14
10,"10096",3443,2503,2464,14,39,"C's",224
10,"10161",75,53,53,0,0,"C's",3
10,"10137",399,344,343,4,1,"C's",13
10,"10042",85,70,70,0,0,"C's",2
10,"10159",323,235,232,2,3,"C's",13
10,"10165",259,212,209,0,3,"C's",16
10,"10032",1705,1296,1277,10,19,"C's",102
10,"10022",435,371,366,1,5,"C's",19
10,"10173",581,432,426,4,6,"C's",37
10,"10051",440,318,314,1,4,"C's",8
10,"10080",368,276,272,1,4,"C's",23
10,"10018",1722,1255,1240,6,15,"C's",80
10,"10130",1761,1322,1308,5,14,"C's",54
10,"10177",1703,1331,1296,10,35,"C's",211
10,"10055",719,554,546,3,8,"C's",47
10,"10201",176,146,145,0,1,"C's",16
10,"10196",306,234,233,1,1,"C's",14
10,"10073",715,536,530,3,6,"C's",27
10,"10048",245,163,161,1,2,"C's",11
10,"10071",144,100,100,2,0,"C's",8
10,"10157",273,209,205,1,4,"C's",22
10,"10059",369,258,255,0,3,"C's",9
10,"10190",561,401,397,2,4,"C's",38
10,"10084",1370,934,906,7,28,"C's",81
10,"10014",1874,1430,1401,11,29,"C's",91
10,"10116",3784,2839,2801,21,38,"C's",305
10,"10169",544,430,423,0,7,"C's",36
10,"10069",831,647,637,2,10,"C's",68
10,"10057",150,112,111,0,1,"C's",7
10,"10135",1329,981,958,1,23,"C's",62
10,"10185",572,433,427,5,6,"C's",27
10,"10002",368,278,275,0,3,"C's",29
10,"10008",1331,1052,1047,6,5,"C's",82
10,"10086",329,259,256,1,3,"C's",22
10,"10167",306,240,237,0,3,"C's",6
10,"10128",5752,4219,4146,39,73,"C's",457
10,"10108",218,122,120,0,2,"C's",13
10,"10064",1490,1142,1119,9,23,"C's",60
10,"10126",1572,1123,1107,3,16,"C's",84
10,"10017",841,606,589,4,17,"C's",16
10,"10148",32985,23666,23394,189,272,"C's",3491
10,"10217",533,431,427,1,4,"C's",28
10,"10050",1062,853,846,5,7,"C's",44
10,"10038",86,70,70,0,0,"C's",2
10,"10098",385,294,286,0,8,"C's",24
10,"10009",270,173,170,1,3,"C's",11
10,"10197",134,94,93,0,1,"C's",7
10,"10039",427,295,290,0,5,"C's",19
10,"10178",781,567,562,1,5,"C's",37
10,"10170",263,204,202,2,2,"C's",17
10,"10124",862,692,678,7,14,"C's",32
10,"10006",1275,1024,1004,7,20,"C's",69
10,"10100",795,602,595,4,7,"C's",33
10,"10025",402,341,328,2,13,"C's",26
10,"10061",1664,1143,1131,8,12,"C's",95
10,"10122",231,166,163,0,3,"C's",18
10,"10060",973,620,607,5,13,"C's",49
10,"10213",571,483,478,1,5,"C's",35
10,"10202",621,495,478,2,17,"C's",54
10,"10183",993,763,761,4,2,"C's",43
10,"10020",1619,1240,1214,9,26,"C's",68
10,"10011",570,450,443,2,7,"C's",35
10,"10036",327,247,244,2,3,"C's",5
10,"10136",318,234,234,4,0,"C's",21
10,"10081",179,133,129,0,4,"C's",13
10,"10166",307,220,219,0,1,"C's",19
10,"10152",470,361,357,3,4,"C's",27
10,"10092",301,238,236,2,2,"C's",22
10,"10200",417,308,305,0,3,"C's",13
10,"10216",1543,1200,1192,9,8,"C's",87
10,"10158",335,252,251,0,1,"C's",8
10,"10024",687,538,533,6,5,"C's",76
10,"10029",418,345,341,1,4,"C's",27
10,"10144",996,755,748,3,7,"C's",100
10,"10171",340,262,261,1,1,"C's",6
10,"10204",442,345,342,5,3,"C's",25
10,"10054",545,427,426,6,1,"C's",40
10,"10070",720,548,540,0,8,"C's",44
10,"10034",350,263,262,1,1,"C's",15
10,"10109",1804,1233,1212,2,21,"C's",100
10,"10041",1056,823,811,4,12,"C's",49
10,"10104",5169,3766,3703,21,63,"C's",427
10,"10120",176,125,125,2,0,"C's",4
10,"10063",179,145,145,1,0,"C's",7
10,"10205",2034,1413,1386,5,27,"C's",102
10,"10902",730,546,536,2,10,"C's",33
10,"10088",205,117,117,0,0,"C's",13
10,"10121",7970,5884,5816,33,68,"C's",499
10,"10113",2354,1800,1778,20,22,"C's",153
10,"10117",260,127,127,0,0,"C's",3
10,"10079",901,703,695,2,8,"C's",72
10,"10052",193,127,126,1,1,"C's",10
10,"10013",282,228,223,2,5,"C's",14
10,"10058",1025,747,737,5,10,"C's",53
10,"10027",78,66,66,0,0,"C's",4
10,"10101",185,147,147,1,0,"C's",11
10,"10146",1509,1018,1004,4,14,"C's",66
10,"10012",599,494,489,1,5,"C's",30
10,"10199",166,120,119,3,1,"C's",23
10,"10040",443,344,342,4,2,"C's",26
10,"10187",443,316,311,1,5,"C's",19
10,"10056",591,456,452,5,4,"C's",26
10,"10163",356,302,299,1,3,"C's",15
10,"10153",318,238,231,3,7,"C's",25
10,"10184",778,620,610,6,10,"C's",34
10,"10112",1583,1203,1176,7,27,"C's",62
10,"10210",551,380,373,1,7,"C's",15
10,"10172",718,501,493,2,8,"C's",45
10,"10119",630,461,455,2,6,"C's",64
10,"10065",205,154,154,1,0,"C's",18
10,"10192",841,592,584,0,8,"C's",31
10,"10095",350,269,267,1,2,"C's",22
10,"10037",76403,58422,57811,329,611,"C's",9893
10,"10127",4724,3529,3463,15,66,"C's",434
10,"10176",374,274,268,1,6,"C's",26
10,"10208",124,100,98,1,2,"C's",4
10,"10001",285,226,225,2,1,"C's",11
10,"10160",225,172,170,0,2,"C's",5
10,"10007",646,488,478,3,10,"C's",27
10,"10139",111,84,83,0,1,"C's",3
10,"10189",2656,2006,1971,10,35,"C's",184
10,"10132",400,258,256,0,2,"C's",7
10,"10186",994,830,816,4,14,"C's",59
10,"10089",1376,1004,988,2,16,"C's",90
10,"10026",646,507,494,5,13,"C's",64
10,"10072",862,644,639,2,5,"C's",31
10,"10154",184,138,134,1,4,"C's",9
10,"10209",296,195,193,1,2,"C's",5
10,"10019",1510,1134,1121,8,13,"C's",122
10,"10023",846,647,637,1,10,"C's",35
10,"10194",536,441,433,5,8,"C's",44
10,"10103",454,342,338,1,4,"C's",23
10,"10193",1421,1150,1130,10,20,"C's",121
10,"10129",363,272,266,4,6,"C's",19
10,"10015",687,500,491,2,9,"C's",55
10,"10049",3849,3185,3111,27,74,"C's",264
10,"10004",713,551,543,1,8,"C's",31
10,"10191",532,417,415,12,2,"C's",46
10,"10180",4159,2765,2734,12,31,"C's",379
10,"10164",742,513,508,1,5,"C's",27
10,"10142",824,620,616,5,4,"C's",37
10,"10033",430,304,301,1,3,"C's",7
10,"10212",1691,1303,1280,8,23,"C's",131
10,"10110",2298,1682,1638,10,44,"C's",168
10,"10093",406,333,324,2,9,"C's",24
10,"10206",212,161,160,3,1,"C's",11
10,"10143",158,121,121,0,0,"C's",5
10,"10151",213,163,161,0,2,"C's",5
10,"10082",1893,1528,1484,13,44,"C's",103
10,"10207",502,352,349,5,3,"C's",24
10,"10099",592,417,413,7,4,"C's",32
10,"10062",413,345,341,3,4,"C's",37
10,"10215",442,320,320,0,0,"C's",18
10,"10021",5198,3960,3878,40,82,"C's",321
10,"10182",129,95,95,0,0,"C's",10
10,"10125",903,648,638,2,10,"C's",39
10,"10087",1701,1233,1215,7,18,"C's",104
10,"10066",158,128,127,1,1,"C's",5
10,"10083",90,69,69,0,0,"C's",6
10,"10156",96,71,70,1,1,"C's",3
10,"10010",2322,1446,1431,12,15,"C's",108
10,"10174",175,141,139,0,2,"C's",8
10,"10105",2519,1745,1714,11,31,"C's",164
10,"10003",557,401,396,2,5,"C's",21
10,"10044",1451,1100,1087,7,13,"C's",94
10,"10115",3578,2857,2811,20,46,"C's",334
10,"10085",335,248,244,1,4,"C's",37
10,"10091",378,304,304,0,0,"C's",32
10,"10111",1364,995,978,9,17,"C's",98
10,"10198",1160,1022,1009,6,13,"C's",50
10,"10043",814,594,590,2,4,"C's",37
10,"10133",1210,1007,989,2,18,"C's",57
10,"10214",208,172,170,0,2,"C's",14
10,"10097",106,79,79,0,0,"C's",13
10,"10102",531,413,410,4,3,"C's",22
10,"10203",4600,3268,3215,14,53,"C's",314
10,"10195",7768,5818,5723,58,95,"C's",613
10,"10188",500,381,373,2,8,"C's",24
10,"10162",579,483,476,0,7,"C's",28
10,"10078",414,325,319,3,6,"C's",22
10,"10138",544,445,437,2,8,"C's",20
10,"10053",289,231,224,1,7,"C's",9
10,"10901",1184,851,835,2,16,"C's",96
10,"10090",522,386,382,5,4,"C's",21
10,"10134",565,395,393,1,2,"C's",25
10,"10155",1140,856,842,3,14,"C's",65
10,"10123",585,480,468,1,12,"C's",24
10,"10046",201,176,173,2,3,"C's",21
10,"10211",454,352,339,2,13,"C's",9
10,"10905",651,458,456,0,2,"C's",76
10,"10035",1880,1390,1372,6,18,"C's",72
10,"10147",1275,985,937,6,48,"C's",47
10,"10016",329,262,259,1,3,"C's",37
10,"10068",746,601,586,3,15,"C's",47
10,"10150",354,301,295,4,6,"C's",15
10,"10045",1031,786,781,11,5,"C's",43
10,"10141",268,190,189,2,1,"C's",6
10,"10075",256,178,177,1,1,"C's",21
10,"10005",537,411,398,3,13,"C's",38
10,"10140",1114,860,848,6,12,"C's",80
10,"10219",1290,860,843,1,17,"C's",72
10,"10175",1434,1054,1028,7,26,"C's",92
10,"10028",98,72,71,0,1,"C's",4
10,"10106",134,111,111,1,0,"C's",6
10,"10904",750,522,520,5,2,"C's",69
10,"10094",232,203,203,3,0,"C's",8
10,"10047",972,783,777,1,6,"C's",60
10,"10077",689,511,504,2,7,"C's",73
10,"10145",126,101,100,1,1,"C's",3
10,"10149",435,315,307,1,8,"C's",33
10,"10903",819,629,624,7,5,"C's",51
10,"10067",10486,7796,7692,54,104,"C's",865
10,"10179",301,247,247,0,0,"C's",19
10,"10218",1143,828,814,2,14,"C's",60
10,"10114",968,721,711,4,10,"C's",52
17,"17172",452,308,307,1,1,"PP",13
17,"17054",375,249,249,2,0,"PP",18
17,"17105",255,170,170,2,0,"PP",9
17,"17132",1311,923,913,10,10,"PP",83
17,"17087",222,169,169,3,0,"PP",13
17,"17203",154,110,110,0,0,"PP",4
17,"17028",303,213,213,4,0,"PP",14
17,"17166",516,386,378,2,8,"PP",14
17,"17161",990,737,734,7,3,"PP",43
17,"17044",6767,4737,4694,36,43,"PP",223
17,"17107",268,189,188,2,1,"PP",12
17,"17027",2826,1993,1973,10,20,"PP",137
17,"17152",10727,6804,6758,46,46,"PP",1016
17,"17078",330,225,225,5,0,"PP",21
17,"17043",158,119,117,1,2,"PP",7
17,"17185",2293,1547,1527,12,20,"PP",72
17,"17016",724,519,515,8,4,"PP",45
17,"17154",92,62,62,0,0,"PP",2
17,"17202",3803,2471,2449,13,22,"PP",247
17,"17076",123,90,88,2,2,"PP",6
17,"17101",543,364,362,3,2,"PP",31
17,"17089",5490,3630,3591,20,39,"PP",261
17,"17141",5869,3688,3653,38,35,"PP",485
17,"17121",221,157,156,1,1,"PP",7
17,"17221",4182,2882,2859,18,23,"PP",365
17,"17002",556,429,419,1,10,"PP",25
17,"17022",6926,4626,4587,47,39,"PP",280
17,"17060",424,277,274,3,3,"PP",54
17,"17180",8300,5429,5368,42,61,"PP",367
17,"17207",2373,1691,1673,18,18,"PP",69
17,"17157",126,104,102,1,2,"PP",2
17,"17011",646,463,462,7,1,"PP",18
17,"17111",873,643,641,12,2,"PP",28
17,"17175",579,366,360,4,6,"PP",53
17,"17222",109,85,85,1,0,"PP",4
17,"17066",26551,16275,16166,140,109,"PP",2248
17,"17209",625,480,477,2,3,"PP",36
17,"17159",627,439,434,2,5,"PP",30
17,"17049",3125,2251,2233,7,18,"PP",96
17,"17137",3411,2391,2369,15,22,"PP",103
17,"17169",2475,1733,1724,11,9,"PP",116
17,"17214",706,471,468,4,3,"PP",42
17,"17024",279,176,176,2,0,"PP",15
17,"17086",1744,1181,1170,10,11,"PP",173
17,"17184",1258,893,887,6,6,"PP",47
17,"17211",839,646,639,3,7,"PP",26
17,"17139",1382,972,963,9,9,"PP",34
17,"17092",3508,2373,2347,13,26,"PP",193
17,"17145",1488,1003,986,9,17,"PP",58
17,"17030",645,430,428,7,2,"PP",51
17,"17160",14740,9853,9795,68,58,"PP",838
17,"17148",1535,1056,1045,12,11,"PP",79
17,"17149",363,267,264,0,3,"PP",4
17,"17204",562,385,384,7,1,"PP",43
17,"17110",1325,953,945,5,8,"PP",97
17,"17103",4942,3150,3129,19,21,"PP",304
17,"17133",1268,887,877,6,10,"PP",29
17,"17052",124,83,83,1,0,"PP",7
17,"17005",401,263,260,5,3,"PP",23
17,"17100",199,142,140,7,2,"PP",9
17,"17233",2287,1682,1664,21,18,"PP",114
17,"17223",807,528,520,6,8,"PP",60
17,"17143",146,109,107,1,2,"PP",7
17,"17033",5293,3509,3476,28,33,"PP",300
17,"17193",4216,2807,2768,26,39,"PP",279
17,"17215",2066,1588,1577,12,11,"PP",96
17,"17042",414,288,286,2,2,"PP",22
17,"17128",302,224,223,4,1,"PP",18
17,"17155",14500,9167,9080,43,87,"PP",849
17,"17210",551,378,376,2,2,"PP",41
17,"17093",893,590,585,6,5,"PP",52
17,"17114",23020,15151,15024,105,127,"PP",965
17,"17035",544,400,399,4,1,"PP",23
17,"17124",1638,1096,1083,10,13,"PP",73
17,"17216",165,112,110,0,2,"PP",5
17,"17195",338,256,251,2,5,"PP",9
17,"17038",369,255,253,2,2,"PP",17
17,"17067",697,500,495,7,5,"PP",22
17,"17220",811,563,555,3,8,"PP",37
17,"17068",245,173,172,0,1,"PP",4
17,"17226",856,572,557,5,15,"PP",81
17,"17112",192,141,139,1,2,"PP",4
17,"17031",172,109,109,3,0,"PP",7
17,"17055",152,125,125,0,0,"PP",4
17,"17230",463,343,339,2,4,"PP",38
17,"17018",477,347,343,3,4,"PP",15
17,"17029",203,131,131,2,0,"PP",14
17,"17146",2979,2030,2009,14,21,"PP",161
17,"17037",104,65,65,0,0,"PP",2
17,"17085",293,223,221,1,2,"PP",8
17,"17074",507,345,341,1,4,"PP",27
17,"17025",1124,834,827,3,7,"PP",46
17,"17007",1730,1235,1224,4,11,"PP",59
17,"17003",102,71,71,0,0,"PP",2
17,"17034",6874,4509,4477,32,32,"PP",376
17,"17120",792,530,518,3,12,"PP",40
17,"17125",129,88,86,0,2,"PP",2
17,"17218",588,448,445,3,3,"PP",34
17,"17058",180,132,131,1,1,"PP",9
17,"17189",1524,1126,1114,4,12,"PP",28
17,"17190",842,592,590,10,2,"PP",32
17,"17197",137,105,105,2,0,"PP",3
17,"17151",174,124,123,3,1,"PP",15
17,"17094",1049,646,641,3,5,"PP",75
17,"17014",61,47,47,1,0,"PP",5
17,"17004",510,371,368,0,3,"PP",17
17,"17115",277,195,195,0,0,"PP",12
17,"17228",295,211,210,1,1,"PP",16
17,"17020",3590,2531,2510,28,21,"PP",86
17,"17225",213,142,142,1,0,"PP",11
17,"17136",175,133,132,1,1,"PP",16
17,"17134",234,163,161,2,2,"PP",2
17,"17051",219,157,155,3,2,"PP",12
17,"17192",145,108,108,1,0,"PP",7
17,"17116",348,243,240,4,3,"PP",17
17,"17091",411,282,273,5,9,"PP",10
17,"17064",325,219,214,1,5,"PP",16
17,"17212",139,108,106,1,2,"PP",1
17,"17039",1764,1229,1217,20,12,"PP",74
17,"17191",146,114,113,1,1,"PP",2
17,"17088",535,372,369,0,3,"PP",14
17,"17048",6269,4072,4044,24,28,"PP",482
17,"17013",2787,1941,1926,17,15,"PP",180
17,"17001",585,417,413,2,4,"PP",14
17,"17165",653,445,443,2,2,"PP",26
17,"17061",162,119,119,1,0,"PP",11
17,"17119",68,59,59,0,0,"PP",1
17,"17150",1407,1074,1060,12,14,"PP",41
17,"17041",215,146,145,2,1,"PP",10
17,"17065",335,250,249,2,1,"PP",5
17,"17040",538,392,391,4,1,"PP",17
17,"17232",149,98,98,1,0,"PP",7
17,"17182",262,191,191,2,0,"PP",23
17,"17069",378,270,267,4,3,"PP",40
17,"17096",178,115,114,0,1,"PP",6
17,"17026",536,381,380,6,1,"PP",24
17,"17077",555,386,383,5,3,"PP",28
17,"17186",3771,2742,2712,18,30,"PP",163
17,"17174",176,102,102,3,0,"PP",3
17,"17099",80,60,59,0,1,"PP",12
17,"17098",311,224,221,2,3,"PP",12
17,"17171",163,123,122,0,1,"PP",8
17,"17063",166,115,113,0,2,"PP",4
17,"17170",172,118,117,2,1,"PP",5
17,"17015",12525,8550,8470,59,80,"PP",485
17,"17008",3636,2423,2395,15,28,"PP",140
17,"17194",78,54,52,2,2,"PP",1
17,"17097",199,149,148,5,1,"PP",5
17,"17167",2697,1876,1852,24,24,"PP",87
17,"17224",314,214,213,3,1,"PP",17
17,"17080",141,98,98,0,0,"PP",11
17,"17234",183,124,124,1,0,"PP",22
17,"17902",1353,957,947,9,10,"PP",46
17,"17188",165,126,126,0,0,"PP",6
17,"17153",186,140,140,0,0,"PP",6
17,"17056",1706,1200,1193,10,7,"PP",58
17,"17164",3996,2555,2543,23,12,"PP",125
17,"17187",621,468,464,6,4,"PP",18
17,"17176",122,91,91,2,0,"PP",4
17,"17138",944,668,663,4,5,"PP",64
17,"17129",137,99,99,1,0,"PP",20
17,"17217",348,268,266,0,2,"PP",8
17,"17057",960,708,699,8,9,"PP",35
17,"17009",4042,2770,2738,18,32,"PP",150
17,"17206",141,89,87,0,2,"PP",6
17,"17903",897,647,638,0,9,"PP",27
17,"17006",1131,730,728,9,2,"PP",44
17,"17081",244,165,163,0,2,"PP",10
17,"17117",14280,9297,9223,75,74,"PP",876
17,"17109",693,443,435,2,8,"PP",21
17,"17200",618,425,422,4,3,"PP",22
17,"17198",430,282,281,4,1,"PP",15
17,"17173",180,141,139,2,2,"PP",8
17,"17158",464,284,281,0,3,"PP",31
17,"17023",27347,18842,18610,118,232,"PP",2021
17,"17183",274,186,186,3,0,"PP",12
17,"17147",8112,5475,5422,43,53,"PP",416
17,"17082",410,273,268,3,5,"PP",35
17,"17123",357,275,273,3,2,"PP",16
17,"17070",109,82,82,1,0,"PP",2
17,"17142",2561,1962,1950,13,12,"PP",151
17,"17130",328,246,245,2,1,"PP",9
17,"17196",214,151,151,2,0,"PP",13
17,"17079",64159,44230,43902,271,328,"PP",4000
17,"17102",576,397,395,4,2,"PP",34
17,"17047",4837,2997,2973,39,24,"PP",449
17,"17208",997,679,671,12,8,"PP",36
17,"17178",1063,690,685,5,5,"PP",46
17,"17046",719,499,492,2,7,"PP",34
17,"17012",1142,763,757,6,6,"PP",67
17,"17201",128,93,92,1,1,"PP",3
17,"17144",210,141,141,2,0,"PP",9
17,"17162",147,91,90,0,1,"PP",4
17,"17199",6845,4527,4483,32,44,"PP",360
17,"17213",5372,3549,3517,17,32,"PP",330
17,"17095",19593,12648,12554,81,94,"PP",1512
17,"17021",135,86,86,2,0,"PP",2
17,"17135",355,263,258,2,5,"PP",24
17,"17181",3380,2272,2251,15,21,"PP",222
17,"17019",1779,1279,1261,13,18,"PP",52
17,"17227",128,95,95,0,0,"PP",0
17,"17106",139,108,106,0,2,"PP",8
17,"17163",2609,1904,1890,18,14,"PP",70
17,"17075",334,234,227,5,7,"PP",13
17,"17062",5970,3695,3657,31,38,"PP",342
17,"17901",989,696,686,7,10,"PP",40
17,"17032",1713,1036,1020,13,16,"PP",31
17,"17168",374,273,272,1,1,"PP",15
17,"17050",649,499,495,3,4,"PP",19
17,"17126",308,252,250,2,2,"PP",5
17,"17140",674,498,495,5,3,"PP",30
17,"17090",542,410,408,3,2,"PP",27
17,"17036",2736,1857,1839,16,18,"PP",117
17,"17083",2935,2059,2042,17,17,"PP",147
17,"17073",1875,1466,1460,11,6,"PP",94
17,"17177",563,359,354,3,5,"PP",29
17,"17205",212,166,166,2,0,"PP",4
17,"17071",1131,810,803,8,7,"PP",34
17,"17118",12824,8557,8477,57,80,"PP",751
17,"17010",330,247,246,5,1,"PP",8
17,"17084",236,160,160,7,0,"PP",6
16,"16140",27,15,15,0,0,"PP",4
16,"16271",637,535,533,3,2,"PP",272
16,"16134",4369,3412,3369,23,43,"PP",1319
16,"16117",1057,814,808,2,6,"PP",296
16,"16169",58,33,32,0,1,"PP",16
16,"16060",760,600,593,5,7,"PP",239
16,"16190",5127,4088,4025,42,63,"PP",1859
16,"16273",324,252,252,2,0,"PP",178
16,"16038",38,28,28,0,0,"PP",18
16,"16055",703,512,509,7,3,"PP",208
16,"16101",160,130,129,0,1,"PP",61
16,"16239",141,110,107,0,3,"PP",30
16,"16064",681,588,581,1,7,"PP",294
16,"16274",127,100,100,0,0,"PP",37
16,"16027",709,567,562,4,5,"PP",188
16,"16171",1818,1514,1498,5,16,"PP",696
16,"16219",91,72,72,0,0,"PP",21
16,"16093",64,52,52,0,0,"PP",31
16,"16253",357,279,279,1,0,"PP",177
16,"16275",11,11,11,1,0,"PP",5
16,"16160",61,46,45,1,1,"PP",29
16,"16192",50,30,29,0,1,"PP",10
16,"16153",955,797,780,5,17,"PP",334
16,"16156",101,76,75,0,1,"PP",31
16,"16177",78,63,63,0,0,"PP",34
16,"16019",217,168,166,1,2,"PP",101
16,"16244",722,625,617,2,8,"PP",308
16,"16089",379,299,299,4,0,"PP",108
16,"16238",509,442,434,2,8,"PP",198
16,"16063",98,87,87,0,0,"PP",47
16,"16110",97,71,70,0,1,"PP",56
16,"16031",46,30,30,2,0,"PP",15
16,"16042",1192,1021,1005,6,16,"PP",359
16,"16065",406,323,319,3,4,"PP",169
16,"16151",64,60,60,0,0,"PP",37
16,"16266",373,279,273,1,6,"PP",176
16,"16155",506,415,414,2,1,"PP",220
16,"16001",75,60,60,0,0,"PP",38
16,"16013",31,28,28,0,0,"PP",16
16,"16269",426,351,349,3,2,"PP",185
16,"16084",49,37,32,0,5,"PP",10
16,"16145",464,389,387,2,2,"PP",142
16,"16259",30,26,26,1,0,"PP",15
16,"16068",145,117,114,2,3,"PP",54
16,"16116",84,62,62,0,0,"PP",26
16,"16087",212,186,186,5,0,"PP",109
16,"16092",161,130,129,1,1,"PP",81
16,"16173",207,155,154,1,1,"PP",80
16,"16109",43,32,32,0,0,"PP",13
16,"16073",188,158,158,0,0,"PP",80
16,"16251",1858,1450,1420,8,30,"PP",745
16,"16002",192,172,172,0,0,"PP",97
16,"16197",65,37,37,0,0,"PP",10
16,"16009",66,48,48,0,0,"PP",32
16,"16158",546,437,431,7,6,"PP",191
16,"16265",21,16,16,0,0,"PP",8
16,"16278",73,55,55,0,0,"PP",26
16,"16189",256,192,191,2,1,"PP",110
16,"16032",287,230,230,1,0,"PP",100
16,"16006",119,96,94,1,2,"PP",41
16,"16113",3080,2309,2278,15,31,"PP",1021
16,"16086",888,768,762,10,6,"PP",362
16,"16212",255,208,206,1,2,"PP",85
16,"16011",28,19,19,0,0,"PP",12
16,"16133",4391,3539,3509,27,30,"PP",1119
16,"16125",1676,1338,1326,9,12,"PP",598
16,"16904",478,387,381,5,6,"PP",142
16,"16279",213,146,143,0,3,"PP",76
16,"16081",49,38,37,0,1,"PP",13
16,"16045",221,166,164,1,2,"PP",71
16,"16280",189,160,157,2,3,"PP",83
16,"16141",145,113,112,1,1,"PP",52
16,"16234",30,19,19,1,0,"PP",3
16,"16029",96,73,71,0,2,"PP",35
16,"16272",228,167,167,1,0,"PP",116
16,"16901",707,520,513,3,7,"PP",253
16,"16166",247,182,177,0,5,"PP",70
16,"16018",401,328,328,1,0,"PP",180
16,"16051",147,118,118,0,0,"PP",64
16,"16206",208,163,162,4,1,"PP",80
16,"16010",154,114,110,1,4,"PP",73
16,"16053",429,352,348,5,4,"PP",101
16,"16172",350,270,270,2,0,"PP",149
16,"16906",82,67,67,1,0,"PP",38
16,"16100",684,587,580,5,7,"PP",297
16,"16137",56,34,33,0,1,"PP",18
16,"16181",64,53,53,0,0,"PP",33
16,"16004",274,212,206,0,6,"PP",120
16,"16026",85,56,53,0,3,"PP",24
16,"16046",250,181,180,1,1,"PP",86
16,"16016",234,173,172,2,1,"PP",92
16,"16052",548,420,420,1,0,"PP",179
16,"16246",484,382,375,1,7,"PP",206
16,"16078",41427,31365,31095,268,270,"PP",12010
16,"16107",120,87,87,1,0,"PP",39
16,"16048",412,312,310,1,2,"PP",168
16,"16228",177,132,131,1,1,"PP",87
16,"16149",153,130,129,0,1,"PP",32
16,"16079",32,21,20,0,1,"PP",7
16,"16023",468,344,343,3,1,"PP",109
16,"16041",354,284,282,0,2,"PP",136
16,"16159",225,170,168,0,2,"PP",85
16,"16126",783,654,648,2,6,"PP",290
16,"16148",587,511,511,1,0,"PP",314
16,"16243",412,354,348,0,6,"PP",161
16,"16130",575,451,446,0,5,"PP",162
16,"16186",465,394,387,2,7,"PP",173
16,"16017",370,300,296,2,4,"PP",126
16,"16167",324,275,271,2,4,"PP",88
16,"16176",39,28,28,0,0,"PP",6
16,"16248",872,711,696,11,15,"PP",313
16,"16245",418,338,333,2,5,"PP",154
16,"16050",251,195,194,1,1,"PP",96
16,"16905",1217,965,956,9,9,"PP",296
16,"16131",134,97,97,1,0,"PP",45
16,"16044",39,28,27,0,1,"PP",15
16,"16121",259,205,205,3,0,"PP",77
16,"16108",49,43,42,0,1,"PP",9
16,"16217",75,58,58,0,0,"PP",39
16,"16123",82,54,53,0,1,"PP",20
16,"16111",171,138,137,2,1,"PP",46
16,"16056",465,333,322,0,11,"PP",110
16,"16104",54,40,40,0,0,"PP",17
16,"16263",961,754,745,4,9,"PP",257
16,"16209",118,100,100,1,0,"PP",49
16,"16142",139,110,109,2,1,"PP",47
16,"16057",78,60,60,0,0,"PP",25
16,"16118",1405,1147,1136,11,11,"PP",609
16,"16082",305,224,224,0,0,"PP",76
16,"16122",254,200,198,4,2,"PP",82
16,"16215",248,177,172,1,5,"PP",54
16,"16124",1870,1536,1518,7,18,"PP",671
16,"16152",40,35,35,0,0,"PP",26
16,"16066",2333,1917,1872,24,45,"PP",904
16,"16106",2729,2130,2095,19,35,"PP",889
16,"16908",197,154,154,1,0,"PP",44
16,"16115",44,33,33,0,0,"PP",17
16,"16194",259,208,200,0,8,"PP",64
16,"16097",162,135,135,1,0,"PP",55
16,"16193",70,57,57,1,0,"PP",17
16,"16157",213,185,182,0,3,"PP",96
16,"16128",63,54,54,2,0,"PP",32
16,"16165",63,51,50,1,1,"PP",17
16,"16211",377,253,250,3,3,"PP",110
16,"16014",613,493,487,1,6,"PP",182
16,"16085",136,108,108,2,0,"PP",52
16,"16074",40,31,31,0,0,"PP",14
16,"16227",112,84,84,0,0,"PP",42
16,"16204",272,207,207,1,0,"PP",78
16,"16276",21,17,17,0,0,"PP",7
16,"16218",189,155,154,1,1,"PP",71
16,"16012",82,69,69,0,0,"PP",25
16,"16150",94,67,67,1,0,"PP",26
16,"16146",87,62,62,1,0,"PP",33
16,"16195",498,380,376,1,4,"PP",149
16,"16187",77,52,52,1,0,"PP",25
16,"16099",208,157,152,0,5,"PP",76
16,"16047",230,176,176,2,0,"PP",85
16,"16015",376,286,285,7,1,"PP",161
16,"16022",78,63,61,0,2,"PP",26
16,"16902",141,105,105,1,0,"PP",42
16,"16163",74,63,63,0,0,"PP",19
16,"16170",698,524,517,1,7,"PP",218
16,"16005",256,191,187,1,4,"PP",90
16,"16088",114,92,92,0,0,"PP",32
16,"16039",398,275,271,1,4,"PP",122
16,"16025",25,21,21,1,0,"PP",12
16,"16143",16,12,12,2,0,"PP",6
16,"16083",55,28,28,0,0,"PP",16
16,"16264",433,374,370,2,4,"PP",197
16,"16242",325,281,278,1,3,"PP",185
16,"16071",20,20,20,0,0,"PP",7
16,"16258",198,143,142,0,1,"PP",80
16,"16091",68,51,49,0,2,"PP",11
16,"16095",84,71,68,0,3,"PP",43
16,"16035",258,192,192,3,0,"PP",58
16,"16910",96,70,70,0,0,"PP",25
16,"16102",1231,922,911,8,11,"PP",471
16,"16072",147,103,102,0,1,"PP",49
16,"16020",17,11,11,0,0,"PP",5
16,"16231",48,38,38,0,0,"PP",20
16,"16058",105,81,80,0,1,"PP",33
16,"16247",71,52,51,0,1,"PP",27
16,"16224",84,68,67,1,1,"PP",32
16,"16098",571,468,461,5,7,"PP",151
16,"16135",139,109,108,0,1,"PP",51
16,"16237",113,89,87,0,2,"PP",50
16,"16033",1729,1385,1365,7,20,"PP",518
16,"16094",132,101,99,1,2,"PP",53
16,"16129",104,82,79,1,3,"PP",46
16,"16254",216,181,179,5,2,"PP",75
16,"16132",34,26,26,0,0,"PP",10
16,"16161",58,53,53,0,0,"PP",34
16,"16162",43,35,35,0,0,"PP",23
16,"16003",127,111,109,0,2,"PP",45
16,"16007",1192,964,959,8,5,"PP",483
16,"16909",706,537,534,3,3,"PP",157
16,"16070",32,31,31,0,0,"PP",11
16,"16062",24,21,21,0,0,"PP",5
16,"16903",1081,824,816,6,8,"PP",523
16,"16174",192,155,155,1,0,"PP",67
16,"16030",25,22,22,1,0,"PP",12
16,"16198",1365,1067,1052,12,15,"PP",314
16,"16103",265,217,217,0,0,"PP",121
16,"16255",141,119,119,0,0,"PP",53
16,"16240",108,79,79,0,0,"PP",35
16,"16188",90,63,62,0,1,"PP",23
16,"16249",1986,1593,1570,8,23,"PP",633
16,"16203",9960,7515,7418,43,97,"PP",2647
16,"16250",76,57,57,0,0,"PP",30
16,"16139",333,255,251,4,4,"PP",135
16,"16191",926,760,752,6,8,"PP",337
16,"16225",76,58,57,0,1,"PP",36
16,"16067",127,92,91,3,1,"PP",58
16,"16034",183,153,153,1,0,"PP",71
16,"16205",114,89,88,0,1,"PP",45
16,"16147",62,43,43,0,0,"PP",19
16,"16008",95,72,72,0,0,"PP",27
16,"16043",99,73,73,1,0,"PP",40
16,"16213",35,28,28,1,0,"PP",8
16,"16024",130,100,98,0,2,"PP",38
16,"16154",4904,3776,3730,47,46,"PP",1613
16,"16049",156,121,121,0,0,"PP",46
16,"16175",5113,4203,4124,35,79,"PP",1561
16,"16185",44,35,33,0,2,"PP",11
16,"16096",273,249,244,2,5,"PP",94
16,"16202",783,573,566,3,7,"PP",231
16,"16270",167,141,141,0,0,"PP",90
16,"16061",964,798,790,13,8,"PP",279
16,"16196",633,538,527,2,11,"PP",199
16,"16236",914,694,689,6,5,"PP",359
16,"16199",31,24,24,0,0,"PP",18
16,"16112",1505,1088,1072,9,16,"PP",459
16,"16277",118,86,84,0,2,"PP",61
16,"16036",128,104,102,2,2,"PP",32
16,"16216",317,275,267,0,8,"PP",98
16,"16040",85,71,71,0,0,"PP",44
16,"16119",169,121,120,0,1,"PP",52
35,"35033",6378,4412,4354,24,58,"PSOE-NCa",1094
35,"35031",7270,5184,5000,36,184,"PSOE-NCa",915
35,"35003",5125,2989,2929,21,60,"PSOE-NCa",702
35,"35021",14942,10691,10537,80,154,"PSOE-NCa",1830
35,"35026",80806,53749,52665,450,1084,"PSOE-NCa",11194
35,"35016",297974,198159,195935,1546,2224,"PSOE-NCa",40066
35,"35014",11169,6234,6107,59,127,"PSOE-NCa",1116
35,"35034",7707,3921,3872,30,49,"PSOE-NCa",688
35,"35019",32253,19902,19621,126,281,"PSOE-NCa",4813
35,"35028",9705,5552,5478,64,74,"PSOE-NCa",1252
35,"35032",3432,2541,2498,19,43,"PSOE-NCa",522
35,"35018",12463,7628,7546,56,82,"PSOE-NCa",1535
35,"35002",23129,15904,15675,74,229,"PSOE-NCa",3794
35,"35007",515,332,330,2,2,"PSOE-NCa",69
35,"35005",1071,718,711,6,7,"PSOE-NCa",274
35,"35030",9205,5602,5501,58,101,"PSOE-NCa",1221
35,"35025",1801,1239,1216,9,23,"PSOE-NCa",229
35,"35006",30302,21967,21625,243,342,"PSOE-NCa",5564
35,"35001",4599,3455,3396,27,59,"PSOE-NCa",1111
35,"35029",4125,2545,2514,34,31,"PSOE-NCa",654
35,"35010",3548,2371,2336,20,35,"PSOE-NCa",523
35,"35024",13621,8665,8555,76,110,"PSOE-NCa",1372
35,"35011",23882,16369,16095,107,274,"PSOE-NCa",3927
35,"35004",38814,20869,20641,192,228,"PSOE-NCa",5483
35,"35013",6609,4997,4881,51,116,"PSOE-NCa",1005
35,"35017",25447,15415,15079,127,336,"PSOE-NCa",2718
35,"35027",10311,7497,7364,58,133,"PSOE-NCa",1679
35,"35022",48059,30474,30134,219,340,"PSOE-NCa",8064
35,"35015",9870,5451,5368,29,83,"PSOE-NCa",1620
35,"35012",10331,5684,5610,32,74,"PSOE-NCa",1339
35,"35020",6054,4073,4018,26,55,"PSOE-NCa",1919
35,"35009",19832,14305,14036,97,269,"PSOE-NCa",4108
35,"35008",6109,4631,4542,37,89,"PSOE-NCa",1032
35,"35023",11680,8467,8295,75,172,"PSOE-NCa",1999
46,"46051",8347,6500,6442,27,58,"EUPV-UPeC",181
46,"46038",345,255,255,0,0,"EUPV-UPeC",13
46,"46242",340,291,285,1,6,"EUPV-UPeC",6
46,"46129",521,435,434,2,1,"EUPV-UPeC",79
46,"46033",197,169,168,1,1,"EUPV-UPeC",5
46,"46083",15467,11584,11443,79,141,"EUPV-UPeC",501
46,"46011",7627,5496,5407,39,89,"EUPV-UPeC",184
46,"46037",1119,952,941,2,11,"EUPV-UPeC",25
46,"46112",552,466,464,1,2,"EUPV-UPeC",6
46,"46107",1915,1566,1553,2,13,"EUPV-UPeC",81
46,"46005",22908,17565,17438,126,127,"EUPV-UPeC",812
46,"46196",153,131,130,0,1,"EUPV-UPeC",1
46,"46132",2148,1850,1830,12,20,"EUPV-UPeC",83
46,"46158",1024,817,804,5,13,"EUPV-UPeC",31
46,"46043",145,131,131,0,0,"EUPV-UPeC",2
46,"46211",1723,1441,1434,13,7,"EUPV-UPeC",38
46,"46091",115,101,100,1,1,"EUPV-UPeC",1
46,"46226",48,44,44,0,0,"EUPV-UPeC",0
46,"46061",337,281,281,3,0,"EUPV-UPeC",11
46,"46253",109,93,93,0,0,"EUPV-UPeC",2
46,"46134",2357,1811,1797,8,14,"EUPV-UPeC",102
46,"46018",635,531,522,3,9,"EUPV-UPeC",16
46,"46186",19033,15061,14950,70,111,"EUPV-UPeC",641
46,"46058",1779,1430,1409,10,21,"EUPV-UPeC",40
46,"46131",49604,37767,37431,266,336,"EUPV-UPeC",1278
46,"46006",4529,3803,3748,18,55,"EUPV-UPeC",103
46,"46096",279,229,225,2,4,"EUPV-UPeC",4
46,"46229",972,785,774,2,11,"EUPV-UPeC",35
46,"46249",9362,7163,7072,42,91,"EUPV-UPeC",360
46,"46190",48824,36748,36542,238,206,"EUPV-UPeC",1666
46,"46063",1757,1399,1384,11,15,"EUPV-UPeC",37
46,"46210",338,295,283,2,12,"EUPV-UPeC",5
46,"46054",11251,8795,8731,46,64,"EUPV-UPeC",504
46,"46044",4237,3347,3285,25,62,"EUPV-UPeC",147
46,"46135",9655,7845,7810,32,35,"EUPV-UPeC",479
46,"46142",797,619,608,2,11,"EUPV-UPeC",44
46,"46246",1066,856,838,7,18,"EUPV-UPeC",11
46,"46086",82,73,73,1,0,"EUPV-UPeC",14
46,"46200",1909,1628,1609,5,19,"EUPV-UPeC",45
46,"46062",4652,3650,3583,32,67,"EUPV-UPeC",122
46,"46071",466,383,379,2,4,"EUPV-UPeC",16
46,"46237",7227,5620,5571,33,49,"EUPV-UPeC",286
46,"46212",1612,1234,1214,5,20,"EUPV-UPeC",37
46,"46117",493,414,411,4,3,"EUPV-UPeC",18
46,"46082",4947,3843,3814,25,29,"EUPV-UPeC",310
46,"46101",858,731,723,4,8,"EUPV-UPeC",65
46,"46084",1576,1314,1298,6,16,"EUPV-UPeC",24
46,"46115",403,296,289,1,7,"EUPV-UPeC",6
46,"46122",2701,2120,2109,18,11,"EUPV-UPeC",90
46,"46046",896,697,686,1,11,"EUPV-UPeC",19
46,"46090",1640,1440,1424,4,16,"EUPV-UPeC",29
46,"46049",280,242,238,1,4,"EUPV-UPeC",8
46,"46137",268,225,220,3,5,"EUPV-UPeC",6
46,"46247",1024,743,733,2,10,"EUPV-UPeC",54
46,"46199",5742,4458,4425,34,33,"EUPV-UPeC",177
46,"46060",9361,7285,7229,30,56,"EUPV-UPeC",283
46,"46257",5579,4440,4391,26,49,"EUPV-UPeC",282
46,"46171",16587,12731,12627,79,104,"EUPV-UPeC",538
46,"46214",15730,12427,12334,56,93,"EUPV-UPeC",575
46,"46024",424,348,340,0,8,"EUPV-UPeC",15
46,"46152",97,76,74,0,2,"EUPV-UPeC",0
46,"46008",2673,2201,2189,8,12,"EUPV-UPeC",216
46,"46248",4873,3679,3639,18,40,"EUPV-UPeC",128
46,"46221",339,305,303,0,2,"EUPV-UPeC",13
46,"46174",984,808,794,3,14,"EUPV-UPeC",27
46,"46260",2572,2100,2081,10,19,"EUPV-UPeC",103
46,"46166",8155,6521,6450,41,71,"EUPV-UPeC",343
46,"46007",11953,9099,9038,65,61,"EUPV-UPeC",353
46,"46023",328,294,287,2,7,"EUPV-UPeC",13
46,"46078",28126,20975,20850,127,125,"EUPV-UPeC",1162
46,"46262",232,172,168,0,4,"EUPV-UPeC",4
46,"46170",3451,2821,2775,16,46,"EUPV-UPeC",60
46,"46181",17066,12779,12636,96,143,"EUPV-UPeC",427
46,"46085",11147,8107,8033,57,74,"EUPV-UPeC",177
46,"46243",141,122,120,0,2,"EUPV-UPeC",5
46,"46021",23646,18220,18100,85,120,"EUPV-UPeC",778
46,"46133",563,458,455,2,3,"EUPV-UPeC",13
46,"46159",22905,17498,17373,102,125,"EUPV-UPeC",1009
46,"46193",8795,7101,7061,40,40,"EUPV-UPeC",332
46,"46904",802,662,654,7,8,"EUPV-UPeC",64
46,"46149",362,288,287,2,1,"EUPV-UPeC",8
46,"46035",6786,5382,5338,27,44,"EUPV-UPeC",225
46,"46140",349,288,284,2,4,"EUPV-UPeC",10
46,"46052",502,432,431,2,1,"EUPV-UPeC",7
46,"46150",1839,1377,1362,10,15,"EUPV-UPeC",113
46,"46128",1601,1316,1281,5,35,"EUPV-UPeC",55
46,"46094",20515,15885,15785,125,100,"EUPV-UPeC",739
46,"46205",14323,11325,11224,55,101,"EUPV-UPeC",573
46,"46004",1924,1582,1559,11,23,"EUPV-UPeC",69
46,"46169",32396,25109,24953,169,156,"EUPV-UPeC",1310
46,"46031",10520,7830,7759,70,71,"EUPV-UPeC",261
46,"46042",3389,2886,2844,19,42,"EUPV-UPeC",120
46,"46207",6656,5355,5293,42,62,"EUPV-UPeC",287
46,"46041",331,254,253,6,1,"EUPV-UPeC",17
46,"46197",1956,1556,1543,8,13,"EUPV-UPeC",296
46,"46232",894,715,712,5,3,"EUPV-UPeC",18
46,"46191",1970,1557,1533,6,24,"EUPV-UPeC",72
46,"46047",525,443,435,2,8,"EUPV-UPeC",4
46,"46172",5040,3629,3599,14,30,"EUPV-UPeC",162
46,"46072",3625,2993,2931,37,62,"EUPV-UPeC",185
46,"46104",1956,1567,1543,6,24,"EUPV-UPeC",67
46,"46236",975,810,806,4,4,"EUPV-UPeC",34
46,"46153",441,358,354,0,4,"EUPV-UPeC",11
46,"46245",516,427,420,3,7,"EUPV-UPeC",11
46,"46223",7814,6169,6129,33,40,"EUPV-UPeC",253
46,"46161",1481,1206,1194,6,12,"EUPV-UPeC",37
46,"46228",2363,1854,1839,16,15,"EUPV-UPeC",72
46,"46156",2087,1712,1702,9,10,"EUPV-UPeC",55
46,"46067",1736,1457,1382,2,75,"EUPV-UPeC",47
46,"46206",577,475,468,4,7,"EUPV-UPeC",16
46,"46258",2676,2099,2078,9,21,"EUPV-UPeC",191
46,"46077",7569,6100,6010,41,90,"EUPV-UPeC",835
46,"46144",665,525,520,2,5,"EUPV-UPeC",10
46,"46019",8833,7183,7109,47,74,"EUPV-UPeC",145
46,"46039",2147,1746,1727,9,19,"EUPV-UPeC",88
46,"46167",373,286,285,1,1,"EUPV-UPeC",16
46,"46147",16843,12206,12099,56,107,"EUPV-UPeC",500
46,"46209",1955,1531,1508,7,23,"EUPV-UPeC",47
46,"46040",1098,914,907,4,7,"EUPV-UPeC",45
46,"46201",67,49,49,0,0,"EUPV-UPeC",0
46,"46121",105,92,91,2,1,"EUPV-UPeC",2
46,"46032",5635,4529,4493,16,36,"EUPV-UPeC",217
46,"46036",583,384,381,8,3,"EUPV-UPeC",18
46,"46173",1336,1097,1080,9,17,"EUPV-UPeC",32
46,"46110",21260,16194,16084,76,110,"EUPV-UPeC",742
46,"46175",459,403,396,1,7,"EUPV-UPeC",23
46,"46263",255,204,202,1,2,"EUPV-UPeC",6
46,"46053",560,454,451,2,3,"EUPV-UPeC",13
46,"46185",386,325,321,4,4,"EUPV-UPeC",4
46,"46154",811,644,640,4,4,"EUPV-UPeC",15
46,"46045",1261,1066,1041,3,25,"EUPV-UPeC",161
46,"46233",3904,2974,2934,15,40,"EUPV-UPeC",90
46,"46151",722,589,583,1,6,"EUPV-UPeC",21
46,"46109",6195,4764,4682,23,82,"EUPV-UPeC",309
46,"46241",400,324,314,1,10,"EUPV-UPeC",36
46,"46216",5039,4207,4188,20,19,"EUPV-UPeC",181
46,"46239",451,353,351,3,2,"EUPV-UPeC",7
46,"46903",5985,4822,4796,24,26,"EUPV-UPeC",203
46,"46244",58586,43371,43098,257,273,"EUPV-UPeC",1501
46,"46099",922,693,685,0,8,"EUPV-UPeC",24
46,"46198",846,702,693,1,9,"EUPV-UPeC",37
46,"46050",200,160,160,0,0,"EUPV-UPeC",10
46,"46068",354,305,297,1,8,"EUPV-UPeC",11
46,"46080",1025,795,784,4,11,"EUPV-UPeC",81
46,"46076",587,489,483,2,6,"EUPV-UPeC",25
46,"46143",4215,3219,3171,27,48,"EUPV-UPeC",146
46,"46250",578668,455375,452638,2701,2737,"EUPV-UPeC",21474
46,"46079",326,267,265,2,2,"EUPV-UPeC",10
46,"46163",1847,1508,1489,8,19,"EUPV-UPeC",69
46,"46002",1175,947,935,5,12,"EUPV-UPeC",47
46,"46224",170,130,130,0,0,"EUPV-UPeC",4
46,"46192",767,573,568,1,5,"EUPV-UPeC",20
46,"46020",3784,3064,3012,15,52,"EUPV-UPeC",75
46,"46119",783,672,666,7,6,"EUPV-UPeC",19
46,"46238",13324,10023,9939,50,84,"EUPV-UPeC",584
46,"46055",1273,1031,1021,4,10,"EUPV-UPeC",47
46,"46145",21946,16629,16495,80,134,"EUPV-UPeC",1248
46,"46176",2025,1431,1416,10,15,"EUPV-UPeC",39
46,"46009",3144,2579,2552,13,27,"EUPV-UPeC",92
46,"46001",802,623,615,4,8,"EUPV-UPeC",17
46,"46177",4698,3715,3665,16,50,"EUPV-UPeC",187
46,"46074",2690,2158,2145,18,13,"EUPV-UPeC",98
46,"46215",1433,1152,1149,4,3,"EUPV-UPeC",150
46,"46028",395,346,339,2,7,"EUPV-UPeC",18
46,"46218",1074,930,912,1,18,"EUPV-UPeC",15
46,"46089",2141,1649,1625,14,24,"EUPV-UPeC",67
46,"46254",1012,786,775,1,11,"EUPV-UPeC",39
46,"46025",2502,2008,1993,6,15,"EUPV-UPeC",64
46,"46065",1588,1246,1227,5,19,"EUPV-UPeC",46
46,"46116",13153,10566,10518,62,48,"EUPV-UPeC",498
46,"46105",16249,11731,11629,59,102,"EUPV-UPeC",304
46,"46016",1068,885,874,3,11,"EUPV-UPeC",24
46,"46255",3145,2494,2470,19,24,"EUPV-UPeC",107
46,"46188",668,548,538,3,10,"EUPV-UPeC",20
46,"46168",1938,1542,1530,11,12,"EUPV-UPeC",43
46,"46069",161,126,122,0,4,"EUPV-UPeC",3
46,"46130",907,722,713,6,9,"EUPV-UPeC",16
46,"46164",11777,8893,8798,54,95,"EUPV-UPeC",411
46,"46106",1543,1177,1167,5,10,"EUPV-UPeC",107
46,"46114",575,488,484,3,4,"EUPV-UPeC",9
46,"46003",963,841,815,1,26,"EUPV-UPeC",18
46,"46251",2490,2082,2045,11,37,"EUPV-UPeC",86
46,"46113",2436,1864,1849,11,15,"EUPV-UPeC",56
46,"46102",19843,15783,15676,102,107,"EUPV-UPeC",772
46,"46125",857,709,701,5,8,"EUPV-UPeC",13
46,"46034",1776,1441,1430,4,11,"EUPV-UPeC",69
46,"46057",495,339,337,6,2,"EUPV-UPeC",6
46,"46012",888,723,703,3,20,"EUPV-UPeC",29
46,"46095",608,498,493,2,5,"EUPV-UPeC",6
46,"46187",1310,1036,1028,6,8,"EUPV-UPeC",23
46,"46252",126,95,93,0,2,"EUPV-UPeC",4
46,"46081",10180,8055,7984,32,71,"EUPV-UPeC",331
46,"46179",2182,1823,1788,13,35,"EUPV-UPeC",70
46,"46136",2534,2008,1990,13,18,"EUPV-UPeC",78
46,"46022",15481,11422,11347,69,75,"EUPV-UPeC",495
46,"46015",7231,5768,5711,33,57,"EUPV-UPeC",226
46,"46126",5555,4619,4574,26,45,"EUPV-UPeC",198
46,"46178",4643,3465,3434,16,31,"EUPV-UPeC",145
46,"46064",527,429,423,0,6,"EUPV-UPeC",13
46,"46056",184,160,158,1,2,"EUPV-UPeC",20
46,"46183",6009,4624,4563,18,61,"EUPV-UPeC",123
46,"46217",886,724,712,3,12,"EUPV-UPeC",29
46,"46155",1035,865,846,2,19,"EUPV-UPeC",22
46,"46259",503,410,406,2,4,"EUPV-UPeC",6
46,"46220",48393,35859,35571,250,288,"EUPV-UPeC",3239
46,"46030",804,660,635,7,25,"EUPV-UPeC",25
46,"46075",149,132,130,2,2,"EUPV-UPeC",2
46,"46148",1528,1206,1192,15,14,"EUPV-UPeC",35
46,"46014",3042,2456,2434,17,22,"EUPV-UPeC",118
46,"46219",125,106,105,2,1,"EUPV-UPeC",2
46,"46097",959,734,728,6,6,"EUPV-UPeC",24
46,"46026",1204,1044,1034,4,10,"EUPV-UPeC",40
46,"46059",1272,1066,1058,4,8,"EUPV-UPeC",126
46,"46182",1274,970,966,2,4,"EUPV-UPeC",54
46,"46203",3598,2962,2928,17,34,"EUPV-UPeC",204
46,"46108",480,375,375,2,0,"EUPV-UPeC",6
46,"46098",2491,1978,1950,14,28,"EUPV-UPeC",66
46,"46070",16903,13091,12999,64,92,"EUPV-UPeC",511
46,"46189",471,412,405,2,7,"EUPV-UPeC",14
46,"46227",915,771,765,5,6,"EUPV-UPeC",25
46,"46092",273,183,183,0,0,"EUPV-UPeC",10
46,"46157",2978,2370,2343,19,27,"EUPV-UPeC",51
46,"46029",20649,15241,15110,113,131,"EUPV-UPeC",726
46,"46231",2411,1759,1735,11,24,"EUPV-UPeC",163
46,"46013",17366,13952,13862,95,90,"EUPV-UPeC",720
46,"46088",176,140,138,0,2,"EUPV-UPeC",3
46,"46180",682,581,572,1,9,"EUPV-UPeC",31
46,"46261",1720,1386,1369,10,17,"EUPV-UPeC",85
46,"46208",1114,931,922,3,9,"EUPV-UPeC",24
46,"46118",3795,2987,2962,18,25,"EUPV-UPeC",103
46,"46235",21793,16577,16424,118,153,"EUPV-UPeC",645
46,"46138",345,292,292,0,0,"EUPV-UPeC",11
46,"46139",4495,3629,3577,26,52,"EUPV-UPeC",126
46,"46093",2117,1721,1710,10,11,"EUPV-UPeC",36
46,"46100",289,240,237,1,3,"EUPV-UPeC",5
46,"46165",7115,5626,5576,31,50,"EUPV-UPeC",269
46,"46073",1097,903,892,6,11,"EUPV-UPeC",44
46,"46120",1109,919,902,4,17,"EUPV-UPeC",39
46,"46225",346,299,290,0,9,"EUPV-UPeC",8
46,"46204",6781,5421,5379,15,42,"EUPV-UPeC",256
46,"46213",15476,11377,11246,110,131,"EUPV-UPeC",507
46,"46240",209,169,164,1,5,"EUPV-UPeC",5
46,"46010",914,725,716,4,9,"EUPV-UPeC",54
46,"46111",10876,8133,8050,35,83,"EUPV-UPeC",530
46,"46230",13944,10746,10646,69,100,"EUPV-UPeC",496
46,"46234",354,289,287,2,2,"EUPV-UPeC",9
46,"46902",379,314,313,3,1,"EUPV-UPeC",3
46,"46066",1255,1028,1020,6,8,"EUPV-UPeC",49
46,"46123",1838,1466,1447,4,19,"EUPV-UPeC",54
46,"46160",1912,1523,1514,3,9,"EUPV-UPeC",54
46,"46087",127,99,99,1,0,"EUPV-UPeC",2
46,"46195",1967,1612,1602,9,10,"EUPV-UPeC",40
46,"46202",16767,13171,13058,59,113,"EUPV-UPeC",504
46,"46124",788,680,672,0,8,"EUPV-UPeC",10
46,"46048",3448,2817,2790,8,27,"EUPV-UPeC",98
46,"46017",33050,24762,24580,144,182,"EUPV-UPeC",970
46,"46146",1670,1333,1318,11,15,"EUPV-UPeC",28
46,"46141",438,359,348,4,11,"EUPV-UPeC",10
46,"46184",26467,20888,20675,138,213,"EUPV-UPeC",1117
46,"46127",2706,2212,2175,10,37,"EUPV-UPeC",65
46,"46256",6833,5087,5062,37,25,"EUPV-UPeC",205
46,"46103",1270,1015,998,8,17,"EUPV-UPeC",78
46,"46027",948,795,781,3,14,"EUPV-UPeC",17
46,"46222",383,322,321,2,1,"EUPV-UPeC",10
46,"46162",1207,962,947,3,15,"EUPV-UPeC",9
46,"46194",15552,11606,11505,69,101,"EUPV-UPeC",474
14,"14066",5890,4366,4322,29,44,"UPYD",17
14,"14048",1206,967,949,11,18,"UPYD",4
14,"14026",2073,1437,1421,13,16,"UPYD",4
14,"14068",545,410,407,6,3,"UPYD",0
14,"14057",6152,4973,4903,56,70,"UPYD",13
14,"14051",1401,1095,1077,5,18,"UPYD",0
14,"14062",1052,813,801,4,12,"UPYD",0
14,"14006",1331,1166,1137,7,29,"UPYD",3
14,"14012",6190,4574,4488,27,86,"UPYD",2
14,"14067",3874,3033,2986,29,47,"UPYD",18
14,"14075",581,463,446,6,17,"UPYD",1
14,"14025",2950,2460,2425,10,35,"UPYD",2
14,"14049",16357,12206,12029,127,177,"UPYD",39
14,"14041",3180,2404,2373,26,31,"UPYD",4
14,"14005",6358,4379,4272,56,107,"UPYD",12
14,"14004",2036,1502,1488,6,14,"UPYD",0
14,"14058",7973,5860,5791,49,69,"UPYD",11
14,"14016",1364,1047,1045,3,2,"UPYD",1
14,"14044",1624,1285,1267,9,18,"UPYD",6
14,"14061",756,606,592,2,14,"UPYD",1
14,"14069",7536,5574,5495,48,79,"UPYD",6
14,"14050",2399,1886,1864,11,22,"UPYD",2
14,"14063",1065,803,797,4,6,"UPYD",5
14,"14042",18921,14842,14653,184,189,"UPYD",58
14,"14001",3552,2861,2830,28,31,"UPYD",3
14,"14023",2041,1742,1717,13,25,"UPYD",4
14,"14021",260189,188939,187558,1934,1381,"UPYD",1122
14,"14022",4036,3199,3169,9,30,"UPYD",12
14,"14032",425,347,335,3,12,"UPYD",1
14,"14017",10869,8130,8029,72,101,"UPYD",32
14,"14040",3792,3036,3010,23,26,"UPYD",6
14,"14037",3344,2476,2442,20,34,"UPYD",3
14,"14002",10951,8231,8150,72,81,"UPYD",11
14,"14033",1285,980,963,11,17,"UPYD",0
14,"14027",7908,6085,6008,57,77,"UPYD",17
14,"14014",2570,2104,2075,8,29,"UPYD",8
14,"14036",3767,2911,2857,53,54,"UPYD",12
14,"14009",2779,1941,1934,13,7,"UPYD",8
14,"14059",699,559,552,5,7,"UPYD",3
14,"14053",6050,4498,4427,56,71,"UPYD",17
14,"14071",937,651,642,2,9,"UPYD",2
14,"14007",15200,11064,10926,81,138,"UPYD",60
14,"14054",13665,10923,10678,103,245,"UPYD",32
14,"14018",3710,2882,2846,28,36,"UPYD",4
14,"14064",331,252,244,2,8,"UPYD",0
14,"14019",6479,5131,5076,46,55,"UPYD",15
14,"14030",8580,6619,6542,66,77,"UPYD",14
14,"14052",9447,6250,6201,49,49,"UPYD",47
14,"14010",4051,3003,2968,17,35,"UPYD",3
14,"14031",597,490,484,0,6,"UPYD",3
14,"14074",2303,1940,1929,13,11,"UPYD",8
14,"14011",584,477,476,3,1,"UPYD",2
14,"14047",1654,1221,1211,17,10,"UPYD",5
14,"14045",3055,2486,2451,13,35,"UPYD",7
14,"14039",2628,2151,2123,11,28,"UPYD",10
14,"14072",1079,834,830,5,4,"UPYD",1
14,"14073",2900,2068,2041,15,27,"UPYD",7
14,"14015",2149,1637,1616,13,21,"UPYD",2
14,"14020",391,278,274,3,4,"UPYD",0
14,"14008",2871,2053,2034,11,19,"UPYD",4
14,"14046",4484,3540,3487,22,53,"UPYD",2
14,"14043",7574,5571,5510,46,61,"UPYD",29
14,"14003",1265,981,970,6,11,"UPYD",3
14,"14065",1861,1461,1446,12,15,"UPYD",6
14,"14056",23613,17016,16804,128,212,"UPYD",58
14,"14013",16845,12599,12414,146,185,"UPYD",62
14,"14070",1343,1026,1008,9,18,"UPYD",3
14,"14029",4206,3170,3135,32,35,"UPYD",8
14,"14038",32236,22982,22773,209,209,"UPYD",113
14,"14034",318,260,252,2,8,"UPYD",1
14,"14028",320,246,244,2,2,"UPYD",0
14,"14055",18572,13587,13410,167,177,"UPYD",55
14,"14060",4854,3695,3633,43,62,"UPYD",12
14,"14035",5992,4475,4437,44,38,"UPYD",6
14,"14024",1920,1522,1488,10,34,"UPYD",8
32,"32069",4333,3324,3261,25,63,"PACMA",24
32,"32009",10783,7555,7468,60,87,"PACMA",45
32,"32038",456,299,297,2,2,"PACMA",1
32,"32043",2555,1824,1793,15,31,"PACMA",11
32,"32082",1259,905,887,6,18,"PACMA",3
32,"32025",1094,821,809,3,12,"PACMA",8
32,"32066",567,435,434,2,1,"PACMA",1
32,"32054",87290,63653,62823,671,830,"PACMA",654
32,"32018",1261,956,945,3,11,"PACMA",3
32,"32010",394,299,298,0,1,"PACMA",1
32,"32034",1141,880,873,4,7,"PACMA",4
32,"32062",832,646,644,7,2,"PACMA",1
32,"32021",956,664,662,2,2,"PACMA",4
32,"32090",791,558,556,2,2,"PACMA",1
32,"32061",1093,852,840,3,12,"PACMA",5
32,"32092",528,337,334,4,3,"PACMA",2
32,"32030",1015,702,689,3,13,"PACMA",4
32,"32085",10709,7489,7403,81,86,"PACMA",38
32,"32046",1179,840,832,5,8,"PACMA",5
32,"32023",1217,884,877,6,7,"PACMA",3
32,"32045",2484,1820,1795,19,25,"PACMA",11
32,"32024",4839,3424,3368,35,56,"PACMA",18
32,"32070",566,335,330,3,5,"PACMA",1
32,"32053",1447,1140,1128,12,12,"PACMA",5
32,"32052",1904,1450,1426,6,24,"PACMA",10
32,"32019",11529,8038,7906,78,132,"PACMA",68
32,"32007",1527,1078,1070,7,8,"PACMA",0
32,"32065",669,494,482,3,12,"PACMA",4
32,"32073",1332,976,965,4,11,"PACMA",3
32,"32012",811,535,533,3,2,"PACMA",2
32,"32091",1909,1389,1375,8,14,"PACMA",1
32,"32059",1849,1357,1339,16,18,"PACMA",4
32,"32089",1332,917,904,5,13,"PACMA",3
32,"32039",1275,989,976,5,13,"PACMA",4
32,"32029",480,349,346,5,3,"PACMA",0
32,"32056",1610,1159,1146,9,13,"PACMA",4
32,"32002",2016,1474,1460,11,14,"PACMA",6
32,"32086",2671,1731,1712,10,19,"PACMA",8
32,"32077",1188,813,796,8,17,"PACMA",5
32,"32050",2455,1874,1855,17,19,"PACMA",8
32,"32005",869,676,671,7,5,"PACMA",1
32,"32004",1826,900,897,8,3,"PACMA",4
32,"32047",1818,1345,1329,3,16,"PACMA",9
32,"32037",742,544,532,8,12,"PACMA",3
32,"32044",900,658,647,5,11,"PACMA",2
32,"32048",906,573,564,6,9,"PACMA",1
32,"32083",860,580,574,4,6,"PACMA",2
32,"32036",1369,1053,1040,5,13,"PACMA",9
32,"32067",1300,838,824,15,14,"PACMA",4
32,"32060",845,609,598,6,11,"PACMA",3
32,"32027",1072,765,747,3,18,"PACMA",6
32,"32026",2736,2039,1998,25,41,"PACMA",12
32,"32071",1496,1013,1004,1,9,"PACMA",2
32,"32072",3833,2799,2761,26,38,"PACMA",5
32,"32017",1272,862,849,5,13,"PACMA",2
32,"32033",750,504,500,4,4,"PACMA",0
32,"32031",1079,826,812,5,14,"PACMA",6
32,"32081",2097,1566,1553,6,13,"PACMA",10
32,"32076",2121,1509,1489,12,20,"PACMA",7
32,"32028",1643,1195,1174,18,21,"PACMA",2
32,"32032",8101,5993,5881,74,112,"PACMA",25
32,"32068",1424,974,969,8,5,"PACMA",2
32,"32014",1170,855,845,7,10,"PACMA",2
32,"32057",575,414,412,5,2,"PACMA",4
32,"32063",1939,1329,1314,16,15,"PACMA",6
32,"32008",8188,5923,5845,44,78,"PACMA",48
32,"32042",1585,1120,1104,13,16,"PACMA",4
32,"32088",1632,1062,1042,8,20,"PACMA",4
32,"32080",333,266,265,0,1,"PACMA",0
32,"32016",825,559,556,3,3,"PACMA",1
32,"32011",934,559,548,5,11,"PACMA",4
32,"32049",775,502,495,5,7,"PACMA",0
32,"32079",1343,1000,987,9,13,"PACMA",8
32,"32020",2625,1997,1974,10,23,"PACMA",2
32,"32040",1472,1112,1089,9,23,"PACMA",5
32,"32003",886,661,653,6,8,"PACMA",6
32,"32058",5209,3808,3750,27,58,"PACMA",29
32,"32006",1571,1140,1127,10,13,"PACMA",8
32,"32078",1243,876,869,6,7,"PACMA",4
32,"32075",4188,3257,3206,43,51,"PACMA",27
32,"32064",526,397,395,1,2,"PACMA",2
32,"32087",1798,1421,1397,7,24,"PACMA",10
32,"32041",772,511,505,5,6,"PACMA",0
32,"32084",925,657,650,3,7,"PACMA",2
32,"32001",4978,3644,3607,31,37,"PACMA",25
32,"32015",899,586,581,5,5,"PACMA",0
32,"32013",2213,1447,1431,8,16,"PACMA",9
32,"32051",1458,1141,1137,4,4,"PACMA",2
32,"32074",1064,731,719,4,12,"PACMA",7
32,"32035",1484,944,938,7,6,"PACMA",1
32,"32022",1377,963,951,7,12,"PACMA",8
32,"32055",1310,952,936,7,16,"PACMA",4
26,"26114",80,71,71,2,0,"C's",7
26,"26011",7336,5309,5255,57,54,"C's",751
26,"26049",174,127,121,0,6,"C's",22
26,"26058",150,114,113,0,1,"C's",9
26,"26065",50,40,40,0,0,"C's",5
26,"26135",167,120,119,0,1,"C's",5
26,"26124",824,664,659,8,5,"C's",43
26,"26138",4600,3374,3325,28,49,"C's",460
26,"26162",121,106,106,2,0,"C's",19
26,"26099",1259,1038,1024,7,14,"C's",100
26,"26136",103,73,72,1,1,"C's",6
26,"26110",162,135,134,0,1,"C's",11
26,"26051",254,202,201,2,1,"C's",19
26,"26042",836,645,635,5,10,"C's",59
26,"26069",240,201,199,0,2,"C's",15
26,"26062",90,73,71,0,2,"C's",5
26,"26086",15,15,15,0,0,"C's",1
26,"26094",85,71,68,0,3,"C's",4
26,"26142",780,618,613,1,5,"C's",66
26,"26059",1117,850,840,9,10,"C's",120
26,"26081",16,14,14,0,0,"C's",2
26,"26098",94,72,71,1,1,"C's",6
26,"26004",68,53,53,1,0,"C's",6
26,"26001",197,163,155,3,8,"C's",6
26,"26066",265,217,209,3,8,"C's",27
26,"26122",119,104,102,2,2,"C's",20
26,"26154",11,8,8,0,0,"C's",2
26,"26053",208,161,160,1,1,"C's",17
26,"26048",22,22,21,0,1,"C's",2
26,"26096",244,199,197,3,2,"C's",35
26,"26126",31,29,29,0,0,"C's",1
26,"26158",265,220,217,4,3,"C's",9
26,"26153",12,11,10,0,1,"C's",0
26,"26149",61,48,48,0,0,"C's",9
26,"26030",12,12,12,0,0,"C's",3
26,"26134",87,65,65,1,0,"C's",2
26,"26078",83,68,68,0,0,"C's",8
26,"26029",37,31,31,0,0,"C's",1
26,"26034",660,522,513,1,9,"C's",50
26,"26160",715,569,567,3,2,"C's",46
26,"26107",92,75,75,0,0,"C's",11
26,"26128",104,80,79,0,1,"C's",4
26,"26032",53,40,40,0,0,"C's",3
26,"26041",134,97,94,1,3,"C's",7
26,"26050",117,86,86,0,0,"C's",11
26,"26103",789,626,616,3,10,"C's",36
26,"26084",6630,5015,4952,27,63,"C's",1019
26,"26174",147,122,112,0,10,"C's",11
26,"26151",446,380,375,1,5,"C's",33
26,"26025",85,71,71,1,0,"C's",7
26,"26074",105,86,85,1,1,"C's",11
26,"26111",248,195,192,1,3,"C's",17
26,"26079",639,536,527,2,9,"C's",40
26,"26056",425,357,353,6,4,"C's",25
26,"26117",2168,1695,1662,19,33,"C's",160
26,"26075",334,268,264,2,4,"C's",20
26,"26038",95,66,65,0,1,"C's",8
26,"26112",243,192,191,1,1,"C's",19
26,"26100",52,43,43,0,0,"C's",3
26,"26020",483,356,344,2,12,"C's",40
26,"26166",142,131,128,1,3,"C's",15
26,"26013",356,264,262,3,2,"C's",41
26,"26093",57,44,44,0,0,"C's",1
26,"26057",51,47,45,0,2,"C's",3
26,"26175",52,44,44,2,0,"C's",1
26,"26161",7,7,7,0,0,"C's",0
26,"26113",37,34,32,0,2,"C's",2
26,"26021",2819,2113,2077,23,36,"C's",236
26,"26017",383,302,301,4,1,"C's",33
26,"26040",68,62,62,0,0,"C's",9
26,"26087",208,157,154,4,3,"C's",16
26,"26179",42,34,33,0,1,"C's",4
26,"26026",1323,1070,1060,8,10,"C's",89
26,"26141",112,85,83,1,2,"C's",7
26,"26027",157,127,127,1,0,"C's",7
26,"26163",143,117,117,2,0,"C's",12
26,"26071",8477,6115,6029,51,86,"C's",886
26,"26101",46,34,34,0,0,"C's",4
26,"26105",2187,1722,1696,16,26,"C's",262
26,"26043",373,284,282,4,2,"C's",23
26,"26146",101,78,77,0,1,"C's",5
26,"26031",106,81,81,0,0,"C's",2
26,"26014",466,319,319,0,0,"C's",22
26,"26073",98,83,83,0,0,"C's",7
26,"26067",23,20,20,0,0,"C's",4
26,"26120",1457,1144,1133,9,11,"C's",125
26,"26168",5318,3853,3802,36,51,"C's",753
26,"26028",133,112,111,0,1,"C's",12
26,"26023",468,358,355,4,3,"C's",33
26,"26165",364,315,311,1,4,"C's",31
26,"26170",448,346,344,8,2,"C's",32
26,"26108",268,207,205,5,2,"C's",20
26,"26007",523,406,401,2,5,"C's",37
26,"26052",158,125,125,0,0,"C's",16
26,"26177",309,266,264,2,2,"C's",25
26,"26104",14,9,9,0,0,"C's",0
26,"26102",6128,4673,4585,42,88,"C's",617
26,"26077",27,25,25,0,0,"C's",0
26,"26125",2708,2013,1988,22,25,"C's",251
26,"26157",296,236,232,3,4,"C's",22
26,"26009",414,326,319,3,7,"C's",30
26,"26091",166,141,138,0,3,"C's",9
26,"26045",12,12,12,0,0,"C's",1
26,"26130",203,167,166,1,1,"C's",26
26,"26183",65,50,50,0,0,"C's",12
26,"26140",260,221,218,1,3,"C's",19
26,"26005",2343,1607,1590,19,17,"C's",216
26,"26152",31,24,23,0,1,"C's",0
26,"26118",61,49,49,1,0,"C's",7
26,"26150",117,98,98,1,0,"C's",6
26,"26123",130,111,108,0,3,"C's",7
26,"26046",1594,1221,1209,3,12,"C's",106
26,"26127",215,182,179,2,3,"C's",16
26,"26039",38,35,35,0,0,"C's",3
26,"26132",111,88,88,1,0,"C's",11
26,"26006",1809,1420,1410,14,10,"C's",134
26,"26145",245,202,201,3,1,"C's",16
26,"26106",88,78,78,0,0,"C's",13
26,"26172",30,25,25,0,0,"C's",2
26,"26010",98,78,78,1,0,"C's",4
26,"26018",10469,8216,8110,71,106,"C's",1174
26,"26002",840,615,608,6,7,"C's",67
26,"26147",30,26,26,0,0,"C's",3
26,"26143",217,178,177,0,1,"C's",35
26,"26035",16,12,12,0,0,"C's",0
26,"26115",17,14,14,0,0,"C's",0
26,"26036",16990,12136,11984,98,152,"C's",2051
26,"26167",59,45,45,1,0,"C's",5
26,"26164",61,41,41,0,0,"C's",9
26,"26080",475,392,388,6,4,"C's",45
26,"26008",1862,1442,1425,7,17,"C's",122
26,"26068",82,68,66,0,2,"C's",6
26,"26076",128,111,110,2,1,"C's",13
26,"26015",193,151,149,0,2,"C's",14
26,"26016",28,24,24,1,0,"C's",1
26,"26063",122,97,96,0,1,"C's",11
26,"26064",2278,1736,1715,17,21,"C's",195
26,"26060",85,67,67,1,0,"C's",9
26,"26129",971,768,757,2,11,"C's",91
26,"26131",34,33,33,1,0,"C's",1
26,"26055",42,33,33,0,0,"C's",1
26,"26024",236,183,183,0,0,"C's",18
26,"26037",131,111,111,1,0,"C's",10
26,"26033",172,143,142,2,1,"C's",14
26,"26054",324,255,254,3,1,"C's",19
26,"26148",171,147,145,0,2,"C's",21
26,"26070",186,154,153,1,1,"C's",10
26,"26092",108,83,82,0,1,"C's",11
26,"26061",1548,1179,1160,14,19,"C's",157
26,"26109",85,76,74,1,2,"C's",3
26,"26119",202,163,162,4,1,"C's",7
26,"26019",351,282,281,1,1,"C's",30
26,"26169",64,60,60,0,0,"C's",5
26,"26089",110513,85146,84302,712,844,"C's",14501
26,"26012",23,23,23,0,0,"C's",1
26,"26082",109,92,89,0,3,"C's",8
26,"26022",198,159,158,0,1,"C's",14
26,"26044",51,46,45,0,1,"C's",5
26,"26178",80,64,63,1,1,"C's",9
26,"26180",221,182,179,0,3,"C's",26
26,"26176",54,46,43,1,3,"C's",2
26,"26095",101,78,77,1,1,"C's",5
26,"26003",416,336,330,2,6,"C's",21
26,"26139",54,46,46,0,0,"C's",1
26,"26155",162,138,137,0,1,"C's",11
26,"26047",1969,1614,1596,14,18,"C's",132
26,"26088",36,32,31,0,1,"C's",0
26,"26121",27,21,21,0,0,"C's",0
26,"26072",289,259,258,2,1,"C's",19
26,"26171",179,136,126,1,10,"C's",12
26,"26083",289,213,213,1,0,"C's",19
26,"26181",15,13,13,0,0,"C's",1
26,"26144",194,150,148,2,2,"C's",7
26,"26173",6,6,6,1,0,"C's",0
25,"25909",155,89,89,3,0,"PSC-PSOE",6
25,"25234",4290,2645,2621,25,24,"PSC-PSOE",377
25,"25252",548,399,398,6,1,"PSC-PSOE",15
25,"25016",2114,1417,1411,8,6,"PSC-PSOE",176
25,"25136",98,71,70,0,1,"PSC-PSOE",1
25,"25138",576,415,408,6,7,"PSC-PSOE",38
25,"25014",254,177,174,4,3,"PSC-PSOE",9
25,"25216",226,150,150,0,0,"PSC-PSOE",0
25,"25034",2331,1516,1505,20,11,"PSC-PSOE",75
25,"25151",670,466,459,3,7,"PSC-PSOE",29
25,"25164",381,264,262,2,2,"PSC-PSOE",16
25,"25025",1346,966,956,10,10,"PSC-PSOE",158
25,"25221",130,76,76,0,0,"PSC-PSOE",3
25,"25177",372,258,258,2,0,"PSC-PSOE",16
25,"25141",156,101,99,1,2,"PSC-PSOE",1
25,"25143",87,58,57,1,1,"PSC-PSOE",8
25,"25249",183,118,118,2,0,"PSC-PSOE",5
25,"25223",922,614,598,8,16,"PSC-PSOE",35
25,"25124",169,118,116,2,2,"PSC-PSOE",0
25,"25064",112,85,85,3,0,"PSC-PSOE",1
25,"25104",125,86,86,3,0,"PSC-PSOE",2
25,"25239",608,320,319,1,1,"PSC-PSOE",35
25,"25001",139,88,87,1,1,"PSC-PSOE",10
25,"25181",177,138,137,5,1,"PSC-PSOE",11
25,"25176",312,239,235,7,4,"PSC-PSOE",8
25,"25182",1043,738,727,13,11,"PSC-PSOE",114
25,"25242",732,480,477,4,3,"PSC-PSOE",35
25,"25051",1522,990,983,10,7,"PSC-PSOE",88
25,"25114",97,87,87,0,0,"PSC-PSOE",1
25,"25045",52,36,36,0,0,"PSC-PSOE",10
25,"25068",558,372,369,9,3,"PSC-PSOE",22
25,"25086",533,373,372,5,1,"PSC-PSOE",39
25,"25008",1135,828,819,11,9,"PSC-PSOE",60
25,"25110",2796,1828,1807,30,21,"PSC-PSOE",233
25,"25133",713,469,464,1,5,"PSC-PSOE",36
25,"25215",334,244,243,2,1,"PSC-PSOE",25
25,"25194",426,278,273,0,5,"PSC-PSOE",9
25,"25251",710,495,494,3,1,"PSC-PSOE",41
25,"25145",85,64,64,2,0,"PSC-PSOE",3
25,"25244",369,252,248,3,4,"PSC-PSOE",19
25,"25078",1007,720,717,6,3,"PSC-PSOE",51
25,"25101",565,393,388,9,5,"PSC-PSOE",35
25,"25036",184,126,121,0,5,"PSC-PSOE",20
25,"25097",87,62,62,4,0,"PSC-PSOE",1
25,"25047",1010,730,722,6,8,"PSC-PSOE",66
25,"25212",234,173,171,1,2,"PSC-PSOE",11
25,"25906",226,144,143,0,1,"PSC-PSOE",23
25,"25169",188,125,124,3,1,"PSC-PSOE",12
25,"25243",3612,2449,2423,30,26,"PSC-PSOE",489
25,"25167",236,158,156,3,2,"PSC-PSOE",0
25,"25207",6216,4062,4031,45,31,"PSC-PSOE",409
25,"25046",421,292,286,1,6,"PSC-PSOE",19
25,"25907",498,317,314,3,3,"PSC-PSOE",13
25,"25131",412,271,261,8,10,"PSC-PSOE",51
25,"25060",70,45,45,2,0,"PSC-PSOE",1
25,"25180",239,151,151,0,0,"PSC-PSOE",7
25,"25089",106,58,58,0,0,"PSC-PSOE",4
25,"25189",2106,1392,1381,16,11,"PSC-PSOE",176
25,"25053",1059,762,759,10,3,"PSC-PSOE",82
25,"25032",61,44,43,0,1,"PSC-PSOE",2
25,"25010",212,131,130,6,1,"PSC-PSOE",10
25,"25185",681,421,418,8,3,"PSC-PSOE",40
25,"25017",239,160,159,2,1,"PSC-PSOE",12
25,"25202",101,72,72,0,0,"PSC-PSOE",9
25,"25119",2259,1582,1569,22,13,"PSC-PSOE",157
25,"25055",172,118,116,2,2,"PSC-PSOE",4
25,"25126",286,214,210,5,4,"PSC-PSOE",33
25,"25003",3782,2390,2372,24,18,"PSC-PSOE",199
25,"25192",767,510,496,11,14,"PSC-PSOE",25
25,"25019",4565,3001,2965,36,36,"PSC-PSOE",443
25,"25041",569,380,374,7,6,"PSC-PSOE",38
25,"25059",801,590,584,11,6,"PSC-PSOE",151
25,"25152",140,100,98,4,2,"PSC-PSOE",6
25,"25197",137,97,97,2,0,"PSC-PSOE",2
25,"25232",1421,961,950,10,11,"PSC-PSOE",132
25,"25218",84,66,66,0,0,"PSC-PSOE",3
25,"25048",1644,1151,1138,8,13,"PSC-PSOE",119
25,"25039",280,182,180,0,2,"PSC-PSOE",23
25,"25225",575,395,393,6,2,"PSC-PSOE",12
25,"25175",194,132,132,7,0,"PSC-PSOE",3
25,"25031",52,31,31,0,0,"PSC-PSOE",4
25,"25233",278,193,191,2,2,"PSC-PSOE",24
25,"25115",824,551,549,12,2,"PSC-PSOE",39
25,"25085",152,106,106,0,0,"PSC-PSOE",3
25,"25069",453,289,286,6,3,"PSC-PSOE",22
25,"25023",4527,3111,3073,20,38,"PSC-PSOE",311
25,"25002",484,323,321,2,2,"PSC-PSOE",18
25,"25205",562,413,402,2,11,"PSC-PSOE",41
25,"25230",1573,1100,1081,13,19,"PSC-PSOE",159
25,"25170",264,182,179,1,3,"PSC-PSOE",20
25,"25904",155,118,118,0,0,"PSC-PSOE",7
25,"25076",146,84,84,1,0,"PSC-PSOE",7
25,"25112",272,189,189,2,0,"PSC-PSOE",16
25,"25231",490,382,382,2,0,"PSC-PSOE",21
25,"25157",181,139,137,1,2,"PSC-PSOE",10
25,"25245",441,313,313,0,0,"PSC-PSOE",69
25,"25118",350,223,223,8,0,"PSC-PSOE",10
25,"25100",212,134,134,3,0,"PSC-PSOE",9
25,"25004",571,425,423,5,2,"PSC-PSOE",34
25,"25037",385,245,241,2,4,"PSC-PSOE",14
25,"25011",5256,3190,3161,36,29,"PSC-PSOE",352
25,"25191",332,225,222,3,3,"PSC-PSOE",18
25,"25905",386,260,255,4,5,"PSC-PSOE",7
25,"25082",280,169,167,3,2,"PSC-PSOE",31
25,"25148",220,155,153,0,2,"PSC-PSOE",1
25,"25224",126,86,86,1,0,"PSC-PSOE",7
25,"25067",730,483,479,4,4,"PSC-PSOE",24
25,"25105",130,95,93,4,2,"PSC-PSOE",2
25,"25130",197,117,117,3,0,"PSC-PSOE",11
25,"25056",243,151,150,2,1,"PSC-PSOE",12
25,"25129",176,113,110,6,3,"PSC-PSOE",1
25,"25062",757,521,516,4,5,"PSC-PSOE",27
25,"25139",479,325,324,3,1,"PSC-PSOE",25
25,"25072",5858,3878,3835,45,43,"PSC-PSOE",416
25,"25165",280,194,190,4,4,"PSC-PSOE",10
25,"25248",891,622,616,3,6,"PSC-PSOE",27
25,"25149",1382,1010,993,7,17,"PSC-PSOE",81
25,"25140",774,468,465,4,3,"PSC-PSOE",35
25,"25123",193,131,130,0,1,"PSC-PSOE",5
25,"25910",101,64,62,0,2,"PSC-PSOE",3
25,"25240",1407,1006,995,10,11,"PSC-PSOE",102
25,"25211",683,427,422,4,5,"PSC-PSOE",26
25,"25079",305,216,214,5,2,"PSC-PSOE",13
25,"25102",712,473,467,10,6,"PSC-PSOE",65
25,"25057",206,152,151,2,1,"PSC-PSOE",33
25,"25210",1104,779,767,9,12,"PSC-PSOE",108
25,"25220",1028,709,701,9,8,"PSC-PSOE",64
25,"25050",3253,2064,2048,27,16,"PSC-PSOE",188
25,"25238",217,151,151,6,0,"PSC-PSOE",6
25,"25163",228,143,142,5,1,"PSC-PSOE",0
25,"25153",198,141,137,0,4,"PSC-PSOE",11
25,"25024",356,233,230,1,3,"PSC-PSOE",37
25,"25166",177,123,121,1,2,"PSC-PSOE",2
25,"25208",316,191,189,1,2,"PSC-PSOE",17
25,"25156",791,574,571,7,3,"PSC-PSOE",48
25,"25092",132,93,89,1,4,"PSC-PSOE",3
25,"25135",1032,707,701,7,6,"PSC-PSOE",76
25,"25150",185,127,124,1,3,"PSC-PSOE",1
25,"25040",10532,6837,6762,81,75,"PSC-PSOE",1022
25,"25012",2296,1504,1488,8,16,"PSC-PSOE",217
25,"25255",426,308,302,4,6,"PSC-PSOE",26
25,"25183",501,332,331,4,1,"PSC-PSOE",33
25,"25908",228,138,137,3,1,"PSC-PSOE",18
25,"25087",61,46,45,0,1,"PSC-PSOE",5
25,"25077",460,272,269,2,3,"PSC-PSOE",14
25,"25030",131,86,86,2,0,"PSC-PSOE",3
25,"25111",115,83,83,1,0,"PSC-PSOE",1
25,"25137",8577,5630,5591,45,39,"PSC-PSOE",809
25,"25903",237,154,152,3,2,"PSC-PSOE",9
25,"25020",292,203,200,2,3,"PSC-PSOE",10
25,"25247",123,72,72,0,0,"PSC-PSOE",13
25,"25173",1702,1180,1171,5,9,"PSC-PSOE",259
25,"25043",794,505,501,3,4,"PSC-PSOE",30
25,"25253",163,125,124,0,1,"PSC-PSOE",3
25,"25250",344,236,234,0,2,"PSC-PSOE",10
25,"25035",397,287,286,3,1,"PSC-PSOE",28
25,"25155",667,463,459,5,4,"PSC-PSOE",43
25,"25120",92243,61433,61005,533,428,"PSC-PSOE",9381
25,"25093",639,451,445,11,6,"PSC-PSOE",37
25,"25013",2171,1380,1366,10,14,"PSC-PSOE",317
25,"25006",346,214,212,6,2,"PSC-PSOE",41
25,"25070",817,584,573,14,11,"PSC-PSOE",42
25,"25204",1241,843,827,3,16,"PSC-PSOE",106
25,"25009",631,465,460,3,5,"PSC-PSOE",42
25,"25121",642,415,413,8,2,"PSC-PSOE",129
25,"25206",257,164,164,3,0,"PSC-PSOE",9
25,"25172",1805,1230,1214,8,16,"PSC-PSOE",92
25,"25203",8976,5588,5526,53,62,"PSC-PSOE",881
25,"25058",4378,2810,2793,27,17,"PSC-PSOE",258
25,"25190",263,195,195,4,0,"PSC-PSOE",26
25,"25073",588,374,371,8,3,"PSC-PSOE",22
25,"25219",144,106,105,3,1,"PSC-PSOE",0
25,"25052",1573,1132,1122,16,10,"PSC-PSOE",74
25,"25015",355,258,257,3,1,"PSC-PSOE",12
25,"25228",3043,2140,2118,21,22,"PSC-PSOE",257
25,"25222",67,52,52,1,0,"PSC-PSOE",2
25,"25132",130,97,95,1,2,"PSC-PSOE",12
25,"25127",212,135,134,3,1,"PSC-PSOE",9
25,"25174",398,299,296,3,3,"PSC-PSOE",30
25,"25142",368,252,251,3,1,"PSC-PSOE",18
25,"25074",182,145,141,0,4,"PSC-PSOE",17
25,"25217",10594,7016,6950,119,66,"PSC-PSOE",851
25,"25158",1639,1163,1150,26,13,"PSC-PSOE",88
25,"25044",189,136,136,3,0,"PSC-PSOE",4
25,"25902",570,390,379,3,11,"PSC-PSOE",17
25,"25911",452,301,299,7,2,"PSC-PSOE",7
25,"25171",2190,1461,1444,4,17,"PSC-PSOE",225
25,"25098",253,163,160,2,3,"PSC-PSOE",18
25,"25901",292,186,181,4,5,"PSC-PSOE",18
25,"25161",368,234,232,3,2,"PSC-PSOE",18
25,"25096",912,586,572,9,14,"PSC-PSOE",56
25,"25075",117,82,82,0,0,"PSC-PSOE",4
25,"25042",208,143,142,0,1,"PSC-PSOE",7
25,"25094",139,111,109,0,2,"PSC-PSOE",2
25,"25033",1106,777,767,7,10,"PSC-PSOE",62
25,"25071",51,31,31,0,0,"PSC-PSOE",0
25,"25168",508,392,391,2,1,"PSC-PSOE",26
25,"25005",277,183,182,2,1,"PSC-PSOE",13
25,"25022",106,76,76,2,0,"PSC-PSOE",1
25,"25254",738,507,493,6,14,"PSC-PSOE",54
25,"25134",635,418,414,4,4,"PSC-PSOE",36
25,"25088",96,76,75,0,1,"PSC-PSOE",3
25,"25061",82,53,53,0,0,"PSC-PSOE",6
25,"25049",151,104,104,1,0,"PSC-PSOE",5
25,"25146",224,150,148,2,2,"PSC-PSOE",5
25,"25226",251,156,153,3,3,"PSC-PSOE",13
25,"25063",91,55,55,0,0,"PSC-PSOE",19
25,"25209",1517,1035,1019,6,16,"PSC-PSOE",107
25,"25196",119,74,74,0,0,"PSC-PSOE",8
25,"25029",1662,1156,1147,13,9,"PSC-PSOE",154
25,"25201",115,70,67,0,3,"PSC-PSOE",1
25,"25099",1260,804,793,8,11,"PSC-PSOE",62
25,"25113",1163,854,845,12,9,"PSC-PSOE",78
25,"25193",765,520,514,3,6,"PSC-PSOE",32
25,"25227",641,398,395,3,3,"PSC-PSOE",44
25,"25027",1001,687,681,3,6,"PSC-PSOE",32
25,"25912",868,618,617,5,1,"PSC-PSOE",118
25,"25125",424,279,273,4,6,"PSC-PSOE",6
25,"25021",2618,1655,1639,32,16,"PSC-PSOE",222
25,"25038",1564,1075,1062,11,13,"PSC-PSOE",85
25,"25103",131,80,80,3,0,"PSC-PSOE",3
25,"25109",238,168,168,1,0,"PSC-PSOE",4
25,"25154",120,68,68,1,0,"PSC-PSOE",3
25,"25179",161,115,114,0,1,"PSC-PSOE",4
25,"25128",142,89,89,0,0,"PSC-PSOE",9
25,"25081",318,213,210,2,3,"PSC-PSOE",10
25,"25007",1410,1005,996,13,9,"PSC-PSOE",144
25,"25200",336,218,218,0,0,"PSC-PSOE",17
25,"25122",1916,1274,1264,15,10,"PSC-PSOE",98
25,"25186",214,141,138,2,3,"PSC-PSOE",2
25,"25913",87,69,69,1,0,"PSC-PSOE",3
51,"51001",59213,33213,32720,413,493,"PP",14786
52,"52001",53255,28182,27819,299,363,"UPYD",239
50,"50117",125,91,90,1,1,"EB",0
50,"50086",184,128,128,1,0,"EB",3
50,"50193",647,514,506,1,8,"EB",5
50,"50043",257,172,171,1,1,"EB",0
50,"50009",106,78,77,1,1,"EB",1
50,"50203",1043,811,802,15,9,"EB",7
50,"50002",148,105,102,0,3,"EB",0
50,"50056",406,325,324,2,1,"EB",4
50,"50007",46,37,37,1,0,"EB",0
50,"50231",260,213,210,7,3,"EB",1
50,"50169",362,264,262,0,2,"EB",1
50,"50055",3612,2533,2490,34,43,"EB",12
50,"50095",12366,8938,8856,94,82,"EB",21
50,"50253",423,328,327,1,1,"EB",0
50,"50054",59,45,45,0,0,"EB",1
50,"50041",12,10,10,0,0,"EB",0
50,"50120",49,36,36,3,0,"EB",0
50,"50210",40,32,31,0,1,"EB",0
50,"50096",39,17,17,0,0,"EB",0
50,"50153",941,737,734,7,3,"EB",0
50,"50206",466,379,376,2,3,"EB",5
50,"50072",174,124,122,2,2,"EB",0
50,"50111",186,152,151,1,1,"EB",4
50,"50122",68,54,54,2,0,"EB",1
50,"50280",340,260,258,0,2,"EB",0
50,"50284",151,115,113,0,2,"EB",0
50,"50170",378,286,283,2,3,"EB",0
50,"50115",3248,2277,2262,31,15,"EB",13
50,"50048",35,23,23,0,0,"EB",0
50,"50234",245,198,193,9,5,"EB",2
50,"50098",181,129,127,2,2,"EB",3
50,"50141",114,85,84,0,1,"EB",1
50,"50011",127,96,96,2,0,"EB",0
50,"50165",1815,1333,1316,27,17,"EB",1
50,"50092",298,256,251,3,5,"EB",1
50,"50065",53,42,42,0,0,"EB",0
50,"50244",205,157,157,3,0,"EB",0
50,"50189",712,574,559,4,15,"EB",0
50,"50044",232,156,156,1,0,"EB",0
50,"50006",939,712,701,8,11,"EB",3
50,"50283",72,55,54,0,1,"EB",0
50,"50063",61,57,57,0,0,"EB",0
50,"50273",31,18,18,0,0,"EB",0
50,"50272",12913,9500,9415,80,85,"EB",71
50,"50236",104,82,82,2,0,"EB",0
50,"50132",755,573,564,7,9,"EB",2
50,"50164",395,263,260,2,3,"EB",3
50,"50161",117,76,76,0,0,"EB",0
50,"50030",225,156,156,2,0,"EB",1
50,"50266",129,85,85,1,0,"EB",1
50,"50163",3655,2766,2740,34,26,"EB",16
50,"50129",245,164,164,1,0,"EB",1
50,"50227",108,79,79,1,0,"EB",0
50,"50124",417,312,312,9,0,"EB",5
50,"50222",1647,1135,1118,8,17,"EB",9
50,"50139",319,239,238,2,1,"EB",1
50,"50032",273,190,189,0,1,"EB",1
50,"50118",2179,1575,1564,7,11,"EB",10
50,"50294",73,58,58,0,0,"EB",1
50,"50143",569,414,411,4,3,"EB",1
50,"50216",236,189,186,4,3,"EB",1
50,"50212",41,37,37,0,0,"EB",0
50,"50114",124,94,94,2,0,"EB",0
50,"50157",301,211,207,2,4,"EB",1
50,"50100",333,263,261,5,2,"EB",2
50,"50175",1025,745,739,6,6,"EB",2
50,"50295",45,39,39,0,0,"EB",0
50,"50254",181,130,129,2,1,"EB",0
50,"50258",56,34,34,1,0,"EB",0
50,"50052",90,71,71,0,0,"EB",0
50,"50186",41,29,29,0,0,"EB",0
50,"50155",102,78,78,0,0,"EB",0
50,"50223",915,747,741,8,6,"EB",0
50,"50159",670,511,501,5,10,"EB",1
50,"50196",108,83,82,1,1,"EB",2
50,"50133",117,88,88,3,0,"EB",1
50,"50288",3371,2566,2547,26,19,"EB",3
50,"50297",499531,377882,375565,3049,2317,"EB",2305
50,"50017",1772,1301,1293,7,8,"EB",7
50,"50012",108,86,83,1,3,"EB",0
50,"50194",84,52,52,0,0,"EB",1
50,"50160",2245,1661,1648,10,13,"EB",3
50,"50128",28,24,24,0,0,"EB",0
50,"50256",84,46,46,0,0,"EB",0
50,"50221",33,20,20,0,0,"EB",0
50,"50022",543,410,398,8,12,"EB",1
50,"50249",312,235,233,1,2,"EB",0
50,"50208",1802,1349,1332,16,17,"EB",7
50,"50019",54,41,41,0,0,"EB",0
50,"50038",1511,1167,1159,13,8,"EB",8
50,"50142",30,21,21,0,0,"EB",0
50,"50174",92,70,70,0,0,"EB",0
50,"50198",56,30,30,0,0,"EB",0
50,"50171",108,70,69,0,1,"EB",1
50,"50178",302,197,196,9,1,"EB",1
50,"50051",828,640,637,8,3,"EB",1
50,"50074",6397,4512,4408,38,104,"EB",22
50,"50026",442,358,353,6,5,"EB",6
50,"50168",28,23,23,0,0,"EB",0
50,"50267",605,424,420,4,4,"EB",0
50,"50192",236,185,183,2,2,"EB",0
50,"50179",257,207,207,2,0,"EB",0
50,"50135",95,63,63,0,0,"EB",2
50,"50071",131,90,90,0,0,"EB",0
50,"50291",100,69,69,0,0,"EB",0
50,"50020",822,560,555,5,5,"EB",2
50,"50058",72,51,51,0,0,"EB",0
50,"50166",260,192,189,2,3,"EB",2
50,"50255",214,163,163,0,0,"EB",0
50,"50116",190,142,140,1,2,"EB",0
50,"50261",215,159,159,1,0,"EB",0
50,"50292",132,103,103,0,0,"EB",0
50,"50265",62,41,41,0,0,"EB",0
50,"50101",879,615,609,5,6,"EB",1
50,"50082",89,58,57,0,1,"EB",0
50,"50123",465,349,344,2,5,"EB",1
50,"50045",1255,944,934,6,10,"EB",4
50,"50024",589,461,459,4,2,"EB",2
50,"50005",234,178,178,1,0,"EB",0
50,"50001",115,81,80,0,1,"EB",0
50,"50105",304,228,228,3,0,"EB",5
50,"50197",92,71,71,2,0,"EB",0
50,"50259",89,61,61,1,0,"EB",0
50,"50109",105,78,77,3,1,"EB",0
50,"50015",98,63,63,0,0,"EB",0
50,"50242",92,81,79,1,2,"EB",0
50,"50167",232,194,193,0,1,"EB",0
50,"50243",340,259,254,1,5,"EB",2
50,"50094",1626,1197,1178,22,19,"EB",2
50,"50290",387,288,287,4,1,"EB",1
50,"50260",35,32,32,0,0,"EB",0
50,"50106",135,105,104,0,1,"EB",1
50,"50057",1396,980,972,8,8,"EB",1
50,"50195",53,38,38,0,0,"EB",1
50,"50036",103,79,79,0,0,"EB",1
50,"50121",276,227,225,4,2,"EB",1
50,"50205",91,69,65,1,4,"EB",0
50,"50150",660,402,402,3,0,"EB",2
50,"50140",165,106,106,0,0,"EB",0
50,"50075",81,59,59,1,0,"EB",1
50,"50085",176,131,129,3,2,"EB",0
50,"50151",650,504,503,7,1,"EB",0
50,"50182",3352,2437,2409,26,28,"EB",10
50,"50034",838,572,569,5,3,"EB",3
50,"50285",648,473,469,3,4,"EB",3
50,"50176",228,158,157,0,1,"EB",1
50,"50027",227,177,176,1,1,"EB",1
50,"50183",338,255,255,0,0,"EB",0
50,"50108",47,37,37,0,0,"EB",1
50,"50173",210,141,140,2,1,"EB",0
50,"50238",97,74,73,0,1,"EB",0
50,"50126",2388,1726,1708,22,18,"EB",10
50,"50213",98,77,72,0,5,"EB",0
50,"50228",270,211,210,5,1,"EB",0
50,"50028",78,53,53,2,0,"EB",0
50,"50070",60,29,29,1,0,"EB",0
50,"50025",4547,3335,3295,45,40,"EB",11
50,"50035",74,53,52,0,1,"EB",0
50,"50138",46,41,41,0,0,"EB",0
50,"50293",423,282,280,5,2,"EB",0
50,"50211",252,187,186,0,1,"EB",0
50,"50039",507,400,398,3,2,"EB",1
50,"50146",190,137,137,5,0,"EB",0
50,"50286",77,54,54,0,0,"EB",0
50,"50064",440,350,349,5,1,"EB",0
50,"50270",38,24,24,2,0,"EB",0
50,"50263",197,123,121,6,2,"EB",0
50,"50067",14055,10236,10109,123,127,"EB",35
50,"50233",114,81,81,1,0,"EB",0
50,"50201",443,335,330,2,5,"EB",3
50,"50181",1003,750,737,9,13,"EB",4
50,"50091",48,32,32,1,0,"EB",0
50,"50147",788,577,576,4,1,"EB",5
50,"50102",863,665,654,6,11,"EB",3
50,"50016",52,37,37,0,0,"EB",0
50,"50264",158,111,111,0,0,"EB",0
50,"50068",1998,1388,1378,17,10,"EB",1
50,"50237",103,73,73,2,0,"EB",0
50,"50247",827,624,615,10,9,"EB",3
50,"50099",3087,2233,2216,15,17,"EB",1
50,"50154",119,92,91,0,1,"EB",0
50,"50089",8144,6285,6249,50,36,"EB",38
50,"50037",139,92,91,1,1,"EB",0
50,"50137",1025,793,786,6,7,"EB",3
50,"50282",70,48,48,0,0,"EB",0
50,"50902",87,78,78,1,0,"EB",1
50,"50062",1810,1407,1389,12,18,"EB",12
50,"50031",161,90,88,1,2,"EB",0
50,"50275",110,73,72,0,1,"EB",0
50,"50119",930,698,691,7,7,"EB",0
50,"50008",5085,3617,3574,30,43,"EB",13
50,"50149",36,23,23,0,0,"EB",3
50,"50224",69,55,55,1,0,"EB",0
50,"50014",146,99,99,1,0,"EB",0
50,"50080",32,25,25,0,0,"EB",0
50,"50269",288,185,183,0,2,"EB",0
50,"50245",90,60,60,1,0,"EB",0
50,"50296",398,297,293,2,4,"EB",4
50,"50204",2457,1830,1816,14,14,"EB",1
50,"50077",226,175,174,5,1,"EB",0
50,"50184",113,82,82,0,0,"EB",1
50,"50066",2613,1956,1951,21,5,"EB",14
50,"50187",70,38,38,0,0,"EB",0
50,"50232",171,120,118,0,2,"EB",0
50,"50029",627,469,468,4,1,"EB",3
50,"50084",79,56,56,1,0,"EB",0
50,"50215",23,15,15,0,0,"EB",0
50,"50162",147,110,110,2,0,"EB",0
50,"50241",593,426,418,1,8,"EB",4
50,"50110",369,258,257,0,1,"EB",0
50,"50901",137,101,101,0,0,"EB",1
50,"50281",80,57,56,0,1,"EB",0
50,"50185",132,110,110,1,0,"EB",0
50,"50040",92,75,75,0,0,"EB",0
50,"50047",50,32,32,1,0,"EB",0
50,"50104",351,283,282,3,1,"EB",0
50,"50251",8300,6228,6167,62,61,"EB",23
50,"50125",371,260,258,3,2,"EB",0
50,"50240",1034,749,737,10,12,"EB",0
50,"50003",126,93,92,3,1,"EB",1
50,"50214",27,16,16,1,0,"EB",0
50,"50093",94,73,73,1,0,"EB",0
50,"50130",395,252,252,1,0,"EB",3
50,"50229",64,42,42,0,0,"EB",0
50,"50220",46,32,32,0,0,"EB",0
50,"50004",534,406,401,0,5,"EB",0
50,"50177",315,251,249,3,2,"EB",4
50,"50078",244,192,189,1,3,"EB",0
50,"50069",76,53,52,0,1,"EB",0
50,"50248",521,407,406,1,1,"EB",2
50,"50279",87,62,62,1,0,"EB",0
50,"50018",948,717,712,6,5,"EB",5
50,"50218",113,90,89,1,1,"EB",0
50,"50274",71,50,49,1,1,"EB",0
50,"50021",32,25,25,3,0,"EB",0
50,"50191",476,327,325,3,2,"EB",2
50,"50046",176,123,123,7,0,"EB",4
50,"50050",98,59,59,3,0,"EB",0
50,"50298",5353,4051,4013,32,38,"EB",14
50,"50219",4098,3010,2980,27,30,"EB",19
50,"50246",41,29,29,0,0,"EB",0
50,"50239",64,47,47,1,0,"EB",0
50,"50053",688,535,522,6,13,"EB",1
50,"50289",52,39,39,1,0,"EB",0
50,"50061",207,174,168,1,6,"EB",0
50,"50235",2323,1687,1675,7,12,"EB",7
50,"50172",196,138,136,0,2,"EB",0
50,"50271",256,187,184,4,3,"EB",2
50,"50268",47,40,39,0,1,"EB",0
50,"50188",30,23,19,0,4,"EB",0
50,"50148",324,240,236,0,4,"EB",3
50,"50225",1568,996,985,2,11,"EB",6
50,"50088",305,234,229,11,5,"EB",0
50,"50033",75,65,65,0,0,"EB",0
50,"50199",341,242,241,4,1,"EB",1
50,"50083",90,72,72,1,0,"EB",0
50,"50209",2560,1787,1774,12,13,"EB",4
50,"50152",1457,1032,1018,11,14,"EB",3
50,"50023",223,175,173,3,2,"EB",0
50,"50113",618,506,496,4,10,"EB",0
50,"50252",5178,3746,3711,36,35,"EB",7
50,"50180",120,97,96,0,1,"EB",0
50,"50087",28,19,19,0,0,"EB",0
50,"50090",156,112,111,0,1,"EB",0
50,"50134",128,88,88,5,0,"EB",0
50,"50079",254,186,184,3,2,"EB",0
50,"50262",1187,931,930,13,1,"EB",1
50,"50013",224,187,186,3,1,"EB",1
50,"50144",36,28,28,0,0,"EB",0
50,"50136",579,420,413,0,7,"EB",1
50,"50076",81,64,64,0,0,"EB",0
50,"50081",512,376,372,6,4,"EB",0
50,"50107",944,772,767,16,5,"EB",5
50,"50903",2225,1686,1669,21,17,"EB",9
50,"50287",274,197,195,4,2,"EB",0
50,"50207",109,88,88,1,0,"EB",0
50,"50059",780,572,567,6,5,"EB",2
50,"50042",16,13,13,0,0,"EB",0
50,"50060",176,138,136,0,2,"EB",2
50,"50156",214,173,170,2,3,"EB",1
50,"50190",708,542,539,3,3,"EB",4
50,"50278",198,145,144,1,1,"EB",0
50,"50010",69,57,57,0,0,"EB",0
50,"50277",55,43,43,1,0,"EB",0
50,"50257",178,139,137,0,2,"EB",0
50,"50250",55,44,44,0,0,"EB",0
50,"50276",129,108,107,0,1,"EB",1
50,"50217",455,334,334,1,0,"EB",1
50,"50230",1176,853,849,11,4,"EB",1
50,"50073",2148,1649,1622,9,27,"EB",6
50,"50202",158,96,92,1,4,"EB",1
50,"50200",509,406,404,6,2,"EB",1
50,"50131",237,168,167,2,1,"EB",0
17,"17180",8300,5429,5368,42,61,"C's",354
17,"17215",2066,1588,1577,12,11,"C's",123
17,"17217",348,268,266,0,2,"C's",8
17,"17161",990,737,734,7,3,"C's",24
17,"17089",5490,3630,3591,20,39,"C's",280
17,"17056",1706,1200,1193,10,7,"C's",60
17,"17087",222,169,169,3,0,"C's",4
17,"17145",1488,1003,986,9,17,"C's",36
17,"17148",1535,1056,1045,12,11,"C's",122
17,"17038",369,255,253,2,2,"C's",20
17,"17066",26551,16275,16166,140,109,"C's",2310
17,"17126",308,252,250,2,2,"C's",7
17,"17049",3125,2251,2233,7,18,"C's",172
17,"17028",303,213,213,4,0,"C's",6
17,"17037",104,65,65,0,0,"C's",1
17,"17168",374,273,272,1,1,"C's",13
17,"17070",109,82,82,1,0,"C's",5
17,"17130",328,246,245,2,1,"C's",7
17,"17079",64159,44230,43902,271,328,"C's",4552
17,"17196",214,151,151,2,0,"C's",5
17,"17198",430,282,281,4,1,"C's",29
17,"17164",3996,2555,2543,23,12,"C's",96
17,"17076",123,90,88,2,2,"C's",5
17,"17137",3411,2391,2369,15,22,"C's",89
17,"17014",61,47,47,1,0,"C's",5
17,"17202",3803,2471,2449,13,22,"C's",281
17,"17029",203,131,131,2,0,"C's",11
17,"17191",146,114,113,1,1,"C's",6
17,"17172",452,308,307,1,1,"C's",8
17,"17192",145,108,108,1,0,"C's",5
17,"17209",625,480,477,2,3,"C's",67
17,"17109",693,443,435,2,8,"C's",11
17,"17165",653,445,443,2,2,"C's",14
17,"17170",172,118,117,2,1,"C's",2
17,"17033",5293,3509,3476,28,33,"C's",345
17,"17182",262,191,191,2,0,"C's",37
17,"17058",180,132,131,1,1,"C's",9
17,"17069",378,270,267,4,3,"C's",20
17,"17220",811,563,555,3,8,"C's",26
17,"17169",2475,1733,1724,11,9,"C's",215
17,"17228",295,211,210,1,1,"C's",16
17,"17213",5372,3549,3517,17,32,"C's",390
17,"17190",842,592,590,10,2,"C's",29
17,"17027",2826,1993,1973,10,20,"C's",108
17,"17216",165,112,110,0,2,"C's",4
17,"17178",1063,690,685,5,5,"C's",35
17,"17010",330,247,246,5,1,"C's",4
17,"17102",576,397,395,4,2,"C's",16
17,"17055",152,125,125,0,0,"C's",0
17,"17012",1142,763,757,6,6,"C's",80
17,"17083",2935,2059,2042,17,17,"C's",181
17,"17124",1638,1096,1083,10,13,"C's",60
17,"17021",135,86,86,2,0,"C's",3
17,"17152",10727,6804,6758,46,46,"C's",1290
17,"17212",139,108,106,1,2,"C's",1
17,"17004",510,371,368,0,3,"C's",24
17,"17107",268,189,188,2,1,"C's",10
17,"17105",255,170,170,2,0,"C's",10
17,"17013",2787,1941,1926,17,15,"C's",228
17,"17095",19593,12648,12554,81,94,"C's",2169
17,"17006",1131,730,728,9,2,"C's",59
17,"17149",363,267,264,0,3,"C's",5
17,"17073",1875,1466,1460,11,6,"C's",120
17,"17039",1764,1229,1217,20,12,"C's",70
17,"17181",3380,2272,2251,15,21,"C's",279
17,"17226",856,572,557,5,15,"C's",129
17,"17150",1407,1074,1060,12,14,"C's",62
17,"17065",335,250,249,2,1,"C's",6
17,"17121",221,157,156,1,1,"C's",8
17,"17158",464,284,281,0,3,"C's",42
17,"17085",293,223,221,1,2,"C's",4
17,"17234",183,124,124,1,0,"C's",11
17,"17019",1779,1279,1261,13,18,"C's",42
17,"17007",1730,1235,1224,4,11,"C's",51
17,"17011",646,463,462,7,1,"C's",18
17,"17026",536,381,380,6,1,"C's",15
17,"17193",4216,2807,2768,26,39,"C's",376
17,"17204",562,385,384,7,1,"C's",36
17,"17128",302,224,223,4,1,"C's",30
17,"17020",3590,2531,2510,28,21,"C's",118
17,"17034",6874,4509,4477,32,32,"C's",508
17,"17147",8112,5475,5422,43,53,"C's",441
17,"17071",1131,810,803,8,7,"C's",29
17,"17115",277,195,195,0,0,"C's",8
17,"17063",166,115,113,0,2,"C's",2
17,"17047",4837,2997,2973,39,24,"C's",397
17,"17129",137,99,99,1,0,"C's",12
17,"17035",544,400,399,4,1,"C's",13
17,"17001",585,417,413,2,4,"C's",29
17,"17230",463,343,339,2,4,"C's",48
17,"17187",621,468,464,6,4,"C's",27
17,"17144",210,141,141,2,0,"C's",8
17,"17080",141,98,98,0,0,"C's",6
17,"17008",3636,2423,2395,15,28,"C's",135
17,"17116",348,243,240,4,3,"C's",7
17,"17221",4182,2882,2859,18,23,"C's",471
17,"17051",219,157,155,3,2,"C's",9
17,"17159",627,439,434,2,5,"C's",21
17,"17048",6269,4072,4044,24,28,"C's",582
17,"17088",535,372,369,0,3,"C's",16
17,"17009",4042,2770,2738,18,32,"C's",95
17,"17084",236,160,160,7,0,"C's",4
17,"17125",129,88,86,0,2,"C's",0
17,"17112",192,141,139,1,2,"C's",5
17,"17142",2561,1962,1950,13,12,"C's",223
17,"17117",14280,9297,9223,75,74,"C's",1055
17,"17062",5970,3695,3657,31,38,"C's",369
17,"17057",960,708,699,8,9,"C's",27
17,"17077",555,386,383,5,3,"C's",39
17,"17054",375,249,249,2,0,"C's",24
17,"17096",178,115,114,0,1,"C's",3
17,"17078",330,225,225,5,0,"C's",11
17,"17143",146,109,107,1,2,"C's",4
17,"17082",410,273,268,3,5,"C's",21
17,"17003",102,71,71,0,0,"C's",0
17,"17197",137,105,105,2,0,"C's",14
17,"17030",645,430,428,7,2,"C's",49
17,"17101",543,364,362,3,2,"C's",25
17,"17023",27347,18842,18610,118,232,"C's",2695
17,"17174",176,102,102,3,0,"C's",5
17,"17163",2609,1904,1890,18,14,"C's",99
17,"17042",414,288,286,2,2,"C's",17
17,"17136",175,133,132,1,1,"C's",4
17,"17160",14740,9853,9795,68,58,"C's",1079
17,"17233",2287,1682,1664,21,18,"C's",107
17,"17067",697,500,495,7,5,"C's",20
17,"17171",163,123,122,0,1,"C's",4
17,"17133",1268,887,877,6,10,"C's",28
17,"17031",172,109,109,3,0,"C's",3
17,"17175",579,366,360,4,6,"C's",40
17,"17194",78,54,52,2,2,"C's",0
17,"17098",311,224,221,2,3,"C's",11
17,"17111",873,643,641,12,2,"C's",56
17,"17016",724,519,515,8,4,"C's",23
17,"17032",1713,1036,1020,13,16,"C's",53
17,"17046",719,499,492,2,7,"C's",15
17,"17068",245,173,172,0,1,"C's",17
17,"17225",213,142,142,1,0,"C's",11
17,"17901",989,696,686,7,10,"C's",42
17,"17222",109,85,85,1,0,"C's",4
17,"17002",556,429,419,1,10,"C's",33
17,"17018",477,347,343,3,4,"C's",18
17,"17099",80,60,59,0,1,"C's",5
17,"17040",538,392,391,4,1,"C's",12
17,"17203",154,110,110,0,0,"C's",1
17,"17214",706,471,468,4,3,"C's",35
17,"17223",807,528,520,6,8,"C's",49
17,"17074",507,345,341,1,4,"C's",43
17,"17210",551,378,376,2,2,"C's",29
17,"17106",139,108,106,0,2,"C's",2
17,"17060",424,277,274,3,3,"C's",12
17,"17118",12824,8557,8477,57,80,"C's",1051
17,"17041",215,146,145,2,1,"C's",8
17,"17902",1353,957,947,9,10,"C's",79
17,"17173",180,141,139,2,2,"C's",8
17,"17166",516,386,378,2,8,"C's",10
17,"17200",618,425,422,4,3,"C's",16
17,"17211",839,646,639,3,7,"C's",31
17,"17151",174,124,123,3,1,"C's",4
17,"17205",212,166,166,2,0,"C's",3
17,"17090",542,410,408,3,2,"C's",23
17,"17103",4942,3150,3129,19,21,"C's",418
17,"17227",128,95,95,0,0,"C's",6
17,"17157",126,104,102,1,2,"C's",4
17,"17208",997,679,671,12,8,"C's",21
17,"17061",162,119,119,1,0,"C's",7
17,"17119",68,59,59,0,0,"C's",3
17,"17050",649,499,495,3,4,"C's",33
17,"17201",128,93,92,1,1,"C's",6
17,"17024",279,176,176,2,0,"C's",12
17,"17224",314,214,213,3,1,"C's",4
17,"17005",401,263,260,5,3,"C's",20
17,"17092",3508,2373,2347,13,26,"C's",274
17,"17146",2979,2030,2009,14,21,"C's",224
17,"17189",1524,1126,1114,4,12,"C's",23
17,"17081",244,165,163,0,2,"C's",9
17,"17097",199,149,148,5,1,"C's",8
17,"17195",338,256,251,2,5,"C's",7
17,"17135",355,263,258,2,5,"C's",37
17,"17036",2736,1857,1839,16,18,"C's",117
17,"17091",411,282,273,5,9,"C's",7
17,"17153",186,140,140,0,0,"C's",4
17,"17188",165,126,126,0,0,"C's",7
17,"17218",588,448,445,3,3,"C's",19
17,"17232",149,98,98,1,0,"C's",1
17,"17186",3771,2742,2712,18,30,"C's",313
17,"17052",124,83,83,1,0,"C's",1
17,"17183",274,186,186,3,0,"C's",5
17,"17199",6845,4527,4483,32,44,"C's",464
17,"17044",6767,4737,4694,36,43,"C's",326
17,"17110",1325,953,945,5,8,"C's",122
17,"17185",2293,1547,1527,12,20,"C's",65
17,"17022",6926,4626,4587,47,39,"C's",264
17,"17086",1744,1181,1170,10,11,"C's",172
17,"17154",92,62,62,0,0,"C's",2
17,"17093",893,590,585,6,5,"C's",52
17,"17100",199,142,140,7,2,"C's",7
17,"17207",2373,1691,1673,18,18,"C's",42
17,"17162",147,91,90,0,1,"C's",3
17,"17167",2697,1876,1852,24,24,"C's",75
17,"17064",325,219,214,1,5,"C's",23
17,"17138",944,668,663,4,5,"C's",66
17,"17184",1258,893,887,6,6,"C's",38
17,"17094",1049,646,641,3,5,"C's",68
17,"17155",14500,9167,9080,43,87,"C's",1078
17,"17903",897,647,638,0,9,"C's",48
17,"17206",141,89,87,0,2,"C's",7
17,"17043",158,119,117,1,2,"C's",5
17,"17139",1382,972,963,9,9,"C's",33
17,"17140",674,498,495,5,3,"C's",42
17,"17123",357,275,273,3,2,"C's",11
17,"17132",1311,923,913,10,10,"C's",77
17,"17176",122,91,91,2,0,"C's",20
17,"17177",563,359,354,3,5,"C's",20
17,"17114",23020,15151,15024,105,127,"C's",870
17,"17141",5869,3688,3653,38,35,"C's",489
17,"17120",792,530,518,3,12,"C's",72
17,"17134",234,163,161,2,2,"C's",1
17,"17015",12525,8550,8470,59,80,"C's",380
17,"17075",334,234,227,5,7,"C's",11
17,"17025",1124,834,827,3,7,"C's",34
16,"16041",354,284,282,0,2,"PSOE",86
16,"16172",350,270,270,2,0,"PSOE",95
16,"16192",50,30,29,0,1,"PSOE",10
16,"16141",145,113,112,1,1,"PSOE",45
16,"16145",464,389,387,2,2,"PSOE",149
16,"16216",317,275,267,0,8,"PSOE",112
16,"16266",373,279,273,1,6,"PSOE",63
16,"16166",247,182,177,0,5,"PSOE",83
16,"16217",75,58,58,0,0,"PSOE",15
16,"16901",707,520,513,3,7,"PSOE",136
16,"16104",54,40,40,0,0,"PSOE",17
16,"16175",5113,4203,4124,35,79,"PSOE",1785
16,"16271",637,535,533,3,2,"PSOE",152
16,"16002",192,172,172,0,0,"PSOE",52
16,"16212",255,208,206,1,2,"PSOE",80
16,"16055",703,512,509,7,3,"PSOE",164
16,"16259",30,26,26,1,0,"PSOE",9
16,"16204",272,207,207,1,0,"PSOE",51
16,"16067",127,92,91,3,1,"PSOE",11
16,"16161",58,53,53,0,0,"PSOE",7
16,"16042",1192,1021,1005,6,16,"PSOE",434
16,"16142",139,110,109,2,1,"PSOE",37
16,"16062",24,21,21,0,0,"PSOE",7
16,"16095",84,71,68,0,3,"PSOE",13
16,"16131",134,97,97,1,0,"PSOE",28
16,"16129",104,82,79,1,3,"PSOE",19
16,"16031",46,30,30,2,0,"PSOE",7
16,"16185",44,35,33,0,2,"PSOE",16
16,"16111",171,138,137,2,1,"PSOE",43
16,"16081",49,38,37,0,1,"PSOE",6
16,"16045",221,166,164,1,2,"PSOE",57
16,"16280",189,160,157,2,3,"PSOE",52
16,"16064",681,588,581,1,7,"PSOE",175
16,"16254",216,181,179,5,2,"PSOE",42
16,"16153",955,797,780,5,17,"PSOE",298
16,"16237",113,89,87,0,2,"PSOE",13
16,"16177",78,63,63,0,0,"PSOE",18
16,"16029",96,73,71,0,2,"PSOE",15
16,"16151",64,60,60,0,0,"PSOE",11
16,"16255",141,119,119,0,0,"PSOE",48
16,"16169",58,33,32,0,1,"PSOE",9
16,"16068",145,117,114,2,3,"PSOE",41
16,"16247",71,52,51,0,1,"PSOE",20
16,"16158",546,437,431,7,6,"PSOE",105
16,"16228",177,132,131,1,1,"PSOE",28
16,"16093",64,52,52,0,0,"PSOE",11
16,"16005",256,191,187,1,4,"PSOE",50
16,"16089",379,299,299,4,0,"PSOE",108
16,"16162",43,35,35,0,0,"PSOE",12
16,"16904",478,387,381,5,6,"PSOE",109
16,"16134",4369,3412,3369,23,43,"PSOE",831
16,"16044",39,28,27,0,1,"PSOE",11
16,"16253",357,279,279,1,0,"PSOE",59
16,"16902",141,105,105,1,0,"PSOE",43
16,"16215",248,177,172,1,5,"PSOE",72
16,"16197",65,37,37,0,0,"PSOE",18
16,"16272",228,167,167,1,0,"PSOE",23
16,"16006",119,96,94,1,2,"PSOE",36
16,"16186",465,394,387,2,7,"PSOE",148
16,"16116",84,62,62,0,0,"PSOE",22
16,"16206",208,163,162,4,1,"PSOE",49
16,"16148",587,511,511,1,0,"PSOE",133
16,"16156",101,76,75,0,1,"PSOE",35
16,"16038",38,28,28,0,0,"PSOE",9
16,"16276",21,17,17,0,0,"PSOE",7
16,"16202",783,573,566,3,7,"PSOE",159
16,"16273",324,252,252,2,0,"PSOE",37
16,"16173",207,155,154,1,1,"PSOE",52
16,"16050",251,195,194,1,1,"PSOE",76
16,"16107",120,87,87,1,0,"PSOE",33
16,"16020",17,11,11,0,0,"PSOE",2
16,"16026",85,56,53,0,3,"PSOE",15
16,"16174",192,155,155,1,0,"PSOE",55
16,"16264",433,374,370,2,4,"PSOE",128
16,"16101",160,130,129,0,1,"PSOE",47
16,"16115",44,33,33,0,0,"PSOE",12
16,"16245",418,338,333,2,5,"PSOE",83
16,"16058",105,81,80,0,1,"PSOE",38
16,"16102",1231,922,911,8,11,"PSOE",266
16,"16035",258,192,192,3,0,"PSOE",74
16,"16170",698,524,517,1,7,"PSOE",173
16,"16274",127,100,100,0,0,"PSOE",41
16,"16040",85,71,71,0,0,"PSOE",5
16,"16243",412,354,348,0,6,"PSOE",89
16,"16010",154,114,110,1,4,"PSOE",18
16,"16110",97,71,70,0,1,"PSOE",4
16,"16198",1365,1067,1052,12,15,"PSOE",479
16,"16121",259,205,205,3,0,"PSOE",70
16,"16909",706,537,534,3,3,"PSOE",251
16,"16234",30,19,19,1,0,"PSOE",13
16,"16112",1505,1088,1072,9,16,"PSOE",370
16,"16011",28,19,19,0,0,"PSOE",4
16,"16086",888,768,762,10,6,"PSOE",251
16,"16194",259,208,200,0,8,"PSOE",103
16,"16195",498,380,376,1,4,"PSOE",193
16,"16258",198,143,142,0,1,"PSOE",41
16,"16132",34,26,26,0,0,"PSOE",9
16,"16015",376,286,285,7,1,"PSOE",62
16,"16098",571,468,461,5,7,"PSOE",166
16,"16047",230,176,176,2,0,"PSOE",40
16,"16147",62,43,43,0,0,"PSOE",9
16,"16051",147,118,118,0,0,"PSOE",45
16,"16263",961,754,745,4,9,"PSOE",295
16,"16227",112,84,84,0,0,"PSOE",19
16,"16118",1405,1147,1136,11,11,"PSOE",281
16,"16078",41427,31365,31095,268,270,"PSOE",7589
16,"16199",31,24,24,0,0,"PSOE",2
16,"16165",63,51,50,1,1,"PSOE",18
16,"16239",141,110,107,0,3,"PSOE",45
16,"16906",82,67,67,1,0,"PSOE",23
16,"16152",40,35,35,0,0,"PSOE",2
16,"16193",70,57,57,1,0,"PSOE",34
16,"16171",1818,1514,1498,5,16,"PSOE",564
16,"16097",162,135,135,1,0,"PSOE",59
16,"16119",169,121,120,0,1,"PSOE",37
16,"16079",32,21,20,0,1,"PSOE",10
16,"16001",75,60,60,0,0,"PSOE",13
16,"16149",153,130,129,0,1,"PSOE",44
16,"16106",2729,2130,2095,19,35,"PSOE",865
16,"16004",274,212,206,0,6,"PSOE",53
16,"16027",709,567,562,4,5,"PSOE",208
16,"16048",412,312,310,1,2,"PSOE",63
16,"16167",324,275,271,2,4,"PSOE",121
16,"16053",429,352,348,5,4,"PSOE",117
16,"16150",94,67,67,1,0,"PSOE",24
16,"16903",1081,824,816,6,8,"PSOE",168
16,"16126",783,654,648,2,6,"PSOE",227
16,"16085",136,108,108,2,0,"PSOE",25
16,"16094",132,101,99,1,2,"PSOE",14
16,"16073",188,158,158,0,0,"PSOE",66
16,"16135",139,109,108,0,1,"PSOE",31
16,"16046",250,181,180,1,1,"PSOE",67
16,"16191",926,760,752,6,8,"PSOE",274
16,"16154",4904,3776,3730,47,46,"PSOE",1171
16,"16187",77,52,52,1,0,"PSOE",10
16,"16033",1729,1385,1365,7,20,"PSOE",462
16,"16003",127,111,109,0,2,"PSOE",43
16,"16025",25,21,21,1,0,"PSOE",4
16,"16034",183,153,153,1,0,"PSOE",51
16,"16213",35,28,28,1,0,"PSOE",9
16,"16196",633,538,527,2,11,"PSOE",233
16,"16061",964,798,790,13,8,"PSOE",333
16,"16113",3080,2309,2278,15,31,"PSOE",702
16,"16188",90,63,62,0,1,"PSOE",24
16,"16071",20,20,20,0,0,"PSOE",3
16,"16100",684,587,580,5,7,"PSOE",194
16,"16278",73,55,55,0,0,"PSOE",25
16,"16066",2333,1917,1872,24,45,"PSOE",474
16,"16123",82,54,53,0,1,"PSOE",14
16,"16139",333,255,251,4,4,"PSOE",62
16,"16013",31,28,28,0,0,"PSOE",3
16,"16124",1870,1536,1518,7,18,"PSOE",459
16,"16279",213,146,143,0,3,"PSOE",35
16,"16189",256,192,191,2,1,"PSOE",34
16,"16072",147,103,102,0,1,"PSOE",38
16,"16250",76,57,57,0,0,"PSOE",12
16,"16084",49,37,32,0,5,"PSOE",17
16,"16908",197,154,154,1,0,"PSOE",60
16,"16023",468,344,343,3,1,"PSOE",90
16,"16032",287,230,230,1,0,"PSOE",87
16,"16203",9960,7515,7418,43,97,"PSOE",2608
16,"16036",128,104,102,2,2,"PSOE",31
16,"16176",39,28,28,0,0,"PSOE",17
16,"16063",98,87,87,0,0,"PSOE",30
16,"16125",1676,1338,1326,9,12,"PSOE",413
16,"16014",613,493,487,1,6,"PSOE",205
16,"16140",27,15,15,0,0,"PSOE",8
16,"16238",509,442,434,2,8,"PSOE",180
16,"16205",114,89,88,0,1,"PSOE",6
16,"16211",377,253,250,3,3,"PSOE",95
16,"16190",5127,4088,4025,42,63,"PSOE",1244
16,"16248",872,711,696,11,15,"PSOE",175
16,"16275",11,11,11,1,0,"PSOE",4
16,"16060",760,600,593,5,7,"PSOE",218
16,"16117",1057,814,808,2,6,"PSOE",293
16,"16122",254,200,198,4,2,"PSOE",63
16,"16244",722,625,617,2,8,"PSOE",204
16,"16225",76,58,57,0,1,"PSOE",15
16,"16159",225,170,168,0,2,"PSOE",68
16,"16905",1217,965,956,9,9,"PSOE",260
16,"16074",40,31,31,0,0,"PSOE",15
16,"16083",55,28,28,0,0,"PSOE",3
16,"16109",43,32,32,0,0,"PSOE",8
16,"16092",161,130,129,1,1,"PSOE",24
16,"16240",108,79,79,0,0,"PSOE",24
16,"16128",63,54,54,2,0,"PSOE",16
16,"16270",167,141,141,0,0,"PSOE",25
16,"16052",548,420,420,1,0,"PSOE",125
16,"16242",325,281,278,1,3,"PSOE",56
16,"16018",401,328,328,1,0,"PSOE",80
16,"16103",265,217,217,0,0,"PSOE",57
16,"16057",78,60,60,0,0,"PSOE",28
16,"16160",61,46,45,1,1,"PSOE",11
16,"16246",484,382,375,1,7,"PSOE",132
16,"16219",91,72,72,0,0,"PSOE",35
16,"16017",370,300,296,2,4,"PSOE",100
16,"16088",114,92,92,0,0,"PSOE",33
16,"16143",16,12,12,2,0,"PSOE",2
16,"16012",82,69,69,0,0,"PSOE",32
16,"16209",118,100,100,1,0,"PSOE",29
16,"16009",66,48,48,0,0,"PSOE",5
16,"16224",84,68,67,1,1,"PSOE",14
16,"16019",217,168,166,1,2,"PSOE",45
16,"16265",21,16,16,0,0,"PSOE",7
16,"16231",48,38,38,0,0,"PSOE",7
16,"16163",74,63,63,0,0,"PSOE",28
16,"16910",96,70,70,0,0,"PSOE",25
16,"16065",406,323,319,3,4,"PSOE",84
16,"16236",914,694,689,6,5,"PSOE",163
16,"16096",273,249,244,2,5,"PSOE",103
16,"16024",130,100,98,0,2,"PSOE",22
16,"16181",64,53,53,0,0,"PSOE",17
16,"16049",156,121,121,0,0,"PSOE",62
16,"16137",56,34,33,0,1,"PSOE",5
16,"16218",189,155,154,1,1,"PSOE",59
16,"16022",78,63,61,0,2,"PSOE",28
16,"16016",234,173,172,2,1,"PSOE",56
16,"16146",87,62,62,1,0,"PSOE",18
16,"16008",95,72,72,0,0,"PSOE",25
16,"16030",25,22,22,1,0,"PSOE",5
16,"16108",49,43,42,0,1,"PSOE",11
16,"16155",506,415,414,2,1,"PSOE",108
16,"16056",465,333,322,0,11,"PSOE",147
16,"16130",575,451,446,0,5,"PSOE",217
16,"16007",1192,964,959,8,5,"PSOE",357
16,"16039",398,275,271,1,4,"PSOE",94
16,"16157",213,185,182,0,3,"PSOE",60
16,"16091",68,51,49,0,2,"PSOE",24
16,"16087",212,186,186,5,0,"PSOE",52
16,"16133",4391,3539,3509,27,30,"PSOE",884
16,"16251",1858,1450,1420,8,30,"PSOE",348
16,"16269",426,351,349,3,2,"PSOE",112
16,"16070",32,31,31,0,0,"PSOE",16
16,"16082",305,224,224,0,0,"PSOE",103
16,"16277",118,86,84,0,2,"PSOE",6
16,"16043",99,73,73,1,0,"PSOE",17
16,"16099",208,157,152,0,5,"PSOE",35
16,"16249",1986,1593,1570,8,23,"PSOE",662
16,"16186",465,394,387,2,7,"PCPE",0
16,"16006",119,96,94,1,2,"PCPE",0
16,"16045",221,166,164,1,2,"PCPE",0
16,"16060",760,600,593,5,7,"PCPE",1
16,"16166",247,182,177,0,5,"PCPE",0
16,"16276",21,17,17,0,0,"PCPE",0
16,"16036",128,104,102,2,2,"PCPE",0
16,"16103",265,217,217,0,0,"PCPE",0
16,"16072",147,103,102,0,1,"PCPE",0
16,"16031",46,30,30,2,0,"PCPE",0
16,"16029",96,73,71,0,2,"PCPE",0
16,"16071",20,20,20,0,0,"PCPE",0
16,"16055",703,512,509,7,3,"PCPE",0
16,"16272",228,167,167,1,0,"PCPE",0
16,"16124",1870,1536,1518,7,18,"PCPE",1
16,"16067",127,92,91,3,1,"PCPE",0
16,"16225",76,58,57,0,1,"PCPE",0
16,"16244",722,625,617,2,8,"PCPE",0
16,"16097",162,135,135,1,0,"PCPE",0
16,"16064",681,588,581,1,7,"PCPE",2
16,"16192",50,30,29,0,1,"PCPE",0
16,"16157",213,185,182,0,3,"PCPE",0
16,"16088",114,92,92,0,0,"PCPE",0
16,"16022",78,63,61,0,2,"PCPE",0
16,"16171",1818,1514,1498,5,16,"PCPE",1
16,"16149",153,130,129,0,1,"PCPE",0
16,"16089",379,299,299,4,0,"PCPE",0
16,"16140",27,15,15,0,0,"PCPE",0
16,"16204",272,207,207,1,0,"PCPE",1
16,"16062",24,21,21,0,0,"PCPE",0
16,"16129",104,82,79,1,3,"PCPE",0
16,"16904",478,387,381,5,6,"PCPE",1
16,"16153",955,797,780,5,17,"PCPE",0
16,"16255",141,119,119,0,0,"PCPE",0
16,"16126",783,654,648,2,6,"PCPE",1
16,"16038",38,28,28,0,0,"PCPE",0
16,"16135",139,109,108,0,1,"PCPE",1
16,"16122",254,200,198,4,2,"PCPE",0
16,"16174",192,155,155,1,0,"PCPE",2
16,"16134",4369,3412,3369,23,43,"PCPE",3
16,"16197",65,37,37,0,0,"PCPE",0
16,"16185",44,35,33,0,2,"PCPE",0
16,"16194",259,208,200,0,8,"PCPE",0
16,"16216",317,275,267,0,8,"PCPE",0
16,"16043",99,73,73,1,0,"PCPE",0
16,"16042",1192,1021,1005,6,16,"PCPE",2
16,"16085",136,108,108,2,0,"PCPE",0
16,"16092",161,130,129,1,1,"PCPE",1
16,"16206",208,163,162,4,1,"PCPE",1
16,"16278",73,55,55,0,0,"PCPE",0
16,"16218",189,155,154,1,1,"PCPE",0
16,"16188",90,63,62,0,1,"PCPE",0
16,"16273",324,252,252,2,0,"PCPE",0
16,"16247",71,52,51,0,1,"PCPE",0
16,"16098",571,468,461,5,7,"PCPE",1
16,"16237",113,89,87,0,2,"PCPE",0
16,"16110",97,71,70,0,1,"PCPE",0
16,"16271",637,535,533,3,2,"PCPE",0
16,"16250",76,57,57,0,0,"PCPE",0
16,"16219",91,72,72,0,0,"PCPE",0
16,"16001",75,60,60,0,0,"PCPE",0
16,"16044",39,28,27,0,1,"PCPE",0
16,"16161",58,53,53,0,0,"PCPE",0
16,"16018",401,328,328,1,0,"PCPE",0
16,"16005",256,191,187,1,4,"PCPE",1
16,"16087",212,186,186,5,0,"PCPE",0
16,"16065",406,323,319,3,4,"PCPE",1
16,"16003",127,111,109,0,2,"PCPE",0
16,"16158",546,437,431,7,6,"PCPE",1
16,"16058",105,81,80,0,1,"PCPE",0
16,"16068",145,117,114,2,3,"PCPE",0
16,"16198",1365,1067,1052,12,15,"PCPE",0
16,"16172",350,270,270,2,0,"PCPE",1
16,"16243",412,354,348,0,6,"PCPE",0
16,"16280",189,160,157,2,3,"PCPE",1
16,"16199",31,24,24,0,0,"PCPE",0
16,"16146",87,62,62,1,0,"PCPE",0
16,"16019",217,168,166,1,2,"PCPE",0
16,"16266",373,279,273,1,6,"PCPE",0
16,"16010",154,114,110,1,4,"PCPE",0
16,"16224",84,68,67,1,1,"PCPE",0
16,"16051",147,118,118,0,0,"PCPE",0
16,"16095",84,71,68,0,3,"PCPE",0
16,"16173",207,155,154,1,1,"PCPE",0
16,"16163",74,63,63,0,0,"PCPE",0
16,"16202",783,573,566,3,7,"PCPE",1
16,"16030",25,22,22,1,0,"PCPE",0
16,"16034",183,153,153,1,0,"PCPE",0
16,"16160",61,46,45,1,1,"PCPE",0
16,"16906",82,67,67,1,0,"PCPE",0
16,"16147",62,43,43,0,0,"PCPE",0
16,"16012",82,69,69,0,0,"PCPE",0
16,"16212",255,208,206,1,2,"PCPE",0
16,"16015",376,286,285,7,1,"PCPE",0
16,"16903",1081,824,816,6,8,"PCPE",0
16,"16143",16,12,12,2,0,"PCPE",0
16,"16035",258,192,192,3,0,"PCPE",1
16,"16084",49,37,32,0,5,"PCPE",0
16,"16228",177,132,131,1,1,"PCPE",0
16,"16040",85,71,71,0,0,"PCPE",1
16,"16119",169,121,120,0,1,"PCPE",1
16,"16909",706,537,534,3,3,"PCPE",0
16,"16079",32,21,20,0,1,"PCPE",0
16,"16053",429,352,348,5,4,"PCPE",0
16,"16231",48,38,38,0,0,"PCPE",0
16,"16052",548,420,420,1,0,"PCPE",0
16,"16130",575,451,446,0,5,"PCPE",0
16,"16121",259,205,205,3,0,"PCPE",0
16,"16176",39,28,28,0,0,"PCPE",0
16,"16081",49,38,37,0,1,"PCPE",0
16,"16211",377,253,250,3,3,"PCPE",0
16,"16118",1405,1147,1136,11,11,"PCPE",2
16,"16002",192,172,172,0,0,"PCPE",0
16,"16050",251,195,194,1,1,"PCPE",0
16,"16155",506,415,414,2,1,"PCPE",0
16,"16245",418,338,333,2,5,"PCPE",0
16,"16150",94,67,67,1,0,"PCPE",0
16,"16162",43,35,35,0,0,"PCPE",0
16,"16234",30,19,19,1,0,"PCPE",0
16,"16910",96,70,70,0,0,"PCPE",0
16,"16091",68,51,49,0,2,"PCPE",0
16,"16905",1217,965,956,9,9,"PCPE",2
16,"16099",208,157,152,0,5,"PCPE",0
16,"16151",64,60,60,0,0,"PCPE",0
16,"16175",5113,4203,4124,35,79,"PCPE",3
16,"16236",914,694,689,6,5,"PCPE",0
16,"16113",3080,2309,2278,15,31,"PCPE",2
16,"16145",464,389,387,2,2,"PCPE",0
16,"16086",888,768,762,10,6,"PCPE",1
16,"16047",230,176,176,2,0,"PCPE",0
16,"16096",273,249,244,2,5,"PCPE",0
16,"16078",41427,31365,31095,268,270,"PCPE",21
16,"16196",633,538,527,2,11,"PCPE",0
16,"16008",95,72,72,0,0,"PCPE",0
16,"16100",684,587,580,5,7,"PCPE",0
16,"16148",587,511,511,1,0,"PCPE",0
16,"16165",63,51,50,1,1,"PCPE",0
16,"16238",509,442,434,2,8,"PCPE",1
16,"16101",160,130,129,0,1,"PCPE",0
16,"16106",2729,2130,2095,19,35,"PCPE",2
16,"16033",1729,1385,1365,7,20,"PCPE",0
16,"16057",78,60,60,0,0,"PCPE",0
16,"16189",256,192,191,2,1,"PCPE",0
16,"16017",370,300,296,2,4,"PCPE",0
16,"16027",709,567,562,4,5,"PCPE",0
16,"16258",198,143,142,0,1,"PCPE",1
16,"16094",132,101,99,1,2,"PCPE",0
16,"16023",468,344,343,3,1,"PCPE",0
16,"16125",1676,1338,1326,9,12,"PCPE",2
16,"16041",354,284,282,0,2,"PCPE",0
16,"16177",78,63,63,0,0,"PCPE",0
16,"16137",56,34,33,0,1,"PCPE",0
16,"16131",134,97,97,1,0,"PCPE",1
16,"16277",118,86,84,0,2,"PCPE",0
16,"16116",84,62,62,0,0,"PCPE",0
16,"16128",63,54,54,2,0,"PCPE",0
16,"16167",324,275,271,2,4,"PCPE",0
16,"16239",141,110,107,0,3,"PCPE",0
16,"16112",1505,1088,1072,9,16,"PCPE",0
16,"16108",49,43,42,0,1,"PCPE",0
16,"16154",4904,3776,3730,47,46,"PCPE",5
16,"16269",426,351,349,3,2,"PCPE",0
16,"16024",130,100,98,0,2,"PCPE",0
16,"16170",698,524,517,1,7,"PCPE",1
16,"16139",333,255,251,4,4,"PCPE",0
16,"16132",34,26,26,0,0,"PCPE",0
16,"16109",43,32,32,0,0,"PCPE",0
16,"16240",108,79,79,0,0,"PCPE",0
16,"16249",1986,1593,1570,8,23,"PCPE",1
16,"16274",127,100,100,0,0,"PCPE",0
16,"16056",465,333,322,0,11,"PCPE",2
16,"16152",40,35,35,0,0,"PCPE",0
16,"16213",35,28,28,1,0,"PCPE",0
16,"16156",101,76,75,0,1,"PCPE",0
16,"16066",2333,1917,1872,24,45,"PCPE",2
16,"16016",234,173,172,2,1,"PCPE",0
16,"16102",1231,922,911,8,11,"PCPE",0
16,"16142",139,110,109,2,1,"PCPE",0
16,"16013",31,28,28,0,0,"PCPE",0
16,"16901",707,520,513,3,7,"PCPE",0
16,"16191",926,760,752,6,8,"PCPE",0
16,"16007",1192,964,959,8,5,"PCPE",1
16,"16254",216,181,179,5,2,"PCPE",0
16,"16009",66,48,48,0,0,"PCPE",0
16,"16908",197,154,154,1,0,"PCPE",0
16,"16032",287,230,230,1,0,"PCPE",1
16,"16093",64,52,52,0,0,"PCPE",0
16,"16107",120,87,87,1,0,"PCPE",0
16,"16073",188,158,158,0,0,"PCPE",0
16,"16104",54,40,40,0,0,"PCPE",0
16,"16133",4391,3539,3509,27,30,"PCPE",6
16,"16263",961,754,745,4,9,"PCPE",0
16,"16070",32,31,31,0,0,"PCPE",0
16,"16046",250,181,180,1,1,"PCPE",0
16,"16205",114,89,88,0,1,"PCPE",1
16,"16227",112,84,84,0,0,"PCPE",0
16,"16039",398,275,271,1,4,"PCPE",0
16,"16190",5127,4088,4025,42,63,"PCPE",3
16,"16049",156,121,121,0,0,"PCPE",0
16,"16169",58,33,32,0,1,"PCPE",0
16,"16061",964,798,790,13,8,"PCPE",1
16,"16259",30,26,26,1,0,"PCPE",0
16,"16159",225,170,168,0,2,"PCPE",1
16,"16265",21,16,16,0,0,"PCPE",0
16,"16193",70,57,57,1,0,"PCPE",0
16,"16181",64,53,53,0,0,"PCPE",0
16,"16902",141,105,105,1,0,"PCPE",0
16,"16209",118,100,100,1,0,"PCPE",0
16,"16063",98,87,87,0,0,"PCPE",0
16,"16020",17,11,11,0,0,"PCPE",0
16,"16074",40,31,31,0,0,"PCPE",0
16,"16117",1057,814,808,2,6,"PCPE",0
16,"16215",248,177,172,1,5,"PCPE",0
16,"16123",82,54,53,0,1,"PCPE",0
16,"16242",325,281,278,1,3,"PCPE",0
16,"16264",433,374,370,2,4,"PCPE",0
16,"16141",145,113,112,1,1,"PCPE",0
16,"16011",28,19,19,0,0,"PCPE",0
16,"16026",85,56,53,0,3,"PCPE",1
16,"16279",213,146,143,0,3,"PCPE",0
16,"16217",75,58,58,0,0,"PCPE",0
16,"16248",872,711,696,11,15,"PCPE",0
16,"16115",44,33,33,0,0,"PCPE",0
16,"16048",412,312,310,1,2,"PCPE",0
16,"16004",274,212,206,0,6,"PCPE",0
16,"16111",171,138,137,2,1,"PCPE",0
16,"16203",9960,7515,7418,43,97,"PCPE",3
16,"16195",498,380,376,1,4,"PCPE",0
16,"16083",55,28,28,0,0,"PCPE",0
16,"16025",25,21,21,1,0,"PCPE",0
16,"16246",484,382,375,1,7,"PCPE",0
16,"16014",613,493,487,1,6,"PCPE",0
16,"16275",11,11,11,1,0,"PCPE",0
16,"16187",77,52,52,1,0,"PCPE",0
16,"16082",305,224,224,0,0,"PCPE",0
16,"16270",167,141,141,0,0,"PCPE",1
16,"16253",357,279,279,1,0,"PCPE",0
16,"16251",1858,1450,1420,8,30,"PCPE",0
26,"26078",83,68,68,0,0,"UPYD",0
26,"26123",130,111,108,0,3,"UPYD",1
26,"26124",824,664,659,8,5,"UPYD",1
26,"26160",715,569,567,3,2,"UPYD",3
26,"26019",351,282,281,1,1,"UPYD",1
26,"26108",268,207,205,5,2,"UPYD",0
26,"26145",245,202,201,3,1,"UPYD",0
26,"26007",523,406,401,2,5,"UPYD",1
26,"26115",17,14,14,0,0,"UPYD",0
26,"26117",2168,1695,1662,19,33,"UPYD",10
26,"26151",446,380,375,1,5,"UPYD",1
26,"26030",12,12,12,0,0,"UPYD",0
26,"26153",12,11,10,0,1,"UPYD",0
26,"26013",356,264,262,3,2,"UPYD",4
26,"26012",23,23,23,0,0,"UPYD",0
26,"26109",85,76,74,1,2,"UPYD",0
26,"26008",1862,1442,1425,7,17,"UPYD",2
26,"26070",186,154,153,1,1,"UPYD",1
26,"26031",106,81,81,0,0,"UPYD",0
26,"26069",240,201,199,0,2,"UPYD",1
26,"26037",131,111,111,1,0,"UPYD",0
26,"26035",16,12,12,0,0,"UPYD",1
26,"26066",265,217,209,3,8,"UPYD",0
26,"26140",260,221,218,1,3,"UPYD",0
26,"26001",197,163,155,3,8,"UPYD",0
26,"26014",466,319,319,0,0,"UPYD",0
26,"26034",660,522,513,1,9,"UPYD",1
26,"26158",265,220,217,4,3,"UPYD",0
26,"26088",36,32,31,0,1,"UPYD",2
26,"26154",11,8,8,0,0,"UPYD",0
26,"26112",243,192,191,1,1,"UPYD",1
26,"26167",59,45,45,1,0,"UPYD",1
26,"26094",85,71,68,0,3,"UPYD",0
26,"26003",416,336,330,2,6,"UPYD",1
26,"26074",105,86,85,1,1,"UPYD",1
26,"26111",248,195,192,1,3,"UPYD",3
26,"26009",414,326,319,3,7,"UPYD",0
26,"26152",31,24,23,0,1,"UPYD",0
26,"26150",117,98,98,1,0,"UPYD",0
26,"26015",193,151,149,0,2,"UPYD",1
26,"26006",1809,1420,1410,14,10,"UPYD",9
26,"26048",22,22,21,0,1,"UPYD",0
26,"26004",68,53,53,1,0,"UPYD",0
26,"26110",162,135,134,0,1,"UPYD",0
26,"26104",14,9,9,0,0,"UPYD",0
26,"26032",53,40,40,0,0,"UPYD",1
26,"26157",296,236,232,3,4,"UPYD",0
26,"26168",5318,3853,3802,36,51,"UPYD",28
26,"26077",27,25,25,0,0,"UPYD",0
26,"26084",6630,5015,4952,27,63,"UPYD",56
26,"26049",174,127,121,0,6,"UPYD",0
26,"26144",194,150,148,2,2,"UPYD",0
26,"26147",30,26,26,0,0,"UPYD",1
26,"26068",82,68,66,0,2,"UPYD",0
26,"26041",134,97,94,1,3,"UPYD",1
26,"26029",37,31,31,0,0,"UPYD",1
26,"26005",2343,1607,1590,19,17,"UPYD",11
26,"26054",324,255,254,3,1,"UPYD",2
26,"26082",109,92,89,0,3,"UPYD",0
26,"26171",179,136,126,1,10,"UPYD",0
26,"26017",383,302,301,4,1,"UPYD",2
26,"26018",10469,8216,8110,71,106,"UPYD",31
26,"26038",95,66,65,0,1,"UPYD",2
26,"26163",143,117,117,2,0,"UPYD",0
26,"26170",448,346,344,8,2,"UPYD",1
26,"26065",50,40,40,0,0,"UPYD",1
26,"26114",80,71,71,2,0,"UPYD",0
26,"26146",101,78,77,0,1,"UPYD",1
26,"26120",1457,1144,1133,9,11,"UPYD",4
26,"26043",373,284,282,4,2,"UPYD",0
26,"26172",30,25,25,0,0,"UPYD",0
26,"26079",639,536,527,2,9,"UPYD",4
26,"26164",61,41,41,0,0,"UPYD",0
26,"26107",92,75,75,0,0,"UPYD",0
26,"26128",104,80,79,0,1,"UPYD",0
26,"26173",6,6,6,1,0,"UPYD",0
26,"26055",42,33,33,0,0,"UPYD",0
26,"26042",836,645,635,5,10,"UPYD",2
26,"26106",88,78,78,0,0,"UPYD",1
26,"26072",289,259,258,2,1,"UPYD",1
26,"26044",51,46,45,0,1,"UPYD",0
26,"26091",166,141,138,0,3,"UPYD",0
26,"26121",27,21,21,0,0,"UPYD",0
26,"26057",51,47,45,0,2,"UPYD",0
26,"26134",87,65,65,1,0,"UPYD",0
26,"26100",52,43,43,0,0,"UPYD",0
26,"26056",425,357,353,6,4,"UPYD",1
26,"26174",147,122,112,0,10,"UPYD",0
26,"26095",101,78,77,1,1,"UPYD",0
26,"26086",15,15,15,0,0,"UPYD",0
26,"26135",167,120,119,0,1,"UPYD",1
26,"26148",171,147,145,0,2,"UPYD",1
26,"26045",12,12,12,0,0,"UPYD",0
26,"26130",203,167,166,1,1,"UPYD",4
26,"26033",172,143,142,2,1,"UPYD",1
26,"26122",119,104,102,2,2,"UPYD",0
26,"26021",2819,2113,2077,23,36,"UPYD",9
26,"26058",150,114,113,0,1,"UPYD",0
26,"26046",1594,1221,1209,3,12,"UPYD",4
26,"26175",52,44,44,2,0,"UPYD",0
26,"26136",103,73,72,1,1,"UPYD",0
26,"26096",244,199,197,3,2,"UPYD",0
26,"26131",34,33,33,1,0,"UPYD",0
26,"26022",198,159,158,0,1,"UPYD",0
26,"26176",54,46,43,1,3,"UPYD",0
26,"26067",23,20,20,0,0,"UPYD",1
26,"26119",202,163,162,4,1,"UPYD",0
26,"26098",94,72,71,1,1,"UPYD",1
26,"26093",57,44,44,0,0,"UPYD",0
26,"26010",98,78,78,1,0,"UPYD",0
26,"26059",1117,850,840,9,10,"UPYD",7
26,"26071",8477,6115,6029,51,86,"UPYD",47
26,"26083",289,213,213,1,0,"UPYD",3
26,"26138",4600,3374,3325,28,49,"UPYD",17
26,"26132",111,88,88,1,0,"UPYD",1
26,"26047",1969,1614,1596,14,18,"UPYD",11
26,"26099",1259,1038,1024,7,14,"UPYD",3
26,"26023",468,358,355,4,3,"UPYD",1
26,"26011",7336,5309,5255,57,54,"UPYD",32
26,"26161",7,7,7,0,0,"UPYD",0
26,"26060",85,67,67,1,0,"UPYD",0
26,"26080",475,392,388,6,4,"UPYD",0
26,"26177",309,266,264,2,2,"UPYD",0
26,"26165",364,315,311,1,4,"UPYD",1
26,"26081",16,14,14,0,0,"UPYD",0
26,"26162",121,106,106,2,0,"UPYD",1
26,"26036",16990,12136,11984,98,152,"UPYD",125
26,"26024",236,183,183,0,0,"UPYD",0
26,"26073",98,83,83,0,0,"UPYD",0
26,"26020",483,356,344,2,12,"UPYD",0
26,"26061",1548,1179,1160,14,19,"UPYD",7
26,"26178",80,64,63,1,1,"UPYD",0
26,"26126",31,29,29,0,0,"UPYD",0
26,"26166",142,131,128,1,3,"UPYD",0
26,"26087",208,157,154,4,3,"UPYD",2
26,"26025",85,71,71,1,0,"UPYD",0
26,"26062",90,73,71,0,2,"UPYD",0
26,"26179",42,34,33,0,1,"UPYD",0
26,"26050",117,86,86,0,0,"UPYD",1
26,"26113",37,34,32,0,2,"UPYD",0
26,"26101",46,34,34,0,0,"UPYD",0
26,"26127",215,182,179,2,3,"UPYD",0
26,"26141",112,85,83,1,2,"UPYD",2
26,"26026",1323,1070,1060,8,10,"UPYD",3
26,"26180",221,182,179,0,3,"UPYD",1
26,"26149",61,48,48,0,0,"UPYD",0
26,"26002",840,615,608,6,7,"UPYD",3
26,"26102",6128,4673,4585,42,88,"UPYD",32
26,"26075",334,268,264,2,4,"UPYD",1
26,"26039",38,35,35,0,0,"UPYD",0
26,"26027",157,127,127,1,0,"UPYD",1
26,"26142",780,618,613,1,5,"UPYD",5
26,"26103",789,626,616,3,10,"UPYD",4
26,"26051",254,202,201,2,1,"UPYD",0
26,"26089",110513,85146,84302,712,844,"UPYD",775
26,"26181",15,13,13,0,0,"UPYD",0
26,"26063",122,97,96,0,1,"UPYD",1
26,"26076",128,111,110,2,1,"UPYD",1
26,"26169",64,60,60,0,0,"UPYD",1
26,"26155",162,138,137,0,1,"UPYD",0
26,"26143",217,178,177,0,1,"UPYD",1
26,"26139",54,46,46,0,0,"UPYD",0
26,"26129",971,768,757,2,11,"UPYD",4
26,"26052",158,125,125,0,0,"UPYD",0
26,"26125",2708,2013,1988,22,25,"UPYD",8
26,"26064",2278,1736,1715,17,21,"UPYD",12
26,"26028",133,112,111,0,1,"UPYD",2
26,"26016",28,24,24,1,0,"UPYD",0
26,"26040",68,62,62,0,0,"UPYD",0
26,"26183",65,50,50,0,0,"UPYD",0
26,"26053",208,161,160,1,1,"UPYD",1
26,"26118",61,49,49,1,0,"UPYD",1
26,"26105",2187,1722,1696,16,26,"UPYD",8
26,"26092",108,83,82,0,1,"UPYD",2
4,"4001",1083,812,796,6,16,"DN",0
4,"4051",440,373,372,0,1,"DN",0
4,"4079",50800,33862,33629,200,233,"DN",19
4,"4027",249,163,163,1,0,"DN",0
4,"4098",1537,1157,1147,8,10,"DN",0
4,"4010",579,469,464,2,5,"DN",0
4,"4041",318,241,241,6,0,"DN",0
4,"4092",2852,2192,2168,13,24,"DN",0
4,"4020",292,208,207,1,1,"DN",0
4,"4050",830,597,594,3,3,"DN",1
4,"4902",45373,28425,28220,249,205,"DN",23
4,"4089",746,536,528,6,8,"DN",0
4,"4061",618,495,491,5,4,"DN",1
4,"4074",2829,1965,1945,24,20,"DN",1
4,"4058",369,292,291,2,1,"DN",0
4,"4086",1792,1271,1258,8,13,"DN",0
4,"4084",337,264,261,1,3,"DN",0
4,"4099",4988,3784,3714,26,70,"DN",2
4,"4011",2798,2244,2220,14,24,"DN",0
4,"4053",12333,9124,9040,66,84,"DN",3
4,"4021",187,148,141,1,7,"DN",0
4,"4065",366,290,288,2,2,"DN",0
4,"4064",2779,2032,2009,8,23,"DN",0
4,"4090",309,242,242,1,0,"DN",0
4,"4062",4528,3610,3579,20,31,"DN",0
4,"4002",1063,765,760,1,5,"DN",0
4,"4031",2359,1791,1786,7,5,"DN",1
4,"4059",1100,752,745,7,7,"DN",0
4,"4056",147,123,120,0,3,"DN",0
4,"4082",306,210,209,0,1,"DN",0
4,"4012",191,170,169,1,1,"DN",0
4,"4022",348,243,242,1,1,"DN",0
4,"4094",209,141,141,1,0,"DN",0
4,"4091",342,280,278,4,2,"DN",0
4,"4063",1099,847,835,2,12,"DN",0
4,"4903",4345,2896,2875,35,21,"DN",3
4,"4901",539,388,386,0,2,"DN",0
4,"4003",17365,10931,10830,57,101,"DN",8
4,"4032",5606,3789,3770,19,19,"DN",1
4,"4029",8887,6103,6048,53,55,"DN",3
4,"4057",1337,941,933,2,8,"DN",0
4,"4054",363,297,292,1,5,"DN",0
4,"4028",226,198,197,0,1,"DN",0
4,"4087",189,140,139,1,1,"DN",0
4,"4013",141116,95203,94625,669,578,"DN",60
4,"4045",1777,1402,1392,9,10,"DN",0
4,"4083",1790,1384,1379,8,5,"DN",0
4,"4007",736,553,551,0,2,"DN",0
4,"4035",8375,6079,6031,28,48,"DN",4
4,"4037",1312,1019,1000,6,19,"DN",0
4,"4005",577,438,432,1,6,"DN",0
4,"4004",421,314,312,2,2,"DN",0
4,"4033",139,100,97,3,3,"DN",0
4,"4072",311,247,244,14,3,"DN",0
4,"4088",2475,1717,1703,10,14,"DN",1
4,"4085",395,302,298,0,4,"DN",0
4,"4030",1140,828,826,8,2,"DN",1
4,"4014",153,118,118,0,0,"DN",0
4,"4046",862,658,656,6,2,"DN",0
4,"4024",3036,2325,2308,18,17,"DN",1
4,"4093",1872,1265,1252,10,13,"DN",0
4,"4080",226,185,182,2,3,"DN",0
4,"4036",228,176,175,2,1,"DN",0
4,"4067",584,432,424,0,8,"DN",0
4,"4015",130,98,98,1,0,"DN",0
4,"4047",2278,1906,1891,13,15,"DN",0
4,"4073",332,231,230,2,1,"DN",0
4,"4075",5152,3772,3715,19,57,"DN",1
4,"4077",303,277,274,2,3,"DN",0
4,"4006",7016,4823,4786,33,37,"DN",1
4,"4026",70,60,60,0,0,"DN",0
4,"4009",169,127,126,0,1,"DN",0
4,"4904",1759,1185,1172,15,13,"DN",0
4,"4016",2146,1584,1564,8,20,"DN",1
4,"4008",501,420,415,3,5,"DN",0
4,"4081",356,290,290,2,0,"DN",0
4,"4068",195,158,158,0,0,"DN",0
4,"4034",173,108,108,3,0,"DN",0
4,"4048",1503,1104,1096,7,8,"DN",0
4,"4049",5280,3658,3623,20,35,"DN",2
4,"4102",13729,8987,8878,114,109,"DN",1
4,"4023",139,104,102,1,2,"DN",0
4,"4095",726,466,463,2,3,"DN",0
4,"4038",3066,2169,2150,20,19,"DN",0
4,"4097",254,196,194,0,2,"DN",0
4,"4066",13573,8651,8570,65,81,"DN",5
4,"4078",1095,784,779,7,5,"DN",0
4,"4017",1301,881,876,5,5,"DN",0
4,"4019",251,199,198,0,1,"DN",0
4,"4100",8712,5545,5482,30,63,"DN",4
4,"4076",1296,1005,993,7,12,"DN",1
4,"4096",274,208,206,0,2,"DN",0
4,"4018",274,245,242,0,3,"DN",0
4,"4070",1623,1233,1229,7,4,"DN",0
4,"4101",4283,2969,2950,22,19,"DN",4
4,"4055",372,315,315,0,0,"DN",0
4,"4052",12246,8393,8353,84,40,"DN",2
4,"4060",466,361,358,2,3,"DN",0
4,"4043",546,466,462,3,4,"DN",0
4,"4103",1478,1051,1037,6,14,"DN",2
4,"4071",398,327,326,2,1,"DN",0
4,"4069",4692,3641,3607,29,34,"DN",1
4,"4044",1555,1253,1243,9,10,"DN",1
17,"17054",375,249,249,2,0,"PACMA",1
17,"17073",1875,1466,1460,11,6,"PACMA",11
17,"17147",8112,5475,5422,43,53,"PACMA",53
17,"17082",410,273,268,3,5,"PACMA",4
17,"17061",162,119,119,1,0,"PACMA",1
17,"17037",104,65,65,0,0,"PACMA",0
17,"17041",215,146,145,2,1,"PACMA",0
17,"17010",330,247,246,5,1,"PACMA",2
17,"17132",1311,923,913,10,10,"PACMA",7
17,"17026",536,381,380,6,1,"PACMA",0
17,"17067",697,500,495,7,5,"PACMA",7
17,"17028",303,213,213,4,0,"PACMA",3
17,"17085",293,223,221,1,2,"PACMA",4
17,"17192",145,108,108,1,0,"PACMA",0
17,"17215",2066,1588,1577,12,11,"PACMA",22
17,"17019",1779,1279,1261,13,18,"PACMA",7
17,"17138",944,668,663,4,5,"PACMA",13
17,"17169",2475,1733,1724,11,9,"PACMA",29
17,"17025",1124,834,827,3,7,"PACMA",3
17,"17134",234,163,161,2,2,"PACMA",1
17,"17166",516,386,378,2,8,"PACMA",2
17,"17209",625,480,477,2,3,"PACMA",9
17,"17030",645,430,428,7,2,"PACMA",5
17,"17218",588,448,445,3,3,"PACMA",4
17,"17116",348,243,240,4,3,"PACMA",4
17,"17058",180,132,131,1,1,"PACMA",2
17,"17191",146,114,113,1,1,"PACMA",1
17,"17036",2736,1857,1839,16,18,"PACMA",21
17,"17207",2373,1691,1673,18,18,"PACMA",8
17,"17139",1382,972,963,9,9,"PACMA",4
17,"17217",348,268,266,0,2,"PACMA",2
17,"17135",355,263,258,2,5,"PACMA",3
17,"17174",176,102,102,3,0,"PACMA",0
17,"17194",78,54,52,2,2,"PACMA",2
17,"17093",893,590,585,6,5,"PACMA",3
17,"17193",4216,2807,2768,26,39,"PACMA",35
17,"17228",295,211,210,1,1,"PACMA",0
17,"17161",990,737,734,7,3,"PACMA",7
17,"17146",2979,2030,2009,14,21,"PACMA",41
17,"17029",203,131,131,2,0,"PACMA",1
17,"17068",245,173,172,0,1,"PACMA",1
17,"17168",374,273,272,1,1,"PACMA",2
17,"17140",674,498,495,5,3,"PACMA",1
17,"17075",334,234,227,5,7,"PACMA",2
17,"17001",585,417,413,2,4,"PACMA",7
17,"17184",1258,893,887,6,6,"PACMA",5
17,"17064",325,219,214,1,5,"PACMA",0
17,"17002",556,429,419,1,10,"PACMA",1
17,"17039",1764,1229,1217,20,12,"PACMA",12
17,"17170",172,118,117,2,1,"PACMA",1
17,"17066",26551,16275,16166,140,109,"PACMA",182
17,"17204",562,385,384,7,1,"PACMA",6
17,"17014",61,47,47,1,0,"PACMA",1
17,"17107",268,189,188,2,1,"PACMA",1
17,"17112",192,141,139,1,2,"PACMA",2
17,"17076",123,90,88,2,2,"PACMA",1
17,"17221",4182,2882,2859,18,23,"PACMA",38
17,"17185",2293,1547,1527,12,20,"PACMA",16
17,"17173",180,141,139,2,2,"PACMA",0
17,"17069",378,270,267,4,3,"PACMA",2
17,"17022",6926,4626,4587,47,39,"PACMA",35
17,"17121",221,157,156,1,1,"PACMA",2
17,"17902",1353,957,947,9,10,"PACMA",9
17,"17119",68,59,59,0,0,"PACMA",0
17,"17024",279,176,176,2,0,"PACMA",4
17,"17040",538,392,391,4,1,"PACMA",5
17,"17126",308,252,250,2,2,"PACMA",1
17,"17136",175,133,132,1,1,"PACMA",4
17,"17110",1325,953,945,5,8,"PACMA",8
17,"17199",6845,4527,4483,32,44,"PACMA",56
17,"17233",2287,1682,1664,21,18,"PACMA",14
17,"17086",1744,1181,1170,10,11,"PACMA",9
17,"17133",1268,887,877,6,10,"PACMA",4
17,"17090",542,410,408,3,2,"PACMA",2
17,"17101",543,364,362,3,2,"PACMA",9
17,"17007",1730,1235,1224,4,11,"PACMA",3
17,"17227",128,95,95,0,0,"PACMA",3
17,"17172",452,308,307,1,1,"PACMA",4
17,"17151",174,124,123,3,1,"PACMA",0
17,"17103",4942,3150,3129,19,21,"PACMA",59
17,"17180",8300,5429,5368,42,61,"PACMA",74
17,"17098",311,224,221,2,3,"PACMA",2
17,"17034",6874,4509,4477,32,32,"PACMA",51
17,"17213",5372,3549,3517,17,32,"PACMA",44
17,"17009",4042,2770,2738,18,32,"PACMA",18
17,"17164",3996,2555,2543,23,12,"PACMA",20
17,"17129",137,99,99,1,0,"PACMA",1
17,"17043",158,119,117,1,2,"PACMA",1
17,"17175",579,366,360,4,6,"PACMA",9
17,"17234",183,124,124,1,0,"PACMA",0
17,"17055",152,125,125,0,0,"PACMA",0
17,"17042",414,288,286,2,2,"PACMA",0
17,"17224",314,214,213,3,1,"PACMA",1
17,"17095",19593,12648,12554,81,94,"PACMA",158
17,"17222",109,85,85,1,0,"PACMA",0
17,"17120",792,530,518,3,12,"PACMA",6
17,"17203",154,110,110,0,0,"PACMA",1
17,"17049",3125,2251,2233,7,18,"PACMA",28
17,"17074",507,345,341,1,4,"PACMA",3
17,"17226",856,572,557,5,15,"PACMA",7
17,"17162",147,91,90,0,1,"PACMA",0
17,"17189",1524,1126,1114,4,12,"PACMA",2
17,"17211",839,646,639,3,7,"PACMA",6
17,"17205",212,166,166,2,0,"PACMA",0
17,"17044",6767,4737,4694,36,43,"PACMA",55
17,"17142",2561,1962,1950,13,12,"PACMA",28
17,"17003",102,71,71,0,0,"PACMA",0
17,"17046",719,499,492,2,7,"PACMA",5
17,"17115",277,195,195,0,0,"PACMA",2
17,"17097",199,149,148,5,1,"PACMA",1
17,"17182",262,191,191,2,0,"PACMA",3
17,"17178",1063,690,685,5,5,"PACMA",4
17,"17063",166,115,113,0,2,"PACMA",0
17,"17106",139,108,106,0,2,"PACMA",1
17,"17183",274,186,186,3,0,"PACMA",5
17,"17008",3636,2423,2395,15,28,"PACMA",18
17,"17096",178,115,114,0,1,"PACMA",0
17,"17111",873,643,641,12,2,"PACMA",4
17,"17060",424,277,274,3,3,"PACMA",1
17,"17035",544,400,399,4,1,"PACMA",3
17,"17087",222,169,169,3,0,"PACMA",2
17,"17225",213,142,142,1,0,"PACMA",0
17,"17124",1638,1096,1083,10,13,"PACMA",5
17,"17080",141,98,98,0,0,"PACMA",1
17,"17012",1142,763,757,6,6,"PACMA",9
17,"17100",199,142,140,7,2,"PACMA",0
17,"17114",23020,15151,15024,105,127,"PACMA",96
17,"17051",219,157,155,3,2,"PACMA",1
17,"17152",10727,6804,6758,46,46,"PACMA",75
17,"17013",2787,1941,1926,17,15,"PACMA",18
17,"17020",3590,2531,2510,28,21,"PACMA",21
17,"17088",535,372,369,0,3,"PACMA",3
17,"17048",6269,4072,4044,24,28,"PACMA",59
17,"17021",135,86,86,2,0,"PACMA",1
17,"17150",1407,1074,1060,12,14,"PACMA",11
17,"17018",477,347,343,3,4,"PACMA",2
17,"17109",693,443,435,2,8,"PACMA",3
17,"17052",124,83,83,1,0,"PACMA",0
17,"17038",369,255,253,2,2,"PACMA",5
17,"17190",842,592,590,10,2,"PACMA",1
17,"17154",92,62,62,0,0,"PACMA",0
17,"17177",563,359,354,3,5,"PACMA",2
17,"17011",646,463,462,7,1,"PACMA",7
17,"17157",126,104,102,1,2,"PACMA",0
17,"17187",621,468,464,6,4,"PACMA",2
17,"17015",12525,8550,8470,59,80,"PACMA",66
17,"17208",997,679,671,12,8,"PACMA",7
17,"17200",618,425,422,4,3,"PACMA",2
17,"17201",128,93,92,1,1,"PACMA",1
17,"17186",3771,2742,2712,18,30,"PACMA",40
17,"17903",897,647,638,0,9,"PACMA",12
17,"17210",551,378,376,2,2,"PACMA",4
17,"17130",328,246,245,2,1,"PACMA",3
17,"17171",163,123,122,0,1,"PACMA",2
17,"17031",172,109,109,3,0,"PACMA",0
17,"17155",14500,9167,9080,43,87,"PACMA",131
17,"17057",960,708,699,8,9,"PACMA",5
17,"17083",2935,2059,2042,17,17,"PACMA",25
17,"17153",186,140,140,0,0,"PACMA",0
17,"17077",555,386,383,5,3,"PACMA",5
17,"17145",1488,1003,986,9,17,"PACMA",12
17,"17005",401,263,260,5,3,"PACMA",3
17,"17141",5869,3688,3653,38,35,"PACMA",55
17,"17102",576,397,395,4,2,"PACMA",2
17,"17128",302,224,223,4,1,"PACMA",4
17,"17220",811,563,555,3,8,"PACMA",6
17,"17081",244,165,163,0,2,"PACMA",0
17,"17144",210,141,141,2,0,"PACMA",3
17,"17195",338,256,251,2,5,"PACMA",2
17,"17056",1706,1200,1193,10,7,"PACMA",9
17,"17099",80,60,59,0,1,"PACMA",0
17,"17065",335,250,249,2,1,"PACMA",3
17,"17143",146,109,107,1,2,"PACMA",0
17,"17006",1131,730,728,9,2,"PACMA",6
17,"17176",122,91,91,2,0,"PACMA",0
17,"17070",109,82,82,1,0,"PACMA",2
17,"17165",653,445,443,2,2,"PACMA",8
17,"17092",3508,2373,2347,13,26,"PACMA",30
17,"17062",5970,3695,3657,31,38,"PACMA",33
17,"17223",807,528,520,6,8,"PACMA",5
17,"17084",236,160,160,7,0,"PACMA",0
17,"17160",14740,9853,9795,68,58,"PACMA",91
17,"17123",357,275,273,3,2,"PACMA",1
17,"17089",5490,3630,3591,20,39,"PACMA",57
17,"17004",510,371,368,0,3,"PACMA",5
17,"17071",1131,810,803,8,7,"PACMA",4
17,"17118",12824,8557,8477,57,80,"PACMA",93
17,"17197",137,105,105,2,0,"PACMA",3
17,"17232",149,98,98,1,0,"PACMA",1
17,"17216",165,112,110,0,2,"PACMA",1
17,"17159",627,439,434,2,5,"PACMA",4
17,"17212",139,108,106,1,2,"PACMA",1
17,"17198",430,282,281,4,1,"PACMA",5
17,"17163",2609,1904,1890,18,14,"PACMA",21
17,"17149",363,267,264,0,3,"PACMA",1
17,"17137",3411,2391,2369,15,22,"PACMA",22
17,"17079",64159,44230,43902,271,328,"PACMA",512
17,"17094",1049,646,641,3,5,"PACMA",4
17,"17188",165,126,126,0,0,"PACMA",0
17,"17202",3803,2471,2449,13,22,"PACMA",28
17,"17033",5293,3509,3476,28,33,"PACMA",39
17,"17027",2826,1993,1973,10,20,"PACMA",15
17,"17158",464,284,281,0,3,"PACMA",3
17,"17105",255,170,170,2,0,"PACMA",1
17,"17125",129,88,86,0,2,"PACMA",0
17,"17050",649,499,495,3,4,"PACMA",7
17,"17181",3380,2272,2251,15,21,"PACMA",36
17,"17214",706,471,468,4,3,"PACMA",5
17,"17148",1535,1056,1045,12,11,"PACMA",22
17,"17901",989,696,686,7,10,"PACMA",8
17,"17196",214,151,151,2,0,"PACMA",5
17,"17167",2697,1876,1852,24,24,"PACMA",16
17,"17091",411,282,273,5,9,"PACMA",1
17,"17047",4837,2997,2973,39,24,"PACMA",35
17,"17230",463,343,339,2,4,"PACMA",6
17,"17078",330,225,225,5,0,"PACMA",3
17,"17023",27347,18842,18610,118,232,"PACMA",228
17,"17206",141,89,87,0,2,"PACMA",0
17,"17117",14280,9297,9223,75,74,"PACMA",108
17,"17016",724,519,515,8,4,"PACMA",1
17,"17032",1713,1036,1020,13,16,"PACMA",11
48,"48010",457,311,307,1,4,"C's",5
48,"48081",1883,1412,1398,12,14,"C's",37
48,"48080",9971,7148,7086,71,62,"C's",156
48,"48037",678,518,509,2,9,"C's",11
48,"48068",1551,1178,1163,16,15,"C's",2
48,"48059",402,317,314,1,3,"C's",2
48,"48074",3333,2467,2428,20,39,"C's",65
48,"48061",762,584,581,4,3,"C's",17
48,"48097",1303,907,898,10,9,"C's",23
48,"48913",1251,933,917,13,16,"C's",19
48,"48005",117,76,76,0,0,"C's",0
48,"48077",3367,2438,2423,17,15,"C's",70
48,"48028",715,553,551,4,2,"C's",2
48,"48911",382,291,286,2,5,"C's",0
48,"48012",2041,1571,1553,11,18,"C's",22
48,"48095",2352,1658,1647,6,11,"C's",45
48,"48030",608,454,453,4,1,"C's",2
48,"48067",1161,837,834,2,3,"C's",7
48,"48035",412,313,312,4,1,"C's",7
48,"48002",7851,5767,5713,41,54,"C's",144
48,"48070",545,378,374,2,4,"C's",0
48,"48087",429,346,343,1,3,"C's",10
48,"48914",330,275,275,1,0,"C's",1
48,"48058",972,691,687,4,4,"C's",20
48,"48004",334,229,227,1,2,"C's",0
48,"48078",38742,28064,27837,231,227,"C's",949
48,"48051",220,169,168,0,1,"C's",3
48,"48086",2073,1519,1504,15,15,"C's",39
48,"48066",346,256,256,1,0,"C's",1
48,"48908",245,200,199,1,1,"C's",1
48,"48069",12765,8985,8910,58,75,"C's",310
48,"48043",4403,3214,3186,28,28,"C's",93
48,"48040",1299,896,884,5,12,"C's",17
48,"48090",6022,4544,4483,23,61,"C's",132
48,"48026",1134,861,853,7,8,"C's",3
48,"48022",2355,1476,1468,9,8,"C's",18
48,"48025",883,642,639,3,3,"C's",2
48,"48082",37673,27006,26811,201,195,"C's",879
48,"48901",4775,3602,3573,35,29,"C's",133
48,"48008",617,433,424,6,9,"C's",5
48,"48054",24135,17493,17374,124,119,"C's",919
48,"48064",603,463,459,7,4,"C's",9
48,"48094",3193,2210,2200,18,10,"C's",24
48,"48902",19124,13344,13227,93,117,"C's",387
48,"48045",5149,3940,3885,35,55,"C's",75
48,"48019",3594,2569,2544,16,25,"C's",74
48,"48042",1384,1111,1091,7,20,"C's",42
48,"48079",425,322,321,4,1,"C's",3
48,"48915",362,238,238,2,0,"C's",0
48,"48021",1352,952,946,8,6,"C's",13
48,"48015",33690,24299,24160,168,139,"C's",782
48,"48041",704,558,555,4,3,"C's",12
48,"48907",355,283,282,2,1,"C's",2
48,"48039",243,201,201,2,0,"C's",8
48,"48014",1218,870,866,8,4,"C's",21
48,"48016",5260,3856,3827,22,29,"C's",214
48,"48027",22033,15929,15825,113,104,"C's",483
48,"48033",215,160,159,0,1,"C's",1
48,"48060",3645,2277,2274,7,3,"C's",13
48,"48029",8332,6155,6119,35,36,"C's",358
48,"48091",1134,821,812,7,9,"C's",9
48,"48049",548,433,431,0,2,"C's",1
48,"48052",1559,1215,1211,0,4,"C's",15
48,"48038",1122,834,824,0,10,"C's",10
48,"48909",207,165,165,1,0,"C's",1
48,"48020",274076,193807,192607,1471,1200,"C's",9254
48,"48007",365,241,239,0,2,"C's",0
48,"48905",2565,1882,1847,2,35,"C's",32
48,"48013",79984,56928,56516,383,412,"C's",2278
48,"48910",2948,2126,2115,17,11,"C's",62
48,"48006",289,246,245,3,1,"C's",2
48,"48032",5735,4173,4151,32,22,"C's",70
48,"48092",837,619,619,13,0,"C's",10
48,"48904",3504,2671,2650,18,21,"C's",92
48,"48053",900,676,670,8,6,"C's",37
48,"48047",161,112,112,0,0,"C's",0
48,"48001",5832,4191,4166,37,25,"C's",137
48,"48071",6118,4467,4412,32,55,"C's",78
48,"48083",6950,5128,5097,33,31,"C's",92
48,"48076",314,237,237,4,0,"C's",2
48,"48903",1838,1400,1385,4,15,"C's",46
48,"48089",3266,2425,2406,23,19,"C's",66
48,"48011",9692,6891,6843,56,48,"C's",213
48,"48057",5749,4093,4081,20,12,"C's",20
48,"48050",198,153,150,0,3,"C's",1
48,"48063",373,289,288,1,1,"C's",0
48,"48017",13290,8908,8856,42,52,"C's",84
48,"48073",6952,4476,4435,43,41,"C's",18
48,"48036",24144,17085,16954,117,131,"C's",546
48,"48055",2662,1961,1938,16,23,"C's",44
48,"48034",12902,9684,9613,79,71,"C's",548
48,"48031",340,245,242,0,3,"C's",1
48,"48048",562,399,394,3,5,"C's",2
48,"48018",875,553,553,3,0,"C's",4
48,"48088",135,97,96,0,1,"C's",0
48,"48003",14338,10497,10414,76,83,"C's",238
48,"48085",10301,7458,7407,50,51,"C's",259
48,"48044",62989,46989,46783,385,206,"C's",3122
48,"48023",594,470,468,4,2,"C's",2
48,"48065",3315,2447,2433,19,14,"C's",45
48,"48062",300,241,240,1,1,"C's",1
48,"48056",978,733,732,7,1,"C's",6
48,"48906",775,579,574,0,5,"C's",0
48,"48075",1975,1440,1421,12,19,"C's",21
48,"48046",12617,9037,8967,56,70,"C's",172
48,"48096",6608,5071,5011,43,60,"C's",142
48,"48009",786,614,609,3,5,"C's",12
48,"48072",974,728,723,5,5,"C's",1
48,"48024",1003,775,771,5,4,"C's",3
48,"48093",900,673,664,4,9,"C's",7
48,"48912",2308,1787,1746,27,41,"C's",50
48,"48084",22577,15689,15540,108,149,"C's",442
43,"43001",695,474,472,4,2,"Unio.Cat",3
43,"43031",1466,1062,1056,8,6,"Unio.Cat",17
43,"43164",300,218,217,0,1,"Unio.Cat",2
43,"43167",383,287,286,2,1,"Unio.Cat",7
43,"43143",56,47,47,1,0,"Unio.Cat",0
43,"43123",70276,47897,47547,302,350,"Unio.Cat",806
43,"43134",283,226,224,2,2,"Unio.Cat",4
43,"43124",484,347,343,6,4,"Unio.Cat",12
43,"43062",274,223,219,7,4,"Unio.Cat",4
43,"43906",2117,1454,1441,3,13,"Unio.Cat",36
43,"43093",3909,2625,2597,44,28,"Unio.Cat",63
43,"43094",2175,1506,1480,11,26,"Unio.Cat",34
43,"43097",390,301,300,0,1,"Unio.Cat",6
43,"43907",4382,3174,3147,14,27,"Unio.Cat",22
43,"43032",523,371,365,7,6,"Unio.Cat",13
43,"43022",1508,1028,1015,20,13,"Unio.Cat",37
43,"43012",3580,2669,2658,22,11,"Unio.Cat",39
43,"43155",22874,15046,14893,137,153,"Unio.Cat",245
43,"43002",1821,1294,1266,12,28,"Unio.Cat",12
43,"43114",388,264,262,1,2,"Unio.Cat",3
43,"43033",778,576,569,5,7,"Unio.Cat",11
43,"43125",942,692,685,4,7,"Unio.Cat",18
43,"43083",140,95,94,0,1,"Unio.Cat",5
43,"43073",85,60,59,0,1,"Unio.Cat",4
43,"43105",162,115,115,3,0,"Unio.Cat",0
43,"43043",3128,2201,2186,11,15,"Unio.Cat",30
43,"43108",1775,1238,1229,8,9,"Unio.Cat",36
43,"43063",560,363,360,8,3,"Unio.Cat",12
43,"43003",322,234,233,3,1,"Unio.Cat",4
43,"43064",2017,1384,1367,16,17,"Unio.Cat",38
43,"43136",10353,6670,6622,50,48,"Unio.Cat",99
43,"43013",4425,2975,2938,21,37,"Unio.Cat",37
43,"43095",2493,1723,1703,13,20,"Unio.Cat",91
43,"43044",3975,2793,2758,34,35,"Unio.Cat",59
43,"43129",4618,3148,3107,24,41,"Unio.Cat",67
43,"43096",101,81,81,0,0,"Unio.Cat",10
43,"43126",1177,848,844,8,4,"Unio.Cat",19
43,"43024",1522,1044,1034,3,10,"Unio.Cat",9
43,"43085",226,178,178,2,0,"Unio.Cat",11
43,"43157",352,273,271,3,2,"Unio.Cat",6
43,"43106",810,544,532,7,12,"Unio.Cat",9
43,"43075",89,62,62,1,0,"Unio.Cat",1
43,"43177",298,236,232,5,4,"Unio.Cat",5
43,"43089",281,211,211,1,0,"Unio.Cat",2
43,"43127",765,554,548,2,6,"Unio.Cat",11
43,"43004",6326,4274,4227,38,47,"Unio.Cat",69
43,"43065",395,266,265,4,1,"Unio.Cat",4
43,"43137",1881,1344,1332,9,12,"Unio.Cat",14
43,"43015",112,91,91,1,0,"Unio.Cat",1
43,"43117",144,110,109,1,1,"Unio.Cat",0
43,"43035",262,167,164,0,3,"Unio.Cat",10
43,"43158",89,55,53,3,2,"Unio.Cat",0
43,"43079",364,258,257,1,1,"Unio.Cat",0
43,"43025",604,431,428,5,3,"Unio.Cat",3
43,"43138",2677,1821,1786,22,35,"Unio.Cat",52
43,"43168",93,64,64,2,0,"Unio.Cat",2
43,"43066",155,109,107,1,2,"Unio.Cat",2
43,"43005",3615,2376,2354,17,22,"Unio.Cat",47
43,"43148",90177,64180,63784,349,396,"Unio.Cat",1023
43,"43128",908,623,616,4,7,"Unio.Cat",6
43,"43009",1431,968,958,5,10,"Unio.Cat",16
43,"43172",351,243,242,8,1,"Unio.Cat",4
43,"43118",413,313,308,1,5,"Unio.Cat",4
43,"43901",8765,5306,5212,81,94,"Unio.Cat",61
43,"43098",343,249,249,4,0,"Unio.Cat",7
43,"43088",1966,1382,1372,6,10,"Unio.Cat",26
43,"43019",1371,904,886,4,18,"Unio.Cat",23
43,"43036",843,545,542,0,3,"Unio.Cat",9
43,"43016",3418,2534,2512,15,22,"Unio.Cat",37
43,"43166",1568,1117,1111,4,6,"Unio.Cat",31
43,"43006",683,463,458,10,5,"Unio.Cat",5
43,"43077",463,307,305,7,2,"Unio.Cat",2
43,"43159",80,57,57,0,0,"Unio.Cat",4
43,"43037",16725,10917,10822,61,95,"Unio.Cat",137
43,"43071",924,650,639,5,11,"Unio.Cat",11
43,"43133",5697,3726,3685,26,41,"Unio.Cat",57
43,"43078",856,640,632,11,8,"Unio.Cat",11
43,"43007",637,481,479,3,2,"Unio.Cat",15
43,"43099",305,234,233,1,1,"Unio.Cat",9
43,"43109",2560,1717,1700,13,17,"Unio.Cat",181
43,"43017",126,100,97,1,3,"Unio.Cat",2
43,"43038",21385,14375,14276,117,99,"Unio.Cat",204
43,"43068",528,346,338,2,8,"Unio.Cat",2
43,"43153",10676,7241,7190,29,51,"Unio.Cat",111
43,"43055",1975,1471,1459,16,12,"Unio.Cat",41
43,"43161",17217,11541,11478,67,63,"Unio.Cat",203
43,"43160",1273,888,879,7,9,"Unio.Cat",18
43,"43154",132,101,100,1,1,"Unio.Cat",2
43,"43130",196,128,127,2,1,"Unio.Cat",1
43,"43120",444,293,288,0,5,"Unio.Cat",0
43,"43100",3268,2360,2352,16,8,"Unio.Cat",29
43,"43018",410,320,316,1,4,"Unio.Cat",7
43,"43104",1798,1285,1268,14,17,"Unio.Cat",21
43,"43171",14593,10107,10049,46,58,"Unio.Cat",128
43,"43082",372,291,285,0,6,"Unio.Cat",5
43,"43008",309,185,181,5,4,"Unio.Cat",0
43,"43039",102,73,73,0,0,"Unio.Cat",0
43,"43904",2908,1799,1760,38,39,"Unio.Cat",26
43,"43070",236,194,193,0,1,"Unio.Cat",6
43,"43040",338,255,247,2,8,"Unio.Cat",7
43,"43132",365,269,264,1,5,"Unio.Cat",5
43,"43080",244,184,184,2,0,"Unio.Cat",13
43,"43131",4623,3059,3031,16,28,"Unio.Cat",28
43,"43029",323,237,237,4,0,"Unio.Cat",9
43,"43101",148,107,107,4,0,"Unio.Cat",2
43,"43046",100,77,72,2,5,"Unio.Cat",2
43,"43010",316,253,251,2,2,"Unio.Cat",4
43,"43026",797,579,574,2,5,"Unio.Cat",12
43,"43020",2202,1631,1614,13,17,"Unio.Cat",24
43,"43021",360,248,247,6,1,"Unio.Cat",5
43,"43162",4313,3132,3101,26,31,"Unio.Cat",39
43,"43058",93,68,67,1,1,"Unio.Cat",1
43,"43069",184,144,143,1,1,"Unio.Cat",5
43,"43011",1083,824,819,5,5,"Unio.Cat",16
43,"43169",457,364,356,3,8,"Unio.Cat",10
43,"43047",4128,2688,2652,19,36,"Unio.Cat",24
43,"43102",485,337,332,2,5,"Unio.Cat",6
43,"43030",430,311,308,1,3,"Unio.Cat",7
43,"43041",226,160,156,0,4,"Unio.Cat",0
43,"43045",152,121,121,0,0,"Unio.Cat",1
43,"43113",408,306,305,2,1,"Unio.Cat",12
43,"43103",892,644,640,6,4,"Unio.Cat",17
43,"43178",1335,939,933,9,6,"Unio.Cat",30
43,"43140",2366,1731,1717,7,14,"Unio.Cat",6
43,"43141",111,71,68,0,3,"Unio.Cat",3
43,"43146",38,30,30,1,0,"Unio.Cat",0
43,"43112",284,178,178,0,0,"Unio.Cat",5
43,"43014",14293,9441,9319,118,122,"Unio.Cat",146
43,"43072",105,77,77,1,0,"Unio.Cat",4
43,"43165",578,431,428,2,3,"Unio.Cat",9
43,"43052",954,662,653,9,9,"Unio.Cat",14
43,"43042",2148,1585,1573,7,12,"Unio.Cat",33
43,"43121",604,393,387,4,6,"Unio.Cat",7
43,"43107",377,265,260,4,5,"Unio.Cat",4
43,"43110",272,169,167,1,2,"Unio.Cat",12
43,"43135",342,252,251,3,1,"Unio.Cat",5
43,"43076",447,318,317,0,1,"Unio.Cat",9
43,"43115",155,116,116,2,0,"Unio.Cat",6
43,"43170",857,603,599,8,4,"Unio.Cat",12
43,"43156",3982,2748,2704,26,44,"Unio.Cat",38
43,"43057",40,25,25,1,0,"Unio.Cat",0
43,"43142",1114,781,771,4,10,"Unio.Cat",24
43,"43050",2521,1654,1640,11,14,"Unio.Cat",26
43,"43053",191,149,147,1,2,"Unio.Cat",1
43,"43175",566,390,387,3,3,"Unio.Cat",11
43,"43150",1300,940,913,5,27,"Unio.Cat",30
43,"43084",526,404,399,5,5,"Unio.Cat",6
43,"43091",136,94,94,2,0,"Unio.Cat",2
43,"43147",521,379,377,1,2,"Unio.Cat",11
43,"43048",807,569,564,8,5,"Unio.Cat",15
43,"43027",165,133,133,2,0,"Unio.Cat",8
43,"43023",231,173,171,3,2,"Unio.Cat",1
43,"43176",799,565,562,5,3,"Unio.Cat",11
43,"43145",4084,2991,2954,36,37,"Unio.Cat",53
43,"43144",1258,914,911,3,3,"Unio.Cat",13
43,"43903",2383,1420,1407,20,13,"Unio.Cat",19
43,"43116",455,326,321,1,5,"Unio.Cat",6
43,"43074",1749,1284,1275,7,9,"Unio.Cat",26
43,"43086",5237,3507,3476,27,31,"Unio.Cat",54
43,"43111",2049,1383,1366,9,17,"Unio.Cat",19
43,"43173",101,63,60,0,3,"Unio.Cat",1
43,"43119",793,559,556,7,3,"Unio.Cat",21
43,"43139",2053,1332,1321,16,11,"Unio.Cat",39
43,"43152",450,338,330,2,8,"Unio.Cat",18
43,"43051",8545,5813,5735,26,78,"Unio.Cat",50
43,"43149",699,483,472,7,11,"Unio.Cat",2
43,"43081",597,425,418,4,7,"Unio.Cat",13
43,"43056",871,532,521,6,11,"Unio.Cat",10
43,"43092",7059,4603,4563,21,40,"Unio.Cat",84
43,"43049",746,546,543,1,3,"Unio.Cat",15
43,"43059",253,195,195,2,0,"Unio.Cat",1
43,"43090",1070,625,620,4,5,"Unio.Cat",5
43,"43151",109,82,82,1,0,"Unio.Cat",1
43,"43028",2717,1727,1715,7,12,"Unio.Cat",18
43,"43902",2760,1775,1739,22,36,"Unio.Cat",24
43,"43060",2887,2019,1990,16,29,"Unio.Cat",24
43,"43054",2836,1873,1852,21,21,"Unio.Cat",42
43,"43067",555,434,430,1,4,"Unio.Cat",6
43,"43905",14371,9191,9136,41,55,"Unio.Cat",133
43,"43061",48,31,29,0,2,"Unio.Cat",1
43,"43034",480,366,358,4,8,"Unio.Cat",3
43,"43174",138,99,99,1,0,"Unio.Cat",2
43,"43163",25252,17001,16847,74,154,"Unio.Cat",208
43,"43122",106,84,84,0,0,"Unio.Cat",2
29,"29001",4196,3276,3253,26,23,"C's",184
29,"29004",328,240,238,2,2,"C's",15
29,"29019",888,675,672,0,3,"C's",33
29,"29074",785,612,611,4,1,"C's",63
29,"29038",17555,11638,11562,124,76,"C's",1911
29,"29903",525,394,389,2,5,"C's",19
29,"29029",420,322,315,4,7,"C's",22
29,"29068",6885,4580,4511,43,69,"C's",868
29,"29057",376,285,284,2,1,"C's",15
29,"29014",219,138,138,1,0,"C's",15
29,"29023",2047,1385,1369,2,16,"C's",332
29,"29079",2444,1880,1846,3,34,"C's",129
29,"29002",1203,855,842,6,13,"C's",102
29,"29058",1463,986,975,6,11,"C's",124
29,"29904",428,363,360,2,3,"C's",12
29,"29075",12952,8681,8619,55,62,"C's",1230
29,"29011",2920,1962,1946,5,16,"C's",205
29,"29085",151,99,98,1,1,"C's",3
29,"29046",2690,1974,1954,17,20,"C's",199
29,"29049",2987,2204,2185,25,19,"C's",139
29,"29092",567,423,415,4,8,"C's",35
29,"29041",3146,2251,2216,26,35,"C's",261
29,"29034",466,361,359,0,2,"C's",30
29,"29003",1002,777,769,1,8,"C's",56
29,"29021",162,114,107,13,7,"C's",7
29,"29076",2163,1508,1482,8,26,"C's",263
29,"29059",2590,2100,2058,11,42,"C's",121
29,"29012",9765,7029,6944,58,85,"C's",609
29,"29031",1633,1115,1106,6,9,"C's",68
29,"29086",795,497,490,3,7,"C's",33
29,"29062",658,564,561,0,3,"C's",25
29,"29087",380,283,276,1,7,"C's",40
29,"29067",424770,295944,294094,2117,1850,"C's",53621
29,"29091",8966,6437,6346,57,91,"C's",826
29,"29077",208,156,153,0,3,"C's",9
29,"29070",39913,26993,26751,203,242,"C's",5725
29,"29007",27319,19557,19395,179,162,"C's",4213
29,"29010",1667,1336,1310,1,26,"C's",74
29,"29081",258,205,200,1,5,"C's",22
29,"29060",706,524,516,0,8,"C's",40
29,"29063",336,255,251,2,4,"C's",35
29,"29090",1704,1174,1165,10,9,"C's",165
29,"29071",938,640,633,6,7,"C's",44
29,"29051",40201,27168,26842,229,326,"C's",4567
29,"29032",6708,5341,5265,26,76,"C's",546
29,"29066",346,252,251,2,1,"C's",23
29,"29053",1702,1178,1160,17,18,"C's",197
29,"29036",636,481,475,3,6,"C's",21
29,"29054",41888,29228,29022,205,206,"C's",5400
29,"29045",1685,1232,1223,4,9,"C's",137
29,"29005",4342,2946,2908,22,38,"C's",378
29,"29088",2720,1930,1883,21,47,"C's",179
29,"29061",1018,833,820,4,13,"C's",77
29,"29098",1257,991,977,12,14,"C's",71
29,"29042",14078,9890,9776,75,114,"C's",1749
29,"29052",226,155,152,0,3,"C's",16
29,"29043",2503,1671,1638,17,33,"C's",210
29,"29033",1132,808,804,2,4,"C's",66
29,"29097",4117,2996,2947,43,49,"C's",315
29,"29099",960,741,734,3,7,"C's",75
29,"29018",2026,1560,1519,15,41,"C's",159
29,"29072",3250,2466,2434,11,32,"C's",271
29,"29006",680,482,474,3,8,"C's",46
29,"29069",85333,56398,55854,443,544,"C's",10113
29,"29035",1587,1218,1208,0,10,"C's",42
29,"29009",1477,1113,1100,3,13,"C's",64
29,"29015",31884,23160,22943,188,217,"C's",3257
29,"29080",6704,4812,4766,44,46,"C's",633
29,"29083",2114,1587,1568,10,19,"C's",118
29,"29025",39210,26938,26747,160,191,"C's",5592
29,"29902",2560,1735,1709,13,26,"C's",134
29,"29016",253,188,188,1,0,"C's",14
29,"29056",1107,815,807,8,8,"C's",92
29,"29044",811,557,556,3,1,"C's",48
29,"29064",506,372,365,2,7,"C's",27
29,"29100",2437,1775,1760,12,15,"C's",208
29,"29008",14541,9954,9820,90,134,"C's",1777
29,"29901",43601,30325,30130,188,195,"C's",6021
29,"29055",1808,1415,1396,13,19,"C's",152
29,"29094",57313,39393,39052,280,341,"C's",6529
29,"29037",212,166,165,1,1,"C's",15
29,"29048",1428,1168,1155,9,13,"C's",42
29,"29065",194,134,134,1,0,"C's",12
29,"29026",1065,776,766,4,10,"C's",49
29,"29022",185,143,143,1,0,"C's",15
29,"29089",3254,2465,2438,10,27,"C's",81
29,"29017",6610,5001,4938,25,63,"C's",518
29,"29013",1612,1282,1272,6,10,"C's",111
29,"29095",3350,2523,2467,17,56,"C's",228
29,"29047",1131,927,914,4,13,"C's",34
29,"29084",27393,19096,18886,192,210,"C's",3512
29,"29082",31505,23154,22990,127,164,"C's",4949
29,"29030",809,653,651,2,2,"C's",32
29,"29039",2662,1948,1931,22,17,"C's",192
29,"29093",2235,1689,1667,12,22,"C's",106
29,"29096",2806,2065,2034,19,31,"C's",199
29,"29028",1249,881,881,4,0,"C's",76
29,"29073",1560,1126,1120,5,6,"C's",93
29,"29040",1964,1321,1301,12,20,"C's",153
29,"29050",425,313,309,1,4,"C's",58
29,"29024",393,271,256,4,15,"C's",41
29,"29027",2343,1737,1722,6,15,"C's",144
29,"29020",3265,2531,2504,17,27,"C's",259
28,"28140",2981,2383,2357,14,26,"C's",520
28,"28179",1441,1082,1071,7,11,"C's",183
28,"28024",152,129,128,1,1,"C's",15
28,"28064",134,105,105,0,0,"C's",12
28,"28149",5653,4516,4469,19,47,"C's",1127
28,"28177",10192,8271,8234,51,37,"C's",2351
28,"28028",1730,1347,1326,8,21,"C's",178
28,"28070",119,91,91,0,0,"C's",18
28,"28088",262,180,179,2,1,"C's",28
28,"28059",4312,3256,3237,11,19,"C's",674
28,"28172",8965,7255,7219,44,36,"C's",1853
28,"28114",149,103,103,1,0,"C's",13
28,"28026",6237,4893,4853,32,40,"C's",1109
28,"28021",544,387,387,2,0,"C's",53
28,"28116",700,544,544,3,0,"C's",118
28,"28090",8405,6792,6751,34,41,"C's",1547
28,"28074",138742,110456,109579,581,877,"C's",17610
28,"28175",850,696,692,2,4,"C's",171
28,"28134",60511,47566,47229,233,337,"C's",10252
28,"28079",2371327,1817203,1806970,9067,10233,"C's",314799
28,"28129",7913,6175,6124,30,51,"C's",1626
28,"28180",5242,4040,3999,11,41,"C's",623
28,"28080",48226,39753,39570,172,183,"C's",9702
28,"28903",32480,27640,27525,161,115,"C's",6935
28,"28078",36,34,34,0,0,"C's",4
28,"28122",518,388,385,2,3,"C's",52
28,"28089",3703,2961,2933,19,28,"C's",622
28,"28171",4238,3002,2962,18,40,"C's",388
28,"28051",1542,1240,1232,5,8,"C's",238
28,"28015",18233,14725,14653,81,72,"C's",4641
28,"28030",1716,1342,1316,2,26,"C's",198
28,"28004",6179,4377,4345,15,32,"C's",813
28,"28058",139289,108214,107323,612,891,"C's",20109
28,"28011",445,339,338,0,1,"C's",50
28,"28164",2986,2281,2263,12,18,"C's",437
28,"28170",2486,1757,1740,9,17,"C's",223
28,"28033",3824,2854,2832,11,22,"C's",584
28,"28173",520,409,408,3,1,"C's",60
28,"28072",5657,4465,4441,20,24,"C's",984
28,"28053",6458,5299,5263,29,36,"C's",1337
28,"28057",1439,1125,1120,5,5,"C's",222
28,"28061",21200,16698,16600,75,98,"C's",3677
28,"28121",198,166,164,2,2,"C's",20
28,"28013",40409,30141,29905,164,236,"C's",5304
28,"28102",881,659,650,3,9,"C's",82
28,"28159",588,469,468,6,1,"C's",52
28,"28126",39,25,25,0,0,"C's",3
28,"28118",58,49,48,1,1,"C's",0
28,"28100",4169,3076,3048,12,28,"C's",563
28,"28106",76612,56555,56006,346,549,"C's",10407
28,"28084",15839,12028,11925,53,103,"C's",2168
28,"28097",124,85,84,1,1,"C's",8
28,"28166",318,258,255,1,3,"C's",33
28,"28123",56464,47181,46948,257,233,"C's",10116
28,"28153",703,510,507,2,3,"C's",71
28,"28165",1788,1332,1321,5,11,"C's",191
28,"28183",1050,770,763,2,7,"C's",78
28,"28016",80,57,57,0,0,"C's",7
28,"28009",14046,11014,10932,51,82,"C's",2618
28,"28124",76,56,54,0,2,"C's",4
28,"28095",1508,1177,1167,6,10,"C's",174
28,"28006",78564,61796,61456,334,340,"C's",12506
28,"28049",58688,48006,47660,286,346,"C's",8574
28,"28085",3908,3106,3078,7,28,"C's",487
28,"28099",1731,1283,1278,8,5,"C's",241
28,"28111",592,489,483,0,6,"C's",88
28,"28008",1768,1293,1282,4,11,"C's",197
28,"28176",12288,9809,9763,50,46,"C's",2538
28,"28158",662,545,543,3,2,"C's",96
28,"28052",3883,2801,2758,18,43,"C's",479
28,"28094",825,636,634,3,2,"C's",127
28,"28007",124358,99423,98711,554,712,"C's",17544
28,"28136",640,540,532,0,8,"C's",102
28,"28029",530,426,424,3,2,"C's",83
28,"28160",8227,6295,6251,26,44,"C's",1455
28,"28147",968,751,745,2,6,"C's",97
28,"28003",181,141,141,3,0,"C's",21
28,"28075",5581,4380,4350,15,30,"C's",994
28,"28087",3176,2545,2528,15,17,"C's",472
28,"28083",8880,6801,6759,47,42,"C's",1607
28,"28023",4697,3835,3817,20,18,"C's",785
28,"28005",134211,104575,103819,667,756,"C's",19761
28,"28119",2074,1641,1625,9,16,"C's",381
28,"28156",998,751,743,3,8,"C's",119
28,"28012",883,702,691,4,11,"C's",137
28,"28073",12505,9485,9384,64,101,"C's",2011
28,"28066",7175,5598,5561,28,37,"C's",1289
28,"28178",1066,850,846,2,4,"C's",183
28,"28056",860,653,647,6,6,"C's",81
28,"28113",34305,27077,26881,156,196,"C's",5682
28,"28143",70,59,59,1,0,"C's",7
28,"28065",125384,101604,100872,477,732,"C's",16697
28,"28063",252,195,194,2,1,"C's",18
28,"28109",1591,1113,1111,3,2,"C's",181
28,"28086",5055,3627,3600,21,27,"C's",756
28,"28014",32852,24749,24571,120,178,"C's",4953
28,"28141",5806,4532,4486,24,46,"C's",1174
28,"28137",1644,1301,1283,7,18,"C's",233
28,"28154",5420,3966,3899,17,67,"C's",779
28,"28041",4452,3572,3550,24,22,"C's",1021
28,"28117",95,84,84,0,0,"C's",15
28,"28133",6002,4259,4204,12,55,"C's",576
28,"28046",4432,3562,3538,19,24,"C's",692
28,"28128",439,323,320,2,3,"C's",42
28,"28040",15691,10833,10728,45,105,"C's",2017
28,"28042",1153,882,874,5,8,"C's",128
28,"28108",3330,2536,2528,17,8,"C's",626
28,"28168",1226,910,900,1,10,"C's",128
28,"28050",4077,3032,3006,15,26,"C's",718
28,"28130",28243,22649,22458,135,191,"C's",4248
28,"28157",595,448,442,1,6,"C's",62
28,"28017",1210,954,943,6,11,"C's",170
28,"28101",218,180,180,0,0,"C's",30
28,"28092",151511,117869,116968,641,901,"C's",20704
28,"28025",427,329,326,1,3,"C's",17
28,"28135",971,740,735,4,5,"C's",92
28,"28001",64,48,48,3,0,"C's",1
28,"28096",18161,13784,13647,57,137,"C's",3046
28,"28047",40783,31308,31072,171,236,"C's",6365
28,"28093",2043,1681,1661,9,20,"C's",297
28,"28060",1509,1194,1183,8,11,"C's",108
28,"28132",11645,8605,8520,55,85,"C's",1634
28,"28038",4935,3858,3815,17,43,"C's",598
28,"28138",69,54,54,0,0,"C's",6
28,"28148",85022,65597,65111,368,486,"C's",12880
28,"28032",4749,3653,3607,19,46,"C's",832
28,"28082",5664,4526,4492,25,34,"C's",807
28,"28115",60579,50819,50657,246,162,"C's",11825
28,"28068",10928,8389,8315,43,74,"C's",1669
28,"28125",2965,2210,2188,13,22,"C's",395
28,"28002",2966,2186,2175,9,11,"C's",478
28,"28104",13836,11414,11349,54,65,"C's",3416
28,"28076",406,322,319,1,3,"C's",42
28,"28043",5922,4063,4008,29,55,"C's",556
28,"28151",3143,2352,2314,6,38,"C's",298
28,"28144",5929,4776,4744,29,32,"C's",881
28,"28181",20344,16669,16572,95,97,"C's",3806
28,"28054",11166,8649,8584,36,65,"C's",1721
28,"28035",1362,1042,1033,3,9,"C's",120
28,"28902",468,352,347,2,5,"C's",55
28,"28027",1199,897,882,5,15,"C's",164
28,"28107",435,326,321,0,5,"C's",50
28,"28044",5766,4623,4584,22,39,"C's",1008
28,"28174",1788,1277,1267,2,10,"C's",245
28,"28037",1566,1175,1168,5,7,"C's",85
28,"28120",1217,918,904,4,14,"C's",144
28,"28163",438,357,354,1,3,"C's",47
28,"28150",3084,2415,2381,13,34,"C's",467
28,"28010",9853,7959,7914,35,45,"C's",1823
28,"28167",8308,6605,6545,35,60,"C's",1477
28,"28110",1949,1543,1525,2,18,"C's",174
28,"28146",1773,1274,1262,9,12,"C's",164
28,"28182",214,174,170,0,4,"C's",35
28,"28091",5436,3827,3786,23,41,"C's",471
28,"28036",2514,1974,1949,12,25,"C's",442
28,"28155",507,420,420,0,0,"C's",37
28,"28039",130,97,97,0,0,"C's",7
28,"28112",167,132,132,0,0,"C's",21
28,"28048",499,406,401,2,5,"C's",44
28,"28169",1427,1164,1158,1,6,"C's",314
28,"28071",60,47,46,0,1,"C's",7
28,"28131",12971,9828,9755,57,73,"C's",2084
28,"28018",3739,3071,3046,12,25,"C's",548
28,"28034",352,270,269,1,1,"C's",33
28,"28145",2370,1824,1809,12,15,"C's",360
28,"28161",48368,37462,37161,190,301,"C's",9830
28,"28062",308,244,241,3,3,"C's",57
28,"28069",54,43,43,1,0,"C's",5
28,"28031",2055,1538,1519,4,19,"C's",144
28,"28020",148,99,97,1,2,"C's",6
28,"28045",33019,25531,25313,146,218,"C's",5353
28,"28055",899,682,676,4,6,"C's",69
28,"28162",2549,2039,2025,13,14,"C's",537
28,"28019",1237,952,938,2,14,"C's",142
28,"28067",4057,3220,3188,12,32,"C's",584
28,"28127",64513,53125,52932,300,193,"C's",14434
28,"28152",16026,13269,13202,46,67,"C's",3461
28,"28901",789,590,584,2,6,"C's",95
28,"28022",32949,27473,27379,169,94,"C's",7280
28,"28034",352,270,269,1,1,"PP",135
28,"28012",883,702,691,4,11,"PP",262
28,"28052",3883,2801,2758,18,43,"PP",1258
28,"28019",1237,952,938,2,14,"PP",258
28,"28124",76,56,54,0,2,"PP",21
28,"28183",1050,770,763,2,7,"PP",249
28,"28024",152,129,128,1,1,"PP",61
28,"28149",5653,4516,4469,19,47,"PP",1393
28,"28089",3703,2961,2933,19,28,"PP",1125
28,"28114",149,103,103,1,0,"PP",48
28,"28042",1153,882,874,5,8,"PP",412
28,"28060",1509,1194,1183,8,11,"PP",263
28,"28172",8965,7255,7219,44,36,"PP",2559
28,"28007",124358,99423,98711,554,712,"PP",30500
28,"28159",588,469,468,6,1,"PP",205
28,"28029",530,426,424,3,2,"PP",162
28,"28009",14046,11014,10932,51,82,"PP",3803
28,"28117",95,84,84,0,0,"PP",38
28,"28028",1730,1347,1326,8,21,"PP",373
28,"28068",10928,8389,8315,43,74,"PP",3194
28,"28130",28243,22649,22458,135,191,"PP",5294
28,"28011",445,339,338,0,1,"PP",132
28,"28107",435,326,321,0,5,"PP",85
28,"28137",1644,1301,1283,7,18,"PP",447
28,"28018",3739,3071,3046,12,25,"PP",1217
28,"28062",308,244,241,3,3,"PP",98
28,"28141",5806,4532,4486,24,46,"PP",1547
28,"28064",134,105,105,0,0,"PP",57
28,"28116",700,544,544,3,0,"PP",157
28,"28146",1773,1274,1262,9,12,"PP",519
28,"28106",76612,56555,56006,346,549,"PP",12451
28,"28111",592,489,483,0,6,"PP",178
28,"28901",789,590,584,2,6,"PP",185
28,"28164",2986,2281,2263,12,18,"PP",879
28,"28152",16026,13269,13202,46,67,"PP",5597
28,"28156",998,751,743,3,8,"PP",273
28,"28086",5055,3627,3600,21,27,"PP",1264
28,"28102",881,659,650,3,9,"PP",189
28,"28167",8308,6605,6545,35,60,"PP",1580
28,"28175",850,696,692,2,4,"PP",269
28,"28131",12971,9828,9755,57,73,"PP",3547
28,"28148",85022,65597,65111,368,486,"PP",18773
28,"28079",2371327,1817203,1806970,9067,10233,"PP",646348
28,"28151",3143,2352,2314,6,38,"PP",713
28,"28096",18161,13784,13647,57,137,"PP",4542
28,"28095",1508,1177,1167,6,10,"PP",457
28,"28104",13836,11414,11349,54,65,"PP",3601
28,"28162",2549,2039,2025,13,14,"PP",763
28,"28128",439,323,320,2,3,"PP",115
28,"28179",1441,1082,1071,7,11,"PP",417
28,"28013",40409,30141,29905,164,236,"PP",9717
28,"28053",6458,5299,5263,29,36,"PP",1579
28,"28061",21200,16698,16600,75,98,"PP",5814
28,"28163",438,357,354,1,3,"PP",111
28,"28037",1566,1175,1168,5,7,"PP",419
28,"28023",4697,3835,3817,20,18,"PP",1326
28,"28059",4312,3256,3237,11,19,"PP",1187
28,"28140",2981,2383,2357,14,26,"PP",857
28,"28169",1427,1164,1158,1,6,"PP",428
28,"28041",4452,3572,3550,24,22,"PP",1196
28,"28040",15691,10833,10728,45,105,"PP",3109
28,"28097",124,85,84,1,1,"PP",16
28,"28084",15839,12028,11925,53,103,"PP",3031
28,"28166",318,258,255,1,3,"PP",84
28,"28153",703,510,507,2,3,"PP",110
28,"28069",54,43,43,1,0,"PP",14
28,"28134",60511,47566,47229,233,337,"PP",14163
28,"28108",3330,2536,2528,17,8,"PP",749
28,"28026",6237,4893,4853,32,40,"PP",1858
28,"28178",1066,850,846,2,4,"PP",296
28,"28031",2055,1538,1519,4,19,"PP",649
28,"28072",5657,4465,4441,20,24,"PP",1709
28,"28094",825,636,634,3,2,"PP",205
28,"28110",1949,1543,1525,2,18,"PP",620
28,"28176",12288,9809,9763,50,46,"PP",4508
28,"28015",18233,14725,14653,81,72,"PP",4254
28,"28161",48368,37462,37161,190,301,"PP",10652
28,"28160",8227,6295,6251,26,44,"PP",2324
28,"28155",507,420,420,0,0,"PP",153
28,"28085",3908,3106,3078,7,28,"PP",1112
28,"28017",1210,954,943,6,11,"PP",297
28,"28112",167,132,132,0,0,"PP",51
28,"28113",34305,27077,26881,156,196,"PP",6764
28,"28115",60579,50819,50657,246,162,"PP",25006
28,"28058",139289,108214,107323,612,891,"PP",24575
28,"28038",4935,3858,3815,17,43,"PP",1240
28,"28109",1591,1113,1111,3,2,"PP",514
28,"28099",1731,1283,1278,8,5,"PP",569
28,"28082",5664,4526,4492,25,34,"PP",1346
28,"28046",4432,3562,3538,19,24,"PP",1343
28,"28076",406,322,319,1,3,"PP",131
28,"28055",899,682,676,4,6,"PP",313
28,"28133",6002,4259,4204,12,55,"PP",1631
28,"28048",499,406,401,2,5,"PP",113
28,"28067",4057,3220,3188,12,32,"PP",1074
28,"28123",56464,47181,46948,257,233,"PP",9139
28,"28181",20344,16669,16572,95,97,"PP",7457
28,"28165",1788,1332,1321,5,11,"PP",654
28,"28004",6179,4377,4345,15,32,"PP",1614
28,"28126",39,25,25,0,0,"PP",15
28,"28073",12505,9485,9384,64,101,"PP",2610
28,"28158",662,545,543,3,2,"PP",264
28,"28091",5436,3827,3786,23,41,"PP",1397
28,"28016",80,57,57,0,0,"PP",19
28,"28001",64,48,48,3,0,"PP",32
28,"28043",5922,4063,4008,29,55,"PP",1574
28,"28087",3176,2545,2528,15,17,"PP",1042
28,"28125",2965,2210,2188,13,22,"PP",905
28,"28138",69,54,54,0,0,"PP",23
28,"28005",134211,104575,103819,667,756,"PP",30927
28,"28032",4749,3653,3607,19,46,"PP",1123
28,"28066",7175,5598,5561,28,37,"PP",2398
28,"28030",1716,1342,1316,2,26,"PP",467
28,"28170",2486,1757,1740,9,17,"PP",592
28,"28118",58,49,48,1,1,"PP",20
28,"28045",33019,25531,25313,146,218,"PP",8428
28,"28157",595,448,442,1,6,"PP",205
28,"28180",5242,4040,3999,11,41,"PP",1348
28,"28101",218,180,180,0,0,"PP",65
28,"28002",2966,2186,2175,9,11,"PP",809
28,"28136",640,540,532,0,8,"PP",213
28,"28902",468,352,347,2,5,"PP",150
28,"28144",5929,4776,4744,29,32,"PP",1926
28,"28903",32480,27640,27525,161,115,"PP",8367
28,"28092",151511,117869,116968,641,901,"PP",33570
28,"28008",1768,1293,1282,4,11,"PP",511
28,"28145",2370,1824,1809,12,15,"PP",498
28,"28057",1439,1125,1120,5,5,"PP",387
28,"28047",40783,31308,31072,171,236,"PP",9479
28,"28127",64513,53125,52932,300,193,"PP",22327
28,"28122",518,388,385,2,3,"PP",149
28,"28021",544,387,387,2,0,"PP",125
28,"28070",119,91,91,0,0,"PP",41
28,"28033",3824,2854,2832,11,22,"PP",1164
28,"28168",1226,910,900,1,10,"PP",367
28,"28006",78564,61796,61456,334,340,"PP",21784
28,"28003",181,141,141,3,0,"PP",44
28,"28147",968,751,745,2,6,"PP",256
28,"28065",125384,101604,100872,477,732,"PP",25896
28,"28135",971,740,735,4,5,"PP",297
28,"28100",4169,3076,3048,12,28,"PP",1027
28,"28075",5581,4380,4350,15,30,"PP",1264
28,"28027",1199,897,882,5,15,"PP",327
28,"28078",36,34,34,0,0,"PP",12
28,"28010",9853,7959,7914,35,45,"PP",2820
28,"28022",32949,27473,27379,169,94,"PP",12404
28,"28020",148,99,97,1,2,"PP",38
28,"28071",60,47,46,0,1,"PP",23
28,"28050",4077,3032,3006,15,26,"PP",1063
28,"28063",252,195,194,2,1,"PP",72
28,"28035",1362,1042,1033,3,9,"PP",392
28,"28054",11166,8649,8584,36,65,"PP",3026
28,"28150",3084,2415,2381,13,34,"PP",898
28,"28177",10192,8271,8234,51,37,"PP",3095
28,"28080",48226,39753,39570,172,183,"PP",18213
28,"28129",7913,6175,6124,30,51,"PP",2126
28,"28090",8405,6792,6751,34,41,"PP",2248
28,"28173",520,409,408,3,1,"PP",157
28,"28093",2043,1681,1661,9,20,"PP",743
28,"28119",2074,1641,1625,9,16,"PP",640
28,"28083",8880,6801,6759,47,42,"PP",1974
28,"28132",11645,8605,8520,55,85,"PP",2281
28,"28143",70,59,59,1,0,"PP",33
28,"28014",32852,24749,24571,120,178,"PP",8168
28,"28154",5420,3966,3899,17,67,"PP",1235
28,"28056",860,653,647,6,6,"PP",230
28,"28025",427,329,326,1,3,"PP",193
28,"28174",1788,1277,1267,2,10,"PP",522
28,"28120",1217,918,904,4,14,"PP",326
28,"28036",2514,1974,1949,12,25,"PP",517
28,"28049",58688,48006,47660,286,346,"PP",11756
28,"28171",4238,3002,2962,18,40,"PP",1366
28,"28051",1542,1240,1232,5,8,"PP",448
28,"28088",262,180,179,2,1,"PP",52
28,"28039",130,97,97,0,0,"PP",36
28,"28074",138742,110456,109579,581,877,"PP",27777
28,"28044",5766,4623,4584,22,39,"PP",1418
28,"28182",214,174,170,0,4,"PP",45
28,"28121",198,166,164,2,2,"PP",66
28,"28107",435,326,321,0,5,"PSOE",120
28,"28180",5242,4040,3999,11,41,"PSOE",1208
28,"28171",4238,3002,2962,18,40,"PSOE",645
28,"28086",5055,3627,3600,21,27,"PSOE",664
28,"28095",1508,1177,1167,6,10,"PSOE",185
28,"28151",3143,2352,2314,6,38,"PSOE",533
28,"28128",439,323,320,2,3,"PSOE",93
28,"28002",2966,2186,2175,9,11,"PSOE",377
28,"28126",39,25,25,0,0,"PSOE",7
28,"28064",134,105,105,0,0,"PSOE",21
28,"28036",2514,1974,1949,12,25,"PSOE",287
28,"28025",427,329,326,1,3,"PSOE",67
28,"28059",4312,3256,3237,11,19,"PSOE",563
28,"28031",2055,1538,1519,4,19,"PSOE",488
28,"28149",5653,4516,4469,19,47,"PSOE",723
28,"28084",15839,12028,11925,53,103,"PSOE",2641
28,"28111",592,489,483,0,6,"PSOE",93
28,"28120",1217,918,904,4,14,"PSOE",210
28,"28015",18233,14725,14653,81,72,"PSOE",1769
28,"28062",308,244,241,3,3,"PSOE",23
28,"28053",6458,5299,5263,29,36,"PSOE",853
28,"28094",825,636,634,3,2,"PSOE",75
28,"28145",2370,1824,1809,12,15,"PSOE",424
28,"28176",12288,9809,9763,50,46,"PSOE",909
28,"28032",4749,3653,3607,19,46,"PSOE",716
28,"28076",406,322,319,1,3,"PSOE",63
28,"28003",181,141,141,3,0,"PSOE",31
28,"28049",58688,48006,47660,286,346,"PSOE",10229
28,"28060",1509,1194,1183,8,11,"PSOE",501
28,"28173",520,409,408,3,1,"PSOE",102
28,"28020",148,99,97,1,2,"PSOE",11
28,"28097",124,85,84,1,1,"PSOE",28
28,"28172",8965,7255,7219,44,36,"PSOE",889
28,"28136",640,540,532,0,8,"PSOE",95
28,"28161",48368,37462,37161,190,301,"PSOE",5806
28,"28110",1949,1543,1525,2,18,"PSOE",422
28,"28021",544,387,387,2,0,"PSOE",42
28,"28069",54,43,43,1,0,"PSOE",7
28,"28902",468,352,347,2,5,"PSOE",28
28,"28130",28243,22649,22458,135,191,"PSOE",4827
28,"28152",16026,13269,13202,46,67,"PSOE",1306
28,"28013",40409,30141,29905,164,236,"PSOE",6580
28,"28174",1788,1277,1267,2,10,"PSOE",243
28,"28007",124358,99423,98711,554,712,"PSOE",20135
28,"28132",11645,8605,8520,55,85,"PSOE",2006
28,"28155",507,420,420,0,0,"PSOE",174
28,"28057",1439,1125,1120,5,5,"PSOE",179
28,"28052",3883,2801,2758,18,43,"PSOE",487
28,"28016",80,57,57,0,0,"PSOE",17
28,"28141",5806,4532,4486,24,46,"PSOE",527
28,"28106",76612,56555,56006,346,549,"PSOE",12334
28,"28088",262,180,179,2,1,"PSOE",44
28,"28154",5420,3966,3899,17,67,"PSOE",930
28,"28074",138742,110456,109579,581,877,"PSOE",27014
28,"28140",2981,2383,2357,14,26,"PSOE",379
28,"28087",3176,2545,2528,15,17,"PSOE",414
28,"28068",10928,8389,8315,43,74,"PSOE",1229
28,"28116",700,544,544,3,0,"PSOE",92
28,"28065",125384,101604,100872,477,732,"PSOE",22815
28,"28104",13836,11414,11349,54,65,"PSOE",1372
28,"28008",1768,1293,1282,4,11,"PSOE",244
28,"28125",2965,2210,2188,13,22,"PSOE",363
28,"28089",3703,2961,2933,19,28,"PSOE",477
28,"28127",64513,53125,52932,300,193,"PSOE",5381
28,"28061",21200,16698,16600,75,98,"PSOE",2338
28,"28159",588,469,468,6,1,"PSOE",125
28,"28023",4697,3835,3817,20,18,"PSOE",490
28,"28100",4169,3076,3048,12,28,"PSOE",400
28,"28096",18161,13784,13647,57,137,"PSOE",2542
28,"28166",318,258,255,1,3,"PSOE",58
28,"28124",76,56,54,0,2,"PSOE",5
28,"28108",3330,2536,2528,17,8,"PSOE",353
28,"28153",703,510,507,2,3,"PSOE",86
28,"28017",1210,954,943,6,11,"PSOE",118
28,"28177",10192,8271,8234,51,37,"PSOE",1047
28,"28903",32480,27640,27525,161,115,"PSOE",3669
28,"28182",214,174,170,0,4,"PSOE",26
28,"28029",530,426,424,3,2,"PSOE",54
28,"28079",2371327,1817203,1806970,9067,10233,"PSOE",306887
28,"28055",899,682,676,4,6,"PSOE",198
28,"28030",1716,1342,1316,2,26,"PSOE",234
28,"28027",1199,897,882,5,15,"PSOE",175
28,"28138",69,54,54,0,0,"PSOE",4
28,"28101",218,180,180,0,0,"PSOE",34
28,"28066",7175,5598,5561,28,37,"PSOE",659
28,"28056",860,653,647,6,6,"PSOE",107
28,"28117",95,84,84,0,0,"PSOE",8
28,"28075",5581,4380,4350,15,30,"PSOE",794
28,"28090",8405,6792,6751,34,41,"PSOE",917
28,"28092",151511,117869,116968,641,901,"PSOE",25451
28,"28034",352,270,269,1,1,"PSOE",49
28,"28091",5436,3827,3786,23,41,"PSOE",934
28,"28009",14046,11014,10932,51,82,"PSOE",1749
28,"28148",85022,65597,65111,368,486,"PSOE",13068
28,"28048",499,406,401,2,5,"PSOE",87
28,"28043",5922,4063,4008,29,55,"PSOE",955
28,"28175",850,696,692,2,4,"PSOE",74
28,"28099",1731,1283,1278,8,5,"PSOE",184
28,"28004",6179,4377,4345,15,32,"PSOE",854
28,"28082",5664,4526,4492,25,34,"PSOE",602
28,"28162",2549,2039,2025,13,14,"PSOE",249
28,"28134",60511,47566,47229,233,337,"PSOE",8627
28,"28035",1362,1042,1033,3,9,"PSOE",251
28,"28050",4077,3032,3006,15,26,"PSOE",429
28,"28122",518,388,385,2,3,"PSOE",78
28,"28160",8227,6295,6251,26,44,"PSOE",787
28,"28167",8308,6605,6545,35,60,"PSOE",1320
28,"28012",883,702,691,4,11,"PSOE",130
28,"28005",134211,104575,103819,667,756,"PSOE",22248
28,"28178",1066,850,846,2,4,"PSOE",145
28,"28026",6237,4893,4853,32,40,"PSOE",600
28,"28037",1566,1175,1168,5,7,"PSOE",468
28,"28113",34305,27077,26881,156,196,"PSOE",5250
28,"28158",662,545,543,3,2,"PSOE",58
28,"28123",56464,47181,46948,257,233,"PSOE",7301
28,"28183",1050,770,763,2,7,"PSOE",124
28,"28045",33019,25531,25313,146,218,"PSOE",4154
28,"28033",3824,2854,2832,11,22,"PSOE",494
28,"28181",20344,16669,16572,95,97,"PSOE",1821
28,"28129",7913,6175,6124,30,51,"PSOE",880
28,"28046",4432,3562,3538,19,24,"PSOE",514
28,"28901",789,590,584,2,6,"PSOE",133
28,"28063",252,195,194,2,1,"PSOE",36
28,"28058",139289,108214,107323,612,891,"PSOE",26909
28,"28112",167,132,132,0,0,"PSOE",36
28,"28044",5766,4623,4584,22,39,"PSOE",701
28,"28115",60579,50819,50657,246,162,"PSOE",5230
28,"28119",2074,1641,1625,9,16,"PSOE",203
28,"28041",4452,3572,3550,24,22,"PSOE",462
28,"28051",1542,1240,1232,5,8,"PSOE",226
28,"28019",1237,952,938,2,14,"PSOE",294
28,"28070",119,91,91,0,0,"PSOE",4
28,"28137",1644,1301,1283,7,18,"PSOE",263
28,"28169",1427,1164,1158,1,6,"PSOE",145
28,"28093",2043,1681,1661,9,20,"PSOE",268
28,"28073",12505,9485,9384,64,101,"PSOE",1908
28,"28010",9853,7959,7914,35,45,"PSOE",1016
28,"28102",881,659,650,3,9,"PSOE",228
28,"28168",1226,910,900,1,10,"PSOE",171
28,"28014",32852,24749,24571,120,178,"PSOE",4763
28,"28147",968,751,745,2,6,"PSOE",198
28,"28085",3908,3106,3078,7,28,"PSOE",713
28,"28135",971,740,735,4,5,"PSOE",125
28,"28170",2486,1757,1740,9,17,"PSOE",483
28,"28040",15691,10833,10728,45,105,"PSOE",2185
28,"28114",149,103,103,1,0,"PSOE",10
28,"28109",1591,1113,1111,3,2,"PSOE",163
28,"28179",1441,1082,1071,7,11,"PSOE",152
28,"28072",5657,4465,4441,20,24,"PSOE",545
28,"28042",1153,882,874,5,8,"PSOE",110
28,"28011",445,339,338,0,1,"PSOE",58
28,"28163",438,357,354,1,3,"PSOE",68
28,"28165",1788,1332,1321,5,11,"PSOE",279
28,"28083",8880,6801,6759,47,42,"PSOE",1118
28,"28024",152,129,128,1,1,"PSOE",25
28,"28156",998,751,743,3,8,"PSOE",147
28,"28018",3739,3071,3046,12,25,"PSOE",487
28,"28131",12971,9828,9755,57,73,"PSOE",1436
28,"28038",4935,3858,3815,17,43,"PSOE",704
28,"28071",60,47,46,0,1,"PSOE",9
28,"28047",40783,31308,31072,171,236,"PSOE",5354
28,"28144",5929,4776,4744,29,32,"PSOE",729
28,"28164",2986,2281,2263,12,18,"PSOE",365
28,"28121",198,166,164,2,2,"PSOE",39
28,"28118",58,49,48,1,1,"PSOE",10
28,"28006",78564,61796,61456,334,340,"PSOE",11073
28,"28001",64,48,48,3,0,"PSOE",4
28,"28080",48226,39753,39570,172,183,"PSOE",4226
28,"28039",130,97,97,0,0,"PSOE",26
28,"28146",1773,1274,1262,9,12,"PSOE",330
28,"28054",11166,8649,8584,36,65,"PSOE",1287
28,"28078",36,34,34,0,0,"PSOE",4
28,"28028",1730,1347,1326,8,21,"PSOE",186
28,"28150",3084,2415,2381,13,34,"PSOE",365
28,"28143",70,59,59,1,0,"PSOE",13
28,"28022",32949,27473,27379,169,94,"PSOE",2587
28,"28133",6002,4259,4204,12,55,"PSOE",1084
28,"28067",4057,3220,3188,12,32,"PSOE",730
28,"28157",595,448,442,1,6,"PSOE",75
28,"28062",308,244,241,3,3,"PACMA",0
28,"28149",5653,4516,4469,19,47,"PACMA",50
28,"28094",825,636,634,3,2,"PACMA",5
28,"28089",3703,2961,2933,19,28,"PACMA",29
28,"28102",881,659,650,3,9,"PACMA",4
28,"28059",4312,3256,3237,11,19,"PACMA",27
28,"28182",214,174,170,0,4,"PACMA",1
28,"28078",36,34,34,0,0,"PACMA",0
28,"28109",1591,1113,1111,3,2,"PACMA",12
28,"28035",1362,1042,1033,3,9,"PACMA",14
28,"28130",28243,22649,22458,135,191,"PACMA",310
28,"28111",592,489,483,0,6,"PACMA",3
28,"28079",2371327,1817203,1806970,9067,10233,"PACMA",12042
28,"28153",703,510,507,2,3,"PACMA",1
28,"28096",18161,13784,13647,57,137,"PACMA",105
28,"28084",15839,12028,11925,53,103,"PACMA",135
28,"28057",1439,1125,1120,5,5,"PACMA",10
28,"28044",5766,4623,4584,22,39,"PACMA",35
28,"28134",60511,47566,47229,233,337,"PACMA",362
28,"28164",2986,2281,2263,12,18,"PACMA",19
28,"28002",2966,2186,2175,9,11,"PACMA",22
28,"28146",1773,1274,1262,9,12,"PACMA",3
28,"28039",130,97,97,0,0,"PACMA",0
28,"28020",148,99,97,1,2,"PACMA",0
28,"28060",1509,1194,1183,8,11,"PACMA",19
28,"28012",883,702,691,4,11,"PACMA",4
28,"28112",167,132,132,0,0,"PACMA",0
28,"28175",850,696,692,2,4,"PACMA",5
28,"28901",789,590,584,2,6,"PACMA",4
28,"28003",181,141,141,3,0,"PACMA",3
28,"28024",152,129,128,1,1,"PACMA",0
28,"28903",32480,27640,27525,161,115,"PACMA",148
28,"28101",218,180,180,0,0,"PACMA",3
28,"28118",58,49,48,1,1,"PACMA",0
28,"28172",8965,7255,7219,44,36,"PACMA",80
28,"28122",518,388,385,2,3,"PACMA",3
28,"28049",58688,48006,47660,286,346,"PACMA",475
28,"28083",8880,6801,6759,47,42,"PACMA",62
28,"28013",40409,30141,29905,164,236,"PACMA",244
28,"28097",124,85,84,1,1,"PACMA",0
28,"28027",1199,897,882,5,15,"PACMA",5
28,"28119",2074,1641,1625,9,16,"PACMA",16
28,"28161",48368,37462,37161,190,301,"PACMA",425
28,"28029",530,426,424,3,2,"PACMA",4
28,"28179",1441,1082,1071,7,11,"PACMA",12
28,"28129",7913,6175,6124,30,51,"PACMA",43
28,"28076",406,322,319,1,3,"PACMA",0
28,"28045",33019,25531,25313,146,218,"PACMA",200
28,"28178",1066,850,846,2,4,"PACMA",16
28,"28157",595,448,442,1,6,"PACMA",3
28,"28070",119,91,91,0,0,"PACMA",0
28,"28080",48226,39753,39570,172,183,"PACMA",243
28,"28022",32949,27473,27379,169,94,"PACMA",165
28,"28056",860,653,647,6,6,"PACMA",6
28,"28037",1566,1175,1168,5,7,"PACMA",6
28,"28072",5657,4465,4441,20,24,"PACMA",42
28,"28155",507,420,420,0,0,"PACMA",0
28,"28007",124358,99423,98711,554,712,"PACMA",737
28,"28136",640,540,532,0,8,"PACMA",4
28,"28095",1508,1177,1167,6,10,"PACMA",8
28,"28108",3330,2536,2528,17,8,"PACMA",12
28,"28150",3084,2415,2381,13,34,"PACMA",19
28,"28053",6458,5299,5263,29,36,"PACMA",32
28,"28154",5420,3966,3899,17,67,"PACMA",41
28,"28026",6237,4893,4853,32,40,"PACMA",53
28,"28123",56464,47181,46948,257,233,"PACMA",432
28,"28183",1050,770,763,2,7,"PACMA",11
28,"28115",60579,50819,50657,246,162,"PACMA",264
28,"28147",968,751,745,2,6,"PACMA",5
28,"28131",12971,9828,9755,57,73,"PACMA",81
28,"28902",468,352,347,2,5,"PACMA",1
28,"28074",138742,110456,109579,581,877,"PACMA",930
28,"28054",11166,8649,8584,36,65,"PACMA",72
28,"28008",1768,1293,1282,4,11,"PACMA",11
28,"28168",1226,910,900,1,10,"PACMA",2
28,"28152",16026,13269,13202,46,67,"PACMA",89
28,"28051",1542,1240,1232,5,8,"PACMA",8
28,"28031",2055,1538,1519,4,19,"PACMA",2
28,"28169",1427,1164,1158,1,6,"PACMA",7
28,"28001",64,48,48,3,0,"PACMA",0
28,"28041",4452,3572,3550,24,22,"PACMA",35
28,"28040",15691,10833,10728,45,105,"PACMA",105
28,"28005",134211,104575,103819,667,756,"PACMA",872
28,"28107",435,326,321,0,5,"PACMA",2
28,"28144",5929,4776,4744,29,32,"PACMA",34
28,"28127",64513,53125,52932,300,193,"PACMA",369
28,"28064",134,105,105,0,0,"PACMA",0
28,"28135",971,740,735,4,5,"PACMA",4
28,"28177",10192,8271,8234,51,37,"PACMA",63
28,"28067",4057,3220,3188,12,32,"PACMA",16
28,"28018",3739,3071,3046,12,25,"PACMA",24
28,"28117",95,84,84,0,0,"PACMA",0
28,"28047",40783,31308,31072,171,236,"PACMA",321
28,"28034",352,270,269,1,1,"PACMA",3
28,"28019",1237,952,938,2,14,"PACMA",8
28,"28170",2486,1757,1740,9,17,"PACMA",7
28,"28068",10928,8389,8315,43,74,"PACMA",61
28,"28173",520,409,408,3,1,"PACMA",5
28,"28015",18233,14725,14653,81,72,"PACMA",122
28,"28017",1210,954,943,6,11,"PACMA",10
28,"28033",3824,2854,2832,11,22,"PACMA",32
28,"28165",1788,1332,1321,5,11,"PACMA",5
28,"28125",2965,2210,2188,13,22,"PACMA",17
28,"28036",2514,1974,1949,12,25,"PACMA",20
28,"28082",5664,4526,4492,25,34,"PACMA",39
28,"28143",70,59,59,1,0,"PACMA",0
28,"28023",4697,3835,3817,20,18,"PACMA",36
28,"28073",12505,9485,9384,64,101,"PACMA",109
28,"28046",4432,3562,3538,19,24,"PACMA",28
28,"28176",12288,9809,9763,50,46,"PACMA",76
28,"28043",5922,4063,4008,29,55,"PACMA",26
28,"28028",1730,1347,1326,8,21,"PACMA",8
28,"28116",700,544,544,3,0,"PACMA",8
28,"28093",2043,1681,1661,9,20,"PACMA",10
28,"28181",20344,16669,16572,95,97,"PACMA",126
28,"28140",2981,2383,2357,14,26,"PACMA",30
28,"28163",438,357,354,1,3,"PACMA",2
28,"28061",21200,16698,16600,75,98,"PACMA",152
28,"28162",2549,2039,2025,13,14,"PACMA",19
28,"28171",4238,3002,2962,18,40,"PACMA",26
28,"28011",445,339,338,0,1,"PACMA",4
28,"28159",588,469,468,6,1,"PACMA",5
28,"28075",5581,4380,4350,15,30,"PACMA",57
28,"28016",80,57,57,0,0,"PACMA",0
28,"28052",3883,2801,2758,18,43,"PACMA",21
28,"28124",76,56,54,0,2,"PACMA",0
28,"28086",5055,3627,3600,21,27,"PACMA",33
28,"28092",151511,117869,116968,641,901,"PACMA",1139
28,"28110",1949,1543,1525,2,18,"PACMA",8
28,"28066",7175,5598,5561,28,37,"PACMA",46
28,"28050",4077,3032,3006,15,26,"PACMA",42
28,"28104",13836,11414,11349,54,65,"PACMA",77
28,"28145",2370,1824,1809,12,15,"PACMA",14
28,"28138",69,54,54,0,0,"PACMA",1
28,"28128",439,323,320,2,3,"PACMA",4
28,"28133",6002,4259,4204,12,55,"PACMA",35
28,"28030",1716,1342,1316,2,26,"PACMA",8
28,"28058",139289,108214,107323,612,891,"PACMA",1383
28,"28071",60,47,46,0,1,"PACMA",0
28,"28088",262,180,179,2,1,"PACMA",0
28,"28010",9853,7959,7914,35,45,"PACMA",60
28,"28063",252,195,194,2,1,"PACMA",4
28,"28113",34305,27077,26881,156,196,"PACMA",322
28,"28014",32852,24749,24571,120,178,"PACMA",223
28,"28048",499,406,401,2,5,"PACMA",4
28,"28126",39,25,25,0,0,"PACMA",0
28,"28090",8405,6792,6751,34,41,"PACMA",54
28,"28038",4935,3858,3815,17,43,"PACMA",35
28,"28106",76612,56555,56006,346,549,"PACMA",787
28,"28121",198,166,164,2,2,"PACMA",1
28,"28151",3143,2352,2314,6,38,"PACMA",13
28,"28132",11645,8605,8520,55,85,"PACMA",122
28,"28160",8227,6295,6251,26,44,"PACMA",62
28,"28141",5806,4532,4486,24,46,"PACMA",51
28,"28100",4169,3076,3048,12,28,"PACMA",41
28,"28006",78564,61796,61456,334,340,"PACMA",450
28,"28137",1644,1301,1283,7,18,"PACMA",14
28,"28099",1731,1283,1278,8,5,"PACMA",12
28,"28114",149,103,103,1,0,"PACMA",0
28,"28158",662,545,543,3,2,"PACMA",5
28,"28091",5436,3827,3786,23,41,"PACMA",20
28,"28025",427,329,326,1,3,"PACMA",5
28,"28167",8308,6605,6545,35,60,"PACMA",98
28,"28120",1217,918,904,4,14,"PACMA",3
28,"28032",4749,3653,3607,19,46,"PACMA",27
28,"28085",3908,3106,3078,7,28,"PACMA",28
28,"28156",998,751,743,3,8,"PACMA",6
28,"28087",3176,2545,2528,15,17,"PACMA",16
28,"28174",1788,1277,1267,2,10,"PACMA",3
28,"28055",899,682,676,4,6,"PACMA",2
28,"28180",5242,4040,3999,11,41,"PACMA",29
28,"28148",85022,65597,65111,368,486,"PACMA",758
28,"28069",54,43,43,1,0,"PACMA",0
28,"28004",6179,4377,4345,15,32,"PACMA",40
28,"28009",14046,11014,10932,51,82,"PACMA",104
28,"28042",1153,882,874,5,8,"PACMA",12
28,"28166",318,258,255,1,3,"PACMA",0
28,"28021",544,387,387,2,0,"PACMA",7
28,"28065",125384,101604,100872,477,732,"PACMA",785
43,"43060",2887,2019,1990,16,29,"C's",93
43,"43125",942,692,685,4,7,"C's",38
43,"43005",3615,2376,2354,17,22,"C's",307
43,"43095",2493,1723,1703,13,20,"C's",267
43,"43044",3975,2793,2758,34,35,"C's",350
43,"43111",2049,1383,1366,9,17,"C's",200
43,"43047",4128,2688,2652,19,36,"C's",425
43,"43158",89,55,53,3,2,"C's",3
43,"43002",1821,1294,1266,12,28,"C's",199
43,"43063",560,363,360,8,3,"C's",13
43,"43096",101,81,81,0,0,"C's",0
43,"43114",388,264,262,1,2,"C's",5
43,"43067",555,434,430,1,4,"C's",9
43,"43050",2521,1654,1640,11,14,"C's",238
43,"43004",6326,4274,4227,38,47,"C's",317
43,"43100",3268,2360,2352,16,8,"C's",448
43,"43012",3580,2669,2658,22,11,"C's",363
43,"43076",447,318,317,0,1,"C's",14
43,"43077",463,307,305,7,2,"C's",22
43,"43070",236,194,193,0,1,"C's",8
43,"43056",871,532,521,6,11,"C's",16
43,"43018",410,320,316,1,4,"C's",12
43,"43058",93,68,67,1,1,"C's",1
43,"43907",4382,3174,3147,14,27,"C's",594
43,"43173",101,63,60,0,3,"C's",0
43,"43003",322,234,233,3,1,"C's",27
43,"43159",80,57,57,0,0,"C's",1
43,"43015",112,91,91,1,0,"C's",2
43,"43162",4313,3132,3101,26,31,"C's",542
43,"43104",1798,1285,1268,14,17,"C's",45
43,"43036",843,545,542,0,3,"C's",66
43,"43902",2760,1775,1739,22,36,"C's",102
43,"43150",1300,940,913,5,27,"C's",42
43,"43037",16725,10917,10822,61,95,"C's",1814
43,"43149",699,483,472,7,11,"C's",23
43,"43073",85,60,59,0,1,"C's",2
43,"43035",262,167,164,0,3,"C's",9
43,"43160",1273,888,879,7,9,"C's",116
43,"43140",2366,1731,1717,7,14,"C's",309
43,"43024",1522,1044,1034,3,10,"C's",155
43,"43034",480,366,358,4,8,"C's",20
43,"43119",793,559,556,7,3,"C's",65
43,"43144",1258,914,911,3,3,"C's",123
43,"43161",17217,11541,11478,67,63,"C's",1145
43,"43147",521,379,377,1,2,"C's",7
43,"43124",484,347,343,6,4,"C's",32
43,"43138",2677,1821,1786,22,35,"C's",248
43,"43049",746,546,543,1,3,"C's",21
43,"43128",908,623,616,4,7,"C's",38
43,"43053",191,149,147,1,2,"C's",7
43,"43108",1775,1238,1229,8,9,"C's",115
43,"43033",778,576,569,5,7,"C's",45
43,"43133",5697,3726,3685,26,41,"C's",379
43,"43088",1966,1382,1372,6,10,"C's",161
43,"43009",1431,968,958,5,10,"C's",82
43,"43115",155,116,116,2,0,"C's",1
43,"43080",244,184,184,2,0,"C's",10
43,"43901",8765,5306,5212,81,94,"C's",253
43,"43029",323,237,237,4,0,"C's",6
43,"43109",2560,1717,1700,13,17,"C's",330
43,"43057",40,25,25,1,0,"C's",0
43,"43139",2053,1332,1321,16,11,"C's",54
43,"43105",162,115,115,3,0,"C's",0
43,"43091",136,94,94,2,0,"C's",3
43,"43145",4084,2991,2954,36,37,"C's",275
43,"43152",450,338,330,2,8,"C's",6
43,"43101",148,107,107,4,0,"C's",0
43,"43082",372,291,285,0,6,"C's",5
43,"43020",2202,1631,1614,13,17,"C's",290
43,"43027",165,133,133,2,0,"C's",0
43,"43163",25252,17001,16847,74,154,"C's",2863
43,"43007",637,481,479,3,2,"C's",38
43,"43120",444,293,288,0,5,"C's",23
43,"43106",810,544,532,7,12,"C's",19
43,"43157",352,273,271,3,2,"C's",3
43,"43048",807,569,564,8,5,"C's",22
43,"43117",144,110,109,1,1,"C's",6
43,"43090",1070,625,620,4,5,"C's",113
43,"43155",22874,15046,14893,137,153,"C's",1474
43,"43052",954,662,653,9,9,"C's",54
43,"43169",457,364,356,3,8,"C's",11
43,"43107",377,265,260,4,5,"C's",14
43,"43134",283,226,224,2,2,"C's",26
43,"43032",523,371,365,7,6,"C's",15
43,"43028",2717,1727,1715,7,12,"C's",223
43,"43083",140,95,94,0,1,"C's",14
43,"43121",604,393,387,4,6,"C's",6
43,"43086",5237,3507,3476,27,31,"C's",241
43,"43151",109,82,82,1,0,"C's",1
43,"43141",111,71,68,0,3,"C's",7
43,"43165",578,431,428,2,3,"C's",20
43,"43137",1881,1344,1332,9,12,"C's",196
43,"43043",3128,2201,2186,11,15,"C's",356
43,"43014",14293,9441,9319,118,122,"C's",802
43,"43039",102,73,73,0,0,"C's",5
43,"43148",90177,64180,63784,349,396,"C's",11680
43,"43054",2836,1873,1852,21,21,"C's",96
43,"43092",7059,4603,4563,21,40,"C's",853
43,"43153",10676,7241,7190,29,51,"C's",1103
43,"43112",284,178,178,0,0,"C's",4
43,"43903",2383,1420,1407,20,13,"C's",99
43,"43110",272,169,167,1,2,"C's",13
43,"43132",365,269,264,1,5,"C's",21
43,"43166",1568,1117,1111,4,6,"C's",136
43,"43904",2908,1799,1760,38,39,"C's",135
43,"43075",89,62,62,1,0,"C's",3
43,"43906",2117,1454,1441,3,13,"C's",139
43,"43089",281,211,211,1,0,"C's",24
43,"43176",799,565,562,5,3,"C's",29
43,"43167",383,287,286,2,1,"C's",11
43,"43008",309,185,181,5,4,"C's",17
43,"43178",1335,939,933,9,6,"C's",134
43,"43071",924,650,639,5,11,"C's",33
43,"43081",597,425,418,4,7,"C's",33
43,"43001",695,474,472,4,2,"C's",37
43,"43085",226,178,178,2,0,"C's",3
43,"43123",70276,47897,47547,302,350,"C's",8071
43,"43177",298,236,232,5,4,"C's",14
43,"43026",797,579,574,2,5,"C's",17
43,"43066",155,109,107,1,2,"C's",8
43,"43127",765,554,548,2,6,"C's",49
43,"43042",2148,1585,1573,7,12,"C's",242
43,"43019",1371,904,886,4,18,"C's",80
43,"43061",48,31,29,0,2,"C's",0
43,"43093",3909,2625,2597,44,28,"C's",234
43,"43130",196,128,127,2,1,"C's",4
43,"43079",364,258,257,1,1,"C's",6
43,"43122",106,84,84,0,0,"C's",7
43,"43055",1975,1471,1459,16,12,"C's",57
43,"43156",3982,2748,2704,26,44,"C's",253
43,"43168",93,64,64,2,0,"C's",6
43,"43068",528,346,338,2,8,"C's",26
43,"43045",152,121,121,0,0,"C's",1
43,"43098",343,249,249,4,0,"C's",14
43,"43175",566,390,387,3,3,"C's",37
43,"43010",316,253,251,2,2,"C's",15
43,"43062",274,223,219,7,4,"C's",23
43,"43084",526,404,399,5,5,"C's",6
43,"43171",14593,10107,10049,46,58,"C's",2455
43,"43154",132,101,100,1,1,"C's",4
43,"43069",184,144,143,1,1,"C's",9
43,"43041",226,160,156,0,4,"C's",17
43,"43170",857,603,599,8,4,"C's",24
43,"43135",342,252,251,3,1,"C's",11
43,"43021",360,248,247,6,1,"C's",29
43,"43094",2175,1506,1480,11,26,"C's",88
43,"43031",1466,1062,1056,8,6,"C's",87
43,"43102",485,337,332,2,5,"C's",12
43,"43142",1114,781,771,4,10,"C's",54
43,"43118",413,313,308,1,5,"C's",16
43,"43023",231,173,171,3,2,"C's",8
43,"43040",338,255,247,2,8,"C's",4
43,"43113",408,306,305,2,1,"C's",14
43,"43143",56,47,47,1,0,"C's",0
43,"43164",300,218,217,0,1,"C's",28
43,"43025",604,431,428,5,3,"C's",28
43,"43011",1083,824,819,5,5,"C's",86
43,"43046",100,77,72,2,5,"C's",1
43,"43064",2017,1384,1367,16,17,"C's",116
43,"43078",856,640,632,11,8,"C's",69
43,"43097",390,301,300,0,1,"C's",29
43,"43174",138,99,99,1,0,"C's",3
43,"43059",253,195,195,2,0,"C's",10
43,"43022",1508,1028,1015,20,13,"C's",71
43,"43013",4425,2975,2938,21,37,"C's",303
43,"43131",4623,3059,3031,16,28,"C's",622
43,"43136",10353,6670,6622,50,48,"C's",437
43,"43072",105,77,77,1,0,"C's",6
43,"43146",38,30,30,1,0,"C's",0
43,"43905",14371,9191,9136,41,55,"C's",2033
43,"43116",455,326,321,1,5,"C's",5
43,"43065",395,266,265,4,1,"C's",8
43,"43016",3418,2534,2512,15,22,"C's",322
43,"43129",4618,3148,3107,24,41,"C's",367
43,"43017",126,100,97,1,3,"C's",3
43,"43038",21385,14375,14276,117,99,"C's",2830
43,"43126",1177,848,844,8,4,"C's",106
43,"43030",430,311,308,1,3,"C's",25
43,"43099",305,234,233,1,1,"C's",7
43,"43006",683,463,458,10,5,"C's",24
43,"43172",351,243,242,8,1,"C's",19
43,"43103",892,644,640,6,4,"C's",142
43,"43051",8545,5813,5735,26,78,"C's",1085
43,"43074",1749,1284,1275,7,9,"C's",118
30,"30008",13860,10066,9945,74,121,"PSOE",2077
30,"30002",9921,7263,7166,34,97,"PSOE",1670
30,"30030",312625,235232,233576,1438,1656,"PSOE",36946
30,"30001",4596,3602,3572,20,30,"PSOE",1061
30,"30003",24305,16558,16419,122,139,"PSOE",5018
30,"30021",9101,6106,6034,25,72,"PSOE",1432
30,"30029",11815,8365,8296,67,69,"PSOE",2604
30,"30011",4706,3582,3541,20,41,"PSOE",876
30,"30036",14624,10139,9988,70,151,"PSOE",1665
30,"30019",25921,18079,17894,121,185,"PSOE",3754
30,"30010",6861,5287,5220,38,67,"PSOE",1281
30,"30005",29559,21408,21203,123,205,"PSOE",3810
30,"30033",10144,7591,7505,86,86,"PSOE",1784
30,"30007",6415,4554,4515,19,39,"PSOE",1085
30,"30035",18616,13185,13085,70,100,"PSOE",1944
30,"30015",19154,13947,13835,77,112,"PSOE",3819
30,"30032",2849,2188,2161,10,27,"PSOE",667
30,"30025",4900,3777,3727,20,50,"PSOE",1219
30,"30020",6261,4502,4459,25,43,"PSOE",1114
30,"30038",15381,10881,10797,51,84,"PSOE",2202
30,"30004",1141,938,933,5,5,"PSOE",349
30,"30043",24972,19411,19139,154,272,"PSOE",3474
30,"30901",10331,7925,7833,54,92,"PSOE",1789
30,"30028",6690,5005,4938,29,67,"PSOE",1780
30,"30041",13640,9156,9092,52,64,"PSOE",2457
30,"30042",1918,1518,1500,6,18,"PSOE",376
30,"30024",58529,42392,42072,275,320,"PSOE",10850
30,"30006",803,683,681,2,2,"PSOE",186
30,"30018",7903,5990,5912,29,78,"PSOE",1689
30,"30027",47867,36054,35794,181,260,"PSOE",6098
30,"30040",727,627,620,1,7,"PSOE",180
30,"30009",12392,9724,9599,40,125,"PSOE",2419
30,"30016",151577,103359,102538,620,821,"PSOE",19007
30,"30902",8022,5454,5412,34,42,"PSOE",1178
30,"30013",7395,5320,5277,38,43,"PSOE",2190
30,"30034",1138,859,846,5,13,"PSOE",287
30,"30026",15722,10147,10024,49,123,"PSOE",2392
30,"30037",18726,13183,13027,73,156,"PSOE",2461
30,"30014",1598,1270,1258,5,12,"PSOE",540
30,"30022",16894,11661,11498,119,163,"PSOE",3278
30,"30039",19199,13538,13405,101,133,"PSOE",2817
30,"30023",3762,2871,2837,14,34,"PSOE",660
30,"30031",498,424,421,2,3,"PSOE",73
30,"30017",11635,8718,8646,46,72,"PSOE",2474
30,"30012",9101,7170,7091,46,79,"PSOE",2492
43,"43036",843,545,542,0,3,"PSC",69
43,"43091",136,94,94,2,0,"PSC",2
43,"43150",1300,940,913,5,27,"PSC",95
43,"43117",144,110,109,1,1,"PSC",11
43,"43066",155,109,107,1,2,"PSC",10
43,"43126",1177,848,844,8,4,"PSC",76
43,"43022",1508,1028,1015,20,13,"PSC",177
43,"43023",231,173,171,3,2,"PSC",37
43,"43068",528,346,338,2,8,"PSC",108
43,"43098",343,249,249,4,0,"PSC",7
43,"43132",365,269,264,1,5,"PSC",17
43,"43128",908,623,616,4,7,"PSC",117
43,"43140",2366,1731,1717,7,14,"PSC",387
43,"43069",184,144,143,1,1,"PSC",16
43,"43156",3982,2748,2704,26,44,"PSC",441
43,"43172",351,243,242,8,1,"PSC",19
43,"43130",196,128,127,2,1,"PSC",12
43,"43106",810,544,532,7,12,"PSC",85
43,"43065",395,266,265,4,1,"PSC",37
43,"43095",2493,1723,1703,13,20,"PSC",210
43,"43074",1749,1284,1275,7,9,"PSC",125
43,"43153",10676,7241,7190,29,51,"PSC",1137
43,"43047",4128,2688,2652,19,36,"PSC",674
43,"43152",450,338,330,2,8,"PSC",53
43,"43006",683,463,458,10,5,"PSC",92
43,"43115",155,116,116,2,0,"PSC",12
43,"43167",383,287,286,2,1,"PSC",16
43,"43011",1083,824,819,5,5,"PSC",53
43,"43058",93,68,67,1,1,"PSC",3
43,"43903",2383,1420,1407,20,13,"PSC",243
43,"43163",25252,17001,16847,74,154,"PSC",2955
43,"43086",5237,3507,3476,27,31,"PSC",455
43,"43014",14293,9441,9319,118,122,"PSC",1561
43,"43001",695,474,472,4,2,"PSC",57
43,"43151",109,82,82,1,0,"PSC",3
43,"43028",2717,1727,1715,7,12,"PSC",297
43,"43101",148,107,107,4,0,"PSC",4
43,"43029",323,237,237,4,0,"PSC",7
43,"43168",93,64,64,2,0,"PSC",6
43,"43049",746,546,543,1,3,"PSC",49
43,"43118",413,313,308,1,5,"PSC",34
43,"43063",560,363,360,8,3,"PSC",37
43,"43113",408,306,305,2,1,"PSC",31
43,"43102",485,337,332,2,5,"PSC",92
43,"43142",1114,781,771,4,10,"PSC",63
43,"43032",523,371,365,7,6,"PSC",75
43,"43050",2521,1654,1640,11,14,"PSC",302
43,"43060",2887,2019,1990,16,29,"PSC",330
43,"43005",3615,2376,2354,17,22,"PSC",333
43,"43016",3418,2534,2512,15,22,"PSC",564
43,"43043",3128,2201,2186,11,15,"PSC",312
43,"43146",38,30,30,1,0,"PSC",0
43,"43099",305,234,233,1,1,"PSC",20
43,"43105",162,115,115,3,0,"PSC",9
43,"43034",480,366,358,4,8,"PSC",47
43,"43033",778,576,569,5,7,"PSC",63
43,"43081",597,425,418,4,7,"PSC",37
43,"43129",4618,3148,3107,24,41,"PSC",329
43,"43009",1431,968,958,5,10,"PSC",120
43,"43071",924,650,639,5,11,"PSC",45
43,"43103",892,644,640,6,4,"PSC",88
43,"43901",8765,5306,5212,81,94,"PSC",1096
43,"43110",272,169,167,1,2,"PSC",23
43,"43147",521,379,377,1,2,"PSC",18
43,"43160",1273,888,879,7,9,"PSC",142
43,"43170",857,603,599,8,4,"PSC",62
43,"43100",3268,2360,2352,16,8,"PSC",316
43,"43035",262,167,164,0,3,"PSC",10
43,"43031",1466,1062,1056,8,6,"PSC",110
43,"43079",364,258,257,1,1,"PSC",27
43,"43107",377,265,260,4,5,"PSC",21
43,"43173",101,63,60,0,3,"PSC",3
43,"43178",1335,939,933,9,6,"PSC",95
43,"43093",3909,2625,2597,44,28,"PSC",419
43,"43121",604,393,387,4,6,"PSC",39
43,"43042",2148,1585,1573,7,12,"PSC",129
43,"43012",3580,2669,2658,22,11,"PSC",296
43,"43073",85,60,59,0,1,"PSC",2
43,"43108",1775,1238,1229,8,9,"PSC",116
43,"43104",1798,1285,1268,14,17,"PSC",201
43,"43046",100,77,72,2,5,"PSC",2
43,"43111",2049,1383,1366,9,17,"PSC",191
43,"43056",871,532,521,6,11,"PSC",44
43,"43084",526,404,399,5,5,"PSC",54
43,"43144",1258,914,911,3,3,"PSC",77
43,"43155",22874,15046,14893,137,153,"PSC",2303
43,"43013",4425,2975,2938,21,37,"PSC",312
43,"43165",578,431,428,2,3,"PSC",30
43,"43904",2908,1799,1760,38,39,"PSC",277
43,"43125",942,692,685,4,7,"PSC",140
43,"43037",16725,10917,10822,61,95,"PSC",1929
43,"43010",316,253,251,2,2,"PSC",30
43,"43092",7059,4603,4563,21,40,"PSC",728
43,"43007",637,481,479,3,2,"PSC",27
43,"43149",699,483,472,7,11,"PSC",144
43,"43136",10353,6670,6622,50,48,"PSC",1029
43,"43004",6326,4274,4227,38,47,"PSC",585
43,"43070",236,194,193,0,1,"PSC",22
43,"43027",165,133,133,2,0,"PSC",3
43,"43141",111,71,68,0,3,"PSC",4
43,"43085",226,178,178,2,0,"PSC",32
43,"43008",309,185,181,5,4,"PSC",58
43,"43061",48,31,29,0,2,"PSC",0
43,"43048",807,569,564,8,5,"PSC",62
43,"43137",1881,1344,1332,9,12,"PSC",202
43,"43072",105,77,77,1,0,"PSC",4
43,"43133",5697,3726,3685,26,41,"PSC",614
43,"43096",101,81,81,0,0,"PSC",6
43,"43120",444,293,288,0,5,"PSC",45
43,"43164",300,218,217,0,1,"PSC",48
43,"43041",226,160,156,0,4,"PSC",18
43,"43015",112,91,91,1,0,"PSC",3
43,"43080",244,184,184,2,0,"PSC",9
43,"43059",253,195,195,2,0,"PSC",11
43,"43159",80,57,57,0,0,"PSC",3
43,"43161",17217,11541,11478,67,63,"PSC",1607
43,"43148",90177,64180,63784,349,396,"PSC",10691
43,"43019",1371,904,886,4,18,"PSC",145
43,"43090",1070,625,620,4,5,"PSC",150
43,"43026",797,579,574,2,5,"PSC",63
43,"43175",566,390,387,3,3,"PSC",22
43,"43114",388,264,262,1,2,"PSC",22
43,"43039",102,73,73,0,0,"PSC",3
43,"43094",2175,1506,1480,11,26,"PSC",238
43,"43907",4382,3174,3147,14,27,"PSC",894
43,"43097",390,301,300,0,1,"PSC",26
43,"43062",274,223,219,7,4,"PSC",33
43,"43177",298,236,232,5,4,"PSC",21
43,"43067",555,434,430,1,4,"PSC",65
43,"43139",2053,1332,1321,16,11,"PSC",99
43,"43053",191,149,147,1,2,"PSC",21
43,"43122",106,84,84,0,0,"PSC",5
43,"43077",463,307,305,7,2,"PSC",129
43,"43057",40,25,25,1,0,"PSC",2
43,"43166",1568,1117,1111,4,6,"PSC",152
43,"43109",2560,1717,1700,13,17,"PSC",255
43,"43902",2760,1775,1739,22,36,"PSC",527
43,"43116",455,326,321,1,5,"PSC",39
43,"43088",1966,1382,1372,6,10,"PSC",77
43,"43038",21385,14375,14276,117,99,"PSC",1916
43,"43124",484,347,343,6,4,"PSC",39
43,"43143",56,47,47,1,0,"PSC",6
43,"43017",126,100,97,1,3,"PSC",6
43,"43174",138,99,99,1,0,"PSC",3
43,"43002",1821,1294,1266,12,28,"PSC",282
43,"43127",765,554,548,2,6,"PSC",22
43,"43157",352,273,271,3,2,"PSC",19
43,"43089",281,211,211,1,0,"PSC",21
43,"43075",89,62,62,1,0,"PSC",4
43,"43171",14593,10107,10049,46,58,"PSC",1945
43,"43082",372,291,285,0,6,"PSC",38
43,"43051",8545,5813,5735,26,78,"PSC",1121
43,"43083",140,95,94,0,1,"PSC",4
43,"43055",1975,1471,1459,16,12,"PSC",184
43,"43003",322,234,233,3,1,"PSC",33
43,"43162",4313,3132,3101,26,31,"PSC",506
43,"43145",4084,2991,2954,36,37,"PSC",506
43,"43078",856,640,632,11,8,"PSC",95
43,"43176",799,565,562,5,3,"PSC",31
43,"43112",284,178,178,0,0,"PSC",7
43,"43138",2677,1821,1786,22,35,"PSC",247
43,"43076",447,318,317,0,1,"PSC",28
43,"43131",4623,3059,3031,16,28,"PSC",561
43,"43135",342,252,251,3,1,"PSC",14
43,"43052",954,662,653,9,9,"PSC",84
43,"43030",430,311,308,1,3,"PSC",28
43,"43134",283,226,224,2,2,"PSC",28
43,"43018",410,320,316,1,4,"PSC",8
43,"43025",604,431,428,5,3,"PSC",117
43,"43906",2117,1454,1441,3,13,"PSC",122
43,"43064",2017,1384,1367,16,17,"PSC",136
43,"43158",89,55,53,3,2,"PSC",0
43,"43024",1522,1044,1034,3,10,"PSC",197
43,"43040",338,255,247,2,8,"PSC",18
43,"43123",70276,47897,47547,302,350,"PSC",7712
43,"43054",2836,1873,1852,21,21,"PSC",207
43,"43154",132,101,100,1,1,"PSC",5
43,"43020",2202,1631,1614,13,17,"PSC",304
43,"43119",793,559,556,7,3,"PSC",77
43,"43045",152,121,121,0,0,"PSC",7
43,"43169",457,364,356,3,8,"PSC",24
43,"43021",360,248,247,6,1,"PSC",20
43,"43044",3975,2793,2758,34,35,"PSC",511
43,"43905",14371,9191,9136,41,55,"PSC",1421
30,"30027",47867,36054,35794,181,260,"C´s",7695
30,"30031",498,424,421,2,3,"C´s",69
30,"30015",19154,13947,13835,77,112,"C´s",2192
30,"30029",11815,8365,8296,67,69,"C´s",1020
30,"30014",1598,1270,1258,5,12,"C´s",91
30,"30011",4706,3582,3541,20,41,"C´s",405
30,"30010",6861,5287,5220,38,67,"C´s",716
30,"30017",11635,8718,8646,46,72,"C´s",1258
30,"30902",8022,5454,5412,34,42,"C´s",899
30,"30040",727,627,620,1,7,"C´s",46
30,"30036",14624,10139,9988,70,151,"C´s",1852
30,"30012",9101,7170,7091,46,79,"C´s",820
30,"30001",4596,3602,3572,20,30,"C´s",368
30,"30019",25921,18079,17894,121,185,"C´s",2399
30,"30024",58529,42392,42072,275,320,"C´s",6496
30,"30006",803,683,681,2,2,"C´s",34
30,"30039",19199,13538,13405,101,133,"C´s",1999
30,"30033",10144,7591,7505,86,86,"C´s",1037
30,"30004",1141,938,933,5,5,"C´s",49
30,"30005",29559,21408,21203,123,205,"C´s",4312
30,"30028",6690,5005,4938,29,67,"C´s",472
30,"30901",10331,7925,7833,54,92,"C´s",1197
30,"30030",312625,235232,233576,1438,1656,"C´s",47007
30,"30009",12392,9724,9599,40,125,"C´s",1186
30,"30038",15381,10881,10797,51,84,"C´s",1958
30,"30002",9921,7263,7166,34,97,"C´s",870
30,"30003",24305,16558,16419,122,139,"C´s",1984
30,"30021",9101,6106,6034,25,72,"C´s",940
30,"30018",7903,5990,5912,29,78,"C´s",928
30,"30020",6261,4502,4459,25,43,"C´s",453
30,"30008",13860,10066,9945,74,121,"C´s",1571
30,"30023",3762,2871,2837,14,34,"C´s",414
30,"30013",7395,5320,5277,38,43,"C´s",667
30,"30022",16894,11661,11498,119,163,"C´s",1460
30,"30043",24972,19411,19139,154,272,"C´s",3479
30,"30016",151577,103359,102538,620,821,"C´s",19825
30,"30037",18726,13183,13027,73,156,"C´s",2491
30,"30034",1138,859,846,5,13,"C´s",63
30,"30032",2849,2188,2161,10,27,"C´s",233
30,"30041",13640,9156,9092,52,64,"C´s",1469
30,"30042",1918,1518,1500,6,18,"C´s",210
30,"30007",6415,4554,4515,19,39,"C´s",684
30,"30035",18616,13185,13085,70,100,"C´s",2835
30,"30025",4900,3777,3727,20,50,"C´s",555
30,"30026",15722,10147,10024,49,123,"C´s",1586
43,"43160",1273,888,879,7,9,"PP",100
43,"43073",85,60,59,0,1,"PP",0
43,"43115",155,116,116,2,0,"PP",4
43,"43053",191,149,147,1,2,"PP",9
43,"43134",283,226,224,2,2,"PP",15
43,"43120",444,293,288,0,5,"PP",46
43,"43014",14293,9441,9319,118,122,"PP",863
43,"43172",351,243,242,8,1,"PP",16
43,"43058",93,68,67,1,1,"PP",2
43,"43162",4313,3132,3101,26,31,"PP",369
43,"43009",1431,968,958,5,10,"PP",52
43,"43098",343,249,249,4,0,"PP",26
43,"43067",555,434,430,1,4,"PP",19
43,"43148",90177,64180,63784,349,396,"PP",9616
43,"43144",1258,914,911,3,3,"PP",79
43,"43147",521,379,377,1,2,"PP",29
43,"43045",152,121,121,0,0,"PP",4
43,"43012",3580,2669,2658,22,11,"PP",268
43,"43158",89,55,53,3,2,"PP",2
43,"43011",1083,824,819,5,5,"PP",66
43,"43121",604,393,387,4,6,"PP",10
43,"43175",566,390,387,3,3,"PP",63
43,"43125",942,692,685,4,7,"PP",77
43,"43003",322,234,233,3,1,"PP",27
43,"43046",100,77,72,2,5,"PP",2
43,"43041",226,160,156,0,4,"PP",43
43,"43166",1568,1117,1111,4,6,"PP",124
43,"43044",3975,2793,2758,34,35,"PP",506
43,"43065",395,266,265,4,1,"PP",19
43,"43036",843,545,542,0,3,"PP",48
43,"43107",377,265,260,4,5,"PP",9
43,"43138",2677,1821,1786,22,35,"PP",268
43,"43040",338,255,247,2,8,"PP",18
43,"43165",578,431,428,2,3,"PP",20
43,"43901",8765,5306,5212,81,94,"PP",548
43,"43153",10676,7241,7190,29,51,"PP",856
43,"43004",6326,4274,4227,38,47,"PP",542
43,"43068",528,346,338,2,8,"PP",73
43,"43122",106,84,84,0,0,"PP",2
43,"43096",101,81,81,0,0,"PP",3
43,"43133",5697,3726,3685,26,41,"PP",421
43,"43063",560,363,360,8,3,"PP",72
43,"43005",3615,2376,2354,17,22,"PP",230
43,"43094",2175,1506,1480,11,26,"PP",113
43,"43104",1798,1285,1268,14,17,"PP",59
43,"43006",683,463,458,10,5,"PP",63
43,"43077",463,307,305,7,2,"PP",57
43,"43062",274,223,219,7,4,"PP",26
43,"43066",155,109,107,1,2,"PP",10
43,"43090",1070,625,620,4,5,"PP",97
43,"43008",309,185,181,5,4,"PP",32
43,"43130",196,128,127,2,1,"PP",12
43,"43083",140,95,94,0,1,"PP",15
43,"43015",112,91,91,1,0,"PP",0
43,"43161",17217,11541,11478,67,63,"PP",1095
43,"43118",413,313,308,1,5,"PP",22
43,"43177",298,236,232,5,4,"PP",24
43,"43080",244,184,184,2,0,"PP",16
43,"43060",2887,2019,1990,16,29,"PP",147
43,"43168",93,64,64,2,0,"PP",0
43,"43142",1114,781,771,4,10,"PP",53
43,"43043",3128,2201,2186,11,15,"PP",200
43,"43076",447,318,317,0,1,"PP",5
43,"43061",48,31,29,0,2,"PP",2
43,"43141",111,71,68,0,3,"PP",5
43,"43149",699,483,472,7,11,"PP",56
43,"43010",316,253,251,2,2,"PP",25
43,"43050",2521,1654,1640,11,14,"PP",233
43,"43034",480,366,358,4,8,"PP",42
43,"43178",1335,939,933,9,6,"PP",97
43,"43124",484,347,343,6,4,"PP",36
43,"43032",523,371,365,7,6,"PP",26
43,"43108",1775,1238,1229,8,9,"PP",102
43,"43151",109,82,82,1,0,"PP",7
43,"43902",2760,1775,1739,22,36,"PP",206
43,"43113",408,306,305,2,1,"PP",33
43,"43127",765,554,548,2,6,"PP",36
43,"43001",695,474,472,4,2,"PP",42
43,"43157",352,273,271,3,2,"PP",19
43,"43007",637,481,479,3,2,"PP",36
43,"43021",360,248,247,6,1,"PP",9
43,"43035",262,167,164,0,3,"PP",19
43,"43028",2717,1727,1715,7,12,"PP",177
43,"43070",236,194,193,0,1,"PP",14
43,"43155",22874,15046,14893,137,153,"PP",1629
43,"43114",388,264,262,1,2,"PP",7
43,"43128",908,623,616,4,7,"PP",34
43,"43055",1975,1471,1459,16,12,"PP",75
43,"43097",390,301,300,0,1,"PP",16
43,"43123",70276,47897,47547,302,350,"PP",6241
43,"43137",1881,1344,1332,9,12,"PP",120
43,"43145",4084,2991,2954,36,37,"PP",232
43,"43029",323,237,237,4,0,"PP",4
43,"43131",4623,3059,3031,16,28,"PP",463
43,"43907",4382,3174,3147,14,27,"PP",379
43,"43904",2908,1799,1760,38,39,"PP",221
43,"43079",364,258,257,1,1,"PP",11
43,"43117",144,110,109,1,1,"PP",17
43,"43002",1821,1294,1266,12,28,"PP",151
43,"43164",300,218,217,0,1,"PP",46
43,"43111",2049,1383,1366,9,17,"PP",199
43,"43159",80,57,57,0,0,"PP",2
43,"43075",89,62,62,1,0,"PP",2
43,"43037",16725,10917,10822,61,95,"PP",1514
43,"43110",272,169,167,1,2,"PP",11
43,"43119",793,559,556,7,3,"PP",59
43,"43105",162,115,115,3,0,"PP",7
43,"43095",2493,1723,1703,13,20,"PP",165
43,"43099",305,234,233,1,1,"PP",10
43,"43039",102,73,73,0,0,"PP",5
43,"43019",1371,904,886,4,18,"PP",93
43,"43085",226,178,178,2,0,"PP",13
43,"43088",1966,1382,1372,6,10,"PP",134
43,"43024",1522,1044,1034,3,10,"PP",139
43,"43071",924,650,639,5,11,"PP",123
43,"43026",797,579,574,2,5,"PP",51
43,"43054",2836,1873,1852,21,21,"PP",137
43,"43139",2053,1332,1321,16,11,"PP",89
43,"43170",857,603,599,8,4,"PP",33
43,"43163",25252,17001,16847,74,154,"PP",2117
43,"43078",856,640,632,11,8,"PP",72
43,"43103",892,644,640,6,4,"PP",56
43,"43100",3268,2360,2352,16,8,"PP",241
43,"43052",954,662,653,9,9,"PP",51
43,"43169",457,364,356,3,8,"PP",13
43,"43126",1177,848,844,8,4,"PP",80
43,"43072",105,77,77,1,0,"PP",13
43,"43038",21385,14375,14276,117,99,"PP",2080
43,"43129",4618,3148,3107,24,41,"PP",286
43,"43112",284,178,178,0,0,"PP",5
43,"43132",365,269,264,1,5,"PP",20
43,"43156",3982,2748,2704,26,44,"PP",454
43,"43173",101,63,60,0,3,"PP",3
43,"43069",184,144,143,1,1,"PP",18
43,"43101",148,107,107,4,0,"PP",6
43,"43056",871,532,521,6,11,"PP",63
43,"43086",5237,3507,3476,27,31,"PP",210
43,"43042",2148,1585,1573,7,12,"PP",155
43,"43171",14593,10107,10049,46,58,"PP",1280
43,"43016",3418,2534,2512,15,22,"PP",204
43,"43081",597,425,418,4,7,"PP",18
43,"43143",56,47,47,1,0,"PP",2
43,"43146",38,30,30,1,0,"PP",2
43,"43030",430,311,308,1,3,"PP",17
43,"43017",126,100,97,1,3,"PP",2
43,"43084",526,404,399,5,5,"PP",26
43,"43018",410,320,316,1,4,"PP",14
43,"43092",7059,4603,4563,21,40,"PP",710
43,"43176",799,565,562,5,3,"PP",31
43,"43048",807,569,564,8,5,"PP",123
43,"43154",132,101,100,1,1,"PP",4
43,"43135",342,252,251,3,1,"PP",17
43,"43106",810,544,532,7,12,"PP",64
43,"43150",1300,940,913,5,27,"PP",95
43,"43082",372,291,285,0,6,"PP",26
43,"43089",281,211,211,1,0,"PP",18
43,"43102",485,337,332,2,5,"PP",21
43,"43174",138,99,99,1,0,"PP",2
43,"43091",136,94,94,2,0,"PP",5
43,"43059",253,195,195,2,0,"PP",5
43,"43025",604,431,428,5,3,"PP",51
43,"43905",14371,9191,9136,41,55,"PP",1664
43,"43033",778,576,569,5,7,"PP",45
43,"43022",1508,1028,1015,20,13,"PP",199
43,"43047",4128,2688,2652,19,36,"PP",378
43,"43057",40,25,25,1,0,"PP",1
43,"43049",746,546,543,1,3,"PP",23
43,"43152",450,338,330,2,8,"PP",12
43,"43064",2017,1384,1367,16,17,"PP",154
43,"43074",1749,1284,1275,7,9,"PP",76
43,"43031",1466,1062,1056,8,6,"PP",59
43,"43020",2202,1631,1614,13,17,"PP",134
43,"43116",455,326,321,1,5,"PP",8
43,"43051",8545,5813,5735,26,78,"PP",878
43,"43013",4425,2975,2938,21,37,"PP",294
43,"43109",2560,1717,1700,13,17,"PP",192
43,"43167",383,287,286,2,1,"PP",26
43,"43027",165,133,133,2,0,"PP",9
43,"43093",3909,2625,2597,44,28,"PP",230
43,"43023",231,173,171,3,2,"PP",5
43,"43140",2366,1731,1717,7,14,"PP",208
43,"43136",10353,6670,6622,50,48,"PP",625
43,"43906",2117,1454,1441,3,13,"PP",162
43,"43903",2383,1420,1407,20,13,"PP",149
30,"30033",10144,7591,7505,86,86,"UPeC-IU",281
30,"30001",4596,3602,3572,20,30,"UPeC-IU",45
30,"30039",19199,13538,13405,101,133,"UPeC-IU",867
30,"30018",7903,5990,5912,29,78,"UPeC-IU",109
30,"30011",4706,3582,3541,20,41,"UPeC-IU",42
30,"30030",312625,235232,233576,1438,1656,"UPeC-IU",7014
30,"30004",1141,938,933,5,5,"UPeC-IU",38
30,"30005",29559,21408,21203,123,205,"UPeC-IU",624
30,"30031",498,424,421,2,3,"UPeC-IU",2
30,"30012",9101,7170,7091,46,79,"UPeC-IU",304
30,"30019",25921,18079,17894,121,185,"UPeC-IU",842
30,"30017",11635,8718,8646,46,72,"UPeC-IU",183
30,"30041",13640,9156,9092,52,64,"UPeC-IU",289
30,"30037",18726,13183,13027,73,156,"UPeC-IU",333
30,"30010",6861,5287,5220,38,67,"UPeC-IU",70
30,"30014",1598,1270,1258,5,12,"UPeC-IU",19
30,"30008",13860,10066,9945,74,121,"UPeC-IU",512
30,"30042",1918,1518,1500,6,18,"UPeC-IU",34
30,"30034",1138,859,846,5,13,"UPeC-IU",9
30,"30009",12392,9724,9599,40,125,"UPeC-IU",330
30,"30036",14624,10139,9988,70,151,"UPeC-IU",149
30,"30003",24305,16558,16419,122,139,"UPeC-IU",515
30,"30901",10331,7925,7833,54,92,"UPeC-IU",236
30,"30002",9921,7263,7166,34,97,"UPeC-IU",271
30,"30032",2849,2188,2161,10,27,"UPeC-IU",16
30,"30016",151577,103359,102538,620,821,"UPeC-IU",2796
30,"30038",15381,10881,10797,51,84,"UPeC-IU",280
30,"30006",803,683,681,2,2,"UPeC-IU",16
30,"30024",58529,42392,42072,275,320,"UPeC-IU",1388
30,"30043",24972,19411,19139,154,272,"UPeC-IU",1025
30,"30022",16894,11661,11498,119,163,"UPeC-IU",452
30,"30025",4900,3777,3727,20,50,"UPeC-IU",57
30,"30029",11815,8365,8296,67,69,"UPeC-IU",294
30,"30007",6415,4554,4515,19,39,"UPeC-IU",101
30,"30902",8022,5454,5412,34,42,"UPeC-IU",146
30,"30020",6261,4502,4459,25,43,"UPeC-IU",176
30,"30035",18616,13185,13085,70,100,"UPeC-IU",275
30,"30028",6690,5005,4938,29,67,"UPeC-IU",473
30,"30026",15722,10147,10024,49,123,"UPeC-IU",303
30,"30013",7395,5320,5277,38,43,"UPeC-IU",115
30,"30023",3762,2871,2837,14,34,"UPeC-IU",94
30,"30021",9101,6106,6034,25,72,"UPeC-IU",104
30,"30027",47867,36054,35794,181,260,"UPeC-IU",1118
30,"30040",727,627,620,1,7,"UPeC-IU",8
30,"30015",19154,13947,13835,77,112,"UPeC-IU",355
50,"50015",98,63,63,0,0,"PP-PAR",15
50,"50208",1802,1349,1332,16,17,"PP-PAR",396
50,"50269",288,185,183,0,2,"PP-PAR",104
50,"50126",2388,1726,1708,22,18,"PP-PAR",739
50,"50244",205,157,157,3,0,"PP-PAR",70
50,"50200",509,406,404,6,2,"PP-PAR",69
50,"50052",90,71,71,0,0,"PP-PAR",44
50,"50108",47,37,37,0,0,"PP-PAR",17
50,"50067",14055,10236,10109,123,127,"PP-PAR",3590
50,"50170",378,286,283,2,3,"PP-PAR",99
50,"50037",139,92,91,1,1,"PP-PAR",49
50,"50056",406,325,324,2,1,"PP-PAR",120
50,"50283",72,55,54,0,1,"PP-PAR",33
50,"50191",476,327,325,3,2,"PP-PAR",130
50,"50252",5178,3746,3711,36,35,"PP-PAR",1553
50,"50201",443,335,330,2,5,"PP-PAR",109
50,"50098",181,129,127,2,2,"PP-PAR",44
50,"50122",68,54,54,2,0,"PP-PAR",28
50,"50216",236,189,186,4,3,"PP-PAR",94
50,"50197",92,71,71,2,0,"PP-PAR",41
50,"50258",56,34,34,1,0,"PP-PAR",15
50,"50189",712,574,559,4,15,"PP-PAR",239
50,"50263",197,123,121,6,2,"PP-PAR",34
50,"50005",234,178,178,1,0,"PP-PAR",88
50,"50082",89,58,57,0,1,"PP-PAR",33
50,"50242",92,81,79,1,2,"PP-PAR",26
50,"50149",36,23,23,0,0,"PP-PAR",16
50,"50047",50,32,32,1,0,"PP-PAR",7
50,"50285",648,473,469,3,4,"PP-PAR",171
50,"50232",171,120,118,0,2,"PP-PAR",47
50,"50073",2148,1649,1622,9,27,"PP-PAR",656
50,"50058",72,51,51,0,0,"PP-PAR",25
50,"50138",46,41,41,0,0,"PP-PAR",24
50,"50190",708,542,539,3,3,"PP-PAR",177
50,"50024",589,461,459,4,2,"PP-PAR",127
50,"50195",53,38,38,0,0,"PP-PAR",16
50,"50109",105,78,77,3,1,"PP-PAR",26
50,"50014",146,99,99,1,0,"PP-PAR",33
50,"50135",95,63,63,0,0,"PP-PAR",27
50,"50008",5085,3617,3574,30,43,"PP-PAR",822
50,"50055",3612,2533,2490,34,43,"PP-PAR",837
50,"50010",69,57,57,0,0,"PP-PAR",41
50,"50241",593,426,418,1,8,"PP-PAR",202
50,"50272",12913,9500,9415,80,85,"PP-PAR",2229
50,"50234",245,198,193,9,5,"PP-PAR",84
50,"50203",1043,811,802,15,9,"PP-PAR",203
50,"50177",315,251,249,3,2,"PP-PAR",115
50,"50154",119,92,91,0,1,"PP-PAR",59
50,"50223",915,747,741,8,6,"PP-PAR",209
50,"50131",237,168,167,2,1,"PP-PAR",84
50,"50259",89,61,61,1,0,"PP-PAR",35
50,"50254",181,130,129,2,1,"PP-PAR",56
50,"50092",298,256,251,3,5,"PP-PAR",87
50,"50124",417,312,312,9,0,"PP-PAR",165
50,"50099",3087,2233,2216,15,17,"PP-PAR",747
50,"50289",52,39,39,1,0,"PP-PAR",20
50,"50221",33,20,20,0,0,"PP-PAR",4
50,"50048",35,23,23,0,0,"PP-PAR",5
50,"50003",126,93,92,3,1,"PP-PAR",38
50,"50128",28,24,24,0,0,"PP-PAR",11
50,"50117",125,91,90,1,1,"PP-PAR",39
50,"50268",47,40,39,0,1,"PP-PAR",16
50,"50148",324,240,236,0,4,"PP-PAR",94
50,"50012",108,86,83,1,3,"PP-PAR",31
50,"50903",2225,1686,1669,21,17,"PP-PAR",471
50,"50174",92,70,70,0,0,"PP-PAR",43
50,"50146",190,137,137,5,0,"PP-PAR",49
50,"50162",147,110,110,2,0,"PP-PAR",38
50,"50069",76,53,52,0,1,"PP-PAR",11
50,"50107",944,772,767,16,5,"PP-PAR",275
50,"50165",1815,1333,1316,27,17,"PP-PAR",314
50,"50262",1187,931,930,13,1,"PP-PAR",206
50,"50293",423,282,280,5,2,"PP-PAR",78
50,"50291",100,69,69,0,0,"PP-PAR",40
50,"50105",304,228,228,3,0,"PP-PAR",87
50,"50290",387,288,287,4,1,"PP-PAR",108
50,"50163",3655,2766,2740,34,26,"PP-PAR",775
50,"50133",117,88,88,3,0,"PP-PAR",30
50,"50054",59,45,45,0,0,"PP-PAR",18
50,"50212",41,37,37,0,0,"PP-PAR",13
50,"50002",148,105,102,0,3,"PP-PAR",60
50,"50143",569,414,411,4,3,"PP-PAR",138
50,"50217",455,334,334,1,0,"PP-PAR",137
50,"50063",61,57,57,0,0,"PP-PAR",19
50,"50192",236,185,183,2,2,"PP-PAR",69
50,"50176",228,158,157,0,1,"PP-PAR",67
50,"50130",395,252,252,1,0,"PP-PAR",98
50,"50292",132,103,103,0,0,"PP-PAR",62
50,"50193",647,514,506,1,8,"PP-PAR",150
50,"50032",273,190,189,0,1,"PP-PAR",66
50,"50256",84,46,46,0,0,"PP-PAR",32
50,"50044",232,156,156,1,0,"PP-PAR",46
50,"50902",87,78,78,1,0,"PP-PAR",44
50,"50095",12366,8938,8856,94,82,"PP-PAR",2456
50,"50296",398,297,293,2,4,"PP-PAR",41
50,"50065",53,42,42,0,0,"PP-PAR",11
50,"50196",108,83,82,1,1,"PP-PAR",10
50,"50160",2245,1661,1648,10,13,"PP-PAR",403
50,"50173",210,141,140,2,1,"PP-PAR",67
50,"50028",78,53,53,2,0,"PP-PAR",14
50,"50266",129,85,85,1,0,"PP-PAR",43
50,"50245",90,60,60,1,0,"PP-PAR",20
50,"50017",1772,1301,1293,7,8,"PP-PAR",380
50,"50013",224,187,186,3,1,"PP-PAR",71
50,"50167",232,194,193,0,1,"PP-PAR",99
50,"50120",49,36,36,3,0,"PP-PAR",8
50,"50187",70,38,38,0,0,"PP-PAR",16
50,"50298",5353,4051,4013,32,38,"PP-PAR",1297
50,"50213",98,77,72,0,5,"PP-PAR",53
50,"50224",69,55,55,1,0,"PP-PAR",34
50,"50132",755,573,564,7,9,"PP-PAR",188
50,"50205",91,69,65,1,4,"PP-PAR",18
50,"50287",274,197,195,4,2,"PP-PAR",82
50,"50175",1025,745,739,6,6,"PP-PAR",212
50,"50053",688,535,522,6,13,"PP-PAR",208
50,"50231",260,213,210,7,3,"PP-PAR",80
50,"50026",442,358,353,6,5,"PP-PAR",111
50,"50142",30,21,21,0,0,"PP-PAR",2
50,"50227",108,79,79,1,0,"PP-PAR",40
50,"50023",223,175,173,3,2,"PP-PAR",100
50,"50027",227,177,176,1,1,"PP-PAR",64
50,"50088",305,234,229,11,5,"PP-PAR",99
50,"50115",3248,2277,2262,31,15,"PP-PAR",785
50,"50257",178,139,137,0,2,"PP-PAR",41
50,"50274",71,50,49,1,1,"PP-PAR",22
50,"50199",341,242,241,4,1,"PP-PAR",87
50,"50140",165,106,106,0,0,"PP-PAR",52
50,"50186",41,29,29,0,0,"PP-PAR",6
50,"50184",113,82,82,0,0,"PP-PAR",48
50,"50295",45,39,39,0,0,"PP-PAR",13
50,"50155",102,78,78,0,0,"PP-PAR",38
50,"50072",174,124,122,2,2,"PP-PAR",58
50,"50275",110,73,72,0,1,"PP-PAR",46
50,"50096",39,17,17,0,0,"PP-PAR",6
50,"50018",948,717,712,6,5,"PP-PAR",255
50,"50286",77,54,54,0,0,"PP-PAR",15
50,"50038",1511,1167,1159,13,8,"PP-PAR",326
50,"50093",94,73,73,1,0,"PP-PAR",25
50,"50066",2613,1956,1951,21,5,"PP-PAR",654
50,"50238",97,74,73,0,1,"PP-PAR",26
50,"50271",256,187,184,4,3,"PP-PAR",88
50,"50080",32,25,25,0,0,"PP-PAR",9
50,"50211",252,187,186,0,1,"PP-PAR",89
50,"50070",60,29,29,1,0,"PP-PAR",8
50,"50057",1396,980,972,8,8,"PP-PAR",393
50,"50239",64,47,47,1,0,"PP-PAR",32
50,"50064",440,350,349,5,1,"PP-PAR",131
50,"50243",340,259,254,1,5,"PP-PAR",113
50,"50253",423,328,327,1,1,"PP-PAR",155
50,"50094",1626,1197,1178,22,19,"PP-PAR",481
50,"50009",106,78,77,1,1,"PP-PAR",45
50,"50901",137,101,101,0,0,"PP-PAR",38
50,"50071",131,90,90,0,0,"PP-PAR",68
50,"50129",245,164,164,1,0,"PP-PAR",66
50,"50147",788,577,576,4,1,"PP-PAR",156
50,"50178",302,197,196,9,1,"PP-PAR",61
50,"50172",196,138,136,0,2,"PP-PAR",67
50,"50078",244,192,189,1,3,"PP-PAR",68
50,"50230",1176,853,849,11,4,"PP-PAR",333
50,"50020",822,560,555,5,5,"PP-PAR",211
50,"50284",151,115,113,0,2,"PP-PAR",39
50,"50219",4098,3010,2980,27,30,"PP-PAR",709
50,"50202",158,96,92,1,4,"PP-PAR",43
50,"50182",3352,2437,2409,26,28,"PP-PAR",766
50,"50159",670,511,501,5,10,"PP-PAR",215
50,"50206",466,379,376,2,3,"PP-PAR",163
50,"50137",1025,793,786,6,7,"PP-PAR",303
50,"50111",186,152,151,1,1,"PP-PAR",59
50,"50060",176,138,136,0,2,"PP-PAR",49
50,"50261",215,159,159,1,0,"PP-PAR",30
50,"50251",8300,6228,6167,62,61,"PP-PAR",2128
50,"50083",90,72,72,1,0,"PP-PAR",18
50,"50001",115,81,80,0,1,"PP-PAR",60
50,"50144",36,28,28,0,0,"PP-PAR",11
50,"50210",40,32,31,0,1,"PP-PAR",13
50,"50152",1457,1032,1018,11,14,"PP-PAR",443
50,"50207",109,88,88,1,0,"PP-PAR",30
50,"50194",84,52,52,0,0,"PP-PAR",29
50,"50265",62,41,41,0,0,"PP-PAR",15
50,"50021",32,25,25,3,0,"PP-PAR",16
50,"50276",129,108,107,0,1,"PP-PAR",44
50,"50185",132,110,110,1,0,"PP-PAR",34
50,"50260",35,32,32,0,0,"PP-PAR",20
50,"50043",257,172,171,1,1,"PP-PAR",61
50,"50106",135,105,104,0,1,"PP-PAR",37
50,"50236",104,82,82,2,0,"PP-PAR",48
50,"50171",108,70,69,0,1,"PP-PAR",34
50,"50150",660,402,402,3,0,"PP-PAR",162
50,"50273",31,18,18,0,0,"PP-PAR",9
50,"50139",319,239,238,2,1,"PP-PAR",115
50,"50218",113,90,89,1,1,"PP-PAR",46
50,"50102",863,665,654,6,11,"PP-PAR",211
50,"50033",75,65,65,0,0,"PP-PAR",23
50,"50237",103,73,73,2,0,"PP-PAR",36
50,"50278",198,145,144,1,1,"PP-PAR",65
50,"50076",81,64,64,0,0,"PP-PAR",17
50,"50006",939,712,701,8,11,"PP-PAR",205
50,"50188",30,23,19,0,4,"PP-PAR",16
50,"50288",3371,2566,2547,26,19,"PP-PAR",837
50,"50085",176,131,129,3,2,"PP-PAR",65
50,"50179",257,207,207,2,0,"PP-PAR",98
50,"50075",81,59,59,1,0,"PP-PAR",45
50,"50118",2179,1575,1564,7,11,"PP-PAR",481
50,"50125",371,260,258,3,2,"PP-PAR",119
50,"50062",1810,1407,1389,12,18,"PP-PAR",373
50,"50007",46,37,37,1,0,"PP-PAR",15
50,"50249",312,235,233,1,2,"PP-PAR",154
50,"50019",54,41,41,0,0,"PP-PAR",18
50,"50016",52,37,37,0,0,"PP-PAR",16
50,"50255",214,163,163,0,0,"PP-PAR",21
50,"50297",499531,377882,375565,3049,2317,"PP-PAR",109329
50,"50004",534,406,401,0,5,"PP-PAR",129
50,"50045",1255,944,934,6,10,"PP-PAR",394
50,"50235",2323,1687,1675,7,12,"PP-PAR",544
50,"50090",156,112,111,0,1,"PP-PAR",72
50,"50180",120,97,96,0,1,"PP-PAR",37
50,"50141",114,85,84,0,1,"PP-PAR",47
50,"50214",27,16,16,1,0,"PP-PAR",7
50,"50025",4547,3335,3295,45,40,"PP-PAR",1233
50,"50247",827,624,615,10,9,"PP-PAR",228
50,"50041",12,10,10,0,0,"PP-PAR",3
50,"50089",8144,6285,6249,50,36,"PP-PAR",1788
50,"50051",828,640,637,8,3,"PP-PAR",231
50,"50029",627,469,468,4,1,"PP-PAR",115
50,"50204",2457,1830,1816,14,14,"PP-PAR",399
50,"50022",543,410,398,8,12,"PP-PAR",194
50,"50077",226,175,174,5,1,"PP-PAR",63
50,"50046",176,123,123,7,0,"PP-PAR",63
50,"50267",605,424,420,4,4,"PP-PAR",127
50,"50225",1568,996,985,2,11,"PP-PAR",435
50,"50030",225,156,156,2,0,"PP-PAR",64
50,"50113",618,506,496,4,10,"PP-PAR",166
50,"50084",79,56,56,1,0,"PP-PAR",24
50,"50168",28,23,23,0,0,"PP-PAR",10
50,"50264",158,111,111,0,0,"PP-PAR",22
50,"50119",930,698,691,7,7,"PP-PAR",280
50,"50169",362,264,262,0,2,"PP-PAR",108
50,"50104",351,283,282,3,1,"PP-PAR",108
50,"50091",48,32,32,1,0,"PP-PAR",19
50,"50240",1034,749,737,10,12,"PP-PAR",216
50,"50031",161,90,88,1,2,"PP-PAR",36
50,"50151",650,504,503,7,1,"PP-PAR",174
50,"50157",301,211,207,2,4,"PP-PAR",71
50,"50156",214,173,170,2,3,"PP-PAR",47
50,"50209",2560,1787,1774,12,13,"PP-PAR",538
50,"50161",117,76,76,0,0,"PP-PAR",37
50,"50281",80,57,56,0,1,"PP-PAR",33
50,"50059",780,572,567,6,5,"PP-PAR",227
50,"50061",207,174,168,1,6,"PP-PAR",77
50,"50123",465,349,344,2,5,"PP-PAR",87
50,"50101",879,615,609,5,6,"PP-PAR",183
50,"50134",128,88,88,5,0,"PP-PAR",37
50,"50116",190,142,140,1,2,"PP-PAR",71
50,"50039",507,400,398,3,2,"PP-PAR",129
50,"50270",38,24,24,2,0,"PP-PAR",9
50,"50246",41,29,29,0,0,"PP-PAR",20
50,"50121",276,227,225,4,2,"PP-PAR",97
50,"50035",74,53,52,0,1,"PP-PAR",4
50,"50198",56,30,30,0,0,"PP-PAR",14
50,"50164",395,263,260,2,3,"PP-PAR",95
50,"50277",55,43,43,1,0,"PP-PAR",22
50,"50280",340,260,258,0,2,"PP-PAR",74
50,"50011",127,96,96,2,0,"PP-PAR",23
50,"50087",28,19,19,0,0,"PP-PAR",11
50,"50114",124,94,94,2,0,"PP-PAR",28
50,"50229",64,42,42,0,0,"PP-PAR",9
50,"50074",6397,4512,4408,38,104,"PP-PAR",1111
50,"50233",114,81,81,1,0,"PP-PAR",38
50,"50153",941,737,734,7,3,"PP-PAR",214
50,"50294",73,58,58,0,0,"PP-PAR",28
50,"50282",70,48,48,0,0,"PP-PAR",25
50,"50215",23,15,15,0,0,"PP-PAR",4
50,"50036",103,79,79,0,0,"PP-PAR",28
50,"50110",369,258,257,0,1,"PP-PAR",89
50,"50081",512,376,372,6,4,"PP-PAR",160
50,"50222",1647,1135,1118,8,17,"PP-PAR",359
50,"50136",579,420,413,0,7,"PP-PAR",226
50,"50040",92,75,75,0,0,"PP-PAR",28
50,"50228",270,211,210,5,1,"PP-PAR",115
50,"50042",16,13,13,0,0,"PP-PAR",9
50,"50034",838,572,569,5,3,"PP-PAR",186
50,"50079",254,186,184,3,2,"PP-PAR",72
50,"50248",521,407,406,1,1,"PP-PAR",126
50,"50181",1003,750,737,9,13,"PP-PAR",286
50,"50068",1998,1388,1378,17,10,"PP-PAR",480
50,"50183",338,255,255,0,0,"PP-PAR",110
50,"50086",184,128,128,1,0,"PP-PAR",19
50,"50100",333,263,261,5,2,"PP-PAR",102
50,"50220",46,32,32,0,0,"PP-PAR",7
50,"50050",98,59,59,3,0,"PP-PAR",11
50,"50250",55,44,44,0,0,"PP-PAR",20
50,"50279",87,62,62,1,0,"PP-PAR",11
50,"50166",260,192,189,2,3,"PP-PAR",79
48,"48002",7851,5767,5713,41,54,"UPYD",6
48,"48911",382,291,286,2,5,"UPYD",0
48,"48067",1161,837,834,2,3,"UPYD",1
48,"48072",974,728,723,5,5,"UPYD",0
48,"48024",1003,775,771,5,4,"UPYD",0
48,"48044",62989,46989,46783,385,206,"UPYD",180
48,"48048",562,399,394,3,5,"UPYD",0
48,"48039",243,201,201,2,0,"UPYD",1
48,"48914",330,275,275,1,0,"UPYD",0
48,"48059",402,317,314,1,3,"UPYD",0
48,"48032",5735,4173,4151,32,22,"UPYD",5
48,"48082",37673,27006,26811,201,195,"UPYD",77
48,"48061",762,584,581,4,3,"UPYD",2
48,"48084",22577,15689,15540,108,149,"UPYD",32
48,"48025",883,642,639,3,3,"UPYD",0
48,"48094",3193,2210,2200,18,10,"UPYD",2
48,"48050",198,153,150,0,3,"UPYD",0
48,"48071",6118,4467,4412,32,55,"UPYD",8
48,"48011",9692,6891,6843,56,48,"UPYD",20
48,"48092",837,619,619,13,0,"UPYD",0
48,"48007",365,241,239,0,2,"UPYD",0
48,"48055",2662,1961,1938,16,23,"UPYD",3
48,"48041",704,558,555,4,3,"UPYD",0
48,"48043",4403,3214,3186,28,28,"UPYD",11
48,"48096",6608,5071,5011,43,60,"UPYD",8
48,"48049",548,433,431,0,2,"UPYD",1
48,"48910",2948,2126,2115,17,11,"UPYD",4
48,"48075",1975,1440,1421,12,19,"UPYD",2
48,"48088",135,97,96,0,1,"UPYD",0
48,"48021",1352,952,946,8,6,"UPYD",1
48,"48058",972,691,687,4,4,"UPYD",0
48,"48083",6950,5128,5097,33,31,"UPYD",11
48,"48060",3645,2277,2274,7,3,"UPYD",0
48,"48038",1122,834,824,0,10,"UPYD",1
48,"48065",3315,2447,2433,19,14,"UPYD",2
48,"48040",1299,896,884,5,12,"UPYD",1
48,"48028",715,553,551,4,2,"UPYD",0
48,"48015",33690,24299,24160,168,139,"UPYD",60
48,"48023",594,470,468,4,2,"UPYD",0
48,"48915",362,238,238,2,0,"UPYD",0
48,"48076",314,237,237,4,0,"UPYD",0
48,"48057",5749,4093,4081,20,12,"UPYD",2
48,"48095",2352,1658,1647,6,11,"UPYD",3
48,"48081",1883,1412,1398,12,14,"UPYD",1
48,"48046",12617,9037,8967,56,70,"UPYD",5
48,"48066",346,256,256,1,0,"UPYD",0
48,"48079",425,322,321,4,1,"UPYD",0
48,"48010",457,311,307,1,4,"UPYD",0
48,"48068",1551,1178,1163,16,15,"UPYD",0
48,"48006",289,246,245,3,1,"UPYD",0
48,"48017",13290,8908,8856,42,52,"UPYD",4
48,"48056",978,733,732,7,1,"UPYD",0
48,"48016",5260,3856,3827,22,29,"UPYD",17
48,"48077",3367,2438,2423,17,15,"UPYD",4
48,"48045",5149,3940,3885,35,55,"UPYD",10
48,"48018",875,553,553,3,0,"UPYD",0
48,"48073",6952,4476,4435,43,41,"UPYD",4
48,"48001",5832,4191,4166,37,25,"UPYD",4
48,"48091",1134,821,812,7,9,"UPYD",0
48,"48908",245,200,199,1,1,"UPYD",1
48,"48037",678,518,509,2,9,"UPYD",0
48,"48033",215,160,159,0,1,"UPYD",0
48,"48027",22033,15929,15825,113,104,"UPYD",36
48,"48902",19124,13344,13227,93,117,"UPYD",26
48,"48022",2355,1476,1468,9,8,"UPYD",5
48,"48029",8332,6155,6119,35,36,"UPYD",17
48,"48005",117,76,76,0,0,"UPYD",1
48,"48030",608,454,453,4,1,"UPYD",0
48,"48052",1559,1215,1211,0,4,"UPYD",2
48,"48020",274076,193807,192607,1471,1200,"UPYD",782
48,"48080",9971,7148,7086,71,62,"UPYD",18
48,"48093",900,673,664,4,9,"UPYD",0
48,"48906",775,579,574,0,5,"UPYD",0
48,"48090",6022,4544,4483,23,61,"UPYD",16
48,"48047",161,112,112,0,0,"UPYD",0
48,"48087",429,346,343,1,3,"UPYD",0
48,"48905",2565,1882,1847,2,35,"UPYD",5
48,"48069",12765,8985,8910,58,75,"UPYD",25
48,"48008",617,433,424,6,9,"UPYD",0
48,"48904",3504,2671,2650,18,21,"UPYD",7
48,"48074",3333,2467,2428,20,39,"UPYD",8
48,"48912",2308,1787,1746,27,41,"UPYD",5
48,"48036",24144,17085,16954,117,131,"UPYD",50
48,"48035",412,313,312,4,1,"UPYD",0
48,"48003",14338,10497,10414,76,83,"UPYD",18
48,"48009",786,614,609,3,5,"UPYD",0
48,"48026",1134,861,853,7,8,"UPYD",0
48,"48089",3266,2425,2406,23,19,"UPYD",8
48,"48034",12902,9684,9613,79,71,"UPYD",39
48,"48097",1303,907,898,10,9,"UPYD",2
48,"48903",1838,1400,1385,4,15,"UPYD",5
48,"48064",603,463,459,7,4,"UPYD",0
48,"48019",3594,2569,2544,16,25,"UPYD",11
48,"48901",4775,3602,3573,35,29,"UPYD",5
48,"48051",220,169,168,0,1,"UPYD",0
48,"48913",1251,933,917,13,16,"UPYD",1
48,"48062",300,241,240,1,1,"UPYD",0
48,"48063",373,289,288,1,1,"UPYD",0
48,"48013",79984,56928,56516,383,412,"UPYD",209
48,"48053",900,676,670,8,6,"UPYD",0
48,"48085",10301,7458,7407,50,51,"UPYD",25
48,"48031",340,245,242,0,3,"UPYD",0
48,"48014",1218,870,866,8,4,"UPYD",1
48,"48909",207,165,165,1,0,"UPYD",0
48,"48054",24135,17493,17374,124,119,"UPYD",46
48,"48012",2041,1571,1553,11,18,"UPYD",2
48,"48078",38742,28064,27837,231,227,"UPYD",109
48,"48042",1384,1111,1091,7,20,"UPYD",7
48,"48004",334,229,227,1,2,"UPYD",1
48,"48070",545,378,374,2,4,"UPYD",0
48,"48907",355,283,282,2,1,"UPYD",2
48,"48086",2073,1519,1504,15,15,"UPYD",5
30,"30009",12392,9724,9599,40,125,"VOX",26
30,"30025",4900,3777,3727,20,50,"VOX",12
30,"30002",9921,7263,7166,34,97,"VOX",13
30,"30003",24305,16558,16419,122,139,"VOX",36
30,"30026",15722,10147,10024,49,123,"VOX",34
30,"30041",13640,9156,9092,52,64,"VOX",31
30,"30042",1918,1518,1500,6,18,"VOX",3
30,"30030",312625,235232,233576,1438,1656,"VOX",1483
30,"30022",16894,11661,11498,119,163,"VOX",29
30,"30011",4706,3582,3541,20,41,"VOX",13
30,"30005",29559,21408,21203,123,205,"VOX",100
30,"30038",15381,10881,10797,51,84,"VOX",23
30,"30004",1141,938,933,5,5,"VOX",0
30,"30036",14624,10139,9988,70,151,"VOX",80
30,"30039",19199,13538,13405,101,133,"VOX",21
30,"30006",803,683,681,2,2,"VOX",2
30,"30008",13860,10066,9945,74,121,"VOX",24
30,"30029",11815,8365,8296,67,69,"VOX",7
30,"30043",24972,19411,19139,154,272,"VOX",86
30,"30033",10144,7591,7505,86,86,"VOX",17
30,"30023",3762,2871,2837,14,34,"VOX",2
30,"30014",1598,1270,1258,5,12,"VOX",1
30,"30040",727,627,620,1,7,"VOX",2
30,"30001",4596,3602,3572,20,30,"VOX",8
30,"30032",2849,2188,2161,10,27,"VOX",4
30,"30021",9101,6106,6034,25,72,"VOX",19
30,"30028",6690,5005,4938,29,67,"VOX",24
30,"30031",498,424,421,2,3,"VOX",0
30,"30010",6861,5287,5220,38,67,"VOX",11
30,"30015",19154,13947,13835,77,112,"VOX",75
30,"30012",9101,7170,7091,46,79,"VOX",15
30,"30024",58529,42392,42072,275,320,"VOX",170
30,"30901",10331,7925,7833,54,92,"VOX",23
30,"30034",1138,859,846,5,13,"VOX",1
30,"30020",6261,4502,4459,25,43,"VOX",11
30,"30037",18726,13183,13027,73,156,"VOX",22
30,"30027",47867,36054,35794,181,260,"VOX",136
30,"30018",7903,5990,5912,29,78,"VOX",35
30,"30007",6415,4554,4515,19,39,"VOX",17
30,"30013",7395,5320,5277,38,43,"VOX",6
30,"30902",8022,5454,5412,34,42,"VOX",10
30,"30035",18616,13185,13085,70,100,"VOX",90
30,"30019",25921,18079,17894,121,185,"VOX",71
30,"30016",151577,103359,102538,620,821,"VOX",471
30,"30017",11635,8718,8646,46,72,"VOX",7
12,"12039",840,726,719,2,7,"ARAPV",0
12,"12003",991,762,752,10,10,"ARAPV",1
12,"12032",23508,17400,17279,89,121,"ARAPV",21
12,"12083",95,82,80,0,2,"ARAPV",0
12,"12010",259,216,209,6,7,"ARAPV",1
12,"12127",77,56,56,0,0,"ARAPV",0
12,"12017",164,133,132,1,1,"ARAPV",0
12,"12052",590,464,442,5,22,"ARAPV",0
12,"12051",477,337,335,2,2,"ARAPV",0
12,"12057",606,495,487,3,8,"ARAPV",1
12,"12071",1280,1002,988,5,14,"ARAPV",1
12,"12034",1430,1078,1053,4,25,"ARAPV",3
12,"12028",12566,9902,9830,55,72,"ARAPV",13
12,"12001",1054,798,786,8,12,"ARAPV",2
12,"12076",87,70,70,1,0,"ARAPV",2
12,"12077",4625,3443,3387,20,56,"ARAPV",3
12,"12063",42,35,34,2,1,"ARAPV",0
12,"12091",185,145,141,3,4,"ARAPV",0
12,"12100",1345,1115,1098,6,17,"ARAPV",1
12,"12031",3830,3049,2987,20,62,"ARAPV",3
12,"12135",35749,27015,26806,174,209,"ARAPV",41
12,"12084",17599,13146,13022,98,124,"ARAPV",12
12,"12136",2657,2302,2252,22,50,"ARAPV",3
12,"12006",176,140,140,1,0,"ARAPV",0
12,"12073",156,132,131,0,1,"ARAPV",0
12,"12099",542,434,405,9,29,"ARAPV",0
12,"12040",117832,89135,88464,525,671,"ARAPV",70
12,"12042",621,520,512,13,8,"ARAPV",0
12,"12098",588,479,473,4,6,"ARAPV",4
12,"12094",851,688,674,2,14,"ARAPV",1
12,"12134",138,97,96,0,1,"ARAPV",1
12,"12132",486,407,398,2,9,"ARAPV",0
12,"12102",536,452,437,1,15,"ARAPV",1
12,"12027",17217,12263,12122,77,141,"ARAPV",77
12,"12125",214,185,183,2,2,"ARAPV",0
12,"12020",124,104,103,1,1,"ARAPV",0
12,"12114",200,150,149,1,1,"ARAPV",0
12,"12074",784,690,678,9,12,"ARAPV",1
12,"12002",116,98,96,0,2,"ARAPV",1
12,"12097",67,55,54,0,1,"ARAPV",0
12,"12061",378,275,275,4,0,"ARAPV",2
12,"12128",1400,1102,1091,11,11,"ARAPV",1
12,"12080",1955,1647,1624,13,23,"ARAPV",0
12,"12081",611,503,493,3,10,"ARAPV",0
12,"12142",161,124,123,0,1,"ARAPV",0
12,"12043",581,470,459,4,11,"ARAPV",0
12,"12129",1840,1391,1360,19,31,"ARAPV",0
12,"12121",1127,955,928,6,27,"ARAPV",2
12,"12092",112,84,84,0,0,"ARAPV",0
12,"12137",37,26,26,1,0,"ARAPV",0
12,"12046",193,154,153,3,1,"ARAPV",0
12,"12106",1170,983,967,16,16,"ARAPV",1
12,"12117",3576,2786,2747,17,39,"ARAPV",5
12,"12004",4204,3174,3130,19,44,"ARAPV",1
12,"12116",67,49,49,0,0,"ARAPV",0
12,"12067",543,442,424,1,18,"ARAPV",0
12,"12049",455,348,339,5,9,"ARAPV",0
12,"12138",19064,13610,13456,135,154,"ARAPV",43
12,"12093",189,147,145,1,2,"ARAPV",0
12,"12069",74,50,49,0,1,"ARAPV",0
12,"12015",96,83,81,0,2,"ARAPV",0
12,"12141",101,80,80,0,0,"ARAPV",0
12,"12075",123,94,92,1,2,"ARAPV",0
12,"12059",244,190,189,1,1,"ARAPV",0
12,"12025",137,106,106,0,0,"ARAPV",0
12,"12110",244,173,170,1,3,"ARAPV",0
12,"12123",47,32,32,0,0,"ARAPV",0
12,"12090",109,94,93,2,1,"ARAPV",0
12,"12131",65,53,53,0,0,"ARAPV",0
12,"12085",5061,3310,3264,20,46,"ARAPV",4
12,"12096",775,587,580,12,7,"ARAPV",0
12,"12119",147,100,100,1,0,"ARAPV",0
12,"12107",351,313,309,3,4,"ARAPV",0
12,"12079",405,318,312,4,6,"ARAPV",0
12,"12021",4442,3486,3432,25,54,"ARAPV",5
12,"12037",16,14,14,0,0,"ARAPV",0
12,"12011",4587,3530,3480,30,50,"ARAPV",8
12,"12055",106,79,79,2,0,"ARAPV",1
12,"12120",184,155,154,1,1,"ARAPV",0
12,"12108",463,395,390,0,5,"ARAPV",0
12,"12902",2148,1562,1536,9,26,"ARAPV",2
12,"12038",171,121,120,1,1,"ARAPV",0
12,"12095",974,789,784,8,5,"ARAPV",0
12,"12065",192,166,166,0,0,"ARAPV",1
12,"12104",6954,5571,5470,26,101,"ARAPV",2
12,"12024",139,115,113,1,2,"ARAPV",0
12,"12082",9655,7570,7492,38,78,"ARAPV",9
12,"12009",17430,12600,12501,77,99,"ARAPV",8
12,"12111",375,314,310,0,4,"ARAPV",2
12,"12012",2695,2236,2204,6,32,"ARAPV",3
12,"12005",8090,6113,6027,57,86,"ARAPV",2
12,"12901",3433,2691,2664,27,27,"ARAPV",1
12,"12089",4331,3103,3050,25,53,"ARAPV",8
12,"12105",851,666,659,5,7,"ARAPV",0
12,"12087",26,18,18,3,0,"ARAPV",0
12,"12014",184,140,136,1,4,"ARAPV",0
12,"12122",805,660,647,4,13,"ARAPV",0
12,"12058",74,60,59,2,1,"ARAPV",0
12,"12022",340,273,269,1,4,"ARAPV",2
12,"12072",1117,962,937,8,25,"ARAPV",1
12,"12118",74,60,59,0,1,"ARAPV",0
12,"12101",363,282,273,3,9,"ARAPV",0
12,"12018",293,244,235,2,9,"ARAPV",0
12,"12103",89,69,68,2,1,"ARAPV",1
12,"12140",1140,961,950,5,11,"ARAPV",0
12,"12007",758,672,667,7,5,"ARAPV",0
12,"12029",717,572,566,6,6,"ARAPV",1
12,"12060",446,367,360,2,7,"ARAPV",0
12,"12013",148,119,116,4,3,"ARAPV",0
12,"12115",217,169,167,2,2,"ARAPV",0
12,"12050",1320,1044,1032,8,12,"ARAPV",0
12,"12133",60,49,49,0,0,"ARAPV",0
12,"12026",894,697,676,14,21,"ARAPV",0
12,"12109",647,531,520,1,11,"ARAPV",0
12,"12126",24480,18885,18687,115,198,"ARAPV",18
12,"12068",49,34,34,1,0,"ARAPV",0
12,"12112",99,81,79,1,2,"ARAPV",1
12,"12139",322,239,237,1,2,"ARAPV",4
12,"12088",69,58,58,0,0,"ARAPV",0
12,"12045",354,282,279,2,3,"ARAPV",1
12,"12056",285,243,238,3,5,"ARAPV",0
12,"12078",339,250,247,1,3,"ARAPV",0
12,"12008",231,192,190,2,2,"ARAPV",2
12,"12070",524,418,408,8,10,"ARAPV",0
12,"12113",85,69,69,2,0,"ARAPV",0
12,"12041",97,77,77,0,0,"ARAPV",0
12,"12044",483,438,431,4,7,"ARAPV",0
12,"12016",1582,1311,1295,9,16,"ARAPV",0
12,"12048",249,196,192,1,4,"ARAPV",0
12,"12130",404,339,332,0,7,"ARAPV",0
12,"12053",2069,1691,1677,8,14,"ARAPV",4
12,"12124",1853,1411,1394,20,17,"ARAPV",2
12,"12033",1907,1483,1436,11,47,"ARAPV",0
12,"12036",593,448,445,2,3,"ARAPV",0
12,"12064",97,83,82,0,1,"ARAPV",0
11,"11026",4804,3581,3511,31,70,"UPYD",18
11,"11005",4560,3203,3143,21,60,"UPYD",16
11,"11020",165400,113865,113092,1184,773,"UPYD",693
11,"11011",1688,1239,1205,14,34,"UPYD",5
11,"11038",13803,10593,10441,121,152,"UPYD",51
11,"11015",62337,40342,40012,407,330,"UPYD",233
11,"11007",18036,10832,10678,181,154,"UPYD",46
11,"11032",53898,32432,32172,371,260,"UPYD",134
11,"11042",1189,877,868,5,9,"UPYD",7
11,"11024",6735,5114,5065,33,49,"UPYD",13
11,"11039",10044,6684,6623,98,61,"UPYD",28
11,"11902",3619,2431,2410,17,21,"UPYD",10
11,"11041",9856,7043,6967,85,76,"UPYD",16
11,"11028",32532,23191,22981,274,210,"UPYD",176
11,"11001",4377,2949,2900,17,49,"UPYD",8
11,"11017",3207,2389,2362,28,27,"UPYD",8
11,"11034",2345,1606,1594,10,12,"UPYD",2
11,"11021",6777,4826,4779,52,47,"UPYD",13
11,"11031",76452,51850,51456,568,394,"UPYD",395
11,"11014",16791,11255,11146,166,109,"UPYD",39
11,"11012",100460,72741,72128,590,613,"UPYD",466
11,"11030",22796,15377,15222,145,155,"UPYD",100
11,"11023",9354,6990,6928,86,62,"UPYD",14
11,"11016",14880,9945,9848,124,97,"UPYD",29
11,"11008",17460,11800,11615,151,185,"UPYD",90
11,"11037",5678,4491,4426,20,65,"UPYD",10
11,"11025",4370,3174,3123,29,51,"UPYD",6
11,"11029",5433,3112,3067,27,45,"UPYD",6
11,"11901",5653,4132,4088,84,44,"UPYD",9
11,"11033",20773,13487,13333,171,154,"UPYD",53
11,"11004",88617,55218,54733,581,485,"UPYD",347
11,"11019",1830,1413,1371,5,42,"UPYD",6
11,"11003",1270,907,899,12,8,"UPYD",0
11,"11035",13569,9000,8908,93,92,"UPYD",30
11,"11010",6420,4423,4362,63,61,"UPYD",13
11,"11022",48778,26546,26333,277,213,"UPYD",94
11,"11002",4287,3245,3238,15,7,"UPYD",2
11,"11036",694,439,437,13,2,"UPYD",1
11,"11027",68010,46675,46322,400,353,"UPYD",364
11,"11009",602,426,422,5,4,"UPYD",1
11,"11006",24504,16649,16486,176,163,"UPYD",58
11,"11018",1485,1109,1090,10,19,"UPYD",3
11,"11040",398,326,317,3,9,"UPYD",1
11,"11013",2324,1687,1653,16,34,"UPYD",9
7,"7061",9831,6618,6546,54,72,"C's",789
7,"7024",7019,3579,3544,39,35,"C's",429
7,"7044",8457,6079,5963,59,116,"C's",461
7,"7065",2079,1462,1451,13,11,"C's",104
7,"7057",7170,4736,4668,44,68,"C's",488
7,"7060",2577,1825,1807,20,18,"C's",141
7,"7019",192,146,146,0,0,"C's",9
7,"7016",2786,1992,1969,30,23,"C's",239
7,"7033",27017,16370,16205,143,165,"C's",2001
7,"7034",991,774,765,2,9,"C's",70
7,"7003",11742,6924,6837,43,87,"C's",875
7,"7039",4880,3473,3412,27,61,"C's",382
7,"7056",5012,3632,3592,40,40,"C's",471
7,"7027",20667,13784,13673,106,111,"C's",1755
7,"7036",26936,19563,19392,156,171,"C's",3794
7,"7059",2998,2119,2084,11,35,"C's",227
7,"7050",3321,2161,2134,33,27,"C's",203
7,"7058",2804,2138,2118,15,20,"C's",243
7,"7018",389,271,265,3,6,"C's",29
7,"7041",2039,1566,1540,5,26,"C's",92
7,"7053",1171,957,946,8,11,"C's",91
7,"7038",2032,1515,1503,10,12,"C's",95
7,"7037",3232,1894,1881,16,13,"C's",238
7,"7015",21076,13304,13169,162,135,"C's",1988
7,"7005",6659,4400,4357,23,43,"C's",605
7,"7901",611,476,469,6,7,"C's",19
7,"7055",7474,4796,4740,48,56,"C's",518
7,"7062",7539,4371,4312,40,59,"C's",523
7,"7042",10666,7023,6967,59,56,"C's",710
7,"7013",6832,4879,4775,34,104,"C's",504
7,"7009",749,552,550,1,2,"C's",52
7,"7035",1517,1188,1181,3,7,"C's",40
7,"7011",27781,18282,18180,135,102,"C's",3173
7,"7006",5175,3559,3528,33,31,"C's",277
7,"7028",892,617,611,2,6,"C's",43
7,"7017",844,625,618,6,7,"C's",73
7,"7049",1498,1080,1071,12,9,"C's",52
7,"7051",5225,3322,3279,38,43,"C's",393
7,"7014",7277,4301,4261,37,40,"C's",498
7,"7064",5361,3588,3546,20,42,"C's",533
7,"7022",11575,7827,7730,85,97,"C's",771
7,"7032",20039,13156,13033,136,123,"C's",2034
7,"7026",31158,18670,18537,161,133,"C's",3057
7,"7047",2236,1602,1584,7,18,"C's",161
7,"7025",478,377,376,1,1,"C's",46
7,"7008",5681,4203,4153,22,50,"C's",514
7,"7007",437,308,304,1,4,"C's",26
7,"7045",1288,996,992,13,4,"C's",132
7,"7030",1573,1151,1129,10,22,"C's",71
7,"7043",3422,2435,2410,13,25,"C's",199
7,"7063",1420,1084,1072,8,12,"C's",134
7,"7046",15649,9532,9443,70,89,"C's",1222
7,"7004",3861,2657,2630,24,27,"C's",270
7,"7048",17339,10192,10101,104,91,"C's",1609
7,"7029",4137,3088,3048,34,40,"C's",302
7,"7902",1072,730,712,18,18,"C's",69
7,"7031",23747,15538,15401,130,137,"C's",2540
7,"7054",22371,12930,12779,104,151,"C's",1991
7,"7002",6367,4466,4401,36,65,"C's",567
7,"7021",234,188,188,0,0,"C's",29
7,"7001",3556,2682,2657,21,25,"C's",325
7,"7012",1877,1421,1408,13,13,"C's",104
7,"7020",3597,2652,2622,27,30,"C's",311
7,"7052",4705,2993,2971,34,22,"C's",462
7,"7040",279737,181078,179570,1280,1508,"C's",30480
7,"7010",4858,3518,3463,52,55,"C's",468
7,"7023",3628,2611,2573,45,38,"C's",330
13,"13045",679,532,522,7,10,"PACMA",1
13,"13046",740,575,570,3,5,"PACMA",0
13,"13023",9003,6578,6517,86,61,"PACMA",23
13,"13901",895,676,660,4,16,"PACMA",2
13,"13034",58010,44627,44241,332,386,"PACMA",463
13,"13022",351,280,280,2,0,"PACMA",2
13,"13014",496,404,398,2,6,"PACMA",0
13,"13079",12273,9195,9036,79,159,"PACMA",53
13,"13055",666,495,490,0,5,"PACMA",0
13,"13094",308,253,249,3,4,"PACMA",2
13,"13037",865,678,667,2,11,"PACMA",1
13,"13075",213,157,153,1,4,"PACMA",1
13,"13077",3518,2443,2378,12,65,"PACMA",6
13,"13071",39775,28222,28052,175,170,"PACMA",208
13,"13012",411,294,292,0,2,"PACMA",0
13,"13040",892,720,710,3,10,"PACMA",3
13,"13044",2675,1959,1920,12,39,"PACMA",5
13,"13066",2519,2057,2026,14,31,"PACMA",12
13,"13903",539,437,432,4,5,"PACMA",0
13,"13032",1150,878,870,9,8,"PACMA",7
13,"13042",928,696,688,3,8,"PACMA",1
13,"13019",5179,3887,3830,35,57,"PACMA",17
13,"13084",908,725,708,5,17,"PACMA",4
13,"13083",2453,1729,1690,14,39,"PACMA",8
13,"13041",253,182,180,0,2,"PACMA",1
13,"13003",487,367,363,2,4,"PACMA",0
13,"13026",452,374,372,1,2,"PACMA",0
13,"13017",267,205,203,1,2,"PACMA",0
13,"13068",1058,787,782,5,5,"PACMA",1
13,"13030",143,110,110,0,0,"PACMA",2
13,"13087",23161,16812,16595,145,217,"PACMA",138
13,"13001",1270,985,977,8,8,"PACMA",1
13,"13074",982,843,833,3,10,"PACMA",0
13,"13052",6497,4715,4648,71,67,"PACMA",25
13,"13036",800,620,614,3,6,"PACMA",4
13,"13089",1728,1410,1381,6,29,"PACMA",6
13,"13015",5494,4146,4106,18,40,"PACMA",14
13,"13096",7677,5743,5661,51,82,"PACMA",25
13,"13073",542,409,405,0,4,"PACMA",0
13,"13007",1273,1056,1028,10,28,"PACMA",5
13,"13091",552,466,459,3,7,"PACMA",1
13,"13024",898,643,637,7,6,"PACMA",1
13,"13076",488,415,408,1,7,"PACMA",0
13,"13016",665,537,529,4,8,"PACMA",7
13,"13902",479,374,367,0,7,"PACMA",1
13,"13010",887,673,665,0,8,"PACMA",0
13,"13005",23330,18245,18030,164,215,"PACMA",96
13,"13058",4110,3157,3127,28,30,"PACMA",17
13,"13009",1459,1167,1156,4,11,"PACMA",3
13,"13039",14383,10833,10684,100,149,"PACMA",61
13,"13047",5785,4462,4406,23,56,"PACMA",29
13,"13043",231,186,185,5,1,"PACMA",0
13,"13021",436,376,374,0,2,"PACMA",3
13,"13081",652,525,508,2,17,"PACMA",2
13,"13097",2282,1783,1768,12,15,"PACMA",11
13,"13082",25841,17702,17561,154,141,"PACMA",149
13,"13054",4970,3911,3866,44,45,"PACMA",14
13,"13013",7086,5419,5340,45,79,"PACMA",32
13,"13035",986,791,784,7,7,"PACMA",4
13,"13031",2455,1940,1914,9,26,"PACMA",23
13,"13095",83,65,65,1,0,"PACMA",0
13,"13093",4111,3056,3014,21,42,"PACMA",17
13,"13062",575,471,466,4,5,"PACMA",0
13,"13008",441,317,311,2,6,"PACMA",2
13,"13061",5723,4210,4149,49,61,"PACMA",26
13,"13064",1684,1288,1283,13,5,"PACMA",21
13,"13011",4866,3346,3312,15,34,"PACMA",15
13,"13038",1649,1317,1294,15,23,"PACMA",9
13,"13080",350,265,265,1,0,"PACMA",0
13,"13092",1860,1544,1529,11,15,"PACMA",1
13,"13020",4792,3494,3451,26,43,"PACMA",20
13,"13057",1172,980,970,1,10,"PACMA",0
13,"13090",1110,872,849,6,23,"PACMA",1
13,"13069",666,518,508,3,10,"PACMA",0
13,"13098",2124,1633,1591,15,42,"PACMA",8
13,"13085",2365,2011,1983,6,28,"PACMA",3
13,"13067",360,298,294,2,4,"PACMA",2
13,"13065",2888,2004,1970,19,34,"PACMA",8
13,"13063",3728,2708,2685,9,23,"PACMA",7
13,"13033",1653,1395,1378,4,17,"PACMA",6
13,"13050",501,403,399,2,4,"PACMA",3
13,"13088",610,501,495,5,6,"PACMA",0
13,"13029",86,69,69,0,0,"PACMA",1
13,"13006",608,487,479,4,8,"PACMA",0
13,"13028",10416,8309,8171,77,138,"PACMA",50
13,"13018",824,667,662,7,5,"PACMA",3
13,"13086",189,146,146,1,0,"PACMA",0
13,"13004",1052,827,816,1,11,"PACMA",1
13,"13072",775,570,565,5,5,"PACMA",1
13,"13051",350,281,278,2,3,"PACMA",0
13,"13027",3446,2543,2498,15,45,"PACMA",9
13,"13048",515,418,416,3,2,"PACMA",1
13,"13070",765,612,605,4,7,"PACMA",2
13,"13904",527,411,406,8,5,"PACMA",3
13,"13049",814,585,579,0,6,"PACMA",2
13,"13059",204,156,156,1,0,"PACMA",0
13,"13056",11354,8732,8634,48,98,"PACMA",87
13,"13060",269,212,209,1,3,"PACMA",2
13,"13053",14389,10624,10521,79,103,"PACMA",82
13,"13025",302,250,246,0,4,"PACMA",0
13,"13002",1500,1003,993,9,10,"PACMA",1
13,"13078",9089,6661,6584,44,77,"PACMA",51
7,"7025",478,377,376,1,1,"PSOE",42
7,"7048",17339,10192,10101,104,91,"PSOE",2047
7,"7022",11575,7827,7730,85,97,"PSOE",1540
7,"7043",3422,2435,2410,13,25,"PSOE",301
7,"7051",5225,3322,3279,38,43,"PSOE",521
7,"7042",10666,7023,6967,59,56,"PSOE",1411
7,"7030",1573,1151,1129,10,22,"PSOE",111
7,"7039",4880,3473,3412,27,61,"PSOE",566
7,"7013",6832,4879,4775,34,104,"PSOE",568
7,"7036",26936,19563,19392,156,171,"PSOE",3054
7,"7003",11742,6924,6837,43,87,"PSOE",1293
7,"7014",7277,4301,4261,37,40,"PSOE",1201
7,"7062",7539,4371,4312,40,59,"PSOE",1095
7,"7024",7019,3579,3544,39,35,"PSOE",796
7,"7037",3232,1894,1881,16,13,"PSOE",349
7,"7016",2786,1992,1969,30,23,"PSOE",448
7,"7026",31158,18670,18537,161,133,"PSOE",4233
7,"7011",27781,18282,18180,135,102,"PSOE",4372
7,"7012",1877,1421,1408,13,13,"PSOE",204
7,"7056",5012,3632,3592,40,40,"PSOE",485
7,"7060",2577,1825,1807,20,18,"PSOE",229
7,"7027",20667,13784,13673,106,111,"PSOE",2978
7,"7053",1171,957,946,8,11,"PSOE",124
7,"7050",3321,2161,2134,33,27,"PSOE",234
7,"7058",2804,2138,2118,15,20,"PSOE",370
7,"7017",844,625,618,6,7,"PSOE",65
7,"7047",2236,1602,1584,7,18,"PSOE",181
7,"7057",7170,4736,4668,44,68,"PSOE",873
7,"7015",21076,13304,13169,162,135,"PSOE",1852
7,"7031",23747,15538,15401,130,137,"PSOE",3003
7,"7009",749,552,550,1,2,"PSOE",104
7,"7028",892,617,611,2,6,"PSOE",93
7,"7020",3597,2652,2622,27,30,"PSOE",309
7,"7035",1517,1188,1181,3,7,"PSOE",224
7,"7046",15649,9532,9443,70,89,"PSOE",2304
7,"7061",9831,6618,6546,54,72,"PSOE",1106
7,"7005",6659,4400,4357,23,43,"PSOE",970
7,"7006",5175,3559,3528,33,31,"PSOE",734
7,"7054",22371,12930,12779,104,151,"PSOE",2327
7,"7065",2079,1462,1451,13,11,"PSOE",124
7,"7021",234,188,188,0,0,"PSOE",17
7,"7049",1498,1080,1071,12,9,"PSOE",119
7,"7040",279737,181078,179570,1280,1508,"PSOE",31847
7,"7029",4137,3088,3048,34,40,"PSOE",777
7,"7018",389,271,265,3,6,"PSOE",37
7,"7032",20039,13156,13033,136,123,"PSOE",2596
7,"7044",8457,6079,5963,59,116,"PSOE",791
7,"7033",27017,16370,16205,143,165,"PSOE",2448
7,"7901",611,476,469,6,7,"PSOE",43
7,"7002",6367,4466,4401,36,65,"PSOE",816
7,"7010",4858,3518,3463,52,55,"PSOE",486
7,"7007",437,308,304,1,4,"PSOE",36
7,"7055",7474,4796,4740,48,56,"PSOE",845
7,"7004",3861,2657,2630,24,27,"PSOE",550
7,"7059",2998,2119,2084,11,35,"PSOE",420
7,"7008",5681,4203,4153,22,50,"PSOE",688
7,"7041",2039,1566,1540,5,26,"PSOE",135
7,"7019",192,146,146,0,0,"PSOE",8
7,"7034",991,774,765,2,9,"PSOE",93
7,"7045",1288,996,992,13,4,"PSOE",196
7,"7902",1072,730,712,18,18,"PSOE",151
7,"7052",4705,2993,2971,34,22,"PSOE",478
7,"7063",1420,1084,1072,8,12,"PSOE",103
7,"7064",5361,3588,3546,20,42,"PSOE",683
7,"7023",3628,2611,2573,45,38,"PSOE",475
7,"7038",2032,1515,1503,10,12,"PSOE",231
7,"7001",3556,2682,2657,21,25,"PSOE",649
7,"7024",7019,3579,3544,39,35,"PP",963
7,"7061",9831,6618,6546,54,72,"PP",2013
7,"7011",27781,18282,18180,135,102,"PP",5260
7,"7005",6659,4400,4357,23,43,"PP",1215
7,"7036",26936,19563,19392,156,171,"PP",5439
7,"7051",5225,3322,3279,38,43,"PP",1020
7,"7030",1573,1151,1129,10,22,"PP",379
7,"7057",7170,4736,4668,44,68,"PP",1833
7,"7037",3232,1894,1881,16,13,"PP",524
7,"7038",2032,1515,1503,10,12,"PP",497
7,"7055",7474,4796,4740,48,56,"PP",1736
7,"7002",6367,4466,4401,36,65,"PP",1412
7,"7006",5175,3559,3528,33,31,"PP",741
7,"7032",20039,13156,13033,136,123,"PP",3653
7,"7052",4705,2993,2971,34,22,"PP",809
7,"7064",5361,3588,3546,20,42,"PP",806
7,"7046",15649,9532,9443,70,89,"PP",2732
7,"7062",7539,4371,4312,40,59,"PP",1206
7,"7009",749,552,550,1,2,"PP",165
7,"7060",2577,1825,1807,20,18,"PP",617
7,"7041",2039,1566,1540,5,26,"PP",534
7,"7039",4880,3473,3412,27,61,"PP",1274
7,"7049",1498,1080,1071,12,9,"PP",354
7,"7047",2236,1602,1584,7,18,"PP",430
7,"7054",22371,12930,12779,104,151,"PP",4380
7,"7013",6832,4879,4775,34,104,"PP",2069
7,"7031",23747,15538,15401,130,137,"PP",4581
7,"7020",3597,2652,2622,27,30,"PP",633
7,"7014",7277,4301,4261,37,40,"PP",940
7,"7035",1517,1188,1181,3,7,"PP",418
7,"7021",234,188,188,0,0,"PP",77
7,"7901",611,476,469,6,7,"PP",187
7,"7033",27017,16370,16205,143,165,"PP",4586
7,"7050",3321,2161,2134,33,27,"PP",1168
7,"7012",1877,1421,1408,13,13,"PP",359
7,"7043",3422,2435,2410,13,25,"PP",861
7,"7058",2804,2138,2118,15,20,"PP",652
7,"7034",991,774,765,2,9,"PP",258
7,"7019",192,146,146,0,0,"PP",86
7,"7004",3861,2657,2630,24,27,"PP",752
7,"7040",279737,181078,179570,1280,1508,"PP",50423
7,"7044",8457,6079,5963,59,116,"PP",2054
7,"7029",4137,3088,3048,34,40,"PP",760
7,"7063",1420,1084,1072,8,12,"PP",409
7,"7045",1288,996,992,13,4,"PP",226
7,"7015",21076,13304,13169,162,135,"PP",3835
7,"7007",437,308,304,1,4,"PP",76
7,"7028",892,617,611,2,6,"PP",200
7,"7016",2786,1992,1969,30,23,"PP",494
7,"7056",5012,3632,3592,40,40,"PP",934
7,"7065",2079,1462,1451,13,11,"PP",500
7,"7023",3628,2611,2573,45,38,"PP",640
7,"7025",478,377,376,1,1,"PP",160
7,"7027",20667,13784,13673,106,111,"PP",4045
7,"7053",1171,957,946,8,11,"PP",332
7,"7059",2998,2119,2084,11,35,"PP",745
7,"7003",11742,6924,6837,43,87,"PP",1905
7,"7010",4858,3518,3463,52,55,"PP",1000
7,"7026",31158,18670,18537,161,133,"PP",4956
7,"7008",5681,4203,4153,22,50,"PP",1189
7,"7902",1072,730,712,18,18,"PP",237
7,"7042",10666,7023,6967,59,56,"PP",1710
7,"7018",389,271,265,3,6,"PP",60
7,"7001",3556,2682,2657,21,25,"PP",720
7,"7017",844,625,618,6,7,"PP",158
7,"7048",17339,10192,10101,104,91,"PP",2639
7,"7022",11575,7827,7730,85,97,"PP",2493
7,"7059",2998,2119,2084,11,35,"UPYD",5
7,"7012",1877,1421,1408,13,13,"UPYD",2
7,"7038",2032,1515,1503,10,12,"UPYD",4
7,"7042",10666,7023,6967,59,56,"UPYD",30
7,"7047",2236,1602,1584,7,18,"UPYD",7
7,"7065",2079,1462,1451,13,11,"UPYD",3
7,"7034",991,774,765,2,9,"UPYD",3
7,"7024",7019,3579,3544,39,35,"UPYD",15
7,"7009",749,552,550,1,2,"UPYD",1
7,"7014",7277,4301,4261,37,40,"UPYD",10
7,"7005",6659,4400,4357,23,43,"UPYD",16
7,"7037",3232,1894,1881,16,13,"UPYD",8
7,"7003",11742,6924,6837,43,87,"UPYD",28
7,"7026",31158,18670,18537,161,133,"UPYD",96
7,"7901",611,476,469,6,7,"UPYD",1
7,"7046",15649,9532,9443,70,89,"UPYD",41
7,"7055",7474,4796,4740,48,56,"UPYD",14
7,"7029",4137,3088,3048,34,40,"UPYD",6
7,"7051",5225,3322,3279,38,43,"UPYD",10
7,"7039",4880,3473,3412,27,61,"UPYD",6
7,"7016",2786,1992,1969,30,23,"UPYD",4
7,"7058",2804,2138,2118,15,20,"UPYD",6
7,"7022",11575,7827,7730,85,97,"UPYD",25
7,"7044",8457,6079,5963,59,116,"UPYD",14
7,"7004",3861,2657,2630,24,27,"UPYD",5
7,"7018",389,271,265,3,6,"UPYD",1
7,"7023",3628,2611,2573,45,38,"UPYD",9
7,"7025",478,377,376,1,1,"UPYD",2
7,"7010",4858,3518,3463,52,55,"UPYD",19
7,"7015",21076,13304,13169,162,135,"UPYD",50
7,"7030",1573,1151,1129,10,22,"UPYD",0
7,"7049",1498,1080,1071,12,9,"UPYD",4
7,"7063",1420,1084,1072,8,12,"UPYD",4
7,"7013",6832,4879,4775,34,104,"UPYD",18
7,"7902",1072,730,712,18,18,"UPYD",0
7,"7043",3422,2435,2410,13,25,"UPYD",1
7,"7033",27017,16370,16205,143,165,"UPYD",53
7,"7011",27781,18282,18180,135,102,"UPYD",85
7,"7050",3321,2161,2134,33,27,"UPYD",6
7,"7028",892,617,611,2,6,"UPYD",0
7,"7052",4705,2993,2971,34,22,"UPYD",11
7,"7006",5175,3559,3528,33,31,"UPYD",12
7,"7048",17339,10192,10101,104,91,"UPYD",42
7,"7064",5361,3588,3546,20,42,"UPYD",17
7,"7040",279737,181078,179570,1280,1508,"UPYD",1100
7,"7031",23747,15538,15401,130,137,"UPYD",80
7,"7007",437,308,304,1,4,"UPYD",1
7,"7017",844,625,618,6,7,"UPYD",2
7,"7027",20667,13784,13673,106,111,"UPYD",45
7,"7056",5012,3632,3592,40,40,"UPYD",10
7,"7045",1288,996,992,13,4,"UPYD",3
7,"7053",1171,957,946,8,11,"UPYD",2
7,"7062",7539,4371,4312,40,59,"UPYD",14
7,"7008",5681,4203,4153,22,50,"UPYD",14
7,"7061",9831,6618,6546,54,72,"UPYD",26
7,"7019",192,146,146,0,0,"UPYD",0
7,"7060",2577,1825,1807,20,18,"UPYD",7
7,"7057",7170,4736,4668,44,68,"UPYD",13
7,"7032",20039,13156,13033,136,123,"UPYD",54
7,"7041",2039,1566,1540,5,26,"UPYD",3
7,"7021",234,188,188,0,0,"UPYD",0
7,"7002",6367,4466,4401,36,65,"UPYD",21
7,"7054",22371,12930,12779,104,151,"UPYD",51
7,"7036",26936,19563,19392,156,171,"UPYD",112
7,"7001",3556,2682,2657,21,25,"UPYD",4
7,"7020",3597,2652,2622,27,30,"UPYD",6
7,"7035",1517,1188,1181,3,7,"UPYD",9
7,"7020",3597,2652,2622,27,30,"PACMA",18
7,"7017",844,625,618,6,7,"PACMA",7
7,"7901",611,476,469,6,7,"PACMA",4
7,"7035",1517,1188,1181,3,7,"PACMA",2
7,"7037",3232,1894,1881,16,13,"PACMA",22
7,"7038",2032,1515,1503,10,12,"PACMA",16
7,"7033",27017,16370,16205,143,165,"PACMA",157
7,"7010",4858,3518,3463,52,55,"PACMA",36
7,"7040",279737,181078,179570,1280,1508,"PACMA",2185
7,"7047",2236,1602,1584,7,18,"PACMA",8
7,"7041",2039,1566,1540,5,26,"PACMA",6
7,"7061",9831,6618,6546,54,72,"PACMA",31
7,"7009",749,552,550,1,2,"PACMA",4
7,"7023",3628,2611,2573,45,38,"PACMA",22
7,"7055",7474,4796,4740,48,56,"PACMA",32
7,"7039",4880,3473,3412,27,61,"PACMA",21
7,"7053",1171,957,946,8,11,"PACMA",12
7,"7049",1498,1080,1071,12,9,"PACMA",4
7,"7054",22371,12930,12779,104,151,"PACMA",164
7,"7002",6367,4466,4401,36,65,"PACMA",32
7,"7025",478,377,376,1,1,"PACMA",0
7,"7063",1420,1084,1072,8,12,"PACMA",14
7,"7036",26936,19563,19392,156,171,"PACMA",261
7,"7045",1288,996,992,13,4,"PACMA",8
7,"7044",8457,6079,5963,59,116,"PACMA",37
7,"7005",6659,4400,4357,23,43,"PACMA",34
7,"7024",7019,3579,3544,39,35,"PACMA",40
7,"7015",21076,13304,13169,162,135,"PACMA",99
7,"7003",11742,6924,6837,43,87,"PACMA",65
7,"7065",2079,1462,1451,13,11,"PACMA",11
7,"7046",15649,9532,9443,70,89,"PACMA",121
7,"7014",7277,4301,4261,37,40,"PACMA",32
7,"7051",5225,3322,3279,38,43,"PACMA",29
7,"7052",4705,2993,2971,34,22,"PACMA",23
7,"7050",3321,2161,2134,33,27,"PACMA",13
7,"7027",20667,13784,13673,106,111,"PACMA",145
7,"7028",892,617,611,2,6,"PACMA",9
7,"7011",27781,18282,18180,135,102,"PACMA",171
7,"7048",17339,10192,10101,104,91,"PACMA",119
7,"7064",5361,3588,3546,20,42,"PACMA",45
7,"7004",3861,2657,2630,24,27,"PACMA",26
7,"7030",1573,1151,1129,10,22,"PACMA",2
7,"7013",6832,4879,4775,34,104,"PACMA",39
7,"7058",2804,2138,2118,15,20,"PACMA",20
7,"7008",5681,4203,4153,22,50,"PACMA",31
7,"7001",3556,2682,2657,21,25,"PACMA",11
7,"7031",23747,15538,15401,130,137,"PACMA",183
7,"7006",5175,3559,3528,33,31,"PACMA",14
7,"7016",2786,1992,1969,30,23,"PACMA",15
7,"7007",437,308,304,1,4,"PACMA",3
7,"7057",7170,4736,4668,44,68,"PACMA",31
7,"7019",192,146,146,0,0,"PACMA",0
7,"7026",31158,18670,18537,161,133,"PACMA",264
7,"7062",7539,4371,4312,40,59,"PACMA",33
7,"7056",5012,3632,3592,40,40,"PACMA",41
7,"7034",991,774,765,2,9,"PACMA",5
7,"7022",11575,7827,7730,85,97,"PACMA",53
7,"7029",4137,3088,3048,34,40,"PACMA",24
7,"7012",1877,1421,1408,13,13,"PACMA",11
7,"7032",20039,13156,13033,136,123,"PACMA",124
7,"7059",2998,2119,2084,11,35,"PACMA",20
7,"7042",10666,7023,6967,59,56,"PACMA",54
7,"7018",389,271,265,3,6,"PACMA",2
7,"7021",234,188,188,0,0,"PACMA",0
7,"7902",1072,730,712,18,18,"PACMA",4
7,"7043",3422,2435,2410,13,25,"PACMA",17
7,"7060",2577,1825,1807,20,18,"PACMA",15
30,"30003",24305,16558,16419,122,139,"UPYD",85
30,"30029",11815,8365,8296,67,69,"UPYD",36
30,"30005",29559,21408,21203,123,205,"UPYD",160
30,"30014",1598,1270,1258,5,12,"UPYD",4
30,"30038",15381,10881,10797,51,84,"UPYD",59
30,"30028",6690,5005,4938,29,67,"UPYD",17
30,"30002",9921,7263,7166,34,97,"UPYD",52
30,"30025",4900,3777,3727,20,50,"UPYD",23
30,"30004",1141,938,933,5,5,"UPYD",2
30,"30007",6415,4554,4515,19,39,"UPYD",25
30,"30020",6261,4502,4459,25,43,"UPYD",11
30,"30006",803,683,681,2,2,"UPYD",2
30,"30019",25921,18079,17894,121,185,"UPYD",117
30,"30037",18726,13183,13027,73,156,"UPYD",83
30,"30013",7395,5320,5277,38,43,"UPYD",19
30,"30042",1918,1518,1500,6,18,"UPYD",7
30,"30022",16894,11661,11498,119,163,"UPYD",78
30,"30012",9101,7170,7091,46,79,"UPYD",26
30,"30024",58529,42392,42072,275,320,"UPYD",170
30,"30021",9101,6106,6034,25,72,"UPYD",31
30,"30039",19199,13538,13405,101,133,"UPYD",71
30,"30009",12392,9724,9599,40,125,"UPYD",54
30,"30001",4596,3602,3572,20,30,"UPYD",10
30,"30034",1138,859,846,5,13,"UPYD",4
30,"30040",727,627,620,1,7,"UPYD",1
30,"30030",312625,235232,233576,1438,1656,"UPYD",2361
30,"30023",3762,2871,2837,14,34,"UPYD",7
30,"30032",2849,2188,2161,10,27,"UPYD",4
30,"30901",10331,7925,7833,54,92,"UPYD",58
30,"30902",8022,5454,5412,34,42,"UPYD",43
30,"30027",47867,36054,35794,181,260,"UPYD",362
30,"30011",4706,3582,3541,20,41,"UPYD",12
30,"30010",6861,5287,5220,38,67,"UPYD",14
30,"30008",13860,10066,9945,74,121,"UPYD",58
30,"30018",7903,5990,5912,29,78,"UPYD",41
30,"30031",498,424,421,2,3,"UPYD",0
30,"30033",10144,7591,7505,86,86,"UPYD",30
30,"30015",19154,13947,13835,77,112,"UPYD",46
30,"30036",14624,10139,9988,70,151,"UPYD",42
30,"30016",151577,103359,102538,620,821,"UPYD",870
30,"30043",24972,19411,19139,154,272,"UPYD",90
30,"30017",11635,8718,8646,46,72,"UPYD",25
30,"30041",13640,9156,9092,52,64,"UPYD",61
30,"30035",18616,13185,13085,70,100,"UPYD",88
30,"30026",15722,10147,10024,49,123,"UPYD",59
35,"35002",23129,15904,15675,74,229,"PCPC",17
35,"35010",3548,2371,2336,20,35,"PCPC",2
35,"35006",30302,21967,21625,243,342,"PCPC",29
35,"35026",80806,53749,52665,450,1084,"PCPC",123
35,"35009",19832,14305,14036,97,269,"PCPC",28
35,"35018",12463,7628,7546,56,82,"PCPC",9
35,"35028",9705,5552,5478,64,74,"PCPC",8
35,"35034",7707,3921,3872,30,49,"PCPC",5
35,"35020",6054,4073,4018,26,55,"PCPC",10
35,"35001",4599,3455,3396,27,59,"PCPC",6
35,"35004",38814,20869,20641,192,228,"PCPC",32
35,"35023",11680,8467,8295,75,172,"PCPC",16
35,"35019",32253,19902,19621,126,281,"PCPC",28
35,"35032",3432,2541,2498,19,43,"PCPC",2
35,"35005",1071,718,711,6,7,"PCPC",4
35,"35022",48059,30474,30134,219,340,"PCPC",56
35,"35012",10331,5684,5610,32,74,"PCPC",9
35,"35031",7270,5184,5000,36,184,"PCPC",9
35,"35027",10311,7497,7364,58,133,"PCPC",13
35,"35025",1801,1239,1216,9,23,"PCPC",2
35,"35013",6609,4997,4881,51,116,"PCPC",3
35,"35015",9870,5451,5368,29,83,"PCPC",14
35,"35029",4125,2545,2514,34,31,"PCPC",0
35,"35003",5125,2989,2929,21,60,"PCPC",2
35,"35017",25447,15415,15079,127,336,"PCPC",30
35,"35014",11169,6234,6107,59,127,"PCPC",10
35,"35024",13621,8665,8555,76,110,"PCPC",2
35,"35016",297974,198159,195935,1546,2224,"PCPC",415
35,"35030",9205,5602,5501,58,101,"PCPC",11
35,"35033",6378,4412,4354,24,58,"PCPC",4
35,"35021",14942,10691,10537,80,154,"PCPC",22
35,"35007",515,332,330,2,2,"PCPC",3
35,"35008",6109,4631,4542,37,89,"PCPC",3
35,"35011",23882,16369,16095,107,274,"PCPC",26
50,"50263",197,123,121,6,2,"C's",11
50,"50225",1568,996,985,2,11,"C's",111
50,"50057",1396,980,972,8,8,"C's",173
50,"50136",579,420,413,0,7,"C's",60
50,"50025",4547,3335,3295,45,40,"C's",552
50,"50035",74,53,52,0,1,"C's",1
50,"50064",440,350,349,5,1,"C's",18
50,"50259",89,61,61,1,0,"C's",9
50,"50155",102,78,78,0,0,"C's",13
50,"50261",215,159,159,1,0,"C's",11
50,"50109",105,78,77,3,1,"C's",22
50,"50042",16,13,13,0,0,"C's",0
50,"50098",181,129,127,2,2,"C's",9
50,"50275",110,73,72,0,1,"C's",4
50,"50105",304,228,228,3,0,"C's",17
50,"50231",260,213,210,7,3,"C's",23
50,"50149",36,23,23,0,0,"C's",1
50,"50164",395,263,260,2,3,"C's",38
50,"50151",650,504,503,7,1,"C's",59
50,"50005",234,178,178,1,0,"C's",32
50,"50206",466,379,376,2,3,"C's",49
50,"50156",214,173,170,2,3,"C's",17
50,"50193",647,514,506,1,8,"C's",77
50,"50203",1043,811,802,15,9,"C's",124
50,"50119",930,698,691,7,7,"C's",106
50,"50093",94,73,73,1,0,"C's",8
50,"50050",98,59,59,3,0,"C's",5
50,"50258",56,34,34,1,0,"C's",6
50,"50264",158,111,111,0,0,"C's",8
50,"50252",5178,3746,3711,36,35,"C's",535
50,"50224",69,55,55,1,0,"C's",2
50,"50260",35,32,32,0,0,"C's",1
50,"50293",423,282,280,5,2,"C's",18
50,"50200",509,406,404,6,2,"C's",75
50,"50227",108,79,79,1,0,"C's",6
50,"50076",81,64,64,0,0,"C's",6
50,"50007",46,37,37,1,0,"C's",4
50,"50128",28,24,24,0,0,"C's",1
50,"50172",196,138,136,0,2,"C's",19
50,"50237",103,73,73,2,0,"C's",5
50,"50285",648,473,469,3,4,"C's",67
50,"50180",120,97,96,0,1,"C's",7
50,"50130",395,252,252,1,0,"C's",34
50,"50176",228,158,157,0,1,"C's",17
50,"50174",92,70,70,0,0,"C's",3
50,"50044",232,156,156,1,0,"C's",9
50,"50056",406,325,324,2,1,"C's",49
50,"50080",32,25,25,0,0,"C's",2
50,"50268",47,40,39,0,1,"C's",3
50,"50902",87,78,78,1,0,"C's",7
50,"50027",227,177,176,1,1,"C's",19
50,"50187",70,38,38,0,0,"C's",1
50,"50903",2225,1686,1669,21,17,"C's",277
50,"50228",270,211,210,5,1,"C's",38
50,"50023",223,175,173,3,2,"C's",17
50,"50063",61,57,57,0,0,"C's",1
50,"50272",12913,9500,9415,80,85,"C's",2057
50,"50254",181,130,129,2,1,"C's",13
50,"50184",113,82,82,0,0,"C's",8
50,"50075",81,59,59,1,0,"C's",1
50,"50212",41,37,37,0,0,"C's",5
50,"50169",362,264,262,0,2,"C's",23
50,"50175",1025,745,739,6,6,"C's",82
50,"50087",28,19,19,0,0,"C's",3
50,"50115",3248,2277,2262,31,15,"C's",345
50,"50054",59,45,45,0,0,"C's",4
50,"50036",103,79,79,0,0,"C's",6
50,"50165",1815,1333,1316,27,17,"C's",199
50,"50196",108,83,82,1,1,"C's",10
50,"50159",670,511,501,5,10,"C's",34
50,"50220",46,32,32,0,0,"C's",4
50,"50207",109,88,88,1,0,"C's",11
50,"50017",1772,1301,1293,7,8,"C's",263
50,"50230",1176,853,849,11,4,"C's",72
50,"50041",12,10,10,0,0,"C's",0
50,"50047",50,32,32,1,0,"C's",3
50,"50289",52,39,39,1,0,"C's",1
50,"50154",119,92,91,0,1,"C's",13
50,"50055",3612,2533,2490,34,43,"C's",407
50,"50032",273,190,189,0,1,"C's",10
50,"50255",214,163,163,0,0,"C's",4
50,"50245",90,60,60,1,0,"C's",8
50,"50194",84,52,52,0,0,"C's",7
50,"50045",1255,944,934,6,10,"C's",105
50,"50113",618,506,496,4,10,"C's",31
50,"50290",387,288,287,4,1,"C's",27
50,"50067",14055,10236,10109,123,127,"C's",1777
50,"50287",274,197,195,4,2,"C's",18
50,"50153",941,737,734,7,3,"C's",61
50,"50189",712,574,559,4,15,"C's",56
50,"50170",378,286,283,2,3,"C's",32
50,"50269",288,185,183,0,2,"C's",17
50,"50250",55,44,44,0,0,"C's",3
50,"50270",38,24,24,2,0,"C's",1
50,"50106",135,105,104,0,1,"C's",13
50,"50192",236,185,183,2,2,"C's",18
50,"50202",158,96,92,1,4,"C's",4
50,"50026",442,358,353,6,5,"C's",33
50,"50013",224,187,186,3,1,"C's",9
50,"50078",244,192,189,1,3,"C's",10
50,"50085",176,131,129,3,2,"C's",6
50,"50281",80,57,56,0,1,"C's",9
50,"50208",1802,1349,1332,16,17,"C's",178
50,"50088",305,234,229,11,5,"C's",11
50,"50188",30,23,19,0,4,"C's",0
50,"50274",71,50,49,1,1,"C's",6
50,"50072",174,124,122,2,2,"C's",15
50,"50040",92,75,75,0,0,"C's",9
50,"50108",47,37,37,0,0,"C's",4
50,"50244",205,157,157,3,0,"C's",26
50,"50137",1025,793,786,6,7,"C's",96
50,"50020",822,560,555,5,5,"C's",70
50,"50140",165,106,106,0,0,"C's",15
50,"50034",838,572,569,5,3,"C's",83
50,"50265",62,41,41,0,0,"C's",2
50,"50291",100,69,69,0,0,"C's",3
50,"50201",443,335,330,2,5,"C's",64
50,"50006",939,712,701,8,11,"C's",106
50,"50197",92,71,71,2,0,"C's",3
50,"50282",70,48,48,0,0,"C's",9
50,"50011",127,96,96,2,0,"C's",8
50,"50135",95,63,63,0,0,"C's",1
50,"50296",398,297,293,2,4,"C's",49
50,"50276",129,108,107,0,1,"C's",10
50,"50279",87,62,62,1,0,"C's",1
50,"50039",507,400,398,3,2,"C's",24
50,"50211",252,187,186,0,1,"C's",19
50,"50053",688,535,522,6,13,"C's",36
50,"50090",156,112,111,0,1,"C's",16
50,"50033",75,65,65,0,0,"C's",7
50,"50191",476,327,325,3,2,"C's",35
50,"50117",125,91,90,1,1,"C's",9
50,"50099",3087,2233,2216,15,17,"C's",285
50,"50019",54,41,41,0,0,"C's",3
50,"50222",1647,1135,1118,8,17,"C's",124
50,"50247",827,624,615,10,9,"C's",134
50,"50162",147,110,110,2,0,"C's",11
50,"50143",569,414,411,4,3,"C's",53
50,"50058",72,51,51,0,0,"C's",6
50,"50288",3371,2566,2547,26,19,"C's",635
50,"50061",207,174,168,1,6,"C's",7
50,"50068",1998,1388,1378,17,10,"C's",172
50,"50295",45,39,39,0,0,"C's",8
50,"50234",245,198,193,9,5,"C's",33
50,"50082",89,58,57,0,1,"C's",6
50,"50010",69,57,57,0,0,"C's",9
50,"50095",12366,8938,8856,94,82,"C's",963
50,"50213",98,77,72,0,5,"C's",6
50,"50111",186,152,151,1,1,"C's",13
50,"50052",90,71,71,0,0,"C's",9
50,"50086",184,128,128,1,0,"C's",11
50,"50021",32,25,25,3,0,"C's",3
50,"50024",589,461,459,4,2,"C's",42
50,"50083",90,72,72,1,0,"C's",7
50,"50004",534,406,401,0,5,"C's",54
50,"50069",76,53,52,0,1,"C's",16
50,"50138",46,41,41,0,0,"C's",4
50,"50235",2323,1687,1675,7,12,"C's",307
50,"50014",146,99,99,1,0,"C's",12
50,"50160",2245,1661,1648,10,13,"C's",189
50,"50204",2457,1830,1816,14,14,"C's",168
50,"50298",5353,4051,4013,32,38,"C's",737
50,"50286",77,54,54,0,0,"C's",13
50,"50217",455,334,334,1,0,"C's",20
50,"50280",340,260,258,0,2,"C's",42
50,"50029",627,469,468,4,1,"C's",42
50,"50236",104,82,82,2,0,"C's",3
50,"50077",226,175,174,5,1,"C's",13
50,"50121",276,227,225,4,2,"C's",14
50,"50215",23,15,15,0,0,"C's",0
50,"50084",79,56,56,1,0,"C's",3
50,"50257",178,139,137,0,2,"C's",13
50,"50002",148,105,102,0,3,"C's",12
50,"50284",151,115,113,0,2,"C's",13
50,"50003",126,93,92,3,1,"C's",10
50,"50168",28,23,23,0,0,"C's",1
50,"50125",371,260,258,3,2,"C's",19
50,"50223",915,747,741,8,6,"C's",74
50,"50277",55,43,43,1,0,"C's",0
50,"50122",68,54,54,2,0,"C's",2
50,"50118",2179,1575,1564,7,11,"C's",133
50,"50147",788,577,576,4,1,"C's",46
50,"50239",64,47,47,1,0,"C's",3
50,"50248",521,407,406,1,1,"C's",54
50,"50048",35,23,23,0,0,"C's",0
50,"50144",36,28,28,0,0,"C's",3
50,"50278",198,145,144,1,1,"C's",18
50,"50173",210,141,140,2,1,"C's",10
50,"50163",3655,2766,2740,34,26,"C's",673
50,"50166",260,192,189,2,3,"C's",18
50,"50131",237,168,167,2,1,"C's",14
50,"50008",5085,3617,3574,30,43,"C's",503
50,"50031",161,90,88,1,2,"C's",1
50,"50126",2388,1726,1708,22,18,"C's",243
50,"50283",72,55,54,0,1,"C's",3
50,"50167",232,194,193,0,1,"C's",19
50,"50221",33,20,20,0,0,"C's",4
50,"50101",879,615,609,5,6,"C's",66
50,"50120",49,36,36,3,0,"C's",6
50,"50249",312,235,233,1,2,"C's",25
50,"50161",117,76,76,0,0,"C's",8
50,"50132",755,573,564,7,9,"C's",113
50,"50094",1626,1197,1178,22,19,"C's",122
50,"50091",48,32,32,1,0,"C's",3
50,"50146",190,137,137,5,0,"C's",9
50,"50070",60,29,29,1,0,"C's",0
50,"50198",56,30,30,0,0,"C's",5
50,"50901",137,101,101,0,0,"C's",15
50,"50253",423,328,327,1,1,"C's",37
50,"50294",73,58,58,0,0,"C's",7
50,"50178",302,197,196,9,1,"C's",29
50,"50133",117,88,88,3,0,"C's",3
50,"50071",131,90,90,0,0,"C's",5
50,"50216",236,189,186,4,3,"C's",18
50,"50186",41,29,29,0,0,"C's",3
50,"50182",3352,2437,2409,26,28,"C's",584
50,"50185",132,110,110,1,0,"C's",8
50,"50179",257,207,207,2,0,"C's",12
50,"50092",298,256,251,3,5,"C's",45
50,"50065",53,42,42,0,0,"C's",9
50,"50183",338,255,255,0,0,"C's",49
50,"50292",132,103,103,0,0,"C's",11
50,"50209",2560,1787,1774,12,13,"C's",348
50,"50062",1810,1407,1389,12,18,"C's",248
50,"50116",190,142,140,1,2,"C's",8
50,"50030",225,156,156,2,0,"C's",8
50,"50129",245,164,164,1,0,"C's",13
50,"50199",341,242,241,4,1,"C's",20
50,"50251",8300,6228,6167,62,61,"C's",1010
50,"50079",254,186,184,3,2,"C's",22
50,"50001",115,81,80,0,1,"C's",7
50,"50096",39,17,17,0,0,"C's",1
50,"50074",6397,4512,4408,38,104,"C's",812
50,"50195",53,38,38,0,0,"C's",4
50,"50262",1187,931,930,13,1,"C's",122
50,"50139",319,239,238,2,1,"C's",17
50,"50107",944,772,767,16,5,"C's",127
50,"50123",465,349,344,2,5,"C's",44
50,"50177",315,251,249,3,2,"C's",26
50,"50110",369,258,257,0,1,"C's",42
50,"50267",605,424,420,4,4,"C's",32
50,"50060",176,138,136,0,2,"C's",19
50,"50102",863,665,654,6,11,"C's",97
50,"50181",1003,750,737,9,13,"C's",69
50,"50043",257,172,171,1,1,"C's",26
50,"50051",828,640,637,8,3,"C's",44
50,"50059",780,572,567,6,5,"C's",72
50,"50256",84,46,46,0,0,"C's",4
50,"50271",256,187,184,4,3,"C's",26
50,"50081",512,376,372,6,4,"C's",28
50,"50240",1034,749,737,10,12,"C's",98
50,"50243",340,259,254,1,5,"C's",42
50,"50016",52,37,37,0,0,"C's",2
50,"50104",351,283,282,3,1,"C's",39
50,"50157",301,211,207,2,4,"C's",11
50,"50009",106,78,77,1,1,"C's",9
50,"50238",97,74,73,0,1,"C's",15
50,"50232",171,120,118,0,2,"C's",3
50,"50015",98,63,63,0,0,"C's",7
50,"50218",113,90,89,1,1,"C's",9
50,"50266",129,85,85,1,0,"C's",4
50,"50037",139,92,91,1,1,"C's",6
50,"50241",593,426,418,1,8,"C's",43
50,"50150",660,402,402,3,0,"C's",56
50,"50152",1457,1032,1018,11,14,"C's",115
50,"50022",543,410,398,8,12,"C's",41
50,"50038",1511,1167,1159,13,8,"C's",94
50,"50141",114,85,84,0,1,"C's",7
50,"50210",40,32,31,0,1,"C's",5
50,"50142",30,21,21,0,0,"C's",1
50,"50073",2148,1649,1622,9,27,"C's",207
50,"50171",108,70,69,0,1,"C's",10
50,"50219",4098,3010,2980,27,30,"C's",665
50,"50273",31,18,18,0,0,"C's",2
50,"50205",91,69,65,1,4,"C's",10
50,"50233",114,81,81,1,0,"C's",18
50,"50242",92,81,79,1,2,"C's",6
50,"50114",124,94,94,2,0,"C's",13
50,"50297",499531,377882,375565,3049,2317,"C's",70642
50,"50229",64,42,42,0,0,"C's",6
50,"50246",41,29,29,0,0,"C's",1
50,"50190",708,542,539,3,3,"C's",55
50,"50066",2613,1956,1951,21,5,"C's",447
50,"50012",108,86,83,1,3,"C's",3
50,"50028",78,53,53,2,0,"C's",8
50,"50214",27,16,16,1,0,"C's",0
50,"50018",948,717,712,6,5,"C's",56
50,"50124",417,312,312,9,0,"C's",52
50,"50046",176,123,123,7,0,"C's",14
50,"50148",324,240,236,0,4,"C's",19
50,"50089",8144,6285,6249,50,36,"C's",1852
50,"50100",333,263,261,5,2,"C's",17
50,"50134",128,88,88,5,0,"C's",11
9,"9025",125,86,79,1,7,"C´s",8
9,"9430",24,19,19,0,0,"C´s",2
9,"9276",387,280,273,2,7,"C´s",32
9,"9208",211,139,136,3,3,"C´s",12
9,"9351",60,46,45,1,1,"C´s",6
9,"9225",84,57,56,1,1,"C´s",2
9,"9372",221,190,189,1,1,"C´s",38
9,"9046",30,26,26,0,0,"C´s",2
9,"9447",42,38,38,0,0,"C´s",4
9,"9412",803,552,550,2,2,"C´s",53
9,"9386",58,44,43,2,1,"C´s",5
9,"9101",79,59,59,0,0,"C´s",4
9,"9422",18,10,10,0,0,"C´s",1
9,"9239",53,44,42,1,2,"C´s",5
9,"9261",463,339,330,8,9,"C´s",56
9,"9340",76,49,49,0,0,"C´s",7
9,"9036",38,31,30,2,1,"C´s",6
9,"9148",86,73,69,5,4,"C´s",6
9,"9247",23,19,19,0,0,"C´s",1
9,"9361",117,96,96,0,0,"C´s",8
9,"9027",47,44,41,0,3,"C´s",1
9,"9202",24,22,22,1,0,"C´s",2
9,"9418",82,63,62,3,1,"C´s",7
9,"9391",361,264,263,2,1,"C´s",20
9,"9109",1068,698,669,10,29,"C´s",72
9,"9137",167,128,128,1,0,"C´s",18
9,"9368",22,14,14,1,0,"C´s",2
9,"9057",144,116,115,0,1,"C´s",14
9,"9288",91,70,69,1,1,"C´s",8
9,"9079",46,40,37,0,3,"C´s",3
9,"9180",136,102,100,2,2,"C´s",18
9,"9482",34,29,28,0,1,"C´s",3
9,"9411",149,111,111,0,0,"C´s",7
9,"9323",64,47,47,0,0,"C´s",7
9,"9122",96,66,66,0,0,"C´s",7
9,"9325",195,125,123,2,2,"C´s",10
9,"9114",87,67,67,0,0,"C´s",13
9,"9442",380,287,282,2,5,"C´s",31
9,"9052",31,22,21,1,1,"C´s",5
9,"9330",1523,1166,1148,15,18,"C´s",163
9,"9256",362,261,255,2,6,"C´s",27
9,"9221",445,337,335,1,2,"C´s",60
9,"9164",165,121,121,1,0,"C´s",19
9,"9354",33,30,30,1,0,"C´s",1
9,"9232",151,125,124,2,1,"C´s",6
9,"9380",78,59,57,0,2,"C´s",6
9,"9215",377,264,260,0,4,"C´s",35
9,"9128",82,66,66,0,0,"C´s",8
9,"9179",43,35,34,0,1,"C´s",3
9,"9083",37,33,33,0,0,"C´s",2
9,"9419",78,45,44,0,1,"C´s",3
9,"9302",116,87,87,0,0,"C´s",17
9,"9407",27,23,23,1,0,"C´s",1
9,"9112",113,75,73,2,2,"C´s",6
9,"9098",516,396,388,6,8,"C´s",44
9,"9403",96,78,76,1,2,"C´s",12
9,"9231",70,49,49,3,0,"C´s",7
9,"9217",361,265,261,4,4,"C´s",28
9,"9108",378,290,287,2,3,"C´s",36
9,"9358",249,191,191,1,0,"C´s",17
9,"9433",60,52,51,0,1,"C´s",0
9,"9405",128,89,89,0,0,"C´s",7
9,"9229",201,146,145,0,1,"C´s",8
9,"9194",2024,1550,1530,17,20,"C´s",220
9,"9093",154,133,128,1,5,"C´s",25
9,"9045",267,186,183,2,3,"C´s",20
9,"9374",90,79,77,2,2,"C´s",15
9,"9023",1096,848,840,9,8,"C´s",205
9,"9259",233,184,184,3,0,"C´s",21
9,"9078",41,35,33,0,2,"C´s",3
9,"9048",1484,1120,1106,4,14,"C´s",120
9,"9163",602,479,472,5,7,"C´s",61
9,"9314",95,80,79,1,1,"C´s",8
9,"9409",109,87,87,0,0,"C´s",11
9,"9294",111,88,86,0,2,"C´s",5
9,"9067",442,308,303,9,5,"C´s",26
9,"9297",323,265,261,5,4,"C´s",50
9,"9100",59,51,50,0,1,"C´s",5
9,"9375",35,27,27,0,0,"C´s",8
9,"9414",201,148,147,1,1,"C´s",22
9,"9363",974,730,725,3,5,"C´s",105
9,"9117",77,61,57,0,4,"C´s",5
9,"9255",86,66,62,0,4,"C´s",9
9,"9220",76,62,61,2,1,"C´s",8
9,"9478",45,38,38,0,0,"C´s",3
9,"9044",46,38,37,0,1,"C´s",8
9,"9476",63,46,46,0,0,"C´s",5
9,"9054",100,73,72,3,1,"C´s",6
9,"9183",51,37,37,0,0,"C´s",3
9,"9472",55,40,40,0,0,"C´s",5
9,"9238",932,576,569,6,7,"C´s",64
9,"9127",55,40,40,0,0,"C´s",3
9,"9304",202,166,163,1,3,"C´s",26
9,"9335",87,72,71,0,1,"C´s",7
9,"9012",93,68,66,1,2,"C´s",7
9,"9018",24702,18365,18158,174,207,"C´s",2993
9,"9443",183,132,129,1,3,"C´s",15
9,"9266",91,72,70,0,2,"C´s",3
9,"9115",92,69,68,0,1,"C´s",1
9,"9395",136,96,95,0,1,"C´s",8
9,"9039",58,38,38,0,0,"C´s",4
9,"9201",30,17,17,0,0,"C´s",1
9,"9427",1428,1014,1003,12,11,"C´s",139
9,"9480",110,89,88,1,1,"C´s",15
9,"9473",85,62,61,1,1,"C´s",5
9,"9090",57,51,51,1,0,"C´s",6
9,"9398",75,54,54,1,0,"C´s",2
9,"9176",61,45,44,0,1,"C´s",1
9,"9464",36,24,24,0,0,"C´s",3
9,"9346",93,71,69,0,2,"C´s",11
9,"9448",216,180,178,1,2,"C´s",15
9,"9445",44,32,32,1,0,"C´s",0
9,"9904",482,389,384,5,5,"C´s",62
9,"9317",16,14,14,0,0,"C´s",0
9,"9306",113,91,91,1,0,"C´s",7
9,"9308",67,43,43,1,0,"C´s",9
9,"9458",466,380,377,3,3,"C´s",96
9,"9273",53,41,40,1,1,"C´s",5
9,"9198",108,86,85,2,1,"C´s",8
9,"9230",38,31,31,0,0,"C´s",4
9,"9058",393,293,289,2,4,"C´s",57
9,"9086",687,475,471,0,4,"C´s",111
9,"9312",98,83,82,0,1,"C´s",11
9,"9041",28,28,28,1,0,"C´s",3
9,"9277",119,101,100,0,1,"C´s",6
9,"9007",59,41,41,0,0,"C´s",7
9,"9062",51,44,44,1,0,"C´s",6
9,"9216",385,283,280,8,3,"C´s",27
9,"9423",27,25,25,0,0,"C´s",2
9,"9103",221,185,184,2,1,"C´s",9
9,"9094",51,42,41,0,1,"C´s",4
9,"9908",469,314,309,2,5,"C´s",35
9,"9173",123,93,93,1,0,"C´s",13
9,"9047",56,45,45,2,0,"C´s",5
9,"9160",90,71,70,0,1,"C´s",8
9,"9035",313,243,240,0,3,"C´s",34
9,"9236",38,32,32,0,0,"C´s",1
9,"9444",72,48,48,2,0,"C´s",3
9,"9425",514,369,366,2,3,"C´s",29
9,"9032",108,73,73,0,0,"C´s",7
9,"9242",81,65,63,2,2,"C´s",3
9,"9903",3251,2359,2340,24,19,"C´s",392
9,"9017",89,67,62,0,5,"C´s",2
9,"9172",125,102,102,2,0,"C´s",8
9,"9140",128,88,87,0,1,"C´s",8
9,"9392",53,40,40,0,0,"C´s",3
9,"9214",684,452,446,6,6,"C´s",39
9,"9248",78,57,57,0,0,"C´s",11
9,"9190",91,56,55,0,1,"C´s",7
9,"9251",371,273,271,3,2,"C´s",35
9,"9213",320,223,220,4,3,"C´s",20
9,"9191",39,32,30,0,2,"C´s",1
9,"9209",4511,3368,3301,37,67,"C´s",482
9,"9352",116,97,97,0,0,"C´s",18
9,"9365",31,20,20,0,0,"C´s",2
9,"9309",306,216,211,2,5,"C´s",21
9,"9034",280,237,233,5,4,"C´s",38
9,"9434",1221,985,970,10,15,"C´s",229
9,"9265",38,31,31,0,0,"C´s",4
9,"9051",168,133,132,1,1,"C´s",16
9,"9362",204,168,164,0,4,"C´s",28
9,"9226",66,55,53,0,2,"C´s",5
9,"9050",72,54,54,0,0,"C´s",1
9,"9134",228,152,152,2,0,"C´s",18
9,"9905",391,308,308,5,0,"C´s",33
9,"9143",27,20,20,0,0,"C´s",1
9,"9339",128,103,103,0,0,"C´s",11
9,"9451",238,199,198,1,1,"C´s",15
9,"9280",27,17,17,0,0,"C´s",1
9,"9200",48,37,36,0,1,"C´s",2
9,"9410",3051,2169,2153,18,16,"C´s",167
9,"9033",89,75,75,0,0,"C´s",2
9,"9060",148,123,123,0,0,"C´s",11
9,"9355",101,75,73,0,2,"C´s",7
9,"9483",212,161,161,1,0,"C´s",17
9,"9102",37,31,31,0,0,"C´s",3
9,"9315",379,269,267,2,2,"C´s",63
9,"9125",596,435,433,3,2,"C´s",47
9,"9133",40,34,34,0,0,"C´s",5
9,"9906",1223,952,947,9,5,"C´s",148
9,"9228",163,138,138,0,0,"C´s",16
9,"9311",60,52,50,0,2,"C´s",3
9,"9020",262,187,180,2,7,"C´s",23
9,"9159",56,48,48,1,0,"C´s",2
9,"9337",115,84,82,0,2,"C´s",7
9,"9429",56,41,41,0,0,"C´s",5
9,"9334",48,39,38,0,1,"C´s",2
9,"9113",464,383,376,6,7,"C´s",60
9,"9130",79,63,62,1,1,"C´s",5
9,"9460",177,135,135,2,0,"C´s",15
9,"9389",77,56,56,0,0,"C´s",2
9,"9347",141,113,109,4,4,"C´s",15
9,"9408",41,34,34,1,0,"C´s",2
9,"9901",374,268,261,3,7,"C´s",46
9,"9084",189,150,148,7,2,"C´s",11
9,"9072",307,240,239,1,1,"C´s",44
9,"9010",32,23,23,2,0,"C´s",1
9,"9907",1420,1120,1115,13,5,"C´s",226
9,"9169",99,83,81,0,2,"C´s",9
9,"9003",192,148,146,2,2,"C´s",10
9,"9182",78,63,61,2,2,"C´s",5
9,"9167",59,42,42,2,0,"C´s",4
9,"9174",809,575,565,10,10,"C´s",59
9,"9381",32,23,22,0,1,"C´s",2
9,"9413",447,333,333,5,0,"C´s",39
9,"9135",41,33,33,1,0,"C´s",1
9,"9129",105,87,87,0,0,"C´s",8
9,"9353",73,57,56,0,1,"C´s",13
9,"9432",189,143,140,1,3,"C´s",11
9,"9350",480,358,347,5,11,"C´s",51
9,"9298",82,62,62,0,0,"C´s",11
9,"9441",74,66,66,0,0,"C´s",6
9,"9063",213,184,182,2,2,"C´s",37
9,"9378",31,21,21,1,0,"C´s",3
9,"9438",544,446,444,3,2,"C´s",80
9,"9178",52,36,36,1,0,"C´s",1
9,"9038",118,97,94,0,3,"C´s",18
9,"9192",55,47,46,0,1,"C´s",2
9,"9022",67,57,57,1,0,"C´s",13
9,"9120",39,35,35,0,0,"C´s",6
9,"9077",36,26,26,1,0,"C´s",5
9,"9066",65,51,51,0,0,"C´s",10
9,"9144",52,40,40,0,0,"C´s",5
9,"9326",148,115,113,2,2,"C´s",29
9,"9382",33,30,29,1,1,"C´s",3
9,"9197",148,108,104,1,4,"C´s",11
9,"9456",129,90,90,2,0,"C´s",9
9,"9074",788,609,598,8,11,"C´s",140
9,"9009",163,130,128,2,2,"C´s",32
9,"9301",616,513,506,5,7,"C´s",115
9,"9454",47,34,34,0,0,"C´s",6
9,"9328",77,55,55,1,0,"C´s",10
9,"9384",293,199,194,0,5,"C´s",34
9,"9014",213,127,126,1,1,"C´s",19
9,"9104",54,43,43,0,0,"C´s",7
9,"9119",46,27,27,0,0,"C´s",4
9,"9141",610,499,493,4,6,"C´s",61
9,"9218",360,272,271,2,1,"C´s",30
9,"9132",173,132,130,0,2,"C´s",22
9,"9223",46,39,39,0,0,"C´s",7
9,"9227",119,97,95,0,2,"C´s",11
9,"9016",85,64,64,2,0,"C´s",12
9,"9001",27,26,26,0,0,"C´s",1
9,"9440",96,78,78,0,0,"C´s",5
9,"9162",143,108,108,0,0,"C´s",17
9,"9267",115,101,100,3,1,"C´s",13
9,"9366",90,64,63,1,1,"C´s",9
9,"9055",52,39,38,0,1,"C´s",4
9,"9428",107,87,87,0,0,"C´s",13
9,"9244",47,26,26,1,0,"C´s",0
9,"9196",154,108,107,1,1,"C´s",9
9,"9439",1005,823,816,9,7,"C´s",176
9,"9295",60,37,37,0,0,"C´s",2
9,"9257",92,80,78,4,2,"C´s",10
9,"9321",1640,1250,1237,5,13,"C´s",185
9,"9287",208,170,168,2,2,"C´s",29
9,"9070",34,31,30,3,1,"C´s",1
9,"9019",147,103,102,1,1,"C´s",6
9,"9345",124,92,92,0,0,"C´s",7
9,"9151",458,364,363,3,1,"C´s",39
9,"9268",95,73,72,0,1,"C´s",1
9,"9421",237,172,172,2,0,"C´s",21
9,"9056",4931,3634,3602,35,32,"C´s",578
9,"9091",732,516,512,7,4,"C´s",52
9,"9424",32,26,26,1,0,"C´s",1
9,"9450",27,21,20,1,1,"C´s",0
9,"9446",12,7,7,0,0,"C´s",2
9,"9417",40,30,30,0,0,"C´s",0
9,"9249",47,37,37,1,0,"C´s",4
9,"9195",57,42,42,2,0,"C´s",6
9,"9396",152,118,118,1,0,"C´s",19
9,"9466",134,99,99,0,0,"C´s",7
9,"9013",47,41,41,0,0,"C´s",4
9,"9088",66,44,42,1,2,"C´s",4
9,"9269",39,33,32,0,1,"C´s",1
9,"9138",90,73,72,0,1,"C´s",6
9,"9075",111,83,83,1,0,"C´s",17
9,"9343",97,70,69,0,1,"C´s",4
9,"9449",87,72,71,1,1,"C´s",15
9,"9463",262,206,206,3,0,"C´s",28
9,"9139",101,75,73,2,2,"C´s",4
9,"9471",151,117,117,0,0,"C´s",16
9,"9400",317,258,256,3,2,"C´s",23
9,"9029",168,134,132,3,2,"C´s",27
9,"9154",142,104,104,2,0,"C´s",23
9,"9177",1117,830,825,5,5,"C´s",167
9,"9219",27590,19903,19724,166,179,"C´s",2338
9,"9329",123,86,86,1,0,"C´s",8
9,"9085",475,352,350,2,2,"C´s",70
9,"9166",97,79,78,3,1,"C´s",6
9,"9307",113,91,91,0,0,"C´s",13
9,"9076",23,14,14,0,0,"C´s",3
9,"9243",75,56,54,1,2,"C´s",2
9,"9275",192,138,137,1,1,"C´s",11
9,"9235",160,124,123,0,1,"C´s",11
9,"9377",625,478,471,5,7,"C´s",94
9,"9224",157,122,122,0,0,"C´s",19
9,"9373",440,285,282,3,3,"C´s",28
9,"9064",332,275,275,3,0,"C´s",97
9,"9168",296,233,231,1,2,"C´s",18
9,"9021",56,33,31,0,2,"C´s",3
9,"9189",130,88,86,2,2,"C´s",9
9,"9175",129,92,92,0,0,"C´s",6
9,"9123",40,35,35,0,0,"C´s",2
9,"9289",1466,1027,1013,6,14,"C´s",121
9,"9292",92,72,70,0,2,"C´s",9
9,"9348",146,116,114,1,2,"C´s",8
9,"9206",61,52,50,3,2,"C´s",4
9,"9262",161,129,129,0,0,"C´s",14
9,"9387",118,96,95,0,1,"C´s",8
9,"9415",267,166,165,0,1,"C´s",32
9,"9253",111,96,94,1,2,"C´s",20
9,"9406",252,196,195,1,1,"C´s",30
9,"9026",397,314,311,1,3,"C´s",50
9,"9485",55,43,43,1,0,"C´s",2
9,"9131",460,381,373,5,8,"C´s",58
9,"9437",286,227,226,5,1,"C´s",31
9,"9037",113,96,96,0,0,"C´s",14
9,"9024",156,117,114,0,3,"C´s",11
9,"9431",119,99,98,0,1,"C´s",15
9,"9184",5,4,4,0,0,"C´s",1
9,"9279",177,130,130,0,0,"C´s",15
9,"9136",192,151,147,2,4,"C´s",14
9,"9105",107,88,86,0,2,"C´s",11
9,"9303",92,72,71,0,1,"C´s",3
9,"9281",147,109,107,0,2,"C´s",25
9,"9250",273,218,218,4,0,"C´s",16
9,"9170",203,152,149,1,3,"C´s",24
9,"9310",13,9,8,0,1,"C´s",3
9,"9316",104,83,80,1,3,"C´s",7
9,"9360",30,27,27,0,0,"C´s",5
9,"9241",201,156,155,3,1,"C´s",38
9,"9274",1098,880,872,9,8,"C´s",94
9,"9043",189,132,132,2,0,"C´s",20
9,"9149",34,25,24,0,1,"C´s",3
9,"9073",926,753,748,10,5,"C´s",155
9,"9258",173,139,136,4,3,"C´s",10
9,"9369",442,331,328,1,3,"C´s",39
9,"9110",80,49,49,1,0,"C´s",5
9,"9030",109,76,76,3,0,"C´s",7
9,"9327",25,22,22,0,0,"C´s",4
9,"9061",166,124,123,1,1,"C´s",7
9,"9390",611,478,477,3,1,"C´s",85
9,"9338",219,173,171,1,2,"C´s",35
9,"9065",147,124,123,2,1,"C´s",14
9,"9124",1520,1113,1096,9,17,"C´s",112
9,"9059",136713,106605,105601,976,1004,"C´s",18186
9,"9902",461,347,339,1,8,"C´s",31
9,"9416",52,39,39,0,0,"C´s",1
9,"9394",727,558,552,8,6,"C´s",58
9,"9356",42,31,31,0,0,"C´s",9
9,"9388",36,31,30,1,1,"C´s",7
9,"9071",45,34,34,0,0,"C´s",7
9,"9011",69,49,49,0,0,"C´s",7
9,"9283",46,29,28,0,1,"C´s",4
9,"9082",40,35,35,0,0,"C´s",4
9,"9318",61,38,38,0,0,"C´s",4
9,"9095",86,62,62,0,0,"C´s",4
9,"9332",140,107,107,1,0,"C´s",23
9,"9455",44,34,33,0,1,"C´s",1
9,"9246",622,458,455,5,3,"C´s",61
9,"9006",61,41,41,0,0,"C´s",7
9,"9467",66,46,46,3,0,"C´s",6
9,"9211",1462,1086,1070,11,16,"C´s",100
9,"9181",302,231,225,3,6,"C´s",26
9,"9272",294,206,203,1,3,"C´s",20
9,"9155",26,20,20,1,0,"C´s",4
9,"9199",91,65,65,2,0,"C´s",9
9,"9152",263,193,192,0,1,"C´s",19
9,"9068",29,23,22,0,1,"C´s",1
9,"9270",163,122,121,1,1,"C´s",27
50,"50134",128,88,88,5,0,"UPYD",3
50,"50227",108,79,79,1,0,"UPYD",0
50,"50222",1647,1135,1118,8,17,"UPYD",7
50,"50289",52,39,39,1,0,"UPYD",0
50,"50035",74,53,52,0,1,"UPYD",0
50,"50084",79,56,56,1,0,"UPYD",0
50,"50069",76,53,52,0,1,"UPYD",1
50,"50022",543,410,398,8,12,"UPYD",1
50,"50228",270,211,210,5,1,"UPYD",2
50,"50195",53,38,38,0,0,"UPYD",0
50,"50066",2613,1956,1951,21,5,"UPYD",9
50,"50264",158,111,111,0,0,"UPYD",0
50,"50192",236,185,183,2,2,"UPYD",0
50,"50197",92,71,71,2,0,"UPYD",0
50,"50014",146,99,99,1,0,"UPYD",0
50,"50003",126,93,92,3,1,"UPYD",0
50,"50235",2323,1687,1675,7,12,"UPYD",17
50,"50274",71,50,49,1,1,"UPYD",1
50,"50138",46,41,41,0,0,"UPYD",1
50,"50223",915,747,741,8,6,"UPYD",0
50,"50254",181,130,129,2,1,"UPYD",0
50,"50174",92,70,70,0,0,"UPYD",1
50,"50105",304,228,228,3,0,"UPYD",0
50,"50238",97,74,73,0,1,"UPYD",0
50,"50198",56,30,30,0,0,"UPYD",0
50,"50154",119,92,91,0,1,"UPYD",1
50,"50161",117,76,76,0,0,"UPYD",1
50,"50067",14055,10236,10109,123,127,"UPYD",50
50,"50212",41,37,37,0,0,"UPYD",0
50,"50054",59,45,45,0,0,"UPYD",0
50,"50036",103,79,79,0,0,"UPYD",0
50,"50024",589,461,459,4,2,"UPYD",3
50,"50902",87,78,78,1,0,"UPYD",0
50,"50123",465,349,344,2,5,"UPYD",0
50,"50047",50,32,32,1,0,"UPYD",0
50,"50078",244,192,189,1,3,"UPYD",0
50,"50253",423,328,327,1,1,"UPYD",0
50,"50104",351,283,282,3,1,"UPYD",3
50,"50020",822,560,555,5,5,"UPYD",3
50,"50040",92,75,75,0,0,"UPYD",1
50,"50072",174,124,122,2,2,"UPYD",0
50,"50029",627,469,468,4,1,"UPYD",7
50,"50071",131,90,90,0,0,"UPYD",0
50,"50152",1457,1032,1018,11,14,"UPYD",3
50,"50088",305,234,229,11,5,"UPYD",0
50,"50257",178,139,137,0,2,"UPYD",0
50,"50095",12366,8938,8856,94,82,"UPYD",54
50,"50116",190,142,140,1,2,"UPYD",1
50,"50200",509,406,404,6,2,"UPYD",2
50,"50041",12,10,10,0,0,"UPYD",0
50,"50038",1511,1167,1159,13,8,"UPYD",9
50,"50297",499531,377882,375565,3049,2317,"UPYD",3615
50,"50167",232,194,193,0,1,"UPYD",1
50,"50204",2457,1830,1816,14,14,"UPYD",4
50,"50187",70,38,38,0,0,"UPYD",0
50,"50283",72,55,54,0,1,"UPYD",1
50,"50052",90,71,71,0,0,"UPYD",0
50,"50193",647,514,506,1,8,"UPYD",7
50,"50048",35,23,23,0,0,"UPYD",1
50,"50295",45,39,39,0,0,"UPYD",0
50,"50201",443,335,330,2,5,"UPYD",0
50,"50060",176,138,136,0,2,"UPYD",0
50,"50160",2245,1661,1648,10,13,"UPYD",6
50,"50050",98,59,59,3,0,"UPYD",0
50,"50266",129,85,85,1,0,"UPYD",0
50,"50215",23,15,15,0,0,"UPYD",0
50,"50135",95,63,63,0,0,"UPYD",0
50,"50102",863,665,654,6,11,"UPYD",1
50,"50182",3352,2437,2409,26,28,"UPYD",26
50,"50068",1998,1388,1378,17,10,"UPYD",6
50,"50121",276,227,225,4,2,"UPYD",2
50,"50286",77,54,54,0,0,"UPYD",0
50,"50026",442,358,353,6,5,"UPYD",4
50,"50260",35,32,32,0,0,"UPYD",2
50,"50099",3087,2233,2216,15,17,"UPYD",4
50,"50199",341,242,241,4,1,"UPYD",2
50,"50165",1815,1333,1316,27,17,"UPYD",3
50,"50075",81,59,59,1,0,"UPYD",0
50,"50119",930,698,691,7,7,"UPYD",6
50,"50234",245,198,193,9,5,"UPYD",1
50,"50055",3612,2533,2490,34,43,"UPYD",19
50,"50263",197,123,121,6,2,"UPYD",0
50,"50213",98,77,72,0,5,"UPYD",1
50,"50284",151,115,113,0,2,"UPYD",0
50,"50203",1043,811,802,15,9,"UPYD",6
50,"50059",780,572,567,6,5,"UPYD",0
50,"50034",838,572,569,5,3,"UPYD",6
50,"50044",232,156,156,1,0,"UPYD",0
50,"50004",534,406,401,0,5,"UPYD",1
50,"50163",3655,2766,2740,34,26,"UPYD",26
50,"50096",39,17,17,0,0,"UPYD",0
50,"50272",12913,9500,9415,80,85,"UPYD",72
50,"50031",161,90,88,1,2,"UPYD",0
50,"50224",69,55,55,1,0,"UPYD",0
50,"50073",2148,1649,1622,9,27,"UPYD",7
50,"50233",114,81,81,1,0,"UPYD",0
50,"50021",32,25,25,3,0,"UPYD",1
50,"50001",115,81,80,0,1,"UPYD",0
50,"50153",941,737,734,7,3,"UPYD",3
50,"50256",84,46,46,0,0,"UPYD",0
50,"50032",273,190,189,0,1,"UPYD",2
50,"50087",28,19,19,0,0,"UPYD",1
50,"50053",688,535,522,6,13,"UPYD",1
50,"50211",252,187,186,0,1,"UPYD",0
50,"50240",1034,749,737,10,12,"UPYD",6
50,"50106",135,105,104,0,1,"UPYD",1
50,"50074",6397,4512,4408,38,104,"UPYD",21
50,"50191",476,327,325,3,2,"UPYD",1
50,"50131",237,168,167,2,1,"UPYD",0
50,"50064",440,350,349,5,1,"UPYD",0
50,"50143",569,414,411,4,3,"UPYD",1
50,"50065",53,42,42,0,0,"UPYD",0
50,"50291",100,69,69,0,0,"UPYD",0
50,"50110",369,258,257,0,1,"UPYD",0
50,"50271",256,187,184,4,3,"UPYD",0
50,"50267",605,424,420,4,4,"UPYD",3
50,"50186",41,29,29,0,0,"UPYD",1
50,"50006",939,712,701,8,11,"UPYD",3
50,"50237",103,73,73,2,0,"UPYD",1
50,"50185",132,110,110,1,0,"UPYD",1
50,"50046",176,123,123,7,0,"UPYD",0
50,"50245",90,60,60,1,0,"UPYD",0
50,"50166",260,192,189,2,3,"UPYD",0
50,"50148",324,240,236,0,4,"UPYD",0
50,"50169",362,264,262,0,2,"UPYD",1
50,"50007",46,37,37,1,0,"UPYD",0
50,"50206",466,379,376,2,3,"UPYD",4
50,"50079",254,186,184,3,2,"UPYD",0
50,"50176",228,158,157,0,1,"UPYD",1
50,"50113",618,506,496,4,10,"UPYD",0
50,"50155",102,78,78,0,0,"UPYD",1
50,"50090",156,112,111,0,1,"UPYD",0
50,"50221",33,20,20,0,0,"UPYD",0
50,"50293",423,282,280,5,2,"UPYD",1
50,"50164",395,263,260,2,3,"UPYD",2
50,"50098",181,129,127,2,2,"UPYD",0
50,"50146",190,137,137,5,0,"UPYD",0
50,"50249",312,235,233,1,2,"UPYD",1
50,"50124",417,312,312,9,0,"UPYD",1
50,"50184",113,82,82,0,0,"UPYD",0
50,"50270",38,24,24,2,0,"UPYD",0
50,"50129",245,164,164,1,0,"UPYD",1
50,"50039",507,400,398,3,2,"UPYD",3
50,"50168",28,23,23,0,0,"UPYD",0
50,"50280",340,260,258,0,2,"UPYD",2
50,"50043",257,172,171,1,1,"UPYD",1
50,"50243",340,259,254,1,5,"UPYD",0
50,"50247",827,624,615,10,9,"UPYD",5
50,"50081",512,376,372,6,4,"UPYD",0
50,"50202",158,96,92,1,4,"UPYD",0
50,"50172",196,138,136,0,2,"UPYD",2
50,"50107",944,772,767,16,5,"UPYD",2
50,"50030",225,156,156,2,0,"UPYD",0
50,"50205",91,69,65,1,4,"UPYD",0
50,"50147",788,577,576,4,1,"UPYD",1
50,"50281",80,57,56,0,1,"UPYD",0
50,"50136",579,420,413,0,7,"UPYD",3
50,"50261",215,159,159,1,0,"UPYD",0
50,"50089",8144,6285,6249,50,36,"UPYD",43
50,"50144",36,28,28,0,0,"UPYD",0
50,"50179",257,207,207,2,0,"UPYD",0
50,"50265",62,41,41,0,0,"UPYD",0
50,"50108",47,37,37,0,0,"UPYD",0
50,"50275",110,73,72,0,1,"UPYD",1
50,"50285",648,473,469,3,4,"UPYD",5
50,"50181",1003,750,737,9,13,"UPYD",1
50,"50011",127,96,96,2,0,"UPYD",0
50,"50242",92,81,79,1,2,"UPYD",3
50,"50220",46,32,32,0,0,"UPYD",0
50,"50180",120,97,96,0,1,"UPYD",1
50,"50282",70,48,48,0,0,"UPYD",0
50,"50194",84,52,52,0,0,"UPYD",0
50,"50229",64,42,42,0,0,"UPYD",0
50,"50042",16,13,13,0,0,"UPYD",0
50,"50077",226,175,174,5,1,"UPYD",0
50,"50232",171,120,118,0,2,"UPYD",3
50,"50252",5178,3746,3711,36,35,"UPYD",8
50,"50250",55,44,44,0,0,"UPYD",0
50,"50114",124,94,94,2,0,"UPYD",0
50,"50276",129,108,107,0,1,"UPYD",0
50,"50094",1626,1197,1178,22,19,"UPYD",3
50,"50294",73,58,58,0,0,"UPYD",0
50,"50012",108,86,83,1,3,"UPYD",0
50,"50057",1396,980,972,8,8,"UPYD",5
50,"50005",234,178,178,1,0,"UPYD",1
50,"50118",2179,1575,1564,7,11,"UPYD",36
50,"50132",755,573,564,7,9,"UPYD",4
50,"50009",106,78,77,1,1,"UPYD",0
50,"50230",1176,853,849,11,4,"UPYD",4
50,"50070",60,29,29,1,0,"UPYD",0
50,"50173",210,141,140,2,1,"UPYD",0
50,"50244",205,157,157,3,0,"UPYD",0
50,"50085",176,131,129,3,2,"UPYD",0
50,"50013",224,187,186,3,1,"UPYD",0
50,"50122",68,54,54,2,0,"UPYD",0
50,"50216",236,189,186,4,3,"UPYD",0
50,"50162",147,110,110,2,0,"UPYD",0
50,"50027",227,177,176,1,1,"UPYD",0
50,"50133",117,88,88,3,0,"UPYD",2
50,"50189",712,574,559,4,15,"UPYD",2
50,"50178",302,197,196,9,1,"UPYD",0
50,"50101",879,615,609,5,6,"UPYD",2
50,"50903",2225,1686,1669,21,17,"UPYD",13
50,"50028",78,53,53,2,0,"UPYD",0
50,"50255",214,163,163,0,0,"UPYD",0
50,"50296",398,297,293,2,4,"UPYD",1
50,"50183",338,255,255,0,0,"UPYD",0
50,"50045",1255,944,934,6,10,"UPYD",3
50,"50210",40,32,31,0,1,"UPYD",0
50,"50190",708,542,539,3,3,"UPYD",1
50,"50141",114,85,84,0,1,"UPYD",0
50,"50015",98,63,63,0,0,"UPYD",1
50,"50025",4547,3335,3295,45,40,"UPYD",27
50,"50159",670,511,501,5,10,"UPYD",3
50,"50080",32,25,25,0,0,"UPYD",0
50,"50219",4098,3010,2980,27,30,"UPYD",28
50,"50128",28,24,24,0,0,"UPYD",0
50,"50236",104,82,82,2,0,"UPYD",0
50,"50225",1568,996,985,2,11,"UPYD",3
50,"50142",30,21,21,0,0,"UPYD",0
50,"50290",387,288,287,4,1,"UPYD",0
50,"50150",660,402,402,3,0,"UPYD",2
50,"50058",72,51,51,0,0,"UPYD",0
50,"50208",1802,1349,1332,16,17,"UPYD",6
50,"50115",3248,2277,2262,31,15,"UPYD",8
50,"50093",94,73,73,1,0,"UPYD",0
50,"50051",828,640,637,8,3,"UPYD",1
50,"50018",948,717,712,6,5,"UPYD",3
50,"50278",198,145,144,1,1,"UPYD",0
50,"50196",108,83,82,1,1,"UPYD",1
50,"50017",1772,1301,1293,7,8,"UPYD",12
50,"50023",223,175,173,3,2,"UPYD",0
50,"50258",56,34,34,1,0,"UPYD",0
50,"50130",395,252,252,1,0,"UPYD",0
50,"50248",521,407,406,1,1,"UPYD",3
50,"50092",298,256,251,3,5,"UPYD",1
50,"50251",8300,6228,6167,62,61,"UPYD",34
50,"50231",260,213,210,7,3,"UPYD",0
50,"50214",27,16,16,1,0,"UPYD",1
50,"50008",5085,3617,3574,30,43,"UPYD",15
50,"50061",207,174,168,1,6,"UPYD",0
50,"50170",378,286,283,2,3,"UPYD",3
50,"50137",1025,793,786,6,7,"UPYD",1
50,"50292",132,103,103,0,0,"UPYD",0
50,"50207",109,88,88,1,0,"UPYD",0
50,"50063",61,57,57,0,0,"UPYD",0
50,"50298",5353,4051,4013,32,38,"UPYD",21
50,"50086",184,128,128,1,0,"UPYD",1
50,"50279",87,62,62,1,0,"UPYD",0
50,"50083",90,72,72,1,0,"UPYD",0
50,"50120",49,36,36,3,0,"UPYD",0
50,"50177",315,251,249,3,2,"UPYD",0
50,"50269",288,185,183,0,2,"UPYD",0
50,"50218",113,90,89,1,1,"UPYD",0
50,"50188",30,23,19,0,4,"UPYD",0
50,"50239",64,47,47,1,0,"UPYD",1
50,"50019",54,41,41,0,0,"UPYD",0
50,"50091",48,32,32,1,0,"UPYD",2
50,"50117",125,91,90,1,1,"UPYD",2
50,"50010",69,57,57,0,0,"UPYD",0
50,"50273",31,18,18,0,0,"UPYD",0
50,"50033",75,65,65,0,0,"UPYD",0
50,"50037",139,92,91,1,1,"UPYD",0
50,"50125",371,260,258,3,2,"UPYD",1
50,"50901",137,101,101,0,0,"UPYD",3
50,"50217",455,334,334,1,0,"UPYD",2
50,"50156",214,173,170,2,3,"UPYD",2
50,"50100",333,263,261,5,2,"UPYD",4
50,"50016",52,37,37,0,0,"UPYD",0
50,"50288",3371,2566,2547,26,19,"UPYD",19
50,"50157",301,211,207,2,4,"UPYD",0
50,"50262",1187,931,930,13,1,"UPYD",4
50,"50259",89,61,61,1,0,"UPYD",0
50,"50082",89,58,57,0,1,"UPYD",0
50,"50241",593,426,418,1,8,"UPYD",1
50,"50149",36,23,23,0,0,"UPYD",0
50,"50175",1025,745,739,6,6,"UPYD",5
50,"50171",108,70,69,0,1,"UPYD",0
50,"50076",81,64,64,0,0,"UPYD",0
50,"50287",274,197,195,4,2,"UPYD",0
50,"50268",47,40,39,0,1,"UPYD",3
50,"50139",319,239,238,2,1,"UPYD",3
50,"50126",2388,1726,1708,22,18,"UPYD",10
50,"50246",41,29,29,0,0,"UPYD",0
50,"50002",148,105,102,0,3,"UPYD",0
50,"50056",406,325,324,2,1,"UPYD",0
50,"50277",55,43,43,1,0,"UPYD",0
50,"50111",186,152,151,1,1,"UPYD",0
50,"50140",165,106,106,0,0,"UPYD",0
50,"50151",650,504,503,7,1,"UPYD",5
50,"50062",1810,1407,1389,12,18,"UPYD",8
50,"50209",2560,1787,1774,12,13,"UPYD",13
50,"50109",105,78,77,3,1,"UPYD",0
8,"8062",951,676,674,5,2,"unio.cat",6
8,"8156",10923,8013,7964,50,49,"unio.cat",85
8,"8249",266,223,220,2,3,"unio.cat",3
8,"8194",25539,16628,16553,77,75,"unio.cat",115
8,"8067",5723,3896,3874,39,22,"unio.cat",47
8,"8075",3875,2709,2695,12,14,"unio.cat",38
8,"8096",42411,30717,30550,204,167,"unio.cat",447
8,"8051",17873,13126,13048,66,78,"unio.cat",222
8,"8208",5736,4318,4295,23,23,"unio.cat",60
8,"8126",8709,6454,6425,34,29,"unio.cat",86
8,"8100",1992,1496,1485,21,11,"unio.cat",40
8,"8018",2654,1834,1819,16,15,"unio.cat",28
8,"8275",254,202,202,4,0,"unio.cat",7
8,"8122",1683,1117,1106,10,11,"unio.cat",12
8,"8298",26426,17862,17784,113,78,"unio.cat",346
8,"8129",456,322,320,3,2,"unio.cat",7
8,"8014",1953,1438,1429,13,9,"unio.cat",32
8,"8296",1787,1358,1351,9,7,"unio.cat",48
8,"8204",3058,2282,2262,17,20,"unio.cat",37
8,"8148",2238,1592,1580,7,12,"unio.cat",23
8,"8260",18306,13492,13423,60,69,"unio.cat",171
8,"8138",4229,2832,2816,19,16,"unio.cat",69
8,"8238",14478,11302,11252,85,50,"unio.cat",240
8,"8160",330,217,217,0,0,"unio.cat",3
8,"8097",1027,736,731,7,5,"unio.cat",6
8,"8246",1682,1157,1152,8,5,"unio.cat",18
8,"8134",803,560,554,5,6,"unio.cat",10
8,"8268",1011,702,699,2,3,"unio.cat",6
8,"8201",436,299,298,1,1,"unio.cat",6
8,"8303",278,206,205,2,1,"unio.cat",2
8,"8093",26,19,19,0,0,"unio.cat",0
8,"8189",126,95,94,2,1,"unio.cat",3
8,"8267",6435,4571,4542,24,29,"unio.cat",49
8,"8214",6841,5018,4994,49,24,"unio.cat",119
8,"8219",15355,11458,11403,86,55,"unio.cat",285
8,"8195",82,64,64,0,0,"unio.cat",1
8,"8036",159,113,112,1,1,"unio.cat",5
8,"8202",12615,8911,8831,70,80,"unio.cat",145
8,"8111",216,185,185,0,0,"unio.cat",5
8,"8041",10314,7291,7238,46,53,"unio.cat",77
8,"8064",1853,1323,1315,9,8,"unio.cat",28
8,"8147",17001,12422,12333,62,89,"unio.cat",143
8,"8271",69,47,46,0,1,"unio.cat",0
8,"8133",128,76,75,0,1,"unio.cat",4
8,"8174",394,306,300,3,6,"unio.cat",12
8,"8187",152527,112013,111491,638,522,"unio.cat",1480
8,"8038",1488,987,981,10,6,"unio.cat",19
8,"8188",117,81,81,2,0,"unio.cat",5
8,"8192",5696,4093,4069,38,24,"unio.cat",84
8,"8287",1044,806,792,7,14,"unio.cat",14
8,"8102",28304,19929,19821,170,108,"unio.cat",407
8,"8308",131,99,97,0,2,"unio.cat",3
8,"8006",11427,7789,7727,46,62,"unio.cat",174
8,"8241",76,59,59,0,0,"unio.cat",5
8,"8059",342,224,223,3,1,"unio.cat",7
8,"8265",1548,1115,1108,8,7,"unio.cat",15
8,"8094",1548,1143,1133,12,10,"unio.cat",26
8,"8217",24985,19385,19317,130,68,"unio.cat",255
8,"8229",535,383,379,3,4,"unio.cat",18
8,"8108",5014,3757,3740,21,17,"unio.cat",50
8,"8109",214,174,173,0,1,"unio.cat",7
8,"8027",690,527,524,3,3,"unio.cat",13
8,"8005",6165,4458,4434,23,24,"unio.cat",88
8,"8078",216,135,135,2,0,"unio.cat",7
8,"8035",12448,8482,8443,54,39,"unio.cat",170
8,"8170",447,293,291,11,2,"unio.cat",8
8,"8052",139,94,94,2,0,"unio.cat",14
8,"8105",9613,7103,7047,46,56,"unio.cat",53
8,"8285",10260,6893,6843,56,50,"unio.cat",111
8,"8274",4702,3349,3323,35,26,"unio.cat",73
8,"8292",1083,796,791,4,5,"unio.cat",17
8,"8058",1742,1210,1194,7,16,"unio.cat",7
8,"8128",564,378,377,1,1,"unio.cat",4
8,"8179",579,427,425,6,2,"unio.cat",8
8,"8247",958,716,714,7,2,"unio.cat",12
8,"8081",345,255,255,1,0,"unio.cat",4
8,"8098",2387,1668,1662,11,6,"unio.cat",35
8,"8015",155841,109156,108536,726,620,"unio.cat",1120
8,"8116",582,421,418,4,3,"unio.cat",12
8,"8198",4391,3167,3138,17,29,"unio.cat",58
8,"8168",375,235,234,0,1,"unio.cat",2
8,"8107",11472,8147,8097,45,50,"unio.cat",92
8,"8197",7605,5331,5317,31,14,"unio.cat",132
8,"8166",1000,680,674,4,6,"unio.cat",14
8,"8178",430,317,315,4,2,"unio.cat",8
8,"8007",6505,4532,4495,28,37,"unio.cat",82
8,"8231",20495,13961,13885,91,76,"unio.cat",198
8,"8253",133,85,85,1,0,"unio.cat",0
8,"8056",41996,30076,29974,178,102,"unio.cat",473
8,"8244",5821,4484,4451,32,33,"unio.cat",116
8,"8254",1746,1261,1257,13,4,"unio.cat",25
8,"8248",5402,3848,3815,27,33,"unio.cat",80
8,"8234",3187,2331,2322,11,9,"unio.cat",40
8,"8042",2233,1668,1653,8,15,"unio.cat",13
8,"8276",233,169,169,3,0,"unio.cat",3
8,"8020",4876,3702,3678,25,24,"unio.cat",57
8,"8065",1179,837,831,8,6,"unio.cat",19
8,"8295",10850,7651,7617,33,34,"unio.cat",111
8,"8167",5879,4463,4448,42,15,"unio.cat",38
8,"8124",36750,26968,26842,140,126,"unio.cat",293
8,"8157",8361,6311,6277,38,34,"unio.cat",102
8,"8164",911,651,644,2,7,"unio.cat",10
8,"8206",731,568,559,9,9,"unio.cat",8
8,"8209",6773,4845,4822,31,23,"unio.cat",60
8,"8101",174802,123863,123197,643,666,"unio.cat",1296
8,"8123",19114,14573,14509,81,64,"unio.cat",253
8,"8184",53690,37794,37636,200,158,"unio.cat",403
8,"8172",20384,14738,14684,85,54,"unio.cat",269
8,"8002",202,142,139,0,3,"unio.cat",8
8,"8025",1486,1087,1083,13,4,"unio.cat",14
8,"8099",749,514,513,4,1,"unio.cat",11
8,"8055",512,366,364,2,2,"unio.cat",3
8,"8139",171,133,132,0,1,"unio.cat",9
8,"8151",463,336,333,11,3,"unio.cat",12
8,"8121",86293,61426,61070,450,356,"unio.cat",857
8,"8080",38,28,27,0,1,"unio.cat",8
8,"8146",1297,958,954,16,4,"unio.cat",12
8,"8091",5253,3817,3795,23,22,"unio.cat",36
8,"8273",2309,1706,1689,12,17,"unio.cat",30
8,"8092",3768,2621,2600,31,21,"unio.cat",60
8,"8155",6736,4779,4734,45,45,"unio.cat",47
8,"8034",766,542,538,3,4,"unio.cat",16
8,"8227",2329,1625,1607,13,18,"unio.cat",47
8,"8205",59169,45410,45231,357,179,"unio.cat",1458
8,"8049",1288,860,841,9,19,"unio.cat",33
8,"8141",4590,3173,3150,39,23,"unio.cat",59
8,"8130",96,66,66,0,0,"unio.cat",1
8,"8290",1490,1163,1155,5,8,"unio.cat",25
8,"8182",2803,2039,2034,16,5,"unio.cat",14
8,"8302",9209,6571,6524,65,47,"unio.cat",89
8,"8235",3683,2612,2595,22,17,"unio.cat",47
8,"8137",265,206,205,1,1,"unio.cat",9
8,"8305",27328,19226,19083,116,143,"unio.cat",346
8,"8905",2305,1789,1774,17,15,"unio.cat",39
8,"8250",7046,4908,4878,33,30,"unio.cat",68
8,"8083",1674,1287,1275,8,12,"unio.cat",17
8,"8024",381,270,269,3,1,"unio.cat",8
8,"8283",5983,4032,4007,31,25,"unio.cat",74
8,"8127",2224,1439,1429,8,10,"unio.cat",37
8,"8016",1822,1229,1214,12,15,"unio.cat",23
8,"8021",69,52,51,3,1,"unio.cat",1
8,"8047",3978,2640,2614,21,26,"unio.cat",92
8,"8218",8045,5643,5613,54,30,"unio.cat",92
8,"8061",1485,1045,1040,5,5,"unio.cat",15
8,"8251",4970,3505,3480,14,25,"unio.cat",49
8,"8281",4841,3577,3553,18,24,"unio.cat",70
8,"8013",1219,873,867,10,6,"unio.cat",17
8,"8113",52051,34906,34729,229,177,"unio.cat",689
8,"8215",2576,1766,1751,30,15,"unio.cat",29
8,"8069",3168,2333,2324,17,9,"unio.cat",34
8,"8054",9013,6747,6702,38,45,"unio.cat",79
8,"8032",1973,1410,1403,6,7,"unio.cat",39
8,"8289",4304,3166,3151,19,15,"unio.cat",36
8,"8200",61275,45027,44785,276,242,"unio.cat",469
8,"8140",4769,3344,3335,25,9,"unio.cat",59
8,"8136",11416,8425,8388,63,37,"unio.cat",99
8,"8256",644,516,512,1,4,"unio.cat",6
8,"8089",33935,24504,24392,150,112,"unio.cat",333
8,"8286",2904,2009,1997,17,12,"unio.cat",36
8,"8114",18335,13196,13092,66,104,"unio.cat",160
8,"8282",6517,5027,5017,40,10,"unio.cat",107
8,"8017",2756,1888,1876,7,12,"unio.cat",34
8,"8103",631,431,431,3,0,"unio.cat",11
8,"8257",110,87,87,0,0,"unio.cat",0
8,"8224",816,598,595,7,3,"unio.cat",7
8,"8904",10563,7474,7437,32,37,"unio.cat",32
8,"8071",241,168,164,3,4,"unio.cat",4
8,"8264",4288,3045,3030,30,15,"unio.cat",83
8,"8119",6182,4517,4492,35,25,"unio.cat",64
8,"8242",216,172,170,0,2,"unio.cat",14
8,"8232",1797,1276,1266,14,10,"unio.cat",32
8,"8294",1971,1357,1349,8,8,"unio.cat",25
8,"8243",160,117,117,6,0,"unio.cat",4
8,"8258",835,602,597,5,5,"unio.cat",9
8,"8149",996,662,660,7,2,"unio.cat",20
8,"8221",12391,9503,9456,49,47,"unio.cat",256
8,"8050",141,107,104,0,3,"unio.cat",0
8,"8142",132,105,104,1,1,"unio.cat",5
8,"8207",1840,1418,1410,17,8,"unio.cat",33
8,"8233",1876,1247,1237,11,10,"unio.cat",19
8,"8068",6729,4765,4739,23,26,"unio.cat",80
8,"8076",16173,11553,11473,73,80,"unio.cat",152
8,"8277",162,132,132,0,0,"unio.cat",2
8,"8284",12067,7855,7792,66,63,"unio.cat",111
8,"8117",2453,1741,1727,23,14,"unio.cat",28
8,"8263",20974,15086,15001,93,85,"unio.cat",213
8,"8307",48233,34249,34071,209,178,"unio.cat",518
8,"8902",3756,2758,2741,18,17,"unio.cat",36
8,"8269",2646,1871,1860,17,11,"unio.cat",41
8,"8029",3438,2645,2632,25,13,"unio.cat",106
8,"8154",694,535,529,3,6,"unio.cat",15
8,"8044",4150,2957,2932,19,25,"unio.cat",62
8,"8073",61659,45611,45356,239,255,"unio.cat",368
8,"8125",25024,18070,17966,99,104,"unio.cat",198
8,"8278",4764,3372,3358,16,14,"unio.cat",52
8,"8190",258,179,177,2,2,"unio.cat",4
8,"8118",17516,12878,12820,79,58,"unio.cat",276
8,"8162",2028,1451,1442,8,9,"unio.cat",22
8,"8110",13392,9211,9142,67,69,"unio.cat",108
8,"8252",24521,18605,18514,110,91,"unio.cat",177
8,"8026",187,155,155,1,0,"unio.cat",1
8,"8104",682,445,443,4,2,"unio.cat",10
8,"8045",72,42,39,0,3,"unio.cat",0
8,"8031",2308,1648,1637,10,11,"unio.cat",46
8,"8216",25,17,17,0,0,"unio.cat",0
8,"8301",48496,35956,35788,200,168,"unio.cat",344
8,"8213",6296,4308,4294,47,14,"unio.cat",78
8,"8004",233,181,181,2,0,"unio.cat",5
8,"8011",1760,1230,1217,10,13,"unio.cat",38
8,"8175",3371,2243,2232,25,11,"unio.cat",62
8,"8191",5287,3732,3712,31,20,"unio.cat",66
8,"8023",6715,4669,4633,25,36,"unio.cat",71
8,"8112",12909,8671,8616,50,55,"unio.cat",126
8,"8203",2422,1602,1591,11,11,"unio.cat",16
8,"8199",665,466,464,6,2,"unio.cat",10
8,"8280",101,67,67,3,0,"unio.cat",0
8,"8272",157,98,97,0,1,"unio.cat",5
8,"8001",8825,6810,6760,24,50,"unio.cat",70
8,"8046",13243,9747,9693,74,54,"unio.cat",158
8,"8028",1031,724,721,6,3,"unio.cat",6
8,"8150",258,189,185,0,4,"unio.cat",5
8,"8095",71,50,50,0,0,"unio.cat",1
8,"8225",93,71,71,2,0,"unio.cat",2
8,"8236",1525,1077,1067,3,10,"unio.cat",20
8,"8259",6623,4921,4885,33,36,"unio.cat",77
8,"8222",1878,1452,1443,16,9,"unio.cat",25
8,"8135",6733,5230,5205,45,25,"unio.cat",41
8,"8145",2585,1927,1915,10,12,"unio.cat",34
8,"8009",9136,6613,6578,40,35,"unio.cat",141
8,"8211",32990,25446,25282,173,164,"unio.cat",390
8,"8077",34550,26102,25983,152,119,"unio.cat",386
8,"8177",40,25,25,1,0,"unio.cat",0
8,"8304",814,578,573,1,5,"unio.cat",16
8,"8300",5682,4328,4312,21,16,"unio.cat",53
8,"8903",213,167,167,0,0,"unio.cat",3
8,"8223",1850,1279,1263,10,16,"unio.cat",18
8,"8088",11840,8684,8627,55,57,"unio.cat",142
8,"8048",583,426,424,5,2,"unio.cat",11
8,"8239",451,324,324,5,0,"unio.cat",14
8,"8106",7216,5220,5176,38,44,"unio.cat",100
8,"8072",10240,6957,6935,40,22,"unio.cat",140
8,"8171",2099,1396,1389,20,7,"unio.cat",27
8,"8074",10587,7309,7274,51,35,"unio.cat",78
8,"8152",114,84,82,1,2,"unio.cat",2
8,"8030",5095,3727,3712,27,15,"unio.cat",88
8,"8261",2319,1638,1632,4,6,"unio.cat",19
8,"8901",232,171,171,6,0,"unio.cat",5
8,"8082",1150,788,783,6,5,"unio.cat",6
8,"8228",296,207,204,3,3,"unio.cat",6
8,"8060",143,100,99,0,1,"unio.cat",5
8,"8196",19247,14101,14047,75,54,"unio.cat",115
8,"8193",942,637,633,9,4,"unio.cat",12
8,"8019",1141245,824778,820790,5063,3988,"unio.cat",18476
8,"8057",59,42,41,2,1,"unio.cat",1
8,"8210",4296,2825,2806,22,19,"unio.cat",54
8,"8008",187,118,118,1,0,"unio.cat",2
8,"8255",140,90,90,1,0,"unio.cat",4
8,"8180",26616,19621,19542,90,79,"unio.cat",204
8,"8161",11145,7658,7621,45,37,"unio.cat",90
8,"8040",10701,7420,7383,43,37,"unio.cat",134
8,"8039",354,259,259,0,0,"unio.cat",8
8,"8085",985,712,704,1,8,"unio.cat",22
8,"8084",1135,795,790,6,5,"unio.cat",19
8,"8237",1642,1165,1160,4,5,"unio.cat",34
8,"8299",395,256,255,3,1,"unio.cat",6
8,"8086",13550,9448,9395,66,53,"unio.cat",149
8,"8053",2805,1789,1775,10,14,"unio.cat",26
8,"8144",715,493,489,9,4,"unio.cat",13
8,"8266",43128,32806,32660,195,146,"unio.cat",414
8,"8279",152985,110533,110039,684,494,"unio.cat",1483
8,"8293",226,162,162,0,0,"unio.cat",1
8,"8010",4196,2876,2852,16,24,"unio.cat",34
8,"8003",7118,5140,5108,28,32,"unio.cat",130
8,"8169",47915,35543,35390,211,153,"unio.cat",326
8,"8115",3817,2835,2814,18,21,"unio.cat",34
8,"8022",12230,7792,7717,60,75,"unio.cat",136
8,"8143",2686,1892,1881,19,11,"unio.cat",35
8,"8066",1364,1029,1025,10,4,"unio.cat",26
8,"8163",18590,12816,12750,72,66,"unio.cat",156
8,"8291",4524,3226,3206,24,20,"unio.cat",43
8,"8212",495,350,347,3,3,"unio.cat",12
8,"8297",138,100,99,1,1,"unio.cat",4
8,"8132",379,259,256,3,3,"unio.cat",14
8,"8183",4524,3125,3103,21,22,"unio.cat",55
8,"8159",14049,10329,10284,51,45,"unio.cat",134
8,"8185",194,132,132,0,0,"unio.cat",6
8,"8288",1632,1061,1053,4,8,"unio.cat",18
8,"8230",7611,5590,5560,40,30,"unio.cat",134
8,"8090",129,103,102,2,1,"unio.cat",4
8,"8012",1676,1175,1170,24,5,"unio.cat",34
8,"8226",879,683,680,3,3,"unio.cat",36
8,"8262",6855,4522,4491,46,31,"unio.cat",65
8,"8165",1657,1181,1175,8,6,"unio.cat",24
8,"8131",699,520,516,4,4,"unio.cat",13
8,"8306",517,360,354,2,6,"unio.cat",9
8,"8063",448,363,363,8,0,"unio.cat",12
8,"8270",18399,12948,12869,83,79,"unio.cat",305
8,"8153",536,432,431,6,1,"unio.cat",8
8,"8070",267,196,193,2,3,"unio.cat",2
8,"8245",78581,55798,55530,345,268,"unio.cat",388
8,"8079",339,254,248,2,6,"unio.cat",7
8,"8181",7896,5774,5724,41,50,"unio.cat",115
8,"8043",3190,2216,2201,12,15,"unio.cat",30
8,"8087",159,131,130,2,1,"unio.cat",7
8,"8240",9354,6996,6953,34,43,"unio.cat",96
8,"8033",12803,9236,9179,79,57,"unio.cat",172
8,"8037",1856,1364,1351,20,13,"unio.cat",22
8,"8220",2358,1783,1770,18,13,"unio.cat",18
8,"8120",6815,5071,5045,34,26,"unio.cat",219
8,"8176",158,113,113,1,0,"unio.cat",0
8,"8158",3105,2166,2145,18,21,"unio.cat",38
50,"50152",1457,1032,1018,11,14,"PACMA",1
50,"50061",207,174,168,1,6,"PACMA",1
50,"50116",190,142,140,1,2,"PACMA",0
50,"50064",440,350,349,5,1,"PACMA",2
50,"50254",181,130,129,2,1,"PACMA",1
50,"50277",55,43,43,1,0,"PACMA",0
50,"50134",128,88,88,5,0,"PACMA",0
50,"50224",69,55,55,1,0,"PACMA",0
50,"50027",227,177,176,1,1,"PACMA",1
50,"50197",92,71,71,2,0,"PACMA",0
50,"50195",53,38,38,0,0,"PACMA",0
50,"50063",61,57,57,0,0,"PACMA",1
50,"50289",52,39,39,1,0,"PACMA",0
50,"50133",117,88,88,3,0,"PACMA",0
50,"50292",132,103,103,0,0,"PACMA",0
50,"50200",509,406,404,6,2,"PACMA",2
50,"50272",12913,9500,9415,80,85,"PACMA",92
50,"50167",232,194,193,0,1,"PACMA",0
50,"50188",30,23,19,0,4,"PACMA",0
50,"50234",245,198,193,9,5,"PACMA",0
50,"50095",12366,8938,8856,94,82,"PACMA",27
50,"50016",52,37,37,0,0,"PACMA",0
50,"50105",304,228,228,3,0,"PACMA",2
50,"50037",139,92,91,1,1,"PACMA",0
50,"50148",324,240,236,0,4,"PACMA",0
50,"50044",232,156,156,1,0,"PACMA",0
50,"50193",647,514,506,1,8,"PACMA",5
50,"50129",245,164,164,1,0,"PACMA",2
50,"50213",98,77,72,0,5,"PACMA",0
50,"50242",92,81,79,1,2,"PACMA",0
50,"50023",223,175,173,3,2,"PACMA",0
50,"50255",214,163,163,0,0,"PACMA",0
50,"50211",252,187,186,0,1,"PACMA",0
50,"50078",244,192,189,1,3,"PACMA",0
50,"50059",780,572,567,6,5,"PACMA",0
50,"50065",53,42,42,0,0,"PACMA",0
50,"50066",2613,1956,1951,21,5,"PACMA",31
50,"50246",41,29,29,0,0,"PACMA",0
50,"50225",1568,996,985,2,11,"PACMA",3
50,"50276",129,108,107,0,1,"PACMA",0
50,"50076",81,64,64,0,0,"PACMA",2
50,"50117",125,91,90,1,1,"PACMA",0
50,"50296",398,297,293,2,4,"PACMA",2
50,"50144",36,28,28,0,0,"PACMA",1
50,"50136",579,420,413,0,7,"PACMA",1
50,"50077",226,175,174,5,1,"PACMA",1
50,"50084",79,56,56,1,0,"PACMA",2
50,"50205",91,69,65,1,4,"PACMA",0
50,"50100",333,263,261,5,2,"PACMA",3
50,"50164",395,263,260,2,3,"PACMA",2
50,"50270",38,24,24,2,0,"PACMA",0
50,"50233",114,81,81,1,0,"PACMA",1
50,"50058",72,51,51,0,0,"PACMA",1
50,"50157",301,211,207,2,4,"PACMA",2
50,"50125",371,260,258,3,2,"PACMA",0
50,"50184",113,82,82,0,0,"PACMA",0
50,"50071",131,90,90,0,0,"PACMA",0
50,"50154",119,92,91,0,1,"PACMA",1
50,"50275",110,73,72,0,1,"PACMA",1
50,"50033",75,65,65,0,0,"PACMA",1
50,"50238",97,74,73,0,1,"PACMA",0
50,"50161",117,76,76,0,0,"PACMA",0
50,"50110",369,258,257,0,1,"PACMA",1
50,"50206",466,379,376,2,3,"PACMA",5
50,"50241",593,426,418,1,8,"PACMA",0
50,"50038",1511,1167,1159,13,8,"PACMA",3
50,"50207",109,88,88,1,0,"PACMA",0
50,"50166",260,192,189,2,3,"PACMA",0
50,"50140",165,106,106,0,0,"PACMA",1
50,"50252",5178,3746,3711,36,35,"PACMA",6
50,"50228",270,211,210,5,1,"PACMA",2
50,"50113",618,506,496,4,10,"PACMA",0
50,"50174",92,70,70,0,0,"PACMA",0
50,"50151",650,504,503,7,1,"PACMA",0
50,"50034",838,572,569,5,3,"PACMA",0
50,"50293",423,282,280,5,2,"PACMA",0
50,"50236",104,82,82,2,0,"PACMA",0
50,"50204",2457,1830,1816,14,14,"PACMA",2
50,"50280",340,260,258,0,2,"PACMA",0
50,"50298",5353,4051,4013,32,38,"PACMA",28
50,"50087",28,19,19,0,0,"PACMA",0
50,"50032",273,190,189,0,1,"PACMA",1
50,"50039",507,400,398,3,2,"PACMA",3
50,"50081",512,376,372,6,4,"PACMA",1
50,"50102",863,665,654,6,11,"PACMA",1
50,"50250",55,44,44,0,0,"PACMA",0
50,"50290",387,288,287,4,1,"PACMA",0
50,"50287",274,197,195,4,2,"PACMA",0
50,"50253",423,328,327,1,1,"PACMA",0
50,"50192",236,185,183,2,2,"PACMA",3
50,"50147",788,577,576,4,1,"PACMA",4
50,"50075",81,59,59,1,0,"PACMA",0
50,"50172",196,138,136,0,2,"PACMA",0
50,"50271",256,187,184,4,3,"PACMA",0
50,"50104",351,283,282,3,1,"PACMA",2
50,"50030",225,156,156,2,0,"PACMA",1
50,"50040",92,75,75,0,0,"PACMA",0
50,"50179",257,207,207,2,0,"PACMA",1
50,"50176",228,158,157,0,1,"PACMA",0
50,"50258",56,34,34,1,0,"PACMA",0
50,"50169",362,264,262,0,2,"PACMA",1
50,"50162",147,110,110,2,0,"PACMA",0
50,"50126",2388,1726,1708,22,18,"PACMA",1
50,"50072",174,124,122,2,2,"PACMA",1
50,"50096",39,17,17,0,0,"PACMA",0
50,"50028",78,53,53,2,0,"PACMA",0
50,"50177",315,251,249,3,2,"PACMA",0
50,"50048",35,23,23,0,0,"PACMA",0
50,"50149",36,23,23,0,0,"PACMA",0
50,"50053",688,535,522,6,13,"PACMA",3
50,"50042",16,13,13,0,0,"PACMA",0
50,"50098",181,129,127,2,2,"PACMA",2
50,"50142",30,21,21,0,0,"PACMA",0
50,"50286",77,54,54,0,0,"PACMA",0
50,"50160",2245,1661,1648,10,13,"PACMA",3
50,"50170",378,286,283,2,3,"PACMA",0
50,"50128",28,24,24,0,0,"PACMA",0
50,"50249",312,235,233,1,2,"PACMA",0
50,"50178",302,197,196,9,1,"PACMA",1
50,"50109",105,78,77,3,1,"PACMA",0
50,"50283",72,55,54,0,1,"PACMA",0
50,"50046",176,123,123,7,0,"PACMA",1
50,"50074",6397,4512,4408,38,104,"PACMA",30
50,"50171",108,70,69,0,1,"PACMA",0
50,"50202",158,96,92,1,4,"PACMA",0
50,"50222",1647,1135,1118,8,17,"PACMA",2
50,"50099",3087,2233,2216,15,17,"PACMA",9
50,"50237",103,73,73,2,0,"PACMA",0
50,"50118",2179,1575,1564,7,11,"PACMA",14
50,"50043",257,172,171,1,1,"PACMA",1
50,"50165",1815,1333,1316,27,17,"PACMA",15
50,"50026",442,358,353,6,5,"PACMA",0
50,"50284",151,115,113,0,2,"PACMA",0
50,"50159",670,511,501,5,10,"PACMA",1
50,"50085",176,131,129,3,2,"PACMA",1
50,"50264",158,111,111,0,0,"PACMA",1
50,"50013",224,187,186,3,1,"PACMA",1
50,"50247",827,624,615,10,9,"PACMA",2
50,"50079",254,186,184,3,2,"PACMA",1
50,"50251",8300,6228,6167,62,61,"PACMA",33
50,"50119",930,698,691,7,7,"PACMA",1
50,"50278",198,145,144,1,1,"PACMA",3
50,"50285",648,473,469,3,4,"PACMA",6
50,"50086",184,128,128,1,0,"PACMA",1
50,"50082",89,58,57,0,1,"PACMA",0
50,"50245",90,60,60,1,0,"PACMA",1
50,"50235",2323,1687,1675,7,12,"PACMA",11
50,"50163",3655,2766,2740,34,26,"PACMA",27
50,"50131",237,168,167,2,1,"PACMA",2
50,"50056",406,325,324,2,1,"PACMA",4
50,"50183",338,255,255,0,0,"PACMA",0
50,"50021",32,25,25,3,0,"PACMA",0
50,"50262",1187,931,930,13,1,"PACMA",5
50,"50191",476,327,325,3,2,"PACMA",2
50,"50015",98,63,63,0,0,"PACMA",0
50,"50005",234,178,178,1,0,"PACMA",0
50,"50124",417,312,312,9,0,"PACMA",1
50,"50201",443,335,330,2,5,"PACMA",0
50,"50243",340,259,254,1,5,"PACMA",0
50,"50156",214,173,170,2,3,"PACMA",0
50,"50106",135,105,104,0,1,"PACMA",0
50,"50036",103,79,79,0,0,"PACMA",1
50,"50153",941,737,734,7,3,"PACMA",3
50,"50057",1396,980,972,8,8,"PACMA",4
50,"50088",305,234,229,11,5,"PACMA",1
50,"50185",132,110,110,1,0,"PACMA",0
50,"50150",660,402,402,3,0,"PACMA",2
50,"50020",822,560,555,5,5,"PACMA",5
50,"50209",2560,1787,1774,12,13,"PACMA",22
50,"50240",1034,749,737,10,12,"PACMA",2
50,"50901",137,101,101,0,0,"PACMA",0
50,"50009",106,78,77,1,1,"PACMA",1
50,"50055",3612,2533,2490,34,43,"PACMA",15
50,"50175",1025,745,739,6,6,"PACMA",0
50,"50196",108,83,82,1,1,"PACMA",0
50,"50186",41,29,29,0,0,"PACMA",0
50,"50092",298,256,251,3,5,"PACMA",0
50,"50288",3371,2566,2547,26,19,"PACMA",23
50,"50130",395,252,252,1,0,"PACMA",2
50,"50248",521,407,406,1,1,"PACMA",3
50,"50062",1810,1407,1389,12,18,"PACMA",15
50,"50189",712,574,559,4,15,"PACMA",2
50,"50203",1043,811,802,15,9,"PACMA",7
50,"50123",465,349,344,2,5,"PACMA",3
50,"50007",46,37,37,1,0,"PACMA",1
50,"50187",70,38,38,0,0,"PACMA",0
50,"50217",455,334,334,1,0,"PACMA",0
50,"50282",70,48,48,0,0,"PACMA",0
50,"50090",156,112,111,0,1,"PACMA",0
50,"50259",89,61,61,1,0,"PACMA",0
50,"50025",4547,3335,3295,45,40,"PACMA",12
50,"50067",14055,10236,10109,123,127,"PACMA",62
50,"50101",879,615,609,5,6,"PACMA",5
50,"50269",288,185,183,0,2,"PACMA",0
50,"50001",115,81,80,0,1,"PACMA",0
50,"50018",948,717,712,6,5,"PACMA",2
50,"50070",60,29,29,1,0,"PACMA",1
50,"50002",148,105,102,0,3,"PACMA",0
50,"50135",95,63,63,0,0,"PACMA",0
50,"50239",64,47,47,1,0,"PACMA",0
50,"50230",1176,853,849,11,4,"PACMA",0
50,"50094",1626,1197,1178,22,19,"PACMA",9
50,"50218",113,90,89,1,1,"PACMA",0
50,"50267",605,424,420,4,4,"PACMA",1
50,"50022",543,410,398,8,12,"PACMA",2
50,"50263",197,123,121,6,2,"PACMA",1
50,"50107",944,772,767,16,5,"PACMA",3
50,"50019",54,41,41,0,0,"PACMA",0
50,"50198",56,30,30,0,0,"PACMA",0
50,"50219",4098,3010,2980,27,30,"PACMA",49
50,"50216",236,189,186,4,3,"PACMA",0
50,"50261",215,159,159,1,0,"PACMA",0
50,"50281",80,57,56,0,1,"PACMA",0
50,"50291",100,69,69,0,0,"PACMA",0
50,"50223",915,747,741,8,6,"PACMA",0
50,"50138",46,41,41,0,0,"PACMA",0
50,"50047",50,32,32,1,0,"PACMA",0
50,"50010",69,57,57,0,0,"PACMA",0
50,"50003",126,93,92,3,1,"PACMA",0
50,"50069",76,53,52,0,1,"PACMA",0
50,"50024",589,461,459,4,2,"PACMA",0
50,"50011",127,96,96,2,0,"PACMA",1
50,"50229",64,42,42,0,0,"PACMA",0
50,"50231",260,213,210,7,3,"PACMA",1
50,"50093",94,73,73,1,0,"PACMA",0
50,"50137",1025,793,786,6,7,"PACMA",0
50,"50141",114,85,84,0,1,"PACMA",1
50,"50903",2225,1686,1669,21,17,"PACMA",11
50,"50029",627,469,468,4,1,"PACMA",2
50,"50031",161,90,88,1,2,"PACMA",0
50,"50008",5085,3617,3574,30,43,"PACMA",27
50,"50232",171,120,118,0,2,"PACMA",2
50,"50073",2148,1649,1622,9,27,"PACMA",5
50,"50045",1255,944,934,6,10,"PACMA",3
50,"50041",12,10,10,0,0,"PACMA",0
50,"50194",84,52,52,0,0,"PACMA",0
50,"50168",28,23,23,0,0,"PACMA",0
50,"50221",33,20,20,0,0,"PACMA",0
50,"50182",3352,2437,2409,26,28,"PACMA",32
50,"50139",319,239,238,2,1,"PACMA",0
50,"50268",47,40,39,0,1,"PACMA",0
50,"50212",41,37,37,0,0,"PACMA",1
50,"50012",108,86,83,1,3,"PACMA",0
50,"50006",939,712,701,8,11,"PACMA",2
50,"50121",276,227,225,4,2,"PACMA",0
50,"50208",1802,1349,1332,16,17,"PACMA",3
50,"50050",98,59,59,3,0,"PACMA",0
50,"50122",68,54,54,2,0,"PACMA",1
50,"50215",23,15,15,0,0,"PACMA",0
50,"50108",47,37,37,0,0,"PACMA",0
50,"50143",569,414,411,4,3,"PACMA",2
50,"50173",210,141,140,2,1,"PACMA",0
50,"50244",205,157,157,3,0,"PACMA",0
50,"50004",534,406,401,0,5,"PACMA",1
50,"50265",62,41,41,0,0,"PACMA",0
50,"50210",40,32,31,0,1,"PACMA",0
50,"50017",1772,1301,1293,7,8,"PACMA",4
50,"50199",341,242,241,4,1,"PACMA",3
50,"50274",71,50,49,1,1,"PACMA",0
50,"50266",129,85,85,1,0,"PACMA",0
50,"50273",31,18,18,0,0,"PACMA",0
50,"50051",828,640,637,8,3,"PACMA",1
50,"50014",146,99,99,1,0,"PACMA",0
50,"50155",102,78,78,0,0,"PACMA",0
50,"50220",46,32,32,0,0,"PACMA",0
50,"50054",59,45,45,0,0,"PACMA",0
50,"50295",45,39,39,0,0,"PACMA",0
50,"50132",755,573,564,7,9,"PACMA",7
50,"50256",84,46,46,0,0,"PACMA",0
50,"50035",74,53,52,0,1,"PACMA",0
50,"50111",186,152,151,1,1,"PACMA",0
50,"50089",8144,6285,6249,50,36,"PACMA",67
50,"50297",499531,377882,375565,3049,2317,"PACMA",3139
50,"50181",1003,750,737,9,13,"PACMA",6
50,"50227",108,79,79,1,0,"PACMA",1
50,"50257",178,139,137,0,2,"PACMA",0
50,"50091",48,32,32,1,0,"PACMA",0
50,"50080",32,25,25,0,0,"PACMA",0
50,"50180",120,97,96,0,1,"PACMA",0
50,"50902",87,78,78,1,0,"PACMA",0
50,"50115",3248,2277,2262,31,15,"PACMA",8
50,"50083",90,72,72,1,0,"PACMA",0
50,"50146",190,137,137,5,0,"PACMA",0
50,"50114",124,94,94,2,0,"PACMA",0
50,"50294",73,58,58,0,0,"PACMA",0
50,"50052",90,71,71,0,0,"PACMA",2
50,"50190",708,542,539,3,3,"PACMA",1
50,"50068",1998,1388,1378,17,10,"PACMA",1
50,"50214",27,16,16,1,0,"PACMA",0
50,"50120",49,36,36,3,0,"PACMA",0
50,"50279",87,62,62,1,0,"PACMA",0
50,"50260",35,32,32,0,0,"PACMA",0
50,"50060",176,138,136,0,2,"PACMA",3
22,"22212",84,70,70,1,0,"EB",2
22,"22234",802,600,597,7,3,"EB",1
22,"22049",78,61,61,1,0,"EB",0
22,"22247",30,23,22,0,1,"EB",0
22,"22125",38845,28287,27998,283,289,"EB",154
22,"22226",774,591,589,2,2,"EB",5
22,"22131",83,63,63,3,0,"EB",0
22,"22157",194,151,151,1,0,"EB",0
22,"22181",93,62,62,1,0,"EB",0
22,"22094",101,77,77,1,0,"EB",3
22,"22048",12633,9215,9141,90,74,"EB",33
22,"22142",98,81,79,1,2,"EB",0
22,"22158",12005,8628,8554,78,74,"EB",61
22,"22022",558,431,427,2,4,"EB",4
22,"22042",118,102,100,1,2,"EB",0
22,"22903",654,542,536,3,6,"EB",3
22,"22141",118,90,89,1,1,"EB",0
22,"22069",435,340,338,3,2,"EB",0
22,"22013",295,235,233,2,2,"EB",0
22,"22150",464,348,348,1,0,"EB",1
22,"22103",680,527,522,8,5,"EB",5
22,"22080",283,217,215,6,2,"EB",0
22,"22182",256,177,176,2,1,"EB",0
22,"22907",1459,1112,1104,21,8,"EB",5
22,"22172",560,399,396,2,3,"EB",1
22,"22200",251,191,189,0,2,"EB",0
22,"22085",107,92,90,2,2,"EB",0
22,"22177",102,77,77,2,0,"EB",0
22,"22039",869,682,681,5,1,"EB",1
22,"22025",1071,726,712,13,14,"EB",2
22,"22041",163,127,126,4,1,"EB",1
22,"22129",183,128,127,2,1,"EB",0
22,"22099",490,378,377,4,1,"EB",1
22,"22178",104,87,87,1,0,"EB",0
22,"22062",162,113,113,3,0,"EB",0
22,"22203",82,68,67,0,1,"EB",0
22,"22084",534,413,411,3,2,"EB",1
22,"22020",114,90,90,2,0,"EB",2
22,"22019",180,156,155,0,1,"EB",0
22,"22228",505,409,407,3,2,"EB",2
22,"22136",815,596,595,6,1,"EB",3
22,"22214",128,94,92,0,2,"EB",0
22,"22009",619,463,461,5,2,"EB",0
22,"22246",77,51,50,0,1,"EB",0
22,"22206",201,141,140,2,1,"EB",3
22,"22187",286,224,221,1,3,"EB",0
22,"22111",152,114,113,0,1,"EB",0
22,"22906",180,146,143,1,3,"EB",2
22,"22239",89,78,76,4,2,"EB",1
22,"22197",479,378,373,6,5,"EB",1
22,"22173",234,158,157,0,1,"EB",1
22,"22102",184,160,159,1,1,"EB",1
22,"22027",325,218,214,0,4,"EB",1
22,"22116",1443,1048,1038,12,10,"EB",3
22,"22061",6685,4796,4740,38,56,"EB",16
22,"22032",107,74,71,0,3,"EB",1
22,"22207",125,89,88,3,1,"EB",0
22,"22054",1542,1126,1106,20,20,"EB",12
22,"22124",204,143,142,1,1,"EB",1
22,"22002",109,94,93,0,1,"EB",0
22,"22126",91,65,65,0,0,"EB",0
22,"22199",7029,5024,4977,55,47,"EB",15
22,"22222",527,390,389,5,1,"EB",0
22,"22227",211,153,151,3,2,"EB",0
22,"22193",283,235,234,3,1,"EB",0
22,"22235",100,77,77,0,0,"EB",0
22,"22135",192,146,144,0,2,"EB",0
22,"22088",157,116,116,1,0,"EB",0
22,"22139",83,65,64,0,1,"EB",1
22,"22040",148,123,121,2,2,"EB",1
22,"22168",20,15,15,1,0,"EB",0
22,"22245",306,258,257,3,1,"EB",0
22,"22057",364,260,259,1,1,"EB",1
22,"22090",102,75,75,0,0,"EB",0
22,"22083",474,400,396,1,4,"EB",2
22,"22017",864,658,651,7,7,"EB",0
22,"22095",73,48,48,1,0,"EB",0
22,"22217",395,307,301,3,6,"EB",1
22,"22213",3029,2225,2181,17,44,"EB",12
22,"22167",498,397,388,7,9,"EB",3
22,"22252",122,93,91,1,2,"EB",0
22,"22229",114,81,81,0,0,"EB",0
22,"22253",61,51,50,0,1,"EB",0
22,"22119",1296,950,940,3,10,"EB",2
22,"22076",305,224,223,0,1,"EB",0
22,"22014",245,184,183,2,1,"EB",1
22,"22165",490,375,372,2,3,"EB",1
22,"22018",332,243,242,3,1,"EB",1
22,"22149",302,236,236,2,0,"EB",3
22,"22075",126,82,81,2,1,"EB",0
22,"22114",123,80,79,4,1,"EB",0
22,"22176",174,140,140,1,0,"EB",0
22,"22902",219,162,160,1,2,"EB",3
22,"22209",159,127,127,4,0,"EB",0
22,"22115",364,270,267,4,3,"EB",0
22,"22081",252,179,177,1,2,"EB",0
22,"22218",43,35,35,0,0,"EB",0
22,"22232",96,73,70,2,3,"EB",0
22,"22015",324,238,236,3,2,"EB",1
22,"22059",1137,839,828,7,11,"EB",12
22,"22007",797,607,603,13,4,"EB",1
22,"22244",52,38,38,0,0,"EB",0
22,"22058",190,152,151,2,1,"EB",1
22,"22220",169,123,122,2,1,"EB",1
22,"22233",82,61,61,0,0,"EB",0
22,"22077",381,295,293,5,2,"EB",3
22,"22112",9592,6871,6820,76,51,"EB",26
22,"22201",269,189,189,0,0,"EB",0
22,"22055",325,252,245,5,7,"EB",1
22,"22078",453,323,319,6,4,"EB",3
22,"22060",1165,885,879,3,6,"EB",2
22,"22117",2497,1788,1770,16,18,"EB",12
22,"22008",173,138,138,3,0,"EB",0
22,"22909",318,238,234,2,4,"EB",4
22,"22003",143,119,119,0,0,"EB",1
22,"22064",165,115,115,1,0,"EB",2
22,"22067",65,45,45,1,0,"EB",1
22,"22029",127,101,100,2,1,"EB",1
22,"22248",118,92,91,0,1,"EB",1
22,"22160",209,161,161,3,0,"EB",0
22,"22215",129,91,91,0,0,"EB",0
22,"22155",77,58,58,2,0,"EB",0
22,"22021",1970,1485,1469,14,16,"EB",4
22,"22190",113,83,83,2,0,"EB",0
22,"22170",642,518,509,4,9,"EB",1
22,"22175",197,140,140,0,0,"EB",1
22,"22066",707,512,508,8,4,"EB",4
22,"22053",787,541,535,12,6,"EB",5
22,"22163",426,360,356,3,4,"EB",2
22,"22052",942,743,741,9,2,"EB",6
22,"22143",213,147,147,3,0,"EB",1
22,"22162",129,101,101,0,0,"EB",0
22,"22127",505,387,386,3,1,"EB",1
22,"22006",298,217,215,1,2,"EB",1
22,"22122",62,49,49,1,0,"EB",0
22,"22156",264,202,200,3,2,"EB",2
22,"22068",82,65,65,3,0,"EB",0
22,"22028",379,297,293,1,4,"EB",1
22,"22254",1129,804,792,9,12,"EB",3
22,"22043",94,71,70,0,1,"EB",0
22,"22243",45,32,32,0,0,"EB",0
22,"22036",91,82,82,0,0,"EB",0
22,"22079",118,86,86,2,0,"EB",0
22,"22074",315,229,226,3,3,"EB",0
22,"22096",297,248,248,0,0,"EB",2
22,"22195",235,190,189,2,1,"EB",0
22,"22044",254,191,188,3,3,"EB",1
22,"22189",184,140,137,1,3,"EB",0
22,"22086",215,162,162,4,0,"EB",0
22,"22221",80,60,59,0,1,"EB",0
22,"22004",136,79,79,0,0,"EB",2
22,"22905",294,224,224,2,0,"EB",3
22,"22012",111,84,82,0,2,"EB",0
22,"22901",754,521,513,9,8,"EB",0
22,"22144",248,195,195,0,0,"EB",0
22,"22110",751,563,558,3,5,"EB",2
22,"22164",35,26,26,1,0,"EB",0
22,"22908",207,144,140,1,4,"EB",0
22,"22242",64,45,44,1,1,"EB",0
22,"22045",89,66,66,0,0,"EB",0
22,"22249",119,97,97,1,0,"EB",0
22,"22087",72,48,48,1,0,"EB",0
22,"22046",740,578,570,6,8,"EB",1
22,"22151",93,68,68,0,0,"EB",0
22,"22202",136,112,112,0,0,"EB",0
22,"22107",123,79,78,2,1,"EB",0
22,"22130",10106,6957,6909,57,48,"EB",17
22,"22035",244,171,168,3,3,"EB",2
22,"22082",298,222,220,2,2,"EB",0
22,"22133",117,89,89,4,0,"EB",0
22,"22174",485,400,396,6,4,"EB",2
22,"22051",101,84,84,1,0,"EB",0
22,"22050",89,78,78,0,0,"EB",1
22,"22230",290,224,223,2,1,"EB",0
22,"22072",192,148,147,1,1,"EB",2
22,"22063",175,140,140,2,0,"EB",1
22,"22223",79,63,62,0,1,"EB",0
22,"22016",613,447,444,8,3,"EB",2
22,"22137",1071,729,719,6,10,"EB",3
22,"22205",434,334,333,2,1,"EB",0
22,"22128",187,146,142,1,4,"EB",2
22,"22204",1095,816,805,10,11,"EB",4
22,"22113",494,362,361,3,1,"EB",4
22,"22184",188,156,156,2,0,"EB",0
22,"22236",249,198,198,1,0,"EB",1
22,"22188",87,66,66,1,0,"EB",0
22,"22047",247,213,212,2,1,"EB",0
22,"22105",118,87,86,1,1,"EB",0
22,"22037",116,95,94,1,1,"EB",0
22,"22106",24,17,17,0,0,"EB",0
22,"22225",2691,1849,1817,24,32,"EB",2
22,"22024",225,174,173,0,1,"EB",1
22,"22001",226,166,166,0,0,"EB",0
22,"22250",347,258,256,5,2,"EB",1
22,"22089",315,227,222,6,5,"EB",3
22,"22109",265,207,206,2,1,"EB",1
22,"22904",835,600,594,6,6,"EB",1
22,"22251",371,283,281,4,2,"EB",2
22,"22011",89,70,70,1,0,"EB",0
22,"22208",178,142,140,0,2,"EB",0
22,"22023",430,329,329,2,0,"EB",0
22,"22186",186,139,137,3,2,"EB",0
9,"9217",361,265,261,4,4,"PSOE",45
9,"9141",610,499,493,4,6,"PSOE",121
9,"9109",1068,698,669,10,29,"PSOE",78
9,"9022",67,57,57,1,0,"PSOE",7
9,"9034",280,237,233,5,4,"PSOE",52
9,"9250",273,218,218,4,0,"PSOE",70
9,"9137",167,128,128,1,0,"PSOE",24
9,"9045",267,186,183,2,3,"PSOE",27
9,"9103",221,185,184,2,1,"PSOE",66
9,"9024",156,117,114,0,3,"PSOE",15
9,"9067",442,308,303,9,5,"PSOE",51
9,"9256",362,261,255,2,6,"PSOE",48
9,"9265",38,31,31,0,0,"PSOE",2
9,"9423",27,25,25,0,0,"PSOE",3
9,"9905",391,308,308,5,0,"PSOE",43
9,"9176",61,45,44,0,1,"PSOE",6
9,"9375",35,27,27,0,0,"PSOE",3
9,"9202",24,22,22,1,0,"PSOE",1
9,"9057",144,116,115,0,1,"PSOE",23
9,"9295",60,37,37,0,0,"PSOE",1
9,"9259",233,184,184,3,0,"PSOE",43
9,"9304",202,166,163,1,3,"PSOE",18
9,"9244",47,26,26,1,0,"PSOE",6
9,"9337",115,84,82,0,2,"PSOE",23
9,"9220",76,62,61,2,1,"PSOE",10
9,"9347",141,113,109,4,4,"PSOE",16
9,"9246",622,458,455,5,3,"PSOE",78
9,"9012",93,68,66,1,2,"PSOE",21
9,"9219",27590,19903,19724,166,179,"PSOE",5454
9,"9213",320,223,220,4,3,"PSOE",49
9,"9208",211,139,136,3,3,"PSOE",23
9,"9382",33,30,29,1,1,"PSOE",1
9,"9229",201,146,145,0,1,"PSOE",41
9,"9036",38,31,30,2,1,"PSOE",2
9,"9179",43,35,34,0,1,"PSOE",8
9,"9108",378,290,287,2,3,"PSOE",75
9,"9199",91,65,65,2,0,"PSOE",4
9,"9380",78,59,57,0,2,"PSOE",8
9,"9152",263,193,192,0,1,"PSOE",46
9,"9247",23,19,19,0,0,"PSOE",1
9,"9425",514,369,366,2,3,"PSOE",104
9,"9298",82,62,62,0,0,"PSOE",1
9,"9273",53,41,40,1,1,"PSOE",3
9,"9014",213,127,126,1,1,"PSOE",22
9,"9446",12,7,7,0,0,"PSOE",1
9,"9405",128,89,89,0,0,"PSOE",20
9,"9447",42,38,38,0,0,"PSOE",12
9,"9041",28,28,28,1,0,"PSOE",6
9,"9112",113,75,73,2,2,"PSOE",20
9,"9276",387,280,273,2,7,"PSOE",50
9,"9483",212,161,161,1,0,"PSOE",51
9,"9048",1484,1120,1106,4,14,"PSOE",240
9,"9430",24,19,19,0,0,"PSOE",4
9,"9050",72,54,54,0,0,"PSOE",8
9,"9023",1096,848,840,9,8,"PSOE",122
9,"9101",79,59,59,0,0,"PSOE",6
9,"9143",27,20,20,0,0,"PSOE",1
9,"9476",63,46,46,0,0,"PSOE",10
9,"9163",602,479,472,5,7,"PSOE",140
9,"9125",596,435,433,3,2,"PSOE",72
9,"9288",91,70,69,1,1,"PSOE",8
9,"9378",31,21,21,1,0,"PSOE",6
9,"9396",152,118,118,1,0,"PSOE",6
9,"9218",360,272,271,2,1,"PSOE",70
9,"9052",31,22,21,1,1,"PSOE",0
9,"9906",1223,952,947,9,5,"PSOE",150
9,"9175",129,92,92,0,0,"PSOE",3
9,"9391",361,264,263,2,1,"PSOE",67
9,"9189",130,88,86,2,2,"PSOE",15
9,"9130",79,63,62,1,1,"PSOE",7
9,"9903",3251,2359,2340,24,19,"PSOE",468
9,"9407",27,23,23,1,0,"PSOE",4
9,"9017",89,67,62,0,5,"PSOE",31
9,"9214",684,452,446,6,6,"PSOE",102
9,"9358",249,191,191,1,0,"PSOE",27
9,"9032",108,73,73,0,0,"PSOE",32
9,"9438",544,446,444,3,2,"PSOE",97
9,"9154",142,104,104,2,0,"PSOE",14
9,"9441",74,66,66,0,0,"PSOE",1
9,"9113",464,383,376,6,7,"PSOE",97
9,"9037",113,96,96,0,0,"PSOE",43
9,"9429",56,41,41,0,0,"PSOE",6
9,"9356",42,31,31,0,0,"PSOE",3
9,"9431",119,99,98,0,1,"PSOE",15
9,"9196",154,108,107,1,1,"PSOE",33
9,"9338",219,173,171,1,2,"PSOE",33
9,"9334",48,39,38,0,1,"PSOE",9
9,"9027",47,44,41,0,3,"PSOE",12
9,"9328",77,55,55,1,0,"PSOE",8
9,"9289",1466,1027,1013,6,14,"PSOE",247
9,"9172",125,102,102,2,0,"PSOE",16
9,"9294",111,88,86,0,2,"PSOE",28
9,"9030",109,76,76,3,0,"PSOE",16
9,"9007",59,41,41,0,0,"PSOE",3
9,"9128",82,66,66,0,0,"PSOE",14
9,"9129",105,87,87,0,0,"PSOE",42
9,"9062",51,44,44,1,0,"PSOE",12
9,"9224",157,122,122,0,0,"PSOE",17
9,"9182",78,63,61,2,2,"PSOE",10
9,"9362",204,168,164,0,4,"PSOE",38
9,"9136",192,151,147,2,4,"PSOE",28
9,"9168",296,233,231,1,2,"PSOE",105
9,"9414",201,148,147,1,1,"PSOE",39
9,"9232",151,125,124,2,1,"PSOE",46
9,"9418",82,63,62,3,1,"PSOE",5
9,"9346",93,71,69,0,2,"PSOE",14
9,"9197",148,108,104,1,4,"PSOE",18
9,"9255",86,66,62,0,4,"PSOE",13
9,"9020",262,187,180,2,7,"PSOE",37
9,"9269",39,33,32,0,1,"PSOE",6
9,"9144",52,40,40,0,0,"PSOE",6
9,"9422",18,10,10,0,0,"PSOE",1
9,"9134",228,152,152,2,0,"PSOE",35
9,"9242",81,65,63,2,2,"PSOE",16
9,"9093",154,133,128,1,5,"PSOE",28
9,"9454",47,34,34,0,0,"PSOE",6
9,"9016",85,64,64,2,0,"PSOE",14
9,"9083",37,33,33,0,0,"PSOE",2
9,"9243",75,56,54,1,2,"PSOE",10
9,"9365",31,20,20,0,0,"PSOE",3
9,"9160",90,71,70,0,1,"PSOE",13
9,"9211",1462,1086,1070,11,16,"PSOE",246
9,"9450",27,21,20,1,1,"PSOE",3
9,"9386",58,44,43,2,1,"PSOE",1
9,"9135",41,33,33,1,0,"PSOE",7
9,"9021",56,33,31,0,2,"PSOE",4
9,"9058",393,293,289,2,4,"PSOE",46
9,"9389",77,56,56,0,0,"PSOE",9
9,"9215",377,264,260,0,4,"PSOE",40
9,"9018",24702,18365,18158,174,207,"PSOE",4229
9,"9301",616,513,506,5,7,"PSOE",72
9,"9174",809,575,565,10,10,"PSOE",131
9,"9055",52,39,38,0,1,"PSOE",11
9,"9073",926,753,748,10,5,"PSOE",114
9,"9297",323,265,261,5,4,"PSOE",30
9,"9105",107,88,86,0,2,"PSOE",14
9,"9120",39,35,35,0,0,"PSOE",10
9,"9200",48,37,36,0,1,"PSOE",10
9,"9444",72,48,48,2,0,"PSOE",3
9,"9456",129,90,90,2,0,"PSOE",33
9,"9373",440,285,282,3,3,"PSOE",12
9,"9047",56,45,45,2,0,"PSOE",5
9,"9448",216,180,178,1,2,"PSOE",13
9,"9019",147,103,102,1,1,"PSOE",21
9,"9140",128,88,87,0,1,"PSOE",28
9,"9417",40,30,30,0,0,"PSOE",2
9,"9354",33,30,30,1,0,"PSOE",6
9,"9074",788,609,598,8,11,"PSOE",105
9,"9403",96,78,76,1,2,"PSOE",12
9,"9316",104,83,80,1,3,"PSOE",19
9,"9098",516,396,388,6,8,"PSOE",114
9,"9466",134,99,99,0,0,"PSOE",14
9,"9013",47,41,41,0,0,"PSOE",3
9,"9306",113,91,91,1,0,"PSOE",15
9,"9388",36,31,30,1,1,"PSOE",6
9,"9190",91,56,55,0,1,"PSOE",10
9,"9410",3051,2169,2153,18,16,"PSOE",654
9,"9221",445,337,335,1,2,"PSOE",57
9,"9084",189,150,148,7,2,"PSOE",28
9,"9415",267,166,165,0,1,"PSOE",25
9,"9261",463,339,330,8,9,"PSOE",93
9,"9191",39,32,30,0,2,"PSOE",5
9,"9079",46,40,37,0,3,"PSOE",0
9,"9061",166,124,123,1,1,"PSOE",7
9,"9223",46,39,39,0,0,"PSOE",2
9,"9138",90,73,72,0,1,"PSOE",15
9,"9226",66,55,53,0,2,"PSOE",13
9,"9029",168,134,132,3,2,"PSOE",17
9,"9302",116,87,87,0,0,"PSOE",10
9,"9384",293,199,194,0,5,"PSOE",28
9,"9428",107,87,87,0,0,"PSOE",19
9,"9390",611,478,477,3,1,"PSOE",96
9,"9076",23,14,14,0,0,"PSOE",1
9,"9432",189,143,140,1,3,"PSOE",34
9,"9051",168,133,132,1,1,"PSOE",14
9,"9377",625,478,471,5,7,"PSOE",61
9,"9345",124,92,92,0,0,"PSOE",28
9,"9400",317,258,256,3,2,"PSOE",67
9,"9406",252,196,195,1,1,"PSOE",30
9,"9139",101,75,73,2,2,"PSOE",24
9,"9095",86,62,62,0,0,"PSOE",9
9,"9167",59,42,42,2,0,"PSOE",3
9,"9059",136713,106605,105601,976,1004,"PSOE",20537
9,"9330",1523,1166,1148,15,18,"PSOE",236
9,"9228",163,138,138,0,0,"PSOE",20
9,"9280",27,17,17,0,0,"PSOE",3
9,"9258",173,139,136,4,3,"PSOE",32
9,"9078",41,35,33,0,2,"PSOE",14
9,"9001",27,26,26,0,0,"PSOE",13
9,"9133",40,34,34,0,0,"PSOE",6
9,"9086",687,475,471,0,4,"PSOE",57
9,"9122",96,66,66,0,0,"PSOE",11
9,"9309",306,216,211,2,5,"PSOE",33
9,"9363",974,730,725,3,5,"PSOE",54
9,"9198",108,86,85,2,1,"PSOE",23
9,"9173",123,93,93,1,0,"PSOE",23
9,"9408",41,34,34,1,0,"PSOE",4
9,"9225",84,57,56,1,1,"PSOE",21
9,"9277",119,101,100,0,1,"PSOE",32
9,"9266",91,72,70,0,2,"PSOE",28
9,"9131",460,381,373,5,8,"PSOE",109
9,"9100",59,51,50,0,1,"PSOE",3
9,"9248",78,57,57,0,0,"PSOE",9
9,"9409",109,87,87,0,0,"PSOE",26
9,"9251",371,273,271,3,2,"PSOE",32
9,"9267",115,101,100,3,1,"PSOE",7
9,"9068",29,23,22,0,1,"PSOE",7
9,"9270",163,122,121,1,1,"PSOE",22
9,"9181",302,231,225,3,6,"PSOE",19
9,"9394",727,558,552,8,6,"PSOE",155
9,"9437",286,227,226,5,1,"PSOE",64
9,"9279",177,130,130,0,0,"PSOE",27
9,"9416",52,39,39,0,0,"PSOE",4
9,"9471",151,117,117,0,0,"PSOE",15
9,"9162",143,108,108,0,0,"PSOE",10
9,"9065",147,124,123,2,1,"PSOE",23
9,"9321",1640,1250,1237,5,13,"PSOE",395
9,"9451",238,199,198,1,1,"PSOE",70
9,"9155",26,20,20,1,0,"PSOE",5
9,"9011",69,49,49,0,0,"PSOE",6
9,"9115",92,69,68,0,1,"PSOE",5
9,"9044",46,38,37,0,1,"PSOE",9
9,"9395",136,96,95,0,1,"PSOE",14
9,"9464",36,24,24,0,0,"PSOE",2
9,"9026",397,314,311,1,3,"PSOE",67
9,"9421",237,172,172,2,0,"PSOE",44
9,"9236",38,32,32,0,0,"PSOE",0
9,"9063",213,184,182,2,2,"PSOE",19
9,"9268",95,73,72,0,1,"PSOE",24
9,"9472",55,40,40,0,0,"PSOE",10
9,"9411",149,111,111,0,0,"PSOE",30
9,"9360",30,27,27,0,0,"PSOE",6
9,"9433",60,52,51,0,1,"PSOE",17
9,"9327",25,22,22,0,0,"PSOE",6
9,"9009",163,130,128,2,2,"PSOE",17
9,"9312",98,83,82,0,1,"PSOE",11
9,"9355",101,75,73,0,2,"PSOE",4
9,"9148",86,73,69,5,4,"PSOE",11
9,"9907",1420,1120,1115,13,5,"PSOE",186
9,"9072",307,240,239,1,1,"PSOE",62
9,"9180",136,102,100,2,2,"PSOE",18
9,"9006",61,41,41,0,0,"PSOE",7
9,"9033",89,75,75,0,0,"PSOE",14
9,"9257",92,80,78,4,2,"PSOE",1
9,"9149",34,25,24,0,1,"PSOE",3
9,"9398",75,54,54,1,0,"PSOE",23
9,"9317",16,14,14,0,0,"PSOE",1
9,"9054",100,73,72,3,1,"PSOE",11
9,"9119",46,27,27,0,0,"PSOE",8
9,"9230",38,31,31,0,0,"PSOE",2
9,"9114",87,67,67,0,0,"PSOE",12
9,"9412",803,552,550,2,2,"PSOE",102
9,"9325",195,125,123,2,2,"PSOE",22
9,"9241",201,156,155,3,1,"PSOE",31
9,"9206",61,52,50,3,2,"PSOE",7
9,"9178",52,36,36,1,0,"PSOE",5
9,"9043",189,132,132,2,0,"PSOE",20
9,"9253",111,96,94,1,2,"PSOE",22
9,"9366",90,64,63,1,1,"PSOE",10
9,"9124",1520,1113,1096,9,17,"PSOE",353
9,"9323",64,47,47,0,0,"PSOE",2
9,"9272",294,206,203,1,3,"PSOE",58
9,"9335",87,72,71,0,1,"PSOE",17
9,"9039",58,38,38,0,0,"PSOE",1
9,"9151",458,364,363,3,1,"PSOE",107
9,"9082",40,35,35,0,0,"PSOE",1
9,"9902",461,347,339,1,8,"PSOE",51
9,"9445",44,32,32,1,0,"PSOE",10
9,"9458",466,380,377,3,3,"PSOE",57
9,"9368",22,14,14,1,0,"PSOE",0
9,"9071",45,34,34,0,0,"PSOE",6
9,"9478",45,38,38,0,0,"PSOE",11
9,"9194",2024,1550,1530,17,20,"PSOE",301
9,"9283",46,29,28,0,1,"PSOE",3
9,"9449",87,72,71,1,1,"PSOE",1
9,"9332",140,107,107,1,0,"PSOE",16
9,"9209",4511,3368,3301,37,67,"PSOE",554
9,"9195",57,42,42,2,0,"PSOE",8
9,"9439",1005,823,816,9,7,"PSOE",131
9,"9088",66,44,42,1,2,"PSOE",10
9,"9442",380,287,282,2,5,"PSOE",76
9,"9183",51,37,37,0,0,"PSOE",9
9,"9901",374,268,261,3,7,"PSOE",50
9,"9010",32,23,23,2,0,"PSOE",4
9,"9443",183,132,129,1,3,"PSOE",17
9,"9904",482,389,384,5,5,"PSOE",81
9,"9485",55,43,43,1,0,"PSOE",3
9,"9046",30,26,26,0,0,"PSOE",4
9,"9434",1221,985,970,10,15,"PSOE",163
9,"9307",113,91,91,0,0,"PSOE",43
9,"9090",57,51,51,1,0,"PSOE",1
9,"9318",61,38,38,0,0,"PSOE",11
9,"9262",161,129,129,0,0,"PSOE",31
9,"9275",192,138,137,1,1,"PSOE",28
9,"9085",475,352,350,2,2,"PSOE",80
9,"9235",160,124,123,0,1,"PSOE",38
9,"9038",118,97,94,0,3,"PSOE",22
9,"9413",447,333,333,5,0,"PSOE",48
9,"9070",34,31,30,3,1,"PSOE",6
9,"9123",40,35,35,0,0,"PSOE",9
9,"9231",70,49,49,3,0,"PSOE",14
9,"9287",208,170,168,2,2,"PSOE",44
9,"9056",4931,3634,3602,35,32,"PSOE",603
9,"9424",32,26,26,1,0,"PSOE",5
9,"9249",47,37,37,1,0,"PSOE",8
9,"9102",37,31,31,0,0,"PSOE",4
9,"9227",119,97,95,0,2,"PSOE",24
9,"9169",99,83,81,0,2,"PSOE",22
9,"9311",60,52,50,0,2,"PSOE",20
9,"9340",76,49,49,0,0,"PSOE",3
9,"9066",65,51,51,0,0,"PSOE",14
9,"9314",95,80,79,1,1,"PSOE",26
9,"9292",92,72,70,0,2,"PSOE",18
9,"9387",118,96,95,0,1,"PSOE",21
9,"9003",192,148,146,2,2,"PSOE",37
9,"9064",332,275,275,3,0,"PSOE",28
9,"9351",60,46,45,1,1,"PSOE",2
9,"9392",53,40,40,0,0,"PSOE",11
9,"9352",116,97,97,0,0,"PSOE",29
9,"9480",110,89,88,1,1,"PSOE",13
9,"9132",173,132,130,0,2,"PSOE",23
9,"9274",1098,880,872,9,8,"PSOE",252
9,"9239",53,44,42,1,2,"PSOE",2
9,"9427",1428,1014,1003,12,11,"PSOE",129
9,"9350",480,358,347,5,11,"PSOE",38
9,"9091",732,516,512,7,4,"PSOE",101
9,"9339",128,103,103,0,0,"PSOE",28
9,"9310",13,9,8,0,1,"PSOE",1
9,"9419",78,45,44,0,1,"PSOE",1
9,"9455",44,34,33,0,1,"PSOE",5
9,"9166",97,79,78,3,1,"PSOE",6
9,"9315",379,269,267,2,2,"PSOE",43
9,"9353",73,57,56,0,1,"PSOE",6
9,"9127",55,40,40,0,0,"PSOE",6
9,"9329",123,86,86,1,0,"PSOE",19
9,"9077",36,26,26,1,0,"PSOE",2
9,"9035",313,243,240,0,3,"PSOE",51
9,"9238",932,576,569,6,7,"PSOE",170
9,"9177",1117,830,825,5,5,"PSOE",139
9,"9482",34,29,28,0,1,"PSOE",2
9,"9303",92,72,71,0,1,"PSOE",14
9,"9216",385,283,280,8,3,"PSOE",51
9,"9369",442,331,328,1,3,"PSOE",98
9,"9374",90,79,77,2,2,"PSOE",12
9,"9201",30,17,17,0,0,"PSOE",5
9,"9348",146,116,114,1,2,"PSOE",26
9,"9343",97,70,69,0,1,"PSOE",8
9,"9192",55,47,46,0,1,"PSOE",9
9,"9075",111,83,83,1,0,"PSOE",9
9,"9281",147,109,107,0,2,"PSOE",27
9,"9170",203,152,149,1,3,"PSOE",20
9,"9463",262,206,206,3,0,"PSOE",43
9,"9467",66,46,46,3,0,"PSOE",6
9,"9025",125,86,79,1,7,"PSOE",14
9,"9372",221,190,189,1,1,"PSOE",28
9,"9381",32,23,22,0,1,"PSOE",2
9,"9361",117,96,96,0,0,"PSOE",14
9,"9110",80,49,49,1,0,"PSOE",12
9,"9164",165,121,121,1,0,"PSOE",21
9,"9159",56,48,48,1,0,"PSOE",2
9,"9308",67,43,43,1,0,"PSOE",2
9,"9440",96,78,78,0,0,"PSOE",22
9,"9460",177,135,135,2,0,"PSOE",20
9,"9094",51,42,41,0,1,"PSOE",3
9,"9184",5,4,4,0,0,"PSOE",0
9,"9326",148,115,113,2,2,"PSOE",18
9,"9117",77,61,57,0,4,"PSOE",12
9,"9473",85,62,61,1,1,"PSOE",8
9,"9908",469,314,309,2,5,"PSOE",53
9,"9104",54,43,43,0,0,"PSOE",1
9,"9060",148,123,123,0,0,"PSOE",19
36,"36001",2593,1968,1952,6,16,"PSdeG-PSOE",379
36,"36025",2292,1396,1389,9,7,"PSdeG-PSOE",209
36,"36041",13428,9842,9710,96,132,"PSdeG-PSOE",1782
36,"36017",17866,13133,12910,137,223,"PSdeG-PSOE",2953
36,"36053",5693,4321,4265,41,56,"PSdeG-PSOE",699
36,"36901",4095,3344,3293,22,51,"PSdeG-PSOE",1179
36,"36029",16129,12262,12078,101,184,"PSdeG-PSOE",2061
36,"36013",2412,1602,1586,12,16,"PSdeG-PSOE",288
36,"36026",20203,14399,14189,144,210,"PSdeG-PSOE",2453
36,"36046",4055,3189,3139,30,50,"PSdeG-PSOE",750
36,"36042",17922,12993,12760,116,233,"PSdeG-PSOE",2559
36,"36050",7562,5567,5457,44,110,"PSdeG-PSOE",1413
36,"36038",66390,49943,49439,522,504,"PSdeG-PSOE",9927
36,"36034",3477,2499,2470,15,29,"PSdeG-PSOE",495
36,"36054",10996,8116,7965,84,151,"PSdeG-PSOE",1560
36,"36002",3151,2290,2255,19,35,"PSdeG-PSOE",474
36,"36003",9979,7496,7401,81,95,"PSdeG-PSOE",1301
36,"36051",14272,10230,10072,95,158,"PSdeG-PSOE",1866
36,"36014",1980,1464,1442,7,22,"PSdeG-PSOE",246
36,"36027",4452,3328,3274,23,54,"PSdeG-PSOE",652
36,"36007",1689,1168,1148,12,20,"PSdeG-PSOE",318
36,"36055",13643,10361,10145,106,216,"PSdeG-PSOE",1884
36,"36031",558,464,454,9,10,"PSdeG-PSOE",64
36,"36049",6761,5193,5069,54,124,"PSdeG-PSOE",824
36,"36039",15350,11581,11349,119,232,"PSdeG-PSOE",2027
36,"36052",7298,5298,5175,37,123,"PSdeG-PSOE",1350
36,"36011",1842,1185,1169,9,16,"PSdeG-PSOE",231
36,"36056",5108,3856,3783,34,73,"PSdeG-PSOE",670
36,"36040",2600,1907,1869,13,38,"PSdeG-PSOE",410
36,"36006",11537,8885,8740,79,145,"PSdeG-PSOE",1597
36,"36016",1173,724,716,7,8,"PSdeG-PSOE",72
36,"36004",10178,7351,7224,69,127,"PSdeG-PSOE",1150
36,"36028",4139,3094,3045,22,49,"PSdeG-PSOE",705
36,"36048",5348,3970,3892,44,78,"PSdeG-PSOE",753
36,"36008",21736,16270,16094,160,176,"PSdeG-PSOE",2347
36,"36032",3655,2745,2699,21,46,"PSdeG-PSOE",667
36,"36036",2511,1923,1892,17,31,"PSdeG-PSOE",439
36,"36022",9056,6635,6514,48,121,"PSdeG-PSOE",1385
36,"36045",24570,18613,18365,184,248,"PSdeG-PSOE",4342
36,"36061",8651,6594,6445,58,149,"PSdeG-PSOE",1197
36,"36059",4937,3379,3318,46,61,"PSdeG-PSOE",511
36,"36005",8120,5839,5747,64,92,"PSdeG-PSOE",1589
36,"36044",2556,1786,1747,13,39,"PSdeG-PSOE",331
36,"36015",4205,2941,2885,32,56,"PSdeG-PSOE",803
36,"36009",4908,3167,3114,25,53,"PSdeG-PSOE",680
36,"36057",236957,177555,175758,1730,1797,"PSdeG-PSOE",38698
36,"36021",12033,9035,8879,99,156,"PSdeG-PSOE",1962
36,"36058",4992,3495,3441,48,54,"PSdeG-PSOE",892
36,"36024",16433,12239,12016,115,223,"PSdeG-PSOE",1986
36,"36060",30350,22032,21753,193,279,"PSdeG-PSOE",4964
36,"36035",14430,10832,10680,86,152,"PSdeG-PSOE",2204
36,"36018",3272,2288,2262,17,26,"PSdeG-PSOE",510
36,"36030",4220,3041,2994,32,47,"PSdeG-PSOE",628
36,"36043",4736,3347,3297,22,50,"PSdeG-PSOE",833
36,"36012",3735,2818,2777,21,41,"PSdeG-PSOE",754
36,"36037",2607,1862,1838,16,24,"PSdeG-PSOE",312
36,"36033",12347,9515,9336,76,179,"PSdeG-PSOE",2175
36,"36023",8420,6287,6180,55,107,"PSdeG-PSOE",1011
36,"36019",1625,1127,1119,12,8,"PSdeG-PSOE",501
36,"36047",2492,1719,1704,16,15,"PSdeG-PSOE",454
36,"36010",2862,2195,2177,18,18,"PSdeG-PSOE",522
36,"36020",2351,1748,1721,20,27,"PSdeG-PSOE",299
3,"3074",1706,1400,1382,3,18,"P-LIB",0
3,"3076",8485,6251,6194,37,57,"P-LIB",1
3,"3134",148,132,132,2,0,"P-LIB",1
3,"3046",1594,1185,1178,9,7,"P-LIB",1
3,"3903",2482,1945,1926,16,19,"P-LIB",1
3,"3090",17087,12723,12602,69,121,"P-LIB",2
3,"3059",20538,15653,15522,79,131,"P-LIB",5
3,"3115",248,219,219,2,0,"P-LIB",0
3,"3099",42365,31612,31259,220,353,"P-LIB",14
3,"3007",168,142,138,0,4,"P-LIB",0
3,"3119",16534,12466,12363,69,103,"P-LIB",5
3,"3034",1367,1095,1079,4,16,"P-LIB",0
3,"3009",46817,36581,36258,240,323,"P-LIB",13
3,"3098",507,403,394,3,9,"P-LIB",0
3,"3040",257,222,222,0,0,"P-LIB",0
3,"3067",98,82,81,1,1,"P-LIB",0
3,"3008",167,132,131,0,1,"P-LIB",0
3,"3053",7196,5800,5736,37,64,"P-LIB",2
3,"3094",9033,6702,6657,32,45,"P-LIB",6
3,"3129",1187,991,984,8,7,"P-LIB",0
3,"3110",289,239,239,1,0,"P-LIB",0
3,"3016",94,79,79,0,0,"P-LIB",0
3,"3015",12544,9478,9388,58,90,"P-LIB",4
3,"3904",1393,1065,1057,8,8,"P-LIB",3
3,"3105",5387,4089,4017,21,72,"P-LIB",2
3,"3069",3060,2187,2168,9,19,"P-LIB",0
3,"3012",1072,862,849,3,13,"P-LIB",0
3,"3106",596,503,501,1,2,"P-LIB",0
3,"3086",153,134,134,1,0,"P-LIB",0
3,"3055",5168,3949,3899,13,50,"P-LIB",1
3,"3056",8737,6809,6731,33,78,"P-LIB",4
3,"3071",3980,3134,3106,28,28,"P-LIB",2
3,"3027",159,135,132,0,3,"P-LIB",0
3,"3118",2452,1732,1714,9,18,"P-LIB",0
3,"3032",106,90,89,1,1,"P-LIB",0
3,"3075",156,139,139,0,0,"P-LIB",0
3,"3114",1568,1216,1203,8,13,"P-LIB",1
3,"3902",10213,7091,6997,52,94,"P-LIB",3
3,"3097",990,817,811,8,6,"P-LIB",0
3,"3035",663,543,538,1,5,"P-LIB",0
3,"3083",5607,4160,4106,36,54,"P-LIB",3
3,"3063",26383,19376,19255,105,121,"P-LIB",8
3,"3045",216,182,179,1,3,"P-LIB",0
3,"3095",4602,3628,3605,27,23,"P-LIB",1
3,"3023",1410,1221,1201,8,20,"P-LIB",0
3,"3128",4097,2972,2942,12,30,"P-LIB",1
3,"3102",7271,5762,5687,46,75,"P-LIB",4
3,"3123",7472,5748,5680,38,68,"P-LIB",2
3,"3013",1114,914,906,5,8,"P-LIB",0
3,"3031",41486,28059,27851,152,208,"P-LIB",13
3,"3140",26176,19795,19509,155,286,"P-LIB",8
3,"3080",1299,1065,1036,3,29,"P-LIB",0
3,"3042",1367,1045,1033,5,12,"P-LIB",0
3,"3085",270,226,225,1,1,"P-LIB",1
3,"3039",85,61,59,0,2,"P-LIB",0
3,"3135",214,176,174,0,2,"P-LIB",0
3,"3136",446,361,361,2,0,"P-LIB",0
3,"3079",18235,14578,14388,114,190,"P-LIB",5
3,"3089",9599,7100,6980,39,120,"P-LIB",4
3,"3137",653,516,515,5,1,"P-LIB",0
3,"3001",337,289,286,3,3,"P-LIB",0
3,"3081",1433,1130,1118,5,12,"P-LIB",0
3,"3061",1057,828,816,2,12,"P-LIB",0
3,"3058",4947,4015,3978,21,37,"P-LIB",0
3,"3021",5627,4691,4613,23,78,"P-LIB",1
3,"3103",278,240,237,1,3,"P-LIB",0
3,"3047",9161,6622,6534,35,88,"P-LIB",1
3,"3127",352,279,277,1,2,"P-LIB",0
3,"3088",5498,4078,4030,42,48,"P-LIB",4
3,"3111",5411,4044,3967,14,77,"P-LIB",0
3,"3070",2038,1526,1499,5,27,"P-LIB",0
3,"3038",358,292,285,2,7,"P-LIB",0
3,"3124",469,400,394,5,6,"P-LIB",0
3,"3082",12542,8709,8597,48,112,"P-LIB",3
3,"3084",543,478,476,4,2,"P-LIB",0
3,"3121",21269,14932,14795,78,137,"P-LIB",2
3,"3072",351,288,287,2,1,"P-LIB",0
3,"3131",175,159,153,0,6,"P-LIB",0
3,"3122",42227,31379,31186,160,193,"P-LIB",11
3,"3078",486,398,397,3,1,"P-LIB",0
3,"3054",338,274,268,4,6,"P-LIB",0
3,"3043",2900,2516,2483,18,33,"P-LIB",1
3,"3005",7753,6158,6118,38,40,"P-LIB",2
3,"3044",4512,3639,3586,16,53,"P-LIB",1
3,"3091",247,217,215,1,2,"P-LIB",0
3,"3125",346,263,262,0,1,"P-LIB",0
3,"3026",1224,970,949,6,21,"P-LIB",0
3,"3107",2459,1807,1791,5,16,"P-LIB",1
3,"3116",1159,892,886,2,6,"P-LIB",0
3,"3002",3610,2714,2682,18,32,"P-LIB",0
3,"3066",42291,31010,30781,190,229,"P-LIB",10
3,"3120",2416,1814,1783,13,31,"P-LIB",1
3,"3050",18601,13710,13610,61,100,"P-LIB",9
3,"3073",236,202,202,1,0,"P-LIB",0
3,"3030",513,432,424,0,8,"P-LIB",0
3,"3025",1270,1003,996,3,7,"P-LIB",0
3,"3138",3154,2406,2378,10,28,"P-LIB",0
3,"3014",237548,173040,172027,866,1013,"P-LIB",64
3,"3901",1129,855,853,5,2,"P-LIB",0
3,"3036",91,80,79,2,1,"P-LIB",0
3,"3048",4858,3785,3735,25,50,"P-LIB",2
3,"3132",536,426,423,0,3,"P-LIB",1
3,"3019",15261,11921,11804,98,117,"P-LIB",7
3,"3077",1374,1139,1126,11,13,"P-LIB",0
3,"3112",653,522,517,2,5,"P-LIB",1
3,"3100",508,446,442,1,4,"P-LIB",0
3,"3133",41763,26236,26039,134,197,"P-LIB",11
3,"3006",497,401,393,4,8,"P-LIB",0
3,"3033",113,97,97,2,0,"P-LIB",0
3,"3062",213,176,175,0,1,"P-LIB",0
3,"3093",19661,15155,14988,84,167,"P-LIB",7
3,"3057",191,148,148,2,0,"P-LIB",0
3,"3049",12082,9341,9236,69,105,"P-LIB",3
3,"3011",7729,5651,5595,29,56,"P-LIB",2
3,"3068",46,41,40,0,1,"P-LIB",1
3,"3017",376,317,312,3,5,"P-LIB",0
3,"3010",325,278,276,0,2,"P-LIB",0
3,"3139",22357,15787,15624,101,163,"P-LIB",15
3,"3003",455,393,388,3,5,"P-LIB",0
3,"3052",969,804,794,6,10,"P-LIB",1
3,"3101",4765,3708,3659,13,49,"P-LIB",1
3,"3096",5811,4539,4492,19,47,"P-LIB",0
3,"3004",585,455,454,1,1,"P-LIB",0
3,"3060",108,92,90,1,2,"P-LIB",0
3,"3065",166944,126831,126024,773,807,"P-LIB",90
3,"3041",5945,4393,4344,28,49,"P-LIB",8
3,"3104",27134,21080,20902,156,178,"P-LIB",8
3,"3092",6749,5398,5342,40,56,"P-LIB",3
3,"3109",2850,2301,2275,11,26,"P-LIB",0
3,"3117",370,325,322,0,3,"P-LIB",0
3,"3113",4254,3159,3120,17,39,"P-LIB",0
3,"3018",12212,9129,9040,64,89,"P-LIB",10
3,"3022",142,120,120,2,0,"P-LIB",0
3,"3051",350,310,305,1,5,"P-LIB",0
3,"3020",102,79,79,0,0,"P-LIB",0
3,"3024",3904,3109,3060,17,49,"P-LIB",0
3,"3037",352,296,293,3,3,"P-LIB",2
3,"3028",1006,833,823,1,10,"P-LIB",2
3,"3130",47,30,30,0,0,"P-LIB",0
3,"3064",5040,3887,3834,16,53,"P-LIB",3
3,"3029",242,186,183,1,3,"P-LIB",0
27,"27039",4372,3327,3244,56,83,"PP",1565
27,"27026",2423,1667,1602,12,65,"PP",667
27,"27045",1049,667,658,9,9,"PP",205
27,"27031",15650,10901,10710,106,191,"PP",4086
27,"27047",1643,1116,1104,10,12,"PP",409
27,"27034",1154,720,710,6,10,"PP",318
27,"27050",2993,2241,2203,16,38,"PP",1286
27,"27005",2615,1942,1918,16,24,"PP",885
27,"27037",1075,736,723,12,13,"PP",383
27,"27901",2404,1647,1624,25,23,"PP",929
27,"27041",2377,1737,1722,16,15,"PP",917
27,"27040",3225,2454,2415,22,39,"PP",1337
27,"27049",1422,969,958,8,11,"PP",549
27,"27066",12767,9200,9039,102,161,"PP",3286
27,"27001",2401,1346,1313,24,33,"PP",802
27,"27032",3313,2269,2230,29,39,"PP",1023
27,"27014",3284,2187,2148,29,39,"PP",923
27,"27030",3361,2333,2290,27,43,"PP",1065
27,"27064",1593,1179,1153,14,26,"PP",649
27,"27002",1651,1224,1200,8,24,"PP",509
27,"27016",7204,5069,4987,65,82,"PP",2255
27,"27053",546,349,349,1,0,"PP",136
27,"27065",12528,8701,8483,150,218,"PP",4349
27,"27025",2859,2293,2243,17,50,"PP",1043
27,"27063",1761,1340,1299,12,41,"PP",519
27,"27019",8120,6041,5936,82,105,"PP",2183
27,"27003",1913,1372,1351,16,21,"PP",764
27,"27035",190,121,121,2,0,"PP",30
27,"27017",1017,674,666,6,8,"PP",340
27,"27022",4859,3324,3251,38,73,"PP",1341
27,"27046",1538,1119,1099,10,20,"PP",407
27,"27054",1205,920,906,7,14,"PP",473
27,"27059",2202,1640,1605,19,35,"PP",925
27,"27021",1772,1167,1136,21,31,"PP",494
27,"27061",1045,821,796,10,25,"PP",361
27,"27060",2651,1761,1729,12,32,"PP",847
27,"27008",1377,1011,992,11,19,"PP",517
27,"27058",3577,2669,2632,37,37,"PP",1465
27,"27051",8102,5883,5784,71,99,"PP",2224
27,"27033",631,454,449,8,5,"PP",187
27,"27020",3539,2954,2896,38,58,"PP",1751
27,"27024",1624,1250,1226,8,24,"PP",591
27,"27004",1251,846,828,2,18,"PP",476
27,"27018",3514,2279,2255,17,24,"PP",814
27,"27057",11176,7921,7709,99,212,"PP",3253
27,"27044",2901,1891,1832,28,59,"PP",922
27,"27038",945,679,674,9,5,"PP",267
27,"27013",3782,3067,3007,21,60,"PP",1085
27,"27007",2833,2211,2144,34,67,"PP",1250
27,"27009",2110,1595,1573,11,22,"PP",927
27,"27052",918,659,649,3,10,"PP",270
27,"27023",2593,1981,1942,24,39,"PP",1126
27,"27055",1320,869,855,3,14,"PP",398
27,"27027",1937,1458,1425,19,33,"PP",556
27,"27042",1759,1258,1235,21,23,"PP",767
27,"27043",1313,875,855,14,20,"PP",411
27,"27029",1475,1142,1116,19,26,"PP",473
27,"27010",4363,3072,2990,45,82,"PP",1386
27,"27028",79061,57271,56444,702,827,"PP",19934
27,"27048",2176,1658,1626,19,32,"PP",689
27,"27056",1268,899,886,11,13,"PP",360
27,"27011",2490,1623,1592,14,31,"PP",637
27,"27062",619,468,465,6,3,"PP",247
27,"27012",1366,778,769,5,9,"PP",344
27,"27006",2611,1752,1723,26,29,"PP",809
27,"27015",4304,3063,2985,41,78,"PP",1554
27,"27902",7196,5017,4921,55,96,"PP",1860
8,"8198",4391,3167,3138,17,29,"PSC-PSOE",259
8,"8086",13550,9448,9395,66,53,"PSC-PSOE",1478
8,"8101",174802,123863,123197,643,666,"PSC-PSOE",31512
8,"8055",512,366,364,2,2,"PSC-PSOE",33
8,"8045",72,42,39,0,3,"PSC-PSOE",0
8,"8103",631,431,431,3,0,"PSC-PSOE",20
8,"8213",6296,4308,4294,47,14,"PSC-PSOE",530
8,"8256",644,516,512,1,4,"PSC-PSOE",35
8,"8181",7896,5774,5724,41,50,"PSC-PSOE",740
8,"8022",12230,7792,7717,60,75,"PSC-PSOE",800
8,"8090",129,103,102,2,1,"PSC-PSOE",5
8,"8139",171,133,132,0,1,"PSC-PSOE",18
8,"8049",1288,860,841,9,19,"PSC-PSOE",24
8,"8062",951,676,674,5,2,"PSC-PSOE",75
8,"8219",15355,11458,11403,86,55,"PSC-PSOE",1081
8,"8047",3978,2640,2614,21,26,"PSC-PSOE",457
8,"8117",2453,1741,1727,23,14,"PSC-PSOE",171
8,"8027",690,527,524,3,3,"PSC-PSOE",63
8,"8069",3168,2333,2324,17,9,"PSC-PSOE",219
8,"8015",155841,109156,108536,726,620,"PSC-PSOE",21603
8,"8147",17001,12422,12333,62,89,"PSC-PSOE",1982
8,"8294",1971,1357,1349,8,8,"PSC-PSOE",70
8,"8260",18306,13492,13423,60,69,"PSC-PSOE",2376
8,"8239",451,324,324,5,0,"PSC-PSOE",18
8,"8105",9613,7103,7047,46,56,"PSC-PSOE",1923
8,"8191",5287,3732,3712,31,20,"PSC-PSOE",645
8,"8119",6182,4517,4492,35,25,"PSC-PSOE",704
8,"8020",4876,3702,3678,25,24,"PSC-PSOE",314
8,"8158",3105,2166,2145,18,21,"PSC-PSOE",312
8,"8050",141,107,104,0,3,"PSC-PSOE",2
8,"8125",25024,18070,17966,99,104,"PSC-PSOE",3515
8,"8051",17873,13126,13048,66,78,"PSC-PSOE",1949
8,"8277",162,132,132,0,0,"PSC-PSOE",7
8,"8194",25539,16628,16553,77,75,"PSC-PSOE",3712
8,"8296",1787,1358,1351,9,7,"PSC-PSOE",92
8,"8121",86293,61426,61070,450,356,"PSC-PSOE",10891
8,"8002",202,142,139,0,3,"PSC-PSOE",2
8,"8088",11840,8684,8627,55,57,"PSC-PSOE",888
8,"8177",40,25,25,1,0,"PSC-PSOE",3
8,"8272",157,98,97,0,1,"PSC-PSOE",4
8,"8138",4229,2832,2816,19,16,"PSC-PSOE",267
8,"8012",1676,1175,1170,24,5,"PSC-PSOE",77
8,"8116",582,421,418,4,3,"PSC-PSOE",21
8,"8075",3875,2709,2695,12,14,"PSC-PSOE",328
8,"8206",731,568,559,9,9,"PSC-PSOE",82
8,"8060",143,100,99,0,1,"PSC-PSOE",2
8,"8006",11427,7789,7727,46,62,"PSC-PSOE",916
8,"8104",682,445,443,4,2,"PSC-PSOE",21
8,"8118",17516,12878,12820,79,58,"PSC-PSOE",1285
8,"8293",226,162,162,0,0,"PSC-PSOE",21
8,"8041",10314,7291,7238,46,53,"PSC-PSOE",1906
8,"8143",2686,1892,1881,19,11,"PSC-PSOE",327
8,"8904",10563,7474,7437,32,37,"PSC-PSOE",2059
8,"8013",1219,873,867,10,6,"PSC-PSOE",70
8,"8150",258,189,185,0,4,"PSC-PSOE",2
8,"8254",1746,1261,1257,13,4,"PSC-PSOE",32
8,"8258",835,602,597,5,5,"PSC-PSOE",20
8,"8064",1853,1323,1315,9,8,"PSC-PSOE",115
8,"8080",38,28,27,0,1,"PSC-PSOE",2
8,"8300",5682,4328,4312,21,16,"PSC-PSOE",564
8,"8035",12448,8482,8443,54,39,"PSC-PSOE",1110
8,"8164",911,651,644,2,7,"PSC-PSOE",55
8,"8039",354,259,259,0,0,"PSC-PSOE",16
8,"8203",2422,1602,1591,11,11,"PSC-PSOE",151
8,"8004",233,181,181,2,0,"PSC-PSOE",4
8,"8023",6715,4669,4633,25,36,"PSC-PSOE",521
8,"8145",2585,1927,1915,10,12,"PSC-PSOE",244
8,"8160",330,217,217,0,0,"PSC-PSOE",5
8,"8057",59,42,41,2,1,"PSC-PSOE",0
8,"8215",2576,1766,1751,30,15,"PSC-PSOE",200
8,"8204",3058,2282,2262,17,20,"PSC-PSOE",335
8,"8216",25,17,17,0,0,"PSC-PSOE",0
8,"8302",9209,6571,6524,65,47,"PSC-PSOE",1474
8,"8065",1179,837,831,8,6,"PSC-PSOE",67
8,"8124",36750,26968,26842,140,126,"PSC-PSOE",5772
8,"8169",47915,35543,35390,211,153,"PSC-PSOE",8087
8,"8248",5402,3848,3815,27,33,"PSC-PSOE",423
8,"8259",6623,4921,4885,33,36,"PSC-PSOE",575
8,"8048",583,426,424,5,2,"PSC-PSOE",31
8,"8161",11145,7658,7621,45,37,"PSC-PSOE",1209
8,"8172",20384,14738,14684,85,54,"PSC-PSOE",2081
8,"8153",536,432,431,6,1,"PSC-PSOE",17
8,"8171",2099,1396,1389,20,7,"PSC-PSOE",83
8,"8093",26,19,19,0,0,"PSC-PSOE",0
8,"8202",12615,8911,8831,70,80,"PSC-PSOE",1344
8,"8095",71,50,50,0,0,"PSC-PSOE",5
8,"8238",14478,11302,11252,85,50,"PSC-PSOE",1127
8,"8205",59169,45410,45231,357,179,"PSC-PSOE",3562
8,"8019",1141245,824778,820790,5063,3988,"PSC-PSOE",108668
8,"8141",4590,3173,3150,39,23,"PSC-PSOE",415
8,"8182",2803,2039,2034,16,5,"PSC-PSOE",483
8,"8298",26426,17862,17784,113,78,"PSC-PSOE",1665
8,"8082",1150,788,783,6,5,"PSC-PSOE",127
8,"8195",82,64,64,0,0,"PSC-PSOE",1
8,"8058",1742,1210,1194,7,16,"PSC-PSOE",197
8,"8232",1797,1276,1266,14,10,"PSC-PSOE",152
8,"8017",2756,1888,1876,7,12,"PSC-PSOE",279
8,"8174",394,306,300,3,6,"PSC-PSOE",21
8,"8094",1548,1143,1133,12,10,"PSC-PSOE",111
8,"8210",4296,2825,2806,22,19,"PSC-PSOE",261
8,"8024",381,270,269,3,1,"PSC-PSOE",21
8,"8251",4970,3505,3480,14,25,"PSC-PSOE",770
8,"8262",6855,4522,4491,46,31,"PSC-PSOE",765
8,"8295",10850,7651,7617,33,34,"PSC-PSOE",1259
8,"8071",241,168,164,3,4,"PSC-PSOE",14
8,"8266",43128,32806,32660,195,146,"PSC-PSOE",5711
8,"8222",1878,1452,1443,16,9,"PSC-PSOE",139
8,"8163",18590,12816,12750,72,66,"PSC-PSOE",2681
8,"8029",3438,2645,2632,25,13,"PSC-PSOE",182
8,"8187",152527,112013,111491,638,522,"PSC-PSOE",20170
8,"8149",996,662,660,7,2,"PSC-PSOE",22
8,"8036",159,113,112,1,1,"PSC-PSOE",3
8,"8237",1642,1165,1160,4,5,"PSC-PSOE",98
8,"8128",564,378,377,1,1,"PSC-PSOE",46
8,"8110",13392,9211,9142,67,69,"PSC-PSOE",1755
8,"8244",5821,4484,4451,32,33,"PSC-PSOE",550
8,"8285",10260,6893,6843,56,50,"PSC-PSOE",814
8,"8230",7611,5590,5560,40,30,"PSC-PSOE",737
8,"8089",33935,24504,24392,150,112,"PSC-PSOE",5105
8,"8209",6773,4845,4822,31,23,"PSC-PSOE",605
8,"8281",4841,3577,3553,18,24,"PSC-PSOE",241
8,"8246",1682,1157,1152,8,5,"PSC-PSOE",43
8,"8305",27328,19226,19083,116,143,"PSC-PSOE",2749
8,"8113",52051,34906,34729,229,177,"PSC-PSOE",4678
8,"8014",1953,1438,1429,13,9,"PSC-PSOE",141
8,"8267",6435,4571,4542,24,29,"PSC-PSOE",783
8,"8085",985,712,704,1,8,"PSC-PSOE",39
8,"8245",78581,55798,55530,345,268,"PSC-PSOE",15707
8,"8137",265,206,205,1,1,"PSC-PSOE",13
8,"8063",448,363,363,8,0,"PSC-PSOE",19
8,"8231",20495,13961,13885,91,76,"PSC-PSOE",2403
8,"8151",463,336,333,11,3,"PSC-PSOE",6
8,"8229",535,383,379,3,4,"PSC-PSOE",11
8,"8261",2319,1638,1632,4,6,"PSC-PSOE",162
8,"8196",19247,14101,14047,75,54,"PSC-PSOE",3436
8,"8005",6165,4458,4434,23,24,"PSC-PSOE",302
8,"8003",7118,5140,5108,28,32,"PSC-PSOE",395
8,"8152",114,84,82,1,2,"PSC-PSOE",1
8,"8176",158,113,113,1,0,"PSC-PSOE",0
8,"8079",339,254,248,2,6,"PSC-PSOE",20
8,"8276",233,169,169,3,0,"PSC-PSOE",12
8,"8199",665,466,464,6,2,"PSC-PSOE",44
8,"8188",117,81,81,2,0,"PSC-PSOE",4
8,"8054",9013,6747,6702,38,45,"PSC-PSOE",992
8,"8108",5014,3757,3740,21,17,"PSC-PSOE",567
8,"8170",447,293,291,11,2,"PSC-PSOE",24
8,"8102",28304,19929,19821,170,108,"PSC-PSOE",2447
8,"8126",8709,6454,6425,34,29,"PSC-PSOE",827
8,"8148",2238,1592,1580,7,12,"PSC-PSOE",269
8,"8268",1011,702,699,2,3,"PSC-PSOE",128
8,"8240",9354,6996,6953,34,43,"PSC-PSOE",1093
8,"8303",278,206,205,2,1,"PSC-PSOE",16
8,"8073",61659,45611,45356,239,255,"PSC-PSOE",11829
8,"8135",6733,5230,5205,45,25,"PSC-PSOE",1220
8,"8021",69,52,51,3,1,"PSC-PSOE",3
8,"8289",4304,3166,3151,19,15,"PSC-PSOE",318
8,"8200",61275,45027,44785,276,242,"PSC-PSOE",10402
8,"8233",1876,1247,1237,11,10,"PSC-PSOE",61
8,"8307",48233,34249,34071,209,178,"PSC-PSOE",5597
8,"8211",32990,25446,25282,173,164,"PSC-PSOE",4967
8,"8249",266,223,220,2,3,"PSC-PSOE",6
8,"8096",42411,30717,30550,204,167,"PSC-PSOE",5410
8,"8059",342,224,223,3,1,"PSC-PSOE",6
8,"8190",258,179,177,2,2,"PSC-PSOE",12
8,"8010",4196,2876,2852,16,24,"PSC-PSOE",284
8,"8007",6505,4532,4495,28,37,"PSC-PSOE",373
8,"8133",128,76,75,0,1,"PSC-PSOE",3
8,"8301",48496,35956,35788,200,168,"PSC-PSOE",8760
8,"8279",152985,110533,110039,684,494,"PSC-PSOE",19305
8,"8034",766,542,538,3,4,"PSC-PSOE",25
8,"8097",1027,736,731,7,5,"PSC-PSOE",51
8,"8220",2358,1783,1770,18,13,"PSC-PSOE",45
8,"8275",254,202,202,4,0,"PSC-PSOE",6
8,"8159",14049,10329,10284,51,45,"PSC-PSOE",1750
8,"8068",6729,4765,4739,23,26,"PSC-PSOE",680
8,"8156",10923,8013,7964,50,49,"PSC-PSOE",1093
8,"8038",1488,987,981,10,6,"PSC-PSOE",95
8,"8247",958,716,714,7,2,"PSC-PSOE",32
8,"8236",1525,1077,1067,3,10,"PSC-PSOE",88
8,"8134",803,560,554,5,6,"PSC-PSOE",61
8,"8146",1297,958,954,16,4,"PSC-PSOE",156
8,"8016",1822,1229,1214,12,15,"PSC-PSOE",160
8,"8192",5696,4093,4069,38,24,"PSC-PSOE",380
8,"8083",1674,1287,1275,8,12,"PSC-PSOE",38
8,"8269",2646,1871,1860,17,11,"PSC-PSOE",98
8,"8127",2224,1439,1429,8,10,"PSC-PSOE",237
8,"8184",53690,37794,37636,200,158,"PSC-PSOE",7413
8,"8270",18399,12948,12869,83,79,"PSC-PSOE",1505
8,"8028",1031,724,721,6,3,"PSC-PSOE",131
8,"8091",5253,3817,3795,23,22,"PSC-PSOE",572
8,"8154",694,535,529,3,6,"PSC-PSOE",51
8,"8106",7216,5220,5176,38,44,"PSC-PSOE",718
8,"8087",159,131,130,2,1,"PSC-PSOE",4
8,"8165",1657,1181,1175,8,6,"PSC-PSOE",174
8,"8304",814,578,573,1,5,"PSC-PSOE",58
8,"8282",6517,5027,5017,40,10,"PSC-PSOE",471
8,"8189",126,95,94,2,1,"PSC-PSOE",2
8,"8033",12803,9236,9179,79,57,"PSC-PSOE",1274
8,"8066",1364,1029,1025,10,4,"PSC-PSOE",143
8,"8129",456,322,320,3,2,"PSC-PSOE",9
8,"8030",5095,3727,3712,27,15,"PSC-PSOE",222
8,"8903",213,167,167,0,0,"PSC-PSOE",2
8,"8241",76,59,59,0,0,"PSC-PSOE",0
8,"8067",5723,3896,3874,39,22,"PSC-PSOE",413
8,"8111",216,185,185,0,0,"PSC-PSOE",4
8,"8122",1683,1117,1106,10,11,"PSC-PSOE",140
8,"8115",3817,2835,2814,18,21,"PSC-PSOE",454
8,"8273",2309,1706,1689,12,17,"PSC-PSOE",120
8,"8131",699,520,516,4,4,"PSC-PSOE",65
8,"8242",216,172,170,0,2,"PSC-PSOE",9
8,"8144",715,493,489,9,4,"PSC-PSOE",42
8,"8901",232,171,171,6,0,"PSC-PSOE",3
8,"8031",2308,1648,1637,10,11,"PSC-PSOE",201
8,"8130",96,66,66,0,0,"PSC-PSOE",0
8,"8235",3683,2612,2595,22,17,"PSC-PSOE",181
8,"8228",296,207,204,3,3,"PSC-PSOE",14
8,"8221",12391,9503,9456,49,47,"PSC-PSOE",1086
8,"8042",2233,1668,1653,8,15,"PSC-PSOE",218
8,"8243",160,117,117,6,0,"PSC-PSOE",2
8,"8217",24985,19385,19317,130,68,"PSC-PSOE",4181
8,"8009",9136,6613,6578,40,35,"PSC-PSOE",691
8,"8140",4769,3344,3335,25,9,"PSC-PSOE",544
8,"8280",101,67,67,3,0,"PSC-PSOE",2
8,"8902",3756,2758,2741,18,17,"PSC-PSOE",331
8,"8218",8045,5643,5613,54,30,"PSC-PSOE",1025
8,"8299",395,256,255,3,1,"PSC-PSOE",23
8,"8098",2387,1668,1662,11,6,"PSC-PSOE",174
8,"8207",1840,1418,1410,17,8,"PSC-PSOE",45
8,"8292",1083,796,791,4,5,"PSC-PSOE",119
8,"8032",1973,1410,1403,6,7,"PSC-PSOE",174
8,"8255",140,90,90,1,0,"PSC-PSOE",2
8,"8132",379,259,256,3,3,"PSC-PSOE",17
8,"8234",3187,2331,2322,11,9,"PSC-PSOE",195
8,"8297",138,100,99,1,1,"PSC-PSOE",3
8,"8291",4524,3226,3206,24,20,"PSC-PSOE",443
8,"8018",2654,1834,1819,16,15,"PSC-PSOE",257
8,"8224",816,598,595,7,3,"PSC-PSOE",54
8,"8084",1135,795,790,6,5,"PSC-PSOE",74
8,"8077",34550,26102,25983,152,119,"PSC-PSOE",5549
8,"8178",430,317,315,4,2,"PSC-PSOE",29
8,"8155",6736,4779,4734,45,45,"PSC-PSOE",761
8,"8227",2329,1625,1607,13,18,"PSC-PSOE",182
8,"8078",216,135,135,2,0,"PSC-PSOE",4
8,"8099",749,514,513,4,1,"PSC-PSOE",79
8,"8278",4764,3372,3358,16,14,"PSC-PSOE",132
8,"8167",5879,4463,4448,42,15,"PSC-PSOE",874
8,"8008",187,118,118,1,0,"PSC-PSOE",9
8,"8011",1760,1230,1217,10,13,"PSC-PSOE",33
8,"8046",13243,9747,9693,74,54,"PSC-PSOE",1037
8,"8180",26616,19621,19542,90,79,"PSC-PSOE",3921
8,"8253",133,85,85,1,0,"PSC-PSOE",1
8,"8257",110,87,87,0,0,"PSC-PSOE",3
8,"8175",3371,2243,2232,25,11,"PSC-PSOE",193
8,"8286",2904,2009,1997,17,12,"PSC-PSOE",390
8,"8283",5983,4032,4007,31,25,"PSC-PSOE",361
8,"8287",1044,806,792,7,14,"PSC-PSOE",58
8,"8905",2305,1789,1774,17,15,"PSC-PSOE",182
8,"8092",3768,2621,2600,31,21,"PSC-PSOE",266
8,"8040",10701,7420,7383,43,37,"PSC-PSOE",870
8,"8265",1548,1115,1108,8,7,"PSC-PSOE",59
8,"8225",93,71,71,2,0,"PSC-PSOE",1
8,"8271",69,47,46,0,1,"PSC-PSOE",3
8,"8056",41996,30076,29974,178,102,"PSC-PSOE",4628
8,"8157",8361,6311,6277,38,34,"PSC-PSOE",1114
8,"8288",1632,1061,1053,4,8,"PSC-PSOE",212
8,"8214",6841,5018,4994,49,24,"PSC-PSOE",467
8,"8076",16173,11553,11473,73,80,"PSC-PSOE",2065
8,"8025",1486,1087,1083,13,4,"PSC-PSOE",106
8,"8168",375,235,234,0,1,"PSC-PSOE",9
8,"8284",12067,7855,7792,66,63,"PSC-PSOE",1197
8,"8290",1490,1163,1155,5,8,"PSC-PSOE",62
8,"8208",5736,4318,4295,23,23,"PSC-PSOE",642
8,"8274",4702,3349,3323,35,26,"PSC-PSOE",660
8,"8037",1856,1364,1351,20,13,"PSC-PSOE",61
8,"8061",1485,1045,1040,5,5,"PSC-PSOE",167
8,"8183",4524,3125,3103,21,22,"PSC-PSOE",345
8,"8264",4288,3045,3030,30,15,"PSC-PSOE",224
8,"8074",10587,7309,7274,51,35,"PSC-PSOE",1086
8,"8252",24521,18605,18514,110,91,"PSC-PSOE",3670
8,"8223",1850,1279,1263,10,16,"PSC-PSOE",108
8,"8052",139,94,94,2,0,"PSC-PSOE",1
8,"8053",2805,1789,1775,10,14,"PSC-PSOE",313
8,"8070",267,196,193,2,3,"PSC-PSOE",8
8,"8026",187,155,155,1,0,"PSC-PSOE",2
8,"8081",345,255,255,1,0,"PSC-PSOE",8
8,"8226",879,683,680,3,3,"PSC-PSOE",37
8,"8166",1000,680,674,4,6,"PSC-PSOE",90
8,"8044",4150,2957,2932,19,25,"PSC-PSOE",484
8,"8212",495,350,347,3,3,"PSC-PSOE",17
8,"8185",194,132,132,0,0,"PSC-PSOE",5
8,"8109",214,174,173,0,1,"PSC-PSOE",1
8,"8306",517,360,354,2,6,"PSC-PSOE",20
8,"8114",18335,13196,13092,66,104,"PSC-PSOE",2572
8,"8123",19114,14573,14509,81,64,"PSC-PSOE",2212
8,"8197",7605,5331,5317,31,14,"PSC-PSOE",433
8,"8136",11416,8425,8388,63,37,"PSC-PSOE",1688
8,"8043",3190,2216,2201,12,15,"PSC-PSOE",362
8,"8120",6815,5071,5045,34,26,"PSC-PSOE",144
8,"8179",579,427,425,6,2,"PSC-PSOE",44
8,"8001",8825,6810,6760,24,50,"PSC-PSOE",1349
8,"8162",2028,1451,1442,8,9,"PSC-PSOE",175
8,"8107",11472,8147,8097,45,50,"PSC-PSOE",1274
8,"8263",20974,15086,15001,93,85,"PSC-PSOE",3011
8,"8193",942,637,633,9,4,"PSC-PSOE",45
8,"8072",10240,6957,6935,40,22,"PSC-PSOE",809
8,"8201",436,299,298,1,1,"PSC-PSOE",15
8,"8250",7046,4908,4878,33,30,"PSC-PSOE",1261
8,"8308",131,99,97,0,2,"PSC-PSOE",1
8,"8100",1992,1496,1485,21,11,"PSC-PSOE",48
8,"8142",132,105,104,1,1,"PSC-PSOE",7
8,"8112",12909,8671,8616,50,55,"PSC-PSOE",1166
38,"38045",3987,2152,2132,23,20,"PSOE-NCa",585
38,"38046",9107,6755,6682,45,73,"PSOE-NCa",1041
38,"38037",12997,8126,7997,46,129,"PSOE-NCa",2046
38,"38051",7217,5147,5089,31,58,"PSOE-NCa",1201
38,"38025",6860,4836,4761,49,75,"PSOE-NCa",1505
38,"38043",18918,12883,12737,109,146,"PSOE-NCa",2572
38,"38009",4127,2842,2793,15,49,"PSOE-NCa",490
38,"38031",28697,21546,21202,140,344,"PSOE-NCa",5870
38,"38006",39553,21159,20940,124,219,"PSOE-NCa",5456
38,"38022",18468,12230,12085,86,145,"PSOE-NCa",2676
38,"38048",3878,2664,2624,20,40,"PSOE-NCa",484
38,"38001",20166,11307,11195,55,112,"PSOE-NCa",3303
38,"38032",13257,8969,8902,72,67,"PSOE-NCa",1713
38,"38053",3754,2419,2370,15,49,"PSOE-NCa",516
38,"38047",1789,1228,1208,5,20,"PSOE-NCa",295
38,"38036",6553,4604,4529,45,75,"PSOE-NCa",1397
38,"38029",1533,776,763,7,13,"PSOE-NCa",214
38,"38012",2378,1620,1606,6,14,"PSOE-NCa",458
38,"38002",942,701,674,14,27,"PSOE-NCa",255
38,"38030",1923,1309,1300,5,9,"PSOE-NCa",447
38,"38050",2471,1616,1590,8,26,"PSOE-NCa",432
38,"38007",1689,1143,1119,3,24,"PSOE-NCa",332
38,"38024",15055,9612,9485,77,127,"PSOE-NCa",1804
38,"38004",4442,2980,2939,20,41,"PSOE-NCa",753
38,"38026",32918,24984,24727,174,257,"PSOE-NCa",4875
38,"38035",9299,5558,5500,35,58,"PSOE-NCa",1263
38,"38028",22063,15095,14954,89,141,"PSOE-NCa",4108
38,"38008",5513,3683,3609,17,74,"PSOE-NCa",885
38,"38021",1643,1014,1002,5,12,"PSOE-NCa",308
38,"38003",1440,970,960,2,10,"PSOE-NCa",397
38,"38010",4014,2726,2678,15,48,"PSOE-NCa",818
38,"38017",28037,16236,16076,100,160,"PSOE-NCa",3566
38,"38020",15021,9813,9693,51,120,"PSOE-NCa",2195
38,"38033",3721,2552,2504,15,48,"PSOE-NCa",835
38,"38005",5463,3443,3417,24,26,"PSOE-NCa",1069
38,"38049",2653,1683,1658,8,25,"PSOE-NCa",387
38,"38011",20435,13760,13627,82,133,"PSOE-NCa",2835
38,"38041",6808,4869,4835,42,34,"PSOE-NCa",757
38,"38013",2915,1865,1847,12,18,"PSOE-NCa",398
38,"38027",5386,3685,3615,29,70,"PSOE-NCa",813
38,"38042",3784,2692,2673,16,19,"PSOE-NCa",986
38,"38039",10584,7532,7462,77,70,"PSOE-NCa",1194
38,"38052",1281,853,844,2,9,"PSOE-NCa",195
38,"38018",4405,3053,3005,21,48,"PSOE-NCa",712
38,"38015",4158,2864,2818,12,46,"PSOE-NCa",597
38,"38023",121610,81337,80453,527,884,"PSOE-NCa",14182
38,"38040",4990,3061,3031,16,30,"PSOE-NCa",561
38,"38038",162030,105122,104174,667,948,"PSOE-NCa",18333
38,"38044",2206,1317,1303,10,14,"PSOE-NCa",376
38,"38019",13217,8168,8075,54,93,"PSOE-NCa",2998
38,"38034",4041,2853,2814,17,39,"PSOE-NCa",704
38,"38901",1387,883,876,4,7,"PSOE-NCa",236
38,"38016",1215,654,641,4,13,"PSOE-NCa",167
38,"38014",1351,935,929,3,6,"PSOE-NCa",215
8,"8263",20974,15086,15001,93,85,"C's",2399
8,"8035",12448,8482,8443,54,39,"C's",876
8,"8144",715,493,489,9,4,"C's",12
8,"8208",5736,4318,4295,23,23,"C's",626
8,"8227",2329,1625,1607,13,18,"C's",129
8,"8161",11145,7658,7621,45,37,"C's",1068
8,"8026",187,155,155,1,0,"C's",7
8,"8142",132,105,104,1,1,"C's",5
8,"8237",1642,1165,1160,4,5,"C's",31
8,"8240",9354,6996,6953,34,43,"C's",508
8,"8109",214,174,173,0,1,"C's",2
8,"8017",2756,1888,1876,7,12,"C's",145
8,"8028",1031,724,721,6,3,"C's",75
8,"8147",17001,12422,12333,62,89,"C's",1696
8,"8146",1297,958,954,16,4,"C's",139
8,"8285",10260,6893,6843,56,50,"C's",414
8,"8286",2904,2009,1997,17,12,"C's",281
8,"8222",1878,1452,1443,16,9,"C's",120
8,"8067",5723,3896,3874,39,22,"C's",219
8,"8100",1992,1496,1485,21,11,"C's",56
8,"8290",1490,1163,1155,5,8,"C's",88
8,"8201",436,299,298,1,1,"C's",7
8,"8029",3438,2645,2632,25,13,"C's",296
8,"8274",4702,3349,3323,35,26,"C's",386
8,"8046",13243,9747,9693,74,54,"C's",1041
8,"8191",5287,3732,3712,31,20,"C's",216
8,"8236",1525,1077,1067,3,10,"C's",35
8,"8027",690,527,524,3,3,"C's",34
8,"8039",354,259,259,0,0,"C's",8
8,"8090",129,103,102,2,1,"C's",1
8,"8083",1674,1287,1275,8,12,"C's",33
8,"8167",5879,4463,4448,42,15,"C's",788
8,"8062",951,676,674,5,2,"C's",75
8,"8252",24521,18605,18514,110,91,"C's",3243
8,"8259",6623,4921,4885,33,36,"C's",383
8,"8084",1135,795,790,6,5,"C's",43
8,"8266",43128,32806,32660,195,146,"C's",4912
8,"8303",278,206,205,2,1,"C's",8
8,"8058",1742,1210,1194,7,16,"C's",142
8,"8106",7216,5220,5176,38,44,"C's",623
8,"8069",3168,2333,2324,17,9,"C's",298
8,"8204",3058,2282,2262,17,20,"C's",309
8,"8131",699,520,516,4,4,"C's",11
8,"8120",6815,5071,5045,34,26,"C's",496
8,"8193",942,637,633,9,4,"C's",49
8,"8124",36750,26968,26842,140,126,"C's",4023
8,"8095",71,50,50,0,0,"C's",2
8,"8140",4769,3344,3335,25,9,"C's",272
8,"8019",1141245,824778,820790,5063,3988,"C's",107500
8,"8070",267,196,193,2,3,"C's",5
8,"8282",6517,5027,5017,40,10,"C's",559
8,"8148",2238,1592,1580,7,12,"C's",263
8,"8194",25539,16628,16553,77,75,"C's",2634
8,"8159",14049,10329,10284,51,45,"C's",1574
8,"8049",1288,860,841,9,19,"C's",22
8,"8205",59169,45410,45231,357,179,"C's",6680
8,"8111",216,185,185,0,0,"C's",5
8,"8262",6855,4522,4491,46,31,"C's",415
8,"8129",456,322,320,3,2,"C's",21
8,"8163",18590,12816,12750,72,66,"C's",1802
8,"8221",12391,9503,9456,49,47,"C's",1310
8,"8004",233,181,181,2,0,"C's",1
8,"8050",141,107,104,0,3,"C's",2
8,"8160",330,217,217,0,0,"C's",5
8,"8265",1548,1115,1108,8,7,"C's",44
8,"8239",451,324,324,5,0,"C's",34
8,"8251",4970,3505,3480,14,25,"C's",450
8,"8054",9013,6747,6702,38,45,"C's",1120
8,"8012",1676,1175,1170,24,5,"C's",35
8,"8087",159,131,130,2,1,"C's",7
8,"8093",26,19,19,0,0,"C's",1
8,"8141",4590,3173,3150,39,23,"C's",163
8,"8215",2576,1766,1751,30,15,"C's",82
8,"8180",26616,19621,19542,90,79,"C's",3312
8,"8016",1822,1229,1214,12,15,"C's",75
8,"8036",159,113,112,1,1,"C's",3
8,"8150",258,189,185,0,4,"C's",10
8,"8091",5253,3817,3795,23,22,"C's",408
8,"8006",11427,7789,7727,46,62,"C's",691
8,"8128",564,378,377,1,1,"C's",18
8,"8055",512,366,364,2,2,"C's",22
8,"8197",7605,5331,5317,31,14,"C's",883
8,"8230",7611,5590,5560,40,30,"C's",863
8,"8299",395,256,255,3,1,"C's",1
8,"8118",17516,12878,12820,79,58,"C's",1492
8,"8030",5095,3727,3712,27,15,"C's",511
8,"8052",139,94,94,2,0,"C's",1
8,"8308",131,99,97,0,2,"C's",2
8,"8007",6505,4532,4495,28,37,"C's",373
8,"8278",4764,3372,3358,16,14,"C's",108
8,"8220",2358,1783,1770,18,13,"C's",39
8,"8107",11472,8147,8097,45,50,"C's",1341
8,"8182",2803,2039,2034,16,5,"C's",325
8,"8166",1000,680,674,4,6,"C's",27
8,"8198",4391,3167,3138,17,29,"C's",357
8,"8014",1953,1438,1429,13,9,"C's",71
8,"8268",1011,702,699,2,3,"C's",49
8,"8901",232,171,171,6,0,"C's",5
8,"8115",3817,2835,2814,18,21,"C's",388
8,"8042",2233,1668,1653,8,15,"C's",239
8,"8015",155841,109156,108536,726,620,"C's",15752
8,"8075",3875,2709,2695,12,14,"C's",355
8,"8199",665,466,464,6,2,"C's",24
8,"8287",1044,806,792,7,14,"C's",27
8,"8280",101,67,67,3,0,"C's",2
8,"8243",160,117,117,6,0,"C's",0
8,"8149",996,662,660,7,2,"C's",25
8,"8005",6165,4458,4434,23,24,"C's",533
8,"8229",535,383,379,3,4,"C's",12
8,"8080",38,28,27,0,1,"C's",0
8,"8057",59,42,41,2,1,"C's",2
8,"8117",2453,1741,1727,23,14,"C's",118
8,"8218",8045,5643,5613,54,30,"C's",746
8,"8061",1485,1045,1040,5,5,"C's",116
8,"8065",1179,837,831,8,6,"C's",38
8,"8051",17873,13126,13048,66,78,"C's",1564
8,"8244",5821,4484,4451,32,33,"C's",687
8,"8207",1840,1418,1410,17,8,"C's",49
8,"8255",140,90,90,1,0,"C's",0
8,"8200",61275,45027,44785,276,242,"C's",6804
8,"8002",202,142,139,0,3,"C's",4
8,"8256",644,516,512,1,4,"C's",34
8,"8099",749,514,513,4,1,"C's",27
8,"8154",694,535,529,3,6,"C's",72
8,"8249",266,223,220,2,3,"C's",12
8,"8088",11840,8684,8627,55,57,"C's",907
8,"8289",4304,3166,3151,19,15,"C's",377
8,"8096",42411,30717,30550,204,167,"C's",4356
8,"8219",15355,11458,11403,86,55,"C's",1399
8,"8059",342,224,223,3,1,"C's",15
8,"8155",6736,4779,4734,45,45,"C's",708
8,"8078",216,135,135,2,0,"C's",1
8,"8190",258,179,177,2,2,"C's",7
8,"8038",1488,987,981,10,6,"C's",68
8,"8235",3683,2612,2595,22,17,"C's",192
8,"8257",110,87,87,0,0,"C's",7
8,"8250",7046,4908,4878,33,30,"C's",787
8,"8228",296,207,204,3,3,"C's",18
8,"8064",1853,1323,1315,9,8,"C's",62
8,"8134",803,560,554,5,6,"C's",29
8,"8119",6182,4517,4492,35,25,"C's",650
8,"8291",4524,3226,3206,24,20,"C's",504
8,"8183",4524,3125,3103,21,22,"C's",134
8,"8305",27328,19226,19083,116,143,"C's",1900
8,"8176",158,113,113,1,0,"C's",1
8,"8217",24985,19385,19317,130,68,"C's",3241
8,"8024",381,270,269,3,1,"C's",9
8,"8254",1746,1261,1257,13,4,"C's",16
8,"8021",69,52,51,3,1,"C's",2
8,"8032",1973,1410,1403,6,7,"C's",149
8,"8153",536,432,431,6,1,"C's",24
8,"8225",93,71,71,2,0,"C's",0
8,"8047",3978,2640,2614,21,26,"C's",263
8,"8025",1486,1087,1083,13,4,"C's",116
8,"8177",40,25,25,1,0,"C's",0
8,"8139",171,133,132,0,1,"C's",3
8,"8295",10850,7651,7617,33,34,"C's",1220
8,"8270",18399,12948,12869,83,79,"C's",2162
8,"8226",879,683,680,3,3,"C's",23
8,"8040",10701,7420,7383,43,37,"C's",749
8,"8172",20384,14738,14684,85,54,"C's",2018
8,"8081",345,255,255,1,0,"C's",11
8,"8048",583,426,424,5,2,"C's",24
8,"8158",3105,2166,2145,18,21,"C's",267
8,"8169",47915,35543,35390,211,153,"C's",5064
8,"8041",10314,7291,7238,46,53,"C's",1261
8,"8234",3187,2331,2322,11,9,"C's",268
8,"8022",12230,7792,7717,60,75,"C's",361
8,"8267",6435,4571,4542,24,29,"C's",534
8,"8293",226,162,162,0,0,"C's",3
8,"8126",8709,6454,6425,34,29,"C's",1009
8,"8037",1856,1364,1351,20,13,"C's",49
8,"8231",20495,13961,13885,91,76,"C's",2318
8,"8170",447,293,291,11,2,"C's",12
8,"8003",7118,5140,5108,28,32,"C's",692
8,"8023",6715,4669,4633,25,36,"C's",630
8,"8137",265,206,205,1,1,"C's",3
8,"8171",2099,1396,1389,20,7,"C's",43
8,"8127",2224,1439,1429,8,10,"C's",112
8,"8294",1971,1357,1349,8,8,"C's",112
8,"8138",4229,2832,2816,19,16,"C's",162
8,"8298",26426,17862,17784,113,78,"C's",1047
8,"8031",2308,1648,1637,10,11,"C's",108
8,"8156",10923,8013,7964,50,49,"C's",1274
8,"8210",4296,2825,2806,22,19,"C's",201
8,"8306",517,360,354,2,6,"C's",41
8,"8192",5696,4093,4069,38,24,"C's",305
8,"8206",731,568,559,9,9,"C's",44
8,"8135",6733,5230,5205,45,25,"C's",679
8,"8232",1797,1276,1266,14,10,"C's",62
8,"8273",2309,1706,1689,12,17,"C's",71
8,"8196",19247,14101,14047,75,54,"C's",2508
8,"8233",1876,1247,1237,11,10,"C's",46
8,"8102",28304,19929,19821,170,108,"C's",1885
8,"8076",16173,11553,11473,73,80,"C's",1501
8,"8009",9136,6613,6578,40,35,"C's",850
8,"8277",162,132,132,0,0,"C's",3
8,"8189",126,95,94,2,1,"C's",1
8,"8044",4150,2957,2932,19,25,"C's",294
8,"8288",1632,1061,1053,4,8,"C's",73
8,"8241",76,59,59,0,0,"C's",5
8,"8174",394,306,300,3,6,"C's",36
8,"8292",1083,796,791,4,5,"C's",69
8,"8085",985,712,704,1,8,"C's",23
8,"8074",10587,7309,7274,51,35,"C's",1290
8,"8238",14478,11302,11252,85,50,"C's",1618
8,"8151",463,336,333,11,3,"C's",9
8,"8260",18306,13492,13423,60,69,"C's",2311
8,"8056",41996,30076,29974,178,102,"C's",6085
8,"8063",448,363,363,8,0,"C's",8
8,"8253",133,85,85,1,0,"C's",0
8,"8060",143,100,99,0,1,"C's",2
8,"8242",216,172,170,0,2,"C's",2
8,"8246",1682,1157,1152,8,5,"C's",48
8,"8271",69,47,46,0,1,"C's",1
8,"8272",157,98,97,0,1,"C's",3
8,"8130",96,66,66,0,0,"C's",1
8,"8020",4876,3702,3678,25,24,"C's",543
8,"8152",114,84,82,1,2,"C's",1
8,"8276",233,169,169,3,0,"C's",7
8,"8008",187,118,118,1,0,"C's",4
8,"8202",12615,8911,8831,70,80,"C's",710
8,"8279",152985,110533,110039,684,494,"C's",16752
8,"8108",5014,3757,3740,21,17,"C's",563
8,"8281",4841,3577,3553,18,24,"C's",405
8,"8302",9209,6571,6524,65,47,"C's",1184
8,"8105",9613,7103,7047,46,56,"C's",1135
8,"8164",911,651,644,2,7,"C's",31
8,"8043",3190,2216,2201,12,15,"C's",360
8,"8098",2387,1668,1662,11,6,"C's",203
8,"8066",1364,1029,1025,10,4,"C's",138
8,"8113",52051,34906,34729,229,177,"C's",3085
8,"8157",8361,6311,6277,38,34,"C's",1038
8,"8211",32990,25446,25282,173,164,"C's",3965
8,"8001",8825,6810,6760,24,50,"C's",1122
8,"8905",2305,1789,1774,17,15,"C's",194
8,"8902",3756,2758,2741,18,17,"C's",426
8,"8089",33935,24504,24392,150,112,"C's",4443
8,"8110",13392,9211,9142,67,69,"C's",1041
8,"8013",1219,873,867,10,6,"C's",81
8,"8165",1657,1181,1175,8,6,"C's",111
8,"8300",5682,4328,4312,21,16,"C's",687
8,"8307",48233,34249,34071,209,178,"C's",4544
8,"8086",13550,9448,9395,66,53,"C's",1676
8,"8010",4196,2876,2852,16,24,"C's",264
8,"8114",18335,13196,13092,66,104,"C's",1935
8,"8245",78581,55798,55530,345,268,"C's",8125
8,"8185",194,132,132,0,0,"C's",12
8,"8216",25,17,17,0,0,"C's",0
8,"8212",495,350,347,3,3,"C's",7
8,"8304",814,578,573,1,5,"C's",42
8,"8297",138,100,99,1,1,"C's",1
8,"8301",48496,35956,35788,200,168,"C's",6293
8,"8168",375,235,234,0,1,"C's",10
8,"8213",6296,4308,4294,47,14,"C's",437
8,"8187",152527,112013,111491,638,522,"C's",14839
8,"8178",430,317,315,4,2,"C's",22
8,"8034",766,542,538,3,4,"C's",17
8,"8079",339,254,248,2,6,"C's",10
8,"8145",2585,1927,1915,10,12,"C's",212
8,"8224",816,598,595,7,3,"C's",40
8,"8082",1150,788,783,6,5,"C's",121
8,"8903",213,167,167,0,0,"C's",1
8,"8125",25024,18070,17966,99,104,"C's",2776
8,"8116",582,421,418,4,3,"C's",9
8,"8121",86293,61426,61070,450,356,"C's",9279
8,"8112",12909,8671,8616,50,55,"C's",716
8,"8214",6841,5018,4994,49,24,"C's",516
8,"8195",82,64,64,0,0,"C's",2
8,"8136",11416,8425,8388,63,37,"C's",1397
8,"8094",1548,1143,1133,12,10,"C's",71
8,"8072",10240,6957,6935,40,22,"C's",943
8,"8247",958,716,714,7,2,"C's",22
8,"8258",835,602,597,5,5,"C's",11
8,"8179",579,427,425,6,2,"C's",31
8,"8018",2654,1834,1819,16,15,"C's",157
8,"8133",128,76,75,0,1,"C's",8
8,"8071",241,168,164,3,4,"C's",4
8,"8184",53690,37794,37636,200,158,"C's",6090
8,"8248",5402,3848,3815,27,33,"C's",534
8,"8143",2686,1892,1881,19,11,"C's",193
8,"8269",2646,1871,1860,17,11,"C's",84
8,"8092",3768,2621,2600,31,21,"C's",110
8,"8296",1787,1358,1351,9,7,"C's",193
8,"8104",682,445,443,4,2,"C's",12
8,"8122",1683,1117,1106,10,11,"C's",63
8,"8101",174802,123863,123197,643,666,"C's",18455
8,"8261",2319,1638,1632,4,6,"C's",276
8,"8123",19114,14573,14509,81,64,"C's",1682
8,"8188",117,81,81,2,0,"C's",2
8,"8073",61659,45611,45356,239,255,"C's",6761
8,"8068",6729,4765,4739,23,26,"C's",663
8,"8045",72,42,39,0,3,"C's",1
8,"8284",12067,7855,7792,66,63,"C's",948
8,"8904",10563,7474,7437,32,37,"C's",1055
8,"8283",5983,4032,4007,31,25,"C's",251
8,"8264",4288,3045,3030,30,15,"C's",530
8,"8132",379,259,256,3,3,"C's",7
8,"8275",254,202,202,4,0,"C's",1
8,"8162",2028,1451,1442,8,9,"C's",183
8,"8223",1850,1279,1263,10,16,"C's",81
8,"8203",2422,1602,1591,11,11,"C's",192
8,"8103",631,431,431,3,0,"C's",34
8,"8033",12803,9236,9179,79,57,"C's",1023
8,"8077",34550,26102,25983,152,119,"C's",4250
8,"8175",3371,2243,2232,25,11,"C's",115
8,"8181",7896,5774,5724,41,50,"C's",790
8,"8011",1760,1230,1217,10,13,"C's",35
8,"8097",1027,736,731,7,5,"C's",64
8,"8053",2805,1789,1775,10,14,"C's",180
8,"8209",6773,4845,4822,31,23,"C's",720
33,"33001",1622,867,852,16,15,"PP-FORO",348
33,"33071",617,459,452,8,7,"PP-FORO",130
33,"33017",3180,2196,2168,30,28,"PP-FORO",795
33,"33040",4564,3125,3091,28,34,"PP-FORO",934
33,"33067",785,608,598,5,10,"PP-FORO",150
33,"33035",11299,8048,7981,67,67,"PP-FORO",2398
33,"33018",2896,2068,2041,18,27,"PP-FORO",828
33,"33005",1479,945,932,12,13,"PP-FORO",353
33,"33062",409,242,239,1,3,"PP-FORO",73
33,"33028",1289,685,682,9,3,"PP-FORO",222
33,"33044",178724,130938,130010,1254,928,"PP-FORO",45788
33,"33015",1561,1042,1031,8,11,"PP-FORO",315
33,"33077",1220,849,840,11,9,"PP-FORO",470
33,"33010",1828,1220,1215,16,5,"PP-FORO",349
33,"33013",456,336,331,6,5,"PP-FORO",130
33,"33043",682,465,460,2,5,"PP-FORO",157
33,"33053",1157,767,762,12,5,"PP-FORO",138
33,"33009",899,606,601,4,5,"PP-FORO",212
33,"33050",603,374,357,0,17,"PP-FORO",109
33,"33038",2298,1690,1675,12,15,"PP-FORO",359
33,"33057",1593,1134,1123,17,11,"PP-FORO",252
33,"33037",34841,24271,24054,200,217,"PP-FORO",5249
33,"33003",665,386,384,7,2,"PP-FORO",148
33,"33045",4503,3249,3216,26,33,"PP-FORO",1011
33,"33024",227211,166618,165475,1240,1143,"PP-FORO",45797
33,"33069",3513,2577,2554,15,23,"PP-FORO",825
33,"33031",35453,23848,23595,242,253,"PP-FORO",4941
33,"33039",1672,1261,1257,14,4,"PP-FORO",361
33,"33030",899,689,687,10,2,"PP-FORO",276
33,"33061",379,194,190,1,4,"PP-FORO",68
33,"33072",1601,1012,1002,4,10,"PP-FORO",271
33,"33022",906,604,599,3,5,"PP-FORO",112
33,"33070",3347,2473,2441,31,32,"PP-FORO",845
33,"33058",1821,1319,1305,10,14,"PP-FORO",194
33,"33008",1808,1268,1247,6,21,"PP-FORO",519
33,"33011",11373,6279,6214,104,65,"PP-FORO",2527
33,"33055",1511,1150,1129,9,21,"PP-FORO",415
33,"33036",11572,8208,8133,80,75,"PP-FORO",2856
33,"33066",43034,29901,29610,261,291,"PP-FORO",8579
33,"33048",156,99,99,2,0,"PP-FORO",38
33,"33034",10693,6796,6725,72,71,"PP-FORO",2564
33,"33073",8631,5015,4948,47,67,"PP-FORO",2013
33,"33042",4316,3143,3105,35,38,"PP-FORO",966
33,"33063",419,330,326,1,4,"PP-FORO",177
33,"33021",4576,3133,3090,33,43,"PP-FORO",1067
33,"33052",730,517,512,1,5,"PP-FORO",140
33,"33076",12270,8265,8203,89,62,"PP-FORO",3213
33,"33051",7167,4810,4772,57,38,"PP-FORO",1710
33,"33059",4702,3228,3185,42,43,"PP-FORO",1440
33,"33032",11483,8036,7921,82,115,"PP-FORO",1712
33,"33020",13297,9527,9445,86,82,"PP-FORO",2260
33,"33033",9943,6851,6803,61,48,"PP-FORO",1635
33,"33026",8621,5600,5555,71,45,"PP-FORO",1735
33,"33075",275,161,155,2,6,"PP-FORO",50
33,"33078",147,98,98,0,0,"PP-FORO",29
33,"33023",3315,2295,2267,35,28,"PP-FORO",748
33,"33041",7270,5138,5093,53,45,"PP-FORO",1613
33,"33012",5230,3595,3568,27,27,"PP-FORO",1495
33,"33027",849,544,543,8,1,"PP-FORO",161
33,"33068",1114,627,623,2,4,"PP-FORO",195
33,"33004",67136,48699,48354,389,345,"PP-FORO",13714
33,"33065",1109,743,735,16,8,"PP-FORO",285
33,"33006",1556,1043,1036,17,7,"PP-FORO",236
33,"33025",9261,6116,6062,58,54,"PP-FORO",1812
33,"33060",14750,10307,10206,82,101,"PP-FORO",1997
33,"33049",6388,4229,4182,48,47,"PP-FORO",1376
33,"33056",5015,3435,3405,32,30,"PP-FORO",1303
33,"33014",9101,6398,6352,46,46,"PP-FORO",1626
33,"33016",19201,14177,14074,115,103,"PP-FORO",4515
33,"33029",363,199,198,1,1,"PP-FORO",52
33,"33046",508,375,365,4,10,"PP-FORO",209
33,"33064",231,181,179,4,2,"PP-FORO",48
33,"33047",1126,868,861,12,7,"PP-FORO",441
33,"33054",1688,1159,1146,8,13,"PP-FORO",393
33,"33007",1524,991,980,10,11,"PP-FORO",354
33,"33019",3094,2079,2054,15,25,"PP-FORO",825
33,"33074",3523,2422,2390,36,32,"PP-FORO",906
33,"33002",10122,7056,6977,55,79,"PP-FORO",2031
9,"9356",42,31,31,0,0,"VOX",0
9,"9478",45,38,38,0,0,"VOX",0
9,"9094",51,42,41,0,1,"VOX",0
9,"9295",60,37,37,0,0,"VOX",0
9,"9259",233,184,184,3,0,"VOX",0
9,"9384",293,199,194,0,5,"VOX",1
9,"9058",393,293,289,2,4,"VOX",5
9,"9360",30,27,27,0,0,"VOX",0
9,"9473",85,62,61,1,1,"VOX",0
9,"9195",57,42,42,2,0,"VOX",0
9,"9354",33,30,30,1,0,"VOX",0
9,"9135",41,33,33,1,0,"VOX",0
9,"9337",115,84,82,0,2,"VOX",1
9,"9454",47,34,34,0,0,"VOX",0
9,"9466",134,99,99,0,0,"VOX",0
9,"9314",95,80,79,1,1,"VOX",0
9,"9276",387,280,273,2,7,"VOX",2
9,"9279",177,130,130,0,0,"VOX",2
9,"9122",96,66,66,0,0,"VOX",1
9,"9283",46,29,28,0,1,"VOX",0
9,"9396",152,118,118,1,0,"VOX",0
9,"9340",76,49,49,0,0,"VOX",0
9,"9027",47,44,41,0,3,"VOX",0
9,"9123",40,35,35,0,0,"VOX",0
9,"9067",442,308,303,9,5,"VOX",3
9,"9244",47,26,26,1,0,"VOX",0
9,"9025",125,86,79,1,7,"VOX",1
9,"9020",262,187,180,2,7,"VOX",1
9,"9351",60,46,45,1,1,"VOX",3
9,"9154",142,104,104,2,0,"VOX",0
9,"9164",165,121,121,1,0,"VOX",0
9,"9281",147,109,107,0,2,"VOX",1
9,"9346",93,71,69,0,2,"VOX",0
9,"9208",211,139,136,3,3,"VOX",0
9,"9190",91,56,55,0,1,"VOX",0
9,"9149",34,25,24,0,1,"VOX",0
9,"9463",262,206,206,3,0,"VOX",1
9,"9084",189,150,148,7,2,"VOX",0
9,"9056",4931,3634,3602,35,32,"VOX",15
9,"9242",81,65,63,2,2,"VOX",0
9,"9093",154,133,128,1,5,"VOX",0
9,"9409",109,87,87,0,0,"VOX",0
9,"9078",41,35,33,0,2,"VOX",0
9,"9010",32,23,23,2,0,"VOX",0
9,"9328",77,55,55,1,0,"VOX",2
9,"9046",30,26,26,0,0,"VOX",0
9,"9012",93,68,66,1,2,"VOX",0
9,"9179",43,35,34,0,1,"VOX",0
9,"9250",273,218,218,4,0,"VOX",0
9,"9269",39,33,32,0,1,"VOX",0
9,"9168",296,233,231,1,2,"VOX",0
9,"9277",119,101,100,0,1,"VOX",0
9,"9041",28,28,28,1,0,"VOX",0
9,"9166",97,79,78,3,1,"VOX",0
9,"9327",25,22,22,0,0,"VOX",0
9,"9302",116,87,87,0,0,"VOX",0
9,"9262",161,129,129,0,0,"VOX",0
9,"9127",55,40,40,0,0,"VOX",0
9,"9137",167,128,128,1,0,"VOX",1
9,"9307",113,91,91,0,0,"VOX",0
9,"9448",216,180,178,1,2,"VOX",1
9,"9907",1420,1120,1115,13,5,"VOX",12
9,"9464",36,24,24,0,0,"VOX",1
9,"9321",1640,1250,1237,5,13,"VOX",2
9,"9201",30,17,17,0,0,"VOX",0
9,"9083",37,33,33,0,0,"VOX",0
9,"9316",104,83,80,1,3,"VOX",0
9,"9072",307,240,239,1,1,"VOX",0
9,"9388",36,31,30,1,1,"VOX",0
9,"9048",1484,1120,1106,4,14,"VOX",5
9,"9415",267,166,165,0,1,"VOX",0
9,"9235",160,124,123,0,1,"VOX",0
9,"9194",2024,1550,1530,17,20,"VOX",1
9,"9112",113,75,73,2,2,"VOX",0
9,"9255",86,66,62,0,4,"VOX",0
9,"9904",482,389,384,5,5,"VOX",0
9,"9439",1005,823,816,9,7,"VOX",3
9,"9128",82,66,66,0,0,"VOX",0
9,"9332",140,107,107,1,0,"VOX",0
9,"9202",24,22,22,1,0,"VOX",0
9,"9247",23,19,19,0,0,"VOX",0
9,"9257",92,80,78,4,2,"VOX",1
9,"9261",463,339,330,8,9,"VOX",0
9,"9043",189,132,132,2,0,"VOX",1
9,"9063",213,184,182,2,2,"VOX",1
9,"9323",64,47,47,0,0,"VOX",0
9,"9231",70,49,49,3,0,"VOX",0
9,"9052",31,22,21,1,1,"VOX",0
9,"9125",596,435,433,3,2,"VOX",0
9,"9060",148,123,123,0,0,"VOX",0
9,"9074",788,609,598,8,11,"VOX",5
9,"9288",91,70,69,1,1,"VOX",0
9,"9228",163,138,138,0,0,"VOX",1
9,"9022",67,57,57,1,0,"VOX",2
9,"9088",66,44,42,1,2,"VOX",0
9,"9472",55,40,40,0,0,"VOX",0
9,"9417",40,30,30,0,0,"VOX",0
9,"9251",371,273,271,3,2,"VOX",0
9,"9090",57,51,51,1,0,"VOX",0
9,"9131",460,381,373,5,8,"VOX",1
9,"9403",96,78,76,1,2,"VOX",0
9,"9246",622,458,455,5,3,"VOX",1
9,"9306",113,91,91,1,0,"VOX",0
9,"9214",684,452,446,6,6,"VOX",0
9,"9239",53,44,42,1,2,"VOX",0
9,"9365",31,20,20,0,0,"VOX",0
9,"9039",58,38,38,0,0,"VOX",0
9,"9050",72,54,54,0,0,"VOX",0
9,"9160",90,71,70,0,1,"VOX",2
9,"9184",5,4,4,0,0,"VOX",0
9,"9086",687,475,471,0,4,"VOX",3
9,"9335",87,72,71,0,1,"VOX",0
9,"9275",192,138,137,1,1,"VOX",0
9,"9211",1462,1086,1070,11,16,"VOX",2
9,"9901",374,268,261,3,7,"VOX",0
9,"9358",249,191,191,1,0,"VOX",2
9,"9017",89,67,62,0,5,"VOX",0
9,"9378",31,21,21,1,0,"VOX",0
9,"9159",56,48,48,1,0,"VOX",0
9,"9248",78,57,57,0,0,"VOX",0
9,"9044",46,38,37,0,1,"VOX",0
9,"9032",108,73,73,0,0,"VOX",0
9,"9411",149,111,111,0,0,"VOX",1
9,"9445",44,32,32,1,0,"VOX",0
9,"9304",202,166,163,1,3,"VOX",2
9,"9108",378,290,287,2,3,"VOX",0
9,"9155",26,20,20,1,0,"VOX",0
9,"9224",157,122,122,0,0,"VOX",0
9,"9392",53,40,40,0,0,"VOX",0
9,"9003",192,148,146,2,2,"VOX",0
9,"9054",100,73,72,3,1,"VOX",0
9,"9100",59,51,50,0,1,"VOX",3
9,"9425",514,369,366,2,3,"VOX",0
9,"9455",44,34,33,0,1,"VOX",0
9,"9141",610,499,493,4,6,"VOX",2
9,"9412",803,552,550,2,2,"VOX",0
9,"9021",56,33,31,0,2,"VOX",0
9,"9398",75,54,54,1,0,"VOX",0
9,"9348",146,116,114,1,2,"VOX",1
9,"9274",1098,880,872,9,8,"VOX",3
9,"9361",117,96,96,0,0,"VOX",0
9,"9219",27590,19903,19724,166,179,"VOX",39
9,"9223",46,39,39,0,0,"VOX",0
9,"9216",385,283,280,8,3,"VOX",0
9,"9353",73,57,56,0,1,"VOX",0
9,"9218",360,272,271,2,1,"VOX",2
9,"9311",60,52,50,0,2,"VOX",0
9,"9444",72,48,48,2,0,"VOX",0
9,"9066",65,51,51,0,0,"VOX",0
9,"9170",203,152,149,1,3,"VOX",0
9,"9451",238,199,198,1,1,"VOX",0
9,"9267",115,101,100,3,1,"VOX",0
9,"9339",128,103,103,0,0,"VOX",0
9,"9272",294,206,203,1,3,"VOX",1
9,"9192",55,47,46,0,1,"VOX",0
9,"9220",76,62,61,2,1,"VOX",0
9,"9258",173,139,136,4,3,"VOX",0
9,"9130",79,63,62,1,1,"VOX",0
9,"9265",38,31,31,0,0,"VOX",0
9,"9175",129,92,92,0,0,"VOX",0
9,"9280",27,17,17,0,0,"VOX",0
9,"9906",1223,952,947,9,5,"VOX",3
9,"9294",111,88,86,0,2,"VOX",0
9,"9438",544,446,444,3,2,"VOX",0
9,"9430",24,19,19,0,0,"VOX",0
9,"9024",156,117,114,0,3,"VOX",0
9,"9013",47,41,41,0,0,"VOX",0
9,"9134",228,152,152,2,0,"VOX",0
9,"9064",332,275,275,3,0,"VOX",1
9,"9173",123,93,93,1,0,"VOX",1
9,"9148",86,73,69,5,4,"VOX",0
9,"9380",78,59,57,0,2,"VOX",0
9,"9036",38,31,30,2,1,"VOX",0
9,"9229",201,146,145,0,1,"VOX",0
9,"9033",89,75,75,0,0,"VOX",0
9,"9449",87,72,71,1,1,"VOX",1
9,"9405",128,89,89,0,0,"VOX",0
9,"9029",168,134,132,3,2,"VOX",0
9,"9352",116,97,97,0,0,"VOX",0
9,"9104",54,43,43,0,0,"VOX",0
9,"9162",143,108,108,0,0,"VOX",0
9,"9114",87,67,67,0,0,"VOX",0
9,"9423",27,25,25,0,0,"VOX",0
9,"9406",252,196,195,1,1,"VOX",1
9,"9366",90,64,63,1,1,"VOX",0
9,"9253",111,96,94,1,2,"VOX",0
9,"9065",147,124,123,2,1,"VOX",0
9,"9905",391,308,308,5,0,"VOX",2
9,"9298",82,62,62,0,0,"VOX",0
9,"9326",148,115,113,2,2,"VOX",1
9,"9315",379,269,267,2,2,"VOX",1
9,"9236",38,32,32,0,0,"VOX",0
9,"9413",447,333,333,5,0,"VOX",1
9,"9082",40,35,35,0,0,"VOX",0
9,"9016",85,64,64,2,0,"VOX",0
9,"9441",74,66,66,0,0,"VOX",0
9,"9373",440,285,282,3,3,"VOX",0
9,"9129",105,87,87,0,0,"VOX",0
9,"9308",67,43,43,1,0,"VOX",0
9,"9903",3251,2359,2340,24,19,"VOX",9
9,"9172",125,102,102,2,0,"VOX",0
9,"9458",466,380,377,3,3,"VOX",3
9,"9395",136,96,95,0,1,"VOX",1
9,"9197",148,108,104,1,4,"VOX",1
9,"9368",22,14,14,1,0,"VOX",0
9,"9238",932,576,569,6,7,"VOX",0
9,"9330",1523,1166,1148,15,18,"VOX",0
9,"9273",53,41,40,1,1,"VOX",0
9,"9243",75,56,54,1,2,"VOX",0
9,"9183",51,37,37,0,0,"VOX",0
9,"9103",221,185,184,2,1,"VOX",0
9,"9180",136,102,100,2,2,"VOX",1
9,"9266",91,72,70,0,2,"VOX",0
9,"9317",16,14,14,0,0,"VOX",0
9,"9289",1466,1027,1013,6,14,"VOX",1
9,"9119",46,27,27,0,0,"VOX",0
9,"9310",13,9,8,0,1,"VOX",0
9,"9079",46,40,37,0,3,"VOX",0
9,"9045",267,186,183,2,3,"VOX",1
9,"9057",144,116,115,0,1,"VOX",0
9,"9006",61,41,41,0,0,"VOX",0
9,"9226",66,55,53,0,2,"VOX",0
9,"9169",99,83,81,0,2,"VOX",0
9,"9191",39,32,30,0,2,"VOX",0
9,"9007",59,41,41,0,0,"VOX",0
9,"9456",129,90,90,2,0,"VOX",0
9,"9199",91,65,65,2,0,"VOX",0
9,"9120",39,35,35,0,0,"VOX",0
9,"9476",63,46,46,0,0,"VOX",0
9,"9241",201,156,155,3,1,"VOX",1
9,"9350",480,358,347,5,11,"VOX",1
9,"9206",61,52,50,3,2,"VOX",0
9,"9062",51,44,44,1,0,"VOX",0
9,"9167",59,42,42,2,0,"VOX",0
9,"9105",107,88,86,0,2,"VOX",0
9,"9023",1096,848,840,9,8,"VOX",2
9,"9407",27,23,23,1,0,"VOX",0
9,"9424",32,26,26,1,0,"VOX",0
9,"9140",128,88,87,0,1,"VOX",0
9,"9009",163,130,128,2,2,"VOX",1
9,"9422",18,10,10,0,0,"VOX",0
9,"9471",151,117,117,0,0,"VOX",0
9,"9432",189,143,140,1,3,"VOX",3
9,"9433",60,52,51,0,1,"VOX",0
9,"9163",602,479,472,5,7,"VOX",0
9,"9152",263,193,192,0,1,"VOX",1
9,"9200",48,37,36,0,1,"VOX",0
9,"9098",516,396,388,6,8,"VOX",0
9,"9217",361,265,261,4,4,"VOX",0
9,"9347",141,113,109,4,4,"VOX",0
9,"9109",1068,698,669,10,29,"VOX",3
9,"9117",77,61,57,0,4,"VOX",0
9,"9301",616,513,506,5,7,"VOX",1
9,"9221",445,337,335,1,2,"VOX",0
9,"9198",108,86,85,2,1,"VOX",0
9,"9369",442,331,328,1,3,"VOX",0
9,"9386",58,44,43,2,1,"VOX",0
9,"9138",90,73,72,0,1,"VOX",0
9,"9139",101,75,73,2,2,"VOX",0
9,"9372",221,190,189,1,1,"VOX",0
9,"9480",110,89,88,1,1,"VOX",2
9,"9018",24702,18365,18158,174,207,"VOX",55
9,"9061",166,124,123,1,1,"VOX",1
9,"9230",38,31,31,0,0,"VOX",0
9,"9051",168,133,132,1,1,"VOX",0
9,"9419",78,45,44,0,1,"VOX",0
9,"9428",107,87,87,0,0,"VOX",1
9,"9447",42,38,38,0,0,"VOX",1
9,"9030",109,76,76,3,0,"VOX",3
9,"9334",48,39,38,0,1,"VOX",0
9,"9303",92,72,71,0,1,"VOX",0
9,"9431",119,99,98,0,1,"VOX",0
9,"9355",101,75,73,0,2,"VOX",0
9,"9085",475,352,350,2,2,"VOX",2
9,"9047",56,45,45,2,0,"VOX",0
9,"9073",926,753,748,10,5,"VOX",4
9,"9035",313,243,240,0,3,"VOX",1
9,"9091",732,516,512,7,4,"VOX",1
9,"9026",397,314,311,1,3,"VOX",1
9,"9001",27,26,26,0,0,"VOX",0
9,"9182",78,63,61,2,2,"VOX",0
9,"9189",130,88,86,2,2,"VOX",1
9,"9421",237,172,172,2,0,"VOX",0
9,"9391",361,264,263,2,1,"VOX",0
9,"9101",79,59,59,0,0,"VOX",0
9,"9270",163,122,121,1,1,"VOX",1
9,"9429",56,41,41,0,0,"VOX",2
9,"9400",317,258,256,3,2,"VOX",0
9,"9427",1428,1014,1003,12,11,"VOX",2
9,"9363",974,730,725,3,5,"VOX",8
9,"9232",151,125,124,2,1,"VOX",0
9,"9176",61,45,44,0,1,"VOX",0
9,"9113",464,383,376,6,7,"VOX",0
9,"9297",323,265,261,5,4,"VOX",2
9,"9446",12,7,7,0,0,"VOX",0
9,"9375",35,27,27,0,0,"VOX",0
9,"9408",41,34,34,1,0,"VOX",0
9,"9077",36,26,26,1,0,"VOX",0
9,"9382",33,30,29,1,1,"VOX",0
9,"9213",320,223,220,4,3,"VOX",2
9,"9151",458,364,363,3,1,"VOX",0
9,"9338",219,173,171,1,2,"VOX",1
9,"9076",23,14,14,0,0,"VOX",0
9,"9196",154,108,107,1,1,"VOX",0
9,"9908",469,314,309,2,5,"VOX",0
9,"9450",27,21,20,1,1,"VOX",0
9,"9102",37,31,31,0,0,"VOX",0
9,"9362",204,168,164,0,4,"VOX",1
9,"9178",52,36,36,1,0,"VOX",0
9,"9011",69,49,49,0,0,"VOX",0
9,"9177",1117,830,825,5,5,"VOX",4
9,"9442",380,287,282,2,5,"VOX",1
9,"9068",29,23,22,0,1,"VOX",0
9,"9124",1520,1113,1096,9,17,"VOX",7
9,"9136",192,151,147,2,4,"VOX",0
9,"9483",212,161,161,1,0,"VOX",0
9,"9115",92,69,68,0,1,"VOX",1
9,"9075",111,83,83,1,0,"VOX",1
9,"9144",52,40,40,0,0,"VOX",0
9,"9309",306,216,211,2,5,"VOX",0
9,"9268",95,73,72,0,1,"VOX",0
9,"9133",40,34,34,0,0,"VOX",0
9,"9418",82,63,62,3,1,"VOX",0
9,"9038",118,97,94,0,3,"VOX",0
9,"9329",123,86,86,1,0,"VOX",0
9,"9292",92,72,70,0,2,"VOX",0
9,"9019",147,103,102,1,1,"VOX",1
9,"9287",208,170,168,2,2,"VOX",1
9,"9070",34,31,30,3,1,"VOX",0
9,"9312",98,83,82,0,1,"VOX",0
9,"9132",173,132,130,0,2,"VOX",1
9,"9225",84,57,56,1,1,"VOX",4
9,"9390",611,478,477,3,1,"VOX",3
9,"9482",34,29,28,0,1,"VOX",1
9,"9209",4511,3368,3301,37,67,"VOX",1
9,"9249",47,37,37,1,0,"VOX",0
9,"9460",177,135,135,2,0,"VOX",0
9,"9377",625,478,471,5,7,"VOX",1
9,"9227",119,97,95,0,2,"VOX",0
9,"9387",118,96,95,0,1,"VOX",0
9,"9345",124,92,92,0,0,"VOX",0
9,"9256",362,261,255,2,6,"VOX",0
9,"9443",183,132,129,1,3,"VOX",0
9,"9394",727,558,552,8,6,"VOX",1
9,"9181",302,231,225,3,6,"VOX",0
9,"9059",136713,106605,105601,976,1004,"VOX",596
9,"9343",97,70,69,0,1,"VOX",0
9,"9467",66,46,46,3,0,"VOX",0
9,"9416",52,39,39,0,0,"VOX",0
9,"9374",90,79,77,2,2,"VOX",1
9,"9034",280,237,233,5,4,"VOX",1
9,"9437",286,227,226,5,1,"VOX",2
9,"9414",201,148,147,1,1,"VOX",0
9,"9381",32,23,22,0,1,"VOX",0
9,"9037",113,96,96,0,0,"VOX",0
9,"9434",1221,985,970,10,15,"VOX",7
9,"9410",3051,2169,2153,18,16,"VOX",2
9,"9902",461,347,339,1,8,"VOX",1
9,"9143",27,20,20,0,0,"VOX",0
9,"9071",45,34,34,0,0,"VOX",1
9,"9325",195,125,123,2,2,"VOX",0
9,"9014",213,127,126,1,1,"VOX",0
9,"9095",86,62,62,0,0,"VOX",0
9,"9055",52,39,38,0,1,"VOX",0
9,"9440",96,78,78,0,0,"VOX",1
9,"9215",377,264,260,0,4,"VOX",0
9,"9174",809,575,565,10,10,"VOX",0
9,"9318",61,38,38,0,0,"VOX",0
9,"9485",55,43,43,1,0,"VOX",0
9,"9389",77,56,56,0,0,"VOX",0
9,"9110",80,49,49,1,0,"VOX",0
38,"38012",2378,1620,1606,6,14,"C's",127
38,"38019",13217,8168,8075,54,93,"C's",586
38,"38002",942,701,674,14,27,"C's",39
38,"38005",5463,3443,3417,24,26,"C's",251
38,"38042",3784,2692,2673,16,19,"C's",134
38,"38023",121610,81337,80453,527,884,"C's",8361
38,"38039",10584,7532,7462,77,70,"C's",824
38,"38046",9107,6755,6682,45,73,"C's",723
38,"38021",1643,1014,1002,5,12,"C's",55
38,"38038",162030,105122,104174,667,948,"C's",13771
38,"38048",3878,2664,2624,20,40,"C's",191
38,"38003",1440,970,960,2,10,"C's",51
38,"38041",6808,4869,4835,42,34,"C's",419
38,"38040",4990,3061,3031,16,30,"C's",255
38,"38032",13257,8969,8902,72,67,"C's",1333
38,"38001",20166,11307,11195,55,112,"C's",1403
38,"38024",15055,9612,9485,77,127,"C's",1112
38,"38015",4158,2864,2818,12,46,"C's",181
38,"38013",2915,1865,1847,12,18,"C's",128
38,"38026",32918,24984,24727,174,257,"C's",2204
38,"38028",22063,15095,14954,89,141,"C's",1422
38,"38027",5386,3685,3615,29,70,"C's",294
38,"38007",1689,1143,1119,3,24,"C's",77
38,"38014",1351,935,929,3,6,"C's",79
38,"38036",6553,4604,4529,45,75,"C's",359
38,"38033",3721,2552,2504,15,48,"C's",162
38,"38047",1789,1228,1208,5,20,"C's",98
38,"38052",1281,853,844,2,9,"C's",68
38,"38029",1533,776,763,7,13,"C's",85
38,"38044",2206,1317,1303,10,14,"C's",99
38,"38049",2653,1683,1658,8,25,"C's",115
38,"38053",3754,2419,2370,15,49,"C's",240
38,"38037",12997,8126,7997,46,129,"C's",748
38,"38010",4014,2726,2678,15,48,"C's",145
38,"38050",2471,1616,1590,8,26,"C's",75
38,"38035",9299,5558,5500,35,58,"C's",556
38,"38011",20435,13760,13627,82,133,"C's",1830
38,"38051",7217,5147,5089,31,58,"C's",345
38,"38025",6860,4836,4761,49,75,"C's",407
38,"38034",4041,2853,2814,17,39,"C's",190
38,"38020",15021,9813,9693,51,120,"C's",894
38,"38022",18468,12230,12085,86,145,"C's",1149
38,"38031",28697,21546,21202,140,344,"C's",1734
38,"38030",1923,1309,1300,5,9,"C's",91
38,"38009",4127,2842,2793,15,49,"C's",324
38,"38901",1387,883,876,4,7,"C's",46
38,"38045",3987,2152,2132,23,20,"C's",144
38,"38043",18918,12883,12737,109,146,"C's",1365
38,"38008",5513,3683,3609,17,74,"C's",343
38,"38017",28037,16236,16076,100,160,"C's",1806
38,"38004",4442,2980,2939,20,41,"C's",261
38,"38018",4405,3053,3005,21,48,"C's",191
38,"38016",1215,654,641,4,13,"C's",37
38,"38006",39553,21159,20940,124,219,"C's",2224
18,"18103",760,596,593,6,3,"UPYD",2
18,"18144",782,596,588,3,8,"UPYD",3
18,"18040",225,142,141,0,1,"UPYD",1
18,"18107",971,719,711,6,8,"UPYD",0
18,"18111",2743,2046,2033,14,13,"UPYD",5
18,"18145",10432,7829,7767,56,62,"UPYD",41
18,"18006",4161,2816,2788,29,28,"UPYD",9
18,"18146",970,734,727,6,7,"UPYD",4
18,"18079",3465,2671,2645,16,26,"UPYD",2
18,"18119",1729,1353,1340,13,13,"UPYD",6
18,"18029",1833,1252,1243,9,9,"UPYD",5
18,"18050",1711,1271,1256,5,15,"UPYD",8
18,"18027",2562,1846,1827,19,19,"UPYD",4
18,"18003",14022,10417,10330,82,87,"UPYD",58
18,"18035",1255,964,958,4,6,"UPYD",4
18,"18901",512,359,357,1,2,"UPYD",0
18,"18149",5177,3946,3902,29,44,"UPYD",23
18,"18909",589,462,459,0,3,"UPYD",1
18,"18028",945,790,781,2,9,"UPYD",1
18,"18010",563,463,459,4,4,"UPYD",3
18,"18164",1831,1273,1260,11,13,"UPYD",4
18,"18179",546,378,377,1,1,"UPYD",0
18,"18175",11624,8549,8467,41,82,"UPYD",38
18,"18159",1009,811,802,3,9,"UPYD",1
18,"18066",2108,1546,1540,4,6,"UPYD",4
18,"18153",8580,6314,6260,39,54,"UPYD",44
18,"18039",3544,2544,2511,34,33,"UPYD",9
18,"18184",2158,1659,1634,4,25,"UPYD",3
18,"18076",815,577,576,0,1,"UPYD",0
18,"18913",818,617,603,2,14,"UPYD",1
18,"18194",2152,1487,1477,6,10,"UPYD",6
18,"18105",4548,3169,3139,19,30,"UPYD",4
18,"18121",132,101,100,1,1,"UPYD",0
18,"18163",324,239,235,1,4,"UPYD",2
18,"18177",427,259,258,3,1,"UPYD",1
18,"18912",1488,1021,1007,7,14,"UPYD",0
18,"18137",1005,758,758,6,0,"UPYD",1
18,"18181",223,159,157,0,2,"UPYD",0
18,"18051",1149,825,823,7,2,"UPYD",4
18,"18173",8978,6319,6251,50,68,"UPYD",22
18,"18004",724,511,505,3,6,"UPYD",0
18,"18021",17451,12420,12305,101,115,"UPYD",93
18,"18180",631,448,447,2,1,"UPYD",1
18,"18042",414,342,341,0,1,"UPYD",1
18,"18015",443,338,337,0,1,"UPYD",0
18,"18097",956,703,691,1,12,"UPYD",3
18,"18057",5263,3968,3937,33,31,"UPYD",16
18,"18024",855,660,653,8,7,"UPYD",1
18,"18141",414,282,277,1,5,"UPYD",0
18,"18133",2187,1731,1722,7,9,"UPYD",1
18,"18193",14194,10280,10196,91,84,"UPYD",57
18,"18168",809,589,588,5,1,"UPYD",0
18,"18071",5583,4221,4176,33,45,"UPYD",20
18,"18012",2330,1670,1660,15,10,"UPYD",4
18,"18096",342,260,259,1,1,"UPYD",1
18,"18170",336,227,225,1,2,"UPYD",0
18,"18152",938,687,681,1,6,"UPYD",2
18,"18062",10298,7584,7512,67,72,"UPYD",41
18,"18056",3545,2716,2687,25,29,"UPYD",10
18,"18132",3312,2582,2556,14,26,"UPYD",3
18,"18099",1581,1271,1249,10,22,"UPYD",2
18,"18007",785,527,523,3,4,"UPYD",3
18,"18089",15132,10489,10402,64,87,"UPYD",43
18,"18078",739,593,590,4,3,"UPYD",1
18,"18134",5811,4002,3946,25,56,"UPYD",21
18,"18151",260,196,196,0,0,"UPYD",1
18,"18030",584,428,426,3,2,"UPYD",0
18,"18120",270,218,216,2,2,"UPYD",0
18,"18059",4153,3074,3039,23,35,"UPYD",6
18,"18138",2482,1721,1712,8,9,"UPYD",4
18,"18054",868,630,627,2,3,"UPYD",0
18,"18136",1875,1477,1470,7,7,"UPYD",1
18,"18109",599,421,419,2,2,"UPYD",2
18,"18116",2882,2245,2215,19,30,"UPYD",12
18,"18037",530,411,408,1,3,"UPYD",4
18,"18049",617,456,451,3,5,"UPYD",3
18,"18061",1059,822,816,1,6,"UPYD",1
18,"18053",1667,1084,1078,9,6,"UPYD",5
18,"18064",379,308,308,1,0,"UPYD",0
18,"18032",239,178,175,0,3,"UPYD",0
18,"18174",442,354,348,2,6,"UPYD",0
18,"18114",634,457,452,2,5,"UPYD",2
18,"18101",9263,6971,6912,55,59,"UPYD",48
18,"18904",779,570,565,1,5,"UPYD",0
18,"18034",510,391,391,1,0,"UPYD",0
18,"18023",15738,11242,11146,92,96,"UPYD",53
18,"18157",1123,836,823,8,13,"UPYD",4
18,"18038",1066,836,826,2,10,"UPYD",1
18,"18182",1919,1356,1347,3,9,"UPYD",5
18,"18126",1497,1094,1087,7,7,"UPYD",4
18,"18043",129,95,95,0,0,"UPYD",0
18,"18013",4236,3108,3052,19,56,"UPYD",18
18,"18908",805,633,620,2,13,"UPYD",5
18,"18187",561,418,417,1,1,"UPYD",0
18,"18911",7392,5359,5301,44,58,"UPYD",33
18,"18017",18172,12077,11954,101,123,"UPYD",54
18,"18135",4583,3045,2998,14,47,"UPYD",13
18,"18140",43567,29155,28932,194,223,"UPYD",125
18,"18176",258,179,178,3,1,"UPYD",0
18,"18002",561,446,444,1,2,"UPYD",0
18,"18022",13306,9165,9091,51,74,"UPYD",37
18,"18086",355,285,283,0,2,"UPYD",0
18,"18069",493,366,363,3,3,"UPYD",1
18,"18171",2123,1640,1616,14,24,"UPYD",2
18,"18914",1658,1304,1290,8,14,"UPYD",3
18,"18154",1016,716,716,2,0,"UPYD",1
18,"18148",819,671,666,1,5,"UPYD",2
18,"18905",14500,10137,10058,82,79,"UPYD",59
18,"18044",179,116,116,0,0,"UPYD",0
18,"18093",2752,1873,1858,10,15,"UPYD",4
18,"18036",3768,2904,2882,18,22,"UPYD",17
18,"18150",6730,4858,4814,28,44,"UPYD",36
18,"18115",2548,1872,1854,16,18,"UPYD",5
18,"18033",294,220,219,1,1,"UPYD",0
18,"18094",2389,1853,1832,22,21,"UPYD",8
18,"18112",131,88,86,1,2,"UPYD",0
18,"18189",772,599,595,7,4,"UPYD",2
18,"18045",1149,803,789,10,14,"UPYD",2
18,"18020",1469,1046,1032,7,14,"UPYD",1
18,"18084",4215,3179,3143,24,36,"UPYD",38
18,"18063",1191,770,767,6,3,"UPYD",0
18,"18048",2390,1824,1806,8,18,"UPYD",10
18,"18185",556,461,461,1,0,"UPYD",0
18,"18122",16171,11670,11508,106,162,"UPYD",43
18,"18095",1959,1486,1474,5,12,"UPYD",5
18,"18910",803,573,569,5,4,"UPYD",2
18,"18102",8424,5783,5716,41,67,"UPYD",11
18,"18014",6372,4620,4566,44,54,"UPYD",24
18,"18906",917,681,673,2,8,"UPYD",1
18,"18161",220,184,184,1,0,"UPYD",0
18,"18167",1897,1321,1313,8,8,"UPYD",6
18,"18147",3734,2416,2386,10,30,"UPYD",4
18,"18082",867,626,621,4,5,"UPYD",3
18,"18907",1859,1482,1475,5,7,"UPYD",4
18,"18016",323,239,237,0,2,"UPYD",1
18,"18001",256,178,177,2,1,"UPYD",1
18,"18067",711,517,516,0,1,"UPYD",0
18,"18903",892,650,645,1,5,"UPYD",0
18,"18005",375,266,265,2,1,"UPYD",0
18,"18011",4321,3136,3119,10,17,"UPYD",15
18,"18192",1529,1216,1208,3,8,"UPYD",2
18,"18183",660,468,465,3,3,"UPYD",0
18,"18087",184873,138280,137516,836,764,"UPYD",1073
18,"18127",16586,11998,11897,97,101,"UPYD",73
18,"18083",266,210,207,1,3,"UPYD",1
18,"18046",1867,1225,1215,8,10,"UPYD",2
18,"18165",4135,2944,2915,23,29,"UPYD",13
18,"18124",393,274,271,1,3,"UPYD",0
18,"18902",847,680,674,10,6,"UPYD",1
18,"18143",979,781,776,2,5,"UPYD",4
18,"18070",283,223,218,0,5,"UPYD",2
18,"18068",1566,1234,1214,5,20,"UPYD",4
18,"18123",293,228,227,2,1,"UPYD",0
18,"18098",6167,4367,4342,22,25,"UPYD",15
18,"18100",7769,5715,5637,57,78,"UPYD",29
18,"18047",5888,4028,4000,32,28,"UPYD",17
18,"18088",1556,1113,1108,5,5,"UPYD",0
18,"18108",858,672,667,0,5,"UPYD",1
18,"18018",640,490,488,0,2,"UPYD",1
18,"18158",8408,5604,5542,38,62,"UPYD",15
18,"18072",666,481,474,4,7,"UPYD",1
18,"18162",951,744,734,0,10,"UPYD",3
18,"18117",513,402,396,4,6,"UPYD",2
18,"18085",729,489,484,2,5,"UPYD",1
18,"18025",294,216,214,0,2,"UPYD",0
18,"18065",625,503,500,1,3,"UPYD",0
18,"18178",743,571,571,2,0,"UPYD",0
18,"18188",1642,1249,1234,8,15,"UPYD",5
18,"18128",344,251,248,0,3,"UPYD",1
18,"18074",273,217,213,2,4,"UPYD",0
13,"13084",908,725,708,5,17,"VOX",0
13,"13092",1860,1544,1529,11,15,"VOX",1
13,"13004",1052,827,816,1,11,"VOX",0
13,"13072",775,570,565,5,5,"VOX",1
13,"13030",143,110,110,0,0,"VOX",0
13,"13088",610,501,495,5,6,"VOX",0
13,"13029",86,69,69,0,0,"VOX",0
13,"13098",2124,1633,1591,15,42,"VOX",3
13,"13046",740,575,570,3,5,"VOX",1
13,"13002",1500,1003,993,9,10,"VOX",2
13,"13069",666,518,508,3,10,"VOX",0
13,"13035",986,791,784,7,7,"VOX",1
13,"13050",501,403,399,2,4,"VOX",1
13,"13094",308,253,249,3,4,"VOX",0
13,"13075",213,157,153,1,4,"VOX",1
13,"13904",527,411,406,8,5,"VOX",0
13,"13053",14389,10624,10521,79,103,"VOX",18
13,"13096",7677,5743,5661,51,82,"VOX",60
13,"13047",5785,4462,4406,23,56,"VOX",0
13,"13054",4970,3911,3866,44,45,"VOX",3
13,"13060",269,212,209,1,3,"VOX",3
13,"13015",5494,4146,4106,18,40,"VOX",1
13,"13056",11354,8732,8634,48,98,"VOX",16
13,"13071",39775,28222,28052,175,170,"VOX",30
13,"13033",1653,1395,1378,4,17,"VOX",1
13,"13066",2519,2057,2026,14,31,"VOX",1
13,"13080",350,265,265,1,0,"VOX",0
13,"13001",1270,985,977,8,8,"VOX",0
13,"13010",887,673,665,0,8,"VOX",0
13,"13067",360,298,294,2,4,"VOX",0
13,"13052",6497,4715,4648,71,67,"VOX",1
13,"13903",539,437,432,4,5,"VOX",1
13,"13059",204,156,156,1,0,"VOX",0
13,"13034",58010,44627,44241,332,386,"VOX",141
13,"13073",542,409,405,0,4,"VOX",0
13,"13037",865,678,667,2,11,"VOX",2
13,"13044",2675,1959,1920,12,39,"VOX",4
13,"13018",824,667,662,7,5,"VOX",2
13,"13063",3728,2708,2685,9,23,"VOX",4
13,"13065",2888,2004,1970,19,34,"VOX",0
13,"13017",267,205,203,1,2,"VOX",0
13,"13038",1649,1317,1294,15,23,"VOX",1
13,"13008",441,317,311,2,6,"VOX",1
13,"13086",189,146,146,1,0,"VOX",0
13,"13003",487,367,363,2,4,"VOX",0
13,"13091",552,466,459,3,7,"VOX",0
13,"13027",3446,2543,2498,15,45,"VOX",9
13,"13085",2365,2011,1983,6,28,"VOX",8
13,"13026",452,374,372,1,2,"VOX",0
13,"13089",1728,1410,1381,6,29,"VOX",5
13,"13023",9003,6578,6517,86,61,"VOX",9
13,"13016",665,537,529,4,8,"VOX",0
13,"13076",488,415,408,1,7,"VOX",0
13,"13095",83,65,65,1,0,"VOX",3
13,"13009",1459,1167,1156,4,11,"VOX",2
13,"13058",4110,3157,3127,28,30,"VOX",10
13,"13043",231,186,185,5,1,"VOX",0
13,"13078",9089,6661,6584,44,77,"VOX",8
13,"13051",350,281,278,2,3,"VOX",0
13,"13097",2282,1783,1768,12,15,"VOX",0
13,"13014",496,404,398,2,6,"VOX",0
13,"13077",3518,2443,2378,12,65,"VOX",9
13,"13902",479,374,367,0,7,"VOX",0
13,"13901",895,676,660,4,16,"VOX",0
13,"13061",5723,4210,4149,49,61,"VOX",5
13,"13070",765,612,605,4,7,"VOX",2
13,"13011",4866,3346,3312,15,34,"VOX",8
13,"13020",4792,3494,3451,26,43,"VOX",10
13,"13079",12273,9195,9036,79,159,"VOX",12
13,"13024",898,643,637,7,6,"VOX",2
13,"13036",800,620,614,3,6,"VOX",3
13,"13045",679,532,522,7,10,"VOX",1
13,"13074",982,843,833,3,10,"VOX",1
13,"13057",1172,980,970,1,10,"VOX",1
13,"13012",411,294,292,0,2,"VOX",0
13,"13081",652,525,508,2,17,"VOX",0
13,"13031",2455,1940,1914,9,26,"VOX",0
13,"13064",1684,1288,1283,13,5,"VOX",2
13,"13042",928,696,688,3,8,"VOX",2
13,"13021",436,376,374,0,2,"VOX",2
13,"13041",253,182,180,0,2,"VOX",0
13,"13055",666,495,490,0,5,"VOX",1
13,"13062",575,471,466,4,5,"VOX",0
13,"13082",25841,17702,17561,154,141,"VOX",27
13,"13007",1273,1056,1028,10,28,"VOX",2
13,"13087",23161,16812,16595,145,217,"VOX",31
13,"13005",23330,18245,18030,164,215,"VOX",35
13,"13019",5179,3887,3830,35,57,"VOX",5
13,"13093",4111,3056,3014,21,42,"VOX",4
13,"13022",351,280,280,2,0,"VOX",0
13,"13068",1058,787,782,5,5,"VOX",0
13,"13006",608,487,479,4,8,"VOX",0
13,"13032",1150,878,870,9,8,"VOX",1
13,"13025",302,250,246,0,4,"VOX",0
13,"13028",10416,8309,8171,77,138,"VOX",11
13,"13090",1110,872,849,6,23,"VOX",0
13,"13040",892,720,710,3,10,"VOX",1
13,"13013",7086,5419,5340,45,79,"VOX",12
13,"13049",814,585,579,0,6,"VOX",1
13,"13039",14383,10833,10684,100,149,"VOX",10
13,"13083",2453,1729,1690,14,39,"VOX",3
13,"13048",515,418,416,3,2,"VOX",0
46,"46021",23646,18220,18100,85,120,"SOMVAL",48
46,"46205",14323,11325,11224,55,101,"SOMVAL",22
46,"46107",1915,1566,1553,2,13,"SOMVAL",2
46,"46086",82,73,73,1,0,"SOMVAL",0
46,"46137",268,225,220,3,5,"SOMVAL",0
46,"46014",3042,2456,2434,17,22,"SOMVAL",5
46,"46084",1576,1314,1298,6,16,"SOMVAL",2
46,"46132",2148,1850,1830,12,20,"SOMVAL",1
46,"46218",1074,930,912,1,18,"SOMVAL",2
46,"46257",5579,4440,4391,26,49,"SOMVAL",13
46,"46210",338,295,283,2,12,"SOMVAL",0
46,"46041",331,254,253,6,1,"SOMVAL",0
46,"46241",400,324,314,1,10,"SOMVAL",0
46,"46114",575,488,484,3,4,"SOMVAL",1
46,"46085",11147,8107,8033,57,74,"SOMVAL",30
46,"46036",583,384,381,8,3,"SOMVAL",1
46,"46038",345,255,255,0,0,"SOMVAL",1
46,"46005",22908,17565,17438,126,127,"SOMVAL",57
46,"46046",896,697,686,1,11,"SOMVAL",1
46,"46167",373,286,285,1,1,"SOMVAL",0
46,"46183",6009,4624,4563,18,61,"SOMVAL",6
46,"46100",289,240,237,1,3,"SOMVAL",2
46,"46204",6781,5421,5379,15,42,"SOMVAL",22
46,"46106",1543,1177,1167,5,10,"SOMVAL",0
46,"46146",1670,1333,1318,11,15,"SOMVAL",1
46,"46162",1207,962,947,3,15,"SOMVAL",3
46,"46190",48824,36748,36542,238,206,"SOMVAL",102
46,"46188",668,548,538,3,10,"SOMVAL",1
46,"46228",2363,1854,1839,16,15,"SOMVAL",3
46,"46117",493,414,411,4,3,"SOMVAL",4
46,"46089",2141,1649,1625,14,24,"SOMVAL",2
46,"46223",7814,6169,6129,33,40,"SOMVAL",26
46,"46135",9655,7845,7810,32,35,"SOMVAL",19
46,"46139",4495,3629,3577,26,52,"SOMVAL",5
46,"46145",21946,16629,16495,80,134,"SOMVAL",61
46,"46053",560,454,451,2,3,"SOMVAL",0
46,"46016",1068,885,874,3,11,"SOMVAL",1
46,"46171",16587,12731,12627,79,104,"SOMVAL",66
46,"46001",802,623,615,4,8,"SOMVAL",0
46,"46011",7627,5496,5407,39,89,"SOMVAL",30
46,"46042",3389,2886,2844,19,42,"SOMVAL",2
46,"46076",587,489,483,2,6,"SOMVAL",0
46,"46260",2572,2100,2081,10,19,"SOMVAL",8
46,"46166",8155,6521,6450,41,71,"SOMVAL",32
46,"46052",502,432,431,2,1,"SOMVAL",2
46,"46243",141,122,120,0,2,"SOMVAL",0
46,"46057",495,339,337,6,2,"SOMVAL",0
46,"46226",48,44,44,0,0,"SOMVAL",1
46,"46201",67,49,49,0,0,"SOMVAL",0
46,"46182",1274,970,966,2,4,"SOMVAL",1
46,"46151",722,589,583,1,6,"SOMVAL",2
46,"46060",9361,7285,7229,30,56,"SOMVAL",16
46,"46113",2436,1864,1849,11,15,"SOMVAL",6
46,"46051",8347,6500,6442,27,58,"SOMVAL",14
46,"46140",349,288,284,2,4,"SOMVAL",0
46,"46128",1601,1316,1281,5,35,"SOMVAL",2
46,"46153",441,358,354,0,4,"SOMVAL",0
46,"46130",907,722,713,6,9,"SOMVAL",4
46,"46170",3451,2821,2775,16,46,"SOMVAL",3
46,"46161",1481,1206,1194,6,12,"SOMVAL",3
46,"46091",115,101,100,1,1,"SOMVAL",0
46,"46186",19033,15061,14950,70,111,"SOMVAL",71
46,"46074",2690,2158,2145,18,13,"SOMVAL",9
46,"46019",8833,7183,7109,47,74,"SOMVAL",12
46,"46157",2978,2370,2343,19,27,"SOMVAL",4
46,"46033",197,169,168,1,1,"SOMVAL",1
46,"46262",232,172,168,0,4,"SOMVAL",0
46,"46144",665,525,520,2,5,"SOMVAL",1
46,"46165",7115,5626,5576,31,50,"SOMVAL",29
46,"46219",125,106,105,2,1,"SOMVAL",0
46,"46034",1776,1441,1430,4,11,"SOMVAL",2
46,"46176",2025,1431,1416,10,15,"SOMVAL",0
46,"46048",3448,2817,2790,8,27,"SOMVAL",4
46,"46064",527,429,423,0,6,"SOMVAL",2
46,"46039",2147,1746,1727,9,19,"SOMVAL",5
46,"46049",280,242,238,1,4,"SOMVAL",0
46,"46007",11953,9099,9038,65,61,"SOMVAL",59
46,"46093",2117,1721,1710,10,11,"SOMVAL",1
46,"46904",802,662,654,7,8,"SOMVAL",4
46,"46181",17066,12779,12636,96,143,"SOMVAL",17
46,"46249",9362,7163,7072,42,91,"SOMVAL",2
46,"46037",1119,952,941,2,11,"SOMVAL",1
46,"46077",7569,6100,6010,41,90,"SOMVAL",5
46,"46087",127,99,99,1,0,"SOMVAL",0
46,"46138",345,292,292,0,0,"SOMVAL",0
46,"46094",20515,15885,15785,125,100,"SOMVAL",139
46,"46098",2491,1978,1950,14,28,"SOMVAL",3
46,"46029",20649,15241,15110,113,131,"SOMVAL",36
46,"46023",328,294,287,2,7,"SOMVAL",0
46,"46031",10520,7830,7759,70,71,"SOMVAL",38
46,"46055",1273,1031,1021,4,10,"SOMVAL",4
46,"46035",6786,5382,5338,27,44,"SOMVAL",20
46,"46237",7227,5620,5571,33,49,"SOMVAL",22
46,"46173",1336,1097,1080,9,17,"SOMVAL",0
46,"46047",525,443,435,2,8,"SOMVAL",1
46,"46244",58586,43371,43098,257,273,"SOMVAL",189
46,"46163",1847,1508,1489,8,19,"SOMVAL",5
46,"46178",4643,3465,3434,16,31,"SOMVAL",13
46,"46191",1970,1557,1533,6,24,"SOMVAL",3
46,"46193",8795,7101,7061,40,40,"SOMVAL",23
46,"46208",1114,931,922,3,9,"SOMVAL",0
46,"46192",767,573,568,1,5,"SOMVAL",5
46,"46015",7231,5768,5711,33,57,"SOMVAL",49
46,"46238",13324,10023,9939,50,84,"SOMVAL",19
46,"46025",2502,2008,1993,6,15,"SOMVAL",13
46,"46209",1955,1531,1508,7,23,"SOMVAL",7
46,"46160",1912,1523,1514,3,9,"SOMVAL",5
46,"46158",1024,817,804,5,13,"SOMVAL",0
46,"46105",16249,11731,11629,59,102,"SOMVAL",30
46,"46263",255,204,202,1,2,"SOMVAL",0
46,"46168",1938,1542,1530,11,12,"SOMVAL",3
46,"46069",161,126,122,0,4,"SOMVAL",0
46,"46026",1204,1044,1034,4,10,"SOMVAL",2
46,"46234",354,289,287,2,2,"SOMVAL",0
46,"46071",466,383,379,2,4,"SOMVAL",0
46,"46079",326,267,265,2,2,"SOMVAL",0
46,"46068",354,305,297,1,8,"SOMVAL",0
46,"46185",386,325,321,4,4,"SOMVAL",0
46,"46022",15481,11422,11347,69,75,"SOMVAL",64
46,"46198",846,702,693,1,9,"SOMVAL",0
46,"46044",4237,3347,3285,25,62,"SOMVAL",0
46,"46224",170,130,130,0,0,"SOMVAL",0
46,"46221",339,305,303,0,2,"SOMVAL",0
46,"46095",608,498,493,2,5,"SOMVAL",0
46,"46115",403,296,289,1,7,"SOMVAL",0
46,"46213",15476,11377,11246,110,131,"SOMVAL",6
46,"46136",2534,2008,1990,13,18,"SOMVAL",1
46,"46212",1612,1234,1214,5,20,"SOMVAL",5
46,"46122",2701,2120,2109,18,11,"SOMVAL",4
46,"46254",1012,786,775,1,11,"SOMVAL",0
46,"46227",915,771,765,5,6,"SOMVAL",1
46,"46156",2087,1712,1702,9,10,"SOMVAL",9
46,"46054",11251,8795,8731,46,64,"SOMVAL",52
46,"46211",1723,1441,1434,13,7,"SOMVAL",4
46,"46009",3144,2579,2552,13,27,"SOMVAL",5
46,"46125",857,709,701,5,8,"SOMVAL",4
46,"46110",21260,16194,16084,76,110,"SOMVAL",49
46,"46206",577,475,468,4,7,"SOMVAL",0
46,"46231",2411,1759,1735,11,24,"SOMVAL",3
46,"46061",337,281,281,3,0,"SOMVAL",4
46,"46175",459,403,396,1,7,"SOMVAL",1
46,"46147",16843,12206,12099,56,107,"SOMVAL",34
46,"46172",5040,3629,3599,14,30,"SOMVAL",15
46,"46124",788,680,672,0,8,"SOMVAL",0
46,"46075",149,132,130,2,2,"SOMVAL",0
46,"46013",17366,13952,13862,95,90,"SOMVAL",74
46,"46090",1640,1440,1424,4,16,"SOMVAL",3
46,"46229",972,785,774,2,11,"SOMVAL",0
46,"46062",4652,3650,3583,32,67,"SOMVAL",9
46,"46097",959,734,728,6,6,"SOMVAL",1
46,"46236",975,810,806,4,4,"SOMVAL",3
46,"46177",4698,3715,3665,16,50,"SOMVAL",13
46,"46028",395,346,339,2,7,"SOMVAL",0
46,"46154",811,644,640,4,4,"SOMVAL",4
46,"46073",1097,903,892,6,11,"SOMVAL",0
46,"46196",153,131,130,0,1,"SOMVAL",0
46,"46155",1035,865,846,2,19,"SOMVAL",0
46,"46059",1272,1066,1058,4,8,"SOMVAL",3
46,"46143",4215,3219,3171,27,48,"SOMVAL",7
46,"46250",578668,455375,452638,2701,2737,"SOMVAL",2039
46,"46150",1839,1377,1362,10,15,"SOMVAL",3
46,"46101",858,731,723,4,8,"SOMVAL",2
46,"46024",424,348,340,0,8,"SOMVAL",1
46,"46063",1757,1399,1384,11,15,"SOMVAL",7
46,"46252",126,95,93,0,2,"SOMVAL",0
46,"46200",1909,1628,1609,5,19,"SOMVAL",3
46,"46179",2182,1823,1788,13,35,"SOMVAL",0
46,"46242",340,291,285,1,6,"SOMVAL",0
46,"46148",1528,1206,1192,15,14,"SOMVAL",1
46,"46216",5039,4207,4188,20,19,"SOMVAL",5
46,"46255",3145,2494,2470,19,24,"SOMVAL",7
46,"46239",451,353,351,3,2,"SOMVAL",0
46,"46003",963,841,815,1,26,"SOMVAL",1
46,"46072",3625,2993,2931,37,62,"SOMVAL",4
46,"46092",273,183,183,0,0,"SOMVAL",0
46,"46099",922,693,685,0,8,"SOMVAL",0
46,"46903",5985,4822,4796,24,26,"SOMVAL",29
46,"46207",6656,5355,5293,42,62,"SOMVAL",18
46,"46220",48393,35859,35571,250,288,"SOMVAL",57
46,"46134",2357,1811,1797,8,14,"SOMVAL",2
46,"46261",1720,1386,1369,10,17,"SOMVAL",1
46,"46214",15730,12427,12334,56,93,"SOMVAL",39
46,"46149",362,288,287,2,1,"SOMVAL",0
46,"46006",4529,3803,3748,18,55,"SOMVAL",5
46,"46258",2676,2099,2078,9,21,"SOMVAL",6
46,"46043",145,131,131,0,0,"SOMVAL",0
46,"46008",2673,2201,2189,8,12,"SOMVAL",5
46,"46018",635,531,522,3,9,"SOMVAL",2
46,"46045",1261,1066,1041,3,25,"SOMVAL",0
46,"46119",783,672,666,7,6,"SOMVAL",0
46,"46127",2706,2212,2175,10,37,"SOMVAL",2
46,"46202",16767,13171,13058,59,113,"SOMVAL",42
46,"46197",1956,1556,1543,8,13,"SOMVAL",4
46,"46121",105,92,91,2,1,"SOMVAL",0
46,"46253",109,93,93,0,0,"SOMVAL",1
46,"46248",4873,3679,3639,18,40,"SOMVAL",5
46,"46102",19843,15783,15676,102,107,"SOMVAL",35
46,"46120",1109,919,902,4,17,"SOMVAL",3
46,"46109",6195,4764,4682,23,82,"SOMVAL",2
46,"46104",1956,1567,1543,6,24,"SOMVAL",5
46,"46225",346,299,290,0,9,"SOMVAL",1
46,"46002",1175,947,935,5,12,"SOMVAL",4
46,"46230",13944,10746,10646,69,100,"SOMVAL",61
46,"46065",1588,1246,1227,5,19,"SOMVAL",15
46,"46199",5742,4458,4425,34,33,"SOMVAL",15
46,"46112",552,466,464,1,2,"SOMVAL",0
46,"46129",521,435,434,2,1,"SOMVAL",0
46,"46010",914,725,716,4,9,"SOMVAL",4
46,"46056",184,160,158,1,2,"SOMVAL",0
46,"46040",1098,914,907,4,7,"SOMVAL",1
46,"46131",49604,37767,37431,266,336,"SOMVAL",95
46,"46082",4947,3843,3814,25,29,"SOMVAL",12
46,"46195",1967,1612,1602,9,10,"SOMVAL",6
46,"46152",97,76,74,0,2,"SOMVAL",0
46,"46141",438,359,348,4,11,"SOMVAL",0
46,"46108",480,375,375,2,0,"SOMVAL",0
46,"46004",1924,1582,1559,11,23,"SOMVAL",3
46,"46142",797,619,608,2,11,"SOMVAL",0
46,"46116",13153,10566,10518,62,48,"SOMVAL",24
46,"46246",1066,856,838,7,18,"SOMVAL",2
46,"46222",383,322,321,2,1,"SOMVAL",2
46,"46902",379,314,313,3,1,"SOMVAL",1
46,"46203",3598,2962,2928,17,34,"SOMVAL",12
46,"46066",1255,1028,1020,6,8,"SOMVAL",7
46,"46187",1310,1036,1028,6,8,"SOMVAL",3
46,"46245",516,427,420,3,7,"SOMVAL",0
46,"46012",888,723,703,3,20,"SOMVAL",0
46,"46020",3784,3064,3012,15,52,"SOMVAL",8
46,"46050",200,160,160,0,0,"SOMVAL",1
46,"46030",804,660,635,7,25,"SOMVAL",1
46,"46067",1736,1457,1382,2,75,"SOMVAL",8
46,"46189",471,412,405,2,7,"SOMVAL",0
46,"46215",1433,1152,1149,4,3,"SOMVAL",0
46,"46078",28126,20975,20850,127,125,"SOMVAL",71
46,"46232",894,715,712,5,3,"SOMVAL",0
46,"46088",176,140,138,0,2,"SOMVAL",0
46,"46180",682,581,572,1,9,"SOMVAL",3
46,"46070",16903,13091,12999,64,92,"SOMVAL",37
46,"46233",3904,2974,2934,15,40,"SOMVAL",28
46,"46058",1779,1430,1409,10,21,"SOMVAL",2
46,"46017",33050,24762,24580,144,182,"SOMVAL",115
46,"46081",10180,8055,7984,32,71,"SOMVAL",29
46,"46240",209,169,164,1,5,"SOMVAL",0
46,"46133",563,458,455,2,3,"SOMVAL",0
46,"46169",32396,25109,24953,169,156,"SOMVAL",96
46,"46080",1025,795,784,4,11,"SOMVAL",0
46,"46126",5555,4619,4574,26,45,"SOMVAL",17
46,"46194",15552,11606,11505,69,101,"SOMVAL",62
46,"46111",10876,8133,8050,35,83,"SOMVAL",14
46,"46096",279,229,225,2,4,"SOMVAL",2
46,"46259",503,410,406,2,4,"SOMVAL",0
46,"46217",886,724,712,3,12,"SOMVAL",0
46,"46164",11777,8893,8798,54,95,"SOMVAL",17
46,"46083",15467,11584,11443,79,141,"SOMVAL",25
46,"46174",984,808,794,3,14,"SOMVAL",1
46,"46235",21793,16577,16424,118,153,"SOMVAL",44
46,"46159",22905,17498,17373,102,125,"SOMVAL",73
46,"46256",6833,5087,5062,37,25,"SOMVAL",23
46,"46027",948,795,781,3,14,"SOMVAL",2
46,"46032",5635,4529,4493,16,36,"SOMVAL",29
46,"46103",1270,1015,998,8,17,"SOMVAL",6
46,"46251",2490,2082,2045,11,37,"SOMVAL",2
46,"46184",26467,20888,20675,138,213,"SOMVAL",24
46,"46123",1838,1466,1447,4,19,"SOMVAL",3
46,"46247",1024,743,733,2,10,"SOMVAL",0
46,"46118",3795,2987,2962,18,25,"SOMVAL",2
46,"46136",2534,2008,1990,13,18,"ARA, PV",2
46,"46044",4237,3347,3285,25,62,"ARA, PV",1
46,"46215",1433,1152,1149,4,3,"ARA, PV",2
46,"46048",3448,2817,2790,8,27,"ARA, PV",4
46,"46040",1098,914,907,4,7,"ARA, PV",0
46,"46020",3784,3064,3012,15,52,"ARA, PV",1
46,"46064",527,429,423,0,6,"ARA, PV",0
46,"46047",525,443,435,2,8,"ARA, PV",0
46,"46128",1601,1316,1281,5,35,"ARA, PV",1
46,"46156",2087,1712,1702,9,10,"ARA, PV",2
46,"46178",4643,3465,3434,16,31,"ARA, PV",1
46,"46053",560,454,451,2,3,"ARA, PV",1
46,"46010",914,725,716,4,9,"ARA, PV",1
46,"46234",354,289,287,2,2,"ARA, PV",0
46,"46113",2436,1864,1849,11,15,"ARA, PV",4
46,"46007",11953,9099,9038,65,61,"ARA, PV",10
46,"46009",3144,2579,2552,13,27,"ARA, PV",3
46,"46016",1068,885,874,3,11,"ARA, PV",0
46,"46204",6781,5421,5379,15,42,"ARA, PV",6
46,"46183",6009,4624,4563,18,61,"ARA, PV",7
46,"46069",161,126,122,0,4,"ARA, PV",0
46,"46212",1612,1234,1214,5,20,"ARA, PV",0
46,"46197",1956,1556,1543,8,13,"ARA, PV",3
46,"46263",255,204,202,1,2,"ARA, PV",0
46,"46198",846,702,693,1,9,"ARA, PV",1
46,"46026",1204,1044,1034,4,10,"ARA, PV",1
46,"46084",1576,1314,1298,6,16,"ARA, PV",1
46,"46019",8833,7183,7109,47,74,"ARA, PV",4
46,"46038",345,255,255,0,0,"ARA, PV",0
46,"46045",1261,1066,1041,3,25,"ARA, PV",4
46,"46199",5742,4458,4425,34,33,"ARA, PV",4
46,"46002",1175,947,935,5,12,"ARA, PV",3
46,"46250",578668,455375,452638,2701,2737,"ARA, PV",320
46,"46079",326,267,265,2,2,"ARA, PV",0
46,"46254",1012,786,775,1,11,"ARA, PV",0
46,"46022",15481,11422,11347,69,75,"ARA, PV",13
46,"46075",149,132,130,2,2,"ARA, PV",0
46,"46221",339,305,303,0,2,"ARA, PV",0
46,"46132",2148,1850,1830,12,20,"ARA, PV",1
46,"46089",2141,1649,1625,14,24,"ARA, PV",1
46,"46247",1024,743,733,2,10,"ARA, PV",0
46,"46166",8155,6521,6450,41,71,"ARA, PV",7
46,"46088",176,140,138,0,2,"ARA, PV",0
46,"46224",170,130,130,0,0,"ARA, PV",0
46,"46031",10520,7830,7759,70,71,"ARA, PV",25
46,"46201",67,49,49,0,0,"ARA, PV",0
46,"46033",197,169,168,1,1,"ARA, PV",0
46,"46238",13324,10023,9939,50,84,"ARA, PV",28
46,"46155",1035,865,846,2,19,"ARA, PV",1
46,"46106",1543,1177,1167,5,10,"ARA, PV",0
46,"46072",3625,2993,2931,37,62,"ARA, PV",12
46,"46260",2572,2100,2081,10,19,"ARA, PV",2
46,"46246",1066,856,838,7,18,"ARA, PV",0
46,"46052",502,432,431,2,1,"ARA, PV",0
46,"46097",959,734,728,6,6,"ARA, PV",0
46,"46004",1924,1582,1559,11,23,"ARA, PV",1
46,"46229",972,785,774,2,11,"ARA, PV",0
46,"46042",3389,2886,2844,19,42,"ARA, PV",1
46,"46094",20515,15885,15785,125,100,"ARA, PV",10
46,"46001",802,623,615,4,8,"ARA, PV",0
46,"46222",383,322,321,2,1,"ARA, PV",0
46,"46227",915,771,765,5,6,"ARA, PV",0
46,"46160",1912,1523,1514,3,9,"ARA, PV",1
46,"46037",1119,952,941,2,11,"ARA, PV",2
46,"46137",268,225,220,3,5,"ARA, PV",2
46,"46074",2690,2158,2145,18,13,"ARA, PV",1
46,"46209",1955,1531,1508,7,23,"ARA, PV",3
46,"46130",907,722,713,6,9,"ARA, PV",0
46,"46014",3042,2456,2434,17,22,"ARA, PV",3
46,"46110",21260,16194,16084,76,110,"ARA, PV",15
46,"46076",587,489,483,2,6,"ARA, PV",0
46,"46104",1956,1567,1543,6,24,"ARA, PV",3
46,"46125",857,709,701,5,8,"ARA, PV",1
46,"46200",1909,1628,1609,5,19,"ARA, PV",1
46,"46131",49604,37767,37431,266,336,"ARA, PV",69
46,"46208",1114,931,922,3,9,"ARA, PV",1
46,"46245",516,427,420,3,7,"ARA, PV",0
46,"46008",2673,2201,2189,8,12,"ARA, PV",4
46,"46173",1336,1097,1080,9,17,"ARA, PV",1
46,"46249",9362,7163,7072,42,91,"ARA, PV",1
46,"46133",563,458,455,2,3,"ARA, PV",0
46,"46006",4529,3803,3748,18,55,"ARA, PV",2
46,"46171",16587,12731,12627,79,104,"ARA, PV",12
46,"46244",58586,43371,43098,257,273,"ARA, PV",30
46,"46124",788,680,672,0,8,"ARA, PV",0
46,"46092",273,183,183,0,0,"ARA, PV",0
46,"46054",11251,8795,8731,46,64,"ARA, PV",9
46,"46184",26467,20888,20675,138,213,"ARA, PV",17
46,"46057",495,339,337,6,2,"ARA, PV",0
46,"46017",33050,24762,24580,144,182,"ARA, PV",36
46,"46255",3145,2494,2470,19,24,"ARA, PV",1
46,"46046",896,697,686,1,11,"ARA, PV",0
46,"46161",1481,1206,1194,6,12,"ARA, PV",0
46,"46163",1847,1508,1489,8,19,"ARA, PV",3
46,"46135",9655,7845,7810,32,35,"ARA, PV",3
46,"46120",1109,919,902,4,17,"ARA, PV",1
46,"46023",328,294,287,2,7,"ARA, PV",0
46,"46140",349,288,284,2,4,"ARA, PV",0
46,"46060",9361,7285,7229,30,56,"ARA, PV",18
46,"46235",21793,16577,16424,118,153,"ARA, PV",49
46,"46129",521,435,434,2,1,"ARA, PV",0
46,"46261",1720,1386,1369,10,17,"ARA, PV",0
46,"46242",340,291,285,1,6,"ARA, PV",0
46,"46035",6786,5382,5338,27,44,"ARA, PV",8
46,"46236",975,810,806,4,4,"ARA, PV",0
46,"46107",1915,1566,1553,2,13,"ARA, PV",0
46,"46211",1723,1441,1434,13,7,"ARA, PV",1
46,"46039",2147,1746,1727,9,19,"ARA, PV",0
46,"46049",280,242,238,1,4,"ARA, PV",1
46,"46071",466,383,379,2,4,"ARA, PV",0
46,"46262",232,172,168,0,4,"ARA, PV",0
46,"46134",2357,1811,1797,8,14,"ARA, PV",0
46,"46169",32396,25109,24953,169,156,"ARA, PV",13
46,"46086",82,73,73,1,0,"ARA, PV",0
46,"46152",97,76,74,0,2,"ARA, PV",0
46,"46194",15552,11606,11505,69,101,"ARA, PV",9
46,"46056",184,160,158,1,2,"ARA, PV",1
46,"46003",963,841,815,1,26,"ARA, PV",0
46,"46091",115,101,100,1,1,"ARA, PV",0
46,"46090",1640,1440,1424,4,16,"ARA, PV",0
46,"46214",15730,12427,12334,56,93,"ARA, PV",5
46,"46114",575,488,484,3,4,"ARA, PV",0
46,"46181",17066,12779,12636,96,143,"ARA, PV",30
46,"46153",441,358,354,0,4,"ARA, PV",1
46,"46015",7231,5768,5711,33,57,"ARA, PV",3
46,"46185",386,325,321,4,4,"ARA, PV",0
46,"46232",894,715,712,5,3,"ARA, PV",0
46,"46174",984,808,794,3,14,"ARA, PV",1
46,"46192",767,573,568,1,5,"ARA, PV",3
46,"46159",22905,17498,17373,102,125,"ARA, PV",10
46,"46231",2411,1759,1735,11,24,"ARA, PV",13
46,"46186",19033,15061,14950,70,111,"ARA, PV",2
46,"46112",552,466,464,1,2,"ARA, PV",0
46,"46115",403,296,289,1,7,"ARA, PV",0
46,"46087",127,99,99,1,0,"ARA, PV",0
46,"46061",337,281,281,3,0,"ARA, PV",1
46,"46146",1670,1333,1318,11,15,"ARA, PV",5
46,"46257",5579,4440,4391,26,49,"ARA, PV",5
46,"46223",7814,6169,6129,33,40,"ARA, PV",6
46,"46111",10876,8133,8050,35,83,"ARA, PV",4
46,"46187",1310,1036,1028,6,8,"ARA, PV",0
46,"46034",1776,1441,1430,4,11,"ARA, PV",2
46,"46105",16249,11731,11629,59,102,"ARA, PV",8
46,"46190",48824,36748,36542,238,206,"ARA, PV",24
46,"46168",1938,1542,1530,11,12,"ARA, PV",1
46,"46028",395,346,339,2,7,"ARA, PV",1
46,"46189",471,412,405,2,7,"ARA, PV",0
46,"46108",480,375,375,2,0,"ARA, PV",0
46,"46118",3795,2987,2962,18,25,"ARA, PV",0
46,"46058",1779,1430,1409,10,21,"ARA, PV",16
46,"46259",503,410,406,2,4,"ARA, PV",0
46,"46029",20649,15241,15110,113,131,"ARA, PV",53
46,"46241",400,324,314,1,10,"ARA, PV",0
46,"46219",125,106,105,2,1,"ARA, PV",0
46,"46143",4215,3219,3171,27,48,"ARA, PV",1
46,"46077",7569,6100,6010,41,90,"ARA, PV",10
46,"46206",577,475,468,4,7,"ARA, PV",0
46,"46098",2491,1978,1950,14,28,"ARA, PV",1
46,"46102",19843,15783,15676,102,107,"ARA, PV",6
46,"46165",7115,5626,5576,31,50,"ARA, PV",6
46,"46243",141,122,120,0,2,"ARA, PV",0
46,"46210",338,295,283,2,12,"ARA, PV",0
46,"46251",2490,2082,2045,11,37,"ARA, PV",4
46,"46030",804,660,635,7,25,"ARA, PV",0
46,"46207",6656,5355,5293,42,62,"ARA, PV",9
46,"46182",1274,970,966,2,4,"ARA, PV",2
46,"46226",48,44,44,0,0,"ARA, PV",0
46,"46258",2676,2099,2078,9,21,"ARA, PV",1
46,"46085",11147,8107,8033,57,74,"ARA, PV",10
46,"46109",6195,4764,4682,23,82,"ARA, PV",2
46,"46018",635,531,522,3,9,"ARA, PV",0
46,"46093",2117,1721,1710,10,11,"ARA, PV",2
46,"46068",354,305,297,1,8,"ARA, PV",1
46,"46103",1270,1015,998,8,17,"ARA, PV",7
46,"46179",2182,1823,1788,13,35,"ARA, PV",0
46,"46205",14323,11325,11224,55,101,"ARA, PV",18
46,"46121",105,92,91,2,1,"ARA, PV",0
46,"46151",722,589,583,1,6,"ARA, PV",0
46,"46024",424,348,340,0,8,"ARA, PV",0
46,"46213",15476,11377,11246,110,131,"ARA, PV",3
46,"46188",668,548,538,3,10,"ARA, PV",0
46,"46158",1024,817,804,5,13,"ARA, PV",0
46,"46011",7627,5496,5407,39,89,"ARA, PV",6
46,"46145",21946,16629,16495,80,134,"ARA, PV",10
46,"46043",145,131,131,0,0,"ARA, PV",0
46,"46248",4873,3679,3639,18,40,"ARA, PV",4
46,"46172",5040,3629,3599,14,30,"ARA, PV",5
46,"46096",279,229,225,2,4,"ARA, PV",0
46,"46065",1588,1246,1227,5,19,"ARA, PV",1
46,"46162",1207,962,947,3,15,"ARA, PV",0
46,"46230",13944,10746,10646,69,100,"ARA, PV",15
46,"46902",379,314,313,3,1,"ARA, PV",1
46,"46005",22908,17565,17438,126,127,"ARA, PV",25
46,"46119",783,672,666,7,6,"ARA, PV",0
46,"46228",2363,1854,1839,16,15,"ARA, PV",1
46,"46127",2706,2212,2175,10,37,"ARA, PV",3
46,"46055",1273,1031,1021,4,10,"ARA, PV",0
46,"46216",5039,4207,4188,20,19,"ARA, PV",3
46,"46063",1757,1399,1384,11,15,"ARA, PV",1
46,"46180",682,581,572,1,9,"ARA, PV",1
46,"46195",1967,1612,1602,9,10,"ARA, PV",0
46,"46149",362,288,287,2,1,"ARA, PV",0
46,"46904",802,662,654,7,8,"ARA, PV",5
46,"46126",5555,4619,4574,26,45,"ARA, PV",10
46,"46100",289,240,237,1,3,"ARA, PV",1
46,"46167",373,286,285,1,1,"ARA, PV",0
46,"46150",1839,1377,1362,10,15,"ARA, PV",0
46,"46059",1272,1066,1058,4,8,"ARA, PV",2
46,"46099",922,693,685,0,8,"ARA, PV",0
46,"46157",2978,2370,2343,19,27,"ARA, PV",3
46,"46252",126,95,93,0,2,"ARA, PV",0
46,"46139",4495,3629,3577,26,52,"ARA, PV",3
46,"46081",10180,8055,7984,32,71,"ARA, PV",12
46,"46012",888,723,703,3,20,"ARA, PV",0
46,"46256",6833,5087,5062,37,25,"ARA, PV",7
46,"46237",7227,5620,5571,33,49,"ARA, PV",4
46,"46027",948,795,781,3,14,"ARA, PV",0
46,"46101",858,731,723,4,8,"ARA, PV",0
46,"46117",493,414,411,4,3,"ARA, PV",0
46,"46218",1074,930,912,1,18,"ARA, PV",2
46,"46233",3904,2974,2934,15,40,"ARA, PV",3
46,"46239",451,353,351,3,2,"ARA, PV",0
46,"46176",2025,1431,1416,10,15,"ARA, PV",0
46,"46051",8347,6500,6442,27,58,"ARA, PV",8
46,"46067",1736,1457,1382,2,75,"ARA, PV",2
46,"46013",17366,13952,13862,95,90,"ARA, PV",18
46,"46050",200,160,160,0,0,"ARA, PV",0
46,"46217",886,724,712,3,12,"ARA, PV",1
46,"46066",1255,1028,1020,6,8,"ARA, PV",1
46,"46070",16903,13091,12999,64,92,"ARA, PV",7
46,"46082",4947,3843,3814,25,29,"ARA, PV",8
46,"46032",5635,4529,4493,16,36,"ARA, PV",3
46,"46148",1528,1206,1192,15,14,"ARA, PV",0
46,"46095",608,498,493,2,5,"ARA, PV",0
46,"46138",345,292,292,0,0,"ARA, PV",1
46,"46147",16843,12206,12099,56,107,"ARA, PV",7
46,"46036",583,384,381,8,3,"ARA, PV",0
46,"46203",3598,2962,2928,17,34,"ARA, PV",2
46,"46025",2502,2008,1993,6,15,"ARA, PV",1
46,"46116",13153,10566,10518,62,48,"ARA, PV",19
46,"46083",15467,11584,11443,79,141,"ARA, PV",16
46,"46144",665,525,520,2,5,"ARA, PV",0
46,"46123",1838,1466,1447,4,19,"ARA, PV",3
46,"46142",797,619,608,2,11,"ARA, PV",0
46,"46170",3451,2821,2775,16,46,"ARA, PV",1
46,"46175",459,403,396,1,7,"ARA, PV",1
46,"46041",331,254,253,6,1,"ARA, PV",0
46,"46202",16767,13171,13058,59,113,"ARA, PV",15
46,"46253",109,93,93,0,0,"ARA, PV",0
46,"46141",438,359,348,4,11,"ARA, PV",2
46,"46196",153,131,130,0,1,"ARA, PV",0
46,"46073",1097,903,892,6,11,"ARA, PV",0
46,"46225",346,299,290,0,9,"ARA, PV",0
46,"46021",23646,18220,18100,85,120,"ARA, PV",20
46,"46220",48393,35859,35571,250,288,"ARA, PV",65
46,"46240",209,169,164,1,5,"ARA, PV",2
46,"46062",4652,3650,3583,32,67,"ARA, PV",1
46,"46191",1970,1557,1533,6,24,"ARA, PV",1
46,"46903",5985,4822,4796,24,26,"ARA, PV",2
46,"46078",28126,20975,20850,127,125,"ARA, PV",17
46,"46080",1025,795,784,4,11,"ARA, PV",0
46,"46154",811,644,640,4,4,"ARA, PV",1
46,"46193",8795,7101,7061,40,40,"ARA, PV",1
46,"46164",11777,8893,8798,54,95,"ARA, PV",8
46,"46122",2701,2120,2109,18,11,"ARA, PV",16
46,"46177",4698,3715,3665,16,50,"ARA, PV",3
29,"29029",420,322,315,4,7,"UPYD",4
29,"29046",2690,1974,1954,17,20,"UPYD",4
29,"29070",39913,26993,26751,203,242,"UPYD",203
29,"29036",636,481,475,3,6,"UPYD",2
29,"29094",57313,39393,39052,280,341,"UPYD",149
29,"29077",208,156,153,0,3,"UPYD",0
29,"29023",2047,1385,1369,2,16,"UPYD",7
29,"29098",1257,991,977,12,14,"UPYD",6
29,"29068",6885,4580,4511,43,69,"UPYD",14
29,"29055",1808,1415,1396,13,19,"UPYD",1
29,"29009",1477,1113,1100,3,13,"UPYD",1
29,"29062",658,564,561,0,3,"UPYD",0
29,"29011",2920,1962,1946,5,16,"UPYD",5
29,"29089",3254,2465,2438,10,27,"UPYD",3
29,"29049",2987,2204,2185,25,19,"UPYD",2
29,"29001",4196,3276,3253,26,23,"UPYD",4
29,"29010",1667,1336,1310,1,26,"UPYD",4
29,"29083",2114,1587,1568,10,19,"UPYD",0
29,"29053",1702,1178,1160,17,18,"UPYD",9
29,"29041",3146,2251,2216,26,35,"UPYD",2
29,"29057",376,285,284,2,1,"UPYD",0
29,"29050",425,313,309,1,4,"UPYD",0
29,"29060",706,524,516,0,8,"UPYD",1
29,"29088",2720,1930,1883,21,47,"UPYD",1
29,"29002",1203,855,842,6,13,"UPYD",6
29,"29005",4342,2946,2908,22,38,"UPYD",9
29,"29035",1587,1218,1208,0,10,"UPYD",0
29,"29043",2503,1671,1638,17,33,"UPYD",5
29,"29017",6610,5001,4938,25,63,"UPYD",11
29,"29075",12952,8681,8619,55,62,"UPYD",21
29,"29006",680,482,474,3,8,"UPYD",1
29,"29004",328,240,238,2,2,"UPYD",0
29,"29034",466,361,359,0,2,"UPYD",0
29,"29028",1249,881,881,4,0,"UPYD",0
29,"29003",1002,777,769,1,8,"UPYD",5
29,"29012",9765,7029,6944,58,85,"UPYD",31
29,"29037",212,166,165,1,1,"UPYD",1
29,"29059",2590,2100,2058,11,42,"UPYD",4
29,"29084",27393,19096,18886,192,210,"UPYD",60
29,"29018",2026,1560,1519,15,41,"UPYD",7
29,"29015",31884,23160,22943,188,217,"UPYD",138
29,"29079",2444,1880,1846,3,34,"UPYD",2
29,"29013",1612,1282,1272,6,10,"UPYD",3
29,"29087",380,283,276,1,7,"UPYD",1
29,"29051",40201,27168,26842,229,326,"UPYD",93
29,"29016",253,188,188,1,0,"UPYD",3
29,"29042",14078,9890,9776,75,114,"UPYD",80
29,"29071",938,640,633,6,7,"UPYD",0
29,"29019",888,675,672,0,3,"UPYD",0
29,"29044",811,557,556,3,1,"UPYD",2
29,"29096",2806,2065,2034,19,31,"UPYD",8
29,"29099",960,741,734,3,7,"UPYD",1
29,"29100",2437,1775,1760,12,15,"UPYD",7
29,"29045",1685,1232,1223,4,9,"UPYD",8
29,"29030",809,653,651,2,2,"UPYD",1
29,"29080",6704,4812,4766,44,46,"UPYD",19
29,"29027",2343,1737,1722,6,15,"UPYD",5
29,"29097",4117,2996,2947,43,49,"UPYD",5
29,"29054",41888,29228,29022,205,206,"UPYD",208
29,"29039",2662,1948,1931,22,17,"UPYD",7
29,"29047",1131,927,914,4,13,"UPYD",2
29,"29081",258,205,200,1,5,"UPYD",0
29,"29020",3265,2531,2504,17,27,"UPYD",7
29,"29066",346,252,251,2,1,"UPYD",1
29,"29048",1428,1168,1155,9,13,"UPYD",1
29,"29073",1560,1126,1120,5,6,"UPYD",4
29,"29074",785,612,611,4,1,"UPYD",1
29,"29095",3350,2523,2467,17,56,"UPYD",7
29,"29033",1132,808,804,2,4,"UPYD",4
29,"29031",1633,1115,1106,6,9,"UPYD",1
29,"29021",162,114,107,13,7,"UPYD",2
29,"29903",525,394,389,2,5,"UPYD",0
29,"29022",185,143,143,1,0,"UPYD",2
29,"29063",336,255,251,2,4,"UPYD",1
29,"29902",2560,1735,1709,13,26,"UPYD",4
29,"29085",151,99,98,1,1,"UPYD",0
29,"29901",43601,30325,30130,188,195,"UPYD",200
29,"29038",17555,11638,11562,124,76,"UPYD",80
29,"29069",85333,56398,55854,443,544,"UPYD",322
29,"29076",2163,1508,1482,8,26,"UPYD",5
29,"29026",1065,776,766,4,10,"UPYD",0
29,"29092",567,423,415,4,8,"UPYD",2
29,"29024",393,271,256,4,15,"UPYD",0
29,"29093",2235,1689,1667,12,22,"UPYD",3
29,"29904",428,363,360,2,3,"UPYD",0
29,"29007",27319,19557,19395,179,162,"UPYD",130
29,"29091",8966,6437,6346,57,91,"UPYD",21
29,"29040",1964,1321,1301,12,20,"UPYD",2
29,"29086",795,497,490,3,7,"UPYD",1
29,"29025",39210,26938,26747,160,191,"UPYD",155
29,"29056",1107,815,807,8,8,"UPYD",4
29,"29008",14541,9954,9820,90,134,"UPYD",29
29,"29032",6708,5341,5265,26,76,"UPYD",12
29,"29052",226,155,152,0,3,"UPYD",0
29,"29072",3250,2466,2434,11,32,"UPYD",5
29,"29061",1018,833,820,4,13,"UPYD",3
29,"29090",1704,1174,1165,10,9,"UPYD",3
29,"29067",424770,295944,294094,2117,1850,"UPYD",2095
29,"29064",506,372,365,2,7,"UPYD",1
29,"29082",31505,23154,22990,127,164,"UPYD",197
29,"29065",194,134,134,1,0,"UPYD",2
29,"29014",219,138,138,1,0,"UPYD",0
29,"29058",1463,986,975,6,11,"UPYD",5
6,"6120",3393,2635,2600,14,35,"C's",216
6,"6068",453,349,344,3,5,"C's",17
6,"6088",12639,8992,8885,68,107,"C's",1032
6,"6106",428,295,293,2,2,"C's",29
6,"6101",466,386,382,0,4,"C's",25
6,"6048",848,716,700,0,16,"C's",37
6,"6059",1858,1361,1342,12,19,"C's",161
6,"6128",4445,3137,3116,36,21,"C's",314
6,"6045",499,378,378,4,0,"C's",21
6,"6075",477,401,389,2,12,"C's",13
6,"6004",1604,1265,1248,10,17,"C's",86
6,"6066",1776,1260,1245,2,15,"C's",57
6,"6115",1260,867,853,7,14,"C's",77
6,"6065",309,257,247,0,10,"C's",8
6,"6021",928,668,656,9,12,"C's",30
6,"6094",1483,1025,1014,6,11,"C's",44
6,"6107",1591,1114,1107,4,7,"C's",55
6,"6064",841,672,671,6,1,"C's",24
6,"6054",5442,4185,4098,32,87,"C's",324
6,"6092",582,402,392,3,10,"C's",26
6,"6104",677,533,529,6,4,"C's",52
6,"6086",1233,884,874,3,10,"C's",55
6,"6009",206,156,156,1,0,"C's",7
6,"6095",9493,6973,6839,97,134,"C's",587
6,"6102",1055,843,830,3,13,"C's",36
6,"6069",3079,2164,2137,21,27,"C's",199
6,"6056",481,401,399,2,2,"C's",18
6,"6046",1248,989,978,4,11,"C's",70
6,"6005",1717,1271,1258,10,13,"C's",91
6,"6029",1213,892,875,8,17,"C's",38
6,"6133",1775,1351,1334,9,17,"C's",76
6,"6137",987,811,805,4,6,"C's",87
6,"6070",7753,5773,5645,52,128,"C's",722
6,"6146",1094,848,837,5,11,"C's",35
6,"6087",2127,1612,1592,16,20,"C's",116
6,"6015",116673,82152,81388,677,764,"C's",13691
6,"6131",1074,887,885,2,2,"C's",39
6,"6129",591,466,462,3,4,"C's",23
6,"6073",745,507,497,5,10,"C's",17
6,"6116",1607,1168,1149,10,19,"C's",86
6,"6006",4595,3365,3318,27,47,"C's",303
6,"6097",2390,1814,1798,7,16,"C's",135
6,"6026",837,632,623,2,9,"C's",43
6,"6112",393,335,333,0,2,"C's",26
6,"6058",2055,1512,1494,14,18,"C's",140
6,"6152",1322,964,951,1,13,"C's",102
6,"6076",837,632,624,2,8,"C's",18
6,"6030",172,138,138,0,0,"C's",8
6,"6010",1111,877,863,7,14,"C's",72
6,"6108",2299,1714,1683,13,31,"C's",165
6,"6090",877,661,642,7,19,"C's",39
6,"6098",545,408,402,1,6,"C's",17
6,"6144",562,450,447,3,3,"C's",19
6,"6134",545,325,323,3,2,"C's",16
6,"6017",274,229,228,1,1,"C's",14
6,"6023",4362,3200,3168,11,32,"C's",207
6,"6014",6688,4651,4586,22,65,"C's",632
6,"6154",2798,2001,1975,17,26,"C's",143
6,"6109",3957,3258,3177,22,81,"C's",195
6,"6113",2725,2091,2054,9,37,"C's",187
6,"6139",553,442,436,1,6,"C's",23
6,"6060",5798,4346,4261,23,85,"C's",342
6,"6051",1573,1235,1222,6,13,"C's",49
6,"6085",3427,2563,2524,21,39,"C's",308
6,"6018",761,543,539,3,4,"C's",23
6,"6141",1741,1246,1223,13,23,"C's",62
6,"6126",2183,1594,1582,9,12,"C's",116
6,"6117",1417,1044,1031,3,13,"C's",94
6,"6096",226,188,182,1,6,"C's",4
6,"6114",148,116,116,0,0,"C's",2
6,"6007",1483,1076,1068,6,8,"C's",43
6,"6020",1822,1435,1406,12,29,"C's",112
6,"6142",276,215,207,0,8,"C's",12
6,"6061",1092,899,890,6,9,"C's",24
6,"6155",1890,1337,1315,15,22,"C's",122
6,"6033",1330,1037,1025,10,12,"C's",54
6,"6100",938,776,763,2,13,"C's",31
6,"6099",1148,768,749,5,19,"C's",45
6,"6008",634,562,558,1,4,"C's",30
6,"6053",607,459,450,2,9,"C's",33
6,"6047",855,664,654,2,10,"C's",44
6,"6062",612,450,441,4,9,"C's",18
6,"6156",1169,903,898,2,5,"C's",49
6,"6049",1021,747,733,2,14,"C's",46
6,"6130",195,174,170,0,4,"C's",6
6,"6035",957,700,690,4,10,"C's",42
6,"6125",1754,1327,1304,7,23,"C's",103
6,"6143",3338,2548,2508,23,40,"C's",145
6,"6034",174,126,125,2,1,"C's",11
6,"6135",1103,904,888,9,16,"C's",70
6,"6028",4253,3716,3631,30,85,"C's",236
6,"6103",4781,3519,3459,40,60,"C's",382
6,"6063",3038,2413,2391,15,22,"C's",153
6,"6071",247,208,203,0,5,"C's",1
6,"6140",633,493,482,6,11,"C's",25
6,"6032",66,54,54,2,0,"C's",12
6,"6153",20417,15129,14934,112,195,"C's",1719
6,"6118",206,165,164,1,1,"C's",2
6,"6019",2090,1519,1488,11,31,"C's",112
6,"6037",1768,1176,1160,5,16,"C's",82
6,"6127",2893,2188,2158,13,30,"C's",173
6,"6091",3782,2728,2690,32,38,"C's",162
6,"6078",510,414,407,1,7,"C's",14
6,"6157",453,316,315,0,1,"C's",15
6,"6011",24721,17683,17506,172,177,"C's",2571
6,"6132",855,634,627,4,7,"C's",24
6,"6072",2334,1813,1792,20,21,"C's",152
6,"6105",631,448,443,0,5,"C's",43
6,"6074",4814,3717,3659,37,58,"C's",392
6,"6119",701,519,514,1,5,"C's",34
6,"6159",2339,1429,1407,14,22,"C's",107
6,"6025",5126,3833,3783,37,50,"C's",297
6,"6038",801,558,551,5,7,"C's",40
6,"6160",3154,2324,2292,12,32,"C's",137
6,"6079",645,502,488,1,14,"C's",36
6,"6039",1838,1546,1517,9,29,"C's",49
6,"6145",916,717,711,9,6,"C's",25
6,"6052",4051,3071,3009,31,62,"C's",283
6,"6093",4472,3476,3416,22,60,"C's",264
6,"6003",830,656,647,6,9,"C's",57
6,"6147",362,285,281,0,4,"C's",14
6,"6080",1931,1498,1480,9,18,"C's",121
6,"6012",3280,2358,2343,12,15,"C's",185
6,"6161",315,236,231,1,5,"C's",16
6,"6067",1984,1408,1377,9,31,"C's",141
6,"6040",1002,758,754,4,4,"C's",34
6,"6121",3383,2518,2483,21,35,"C's",251
6,"6013",265,230,224,1,6,"C's",9
6,"6036",5085,3797,3739,29,58,"C's",417
6,"6022",2660,2159,2140,12,19,"C's",179
6,"6081",1078,850,839,4,11,"C's",69
6,"6148",973,739,730,5,9,"C's",38
6,"6027",681,586,576,1,10,"C's",40
6,"6077",347,276,272,3,4,"C's",13
6,"6122",6651,4654,4553,29,101,"C's",455
6,"6050",4124,3178,3110,30,68,"C's",249
6,"6158",13305,9965,9802,91,163,"C's",1171
6,"6162",2938,2278,2239,17,39,"C's",202
6,"6136",1578,1182,1168,8,14,"C's",83
6,"6082",382,312,306,3,6,"C's",27
6,"6149",10342,8013,7897,70,116,"C's",952
6,"6041",460,378,375,3,3,"C's",17
6,"6042",1012,711,703,3,8,"C's",33
6,"6055",2058,1557,1527,21,30,"C's",88
6,"6901",2114,1648,1625,28,23,"C's",140
6,"6001",696,526,521,1,5,"C's",27
6,"6150",806,658,650,6,8,"C's",67
6,"6002",4335,3084,3006,33,78,"C's",323
6,"6024",1181,955,942,5,13,"C's",46
6,"6110",151,107,104,0,3,"C's",9
6,"6123",4644,3420,3357,22,63,"C's",325
6,"6016",2978,2258,2235,14,23,"C's",167
6,"6083",46111,32608,32276,235,332,"C's",5344
6,"6902",1672,1239,1224,6,15,"C's",102
6,"6124",1739,1309,1287,15,22,"C's",72
6,"6043",673,542,535,5,7,"C's",73
6,"6111",507,360,359,2,1,"C's",18
6,"6903",2017,1509,1475,11,34,"C's",112
6,"6151",1094,809,801,8,8,"C's",71
6,"6089",598,491,488,3,3,"C's",33
6,"6057",573,471,466,1,5,"C's",9
6,"6044",28899,20862,20681,153,181,"C's",2600
6,"6084",1100,857,842,4,15,"C's",61
6,"6138",1059,795,773,3,22,"C's",52
6,"6031",466,321,316,2,5,"C's",13
36,"36024",16433,12239,12016,115,223,"PACMA",81
36,"36050",7562,5567,5457,44,110,"PACMA",42
36,"36049",6761,5193,5069,54,124,"PACMA",43
36,"36005",8120,5839,5747,64,92,"PACMA",39
36,"36039",15350,11581,11349,119,232,"PACMA",117
36,"36023",8420,6287,6180,55,107,"PACMA",36
36,"36037",2607,1862,1838,16,24,"PACMA",14
36,"36058",4992,3495,3441,48,54,"PACMA",20
36,"36014",1980,1464,1442,7,22,"PACMA",8
36,"36011",1842,1185,1169,9,16,"PACMA",2
36,"36043",4736,3347,3297,22,50,"PACMA",37
36,"36001",2593,1968,1952,6,16,"PACMA",13
36,"36008",21736,16270,16094,160,176,"PACMA",153
36,"36901",4095,3344,3293,22,51,"PACMA",24
36,"36041",13428,9842,9710,96,132,"PACMA",93
36,"36053",5693,4321,4265,41,56,"PACMA",43
36,"36007",1689,1168,1148,12,20,"PACMA",7
36,"36031",558,464,454,9,10,"PACMA",2
36,"36009",4908,3167,3114,25,53,"PACMA",14
36,"36022",9056,6635,6514,48,121,"PACMA",33
36,"36060",30350,22032,21753,193,279,"PACMA",194
36,"36025",2292,1396,1389,9,7,"PACMA",12
36,"36029",16129,12262,12078,101,184,"PACMA",94
36,"36048",5348,3970,3892,44,78,"PACMA",32
36,"36027",4452,3328,3274,23,54,"PACMA",25
36,"36042",17922,12993,12760,116,233,"PACMA",118
36,"36051",14272,10230,10072,95,158,"PACMA",85
36,"36018",3272,2288,2262,17,26,"PACMA",13
36,"36061",8651,6594,6445,58,149,"PACMA",67
36,"36054",10996,8116,7965,84,151,"PACMA",73
36,"36006",11537,8885,8740,79,145,"PACMA",77
36,"36026",20203,14399,14189,144,210,"PACMA",141
36,"36052",7298,5298,5175,37,123,"PACMA",22
36,"36045",24570,18613,18365,184,248,"PACMA",172
36,"36057",236957,177555,175758,1730,1797,"PACMA",1974
36,"36010",2862,2195,2177,18,18,"PACMA",14
36,"36035",14430,10832,10680,86,152,"PACMA",114
36,"36040",2600,1907,1869,13,38,"PACMA",11
36,"36002",3151,2290,2255,19,35,"PACMA",13
36,"36047",2492,1719,1704,16,15,"PACMA",1
36,"36056",5108,3856,3783,34,73,"PACMA",30
36,"36055",13643,10361,10145,106,216,"PACMA",99
36,"36019",1625,1127,1119,12,8,"PACMA",5
36,"36016",1173,724,716,7,8,"PACMA",1
36,"36012",3735,2818,2777,21,41,"PACMA",20
36,"36004",10178,7351,7224,69,127,"PACMA",69
36,"36030",4220,3041,2994,32,47,"PACMA",22
36,"36021",12033,9035,8879,99,156,"PACMA",86
36,"36033",12347,9515,9336,76,179,"PACMA",80
36,"36034",3477,2499,2470,15,29,"PACMA",18
36,"36020",2351,1748,1721,20,27,"PACMA",6
36,"36044",2556,1786,1747,13,39,"PACMA",13
36,"36046",4055,3189,3139,30,50,"PACMA",25
36,"36017",17866,13133,12910,137,223,"PACMA",66
36,"36032",3655,2745,2699,21,46,"PACMA",16
36,"36036",2511,1923,1892,17,31,"PACMA",13
36,"36038",66390,49943,49439,522,504,"PACMA",450
36,"36013",2412,1602,1586,12,16,"PACMA",11
36,"36003",9979,7496,7401,81,95,"PACMA",57
36,"36028",4139,3094,3045,22,49,"PACMA",20
36,"36015",4205,2941,2885,32,56,"PACMA",14
36,"36059",4937,3379,3318,46,61,"PACMA",20
48,"48052",1559,1215,1211,0,4,"EH Bildu",551
48,"48026",1134,861,853,7,8,"EH Bildu",408
48,"48053",900,676,670,8,6,"EH Bildu",99
48,"48908",245,200,199,1,1,"EH Bildu",65
48,"48072",974,728,723,5,5,"EH Bildu",323
48,"48091",1134,821,812,7,9,"EH Bildu",267
48,"48018",875,553,553,3,0,"EH Bildu",225
48,"48097",1303,907,898,10,9,"EH Bildu",161
48,"48094",3193,2210,2200,18,10,"EH Bildu",763
48,"48080",9971,7148,7086,71,62,"EH Bildu",714
48,"48062",300,241,240,1,1,"EH Bildu",73
48,"48002",7851,5767,5713,41,54,"EH Bildu",660
48,"48088",135,97,96,0,1,"EH Bildu",59
48,"48049",548,433,431,0,2,"EH Bildu",139
48,"48081",1883,1412,1398,12,14,"EH Bildu",292
48,"48055",2662,1961,1938,16,23,"EH Bildu",567
48,"48904",3504,2671,2650,18,21,"EH Bildu",317
48,"48050",198,153,150,0,3,"EH Bildu",71
48,"48067",1161,837,834,2,3,"EH Bildu",342
48,"48912",2308,1787,1746,27,41,"EH Bildu",363
48,"48068",1551,1178,1163,16,15,"EH Bildu",263
48,"48043",4403,3214,3186,28,28,"EH Bildu",544
48,"48070",545,378,374,2,4,"EH Bildu",232
48,"48003",14338,10497,10414,76,83,"EH Bildu",2220
48,"48025",883,642,639,3,3,"EH Bildu",208
48,"48076",314,237,237,4,0,"EH Bildu",50
48,"48060",3645,2277,2274,7,3,"EH Bildu",825
48,"48082",37673,27006,26811,201,195,"EH Bildu",2527
48,"48092",837,619,619,13,0,"EH Bildu",103
48,"48010",457,311,307,1,4,"EH Bildu",89
48,"48021",1352,952,946,8,6,"EH Bildu",239
48,"48069",12765,8985,8910,58,75,"EH Bildu",1346
48,"48909",207,165,165,1,0,"EH Bildu",90
48,"48046",12617,9037,8967,56,70,"EH Bildu",2353
48,"48019",3594,2569,2544,16,25,"EH Bildu",545
48,"48079",425,322,321,4,1,"EH Bildu",130
48,"48042",1384,1111,1091,7,20,"EH Bildu",91
48,"48036",24144,17085,16954,117,131,"EH Bildu",2439
48,"48022",2355,1476,1468,9,8,"EH Bildu",117
48,"48914",330,275,275,1,0,"EH Bildu",100
48,"48073",6952,4476,4435,43,41,"EH Bildu",1907
48,"48066",346,256,256,1,0,"EH Bildu",67
48,"48034",12902,9684,9613,79,71,"EH Bildu",755
48,"48037",678,518,509,2,9,"EH Bildu",108
48,"48033",215,160,159,0,1,"EH Bildu",53
48,"48077",3367,2438,2423,17,15,"EH Bildu",416
48,"48064",603,463,459,7,4,"EH Bildu",171
48,"48087",429,346,343,1,3,"EH Bildu",36
48,"48006",289,246,245,3,1,"EH Bildu",108
48,"48902",19124,13344,13227,93,117,"EH Bildu",1255
48,"48059",402,317,314,1,3,"EH Bildu",112
48,"48901",4775,3602,3573,35,29,"EH Bildu",399
48,"48074",3333,2467,2428,20,39,"EH Bildu",540
48,"48004",334,229,227,1,2,"EH Bildu",107
48,"48903",1838,1400,1385,4,15,"EH Bildu",142
48,"48001",5832,4191,4166,37,25,"EH Bildu",991
48,"48017",13290,8908,8856,42,52,"EH Bildu",2261
48,"48906",775,579,574,0,5,"EH Bildu",186
48,"48014",1218,870,866,8,4,"EH Bildu",161
48,"48044",62989,46989,46783,385,206,"EH Bildu",4648
48,"48031",340,245,242,0,3,"EH Bildu",88
48,"48096",6608,5071,5011,43,60,"EH Bildu",552
48,"48071",6118,4467,4412,32,55,"EH Bildu",456
48,"48075",1975,1440,1421,12,19,"EH Bildu",304
48,"48910",2948,2126,2115,17,11,"EH Bildu",450
48,"48005",117,76,76,0,0,"EH Bildu",20
48,"48013",79984,56928,56516,383,412,"EH Bildu",3865
48,"48090",6022,4544,4483,23,61,"EH Bildu",433
48,"48057",5749,4093,4081,20,12,"EH Bildu",1672
48,"48020",274076,193807,192607,1471,1200,"EH Bildu",17128
48,"48095",2352,1658,1647,6,11,"EH Bildu",399
48,"48061",762,584,581,4,3,"EH Bildu",114
48,"48029",8332,6155,6119,35,36,"EH Bildu",383
48,"48038",1122,834,824,0,10,"EH Bildu",185
48,"48008",617,433,424,6,9,"EH Bildu",47
48,"48051",220,169,168,0,1,"EH Bildu",15
48,"48911",382,291,286,2,5,"EH Bildu",172
48,"48016",5260,3856,3827,22,29,"EH Bildu",581
48,"48032",5735,4173,4151,32,22,"EH Bildu",1323
48,"48011",9692,6891,6843,56,48,"EH Bildu",1069
48,"48041",704,558,555,4,3,"EH Bildu",147
48,"48028",715,553,551,4,2,"EH Bildu",257
48,"48012",2041,1571,1553,11,18,"EH Bildu",458
48,"48093",900,673,664,4,9,"EH Bildu",249
48,"48089",3266,2425,2406,23,19,"EH Bildu",407
48,"48905",2565,1882,1847,2,35,"EH Bildu",384
48,"48015",33690,24299,24160,168,139,"EH Bildu",2044
48,"48040",1299,896,884,5,12,"EH Bildu",195
48,"48086",2073,1519,1504,15,15,"EH Bildu",255
48,"48915",362,238,238,2,0,"EH Bildu",128
48,"48056",978,733,732,7,1,"EH Bildu",164
48,"48085",10301,7458,7407,50,51,"EH Bildu",1283
48,"48048",562,399,394,3,5,"EH Bildu",135
48,"48054",24135,17493,17374,124,119,"EH Bildu",1471
48,"48035",412,313,312,4,1,"EH Bildu",89
48,"48078",38742,28064,27837,231,227,"EH Bildu",1984
48,"48009",786,614,609,3,5,"EH Bildu",235
48,"48039",243,201,201,2,0,"EH Bildu",61
48,"48058",972,691,687,4,4,"EH Bildu",241
48,"48030",608,454,453,4,1,"EH Bildu",175
48,"48023",594,470,468,4,2,"EH Bildu",175
48,"48045",5149,3940,3885,35,55,"EH Bildu",605
48,"48063",373,289,288,1,1,"EH Bildu",106
48,"48027",22033,15929,15825,113,104,"EH Bildu",2910
48,"48083",6950,5128,5097,33,31,"EH Bildu",393
48,"48084",22577,15689,15540,108,149,"EH Bildu",1150
48,"48007",365,241,239,0,2,"EH Bildu",116
48,"48047",161,112,112,0,0,"EH Bildu",63
48,"48024",1003,775,771,5,4,"EH Bildu",282
48,"48913",1251,933,917,13,16,"EH Bildu",152
48,"48065",3315,2447,2433,19,14,"EH Bildu",491
48,"48907",355,283,282,2,1,"EH Bildu",84
3,"3051",350,310,305,1,5,"ARAPV",2
3,"3114",1568,1216,1203,8,13,"ARAPV",1
3,"3140",26176,19795,19509,155,286,"ARAPV",9
3,"3015",12544,9478,9388,58,90,"ARAPV",1
3,"3010",325,278,276,0,2,"ARAPV",0
3,"3105",5387,4089,4017,21,72,"ARAPV",2
3,"3081",1433,1130,1118,5,12,"ARAPV",2
3,"3007",168,142,138,0,4,"ARAPV",0
3,"3013",1114,914,906,5,8,"ARAPV",0
3,"3122",42227,31379,31186,160,193,"ARAPV",10
3,"3106",596,503,501,1,2,"ARAPV",0
3,"3008",167,132,131,0,1,"ARAPV",0
3,"3903",2482,1945,1926,16,19,"ARAPV",1
3,"3001",337,289,286,3,3,"ARAPV",0
3,"3031",41486,28059,27851,152,208,"ARAPV",29
3,"3009",46817,36581,36258,240,323,"ARAPV",48
3,"3027",159,135,132,0,3,"ARAPV",0
3,"3050",18601,13710,13610,61,100,"ARAPV",4
3,"3022",142,120,120,2,0,"ARAPV",1
3,"3056",8737,6809,6731,33,78,"ARAPV",8
3,"3052",969,804,794,6,10,"ARAPV",1
3,"3034",1367,1095,1079,4,16,"ARAPV",0
3,"3112",653,522,517,2,5,"ARAPV",0
3,"3070",2038,1526,1499,5,27,"ARAPV",1
3,"3023",1410,1221,1201,8,20,"ARAPV",1
3,"3136",446,361,361,2,0,"ARAPV",0
3,"3098",507,403,394,3,9,"ARAPV",1
3,"3012",1072,862,849,3,13,"ARAPV",0
3,"3089",9599,7100,6980,39,120,"ARAPV",4
3,"3048",4858,3785,3735,25,50,"ARAPV",1
3,"3103",278,240,237,1,3,"ARAPV",0
3,"3058",4947,4015,3978,21,37,"ARAPV",0
3,"3047",9161,6622,6534,35,88,"ARAPV",5
3,"3904",1393,1065,1057,8,8,"ARAPV",0
3,"3135",214,176,174,0,2,"ARAPV",0
3,"3067",98,82,81,1,1,"ARAPV",0
3,"3045",216,182,179,1,3,"ARAPV",0
3,"3115",248,219,219,2,0,"ARAPV",0
3,"3097",990,817,811,8,6,"ARAPV",0
3,"3134",148,132,132,2,0,"ARAPV",0
3,"3093",19661,15155,14988,84,167,"ARAPV",11
3,"3066",42291,31010,30781,190,229,"ARAPV",7
3,"3111",5411,4044,3967,14,77,"ARAPV",0
3,"3004",585,455,454,1,1,"ARAPV",0
3,"3040",257,222,222,0,0,"ARAPV",0
3,"3021",5627,4691,4613,23,78,"ARAPV",4
3,"3053",7196,5800,5736,37,64,"ARAPV",22
3,"3061",1057,828,816,2,12,"ARAPV",1
3,"3062",213,176,175,0,1,"ARAPV",0
3,"3035",663,543,538,1,5,"ARAPV",0
3,"3071",3980,3134,3106,28,28,"ARAPV",3
3,"3016",94,79,79,0,0,"ARAPV",0
3,"3088",5498,4078,4030,42,48,"ARAPV",1
3,"3043",2900,2516,2483,18,33,"ARAPV",4
3,"3099",42365,31612,31259,220,353,"ARAPV",10
3,"3002",3610,2714,2682,18,32,"ARAPV",3
3,"3083",5607,4160,4106,36,54,"ARAPV",15
3,"3074",1706,1400,1382,3,18,"ARAPV",0
3,"3133",41763,26236,26039,134,197,"ARAPV",9
3,"3029",242,186,183,1,3,"ARAPV",1
3,"3079",18235,14578,14388,114,190,"ARAPV",5
3,"3069",3060,2187,2168,9,19,"ARAPV",1
3,"3063",26383,19376,19255,105,121,"ARAPV",18
3,"3077",1374,1139,1126,11,13,"ARAPV",1
3,"3055",5168,3949,3899,13,50,"ARAPV",0
3,"3096",5811,4539,4492,19,47,"ARAPV",4
3,"3017",376,317,312,3,5,"ARAPV",0
3,"3132",536,426,423,0,3,"ARAPV",0
3,"3090",17087,12723,12602,69,121,"ARAPV",10
3,"3082",12542,8709,8597,48,112,"ARAPV",7
3,"3129",1187,991,984,8,7,"ARAPV",1
3,"3137",653,516,515,5,1,"ARAPV",5
3,"3064",5040,3887,3834,16,53,"ARAPV",1
3,"3037",352,296,293,3,3,"ARAPV",0
3,"3054",338,274,268,4,6,"ARAPV",0
3,"3044",4512,3639,3586,16,53,"ARAPV",0
3,"3086",153,134,134,1,0,"ARAPV",1
3,"3123",7472,5748,5680,38,68,"ARAPV",1
3,"3078",486,398,397,3,1,"ARAPV",0
3,"3080",1299,1065,1036,3,29,"ARAPV",0
3,"3131",175,159,153,0,6,"ARAPV",0
3,"3119",16534,12466,12363,69,103,"ARAPV",22
3,"3075",156,139,139,0,0,"ARAPV",0
3,"3102",7271,5762,5687,46,75,"ARAPV",21
3,"3085",270,226,225,1,1,"ARAPV",1
3,"3073",236,202,202,1,0,"ARAPV",0
3,"3084",543,478,476,4,2,"ARAPV",3
3,"3024",3904,3109,3060,17,49,"ARAPV",1
3,"3005",7753,6158,6118,38,40,"ARAPV",0
3,"3036",91,80,79,2,1,"ARAPV",0
3,"3065",166944,126831,126024,773,807,"ARAPV",39
3,"3101",4765,3708,3659,13,49,"ARAPV",13
3,"3060",108,92,90,1,2,"ARAPV",0
3,"3124",469,400,394,5,6,"ARAPV",0
3,"3072",351,288,287,2,1,"ARAPV",1
3,"3109",2850,2301,2275,11,26,"ARAPV",0
3,"3095",4602,3628,3605,27,23,"ARAPV",8
3,"3018",12212,9129,9040,64,89,"ARAPV",13
3,"3117",370,325,322,0,3,"ARAPV",0
3,"3011",7729,5651,5595,29,56,"ARAPV",1
3,"3130",47,30,30,0,0,"ARAPV",0
3,"3006",497,401,393,4,8,"ARAPV",2
3,"3049",12082,9341,9236,69,105,"ARAPV",1
3,"3139",22357,15787,15624,101,163,"ARAPV",21
3,"3039",85,61,59,0,2,"ARAPV",1
3,"3041",5945,4393,4344,28,49,"ARAPV",6
3,"3038",358,292,285,2,7,"ARAPV",1
3,"3116",1159,892,886,2,6,"ARAPV",0
3,"3003",455,393,388,3,5,"ARAPV",0
3,"3020",102,79,79,0,0,"ARAPV",0
3,"3028",1006,833,823,1,10,"ARAPV",3
3,"3033",113,97,97,2,0,"ARAPV",0
3,"3110",289,239,239,1,0,"ARAPV",0
3,"3059",20538,15653,15522,79,131,"ARAPV",17
3,"3901",1129,855,853,5,2,"ARAPV",2
3,"3113",4254,3159,3120,17,39,"ARAPV",4
3,"3068",46,41,40,0,1,"ARAPV",1
3,"3120",2416,1814,1783,13,31,"ARAPV",0
3,"3100",508,446,442,1,4,"ARAPV",0
3,"3092",6749,5398,5342,40,56,"ARAPV",5
3,"3076",8485,6251,6194,37,57,"ARAPV",0
3,"3014",237548,173040,172027,866,1013,"ARAPV",90
3,"3032",106,90,89,1,1,"ARAPV",0
3,"3118",2452,1732,1714,9,18,"ARAPV",0
3,"3127",352,279,277,1,2,"ARAPV",0
3,"3046",1594,1185,1178,9,7,"ARAPV",1
3,"3025",1270,1003,996,3,7,"ARAPV",0
3,"3121",21269,14932,14795,78,137,"ARAPV",5
3,"3104",27134,21080,20902,156,178,"ARAPV",11
3,"3128",4097,2972,2942,12,30,"ARAPV",0
3,"3019",15261,11921,11804,98,117,"ARAPV",7
3,"3042",1367,1045,1033,5,12,"ARAPV",3
3,"3107",2459,1807,1791,5,16,"ARAPV",1
3,"3138",3154,2406,2378,10,28,"ARAPV",2
3,"3026",1224,970,949,6,21,"ARAPV",2
3,"3094",9033,6702,6657,32,45,"ARAPV",16
3,"3030",513,432,424,0,8,"ARAPV",1
3,"3125",346,263,262,0,1,"ARAPV",0
3,"3091",247,217,215,1,2,"ARAPV",0
3,"3057",191,148,148,2,0,"ARAPV",0
3,"3902",10213,7091,6997,52,94,"ARAPV",2
15,"15003",1818,1326,1302,18,24,"SAIn",1
15,"15033",2489,1953,1931,13,22,"SAIn",0
15,"15012",3666,2787,2721,40,66,"SAIn",1
15,"15065",7345,5517,5412,46,105,"SAIn",3
15,"15005",24459,16742,16482,215,260,"SAIn",15
15,"15001",4805,3466,3419,45,47,"SAIn",1
15,"15023",6481,4658,4595,44,63,"SAIn",0
15,"15020",3844,2651,2629,17,22,"SAIn",0
15,"15050",1843,1089,1070,19,19,"SAIn",1
15,"15013",6126,4315,4257,43,58,"SAIn",2
15,"15082",15162,11273,11134,135,139,"SAIn",20
15,"15061",5646,3945,3894,35,51,"SAIn",1
15,"15039",1271,935,917,8,18,"SAIn",2
15,"15016",4806,3291,3222,21,69,"SAIn",2
15,"15017",19380,14272,14098,156,174,"SAIn",9
15,"15055",4618,3208,3159,49,49,"SAIn",2
15,"15035",11517,8305,8192,144,113,"SAIn",4
15,"15087",5804,3942,3901,49,41,"SAIn",0
15,"15006",5353,3534,3469,49,65,"SAIn",2
15,"15036",58409,40932,40506,484,426,"SAIn",16
15,"15090",1182,868,861,13,7,"SAIn",1
15,"15048",4855,3582,3534,41,48,"SAIn",1
15,"15004",4855,3594,3535,28,59,"SAIn",0
15,"15014",4034,2809,2757,34,52,"SAIn",2
15,"15022",5817,4026,3981,29,45,"SAIn",1
15,"15084",3312,2361,2326,28,35,"SAIn",0
15,"15076",2649,1827,1802,24,25,"SAIn",1
15,"15015",2840,2126,2100,21,26,"SAIn",0
15,"15066",4039,2950,2894,34,56,"SAIn",1
15,"15053",7783,5386,5314,47,72,"SAIn",3
15,"15042",3060,2170,2127,21,43,"SAIn",0
15,"15080",1760,1215,1197,11,18,"SAIn",1
15,"15074",4061,2983,2947,24,36,"SAIn",2
15,"15077",8303,5648,5544,57,104,"SAIn",2
15,"15901",3595,2401,2374,30,27,"SAIn",0
15,"15031",23321,17319,17152,218,167,"SAIn",10
15,"15018",1156,817,806,7,11,"SAIn",0
15,"15070",9117,6514,6390,98,124,"SAIn",1
15,"15034",2897,1931,1909,14,22,"SAIn",4
15,"15051",4651,3343,3297,38,46,"SAIn",0
15,"15007",3352,2469,2453,24,16,"SAIn",0
15,"15091",1119,807,784,12,23,"SAIn",1
15,"15011",15463,11105,10890,92,215,"SAIn",9
15,"15068",5096,3518,3476,39,42,"SAIn",1
15,"15010",1913,1355,1338,21,17,"SAIn",0
15,"15038",2236,1556,1530,18,26,"SAIn",0
15,"15043",5147,3834,3764,36,70,"SAIn",4
15,"15030",200245,148692,147426,1699,1266,"SAIn",75
15,"15021",5099,3673,3611,43,62,"SAIn",1
15,"15037",4087,2775,2733,18,42,"SAIn",0
15,"15902",4660,3352,3296,30,56,"SAIn",3
15,"15086",2918,2109,2077,19,32,"SAIn",3
15,"15073",21884,14792,14587,149,205,"SAIn",11
15,"15093",4265,2856,2814,35,42,"SAIn",3
15,"15062",5936,4047,3993,31,54,"SAIn",2
15,"15067",8073,6067,6000,45,67,"SAIn",3
15,"15024",4412,3325,3278,35,47,"SAIn",0
15,"15059",10406,7710,7553,91,157,"SAIn",12
15,"15052",4351,3122,3063,26,59,"SAIn",2
15,"15047",2463,1669,1633,21,36,"SAIn",2
15,"15008",5650,4239,4175,42,64,"SAIn",1
15,"15069",6785,5107,5032,54,75,"SAIn",2
15,"15041",9627,7409,7291,79,118,"SAIn",4
15,"15075",12279,9076,8952,117,124,"SAIn",5
15,"15060",5780,4245,4167,48,78,"SAIn",2
15,"15049",1099,765,755,12,10,"SAIn",0
15,"15071",7965,5559,5483,37,76,"SAIn",6
15,"15025",1069,662,654,5,8,"SAIn",0
15,"15083",1100,809,795,5,14,"SAIn",0
15,"15056",5757,4167,4108,43,59,"SAIn",3
15,"15054",32177,22065,21778,349,287,"SAIn",9
15,"15088",3550,2398,2372,18,26,"SAIn",1
15,"15089",4317,3238,3188,24,50,"SAIn",0
15,"15081",1042,819,814,12,5,"SAIn",0
15,"15032",3455,2438,2391,26,47,"SAIn",0
15,"15028",1415,1085,1070,10,15,"SAIn",0
15,"15079",1562,1092,1075,16,17,"SAIn",0
15,"15027",1540,1224,1203,6,21,"SAIn",2
15,"15092",6523,4518,4449,54,69,"SAIn",3
15,"15002",22929,16941,16742,205,199,"SAIn",16
15,"15044",1309,955,941,5,14,"SAIn",1
15,"15078",78093,58164,57487,673,677,"SAIn",93
15,"15058",27623,21002,20788,257,214,"SAIn",4
15,"15040",2763,2050,2017,10,33,"SAIn",3
15,"15019",25902,18111,17866,232,245,"SAIn",9
15,"15064",2207,1680,1650,22,30,"SAIn",0
15,"15072",9626,7024,6920,52,104,"SAIn",4
15,"15009",10780,8075,7957,70,118,"SAIn",4
15,"15046",6345,4625,4532,53,93,"SAIn",0
15,"15045",3803,2382,2354,15,28,"SAIn",3
15,"15085",3346,2365,2311,26,54,"SAIn",0
15,"15029",5761,3994,3928,47,66,"SAIn",2
15,"15057",12169,8853,8729,88,124,"SAIn",1
37,"37031",365,258,257,1,1,"PP",155
37,"37342",256,210,208,1,2,"PP",97
37,"37047",167,83,83,0,0,"PP",54
37,"37197",87,55,55,2,0,"PP",32
37,"37086",98,80,80,2,0,"PP",47
37,"37002",144,87,87,0,0,"PP",37
37,"37262",78,64,64,1,0,"PP",50
37,"37285",412,311,305,2,6,"PP",159
37,"37206",94,71,71,4,0,"PP",33
37,"37071",78,73,72,1,1,"PP",23
37,"37106",266,172,166,1,6,"PP",91
37,"37104",27,21,21,0,0,"PP",11
37,"37322",2472,1691,1676,12,15,"PP",548
37,"37035",194,161,161,0,0,"PP",78
37,"37354",5182,3955,3915,50,40,"PP",1339
37,"37015",222,145,143,3,2,"PP",63
37,"37238",112,88,85,2,3,"PP",24
37,"37261",227,165,161,2,4,"PP",90
37,"37288",258,211,210,7,1,"PP",76
37,"37102",411,291,289,3,2,"PP",138
37,"37253",135,110,110,1,0,"PP",48
37,"37278",753,573,568,7,5,"PP",154
37,"37126",30,24,24,0,0,"PP",18
37,"37090",52,38,36,0,2,"PP",22
37,"37309",45,28,28,0,0,"PP",17
37,"37319",117,78,77,0,1,"PP",33
37,"37159",91,74,74,0,0,"PP",35
37,"37194",252,191,190,2,1,"PP",82
37,"37239",229,196,194,6,2,"PP",82
37,"37212",111,83,83,1,0,"PP",28
37,"37237",325,250,248,4,2,"PP",88
37,"37080",232,176,176,1,0,"PP",79
37,"37265",217,180,178,2,2,"PP",54
37,"37272",136,97,96,0,1,"PP",47
37,"37132",351,272,269,2,3,"PP",120
37,"37216",310,264,257,4,7,"PP",129
37,"37166",213,142,142,1,0,"PP",86
37,"37335",415,301,293,2,8,"PP",154
37,"37190",219,167,167,0,0,"PP",108
37,"37088",204,152,152,3,0,"PP",69
37,"37289",240,182,182,2,0,"PP",104
37,"37229",143,102,102,1,0,"PP",69
37,"37259",45,30,30,0,0,"PP",20
37,"37307",160,103,103,0,0,"PP",63
37,"37117",1458,1075,1068,14,7,"PP",332
37,"37245",345,252,246,7,6,"PP",123
37,"37099",73,45,45,2,0,"PP",31
37,"37131",190,140,139,0,1,"PP",73
37,"37209",406,281,280,7,1,"PP",75
37,"37074",153,109,103,4,6,"PP",40
37,"37370",337,258,255,3,3,"PP",145
37,"37008",4298,3312,3272,16,40,"PP",1581
37,"37116",69,51,51,0,0,"PP",27
37,"37162",206,151,149,2,2,"PP",79
37,"37352",204,148,147,0,1,"PP",58
37,"37294",11680,8850,8760,84,90,"PP",3075
37,"37365",174,147,144,0,3,"PP",84
37,"37351",281,239,238,0,1,"PP",106
37,"37314",87,74,72,0,2,"PP",46
37,"37184",345,247,244,1,3,"PP",128
37,"37005",77,58,56,0,2,"PP",37
37,"37364",836,598,583,6,15,"PP",282
37,"37360",230,167,166,2,1,"PP",84
37,"37012",150,117,115,0,2,"PP",70
37,"37287",318,237,237,3,0,"PP",123
37,"37228",367,301,299,1,2,"PP",135
37,"37082",799,570,560,1,10,"PP",232
37,"37270",190,142,139,1,3,"PP",80
37,"37281",37,34,33,0,1,"PP",14
37,"37246",5335,4190,4152,41,38,"PP",1660
37,"37169",176,139,137,0,2,"PP",51
37,"37346",267,222,220,1,2,"PP",137
37,"37052",274,197,197,2,0,"PP",85
37,"37178",99,84,81,0,3,"PP",53
37,"37024",92,77,77,0,0,"PP",43
37,"37266",84,55,55,1,0,"PP",32
37,"37013",121,87,86,3,1,"PP",49
37,"37017",251,186,184,2,2,"PP",115
37,"37263",348,252,251,1,1,"PP",106
37,"37292",103,72,72,1,0,"PP",46
37,"37316",751,584,577,5,7,"PP",328
37,"37203",165,118,118,0,0,"PP",60
37,"37182",77,62,62,0,0,"PP",35
37,"37006",135,91,90,1,1,"PP",54
37,"37107",10855,7694,7598,96,96,"PP",3512
37,"37141",156,127,127,1,0,"PP",44
37,"37317",306,246,243,1,3,"PP",134
37,"37165",33,27,27,0,0,"PP",16
37,"37092",1731,1264,1250,11,14,"PP",384
37,"37128",264,211,201,4,10,"PP",78
37,"37149",70,63,63,0,0,"PP",48
37,"37271",361,283,276,3,7,"PP",143
37,"37374",1178,971,943,8,28,"PP",435
37,"37202",978,773,763,7,10,"PP",249
37,"37297",420,342,331,4,11,"PP",176
37,"37003",119,93,90,0,3,"PP",49
37,"37029",213,155,152,0,3,"PP",63
37,"37199",142,108,108,0,0,"PP",41
37,"37330",335,262,258,4,4,"PP",122
37,"37348",113,91,91,1,0,"PP",59
37,"37254",183,153,149,0,4,"PP",79
37,"37303",188,152,151,1,1,"PP",62
37,"37060",245,192,192,0,0,"PP",65
37,"37257",53,43,43,0,0,"PP",26
37,"37318",209,156,155,1,1,"PP",77
37,"37016",573,451,447,3,4,"PP",159
37,"37118",125,96,96,0,0,"PP",52
37,"37353",129,92,92,1,0,"PP",44
37,"37268",116,71,70,0,1,"PP",40
37,"37072",166,133,132,2,1,"PP",90
37,"37098",335,237,237,1,0,"PP",79
37,"37200",190,134,133,2,1,"PP",66
37,"37032",543,411,410,1,1,"PP",189
37,"37137",105,73,73,0,0,"PP",53
37,"37065",323,237,235,0,2,"PP",150
37,"37350",421,324,320,4,4,"PP",192
37,"37244",134,91,90,1,1,"PP",53
37,"37361",84,56,55,0,1,"PP",41
37,"37164",256,200,195,1,5,"PP",73
37,"37152",424,290,283,2,7,"PP",139
37,"37123",182,141,138,0,3,"PP",103
37,"37233",65,45,45,0,0,"PP",14
37,"37284",325,245,244,2,1,"PP",105
37,"37057",213,168,167,0,1,"PP",113
37,"37347",477,365,359,3,6,"PP",132
37,"37045",27,20,20,0,0,"PP",9
37,"37324",371,284,279,4,5,"PP",151
37,"37112",161,115,114,0,1,"PP",54
37,"37113",430,340,340,3,0,"PP",136
37,"37260",154,126,126,1,0,"PP",45
37,"37264",67,43,43,0,0,"PP",24
37,"37062",84,67,66,1,1,"PP",43
37,"37139",205,163,162,2,1,"PP",65
37,"37089",67,50,49,0,1,"PP",25
37,"37275",123,87,86,1,1,"PP",40
37,"37175",407,316,314,5,2,"PP",186
37,"37188",185,127,125,3,2,"PP",53
37,"37034",84,66,66,3,0,"PP",18
37,"37041",74,48,48,0,0,"PP",31
37,"37023",1378,1116,1105,9,11,"PP",332
37,"37345",166,135,133,3,2,"PP",63
37,"37283",120,88,88,1,0,"PP",47
37,"37181",291,209,207,1,2,"PP",116
37,"37114",88,67,66,1,1,"PP",42
37,"37121",584,434,430,5,4,"PP",174
37,"37087",855,681,676,8,5,"PP",240
37,"37291",268,206,206,1,0,"PP",89
37,"37009",216,161,160,3,1,"PP",84
37,"37100",81,68,67,1,1,"PP",43
37,"37039",304,213,213,4,0,"PP",107
37,"37170",1479,1055,1031,10,24,"PP",478
37,"37101",163,122,122,2,0,"PP",84
37,"37028",150,111,110,1,1,"PP",76
37,"37312",262,211,210,3,1,"PP",117
37,"37224",210,183,179,2,4,"PP",120
37,"37115",123,89,87,0,2,"PP",69
37,"37014",1161,850,847,5,3,"PP",341
37,"37300",575,427,423,3,4,"PP",173
37,"37328",189,142,140,0,2,"PP",51
37,"37320",93,71,71,1,0,"PP",45
37,"37148",425,304,295,6,9,"PP",175
37,"37225",106,94,92,0,2,"PP",50
37,"37157",77,62,62,0,0,"PP",20
37,"37161",138,109,107,0,2,"PP",72
37,"37061",226,166,164,1,2,"PP",84
37,"37274",119148,88959,88152,853,807,"PP",36272
37,"37362",4592,3442,3403,48,39,"PP",1263
37,"37217",56,46,44,1,2,"PP",20
37,"37241",172,128,126,1,2,"PP",87
37,"37267",199,151,147,2,4,"PP",48
37,"37234",357,224,222,1,2,"PP",108
37,"37301",73,62,62,0,0,"PP",39
37,"37198",206,161,160,3,1,"PP",61
37,"37059",124,100,98,0,2,"PP",44
37,"37293",118,84,84,0,0,"PP",44
37,"37341",56,43,41,0,2,"PP",25
37,"37176",137,100,98,0,2,"PP",50
37,"37037",119,81,81,0,0,"PP",47
37,"37215",136,102,101,2,1,"PP",48
37,"37235",223,168,163,1,5,"PP",77
37,"37150",43,35,35,0,0,"PP",34
37,"37242",91,71,71,0,0,"PP",37
37,"37173",1526,1138,1125,5,13,"PP",518
37,"37356",86,73,71,1,2,"PP",37
37,"37073",583,449,442,8,7,"PP",216
37,"37038",789,628,616,5,12,"PP",271
37,"37375",705,593,582,11,11,"PP",201
37,"37143",385,301,299,1,2,"PP",148
37,"37382",180,133,133,4,0,"PP",70
37,"37368",16,15,15,0,0,"PP",7
37,"37163",42,33,33,0,0,"PP",16
37,"37079",74,64,63,0,1,"PP",36
37,"37189",125,97,97,0,0,"PP",40
37,"37010",956,716,708,3,8,"PP",276
37,"37240",907,646,636,5,10,"PP",237
37,"37110",117,92,89,1,3,"PP",41
37,"37186",106,78,78,3,0,"PP",45
37,"37156",4310,3173,3126,27,47,"PP",1580
37,"37277",73,55,55,0,0,"PP",33
37,"37201",262,179,177,0,2,"PP",77
37,"37369",140,96,96,0,0,"PP",48
37,"37343",62,49,49,0,0,"PP",14
37,"37358",168,136,135,2,1,"PP",65
37,"37313",555,415,411,1,4,"PP",220
37,"37096",220,174,174,5,0,"PP",97
37,"37040",393,320,317,3,3,"PP",132
37,"37249",44,33,33,1,0,"PP",17
37,"37120",99,77,76,1,1,"PP",46
37,"37119",109,86,86,1,0,"PP",34
37,"37145",257,190,187,0,3,"PP",82
37,"37022",268,220,219,2,1,"PP",122
37,"37282",209,136,136,0,0,"PP",78
37,"37329",36,28,28,0,0,"PP",20
37,"37231",259,208,207,4,1,"PP",86
37,"37026",192,158,154,2,4,"PP",67
37,"37366",43,27,27,0,0,"PP",14
37,"37180",73,52,52,1,0,"PP",31
37,"37258",180,117,115,1,2,"PP",60
37,"37302",294,216,214,1,2,"PP",106
37,"37078",823,670,657,8,13,"PP",293
37,"37142",592,453,451,2,2,"PP",160
37,"37311",226,182,182,2,0,"PP",86
37,"37177",298,223,221,1,2,"PP",120
37,"37371",281,183,177,1,6,"PP",93
37,"37195",48,35,35,1,0,"PP",5
37,"37338",78,66,66,1,0,"PP",37
37,"37306",271,171,171,0,0,"PP",90
37,"37027",228,187,187,0,0,"PP",85
37,"37379",173,134,134,2,0,"PP",53
37,"37097",36,30,30,0,0,"PP",20
37,"37130",173,155,153,5,2,"PP",105
37,"37144",370,288,284,2,4,"PP",159
37,"37056",41,30,30,0,0,"PP",23
37,"37221",434,328,323,2,5,"PP",154
37,"37255",51,38,38,0,0,"PP",24
37,"37331",217,150,148,1,2,"PP",90
37,"37247",199,162,154,3,8,"PP",99
37,"37160",627,450,443,7,7,"PP",192
37,"37044",470,353,341,1,12,"PP",162
37,"37339",316,257,257,4,0,"PP",148
37,"37021",80,62,62,0,0,"PP",37
37,"37304",170,114,109,4,5,"PP",69
37,"37213",87,73,73,0,0,"PP",41
37,"37325",91,68,63,0,5,"PP",42
37,"37250",358,223,223,1,0,"PP",82
37,"37067",3125,2551,2523,22,28,"PP",850
37,"37049",147,98,98,2,0,"PP",45
37,"37179",215,173,170,0,3,"PP",98
37,"37011",122,91,89,0,2,"PP",38
37,"37252",116,89,89,0,0,"PP",64
37,"37054",261,199,198,1,1,"PP",85
37,"37183",417,305,301,2,4,"PP",130
37,"37355",189,147,146,1,1,"PP",72
37,"37363",120,98,94,0,4,"PP",40
37,"37256",220,158,157,1,1,"PP",74
37,"37081",933,720,714,4,6,"PP",296
37,"37357",276,216,215,0,1,"PP",107
37,"37051",80,54,53,0,1,"PP",30
37,"37046",11336,8300,8171,62,129,"PP",3349
37,"37381",139,98,92,0,6,"PP",52
37,"37108",101,81,79,2,2,"PP",42
37,"37299",221,170,163,1,7,"PP",89
37,"37286",206,156,156,4,0,"PP",41
37,"37001",195,147,144,0,3,"PP",64
37,"37273",108,77,77,0,0,"PP",47
37,"37192",353,245,242,2,3,"PP",83
37,"37243",102,76,76,0,0,"PP",57
37,"37124",219,149,148,0,1,"PP",79
37,"37185",591,450,443,4,7,"PP",200
37,"37167",173,150,144,2,6,"PP",35
37,"37372",146,117,115,0,2,"PP",53
37,"37251",126,87,87,2,0,"PP",53
37,"37219",179,110,110,0,0,"PP",52
37,"37020",430,340,334,3,6,"PP",147
37,"37070",533,403,396,4,7,"PP",179
37,"37122",202,158,156,3,2,"PP",58
37,"37296",338,258,255,4,3,"PP",120
37,"37230",221,167,167,2,0,"PP",66
37,"37146",122,100,99,1,1,"PP",72
37,"37280",79,50,50,0,0,"PP",38
37,"37204",280,214,211,1,3,"PP",127
37,"37332",69,53,52,0,1,"PP",34
37,"37055",123,105,98,0,7,"PP",62
37,"37103",446,326,325,4,1,"PP",156
37,"37290",140,116,116,0,0,"PP",43
37,"37333",225,143,142,4,1,"PP",61
37,"37380",55,46,46,2,0,"PP",8
37,"37127",221,158,158,4,0,"PP",54
37,"37344",246,184,183,1,1,"PP",76
37,"37321",170,131,129,2,2,"PP",64
37,"37218",71,33,33,2,0,"PP",20
37,"37134",230,175,173,1,2,"PP",66
37,"37340",150,105,104,1,1,"PP",72
37,"37068",366,272,271,5,1,"PP",155
37,"37085",4704,3475,3432,35,43,"PP",1202
37,"37248",152,127,126,2,1,"PP",79
37,"37155",73,54,54,1,0,"PP",15
37,"37315",93,69,67,1,2,"PP",48
37,"37232",390,349,348,0,1,"PP",205
37,"37158",248,183,181,0,2,"PP",63
37,"37030",84,68,66,0,2,"PP",38
37,"37298",184,125,125,1,0,"PP",64
37,"37004",32,22,22,0,0,"PP",14
37,"37083",179,159,159,0,0,"PP",65
37,"37334",79,42,42,1,0,"PP",21
37,"37378",111,74,70,2,4,"PP",38
37,"37147",191,141,136,0,5,"PP",48
37,"37135",1211,932,925,10,7,"PP",408
37,"37222",97,66,66,1,0,"PP",35
37,"37305",216,170,169,2,1,"PP",83
37,"37337",139,120,120,2,0,"PP",86
37,"37187",565,431,426,4,5,"PP",199
37,"37269",452,328,328,2,0,"PP",118
37,"37136",667,453,448,2,5,"PP",151
37,"37208",81,49,48,0,1,"PP",31
37,"37193",399,279,278,6,1,"PP",106
37,"37310",180,129,128,2,1,"PP",46
37,"37376",2251,1588,1568,9,20,"PP",794
37,"37077",260,234,230,0,4,"PP",78
37,"37050",67,47,46,1,1,"PP",26
37,"37058",61,43,42,0,1,"PP",23
37,"37226",156,121,119,1,2,"PP",88
37,"37214",125,88,88,1,0,"PP",39
37,"37140",678,440,435,2,5,"PP",240
37,"37091",176,114,113,2,1,"PP",62
37,"37211",223,163,163,4,0,"PP",88
37,"37019",151,114,111,0,3,"PP",76
37,"37373",755,548,545,3,3,"PP",149
37,"37018",105,80,80,1,0,"PP",38
37,"37151",146,116,115,2,1,"PP",82
37,"37109",182,119,118,0,1,"PP",81
37,"37377",249,199,195,3,4,"PP",115
37,"37036",63,46,46,0,0,"PP",34
37,"37336",55,47,47,0,0,"PP",24
37,"37172",878,580,576,3,4,"PP",298
37,"37205",233,201,197,1,4,"PP",71
37,"37025",258,223,221,2,2,"PP",115
37,"37042",42,29,29,2,0,"PP",19
37,"37236",139,94,89,0,5,"PP",51
37,"37125",228,158,156,3,2,"PP",75
37,"37349",112,83,82,0,1,"PP",56
37,"37129",251,199,194,1,5,"PP",73
37,"37138",199,155,154,4,1,"PP",76
37,"37327",185,157,157,5,0,"PP",58
37,"37171",411,321,317,1,4,"PP",199
37,"37168",443,319,311,2,8,"PP",151
37,"37196",77,54,53,0,1,"PP",25
37,"37154",141,116,112,0,4,"PP",83
37,"37191",116,78,76,0,2,"PP",47
37,"37279",763,572,562,11,10,"PP",271
37,"37174",1065,838,826,3,12,"PP",388
37,"37323",521,387,385,8,2,"PP",189
37,"37367",199,160,158,7,2,"PP",107
37,"37063",74,59,59,1,0,"PP",26
37,"37007",439,321,313,4,8,"PP",146
37,"37033",98,63,63,0,0,"PP",33
37,"37207",303,234,233,0,1,"PP",105
37,"37223",109,90,87,0,3,"PP",48
37,"37133",108,82,79,4,3,"PP",45
37,"37276",149,100,99,0,1,"PP",55
37,"37069",976,713,699,9,14,"PP",294
37,"37359",184,131,129,0,2,"PP",78
11,"11006",24504,16649,16486,176,163,"PACMA",94
11,"11008",17460,11800,11615,151,185,"PACMA",109
11,"11015",62337,40342,40012,407,330,"PACMA",544
11,"11902",3619,2431,2410,17,21,"PACMA",13
11,"11036",694,439,437,13,2,"PACMA",0
11,"11027",68010,46675,46322,400,353,"PACMA",519
11,"11039",10044,6684,6623,98,61,"PACMA",51
11,"11001",4377,2949,2900,17,49,"PACMA",13
11,"11025",4370,3174,3123,29,51,"PACMA",10
11,"11026",4804,3581,3511,31,70,"PACMA",18
11,"11032",53898,32432,32172,371,260,"PACMA",331
11,"11020",165400,113865,113092,1184,773,"PACMA",1324
11,"11041",9856,7043,6967,85,76,"PACMA",43
11,"11014",16791,11255,11146,166,109,"PACMA",76
11,"11007",18036,10832,10678,181,154,"PACMA",112
11,"11016",14880,9945,9848,124,97,"PACMA",93
11,"11034",2345,1606,1594,10,12,"PACMA",1
11,"11004",88617,55218,54733,581,485,"PACMA",705
11,"11009",602,426,422,5,4,"PACMA",1
11,"11028",32532,23191,22981,274,210,"PACMA",296
11,"11021",6777,4826,4779,52,47,"PACMA",18
11,"11011",1688,1239,1205,14,34,"PACMA",9
11,"11901",5653,4132,4088,84,44,"PACMA",22
11,"11019",1830,1413,1371,5,42,"PACMA",7
11,"11017",3207,2389,2362,28,27,"PACMA",8
11,"11023",9354,6990,6928,86,62,"PACMA",44
11,"11005",4560,3203,3143,21,60,"PACMA",8
11,"11037",5678,4491,4426,20,65,"PACMA",25
11,"11042",1189,877,868,5,9,"PACMA",2
11,"11033",20773,13487,13333,171,154,"PACMA",144
11,"11029",5433,3112,3067,27,45,"PACMA",7
11,"11040",398,326,317,3,9,"PACMA",2
11,"11013",2324,1687,1653,16,34,"PACMA",11
11,"11003",1270,907,899,12,8,"PACMA",6
11,"11018",1485,1109,1090,10,19,"PACMA",1
11,"11012",100460,72741,72128,590,613,"PACMA",1277
11,"11010",6420,4423,4362,63,61,"PACMA",19
11,"11030",22796,15377,15222,145,155,"PACMA",170
11,"11002",4287,3245,3238,15,7,"PACMA",3
11,"11035",13569,9000,8908,93,92,"PACMA",78
11,"11022",48778,26546,26333,277,213,"PACMA",408
11,"11024",6735,5114,5065,33,49,"PACMA",16
11,"11038",13803,10593,10441,121,152,"PACMA",99
11,"11031",76452,51850,51456,568,394,"PACMA",832
20,"20049",4124,2793,2780,22,13,"UPYD",3
20,"20054",447,301,297,5,4,"UPYD",0
20,"20003",541,334,334,3,0,"UPYD",0
20,"20079",17835,12650,12587,81,63,"UPYD",13
20,"20035",482,329,328,4,1,"UPYD",2
20,"20070",1099,749,744,4,5,"UPYD",0
20,"20010",1494,1055,1053,4,2,"UPYD",1
20,"20080",7900,5517,5487,33,30,"UPYD",149
20,"20065",3006,2104,2089,18,15,"UPYD",4
20,"20023",445,258,258,2,0,"UPYD",0
20,"20042",3251,2170,2152,23,18,"UPYD",2
20,"20041",258,148,148,2,0,"UPYD",0
20,"20019",10053,6876,6844,72,32,"UPYD",8
20,"20011",1660,1283,1278,9,5,"UPYD",2
20,"20059",8863,6091,6072,30,19,"UPYD",6
20,"20047",477,329,329,2,0,"UPYD",1
20,"20018",11074,7100,7059,29,41,"UPYD",8
20,"20004",252,135,135,2,0,"UPYD",0
20,"20053",4765,3150,3132,18,18,"UPYD",8
20,"20075",4359,2852,2833,16,19,"UPYD",6
20,"20009",11528,7997,7955,57,42,"UPYD",8
20,"20001",242,138,137,1,1,"UPYD",0
20,"20002",343,227,226,10,1,"UPYD",0
20,"20052",1091,797,792,6,5,"UPYD",0
20,"20022",834,499,494,7,5,"UPYD",0
20,"20066",461,279,276,3,3,"UPYD",0
20,"20071",14818,10095,10057,62,38,"UPYD",15
20,"20072",4731,3132,3123,23,9,"UPYD",11
20,"20025",1144,774,767,5,7,"UPYD",1
20,"20015",1272,924,921,9,3,"UPYD",0
20,"20014",1111,635,632,4,3,"UPYD",1
20,"20056",4104,2654,2633,12,21,"UPYD",1
20,"20048",176,104,104,2,0,"UPYD",1
20,"20024",393,226,226,2,0,"UPYD",0
20,"20068",183,117,115,0,2,"UPYD",0
20,"20055",17522,12125,12043,52,82,"UPYD",11
20,"20026",202,141,129,4,12,"UPYD",0
20,"20067",30825,21606,21512,113,94,"UPYD",46
20,"20903",4247,2846,2826,9,20,"UPYD",9
20,"20061",4273,2832,2816,21,16,"UPYD",2
20,"20020",129,71,71,0,0,"UPYD",0
20,"20016",1514,885,884,5,1,"UPYD",0
20,"20901",1441,982,979,2,3,"UPYD",0
20,"20030",21515,15110,15019,108,91,"UPYD",31
20,"20027",2816,1842,1833,11,9,"UPYD",0
20,"20069",147189,106909,106506,699,403,"UPYD",532
20,"20904",96,62,62,0,0,"UPYD",0
20,"20008",721,382,376,5,6,"UPYD",2
20,"20074",11610,8382,8320,43,62,"UPYD",6
20,"20045",46691,32759,32560,222,199,"UPYD",144
20,"20062",982,685,684,3,1,"UPYD",1
20,"20081",7460,5187,5159,33,28,"UPYD",4
20,"20039",2111,1539,1532,13,7,"UPYD",2
20,"20028",2255,1503,1494,17,9,"UPYD",7
20,"20902",14193,10263,10219,56,44,"UPYD",41
20,"20905",141,105,105,0,0,"UPYD",0
20,"20038",392,284,281,1,3,"UPYD",0
20,"20046",1167,797,794,4,3,"UPYD",5
20,"20012",144,108,108,3,0,"UPYD",0
20,"20051",6904,5001,4975,31,26,"UPYD",9
20,"20057",201,122,121,0,1,"UPYD",0
20,"20033",864,629,625,3,4,"UPYD",0
20,"20006",262,161,159,1,2,"UPYD",0
20,"20058",746,547,546,3,1,"UPYD",0
20,"20907",120,85,84,2,1,"UPYD",0
20,"20064",12526,8429,8387,59,42,"UPYD",25
20,"20036",13148,9191,9132,85,59,"UPYD",87
20,"20005",1261,811,805,7,6,"UPYD",0
20,"20043",1740,1157,1152,6,5,"UPYD",1
20,"20032",8785,6115,6076,45,39,"UPYD",23
20,"20073",4677,3219,3208,21,11,"UPYD",2
20,"20037",97,59,59,1,0,"UPYD",0
20,"20078",1155,866,864,6,2,"UPYD",0
20,"20013",5427,3901,3875,19,26,"UPYD",7
20,"20060",89,76,75,2,1,"UPYD",0
20,"20077",5243,3792,3777,25,15,"UPYD",6
20,"20029",4258,3005,2992,17,13,"UPYD",5
20,"20031",180,105,102,1,3,"UPYD",0
20,"20007",304,209,209,5,0,"UPYD",0
20,"20040",15321,10260,10176,69,84,"UPYD",10
20,"20906",121,84,84,1,0,"UPYD",0
20,"20034",3157,2145,2141,7,4,"UPYD",3
20,"20076",6978,4975,4958,39,17,"UPYD",4
20,"20050",263,160,160,4,0,"UPYD",0
20,"20063",7990,5449,5415,23,34,"UPYD",10
20,"20017",8580,5807,5770,37,37,"UPYD",7
20,"20044",368,264,259,0,5,"UPYD",0
20,"20021",199,110,110,2,0,"UPYD",0
38,"38006",39553,21159,20940,124,219,"PCPC",58
38,"38036",6553,4604,4529,45,75,"PCPC",11
38,"38042",3784,2692,2673,16,19,"PCPC",0
38,"38035",9299,5558,5500,35,58,"PCPC",11
38,"38008",5513,3683,3609,17,74,"PCPC",7
38,"38037",12997,8126,7997,46,129,"PCPC",17
38,"38002",942,701,674,14,27,"PCPC",1
38,"38029",1533,776,763,7,13,"PCPC",2
38,"38032",13257,8969,8902,72,67,"PCPC",11
38,"38039",10584,7532,7462,77,70,"PCPC",5
38,"38025",6860,4836,4761,49,75,"PCPC",2
38,"38015",4158,2864,2818,12,46,"PCPC",3
38,"38017",28037,16236,16076,100,160,"PCPC",22
38,"38031",28697,21546,21202,140,344,"PCPC",25
38,"38048",3878,2664,2624,20,40,"PCPC",0
38,"38040",4990,3061,3031,16,30,"PCPC",5
38,"38049",2653,1683,1658,8,25,"PCPC",2
38,"38045",3987,2152,2132,23,20,"PCPC",5
38,"38018",4405,3053,3005,21,48,"PCPC",5
38,"38011",20435,13760,13627,82,133,"PCPC",14
38,"38004",4442,2980,2939,20,41,"PCPC",11
38,"38038",162030,105122,104174,667,948,"PCPC",184
38,"38046",9107,6755,6682,45,73,"PCPC",7
38,"38030",1923,1309,1300,5,9,"PCPC",2
38,"38028",22063,15095,14954,89,141,"PCPC",21
38,"38026",32918,24984,24727,174,257,"PCPC",43
38,"38052",1281,853,844,2,9,"PCPC",0
38,"38007",1689,1143,1119,3,24,"PCPC",0
38,"38041",6808,4869,4835,42,34,"PCPC",2
38,"38009",4127,2842,2793,15,49,"PCPC",8
38,"38016",1215,654,641,4,13,"PCPC",0
38,"38019",13217,8168,8075,54,93,"PCPC",13
38,"38012",2378,1620,1606,6,14,"PCPC",4
38,"38027",5386,3685,3615,29,70,"PCPC",4
38,"38021",1643,1014,1002,5,12,"PCPC",0
38,"38050",2471,1616,1590,8,26,"PCPC",1
38,"38022",18468,12230,12085,86,145,"PCPC",21
38,"38010",4014,2726,2678,15,48,"PCPC",6
38,"38024",15055,9612,9485,77,127,"PCPC",7
38,"38020",15021,9813,9693,51,120,"PCPC",12
38,"38013",2915,1865,1847,12,18,"PCPC",2
38,"38005",5463,3443,3417,24,26,"PCPC",10
38,"38003",1440,970,960,2,10,"PCPC",2
38,"38033",3721,2552,2504,15,48,"PCPC",3
38,"38901",1387,883,876,4,7,"PCPC",0
38,"38047",1789,1228,1208,5,20,"PCPC",2
38,"38034",4041,2853,2814,17,39,"PCPC",8
38,"38051",7217,5147,5089,31,58,"PCPC",2
38,"38001",20166,11307,11195,55,112,"PCPC",17
38,"38053",3754,2419,2370,15,49,"PCPC",3
38,"38023",121610,81337,80453,527,884,"PCPC",135
38,"38043",18918,12883,12737,109,146,"PCPC",20
38,"38044",2206,1317,1303,10,14,"PCPC",1
38,"38014",1351,935,929,3,6,"PCPC",1
22,"22079",118,86,86,2,0,"C's",12
22,"22252",122,93,91,1,2,"C's",11
22,"22043",94,71,70,0,1,"C's",6
22,"22903",654,542,536,3,6,"C's",71
22,"22004",136,79,79,0,0,"C's",16
22,"22006",298,217,215,1,2,"C's",23
22,"22193",283,235,234,3,1,"C's",33
22,"22129",183,128,127,2,1,"C's",25
22,"22099",490,378,377,4,1,"C's",41
22,"22058",190,152,151,2,1,"C's",20
22,"22074",315,229,226,3,3,"C's",29
22,"22254",1129,804,792,9,12,"C's",109
22,"22002",109,94,93,0,1,"C's",8
22,"22081",252,179,177,1,2,"C's",38
22,"22182",256,177,176,2,1,"C's",22
22,"22239",89,78,76,4,2,"C's",7
22,"22190",113,83,83,2,0,"C's",9
22,"22022",558,431,427,2,4,"C's",72
22,"22047",247,213,212,2,1,"C's",44
22,"22218",43,35,35,0,0,"C's",1
22,"22029",127,101,100,2,1,"C's",11
22,"22084",534,413,411,3,2,"C's",49
22,"22244",52,38,38,0,0,"C's",3
22,"22202",136,112,112,0,0,"C's",10
22,"22242",64,45,44,1,1,"C's",6
22,"22015",324,238,236,3,2,"C's",28
22,"22142",98,81,79,1,2,"C's",4
22,"22243",45,32,32,0,0,"C's",4
22,"22248",118,92,91,0,1,"C's",14
22,"22222",527,390,389,5,1,"C's",84
22,"22209",159,127,127,4,0,"C's",19
22,"22088",157,116,116,1,0,"C's",7
22,"22189",184,140,137,1,3,"C's",18
22,"22178",104,87,87,1,0,"C's",25
22,"22130",10106,6957,6909,57,48,"C's",1268
22,"22168",20,15,15,1,0,"C's",5
22,"22162",129,101,101,0,0,"C's",26
22,"22908",207,144,140,1,4,"C's",11
22,"22046",740,578,570,6,8,"C's",47
22,"22181",93,62,62,1,0,"C's",18
22,"22044",254,191,188,3,3,"C's",26
22,"22246",77,51,50,0,1,"C's",5
22,"22217",395,307,301,3,6,"C's",45
22,"22049",78,61,61,1,0,"C's",12
22,"22053",787,541,535,12,6,"C's",56
22,"22018",332,243,242,3,1,"C's",24
22,"22032",107,74,71,0,3,"C's",11
22,"22151",93,68,68,0,0,"C's",10
22,"22057",364,260,259,1,1,"C's",33
22,"22095",73,48,48,1,0,"C's",6
22,"22247",30,23,22,0,1,"C's",1
22,"22008",173,138,138,3,0,"C's",13
22,"22907",1459,1112,1104,21,8,"C's",159
22,"22027",325,218,214,0,4,"C's",34
22,"22050",89,78,78,0,0,"C's",7
22,"22250",347,258,256,5,2,"C's",36
22,"22157",194,151,151,1,0,"C's",18
22,"22236",249,198,198,1,0,"C's",27
22,"22011",89,70,70,1,0,"C's",8
22,"22089",315,227,222,6,5,"C's",32
22,"22025",1071,726,712,13,14,"C's",117
22,"22149",302,236,236,2,0,"C's",22
22,"22909",318,238,234,2,4,"C's",14
22,"22014",245,184,183,2,1,"C's",17
22,"22176",174,140,140,1,0,"C's",22
22,"22122",62,49,49,1,0,"C's",2
22,"22086",215,162,162,4,0,"C's",31
22,"22214",128,94,92,0,2,"C's",20
22,"22082",298,222,220,2,2,"C's",45
22,"22003",143,119,119,0,0,"C's",23
22,"22197",479,378,373,6,5,"C's",44
22,"22090",102,75,75,0,0,"C's",7
22,"22144",248,195,195,0,0,"C's",9
22,"22205",434,334,333,2,1,"C's",33
22,"22158",12005,8628,8554,78,74,"C's",1436
22,"22207",125,89,88,3,1,"C's",17
22,"22102",184,160,159,1,1,"C's",30
22,"22201",269,189,189,0,0,"C's",23
22,"22039",869,682,681,5,1,"C's",71
22,"22009",619,463,461,5,2,"C's",54
22,"22017",864,658,651,7,7,"C's",101
22,"22021",1970,1485,1469,14,16,"C's",231
22,"22037",116,95,94,1,1,"C's",12
22,"22042",118,102,100,1,2,"C's",9
22,"22106",24,17,17,0,0,"C's",2
22,"22001",226,166,166,0,0,"C's",31
22,"22221",80,60,59,0,1,"C's",14
22,"22072",192,148,147,1,1,"C's",11
22,"22069",435,340,338,3,2,"C's",55
22,"22083",474,400,396,1,4,"C's",51
22,"22172",560,399,396,2,3,"C's",72
22,"22060",1165,885,879,3,6,"C's",134
22,"22112",9592,6871,6820,76,51,"C's",1302
22,"22200",251,191,189,0,2,"C's",24
22,"22016",613,447,444,8,3,"C's",36
22,"22156",264,202,200,3,2,"C's",40
22,"22068",82,65,65,3,0,"C's",11
22,"22007",797,607,603,13,4,"C's",74
22,"22019",180,156,155,0,1,"C's",36
22,"22116",1443,1048,1038,12,10,"C's",146
22,"22177",102,77,77,2,0,"C's",6
22,"22174",485,400,396,6,4,"C's",44
22,"22165",490,375,372,2,3,"C's",55
22,"22136",815,596,595,6,1,"C's",64
22,"22077",381,295,293,5,2,"C's",32
22,"22139",83,65,64,0,1,"C's",5
22,"22109",265,207,206,2,1,"C's",43
22,"22061",6685,4796,4740,38,56,"C's",839
22,"22035",244,171,168,3,3,"C's",11
22,"22111",152,114,113,0,1,"C's",22
22,"22117",2497,1788,1770,16,18,"C's",261
22,"22105",118,87,86,1,1,"C's",8
22,"22028",379,297,293,1,4,"C's",41
22,"22164",35,26,26,1,0,"C's",2
22,"22141",118,90,89,1,1,"C's",9
22,"22013",295,235,233,2,2,"C's",32
22,"22229",114,81,81,0,0,"C's",9
22,"22078",453,323,319,6,4,"C's",37
22,"22253",61,51,50,0,1,"C's",6
22,"22024",225,174,173,0,1,"C's",26
22,"22227",211,153,151,3,2,"C's",19
22,"22170",642,518,509,4,9,"C's",63
22,"22062",162,113,113,3,0,"C's",17
22,"22234",802,600,597,7,3,"C's",100
22,"22066",707,512,508,8,4,"C's",57
22,"22094",101,77,77,1,0,"C's",9
22,"22160",209,161,161,3,0,"C's",18
22,"22064",165,115,115,1,0,"C's",4
22,"22131",83,63,63,3,0,"C's",14
22,"22107",123,79,78,2,1,"C's",11
22,"22213",3029,2225,2181,17,44,"C's",278
22,"22127",505,387,386,3,1,"C's",105
22,"22167",498,397,388,7,9,"C's",43
22,"22128",187,146,142,1,4,"C's",19
22,"22075",126,82,81,2,1,"C's",11
22,"22040",148,123,121,2,2,"C's",15
22,"22220",169,123,122,2,1,"C's",15
22,"22067",65,45,45,1,0,"C's",3
22,"22235",100,77,77,0,0,"C's",10
22,"22054",1542,1126,1106,20,20,"C's",203
22,"22115",364,270,267,4,3,"C's",27
22,"22225",2691,1849,1817,24,32,"C's",269
22,"22055",325,252,245,5,7,"C's",36
22,"22245",306,258,257,3,1,"C's",46
22,"22012",111,84,82,0,2,"C's",20
22,"22188",87,66,66,1,0,"C's",11
22,"22076",305,224,223,0,1,"C's",33
22,"22175",197,140,140,0,0,"C's",19
22,"22226",774,591,589,2,2,"C's",68
22,"22186",186,139,137,3,2,"C's",11
22,"22045",89,66,66,0,0,"C's",11
22,"22126",91,65,65,0,0,"C's",10
22,"22052",942,743,741,9,2,"C's",88
22,"22020",114,90,90,2,0,"C's",11
22,"22212",84,70,70,1,0,"C's",7
22,"22124",204,143,142,1,1,"C's",15
22,"22195",235,190,189,2,1,"C's",43
22,"22215",129,91,91,0,0,"C's",10
22,"22206",201,141,140,2,1,"C's",17
22,"22203",82,68,67,0,1,"C's",6
22,"22230",290,224,223,2,1,"C's",47
22,"22048",12633,9215,9141,90,74,"C's",1714
22,"22113",494,362,361,3,1,"C's",50
22,"22163",426,360,356,3,4,"C's",86
22,"22904",835,600,594,6,6,"C's",78
22,"22119",1296,950,940,3,10,"C's",98
22,"22080",283,217,215,6,2,"C's",38
22,"22208",178,142,140,0,2,"C's",14
22,"22223",79,63,62,0,1,"C's",1
22,"22133",117,89,89,4,0,"C's",5
22,"22251",371,283,281,4,2,"C's",56
22,"22114",123,80,79,4,1,"C's",8
22,"22199",7029,5024,4977,55,47,"C's",761
22,"22228",505,409,407,3,2,"C's",119
22,"22087",72,48,48,1,0,"C's",2
22,"22110",751,563,558,3,5,"C's",68
22,"22125",38845,28287,27998,283,289,"C's",5084
22,"22135",192,146,144,0,2,"C's",22
22,"22173",234,158,157,0,1,"C's",10
22,"22187",286,224,221,1,3,"C's",27
22,"22233",82,61,61,0,0,"C's",11
22,"22901",754,521,513,9,8,"C's",62
22,"22041",163,127,126,4,1,"C's",8
22,"22085",107,92,90,2,2,"C's",6
22,"22143",213,147,147,3,0,"C's",18
22,"22150",464,348,348,1,0,"C's",40
22,"22103",680,527,522,8,5,"C's",68
22,"22249",119,97,97,1,0,"C's",17
22,"22905",294,224,224,2,0,"C's",45
22,"22906",180,146,143,1,3,"C's",26
22,"22059",1137,839,828,7,11,"C's",124
22,"22096",297,248,248,0,0,"C's",48
22,"22063",175,140,140,2,0,"C's",15
22,"22155",77,58,58,2,0,"C's",11
22,"22902",219,162,160,1,2,"C's",31
22,"22184",188,156,156,2,0,"C's",12
22,"22036",91,82,82,0,0,"C's",13
22,"22204",1095,816,805,10,11,"C's",150
22,"22137",1071,729,719,6,10,"C's",71
22,"22232",96,73,70,2,3,"C's",8
22,"22051",101,84,84,1,0,"C's",9
22,"22023",430,329,329,2,0,"C's",52
28,"28039",130,97,97,0,0,"UPYD",1
28,"28076",406,322,319,1,3,"UPYD",1
28,"28145",2370,1824,1809,12,15,"UPYD",21
28,"28046",4432,3562,3538,19,24,"UPYD",26
28,"28085",3908,3106,3078,7,28,"UPYD",34
28,"28151",3143,2352,2314,6,38,"UPYD",53
28,"28109",1591,1113,1111,3,2,"UPYD",8
28,"28011",445,339,338,0,1,"UPYD",0
28,"28170",2486,1757,1740,9,17,"UPYD",5
28,"28135",971,740,735,4,5,"UPYD",2
28,"28136",640,540,532,0,8,"UPYD",1
28,"28075",5581,4380,4350,15,30,"UPYD",32
28,"28059",4312,3256,3237,11,19,"UPYD",30
28,"28029",530,426,424,3,2,"UPYD",9
28,"28001",64,48,48,3,0,"UPYD",1
28,"28117",95,84,84,0,0,"UPYD",0
28,"28156",998,751,743,3,8,"UPYD",7
28,"28902",468,352,347,2,5,"UPYD",4
28,"28161",48368,37462,37161,190,301,"UPYD",461
28,"28073",12505,9485,9384,64,101,"UPYD",105
28,"28036",2514,1974,1949,12,25,"UPYD",12
28,"28018",3739,3071,3046,12,25,"UPYD",27
28,"28041",4452,3572,3550,24,22,"UPYD",38
28,"28003",181,141,141,3,0,"UPYD",0
28,"28159",588,469,468,6,1,"UPYD",2
28,"28017",1210,954,943,6,11,"UPYD",14
28,"28070",119,91,91,0,0,"UPYD",0
28,"28007",124358,99423,98711,554,712,"UPYD",1098
28,"28149",5653,4516,4469,19,47,"UPYD",62
28,"28163",438,357,354,1,3,"UPYD",2
28,"28128",439,323,320,2,3,"UPYD",5
28,"28137",1644,1301,1283,7,18,"UPYD",9
28,"28132",11645,8605,8520,55,85,"UPYD",77
28,"28013",40409,30141,29905,164,236,"UPYD",260
28,"28178",1066,850,846,2,4,"UPYD",6
28,"28038",4935,3858,3815,17,43,"UPYD",30
28,"28079",2371327,1817203,1806970,9067,10233,"UPYD",22940
28,"28130",28243,22649,22458,135,191,"UPYD",226
28,"28090",8405,6792,6751,34,41,"UPYD",78
28,"28058",139289,108214,107323,612,891,"UPYD",1106
28,"28033",3824,2854,2832,11,22,"UPYD",16
28,"28169",1427,1164,1158,1,6,"UPYD",17
28,"28026",6237,4893,4853,32,40,"UPYD",31
28,"28051",1542,1240,1232,5,8,"UPYD",13
28,"28048",499,406,401,2,5,"UPYD",5
28,"28021",544,387,387,2,0,"UPYD",7
28,"28166",318,258,255,1,3,"UPYD",4
28,"28056",860,653,647,6,6,"UPYD",5
28,"28044",5766,4623,4584,22,39,"UPYD",57
28,"28091",5436,3827,3786,23,41,"UPYD",20
28,"28133",6002,4259,4204,12,55,"UPYD",20
28,"28147",968,751,745,2,6,"UPYD",2
28,"28072",5657,4465,4441,20,24,"UPYD",43
28,"28024",152,129,128,1,1,"UPYD",2
28,"28078",36,34,34,0,0,"UPYD",0
28,"28057",1439,1125,1120,5,5,"UPYD",7
28,"28062",308,244,241,3,3,"UPYD",3
28,"28171",4238,3002,2962,18,40,"UPYD",10
28,"28182",214,174,170,0,4,"UPYD",3
28,"28141",5806,4532,4486,24,46,"UPYD",54
28,"28035",1362,1042,1033,3,9,"UPYD",9
28,"28065",125384,101604,100872,477,732,"UPYD",1116
28,"28092",151511,117869,116968,641,901,"UPYD",1268
28,"28120",1217,918,904,4,14,"UPYD",6
28,"28084",15839,12028,11925,53,103,"UPYD",192
28,"28050",4077,3032,3006,15,26,"UPYD",23
28,"28002",2966,2186,2175,9,11,"UPYD",22
28,"28181",20344,16669,16572,95,97,"UPYD",182
28,"28126",39,25,25,0,0,"UPYD",0
28,"28008",1768,1293,1282,4,11,"UPYD",1
28,"28066",7175,5598,5561,28,37,"UPYD",60
28,"28165",1788,1332,1321,5,11,"UPYD",8
28,"28138",69,54,54,0,0,"UPYD",1
28,"28053",6458,5299,5263,29,36,"UPYD",61
28,"28131",12971,9828,9755,57,73,"UPYD",125
28,"28061",21200,16698,16600,75,98,"UPYD",215
28,"28146",1773,1274,1262,9,12,"UPYD",5
28,"28113",34305,27077,26881,156,196,"UPYD",312
28,"28164",2986,2281,2263,12,18,"UPYD",17
28,"28157",595,448,442,1,6,"UPYD",1
28,"28074",138742,110456,109579,581,877,"UPYD",1295
28,"28176",12288,9809,9763,50,46,"UPYD",118
28,"28106",76612,56555,56006,346,549,"UPYD",535
28,"28016",80,57,57,0,0,"UPYD",0
28,"28045",33019,25531,25313,146,218,"UPYD",393
28,"28054",11166,8649,8584,36,65,"UPYD",95
28,"28099",1731,1283,1278,8,5,"UPYD",5
28,"28162",2549,2039,2025,13,14,"UPYD",20
28,"28096",18161,13784,13647,57,137,"UPYD",141
28,"28174",1788,1277,1267,2,10,"UPYD",10
28,"28140",2981,2383,2357,14,26,"UPYD",21
28,"28087",3176,2545,2528,15,17,"UPYD",14
28,"28068",10928,8389,8315,43,74,"UPYD",85
28,"28148",85022,65597,65111,368,486,"UPYD",752
28,"28122",518,388,385,2,3,"UPYD",8
28,"28153",703,510,507,2,3,"UPYD",3
28,"28150",3084,2415,2381,13,34,"UPYD",21
28,"28012",883,702,691,4,11,"UPYD",8
28,"28022",32949,27473,27379,169,94,"UPYD",332
28,"28082",5664,4526,4492,25,34,"UPYD",50
28,"28175",850,696,692,2,4,"UPYD",3
28,"28183",1050,770,763,2,7,"UPYD",8
28,"28030",1716,1342,1316,2,26,"UPYD",7
28,"28047",40783,31308,31072,171,236,"UPYD",442
28,"28154",5420,3966,3899,17,67,"UPYD",50
28,"28903",32480,27640,27525,161,115,"UPYD",479
28,"28152",16026,13269,13202,46,67,"UPYD",162
28,"28023",4697,3835,3817,20,18,"UPYD",32
28,"28143",70,59,59,1,0,"UPYD",0
28,"28121",198,166,164,2,2,"UPYD",1
28,"28116",700,544,544,3,0,"UPYD",2
28,"28118",58,49,48,1,1,"UPYD",1
28,"28005",134211,104575,103819,667,756,"UPYD",1222
28,"28071",60,47,46,0,1,"UPYD",0
28,"28083",8880,6801,6759,47,42,"UPYD",68
28,"28123",56464,47181,46948,257,233,"UPYD",538
28,"28160",8227,6295,6251,26,44,"UPYD",75
28,"28102",881,659,650,3,9,"UPYD",7
28,"28101",218,180,180,0,0,"UPYD",0
28,"28129",7913,6175,6124,30,51,"UPYD",81
28,"28158",662,545,543,3,2,"UPYD",5
28,"28067",4057,3220,3188,12,32,"UPYD",22
28,"28124",76,56,54,0,2,"UPYD",4
28,"28049",58688,48006,47660,286,346,"UPYD",515
28,"28172",8965,7255,7219,44,36,"UPYD",100
28,"28009",14046,11014,10932,51,82,"UPYD",105
28,"28177",10192,8271,8234,51,37,"UPYD",85
28,"28032",4749,3653,3607,19,46,"UPYD",35
28,"28901",789,590,584,2,6,"UPYD",7
28,"28042",1153,882,874,5,8,"UPYD",7
28,"28094",825,636,634,3,2,"UPYD",4
28,"28111",592,489,483,0,6,"UPYD",2
28,"28155",507,420,420,0,0,"UPYD",0
28,"28168",1226,910,900,1,10,"UPYD",7
28,"28043",5922,4063,4008,29,55,"UPYD",20
28,"28086",5055,3627,3600,21,27,"UPYD",28
28,"28110",1949,1543,1525,2,18,"UPYD",17
28,"28063",252,195,194,2,1,"UPYD",1
28,"28180",5242,4040,3999,11,41,"UPYD",36
28,"28020",148,99,97,1,2,"UPYD",0
28,"28089",3703,2961,2933,19,28,"UPYD",25
28,"28027",1199,897,882,5,15,"UPYD",9
28,"28108",3330,2536,2528,17,8,"UPYD",37
28,"28025",427,329,326,1,3,"UPYD",0
28,"28040",15691,10833,10728,45,105,"UPYD",74
28,"28125",2965,2210,2188,13,22,"UPYD",15
28,"28004",6179,4377,4345,15,32,"UPYD",17
28,"28179",1441,1082,1071,7,11,"UPYD",12
28,"28112",167,132,132,0,0,"UPYD",3
28,"28019",1237,952,938,2,14,"UPYD",0
28,"28100",4169,3076,3048,12,28,"UPYD",53
28,"28028",1730,1347,1326,8,21,"UPYD",15
28,"28097",124,85,84,1,1,"UPYD",2
28,"28060",1509,1194,1183,8,11,"UPYD",5
28,"28173",520,409,408,3,1,"UPYD",2
28,"28080",48226,39753,39570,172,183,"UPYD",496
28,"28055",899,682,676,4,6,"UPYD",2
28,"28069",54,43,43,1,0,"UPYD",0
28,"28095",1508,1177,1167,6,10,"UPYD",9
28,"28127",64513,53125,52932,300,193,"UPYD",807
28,"28015",18233,14725,14653,81,72,"UPYD",165
28,"28167",8308,6605,6545,35,60,"UPYD",79
28,"28104",13836,11414,11349,54,65,"UPYD",130
28,"28107",435,326,321,0,5,"UPYD",3
28,"28144",5929,4776,4744,29,32,"UPYD",52
28,"28134",60511,47566,47229,233,337,"UPYD",543
28,"28064",134,105,105,0,0,"UPYD",0
28,"28115",60579,50819,50657,246,162,"UPYD",633
28,"28031",2055,1538,1519,4,19,"UPYD",6
28,"28037",1566,1175,1168,5,7,"UPYD",6
28,"28014",32852,24749,24571,120,178,"UPYD",243
28,"28006",78564,61796,61456,334,340,"UPYD",791
28,"28088",262,180,179,2,1,"UPYD",0
28,"28119",2074,1641,1625,9,16,"UPYD",20
28,"28114",149,103,103,1,0,"UPYD",4
28,"28052",3883,2801,2758,18,43,"UPYD",18
28,"28010",9853,7959,7914,35,45,"UPYD",96
28,"28034",352,270,269,1,1,"UPYD",1
28,"28093",2043,1681,1661,9,20,"UPYD",9
21,"21065",287,202,196,0,6,"PSOE",69
21,"21076",2123,1549,1532,13,17,"PSOE",769
21,"21016",1034,777,764,2,13,"PSOE",408
21,"21042",15349,7802,7708,106,94,"PSOE",2312
21,"21075",351,270,266,2,4,"PSOE",130
21,"21062",1395,936,926,9,10,"PSOE",454
21,"21035",9622,6399,6313,69,86,"PSOE",2706
21,"21071",204,160,158,2,2,"PSOE",77
21,"21029",1564,1166,1126,16,40,"PSOE",526
21,"21008",2662,1847,1831,14,16,"PSOE",1066
21,"21079",731,526,522,3,4,"PSOE",261
21,"21054",8105,6025,5919,41,106,"PSOE",1604
21,"21010",14684,8766,8698,92,68,"PSOE",3024
21,"21028",381,290,287,0,3,"PSOE",131
21,"21032",1805,1378,1359,15,19,"PSOE",554
21,"21046",1703,1200,1173,15,27,"PSOE",530
21,"21037",472,364,360,2,4,"PSOE",202
21,"21002",15348,10939,10864,80,75,"PSOE",2407
21,"21058",2602,1904,1886,8,18,"PSOE",1221
21,"21060",11959,7565,7488,103,77,"PSOE",2397
21,"21041",113604,74902,74244,718,658,"PSOE",21386
21,"21004",1641,1070,1047,10,23,"PSOE",542
21,"21026",270,184,178,1,6,"PSOE",80
21,"21049",3372,2162,2108,15,54,"PSOE",922
21,"21047",1914,1213,1179,19,34,"PSOE",488
21,"21070",6296,4450,4397,38,53,"PSOE",1889
21,"21005",15486,10310,10189,64,121,"PSOE",4667
21,"21043",1858,1356,1341,13,15,"PSOE",751
21,"21057",1045,641,640,8,1,"PSOE",378
21,"21068",998,606,605,14,1,"PSOE",318
21,"21027",49,36,36,1,0,"PSOE",17
21,"21017",3643,2301,2269,17,32,"PSOE",1137
21,"21014",4041,3203,3170,15,33,"PSOE",1593
21,"21050",12448,8431,8382,86,49,"PSOE",3412
21,"21024",495,350,344,5,6,"PSOE",168
21,"21072",10280,7869,7777,76,92,"PSOE",3058
21,"21007",6231,4285,4227,45,58,"PSOE",1592
21,"21069",1715,1186,1175,7,11,"PSOE",642
21,"21023",2147,1379,1357,6,22,"PSOE",710
21,"21040",3158,2386,2345,15,41,"PSOE",1056
21,"21078",2763,1928,1907,12,21,"PSOE",895
21,"21063",2614,2044,2034,12,10,"PSOE",1318
21,"21066",507,408,405,1,3,"PSOE",235
21,"21022",174,115,109,1,6,"PSOE",46
21,"21073",1871,1134,1120,12,14,"PSOE",465
21,"21012",322,234,227,0,7,"PSOE",90
21,"21039",308,223,222,2,1,"PSOE",108
21,"21018",1780,1152,1131,10,21,"PSOE",618
21,"21020",372,241,238,2,3,"PSOE",123
21,"21030",1824,1491,1472,11,19,"PSOE",775
21,"21051",245,176,173,1,3,"PSOE",79
21,"21045",253,192,190,0,2,"PSOE",92
21,"21019",590,433,423,4,10,"PSOE",227
21,"21006",3402,2398,2359,13,39,"PSOE",1389
21,"21031",1209,845,828,3,17,"PSOE",421
21,"21048",305,220,220,3,0,"PSOE",109
21,"21038",1082,732,719,8,13,"PSOE",261
21,"21052",4618,2837,2773,20,64,"PSOE",1298
21,"21077",1722,1261,1246,5,15,"PSOE",600
21,"21074",2660,1869,1844,18,25,"PSOE",963
21,"21036",192,138,138,1,0,"PSOE",70
21,"21013",10597,7220,7061,69,159,"PSOE",2662
21,"21059",220,167,165,3,2,"PSOE",121
21,"21033",536,399,395,0,4,"PSOE",190
21,"21009",860,571,555,6,16,"PSOE",248
21,"21055",6914,5286,5218,34,68,"PSOE",1443
21,"21011",3464,2536,2518,19,18,"PSOE",1238
21,"21001",648,479,469,4,10,"PSOE",231
21,"21025",4049,2682,2653,25,29,"PSOE",1140
21,"21064",6526,4544,4492,51,52,"PSOE",1928
21,"21021",12233,7551,7470,94,81,"PSOE",2681
21,"21044",17552,10820,10692,106,128,"PSOE",3022
21,"21053",3316,2257,2219,25,38,"PSOE",1049
21,"21067",415,309,303,0,6,"PSOE",166
21,"21056",2912,2115,2024,20,91,"PSOE",896
21,"21003",695,533,525,1,8,"PSOE",338
21,"21034",1207,848,838,8,10,"PSOE",366
21,"21015",683,425,420,6,5,"PSOE",253
21,"21061",5092,3471,3429,32,42,"PSOE",1774
22,"22018",332,243,242,3,1,"PCPE",1
22,"22032",107,74,71,0,3,"PCPE",0
22,"22053",787,541,535,12,6,"PCPE",0
22,"22181",93,62,62,1,0,"PCPE",0
22,"22213",3029,2225,2181,17,44,"PCPE",9
22,"22243",45,32,32,0,0,"PCPE",0
22,"22102",184,160,159,1,1,"PCPE",0
22,"22222",527,390,389,5,1,"PCPE",2
22,"22136",815,596,595,6,1,"PCPE",1
22,"22133",117,89,89,4,0,"PCPE",0
22,"22203",82,68,67,0,1,"PCPE",0
22,"22202",136,112,112,0,0,"PCPE",0
22,"22184",188,156,156,2,0,"PCPE",0
22,"22195",235,190,189,2,1,"PCPE",1
22,"22151",93,68,68,0,0,"PCPE",0
22,"22131",83,63,63,3,0,"PCPE",0
22,"22182",256,177,176,2,1,"PCPE",0
22,"22227",211,153,151,3,2,"PCPE",0
22,"22014",245,184,183,2,1,"PCPE",0
22,"22188",87,66,66,1,0,"PCPE",0
22,"22158",12005,8628,8554,78,74,"PCPE",27
22,"22006",298,217,215,1,2,"PCPE",0
22,"22130",10106,6957,6909,57,48,"PCPE",10
22,"22046",740,578,570,6,8,"PCPE",1
22,"22009",619,463,461,5,2,"PCPE",2
22,"22050",89,78,78,0,0,"PCPE",0
22,"22177",102,77,77,2,0,"PCPE",0
22,"22008",173,138,138,3,0,"PCPE",0
22,"22062",162,113,113,3,0,"PCPE",1
22,"22246",77,51,50,0,1,"PCPE",0
22,"22007",797,607,603,13,4,"PCPE",2
22,"22035",244,171,168,3,3,"PCPE",1
22,"22036",91,82,82,0,0,"PCPE",0
22,"22019",180,156,155,0,1,"PCPE",0
22,"22052",942,743,741,9,2,"PCPE",1
22,"22051",101,84,84,1,0,"PCPE",0
22,"22144",248,195,195,0,0,"PCPE",0
22,"22012",111,84,82,0,2,"PCPE",0
22,"22232",96,73,70,2,3,"PCPE",0
22,"22239",89,78,76,4,2,"PCPE",0
22,"22233",82,61,61,0,0,"PCPE",0
22,"22045",89,66,66,0,0,"PCPE",0
22,"22087",72,48,48,1,0,"PCPE",0
22,"22230",290,224,223,2,1,"PCPE",0
22,"22105",118,87,86,1,1,"PCPE",1
22,"22156",264,202,200,3,2,"PCPE",0
22,"22234",802,600,597,7,3,"PCPE",1
22,"22094",101,77,77,1,0,"PCPE",1
22,"22025",1071,726,712,13,14,"PCPE",1
22,"22042",118,102,100,1,2,"PCPE",0
22,"22235",100,77,77,0,0,"PCPE",0
22,"22245",306,258,257,3,1,"PCPE",0
22,"22162",129,101,101,0,0,"PCPE",0
22,"22039",869,682,681,5,1,"PCPE",2
22,"22214",128,94,92,0,2,"PCPE",1
22,"22095",73,48,48,1,0,"PCPE",0
22,"22004",136,79,79,0,0,"PCPE",0
22,"22059",1137,839,828,7,11,"PCPE",1
22,"22043",94,71,70,0,1,"PCPE",1
22,"22112",9592,6871,6820,76,51,"PCPE",15
22,"22089",315,227,222,6,5,"PCPE",0
22,"22247",30,23,22,0,1,"PCPE",0
22,"22054",1542,1126,1106,20,20,"PCPE",2
22,"22055",325,252,245,5,7,"PCPE",0
22,"22142",98,81,79,1,2,"PCPE",0
22,"22068",82,65,65,3,0,"PCPE",0
22,"22248",118,92,91,0,1,"PCPE",0
22,"22190",113,83,83,2,0,"PCPE",0
22,"22109",265,207,206,2,1,"PCPE",0
22,"22060",1165,885,879,3,6,"PCPE",0
22,"22028",379,297,293,1,4,"PCPE",0
22,"22205",434,334,333,2,1,"PCPE",0
22,"22209",159,127,127,4,0,"PCPE",0
22,"22186",186,139,137,3,2,"PCPE",1
22,"22083",474,400,396,1,4,"PCPE",0
22,"22024",225,174,173,0,1,"PCPE",0
22,"22064",165,115,115,1,0,"PCPE",0
22,"22016",613,447,444,8,3,"PCPE",1
22,"22139",83,65,64,0,1,"PCPE",0
22,"22110",751,563,558,3,5,"PCPE",0
22,"22251",371,283,281,4,2,"PCPE",0
22,"22029",127,101,100,2,1,"PCPE",0
22,"22069",435,340,338,3,2,"PCPE",0
22,"22057",364,260,259,1,1,"PCPE",2
22,"22165",490,375,372,2,3,"PCPE",2
22,"22226",774,591,589,2,2,"PCPE",2
22,"22212",84,70,70,1,0,"PCPE",0
22,"22115",364,270,267,4,3,"PCPE",1
22,"22253",61,51,50,0,1,"PCPE",0
22,"22072",192,148,147,1,1,"PCPE",1
22,"22058",190,152,151,2,1,"PCPE",1
22,"22199",7029,5024,4977,55,47,"PCPE",7
22,"22254",1129,804,792,9,12,"PCPE",2
22,"22149",302,236,236,2,0,"PCPE",0
22,"22027",325,218,214,0,4,"PCPE",0
22,"22084",534,413,411,3,2,"PCPE",0
22,"22085",107,92,90,2,2,"PCPE",0
22,"22207",125,89,88,3,1,"PCPE",0
22,"22167",498,397,388,7,9,"PCPE",0
22,"22074",315,229,226,3,3,"PCPE",0
22,"22047",247,213,212,2,1,"PCPE",1
22,"22236",249,198,198,1,0,"PCPE",0
22,"22200",251,191,189,0,2,"PCPE",0
22,"22103",680,527,522,8,5,"PCPE",1
22,"22201",269,189,189,0,0,"PCPE",0
22,"22901",754,521,513,9,8,"PCPE",1
22,"22228",505,409,407,3,2,"PCPE",4
22,"22086",215,162,162,4,0,"PCPE",2
22,"22244",52,38,38,0,0,"PCPE",0
22,"22048",12633,9215,9141,90,74,"PCPE",13
22,"22023",430,329,329,2,0,"PCPE",1
22,"22113",494,362,361,3,1,"PCPE",2
22,"22168",20,15,15,1,0,"PCPE",0
22,"22229",114,81,81,0,0,"PCPE",0
22,"22902",219,162,160,1,2,"PCPE",0
22,"22075",126,82,81,2,1,"PCPE",2
22,"22170",642,518,509,4,9,"PCPE",2
22,"22252",122,93,91,1,2,"PCPE",0
22,"22119",1296,950,940,3,10,"PCPE",2
22,"22215",129,91,91,0,0,"PCPE",0
22,"22164",35,26,26,1,0,"PCPE",0
22,"22021",1970,1485,1469,14,16,"PCPE",4
22,"22135",192,146,144,0,2,"PCPE",1
22,"22106",24,17,17,0,0,"PCPE",0
22,"22242",64,45,44,1,1,"PCPE",0
22,"22037",116,95,94,1,1,"PCPE",1
22,"22155",77,58,58,2,0,"PCPE",0
22,"22217",395,307,301,3,6,"PCPE",0
22,"22061",6685,4796,4740,38,56,"PCPE",15
22,"22049",78,61,61,1,0,"PCPE",0
22,"22088",157,116,116,1,0,"PCPE",0
22,"22187",286,224,221,1,3,"PCPE",0
22,"22903",654,542,536,3,6,"PCPE",3
22,"22122",62,49,49,1,0,"PCPE",0
22,"22150",464,348,348,1,0,"PCPE",0
22,"22077",381,295,293,5,2,"PCPE",0
22,"22172",560,399,396,2,3,"PCPE",1
22,"22011",89,70,70,1,0,"PCPE",0
22,"22137",1071,729,719,6,10,"PCPE",2
22,"22107",123,79,78,2,1,"PCPE",0
22,"22204",1095,816,805,10,11,"PCPE",0
22,"22116",1443,1048,1038,12,10,"PCPE",1
22,"22124",204,143,142,1,1,"PCPE",0
22,"22904",835,600,594,6,6,"PCPE",3
22,"22040",148,123,121,2,2,"PCPE",0
22,"22063",175,140,140,2,0,"PCPE",0
22,"22078",453,323,319,6,4,"PCPE",4
22,"22218",43,35,35,0,0,"PCPE",0
22,"22157",194,151,151,1,0,"PCPE",0
22,"22174",485,400,396,6,4,"PCPE",0
22,"22117",2497,1788,1770,16,18,"PCPE",0
22,"22125",38845,28287,27998,283,289,"PCPE",53
22,"22079",118,86,86,2,0,"PCPE",0
22,"22020",114,90,90,2,0,"PCPE",0
22,"22090",102,75,75,0,0,"PCPE",0
22,"22905",294,224,224,2,0,"PCPE",1
22,"22013",295,235,233,2,2,"PCPE",0
22,"22189",184,140,137,1,3,"PCPE",1
22,"22249",119,97,97,1,0,"PCPE",0
22,"22041",163,127,126,4,1,"PCPE",0
22,"22114",123,80,79,4,1,"PCPE",0
22,"22141",118,90,89,1,1,"PCPE",0
22,"22111",152,114,113,0,1,"PCPE",0
22,"22221",80,60,59,0,1,"PCPE",0
22,"22076",305,224,223,0,1,"PCPE",1
22,"22160",209,161,161,3,0,"PCPE",0
22,"22066",707,512,508,8,4,"PCPE",2
22,"22175",197,140,140,0,0,"PCPE",4
22,"22206",201,141,140,2,1,"PCPE",0
22,"22080",283,217,215,6,2,"PCPE",3
22,"22193",283,235,234,3,1,"PCPE",0
22,"22126",91,65,65,0,0,"PCPE",0
22,"22907",1459,1112,1104,21,8,"PCPE",1
22,"22176",174,140,140,1,0,"PCPE",0
22,"22022",558,431,427,2,4,"PCPE",1
22,"22081",252,179,177,1,2,"PCPE",0
22,"22001",226,166,166,0,0,"PCPE",0
22,"22015",324,238,236,3,2,"PCPE",0
22,"22127",505,387,386,3,1,"PCPE",1
22,"22250",347,258,256,5,2,"PCPE",1
22,"22002",109,94,93,0,1,"PCPE",0
22,"22173",234,158,157,0,1,"PCPE",0
22,"22067",65,45,45,1,0,"PCPE",0
22,"22223",79,63,62,0,1,"PCPE",0
22,"22096",297,248,248,0,0,"PCPE",0
22,"22143",213,147,147,3,0,"PCPE",0
22,"22128",187,146,142,1,4,"PCPE",0
22,"22208",178,142,140,0,2,"PCPE",0
22,"22044",254,191,188,3,3,"PCPE",0
22,"22908",207,144,140,1,4,"PCPE",0
22,"22220",169,123,122,2,1,"PCPE",2
22,"22163",426,360,356,3,4,"PCPE",3
22,"22225",2691,1849,1817,24,32,"PCPE",4
22,"22003",143,119,119,0,0,"PCPE",0
22,"22082",298,222,220,2,2,"PCPE",0
22,"22197",479,378,373,6,5,"PCPE",0
22,"22129",183,128,127,2,1,"PCPE",0
22,"22017",864,658,651,7,7,"PCPE",1
22,"22178",104,87,87,1,0,"PCPE",1
22,"22099",490,378,377,4,1,"PCPE",1
22,"22906",180,146,143,1,3,"PCPE",0
22,"22909",318,238,234,2,4,"PCPE",1
33,"33050",603,374,357,0,17,"UPYD",1
33,"33001",1622,867,852,16,15,"UPYD",2
33,"33042",4316,3143,3105,35,38,"UPYD",14
33,"33067",785,608,598,5,10,"UPYD",4
33,"33007",1524,991,980,10,11,"UPYD",6
33,"33008",1808,1268,1247,6,21,"UPYD",3
33,"33057",1593,1134,1123,17,11,"UPYD",7
33,"33069",3513,2577,2554,15,23,"UPYD",11
33,"33056",5015,3435,3405,32,30,"UPYD",17
33,"33048",156,99,99,2,0,"UPYD",1
33,"33003",665,386,384,7,2,"UPYD",1
33,"33039",1672,1261,1257,14,4,"UPYD",7
33,"33030",899,689,687,10,2,"UPYD",2
33,"33005",1479,945,932,12,13,"UPYD",5
33,"33023",3315,2295,2267,35,28,"UPYD",12
33,"33062",409,242,239,1,3,"UPYD",1
33,"33014",9101,6398,6352,46,46,"UPYD",45
33,"33065",1109,743,735,16,8,"UPYD",2
33,"33028",1289,685,682,9,3,"UPYD",4
33,"33022",906,604,599,3,5,"UPYD",0
33,"33043",682,465,460,2,5,"UPYD",3
33,"33063",419,330,326,1,4,"UPYD",1
33,"33032",11483,8036,7921,82,115,"UPYD",32
33,"33040",4564,3125,3091,28,34,"UPYD",11
33,"33051",7167,4810,4772,57,38,"UPYD",11
33,"33018",2896,2068,2041,18,27,"UPYD",16
33,"33054",1688,1159,1146,8,13,"UPYD",3
33,"33076",12270,8265,8203,89,62,"UPYD",44
33,"33027",849,544,543,8,1,"UPYD",2
33,"33017",3180,2196,2168,30,28,"UPYD",9
33,"33074",3523,2422,2390,36,32,"UPYD",8
33,"33033",9943,6851,6803,61,48,"UPYD",24
33,"33053",1157,767,762,12,5,"UPYD",3
33,"33010",1828,1220,1215,16,5,"UPYD",4
33,"33011",11373,6279,6214,104,65,"UPYD",35
33,"33002",10122,7056,6977,55,79,"UPYD",22
33,"33045",4503,3249,3216,26,33,"UPYD",12
33,"33036",11572,8208,8133,80,75,"UPYD",29
33,"33038",2298,1690,1675,12,15,"UPYD",11
33,"33013",456,336,331,6,5,"UPYD",1
33,"33012",5230,3595,3568,27,27,"UPYD",14
33,"33059",4702,3228,3185,42,43,"UPYD",8
33,"33035",11299,8048,7981,67,67,"UPYD",44
33,"33016",19201,14177,14074,115,103,"UPYD",55
33,"33020",13297,9527,9445,86,82,"UPYD",43
33,"33019",3094,2079,2054,15,25,"UPYD",5
33,"33026",8621,5600,5555,71,45,"UPYD",17
33,"33029",363,199,198,1,1,"UPYD",1
33,"33060",14750,10307,10206,82,101,"UPYD",24
33,"33058",1821,1319,1305,10,14,"UPYD",1
33,"33021",4576,3133,3090,33,43,"UPYD",13
33,"33052",730,517,512,1,5,"UPYD",5
33,"33041",7270,5138,5093,53,45,"UPYD",20
33,"33037",34841,24271,24054,200,217,"UPYD",85
33,"33024",227211,166618,165475,1240,1143,"UPYD",1157
33,"33068",1114,627,623,2,4,"UPYD",0
33,"33047",1126,868,861,12,7,"UPYD",1
33,"33025",9261,6116,6062,58,54,"UPYD",26
33,"33073",8631,5015,4948,47,67,"UPYD",13
33,"33055",1511,1150,1129,9,21,"UPYD",6
33,"33034",10693,6796,6725,72,71,"UPYD",28
33,"33075",275,161,155,2,6,"UPYD",0
33,"33077",1220,849,840,11,9,"UPYD",5
33,"33071",617,459,452,8,7,"UPYD",1
33,"33044",178724,130938,130010,1254,928,"UPYD",1152
33,"33031",35453,23848,23595,242,253,"UPYD",83
33,"33004",67136,48699,48354,389,345,"UPYD",334
33,"33009",899,606,601,4,5,"UPYD",0
33,"33015",1561,1042,1031,8,11,"UPYD",2
33,"33072",1601,1012,1002,4,10,"UPYD",4
33,"33046",508,375,365,4,10,"UPYD",1
33,"33064",231,181,179,4,2,"UPYD",0
33,"33006",1556,1043,1036,17,7,"UPYD",3
33,"33049",6388,4229,4182,48,47,"UPYD",18
33,"33078",147,98,98,0,0,"UPYD",1
33,"33061",379,194,190,1,4,"UPYD",0
33,"33066",43034,29901,29610,261,291,"UPYD",184
33,"33070",3347,2473,2441,31,32,"UPYD",12
38,"38006",39553,21159,20940,124,219,"PACMA",287
38,"38042",3784,2692,2673,16,19,"PACMA",15
38,"38027",5386,3685,3615,29,70,"PACMA",24
38,"38015",4158,2864,2818,12,46,"PACMA",17
38,"38001",20166,11307,11195,55,112,"PACMA",160
38,"38016",1215,654,641,4,13,"PACMA",4
38,"38019",13217,8168,8075,54,93,"PACMA",56
38,"38022",18468,12230,12085,86,145,"PACMA",93
38,"38033",3721,2552,2504,15,48,"PACMA",23
38,"38007",1689,1143,1119,3,24,"PACMA",7
38,"38901",1387,883,876,4,7,"PACMA",4
38,"38004",4442,2980,2939,20,41,"PACMA",31
38,"38020",15021,9813,9693,51,120,"PACMA",104
38,"38053",3754,2419,2370,15,49,"PACMA",25
38,"38030",1923,1309,1300,5,9,"PACMA",8
38,"38047",1789,1228,1208,5,20,"PACMA",13
38,"38025",6860,4836,4761,49,75,"PACMA",49
38,"38011",20435,13760,13627,82,133,"PACMA",217
38,"38021",1643,1014,1002,5,12,"PACMA",6
38,"38041",6808,4869,4835,42,34,"PACMA",67
38,"38009",4127,2842,2793,15,49,"PACMA",28
38,"38003",1440,970,960,2,10,"PACMA",7
38,"38044",2206,1317,1303,10,14,"PACMA",7
38,"38046",9107,6755,6682,45,73,"PACMA",80
38,"38040",4990,3061,3031,16,30,"PACMA",13
38,"38038",162030,105122,104174,667,948,"PACMA",1874
38,"38045",3987,2152,2132,23,20,"PACMA",16
38,"38024",15055,9612,9485,77,127,"PACMA",138
38,"38051",7217,5147,5089,31,58,"PACMA",45
38,"38048",3878,2664,2624,20,40,"PACMA",18
38,"38052",1281,853,844,2,9,"PACMA",3
38,"38039",10584,7532,7462,77,70,"PACMA",99
38,"38029",1533,776,763,7,13,"PACMA",14
38,"38050",2471,1616,1590,8,26,"PACMA",5
38,"38013",2915,1865,1847,12,18,"PACMA",8
38,"38028",22063,15095,14954,89,141,"PACMA",180
38,"38012",2378,1620,1606,6,14,"PACMA",13
38,"38002",942,701,674,14,27,"PACMA",6
38,"38005",5463,3443,3417,24,26,"PACMA",35
38,"38049",2653,1683,1658,8,25,"PACMA",13
38,"38010",4014,2726,2678,15,48,"PACMA",24
38,"38036",6553,4604,4529,45,75,"PACMA",41
38,"38032",13257,8969,8902,72,67,"PACMA",133
38,"38023",121610,81337,80453,527,884,"PACMA",1373
38,"38014",1351,935,929,3,6,"PACMA",8
38,"38043",18918,12883,12737,109,146,"PACMA",162
38,"38037",12997,8126,7997,46,129,"PACMA",81
38,"38008",5513,3683,3609,17,74,"PACMA",34
38,"38035",9299,5558,5500,35,58,"PACMA",92
38,"38026",32918,24984,24727,174,257,"PACMA",270
38,"38031",28697,21546,21202,140,344,"PACMA",242
38,"38017",28037,16236,16076,100,160,"PACMA",207
38,"38018",4405,3053,3005,21,48,"PACMA",26
38,"38034",4041,2853,2814,17,39,"PACMA",21
37,"37001",195,147,144,0,3,"PSOE",38
37,"37113",430,340,340,3,0,"PSOE",127
37,"37180",73,52,52,1,0,"PSOE",8
37,"37250",358,223,223,1,0,"PSOE",75
37,"37012",150,117,115,0,2,"PSOE",23
37,"37318",209,156,155,1,1,"PSOE",23
37,"37215",136,102,101,2,1,"PSOE",35
37,"37114",88,67,66,1,1,"PSOE",9
37,"37034",84,66,66,3,0,"PSOE",19
37,"37136",667,453,448,2,5,"PSOE",170
37,"37364",836,598,583,6,15,"PSOE",168
37,"37283",120,88,88,1,0,"PSOE",27
37,"37331",217,150,148,1,2,"PSOE",29
37,"37284",325,245,244,2,1,"PSOE",61
37,"37216",310,264,257,4,7,"PSOE",60
37,"37002",144,87,87,0,0,"PSOE",34
37,"37035",194,161,161,0,0,"PSOE",45
37,"37251",126,87,87,2,0,"PSOE",8
37,"37319",117,78,77,0,1,"PSOE",14
37,"37182",77,62,62,0,0,"PSOE",7
37,"37332",69,53,52,0,1,"PSOE",7
37,"37148",425,304,295,6,9,"PSOE",66
37,"37273",108,77,77,0,0,"PSOE",11
37,"37036",63,46,46,0,0,"PSOE",4
37,"37365",174,147,144,0,3,"PSOE",22
37,"37297",420,342,331,4,11,"PSOE",89
37,"37074",153,109,103,4,6,"PSOE",45
37,"37115",123,89,87,0,2,"PSOE",12
37,"37354",5182,3955,3915,50,40,"PSOE",743
37,"37252",116,89,89,0,0,"PSOE",4
37,"37003",119,93,90,0,3,"PSOE",22
37,"37320",93,71,71,1,0,"PSOE",17
37,"37014",1161,850,847,5,3,"PSOE",273
37,"37183",417,305,301,2,4,"PSOE",108
37,"37274",119148,88959,88152,853,807,"PSOE",17586
37,"37217",56,46,44,1,2,"PSOE",11
37,"37286",206,156,156,4,0,"PSOE",59
37,"37037",119,81,81,0,0,"PSOE",15
37,"37321",170,131,129,2,2,"PSOE",36
37,"37116",69,51,51,0,0,"PSOE",6
37,"37050",67,47,46,1,1,"PSOE",15
37,"37162",206,151,149,2,2,"PSOE",40
37,"37275",123,87,86,1,1,"PSOE",33
37,"37004",32,22,22,0,0,"PSOE",2
37,"37322",2472,1691,1676,12,15,"PSOE",417
37,"37218",71,33,33,2,0,"PSOE",6
37,"37334",79,42,42,1,0,"PSOE",16
37,"37254",183,153,149,0,4,"PSOE",32
37,"37265",217,180,178,2,2,"PSOE",83
37,"37117",1458,1075,1068,14,7,"PSOE",207
37,"37151",146,116,115,2,1,"PSOE",13
37,"37005",77,58,56,0,2,"PSOE",9
37,"37118",125,96,96,0,0,"PSOE",21
37,"37038",789,628,616,5,12,"PSOE",196
37,"37368",16,15,15,0,0,"PSOE",0
37,"37196",77,54,53,0,1,"PSOE",13
37,"37006",135,91,90,1,1,"PSOE",14
37,"37219",179,110,110,0,0,"PSOE",19
37,"37129",251,199,194,1,5,"PSOE",41
37,"37335",415,301,293,2,8,"PSOE",64
37,"37323",521,387,385,8,2,"PSOE",104
37,"37039",304,213,213,4,0,"PSOE",69
37,"37255",51,38,38,0,0,"PSOE",7
37,"37369",140,96,96,0,0,"PSOE",22
37,"37186",106,78,78,3,0,"PSOE",11
37,"37347",477,365,359,3,6,"PSOE",70
37,"37324",371,284,279,4,5,"PSOE",80
37,"37054",261,199,198,1,1,"PSOE",71
37,"37119",109,86,86,1,0,"PSOE",27
37,"37130",173,155,153,5,2,"PSOE",12
37,"37313",555,415,411,1,4,"PSOE",125
37,"37040",393,320,317,3,3,"PSOE",110
37,"37152",424,290,283,2,7,"PSOE",67
37,"37092",1731,1264,1250,11,14,"PSOE",195
37,"37222",97,66,66,1,0,"PSOE",10
37,"37007",439,321,313,4,8,"PSOE",90
37,"37359",184,131,129,0,2,"PSOE",21
37,"37256",220,158,157,1,1,"PSOE",48
37,"37325",91,68,63,0,5,"PSOE",12
37,"37348",113,91,91,1,0,"PSOE",8
37,"37120",99,77,76,1,1,"PSOE",15
37,"37081",933,720,714,4,6,"PSOE",270
37,"37008",4298,3312,3272,16,40,"PSOE",770
37,"37199",142,108,108,0,0,"PSOE",36
37,"37188",185,127,125,3,2,"PSOE",35
37,"37223",109,90,87,0,3,"PSOE",28
37,"37155",73,54,54,1,0,"PSOE",23
37,"37290",140,116,116,0,0,"PSOE",24
37,"37257",53,43,43,0,0,"PSOE",3
37,"37121",584,434,430,5,4,"PSOE",142
37,"37327",185,157,157,5,0,"PSOE",35
37,"37338",78,66,66,1,0,"PSOE",6
37,"37303",188,152,151,1,1,"PSOE",37
37,"37042",42,29,29,2,0,"PSOE",2
37,"37360",230,167,166,2,1,"PSOE",33
37,"37189",125,97,97,0,0,"PSOE",33
37,"37009",216,161,160,3,1,"PSOE",41
37,"37156",4310,3173,3126,27,47,"PSOE",707
37,"37328",189,142,140,0,2,"PSOE",38
37,"37224",210,183,179,2,4,"PSOE",22
37,"37044",470,353,341,1,12,"PSOE",76
37,"37122",202,158,156,3,2,"PSOE",57
37,"37259",45,30,30,0,0,"PSOE",3
37,"37212",111,83,83,1,0,"PSOE",14
37,"37010",956,716,708,3,8,"PSOE",194
37,"37270",190,142,139,1,3,"PSOE",33
37,"37201",262,179,177,0,2,"PSOE",39
37,"37292",103,72,72,1,0,"PSOE",8
37,"37225",106,94,92,0,2,"PSOE",16
37,"37190",219,167,167,0,0,"PSOE",40
37,"37329",36,28,28,0,0,"PSOE",0
37,"37123",182,141,138,0,3,"PSOE",15
37,"37157",77,62,62,0,0,"PSOE",28
37,"37045",27,20,20,0,0,"PSOE",5
37,"37011",122,91,89,0,2,"PSOE",28
37,"37168",443,319,311,2,8,"PSOE",77
37,"37134",230,175,173,1,2,"PSOE",65
37,"37293",118,84,84,0,0,"PSOE",21
37,"37363",120,98,94,0,4,"PSOE",36
37,"37374",1178,971,943,8,28,"PSOE",295
37,"37226",156,121,119,1,2,"PSOE",9
37,"37341",56,43,41,0,2,"PSOE",8
37,"37124",219,149,148,0,1,"PSOE",35
37,"37158",248,183,181,0,2,"PSOE",45
37,"37239",229,196,194,6,2,"PSOE",43
37,"37135",1211,932,925,10,7,"PSOE",243
37,"37330",335,262,258,4,4,"PSOE",72
37,"37100",81,68,67,1,1,"PSOE",1
37,"37261",227,165,161,2,4,"PSOE",30
37,"37272",136,97,96,0,1,"PSOE",32
37,"37051",80,54,53,0,1,"PSOE",20
37,"37375",705,593,582,11,11,"PSOE",249
37,"37090",52,38,36,0,2,"PSOE",5
37,"37163",42,33,33,0,0,"PSOE",0
37,"37087",855,681,676,8,5,"PSOE",75
37,"37047",167,83,83,0,0,"PSOE",17
37,"37170",1479,1055,1031,10,24,"PSOE",226
37,"37159",91,74,74,0,0,"PSOE",17
37,"37125",228,158,156,3,2,"PSOE",30
37,"37013",121,87,86,3,1,"PSOE",13
37,"37160",627,450,443,7,7,"PSOE",171
37,"37307",160,103,103,0,0,"PSOE",23
37,"37262",78,64,64,1,0,"PSOE",3
37,"37296",338,258,255,4,3,"PSOE",105
37,"37240",907,646,636,5,10,"PSOE",116
37,"37061",226,166,164,1,2,"PSOE",38
37,"37376",2251,1588,1568,9,20,"PSOE",304
37,"37102",411,291,289,3,2,"PSOE",66
37,"37088",204,152,152,3,0,"PSOE",51
37,"37161",138,109,107,0,2,"PSOE",23
37,"37127",221,158,158,4,0,"PSOE",50
37,"37049",147,98,98,2,0,"PSOE",26
37,"37377",249,199,195,3,4,"PSOE",41
37,"37309",45,28,28,0,0,"PSOE",3
37,"37230",221,167,167,2,0,"PSOE",56
37,"37366",43,27,27,0,0,"PSOE",7
37,"37298",184,125,125,1,0,"PSOE",33
37,"37264",67,43,43,0,0,"PSOE",7
37,"37172",878,580,576,3,4,"PSOE",109
37,"37089",67,50,49,0,1,"PSOE",9
37,"37333",225,143,142,4,1,"PSOE",27
37,"37139",205,163,162,2,1,"PSOE",23
37,"37344",246,184,183,1,1,"PSOE",59
37,"37268",116,71,70,0,1,"PSOE",10
37,"37015",222,145,143,3,2,"PSOE",37
37,"37016",573,451,447,3,4,"PSOE",95
37,"37104",27,21,21,0,0,"PSOE",8
37,"37242",91,71,71,0,0,"PSOE",20
37,"37128",264,211,201,4,10,"PSOE",51
37,"37206",94,71,71,4,0,"PSOE",17
37,"37147",191,141,136,0,5,"PSOE",41
37,"37367",199,160,158,7,2,"PSOE",22
37,"37349",112,83,82,0,1,"PSOE",8
37,"37177",298,223,221,1,2,"PSOE",40
37,"37232",390,349,348,0,1,"PSOE",63
37,"37174",1065,838,826,3,12,"PSOE",222
37,"37106",266,172,166,1,6,"PSOE",40
37,"37028",150,111,110,1,1,"PSOE",16
37,"37346",267,222,220,1,2,"PSOE",37
37,"37065",323,237,235,0,2,"PSOE",51
37,"37277",73,55,55,0,0,"PSOE",11
37,"37017",251,186,184,2,2,"PSOE",17
37,"37266",84,55,55,1,0,"PSOE",6
37,"37197",87,55,55,2,0,"PSOE",8
37,"37312",262,211,210,3,1,"PSOE",67
37,"37164",256,200,195,1,5,"PSOE",40
37,"37350",421,324,320,4,4,"PSOE",26
37,"37300",575,427,423,3,4,"PSOE",95
37,"37029",213,155,152,0,3,"PSOE",55
37,"37336",55,47,47,0,0,"PSOE",10
37,"37278",753,573,568,7,5,"PSOE",92
37,"37080",232,176,176,1,0,"PSOE",48
37,"37141",156,127,127,1,0,"PSOE",45
37,"37165",33,27,27,0,0,"PSOE",3
37,"37142",592,453,451,2,2,"PSOE",90
37,"37067",3125,2551,2523,22,28,"PSOE",405
37,"37131",190,140,139,0,1,"PSOE",27
37,"37018",105,80,80,1,0,"PSOE",26
37,"37370",337,258,255,3,3,"PSOE",40
37,"37267",199,151,147,2,4,"PSOE",46
37,"37154",141,116,112,0,4,"PSOE",18
37,"37169",176,139,137,0,2,"PSOE",45
37,"37019",151,114,111,0,3,"PSOE",8
37,"37023",1378,1116,1105,9,11,"PSOE",172
37,"37068",366,272,271,5,1,"PSOE",61
37,"37166",213,142,142,1,0,"PSOE",33
37,"37337",139,120,120,2,0,"PSOE",4
37,"37302",294,216,214,1,2,"PSOE",62
37,"37246",5335,4190,4152,41,38,"PSOE",1255
37,"37109",182,119,118,0,1,"PSOE",18
37,"37287",318,237,237,3,0,"PSOE",42
37,"37291",268,206,206,1,0,"PSOE",66
37,"37243",102,76,76,0,0,"PSOE",7
37,"37276",149,100,99,0,1,"PSOE",14
37,"37020",430,340,334,3,6,"PSOE",94
37,"37056",41,30,30,0,0,"PSOE",1
37,"37371",281,183,177,1,6,"PSOE",55
37,"37167",173,150,144,2,6,"PSOE",61
37,"37098",335,237,237,1,0,"PSOE",90
37,"37236",139,94,89,0,5,"PSOE",18
37,"37021",80,62,62,0,0,"PSOE",17
37,"37339",316,257,257,4,0,"PSOE",66
37,"37200",190,134,133,2,1,"PSOE",42
37,"37237",325,250,248,4,2,"PSOE",99
37,"37304",170,114,109,4,5,"PSOE",23
37,"37372",146,117,115,0,2,"PSOE",31
37,"37213",87,73,73,0,0,"PSOE",6
37,"37248",152,127,126,2,1,"PSOE",17
37,"37373",755,548,545,3,3,"PSOE",239
37,"37057",213,168,167,0,1,"PSOE",36
37,"37137",105,73,73,0,0,"PSOE",4
37,"37340",150,105,104,1,1,"PSOE",12
37,"37022",268,220,219,2,1,"PSOE",40
37,"37179",215,173,170,0,3,"PSOE",46
37,"37203",165,118,118,0,0,"PSOE",25
37,"37238",112,88,85,2,3,"PSOE",21
37,"37271",361,283,276,3,7,"PSOE",84
37,"37351",281,239,238,0,1,"PSOE",74
37,"37282",209,136,136,0,0,"PSOE",36
37,"37071",78,73,72,1,1,"PSOE",34
37,"37317",306,246,243,1,3,"PSOE",61
37,"37062",84,67,66,1,1,"PSOE",7
37,"37352",204,148,147,0,1,"PSOE",32
37,"37103",446,326,325,4,1,"PSOE",82
37,"37260",154,126,126,1,0,"PSOE",43
37,"37026",192,158,154,2,4,"PSOE",51
37,"37027",228,187,187,0,0,"PSOE",34
37,"37342",256,210,208,1,2,"PSOE",41
37,"37181",291,209,207,1,2,"PSOE",54
37,"37072",166,133,132,2,1,"PSOE",25
37,"37306",271,171,171,0,0,"PSOE",40
37,"37311",226,182,182,2,0,"PSOE",44
37,"37195",48,35,35,1,0,"PSOE",14
37,"37356",86,73,71,1,2,"PSOE",18
37,"37207",303,234,233,0,1,"PSOE",16
37,"37140",678,440,435,2,5,"PSOE",58
37,"37185",591,450,443,4,7,"PSOE",70
37,"37353",129,92,92,1,0,"PSOE",28
37,"37073",583,449,442,8,7,"PSOE",90
37,"37024",92,77,77,0,0,"PSOE",23
37,"37362",4592,3442,3403,48,39,"PSOE",487
37,"37060",245,192,192,0,0,"PSOE",41
37,"37126",30,24,24,0,0,"PSOE",3
37,"37091",176,114,113,2,1,"PSOE",21
37,"37221",434,328,323,2,5,"PSOE",119
37,"37204",280,214,211,1,3,"PSOE",43
37,"37133",108,82,79,4,3,"PSOE",15
37,"37193",399,279,278,6,1,"PSOE",94
37,"37208",81,49,48,0,1,"PSOE",3
37,"37025",258,223,221,2,2,"PSOE",62
37,"37175",407,316,314,5,2,"PSOE",62
37,"37343",62,49,49,0,0,"PSOE",4
37,"37285",412,311,305,2,6,"PSOE",87
37,"37235",223,168,163,1,5,"PSOE",43
37,"37150",43,35,35,0,0,"PSOE",0
37,"37138",199,155,154,4,1,"PSOE",43
37,"37380",55,46,46,2,0,"PSOE",13
37,"37310",180,129,128,2,1,"PSOE",59
37,"37205",233,201,197,1,4,"PSOE",64
37,"37194",252,191,190,2,1,"PSOE",60
37,"37030",84,68,66,0,2,"PSOE",11
37,"37234",357,224,222,1,2,"PSOE",77
37,"37033",98,63,63,0,0,"PSOE",10
37,"37279",763,572,562,11,10,"PSOE",141
37,"37211",223,163,163,4,0,"PSOE",23
37,"37096",220,174,174,5,0,"PSOE",31
37,"37079",74,64,63,0,1,"PSOE",6
37,"37379",173,134,134,2,0,"PSOE",44
37,"37253",135,110,110,1,0,"PSOE",23
37,"37082",799,570,560,1,10,"PSOE",186
37,"37184",345,247,244,1,3,"PSOE",69
37,"37192",353,245,242,2,3,"PSOE",29
37,"37110",117,92,89,1,3,"PSOE",20
37,"37245",345,252,246,7,6,"PSOE",88
37,"37299",221,170,163,1,7,"PSOE",29
37,"37069",976,713,699,9,14,"PSOE",171
37,"37143",385,301,299,1,2,"PSOE",91
37,"37382",180,133,133,4,0,"PSOE",47
37,"37031",365,258,257,1,1,"PSOE",47
37,"37244",134,91,90,1,1,"PSOE",7
37,"37263",348,252,251,1,1,"PSOE",71
37,"37032",543,411,410,1,1,"PSOE",68
37,"37052",274,197,197,2,0,"PSOE",60
37,"37269",452,328,328,2,0,"PSOE",101
37,"37281",37,34,33,0,1,"PSOE",14
37,"37202",978,773,763,7,10,"PSOE",142
37,"37233",65,45,45,0,0,"PSOE",20
37,"37077",260,234,230,0,4,"PSOE",104
37,"37316",751,584,577,5,7,"PSOE",94
37,"37288",258,211,210,7,1,"PSOE",36
37,"37145",257,190,187,0,3,"PSOE",73
37,"37358",168,136,135,2,1,"PSOE",30
37,"37059",124,100,98,0,2,"PSOE",37
37,"37209",406,281,280,7,1,"PSOE",108
37,"37314",87,74,72,0,2,"PSOE",5
37,"37191",116,78,76,0,2,"PSOE",22
37,"37112",161,115,114,0,1,"PSOE",38
37,"37381",139,98,92,0,6,"PSOE",13
37,"37294",11680,8850,8760,84,90,"PSOE",1629
37,"37289",240,182,182,2,0,"PSOE",35
37,"37058",61,43,42,0,1,"PSOE",14
37,"37301",73,62,62,0,0,"PSOE",13
37,"37355",189,147,146,1,1,"PSOE",28
37,"37046",11336,8300,8171,62,129,"PSOE",1850
37,"37249",44,33,33,1,0,"PSOE",4
37,"37132",351,272,269,2,3,"PSOE",94
37,"37247",199,162,154,3,8,"PSOE",28
37,"37083",179,159,159,0,0,"PSOE",50
37,"37280",79,50,50,0,0,"PSOE",7
37,"37228",367,301,299,1,2,"PSOE",110
37,"37101",163,122,122,2,0,"PSOE",16
37,"37085",4704,3475,3432,35,43,"PSOE",526
37,"37171",411,321,317,1,4,"PSOE",51
37,"37258",180,117,115,1,2,"PSOE",33
37,"37055",123,105,98,0,7,"PSOE",21
37,"37378",111,74,70,2,4,"PSOE",23
37,"37357",276,216,215,0,1,"PSOE",65
37,"37063",74,59,59,1,0,"PSOE",19
37,"37041",74,48,48,0,0,"PSOE",2
37,"37107",10855,7694,7598,96,96,"PSOE",1712
37,"37146",122,100,99,1,1,"PSOE",8
37,"37078",823,670,657,8,13,"PSOE",193
37,"37144",370,288,284,2,4,"PSOE",77
37,"37345",166,135,133,3,2,"PSOE",32
37,"37178",99,84,81,0,3,"PSOE",19
37,"37070",533,403,396,4,7,"PSOE",94
37,"37176",137,100,98,0,2,"PSOE",31
37,"37149",70,63,63,0,0,"PSOE",7
37,"37214",125,88,88,1,0,"PSOE",18
37,"37315",93,69,67,1,2,"PSOE",10
37,"37097",36,30,30,0,0,"PSOE",8
37,"37231",259,208,207,4,1,"PSOE",49
37,"37198",206,161,160,3,1,"PSOE",42
37,"37173",1526,1138,1125,5,13,"PSOE",313
37,"37108",101,81,79,2,2,"PSOE",21
37,"37241",172,128,126,1,2,"PSOE",24
37,"37229",143,102,102,1,0,"PSOE",12
37,"37099",73,45,45,2,0,"PSOE",9
37,"37305",216,170,169,2,1,"PSOE",30
37,"37187",565,431,426,4,5,"PSOE",160
37,"37086",98,80,80,2,0,"PSOE",16
37,"37361",84,56,55,0,1,"PSOE",7
35,"35004",38814,20869,20641,192,228,"PACMA",294
35,"35012",10331,5684,5610,32,74,"PACMA",53
35,"35002",23129,15904,15675,74,229,"PACMA",124
35,"35003",5125,2989,2929,21,60,"PACMA",18
35,"35028",9705,5552,5478,64,74,"PACMA",63
35,"35023",11680,8467,8295,75,172,"PACMA",58
35,"35015",9870,5451,5368,29,83,"PACMA",38
35,"35014",11169,6234,6107,59,127,"PACMA",72
35,"35006",30302,21967,21625,243,342,"PACMA",202
35,"35034",7707,3921,3872,30,49,"PACMA",42
35,"35007",515,332,330,2,2,"PACMA",1
35,"35018",12463,7628,7546,56,82,"PACMA",110
35,"35026",80806,53749,52665,450,1084,"PACMA",498
35,"35025",1801,1239,1216,9,23,"PACMA",4
35,"35001",4599,3455,3396,27,59,"PACMA",18
35,"35010",3548,2371,2336,20,35,"PACMA",22
35,"35017",25447,15415,15079,127,336,"PACMA",134
35,"35032",3432,2541,2498,19,43,"PACMA",13
35,"35011",23882,16369,16095,107,274,"PACMA",142
35,"35008",6109,4631,4542,37,89,"PACMA",27
35,"35027",10311,7497,7364,58,133,"PACMA",59
35,"35022",48059,30474,30134,219,340,"PACMA",351
35,"35009",19832,14305,14036,97,269,"PACMA",102
35,"35024",13621,8665,8555,76,110,"PACMA",105
35,"35005",1071,718,711,6,7,"PACMA",0
35,"35016",297974,198159,195935,1546,2224,"PACMA",2328
35,"35013",6609,4997,4881,51,116,"PACMA",19
35,"35021",14942,10691,10537,80,154,"PACMA",94
35,"35030",9205,5602,5501,58,101,"PACMA",35
35,"35029",4125,2545,2514,34,31,"PACMA",15
35,"35020",6054,4073,4018,26,55,"PACMA",26
35,"35031",7270,5184,5000,36,184,"PACMA",41
35,"35019",32253,19902,19621,126,281,"PACMA",211
35,"35033",6378,4412,4354,24,58,"PACMA",29
3,"3114",1568,1216,1203,8,13,"EUPV-UPeC",52
3,"3085",270,226,225,1,1,"EUPV-UPeC",7
3,"3007",168,142,138,0,4,"EUPV-UPeC",8
3,"3062",213,176,175,0,1,"EUPV-UPeC",1
3,"3109",2850,2301,2275,11,26,"EUPV-UPeC",42
3,"3013",1114,914,906,5,8,"EUPV-UPeC",19
3,"3029",242,186,183,1,3,"EUPV-UPeC",6
3,"3105",5387,4089,4017,21,72,"EUPV-UPeC",131
3,"3077",1374,1139,1126,11,13,"EUPV-UPeC",30
3,"3050",18601,13710,13610,61,100,"EUPV-UPeC",513
3,"3004",585,455,454,1,1,"EUPV-UPeC",14
3,"3117",370,325,322,0,3,"EUPV-UPeC",8
3,"3054",338,274,268,4,6,"EUPV-UPeC",2
3,"3132",536,426,423,0,3,"EUPV-UPeC",16
3,"3051",350,310,305,1,5,"EUPV-UPeC",11
3,"3018",12212,9129,9040,64,89,"EUPV-UPeC",387
3,"3115",248,219,219,2,0,"EUPV-UPeC",5
3,"3102",7271,5762,5687,46,75,"EUPV-UPeC",171
3,"3075",156,139,139,0,0,"EUPV-UPeC",1
3,"3048",4858,3785,3735,25,50,"EUPV-UPeC",111
3,"3064",5040,3887,3834,16,53,"EUPV-UPeC",67
3,"3063",26383,19376,19255,105,121,"EUPV-UPeC",742
3,"3100",508,446,442,1,4,"EUPV-UPeC",16
3,"3097",990,817,811,8,6,"EUPV-UPeC",27
3,"3020",102,79,79,0,0,"EUPV-UPeC",3
3,"3120",2416,1814,1783,13,31,"EUPV-UPeC",76
3,"3123",7472,5748,5680,38,68,"EUPV-UPeC",216
3,"3060",108,92,90,1,2,"EUPV-UPeC",0
3,"3086",153,134,134,1,0,"EUPV-UPeC",7
3,"3082",12542,8709,8597,48,112,"EUPV-UPeC",251
3,"3002",3610,2714,2682,18,32,"EUPV-UPeC",91
3,"3023",1410,1221,1201,8,20,"EUPV-UPeC",60
3,"3003",455,393,388,3,5,"EUPV-UPeC",10
3,"3090",17087,12723,12602,69,121,"EUPV-UPeC",542
3,"3055",5168,3949,3899,13,50,"EUPV-UPeC",101
3,"3068",46,41,40,0,1,"EUPV-UPeC",1
3,"3092",6749,5398,5342,40,56,"EUPV-UPeC",320
3,"3067",98,82,81,1,1,"EUPV-UPeC",1
3,"3024",3904,3109,3060,17,49,"EUPV-UPeC",53
3,"3066",42291,31010,30781,190,229,"EUPV-UPeC",1263
3,"3078",486,398,397,3,1,"EUPV-UPeC",5
3,"3031",41486,28059,27851,152,208,"EUPV-UPeC",759
3,"3056",8737,6809,6731,33,78,"EUPV-UPeC",392
3,"3112",653,522,517,2,5,"EUPV-UPeC",9
3,"3015",12544,9478,9388,58,90,"EUPV-UPeC",540
3,"3119",16534,12466,12363,69,103,"EUPV-UPeC",541
3,"3010",325,278,276,0,2,"EUPV-UPeC",7
3,"3133",41763,26236,26039,134,197,"EUPV-UPeC",735
3,"3098",507,403,394,3,9,"EUPV-UPeC",24
3,"3028",1006,833,823,1,10,"EUPV-UPeC",46
3,"3131",175,159,153,0,6,"EUPV-UPeC",4
3,"3107",2459,1807,1791,5,16,"EUPV-UPeC",77
3,"3074",1706,1400,1382,3,18,"EUPV-UPeC",36
3,"3047",9161,6622,6534,35,88,"EUPV-UPeC",241
3,"3070",2038,1526,1499,5,27,"EUPV-UPeC",33
3,"3016",94,79,79,0,0,"EUPV-UPeC",0
3,"3039",85,61,59,0,2,"EUPV-UPeC",2
3,"3904",1393,1065,1057,8,8,"EUPV-UPeC",14
3,"3096",5811,4539,4492,19,47,"EUPV-UPeC",238
3,"3140",26176,19795,19509,155,286,"EUPV-UPeC",866
3,"3057",191,148,148,2,0,"EUPV-UPeC",0
3,"3072",351,288,287,2,1,"EUPV-UPeC",13
3,"3083",5607,4160,4106,36,54,"EUPV-UPeC",148
3,"3058",4947,4015,3978,21,37,"EUPV-UPeC",106
3,"3129",1187,991,984,8,7,"EUPV-UPeC",32
3,"3137",653,516,515,5,1,"EUPV-UPeC",25
3,"3091",247,217,215,1,2,"EUPV-UPeC",4
3,"3094",9033,6702,6657,32,45,"EUPV-UPeC",173
3,"3053",7196,5800,5736,37,64,"EUPV-UPeC",222
3,"3021",5627,4691,4613,23,78,"EUPV-UPeC",118
3,"3061",1057,828,816,2,12,"EUPV-UPeC",24
3,"3099",42365,31612,31259,220,353,"EUPV-UPeC",668
3,"3106",596,503,501,1,2,"EUPV-UPeC",17
3,"3011",7729,5651,5595,29,56,"EUPV-UPeC",132
3,"3110",289,239,239,1,0,"EUPV-UPeC",8
3,"3012",1072,862,849,3,13,"EUPV-UPeC",14
3,"3046",1594,1185,1178,9,7,"EUPV-UPeC",37
3,"3130",47,30,30,0,0,"EUPV-UPeC",1
3,"3136",446,361,361,2,0,"EUPV-UPeC",10
3,"3036",91,80,79,2,1,"EUPV-UPeC",4
3,"3037",352,296,293,3,3,"EUPV-UPeC",12
3,"3005",7753,6158,6118,38,40,"EUPV-UPeC",130
3,"3044",4512,3639,3586,16,53,"EUPV-UPeC",69
3,"3103",278,240,237,1,3,"EUPV-UPeC",20
3,"3041",5945,4393,4344,28,49,"EUPV-UPeC",170
3,"3049",12082,9341,9236,69,105,"EUPV-UPeC",546
3,"3111",5411,4044,3967,14,77,"EUPV-UPeC",66
3,"3124",469,400,394,5,6,"EUPV-UPeC",24
3,"3081",1433,1130,1118,5,12,"EUPV-UPeC",33
3,"3001",337,289,286,3,3,"EUPV-UPeC",10
3,"3901",1129,855,853,5,2,"EUPV-UPeC",39
3,"3026",1224,970,949,6,21,"EUPV-UPeC",34
3,"3134",148,132,132,2,0,"EUPV-UPeC",2
3,"3071",3980,3134,3106,28,28,"EUPV-UPeC",113
3,"3122",42227,31379,31186,160,193,"EUPV-UPeC",1562
3,"3069",3060,2187,2168,9,19,"EUPV-UPeC",64
3,"3022",142,120,120,2,0,"EUPV-UPeC",2
3,"3076",8485,6251,6194,37,57,"EUPV-UPeC",303
3,"3118",2452,1732,1714,9,18,"EUPV-UPeC",31
3,"3038",358,292,285,2,7,"EUPV-UPeC",4
3,"3008",167,132,131,0,1,"EUPV-UPeC",2
3,"3052",969,804,794,6,10,"EUPV-UPeC",33
3,"3080",1299,1065,1036,3,29,"EUPV-UPeC",22
3,"3045",216,182,179,1,3,"EUPV-UPeC",4
3,"3032",106,90,89,1,1,"EUPV-UPeC",8
3,"3084",543,478,476,4,2,"EUPV-UPeC",17
3,"3009",46817,36581,36258,240,323,"EUPV-UPeC",2087
3,"3017",376,317,312,3,5,"EUPV-UPeC",15
3,"3027",159,135,132,0,3,"EUPV-UPeC",0
3,"3079",18235,14578,14388,114,190,"EUPV-UPeC",703
3,"3073",236,202,202,1,0,"EUPV-UPeC",8
3,"3059",20538,15653,15522,79,131,"EUPV-UPeC",496
3,"3030",513,432,424,0,8,"EUPV-UPeC",9
3,"3104",27134,21080,20902,156,178,"EUPV-UPeC",1062
3,"3125",346,263,262,0,1,"EUPV-UPeC",5
3,"3043",2900,2516,2483,18,33,"EUPV-UPeC",119
3,"3101",4765,3708,3659,13,49,"EUPV-UPeC",183
3,"3128",4097,2972,2942,12,30,"EUPV-UPeC",65
3,"3095",4602,3628,3605,27,23,"EUPV-UPeC",168
3,"3034",1367,1095,1079,4,16,"EUPV-UPeC",32
3,"3121",21269,14932,14795,78,137,"EUPV-UPeC",462
3,"3040",257,222,222,0,0,"EUPV-UPeC",1
3,"3006",497,401,393,4,8,"EUPV-UPeC",16
3,"3093",19661,15155,14988,84,167,"EUPV-UPeC",504
3,"3116",1159,892,886,2,6,"EUPV-UPeC",18
3,"3135",214,176,174,0,2,"EUPV-UPeC",16
3,"3902",10213,7091,6997,52,94,"EUPV-UPeC",112
3,"3903",2482,1945,1926,16,19,"EUPV-UPeC",32
3,"3042",1367,1045,1033,5,12,"EUPV-UPeC",19
3,"3139",22357,15787,15624,101,163,"EUPV-UPeC",584
3,"3113",4254,3159,3120,17,39,"EUPV-UPeC",93
3,"3127",352,279,277,1,2,"EUPV-UPeC",5
3,"3035",663,543,538,1,5,"EUPV-UPeC",19
3,"3065",166944,126831,126024,773,807,"EUPV-UPeC",3445
3,"3089",9599,7100,6980,39,120,"EUPV-UPeC",256
3,"3014",237548,173040,172027,866,1013,"EUPV-UPeC",6741
3,"3033",113,97,97,2,0,"EUPV-UPeC",1
3,"3019",15261,11921,11804,98,117,"EUPV-UPeC",641
3,"3025",1270,1003,996,3,7,"EUPV-UPeC",11
3,"3138",3154,2406,2378,10,28,"EUPV-UPeC",56
3,"3088",5498,4078,4030,42,48,"EUPV-UPeC",282
28,"28051",1542,1240,1232,5,8,"IU-UPeC",49
28,"28058",139289,108214,107323,612,891,"IU-UPeC",5721
28,"28176",12288,9809,9763,50,46,"IU-UPeC",241
28,"28018",3739,3071,3046,12,25,"IU-UPeC",159
28,"28024",152,129,128,1,1,"IU-UPeC",8
28,"28054",11166,8649,8584,36,65,"IU-UPeC",430
28,"28043",5922,4063,4008,29,55,"IU-UPeC",145
28,"28076",406,322,319,1,3,"IU-UPeC",13
28,"28015",18233,14725,14653,81,72,"IU-UPeC",590
28,"28135",971,740,735,4,5,"IU-UPeC",40
28,"28161",48368,37462,37161,190,301,"IU-UPeC",1753
28,"28023",4697,3835,3817,20,18,"IU-UPeC",209
28,"28153",703,510,507,2,3,"IU-UPeC",59
28,"28125",2965,2210,2188,13,22,"IU-UPeC",84
28,"28136",640,540,532,0,8,"IU-UPeC",21
28,"28084",15839,12028,11925,53,103,"IU-UPeC",668
28,"28005",134211,104575,103819,667,756,"IU-UPeC",5330
28,"28009",14046,11014,10932,51,82,"IU-UPeC",497
28,"28156",998,751,743,3,8,"IU-UPeC",30
28,"28036",2514,1974,1949,12,25,"IU-UPeC",168
28,"28074",138742,110456,109579,581,877,"IU-UPeC",6498
28,"28085",3908,3106,3078,7,28,"IU-UPeC",137
28,"28120",1217,918,904,4,14,"IU-UPeC",38
28,"28157",595,448,442,1,6,"IU-UPeC",6
28,"28108",3330,2536,2528,17,8,"IU-UPeC",119
28,"28063",252,195,194,2,1,"IU-UPeC",16
28,"28178",1066,850,846,2,4,"IU-UPeC",19
28,"28902",468,352,347,2,5,"IU-UPeC",30
28,"28027",1199,897,882,5,15,"IU-UPeC",49
28,"28021",544,387,387,2,0,"IU-UPeC",14
28,"28901",789,590,584,2,6,"IU-UPeC",33
28,"28171",4238,3002,2962,18,40,"IU-UPeC",87
28,"28016",80,57,57,0,0,"IU-UPeC",5
28,"28126",39,25,25,0,0,"IU-UPeC",0
28,"28066",7175,5598,5561,28,37,"IU-UPeC",182
28,"28163",438,357,354,1,3,"IU-UPeC",34
28,"28179",1441,1082,1071,7,11,"IU-UPeC",50
28,"28030",1716,1342,1316,2,26,"IU-UPeC",68
28,"28064",134,105,105,0,0,"IU-UPeC",9
28,"28152",16026,13269,13202,46,67,"IU-UPeC",491
28,"28007",124358,99423,98711,554,712,"IU-UPeC",5535
28,"28002",2966,2186,2175,9,11,"IU-UPeC",95
28,"28116",700,544,544,3,0,"IU-UPeC",22
28,"28146",1773,1274,1262,9,12,"IU-UPeC",29
28,"28164",2986,2281,2263,12,18,"IU-UPeC",80
28,"28082",5664,4526,4492,25,34,"IU-UPeC",255
28,"28065",125384,101604,100872,477,732,"IU-UPeC",7178
28,"28106",76612,56555,56006,346,549,"IU-UPeC",3554
28,"28022",32949,27473,27379,169,94,"IU-UPeC",832
28,"28001",64,48,48,3,0,"IU-UPeC",1
28,"28173",520,409,408,3,1,"IU-UPeC",9
28,"28165",1788,1332,1321,5,11,"IU-UPeC",34
28,"28087",3176,2545,2528,15,17,"IU-UPeC",106
28,"28034",352,270,269,1,1,"IU-UPeC",11
28,"28167",8308,6605,6545,35,60,"IU-UPeC",462
28,"28068",10928,8389,8315,43,74,"IU-UPeC",347
28,"28092",151511,117869,116968,641,901,"IU-UPeC",6118
28,"28113",34305,27077,26881,156,196,"IU-UPeC",1669
28,"28083",8880,6801,6759,47,42,"IU-UPeC",368
28,"28020",148,99,97,1,2,"IU-UPeC",4
28,"28114",149,103,103,1,0,"IU-UPeC",7
28,"28070",119,91,91,0,0,"IU-UPeC",6
28,"28095",1508,1177,1167,6,10,"IU-UPeC",56
28,"28099",1731,1283,1278,8,5,"IU-UPeC",54
28,"28137",1644,1301,1283,7,18,"IU-UPeC",57
28,"28140",2981,2383,2357,14,26,"IU-UPeC",88
28,"28093",2043,1681,1661,9,20,"IU-UPeC",63
28,"28019",1237,952,938,2,14,"IU-UPeC",49
28,"28148",85022,65597,65111,368,486,"IU-UPeC",3488
28,"28004",6179,4377,4345,15,32,"IU-UPeC",156
28,"28010",9853,7959,7914,35,45,"IU-UPeC",381
28,"28172",8965,7255,7219,44,36,"IU-UPeC",271
28,"28060",1509,1194,1183,8,11,"IU-UPeC",50
28,"28088",262,180,179,2,1,"IU-UPeC",12
28,"28169",1427,1164,1158,1,6,"IU-UPeC",46
28,"28078",36,34,34,0,0,"IU-UPeC",2
28,"28044",5766,4623,4584,22,39,"IU-UPeC",251
28,"28147",968,751,745,2,6,"IU-UPeC",30
28,"28130",28243,22649,22458,135,191,"IU-UPeC",1708
28,"28132",11645,8605,8520,55,85,"IU-UPeC",427
28,"28175",850,696,692,2,4,"IU-UPeC",37
28,"28055",899,682,676,4,6,"IU-UPeC",18
28,"28100",4169,3076,3048,12,28,"IU-UPeC",153
28,"28091",5436,3827,3786,23,41,"IU-UPeC",181
28,"28160",8227,6295,6251,26,44,"IU-UPeC",255
28,"28026",6237,4893,4853,32,40,"IU-UPeC",242
28,"28150",3084,2415,2381,13,34,"IU-UPeC",98
28,"28032",4749,3653,3607,19,46,"IU-UPeC",185
28,"28133",6002,4259,4204,12,55,"IU-UPeC",182
28,"28025",427,329,326,1,3,"IU-UPeC",7
28,"28048",499,406,401,2,5,"IU-UPeC",35
28,"28013",40409,30141,29905,164,236,"IU-UPeC",1392
28,"28158",662,545,543,3,2,"IU-UPeC",11
28,"28017",1210,954,943,6,11,"IU-UPeC",41
28,"28151",3143,2352,2314,6,38,"IU-UPeC",76
28,"28117",95,84,84,0,0,"IU-UPeC",6
28,"28011",445,339,338,0,1,"IU-UPeC",18
28,"28035",1362,1042,1033,3,9,"IU-UPeC",44
28,"28124",76,56,54,0,2,"IU-UPeC",6
28,"28134",60511,47566,47229,233,337,"IU-UPeC",2728
28,"28903",32480,27640,27525,161,115,"IU-UPeC",1586
28,"28028",1730,1347,1326,8,21,"IU-UPeC",121
28,"28067",4057,3220,3188,12,32,"IU-UPeC",178
28,"28102",881,659,650,3,9,"IU-UPeC",30
28,"28056",860,653,647,6,6,"IU-UPeC",39
28,"28050",4077,3032,3006,15,26,"IU-UPeC",109
28,"28057",1439,1125,1120,5,5,"IU-UPeC",50
28,"28086",5055,3627,3600,21,27,"IU-UPeC",120
28,"28094",825,636,634,3,2,"IU-UPeC",24
28,"28052",3883,2801,2758,18,43,"IU-UPeC",107
28,"28042",1153,882,874,5,8,"IU-UPeC",29
28,"28112",167,132,132,0,0,"IU-UPeC",1
28,"28079",2371327,1817203,1806970,9067,10233,"IU-UPeC",96366
28,"28089",3703,2961,2933,19,28,"IU-UPeC",104
28,"28045",33019,25531,25313,146,218,"IU-UPeC",1287
28,"28166",318,258,255,1,3,"IU-UPeC",13
28,"28041",4452,3572,3550,24,22,"IU-UPeC",160
28,"28090",8405,6792,6751,34,41,"IU-UPeC",422
28,"28014",32852,24749,24571,120,178,"IU-UPeC",1160
28,"28107",435,326,321,0,5,"IU-UPeC",15
28,"28047",40783,31308,31072,171,236,"IU-UPeC",1750
28,"28149",5653,4516,4469,19,47,"IU-UPeC",171
28,"28122",518,388,385,2,3,"IU-UPeC",23
28,"28115",60579,50819,50657,246,162,"IU-UPeC",1322
28,"28121",198,166,164,2,2,"IU-UPeC",1
28,"28006",78564,61796,61456,334,340,"IU-UPeC",2632
28,"28101",218,180,180,0,0,"IU-UPeC",10
28,"28008",1768,1293,1282,4,11,"IU-UPeC",50
28,"28003",181,141,141,3,0,"IU-UPeC",6
28,"28038",4935,3858,3815,17,43,"IU-UPeC",290
28,"28127",64513,53125,52932,300,193,"IU-UPeC",1692
28,"28061",21200,16698,16600,75,98,"IU-UPeC",777
28,"28046",4432,3562,3538,19,24,"IU-UPeC",186
28,"28096",18161,13784,13647,57,137,"IU-UPeC",536
28,"28097",124,85,84,1,1,"IU-UPeC",5
28,"28182",214,174,170,0,4,"IU-UPeC",15
28,"28143",70,59,59,1,0,"IU-UPeC",1
28,"28075",5581,4380,4350,15,30,"IU-UPeC",223
28,"28141",5806,4532,4486,24,46,"IU-UPeC",146
28,"28029",530,426,424,3,2,"IU-UPeC",24
28,"28071",60,47,46,0,1,"IU-UPeC",3
28,"28109",1591,1113,1111,3,2,"IU-UPeC",35
28,"28183",1050,770,763,2,7,"IU-UPeC",61
28,"28037",1566,1175,1168,5,7,"IU-UPeC",51
28,"28031",2055,1538,1519,4,19,"IU-UPeC",44
28,"28129",7913,6175,6124,30,51,"IU-UPeC",208
28,"28119",2074,1641,1625,9,16,"IU-UPeC",59
28,"28080",48226,39753,39570,172,183,"IU-UPeC",1198
28,"28039",130,97,97,0,0,"IU-UPeC",11
28,"28159",588,469,468,6,1,"IU-UPeC",8
28,"28155",507,420,420,0,0,"IU-UPeC",16
28,"28118",58,49,48,1,1,"IU-UPeC",3
28,"28104",13836,11414,11349,54,65,"IU-UPeC",444
28,"28053",6458,5299,5263,29,36,"IU-UPeC",229
28,"28069",54,43,43,1,0,"IU-UPeC",3
28,"28110",1949,1543,1525,2,18,"IU-UPeC",36
28,"28177",10192,8271,8234,51,37,"IU-UPeC",257
28,"28168",1226,910,900,1,10,"IU-UPeC",26
28,"28144",5929,4776,4744,29,32,"IU-UPeC",184
28,"28181",20344,16669,16572,95,97,"IU-UPeC",626
28,"28180",5242,4040,3999,11,41,"IU-UPeC",127
28,"28128",439,323,320,2,3,"IU-UPeC",9
28,"28162",2549,2039,2025,13,14,"IU-UPeC",76
28,"28040",15691,10833,10728,45,105,"IU-UPeC",706
28,"28174",1788,1277,1267,2,10,"IU-UPeC",23
28,"28123",56464,47181,46948,257,233,"IU-UPeC",4070
28,"28131",12971,9828,9755,57,73,"IU-UPeC",464
28,"28145",2370,1824,1809,12,15,"IU-UPeC",93
28,"28072",5657,4465,4441,20,24,"IU-UPeC",220
28,"28049",58688,48006,47660,286,346,"IU-UPeC",3273
28,"28154",5420,3966,3899,17,67,"IU-UPeC",160
28,"28111",592,489,483,0,6,"IU-UPeC",35
28,"28012",883,702,691,4,11,"IU-UPeC",26
28,"28059",4312,3256,3237,11,19,"IU-UPeC",150
28,"28062",308,244,241,3,3,"IU-UPeC",10
28,"28170",2486,1757,1740,9,17,"IU-UPeC",197
28,"28138",69,54,54,0,0,"IU-UPeC",3
28,"28033",3824,2854,2832,11,22,"IU-UPeC",83
28,"28073",12505,9485,9384,64,101,"IU-UPeC",470
3,"3129",1187,991,984,8,7,"VOX",3
3,"3114",1568,1216,1203,8,13,"VOX",1
3,"3038",358,292,285,2,7,"VOX",2
3,"3103",278,240,237,1,3,"VOX",1
3,"3086",153,134,134,1,0,"VOX",0
3,"3029",242,186,183,1,3,"VOX",0
3,"3030",513,432,424,0,8,"VOX",0
3,"3021",5627,4691,4613,23,78,"VOX",14
3,"3069",3060,2187,2168,9,19,"VOX",5
3,"3012",1072,862,849,3,13,"VOX",0
3,"3022",142,120,120,2,0,"VOX",0
3,"3070",2038,1526,1499,5,27,"VOX",5
3,"3102",7271,5762,5687,46,75,"VOX",14
3,"3124",469,400,394,5,6,"VOX",0
3,"3004",585,455,454,1,1,"VOX",0
3,"3061",1057,828,816,2,12,"VOX",1
3,"3018",12212,9129,9040,64,89,"VOX",24
3,"3010",325,278,276,0,2,"VOX",0
3,"3045",216,182,179,1,3,"VOX",0
3,"3077",1374,1139,1126,11,13,"VOX",4
3,"3902",10213,7091,6997,52,94,"VOX",33
3,"3062",213,176,175,0,1,"VOX",0
3,"3080",1299,1065,1036,3,29,"VOX",2
3,"3085",270,226,225,1,1,"VOX",0
3,"3112",653,522,517,2,5,"VOX",0
3,"3138",3154,2406,2378,10,28,"VOX",2
3,"3050",18601,13710,13610,61,100,"VOX",30
3,"3135",214,176,174,0,2,"VOX",0
3,"3075",156,139,139,0,0,"VOX",0
3,"3074",1706,1400,1382,3,18,"VOX",2
3,"3091",247,217,215,1,2,"VOX",0
3,"3119",16534,12466,12363,69,103,"VOX",36
3,"3028",1006,833,823,1,10,"VOX",6
3,"3005",7753,6158,6118,38,40,"VOX",39
3,"3023",1410,1221,1201,8,20,"VOX",2
3,"3123",7472,5748,5680,38,68,"VOX",3
3,"3090",17087,12723,12602,69,121,"VOX",21
3,"3084",543,478,476,4,2,"VOX",0
3,"3015",12544,9478,9388,58,90,"VOX",23
3,"3016",94,79,79,0,0,"VOX",3
3,"3007",168,142,138,0,4,"VOX",0
3,"3008",167,132,131,0,1,"VOX",0
3,"3048",4858,3785,3735,25,50,"VOX",9
3,"3082",12542,8709,8597,48,112,"VOX",13
3,"3002",3610,2714,2682,18,32,"VOX",1
3,"3034",1367,1095,1079,4,16,"VOX",3
3,"3031",41486,28059,27851,152,208,"VOX",63
3,"3137",653,516,515,5,1,"VOX",1
3,"3053",7196,5800,5736,37,64,"VOX",23
3,"3904",1393,1065,1057,8,8,"VOX",2
3,"3105",5387,4089,4017,21,72,"VOX",9
3,"3019",15261,11921,11804,98,117,"VOX",32
3,"3096",5811,4539,4492,19,47,"VOX",1
3,"3073",236,202,202,1,0,"VOX",0
3,"3067",98,82,81,1,1,"VOX",0
3,"3093",19661,15155,14988,84,167,"VOX",21
3,"3040",257,222,222,0,0,"VOX",1
3,"3139",22357,15787,15624,101,163,"VOX",38
3,"3060",108,92,90,1,2,"VOX",3
3,"3001",337,289,286,3,3,"VOX",0
3,"3039",85,61,59,0,2,"VOX",0
3,"3120",2416,1814,1783,13,31,"VOX",4
3,"3117",370,325,322,0,3,"VOX",0
3,"3071",3980,3134,3106,28,28,"VOX",6
3,"3116",1159,892,886,2,6,"VOX",3
3,"3109",2850,2301,2275,11,26,"VOX",5
3,"3099",42365,31612,31259,220,353,"VOX",103
3,"3054",338,274,268,4,6,"VOX",0
3,"3066",42291,31010,30781,190,229,"VOX",57
3,"3088",5498,4078,4030,42,48,"VOX",7
3,"3100",508,446,442,1,4,"VOX",1
3,"3058",4947,4015,3978,21,37,"VOX",13
3,"3068",46,41,40,0,1,"VOX",0
3,"3136",446,361,361,2,0,"VOX",1
3,"3131",175,159,153,0,6,"VOX",0
3,"3078",486,398,397,3,1,"VOX",0
3,"3020",102,79,79,0,0,"VOX",1
3,"3047",9161,6622,6534,35,88,"VOX",8
3,"3049",12082,9341,9236,69,105,"VOX",16
3,"3009",46817,36581,36258,240,323,"VOX",85
3,"3092",6749,5398,5342,40,56,"VOX",12
3,"3024",3904,3109,3060,17,49,"VOX",9
3,"3026",1224,970,949,6,21,"VOX",0
3,"3101",4765,3708,3659,13,49,"VOX",0
3,"3041",5945,4393,4344,28,49,"VOX",4
3,"3042",1367,1045,1033,5,12,"VOX",1
3,"3113",4254,3159,3120,17,39,"VOX",9
3,"3037",352,296,293,3,3,"VOX",0
3,"3122",42227,31379,31186,160,193,"VOX",62
3,"3095",4602,3628,3605,27,23,"VOX",4
3,"3104",27134,21080,20902,156,178,"VOX",22
3,"3079",18235,14578,14388,114,190,"VOX",20
3,"3121",21269,14932,14795,78,137,"VOX",31
3,"3043",2900,2516,2483,18,33,"VOX",5
3,"3118",2452,1732,1714,9,18,"VOX",3
3,"3130",47,30,30,0,0,"VOX",0
3,"3025",1270,1003,996,3,7,"VOX",4
3,"3056",8737,6809,6731,33,78,"VOX",17
3,"3094",9033,6702,6657,32,45,"VOX",13
3,"3098",507,403,394,3,9,"VOX",0
3,"3036",91,80,79,2,1,"VOX",0
3,"3055",5168,3949,3899,13,50,"VOX",15
3,"3063",26383,19376,19255,105,121,"VOX",23
3,"3059",20538,15653,15522,79,131,"VOX",74
3,"3017",376,317,312,3,5,"VOX",0
3,"3107",2459,1807,1791,5,16,"VOX",6
3,"3903",2482,1945,1926,16,19,"VOX",9
3,"3076",8485,6251,6194,37,57,"VOX",8
3,"3052",969,804,794,6,10,"VOX",0
3,"3072",351,288,287,2,1,"VOX",2
3,"3035",663,543,538,1,5,"VOX",0
3,"3064",5040,3887,3834,16,53,"VOX",9
3,"3014",237548,173040,172027,866,1013,"VOX",554
3,"3128",4097,2972,2942,12,30,"VOX",12
3,"3106",596,503,501,1,2,"VOX",1
3,"3057",191,148,148,2,0,"VOX",1
3,"3044",4512,3639,3586,16,53,"VOX",9
3,"3140",26176,19795,19509,155,286,"VOX",52
3,"3132",536,426,423,0,3,"VOX",1
3,"3006",497,401,393,4,8,"VOX",1
3,"3065",166944,126831,126024,773,807,"VOX",257
3,"3032",106,90,89,1,1,"VOX",4
3,"3115",248,219,219,2,0,"VOX",0
3,"3111",5411,4044,3967,14,77,"VOX",9
3,"3110",289,239,239,1,0,"VOX",0
3,"3125",346,263,262,0,1,"VOX",0
3,"3013",1114,914,906,5,8,"VOX",3
3,"3134",148,132,132,2,0,"VOX",1
3,"3046",1594,1185,1178,9,7,"VOX",1
3,"3083",5607,4160,4106,36,54,"VOX",13
3,"3003",455,393,388,3,5,"VOX",1
3,"3033",113,97,97,2,0,"VOX",0
3,"3011",7729,5651,5595,29,56,"VOX",22
3,"3027",159,135,132,0,3,"VOX",0
3,"3081",1433,1130,1118,5,12,"VOX",0
3,"3089",9599,7100,6980,39,120,"VOX",9
3,"3097",990,817,811,8,6,"VOX",1
3,"3051",350,310,305,1,5,"VOX",0
3,"3127",352,279,277,1,2,"VOX",0
3,"3133",41763,26236,26039,134,197,"VOX",102
3,"3901",1129,855,853,5,2,"VOX",1
3,"3122",42227,31379,31186,160,193,"PCPE",64
3,"3130",47,30,30,0,0,"PCPE",0
3,"3006",497,401,393,4,8,"PCPE",1
3,"3081",1433,1130,1118,5,12,"PCPE",1
3,"3012",1072,862,849,3,13,"PCPE",0
3,"3095",4602,3628,3605,27,23,"PCPE",6
3,"3059",20538,15653,15522,79,131,"PCPE",17
3,"3007",168,142,138,0,4,"PCPE",0
3,"3017",376,317,312,3,5,"PCPE",2
3,"3111",5411,4044,3967,14,77,"PCPE",2
3,"3080",1299,1065,1036,3,29,"PCPE",1
3,"3045",216,182,179,1,3,"PCPE",0
3,"3134",148,132,132,2,0,"PCPE",1
3,"3068",46,41,40,0,1,"PCPE",0
3,"3119",16534,12466,12363,69,103,"PCPE",23
3,"3104",27134,21080,20902,156,178,"PCPE",29
3,"3039",85,61,59,0,2,"PCPE",0
3,"3139",22357,15787,15624,101,163,"PCPE",39
3,"3078",486,398,397,3,1,"PCPE",1
3,"3137",653,516,515,5,1,"PCPE",0
3,"3118",2452,1732,1714,9,18,"PCPE",5
3,"3067",98,82,81,1,1,"PCPE",0
3,"3128",4097,2972,2942,12,30,"PCPE",5
3,"3114",1568,1216,1203,8,13,"PCPE",3
3,"3066",42291,31010,30781,190,229,"PCPE",40
3,"3020",102,79,79,0,0,"PCPE",0
3,"3001",337,289,286,3,3,"PCPE",0
3,"3031",41486,28059,27851,152,208,"PCPE",55
3,"3021",5627,4691,4613,23,78,"PCPE",7
3,"3138",3154,2406,2378,10,28,"PCPE",1
3,"3057",191,148,148,2,0,"PCPE",1
3,"3014",237548,173040,172027,866,1013,"PCPE",378
3,"3904",1393,1065,1057,8,8,"PCPE",1
3,"3069",3060,2187,2168,9,19,"PCPE",3
3,"3072",351,288,287,2,1,"PCPE",0
3,"3120",2416,1814,1783,13,31,"PCPE",4
3,"3075",156,139,139,0,0,"PCPE",2
3,"3902",10213,7091,6997,52,94,"PCPE",8
3,"3125",346,263,262,0,1,"PCPE",0
3,"3117",370,325,322,0,3,"PCPE",0
3,"3089",9599,7100,6980,39,120,"PCPE",6
3,"3129",1187,991,984,8,7,"PCPE",2
3,"3060",108,92,90,1,2,"PCPE",0
3,"3029",242,186,183,1,3,"PCPE",0
3,"3062",213,176,175,0,1,"PCPE",0
3,"3015",12544,9478,9388,58,90,"PCPE",16
3,"3013",1114,914,906,5,8,"PCPE",2
3,"3064",5040,3887,3834,16,53,"PCPE",2
3,"3056",8737,6809,6731,33,78,"PCPE",12
3,"3002",3610,2714,2682,18,32,"PCPE",13
3,"3026",1224,970,949,6,21,"PCPE",2
3,"3034",1367,1095,1079,4,16,"PCPE",1
3,"3042",1367,1045,1033,5,12,"PCPE",1
3,"3136",446,361,361,2,0,"PCPE",4
3,"3102",7271,5762,5687,46,75,"PCPE",10
3,"3047",9161,6622,6534,35,88,"PCPE",15
3,"3030",513,432,424,0,8,"PCPE",2
3,"3099",42365,31612,31259,220,353,"PCPE",70
3,"3022",142,120,120,2,0,"PCPE",0
3,"3116",1159,892,886,2,6,"PCPE",5
3,"3096",5811,4539,4492,19,47,"PCPE",12
3,"3053",7196,5800,5736,37,64,"PCPE",12
3,"3132",536,426,423,0,3,"PCPE",2
3,"3083",5607,4160,4106,36,54,"PCPE",5
3,"3074",1706,1400,1382,3,18,"PCPE",1
3,"3901",1129,855,853,5,2,"PCPE",0
3,"3094",9033,6702,6657,32,45,"PCPE",12
3,"3041",5945,4393,4344,28,49,"PCPE",3
3,"3036",91,80,79,2,1,"PCPE",0
3,"3131",175,159,153,0,6,"PCPE",0
3,"3135",214,176,174,0,2,"PCPE",0
3,"3009",46817,36581,36258,240,323,"PCPE",83
3,"3121",21269,14932,14795,78,137,"PCPE",16
3,"3105",5387,4089,4017,21,72,"PCPE",4
3,"3123",7472,5748,5680,38,68,"PCPE",18
3,"3103",278,240,237,1,3,"PCPE",0
3,"3025",1270,1003,996,3,7,"PCPE",3
3,"3100",508,446,442,1,4,"PCPE",1
3,"3023",1410,1221,1201,8,20,"PCPE",1
3,"3018",12212,9129,9040,64,89,"PCPE",13
3,"3079",18235,14578,14388,114,190,"PCPE",67
3,"3077",1374,1139,1126,11,13,"PCPE",2
3,"3088",5498,4078,4030,42,48,"PCPE",12
3,"3903",2482,1945,1926,16,19,"PCPE",1
3,"3113",4254,3159,3120,17,39,"PCPE",0
3,"3076",8485,6251,6194,37,57,"PCPE",3
3,"3027",159,135,132,0,3,"PCPE",0
3,"3109",2850,2301,2275,11,26,"PCPE",4
3,"3049",12082,9341,9236,69,105,"PCPE",19
3,"3033",113,97,97,2,0,"PCPE",0
3,"3091",247,217,215,1,2,"PCPE",0
3,"3082",12542,8709,8597,48,112,"PCPE",15
3,"3063",26383,19376,19255,105,121,"PCPE",40
3,"3028",1006,833,823,1,10,"PCPE",1
3,"3055",5168,3949,3899,13,50,"PCPE",0
3,"3005",7753,6158,6118,38,40,"PCPE",22
3,"3101",4765,3708,3659,13,49,"PCPE",7
3,"3054",338,274,268,4,6,"PCPE",0
3,"3019",15261,11921,11804,98,117,"PCPE",26
3,"3084",543,478,476,4,2,"PCPE",0
3,"3073",236,202,202,1,0,"PCPE",0
3,"3058",4947,4015,3978,21,37,"PCPE",13
3,"3004",585,455,454,1,1,"PCPE",0
3,"3070",2038,1526,1499,5,27,"PCPE",2
3,"3037",352,296,293,3,3,"PCPE",1
3,"3092",6749,5398,5342,40,56,"PCPE",9
3,"3050",18601,13710,13610,61,100,"PCPE",31
3,"3093",19661,15155,14988,84,167,"PCPE",26
3,"3071",3980,3134,3106,28,28,"PCPE",5
3,"3003",455,393,388,3,5,"PCPE",0
3,"3140",26176,19795,19509,155,286,"PCPE",33
3,"3065",166944,126831,126024,773,807,"PCPE",220
3,"3106",596,503,501,1,2,"PCPE",0
3,"3086",153,134,134,1,0,"PCPE",0
3,"3032",106,90,89,1,1,"PCPE",0
3,"3112",653,522,517,2,5,"PCPE",0
3,"3124",469,400,394,5,6,"PCPE",0
3,"3090",17087,12723,12602,69,121,"PCPE",23
3,"3035",663,543,538,1,5,"PCPE",2
3,"3052",969,804,794,6,10,"PCPE",0
3,"3133",41763,26236,26039,134,197,"PCPE",70
3,"3046",1594,1185,1178,9,7,"PCPE",0
3,"3040",257,222,222,0,0,"PCPE",0
3,"3127",352,279,277,1,2,"PCPE",0
3,"3008",167,132,131,0,1,"PCPE",1
3,"3061",1057,828,816,2,12,"PCPE",0
3,"3024",3904,3109,3060,17,49,"PCPE",4
3,"3044",4512,3639,3586,16,53,"PCPE",0
3,"3097",990,817,811,8,6,"PCPE",4
3,"3010",325,278,276,0,2,"PCPE",0
3,"3043",2900,2516,2483,18,33,"PCPE",2
3,"3011",7729,5651,5595,29,56,"PCPE",7
3,"3098",507,403,394,3,9,"PCPE",0
3,"3016",94,79,79,0,0,"PCPE",0
3,"3115",248,219,219,2,0,"PCPE",0
3,"3110",289,239,239,1,0,"PCPE",0
3,"3085",270,226,225,1,1,"PCPE",3
3,"3038",358,292,285,2,7,"PCPE",0
3,"3051",350,310,305,1,5,"PCPE",2
3,"3048",4858,3785,3735,25,50,"PCPE",4
3,"3107",2459,1807,1791,5,16,"PCPE",1
52,"52001",53255,28182,27819,299,363,"PACMA",313
15,"15031",23321,17319,17152,218,167,"C's",2230
15,"15027",1540,1224,1203,6,21,"C's",121
15,"15009",10780,8075,7957,70,118,"C's",737
15,"15082",15162,11273,11134,135,139,"C's",1363
15,"15048",4855,3582,3534,41,48,"C's",321
15,"15006",5353,3534,3469,49,65,"C's",266
15,"15073",21884,14792,14587,149,205,"C's",1726
15,"15053",7783,5386,5314,47,72,"C's",293
15,"15013",6126,4315,4257,43,58,"C's",440
15,"15077",8303,5648,5544,57,104,"C's",441
15,"15084",3312,2361,2326,28,35,"C's",127
15,"15057",12169,8853,8729,88,124,"C's",768
15,"15038",2236,1556,1530,18,26,"C's",81
15,"15045",3803,2382,2354,15,28,"C's",116
15,"15028",1415,1085,1070,10,15,"C's",67
15,"15040",2763,2050,2017,10,33,"C's",110
15,"15044",1309,955,941,5,14,"C's",51
15,"15036",58409,40932,40506,484,426,"C's",4165
15,"15087",5804,3942,3901,49,41,"C's",309
15,"15035",11517,8305,8192,144,113,"C's",629
15,"15050",1843,1089,1070,19,19,"C's",44
15,"15021",5099,3673,3611,43,62,"C's",317
15,"15015",2840,2126,2100,21,26,"C's",154
15,"15020",3844,2651,2629,17,22,"C's",162
15,"15039",1271,935,917,8,18,"C's",46
15,"15012",3666,2787,2721,40,66,"C's",238
15,"15067",8073,6067,6000,45,67,"C's",468
15,"15060",5780,4245,4167,48,78,"C's",409
15,"15010",1913,1355,1338,21,17,"C's",53
15,"15024",4412,3325,3278,35,47,"C's",219
15,"15051",4651,3343,3297,38,46,"C's",258
15,"15069",6785,5107,5032,54,75,"C's",347
15,"15003",1818,1326,1302,18,24,"C's",70
15,"15023",6481,4658,4595,44,63,"C's",415
15,"15059",10406,7710,7553,91,157,"C's",550
15,"15066",4039,2950,2894,34,56,"C's",226
15,"15011",15463,11105,10890,92,215,"C's",1163
15,"15041",9627,7409,7291,79,118,"C's",650
15,"15078",78093,58164,57487,673,677,"C's",6083
15,"15033",2489,1953,1931,13,22,"C's",110
15,"15088",3550,2398,2372,18,26,"C's",191
15,"15076",2649,1827,1802,24,25,"C's",117
15,"15055",4618,3208,3159,49,49,"C's",227
15,"15083",1100,809,795,5,14,"C's",26
15,"15062",5936,4047,3993,31,54,"C's",258
15,"15004",4855,3594,3535,28,59,"C's",316
15,"15007",3352,2469,2453,24,16,"C's",139
15,"15089",4317,3238,3188,24,50,"C's",264
15,"15093",4265,2856,2814,35,42,"C's",192
15,"15058",27623,21002,20788,257,214,"C's",2912
15,"15001",4805,3466,3419,45,47,"C's",352
15,"15901",3595,2401,2374,30,27,"C's",156
15,"15008",5650,4239,4175,42,64,"C's",438
15,"15064",2207,1680,1650,22,30,"C's",147
15,"15091",1119,807,784,12,23,"C's",49
15,"15074",4061,2983,2947,24,36,"C's",249
15,"15071",7965,5559,5483,37,76,"C's",407
15,"15052",4351,3122,3063,26,59,"C's",151
15,"15030",200245,148692,147426,1699,1266,"C's",16679
15,"15005",24459,16742,16482,215,260,"C's",1846
15,"15049",1099,765,755,12,10,"C's",39
15,"15070",9117,6514,6390,98,124,"C's",368
15,"15080",1760,1215,1197,11,18,"C's",65
15,"15042",3060,2170,2127,21,43,"C's",155
15,"15054",32177,22065,21778,349,287,"C's",2484
15,"15902",4660,3352,3296,30,56,"C's",266
15,"15019",25902,18111,17866,232,245,"C's",1722
15,"15092",6523,4518,4449,54,69,"C's",213
15,"15068",5096,3518,3476,39,42,"C's",229
15,"15034",2897,1931,1909,14,22,"C's",89
15,"15056",5757,4167,4108,43,59,"C's",436
15,"15014",4034,2809,2757,34,52,"C's",211
15,"15061",5646,3945,3894,35,51,"C's",269
15,"15090",1182,868,861,13,7,"C's",40
15,"15032",3455,2438,2391,26,47,"C's",158
15,"15081",1042,819,814,12,5,"C's",29
15,"15029",5761,3994,3928,47,66,"C's",234
15,"15022",5817,4026,3981,29,45,"C's",273
15,"15085",3346,2365,2311,26,54,"C's",148
15,"15016",4806,3291,3222,21,69,"C's",165
15,"15086",2918,2109,2077,19,32,"C's",151
15,"15002",22929,16941,16742,205,199,"C's",2285
15,"15017",19380,14272,14098,156,174,"C's",1802
15,"15072",9626,7024,6920,52,104,"C's",432
15,"15018",1156,817,806,7,11,"C's",42
15,"15046",6345,4625,4532,53,93,"C's",331
15,"15037",4087,2775,2733,18,42,"C's",156
15,"15075",12279,9076,8952,117,124,"C's",1215
15,"15079",1562,1092,1075,16,17,"C's",45
15,"15043",5147,3834,3764,36,70,"C's",272
15,"15025",1069,662,654,5,8,"C's",50
15,"15065",7345,5517,5412,46,105,"C's",492
15,"15047",2463,1669,1633,21,36,"C's",70
29,"29015",31884,23160,22943,188,217,"PCPE",32
29,"29020",3265,2531,2504,17,27,"PCPE",3
29,"29080",6704,4812,4766,44,46,"PCPE",12
29,"29022",185,143,143,1,0,"PCPE",0
29,"29025",39210,26938,26747,160,191,"PCPE",32
29,"29004",328,240,238,2,2,"PCPE",0
29,"29093",2235,1689,1667,12,22,"PCPE",3
29,"29001",4196,3276,3253,26,23,"PCPE",10
29,"29038",17555,11638,11562,124,76,"PCPE",7
29,"29902",2560,1735,1709,13,26,"PCPE",4
29,"29065",194,134,134,1,0,"PCPE",0
29,"29011",2920,1962,1946,5,16,"PCPE",3
29,"29003",1002,777,769,1,8,"PCPE",2
29,"29061",1018,833,820,4,13,"PCPE",1
29,"29090",1704,1174,1165,10,9,"PCPE",0
29,"29023",2047,1385,1369,2,16,"PCPE",0
29,"29056",1107,815,807,8,8,"PCPE",0
29,"29062",658,564,561,0,3,"PCPE",0
29,"29017",6610,5001,4938,25,63,"PCPE",10
29,"29074",785,612,611,4,1,"PCPE",1
29,"29014",219,138,138,1,0,"PCPE",0
29,"29019",888,675,672,0,3,"PCPE",0
29,"29012",9765,7029,6944,58,85,"PCPE",5
29,"29013",1612,1282,1272,6,10,"PCPE",2
29,"29081",258,205,200,1,5,"PCPE",0
29,"29047",1131,927,914,4,13,"PCPE",1
29,"29066",346,252,251,2,1,"PCPE",0
29,"29046",2690,1974,1954,17,20,"PCPE",0
29,"29092",567,423,415,4,8,"PCPE",1
29,"29027",2343,1737,1722,6,15,"PCPE",1
29,"29029",420,322,315,4,7,"PCPE",0
29,"29064",506,372,365,2,7,"PCPE",0
29,"29050",425,313,309,1,4,"PCPE",0
29,"29076",2163,1508,1482,8,26,"PCPE",1
29,"29039",2662,1948,1931,22,17,"PCPE",12
29,"29033",1132,808,804,2,4,"PCPE",4
29,"29051",40201,27168,26842,229,326,"PCPE",31
29,"29031",1633,1115,1106,6,9,"PCPE",2
29,"29079",2444,1880,1846,3,34,"PCPE",3
29,"29018",2026,1560,1519,15,41,"PCPE",4
29,"29070",39913,26993,26751,203,242,"PCPE",26
29,"29028",1249,881,881,4,0,"PCPE",0
29,"29042",14078,9890,9776,75,114,"PCPE",10
29,"29010",1667,1336,1310,1,26,"PCPE",0
29,"29035",1587,1218,1208,0,10,"PCPE",3
29,"29034",466,361,359,0,2,"PCPE",0
29,"29049",2987,2204,2185,25,19,"PCPE",4
29,"29044",811,557,556,3,1,"PCPE",1
29,"29089",3254,2465,2438,10,27,"PCPE",6
29,"29008",14541,9954,9820,90,134,"PCPE",8
29,"29097",4117,2996,2947,43,49,"PCPE",3
29,"29100",2437,1775,1760,12,15,"PCPE",4
29,"29903",525,394,389,2,5,"PCPE",0
29,"29045",1685,1232,1223,4,9,"PCPE",0
29,"29096",2806,2065,2034,19,31,"PCPE",4
29,"29099",960,741,734,3,7,"PCPE",1
29,"29040",1964,1321,1301,12,20,"PCPE",3
29,"29063",336,255,251,2,4,"PCPE",1
29,"29087",380,283,276,1,7,"PCPE",0
29,"29060",706,524,516,0,8,"PCPE",1
29,"29057",376,285,284,2,1,"PCPE",0
29,"29021",162,114,107,13,7,"PCPE",0
29,"29072",3250,2466,2434,11,32,"PCPE",1
29,"29085",151,99,98,1,1,"PCPE",0
29,"29901",43601,30325,30130,188,195,"PCPE",32
29,"29073",1560,1126,1120,5,6,"PCPE",2
29,"29086",795,497,490,3,7,"PCPE",0
29,"29016",253,188,188,1,0,"PCPE",0
29,"29068",6885,4580,4511,43,69,"PCPE",4
29,"29006",680,482,474,3,8,"PCPE",1
29,"29071",938,640,633,6,7,"PCPE",2
29,"29005",4342,2946,2908,22,38,"PCPE",6
29,"29037",212,166,165,1,1,"PCPE",0
29,"29054",41888,29228,29022,205,206,"PCPE",19
29,"29048",1428,1168,1155,9,13,"PCPE",0
29,"29094",57313,39393,39052,280,341,"PCPE",48
29,"29036",636,481,475,3,6,"PCPE",4
29,"29009",1477,1113,1100,3,13,"PCPE",1
29,"29098",1257,991,977,12,14,"PCPE",2
29,"29904",428,363,360,2,3,"PCPE",0
29,"29088",2720,1930,1883,21,47,"PCPE",2
29,"29084",27393,19096,18886,192,210,"PCPE",20
29,"29083",2114,1587,1568,10,19,"PCPE",6
29,"29002",1203,855,842,6,13,"PCPE",1
29,"29055",1808,1415,1396,13,19,"PCPE",0
29,"29095",3350,2523,2467,17,56,"PCPE",8
29,"29032",6708,5341,5265,26,76,"PCPE",21
29,"29069",85333,56398,55854,443,544,"PCPE",97
29,"29007",27319,19557,19395,179,162,"PCPE",19
29,"29082",31505,23154,22990,127,164,"PCPE",24
29,"29058",1463,986,975,6,11,"PCPE",5
29,"29052",226,155,152,0,3,"PCPE",0
29,"29043",2503,1671,1638,17,33,"PCPE",2
29,"29026",1065,776,766,4,10,"PCPE",0
29,"29053",1702,1178,1160,17,18,"PCPE",0
29,"29024",393,271,256,4,15,"PCPE",0
29,"29030",809,653,651,2,2,"PCPE",0
29,"29091",8966,6437,6346,57,91,"PCPE",7
29,"29059",2590,2100,2058,11,42,"PCPE",1
29,"29067",424770,295944,294094,2117,1850,"PCPE",414
29,"29077",208,156,153,0,3,"PCPE",0
29,"29041",3146,2251,2216,26,35,"PCPE",4
29,"29075",12952,8681,8619,55,62,"PCPE",5
48,"48040",1299,896,884,5,12,"PODEMOS-AHA",191
48,"48905",2565,1882,1847,2,35,"PODEMOS-AHA",365
48,"48087",429,346,343,1,3,"PODEMOS-AHA",57
48,"48058",972,691,687,4,4,"PODEMOS-AHA",114
48,"48074",3333,2467,2428,20,39,"PODEMOS-AHA",551
48,"48084",22577,15689,15540,108,149,"PODEMOS-AHA",5168
48,"48023",594,470,468,4,2,"PODEMOS-AHA",57
48,"48056",978,733,732,7,1,"PODEMOS-AHA",186
48,"48003",14338,10497,10414,76,83,"PODEMOS-AHA",2508
48,"48024",1003,775,771,5,4,"PODEMOS-AHA",79
48,"48008",617,433,424,6,9,"PODEMOS-AHA",90
48,"48001",5832,4191,4166,37,25,"PODEMOS-AHA",1027
48,"48076",314,237,237,4,0,"PODEMOS-AHA",28
48,"48049",548,433,431,0,2,"PODEMOS-AHA",53
48,"48901",4775,3602,3573,35,29,"PODEMOS-AHA",939
48,"48012",2041,1571,1553,11,18,"PODEMOS-AHA",259
48,"48907",355,283,282,2,1,"PODEMOS-AHA",39
48,"48085",10301,7458,7407,50,51,"PODEMOS-AHA",2296
48,"48038",1122,834,824,0,10,"PODEMOS-AHA",156
48,"48036",24144,17085,16954,117,131,"PODEMOS-AHA",4812
48,"48013",79984,56928,56516,383,412,"PODEMOS-AHA",18146
48,"48094",3193,2210,2200,18,10,"PODEMOS-AHA",342
48,"48061",762,584,581,4,3,"PODEMOS-AHA",117
48,"48032",5735,4173,4151,32,22,"PODEMOS-AHA",735
48,"48906",775,579,574,0,5,"PODEMOS-AHA",76
48,"48904",3504,2671,2650,18,21,"PODEMOS-AHA",567
48,"48047",161,112,112,0,0,"PODEMOS-AHA",16
48,"48069",12765,8985,8910,58,75,"PODEMOS-AHA",2035
48,"48010",457,311,307,1,4,"PODEMOS-AHA",47
48,"48096",6608,5071,5011,43,60,"PODEMOS-AHA",1346
48,"48060",3645,2277,2274,7,3,"PODEMOS-AHA",299
48,"48912",2308,1787,1746,27,41,"PODEMOS-AHA",398
48,"48097",1303,907,898,10,9,"PODEMOS-AHA",264
48,"48911",382,291,286,2,5,"PODEMOS-AHA",21
48,"48903",1838,1400,1385,4,15,"PODEMOS-AHA",243
48,"48914",330,275,275,1,0,"PODEMOS-AHA",24
48,"48913",1251,933,917,13,16,"PODEMOS-AHA",245
48,"48054",24135,17493,17374,124,119,"PODEMOS-AHA",5238
48,"48077",3367,2438,2423,17,15,"PODEMOS-AHA",529
48,"48014",1218,870,866,8,4,"PODEMOS-AHA",243
48,"48093",900,673,664,4,9,"PODEMOS-AHA",89
48,"48030",608,454,453,4,1,"PODEMOS-AHA",37
48,"48033",215,160,159,0,1,"PODEMOS-AHA",21
48,"48055",2662,1961,1938,16,23,"PODEMOS-AHA",404
48,"48015",33690,24299,24160,168,139,"PODEMOS-AHA",6867
48,"48064",603,463,459,7,4,"PODEMOS-AHA",78
48,"48004",334,229,227,1,2,"PODEMOS-AHA",15
48,"48044",62989,46989,46783,385,206,"PODEMOS-AHA",9424
48,"48066",346,256,256,1,0,"PODEMOS-AHA",27
48,"48065",3315,2447,2433,19,14,"PODEMOS-AHA",614
48,"48020",274076,193807,192607,1471,1200,"PODEMOS-AHA",48342
48,"48086",2073,1519,1504,15,15,"PODEMOS-AHA",441
48,"48902",19124,13344,13227,93,117,"PODEMOS-AHA",4209
48,"48073",6952,4476,4435,43,41,"PODEMOS-AHA",622
48,"48071",6118,4467,4412,32,55,"PODEMOS-AHA",1373
48,"48025",883,642,639,3,3,"PODEMOS-AHA",99
48,"48026",1134,861,853,7,8,"PODEMOS-AHA",105
48,"48039",243,201,201,2,0,"PODEMOS-AHA",18
48,"48095",2352,1658,1647,6,11,"PODEMOS-AHA",344
48,"48075",1975,1440,1421,12,19,"PODEMOS-AHA",305
48,"48029",8332,6155,6119,35,36,"PODEMOS-AHA",2258
48,"48027",22033,15929,15825,113,104,"PODEMOS-AHA",3886
48,"48043",4403,3214,3186,28,28,"PODEMOS-AHA",772
48,"48089",3266,2425,2406,23,19,"PODEMOS-AHA",628
48,"48068",1551,1178,1163,16,15,"PODEMOS-AHA",173
48,"48028",715,553,551,4,2,"PODEMOS-AHA",40
48,"48031",340,245,242,0,3,"PODEMOS-AHA",20
48,"48035",412,313,312,4,1,"PODEMOS-AHA",49
48,"48082",37673,27006,26811,201,195,"PODEMOS-AHA",8641
48,"48022",2355,1476,1468,9,8,"PODEMOS-AHA",382
48,"48051",220,169,168,0,1,"PODEMOS-AHA",53
48,"48034",12902,9684,9613,79,71,"PODEMOS-AHA",2579
48,"48011",9692,6891,6843,56,48,"PODEMOS-AHA",2078
48,"48092",837,619,619,13,0,"PODEMOS-AHA",107
48,"48090",6022,4544,4483,23,61,"PODEMOS-AHA",1181
48,"48080",9971,7148,7086,71,62,"PODEMOS-AHA",2208
48,"48910",2948,2126,2115,17,11,"PODEMOS-AHA",413
48,"48072",974,728,723,5,5,"PODEMOS-AHA",101
48,"48007",365,241,239,0,2,"PODEMOS-AHA",14
48,"48006",289,246,245,3,1,"PODEMOS-AHA",30
48,"48017",13290,8908,8856,42,52,"PODEMOS-AHA",1947
48,"48016",5260,3856,3827,22,29,"PODEMOS-AHA",1007
48,"48041",704,558,555,4,3,"PODEMOS-AHA",74
48,"48052",1559,1215,1211,0,4,"PODEMOS-AHA",165
48,"48005",117,76,76,0,0,"PODEMOS-AHA",22
48,"48050",198,153,150,0,3,"PODEMOS-AHA",11
48,"48048",562,399,394,3,5,"PODEMOS-AHA",49
48,"48021",1352,952,946,8,6,"PODEMOS-AHA",145
48,"48053",900,676,670,8,6,"PODEMOS-AHA",74
48,"48091",1134,821,812,7,9,"PODEMOS-AHA",155
48,"48063",373,289,288,1,1,"PODEMOS-AHA",41
48,"48078",38742,28064,27837,231,227,"PODEMOS-AHA",8529
48,"48915",362,238,238,2,0,"PODEMOS-AHA",14
48,"48070",545,378,374,2,4,"PODEMOS-AHA",22
48,"48057",5749,4093,4081,20,12,"PODEMOS-AHA",551
48,"48019",3594,2569,2544,16,25,"PODEMOS-AHA",626
48,"48018",875,553,553,3,0,"PODEMOS-AHA",76
48,"48083",6950,5128,5097,33,31,"PODEMOS-AHA",2056
48,"48042",1384,1111,1091,7,20,"PODEMOS-AHA",205
48,"48081",1883,1412,1398,12,14,"PODEMOS-AHA",267
48,"48088",135,97,96,0,1,"PODEMOS-AHA",9
48,"48037",678,518,509,2,9,"PODEMOS-AHA",101
48,"48009",786,614,609,3,5,"PODEMOS-AHA",77
48,"48045",5149,3940,3885,35,55,"PODEMOS-AHA",879
48,"48062",300,241,240,1,1,"PODEMOS-AHA",36
48,"48909",207,165,165,1,0,"PODEMOS-AHA",16
48,"48079",425,322,321,4,1,"PODEMOS-AHA",41
48,"48067",1161,837,834,2,3,"PODEMOS-AHA",116
48,"48002",7851,5767,5713,41,54,"PODEMOS-AHA",2114
48,"48046",12617,9037,8967,56,70,"PODEMOS-AHA",1800
48,"48059",402,317,314,1,3,"PODEMOS-AHA",43
48,"48908",245,200,199,1,1,"PODEMOS-AHA",35
42,"42182",57,45,45,1,0,"IU-UPeC",0
42,"42070",35,27,25,0,2,"IU-UPeC",3
42,"42001",279,219,215,2,4,"IU-UPeC",5
42,"42148",10,10,10,0,0,"IU-UPeC",0
42,"42191",187,135,132,2,3,"IU-UPeC",3
42,"42209",146,111,108,3,3,"IU-UPeC",4
42,"42027",76,56,56,0,0,"IU-UPeC",1
42,"42039",233,148,146,2,2,"IU-UPeC",1
42,"42174",180,149,148,1,1,"IU-UPeC",6
42,"42166",60,40,40,0,0,"IU-UPeC",1
42,"42056",22,19,19,0,0,"IU-UPeC",1
42,"42030",95,77,76,3,1,"IU-UPeC",2
42,"42061",292,221,219,2,2,"IU-UPeC",5
42,"42044",53,49,47,3,2,"IU-UPeC",0
42,"42017",142,115,114,1,1,"IU-UPeC",6
42,"42124",64,44,44,0,0,"IU-UPeC",1
42,"42068",85,62,61,2,1,"IU-UPeC",0
42,"42018",152,116,114,0,2,"IU-UPeC",1
42,"42094",608,470,463,9,7,"IU-UPeC",21
42,"42026",24,20,20,0,0,"IU-UPeC",0
42,"42129",692,522,516,4,6,"IU-UPeC",16
42,"42011",17,10,10,0,0,"IU-UPeC",0
42,"42048",67,53,51,1,2,"IU-UPeC",0
42,"42204",56,39,38,0,1,"IU-UPeC",0
42,"42045",312,218,214,1,4,"IU-UPeC",4
42,"42021",85,53,53,1,0,"IU-UPeC",0
42,"42043",3796,2833,2792,26,41,"IU-UPeC",99
42,"42083",25,23,21,0,2,"IU-UPeC",0
42,"42132",143,118,117,0,1,"IU-UPeC",1
42,"42009",80,65,64,2,1,"IU-UPeC",2
42,"42019",516,367,363,4,4,"IU-UPeC",15
42,"42096",281,181,178,8,3,"IU-UPeC",8
42,"42008",57,38,38,0,0,"IU-UPeC",3
42,"42177",71,55,54,1,1,"IU-UPeC",3
42,"42003",66,59,57,1,2,"IU-UPeC",0
42,"42153",14,14,14,1,0,"IU-UPeC",0
42,"42016",18,13,13,0,0,"IU-UPeC",0
42,"42149",393,300,293,1,7,"IU-UPeC",8
42,"42062",25,16,15,0,1,"IU-UPeC",0
42,"42050",31,18,18,0,0,"IU-UPeC",0
42,"42022",214,171,171,2,0,"IU-UPeC",3
42,"42058",112,97,92,1,5,"IU-UPeC",0
42,"42092",65,42,41,1,1,"IU-UPeC",0
42,"42211",83,67,67,1,0,"IU-UPeC",4
42,"42184",59,45,44,2,1,"IU-UPeC",2
42,"42217",31,25,25,0,0,"IU-UPeC",0
42,"42057",175,106,104,1,2,"IU-UPeC",0
42,"42140",16,10,10,1,0,"IU-UPeC",0
42,"42014",66,43,43,2,0,"IU-UPeC",0
42,"42046",51,43,43,1,0,"IU-UPeC",1
42,"42200",84,60,60,2,0,"IU-UPeC",1
42,"42004",2296,1767,1748,32,19,"IU-UPeC",43
42,"42155",173,105,104,1,1,"IU-UPeC",0
42,"42196",11,10,10,0,0,"IU-UPeC",0
42,"42212",69,54,54,3,0,"IU-UPeC",0
42,"42125",81,66,66,2,0,"IU-UPeC",1
42,"42144",442,357,352,5,5,"IU-UPeC",10
42,"42198",22,17,17,0,0,"IU-UPeC",1
42,"42208",21,14,14,2,0,"IU-UPeC",1
42,"42041",35,25,25,0,0,"IU-UPeC",0
42,"42175",23,18,18,0,0,"IU-UPeC",0
42,"42103",583,467,459,5,8,"IU-UPeC",12
42,"42195",100,60,60,3,0,"IU-UPeC",4
42,"42120",148,98,98,1,0,"IU-UPeC",2
42,"42205",93,64,63,0,1,"IU-UPeC",2
42,"42172",29,25,25,2,0,"IU-UPeC",0
42,"42197",76,61,59,1,2,"IU-UPeC",1
42,"42192",41,31,31,1,0,"IU-UPeC",1
42,"42152",82,59,59,1,0,"IU-UPeC",1
42,"42007",117,86,86,2,0,"IU-UPeC",1
42,"42158",110,78,78,1,0,"IU-UPeC",2
42,"42201",23,23,22,0,1,"IU-UPeC",1
42,"42081",143,111,106,2,5,"IU-UPeC",0
42,"42020",4288,3087,3044,42,43,"IU-UPeC",93
42,"42167",259,195,194,2,1,"IU-UPeC",1
42,"42131",50,32,32,0,0,"IU-UPeC",0
42,"42069",1529,1078,1066,10,12,"IU-UPeC",22
42,"42130",60,51,50,3,1,"IU-UPeC",0
42,"42108",12,10,10,0,0,"IU-UPeC",0
42,"42054",20,14,14,0,0,"IU-UPeC",0
42,"42111",307,221,220,1,1,"IU-UPeC",3
42,"42162",2363,1690,1672,21,18,"IU-UPeC",57
42,"42176",29,23,23,0,0,"IU-UPeC",1
42,"42164",1614,1208,1190,9,18,"IU-UPeC",29
42,"42085",191,136,136,2,0,"IU-UPeC",3
42,"42215",786,555,552,8,3,"IU-UPeC",14
42,"42071",169,111,109,2,2,"IU-UPeC",0
42,"42219",43,32,32,0,0,"IU-UPeC",0
42,"42076",219,176,173,4,3,"IU-UPeC",2
42,"42118",23,16,16,0,0,"IU-UPeC",0
42,"42051",21,15,15,0,0,"IU-UPeC",0
42,"42093",40,29,29,3,0,"IU-UPeC",0
42,"42189",64,50,50,2,0,"IU-UPeC",0
42,"42135",75,53,53,1,0,"IU-UPeC",3
42,"42163",49,37,37,0,0,"IU-UPeC",0
42,"42178",117,81,79,2,2,"IU-UPeC",2
42,"42023",66,53,53,0,0,"IU-UPeC",1
42,"42082",9,8,8,1,0,"IU-UPeC",0
42,"42097",21,14,14,0,0,"IU-UPeC",0
42,"42028",70,49,49,0,0,"IU-UPeC",0
42,"42012",37,29,29,0,0,"IU-UPeC",0
42,"42024",87,68,67,0,1,"IU-UPeC",1
42,"42079",27,17,17,1,0,"IU-UPeC",0
42,"42031",26,19,19,0,0,"IU-UPeC",0
42,"42187",63,55,54,1,1,"IU-UPeC",3
42,"42015",32,25,25,0,0,"IU-UPeC",0
42,"42042",47,38,38,2,0,"IU-UPeC",1
42,"42006",164,121,118,8,3,"IU-UPeC",2
42,"42065",22,20,19,0,1,"IU-UPeC",2
42,"42087",45,38,37,0,1,"IU-UPeC",6
42,"42154",97,78,78,1,0,"IU-UPeC",2
42,"42207",41,33,33,1,0,"IU-UPeC",5
42,"42053",26,21,21,1,0,"IU-UPeC",0
42,"42119",164,97,97,2,0,"IU-UPeC",1
42,"42194",176,127,126,2,1,"IU-UPeC",4
42,"42088",71,53,53,0,0,"IU-UPeC",1
42,"42075",87,63,63,1,0,"IU-UPeC",0
42,"42084",26,21,21,0,0,"IU-UPeC",1
42,"42115",63,46,46,0,0,"IU-UPeC",2
42,"42013",35,28,28,0,0,"IU-UPeC",1
42,"42089",55,46,46,1,0,"IU-UPeC",0
42,"42032",148,117,117,0,0,"IU-UPeC",3
42,"42121",64,48,48,1,0,"IU-UPeC",0
42,"42168",109,88,88,1,0,"IU-UPeC",1
42,"42185",25,21,21,0,0,"IU-UPeC",0
42,"42106",15,9,9,0,0,"IU-UPeC",0
42,"42052",15,13,13,0,0,"IU-UPeC",3
42,"42123",165,119,119,4,0,"IU-UPeC",7
42,"42128",39,37,37,1,0,"IU-UPeC",3
42,"42160",261,205,203,1,2,"IU-UPeC",12
42,"42181",419,318,312,3,6,"IU-UPeC",29
42,"42110",63,46,46,0,0,"IU-UPeC",5
42,"42073",72,56,56,0,0,"IU-UPeC",2
42,"42139",22,16,16,0,0,"IU-UPeC",1
42,"42033",50,43,43,0,0,"IU-UPeC",0
42,"42171",128,78,78,1,0,"IU-UPeC",3
42,"42035",782,566,562,4,4,"IU-UPeC",12
42,"42202",24,12,11,0,1,"IU-UPeC",0
42,"42134",2642,1961,1938,24,23,"IU-UPeC",91
42,"42190",94,71,71,1,0,"IU-UPeC",2
42,"42206",8,5,5,0,0,"IU-UPeC",0
42,"42142",52,33,33,0,0,"IU-UPeC",1
42,"42080",155,113,110,0,3,"IU-UPeC",0
42,"42105",49,42,42,0,0,"IU-UPeC",0
42,"42059",20,14,14,0,0,"IU-UPeC",0
42,"42165",408,289,282,7,7,"IU-UPeC",11
42,"42156",30,21,21,0,0,"IU-UPeC",1
42,"42157",13,10,10,1,0,"IU-UPeC",0
42,"42188",50,44,43,0,1,"IU-UPeC",0
42,"42025",1216,884,873,11,11,"IU-UPeC",29
42,"42161",140,106,106,2,0,"IU-UPeC",1
42,"42193",16,11,11,0,0,"IU-UPeC",1
42,"42117",148,113,111,3,2,"IU-UPeC",4
42,"42086",38,29,29,1,0,"IU-UPeC",2
42,"42216",25,21,21,0,0,"IU-UPeC",0
42,"42036",50,39,38,0,1,"IU-UPeC",4
42,"42038",36,27,27,2,0,"IU-UPeC",1
42,"42107",74,51,48,1,3,"IU-UPeC",1
42,"42100",32,31,31,1,0,"IU-UPeC",1
42,"42034",31,22,22,0,0,"IU-UPeC",0
42,"42159",38,33,32,1,1,"IU-UPeC",0
42,"42090",93,70,69,1,1,"IU-UPeC",7
42,"42116",47,33,33,0,0,"IU-UPeC",0
42,"42063",49,37,37,1,0,"IU-UPeC",1
42,"42213",29,18,18,1,0,"IU-UPeC",0
42,"42010",18,14,14,0,0,"IU-UPeC",1
42,"42029",143,106,106,0,0,"IU-UPeC",0
42,"42098",11,6,6,0,0,"IU-UPeC",1
42,"42078",1031,752,744,6,8,"IU-UPeC",23
42,"42055",165,127,127,3,0,"IU-UPeC",1
42,"42064",85,74,74,0,0,"IU-UPeC",4
42,"42141",111,79,79,0,0,"IU-UPeC",1
42,"42049",120,75,73,1,2,"IU-UPeC",5
42,"42127",40,27,27,1,0,"IU-UPeC",0
42,"42218",80,54,54,1,0,"IU-UPeC",0
42,"42060",34,23,21,0,2,"IU-UPeC",0
42,"42173",29201,21456,21181,272,275,"IU-UPeC",935
42,"42151",35,31,29,2,2,"IU-UPeC",0
42,"42113",512,390,386,3,4,"IU-UPeC",8
42,"42145",137,121,121,3,0,"IU-UPeC",0
42,"42183",111,79,78,2,1,"IU-UPeC",0
42,"42095",1762,1319,1303,15,16,"IU-UPeC",38
42,"42037",34,17,17,1,0,"IU-UPeC",0
22,"22035",244,171,168,3,3,"PSOE",78
22,"22017",864,658,651,7,7,"PSOE",179
22,"22103",680,527,522,8,5,"PSOE",176
22,"22107",123,79,78,2,1,"PSOE",13
22,"22002",109,94,93,0,1,"PSOE",25
22,"22025",1071,726,712,13,14,"PSOE",172
22,"22136",815,596,595,6,1,"PSOE",183
22,"22095",73,48,48,1,0,"PSOE",20
22,"22226",774,591,589,2,2,"PSOE",189
22,"22162",129,101,101,0,0,"PSOE",25
22,"22112",9592,6871,6820,76,51,"PSOE",1576
22,"22167",498,397,388,7,9,"PSOE",104
22,"22083",474,400,396,1,4,"PSOE",131
22,"22143",213,147,147,3,0,"PSOE",23
22,"22232",96,73,70,2,3,"PSOE",14
22,"22072",192,148,147,1,1,"PSOE",41
22,"22909",318,238,234,2,4,"PSOE",83
22,"22235",100,77,77,0,0,"PSOE",29
22,"22176",174,140,140,1,0,"PSOE",28
22,"22157",194,151,151,1,0,"PSOE",61
22,"22032",107,74,71,0,3,"PSOE",29
22,"22236",249,198,198,1,0,"PSOE",69
22,"22244",52,38,38,0,0,"PSOE",8
22,"22006",298,217,215,1,2,"PSOE",49
22,"22248",118,92,91,0,1,"PSOE",34
22,"22222",527,390,389,5,1,"PSOE",63
22,"22250",347,258,256,5,2,"PSOE",46
22,"22128",187,146,142,1,4,"PSOE",34
22,"22139",83,65,64,0,1,"PSOE",6
22,"22209",159,127,127,4,0,"PSOE",39
22,"22099",490,378,377,4,1,"PSOE",112
22,"22060",1165,885,879,3,6,"PSOE",267
22,"22178",104,87,87,1,0,"PSOE",18
22,"22233",82,61,61,0,0,"PSOE",17
22,"22020",114,90,90,2,0,"PSOE",18
22,"22234",802,600,597,7,3,"PSOE",164
22,"22087",72,48,48,1,0,"PSOE",7
22,"22207",125,89,88,3,1,"PSOE",21
22,"22168",20,15,15,1,0,"PSOE",5
22,"22082",298,222,220,2,2,"PSOE",44
22,"22181",93,62,62,1,0,"PSOE",6
22,"22057",364,260,259,1,1,"PSOE",111
22,"22172",560,399,396,2,3,"PSOE",90
22,"22175",197,140,140,0,0,"PSOE",34
22,"22907",1459,1112,1104,21,8,"PSOE",252
22,"22199",7029,5024,4977,55,47,"PSOE",1378
22,"22156",264,202,200,3,2,"PSOE",47
22,"22122",62,49,49,1,0,"PSOE",8
22,"22018",332,243,242,3,1,"PSOE",83
22,"22182",256,177,176,2,1,"PSOE",42
22,"22022",558,431,427,2,4,"PSOE",121
22,"22009",619,463,461,5,2,"PSOE",147
22,"22062",162,113,113,3,0,"PSOE",24
22,"22217",395,307,301,3,6,"PSOE",82
22,"22039",869,682,681,5,1,"PSOE",171
22,"22904",835,600,594,6,6,"PSOE",133
22,"22015",324,238,236,3,2,"PSOE",53
22,"22027",325,218,214,0,4,"PSOE",60
22,"22052",942,743,741,9,2,"PSOE",265
22,"22195",235,190,189,2,1,"PSOE",19
22,"22089",315,227,222,6,5,"PSOE",53
22,"22247",30,23,22,0,1,"PSOE",13
22,"22133",117,89,89,4,0,"PSOE",36
22,"22184",188,156,156,2,0,"PSOE",30
22,"22067",65,45,45,1,0,"PSOE",20
22,"22205",434,334,333,2,1,"PSOE",162
22,"22124",204,143,142,1,1,"PSOE",37
22,"22151",93,68,68,0,0,"PSOE",8
22,"22163",426,360,356,3,4,"PSOE",64
22,"22129",183,128,127,2,1,"PSOE",19
22,"22225",2691,1849,1817,24,32,"PSOE",354
22,"22094",101,77,77,1,0,"PSOE",19
22,"22024",225,174,173,0,1,"PSOE",34
22,"22117",2497,1788,1770,16,18,"PSOE",341
22,"22029",127,101,100,2,1,"PSOE",28
22,"22004",136,79,79,0,0,"PSOE",16
22,"22906",180,146,143,1,3,"PSOE",49
22,"22252",122,93,91,1,2,"PSOE",27
22,"22160",209,161,161,3,0,"PSOE",38
22,"22141",118,90,89,1,1,"PSOE",14
22,"22155",77,58,58,2,0,"PSOE",8
22,"22902",219,162,160,1,2,"PSOE",27
22,"22203",82,68,67,0,1,"PSOE",18
22,"22187",286,224,221,1,3,"PSOE",40
22,"22042",118,102,100,1,2,"PSOE",32
22,"22212",84,70,70,1,0,"PSOE",22
22,"22084",534,413,411,3,2,"PSOE",83
22,"22149",302,236,236,2,0,"PSOE",73
22,"22127",505,387,386,3,1,"PSOE",60
22,"22011",89,70,70,1,0,"PSOE",9
22,"22080",283,217,215,6,2,"PSOE",37
22,"22050",89,78,78,0,0,"PSOE",23
22,"22066",707,512,508,8,4,"PSOE",117
22,"22088",157,116,116,1,0,"PSOE",42
22,"22177",102,77,77,2,0,"PSOE",21
22,"22201",269,189,189,0,0,"PSOE",74
22,"22200",251,191,189,0,2,"PSOE",38
22,"22047",247,213,212,2,1,"PSOE",24
22,"22223",79,63,62,0,1,"PSOE",22
22,"22007",797,607,603,13,4,"PSOE",162
22,"22251",371,283,281,4,2,"PSOE",48
22,"22044",254,191,188,3,3,"PSOE",48
22,"22078",453,323,319,6,4,"PSOE",68
22,"22116",1443,1048,1038,12,10,"PSOE",313
22,"22074",315,229,226,3,3,"PSOE",49
22,"22016",613,447,444,8,3,"PSOE",158
22,"22068",82,65,65,3,0,"PSOE",10
22,"22249",119,97,97,1,0,"PSOE",27
22,"22170",642,518,509,4,9,"PSOE",86
22,"22008",173,138,138,3,0,"PSOE",29
22,"22228",505,409,407,3,2,"PSOE",63
22,"22197",479,378,373,6,5,"PSOE",118
22,"22144",248,195,195,0,0,"PSOE",55
22,"22905",294,224,224,2,0,"PSOE",39
22,"22135",192,146,144,0,2,"PSOE",28
22,"22229",114,81,81,0,0,"PSOE",23
22,"22202",136,112,112,0,0,"PSOE",36
22,"22064",165,115,115,1,0,"PSOE",36
22,"22164",35,26,26,1,0,"PSOE",9
22,"22061",6685,4796,4740,38,56,"PSOE",1129
22,"22075",126,82,81,2,1,"PSOE",34
22,"22220",169,123,122,2,1,"PSOE",32
22,"22014",245,184,183,2,1,"PSOE",62
22,"22119",1296,950,940,3,10,"PSOE",262
22,"22053",787,541,535,12,6,"PSOE",163
22,"22021",1970,1485,1469,14,16,"PSOE",447
22,"22046",740,578,570,6,8,"PSOE",212
22,"22058",190,152,151,2,1,"PSOE",40
22,"22115",364,270,267,4,3,"PSOE",67
22,"22142",98,81,79,1,2,"PSOE",9
22,"22077",381,295,293,5,2,"PSOE",119
22,"22903",654,542,536,3,6,"PSOE",179
22,"22230",290,224,223,2,1,"PSOE",47
22,"22110",751,563,558,3,5,"PSOE",164
22,"22049",78,61,61,1,0,"PSOE",7
22,"22055",325,252,245,5,7,"PSOE",86
22,"22040",148,123,121,2,2,"PSOE",29
22,"22243",45,32,32,0,0,"PSOE",14
22,"22085",107,92,90,2,2,"PSOE",36
22,"22188",87,66,66,1,0,"PSOE",18
22,"22019",180,156,155,0,1,"PSOE",36
22,"22109",265,207,206,2,1,"PSOE",32
22,"22043",94,71,70,0,1,"PSOE",16
22,"22012",111,84,82,0,2,"PSOE",18
22,"22150",464,348,348,1,0,"PSOE",79
22,"22105",118,87,86,1,1,"PSOE",27
22,"22111",152,114,113,0,1,"PSOE",27
22,"22051",101,84,84,1,0,"PSOE",22
22,"22037",116,95,94,1,1,"PSOE",6
22,"22130",10106,6957,6909,57,48,"PSOE",1645
22,"22041",163,127,126,4,1,"PSOE",26
22,"22245",306,258,257,3,1,"PSOE",45
22,"22189",184,140,137,1,3,"PSOE",47
22,"22013",295,235,233,2,2,"PSOE",76
22,"22079",118,86,86,2,0,"PSOE",35
22,"22090",102,75,75,0,0,"PSOE",26
22,"22114",123,80,79,4,1,"PSOE",22
22,"22045",89,66,66,0,0,"PSOE",20
22,"22069",435,340,338,3,2,"PSOE",82
22,"22096",297,248,248,0,0,"PSOE",46
22,"22165",490,375,372,2,3,"PSOE",93
22,"22003",143,119,119,0,0,"PSOE",22
22,"22901",754,521,513,9,8,"PSOE",156
22,"22221",80,60,59,0,1,"PSOE",4
22,"22242",64,45,44,1,1,"PSOE",11
22,"22190",113,83,83,2,0,"PSOE",34
22,"22206",201,141,140,2,1,"PSOE",51
22,"22213",3029,2225,2181,17,44,"PSOE",648
22,"22086",215,162,162,4,0,"PSOE",20
22,"22253",61,51,50,0,1,"PSOE",15
22,"22131",83,63,63,3,0,"PSOE",18
22,"22193",283,235,234,3,1,"PSOE",61
22,"22113",494,362,361,3,1,"PSOE",84
22,"22239",89,78,76,4,2,"PSOE",14
22,"22218",43,35,35,0,0,"PSOE",12
22,"22908",207,144,140,1,4,"PSOE",39
22,"22054",1542,1126,1106,20,20,"PSOE",193
22,"22081",252,179,177,1,2,"PSOE",27
22,"22063",175,140,140,2,0,"PSOE",18
22,"22215",129,91,91,0,0,"PSOE",33
22,"22059",1137,839,828,7,11,"PSOE",184
22,"22246",77,51,50,0,1,"PSOE",12
22,"22001",226,166,166,0,0,"PSOE",25
22,"22214",128,94,92,0,2,"PSOE",9
22,"22102",184,160,159,1,1,"PSOE",32
22,"22076",305,224,223,0,1,"PSOE",49
22,"22125",38845,28287,27998,283,289,"PSOE",6277
22,"22174",485,400,396,6,4,"PSOE",95
22,"22227",211,153,151,3,2,"PSOE",49
22,"22186",186,139,137,3,2,"PSOE",49
22,"22048",12633,9215,9141,90,74,"PSOE",2182
22,"22208",178,142,140,0,2,"PSOE",30
22,"22126",91,65,65,0,0,"PSOE",15
22,"22254",1129,804,792,9,12,"PSOE",286
22,"22204",1095,816,805,10,11,"PSOE",96
22,"22137",1071,729,719,6,10,"PSOE",264
22,"22173",234,158,157,0,1,"PSOE",38
22,"22036",91,82,82,0,0,"PSOE",11
22,"22023",430,329,329,2,0,"PSOE",101
22,"22028",379,297,293,1,4,"PSOE",66
22,"22106",24,17,17,0,0,"PSOE",4
22,"22158",12005,8628,8554,78,74,"PSOE",2260
32,"32058",5209,3808,3750,27,58,"PP",1731
32,"32065",669,494,482,3,12,"PP",229
32,"32087",1798,1421,1397,7,24,"PP",832
32,"32038",456,299,297,2,2,"PP",136
32,"32022",1377,963,951,7,12,"PP",422
32,"32007",1527,1078,1070,7,8,"PP",481
32,"32079",1343,1000,987,9,13,"PP",482
32,"32029",480,349,346,5,3,"PP",223
32,"32002",2016,1474,1460,11,14,"PP",616
32,"32037",742,544,532,8,12,"PP",321
32,"32073",1332,976,965,4,11,"PP",448
32,"32026",2736,2039,1998,25,41,"PP",745
32,"32040",1472,1112,1089,9,23,"PP",618
32,"32046",1179,840,832,5,8,"PP",429
32,"32047",1818,1345,1329,3,16,"PP",832
32,"32054",87290,63653,62823,671,830,"PP",22553
32,"32014",1170,855,845,7,10,"PP",509
32,"32018",1261,956,945,3,11,"PP",353
32,"32010",394,299,298,0,1,"PP",170
32,"32034",1141,880,873,4,7,"PP",461
32,"32080",333,266,265,0,1,"PP",186
32,"32011",934,559,548,5,11,"PP",455
32,"32021",956,664,662,2,2,"PP",236
32,"32024",4839,3424,3368,35,56,"PP",1704
32,"32025",1094,821,809,3,12,"PP",439
32,"32035",1484,944,938,7,6,"PP",577
32,"32071",1496,1013,1004,1,9,"PP",533
32,"32069",4333,3324,3261,25,63,"PP",1186
32,"32082",1259,905,887,6,18,"PP",507
32,"32062",832,646,644,7,2,"PP",430
32,"32036",1369,1053,1040,5,13,"PP",657
32,"32042",1585,1120,1104,13,16,"PP",605
32,"32027",1072,765,747,3,18,"PP",413
32,"32085",10709,7489,7403,81,86,"PP",3309
32,"32008",8188,5923,5845,44,78,"PP",2048
32,"32044",900,658,647,5,11,"PP",306
32,"32049",775,502,495,5,7,"PP",237
32,"32016",825,559,556,3,3,"PP",211
32,"32048",906,573,564,6,9,"PP",216
32,"32013",2213,1447,1431,8,16,"PP",905
32,"32081",2097,1566,1553,6,13,"PP",716
32,"32074",1064,731,719,4,12,"PP",395
32,"32057",575,414,412,5,2,"PP",113
32,"32066",567,435,434,2,1,"PP",331
32,"32088",1632,1062,1042,8,20,"PP",430
32,"32012",811,535,533,3,2,"PP",288
32,"32060",845,609,598,6,11,"PP",179
32,"32043",2555,1824,1793,15,31,"PP",947
32,"32068",1424,974,969,8,5,"PP",495
32,"32067",1300,838,824,15,14,"PP",413
32,"32077",1188,813,796,8,17,"PP",366
32,"32050",2455,1874,1855,17,19,"PP",1125
32,"32004",1826,900,897,8,3,"PP",740
32,"32086",2671,1731,1712,10,19,"PP",820
32,"32003",886,661,653,6,8,"PP",369
32,"32090",791,558,556,2,2,"PP",173
32,"32030",1015,702,689,3,13,"PP",246
32,"32041",772,511,505,5,6,"PP",311
32,"32092",528,337,334,4,3,"PP",184
32,"32023",1217,884,877,6,7,"PP",398
32,"32031",1079,826,812,5,14,"PP",497
32,"32017",1272,862,849,5,13,"PP",517
32,"32039",1275,989,976,5,13,"PP",570
32,"32052",1904,1450,1426,6,24,"PP",862
32,"32072",3833,2799,2761,26,38,"PP",1075
32,"32064",526,397,395,1,2,"PP",272
32,"32078",1243,876,869,6,7,"PP",558
32,"32033",750,504,500,4,4,"PP",297
32,"32051",1458,1141,1137,4,4,"PP",751
32,"32015",899,586,581,5,5,"PP",366
32,"32020",2625,1997,1974,10,23,"PP",1142
32,"32076",2121,1509,1489,12,20,"PP",883
32,"32089",1332,917,904,5,13,"PP",549
32,"32059",1849,1357,1339,16,18,"PP",733
32,"32070",566,335,330,3,5,"PP",163
32,"32053",1447,1140,1128,12,12,"PP",664
32,"32009",10783,7555,7468,60,87,"PP",3089
32,"32075",4188,3257,3206,43,51,"PP",1591
32,"32061",1093,852,840,3,12,"PP",440
32,"32083",860,580,574,4,6,"PP",338
32,"32055",1310,952,936,7,16,"PP",540
32,"32045",2484,1820,1795,19,25,"PP",892
32,"32056",1610,1159,1146,9,13,"PP",718
32,"32032",8101,5993,5881,74,112,"PP",2872
32,"32001",4978,3644,3607,31,37,"PP",1084
32,"32006",1571,1140,1127,10,13,"PP",748
32,"32091",1909,1389,1375,8,14,"PP",736
32,"32084",925,657,650,3,7,"PP",356
32,"32005",869,676,671,7,5,"PP",440
32,"32063",1939,1329,1314,16,15,"PP",583
32,"32028",1643,1195,1174,18,21,"PP",819
32,"32019",11529,8038,7906,78,132,"PP",3794
13,"13902",479,374,367,0,7,"RECORTES CE",0
13,"13035",986,791,784,7,7,"RECORTES CE",0
13,"13903",539,437,432,4,5,"RECORTES CE",0
13,"13074",982,843,833,3,10,"RECORTES CE",0
13,"13058",4110,3157,3127,28,30,"RECORTES CE",3
13,"13030",143,110,110,0,0,"RECORTES CE",0
13,"13088",610,501,495,5,6,"RECORTES CE",0
13,"13039",14383,10833,10684,100,149,"RECORTES CE",18
13,"13070",765,612,605,4,7,"RECORTES CE",1
13,"13081",652,525,508,2,17,"RECORTES CE",0
13,"13055",666,495,490,0,5,"RECORTES CE",1
13,"13033",1653,1395,1378,4,17,"RECORTES CE",1
13,"13083",2453,1729,1690,14,39,"RECORTES CE",2
13,"13091",552,466,459,3,7,"RECORTES CE",0
13,"13082",25841,17702,17561,154,141,"RECORTES CE",27
13,"13019",5179,3887,3830,35,57,"RECORTES CE",4
13,"13013",7086,5419,5340,45,79,"RECORTES CE",6
13,"13038",1649,1317,1294,15,23,"RECORTES CE",1
13,"13008",441,317,311,2,6,"RECORTES CE",0
13,"13089",1728,1410,1381,6,29,"RECORTES CE",0
13,"13009",1459,1167,1156,4,11,"RECORTES CE",3
13,"13063",3728,2708,2685,9,23,"RECORTES CE",5
13,"13080",350,265,265,1,0,"RECORTES CE",1
13,"13056",11354,8732,8634,48,98,"RECORTES CE",9
13,"13031",2455,1940,1914,9,26,"RECORTES CE",1
13,"13079",12273,9195,9036,79,159,"RECORTES CE",10
13,"13068",1058,787,782,5,5,"RECORTES CE",1
13,"13014",496,404,398,2,6,"RECORTES CE",0
13,"13004",1052,827,816,1,11,"RECORTES CE",0
13,"13072",775,570,565,5,5,"RECORTES CE",1
13,"13093",4111,3056,3014,21,42,"RECORTES CE",8
13,"13098",2124,1633,1591,15,42,"RECORTES CE",0
13,"13090",1110,872,849,6,23,"RECORTES CE",0
13,"13027",3446,2543,2498,15,45,"RECORTES CE",1
13,"13069",666,518,508,3,10,"RECORTES CE",0
13,"13045",679,532,522,7,10,"RECORTES CE",1
13,"13073",542,409,405,0,4,"RECORTES CE",0
13,"13097",2282,1783,1768,12,15,"RECORTES CE",0
13,"13076",488,415,408,1,7,"RECORTES CE",0
13,"13078",9089,6661,6584,44,77,"RECORTES CE",8
13,"13044",2675,1959,1920,12,39,"RECORTES CE",2
13,"13041",253,182,180,0,2,"RECORTES CE",0
13,"13094",308,253,249,3,4,"RECORTES CE",0
13,"13021",436,376,374,0,2,"RECORTES CE",0
13,"13005",23330,18245,18030,164,215,"RECORTES CE",27
13,"13028",10416,8309,8171,77,138,"RECORTES CE",3
13,"13057",1172,980,970,1,10,"RECORTES CE",0
13,"13046",740,575,570,3,5,"RECORTES CE",0
13,"13034",58010,44627,44241,332,386,"RECORTES CE",96
13,"13036",800,620,614,3,6,"RECORTES CE",1
13,"13002",1500,1003,993,9,10,"RECORTES CE",2
13,"13025",302,250,246,0,4,"RECORTES CE",0
13,"13026",452,374,372,1,2,"RECORTES CE",0
13,"13001",1270,985,977,8,8,"RECORTES CE",2
13,"13095",83,65,65,1,0,"RECORTES CE",0
13,"13022",351,280,280,2,0,"RECORTES CE",0
13,"13047",5785,4462,4406,23,56,"RECORTES CE",7
13,"13007",1273,1056,1028,10,28,"RECORTES CE",1
13,"13023",9003,6578,6517,86,61,"RECORTES CE",4
13,"13066",2519,2057,2026,14,31,"RECORTES CE",0
13,"13096",7677,5743,5661,51,82,"RECORTES CE",3
13,"13011",4866,3346,3312,15,34,"RECORTES CE",4
13,"13017",267,205,203,1,2,"RECORTES CE",0
13,"13061",5723,4210,4149,49,61,"RECORTES CE",5
13,"13092",1860,1544,1529,11,15,"RECORTES CE",1
13,"13015",5494,4146,4106,18,40,"RECORTES CE",1
13,"13006",608,487,479,4,8,"RECORTES CE",2
13,"13048",515,418,416,3,2,"RECORTES CE",1
13,"13060",269,212,209,1,3,"RECORTES CE",0
13,"13032",1150,878,870,9,8,"RECORTES CE",0
13,"13020",4792,3494,3451,26,43,"RECORTES CE",11
13,"13086",189,146,146,1,0,"RECORTES CE",0
13,"13024",898,643,637,7,6,"RECORTES CE",0
13,"13040",892,720,710,3,10,"RECORTES CE",0
13,"13085",2365,2011,1983,6,28,"RECORTES CE",1
13,"13012",411,294,292,0,2,"RECORTES CE",0
13,"13029",86,69,69,0,0,"RECORTES CE",0
13,"13062",575,471,466,4,5,"RECORTES CE",1
13,"13049",814,585,579,0,6,"RECORTES CE",0
13,"13084",908,725,708,5,17,"RECORTES CE",0
13,"13075",213,157,153,1,4,"RECORTES CE",0
13,"13053",14389,10624,10521,79,103,"RECORTES CE",20
13,"13059",204,156,156,1,0,"RECORTES CE",0
13,"13010",887,673,665,0,8,"RECORTES CE",1
13,"13901",895,676,660,4,16,"RECORTES CE",1
13,"13051",350,281,278,2,3,"RECORTES CE",0
13,"13043",231,186,185,5,1,"RECORTES CE",0
13,"13042",928,696,688,3,8,"RECORTES CE",1
13,"13071",39775,28222,28052,175,170,"RECORTES CE",40
13,"13018",824,667,662,7,5,"RECORTES CE",0
13,"13054",4970,3911,3866,44,45,"RECORTES CE",3
13,"13050",501,403,399,2,4,"RECORTES CE",0
13,"13003",487,367,363,2,4,"RECORTES CE",0
13,"13052",6497,4715,4648,71,67,"RECORTES CE",5
13,"13077",3518,2443,2378,12,65,"RECORTES CE",2
13,"13065",2888,2004,1970,19,34,"RECORTES CE",0
13,"13904",527,411,406,8,5,"RECORTES CE",0
13,"13016",665,537,529,4,8,"RECORTES CE",0
13,"13067",360,298,294,2,4,"RECORTES CE",0
13,"13064",1684,1288,1283,13,5,"RECORTES CE",1
13,"13037",865,678,667,2,11,"RECORTES CE",0
13,"13087",23161,16812,16595,145,217,"RECORTES CE",21
35,"35001",4599,3455,3396,27,59,"PODEMOS",631
35,"35025",1801,1239,1216,9,23,"PODEMOS",207
35,"35033",6378,4412,4354,24,58,"PODEMOS",939
35,"35009",19832,14305,14036,97,269,"PODEMOS",3105
35,"35016",297974,198159,195935,1546,2224,"PODEMOS",56196
35,"35024",13621,8665,8555,76,110,"PODEMOS",2032
35,"35031",7270,5184,5000,36,184,"PODEMOS",1228
35,"35017",25447,15415,15079,127,336,"PODEMOS",4344
35,"35020",6054,4073,4018,26,55,"PODEMOS",569
35,"35028",9705,5552,5478,64,74,"PODEMOS",1202
35,"35034",7707,3921,3872,30,49,"PODEMOS",1105
35,"35002",23129,15904,15675,74,229,"PODEMOS",4360
35,"35027",10311,7497,7364,58,133,"PODEMOS",1535
35,"35029",4125,2545,2514,34,31,"PODEMOS",467
35,"35018",12463,7628,7546,56,82,"PODEMOS",2157
35,"35015",9870,5451,5368,29,83,"PODEMOS",1278
35,"35026",80806,53749,52665,450,1084,"PODEMOS",14379
35,"35023",11680,8467,8295,75,172,"PODEMOS",1799
35,"35021",14942,10691,10537,80,154,"PODEMOS",2654
35,"35013",6609,4997,4881,51,116,"PODEMOS",862
35,"35003",5125,2989,2929,21,60,"PODEMOS",660
35,"35012",10331,5684,5610,32,74,"PODEMOS",1225
35,"35008",6109,4631,4542,37,89,"PODEMOS",1012
35,"35032",3432,2541,2498,19,43,"PODEMOS",446
35,"35019",32253,19902,19621,126,281,"PODEMOS",5004
35,"35005",1071,718,711,6,7,"PODEMOS",94
35,"35030",9205,5602,5501,58,101,"PODEMOS",1088
35,"35011",23882,16369,16095,107,274,"PODEMOS",4345
35,"35010",3548,2371,2336,20,35,"PODEMOS",431
35,"35007",515,332,330,2,2,"PODEMOS",48
35,"35014",11169,6234,6107,59,127,"PODEMOS",1799
35,"35006",30302,21967,21625,243,342,"PODEMOS",5679
35,"35004",38814,20869,20641,192,228,"PODEMOS",5317
35,"35022",48059,30474,30134,219,340,"PODEMOS",8081
38,"38002",942,701,674,14,27,"CANARIAS DE",0
38,"38040",4990,3061,3031,16,30,"CANARIAS DE",7
38,"38005",5463,3443,3417,24,26,"CANARIAS DE",8
38,"38022",18468,12230,12085,86,145,"CANARIAS DE",83
38,"38025",6860,4836,4761,49,75,"CANARIAS DE",20
38,"38032",13257,8969,8902,72,67,"CANARIAS DE",24
38,"38036",6553,4604,4529,45,75,"CANARIAS DE",13
38,"38027",5386,3685,3615,29,70,"CANARIAS DE",2
38,"38038",162030,105122,104174,667,948,"CANARIAS DE",316
38,"38021",1643,1014,1002,5,12,"CANARIAS DE",1
38,"38026",32918,24984,24727,174,257,"CANARIAS DE",51
38,"38017",28037,16236,16076,100,160,"CANARIAS DE",49
38,"38048",3878,2664,2624,20,40,"CANARIAS DE",2
38,"38024",15055,9612,9485,77,127,"CANARIAS DE",23
38,"38013",2915,1865,1847,12,18,"CANARIAS DE",2
38,"38037",12997,8126,7997,46,129,"CANARIAS DE",10
38,"38004",4442,2980,2939,20,41,"CANARIAS DE",6
38,"38012",2378,1620,1606,6,14,"CANARIAS DE",5
38,"38041",6808,4869,4835,42,34,"CANARIAS DE",9
38,"38028",22063,15095,14954,89,141,"CANARIAS DE",29
38,"38008",5513,3683,3609,17,74,"CANARIAS DE",6
38,"38039",10584,7532,7462,77,70,"CANARIAS DE",8
38,"38046",9107,6755,6682,45,73,"CANARIAS DE",12
38,"38014",1351,935,929,3,6,"CANARIAS DE",3
38,"38042",3784,2692,2673,16,19,"CANARIAS DE",1
38,"38023",121610,81337,80453,527,884,"CANARIAS DE",238
38,"38009",4127,2842,2793,15,49,"CANARIAS DE",4
38,"38034",4041,2853,2814,17,39,"CANARIAS DE",4
38,"38901",1387,883,876,4,7,"CANARIAS DE",0
38,"38029",1533,776,763,7,13,"CANARIAS DE",1
38,"38018",4405,3053,3005,21,48,"CANARIAS DE",11
38,"38001",20166,11307,11195,55,112,"CANARIAS DE",37
38,"38003",1440,970,960,2,10,"CANARIAS DE",0
38,"38010",4014,2726,2678,15,48,"CANARIAS DE",10
38,"38020",15021,9813,9693,51,120,"CANARIAS DE",24
38,"38053",3754,2419,2370,15,49,"CANARIAS DE",6
38,"38045",3987,2152,2132,23,20,"CANARIAS DE",4
38,"38031",28697,21546,21202,140,344,"CANARIAS DE",49
38,"38030",1923,1309,1300,5,9,"CANARIAS DE",2
38,"38033",3721,2552,2504,15,48,"CANARIAS DE",2
38,"38043",18918,12883,12737,109,146,"CANARIAS DE",40
38,"38035",9299,5558,5500,35,58,"CANARIAS DE",17
38,"38019",13217,8168,8075,54,93,"CANARIAS DE",17
38,"38049",2653,1683,1658,8,25,"CANARIAS DE",7
38,"38011",20435,13760,13627,82,133,"CANARIAS DE",35
38,"38047",1789,1228,1208,5,20,"CANARIAS DE",2
38,"38016",1215,654,641,4,13,"CANARIAS DE",0
38,"38051",7217,5147,5089,31,58,"CANARIAS DE",10
38,"38006",39553,21159,20940,124,219,"CANARIAS DE",57
38,"38052",1281,853,844,2,9,"CANARIAS DE",0
38,"38015",4158,2864,2818,12,46,"CANARIAS DE",3
38,"38044",2206,1317,1303,10,14,"CANARIAS DE",1
38,"38050",2471,1616,1590,8,26,"CANARIAS DE",2
38,"38007",1689,1143,1119,3,24,"CANARIAS DE",2
22,"22001",226,166,166,0,0,"PACMA",0
22,"22053",787,541,535,12,6,"PACMA",2
22,"22126",91,65,65,0,0,"PACMA",1
22,"22907",1459,1112,1104,21,8,"PACMA",2
22,"22249",119,97,97,1,0,"PACMA",1
22,"22160",209,161,161,3,0,"PACMA",0
22,"22046",740,578,570,6,8,"PACMA",4
22,"22066",707,512,508,8,4,"PACMA",2
22,"22094",101,77,77,1,0,"PACMA",0
22,"22127",505,387,386,3,1,"PACMA",1
22,"22222",527,390,389,5,1,"PACMA",6
22,"22903",654,542,536,3,6,"PACMA",1
22,"22235",100,77,77,0,0,"PACMA",0
22,"22193",283,235,234,3,1,"PACMA",3
22,"22095",73,48,48,1,0,"PACMA",0
22,"22067",65,45,45,1,0,"PACMA",2
22,"22908",207,144,140,1,4,"PACMA",1
22,"22002",109,94,93,0,1,"PACMA",0
22,"22143",213,147,147,3,0,"PACMA",0
22,"22043",94,71,70,0,1,"PACMA",1
22,"22082",298,222,220,2,2,"PACMA",1
22,"22015",324,238,236,3,2,"PACMA",2
22,"22044",254,191,188,3,3,"PACMA",1
22,"22223",79,63,62,0,1,"PACMA",0
22,"22003",143,119,119,0,0,"PACMA",3
22,"22909",318,238,234,2,4,"PACMA",2
22,"22055",325,252,245,5,7,"PACMA",1
22,"22113",494,362,361,3,1,"PACMA",2
22,"22128",187,146,142,1,4,"PACMA",0
22,"22239",89,78,76,4,2,"PACMA",0
22,"22016",613,447,444,8,3,"PACMA",3
22,"22178",104,87,87,1,0,"PACMA",0
22,"22229",114,81,81,0,0,"PACMA",1
22,"22225",2691,1849,1817,24,32,"PACMA",17
22,"22144",248,195,195,0,0,"PACMA",1
22,"22197",479,378,373,6,5,"PACMA",1
22,"22129",183,128,127,2,1,"PACMA",0
22,"22155",77,58,58,2,0,"PACMA",0
22,"22017",864,658,651,7,7,"PACMA",2
22,"22004",136,79,79,0,0,"PACMA",0
22,"22165",490,375,372,2,3,"PACMA",4
22,"22083",474,400,396,1,4,"PACMA",1
22,"22212",84,70,70,1,0,"PACMA",0
22,"22181",93,62,62,1,0,"PACMA",0
22,"22226",774,591,589,2,2,"PACMA",1
22,"22130",10106,6957,6909,57,48,"PACMA",59
22,"22136",815,596,595,6,1,"PACMA",1
22,"22072",192,148,147,1,1,"PACMA",0
22,"22011",89,70,70,1,0,"PACMA",0
22,"22084",534,413,411,3,2,"PACMA",4
22,"22018",332,243,242,3,1,"PACMA",0
22,"22142",98,81,79,1,2,"PACMA",0
22,"22131",83,63,63,3,0,"PACMA",1
22,"22006",298,217,215,1,2,"PACMA",0
22,"22156",264,202,200,3,2,"PACMA",1
22,"22182",256,177,176,2,1,"PACMA",0
22,"22227",211,153,151,3,2,"PACMA",1
22,"22007",797,607,603,13,4,"PACMA",2
22,"22200",251,191,189,0,2,"PACMA",0
22,"22150",464,348,348,1,0,"PACMA",1
22,"22047",247,213,212,2,1,"PACMA",2
22,"22085",107,92,90,2,2,"PACMA",1
22,"22201",269,189,189,0,0,"PACMA",1
22,"22035",244,171,168,3,3,"PACMA",0
22,"22059",1137,839,828,7,11,"PACMA",8
22,"22228",505,409,407,3,2,"PACMA",2
22,"22105",118,87,86,1,1,"PACMA",0
22,"22133",117,89,89,4,0,"PACMA",1
22,"22184",188,156,156,2,0,"PACMA",0
22,"22020",114,90,90,2,0,"PACMA",0
22,"22008",173,138,138,3,0,"PACMA",0
22,"22245",306,258,257,3,1,"PACMA",0
22,"22174",485,400,396,6,4,"PACMA",2
22,"22135",192,146,144,0,2,"PACMA",1
22,"22117",2497,1788,1770,16,18,"PACMA",8
22,"22902",219,162,160,1,2,"PACMA",1
22,"22186",186,139,137,3,2,"PACMA",0
22,"22099",490,378,377,4,1,"PACMA",3
22,"22061",6685,4796,4740,38,56,"PACMA",31
22,"22009",619,463,461,5,2,"PACMA",0
22,"22037",116,95,94,1,1,"PACMA",0
22,"22202",136,112,112,0,0,"PACMA",0
22,"22076",305,224,223,0,1,"PACMA",1
22,"22230",290,224,223,2,1,"PACMA",0
22,"22141",118,90,89,1,1,"PACMA",0
22,"22187",286,224,221,1,3,"PACMA",3
22,"22149",302,236,236,2,0,"PACMA",1
22,"22021",1970,1485,1469,14,16,"PACMA",3
22,"22217",395,307,301,3,6,"PACMA",0
22,"22088",157,116,116,1,0,"PACMA",4
22,"22122",62,49,49,1,0,"PACMA",0
22,"22115",364,270,267,4,3,"PACMA",0
22,"22250",347,258,256,5,2,"PACMA",2
22,"22022",558,431,427,2,4,"PACMA",3
22,"22208",178,142,140,0,2,"PACMA",2
22,"22062",162,113,113,3,0,"PACMA",0
22,"22137",1071,729,719,6,10,"PACMA",0
22,"22157",194,151,151,1,0,"PACMA",0
22,"22051",101,84,84,1,0,"PACMA",0
22,"22063",175,140,140,2,0,"PACMA",1
22,"22012",111,84,82,0,2,"PACMA",0
22,"22188",87,66,66,1,0,"PACMA",2
22,"22068",82,65,65,3,0,"PACMA",1
22,"22089",315,227,222,6,5,"PACMA",0
22,"22023",430,329,329,2,0,"PACMA",0
22,"22109",265,207,206,2,1,"PACMA",0
22,"22233",82,61,61,0,0,"PACMA",0
22,"22175",197,140,140,0,0,"PACMA",1
22,"22090",102,75,75,0,0,"PACMA",0
22,"22248",118,92,91,0,1,"PACMA",0
22,"22139",83,65,64,0,1,"PACMA",0
22,"22189",184,140,137,1,3,"PACMA",2
22,"22209",159,127,127,4,0,"PACMA",0
22,"22064",165,115,115,1,0,"PACMA",0
22,"22110",751,563,558,3,5,"PACMA",1
22,"22052",942,743,741,9,2,"PACMA",4
22,"22158",12005,8628,8554,78,74,"PACMA",72
22,"22170",642,518,509,4,9,"PACMA",4
22,"22234",802,600,597,7,3,"PACMA",1
22,"22013",295,235,233,2,2,"PACMA",0
22,"22254",1129,804,792,9,12,"PACMA",5
22,"22014",245,184,183,2,1,"PACMA",0
22,"22025",1071,726,712,13,14,"PACMA",6
22,"22190",113,83,83,2,0,"PACMA",0
22,"22199",7029,5024,4977,55,47,"PACMA",41
22,"22242",64,45,44,1,1,"PACMA",0
22,"22172",560,399,396,2,3,"PACMA",1
22,"22058",190,152,151,2,1,"PACMA",0
22,"22236",249,198,198,1,0,"PACMA",0
22,"22207",125,89,88,3,1,"PACMA",0
22,"22112",9592,6871,6820,76,51,"PACMA",40
22,"22050",89,78,78,0,0,"PACMA",0
22,"22028",379,297,293,1,4,"PACMA",1
22,"22251",371,283,281,4,2,"PACMA",1
22,"22078",453,323,319,6,4,"PACMA",2
22,"22151",93,68,68,0,0,"PACMA",0
22,"22243",45,32,32,0,0,"PACMA",0
22,"22162",129,101,101,0,0,"PACMA",0
22,"22054",1542,1126,1106,20,20,"PACMA",14
22,"22204",1095,816,805,10,11,"PACMA",8
22,"22195",235,190,189,2,1,"PACMA",4
22,"22114",123,80,79,4,1,"PACMA",0
22,"22019",180,156,155,0,1,"PACMA",1
22,"22214",128,94,92,0,2,"PACMA",0
22,"22163",426,360,356,3,4,"PACMA",7
22,"22069",435,340,338,3,2,"PACMA",1
22,"22164",35,26,26,1,0,"PACMA",0
22,"22057",364,260,259,1,1,"PACMA",1
22,"22045",89,66,66,0,0,"PACMA",3
22,"22036",91,82,82,0,0,"PACMA",0
22,"22252",122,93,91,1,2,"PACMA",0
22,"22060",1165,885,879,3,6,"PACMA",2
22,"22168",20,15,15,1,0,"PACMA",0
22,"22220",169,123,122,2,1,"PACMA",0
22,"22107",123,79,78,2,1,"PACMA",0
22,"22086",215,162,162,4,0,"PACMA",1
22,"22029",127,101,100,2,1,"PACMA",0
22,"22125",38845,28287,27998,283,289,"PACMA",198
22,"22203",82,68,67,0,1,"PACMA",0
22,"22901",754,521,513,9,8,"PACMA",3
22,"22176",174,140,140,1,0,"PACMA",0
22,"22106",24,17,17,0,0,"PACMA",0
22,"22087",72,48,48,1,0,"PACMA",0
22,"22042",118,102,100,1,2,"PACMA",0
22,"22906",180,146,143,1,3,"PACMA",1
22,"22111",152,114,113,0,1,"PACMA",0
22,"22032",107,74,71,0,3,"PACMA",0
22,"22103",680,527,522,8,5,"PACMA",2
22,"22213",3029,2225,2181,17,44,"PACMA",13
22,"22246",77,51,50,0,1,"PACMA",0
22,"22077",381,295,293,5,2,"PACMA",0
22,"22116",1443,1048,1038,12,10,"PACMA",2
22,"22206",201,141,140,2,1,"PACMA",0
22,"22244",52,38,38,0,0,"PACMA",0
22,"22905",294,224,224,2,0,"PACMA",0
22,"22049",78,61,61,1,0,"PACMA",0
22,"22096",297,248,248,0,0,"PACMA",0
22,"22075",126,82,81,2,1,"PACMA",1
22,"22074",315,229,226,3,3,"PACMA",2
22,"22027",325,218,214,0,4,"PACMA",2
22,"22039",869,682,681,5,1,"PACMA",1
22,"22102",184,160,159,1,1,"PACMA",0
22,"22173",234,158,157,0,1,"PACMA",2
22,"22167",498,397,388,7,9,"PACMA",1
22,"22177",102,77,77,2,0,"PACMA",1
22,"22215",129,91,91,0,0,"PACMA",0
22,"22119",1296,950,940,3,10,"PACMA",4
22,"22221",80,60,59,0,1,"PACMA",1
22,"22205",434,334,333,2,1,"PACMA",2
22,"22232",96,73,70,2,3,"PACMA",0
22,"22218",43,35,35,0,0,"PACMA",0
22,"22024",225,174,173,0,1,"PACMA",2
22,"22079",118,86,86,2,0,"PACMA",0
22,"22253",61,51,50,0,1,"PACMA",0
22,"22904",835,600,594,6,6,"PACMA",4
22,"22247",30,23,22,0,1,"PACMA",0
22,"22080",283,217,215,6,2,"PACMA",2
22,"22124",204,143,142,1,1,"PACMA",2
22,"22040",148,123,121,2,2,"PACMA",1
22,"22081",252,179,177,1,2,"PACMA",0
22,"22041",163,127,126,4,1,"PACMA",1
22,"22048",12633,9215,9141,90,74,"PACMA",88
25,"25001",139,88,87,1,1,"unio.cat",4
25,"25119",2259,1582,1569,22,13,"unio.cat",38
25,"25139",479,325,324,3,1,"unio.cat",6
25,"25025",1346,966,956,10,10,"unio.cat",44
25,"25068",558,372,369,9,3,"unio.cat",11
25,"25093",639,451,445,11,6,"unio.cat",17
25,"25104",125,86,86,3,0,"unio.cat",5
25,"25212",234,173,171,1,2,"unio.cat",8
25,"25239",608,320,319,1,1,"unio.cat",15
25,"25251",710,495,494,3,1,"unio.cat",17
25,"25175",194,132,132,7,0,"unio.cat",11
25,"25111",115,83,83,1,0,"unio.cat",1
25,"25215",334,244,243,2,1,"unio.cat",9
25,"25105",130,95,93,4,2,"unio.cat",0
25,"25189",2106,1392,1381,16,11,"unio.cat",41
25,"25140",774,468,465,4,3,"unio.cat",10
25,"25906",226,144,143,0,1,"unio.cat",3
25,"25012",2296,1504,1488,8,16,"unio.cat",25
25,"25035",397,287,286,3,1,"unio.cat",5
25,"25079",305,216,214,5,2,"unio.cat",9
25,"25002",484,323,321,2,2,"unio.cat",9
25,"25069",453,289,286,6,3,"unio.cat",5
25,"25190",263,195,195,4,0,"unio.cat",2
25,"25094",139,111,109,0,2,"unio.cat",0
25,"25046",421,292,286,1,6,"unio.cat",9
25,"25036",184,126,121,0,5,"unio.cat",4
25,"25141",156,101,99,1,2,"unio.cat",5
25,"25177",372,258,258,2,0,"unio.cat",11
25,"25003",3782,2390,2372,24,18,"unio.cat",48
25,"25040",10532,6837,6762,81,75,"unio.cat",117
25,"25013",2171,1380,1366,10,14,"unio.cat",43
25,"25121",642,415,413,8,2,"unio.cat",0
25,"25142",368,252,251,3,1,"unio.cat",1
25,"25109",238,168,168,1,0,"unio.cat",12
25,"25037",385,245,241,2,4,"unio.cat",9
25,"25122",1916,1274,1264,15,10,"unio.cat",24
25,"25004",571,425,423,5,2,"unio.cat",17
25,"25217",10594,7016,6950,119,66,"unio.cat",148
25,"25110",2796,1828,1807,30,21,"unio.cat",40
25,"25097",87,62,62,4,0,"unio.cat",0
25,"25205",562,413,402,2,11,"unio.cat",14
25,"25014",254,177,174,4,3,"unio.cat",3
25,"25227",641,398,395,3,3,"unio.cat",6
25,"25238",217,151,151,6,0,"unio.cat",6
25,"25038",1564,1075,1062,11,13,"unio.cat",33
25,"25114",97,87,87,0,0,"unio.cat",0
25,"25179",161,115,114,0,1,"unio.cat",3
25,"25015",355,258,257,3,1,"unio.cat",12
25,"25071",51,31,31,0,0,"unio.cat",2
25,"25218",84,66,66,0,0,"unio.cat",0
25,"25228",3043,2140,2118,21,22,"unio.cat",43
25,"25008",1135,828,819,11,9,"unio.cat",19
25,"25254",738,507,493,6,14,"unio.cat",6
25,"25005",277,183,182,2,1,"unio.cat",8
25,"25048",1644,1151,1138,8,13,"unio.cat",26
25,"25206",257,164,164,3,0,"unio.cat",3
25,"25085",152,106,106,0,0,"unio.cat",1
25,"25169",188,125,124,3,1,"unio.cat",1
25,"25910",101,64,62,0,2,"unio.cat",2
25,"25098",253,163,160,2,3,"unio.cat",9
25,"25039",280,182,180,0,2,"unio.cat",1
25,"25029",1662,1156,1147,13,9,"unio.cat",15
25,"25200",336,218,218,0,0,"unio.cat",16
25,"25145",85,64,64,2,0,"unio.cat",0
25,"25112",272,189,189,2,0,"unio.cat",17
25,"25219",144,106,105,3,1,"unio.cat",2
25,"25099",1260,804,793,8,11,"unio.cat",19
25,"25016",2114,1417,1411,8,6,"unio.cat",77
25,"25245",441,313,313,0,0,"unio.cat",10
25,"25249",183,118,118,2,0,"unio.cat",5
25,"25006",346,214,212,6,2,"unio.cat",3
25,"25220",1028,709,701,9,8,"unio.cat",12
25,"25081",318,213,210,2,3,"unio.cat",8
25,"25007",1410,1005,996,13,9,"unio.cat",17
25,"25113",1163,854,845,12,9,"unio.cat",16
25,"25231",490,382,382,2,0,"unio.cat",4
25,"25208",316,191,189,1,2,"unio.cat",1
25,"25196",119,74,74,0,0,"unio.cat",3
25,"25146",224,150,148,2,2,"unio.cat",4
25,"25129",176,113,110,6,3,"unio.cat",6
25,"25074",182,145,141,0,4,"unio.cat",3
25,"25011",5256,3190,3161,36,29,"unio.cat",59
25,"25132",130,97,95,1,2,"unio.cat",3
25,"25242",732,480,477,4,3,"unio.cat",13
25,"25158",1639,1163,1150,26,13,"unio.cat",48
25,"25044",189,136,136,3,0,"unio.cat",4
25,"25148",220,155,153,0,2,"unio.cat",10
25,"25232",1421,961,950,10,11,"unio.cat",25
25,"25075",117,82,82,0,0,"unio.cat",5
25,"25041",569,380,374,7,6,"unio.cat",10
25,"25221",130,76,76,0,0,"unio.cat",1
25,"25165",280,194,190,4,4,"unio.cat",5
25,"25126",286,214,210,5,4,"unio.cat",11
25,"25161",368,234,232,3,2,"unio.cat",5
25,"25222",67,52,52,1,0,"unio.cat",1
25,"25233",278,193,191,2,2,"unio.cat",6
25,"25115",824,551,549,12,2,"unio.cat",11
25,"25042",208,143,142,0,1,"unio.cat",6
25,"25149",1382,1010,993,7,17,"unio.cat",33
25,"25052",1573,1132,1122,16,10,"unio.cat",17
25,"25089",106,58,58,0,0,"unio.cat",1
25,"25020",292,203,200,2,3,"unio.cat",1
25,"25176",312,239,235,7,4,"unio.cat",6
25,"25904",155,118,118,0,0,"unio.cat",1
25,"25009",631,465,460,3,5,"unio.cat",12
25,"25150",185,127,124,1,3,"unio.cat",2
25,"25234",4290,2645,2621,25,24,"unio.cat",50
25,"25223",922,614,598,8,16,"unio.cat",12
25,"25153",198,141,137,0,4,"unio.cat",3
25,"25907",498,317,314,3,3,"unio.cat",8
25,"25043",794,505,501,3,4,"unio.cat",15
25,"25163",228,143,142,5,1,"unio.cat",3
25,"25207",6216,4062,4031,45,31,"unio.cat",86
25,"25118",350,223,223,8,0,"unio.cat",12
25,"25128",142,89,89,0,0,"unio.cat",4
25,"25077",460,272,269,2,3,"unio.cat",15
25,"25151",670,466,459,3,7,"unio.cat",14
25,"25010",212,131,130,6,1,"unio.cat",4
25,"25055",172,118,116,2,2,"unio.cat",0
25,"25192",767,510,496,11,14,"unio.cat",13
25,"25224",126,86,86,1,0,"unio.cat",1
25,"25247",123,72,72,0,0,"unio.cat",0
25,"25174",398,299,296,3,3,"unio.cat",6
25,"25045",52,36,36,0,0,"unio.cat",1
25,"25909",155,89,89,3,0,"unio.cat",0
25,"25056",243,151,150,2,1,"unio.cat",4
25,"25202",101,72,72,0,0,"unio.cat",0
25,"25082",280,169,167,3,2,"unio.cat",6
25,"25078",1007,720,717,6,3,"unio.cat",16
25,"25123",193,131,130,0,1,"unio.cat",3
25,"25022",106,76,76,2,0,"unio.cat",3
25,"25027",1001,687,681,3,6,"unio.cat",43
25,"25155",667,463,459,5,4,"unio.cat",13
25,"25225",575,395,393,6,2,"unio.cat",8
25,"25130",197,117,117,3,0,"unio.cat",3
25,"25072",5858,3878,3835,45,43,"unio.cat",90
25,"25050",3253,2064,2048,27,16,"unio.cat",39
25,"25133",713,469,464,1,5,"unio.cat",10
25,"25240",1407,1006,995,10,11,"unio.cat",26
25,"25120",92243,61433,61005,533,428,"unio.cat",1431
25,"25057",206,152,151,2,1,"unio.cat",7
25,"25156",791,574,571,7,3,"unio.cat",17
25,"25154",120,68,68,1,0,"unio.cat",0
25,"25032",61,44,43,0,1,"unio.cat",0
25,"25064",112,85,85,3,0,"unio.cat",6
25,"25203",8976,5588,5526,53,62,"unio.cat",120
25,"25226",251,156,153,3,3,"unio.cat",4
25,"25166",177,123,121,1,2,"unio.cat",2
25,"25244",369,252,248,3,4,"unio.cat",9
25,"25197",137,97,97,2,0,"unio.cat",2
25,"25124",169,118,116,2,2,"unio.cat",11
25,"25127",212,135,134,3,1,"unio.cat",1
25,"25076",146,84,84,1,0,"unio.cat",0
25,"25131",412,271,261,8,10,"unio.cat",16
25,"25047",1010,730,722,6,8,"unio.cat",24
25,"25059",801,590,584,11,6,"unio.cat",13
25,"25216",226,150,150,0,0,"unio.cat",10
25,"25911",452,301,299,7,2,"unio.cat",16
25,"25191",332,225,222,3,3,"unio.cat",9
25,"25171",2190,1461,1444,4,17,"unio.cat",30
25,"25100",212,134,134,3,0,"unio.cat",5
25,"25180",239,151,151,0,0,"unio.cat",3
25,"25194",426,278,273,0,5,"unio.cat",9
25,"25063",91,55,55,0,0,"unio.cat",1
25,"25204",1241,843,827,3,16,"unio.cat",22
25,"25137",8577,5630,5591,45,39,"unio.cat",96
25,"25062",757,521,516,4,5,"unio.cat",12
25,"25902",570,390,379,3,11,"unio.cat",13
25,"25183",501,332,331,4,1,"unio.cat",8
25,"25136",98,71,70,0,1,"unio.cat",2
25,"25243",3612,2449,2423,30,26,"unio.cat",53
25,"25051",1522,990,983,10,7,"unio.cat",32
25,"25019",4565,3001,2965,36,36,"unio.cat",79
25,"25168",508,392,391,2,1,"unio.cat",9
25,"25255",426,308,302,4,6,"unio.cat",7
25,"25031",52,31,31,0,0,"unio.cat",0
25,"25096",912,586,572,9,14,"unio.cat",10
25,"25181",177,138,137,5,1,"unio.cat",5
25,"25125",424,279,273,4,6,"unio.cat",10
25,"25134",635,418,414,4,4,"unio.cat",6
25,"25193",765,520,514,3,6,"unio.cat",11
25,"25017",239,160,159,2,1,"unio.cat",4
25,"25030",131,86,86,2,0,"unio.cat",6
25,"25073",588,374,371,8,3,"unio.cat",7
25,"25201",115,70,67,0,3,"unio.cat",9
25,"25230",1573,1100,1081,13,19,"unio.cat",28
25,"25049",151,104,104,1,0,"unio.cat",8
25,"25905",386,260,255,4,5,"unio.cat",5
25,"25024",356,233,230,1,3,"unio.cat",1
25,"25152",140,100,98,4,2,"unio.cat",1
25,"25913",87,69,69,1,0,"unio.cat",0
25,"25252",548,399,398,6,1,"unio.cat",38
25,"25135",1032,707,701,7,6,"unio.cat",9
25,"25058",4378,2810,2793,27,17,"unio.cat",66
25,"25087",61,46,45,0,1,"unio.cat",0
25,"25182",1043,738,727,13,11,"unio.cat",13
25,"25034",2331,1516,1505,20,11,"unio.cat",50
25,"25912",868,618,617,5,1,"unio.cat",13
25,"25061",82,53,53,0,0,"unio.cat",7
25,"25250",344,236,234,0,2,"unio.cat",5
25,"25172",1805,1230,1214,8,16,"unio.cat",37
25,"25101",565,393,388,9,5,"unio.cat",19
25,"25023",4527,3111,3073,20,38,"unio.cat",85
25,"25210",1104,779,767,9,12,"unio.cat",18
25,"25053",1059,762,759,10,3,"unio.cat",14
25,"25209",1517,1035,1019,6,16,"unio.cat",18
25,"25164",381,264,262,2,2,"unio.cat",6
25,"25248",891,622,616,3,6,"unio.cat",14
25,"25143",87,58,57,1,1,"unio.cat",0
25,"25138",576,415,408,6,7,"unio.cat",5
25,"25092",132,93,89,1,4,"unio.cat",3
25,"25211",683,427,422,4,5,"unio.cat",7
25,"25157",181,139,137,1,2,"unio.cat",10
25,"25185",681,421,418,8,3,"unio.cat",10
25,"25021",2618,1655,1639,32,16,"unio.cat",57
25,"25060",70,45,45,2,0,"unio.cat",0
25,"25167",236,158,156,3,2,"unio.cat",5
25,"25102",712,473,467,10,6,"unio.cat",9
25,"25908",228,138,137,3,1,"unio.cat",1
25,"25088",96,76,75,0,1,"unio.cat",4
25,"25103",131,80,80,3,0,"unio.cat",0
25,"25173",1702,1180,1171,5,9,"unio.cat",36
25,"25067",730,483,479,4,4,"unio.cat",16
25,"25070",817,584,573,14,11,"unio.cat",18
25,"25901",292,186,181,4,5,"unio.cat",3
25,"25903",237,154,152,3,2,"unio.cat",2
25,"25086",533,373,372,5,1,"unio.cat",4
25,"25186",214,141,138,2,3,"unio.cat",5
25,"25170",264,182,179,1,3,"unio.cat",4
25,"25033",1106,777,767,7,10,"unio.cat",9
25,"25253",163,125,124,0,1,"unio.cat",3
14,"14053",6050,4498,4427,56,71,"PCPE",6
14,"14052",9447,6250,6201,49,49,"PCPE",8
14,"14060",4854,3695,3633,43,62,"PCPE",5
14,"14037",3344,2476,2442,20,34,"PCPE",4
14,"14051",1401,1095,1077,5,18,"PCPE",1
14,"14046",4484,3540,3487,22,53,"PCPE",8
14,"14048",1206,967,949,11,18,"PCPE",2
14,"14036",3767,2911,2857,53,54,"PCPE",10
14,"14018",3710,2882,2846,28,36,"PCPE",3
14,"14049",16357,12206,12029,127,177,"PCPE",21
14,"14035",5992,4475,4437,44,38,"PCPE",6
14,"14067",3874,3033,2986,29,47,"PCPE",6
14,"14022",4036,3199,3169,9,30,"PCPE",7
14,"14025",2950,2460,2425,10,35,"PCPE",3
14,"14019",6479,5131,5076,46,55,"PCPE",6
14,"14064",331,252,244,2,8,"PCPE",0
14,"14016",1364,1047,1045,3,2,"PCPE",0
14,"14006",1331,1166,1137,7,29,"PCPE",3
14,"14026",2073,1437,1421,13,16,"PCPE",2
14,"14068",545,410,407,6,3,"PCPE",1
14,"14054",13665,10923,10678,103,245,"PCPE",12
14,"14070",1343,1026,1008,9,18,"PCPE",1
14,"14005",6358,4379,4272,56,107,"PCPE",6
14,"14021",260189,188939,187558,1934,1381,"PCPE",239
14,"14017",10869,8130,8029,72,101,"PCPE",14
14,"14056",23613,17016,16804,128,212,"PCPE",28
14,"14034",318,260,252,2,8,"PCPE",0
14,"14027",7908,6085,6008,57,77,"PCPE",10
14,"14003",1265,981,970,6,11,"PCPE",0
14,"14057",6152,4973,4903,56,70,"PCPE",15
14,"14010",4051,3003,2968,17,35,"PCPE",2
14,"14023",2041,1742,1717,13,25,"PCPE",1
14,"14059",699,559,552,5,7,"PCPE",1
14,"14011",584,477,476,3,1,"PCPE",0
14,"14031",597,490,484,0,6,"PCPE",0
14,"14001",3552,2861,2830,28,31,"PCPE",6
14,"14042",18921,14842,14653,184,189,"PCPE",29
14,"14032",425,347,335,3,12,"PCPE",0
14,"14062",1052,813,801,4,12,"PCPE",2
14,"14029",4206,3170,3135,32,35,"PCPE",10
14,"14028",320,246,244,2,2,"PCPE",1
14,"14055",18572,13587,13410,167,177,"PCPE",30
14,"14038",32236,22982,22773,209,209,"PCPE",52
14,"14012",6190,4574,4488,27,86,"PCPE",6
14,"14069",7536,5574,5495,48,79,"PCPE",8
14,"14050",2399,1886,1864,11,22,"PCPE",4
14,"14033",1285,980,963,11,17,"PCPE",3
14,"14002",10951,8231,8150,72,81,"PCPE",114
14,"14063",1065,803,797,4,6,"PCPE",0
14,"14040",3792,3036,3010,23,26,"PCPE",10
14,"14030",8580,6619,6542,66,77,"PCPE",12
14,"14043",7574,5571,5510,46,61,"PCPE",5
14,"14009",2779,1941,1934,13,7,"PCPE",5
14,"14066",5890,4366,4322,29,44,"PCPE",27
14,"14039",2628,2151,2123,11,28,"PCPE",7
14,"14007",15200,11064,10926,81,138,"PCPE",22
14,"14074",2303,1940,1929,13,11,"PCPE",2
14,"14073",2900,2068,2041,15,27,"PCPE",5
14,"14020",391,278,274,3,4,"PCPE",0
14,"14041",3180,2404,2373,26,31,"PCPE",6
14,"14058",7973,5860,5791,49,69,"PCPE",11
14,"14014",2570,2104,2075,8,29,"PCPE",4
14,"14071",937,651,642,2,9,"PCPE",2
14,"14044",1624,1285,1267,9,18,"PCPE",2
14,"14004",2036,1502,1488,6,14,"PCPE",4
14,"14061",756,606,592,2,14,"PCPE",1
14,"14047",1654,1221,1211,17,10,"PCPE",2
14,"14024",1920,1522,1488,10,34,"PCPE",5
14,"14008",2871,2053,2034,11,19,"PCPE",3
14,"14065",1861,1461,1446,12,15,"PCPE",3
14,"14013",16845,12599,12414,146,185,"PCPE",23
14,"14045",3055,2486,2451,13,35,"PCPE",10
14,"14075",581,463,446,6,17,"PCPE",2
14,"14015",2149,1637,1616,13,21,"PCPE",4
14,"14072",1079,834,830,5,4,"PCPE",1
25,"25136",98,71,70,0,1,"ERC-CATSI",22
25,"25247",123,72,72,0,0,"ERC-CATSI",5
25,"25179",161,115,114,0,1,"ERC-CATSI",30
25,"25034",2331,1516,1505,20,11,"ERC-CATSI",459
25,"25063",91,55,55,0,0,"ERC-CATSI",2
25,"25209",1517,1035,1019,6,16,"ERC-CATSI",272
25,"25059",801,590,584,11,6,"ERC-CATSI",31
25,"25234",4290,2645,2621,25,24,"ERC-CATSI",582
25,"25008",1135,828,819,11,9,"ERC-CATSI",164
25,"25004",571,425,423,5,2,"ERC-CATSI",126
25,"25104",125,86,86,3,0,"ERC-CATSI",14
25,"25173",1702,1180,1171,5,9,"ERC-CATSI",169
25,"25208",316,191,189,1,2,"ERC-CATSI",56
25,"25019",4565,3001,2965,36,36,"ERC-CATSI",491
25,"25048",1644,1151,1138,8,13,"ERC-CATSI",301
25,"25020",292,203,200,2,3,"ERC-CATSI",58
25,"25200",336,218,218,0,0,"ERC-CATSI",97
25,"25192",767,510,496,11,14,"ERC-CATSI",152
25,"25003",3782,2390,2372,24,18,"ERC-CATSI",733
25,"25141",156,101,99,1,2,"ERC-CATSI",29
25,"25123",193,131,130,0,1,"ERC-CATSI",51
25,"25122",1916,1274,1264,15,10,"ERC-CATSI",446
25,"25180",239,151,151,0,0,"ERC-CATSI",38
25,"25100",212,134,134,3,0,"ERC-CATSI",21
25,"25202",101,72,72,0,0,"ERC-CATSI",22
25,"25035",397,287,286,3,1,"ERC-CATSI",59
25,"25033",1106,777,767,7,10,"ERC-CATSI",220
25,"25219",144,106,105,3,1,"ERC-CATSI",43
25,"25053",1059,762,759,10,3,"ERC-CATSI",179
25,"25238",217,151,151,6,0,"ERC-CATSI",41
25,"25025",1346,966,956,10,10,"ERC-CATSI",69
25,"25001",139,88,87,1,1,"ERC-CATSI",23
25,"25029",1662,1156,1147,13,9,"ERC-CATSI",344
25,"25904",155,118,118,0,0,"ERC-CATSI",27
25,"25166",177,123,121,1,2,"ERC-CATSI",51
25,"25150",185,127,124,1,3,"ERC-CATSI",29
25,"25103",131,80,80,3,0,"ERC-CATSI",19
25,"25148",220,155,153,0,2,"ERC-CATSI",41
25,"25215",334,244,243,2,1,"ERC-CATSI",51
25,"25207",6216,4062,4031,45,31,"ERC-CATSI",1327
25,"25251",710,495,494,3,1,"ERC-CATSI",119
25,"25181",177,138,137,5,1,"ERC-CATSI",23
25,"25073",588,374,371,8,3,"ERC-CATSI",109
25,"25223",922,614,598,8,16,"ERC-CATSI",215
25,"25092",132,93,89,1,4,"ERC-CATSI",38
25,"25190",263,195,195,4,0,"ERC-CATSI",68
25,"25011",5256,3190,3161,36,29,"ERC-CATSI",773
25,"25212",234,173,171,1,2,"ERC-CATSI",38
25,"25044",189,136,136,3,0,"ERC-CATSI",24
25,"25071",51,31,31,0,0,"ERC-CATSI",12
25,"25030",131,86,86,2,0,"ERC-CATSI",20
25,"25912",868,618,617,5,1,"ERC-CATSI",79
25,"25155",667,463,459,5,4,"ERC-CATSI",112
25,"25046",421,292,286,1,6,"ERC-CATSI",95
25,"25127",212,135,134,3,1,"ERC-CATSI",57
25,"25069",453,289,286,6,3,"ERC-CATSI",94
25,"25137",8577,5630,5591,45,39,"ERC-CATSI",1186
25,"25157",181,139,137,1,2,"ERC-CATSI",30
25,"25135",1032,707,701,7,6,"ERC-CATSI",169
25,"25165",280,194,190,4,4,"ERC-CATSI",52
25,"25094",139,111,109,0,2,"ERC-CATSI",21
25,"25218",84,66,66,0,0,"ERC-CATSI",25
25,"25145",85,64,64,2,0,"ERC-CATSI",19
25,"25227",641,398,395,3,3,"ERC-CATSI",120
25,"25022",106,76,76,2,0,"ERC-CATSI",16
25,"25112",272,189,189,2,0,"ERC-CATSI",38
25,"25224",126,86,86,1,0,"ERC-CATSI",31
25,"25055",172,118,116,2,2,"ERC-CATSI",19
25,"25907",498,317,314,3,3,"ERC-CATSI",112
25,"25024",356,233,230,1,3,"ERC-CATSI",79
25,"25064",112,85,85,3,0,"ERC-CATSI",20
25,"25132",130,97,95,1,2,"ERC-CATSI",29
25,"25163",228,143,142,5,1,"ERC-CATSI",45
25,"25252",548,399,398,6,1,"ERC-CATSI",90
25,"25006",346,214,212,6,2,"ERC-CATSI",53
25,"25131",412,271,261,8,10,"ERC-CATSI",78
25,"25177",372,258,258,2,0,"ERC-CATSI",69
25,"25138",576,415,408,6,7,"ERC-CATSI",132
25,"25232",1421,961,950,10,11,"ERC-CATSI",244
25,"25115",824,551,549,12,2,"ERC-CATSI",142
25,"25079",305,216,214,5,2,"ERC-CATSI",52
25,"25140",774,468,465,4,3,"ERC-CATSI",119
25,"25068",558,372,369,9,3,"ERC-CATSI",91
25,"25225",575,395,393,6,2,"ERC-CATSI",125
25,"25909",155,89,89,3,0,"ERC-CATSI",15
25,"25142",368,252,251,3,1,"ERC-CATSI",108
25,"25217",10594,7016,6950,119,66,"ERC-CATSI",1656
25,"25902",570,390,379,3,11,"ERC-CATSI",121
25,"25097",87,62,62,4,0,"ERC-CATSI",29
25,"25158",1639,1163,1150,26,13,"ERC-CATSI",316
25,"25007",1410,1005,996,13,9,"ERC-CATSI",198
25,"25031",52,31,31,0,0,"ERC-CATSI",0
25,"25193",765,520,514,3,6,"ERC-CATSI",157
25,"25051",1522,990,983,10,7,"ERC-CATSI",308
25,"25120",92243,61433,61005,533,428,"ERC-CATSI",9648
25,"25244",369,252,248,3,4,"ERC-CATSI",64
25,"25105",130,95,93,4,2,"ERC-CATSI",16
25,"25240",1407,1006,995,10,11,"ERC-CATSI",242
25,"25903",237,154,152,3,2,"ERC-CATSI",56
25,"25906",226,144,143,0,1,"ERC-CATSI",42
25,"25248",891,622,616,3,6,"ERC-CATSI",197
25,"25233",278,193,191,2,2,"ERC-CATSI",40
25,"25133",713,469,464,1,5,"ERC-CATSI",112
25,"25060",70,45,45,2,0,"ERC-CATSI",6
25,"25203",8976,5588,5526,53,62,"ERC-CATSI",1098
25,"25086",533,373,372,5,1,"ERC-CATSI",130
25,"25016",2114,1417,1411,8,6,"ERC-CATSI",387
25,"25052",1573,1132,1122,16,10,"ERC-CATSI",436
25,"25149",1382,1010,993,7,17,"ERC-CATSI",243
25,"25078",1007,720,717,6,3,"ERC-CATSI",220
25,"25913",87,69,69,1,0,"ERC-CATSI",27
25,"25170",264,182,179,1,3,"ERC-CATSI",63
25,"25226",251,156,153,3,3,"ERC-CATSI",42
25,"25124",169,118,116,2,2,"ERC-CATSI",25
25,"25249",183,118,118,2,0,"ERC-CATSI",48
25,"25009",631,465,460,3,5,"ERC-CATSI",113
25,"25146",224,150,148,2,2,"ERC-CATSI",31
25,"25125",424,279,273,4,6,"ERC-CATSI",112
25,"25221",130,76,76,0,0,"ERC-CATSI",18
25,"25201",115,70,67,0,3,"ERC-CATSI",10
25,"25041",569,380,374,7,6,"ERC-CATSI",104
25,"25230",1573,1100,1081,13,19,"ERC-CATSI",283
25,"25102",712,473,467,10,6,"ERC-CATSI",62
25,"25076",146,84,84,1,0,"ERC-CATSI",35
25,"25196",119,74,74,0,0,"ERC-CATSI",15
25,"25129",176,113,110,6,3,"ERC-CATSI",36
25,"25250",344,236,234,0,2,"ERC-CATSI",97
25,"25905",386,260,255,4,5,"ERC-CATSI",74
25,"25113",1163,854,845,12,9,"ERC-CATSI",239
25,"25067",730,483,479,4,4,"ERC-CATSI",130
25,"25152",140,100,98,4,2,"ERC-CATSI",31
25,"25156",791,574,571,7,3,"ERC-CATSI",147
25,"25185",681,421,418,8,3,"ERC-CATSI",113
25,"25012",2296,1504,1488,8,16,"ERC-CATSI",313
25,"25039",280,182,180,0,2,"ERC-CATSI",55
25,"25167",236,158,156,3,2,"ERC-CATSI",43
25,"25075",117,82,82,0,0,"ERC-CATSI",30
25,"25056",243,151,150,2,1,"ERC-CATSI",48
25,"25114",97,87,87,0,0,"ERC-CATSI",30
25,"25005",277,183,182,2,1,"ERC-CATSI",38
25,"25143",87,58,57,1,1,"ERC-CATSI",12
25,"25175",194,132,132,7,0,"ERC-CATSI",26
25,"25111",115,83,83,1,0,"ERC-CATSI",20
25,"25239",608,320,319,1,1,"ERC-CATSI",68
25,"25070",817,584,573,14,11,"ERC-CATSI",172
25,"25908",228,138,137,3,1,"ERC-CATSI",41
25,"25037",385,245,241,2,4,"ERC-CATSI",79
25,"25118",350,223,223,8,0,"ERC-CATSI",46
25,"25210",1104,779,767,9,12,"ERC-CATSI",190
25,"25057",206,152,151,2,1,"ERC-CATSI",9
25,"25089",106,58,58,0,0,"ERC-CATSI",23
25,"25130",197,117,117,3,0,"ERC-CATSI",34
25,"25255",426,308,302,4,6,"ERC-CATSI",84
25,"25043",794,505,501,3,4,"ERC-CATSI",169
25,"25216",226,150,150,0,0,"ERC-CATSI",35
25,"25119",2259,1582,1569,22,13,"ERC-CATSI",458
25,"25062",757,521,516,4,5,"ERC-CATSI",162
25,"25134",635,418,414,4,4,"ERC-CATSI",124
25,"25182",1043,738,727,13,11,"ERC-CATSI",166
25,"25176",312,239,235,7,4,"ERC-CATSI",54
25,"25032",61,44,43,0,1,"ERC-CATSI",25
25,"25161",368,234,232,3,2,"ERC-CATSI",77
25,"25074",182,145,141,0,4,"ERC-CATSI",54
25,"25082",280,169,167,3,2,"ERC-CATSI",49
25,"25139",479,325,324,3,1,"ERC-CATSI",117
25,"25021",2618,1655,1639,32,16,"ERC-CATSI",460
25,"25242",732,480,477,4,3,"ERC-CATSI",128
25,"25171",2190,1461,1444,4,17,"ERC-CATSI",435
25,"25254",738,507,493,6,14,"ERC-CATSI",141
25,"25197",137,97,97,2,0,"ERC-CATSI",31
25,"25015",355,258,257,3,1,"ERC-CATSI",76
25,"25228",3043,2140,2118,21,22,"ERC-CATSI",455
25,"25101",565,393,388,9,5,"ERC-CATSI",145
25,"25901",292,186,181,4,5,"ERC-CATSI",48
25,"25109",238,168,168,1,0,"ERC-CATSI",33
25,"25002",484,323,321,2,2,"ERC-CATSI",129
25,"25045",52,36,36,0,0,"ERC-CATSI",3
25,"25168",508,392,391,2,1,"ERC-CATSI",109
25,"25172",1805,1230,1214,8,16,"ERC-CATSI",365
25,"25088",96,76,75,0,1,"ERC-CATSI",15
25,"25243",3612,2449,2423,30,26,"ERC-CATSI",166
25,"25013",2171,1380,1366,10,14,"ERC-CATSI",190
25,"25049",151,104,104,1,0,"ERC-CATSI",23
25,"25087",61,46,45,0,1,"ERC-CATSI",19
25,"25911",452,301,299,7,2,"ERC-CATSI",89
25,"25072",5858,3878,3835,45,43,"ERC-CATSI",886
25,"25098",253,163,160,2,3,"ERC-CATSI",36
25,"25222",67,52,52,1,0,"ERC-CATSI",10
25,"25151",670,466,459,3,7,"ERC-CATSI",127
25,"25042",208,143,142,0,1,"ERC-CATSI",30
25,"25204",1241,843,827,3,16,"ERC-CATSI",243
25,"25014",254,177,174,4,3,"ERC-CATSI",71
25,"25017",239,160,159,2,1,"ERC-CATSI",44
25,"25036",184,126,121,0,5,"ERC-CATSI",27
25,"25099",1260,804,793,8,11,"ERC-CATSI",208
25,"25110",2796,1828,1807,30,21,"ERC-CATSI",483
25,"25047",1010,730,722,6,8,"ERC-CATSI",220
25,"25085",152,106,106,0,0,"ERC-CATSI",32
25,"25121",642,415,413,8,2,"ERC-CATSI",19
25,"25027",1001,687,681,3,6,"ERC-CATSI",216
25,"25183",501,332,331,4,1,"ERC-CATSI",91
25,"25023",4527,3111,3073,20,38,"ERC-CATSI",614
25,"25050",3253,2064,2048,27,16,"ERC-CATSI",628
25,"25093",639,451,445,11,6,"ERC-CATSI",100
25,"25126",286,214,210,5,4,"ERC-CATSI",47
25,"25174",398,299,296,3,3,"ERC-CATSI",46
25,"25040",10532,6837,6762,81,75,"ERC-CATSI",1413
25,"25220",1028,709,701,9,8,"ERC-CATSI",208
25,"25154",120,68,68,1,0,"ERC-CATSI",16
25,"25077",460,272,269,2,3,"ERC-CATSI",104
25,"25189",2106,1392,1381,16,11,"ERC-CATSI",304
25,"25194",426,278,273,0,5,"ERC-CATSI",56
25,"25038",1564,1075,1062,11,13,"ERC-CATSI",192
25,"25910",101,64,62,0,2,"ERC-CATSI",22
25,"25096",912,586,572,9,14,"ERC-CATSI",174
25,"25186",214,141,138,2,3,"ERC-CATSI",45
25,"25245",441,313,313,0,0,"ERC-CATSI",62
25,"25061",82,53,53,0,0,"ERC-CATSI",10
25,"25153",198,141,137,0,4,"ERC-CATSI",33
25,"25206",257,164,164,3,0,"ERC-CATSI",61
25,"25205",562,413,402,2,11,"ERC-CATSI",80
25,"25191",332,225,222,3,3,"ERC-CATSI",57
25,"25058",4378,2810,2793,27,17,"ERC-CATSI",884
25,"25211",683,427,422,4,5,"ERC-CATSI",169
25,"25128",142,89,89,0,0,"ERC-CATSI",21
25,"25081",318,213,210,2,3,"ERC-CATSI",50
25,"25253",163,125,124,0,1,"ERC-CATSI",53
25,"25164",381,264,262,2,2,"ERC-CATSI",66
25,"25010",212,131,130,6,1,"ERC-CATSI",48
25,"25169",188,125,124,3,1,"ERC-CATSI",37
25,"25231",490,382,382,2,0,"ERC-CATSI",143
25,"25031",52,31,31,0,0,"PP",5
25,"25221",130,76,76,0,0,"PP",6
25,"25158",1639,1163,1150,26,13,"PP",55
25,"25027",1001,687,681,3,6,"PP",47
25,"25906",226,144,143,0,1,"PP",7
25,"25110",2796,1828,1807,30,21,"PP",124
25,"25181",177,138,137,5,1,"PP",15
25,"25037",385,245,241,2,4,"PP",25
25,"25034",2331,1516,1505,20,11,"PP",143
25,"25255",426,308,302,4,6,"PP",35
25,"25104",125,86,86,3,0,"PP",8
25,"25048",1644,1151,1138,8,13,"PP",101
25,"25217",10594,7016,6950,119,66,"PP",541
25,"25122",1916,1274,1264,15,10,"PP",108
25,"25205",562,413,402,2,11,"PP",38
25,"25219",144,106,105,3,1,"PP",9
25,"25010",212,131,130,6,1,"PP",4
25,"25131",412,271,261,8,10,"PP",23
25,"25208",316,191,189,1,2,"PP",9
25,"25223",922,614,598,8,16,"PP",26
25,"25212",234,173,171,1,2,"PP",13
25,"25197",137,97,97,2,0,"PP",3
25,"25074",182,145,141,0,4,"PP",5
25,"25232",1421,961,950,10,11,"PP",109
25,"25163",228,143,142,5,1,"PP",9
25,"25202",101,72,72,0,0,"PP",2
25,"25021",2618,1655,1639,32,16,"PP",121
25,"25903",237,154,152,3,2,"PP",4
25,"25071",51,31,31,0,0,"PP",1
25,"25001",139,88,87,1,1,"PP",6
25,"25004",571,425,423,5,2,"PP",31
25,"25094",139,111,109,0,2,"PP",17
25,"25186",214,141,138,2,3,"PP",10
25,"25121",642,415,413,8,2,"PP",75
25,"25109",238,168,168,1,0,"PP",9
25,"25025",1346,966,956,10,10,"PP",184
25,"25210",1104,779,767,9,12,"PP",73
25,"25185",681,421,418,8,3,"PP",32
25,"25006",346,214,212,6,2,"PP",25
25,"25035",397,287,286,3,1,"PP",27
25,"25046",421,292,286,1,6,"PP",39
25,"25130",197,117,117,3,0,"PP",3
25,"25118",350,223,223,8,0,"PP",23
25,"25081",318,213,210,2,3,"PP",18
25,"25061",82,53,53,0,0,"PP",1
25,"25128",142,89,89,0,0,"PP",3
25,"25224",126,86,86,1,0,"PP",7
25,"25174",398,299,296,3,3,"PP",25
25,"25079",305,216,214,5,2,"PP",24
25,"25100",212,134,134,3,0,"PP",3
25,"25912",868,618,617,5,1,"PP",101
25,"25022",106,76,76,2,0,"PP",1
25,"25249",183,118,118,2,0,"PP",17
25,"25008",1135,828,819,11,9,"PP",113
25,"25011",5256,3190,3161,36,29,"PP",357
25,"25134",635,418,414,4,4,"PP",41
25,"25140",774,468,465,4,3,"PP",39
25,"25058",4378,2810,2793,27,17,"PP",193
25,"25093",639,451,445,11,6,"PP",41
25,"25904",155,118,118,0,0,"PP",9
25,"25244",369,252,248,3,4,"PP",28
25,"25157",181,139,137,1,2,"PP",13
25,"25049",151,104,104,1,0,"PP",10
25,"25240",1407,1006,995,10,11,"PP",132
25,"25002",484,323,321,2,2,"PP",26
25,"25200",336,218,218,0,0,"PP",6
25,"25016",2114,1417,1411,8,6,"PP",125
25,"25102",712,473,467,10,6,"PP",56
25,"25192",767,510,496,11,14,"PP",47
25,"25170",264,182,179,1,3,"PP",9
25,"25206",257,164,164,3,0,"PP",5
25,"25023",4527,3111,3073,20,38,"PP",344
25,"25077",460,272,269,2,3,"PP",21
25,"25155",667,463,459,5,4,"PP",54
25,"25132",130,97,95,1,2,"PP",4
25,"25905",386,260,255,4,5,"PP",38
25,"25067",730,483,479,4,4,"PP",79
25,"25017",239,160,159,2,1,"PP",9
25,"25168",508,392,391,2,1,"PP",55
25,"25175",194,132,132,7,0,"PP",19
25,"25078",1007,720,717,6,3,"PP",49
25,"25114",97,87,87,0,0,"PP",2
25,"25055",172,118,116,2,2,"PP",16
25,"25234",4290,2645,2621,25,24,"PP",253
25,"25204",1241,843,827,3,16,"PP",89
25,"25216",226,150,150,0,0,"PP",18
25,"25138",576,415,408,6,7,"PP",45
25,"25059",801,590,584,11,6,"PP",147
25,"25039",280,182,180,0,2,"PP",7
25,"25120",92243,61433,61005,533,428,"PP",9250
25,"25029",1662,1156,1147,13,9,"PP",83
25,"25193",765,520,514,3,6,"PP",29
25,"25069",453,289,286,6,3,"PP",23
25,"25009",631,465,460,3,5,"PP",58
25,"25133",713,469,464,1,5,"PP",53
25,"25913",87,69,69,1,0,"PP",3
25,"25047",1010,730,722,6,8,"PP",43
25,"25250",344,236,234,0,2,"PP",17
25,"25196",119,74,74,0,0,"PP",8
25,"25902",570,390,379,3,11,"PP",50
25,"25239",608,320,319,1,1,"PP",27
25,"25087",61,46,45,0,1,"PP",0
25,"25041",569,380,374,7,6,"PP",47
25,"25171",2190,1461,1444,4,17,"PP",74
25,"25020",292,203,200,2,3,"PP",28
25,"25136",98,71,70,0,1,"PP",9
25,"25148",220,155,153,0,2,"PP",8
25,"25076",146,84,84,1,0,"PP",3
25,"25003",3782,2390,2372,24,18,"PP",239
25,"25209",1517,1035,1019,6,16,"PP",71
25,"25126",286,214,210,5,4,"PP",18
25,"25032",61,44,43,0,1,"PP",0
25,"25068",558,372,369,9,3,"PP",23
25,"25907",498,317,314,3,3,"PP",27
25,"25238",217,151,151,6,0,"PP",9
25,"25190",263,195,195,4,0,"PP",4
25,"25910",101,64,62,0,2,"PP",2
25,"25064",112,85,85,3,0,"PP",3
25,"25137",8577,5630,5591,45,39,"PP",509
25,"25045",52,36,36,0,0,"PP",7
25,"25101",565,393,388,9,5,"PP",9
25,"25247",123,72,72,0,0,"PP",6
25,"25063",91,55,55,0,0,"PP",13
25,"25146",224,150,148,2,2,"PP",16
25,"25145",85,64,64,2,0,"PP",2
25,"25911",452,301,299,7,2,"PP",18
25,"25129",176,113,110,6,3,"PP",3
25,"25233",278,193,191,2,2,"PP",19
25,"25014",254,177,174,4,3,"PP",8
25,"25096",912,586,572,9,14,"PP",76
25,"25220",1028,709,701,9,8,"PP",95
25,"25053",1059,762,759,10,3,"PP",73
25,"25908",228,138,137,3,1,"PP",15
25,"25203",8976,5588,5526,53,62,"PP",596
25,"25215",334,244,243,2,1,"PP",24
25,"25253",163,125,124,0,1,"PP",8
25,"25901",292,186,181,4,5,"PP",22
25,"25179",161,115,114,0,1,"PP",7
25,"25142",368,252,251,3,1,"PP",24
25,"25225",575,395,393,6,2,"PP",37
25,"25194",426,278,273,0,5,"PP",37
25,"25161",368,234,232,3,2,"PP",8
25,"25062",757,521,516,4,5,"PP",45
25,"25075",117,82,82,0,0,"PP",2
25,"25057",206,152,151,2,1,"PP",27
25,"25222",67,52,52,1,0,"PP",9
25,"25005",277,183,182,2,1,"PP",17
25,"25251",710,495,494,3,1,"PP",53
25,"25150",185,127,124,1,3,"PP",14
25,"25012",2296,1504,1488,8,16,"PP",116
25,"25019",4565,3001,2965,36,36,"PP",380
25,"25909",155,89,89,3,0,"PP",6
25,"25176",312,239,235,7,4,"PP",32
25,"25030",131,86,86,2,0,"PP",4
25,"25044",189,136,136,3,0,"PP",25
25,"25015",355,258,257,3,1,"PP",26
25,"25218",84,66,66,0,0,"PP",0
25,"25070",817,584,573,14,11,"PP",36
25,"25073",588,374,371,8,3,"PP",20
25,"25201",115,70,67,0,3,"PP",7
25,"25097",87,62,62,4,0,"PP",11
25,"25154",120,68,68,1,0,"PP",4
25,"25139",479,325,324,3,1,"PP",12
25,"25052",1573,1132,1122,16,10,"PP",61
25,"25173",1702,1180,1171,5,9,"PP",107
25,"25182",1043,738,727,13,11,"PP",87
25,"25189",2106,1392,1381,16,11,"PP",112
25,"25056",243,151,150,2,1,"PP",8
25,"25125",424,279,273,4,6,"PP",34
25,"25119",2259,1582,1569,22,13,"PP",105
25,"25228",3043,2140,2118,21,22,"PP",182
25,"25060",70,45,45,2,0,"PP",5
25,"25105",130,95,93,4,2,"PP",6
25,"25149",1382,1010,993,7,17,"PP",75
25,"25135",1032,707,701,7,6,"PP",37
25,"25152",140,100,98,4,2,"PP",12
25,"25151",670,466,459,3,7,"PP",33
25,"25226",251,156,153,3,3,"PP",14
25,"25013",2171,1380,1366,10,14,"PP",199
25,"25086",533,373,372,5,1,"PP",11
25,"25112",272,189,189,2,0,"PP",28
25,"25127",212,135,134,3,1,"PP",3
25,"25165",280,194,190,4,4,"PP",16
25,"25248",891,622,616,3,6,"PP",32
25,"25252",548,399,398,6,1,"PP",49
25,"25024",356,233,230,1,3,"PP",6
25,"25177",372,258,258,2,0,"PP",26
25,"25183",501,332,331,4,1,"PP",20
25,"25113",1163,854,845,12,9,"PP",66
25,"25089",106,58,58,0,0,"PP",1
25,"25050",3253,2064,2048,27,16,"PP",161
25,"25033",1106,777,767,7,10,"PP",40
25,"25124",169,118,116,2,2,"PP",15
25,"25082",280,169,167,3,2,"PP",5
25,"25051",1522,990,983,10,7,"PP",66
25,"25230",1573,1100,1081,13,19,"PP",134
25,"25007",1410,1005,996,13,9,"PP",82
25,"25088",96,76,75,0,1,"PP",3
25,"25098",253,163,160,2,3,"PP",7
25,"25243",3612,2449,2423,30,26,"PP",481
25,"25099",1260,804,793,8,11,"PP",47
25,"25207",6216,4062,4031,45,31,"PP",288
25,"25227",641,398,395,3,3,"PP",16
25,"25164",381,264,262,2,2,"PP",14
25,"25231",490,382,382,2,0,"PP",33
25,"25167",236,158,156,3,2,"PP",23
25,"25166",177,123,121,1,2,"PP",17
25,"25111",115,83,83,1,0,"PP",9
25,"25172",1805,1230,1214,8,16,"PP",130
25,"25085",152,106,106,0,0,"PP",19
25,"25143",87,58,57,1,1,"PP",8
25,"25156",791,574,571,7,3,"PP",39
25,"25040",10532,6837,6762,81,75,"PP",776
25,"25115",824,551,549,12,2,"PP",35
25,"25103",131,80,80,3,0,"PP",11
25,"25092",132,93,89,1,4,"PP",2
25,"25036",184,126,121,0,5,"PP",22
25,"25242",732,480,477,4,3,"PP",42
25,"25043",794,505,501,3,4,"PP",15
25,"25245",441,313,313,0,0,"PP",27
25,"25254",738,507,493,6,14,"PP",70
25,"25042",208,143,142,0,1,"PP",19
25,"25169",188,125,124,3,1,"PP",8
25,"25180",239,151,151,0,0,"PP",11
25,"25191",332,225,222,3,3,"PP",33
25,"25211",683,427,422,4,5,"PP",42
25,"25123",193,131,130,0,1,"PP",1
25,"25038",1564,1075,1062,11,13,"PP",181
25,"25153",198,141,137,0,4,"PP",28
25,"25072",5858,3878,3835,45,43,"PP",417
25,"25141",156,101,99,1,2,"PP",11
25,"25118",350,223,223,8,0,"PACMA",2
25,"25045",52,36,36,0,0,"PACMA",0
25,"25001",139,88,87,1,1,"PACMA",0
25,"25232",1421,961,950,10,11,"PACMA",8
25,"25170",264,182,179,1,3,"PACMA",1
25,"25157",181,139,137,1,2,"PACMA",1
25,"25250",344,236,234,0,2,"PACMA",1
25,"25136",98,71,70,0,1,"PACMA",0
25,"25181",177,138,137,5,1,"PACMA",1
25,"25210",1104,779,767,9,12,"PACMA",1
25,"25032",61,44,43,0,1,"PACMA",0
25,"25135",1032,707,701,7,6,"PACMA",8
25,"25110",2796,1828,1807,30,21,"PACMA",17
25,"25192",767,510,496,11,14,"PACMA",1
25,"25217",10594,7016,6950,119,66,"PACMA",45
25,"25071",51,31,31,0,0,"PACMA",2
25,"25164",381,264,262,2,2,"PACMA",0
25,"25027",1001,687,681,3,6,"PACMA",2
25,"25031",52,31,31,0,0,"PACMA",0
25,"25906",226,144,143,0,1,"PACMA",0
25,"25904",155,118,118,0,0,"PACMA",0
25,"25179",161,115,114,0,1,"PACMA",0
25,"25902",570,390,379,3,11,"PACMA",0
25,"25086",533,373,372,5,1,"PACMA",2
25,"25211",683,427,422,4,5,"PACMA",3
25,"25234",4290,2645,2621,25,24,"PACMA",22
25,"25006",346,214,212,6,2,"PACMA",0
25,"25121",642,415,413,8,2,"PACMA",9
25,"25197",137,97,97,2,0,"PACMA",1
25,"25082",280,169,167,3,2,"PACMA",1
25,"25011",5256,3190,3161,36,29,"PACMA",33
25,"25168",508,392,391,2,1,"PACMA",0
25,"25240",1407,1006,995,10,11,"PACMA",5
25,"25140",774,468,465,4,3,"PACMA",6
25,"25130",197,117,117,3,0,"PACMA",2
25,"25141",156,101,99,1,2,"PACMA",1
25,"25047",1010,730,722,6,8,"PACMA",3
25,"25096",912,586,572,9,14,"PACMA",1
25,"25132",130,97,95,1,2,"PACMA",2
25,"25104",125,86,86,3,0,"PACMA",1
25,"25050",3253,2064,2048,27,16,"PACMA",11
25,"25113",1163,854,845,12,9,"PACMA",6
25,"25156",791,574,571,7,3,"PACMA",4
25,"25060",70,45,45,2,0,"PACMA",0
25,"25169",188,125,124,3,1,"PACMA",0
25,"25221",130,76,76,0,0,"PACMA",2
25,"25233",278,193,191,2,2,"PACMA",0
25,"25120",92243,61433,61005,533,428,"PACMA",799
25,"25227",641,398,395,3,3,"PACMA",0
25,"25073",588,374,371,8,3,"PACMA",3
25,"25004",571,425,423,5,2,"PACMA",1
25,"25145",85,64,64,2,0,"PACMA",0
25,"25163",228,143,142,5,1,"PACMA",0
25,"25154",120,68,68,1,0,"PACMA",0
25,"25074",182,145,141,0,4,"PACMA",0
25,"25003",3782,2390,2372,24,18,"PACMA",7
25,"25112",272,189,189,2,0,"PACMA",3
25,"25067",730,483,479,4,4,"PACMA",3
25,"25057",206,152,151,2,1,"PACMA",3
25,"25139",479,325,324,3,1,"PACMA",1
25,"25203",8976,5588,5526,53,62,"PACMA",51
25,"25225",575,395,393,6,2,"PACMA",2
25,"25077",460,272,269,2,3,"PACMA",2
25,"25128",142,89,89,0,0,"PACMA",1
25,"25040",10532,6837,6762,81,75,"PACMA",56
25,"25155",667,463,459,5,4,"PACMA",2
25,"25185",681,421,418,8,3,"PACMA",2
25,"25015",355,258,257,3,1,"PACMA",2
25,"25151",670,466,459,3,7,"PACMA",4
25,"25078",1007,720,717,6,3,"PACMA",1
25,"25171",2190,1461,1444,4,17,"PACMA",8
25,"25019",4565,3001,2965,36,36,"PACMA",17
25,"25202",101,72,72,0,0,"PACMA",0
25,"25023",4527,3111,3073,20,38,"PACMA",24
25,"25061",82,53,53,0,0,"PACMA",0
25,"25052",1573,1132,1122,16,10,"PACMA",3
25,"25014",254,177,174,4,3,"PACMA",0
25,"25190",263,195,195,4,0,"PACMA",1
25,"25056",243,151,150,2,1,"PACMA",1
25,"25205",562,413,402,2,11,"PACMA",5
25,"25064",112,85,85,3,0,"PACMA",0
25,"25152",140,100,98,4,2,"PACMA",3
25,"25076",146,84,84,1,0,"PACMA",0
25,"25248",891,622,616,3,6,"PACMA",6
25,"25115",824,551,549,12,2,"PACMA",1
25,"25910",101,64,62,0,2,"PACMA",1
25,"25252",548,399,398,6,1,"PACMA",3
25,"25101",565,393,388,9,5,"PACMA",4
25,"25079",305,216,214,5,2,"PACMA",0
25,"25036",184,126,121,0,5,"PACMA",0
25,"25907",498,317,314,3,3,"PACMA",2
25,"25021",2618,1655,1639,32,16,"PACMA",16
25,"25153",198,141,137,0,4,"PACMA",0
25,"25022",106,76,76,2,0,"PACMA",0
25,"25226",251,156,153,3,3,"PACMA",0
25,"25230",1573,1100,1081,13,19,"PACMA",3
25,"25131",412,271,261,8,10,"PACMA",0
25,"25911",452,301,299,7,2,"PACMA",0
25,"25138",576,415,408,6,7,"PACMA",3
25,"25191",332,225,222,3,3,"PACMA",0
25,"25102",712,473,467,10,6,"PACMA",5
25,"25231",490,382,382,2,0,"PACMA",2
25,"25025",1346,966,956,10,10,"PACMA",7
25,"25238",217,151,151,6,0,"PACMA",0
25,"25908",228,138,137,3,1,"PACMA",1
25,"25097",87,62,62,4,0,"PACMA",0
25,"25053",1059,762,759,10,3,"PACMA",2
25,"25253",163,125,124,0,1,"PACMA",0
25,"25174",398,299,296,3,3,"PACMA",5
25,"25158",1639,1163,1150,26,13,"PACMA",5
25,"25255",426,308,302,4,6,"PACMA",3
25,"25093",639,451,445,11,6,"PACMA",1
25,"25909",155,89,89,3,0,"PACMA",0
25,"25051",1522,990,983,10,7,"PACMA",10
25,"25175",194,132,132,7,0,"PACMA",1
25,"25129",176,113,110,6,3,"PACMA",0
25,"25075",117,82,82,0,0,"PACMA",0
25,"25209",1517,1035,1019,6,16,"PACMA",7
25,"25098",253,163,160,2,3,"PACMA",0
25,"25034",2331,1516,1505,20,11,"PACMA",9
25,"25218",84,66,66,0,0,"PACMA",0
25,"25123",193,131,130,0,1,"PACMA",0
25,"25193",765,520,514,3,6,"PACMA",2
25,"25099",1260,804,793,8,11,"PACMA",4
25,"25035",397,287,286,3,1,"PACMA",2
25,"25903",237,154,152,3,2,"PACMA",0
25,"25094",139,111,109,0,2,"PACMA",1
25,"25046",421,292,286,1,6,"PACMA",2
25,"25150",185,127,124,1,3,"PACMA",1
25,"25196",119,74,74,0,0,"PACMA",1
25,"25194",426,278,273,0,5,"PACMA",0
25,"25204",1241,843,827,3,16,"PACMA",6
25,"25249",183,118,118,2,0,"PACMA",0
25,"25244",369,252,248,3,4,"PACMA",0
25,"25089",106,58,58,0,0,"PACMA",1
25,"25033",1106,777,767,7,10,"PACMA",10
25,"25042",208,143,142,0,1,"PACMA",0
25,"25207",6216,4062,4031,45,31,"PACMA",21
25,"25109",238,168,168,1,0,"PACMA",1
25,"25070",817,584,573,14,11,"PACMA",3
25,"25092",132,93,89,1,4,"PACMA",2
25,"25103",131,80,80,3,0,"PACMA",2
25,"25059",801,590,584,11,6,"PACMA",3
25,"25167",236,158,156,3,2,"PACMA",0
25,"25087",61,46,45,0,1,"PACMA",0
25,"25017",239,160,159,2,1,"PACMA",1
25,"25125",424,279,273,4,6,"PACMA",0
25,"25100",212,134,134,3,0,"PACMA",0
25,"25037",385,245,241,2,4,"PACMA",1
25,"25912",868,618,617,5,1,"PACMA",4
25,"25200",336,218,218,0,0,"PACMA",0
25,"25143",87,58,57,1,1,"PACMA",0
25,"25068",558,372,369,9,3,"PACMA",0
25,"25062",757,521,516,4,5,"PACMA",3
25,"25114",97,87,87,0,0,"PACMA",0
25,"25166",177,123,121,1,2,"PACMA",0
25,"25254",738,507,493,6,14,"PACMA",1
25,"25038",1564,1075,1062,11,13,"PACMA",2
25,"25183",501,332,331,4,1,"PACMA",1
25,"25172",1805,1230,1214,8,16,"PACMA",9
25,"25165",280,194,190,4,4,"PACMA",0
25,"25002",484,323,321,2,2,"PACMA",4
25,"25243",3612,2449,2423,30,26,"PACMA",22
25,"25024",356,233,230,1,3,"PACMA",1
25,"25009",631,465,460,3,5,"PACMA",2
25,"25127",212,135,134,3,1,"PACMA",0
25,"25124",169,118,116,2,2,"PACMA",0
25,"25173",1702,1180,1171,5,9,"PACMA",8
25,"25058",4378,2810,2793,27,17,"PACMA",21
25,"25055",172,118,116,2,2,"PACMA",0
25,"25039",280,182,180,0,2,"PACMA",0
25,"25029",1662,1156,1147,13,9,"PACMA",7
25,"25016",2114,1417,1411,8,6,"PACMA",4
25,"25180",239,151,151,0,0,"PACMA",1
25,"25043",794,505,501,3,4,"PACMA",3
25,"25228",3043,2140,2118,21,22,"PACMA",24
25,"25072",5858,3878,3835,45,43,"PACMA",34
25,"25013",2171,1380,1366,10,14,"PACMA",13
25,"25219",144,106,105,3,1,"PACMA",1
25,"25220",1028,709,701,9,8,"PACMA",3
25,"25901",292,186,181,4,5,"PACMA",2
25,"25119",2259,1582,1569,22,13,"PACMA",9
25,"25251",710,495,494,3,1,"PACMA",4
25,"25201",115,70,67,0,3,"PACMA",0
25,"25186",214,141,138,2,3,"PACMA",0
25,"25905",386,260,255,4,5,"PACMA",2
25,"25134",635,418,414,4,4,"PACMA",2
25,"25245",441,313,313,0,0,"PACMA",2
25,"25122",1916,1274,1264,15,10,"PACMA",4
25,"25005",277,183,182,2,1,"PACMA",1
25,"25111",115,83,83,1,0,"PACMA",3
25,"25148",220,155,153,0,2,"PACMA",0
25,"25224",126,86,86,1,0,"PACMA",0
25,"25189",2106,1392,1381,16,11,"PACMA",15
25,"25105",130,95,93,4,2,"PACMA",2
25,"25146",224,150,148,2,2,"PACMA",1
25,"25913",87,69,69,1,0,"PACMA",3
25,"25247",123,72,72,0,0,"PACMA",0
25,"25126",286,214,210,5,4,"PACMA",2
25,"25208",316,191,189,1,2,"PACMA",1
25,"25137",8577,5630,5591,45,39,"PACMA",48
25,"25069",453,289,286,6,3,"PACMA",1
25,"25161",368,234,232,3,2,"PACMA",5
25,"25048",1644,1151,1138,8,13,"PACMA",11
25,"25239",608,320,319,1,1,"PACMA",2
25,"25177",372,258,258,2,0,"PACMA",0
25,"25176",312,239,235,7,4,"PACMA",1
25,"25242",732,480,477,4,3,"PACMA",3
25,"25206",257,164,164,3,0,"PACMA",0
25,"25041",569,380,374,7,6,"PACMA",6
25,"25012",2296,1504,1488,8,16,"PACMA",31
25,"25049",151,104,104,1,0,"PACMA",0
25,"25085",152,106,106,0,0,"PACMA",1
25,"25063",91,55,55,0,0,"PACMA",2
25,"25008",1135,828,819,11,9,"PACMA",4
25,"25020",292,203,200,2,3,"PACMA",0
25,"25133",713,469,464,1,5,"PACMA",1
25,"25142",368,252,251,3,1,"PACMA",1
25,"25044",189,136,136,3,0,"PACMA",0
25,"25010",212,131,130,6,1,"PACMA",2
25,"25223",922,614,598,8,16,"PACMA",1
25,"25216",226,150,150,0,0,"PACMA",0
25,"25215",334,244,243,2,1,"PACMA",1
25,"25182",1043,738,727,13,11,"PACMA",4
25,"25212",234,173,171,1,2,"PACMA",2
25,"25222",67,52,52,1,0,"PACMA",0
25,"25007",1410,1005,996,13,9,"PACMA",11
25,"25030",131,86,86,2,0,"PACMA",0
25,"25088",96,76,75,0,1,"PACMA",1
25,"25081",318,213,210,2,3,"PACMA",1
25,"25149",1382,1010,993,7,17,"PACMA",1
20,"20071",14818,10095,10057,62,38,"EH Bildu",2596
20,"20025",1144,774,767,5,7,"EH Bildu",320
20,"20032",8785,6115,6076,45,39,"EH Bildu",1267
20,"20070",1099,749,744,4,5,"EH Bildu",345
20,"20005",1261,811,805,7,6,"EH Bildu",342
20,"20012",144,108,108,3,0,"EH Bildu",51
20,"20023",445,258,258,2,0,"EH Bildu",116
20,"20901",1441,982,979,2,3,"EH Bildu",220
20,"20039",2111,1539,1532,13,7,"EH Bildu",631
20,"20037",97,59,59,1,0,"EH Bildu",27
20,"20062",982,685,684,3,1,"EH Bildu",227
20,"20028",2255,1503,1494,17,9,"EH Bildu",530
20,"20058",746,547,546,3,1,"EH Bildu",111
20,"20053",4765,3150,3132,18,18,"EH Bildu",911
20,"20027",2816,1842,1833,11,9,"EH Bildu",753
20,"20057",201,122,121,0,1,"EH Bildu",61
20,"20002",343,227,226,10,1,"EH Bildu",108
20,"20077",5243,3792,3777,25,15,"EH Bildu",815
20,"20029",4258,3005,2992,17,13,"EH Bildu",850
20,"20033",864,629,625,3,4,"EH Bildu",262
20,"20056",4104,2654,2633,12,21,"EH Bildu",834
20,"20081",7460,5187,5159,33,28,"EH Bildu",1391
20,"20034",3157,2145,2141,7,4,"EH Bildu",515
20,"20044",368,264,259,0,5,"EH Bildu",111
20,"20008",721,382,376,5,6,"EH Bildu",178
20,"20054",447,301,297,5,4,"EH Bildu",215
20,"20046",1167,797,794,4,3,"EH Bildu",249
20,"20035",482,329,328,4,1,"EH Bildu",139
20,"20016",1514,885,884,5,1,"EH Bildu",260
20,"20026",202,141,129,4,12,"EH Bildu",55
20,"20061",4273,2832,2816,21,16,"EH Bildu",729
20,"20036",13148,9191,9132,85,59,"EH Bildu",1156
20,"20042",3251,2170,2152,23,18,"EH Bildu",669
20,"20080",7900,5517,5487,33,30,"EH Bildu",727
20,"20030",21515,15110,15019,108,91,"EH Bildu",2376
20,"20009",11528,7997,7955,57,42,"EH Bildu",1542
20,"20050",263,160,160,4,0,"EH Bildu",82
20,"20014",1111,635,632,4,3,"EH Bildu",275
20,"20010",1494,1055,1053,4,2,"EH Bildu",382
20,"20063",7990,5449,5415,23,34,"EH Bildu",2575
20,"20006",262,161,159,1,2,"EH Bildu",58
20,"20076",6978,4975,4958,39,17,"EH Bildu",1276
20,"20906",121,84,84,1,0,"EH Bildu",41
20,"20040",15321,10260,10176,69,84,"EH Bildu",3304
20,"20068",183,117,115,0,2,"EH Bildu",61
20,"20047",477,329,329,2,0,"EH Bildu",154
20,"20043",1740,1157,1152,6,5,"EH Bildu",407
20,"20045",46691,32759,32560,222,199,"EH Bildu",2520
20,"20018",11074,7100,7059,29,41,"EH Bildu",2687
20,"20052",1091,797,792,6,5,"EH Bildu",268
20,"20055",17522,12125,12043,52,82,"EH Bildu",2907
20,"20001",242,138,137,1,1,"EH Bildu",70
20,"20075",4359,2852,2833,16,19,"EH Bildu",890
20,"20907",120,85,84,2,1,"EH Bildu",30
20,"20067",30825,21606,21512,113,94,"EH Bildu",3943
20,"20004",252,135,135,2,0,"EH Bildu",33
20,"20904",96,62,62,0,0,"EH Bildu",41
20,"20015",1272,924,921,9,3,"EH Bildu",504
20,"20074",11610,8382,8320,43,62,"EH Bildu",2490
20,"20905",141,105,105,0,0,"EH Bildu",61
20,"20078",1155,866,864,6,2,"EH Bildu",561
20,"20011",1660,1283,1278,9,5,"EH Bildu",539
20,"20051",6904,5001,4975,31,26,"EH Bildu",1147
20,"20069",147189,106909,106506,699,403,"EH Bildu",14476
20,"20017",8580,5807,5770,37,37,"EH Bildu",1471
20,"20065",3006,2104,2089,18,15,"EH Bildu",606
20,"20079",17835,12650,12587,81,63,"EH Bildu",2790
20,"20060",89,76,75,2,1,"EH Bildu",72
20,"20041",258,148,148,2,0,"EH Bildu",55
20,"20064",12526,8429,8387,59,42,"EH Bildu",1535
20,"20059",8863,6091,6072,30,19,"EH Bildu",2339
20,"20902",14193,10263,10219,56,44,"EH Bildu",1465
20,"20020",129,71,71,0,0,"EH Bildu",36
20,"20073",4677,3219,3208,21,11,"EH Bildu",1362
20,"20031",180,105,102,1,3,"EH Bildu",46
20,"20003",541,334,334,3,0,"EH Bildu",184
20,"20066",461,279,276,3,3,"EH Bildu",178
20,"20022",834,499,494,7,5,"EH Bildu",227
20,"20903",4247,2846,2826,9,20,"EH Bildu",742
20,"20049",4124,2793,2780,22,13,"EH Bildu",928
20,"20013",5427,3901,3875,19,26,"EH Bildu",1062
20,"20024",393,226,226,2,0,"EH Bildu",119
20,"20072",4731,3132,3123,23,9,"EH Bildu",535
20,"20019",10053,6876,6844,72,32,"EH Bildu",1311
20,"20038",392,284,281,1,3,"EH Bildu",123
20,"20007",304,209,209,5,0,"EH Bildu",127
20,"20021",199,110,110,2,0,"EH Bildu",46
20,"20048",176,104,104,2,0,"EH Bildu",50
17,"17001",585,417,413,2,4,"UPYD",1
17,"17224",314,214,213,3,1,"UPYD",1
17,"17106",139,108,106,0,2,"UPYD",0
17,"17212",139,108,106,1,2,"UPYD",0
17,"17035",544,400,399,4,1,"UPYD",0
17,"17180",8300,5429,5368,42,61,"UPYD",15
17,"17157",126,104,102,1,2,"UPYD",0
17,"17047",4837,2997,2973,39,24,"UPYD",6
17,"17213",5372,3549,3517,17,32,"UPYD",7
17,"17084",236,160,160,7,0,"UPYD",0
17,"17202",3803,2471,2449,13,22,"UPYD",4
17,"17225",213,142,142,1,0,"UPYD",0
17,"17002",556,429,419,1,10,"UPYD",0
17,"17073",1875,1466,1460,11,6,"UPYD",1
17,"17107",268,189,188,2,1,"UPYD",0
17,"17145",1488,1003,986,9,17,"UPYD",2
17,"17192",145,108,108,1,0,"UPYD",0
17,"17214",706,471,468,4,3,"UPYD",0
17,"17013",2787,1941,1926,17,15,"UPYD",3
17,"17048",6269,4072,4044,24,28,"UPYD",4
17,"17036",2736,1857,1839,16,18,"UPYD",3
17,"17181",3380,2272,2251,15,21,"UPYD",7
17,"17135",355,263,258,2,5,"UPYD",0
17,"17109",693,443,435,2,8,"UPYD",0
17,"17121",221,157,156,1,1,"UPYD",1
17,"17037",104,65,65,0,0,"UPYD",1
17,"17215",2066,1588,1577,12,11,"UPYD",3
17,"17074",507,345,341,1,4,"UPYD",0
17,"17003",102,71,71,0,0,"UPYD",0
17,"17014",61,47,47,1,0,"UPYD",0
17,"17207",2373,1691,1673,18,18,"UPYD",3
17,"17170",172,118,117,2,1,"UPYD",0
17,"17097",199,149,148,5,1,"UPYD",0
17,"17038",369,255,253,2,2,"UPYD",0
17,"17147",8112,5475,5422,43,53,"UPYD",12
17,"17123",357,275,273,3,2,"UPYD",0
17,"17075",334,234,227,5,7,"UPYD",0
17,"17204",562,385,384,7,1,"UPYD",0
17,"17004",510,371,368,0,3,"UPYD",1
17,"17110",1325,953,945,5,8,"UPYD",2
17,"17015",12525,8550,8470,59,80,"UPYD",13
17,"17063",166,115,113,0,2,"UPYD",0
17,"17216",165,112,110,0,2,"UPYD",0
17,"17098",311,224,221,2,3,"UPYD",0
17,"17124",1638,1096,1083,10,13,"UPYD",0
17,"17111",873,643,641,12,2,"UPYD",0
17,"17087",222,169,169,3,0,"UPYD",0
17,"17217",348,268,266,0,2,"UPYD",1
17,"17148",1535,1056,1045,12,11,"UPYD",2
17,"17183",274,186,186,3,0,"UPYD",0
17,"17206",141,89,87,0,2,"UPYD",0
17,"17184",1258,893,887,6,6,"UPYD",1
17,"17901",989,696,686,7,10,"UPYD",4
17,"17149",363,267,264,0,3,"UPYD",1
17,"17005",401,263,260,5,3,"UPYD",0
17,"17125",129,88,86,0,2,"UPYD",0
17,"17138",944,668,663,4,5,"UPYD",1
17,"17040",538,392,391,4,1,"UPYD",1
17,"17029",203,131,131,2,0,"UPYD",0
17,"17006",1131,730,728,9,2,"UPYD",4
17,"17153",186,140,140,0,0,"UPYD",0
17,"17112",192,141,139,1,2,"UPYD",0
17,"17077",555,386,383,5,3,"UPYD",0
17,"17150",1407,1074,1060,12,14,"UPYD",3
17,"17114",23020,15151,15024,105,127,"UPYD",20
17,"17196",214,151,151,2,0,"UPYD",0
17,"17007",1730,1235,1224,4,11,"UPYD",2
17,"17218",588,448,445,3,3,"UPYD",1
17,"17126",308,252,250,2,2,"UPYD",0
17,"17078",330,225,225,5,0,"UPYD",0
17,"17093",893,590,585,6,5,"UPYD",6
17,"17208",997,679,671,12,8,"UPYD",0
17,"17139",1382,972,963,9,9,"UPYD",1
17,"17041",215,146,145,2,1,"UPYD",0
17,"17220",811,563,555,3,8,"UPYD",0
17,"17019",1779,1279,1261,13,18,"UPYD",2
17,"17030",645,430,428,7,2,"UPYD",0
17,"17115",277,195,195,0,0,"UPYD",0
17,"17031",172,109,109,3,0,"UPYD",0
17,"17008",3636,2423,2395,15,28,"UPYD",2
17,"17151",174,124,123,3,1,"UPYD",0
17,"17197",137,105,105,2,0,"UPYD",0
17,"17187",621,468,464,6,4,"UPYD",0
17,"17012",1142,763,757,6,6,"UPYD",1
17,"17116",348,243,240,4,3,"UPYD",0
17,"17221",4182,2882,2859,18,23,"UPYD",6
17,"17042",414,288,286,2,2,"UPYD",0
17,"17024",279,176,176,2,0,"UPYD",0
17,"17009",4042,2770,2738,18,32,"UPYD",1
17,"17080",141,98,98,0,0,"UPYD",1
17,"17152",10727,6804,6758,46,46,"UPYD",12
17,"17010",330,247,246,5,1,"UPYD",0
17,"17168",374,273,272,1,1,"UPYD",1
17,"17164",3996,2555,2543,23,12,"UPYD",4
17,"17129",137,99,99,1,0,"UPYD",0
17,"17043",158,119,117,1,2,"UPYD",0
17,"17222",109,85,85,1,0,"UPYD",0
17,"17068",245,173,172,0,1,"UPYD",0
17,"17188",165,126,126,0,0,"UPYD",0
17,"17117",14280,9297,9223,75,74,"UPYD",23
17,"17176",122,91,91,2,0,"UPYD",0
17,"17165",653,445,443,2,2,"UPYD",0
17,"17081",244,165,163,0,2,"UPYD",0
17,"17044",6767,4737,4694,36,43,"UPYD",4
17,"17178",1063,690,685,5,5,"UPYD",1
17,"17189",1524,1126,1114,4,12,"UPYD",0
17,"17223",807,528,520,6,8,"UPYD",1
17,"17103",4942,3150,3129,19,21,"UPYD",8
17,"17082",410,273,268,3,5,"UPYD",0
17,"17118",12824,8557,8477,57,80,"UPYD",6
17,"17062",5970,3695,3657,31,38,"UPYD",6
17,"17154",92,62,62,0,0,"UPYD",0
17,"17058",180,132,131,1,1,"UPYD",0
17,"17016",724,519,515,8,4,"UPYD",1
17,"17177",563,359,354,3,5,"UPYD",0
17,"17046",719,499,492,2,7,"UPYD",0
17,"17011",646,463,462,7,1,"UPYD",0
17,"17060",424,277,274,3,3,"UPYD",2
17,"17201",128,93,92,1,1,"UPYD",0
17,"17155",14500,9167,9080,43,87,"UPYD",13
17,"17190",842,592,590,10,2,"UPYD",0
17,"17133",1268,887,877,6,10,"UPYD",0
17,"17903",897,647,638,0,9,"UPYD",0
17,"17194",78,54,52,2,2,"UPYD",0
17,"17119",68,59,59,0,0,"UPYD",0
17,"17083",2935,2059,2042,17,17,"UPYD",2
17,"17146",2979,2030,2009,14,21,"UPYD",2
17,"17205",212,166,166,2,0,"UPYD",0
17,"17191",146,114,113,1,1,"UPYD",0
17,"17120",792,530,518,3,12,"UPYD",0
17,"17052",124,83,83,1,0,"UPYD",0
17,"17096",178,115,114,0,1,"UPYD",2
17,"17232",149,98,98,1,0,"UPYD",0
17,"17061",162,119,119,1,0,"UPYD",0
17,"17095",19593,12648,12554,81,94,"UPYD",45
17,"17025",1124,834,827,3,7,"UPYD",3
17,"17226",856,572,557,5,15,"UPYD",1
17,"17161",990,737,734,7,3,"UPYD",0
17,"17134",234,163,161,2,2,"UPYD",2
17,"17211",839,646,639,3,7,"UPYD",1
17,"17175",579,366,360,4,6,"UPYD",3
17,"17158",464,284,281,0,3,"UPYD",1
17,"17162",147,91,90,0,1,"UPYD",0
17,"17182",262,191,191,2,0,"UPYD",0
17,"17228",295,211,210,1,1,"UPYD",1
17,"17050",649,499,495,3,4,"UPYD",2
17,"17049",3125,2251,2233,7,18,"UPYD",5
17,"17085",293,223,221,1,2,"UPYD",0
17,"17200",618,425,422,4,3,"UPYD",0
17,"17143",146,109,107,1,2,"UPYD",0
17,"17233",2287,1682,1664,21,18,"UPYD",5
17,"17066",26551,16275,16166,140,109,"UPYD",30
17,"17094",1049,646,641,3,5,"UPYD",2
17,"17021",135,86,86,2,0,"UPYD",0
17,"17227",128,95,95,0,0,"UPYD",0
17,"17086",1744,1181,1170,10,11,"UPYD",4
17,"17064",325,219,214,1,5,"UPYD",0
17,"17076",123,90,88,2,2,"UPYD",2
17,"17018",477,347,343,3,4,"UPYD",1
17,"17079",64159,44230,43902,271,328,"UPYD",87
17,"17020",3590,2531,2510,28,21,"UPYD",4
17,"17027",2826,1993,1973,10,20,"UPYD",4
17,"17067",697,500,495,7,5,"UPYD",5
17,"17234",183,124,124,1,0,"UPYD",0
17,"17128",302,224,223,4,1,"UPYD",1
17,"17065",335,250,249,2,1,"UPYD",0
17,"17089",5490,3630,3591,20,39,"UPYD",6
17,"17091",411,282,273,5,9,"UPYD",1
17,"17039",1764,1229,1217,20,12,"UPYD",1
17,"17169",2475,1733,1724,11,9,"UPYD",5
17,"17022",6926,4626,4587,47,39,"UPYD",3
17,"17023",27347,18842,18610,118,232,"UPYD",35
17,"17142",2561,1962,1950,13,12,"UPYD",3
17,"17209",625,480,477,2,3,"UPYD",0
17,"17230",463,343,339,2,4,"UPYD",0
17,"17028",303,213,213,4,0,"UPYD",0
17,"17099",80,60,59,0,1,"UPYD",1
17,"17199",6845,4527,4483,32,44,"UPYD",4
17,"17172",452,308,307,1,1,"UPYD",0
17,"17032",1713,1036,1020,13,16,"UPYD",5
17,"17071",1131,810,803,8,7,"UPYD",2
17,"17130",328,246,245,2,1,"UPYD",0
17,"17163",2609,1904,1890,18,14,"UPYD",0
17,"17100",199,142,140,7,2,"UPYD",0
17,"17141",5869,3688,3653,38,35,"UPYD",4
17,"17159",627,439,434,2,5,"UPYD",0
17,"17166",516,386,378,2,8,"UPYD",1
17,"17132",1311,923,913,10,10,"UPYD",1
17,"17026",536,381,380,6,1,"UPYD",0
17,"17055",152,125,125,0,0,"UPYD",0
17,"17105",255,170,170,2,0,"UPYD",0
17,"17186",3771,2742,2712,18,30,"UPYD",6
17,"17056",1706,1200,1193,10,7,"UPYD",2
17,"17195",338,256,251,2,5,"UPYD",0
17,"17054",375,249,249,2,0,"UPYD",0
17,"17102",576,397,395,4,2,"UPYD",0
17,"17167",2697,1876,1852,24,24,"UPYD",2
17,"17160",14740,9853,9795,68,58,"UPYD",21
17,"17902",1353,957,947,9,10,"UPYD",2
17,"17034",6874,4509,4477,32,32,"UPYD",7
17,"17203",154,110,110,0,0,"UPYD",0
17,"17090",542,410,408,3,2,"UPYD",0
17,"17210",551,378,376,2,2,"UPYD",0
17,"17144",210,141,141,2,0,"UPYD",0
17,"17101",543,364,362,3,2,"UPYD",0
17,"17136",175,133,132,1,1,"UPYD",1
17,"17174",176,102,102,3,0,"UPYD",0
17,"17137",3411,2391,2369,15,22,"UPYD",5
17,"17140",674,498,495,5,3,"UPYD",2
17,"17185",2293,1547,1527,12,20,"UPYD",3
17,"17198",430,282,281,4,1,"UPYD",0
17,"17171",163,123,122,0,1,"UPYD",1
17,"17092",3508,2373,2347,13,26,"UPYD",2
17,"17088",535,372,369,0,3,"UPYD",0
17,"17051",219,157,155,3,2,"UPYD",0
17,"17069",378,270,267,4,3,"UPYD",0
17,"17070",109,82,82,1,0,"UPYD",0
17,"17193",4216,2807,2768,26,39,"UPYD",3
17,"17033",5293,3509,3476,28,33,"UPYD",5
17,"17057",960,708,699,8,9,"UPYD",0
17,"17173",180,141,139,2,2,"UPYD",0
5,"5001",194,153,152,1,1,"RECORTES CE",0
5,"5240",3393,2354,2335,9,19,"RECORTES CE",1
5,"5125",57,45,44,0,1,"RECORTES CE",0
5,"5023",173,153,153,5,0,"RECORTES CE",0
5,"5018",29,21,21,0,0,"RECORTES CE",0
5,"5241",3081,2143,2115,17,28,"RECORTES CE",1
5,"5256",116,92,92,1,0,"RECORTES CE",0
5,"5139",76,66,66,0,0,"RECORTES CE",0
5,"5060",120,99,99,1,0,"RECORTES CE",0
5,"5189",443,340,336,3,4,"RECORTES CE",1
5,"5002",1954,1471,1450,9,21,"RECORTES CE",3
5,"5047",4199,3287,3244,7,43,"RECORTES CE",6
5,"5126",70,59,59,0,0,"RECORTES CE",0
5,"5087",137,93,93,0,0,"RECORTES CE",0
5,"5166",188,135,134,1,1,"RECORTES CE",0
5,"5242",681,538,527,10,11,"RECORTES CE",1
5,"5140",116,97,96,0,1,"RECORTES CE",0
5,"5061",253,198,196,4,2,"RECORTES CE",1
5,"5182",801,559,546,9,13,"RECORTES CE",0
5,"5217",58,45,45,0,0,"RECORTES CE",0
5,"5092",155,120,120,0,0,"RECORTES CE",0
5,"5127",650,539,535,4,4,"RECORTES CE",0
5,"5257",140,98,98,0,0,"RECORTES CE",0
5,"5005",187,150,149,0,1,"RECORTES CE",0
5,"5243",88,61,61,1,0,"RECORTES CE",1
5,"5036",123,97,97,0,0,"RECORTES CE",0
5,"5049",399,301,291,1,10,"RECORTES CE",0
5,"5128",350,289,284,4,5,"RECORTES CE",0
5,"5205",75,58,58,0,0,"RECORTES CE",0
5,"5141",95,86,86,2,0,"RECORTES CE",0
5,"5115",532,392,386,2,6,"RECORTES CE",0
5,"5116",118,95,93,1,2,"RECORTES CE",0
5,"5007",113,74,74,1,0,"RECORTES CE",0
5,"5167",265,209,199,0,10,"RECORTES CE",0
5,"5168",3565,2740,2711,17,29,"RECORTES CE",2
5,"5089",478,377,365,0,12,"RECORTES CE",0
5,"5206",29,22,21,0,1,"RECORTES CE",0
5,"5022",1611,1279,1271,4,8,"RECORTES CE",0
5,"5103",78,56,56,0,0,"RECORTES CE",0
5,"5244",51,38,38,0,0,"RECORTES CE",0
5,"5051",181,152,147,3,5,"RECORTES CE",0
5,"5904",133,92,91,1,1,"RECORTES CE",0
5,"5008",227,180,176,2,4,"RECORTES CE",0
5,"5133",67,55,55,1,0,"RECORTES CE",0
5,"5129",129,78,78,0,0,"RECORTES CE",0
5,"5245",348,293,288,0,5,"RECORTES CE",0
5,"5207",697,553,548,0,5,"RECORTES CE",3
5,"5169",226,178,176,1,2,"RECORTES CE",0
5,"5117",201,178,174,2,4,"RECORTES CE",0
5,"5090",84,69,68,1,1,"RECORTES CE",0
5,"5130",95,82,82,0,0,"RECORTES CE",0
5,"5064",103,87,87,1,0,"RECORTES CE",0
5,"5010",149,119,118,1,1,"RECORTES CE",0
5,"5052",99,89,88,0,1,"RECORTES CE",0
5,"5246",60,42,42,0,0,"RECORTES CE",0
5,"5143",66,55,55,1,0,"RECORTES CE",0
5,"5220",382,298,294,1,4,"RECORTES CE",0
5,"5261",42,26,26,0,0,"RECORTES CE",0
5,"5252",64,45,45,0,0,"RECORTES CE",1
5,"5065",469,388,385,6,3,"RECORTES CE",0
5,"5265",82,70,70,0,0,"RECORTES CE",1
5,"5053",86,58,58,0,0,"RECORTES CE",0
5,"5131",105,70,69,1,1,"RECORTES CE",0
5,"5025",96,73,72,1,1,"RECORTES CE",0
5,"5183",140,114,113,1,1,"RECORTES CE",0
5,"5119",33,20,20,0,0,"RECORTES CE",0
5,"5012",135,110,108,0,2,"RECORTES CE",0
5,"5171",73,58,57,2,1,"RECORTES CE",0
5,"5209",83,63,63,0,0,"RECORTES CE",0
5,"5262",358,278,277,1,1,"RECORTES CE",0
5,"5013",876,733,723,2,10,"RECORTES CE",0
5,"5196",53,39,39,0,0,"RECORTES CE",0
5,"5247",250,147,146,1,1,"RECORTES CE",0
5,"5132",992,678,672,2,6,"RECORTES CE",1
5,"5054",1238,953,933,1,20,"RECORTES CE",0
5,"5094",140,110,110,0,0,"RECORTES CE",0
5,"5249",107,82,82,0,0,"RECORTES CE",0
5,"5081",39,33,31,0,2,"RECORTES CE",0
5,"5055",576,476,467,0,9,"RECORTES CE",1
5,"5184",250,197,192,0,5,"RECORTES CE",3
5,"5027",269,220,218,2,2,"RECORTES CE",1
5,"5147",162,119,116,0,3,"RECORTES CE",1
5,"5172",123,104,102,2,2,"RECORTES CE",0
5,"5201",529,439,431,2,8,"RECORTES CE",0
5,"5156",249,163,161,0,2,"RECORTES CE",0
5,"5014",5422,4137,4084,30,53,"RECORTES CE",4
5,"5173",60,45,45,0,0,"RECORTES CE",0
5,"5251",68,40,40,0,0,"RECORTES CE",0
5,"5108",51,30,30,0,0,"RECORTES CE",0
5,"5029",123,92,89,0,3,"RECORTES CE",0
5,"5264",62,43,42,1,1,"RECORTES CE",1
5,"5095",266,220,218,0,2,"RECORTES CE",0
5,"5134",48,40,40,0,0,"RECORTES CE",0
5,"5174",69,55,55,1,0,"RECORTES CE",0
5,"5096",79,57,57,0,0,"RECORTES CE",0
5,"5083",145,108,100,2,8,"RECORTES CE",0
5,"5015",87,66,65,1,1,"RECORTES CE",0
5,"5135",425,325,322,1,3,"RECORTES CE",0
5,"5178",371,295,289,0,6,"RECORTES CE",0
5,"5186",1572,1240,1222,9,18,"RECORTES CE",3
5,"5154",36,30,30,0,0,"RECORTES CE",0
5,"5238",787,565,556,4,9,"RECORTES CE",2
5,"5030",46,37,37,0,0,"RECORTES CE",0
5,"5097",474,324,317,3,7,"RECORTES CE",1
5,"5057",2470,1977,1953,14,24,"RECORTES CE",1
5,"5253",88,70,70,0,0,"RECORTES CE",0
5,"5213",101,83,83,0,0,"RECORTES CE",0
5,"5136",97,74,73,5,1,"RECORTES CE",0
5,"5058",78,55,55,2,0,"RECORTES CE",1
5,"5016",6335,4873,4775,39,98,"RECORTES CE",6
5,"5163",1756,1351,1345,1,6,"RECORTES CE",2
5,"5017",85,75,75,0,0,"RECORTES CE",0
5,"5199",39,32,32,0,0,"RECORTES CE",0
5,"5188",45,38,38,0,0,"RECORTES CE",0
5,"5085",38,29,29,0,0,"RECORTES CE",0
5,"5045",95,70,70,0,0,"RECORTES CE",0
5,"5254",196,166,166,0,0,"RECORTES CE",0
5,"5227",373,250,248,0,2,"RECORTES CE",0
5,"5033",174,139,138,0,1,"RECORTES CE",0
5,"5176",234,190,187,2,3,"RECORTES CE",0
5,"5267",100,65,64,0,1,"RECORTES CE",0
5,"5099",497,398,381,3,17,"RECORTES CE",0
5,"5160",323,263,260,1,3,"RECORTES CE",1
5,"5259",125,107,106,3,1,"RECORTES CE",0
5,"5211",465,375,373,2,2,"RECORTES CE",0
5,"5152",690,561,558,3,3,"RECORTES CE",1
5,"5138",311,241,239,3,2,"RECORTES CE",0
5,"5901",273,187,185,5,2,"RECORTES CE",0
5,"5074",693,543,540,1,3,"RECORTES CE",0
5,"5113",78,58,58,1,0,"RECORTES CE",0
5,"5024",231,169,163,5,6,"RECORTES CE",0
5,"5019",44606,34903,34564,285,339,"RECORTES CE",54
5,"5177",160,128,128,1,0,"RECORTES CE",0
5,"5101",316,240,238,1,2,"RECORTES CE",0
5,"5216",224,155,155,2,0,"RECORTES CE",0
5,"5114",1359,1131,1115,5,16,"RECORTES CE",2
5,"5229",84,67,67,0,0,"RECORTES CE",1
5,"5158",371,289,287,1,2,"RECORTES CE",1
5,"5079",70,54,54,0,0,"RECORTES CE",0
5,"5194",138,122,121,5,1,"RECORTES CE",0
5,"5040",68,45,45,0,0,"RECORTES CE",0
5,"5144",79,62,60,2,2,"RECORTES CE",0
5,"5902",288,227,227,0,0,"RECORTES CE",1
5,"5903",157,108,107,0,1,"RECORTES CE",0
5,"5195",224,162,161,1,1,"RECORTES CE",0
5,"5258",113,98,97,0,1,"RECORTES CE",0
5,"5048",120,104,103,0,1,"RECORTES CE",0
5,"5102",1807,1431,1412,7,19,"RECORTES CE",0
5,"5062",184,155,154,2,1,"RECORTES CE",1
5,"5021",1932,1478,1456,12,22,"RECORTES CE",2
5,"5191",126,104,104,1,0,"RECORTES CE",0
5,"5080",59,42,40,0,2,"RECORTES CE",0
5,"5219",39,28,28,0,0,"RECORTES CE",0
5,"5026",197,170,169,1,1,"RECORTES CE",0
5,"5222",159,126,126,0,0,"RECORTES CE",0
5,"5218",121,97,95,0,2,"RECORTES CE",0
5,"5263",172,137,137,0,0,"RECORTES CE",0
5,"5192",100,82,81,1,1,"RECORTES CE",0
5,"5059",109,79,76,1,3,"RECORTES CE",0
5,"5077",161,137,136,2,1,"RECORTES CE",0
5,"5180",88,68,68,1,0,"RECORTES CE",0
5,"5142",104,88,82,1,6,"RECORTES CE",0
5,"5164",27,19,19,1,0,"RECORTES CE",0
5,"5185",94,80,80,1,0,"RECORTES CE",0
5,"5193",194,163,163,1,0,"RECORTES CE",0
5,"5198",73,59,59,0,0,"RECORTES CE",0
5,"5038",116,87,85,0,2,"RECORTES CE",0
5,"5078",115,100,99,3,1,"RECORTES CE",0
5,"5260",104,84,83,1,1,"RECORTES CE",0
5,"5043",84,67,67,0,0,"RECORTES CE",0
5,"5105",349,279,270,3,9,"RECORTES CE",1
5,"5157",240,170,167,1,3,"RECORTES CE",0
5,"5905",214,150,150,1,0,"RECORTES CE",0
5,"5118",84,57,57,0,0,"RECORTES CE",0
5,"5069",74,58,58,0,0,"RECORTES CE",0
5,"5212",233,157,155,1,2,"RECORTES CE",0
5,"5208",40,34,34,0,0,"RECORTES CE",0
5,"5162",87,60,60,2,0,"RECORTES CE",0
5,"5076",481,401,387,5,14,"RECORTES CE",0
5,"5122",144,115,113,1,2,"RECORTES CE",0
5,"5088",33,24,24,0,0,"RECORTES CE",0
5,"5224",106,87,86,0,1,"RECORTES CE",0
5,"5221",353,270,264,3,6,"RECORTES CE",0
5,"5037",261,165,163,3,2,"RECORTES CE",0
5,"5044",259,180,180,0,0,"RECORTES CE",0
5,"5170",52,46,46,0,0,"RECORTES CE",0
5,"5106",36,27,27,0,0,"RECORTES CE",0
5,"5110",721,559,552,3,7,"RECORTES CE",0
5,"5066",458,365,364,3,1,"RECORTES CE",0
5,"5231",160,126,124,1,2,"RECORTES CE",0
5,"5266",102,89,89,0,0,"RECORTES CE",0
5,"5236",128,85,84,0,1,"RECORTES CE",0
5,"5084",74,56,56,1,0,"RECORTES CE",0
5,"5067",83,66,59,1,7,"RECORTES CE",0
5,"5239",207,163,162,1,1,"RECORTES CE",0
5,"5120",35,26,26,0,0,"RECORTES CE",0
5,"5100",285,229,228,0,1,"RECORTES CE",1
5,"5121",241,186,185,3,1,"RECORTES CE",0
5,"5215",169,126,122,2,4,"RECORTES CE",0
5,"5214",38,27,26,0,1,"RECORTES CE",1
5,"5042",155,126,125,0,1,"RECORTES CE",0
5,"5056",96,73,73,0,0,"RECORTES CE",0
5,"5145",52,41,41,0,0,"RECORTES CE",1
5,"5190",55,42,42,2,0,"RECORTES CE",0
5,"5155",52,37,37,0,0,"RECORTES CE",1
5,"5070",32,26,26,0,0,"RECORTES CE",0
5,"5086",82,66,64,1,2,"RECORTES CE",0
5,"5039",56,43,42,0,1,"RECORTES CE",0
5,"5165",380,291,283,5,8,"RECORTES CE",0
5,"5148",27,17,17,0,0,"RECORTES CE",0
5,"5159",254,175,174,2,1,"RECORTES CE",0
5,"5153",108,78,77,3,1,"RECORTES CE",0
5,"5109",454,378,362,3,16,"RECORTES CE",1
5,"5204",611,473,471,1,2,"RECORTES CE",0
5,"5149",105,76,75,0,1,"RECORTES CE",0
5,"5234",51,46,46,1,0,"RECORTES CE",0
5,"5235",124,111,110,1,1,"RECORTES CE",0
5,"5228",179,126,126,0,0,"RECORTES CE",0
5,"5072",87,70,69,1,1,"RECORTES CE",0
5,"5179",215,184,180,0,4,"RECORTES CE",0
5,"5075",107,67,67,0,0,"RECORTES CE",0
5,"5123",96,69,66,2,3,"RECORTES CE",0
5,"5041",1001,772,765,10,7,"RECORTES CE",1
5,"5197",98,90,90,0,0,"RECORTES CE",1
5,"5151",93,70,70,1,0,"RECORTES CE",0
5,"5073",297,243,238,4,5,"RECORTES CE",0
5,"5237",164,131,126,1,5,"RECORTES CE",0
5,"5124",107,83,81,1,2,"RECORTES CE",0
5,"5232",98,83,81,1,2,"RECORTES CE",0
5,"5112",97,72,70,1,2,"RECORTES CE",0
5,"5210",85,72,72,1,0,"RECORTES CE",0
5,"5175",159,130,130,0,0,"RECORTES CE",1
5,"5034",15,12,12,1,0,"RECORTES CE",0
5,"5046",45,38,38,1,0,"RECORTES CE",0
5,"5082",528,437,427,5,10,"RECORTES CE",0
5,"5230",65,56,54,1,2,"RECORTES CE",0
5,"5181",43,31,31,1,0,"RECORTES CE",0
5,"5233",226,179,177,0,2,"RECORTES CE",0
5,"5226",77,57,57,0,0,"RECORTES CE",0
5,"5063",34,24,24,0,0,"RECORTES CE",0
5,"5035",107,84,84,1,0,"RECORTES CE",0
5,"5093",417,313,311,1,2,"RECORTES CE",0
5,"5107",64,39,39,1,0,"RECORTES CE",0
5,"5104",34,23,22,1,1,"RECORTES CE",0
5,"5200",49,28,28,0,0,"RECORTES CE",0
5,"5225",372,316,315,5,1,"RECORTES CE",0
5,"5161",586,483,473,2,10,"RECORTES CE",0
5,"5187",1755,1409,1395,11,14,"RECORTES CE",1
49,"49169",35,29,29,0,0,"PREPAL",0
49,"49048",134,84,84,0,0,"PREPAL",1
49,"49084",290,241,238,5,3,"PREPAL",1
49,"49113",172,144,142,1,2,"PREPAL",0
49,"49244",45,28,28,0,0,"PREPAL",0
49,"49186",263,189,187,0,2,"PREPAL",0
49,"49050",513,349,348,3,1,"PREPAL",2
49,"49087",523,322,319,0,3,"PREPAL",0
49,"49194",377,229,228,2,1,"PREPAL",0
49,"49156",237,185,183,2,2,"PREPAL",0
49,"49032",326,251,250,0,1,"PREPAL",2
49,"49058",316,252,250,0,2,"PREPAL",0
49,"49002",64,48,48,1,0,"PREPAL",0
49,"49067",372,258,256,3,2,"PREPAL",2
49,"49136",324,228,222,4,6,"PREPAL",2
49,"49151",627,473,467,4,6,"PREPAL",1
49,"49138",231,164,163,1,1,"PREPAL",0
49,"49248",188,145,144,0,1,"PREPAL",0
49,"49037",185,156,156,0,0,"PREPAL",0
49,"49098",222,167,166,2,1,"PREPAL",0
49,"49252",326,260,255,7,5,"PREPAL",0
49,"49043",300,226,225,2,1,"PREPAL",0
49,"49255",426,330,327,4,3,"PREPAL",0
49,"49270",138,100,99,0,1,"PREPAL",0
49,"49003",904,631,624,4,7,"PREPAL",4
49,"49069",384,243,242,6,1,"PREPAL",0
49,"49222",387,294,289,7,5,"PREPAL",1
49,"49125",1400,977,957,10,20,"PREPAL",0
49,"49188",115,92,91,1,1,"PREPAL",0
49,"49046",272,209,206,3,3,"PREPAL",0
49,"49179",393,265,263,0,2,"PREPAL",0
49,"49038",99,74,74,1,0,"PREPAL",0
49,"49171",648,507,500,5,7,"PREPAL",0
49,"49090",194,148,147,1,1,"PREPAL",2
49,"49114",44,31,30,0,1,"PREPAL",0
49,"49078",174,143,143,0,0,"PREPAL",0
49,"49033",728,530,528,4,2,"PREPAL",0
49,"49006",154,116,112,0,4,"PREPAL",0
49,"49192",134,114,114,2,0,"PREPAL",1
49,"49004",128,92,88,2,4,"PREPAL",0
49,"49147",267,190,189,2,1,"PREPAL",0
49,"49047",111,78,77,0,1,"PREPAL",2
49,"49133",306,218,217,1,1,"PREPAL",0
49,"49190",64,49,49,0,0,"PREPAL",0
49,"49134",187,115,110,0,5,"PREPAL",0
49,"49165",60,59,58,2,1,"PREPAL",0
49,"49275",52483,38405,37981,427,424,"PREPAL",103
49,"49251",166,126,119,0,7,"PREPAL",0
49,"49209",510,347,345,5,2,"PREPAL",0
49,"49262",392,268,266,1,2,"PREPAL",0
49,"49143",225,161,157,2,4,"PREPAL",0
49,"49076",325,253,250,2,3,"PREPAL",1
49,"49119",236,172,172,0,0,"PREPAL",0
49,"49053",938,737,729,5,8,"PREPAL",0
49,"49117",458,336,328,3,8,"PREPAL",1
49,"49020",294,226,223,5,3,"PREPAL",0
49,"49121",372,269,265,4,4,"PREPAL",0
49,"49127",2369,1752,1731,22,21,"PREPAL",2
49,"49228",56,43,41,0,2,"PREPAL",2
49,"49237",170,120,120,3,0,"PREPAL",0
49,"49153",172,124,123,1,1,"PREPAL",1
49,"49118",206,167,167,0,0,"PREPAL",1
49,"49178",699,503,487,4,16,"PREPAL",1
49,"49241",256,190,186,0,4,"PREPAL",0
49,"49236",76,54,53,0,1,"PREPAL",0
49,"49177",284,190,189,1,1,"PREPAL",0
49,"49094",243,149,149,1,0,"PREPAL",0
49,"49102",198,148,145,1,3,"PREPAL",1
49,"49159",276,220,216,2,4,"PREPAL",0
49,"49202",190,138,136,2,2,"PREPAL",1
49,"49091",269,202,202,0,0,"PREPAL",1
49,"49167",205,147,144,0,3,"PREPAL",1
49,"49260",774,597,593,12,4,"PREPAL",2
49,"49238",258,202,201,0,1,"PREPAL",0
49,"49021",14387,10353,10196,117,157,"PREPAL",21
49,"49041",440,315,307,1,8,"PREPAL",0
49,"49120",74,53,51,0,2,"PREPAL",1
49,"49016",256,185,179,2,6,"PREPAL",0
49,"49080",692,523,518,6,5,"PREPAL",0
49,"49059",93,61,61,0,0,"PREPAL",0
49,"49129",861,626,617,10,9,"PREPAL",0
49,"49056",295,220,211,4,9,"PREPAL",0
49,"49225",153,95,92,2,3,"PREPAL",2
49,"49210",478,365,358,4,7,"PREPAL",2
49,"49200",950,737,719,9,18,"PREPAL",5
49,"49185",162,125,121,0,4,"PREPAL",0
49,"49223",766,628,616,5,12,"PREPAL",0
49,"49160",48,36,32,0,4,"PREPAL",1
49,"49066",498,336,328,4,8,"PREPAL",0
49,"49239",673,488,476,6,12,"PREPAL",1
49,"49100",303,216,215,1,1,"PREPAL",0
49,"49205",382,296,294,8,2,"PREPAL",0
49,"49064",521,343,339,2,4,"PREPAL",1
49,"49163",230,166,160,1,6,"PREPAL",0
49,"49176",681,446,444,2,2,"PREPAL",1
49,"49042",244,199,195,2,4,"PREPAL",0
49,"49012",72,47,47,1,0,"PREPAL",0
49,"49174",130,95,94,2,1,"PREPAL",1
49,"49258",115,96,95,2,1,"PREPAL",0
49,"49110",366,215,215,5,0,"PREPAL",1
49,"49044",85,56,55,0,1,"PREPAL",0
49,"49245",261,178,174,0,4,"PREPAL",0
49,"49220",146,116,114,1,2,"PREPAL",0
49,"49131",269,186,181,1,5,"PREPAL",0
49,"49036",521,375,371,3,4,"PREPAL",0
49,"49148",249,143,141,0,2,"PREPAL",0
49,"49229",130,98,97,1,1,"PREPAL",0
49,"49184",179,117,114,1,3,"PREPAL",0
49,"49268",416,307,305,5,2,"PREPAL",2
49,"49227",316,259,255,4,4,"PREPAL",0
49,"49233",95,60,57,0,3,"PREPAL",0
49,"49175",234,183,182,2,1,"PREPAL",0
49,"49146",296,232,228,2,4,"PREPAL",0
49,"49107",131,98,97,2,1,"PREPAL",0
49,"49128",557,428,424,2,4,"PREPAL",0
49,"49226",253,203,200,1,3,"PREPAL",0
49,"49085",1033,708,701,0,7,"PREPAL",0
49,"49095",297,233,231,1,2,"PREPAL",0
49,"49149",392,275,271,3,4,"PREPAL",0
49,"49272",88,73,73,1,0,"PREPAL",0
49,"49203",319,245,236,1,9,"PREPAL",0
49,"49022",287,230,226,3,4,"PREPAL",1
49,"49157",214,167,162,1,5,"PREPAL",0
49,"49231",330,216,212,1,4,"PREPAL",0
49,"49219",7519,5407,5331,58,76,"PREPAL",5
49,"49273",189,120,118,0,2,"PREPAL",1
49,"49018",331,252,245,1,7,"PREPAL",0
49,"49092",132,92,91,1,1,"PREPAL",0
49,"49137",176,140,137,2,3,"PREPAL",0
49,"49173",379,229,227,5,2,"PREPAL",0
49,"49201",306,250,248,4,2,"PREPAL",0
49,"49139",170,139,136,0,3,"PREPAL",0
49,"49010",346,285,282,3,3,"PREPAL",0
49,"49152",532,346,344,9,2,"PREPAL",0
49,"49135",635,450,449,5,1,"PREPAL",0
49,"49259",93,70,63,0,7,"PREPAL",0
49,"49023",977,702,697,9,5,"PREPAL",0
49,"49093",287,233,231,2,2,"PREPAL",0
49,"49166",1225,945,934,11,11,"PREPAL",0
49,"49063",341,274,274,2,0,"PREPAL",1
49,"49011",230,183,180,7,3,"PREPAL",1
49,"49224",160,109,106,4,3,"PREPAL",0
49,"49007",371,267,254,6,13,"PREPAL",0
49,"49111",130,96,96,6,0,"PREPAL",0
49,"49216",162,138,137,0,1,"PREPAL",0
49,"49271",204,154,154,3,0,"PREPAL",0
49,"49199",259,203,200,1,3,"PREPAL",1
49,"49249",68,60,59,1,1,"PREPAL",0
49,"49180",156,101,101,0,0,"PREPAL",0
49,"49154",131,79,78,0,1,"PREPAL",0
49,"49008",468,346,342,6,4,"PREPAL",0
49,"49207",237,156,155,0,1,"PREPAL",1
49,"49221",258,142,135,1,7,"PREPAL",2
49,"49246",233,190,185,1,5,"PREPAL",1
49,"49256",256,207,206,2,1,"PREPAL",1
49,"49052",191,144,139,1,5,"PREPAL",0
49,"49065",1121,850,835,8,15,"PREPAL",0
49,"49088",92,70,70,0,0,"PREPAL",0
49,"49082",364,306,304,6,2,"PREPAL",1
49,"49247",454,301,296,3,5,"PREPAL",0
49,"49112",128,85,85,1,0,"PREPAL",0
49,"49267",91,75,74,1,1,"PREPAL",1
49,"49257",279,187,184,1,3,"PREPAL",0
49,"49269",230,165,163,4,2,"PREPAL",0
49,"49086",119,98,97,1,1,"PREPAL",0
49,"49030",84,69,67,1,2,"PREPAL",1
49,"49187",1251,956,946,8,10,"PREPAL",2
49,"49071",770,505,502,6,3,"PREPAL",0
49,"49083",52,43,41,1,2,"PREPAL",0
49,"49109",626,491,490,4,1,"PREPAL",1
49,"49099",132,85,85,1,0,"PREPAL",0
49,"49105",155,121,121,0,0,"PREPAL",0
49,"49103",412,333,330,4,3,"PREPAL",0
49,"49034",446,337,333,3,4,"PREPAL",3
49,"49024",667,464,457,7,7,"PREPAL",0
49,"49183",101,80,80,4,0,"PREPAL",0
49,"49019",246,187,181,5,6,"PREPAL",0
49,"49126",236,158,157,4,1,"PREPAL",0
49,"49266",75,60,60,0,0,"PREPAL",0
49,"49264",592,395,391,4,4,"PREPAL",2
49,"49214",707,529,523,7,6,"PREPAL",2
49,"49040",117,99,99,1,0,"PREPAL",0
49,"49170",104,70,68,1,2,"PREPAL",0
49,"49162",192,140,138,1,2,"PREPAL",0
49,"49132",327,242,236,0,6,"PREPAL",1
49,"49232",97,74,73,0,1,"PREPAL",0
49,"49123",547,414,410,0,4,"PREPAL",0
49,"49055",104,85,85,2,0,"PREPAL",0
49,"49068",472,292,289,2,3,"PREPAL",0
49,"49145",235,145,137,2,8,"PREPAL",1
49,"49115",185,140,139,4,1,"PREPAL",0
49,"49141",348,251,249,3,2,"PREPAL",0
49,"49230",103,82,81,1,1,"PREPAL",0
49,"49075",140,109,106,1,3,"PREPAL",0
49,"49158",215,164,161,3,3,"PREPAL",0
49,"49150",145,109,104,2,5,"PREPAL",0
49,"49235",450,330,321,5,9,"PREPAL",0
49,"49031",145,115,113,0,2,"PREPAL",6
49,"49015",233,189,188,1,1,"PREPAL",0
49,"49193",472,323,316,4,7,"PREPAL",0
49,"49108",476,359,352,4,7,"PREPAL",2
49,"49142",247,182,180,5,2,"PREPAL",0
49,"49062",121,82,81,1,1,"PREPAL",1
49,"49189",202,130,130,5,0,"PREPAL",0
49,"49243",111,97,95,0,2,"PREPAL",0
49,"49101",153,106,101,3,5,"PREPAL",0
49,"49250",1254,974,952,11,22,"PREPAL",3
49,"49061",150,113,113,1,0,"PREPAL",3
49,"49104",353,224,223,0,1,"PREPAL",0
49,"49191",272,215,213,1,2,"PREPAL",0
49,"49077",189,115,115,0,0,"PREPAL",0
49,"49081",1365,1071,1057,7,14,"PREPAL",0
49,"49172",536,347,341,1,6,"PREPAL",0
49,"49027",150,116,116,5,0,"PREPAL",0
49,"49096",175,134,127,1,7,"PREPAL",0
49,"49097",90,47,47,0,0,"PREPAL",0
49,"49197",180,127,123,2,4,"PREPAL",0
49,"49240",218,168,159,3,9,"PREPAL",1
49,"49124",254,179,176,2,3,"PREPAL",2
49,"49261",1546,1171,1154,9,17,"PREPAL",0
49,"49079",105,80,76,2,4,"PREPAL",0
49,"49263",54,41,41,0,0,"PREPAL",0
49,"49025",174,128,126,0,2,"PREPAL",0
49,"49057",106,77,76,0,1,"PREPAL",0
49,"49028",122,103,102,1,1,"PREPAL",0
49,"49029",623,494,482,4,12,"PREPAL",0
49,"49155",83,64,63,1,1,"PREPAL",0
49,"49054",908,668,651,13,17,"PREPAL",3
49,"49168",90,73,73,2,0,"PREPAL",0
49,"49130",180,137,132,5,5,"PREPAL",2
49,"49039",333,259,252,1,7,"PREPAL",1
49,"49122",773,578,569,7,9,"PREPAL",2
49,"49234",410,336,334,1,2,"PREPAL",0
49,"49026",233,182,179,0,3,"PREPAL",0
49,"49181",369,274,274,2,0,"PREPAL",0
49,"49014",112,83,82,1,1,"PREPAL",0
49,"49208",395,255,250,1,5,"PREPAL",0
49,"49206",854,611,595,6,16,"PREPAL",0
49,"49242",455,373,365,8,8,"PREPAL",0
49,"49005",142,93,93,0,0,"PREPAL",0
49,"49204",64,45,44,0,1,"PREPAL",0
49,"49035",236,205,200,0,5,"PREPAL",0
49,"49265",128,91,91,1,0,"PREPAL",0
49,"49009",400,290,286,4,4,"PREPAL",0
49,"49013",254,172,168,4,4,"PREPAL",0
49,"49116",389,272,266,4,6,"PREPAL",1
49,"49164",158,120,118,1,2,"PREPAL",0
49,"49017",251,169,169,2,0,"PREPAL",0
39,"39001",2127,1651,1631,17,20,"UPYD",8
39,"39061",3488,2746,2722,29,24,"UPYD",16
39,"39044",3833,2889,2860,26,29,"UPYD",21
39,"39102",2281,1647,1631,13,16,"UPYD",11
39,"39031",1235,873,863,5,10,"UPYD",6
39,"39041",1764,1416,1395,10,21,"UPYD",4
39,"39011",1602,1211,1202,13,9,"UPYD",8
39,"39095",2268,1812,1789,9,23,"UPYD",4
39,"39008",13932,10600,10506,92,94,"UPYD",89
39,"39092",916,668,663,4,5,"UPYD",3
39,"39032",1476,1117,1100,8,17,"UPYD",6
39,"39062",1824,1400,1392,14,8,"UPYD",7
39,"39002",3313,2430,2391,17,39,"UPYD",10
39,"39082",1658,1212,1202,15,10,"UPYD",4
39,"39093",307,232,232,1,0,"UPYD",4
39,"39015",862,650,643,6,7,"UPYD",3
39,"39076",3491,2696,2662,24,34,"UPYD",22
39,"39042",5968,4614,4572,33,42,"UPYD",43
39,"39066",868,697,688,7,9,"UPYD",5
39,"39043",1468,1167,1151,10,16,"UPYD",4
39,"39053",219,135,135,1,0,"UPYD",0
39,"39083",1139,747,739,6,8,"UPYD",7
39,"39087",42262,32560,32124,234,436,"UPYD",215
39,"39023",6316,4900,4827,37,73,"UPYD",48
39,"39033",578,432,432,5,0,"UPYD",3
39,"39094",854,644,637,9,7,"UPYD",6
39,"39013",515,378,375,1,3,"UPYD",1
39,"39003",299,219,217,0,2,"UPYD",0
39,"39074",6905,5370,5288,52,82,"UPYD",61
39,"39057",2321,1773,1746,13,27,"UPYD",11
39,"39064",1349,1036,1016,6,20,"UPYD",7
39,"39010",639,509,505,5,4,"UPYD",2
39,"39101",292,206,202,2,4,"UPYD",0
39,"39037",2003,1570,1547,8,23,"UPYD",9
39,"39054",4472,3478,3441,45,37,"UPYD",25
39,"39081",435,349,342,3,7,"UPYD",2
39,"39014",898,655,644,8,11,"UPYD",1
39,"39035",9587,7315,7214,56,101,"UPYD",41
39,"39051",67,62,61,1,1,"UPYD",1
39,"39007",434,298,297,1,1,"UPYD",2
39,"39075",137597,102862,102053,819,809,"UPYD",1084
39,"39034",286,180,179,4,1,"UPYD",0
39,"39052",18086,14014,13852,124,162,"UPYD",165
39,"39065",256,202,200,6,2,"UPYD",3
39,"39024",1882,1452,1438,14,14,"UPYD",3
39,"39099",3117,2446,2406,23,40,"UPYD",22
39,"39004",1539,1177,1160,12,17,"UPYD",4
39,"39028",3733,2918,2877,17,41,"UPYD",27
39,"39085",6834,5319,5265,37,54,"UPYD",22
39,"39055",1118,838,826,6,12,"UPYD",3
39,"39036",983,774,770,8,4,"UPYD",4
39,"39096",702,477,474,3,3,"UPYD",1
39,"39005",1396,1089,1084,4,5,"UPYD",9
39,"39012",6693,5213,5131,44,82,"UPYD",28
39,"39022",987,735,730,7,5,"UPYD",1
39,"39067",813,569,561,5,8,"UPYD",1
39,"39039",572,397,396,1,1,"UPYD",2
39,"39046",1402,1015,985,11,30,"UPYD",3
39,"39069",1968,1586,1555,12,31,"UPYD",11
39,"39097",713,409,400,10,9,"UPYD",2
39,"39006",1728,1353,1337,12,16,"UPYD",7
39,"39056",2326,1805,1775,17,30,"UPYD",18
39,"39049",330,251,248,1,3,"UPYD",0
39,"39048",1697,1372,1361,10,11,"UPYD",8
39,"39040",4290,3337,3309,22,28,"UPYD",26
39,"39016",23860,18608,18405,149,203,"UPYD",163
39,"39026",1751,1303,1295,9,8,"UPYD",1
39,"39030",1894,1314,1290,9,24,"UPYD",10
39,"39088",71,51,51,0,0,"UPYD",1
39,"39073",9806,7636,7574,42,62,"UPYD",81
39,"39047",1978,1463,1448,15,15,"UPYD",7
39,"39009",3223,2395,2370,22,25,"UPYD",11
39,"39020",23612,16515,16334,125,181,"UPYD",113
39,"39060",6705,5437,5339,46,98,"UPYD",38
39,"39017",571,385,377,2,8,"UPYD",3
39,"39027",3139,2493,2439,30,54,"UPYD",23
39,"39091",1947,1572,1552,9,20,"UPYD",8
39,"39089",149,104,103,1,1,"UPYD",0
39,"39079",8951,6734,6657,54,77,"UPYD",39
39,"39018",4211,3389,3329,27,60,"UPYD",20
39,"39098",1422,1078,1074,11,4,"UPYD",11
39,"39084",843,608,604,5,4,"UPYD",2
39,"39068",659,486,479,2,7,"UPYD",4
39,"39078",1413,1045,1032,10,13,"UPYD",1
39,"39070",146,111,109,3,2,"UPYD",0
39,"39029",624,507,503,4,4,"UPYD",7
39,"39050",276,173,170,0,3,"UPYD",1
39,"39072",343,213,213,1,0,"UPYD",0
39,"39038",1463,1039,1030,6,9,"UPYD",11
39,"39077",246,186,182,0,4,"UPYD",0
39,"39058",831,594,592,6,2,"UPYD",4
39,"39100",869,628,617,12,11,"UPYD",5
39,"39025",8693,6696,6583,58,113,"UPYD",31
39,"39086",357,260,258,1,2,"UPYD",2
39,"39090",756,564,550,4,14,"UPYD",6
39,"39059",8057,6049,5972,50,77,"UPYD",59
39,"39080",3552,2734,2701,17,33,"UPYD",6
39,"39071",405,277,272,2,5,"UPYD",1
39,"39045",376,284,276,1,8,"UPYD",2
39,"39019",2098,1669,1646,24,23,"UPYD",10
39,"39063",973,725,720,7,5,"UPYD",4
39,"39021",495,399,391,4,8,"UPYD",1
46,"46094",20515,15885,15785,125,100,"PP",4393
46,"46147",16843,12206,12099,56,107,"PP",3961
46,"46120",1109,919,902,4,17,"PP",272
46,"46227",915,771,765,5,6,"PP",166
46,"46110",21260,16194,16084,76,110,"PP",4379
46,"46239",451,353,351,3,2,"PP",152
46,"46149",362,288,287,2,1,"PP",141
46,"46162",1207,962,947,3,15,"PP",373
46,"46099",922,693,685,0,8,"PP",216
46,"46034",1776,1441,1430,4,11,"PP",396
46,"46258",2676,2099,2078,9,21,"PP",786
46,"46096",279,229,225,2,4,"PP",71
46,"46224",170,130,130,0,0,"PP",44
46,"46223",7814,6169,6129,33,40,"PP",1904
46,"46197",1956,1556,1543,8,13,"PP",302
46,"46076",587,489,483,2,6,"PP",206
46,"46262",232,172,168,0,4,"PP",68
46,"46263",255,204,202,1,2,"PP",49
46,"46185",386,325,321,4,4,"PP",38
46,"46022",15481,11422,11347,69,75,"PP",3097
46,"46113",2436,1864,1849,11,15,"PP",692
46,"46137",268,225,220,3,5,"PP",73
46,"46055",1273,1031,1021,4,10,"PP",282
46,"46124",788,680,672,0,8,"PP",238
46,"46088",176,140,138,0,2,"PP",52
46,"46260",2572,2100,2081,10,19,"PP",582
46,"46153",441,358,354,0,4,"PP",101
46,"46247",1024,743,733,2,10,"PP",363
46,"46033",197,169,168,1,1,"PP",77
46,"46098",2491,1978,1950,14,28,"PP",570
46,"46115",403,296,289,1,7,"PP",141
46,"46047",525,443,435,2,8,"PP",115
46,"46200",1909,1628,1609,5,19,"PP",545
46,"46205",14323,11325,11224,55,101,"PP",3314
46,"46182",1274,970,966,2,4,"PP",229
46,"46060",9361,7285,7229,30,56,"PP",2266
46,"46174",984,808,794,3,14,"PP",228
46,"46245",516,427,420,3,7,"PP",135
46,"46219",125,106,105,2,1,"PP",47
46,"46145",21946,16629,16495,80,134,"PP",4695
46,"46009",3144,2579,2552,13,27,"PP",734
46,"46152",97,76,74,0,2,"PP",27
46,"46189",471,412,405,2,7,"PP",99
46,"46071",466,383,379,2,4,"PP",127
46,"46054",11251,8795,8731,46,64,"PP",2437
46,"46100",289,240,237,1,3,"PP",70
46,"46257",5579,4440,4391,26,49,"PP",1227
46,"46070",16903,13091,12999,64,92,"PP",4086
46,"46017",33050,24762,24580,144,182,"PP",7924
46,"46261",1720,1386,1369,10,17,"PP",505
46,"46242",340,291,285,1,6,"PP",154
46,"46136",2534,2008,1990,13,18,"PP",606
46,"46052",502,432,431,2,1,"PP",145
46,"46004",1924,1582,1559,11,23,"PP",426
46,"46003",963,841,815,1,26,"PP",305
46,"46114",575,488,484,3,4,"PP",199
46,"46011",7627,5496,5407,39,89,"PP",1797
46,"46108",480,375,375,2,0,"PP",151
46,"46254",1012,786,775,1,11,"PP",333
46,"46063",1757,1399,1384,11,15,"PP",403
46,"46228",2363,1854,1839,16,15,"PP",666
46,"46167",373,286,285,1,1,"PP",110
46,"46013",17366,13952,13862,95,90,"PP",3845
46,"46201",67,49,49,0,0,"PP",7
46,"46093",2117,1721,1710,10,11,"PP",646
46,"46214",15730,12427,12334,56,93,"PP",3451
46,"46130",907,722,713,6,9,"PP",230
46,"46206",577,475,468,4,7,"PP",140
46,"46079",326,267,265,2,2,"PP",135
46,"46005",22908,17565,17438,126,127,"PP",4251
46,"46243",141,122,120,0,2,"PP",41
46,"46903",5985,4822,4796,24,26,"PP",1444
46,"46194",15552,11606,11505,69,101,"PP",3324
46,"46156",2087,1712,1702,9,10,"PP",553
46,"46042",3389,2886,2844,19,42,"PP",1113
46,"46050",200,160,160,0,0,"PP",36
46,"46158",1024,817,804,5,13,"PP",278
46,"46161",1481,1206,1194,6,12,"PP",370
46,"46171",16587,12731,12627,79,104,"PP",3510
46,"46238",13324,10023,9939,50,84,"PP",2852
46,"46236",975,810,806,4,4,"PP",232
46,"46226",48,44,44,0,0,"PP",8
46,"46138",345,292,292,0,0,"PP",111
46,"46178",4643,3465,3434,16,31,"PP",1112
46,"46183",6009,4624,4563,18,61,"PP",1727
46,"46218",1074,930,912,1,18,"PP",370
46,"46208",1114,931,922,3,9,"PP",278
46,"46106",1543,1177,1167,5,10,"PP",441
46,"46128",1601,1316,1281,5,35,"PP",463
46,"46204",6781,5421,5379,15,42,"PP",1419
46,"46252",126,95,93,0,2,"PP",53
46,"46209",1955,1531,1508,7,23,"PP",481
46,"46244",58586,43371,43098,257,273,"PP",12758
46,"46087",127,99,99,1,0,"PP",29
46,"46069",161,126,122,0,4,"PP",49
46,"46134",2357,1811,1797,8,14,"PP",480
46,"46091",115,101,100,1,1,"PP",58
46,"46151",722,589,583,1,6,"PP",164
46,"46053",560,454,451,2,3,"PP",98
46,"46220",48393,35859,35571,250,288,"PP",8752
46,"46129",521,435,434,2,1,"PP",87
46,"46141",438,359,348,4,11,"PP",178
46,"46215",1433,1152,1149,4,3,"PP",216
46,"46072",3625,2993,2931,37,62,"PP",885
46,"46241",400,324,314,1,10,"PP",75
46,"46133",563,458,455,2,3,"PP",139
46,"46181",17066,12779,12636,96,143,"PP",3825
46,"46092",273,183,183,0,0,"PP",99
46,"46001",802,623,615,4,8,"PP",273
46,"46190",48824,36748,36542,238,206,"PP",9338
46,"46193",8795,7101,7061,40,40,"PP",1710
46,"46006",4529,3803,3748,18,55,"PP",1367
46,"46031",10520,7830,7759,70,71,"PP",2054
46,"46015",7231,5768,5711,33,57,"PP",1590
46,"46237",7227,5620,5571,33,49,"PP",1405
46,"46131",49604,37767,37431,266,336,"PP",13042
46,"46045",1261,1066,1041,3,25,"PP",297
46,"46105",16249,11731,11629,59,102,"PP",3788
46,"46014",3042,2456,2434,17,22,"PP",725
46,"46039",2147,1746,1727,9,19,"PP",614
46,"46166",8155,6521,6450,41,71,"PP",1853
46,"46068",354,305,297,1,8,"PP",94
46,"46049",280,242,238,1,4,"PP",120
46,"46085",11147,8107,8033,57,74,"PP",2664
46,"46140",349,288,284,2,4,"PP",77
46,"46184",26467,20888,20675,138,213,"PP",5589
46,"46172",5040,3629,3599,14,30,"PP",1085
46,"46086",82,73,73,1,0,"PP",8
46,"46037",1119,952,941,2,11,"PP",301
46,"46199",5742,4458,4425,34,33,"PP",1430
46,"46176",2025,1431,1416,10,15,"PP",435
46,"46107",1915,1566,1553,2,13,"PP",527
46,"46041",331,254,253,6,1,"PP",67
46,"46061",337,281,281,3,0,"PP",67
46,"46146",1670,1333,1318,11,15,"PP",389
46,"46251",2490,2082,2045,11,37,"PP",660
46,"46203",3598,2962,2928,17,34,"PP",700
46,"46256",6833,5087,5062,37,25,"PP",1818
46,"46230",13944,10746,10646,69,100,"PP",2877
46,"46075",149,132,130,2,2,"PP",42
46,"46192",767,573,568,1,5,"PP",160
46,"46012",888,723,703,3,20,"PP",258
46,"46056",184,160,158,1,2,"PP",47
46,"46074",2690,2158,2145,18,13,"PP",522
46,"46188",668,548,538,3,10,"PP",157
46,"46077",7569,6100,6010,41,90,"PP",1222
46,"46026",1204,1044,1034,4,10,"PP",362
46,"46210",338,295,283,2,12,"PP",100
46,"46102",19843,15783,15676,102,107,"PP",3652
46,"46246",1066,856,838,7,18,"PP",375
46,"46038",345,255,255,0,0,"PP",88
46,"46150",1839,1377,1362,10,15,"PP",527
46,"46048",3448,2817,2790,8,27,"PP",792
46,"46080",1025,795,784,4,11,"PP",279
46,"46229",972,785,774,2,11,"PP",260
46,"46016",1068,885,874,3,11,"PP",230
46,"46157",2978,2370,2343,19,27,"PP",945
46,"46021",23646,18220,18100,85,120,"PP",4449
46,"46057",495,339,337,6,2,"PP",144
46,"46196",153,131,130,0,1,"PP",65
46,"46139",4495,3629,3577,26,52,"PP",1261
46,"46028",395,346,339,2,7,"PP",119
46,"46179",2182,1823,1788,13,35,"PP",663
46,"46118",3795,2987,2962,18,25,"PP",995
46,"46144",665,525,520,2,5,"PP",263
46,"46904",802,662,654,7,8,"PP",171
46,"46083",15467,11584,11443,79,141,"PP",3785
46,"46040",1098,914,907,4,7,"PP",309
46,"46097",959,734,728,6,6,"PP",210
46,"46231",2411,1759,1735,11,24,"PP",422
46,"46112",552,466,464,1,2,"PP",204
46,"46222",383,322,321,2,1,"PP",69
46,"46023",328,294,287,2,7,"PP",93
46,"46198",846,702,693,1,9,"PP",149
46,"46211",1723,1441,1434,13,7,"PP",497
46,"46155",1035,865,846,2,19,"PP",231
46,"46122",2701,2120,2109,18,11,"PP",532
46,"46008",2673,2201,2189,8,12,"PP",609
46,"46121",105,92,91,2,1,"PP",43
46,"46202",16767,13171,13058,59,113,"PP",3858
46,"46163",1847,1508,1489,8,19,"PP",416
46,"46255",3145,2494,2470,19,24,"PP",760
46,"46125",857,709,701,5,8,"PP",209
46,"46221",339,305,303,0,2,"PP",112
46,"46101",858,731,723,4,8,"PP",214
46,"46259",503,410,406,2,4,"PP",159
46,"46235",21793,16577,16424,118,153,"PP",4221
46,"46027",948,795,781,3,14,"PP",290
46,"46180",682,581,572,1,9,"PP",128
46,"46064",527,429,423,0,6,"PP",140
46,"46127",2706,2212,2175,10,37,"PP",698
46,"46248",4873,3679,3639,18,40,"PP",1325
46,"46090",1640,1440,1424,4,16,"PP",483
46,"46082",4947,3843,3814,25,29,"PP",1040
46,"46025",2502,2008,1993,6,15,"PP",566
46,"46065",1588,1246,1227,5,19,"PP",323
46,"46165",7115,5626,5576,31,50,"PP",1764
46,"46160",1912,1523,1514,3,9,"PP",315
46,"46117",493,414,411,4,3,"PP",124
46,"46123",1838,1466,1447,4,19,"PP",374
46,"46032",5635,4529,4493,16,36,"PP",1209
46,"46007",11953,9099,9038,65,61,"PP",2772
46,"46062",4652,3650,3583,32,67,"PP",1310
46,"46253",109,93,93,0,0,"PP",22
46,"46135",9655,7845,7810,32,35,"PP",2467
46,"46081",10180,8055,7984,32,71,"PP",2658
46,"46044",4237,3347,3285,25,62,"PP",1026
46,"46043",145,131,131,0,0,"PP",61
46,"46216",5039,4207,4188,20,19,"PP",1504
46,"46232",894,715,712,5,3,"PP",241
46,"46173",1336,1097,1080,9,17,"PP",352
46,"46111",10876,8133,8050,35,83,"PP",2422
46,"46159",22905,17498,17373,102,125,"PP",4566
46,"46030",804,660,635,7,25,"PP",206
46,"46142",797,619,608,2,11,"PP",223
46,"46084",1576,1314,1298,6,16,"PP",464
46,"46148",1528,1206,1192,15,14,"PP",437
46,"46036",583,384,381,8,3,"PP",163
46,"46168",1938,1542,1530,11,12,"PP",417
46,"46095",608,498,493,2,5,"PP",199
46,"46109",6195,4764,4682,23,82,"PP",1471
46,"46089",2141,1649,1625,14,24,"PP",581
46,"46010",914,725,716,4,9,"PP",216
46,"46195",1967,1612,1602,9,10,"PP",463
46,"46035",6786,5382,5338,27,44,"PP",1265
46,"46046",896,697,686,1,11,"PP",244
46,"46212",1612,1234,1214,5,20,"PP",373
46,"46029",20649,15241,15110,113,131,"PP",4753
46,"46250",578668,455375,452638,2701,2737,"PP",145548
46,"46213",15476,11377,11246,110,131,"PP",3781
46,"46191",1970,1557,1533,6,24,"PP",589
46,"46018",635,531,522,3,9,"PP",218
46,"46119",783,672,666,7,6,"PP",192
46,"46217",886,724,712,3,12,"PP",223
46,"46233",3904,2974,2934,15,40,"PP",953
46,"46187",1310,1036,1028,6,8,"PP",343
46,"46104",1956,1567,1543,6,24,"PP",550
46,"46024",424,348,340,0,8,"PP",137
46,"46019",8833,7183,7109,47,74,"PP",1946
46,"46225",346,299,290,0,9,"PP",117
46,"46249",9362,7163,7072,42,91,"PP",2313
46,"46067",1736,1457,1382,2,75,"PP",448
46,"46132",2148,1850,1830,12,20,"PP",682
46,"46051",8347,6500,6442,27,58,"PP",2576
46,"46207",6656,5355,5293,42,62,"PP",1664
46,"46002",1175,947,935,5,12,"PP",283
46,"46066",1255,1028,1020,6,8,"PP",306
46,"46078",28126,20975,20850,127,125,"PP",5127
46,"46186",19033,15061,14950,70,111,"PP",3894
46,"46143",4215,3219,3171,27,48,"PP",1056
46,"46103",1270,1015,998,8,17,"PP",340
46,"46059",1272,1066,1058,4,8,"PP",214
46,"46154",811,644,640,4,4,"PP",255
46,"46058",1779,1430,1409,10,21,"PP",398
46,"46175",459,403,396,1,7,"PP",134
46,"46177",4698,3715,3665,16,50,"PP",875
46,"46116",13153,10566,10518,62,48,"PP",3193
46,"46170",3451,2821,2775,16,46,"PP",1010
46,"46073",1097,903,892,6,11,"PP",275
46,"46020",3784,3064,3012,15,52,"PP",1038
46,"46126",5555,4619,4574,26,45,"PP",1196
46,"46234",354,289,287,2,2,"PP",101
46,"46902",379,314,313,3,1,"PP",56
46,"46164",11777,8893,8798,54,95,"PP",2479
46,"46169",32396,25109,24953,169,156,"PP",6458
46,"46240",209,169,164,1,5,"PP",74
25,"25212",234,173,171,1,2,"UPYD",0
25,"25064",112,85,85,3,0,"UPYD",0
25,"25173",1702,1180,1171,5,9,"UPYD",3
25,"25031",52,31,31,0,0,"UPYD",0
25,"25017",239,160,159,2,1,"UPYD",0
25,"25126",286,214,210,5,4,"UPYD",0
25,"25221",130,76,76,0,0,"UPYD",0
25,"25006",346,214,212,6,2,"UPYD",0
25,"25057",206,152,151,2,1,"UPYD",0
25,"25021",2618,1655,1639,32,16,"UPYD",5
25,"25055",172,118,116,2,2,"UPYD",0
25,"25223",922,614,598,8,16,"UPYD",0
25,"25136",98,71,70,0,1,"UPYD",0
25,"25067",730,483,479,4,4,"UPYD",2
25,"25217",10594,7016,6950,119,66,"UPYD",4
25,"25201",115,70,67,0,3,"UPYD",0
25,"25200",336,218,218,0,0,"UPYD",0
25,"25060",70,45,45,2,0,"UPYD",0
25,"25150",185,127,124,1,3,"UPYD",0
25,"25128",142,89,89,0,0,"UPYD",1
25,"25253",163,125,124,0,1,"UPYD",0
25,"25074",182,145,141,0,4,"UPYD",2
25,"25097",87,62,62,4,0,"UPYD",0
25,"25205",562,413,402,2,11,"UPYD",1
25,"25004",571,425,423,5,2,"UPYD",1
25,"25112",272,189,189,2,0,"UPYD",0
25,"25207",6216,4062,4031,45,31,"UPYD",2
25,"25077",460,272,269,2,3,"UPYD",1
25,"25204",1241,843,827,3,16,"UPYD",0
25,"25185",681,421,418,8,3,"UPYD",0
25,"25109",238,168,168,1,0,"UPYD",0
25,"25113",1163,854,845,12,9,"UPYD",1
25,"25138",576,415,408,6,7,"UPYD",0
25,"25904",155,118,118,0,0,"UPYD",0
25,"25170",264,182,179,1,3,"UPYD",1
25,"25238",217,151,151,6,0,"UPYD",0
25,"25157",181,139,137,1,2,"UPYD",0
25,"25003",3782,2390,2372,24,18,"UPYD",1
25,"25202",101,72,72,0,0,"UPYD",0
25,"25129",176,113,110,6,3,"UPYD",0
25,"25182",1043,738,727,13,11,"UPYD",1
25,"25041",569,380,374,7,6,"UPYD",1
25,"25254",738,507,493,6,14,"UPYD",1
25,"25166",177,123,121,1,2,"UPYD",0
25,"25035",397,287,286,3,1,"UPYD",1
25,"25103",131,80,80,3,0,"UPYD",1
25,"25142",368,252,251,3,1,"UPYD",0
25,"25152",140,100,98,4,2,"UPYD",0
25,"25130",197,117,117,3,0,"UPYD",0
25,"25905",386,260,255,4,5,"UPYD",0
25,"25104",125,86,86,3,0,"UPYD",0
25,"25251",710,495,494,3,1,"UPYD",3
25,"25190",263,195,195,4,0,"UPYD",0
25,"25225",575,395,393,6,2,"UPYD",0
25,"25180",239,151,151,0,0,"UPYD",0
25,"25110",2796,1828,1807,30,21,"UPYD",3
25,"25043",794,505,501,3,4,"UPYD",0
25,"25089",106,58,58,0,0,"UPYD",1
25,"25175",194,132,132,7,0,"UPYD",0
25,"25215",334,244,243,2,1,"UPYD",2
25,"25096",912,586,572,9,14,"UPYD",0
25,"25099",1260,804,793,8,11,"UPYD",1
25,"25216",226,150,150,0,0,"UPYD",0
25,"25101",565,393,388,9,5,"UPYD",0
25,"25086",533,373,372,5,1,"UPYD",0
25,"25053",1059,762,759,10,3,"UPYD",0
25,"25177",372,258,258,2,0,"UPYD",0
25,"25191",332,225,222,3,3,"UPYD",0
25,"25033",1106,777,767,7,10,"UPYD",0
25,"25909",155,89,89,3,0,"UPYD",0
25,"25233",278,193,191,2,2,"UPYD",0
25,"25145",85,64,64,2,0,"UPYD",0
25,"25222",67,52,52,1,0,"UPYD",0
25,"25132",130,97,95,1,2,"UPYD",0
25,"25179",161,115,114,0,1,"UPYD",0
25,"25227",641,398,395,3,3,"UPYD",0
25,"25081",318,213,210,2,3,"UPYD",1
25,"25048",1644,1151,1138,8,13,"UPYD",1
25,"25168",508,392,391,2,1,"UPYD",0
25,"25014",254,177,174,4,3,"UPYD",0
25,"25250",344,236,234,0,2,"UPYD",0
25,"25148",220,155,153,0,2,"UPYD",0
25,"25244",369,252,248,3,4,"UPYD",0
25,"25051",1522,990,983,10,7,"UPYD",0
25,"25088",96,76,75,0,1,"UPYD",1
25,"25025",1346,966,956,10,10,"UPYD",3
25,"25119",2259,1582,1569,22,13,"UPYD",1
25,"25189",2106,1392,1381,16,11,"UPYD",3
25,"25093",639,451,445,11,6,"UPYD",0
25,"25122",1916,1274,1264,15,10,"UPYD",0
25,"25045",52,36,36,0,0,"UPYD",0
25,"25072",5858,3878,3835,45,43,"UPYD",4
25,"25123",193,131,130,0,1,"UPYD",0
25,"25098",253,163,160,2,3,"UPYD",0
25,"25015",355,258,257,3,1,"UPYD",1
25,"25912",868,618,617,5,1,"UPYD",0
25,"25903",237,154,152,3,2,"UPYD",0
25,"25012",2296,1504,1488,8,16,"UPYD",3
25,"25078",1007,720,717,6,3,"UPYD",3
25,"25153",198,141,137,0,4,"UPYD",0
25,"25226",251,156,153,3,3,"UPYD",0
25,"25176",312,239,235,7,4,"UPYD",0
25,"25073",588,374,371,8,3,"UPYD",0
25,"25219",144,106,105,3,1,"UPYD",0
25,"25234",4290,2645,2621,25,24,"UPYD",0
25,"25240",1407,1006,995,10,11,"UPYD",1
25,"25076",146,84,84,1,0,"UPYD",1
25,"25024",356,233,230,1,3,"UPYD",0
25,"25208",316,191,189,1,2,"UPYD",0
25,"25010",212,131,130,6,1,"UPYD",0
25,"25908",228,138,137,3,1,"UPYD",0
25,"25137",8577,5630,5591,45,39,"UPYD",9
25,"25146",224,150,148,2,2,"UPYD",0
25,"25231",490,382,382,2,0,"UPYD",2
25,"25167",236,158,156,3,2,"UPYD",0
25,"25186",214,141,138,2,3,"UPYD",0
25,"25196",119,74,74,0,0,"UPYD",0
25,"25092",132,93,89,1,4,"UPYD",0
25,"25034",2331,1516,1505,20,11,"UPYD",0
25,"25139",479,325,324,3,1,"UPYD",0
25,"25059",801,590,584,11,6,"UPYD",2
25,"25019",4565,3001,2965,36,36,"UPYD",4
25,"25052",1573,1132,1122,16,10,"UPYD",2
25,"25056",243,151,150,2,1,"UPYD",0
25,"25192",767,510,496,11,14,"UPYD",0
25,"25158",1639,1163,1150,26,13,"UPYD",0
25,"25140",774,468,465,4,3,"UPYD",0
25,"25243",3612,2449,2423,30,26,"UPYD",2
25,"25001",139,88,87,1,1,"UPYD",0
25,"25068",558,372,369,9,3,"UPYD",0
25,"25042",208,143,142,0,1,"UPYD",0
25,"25023",4527,3111,3073,20,38,"UPYD",5
25,"25143",87,58,57,1,1,"UPYD",0
25,"25120",92243,61433,61005,533,428,"UPYD",519
25,"25206",257,164,164,3,0,"UPYD",0
25,"25141",156,101,99,1,2,"UPYD",0
25,"25029",1662,1156,1147,13,9,"UPYD",1
25,"25039",280,182,180,0,2,"UPYD",0
25,"25252",548,399,398,6,1,"UPYD",0
25,"25032",61,44,43,0,1,"UPYD",0
25,"25210",1104,779,767,9,12,"UPYD",0
25,"25102",712,473,467,10,6,"UPYD",1
25,"25163",228,143,142,5,1,"UPYD",0
25,"25079",305,216,214,5,2,"UPYD",0
25,"25134",635,418,414,4,4,"UPYD",0
25,"25118",350,223,223,8,0,"UPYD",0
25,"25181",177,138,137,5,1,"UPYD",0
25,"25016",2114,1417,1411,8,6,"UPYD",2
25,"25114",97,87,87,0,0,"UPYD",1
25,"25121",642,415,413,8,2,"UPYD",1
25,"25911",452,301,299,7,2,"UPYD",1
25,"25245",441,313,313,0,0,"UPYD",1
25,"25174",398,299,296,3,3,"UPYD",0
25,"25047",1010,730,722,6,8,"UPYD",1
25,"25070",817,584,573,14,11,"UPYD",1
25,"25037",385,245,241,2,4,"UPYD",0
25,"25022",106,76,76,2,0,"UPYD",0
25,"25154",120,68,68,1,0,"UPYD",0
25,"25058",4378,2810,2793,27,17,"UPYD",7
25,"25082",280,169,167,3,2,"UPYD",0
25,"25044",189,136,136,3,0,"UPYD",0
25,"25248",891,622,616,3,6,"UPYD",0
25,"25124",169,118,116,2,2,"UPYD",0
25,"25071",51,31,31,0,0,"UPYD",0
25,"25127",212,135,134,3,1,"UPYD",0
25,"25062",757,521,516,4,5,"UPYD",0
25,"25038",1564,1075,1062,11,13,"UPYD",1
25,"25105",130,95,93,4,2,"UPYD",1
25,"25133",713,469,464,1,5,"UPYD",0
25,"25011",5256,3190,3161,36,29,"UPYD",5
25,"25005",277,183,182,2,1,"UPYD",3
25,"25075",117,82,82,0,0,"UPYD",0
25,"25197",137,97,97,2,0,"UPYD",0
25,"25008",1135,828,819,11,9,"UPYD",1
25,"25013",2171,1380,1366,10,14,"UPYD",1
25,"25036",184,126,121,0,5,"UPYD",0
25,"25009",631,465,460,3,5,"UPYD",0
25,"25239",608,320,319,1,1,"UPYD",0
25,"25156",791,574,571,7,3,"UPYD",0
25,"25115",824,551,549,12,2,"UPYD",0
25,"25087",61,46,45,0,1,"UPYD",0
25,"25094",139,111,109,0,2,"UPYD",0
25,"25131",412,271,261,8,10,"UPYD",0
25,"25230",1573,1100,1081,13,19,"UPYD",0
25,"25249",183,118,118,2,0,"UPYD",0
25,"25910",101,64,62,0,2,"UPYD",0
25,"25069",453,289,286,6,3,"UPYD",0
25,"25169",188,125,124,3,1,"UPYD",0
25,"25913",87,69,69,1,0,"UPYD",0
25,"25255",426,308,302,4,6,"UPYD",2
25,"25111",115,83,83,1,0,"UPYD",0
25,"25135",1032,707,701,7,6,"UPYD",2
25,"25040",10532,6837,6762,81,75,"UPYD",11
25,"25247",123,72,72,0,0,"UPYD",0
25,"25224",126,86,86,1,0,"UPYD",0
25,"25901",292,186,181,4,5,"UPYD",0
25,"25172",1805,1230,1214,8,16,"UPYD",5
25,"25171",2190,1461,1444,4,17,"UPYD",0
25,"25220",1028,709,701,9,8,"UPYD",1
25,"25030",131,86,86,2,0,"UPYD",0
25,"25209",1517,1035,1019,6,16,"UPYD",1
25,"25194",426,278,273,0,5,"UPYD",0
25,"25046",421,292,286,1,6,"UPYD",0
25,"25242",732,480,477,4,3,"UPYD",0
25,"25049",151,104,104,1,0,"UPYD",0
25,"25165",280,194,190,4,4,"UPYD",0
25,"25161",368,234,232,3,2,"UPYD",0
25,"25027",1001,687,681,3,6,"UPYD",0
25,"25063",91,55,55,0,0,"UPYD",0
25,"25164",381,264,262,2,2,"UPYD",0
25,"25218",84,66,66,0,0,"UPYD",0
25,"25100",212,134,134,3,0,"UPYD",1
25,"25085",152,106,106,0,0,"UPYD",0
25,"25050",3253,2064,2048,27,16,"UPYD",2
25,"25020",292,203,200,2,3,"UPYD",1
25,"25002",484,323,321,2,2,"UPYD",0
25,"25061",82,53,53,0,0,"UPYD",1
25,"25193",765,520,514,3,6,"UPYD",0
25,"25228",3043,2140,2118,21,22,"UPYD",4
25,"25125",424,279,273,4,6,"UPYD",0
25,"25906",226,144,143,0,1,"UPYD",0
25,"25149",1382,1010,993,7,17,"UPYD",0
25,"25183",501,332,331,4,1,"UPYD",0
25,"25203",8976,5588,5526,53,62,"UPYD",10
25,"25232",1421,961,950,10,11,"UPYD",0
25,"25151",670,466,459,3,7,"UPYD",1
25,"25907",498,317,314,3,3,"UPYD",0
25,"25007",1410,1005,996,13,9,"UPYD",0
25,"25211",683,427,422,4,5,"UPYD",0
25,"25902",570,390,379,3,11,"UPYD",1
25,"25155",667,463,459,5,4,"UPYD",0
39,"39019",2098,1669,1646,24,23,"PACMA",20
39,"39088",71,51,51,0,0,"PACMA",0
39,"39082",1658,1212,1202,15,10,"PACMA",11
39,"39032",1476,1117,1100,8,17,"PACMA",4
39,"39099",3117,2446,2406,23,40,"PACMA",24
39,"39081",435,349,342,3,7,"PACMA",0
39,"39003",299,219,217,0,2,"PACMA",1
39,"39044",3833,2889,2860,26,29,"PACMA",36
39,"39025",8693,6696,6583,58,113,"PACMA",44
39,"39064",1349,1036,1016,6,20,"PACMA",9
39,"39028",3733,2918,2877,17,41,"PACMA",8
39,"39038",1463,1039,1030,6,9,"PACMA",13
39,"39024",1882,1452,1438,14,14,"PACMA",5
39,"39017",571,385,377,2,8,"PACMA",3
39,"39071",405,277,272,2,5,"PACMA",0
39,"39096",702,477,474,3,3,"PACMA",0
39,"39045",376,284,276,1,8,"PACMA",2
39,"39101",292,206,202,2,4,"PACMA",0
39,"39069",1968,1586,1555,12,31,"PACMA",13
39,"39097",713,409,400,10,9,"PACMA",0
39,"39072",343,213,213,1,0,"PACMA",0
39,"39026",1751,1303,1295,9,8,"PACMA",6
39,"39021",495,399,391,4,8,"PACMA",0
39,"39094",854,644,637,9,7,"PACMA",7
39,"39057",2321,1773,1746,13,27,"PACMA",10
39,"39007",434,298,297,1,1,"PACMA",0
39,"39041",1764,1416,1395,10,21,"PACMA",5
39,"39046",1402,1015,985,11,30,"PACMA",2
39,"39084",843,608,604,5,4,"PACMA",6
39,"39033",578,432,432,5,0,"PACMA",1
39,"39034",286,180,179,4,1,"PACMA",0
39,"39022",987,735,730,7,5,"PACMA",0
39,"39091",1947,1572,1552,9,20,"PACMA",4
39,"39065",256,202,200,6,2,"PACMA",0
39,"39012",6693,5213,5131,44,82,"PACMA",44
39,"39068",659,486,479,2,7,"PACMA",3
39,"39092",916,668,663,4,5,"PACMA",4
39,"39011",1602,1211,1202,13,9,"PACMA",5
39,"39074",6905,5370,5288,52,82,"PACMA",36
39,"39060",6705,5437,5339,46,98,"PACMA",37
39,"39001",2127,1651,1631,17,20,"PACMA",8
39,"39075",137597,102862,102053,819,809,"PACMA",917
39,"39014",898,655,644,8,11,"PACMA",1
39,"39035",9587,7315,7214,56,101,"PACMA",86
39,"39043",1468,1167,1151,10,16,"PACMA",19
39,"39059",8057,6049,5972,50,77,"PACMA",48
39,"39070",146,111,109,3,2,"PACMA",3
39,"39050",276,173,170,0,3,"PACMA",1
39,"39023",6316,4900,4827,37,73,"PACMA",56
39,"39102",2281,1647,1631,13,16,"PACMA",7
39,"39053",219,135,135,1,0,"PACMA",0
39,"39002",3313,2430,2391,17,39,"PACMA",10
39,"39055",1118,838,826,6,12,"PACMA",2
39,"39009",3223,2395,2370,22,25,"PACMA",20
39,"39049",330,251,248,1,3,"PACMA",1
39,"39005",1396,1089,1084,4,5,"PACMA",17
39,"39016",23860,18608,18405,149,203,"PACMA",139
39,"39098",1422,1078,1074,11,4,"PACMA",7
39,"39067",813,569,561,5,8,"PACMA",4
39,"39085",6834,5319,5265,37,54,"PACMA",57
39,"39029",624,507,503,4,4,"PACMA",1
39,"39006",1728,1353,1337,12,16,"PACMA",5
39,"39077",246,186,182,0,4,"PACMA",2
39,"39047",1978,1463,1448,15,15,"PACMA",18
39,"39027",3139,2493,2439,30,54,"PACMA",19
39,"39037",2003,1570,1547,8,23,"PACMA",12
39,"39013",515,378,375,1,3,"PACMA",0
39,"39051",67,62,61,1,1,"PACMA",2
39,"39031",1235,873,863,5,10,"PACMA",0
39,"39010",639,509,505,5,4,"PACMA",4
39,"39018",4211,3389,3329,27,60,"PACMA",25
39,"39058",831,594,592,6,2,"PACMA",1
39,"39080",3552,2734,2701,17,33,"PACMA",15
39,"39042",5968,4614,4572,33,42,"PACMA",35
39,"39036",983,774,770,8,4,"PACMA",4
39,"39078",1413,1045,1032,10,13,"PACMA",7
39,"39008",13932,10600,10506,92,94,"PACMA",97
39,"39100",869,628,617,12,11,"PACMA",8
39,"39061",3488,2746,2722,29,24,"PACMA",27
39,"39090",756,564,550,4,14,"PACMA",4
39,"39004",1539,1177,1160,12,17,"PACMA",4
39,"39083",1139,747,739,6,8,"PACMA",3
39,"39052",18086,14014,13852,124,162,"PACMA",130
39,"39086",357,260,258,1,2,"PACMA",0
39,"39039",572,397,396,1,1,"PACMA",0
39,"39040",4290,3337,3309,22,28,"PACMA",25
39,"39087",42262,32560,32124,234,436,"PACMA",247
39,"39093",307,232,232,1,0,"PACMA",1
39,"39079",8951,6734,6657,54,77,"PACMA",70
39,"39056",2326,1805,1775,17,30,"PACMA",13
39,"39048",1697,1372,1361,10,11,"PACMA",6
39,"39076",3491,2696,2662,24,34,"PACMA",28
39,"39020",23612,16515,16334,125,181,"PACMA",186
39,"39066",868,697,688,7,9,"PACMA",1
39,"39054",4472,3478,3441,45,37,"PACMA",43
39,"39095",2268,1812,1789,9,23,"PACMA",8
39,"39089",149,104,103,1,1,"PACMA",0
39,"39073",9806,7636,7574,42,62,"PACMA",78
39,"39062",1824,1400,1392,14,8,"PACMA",8
39,"39063",973,725,720,7,5,"PACMA",1
39,"39015",862,650,643,6,7,"PACMA",3
39,"39030",1894,1314,1290,9,24,"PACMA",17
44,"44112",426,293,284,2,9,"UPYD",2
44,"44221",365,298,296,2,2,"UPYD",1
44,"44060",40,35,35,1,0,"UPYD",0
44,"44027",161,122,121,4,1,"UPYD",0
44,"44111",92,69,69,0,0,"UPYD",0
44,"44226",141,102,100,2,2,"UPYD",0
44,"44149",99,71,71,3,0,"UPYD",0
44,"44109",110,76,74,1,2,"UPYD",1
44,"44169",351,268,266,3,2,"UPYD",1
44,"44238",2345,1743,1729,7,14,"UPYD",5
44,"44187",199,148,143,1,5,"UPYD",0
44,"44151",191,147,145,1,2,"UPYD",1
44,"44024",27,23,23,0,0,"UPYD",0
44,"44040",202,160,158,3,2,"UPYD",0
44,"44062",35,27,26,0,1,"UPYD",0
44,"44227",75,63,63,0,0,"UPYD",0
44,"44021",107,83,83,2,0,"UPYD",0
44,"44231",38,32,32,0,0,"UPYD",0
44,"44236",59,45,45,0,0,"UPYD",1
44,"44234",62,48,48,1,0,"UPYD",0
44,"44059",541,431,423,7,8,"UPYD",4
44,"44039",219,162,160,2,2,"UPYD",1
44,"44196",134,102,102,1,0,"UPYD",0
44,"44029",567,475,467,5,8,"UPYD",0
44,"44113",72,50,50,0,0,"UPYD",0
44,"44066",110,83,83,1,0,"UPYD",0
44,"44216",26539,19621,19346,248,275,"UPYD",135
44,"44121",60,43,43,0,0,"UPYD",1
44,"44190",72,53,52,0,1,"UPYD",0
44,"44225",111,76,76,4,0,"UPYD",0
44,"44208",34,22,22,0,0,"UPYD",1
44,"44157",65,41,40,0,1,"UPYD",0
44,"44199",43,36,36,1,0,"UPYD",0
44,"44178",56,42,42,0,0,"UPYD",0
44,"44023",18,15,15,0,0,"UPYD",0
44,"44047",221,139,135,0,4,"UPYD",1
44,"44022",490,323,316,9,7,"UPYD",1
44,"44173",101,85,84,0,1,"UPYD",3
44,"44204",25,22,22,0,0,"UPYD",0
44,"44191",771,595,586,7,9,"UPYD",1
44,"44020",24,20,19,1,1,"UPYD",0
44,"44218",37,26,26,0,0,"UPYD",1
44,"44150",32,21,20,0,1,"UPYD",0
44,"44106",159,127,126,3,1,"UPYD",0
44,"44119",135,94,90,2,4,"UPYD",0
44,"44033",279,193,191,2,2,"UPYD",1
44,"44161",447,324,320,3,4,"UPYD",2
44,"44154",261,194,191,3,3,"UPYD",0
44,"44049",850,624,613,8,11,"UPYD",1
44,"44036",24,16,16,0,0,"UPYD",0
44,"44124",78,58,58,1,0,"UPYD",0
44,"44025",6062,4490,4394,48,96,"UPYD",27
44,"44147",419,312,307,5,5,"UPYD",2
44,"44034",138,112,110,2,2,"UPYD",1
44,"44108",331,238,234,4,4,"UPYD",0
44,"44084",55,45,45,0,0,"UPYD",0
44,"44163",128,94,94,0,0,"UPYD",0
44,"44189",58,40,40,1,0,"UPYD",0
44,"44246",1554,1091,1079,13,12,"UPYD",2
44,"44159",39,34,34,0,0,"UPYD",0
44,"44200",40,22,22,0,0,"UPYD",0
44,"44158",1170,898,872,12,26,"UPYD",8
44,"44155",1102,831,825,7,6,"UPYD",7
44,"44065",55,36,36,1,0,"UPYD",0
44,"44228",99,79,79,1,0,"UPYD",1
44,"44203",10,8,8,0,0,"UPYD",0
44,"44085",52,40,40,4,0,"UPYD",0
44,"44026",90,71,71,0,0,"UPYD",0
44,"44100",187,154,153,0,1,"UPYD",0
44,"44194",111,79,75,0,4,"UPYD",1
44,"44032",16,13,13,0,0,"UPYD",0
44,"44077",75,58,57,0,1,"UPYD",0
44,"44229",151,108,107,1,1,"UPYD",0
44,"44148",93,76,76,3,0,"UPYD",0
44,"44002",54,41,41,0,0,"UPYD",0
44,"44224",22,14,14,0,0,"UPYD",0
44,"44041",54,46,46,2,0,"UPYD",0
44,"44230",155,126,126,2,0,"UPYD",1
44,"44235",91,71,70,2,1,"UPYD",0
44,"44067",117,80,80,0,0,"UPYD",0
44,"44063",78,61,61,0,0,"UPYD",0
44,"44011",57,35,35,0,0,"UPYD",0
44,"44102",31,25,25,0,0,"UPYD",0
44,"44222",137,96,96,0,0,"UPYD",1
44,"44249",57,47,47,3,0,"UPYD",1
44,"44192",364,280,278,0,2,"UPYD",0
44,"44195",92,61,61,2,0,"UPYD",1
44,"44003",19,16,16,0,0,"UPYD",0
44,"44247",314,230,228,2,2,"UPYD",0
44,"44120",222,140,138,2,2,"UPYD",3
44,"44042",127,93,92,1,1,"UPYD",0
44,"44116",83,67,65,1,2,"UPYD",0
44,"44082",91,68,67,0,1,"UPYD",0
44,"44193",82,62,62,1,0,"UPYD",0
44,"44245",250,189,186,1,3,"UPYD",0
44,"44250",19,12,12,2,0,"UPYD",1
44,"44004",415,295,291,3,4,"UPYD",0
44,"44232",391,286,279,4,7,"UPYD",1
44,"44156",46,33,32,1,1,"UPYD",0
44,"44127",73,51,50,0,1,"UPYD",0
44,"44183",77,45,44,0,1,"UPYD",0
44,"44171",183,136,135,1,1,"UPYD",0
44,"44241",537,408,403,2,5,"UPYD",1
44,"44198",187,151,148,3,3,"UPYD",0
44,"44237",408,327,321,2,6,"UPYD",1
44,"44125",65,39,39,0,0,"UPYD",0
44,"44031",99,64,64,0,0,"UPYD",0
44,"44071",599,430,424,8,6,"UPYD",6
44,"44117",347,278,274,2,4,"UPYD",3
44,"44005",54,38,37,2,1,"UPYD",0
44,"44153",1812,1209,1196,15,13,"UPYD",10
44,"44114",244,186,185,3,1,"UPYD",2
44,"44212",41,32,32,0,0,"UPYD",0
44,"44172",310,216,216,6,0,"UPYD",1
44,"44118",165,127,125,2,2,"UPYD",0
44,"44252",85,67,66,0,1,"UPYD",1
44,"44256",39,34,34,1,0,"UPYD",0
44,"44239",22,20,20,0,0,"UPYD",0
44,"44074",430,338,329,5,9,"UPYD",2
44,"44006",250,188,186,1,2,"UPYD",1
44,"44045",355,290,286,2,4,"UPYD",2
44,"44090",82,57,57,0,0,"UPYD",0
44,"44146",173,157,157,1,0,"UPYD",0
44,"44131",26,20,20,0,0,"UPYD",0
44,"44174",430,314,313,2,1,"UPYD",1
44,"44092",80,53,52,0,1,"UPYD",0
44,"44213",63,47,47,0,0,"UPYD",0
44,"44007",184,124,120,0,4,"UPYD",1
44,"44064",70,51,51,0,0,"UPYD",0
44,"44038",107,83,83,2,0,"UPYD",2
44,"44132",61,50,50,1,0,"UPYD",1
44,"44201",497,414,410,2,4,"UPYD",5
44,"44068",664,519,515,4,4,"UPYD",2
44,"44075",324,256,250,4,6,"UPYD",4
44,"44257",167,120,120,1,0,"UPYD",1
44,"44008",1615,1217,1200,7,17,"UPYD",3
44,"44046",48,31,31,2,0,"UPYD",0
44,"44088",30,26,26,2,0,"UPYD",0
44,"44160",478,329,322,5,7,"UPYD",2
44,"44215",156,105,103,2,2,"UPYD",0
44,"44035",117,81,81,0,0,"UPYD",1
44,"44076",2234,1759,1729,16,30,"UPYD",5
44,"44175",121,91,89,2,2,"UPYD",0
44,"44258",69,46,46,0,0,"UPYD",0
44,"44061",71,57,54,1,3,"UPYD",0
44,"44211",40,30,30,0,0,"UPYD",0
44,"44260",139,100,98,2,2,"UPYD",0
44,"44009",809,586,578,5,8,"UPYD",4
44,"44133",23,17,17,0,0,"UPYD",0
44,"44094",113,102,100,1,2,"UPYD",1
44,"44243",23,18,18,0,0,"UPYD",0
44,"44130",34,24,24,0,0,"UPYD",0
44,"44110",52,46,44,0,2,"UPYD",0
44,"44122",1356,971,969,12,2,"UPYD",6
44,"44135",115,89,86,0,3,"UPYD",0
44,"44010",178,124,121,2,3,"UPYD",0
44,"44048",65,51,51,0,0,"UPYD",0
44,"44217",28,20,20,0,0,"UPYD",0
44,"44037",453,326,321,5,5,"UPYD",2
44,"44096",161,141,139,0,2,"UPYD",0
44,"44080",292,221,218,4,3,"UPYD",2
44,"44123",105,69,69,1,0,"UPYD",0
44,"44177",111,77,76,1,1,"UPYD",1
44,"44244",75,39,39,0,0,"UPYD",1
44,"44136",49,42,42,1,0,"UPYD",0
44,"44261",734,552,542,8,10,"UPYD",2
44,"44205",712,474,468,6,6,"UPYD",0
44,"44050",3129,2135,2103,30,32,"UPYD",14
44,"44107",216,162,162,1,0,"UPYD",8
44,"44182",194,155,154,3,1,"UPYD",1
44,"44097",147,89,87,1,2,"UPYD",2
44,"44219",198,141,134,4,7,"UPYD",0
44,"44012",336,279,276,2,3,"UPYD",0
44,"44099",708,514,510,1,4,"UPYD",0
44,"44164",26,22,22,0,0,"UPYD",0
44,"44262",137,107,107,1,0,"UPYD",0
44,"44137",205,159,159,2,0,"UPYD",1
44,"44093",76,60,60,0,0,"UPYD",0
44,"44206",112,90,88,0,2,"UPYD",0
44,"44263",369,265,259,2,6,"UPYD",3
44,"44165",184,153,152,1,1,"UPYD",2
44,"44152",67,48,48,1,0,"UPYD",0
44,"44220",121,85,82,2,3,"UPYD",0
44,"44179",345,229,227,2,2,"UPYD",1
44,"44051",2704,2074,2046,32,28,"UPYD",11
44,"44176",160,127,127,0,0,"UPYD",1
44,"44138",140,79,77,0,2,"UPYD",1
44,"44180",71,57,56,1,1,"UPYD",0
44,"44167",38,31,31,0,0,"UPYD",0
44,"44207",158,119,115,0,4,"UPYD",0
44,"44013",11254,8292,8205,82,87,"UPYD",55
44,"44264",253,211,210,2,1,"UPYD",1
44,"44001",68,50,50,0,0,"UPYD",0
44,"44141",135,105,104,1,1,"UPYD",0
44,"44052",80,55,54,0,1,"UPYD",0
44,"44181",78,63,63,1,0,"UPYD",0
44,"44014",2530,2008,1966,17,42,"UPYD",23
44,"44101",59,44,44,0,0,"UPYD",1
44,"44126",334,239,235,7,4,"UPYD",1
44,"44265",188,144,138,2,6,"UPYD",0
44,"44168",191,137,131,3,6,"UPYD",3
44,"44028",191,150,142,1,8,"UPYD",0
44,"44115",106,93,92,4,1,"UPYD",1
44,"44086",453,355,350,3,5,"UPYD",4
44,"44053",102,79,73,0,6,"UPYD",0
44,"44142",36,27,27,5,0,"UPYD",0
44,"44209",839,640,623,3,17,"UPYD",1
44,"44266",118,95,95,0,0,"UPYD",1
44,"44016",486,361,357,7,4,"UPYD",2
44,"44240",161,128,125,0,3,"UPYD",2
44,"44054",109,90,90,0,0,"UPYD",0
44,"44143",388,310,309,3,1,"UPYD",1
44,"44087",81,70,70,3,0,"UPYD",0
44,"44210",759,597,596,2,1,"UPYD",1
44,"44197",58,34,34,0,0,"UPYD",0
44,"44223",75,55,55,2,0,"UPYD",0
44,"44017",285,221,220,0,1,"UPYD",2
44,"44103",130,106,106,0,0,"UPYD",0
44,"44070",55,47,46,1,1,"UPYD",0
44,"44128",69,50,50,0,0,"UPYD",0
44,"44251",254,202,194,2,8,"UPYD",0
44,"44043",108,75,75,1,0,"UPYD",0
44,"44267",71,50,50,0,0,"UPYD",0
44,"44105",80,62,62,0,0,"UPYD",0
44,"44055",69,52,51,3,1,"UPYD",0
44,"44018",20,20,20,0,0,"UPYD",0
44,"44089",46,42,42,0,0,"UPYD",0
44,"44129",41,34,34,0,0,"UPYD",0
44,"44144",351,256,252,1,4,"UPYD",1
44,"44184",48,30,30,0,0,"UPYD",0
44,"44145",1029,768,763,7,5,"UPYD",4
44,"44044",91,70,70,0,0,"UPYD",0
44,"44056",513,348,341,4,7,"UPYD",4
44,"44268",28,24,24,0,0,"UPYD",0
44,"44185",104,77,77,0,0,"UPYD",0
44,"44019",68,49,48,1,1,"UPYD",0
51,"51001",59213,33213,32720,413,493,"PODEMOS",4630
17,"17054",375,249,249,2,0,"DL",62
17,"17114",23020,15151,15024,105,127,"DL",4959
17,"17058",180,132,131,1,1,"DL",32
17,"17123",357,275,273,3,2,"DL",139
17,"17006",1131,730,728,9,2,"DL",217
17,"17902",1353,957,947,9,10,"DL",336
17,"17137",3411,2391,2369,15,22,"DL",843
17,"17144",210,141,141,2,0,"DL",48
17,"17070",109,82,82,1,0,"DL",43
17,"17192",145,108,108,1,0,"DL",59
17,"17005",401,263,260,5,3,"DL",70
17,"17119",68,59,59,0,0,"DL",17
17,"17159",627,439,434,2,5,"DL",154
17,"17215",2066,1588,1577,12,11,"DL",365
17,"17033",5293,3509,3476,28,33,"DL",712
17,"17026",536,381,380,6,1,"DL",169
17,"17214",706,471,468,4,3,"DL",156
17,"17111",873,643,641,12,2,"DL",241
17,"17203",154,110,110,0,0,"DL",37
17,"17136",175,133,132,1,1,"DL",48
17,"17191",146,114,113,1,1,"DL",51
17,"17101",543,364,362,3,2,"DL",81
17,"17046",719,499,492,2,7,"DL",154
17,"17035",544,400,399,4,1,"DL",172
17,"17186",3771,2742,2712,18,30,"DL",501
17,"17121",221,157,156,1,1,"DL",67
17,"17209",625,480,477,2,3,"DL",115
17,"17167",2697,1876,1852,24,24,"DL",665
17,"17183",274,186,186,3,0,"DL",79
17,"17042",414,288,286,2,2,"DL",106
17,"17146",2979,2030,2009,14,21,"DL",317
17,"17067",697,500,495,7,5,"DL",158
17,"17099",80,60,59,0,1,"DL",20
17,"17047",4837,2997,2973,39,24,"DL",568
17,"17076",123,90,88,2,2,"DL",27
17,"17090",542,410,408,3,2,"DL",165
17,"17039",1764,1229,1217,20,12,"DL",447
17,"17206",141,89,87,0,2,"DL",31
17,"17086",1744,1181,1170,10,11,"DL",171
17,"17139",1382,972,963,9,9,"DL",395
17,"17080",141,98,98,0,0,"DL",22
17,"17102",576,397,395,4,2,"DL",127
17,"17230",463,343,339,2,4,"DL",91
17,"17217",348,268,266,0,2,"DL",92
17,"17232",149,98,98,1,0,"DL",31
17,"17107",268,189,188,2,1,"DL",83
17,"17160",14740,9853,9795,68,58,"DL",1829
17,"17224",314,214,213,3,1,"DL",97
17,"17211",839,646,639,3,7,"DL",256
17,"17062",5970,3695,3657,31,38,"DL",869
17,"17226",856,572,557,5,15,"DL",95
17,"17100",199,142,140,7,2,"DL",65
17,"17103",4942,3150,3129,19,21,"DL",458
17,"17003",102,71,71,0,0,"DL",24
17,"17022",6926,4626,4587,47,39,"DL",1029
17,"17150",1407,1074,1060,12,14,"DL",430
17,"17109",693,443,435,2,8,"DL",157
17,"17095",19593,12648,12554,81,94,"DL",1619
17,"17036",2736,1857,1839,16,18,"DL",549
17,"17184",1258,893,887,6,6,"DL",375
17,"17205",212,166,166,2,0,"DL",67
17,"17019",1779,1279,1261,13,18,"DL",536
17,"17147",8112,5475,5422,43,53,"DL",1536
17,"17118",12824,8557,8477,57,80,"DL",1722
17,"17193",4216,2807,2768,26,39,"DL",597
17,"17151",174,124,123,3,1,"DL",33
17,"17110",1325,953,945,5,8,"DL",198
17,"17050",649,499,495,3,4,"DL",160
17,"17221",4182,2882,2859,18,23,"DL",546
17,"17228",295,211,210,1,1,"DL",77
17,"17041",215,146,145,2,1,"DL",29
17,"17157",126,104,102,1,2,"DL",50
17,"17011",646,463,462,7,1,"DL",171
17,"17056",1706,1200,1193,10,7,"DL",480
17,"17187",621,468,464,6,4,"DL",135
17,"17225",213,142,142,1,0,"DL",33
17,"17198",430,282,281,4,1,"DL",73
17,"17148",1535,1056,1045,12,11,"DL",276
17,"17124",1638,1096,1083,10,13,"DL",368
17,"17234",183,124,124,1,0,"DL",20
17,"17125",129,88,86,0,2,"DL",43
17,"17061",162,119,119,1,0,"DL",47
17,"17153",186,140,140,0,0,"DL",49
17,"17068",245,173,172,0,1,"DL",73
17,"17065",335,250,249,2,1,"DL",100
17,"17141",5869,3688,3653,38,35,"DL",813
17,"17188",165,126,126,0,0,"DL",49
17,"17040",538,392,391,4,1,"DL",161
17,"17135",355,263,258,2,5,"DL",40
17,"17044",6767,4737,4694,36,43,"DL",1470
17,"17029",203,131,131,2,0,"DL",37
17,"17165",653,445,443,2,2,"DL",167
17,"17014",61,47,47,1,0,"DL",10
17,"17166",516,386,378,2,8,"DL",143
17,"17142",2561,1962,1950,13,12,"DL",479
17,"17092",3508,2373,2347,13,26,"DL",470
17,"17132",1311,923,913,10,10,"DL",331
17,"17078",330,225,225,5,0,"DL",108
17,"17009",4042,2770,2738,18,32,"DL",970
17,"17170",172,118,117,2,1,"DL",41
17,"17190",842,592,590,10,2,"DL",198
17,"17093",893,590,585,6,5,"DL",169
17,"17115",277,195,195,0,0,"DL",67
17,"17030",645,430,428,7,2,"DL",112
17,"17143",146,109,107,1,2,"DL",44
17,"17063",166,115,113,0,2,"DL",45
17,"17015",12525,8550,8470,59,80,"DL",3018
17,"17031",172,109,109,3,0,"DL",32
17,"17079",64159,44230,43902,271,328,"DL",10402
17,"17163",2609,1904,1890,18,14,"DL",665
17,"17087",222,169,169,3,0,"DL",64
17,"17133",1268,887,877,6,10,"DL",411
17,"17202",3803,2471,2449,13,22,"DL",500
17,"17071",1131,810,803,8,7,"DL",306
17,"17213",5372,3549,3517,17,32,"DL",876
17,"17152",10727,6804,6758,46,46,"DL",1093
17,"17094",1049,646,641,3,5,"DL",207
17,"17158",464,284,281,0,3,"DL",72
17,"17164",3996,2555,2543,23,12,"DL",930
17,"17901",989,696,686,7,10,"DL",195
17,"17116",348,243,240,4,3,"DL",84
17,"17112",192,141,139,1,2,"DL",73
17,"17180",8300,5429,5368,42,61,"DL",1532
17,"17073",1875,1466,1460,11,6,"DL",539
17,"17002",556,429,419,1,10,"DL",149
17,"17052",124,83,83,1,0,"DL",29
17,"17195",338,256,251,2,5,"DL",67
17,"17181",3380,2272,2251,15,21,"DL",495
17,"17088",535,372,369,0,3,"DL",116
17,"17049",3125,2251,2233,7,18,"DL",432
17,"17194",78,54,52,2,2,"DL",16
17,"17081",244,165,163,0,2,"DL",65
17,"17185",2293,1547,1527,12,20,"DL",635
17,"17085",293,223,221,1,2,"DL",76
17,"17074",507,345,341,1,4,"DL",80
17,"17200",618,425,422,4,3,"DL",135
17,"17089",5490,3630,3591,20,39,"DL",935
17,"17223",807,528,520,6,8,"DL",102
17,"17189",1524,1126,1114,4,12,"DL",442
17,"17204",562,385,384,7,1,"DL",100
17,"17182",262,191,191,2,0,"DL",28
17,"17037",104,65,65,0,0,"DL",40
17,"17082",410,273,268,3,5,"DL",113
17,"17138",944,668,663,4,5,"DL",102
17,"17207",2373,1691,1673,18,18,"DL",698
17,"17174",176,102,102,3,0,"DL",38
17,"17055",152,125,125,0,0,"DL",36
17,"17097",199,149,148,5,1,"DL",53
17,"17020",3590,2531,2510,28,21,"DL",840
17,"17075",334,234,227,5,7,"DL",75
17,"17216",165,112,110,0,2,"DL",38
17,"17171",163,123,122,0,1,"DL",41
17,"17004",510,371,368,0,3,"DL",115
17,"17083",2935,2059,2042,17,17,"DL",451
17,"17016",724,519,515,8,4,"DL",158
17,"17001",585,417,413,2,4,"DL",103
17,"17034",6874,4509,4477,32,32,"DL",983
17,"17069",378,270,267,4,3,"DL",91
17,"17175",579,366,360,4,6,"DL",48
17,"17117",14280,9297,9223,75,74,"DL",1833
17,"17051",219,157,155,3,2,"DL",60
17,"17129",137,99,99,1,0,"DL",16
17,"17077",555,386,383,5,3,"DL",126
17,"17161",990,737,734,7,3,"DL",275
17,"17018",477,347,343,3,4,"DL",114
17,"17210",551,378,376,2,2,"DL",123
17,"17199",6845,4527,4483,32,44,"DL",1232
17,"17222",109,85,85,1,0,"DL",28
17,"17176",122,91,91,2,0,"DL",22
17,"17028",303,213,213,4,0,"DL",80
17,"17227",128,95,95,0,0,"DL",28
17,"17169",2475,1733,1724,11,9,"DL",391
17,"17218",588,448,445,3,3,"DL",144
17,"17154",92,62,62,0,0,"DL",8
17,"17208",997,679,671,12,8,"DL",260
17,"17038",369,255,253,2,2,"DL",108
17,"17106",139,108,106,0,2,"DL",38
17,"17197",137,105,105,2,0,"DL",31
17,"17173",180,141,139,2,2,"DL",43
17,"17162",147,91,90,0,1,"DL",28
17,"17233",2287,1682,1664,21,18,"DL",595
17,"17023",27347,18842,18610,118,232,"DL",2232
17,"17126",308,252,250,2,2,"DL",104
17,"17064",325,219,214,1,5,"DL",58
17,"17130",328,246,245,2,1,"DL",111
17,"17096",178,115,114,0,1,"DL",42
17,"17140",674,498,495,5,3,"DL",187
17,"17091",411,282,273,5,9,"DL",112
17,"17120",792,530,518,3,12,"DL",159
17,"17025",1124,834,827,3,7,"DL",302
17,"17032",1713,1036,1020,13,16,"DL",259
17,"17060",424,277,274,3,3,"DL",59
17,"17155",14500,9167,9080,43,87,"DL",1617
17,"17027",2826,1993,1973,10,20,"DL",530
17,"17024",279,176,176,2,0,"DL",70
17,"17201",128,93,92,1,1,"DL",41
17,"17012",1142,763,757,6,6,"DL",156
17,"17066",26551,16275,16166,140,109,"DL",2914
17,"17220",811,563,555,3,8,"DL",217
17,"17057",960,708,699,8,9,"DL",235
17,"17196",214,151,151,2,0,"DL",34
17,"17021",135,86,86,2,0,"DL",27
17,"17177",563,359,354,3,5,"DL",143
17,"17128",302,224,223,4,1,"DL",67
17,"17168",374,273,272,1,1,"DL",103
17,"17013",2787,1941,1926,17,15,"DL",406
17,"17903",897,647,638,0,9,"DL",233
17,"17105",255,170,170,2,0,"DL",45
17,"17178",1063,690,685,5,5,"DL",224
17,"17048",6269,4072,4044,24,28,"DL",879
17,"17172",452,308,307,1,1,"DL",94
17,"17043",158,119,117,1,2,"DL",58
17,"17010",330,247,246,5,1,"DL",83
17,"17145",1488,1003,986,9,17,"DL",358
17,"17008",3636,2423,2395,15,28,"DL",845
17,"17149",363,267,264,0,3,"DL",107
17,"17098",311,224,221,2,3,"DL",53
17,"17007",1730,1235,1224,4,11,"DL",515
17,"17134",234,163,161,2,2,"DL",58
17,"17212",139,108,106,1,2,"DL",50
17,"17084",236,160,160,7,0,"DL",52
12,"12121",1127,955,928,6,27,"UPYD",0
12,"12014",184,140,136,1,4,"UPYD",0
12,"12129",1840,1391,1360,19,31,"UPYD",5
12,"12082",9655,7570,7492,38,78,"UPYD",32
12,"12102",536,452,437,1,15,"UPYD",1
12,"12094",851,688,674,2,14,"UPYD",5
12,"12024",139,115,113,1,2,"UPYD",2
12,"12084",17599,13146,13022,98,124,"UPYD",61
12,"12118",74,60,59,0,1,"UPYD",0
12,"12056",285,243,238,3,5,"UPYD",1
12,"12007",758,672,667,7,5,"UPYD",3
12,"12034",1430,1078,1053,4,25,"UPYD",8
12,"12064",97,83,82,0,1,"UPYD",1
12,"12093",189,147,145,1,2,"UPYD",0
12,"12074",784,690,678,9,12,"UPYD",2
12,"12001",1054,798,786,8,12,"UPYD",1
12,"12017",164,133,132,1,1,"UPYD",0
12,"12124",1853,1411,1394,20,17,"UPYD",5
12,"12020",124,104,103,1,1,"UPYD",0
12,"12130",404,339,332,0,7,"UPYD",0
12,"12060",446,367,360,2,7,"UPYD",2
12,"12128",1400,1102,1091,11,11,"UPYD",4
12,"12091",185,145,141,3,4,"UPYD",3
12,"12025",137,106,106,0,0,"UPYD",2
12,"12002",116,98,96,0,2,"UPYD",0
12,"12032",23508,17400,17279,89,121,"UPYD",95
12,"12077",4625,3443,3387,20,56,"UPYD",11
12,"12126",24480,18885,18687,115,198,"UPYD",73
12,"12083",95,82,80,0,2,"UPYD",1
12,"12140",1140,961,950,5,11,"UPYD",1
12,"12072",1117,962,937,8,25,"UPYD",1
12,"12138",19064,13610,13456,135,154,"UPYD",70
12,"12043",581,470,459,4,11,"UPYD",1
12,"12103",89,69,68,2,1,"UPYD",0
12,"12061",378,275,275,4,0,"UPYD",2
12,"12012",2695,2236,2204,6,32,"UPYD",3
12,"12107",351,313,309,3,4,"UPYD",0
12,"12078",339,250,247,1,3,"UPYD",2
12,"12070",524,418,408,8,10,"UPYD",0
12,"12095",974,789,784,8,5,"UPYD",2
12,"12135",35749,27015,26806,174,209,"UPYD",173
12,"12134",138,97,96,0,1,"UPYD",0
12,"12092",112,84,84,0,0,"UPYD",0
12,"12013",148,119,116,4,3,"UPYD",1
12,"12120",184,155,154,1,1,"UPYD",0
12,"12079",405,318,312,4,6,"UPYD",1
12,"12021",4442,3486,3432,25,54,"UPYD",10
12,"12006",176,140,140,1,0,"UPYD",1
12,"12003",991,762,752,10,10,"UPYD",3
12,"12069",74,50,49,0,1,"UPYD",1
12,"12045",354,282,279,2,3,"UPYD",0
12,"12073",156,132,131,0,1,"UPYD",0
12,"12010",259,216,209,6,7,"UPYD",0
12,"12075",123,94,92,1,2,"UPYD",0
12,"12051",477,337,335,2,2,"UPYD",0
12,"12081",611,503,493,3,10,"UPYD",2
12,"12137",37,26,26,1,0,"UPYD",0
12,"12022",340,273,269,1,4,"UPYD",2
12,"12104",6954,5571,5470,26,101,"UPYD",28
12,"12131",65,53,53,0,0,"UPYD",0
12,"12096",775,587,580,12,7,"UPYD",3
12,"12111",375,314,310,0,4,"UPYD",1
12,"12048",249,196,192,1,4,"UPYD",0
12,"12042",621,520,512,13,8,"UPYD",0
12,"12041",97,77,77,0,0,"UPYD",1
12,"12090",109,94,93,2,1,"UPYD",1
12,"12127",77,56,56,0,0,"UPYD",0
12,"12015",96,83,81,0,2,"UPYD",0
12,"12142",161,124,123,0,1,"UPYD",0
12,"12067",543,442,424,1,18,"UPYD",2
12,"12031",3830,3049,2987,20,62,"UPYD",19
12,"12009",17430,12600,12501,77,99,"UPYD",62
12,"12112",99,81,79,1,2,"UPYD",1
12,"12068",49,34,34,1,0,"UPYD",0
12,"12109",647,531,520,1,11,"UPYD",2
12,"12115",217,169,167,2,2,"UPYD",2
12,"12088",69,58,58,0,0,"UPYD",1
12,"12100",1345,1115,1098,6,17,"UPYD",4
12,"12119",147,100,100,1,0,"UPYD",1
12,"12136",2657,2302,2252,22,50,"UPYD",5
12,"12901",3433,2691,2664,27,27,"UPYD",12
12,"12036",593,448,445,2,3,"UPYD",2
12,"12065",192,166,166,0,0,"UPYD",0
12,"12040",117832,89135,88464,525,671,"UPYD",688
12,"12113",85,69,69,2,0,"UPYD",0
12,"12058",74,60,59,2,1,"UPYD",0
12,"12004",4204,3174,3130,19,44,"UPYD",12
12,"12050",1320,1044,1032,8,12,"UPYD",4
12,"12105",851,666,659,5,7,"UPYD",5
12,"12037",16,14,14,0,0,"UPYD",1
12,"12089",4331,3103,3050,25,53,"UPYD",12
12,"12029",717,572,566,6,6,"UPYD",2
12,"12005",8090,6113,6027,57,86,"UPYD",28
12,"12080",1955,1647,1624,13,23,"UPYD",6
12,"12008",231,192,190,2,2,"UPYD",1
12,"12097",67,55,54,0,1,"UPYD",2
12,"12026",894,697,676,14,21,"UPYD",1
12,"12098",588,479,473,4,6,"UPYD",2
12,"12125",214,185,183,2,2,"UPYD",0
12,"12059",244,190,189,1,1,"UPYD",0
12,"12085",5061,3310,3264,20,46,"UPYD",15
12,"12018",293,244,235,2,9,"UPYD",1
12,"12027",17217,12263,12122,77,141,"UPYD",63
12,"12139",322,239,237,1,2,"UPYD",1
12,"12011",4587,3530,3480,30,50,"UPYD",21
12,"12110",244,173,170,1,3,"UPYD",0
12,"12046",193,154,153,3,1,"UPYD",1
12,"12099",542,434,405,9,29,"UPYD",0
12,"12116",67,49,49,0,0,"UPYD",0
12,"12114",200,150,149,1,1,"UPYD",1
12,"12052",590,464,442,5,22,"UPYD",3
12,"12038",171,121,120,1,1,"UPYD",1
12,"12033",1907,1483,1436,11,47,"UPYD",9
12,"12902",2148,1562,1536,9,26,"UPYD",8
12,"12049",455,348,339,5,9,"UPYD",1
12,"12039",840,726,719,2,7,"UPYD",4
12,"12108",463,395,390,0,5,"UPYD",2
12,"12117",3576,2786,2747,17,39,"UPYD",5
12,"12028",12566,9902,9830,55,72,"UPYD",68
12,"12057",606,495,487,3,8,"UPYD",4
12,"12123",47,32,32,0,0,"UPYD",0
12,"12016",1582,1311,1295,9,16,"UPYD",4
12,"12133",60,49,49,0,0,"UPYD",1
12,"12044",483,438,431,4,7,"UPYD",0
12,"12087",26,18,18,3,0,"UPYD",0
12,"12141",101,80,80,0,0,"UPYD",0
12,"12055",106,79,79,2,0,"UPYD",0
12,"12106",1170,983,967,16,16,"UPYD",8
12,"12071",1280,1002,988,5,14,"UPYD",1
12,"12101",363,282,273,3,9,"UPYD",1
12,"12063",42,35,34,2,1,"UPYD",0
12,"12076",87,70,70,1,0,"UPYD",0
12,"12122",805,660,647,4,13,"UPYD",1
12,"12053",2069,1691,1677,8,14,"UPYD",9
12,"12132",486,407,398,2,9,"UPYD",1
44,"44022",490,323,316,9,7,"EB",0
44,"44236",59,45,45,0,0,"EB",0
44,"44025",6062,4490,4394,48,96,"EB",18
44,"44249",57,47,47,3,0,"EB",0
44,"44064",70,51,51,0,0,"EB",0
44,"44092",80,53,52,0,1,"EB",0
44,"44228",99,79,79,1,0,"EB",0
44,"44086",453,355,350,3,5,"EB",2
44,"44216",26539,19621,19346,248,275,"EB",133
44,"44116",83,67,65,1,2,"EB",1
44,"44187",199,148,143,1,5,"EB",0
44,"44167",38,31,31,0,0,"EB",0
44,"44021",107,83,83,2,0,"EB",0
44,"44120",222,140,138,2,2,"EB",0
44,"44250",19,12,12,2,0,"EB",0
44,"44029",567,475,467,5,8,"EB",1
44,"44138",140,79,77,0,2,"EB",0
44,"44164",26,22,22,0,0,"EB",0
44,"44195",92,61,61,2,0,"EB",1
44,"44232",391,286,279,4,7,"EB",3
44,"44193",82,62,62,1,0,"EB",0
44,"44258",69,46,46,0,0,"EB",0
44,"44100",187,154,153,0,1,"EB",1
44,"44172",310,216,216,6,0,"EB",0
44,"44200",40,22,22,0,0,"EB",0
44,"44067",117,80,80,0,0,"EB",1
44,"44212",41,32,32,0,0,"EB",0
44,"44110",52,46,44,0,2,"EB",0
44,"44114",244,186,185,3,1,"EB",0
44,"44191",771,595,586,7,9,"EB",2
44,"44009",809,586,578,5,8,"EB",1
44,"44097",147,89,87,1,2,"EB",0
44,"44245",250,189,186,1,3,"EB",0
44,"44054",109,90,90,0,0,"EB",0
44,"44019",68,49,48,1,1,"EB",0
44,"44043",108,75,75,1,0,"EB",0
44,"44142",36,27,27,5,0,"EB",0
44,"44053",102,79,73,0,6,"EB",0
44,"44060",40,35,35,1,0,"EB",0
44,"44227",75,63,63,0,0,"EB",0
44,"44023",18,15,15,0,0,"EB",0
44,"44016",486,361,357,7,4,"EB",0
44,"44038",107,83,83,2,0,"EB",0
44,"44221",365,298,296,2,2,"EB",1
44,"44152",67,48,48,1,0,"EB",0
44,"44129",41,34,34,0,0,"EB",0
44,"44133",23,17,17,0,0,"EB",0
44,"44103",130,106,106,0,0,"EB",0
44,"44035",117,81,81,0,0,"EB",0
44,"44017",285,221,220,0,1,"EB",2
44,"44061",71,57,54,1,3,"EB",0
44,"44184",48,30,30,0,0,"EB",0
44,"44101",59,44,44,0,0,"EB",0
44,"44075",324,256,250,4,6,"EB",3
44,"44014",2530,2008,1966,17,42,"EB",4
44,"44055",69,52,51,3,1,"EB",1
44,"44087",81,70,70,3,0,"EB",0
44,"44169",351,268,266,3,2,"EB",2
44,"44084",55,45,45,0,0,"EB",0
44,"44004",415,295,291,3,4,"EB",0
44,"44125",65,39,39,0,0,"EB",0
44,"44165",184,153,152,1,1,"EB",1
44,"44268",28,24,24,0,0,"EB",0
44,"44056",513,348,341,4,7,"EB",1
44,"44119",135,94,90,2,4,"EB",0
44,"44127",73,51,50,0,1,"EB",0
44,"44062",35,27,26,0,1,"EB",0
44,"44137",205,159,159,2,0,"EB",0
44,"44074",430,338,329,5,9,"EB",3
44,"44207",158,119,115,0,4,"EB",0
44,"44180",71,57,56,1,1,"EB",0
44,"44252",85,67,66,0,1,"EB",0
44,"44109",110,76,74,1,2,"EB",0
44,"44008",1615,1217,1200,7,17,"EB",3
44,"44117",347,278,274,2,4,"EB",1
44,"44011",57,35,35,0,0,"EB",0
44,"44205",712,474,468,6,6,"EB",0
44,"44183",77,45,44,0,1,"EB",0
44,"44176",160,127,127,0,0,"EB",0
44,"44068",664,519,515,4,4,"EB",0
44,"44234",62,48,48,1,0,"EB",1
44,"44257",167,120,120,1,0,"EB",0
44,"44122",1356,971,969,12,2,"EB",3
44,"44225",111,76,76,4,0,"EB",0
44,"44027",161,122,121,4,1,"EB",1
44,"44090",82,57,57,0,0,"EB",0
44,"44203",10,8,8,0,0,"EB",0
44,"44099",708,514,510,1,4,"EB",1
44,"44215",156,105,103,2,2,"EB",0
44,"44132",61,50,50,1,0,"EB",0
44,"44089",46,42,42,0,0,"EB",1
44,"44209",839,640,623,3,17,"EB",3
44,"44243",23,18,18,0,0,"EB",0
44,"44239",22,20,20,0,0,"EB",0
44,"44044",91,70,70,0,0,"EB",0
44,"44151",191,147,145,1,2,"EB",0
44,"44231",38,32,32,0,0,"EB",0
44,"44159",39,34,34,0,0,"EB",0
44,"44034",138,112,110,2,2,"EB",0
44,"44128",69,50,50,0,0,"EB",1
44,"44157",65,41,40,0,1,"EB",0
44,"44085",52,40,40,4,0,"EB",1
44,"44126",334,239,235,7,4,"EB",0
44,"44033",279,193,191,2,2,"EB",0
44,"44201",497,414,410,2,4,"EB",0
44,"44123",105,69,69,1,0,"EB",0
44,"44241",537,408,403,2,5,"EB",0
44,"44003",19,16,16,0,0,"EB",1
44,"44026",90,71,71,0,0,"EB",0
44,"44237",408,327,321,2,6,"EB",0
44,"44051",2704,2074,2046,32,28,"EB",7
44,"44190",72,53,52,0,1,"EB",0
44,"44031",99,64,64,0,0,"EB",0
44,"44124",78,58,58,1,0,"EB",0
44,"44210",759,597,596,2,1,"EB",0
44,"44020",24,20,19,1,1,"EB",0
44,"44219",198,141,134,4,7,"EB",1
44,"44036",24,16,16,0,0,"EB",0
44,"44071",599,430,424,8,6,"EB",0
44,"44077",75,58,57,0,1,"EB",1
44,"44199",43,36,36,1,0,"EB",0
44,"44181",78,63,63,1,0,"EB",0
44,"44264",253,211,210,2,1,"EB",0
44,"44150",32,21,20,0,1,"EB",1
44,"44080",292,221,218,4,3,"EB",3
44,"44204",25,22,22,0,0,"EB",0
44,"44050",3129,2135,2103,30,32,"EB",9
44,"44018",20,20,20,0,0,"EB",0
44,"44266",118,95,95,0,0,"EB",0
44,"44032",16,13,13,0,0,"EB",0
44,"44163",128,94,94,0,0,"EB",0
44,"44131",26,20,20,0,0,"EB",0
44,"44168",191,137,131,3,6,"EB",0
44,"44178",56,42,42,0,0,"EB",0
44,"44107",216,162,162,1,0,"EB",1
44,"44143",388,310,309,3,1,"EB",0
44,"44160",478,329,322,5,7,"EB",1
44,"44262",137,107,107,1,0,"EB",1
44,"44206",112,90,88,0,2,"EB",0
44,"44094",113,102,100,1,2,"EB",0
44,"44042",127,93,92,1,1,"EB",0
44,"44005",54,38,37,2,1,"EB",0
44,"44063",78,61,61,0,0,"EB",0
44,"44145",1029,768,763,7,5,"EB",1
44,"44260",139,100,98,2,2,"EB",0
44,"44108",331,238,234,4,4,"EB",0
44,"44246",1554,1091,1079,13,12,"EB",5
44,"44001",68,50,50,0,0,"EB",0
44,"44224",22,14,14,0,0,"EB",0
44,"44153",1812,1209,1196,15,13,"EB",3
44,"44088",30,26,26,2,0,"EB",0
44,"44113",72,50,50,0,0,"EB",0
44,"44208",34,22,22,0,0,"EB",0
44,"44235",91,71,70,2,1,"EB",1
44,"44147",419,312,307,5,5,"EB",1
44,"44189",58,40,40,1,0,"EB",1
44,"44196",134,102,102,1,0,"EB",1
44,"44041",54,46,46,2,0,"EB",0
44,"44198",187,151,148,3,3,"EB",0
44,"44247",314,230,228,2,2,"EB",2
44,"44002",54,41,41,0,0,"EB",0
44,"44130",34,24,24,0,0,"EB",0
44,"44244",75,39,39,0,0,"EB",2
44,"44052",80,55,54,0,1,"EB",0
44,"44229",151,108,107,1,1,"EB",0
44,"44155",1102,831,825,7,6,"EB",1
44,"44182",194,155,154,3,1,"EB",1
44,"44240",161,128,125,0,3,"EB",1
44,"44037",453,326,321,5,5,"EB",2
44,"44226",141,102,100,2,2,"EB",0
44,"44105",80,62,62,0,0,"EB",0
44,"44136",49,42,42,1,0,"EB",0
44,"44256",39,34,34,1,0,"EB",0
44,"44223",75,55,55,2,0,"EB",0
44,"44028",191,150,142,1,8,"EB",1
44,"44148",93,76,76,3,0,"EB",0
44,"44220",121,85,82,2,3,"EB",2
44,"44197",58,34,34,0,0,"EB",0
44,"44194",111,79,75,0,4,"EB",0
44,"44039",219,162,160,2,2,"EB",1
44,"44185",104,77,77,0,0,"EB",0
44,"44082",91,68,67,0,1,"EB",0
44,"44007",184,124,120,0,4,"EB",1
44,"44213",63,47,47,0,0,"EB",0
44,"44059",541,431,423,7,8,"EB",0
44,"44048",65,51,51,0,0,"EB",1
44,"44121",60,43,43,0,0,"EB",2
44,"44251",254,202,194,2,8,"EB",1
44,"44141",135,105,104,1,1,"EB",1
44,"44066",110,83,83,1,0,"EB",0
44,"44093",76,60,60,0,0,"EB",0
44,"44192",364,280,278,0,2,"EB",1
44,"44118",165,127,125,2,2,"EB",0
44,"44174",430,314,313,2,1,"EB",1
44,"44112",426,293,284,2,9,"EB",0
44,"44010",178,124,121,2,3,"EB",0
44,"44154",261,194,191,3,3,"EB",0
44,"44146",173,157,157,1,0,"EB",1
44,"44102",31,25,25,0,0,"EB",0
44,"44115",106,93,92,4,1,"EB",0
44,"44135",115,89,86,0,3,"EB",0
44,"44230",155,126,126,2,0,"EB",3
44,"44222",137,96,96,0,0,"EB",0
44,"44171",183,136,135,1,1,"EB",0
44,"44013",11254,8292,8205,82,87,"EB",18
44,"44046",48,31,31,2,0,"EB",0
44,"44161",447,324,320,3,4,"EB",3
44,"44049",850,624,613,8,11,"EB",2
44,"44173",101,85,84,0,1,"EB",0
44,"44238",2345,1743,1729,7,14,"EB",13
44,"44217",28,20,20,0,0,"EB",0
44,"44024",27,23,23,0,0,"EB",0
44,"44158",1170,898,872,12,26,"EB",0
44,"44111",92,69,69,0,0,"EB",0
44,"44175",121,91,89,2,2,"EB",0
44,"44211",40,30,30,0,0,"EB",0
44,"44047",221,139,135,0,4,"EB",1
44,"44076",2234,1759,1729,16,30,"EB",3
44,"44263",369,265,259,2,6,"EB",0
44,"44177",111,77,76,1,1,"EB",1
44,"44045",355,290,286,2,4,"EB",0
44,"44265",188,144,138,2,6,"EB",0
44,"44261",734,552,542,8,10,"EB",4
44,"44106",159,127,126,3,1,"EB",0
44,"44040",202,160,158,3,2,"EB",1
44,"44149",99,71,71,3,0,"EB",1
44,"44065",55,36,36,1,0,"EB",0
44,"44012",336,279,276,2,3,"EB",1
44,"44267",71,50,50,0,0,"EB",0
44,"44179",345,229,227,2,2,"EB",0
44,"44218",37,26,26,0,0,"EB",3
44,"44006",250,188,186,1,2,"EB",0
44,"44096",161,141,139,0,2,"EB",0
44,"44070",55,47,46,1,1,"EB",0
44,"44144",351,256,252,1,4,"EB",0
44,"44156",46,33,32,1,1,"EB",0
20,"20023",445,258,258,2,0,"PACMA",1
20,"20057",201,122,121,0,1,"PACMA",1
20,"20013",5427,3901,3875,19,26,"PACMA",9
20,"20008",721,382,376,5,6,"PACMA",0
20,"20075",4359,2852,2833,16,19,"PACMA",17
20,"20012",144,108,108,3,0,"PACMA",0
20,"20005",1261,811,805,7,6,"PACMA",7
20,"20061",4273,2832,2816,21,16,"PACMA",8
20,"20036",13148,9191,9132,85,59,"PACMA",49
20,"20010",1494,1055,1053,4,2,"PACMA",9
20,"20002",343,227,226,10,1,"PACMA",0
20,"20059",8863,6091,6072,30,19,"PACMA",11
20,"20014",1111,635,632,4,3,"PACMA",9
20,"20071",14818,10095,10057,62,38,"PACMA",38
20,"20069",147189,106909,106506,699,403,"PACMA",712
20,"20060",89,76,75,2,1,"PACMA",0
20,"20078",1155,866,864,6,2,"PACMA",2
20,"20042",3251,2170,2152,23,18,"PACMA",8
20,"20009",11528,7997,7955,57,42,"PACMA",41
20,"20001",242,138,137,1,1,"PACMA",0
20,"20074",11610,8382,8320,43,62,"PACMA",28
20,"20045",46691,32759,32560,222,199,"PACMA",279
20,"20037",97,59,59,1,0,"PACMA",0
20,"20026",202,141,129,4,12,"PACMA",0
20,"20016",1514,885,884,5,1,"PACMA",8
20,"20017",8580,5807,5770,37,37,"PACMA",27
20,"20024",393,226,226,2,0,"PACMA",0
20,"20063",7990,5449,5415,23,34,"PACMA",20
20,"20046",1167,797,794,4,3,"PACMA",1
20,"20025",1144,774,767,5,7,"PACMA",5
20,"20047",477,329,329,2,0,"PACMA",0
20,"20072",4731,3132,3123,23,9,"PACMA",15
20,"20050",263,160,160,4,0,"PACMA",0
20,"20028",2255,1503,1494,17,9,"PACMA",7
20,"20058",746,547,546,3,1,"PACMA",4
20,"20038",392,284,281,1,3,"PACMA",0
20,"20035",482,329,328,4,1,"PACMA",4
20,"20003",541,334,334,3,0,"PACMA",0
20,"20066",461,279,276,3,3,"PACMA",1
20,"20049",4124,2793,2780,22,13,"PACMA",17
20,"20029",4258,3005,2992,17,13,"PACMA",22
20,"20073",4677,3219,3208,21,11,"PACMA",13
20,"20070",1099,749,744,4,5,"PACMA",0
20,"20081",7460,5187,5159,33,28,"PACMA",24
20,"20051",6904,5001,4975,31,26,"PACMA",19
20,"20052",1091,797,792,6,5,"PACMA",2
20,"20904",96,62,62,0,0,"PACMA",0
20,"20033",864,629,625,3,4,"PACMA",8
20,"20040",15321,10260,10176,69,84,"PACMA",54
20,"20062",982,685,684,3,1,"PACMA",5
20,"20019",10053,6876,6844,72,32,"PACMA",28
20,"20030",21515,15110,15019,108,91,"PACMA",76
20,"20901",1441,982,979,2,3,"PACMA",4
20,"20041",258,148,148,2,0,"PACMA",0
20,"20048",176,104,104,2,0,"PACMA",1
20,"20034",3157,2145,2141,7,4,"PACMA",12
20,"20064",12526,8429,8387,59,42,"PACMA",101
20,"20027",2816,1842,1833,11,9,"PACMA",4
20,"20020",129,71,71,0,0,"PACMA",2
20,"20031",180,105,102,1,3,"PACMA",0
20,"20905",141,105,105,0,0,"PACMA",0
20,"20015",1272,924,921,9,3,"PACMA",0
20,"20067",30825,21606,21512,113,94,"PACMA",163
20,"20068",183,117,115,0,2,"PACMA",0
20,"20902",14193,10263,10219,56,44,"PACMA",62
20,"20053",4765,3150,3132,18,18,"PACMA",19
20,"20079",17835,12650,12587,81,63,"PACMA",58
20,"20056",4104,2654,2633,12,21,"PACMA",11
20,"20006",262,161,159,1,2,"PACMA",4
20,"20080",7900,5517,5487,33,30,"PACMA",28
20,"20039",2111,1539,1532,13,7,"PACMA",6
20,"20076",6978,4975,4958,39,17,"PACMA",18
20,"20065",3006,2104,2089,18,15,"PACMA",8
20,"20054",447,301,297,5,4,"PACMA",0
20,"20906",121,84,84,1,0,"PACMA",1
20,"20043",1740,1157,1152,6,5,"PACMA",2
20,"20032",8785,6115,6076,45,39,"PACMA",42
20,"20007",304,209,209,5,0,"PACMA",3
20,"20021",199,110,110,2,0,"PACMA",0
20,"20055",17522,12125,12043,52,82,"PACMA",60
20,"20011",1660,1283,1278,9,5,"PACMA",2
20,"20018",11074,7100,7059,29,41,"PACMA",15
20,"20044",368,264,259,0,5,"PACMA",1
20,"20903",4247,2846,2826,9,20,"PACMA",23
20,"20022",834,499,494,7,5,"PACMA",3
20,"20077",5243,3792,3777,25,15,"PACMA",16
20,"20907",120,85,84,2,1,"PACMA",0
20,"20004",252,135,135,2,0,"PACMA",1
51,"51001",59213,33213,32720,413,493,"PACMA",356
1,"1016",439,255,249,3,6,"UPYD",0
1,"1030",159,126,123,1,3,"UPYD",1
1,"1063",1799,1320,1309,10,11,"UPYD",6
1,"1056",218,141,140,1,1,"UPYD",0
1,"1034",165,120,119,1,1,"UPYD",0
1,"1046",594,445,435,3,10,"UPYD",1
1,"1011",237,177,175,7,2,"UPYD",1
1,"1061",153,132,132,2,0,"UPYD",0
1,"1027",416,268,268,0,0,"UPYD",4
1,"1018",1370,964,963,4,1,"UPYD",4
1,"1054",952,694,688,4,6,"UPYD",0
1,"1013",711,486,483,3,3,"UPYD",0
1,"1021",460,336,332,1,4,"UPYD",3
1,"1003",1186,842,833,19,9,"UPYD",1
1,"1002",8139,5961,5878,32,83,"UPYD",7
1,"1053",587,367,365,3,2,"UPYD",4
1,"1041",153,105,100,1,5,"UPYD",0
1,"1004",1405,1026,1010,7,16,"UPYD",0
1,"1062",314,215,215,3,0,"UPYD",2
1,"1031",1183,907,885,6,22,"UPYD",2
1,"1049",140,108,108,0,0,"UPYD",0
1,"1022",805,593,587,3,6,"UPYD",3
1,"1902",738,537,528,4,9,"UPYD",6
1,"1901",2344,1688,1669,17,19,"UPYD",4
1,"1057",245,203,202,0,1,"UPYD",0
1,"1060",199,162,159,0,3,"UPYD",0
1,"1042",901,653,650,11,3,"UPYD",0
1,"1059",186354,135873,134633,948,1240,"UPYD",647
1,"1051",3606,2413,2389,21,24,"UPYD",2
1,"1017",869,584,577,4,7,"UPYD",4
1,"1047",964,713,702,13,11,"UPYD",6
1,"1039",202,161,156,0,5,"UPYD",0
1,"1043",2318,1644,1624,8,20,"UPYD",6
1,"1055",836,564,552,8,12,"UPYD",2
1,"1006",176,142,141,1,1,"UPYD",0
1,"1008",790,548,542,13,6,"UPYD",0
1,"1044",236,189,187,1,2,"UPYD",1
1,"1028",1077,759,753,6,6,"UPYD",0
1,"1009",1281,908,898,2,10,"UPYD",2
1,"1019",144,112,111,2,1,"UPYD",0
1,"1058",1327,843,833,8,10,"UPYD",3
1,"1014",372,292,284,1,8,"UPYD",1
1,"1033",649,512,508,5,4,"UPYD",3
1,"1001",1984,1426,1405,8,21,"UPYD",5
1,"1036",15034,10733,10619,73,114,"UPYD",29
1,"1037",586,425,419,2,6,"UPYD",1
1,"1032",522,368,361,0,7,"UPYD",2
1,"1010",2275,1729,1717,17,12,"UPYD",0
1,"1052",244,188,186,1,2,"UPYD",0
1,"1023",269,197,195,2,2,"UPYD",0
1,"1020",326,232,228,0,4,"UPYD",1
42,"42154",97,78,78,1,0,"RECORTES CE",0
42,"42191",187,135,132,2,3,"RECORTES CE",1
42,"42176",29,23,23,0,0,"RECORTES CE",0
42,"42062",25,16,15,0,1,"RECORTES CE",0
42,"42164",1614,1208,1190,9,18,"RECORTES CE",2
42,"42172",29,25,25,2,0,"RECORTES CE",0
42,"42177",71,55,54,1,1,"RECORTES CE",0
42,"42050",31,18,18,0,0,"RECORTES CE",1
42,"42182",57,45,45,1,0,"RECORTES CE",0
42,"42098",11,6,6,0,0,"RECORTES CE",0
42,"42185",25,21,21,0,0,"RECORTES CE",0
42,"42044",53,49,47,3,2,"RECORTES CE",0
42,"42052",15,13,13,0,0,"RECORTES CE",0
42,"42013",35,28,28,0,0,"RECORTES CE",0
42,"42113",512,390,386,3,4,"RECORTES CE",0
42,"42029",143,106,106,0,0,"RECORTES CE",0
42,"42120",148,98,98,1,0,"RECORTES CE",0
42,"42198",22,17,17,0,0,"RECORTES CE",0
42,"42031",26,19,19,0,0,"RECORTES CE",0
42,"42211",83,67,67,1,0,"RECORTES CE",0
42,"42026",24,20,20,0,0,"RECORTES CE",0
42,"42056",22,19,19,0,0,"RECORTES CE",0
42,"42158",110,78,78,1,0,"RECORTES CE",0
42,"42200",84,60,60,2,0,"RECORTES CE",0
42,"42096",281,181,178,8,3,"RECORTES CE",0
42,"42119",164,97,97,2,0,"RECORTES CE",1
42,"42007",117,86,86,2,0,"RECORTES CE",0
42,"42078",1031,752,744,6,8,"RECORTES CE",1
42,"42010",18,14,14,0,0,"RECORTES CE",0
42,"42036",50,39,38,0,1,"RECORTES CE",0
42,"42215",786,555,552,8,3,"RECORTES CE",0
42,"42021",85,53,53,1,0,"RECORTES CE",0
42,"42178",117,81,79,2,2,"RECORTES CE",0
42,"42054",20,14,14,0,0,"RECORTES CE",0
42,"42023",66,53,53,0,0,"RECORTES CE",0
42,"42184",59,45,44,2,1,"RECORTES CE",0
42,"42085",191,136,136,2,0,"RECORTES CE",0
42,"42043",3796,2833,2792,26,41,"RECORTES CE",5
42,"42174",180,149,148,1,1,"RECORTES CE",0
42,"42039",233,148,146,2,2,"RECORTES CE",0
42,"42205",93,64,63,0,1,"RECORTES CE",0
42,"42216",25,21,21,0,0,"RECORTES CE",0
42,"42034",31,22,22,0,0,"RECORTES CE",0
42,"42132",143,118,117,0,1,"RECORTES CE",0
42,"42208",21,14,14,2,0,"RECORTES CE",0
42,"42149",393,300,293,1,7,"RECORTES CE",0
42,"42073",72,56,56,0,0,"RECORTES CE",0
42,"42116",47,33,33,0,0,"RECORTES CE",0
42,"42209",146,111,108,3,3,"RECORTES CE",0
42,"42124",64,44,44,0,0,"RECORTES CE",0
42,"42118",23,16,16,0,0,"RECORTES CE",0
42,"42061",292,221,219,2,2,"RECORTES CE",0
42,"42144",442,357,352,5,5,"RECORTES CE",1
42,"42084",26,21,21,0,0,"RECORTES CE",0
42,"42192",41,31,31,1,0,"RECORTES CE",0
42,"42155",173,105,104,1,1,"RECORTES CE",0
42,"42032",148,117,117,0,0,"RECORTES CE",0
42,"42011",17,10,10,0,0,"RECORTES CE",0
42,"42094",608,470,463,9,7,"RECORTES CE",3
42,"42121",64,48,48,1,0,"RECORTES CE",0
42,"42207",41,33,33,1,0,"RECORTES CE",0
42,"42058",112,97,92,1,5,"RECORTES CE",0
42,"42193",16,11,11,0,0,"RECORTES CE",0
42,"42082",9,8,8,1,0,"RECORTES CE",0
42,"42060",34,23,21,0,2,"RECORTES CE",0
42,"42152",82,59,59,1,0,"RECORTES CE",0
42,"42213",29,18,18,1,0,"RECORTES CE",0
42,"42090",93,70,69,1,1,"RECORTES CE",0
42,"42095",1762,1319,1303,15,16,"RECORTES CE",1
42,"42190",94,71,71,1,0,"RECORTES CE",0
42,"42017",142,115,114,1,1,"RECORTES CE",0
42,"42175",23,18,18,0,0,"RECORTES CE",0
42,"42049",120,75,73,1,2,"RECORTES CE",0
42,"42079",27,17,17,1,0,"RECORTES CE",0
42,"42033",50,43,43,0,0,"RECORTES CE",0
42,"42141",111,79,79,0,0,"RECORTES CE",0
42,"42089",55,46,46,1,0,"RECORTES CE",0
42,"42157",13,10,10,1,0,"RECORTES CE",0
42,"42134",2642,1961,1938,24,23,"RECORTES CE",2
42,"42181",419,318,312,3,6,"RECORTES CE",0
42,"42153",14,14,14,1,0,"RECORTES CE",0
42,"42219",43,32,32,0,0,"RECORTES CE",0
42,"42142",52,33,33,0,0,"RECORTES CE",0
42,"42022",214,171,171,2,0,"RECORTES CE",0
42,"42068",85,62,61,2,1,"RECORTES CE",0
42,"42087",45,38,37,0,1,"RECORTES CE",0
42,"42217",31,25,25,0,0,"RECORTES CE",0
42,"42129",692,522,516,4,6,"RECORTES CE",2
42,"42188",50,44,43,0,1,"RECORTES CE",0
42,"42108",12,10,10,0,0,"RECORTES CE",0
42,"42167",259,195,194,2,1,"RECORTES CE",0
42,"42008",57,38,38,0,0,"RECORTES CE",0
42,"42003",66,59,57,1,2,"RECORTES CE",0
42,"42196",11,10,10,0,0,"RECORTES CE",0
42,"42139",22,16,16,0,0,"RECORTES CE",0
42,"42106",15,9,9,0,0,"RECORTES CE",0
42,"42024",87,68,67,0,1,"RECORTES CE",0
42,"42111",307,221,220,1,1,"RECORTES CE",0
42,"42051",21,15,15,0,0,"RECORTES CE",1
42,"42071",169,111,109,2,2,"RECORTES CE",0
42,"42195",100,60,60,3,0,"RECORTES CE",0
42,"42064",85,74,74,0,0,"RECORTES CE",0
42,"42038",36,27,27,2,0,"RECORTES CE",0
42,"42081",143,111,106,2,5,"RECORTES CE",0
42,"42025",1216,884,873,11,11,"RECORTES CE",1
42,"42048",67,53,51,1,2,"RECORTES CE",0
42,"42030",95,77,76,3,1,"RECORTES CE",0
42,"42006",164,121,118,8,3,"RECORTES CE",0
42,"42140",16,10,10,1,0,"RECORTES CE",0
42,"42168",109,88,88,1,0,"RECORTES CE",1
42,"42107",74,51,48,1,3,"RECORTES CE",1
42,"42194",176,127,126,2,1,"RECORTES CE",0
42,"42117",148,113,111,3,2,"RECORTES CE",0
42,"42070",35,27,25,0,2,"RECORTES CE",0
42,"42015",32,25,25,0,0,"RECORTES CE",0
42,"42053",26,21,21,1,0,"RECORTES CE",1
42,"42057",175,106,104,1,2,"RECORTES CE",0
42,"42161",140,106,106,2,0,"RECORTES CE",0
42,"42065",22,20,19,0,1,"RECORTES CE",0
42,"42093",40,29,29,3,0,"RECORTES CE",0
42,"42130",60,51,50,3,1,"RECORTES CE",0
42,"42162",2363,1690,1672,21,18,"RECORTES CE",2
42,"42135",75,53,53,1,0,"RECORTES CE",0
42,"42041",35,25,25,0,0,"RECORTES CE",0
42,"42045",312,218,214,1,4,"RECORTES CE",0
42,"42171",128,78,78,1,0,"RECORTES CE",0
42,"42151",35,31,29,2,2,"RECORTES CE",0
42,"42042",47,38,38,2,0,"RECORTES CE",0
42,"42009",80,65,64,2,1,"RECORTES CE",0
42,"42097",21,14,14,0,0,"RECORTES CE",0
42,"42055",165,127,127,3,0,"RECORTES CE",0
42,"42075",87,63,63,1,0,"RECORTES CE",0
42,"42103",583,467,459,5,8,"RECORTES CE",1
42,"42080",155,113,110,0,3,"RECORTES CE",0
42,"42004",2296,1767,1748,32,19,"RECORTES CE",2
42,"42105",49,42,42,0,0,"RECORTES CE",0
42,"42183",111,79,78,2,1,"RECORTES CE",0
42,"42037",34,17,17,1,0,"RECORTES CE",0
42,"42131",50,32,32,0,0,"RECORTES CE",0
42,"42014",66,43,43,2,0,"RECORTES CE",0
42,"42046",51,43,43,1,0,"RECORTES CE",0
42,"42100",32,31,31,1,0,"RECORTES CE",0
42,"42189",64,50,50,2,0,"RECORTES CE",0
42,"42212",69,54,54,3,0,"RECORTES CE",2
42,"42202",24,12,11,0,1,"RECORTES CE",0
42,"42020",4288,3087,3044,42,43,"RECORTES CE",2
42,"42160",261,205,203,1,2,"RECORTES CE",0
42,"42018",152,116,114,0,2,"RECORTES CE",0
42,"42128",39,37,37,1,0,"RECORTES CE",0
42,"42156",30,21,21,0,0,"RECORTES CE",0
42,"42069",1529,1078,1066,10,12,"RECORTES CE",0
42,"42035",782,566,562,4,4,"RECORTES CE",1
42,"42059",20,14,14,0,0,"RECORTES CE",0
42,"42159",38,33,32,1,1,"RECORTES CE",0
42,"42115",63,46,46,0,0,"RECORTES CE",0
42,"42019",516,367,363,4,4,"RECORTES CE",0
42,"42148",10,10,10,0,0,"RECORTES CE",0
42,"42086",38,29,29,1,0,"RECORTES CE",0
42,"42001",279,219,215,2,4,"RECORTES CE",0
42,"42092",65,42,41,1,1,"RECORTES CE",0
42,"42110",63,46,46,0,0,"RECORTES CE",0
42,"42083",25,23,21,0,2,"RECORTES CE",0
42,"42206",8,5,5,0,0,"RECORTES CE",0
42,"42063",49,37,37,1,0,"RECORTES CE",0
42,"42028",70,49,49,0,0,"RECORTES CE",0
42,"42197",76,61,59,1,2,"RECORTES CE",0
42,"42125",81,66,66,2,0,"RECORTES CE",0
42,"42166",60,40,40,0,0,"RECORTES CE",0
42,"42127",40,27,27,1,0,"RECORTES CE",0
42,"42012",37,29,29,0,0,"RECORTES CE",0
42,"42027",76,56,56,0,0,"RECORTES CE",1
42,"42173",29201,21456,21181,272,275,"RECORTES CE",46
42,"42088",71,53,53,0,0,"RECORTES CE",0
42,"42204",56,39,38,0,1,"RECORTES CE",0
42,"42076",219,176,173,4,3,"RECORTES CE",0
42,"42145",137,121,121,3,0,"RECORTES CE",0
42,"42123",165,119,119,4,0,"RECORTES CE",0
42,"42187",63,55,54,1,1,"RECORTES CE",0
42,"42163",49,37,37,0,0,"RECORTES CE",0
42,"42016",18,13,13,0,0,"RECORTES CE",0
42,"42218",80,54,54,1,0,"RECORTES CE",2
42,"42201",23,23,22,0,1,"RECORTES CE",0
42,"42165",408,289,282,7,7,"RECORTES CE",1
16,"16213",35,28,28,1,0,"PACMA",0
16,"16169",58,33,32,0,1,"PACMA",0
16,"16095",84,71,68,0,3,"PACMA",0
16,"16170",698,524,517,1,7,"PACMA",1
16,"16125",1676,1338,1326,9,12,"PACMA",8
16,"16149",153,130,129,0,1,"PACMA",2
16,"16078",41427,31365,31095,268,270,"PACMA",178
16,"16175",5113,4203,4124,35,79,"PACMA",7
16,"16152",40,35,35,0,0,"PACMA",1
16,"16089",379,299,299,4,0,"PACMA",0
16,"16195",498,380,376,1,4,"PACMA",0
16,"16006",119,96,94,1,2,"PACMA",0
16,"16072",147,103,102,0,1,"PACMA",0
16,"16038",38,28,28,0,0,"PACMA",0
16,"16057",78,60,60,0,0,"PACMA",0
16,"16165",63,51,50,1,1,"PACMA",0
16,"16001",75,60,60,0,0,"PACMA",1
16,"16115",44,33,33,0,0,"PACMA",0
16,"16024",130,100,98,0,2,"PACMA",0
16,"16016",234,173,172,2,1,"PACMA",0
16,"16029",96,73,71,0,2,"PACMA",0
16,"16042",1192,1021,1005,6,16,"PACMA",0
16,"16135",139,109,108,0,1,"PACMA",0
16,"16190",5127,4088,4025,42,63,"PACMA",19
16,"16018",401,328,328,1,0,"PACMA",0
16,"16172",350,270,270,2,0,"PACMA",1
16,"16216",317,275,267,0,8,"PACMA",0
16,"16167",324,275,271,2,4,"PACMA",4
16,"16198",1365,1067,1052,12,15,"PACMA",6
16,"16093",64,52,52,0,0,"PACMA",0
16,"16209",118,100,100,1,0,"PACMA",0
16,"16206",208,163,162,4,1,"PACMA",0
16,"16023",468,344,343,3,1,"PACMA",2
16,"16034",183,153,153,1,0,"PACMA",0
16,"16020",17,11,11,0,0,"PACMA",0
16,"16278",73,55,55,0,0,"PACMA",0
16,"16237",113,89,87,0,2,"PACMA",0
16,"16274",127,100,100,0,0,"PACMA",0
16,"16166",247,182,177,0,5,"PACMA",0
16,"16131",134,97,97,1,0,"PACMA",0
16,"16046",250,181,180,1,1,"PACMA",0
16,"16162",43,35,35,0,0,"PACMA",0
16,"16909",706,537,534,3,3,"PACMA",2
16,"16161",58,53,53,0,0,"PACMA",0
16,"16258",198,143,142,0,1,"PACMA",0
16,"16099",208,157,152,0,5,"PACMA",0
16,"16193",70,57,57,1,0,"PACMA",0
16,"16134",4369,3412,3369,23,43,"PACMA",25
16,"16265",21,16,16,0,0,"PACMA",0
16,"16067",127,92,91,3,1,"PACMA",0
16,"16121",259,205,205,3,0,"PACMA",0
16,"16064",681,588,581,1,7,"PACMA",2
16,"16110",97,71,70,0,1,"PACMA",0
16,"16025",25,21,21,1,0,"PACMA",0
16,"16063",98,87,87,0,0,"PACMA",0
16,"16908",197,154,154,1,0,"PACMA",0
16,"16275",11,11,11,1,0,"PACMA",0
16,"16041",354,284,282,0,2,"PACMA",0
16,"16129",104,82,79,1,3,"PACMA",0
16,"16068",145,117,114,2,3,"PACMA",1
16,"16122",254,200,198,4,2,"PACMA",3
16,"16065",406,323,319,3,4,"PACMA",1
16,"16248",872,711,696,11,15,"PACMA",2
16,"16254",216,181,179,5,2,"PACMA",1
16,"16212",255,208,206,1,2,"PACMA",0
16,"16094",132,101,99,1,2,"PACMA",0
16,"16150",94,67,67,1,0,"PACMA",1
16,"16194",259,208,200,0,8,"PACMA",0
16,"16904",478,387,381,5,6,"PACMA",1
16,"16186",465,394,387,2,7,"PACMA",3
16,"16228",177,132,131,1,1,"PACMA",0
16,"16199",31,24,24,0,0,"PACMA",0
16,"16004",274,212,206,0,6,"PACMA",0
16,"16196",633,538,527,2,11,"PACMA",2
16,"16113",3080,2309,2278,15,31,"PACMA",14
16,"16218",189,155,154,1,1,"PACMA",0
16,"16156",101,76,75,0,1,"PACMA",1
16,"16119",169,121,120,0,1,"PACMA",0
16,"16087",212,186,186,5,0,"PACMA",0
16,"16185",44,35,33,0,2,"PACMA",0
16,"16086",888,768,762,10,6,"PACMA",3
16,"16053",429,352,348,5,4,"PACMA",0
16,"16133",4391,3539,3509,27,30,"PACMA",20
16,"16246",484,382,375,1,7,"PACMA",0
16,"16148",587,511,511,1,0,"PACMA",0
16,"16036",128,104,102,2,2,"PACMA",1
16,"16097",162,135,135,1,0,"PACMA",0
16,"16251",1858,1450,1420,8,30,"PACMA",3
16,"16171",1818,1514,1498,5,16,"PACMA",3
16,"16243",412,354,348,0,6,"PACMA",2
16,"16247",71,52,51,0,1,"PACMA",0
16,"16157",213,185,182,0,3,"PACMA",1
16,"16032",287,230,230,1,0,"PACMA",0
16,"16204",272,207,207,1,0,"PACMA",0
16,"16027",709,567,562,4,5,"PACMA",4
16,"16116",84,62,62,0,0,"PACMA",0
16,"16224",84,68,67,1,1,"PACMA",1
16,"16264",433,374,370,2,4,"PACMA",2
16,"16272",228,167,167,1,0,"PACMA",0
16,"16225",76,58,57,0,1,"PACMA",0
16,"16158",546,437,431,7,6,"PACMA",0
16,"16070",32,31,31,0,0,"PACMA",0
16,"16141",145,113,112,1,1,"PACMA",1
16,"16177",78,63,63,0,0,"PACMA",0
16,"16905",1217,965,956,9,9,"PACMA",2
16,"16056",465,333,322,0,11,"PACMA",0
16,"16118",1405,1147,1136,11,11,"PACMA",8
16,"16061",964,798,790,13,8,"PACMA",11
16,"16173",207,155,154,1,1,"PACMA",1
16,"16047",230,176,176,2,0,"PACMA",4
16,"16253",357,279,279,1,0,"PACMA",0
16,"16142",139,110,109,2,1,"PACMA",0
16,"16174",192,155,155,1,0,"PACMA",1
16,"16240",108,79,79,0,0,"PACMA",0
16,"16245",418,338,333,2,5,"PACMA",4
16,"16249",1986,1593,1570,8,23,"PACMA",4
16,"16026",85,56,53,0,3,"PACMA",0
16,"16083",55,28,28,0,0,"PACMA",0
16,"16062",24,21,21,0,0,"PACMA",0
16,"16143",16,12,12,2,0,"PACMA",0
16,"16903",1081,824,816,6,8,"PACMA",1
16,"16124",1870,1536,1518,7,18,"PACMA",4
16,"16052",548,420,420,1,0,"PACMA",4
16,"16250",76,57,57,0,0,"PACMA",1
16,"16255",141,119,119,0,0,"PACMA",1
16,"16279",213,146,143,0,3,"PACMA",1
16,"16058",105,81,80,0,1,"PACMA",0
16,"16079",32,21,20,0,1,"PACMA",0
16,"16101",160,130,129,0,1,"PACMA",0
16,"16163",74,63,63,0,0,"PACMA",0
16,"16091",68,51,49,0,2,"PACMA",0
16,"16111",171,138,137,2,1,"PACMA",1
16,"16153",955,797,780,5,17,"PACMA",1
16,"16107",120,87,87,1,0,"PACMA",0
16,"16073",188,158,158,0,0,"PACMA",0
16,"16266",373,279,273,1,6,"PACMA",1
16,"16231",48,38,38,0,0,"PACMA",1
16,"16019",217,168,166,1,2,"PACMA",0
16,"16102",1231,922,911,8,11,"PACMA",3
16,"16234",30,19,19,1,0,"PACMA",0
16,"16011",28,19,19,0,0,"PACMA",0
16,"16003",127,111,109,0,2,"PACMA",1
16,"16051",147,118,118,0,0,"PACMA",0
16,"16902",141,105,105,1,0,"PACMA",0
16,"16910",96,70,70,0,0,"PACMA",0
16,"16205",114,89,88,0,1,"PACMA",0
16,"16132",34,26,26,0,0,"PACMA",0
16,"16137",56,34,33,0,1,"PACMA",0
16,"16039",398,275,271,1,4,"PACMA",2
16,"16092",161,130,129,1,1,"PACMA",0
16,"16035",258,192,192,3,0,"PACMA",2
16,"16160",61,46,45,1,1,"PACMA",0
16,"16202",783,573,566,3,7,"PACMA",4
16,"16263",961,754,745,4,9,"PACMA",2
16,"16236",914,694,689,6,5,"PACMA",2
16,"16049",156,121,121,0,0,"PACMA",1
16,"16112",1505,1088,1072,9,16,"PACMA",6
16,"16188",90,63,62,0,1,"PACMA",0
16,"16071",20,20,20,0,0,"PACMA",0
16,"16906",82,67,67,1,0,"PACMA",0
16,"16084",49,37,32,0,5,"PACMA",0
16,"16106",2729,2130,2095,19,35,"PACMA",6
16,"16022",78,63,61,0,2,"PACMA",0
16,"16088",114,92,92,0,0,"PACMA",0
16,"16009",66,48,48,0,0,"PACMA",0
16,"16189",256,192,191,2,1,"PACMA",0
16,"16005",256,191,187,1,4,"PACMA",0
16,"16215",248,177,172,1,5,"PACMA",0
16,"16007",1192,964,959,8,5,"PACMA",0
16,"16140",27,15,15,0,0,"PACMA",0
16,"16082",305,224,224,0,0,"PACMA",0
16,"16103",265,217,217,0,0,"PACMA",0
16,"16139",333,255,251,4,4,"PACMA",1
16,"16238",509,442,434,2,8,"PACMA",1
16,"16045",221,166,164,1,2,"PACMA",0
16,"16002",192,172,172,0,0,"PACMA",4
16,"16085",136,108,108,2,0,"PACMA",0
16,"16154",4904,3776,3730,47,46,"PACMA",14
16,"16014",613,493,487,1,6,"PACMA",0
16,"16055",703,512,509,7,3,"PACMA",3
16,"16239",141,110,107,0,3,"PACMA",0
16,"16100",684,587,580,5,7,"PACMA",1
16,"16108",49,43,42,0,1,"PACMA",2
16,"16280",189,160,157,2,3,"PACMA",0
16,"16270",167,141,141,0,0,"PACMA",0
16,"16187",77,52,52,1,0,"PACMA",0
16,"16181",64,53,53,0,0,"PACMA",0
16,"16030",25,22,22,1,0,"PACMA",0
16,"16074",40,31,31,0,0,"PACMA",0
16,"16012",82,69,69,0,0,"PACMA",0
16,"16192",50,30,29,0,1,"PACMA",1
16,"16151",64,60,60,0,0,"PACMA",0
16,"16104",54,40,40,0,0,"PACMA",0
16,"16155",506,415,414,2,1,"PACMA",1
16,"16033",1729,1385,1365,7,20,"PACMA",9
16,"16109",43,32,32,0,0,"PACMA",1
16,"16176",39,28,28,0,0,"PACMA",0
16,"16217",75,58,58,0,0,"PACMA",0
16,"16066",2333,1917,1872,24,45,"PACMA",16
16,"16017",370,300,296,2,4,"PACMA",0
16,"16197",65,37,37,0,0,"PACMA",0
16,"16013",31,28,28,0,0,"PACMA",0
16,"16242",325,281,278,1,3,"PACMA",2
16,"16227",112,84,84,0,0,"PACMA",0
16,"16203",9960,7515,7418,43,97,"PACMA",41
16,"16048",412,312,310,1,2,"PACMA",2
16,"16244",722,625,617,2,8,"PACMA",3
16,"16269",426,351,349,3,2,"PACMA",0
16,"16081",49,38,37,0,1,"PACMA",0
16,"16060",760,600,593,5,7,"PACMA",2
16,"16277",118,86,84,0,2,"PACMA",0
16,"16259",30,26,26,1,0,"PACMA",0
16,"16130",575,451,446,0,5,"PACMA",2
16,"16145",464,389,387,2,2,"PACMA",3
16,"16117",1057,814,808,2,6,"PACMA",3
16,"16271",637,535,533,3,2,"PACMA",0
16,"16010",154,114,110,1,4,"PACMA",0
16,"16146",87,62,62,1,0,"PACMA",0
16,"16043",99,73,73,1,0,"PACMA",0
16,"16147",62,43,43,0,0,"PACMA",1
16,"16031",46,30,30,2,0,"PACMA",0
16,"16096",273,249,244,2,5,"PACMA",1
16,"16159",225,170,168,0,2,"PACMA",0
16,"16040",85,71,71,0,0,"PACMA",1
16,"16008",95,72,72,0,0,"PACMA",0
16,"16191",926,760,752,6,8,"PACMA",0
16,"16276",21,17,17,0,0,"PACMA",0
16,"16015",376,286,285,7,1,"PACMA",2
16,"16098",571,468,461,5,7,"PACMA",3
16,"16123",82,54,53,0,1,"PACMA",0
16,"16126",783,654,648,2,6,"PACMA",0
16,"16273",324,252,252,2,0,"PACMA",2
16,"16050",251,195,194,1,1,"PACMA",0
16,"16044",39,28,27,0,1,"PACMA",0
16,"16219",91,72,72,0,0,"PACMA",0
16,"16128",63,54,54,2,0,"PACMA",0
16,"16901",707,520,513,3,7,"PACMA",0
16,"16211",377,253,250,3,3,"PACMA",1
44,"44193",82,62,62,1,0,"RECORTES CE",0
44,"44165",184,153,152,1,1,"RECORTES CE",0
44,"44175",121,91,89,2,2,"RECORTES CE",0
44,"44054",109,90,90,0,0,"RECORTES CE",0
44,"44141",135,105,104,1,1,"RECORTES CE",0
44,"44001",68,50,50,0,0,"RECORTES CE",0
44,"44251",254,202,194,2,8,"RECORTES CE",0
44,"44022",490,323,316,9,7,"RECORTES CE",0
44,"44234",62,48,48,1,0,"RECORTES CE",0
44,"44029",567,475,467,5,8,"RECORTES CE",0
44,"44257",167,120,120,1,0,"RECORTES CE",0
44,"44180",71,57,56,1,1,"RECORTES CE",0
44,"44231",38,32,32,0,0,"RECORTES CE",0
44,"44008",1615,1217,1200,7,17,"RECORTES CE",1
44,"44052",80,55,54,0,1,"RECORTES CE",0
44,"44084",55,45,45,0,0,"RECORTES CE",0
44,"44041",54,46,46,2,0,"RECORTES CE",0
44,"44213",63,47,47,0,0,"RECORTES CE",0
44,"44117",347,278,274,2,4,"RECORTES CE",0
44,"44227",75,63,63,0,0,"RECORTES CE",0
44,"44181",78,63,63,1,0,"RECORTES CE",1
44,"44194",111,79,75,0,4,"RECORTES CE",0
44,"44237",408,327,321,2,6,"RECORTES CE",0
44,"44011",57,35,35,0,0,"RECORTES CE",0
44,"44035",117,81,81,0,0,"RECORTES CE",0
44,"44009",809,586,578,5,8,"RECORTES CE",1
44,"44153",1812,1209,1196,15,13,"RECORTES CE",2
44,"44089",46,42,42,0,0,"RECORTES CE",0
44,"44177",111,77,76,1,1,"RECORTES CE",0
44,"44124",78,58,58,1,0,"RECORTES CE",0
44,"44135",115,89,86,0,3,"RECORTES CE",0
44,"44196",134,102,102,1,0,"RECORTES CE",0
44,"44014",2530,2008,1966,17,42,"RECORTES CE",2
44,"44173",101,85,84,0,1,"RECORTES CE",0
44,"44090",82,57,57,0,0,"RECORTES CE",0
44,"44190",72,53,52,0,1,"RECORTES CE",0
44,"44241",537,408,403,2,5,"RECORTES CE",2
44,"44245",250,189,186,1,3,"RECORTES CE",0
44,"44219",198,141,134,4,7,"RECORTES CE",0
44,"44164",26,22,22,0,0,"RECORTES CE",0
44,"44223",75,55,55,2,0,"RECORTES CE",0
44,"44025",6062,4490,4394,48,96,"RECORTES CE",5
44,"44261",734,552,542,8,10,"RECORTES CE",0
44,"44107",216,162,162,1,0,"RECORTES CE",1
44,"44146",173,157,157,1,0,"RECORTES CE",0
44,"44240",161,128,125,0,3,"RECORTES CE",0
44,"44178",56,42,42,0,0,"RECORTES CE",0
44,"44147",419,312,307,5,5,"RECORTES CE",1
44,"44100",187,154,153,0,1,"RECORTES CE",0
44,"44221",365,298,296,2,2,"RECORTES CE",0
44,"44224",22,14,14,0,0,"RECORTES CE",0
44,"44070",55,47,46,1,1,"RECORTES CE",0
44,"44013",11254,8292,8205,82,87,"RECORTES CE",13
44,"44066",110,83,83,1,0,"RECORTES CE",0
44,"44085",52,40,40,4,0,"RECORTES CE",0
44,"44171",183,136,135,1,1,"RECORTES CE",1
44,"44197",58,34,34,0,0,"RECORTES CE",0
44,"44023",18,15,15,0,0,"RECORTES CE",0
44,"44226",141,102,100,2,2,"RECORTES CE",0
44,"44019",68,49,48,1,1,"RECORTES CE",0
44,"44163",128,94,94,0,0,"RECORTES CE",0
44,"44262",137,107,107,1,0,"RECORTES CE",1
44,"44266",118,95,95,0,0,"RECORTES CE",1
44,"44250",19,12,12,2,0,"RECORTES CE",0
44,"44102",31,25,25,0,0,"RECORTES CE",0
44,"44004",415,295,291,3,4,"RECORTES CE",2
44,"44143",388,310,309,3,1,"RECORTES CE",0
44,"44038",107,83,83,2,0,"RECORTES CE",0
44,"44113",72,50,50,0,0,"RECORTES CE",0
44,"44172",310,216,216,6,0,"RECORTES CE",0
44,"44127",73,51,50,0,1,"RECORTES CE",0
44,"44043",108,75,75,1,0,"RECORTES CE",0
44,"44187",199,148,143,1,5,"RECORTES CE",0
44,"44128",69,50,50,0,0,"RECORTES CE",0
44,"44212",41,32,32,0,0,"RECORTES CE",0
44,"44133",23,17,17,0,0,"RECORTES CE",0
44,"44031",99,64,64,0,0,"RECORTES CE",0
44,"44121",60,43,43,0,0,"RECORTES CE",0
44,"44076",2234,1759,1729,16,30,"RECORTES CE",2
44,"44189",58,40,40,1,0,"RECORTES CE",0
44,"44160",478,329,322,5,7,"RECORTES CE",0
44,"44169",351,268,266,3,2,"RECORTES CE",2
44,"44075",324,256,250,4,6,"RECORTES CE",0
44,"44012",336,279,276,2,3,"RECORTES CE",0
44,"44071",599,430,424,8,6,"RECORTES CE",4
44,"44096",161,141,139,0,2,"RECORTES CE",0
44,"44048",65,51,51,0,0,"RECORTES CE",0
44,"44042",127,93,92,1,1,"RECORTES CE",0
44,"44149",99,71,71,3,0,"RECORTES CE",0
44,"44074",430,338,329,5,9,"RECORTES CE",0
44,"44053",102,79,73,0,6,"RECORTES CE",0
44,"44168",191,137,131,3,6,"RECORTES CE",0
44,"44154",261,194,191,3,3,"RECORTES CE",1
44,"44265",188,144,138,2,6,"RECORTES CE",0
44,"44044",91,70,70,0,0,"RECORTES CE",0
44,"44132",61,50,50,1,0,"RECORTES CE",0
44,"44056",513,348,341,4,7,"RECORTES CE",1
44,"44064",70,51,51,0,0,"RECORTES CE",0
44,"44142",36,27,27,5,0,"RECORTES CE",1
44,"44159",39,34,34,0,0,"RECORTES CE",1
44,"44114",244,186,185,3,1,"RECORTES CE",0
44,"44020",24,20,19,1,1,"RECORTES CE",1
44,"44174",430,314,313,2,1,"RECORTES CE",0
44,"44092",80,53,52,0,1,"RECORTES CE",0
44,"44082",91,68,67,0,1,"RECORTES CE",1
44,"44068",664,519,515,4,4,"RECORTES CE",0
44,"44021",107,83,83,2,0,"RECORTES CE",0
44,"44116",83,67,65,1,2,"RECORTES CE",0
44,"44211",40,30,30,0,0,"RECORTES CE",0
44,"44230",155,126,126,2,0,"RECORTES CE",0
44,"44210",759,597,596,2,1,"RECORTES CE",1
44,"44206",112,90,88,0,2,"RECORTES CE",0
44,"44148",93,76,76,3,0,"RECORTES CE",0
44,"44007",184,124,120,0,4,"RECORTES CE",0
44,"44198",187,151,148,3,3,"RECORTES CE",0
44,"44129",41,34,34,0,0,"RECORTES CE",0
44,"44232",391,286,279,4,7,"RECORTES CE",2
44,"44246",1554,1091,1079,13,12,"RECORTES CE",1
44,"44152",67,48,48,1,0,"RECORTES CE",0
44,"44006",250,188,186,1,2,"RECORTES CE",0
44,"44065",55,36,36,1,0,"RECORTES CE",0
44,"44061",71,57,54,1,3,"RECORTES CE",0
44,"44060",40,35,35,1,0,"RECORTES CE",0
44,"44118",165,127,125,2,2,"RECORTES CE",0
44,"44207",158,119,115,0,4,"RECORTES CE",0
44,"44229",151,108,107,1,1,"RECORTES CE",1
44,"44217",28,20,20,0,0,"RECORTES CE",0
44,"44145",1029,768,763,7,5,"RECORTES CE",0
44,"44247",314,230,228,2,2,"RECORTES CE",0
44,"44185",104,77,77,0,0,"RECORTES CE",0
44,"44150",32,21,20,0,1,"RECORTES CE",0
44,"44191",771,595,586,7,9,"RECORTES CE",4
44,"44209",839,640,623,3,17,"RECORTES CE",1
44,"44110",52,46,44,0,2,"RECORTES CE",0
44,"44120",222,140,138,2,2,"RECORTES CE",0
44,"44220",121,85,82,2,3,"RECORTES CE",1
44,"44249",57,47,47,3,0,"RECORTES CE",0
44,"44222",137,96,96,0,0,"RECORTES CE",1
44,"44033",279,193,191,2,2,"RECORTES CE",1
44,"44037",453,326,321,5,5,"RECORTES CE",0
44,"44097",147,89,87,1,2,"RECORTES CE",0
44,"44115",106,93,92,4,1,"RECORTES CE",0
44,"44137",205,159,159,2,0,"RECORTES CE",0
44,"44111",92,69,69,0,0,"RECORTES CE",0
44,"44016",486,361,357,7,4,"RECORTES CE",0
44,"44216",26539,19621,19346,248,275,"RECORTES CE",50
44,"44050",3129,2135,2103,30,32,"RECORTES CE",7
44,"44002",54,41,41,0,0,"RECORTES CE",0
44,"44215",156,105,103,2,2,"RECORTES CE",0
44,"44032",16,13,13,0,0,"RECORTES CE",0
44,"44108",331,238,234,4,4,"RECORTES CE",1
44,"44183",77,45,44,0,1,"RECORTES CE",0
44,"44051",2704,2074,2046,32,28,"RECORTES CE",0
44,"44039",219,162,160,2,2,"RECORTES CE",0
44,"44005",54,38,37,2,1,"RECORTES CE",0
44,"44156",46,33,32,1,1,"RECORTES CE",0
44,"44267",71,50,50,0,0,"RECORTES CE",0
44,"44017",285,221,220,0,1,"RECORTES CE",0
44,"44027",161,122,121,4,1,"RECORTES CE",0
44,"44199",43,36,36,1,0,"RECORTES CE",0
44,"44103",130,106,106,0,0,"RECORTES CE",0
44,"44067",117,80,80,0,0,"RECORTES CE",0
44,"44192",364,280,278,0,2,"RECORTES CE",2
44,"44125",65,39,39,0,0,"RECORTES CE",0
44,"44184",48,30,30,0,0,"RECORTES CE",0
44,"44243",23,18,18,0,0,"RECORTES CE",0
44,"44062",35,27,26,0,1,"RECORTES CE",1
44,"44036",24,16,16,0,0,"RECORTES CE",0
44,"44176",160,127,127,0,0,"RECORTES CE",0
44,"44260",139,100,98,2,2,"RECORTES CE",0
44,"44087",81,70,70,3,0,"RECORTES CE",0
44,"44218",37,26,26,0,0,"RECORTES CE",0
44,"44138",140,79,77,0,2,"RECORTES CE",0
44,"44204",25,22,22,0,0,"RECORTES CE",0
44,"44201",497,414,410,2,4,"RECORTES CE",1
44,"44239",22,20,20,0,0,"RECORTES CE",0
44,"44059",541,431,423,7,8,"RECORTES CE",0
44,"44205",712,474,468,6,6,"RECORTES CE",1
44,"44063",78,61,61,0,0,"RECORTES CE",0
44,"44235",91,71,70,2,1,"RECORTES CE",0
44,"44045",355,290,286,2,4,"RECORTES CE",0
44,"44131",26,20,20,0,0,"RECORTES CE",0
44,"44028",191,150,142,1,8,"RECORTES CE",0
44,"44109",110,76,74,1,2,"RECORTES CE",0
44,"44179",345,229,227,2,2,"RECORTES CE",0
44,"44106",159,127,126,3,1,"RECORTES CE",1
44,"44093",76,60,60,0,0,"RECORTES CE",0
44,"44225",111,76,76,4,0,"RECORTES CE",0
44,"44080",292,221,218,4,3,"RECORTES CE",0
44,"44119",135,94,90,2,4,"RECORTES CE",0
44,"44046",48,31,31,2,0,"RECORTES CE",0
44,"44268",28,24,24,0,0,"RECORTES CE",0
44,"44236",59,45,45,0,0,"RECORTES CE",0
44,"44238",2345,1743,1729,7,14,"RECORTES CE",1
44,"44228",99,79,79,1,0,"RECORTES CE",0
44,"44047",221,139,135,0,4,"RECORTES CE",1
44,"44208",34,22,22,0,0,"RECORTES CE",0
44,"44123",105,69,69,1,0,"RECORTES CE",0
44,"44182",194,155,154,3,1,"RECORTES CE",1
44,"44157",65,41,40,0,1,"RECORTES CE",0
44,"44034",138,112,110,2,2,"RECORTES CE",0
44,"44252",85,67,66,0,1,"RECORTES CE",1
44,"44010",178,124,121,2,3,"RECORTES CE",0
44,"44126",334,239,235,7,4,"RECORTES CE",1
44,"44256",39,34,34,1,0,"RECORTES CE",0
44,"44200",40,22,22,0,0,"RECORTES CE",0
44,"44158",1170,898,872,12,26,"RECORTES CE",1
44,"44018",20,20,20,0,0,"RECORTES CE",0
44,"44167",38,31,31,0,0,"RECORTES CE",0
44,"44112",426,293,284,2,9,"RECORTES CE",2
44,"44263",369,265,259,2,6,"RECORTES CE",0
44,"44130",34,24,24,0,0,"RECORTES CE",0
44,"44024",27,23,23,0,0,"RECORTES CE",0
44,"44122",1356,971,969,12,2,"RECORTES CE",0
44,"44086",453,355,350,3,5,"RECORTES CE",0
44,"44264",253,211,210,2,1,"RECORTES CE",0
44,"44161",447,324,320,3,4,"RECORTES CE",0
44,"44151",191,147,145,1,2,"RECORTES CE",0
44,"44144",351,256,252,1,4,"RECORTES CE",0
44,"44040",202,160,158,3,2,"RECORTES CE",0
44,"44003",19,16,16,0,0,"RECORTES CE",0
44,"44101",59,44,44,0,0,"RECORTES CE",0
44,"44244",75,39,39,0,0,"RECORTES CE",0
44,"44094",113,102,100,1,2,"RECORTES CE",0
44,"44155",1102,831,825,7,6,"RECORTES CE",2
44,"44049",850,624,613,8,11,"RECORTES CE",0
44,"44099",708,514,510,1,4,"RECORTES CE",0
44,"44026",90,71,71,0,0,"RECORTES CE",0
44,"44055",69,52,51,3,1,"RECORTES CE",0
44,"44088",30,26,26,2,0,"RECORTES CE",0
44,"44195",92,61,61,2,0,"RECORTES CE",0
44,"44203",10,8,8,0,0,"RECORTES CE",0
44,"44258",69,46,46,0,0,"RECORTES CE",0
44,"44136",49,42,42,1,0,"RECORTES CE",0
44,"44105",80,62,62,0,0,"RECORTES CE",0
44,"44077",75,58,57,0,1,"RECORTES CE",0
10,"10028",98,72,71,0,1,"PACMA",0
10,"10179",301,247,247,0,0,"PACMA",2
10,"10063",179,145,145,1,0,"PACMA",0
10,"10153",318,238,231,3,7,"PACMA",0
10,"10084",1370,934,906,7,28,"PACMA",1
10,"10008",1331,1052,1047,6,5,"PACMA",4
10,"10051",440,318,314,1,4,"PACMA",0
10,"10036",327,247,244,2,3,"PACMA",1
10,"10167",306,240,237,0,3,"PACMA",0
10,"10034",350,263,262,1,1,"PACMA",0
10,"10149",435,315,307,1,8,"PACMA",0
10,"10006",1275,1024,1004,7,20,"PACMA",0
10,"10043",814,594,590,2,4,"PACMA",1
10,"10098",385,294,286,0,8,"PACMA",1
10,"10117",260,127,127,0,0,"PACMA",0
10,"10219",1290,860,843,1,17,"PACMA",2
10,"10035",1880,1390,1372,6,18,"PACMA",7
10,"10067",10486,7796,7692,54,104,"PACMA",26
10,"10213",571,483,478,1,5,"PACMA",0
10,"10217",533,431,427,1,4,"PACMA",1
10,"10904",750,522,520,5,2,"PACMA",4
10,"10080",368,276,272,1,4,"PACMA",0
10,"10177",1703,1331,1296,10,35,"PACMA",7
10,"10134",565,395,393,1,2,"PACMA",0
10,"10193",1421,1150,1130,10,20,"PACMA",6
10,"10044",1451,1100,1087,7,13,"PACMA",6
10,"10169",544,430,423,0,7,"PACMA",0
10,"10018",1722,1255,1240,6,15,"PACMA",8
10,"10029",418,345,341,1,4,"PACMA",2
10,"10104",5169,3766,3703,21,63,"PACMA",32
10,"10071",144,100,100,2,0,"PACMA",0
10,"10012",599,494,489,1,5,"PACMA",2
10,"10050",1062,853,846,5,7,"PACMA",1
10,"10112",1583,1203,1176,7,27,"PACMA",5
10,"10022",435,371,366,1,5,"PACMA",0
10,"10157",273,209,205,1,4,"PACMA",0
10,"10150",354,301,295,4,6,"PACMA",1
10,"10100",795,602,595,4,7,"PACMA",3
10,"10002",368,278,275,0,3,"PACMA",0
10,"10088",205,117,117,0,0,"PACMA",1
10,"10161",75,53,53,0,0,"PACMA",0
10,"10902",730,546,536,2,10,"PACMA",1
10,"10026",646,507,494,5,13,"PACMA",0
10,"10165",259,212,209,0,3,"PACMA",0
10,"10096",3443,2503,2464,14,39,"PACMA",11
10,"10069",831,647,637,2,10,"PACMA",5
10,"10126",1572,1123,1107,3,16,"PACMA",2
10,"10110",2298,1682,1638,10,44,"PACMA",8
10,"10191",532,417,415,12,2,"PACMA",2
10,"10209",296,195,193,1,2,"PACMA",1
10,"10147",1275,985,937,6,48,"PACMA",3
10,"10160",225,172,170,0,2,"PACMA",1
10,"10046",201,176,173,2,3,"PACMA",0
10,"10205",2034,1413,1386,5,27,"PACMA",6
10,"10010",2322,1446,1431,12,15,"PACMA",1
10,"10148",32985,23666,23394,189,272,"PACMA",185
10,"10171",340,262,261,1,1,"PACMA",2
10,"10093",406,333,324,2,9,"PACMA",2
10,"10040",443,344,342,4,2,"PACMA",1
10,"10017",841,606,589,4,17,"PACMA",0
10,"10078",414,325,319,3,6,"PACMA",0
10,"10170",263,204,202,2,2,"PACMA",0
10,"10122",231,166,163,0,3,"PACMA",0
10,"10075",256,178,177,1,1,"PACMA",1
10,"10185",572,433,427,5,6,"PACMA",0
10,"10038",86,70,70,0,0,"PACMA",0
10,"10903",819,629,624,7,5,"PACMA",5
10,"10030",477,316,304,1,12,"PACMA",1
10,"10068",746,601,586,3,15,"PACMA",3
10,"10042",85,70,70,0,0,"PACMA",0
10,"10204",442,345,342,5,3,"PACMA",0
10,"10073",715,536,530,3,6,"PACMA",1
10,"10105",2519,1745,1714,11,31,"PACMA",11
10,"10201",176,146,145,0,1,"PACMA",0
10,"10197",134,94,93,0,1,"PACMA",0
10,"10211",454,352,339,2,13,"PACMA",2
10,"10154",184,138,134,1,4,"PACMA",0
10,"10203",4600,3268,3215,14,53,"PACMA",14
10,"10152",470,361,357,3,4,"PACMA",0
10,"10189",2656,2006,1971,10,35,"PACMA",5
10,"10181",694,571,558,7,13,"PACMA",0
10,"10054",545,427,426,6,1,"PACMA",3
10,"10210",551,380,373,1,7,"PACMA",1
10,"10180",4159,2765,2734,12,31,"PACMA",7
10,"10033",430,304,301,1,3,"PACMA",1
10,"10090",522,386,382,5,4,"PACMA",0
10,"10158",335,252,251,0,1,"PACMA",0
10,"10032",1705,1296,1277,10,19,"PACMA",5
10,"10092",301,238,236,2,2,"PACMA",5
10,"10124",862,692,678,7,14,"PACMA",0
10,"10062",413,345,341,3,4,"PACMA",3
10,"10128",5752,4219,4146,39,73,"PACMA",21
10,"10076",820,608,595,3,13,"PACMA",0
10,"10101",185,147,147,1,0,"PACMA",0
10,"10188",500,381,373,2,8,"PACMA",0
10,"10172",718,501,493,2,8,"PACMA",5
10,"10056",591,456,452,5,4,"PACMA",5
10,"10121",7970,5884,5816,33,68,"PACMA",17
10,"10145",126,101,100,1,1,"PACMA",0
10,"10207",502,352,349,5,3,"PACMA",0
10,"10115",3578,2857,2811,20,46,"PACMA",15
10,"10199",166,120,119,3,1,"PACMA",0
10,"10130",1761,1322,1308,5,14,"PACMA",2
10,"10118",289,257,257,1,0,"PACMA",0
10,"10183",993,763,761,4,2,"PACMA",2
10,"10136",318,234,234,4,0,"PACMA",1
10,"10087",1701,1233,1215,7,18,"PACMA",5
10,"10200",417,308,305,0,3,"PACMA",1
10,"10178",781,567,562,1,5,"PACMA",2
10,"10045",1031,786,781,11,5,"PACMA",3
10,"10009",270,173,170,1,3,"PACMA",0
10,"10005",537,411,398,3,13,"PACMA",1
10,"10072",862,644,639,2,5,"PACMA",0
10,"10097",106,79,79,0,0,"PACMA",1
10,"10024",687,538,533,6,5,"PACMA",3
10,"10108",218,122,120,0,2,"PACMA",0
10,"10041",1056,823,811,4,12,"PACMA",2
10,"10058",1025,747,737,5,10,"PACMA",0
10,"10140",1114,860,848,6,12,"PACMA",5
10,"10014",1874,1430,1401,11,29,"PACMA",2
10,"10081",179,133,129,0,4,"PACMA",0
10,"10083",90,69,69,0,0,"PACMA",2
10,"10116",3784,2839,2801,21,38,"PACMA",12
10,"10168",320,240,237,0,3,"PACMA",0
10,"10059",369,258,255,0,3,"PACMA",0
10,"10208",124,100,98,1,2,"PACMA",0
10,"10052",193,127,126,1,1,"PACMA",3
10,"10085",335,248,244,1,4,"PACMA",1
10,"10109",1804,1233,1212,2,21,"PACMA",6
10,"10060",973,620,607,5,13,"PACMA",5
10,"10020",1619,1240,1214,9,26,"PACMA",2
10,"10164",742,513,508,1,5,"PACMA",1
10,"10070",720,548,540,0,8,"PACMA",2
10,"10021",5198,3960,3878,40,82,"PACMA",16
10,"10064",1490,1142,1119,9,23,"PACMA",6
10,"10186",994,830,816,4,14,"PACMA",1
10,"10190",561,401,397,2,4,"PACMA",0
10,"10049",3849,3185,3111,27,74,"PACMA",15
10,"10198",1160,1022,1009,6,13,"PACMA",0
10,"10174",175,141,139,0,2,"PACMA",3
10,"10187",443,316,311,1,5,"PACMA",5
10,"10079",901,703,695,2,8,"PACMA",1
10,"10066",158,128,127,1,1,"PACMA",2
10,"10212",1691,1303,1280,8,23,"PACMA",9
10,"10016",329,262,259,1,3,"PACMA",2
10,"10099",592,417,413,7,4,"PACMA",0
10,"10156",96,71,70,1,1,"PACMA",0
10,"10192",841,592,584,0,8,"PACMA",0
10,"10131",12850,9036,8977,44,59,"PACMA",75
10,"10057",150,112,111,0,1,"PACMA",0
10,"10132",400,258,256,0,2,"PACMA",0
10,"10139",111,84,83,0,1,"PACMA",0
10,"10086",329,259,256,1,3,"PACMA",1
10,"10004",713,551,543,1,8,"PACMA",0
10,"10077",689,511,504,2,7,"PACMA",0
10,"10166",307,220,219,0,1,"PACMA",2
10,"10162",579,483,476,0,7,"PACMA",0
10,"10001",285,226,225,2,1,"PACMA",0
10,"10195",7768,5818,5723,58,95,"PACMA",17
10,"10023",846,647,637,1,10,"PACMA",0
10,"10007",646,488,478,3,10,"PACMA",0
10,"10120",176,125,125,2,0,"PACMA",0
10,"10095",350,269,267,1,2,"PACMA",0
10,"10027",78,66,66,0,0,"PACMA",0
10,"10039",427,295,290,0,5,"PACMA",1
10,"10065",205,154,154,1,0,"PACMA",1
10,"10151",213,163,161,0,2,"PACMA",0
10,"10082",1893,1528,1484,13,44,"PACMA",3
10,"10091",378,304,304,0,0,"PACMA",0
10,"10144",996,755,748,3,7,"PACMA",1
10,"10003",557,401,396,2,5,"PACMA",2
10,"10184",778,620,610,6,10,"PACMA",0
10,"10215",442,320,320,0,0,"PACMA",0
10,"10106",134,111,111,1,0,"PACMA",0
10,"10015",687,500,491,2,9,"PACMA",4
10,"10129",363,272,266,4,6,"PACMA",2
10,"10143",158,121,121,0,0,"PACMA",1
10,"10094",232,203,203,3,0,"PACMA",0
10,"10214",208,172,170,0,2,"PACMA",0
10,"10206",212,161,160,3,1,"PACMA",0
10,"10142",824,620,616,5,4,"PACMA",1
10,"10048",245,163,161,1,2,"PACMA",0
10,"10182",129,95,95,0,0,"PACMA",0
10,"10216",1543,1200,1192,9,8,"PACMA",4
10,"10155",1140,856,842,3,14,"PACMA",2
10,"10037",76403,58422,57811,329,611,"PACMA",525
10,"10107",1033,825,815,11,10,"PACMA",0
10,"10111",1364,995,978,9,17,"PACMA",4
10,"10202",621,495,478,2,17,"PACMA",0
10,"10019",1510,1134,1121,8,13,"PACMA",4
10,"10089",1376,1004,988,2,16,"PACMA",5
10,"10159",323,235,232,2,3,"PACMA",0
10,"10146",1509,1018,1004,4,14,"PACMA",3
10,"10135",1329,981,958,1,23,"PACMA",1
10,"10905",651,458,456,0,2,"PACMA",3
10,"10053",289,231,224,1,7,"PACMA",1
10,"10113",2354,1800,1778,20,22,"PACMA",9
10,"10061",1664,1143,1131,8,12,"PACMA",2
10,"10133",1210,1007,989,2,18,"PACMA",1
10,"10031",167,138,137,1,1,"PACMA",1
10,"10141",268,190,189,2,1,"PACMA",0
10,"10127",4724,3529,3463,15,66,"PACMA",22
10,"10175",1434,1054,1028,7,26,"PACMA",5
10,"10025",402,341,328,2,13,"PACMA",1
10,"10138",544,445,437,2,8,"PACMA",0
10,"10102",531,413,410,4,3,"PACMA",1
10,"10123",585,480,468,1,12,"PACMA",0
10,"10137",399,344,343,4,1,"PACMA",1
10,"10119",630,461,455,2,6,"PACMA",2
10,"10114",968,721,711,4,10,"PACMA",7
10,"10047",972,783,777,1,6,"PACMA",4
10,"10055",719,554,546,3,8,"PACMA",0
10,"10125",903,648,638,2,10,"PACMA",2
10,"10173",581,432,426,4,6,"PACMA",0
10,"10196",306,234,233,1,1,"PACMA",2
10,"10176",374,274,268,1,6,"PACMA",0
10,"10901",1184,851,835,2,16,"PACMA",6
10,"10163",356,302,299,1,3,"PACMA",0
10,"10194",536,441,433,5,8,"PACMA",2
10,"10218",1143,828,814,2,14,"PACMA",1
10,"10013",282,228,223,2,5,"PACMA",0
10,"10103",454,342,338,1,4,"PACMA",6
10,"10011",570,450,443,2,7,"PACMA",1
9,"9434",1221,985,970,10,15,"PODEMOS",203
9,"9302",116,87,87,0,0,"PODEMOS",10
9,"9308",67,43,43,1,0,"PODEMOS",5
9,"9391",361,264,263,2,1,"PODEMOS",12
9,"9169",99,83,81,0,2,"PODEMOS",6
9,"9353",73,57,56,0,1,"PODEMOS",14
9,"9155",26,20,20,1,0,"PODEMOS",0
9,"9030",109,76,76,3,0,"PODEMOS",2
9,"9182",78,63,61,2,2,"PODEMOS",3
9,"9292",92,72,70,0,2,"PODEMOS",10
9,"9304",202,166,163,1,3,"PODEMOS",10
9,"9396",152,118,118,1,0,"PODEMOS",14
9,"9256",362,261,255,2,6,"PODEMOS",27
9,"9248",78,57,57,0,0,"PODEMOS",5
9,"9017",89,67,62,0,5,"PODEMOS",1
9,"9392",53,40,40,0,0,"PODEMOS",10
9,"9261",463,339,330,8,9,"PODEMOS",41
9,"9421",237,172,172,2,0,"PODEMOS",26
9,"9063",213,184,182,2,2,"PODEMOS",13
9,"9211",1462,1086,1070,11,16,"PODEMOS",105
9,"9413",447,333,333,5,0,"PODEMOS",54
9,"9378",31,21,21,1,0,"PODEMOS",2
9,"9163",602,479,472,5,7,"PODEMOS",60
9,"9046",30,26,26,0,0,"PODEMOS",3
9,"9247",23,19,19,0,0,"PODEMOS",1
9,"9133",40,34,34,0,0,"PODEMOS",9
9,"9411",149,111,111,0,0,"PODEMOS",22
9,"9389",77,56,56,0,0,"PODEMOS",7
9,"9137",167,128,128,1,0,"PODEMOS",15
9,"9082",40,35,35,0,0,"PODEMOS",1
9,"9251",371,273,271,3,2,"PODEMOS",55
9,"9168",296,233,231,1,2,"PODEMOS",17
9,"9039",58,38,38,0,0,"PODEMOS",1
9,"9270",163,122,121,1,1,"PODEMOS",7
9,"9274",1098,880,872,9,8,"PODEMOS",118
9,"9140",128,88,87,0,1,"PODEMOS",7
9,"9375",35,27,27,0,0,"PODEMOS",2
9,"9386",58,44,43,2,1,"PODEMOS",4
9,"9084",189,150,148,7,2,"PODEMOS",20
9,"9415",267,166,165,0,1,"PODEMOS",9
9,"9023",1096,848,840,9,8,"PODEMOS",172
9,"9060",148,123,123,0,0,"PODEMOS",14
9,"9035",313,243,240,0,3,"PODEMOS",54
9,"9052",31,22,21,1,1,"PODEMOS",1
9,"9288",91,70,69,1,1,"PODEMOS",8
9,"9128",82,66,66,0,0,"PODEMOS",12
9,"9275",192,138,137,1,1,"PODEMOS",15
9,"9189",130,88,86,2,2,"PODEMOS",11
9,"9350",480,358,347,5,11,"PODEMOS",18
9,"9047",56,45,45,2,0,"PODEMOS",8
9,"9051",168,133,132,1,1,"PODEMOS",13
9,"9400",317,258,256,3,2,"PODEMOS",60
9,"9441",74,66,66,0,0,"PODEMOS",2
9,"9127",55,40,40,0,0,"PODEMOS",4
9,"9134",228,152,152,2,0,"PODEMOS",41
9,"9317",16,14,14,0,0,"PODEMOS",8
9,"9446",12,7,7,0,0,"PODEMOS",0
9,"9449",87,72,71,1,1,"PODEMOS",2
9,"9414",201,148,147,1,1,"PODEMOS",12
9,"9048",1484,1120,1106,4,14,"PODEMOS",174
9,"9086",687,475,471,0,4,"PODEMOS",72
9,"9454",47,34,34,0,0,"PODEMOS",5
9,"9417",40,30,30,0,0,"PODEMOS",0
9,"9250",273,218,218,4,0,"PODEMOS",19
9,"9337",115,84,82,0,2,"PODEMOS",15
9,"9180",136,102,100,2,2,"PODEMOS",16
9,"9259",233,184,184,3,0,"PODEMOS",16
9,"9246",622,458,455,5,3,"PODEMOS",91
9,"9194",2024,1550,1530,17,20,"PODEMOS",234
9,"9451",238,199,198,1,1,"PODEMOS",34
9,"9249",47,37,37,1,0,"PODEMOS",5
9,"9160",90,71,70,0,1,"PODEMOS",6
9,"9075",111,83,83,1,0,"PODEMOS",13
9,"9235",160,124,123,0,1,"PODEMOS",22
9,"9338",219,173,171,1,2,"PODEMOS",32
9,"9141",610,499,493,4,6,"PODEMOS",77
9,"9277",119,101,100,0,1,"PODEMOS",33
9,"9334",48,39,38,0,1,"PODEMOS",9
9,"9199",91,65,65,2,0,"PODEMOS",9
9,"9014",213,127,126,1,1,"PODEMOS",22
9,"9231",70,49,49,3,0,"PODEMOS",2
9,"9369",442,331,328,1,3,"PODEMOS",42
9,"9418",82,63,62,3,1,"PODEMOS",2
9,"9125",596,435,433,3,2,"PODEMOS",42
9,"9132",173,132,130,0,2,"PODEMOS",13
9,"9139",101,75,73,2,2,"PODEMOS",10
9,"9043",189,132,132,2,0,"PODEMOS",14
9,"9136",192,151,147,2,4,"PODEMOS",30
9,"9444",72,48,48,2,0,"PODEMOS",2
9,"9170",203,152,149,1,3,"PODEMOS",18
9,"9175",129,92,92,0,0,"PODEMOS",11
9,"9213",320,223,220,4,3,"PODEMOS",43
9,"9066",65,51,51,0,0,"PODEMOS",10
9,"9151",458,364,363,3,1,"PODEMOS",59
9,"9020",262,187,180,2,7,"PODEMOS",9
9,"9012",93,68,66,1,2,"PODEMOS",3
9,"9088",66,44,42,1,2,"PODEMOS",8
9,"9429",56,41,41,0,0,"PODEMOS",6
9,"9294",111,88,86,0,2,"PODEMOS",11
9,"9382",33,30,29,1,1,"PODEMOS",0
9,"9327",25,22,22,0,0,"PODEMOS",4
9,"9242",81,65,63,2,2,"PODEMOS",2
9,"9144",52,40,40,0,0,"PODEMOS",0
9,"9093",154,133,128,1,5,"PODEMOS",15
9,"9301",616,513,506,5,7,"PODEMOS",90
9,"9269",39,33,32,0,1,"PODEMOS",3
9,"9176",61,45,44,0,1,"PODEMOS",6
9,"9016",85,64,64,2,0,"PODEMOS",8
9,"9067",442,308,303,9,5,"PODEMOS",23
9,"9255",86,66,62,0,4,"PODEMOS",6
9,"9343",97,70,69,0,1,"PODEMOS",5
9,"9021",56,33,31,0,2,"PODEMOS",7
9,"9018",24702,18365,18158,174,207,"PODEMOS",3004
9,"9455",44,34,33,0,1,"PODEMOS",1
9,"9177",1117,830,825,5,5,"PODEMOS",125
9,"9166",97,79,78,3,1,"PODEMOS",6
9,"9218",360,272,271,2,1,"PODEMOS",25
9,"9041",28,28,28,1,0,"PODEMOS",5
9,"9149",34,25,24,0,1,"PODEMOS",1
9,"9463",262,206,206,3,0,"PODEMOS",26
9,"9266",91,72,70,0,2,"PODEMOS",2
9,"9419",78,45,44,0,1,"PODEMOS",2
9,"9328",77,55,55,1,0,"PODEMOS",0
9,"9090",57,51,51,1,0,"PODEMOS",7
9,"9257",92,80,78,4,2,"PODEMOS",5
9,"9174",809,575,565,10,10,"PODEMOS",77
9,"9287",208,170,168,2,2,"PODEMOS",38
9,"9253",111,96,94,1,2,"PODEMOS",11
9,"9329",123,86,86,1,0,"PODEMOS",18
9,"9339",128,103,103,0,0,"PODEMOS",14
9,"9059",136713,106605,105601,976,1004,"PODEMOS",17945
9,"9091",732,516,512,7,4,"PODEMOS",40
9,"9373",440,285,282,3,3,"PODEMOS",19
9,"9258",173,139,136,4,3,"PODEMOS",5
9,"9070",34,31,30,3,1,"PODEMOS",8
9,"9197",148,108,104,1,4,"PODEMOS",19
9,"9178",52,36,36,1,0,"PODEMOS",5
9,"9448",216,180,178,1,2,"PODEMOS",17
9,"9387",118,96,95,0,1,"PODEMOS",24
9,"9346",93,71,69,0,2,"PODEMOS",8
9,"9179",43,35,34,0,1,"PODEMOS",5
9,"9330",1523,1166,1148,15,18,"PODEMOS",206
9,"9083",37,33,33,0,0,"PODEMOS",4
9,"9374",90,79,77,2,2,"PODEMOS",10
9,"9425",514,369,366,2,3,"PODEMOS",79
9,"9466",134,99,99,0,0,"PODEMOS",4
9,"9347",141,113,109,4,4,"PODEMOS",23
9,"9024",156,117,114,0,3,"PODEMOS",21
9,"9229",201,146,145,0,1,"PODEMOS",12
9,"9306",113,91,91,1,0,"PODEMOS",9
9,"9427",1428,1014,1003,12,11,"PODEMOS",114
9,"9332",140,107,107,1,0,"PODEMOS",12
9,"9221",445,337,335,1,2,"PODEMOS",84
9,"9013",47,41,41,0,0,"PODEMOS",6
9,"9061",166,124,123,1,1,"PODEMOS",3
9,"9050",72,54,54,0,0,"PODEMOS",18
9,"9467",66,46,46,3,0,"PODEMOS",2
9,"9209",4511,3368,3301,37,67,"PODEMOS",594
9,"9223",46,39,39,0,0,"PODEMOS",6
9,"9348",146,116,114,1,2,"PODEMOS",14
9,"9094",51,42,41,0,1,"PODEMOS",3
9,"9450",27,21,20,1,1,"PODEMOS",4
9,"9085",475,352,350,2,2,"PODEMOS",52
9,"9398",75,54,54,1,0,"PODEMOS",2
9,"9019",147,103,102,1,1,"PODEMOS",11
9,"9219",27590,19903,19724,166,179,"PODEMOS",4754
9,"9262",161,129,129,0,0,"PODEMOS",10
9,"9416",52,39,39,0,0,"PODEMOS",20
9,"9227",119,97,95,0,2,"PODEMOS",15
9,"9303",92,72,71,0,1,"PODEMOS",4
9,"9390",611,478,477,3,1,"PODEMOS",60
9,"9062",51,44,44,1,0,"PODEMOS",5
9,"9224",157,122,122,0,0,"PODEMOS",7
9,"9471",151,117,117,0,0,"PODEMOS",28
9,"9377",625,478,471,5,7,"PODEMOS",49
9,"9280",27,17,17,0,0,"PODEMOS",0
9,"9129",105,87,87,0,0,"PODEMOS",9
9,"9026",397,314,311,1,3,"PODEMOS",45
9,"9172",125,102,102,2,0,"PODEMOS",12
9,"9102",37,31,31,0,0,"PODEMOS",3
9,"9130",79,63,62,1,1,"PODEMOS",7
9,"9225",84,57,56,1,1,"PODEMOS",2
9,"9265",38,31,31,0,0,"PODEMOS",1
9,"9103",221,185,184,2,1,"PODEMOS",20
9,"9027",47,44,41,0,3,"PODEMOS",14
9,"9430",24,19,19,0,0,"PODEMOS",0
9,"9173",123,93,93,1,0,"PODEMOS",1
9,"9380",78,59,57,0,2,"PODEMOS",6
9,"9100",59,51,50,0,1,"PODEMOS",3
9,"9295",60,37,37,0,0,"PODEMOS",4
9,"9309",306,216,211,2,5,"PODEMOS",36
9,"9351",60,46,45,1,1,"PODEMOS",3
9,"9131",460,381,373,5,8,"PODEMOS",71
9,"9215",377,264,260,0,4,"PODEMOS",57
9,"9226",66,55,53,0,2,"PODEMOS",4
9,"9029",168,134,132,3,2,"PODEMOS",29
9,"9325",195,125,123,2,2,"PODEMOS",11
9,"9473",85,62,61,1,1,"PODEMOS",6
9,"9064",332,275,275,3,0,"PODEMOS",22
9,"9297",323,265,261,5,4,"PODEMOS",21
9,"9289",1466,1027,1013,6,14,"PODEMOS",132
9,"9381",32,23,22,0,1,"PODEMOS",2
9,"9352",116,97,97,0,0,"PODEMOS",2
9,"9055",52,39,38,0,1,"PODEMOS",4
9,"9431",119,99,98,0,1,"PODEMOS",10
9,"9181",302,231,225,3,6,"PODEMOS",23
9,"9065",147,124,123,2,1,"PODEMOS",24
9,"9456",129,90,90,2,0,"PODEMOS",5
9,"9307",113,91,91,0,0,"PODEMOS",8
9,"9298",82,62,62,0,0,"PODEMOS",4
9,"9143",27,20,20,0,0,"PODEMOS",3
9,"9105",107,88,86,0,2,"PODEMOS",17
9,"9268",95,73,72,0,1,"PODEMOS",13
9,"9432",189,143,140,1,3,"PODEMOS",31
9,"9216",385,283,280,8,3,"PODEMOS",48
9,"9464",36,24,24,0,0,"PODEMOS",0
9,"9032",108,73,73,0,0,"PODEMOS",7
9,"9395",136,96,95,0,1,"PODEMOS",11
9,"9056",4931,3634,3602,35,32,"PODEMOS",586
9,"9433",60,52,51,0,1,"PODEMOS",12
9,"9458",466,380,377,3,3,"PODEMOS",98
9,"9340",76,49,49,0,0,"PODEMOS",4
9,"9422",18,10,10,0,0,"PODEMOS",0
9,"9044",46,38,37,0,1,"PODEMOS",1
9,"9108",378,290,287,2,3,"PODEMOS",67
9,"9148",86,73,69,5,4,"PODEMOS",12
9,"9057",144,116,115,0,1,"PODEMOS",28
9,"9354",33,30,30,1,0,"PODEMOS",3
9,"9054",100,73,72,3,1,"PODEMOS",14
9,"9190",91,56,55,0,1,"PODEMOS",13
9,"9033",89,75,75,0,0,"PODEMOS",7
9,"9109",1068,698,669,10,29,"PODEMOS",272
9,"9480",110,89,88,1,1,"PODEMOS",6
9,"9423",27,25,25,0,0,"PODEMOS",1
9,"9384",293,199,194,0,5,"PODEMOS",20
9,"9068",29,23,22,0,1,"PODEMOS",4
9,"9058",393,293,289,2,4,"PODEMOS",62
9,"9355",101,75,73,0,2,"PODEMOS",1
9,"9135",41,33,33,1,0,"PODEMOS",2
9,"9412",803,552,550,2,2,"PODEMOS",103
9,"9191",39,32,30,0,2,"PODEMOS",4
9,"9230",38,31,31,0,0,"PODEMOS",1
9,"9034",280,237,233,5,4,"PODEMOS",13
9,"9022",67,57,57,1,0,"PODEMOS",6
9,"9345",124,92,92,0,0,"PODEMOS",13
9,"9104",54,43,43,0,0,"PODEMOS",2
9,"9356",42,31,31,0,0,"PODEMOS",3
9,"9095",86,62,62,0,0,"PODEMOS",2
9,"9267",115,101,100,3,1,"PODEMOS",2
9,"9424",32,26,26,1,0,"PODEMOS",1
9,"9272",294,206,203,1,3,"PODEMOS",25
9,"9192",55,47,46,0,1,"PODEMOS",20
9,"9447",42,38,38,0,0,"PODEMOS",3
9,"9315",379,269,267,2,2,"PODEMOS",60
9,"9437",286,227,226,5,1,"PODEMOS",11
9,"9208",211,139,136,3,3,"PODEMOS",15
9,"9358",249,191,191,1,0,"PODEMOS",22
9,"9438",544,446,444,3,2,"PODEMOS",53
9,"9483",212,161,161,1,0,"PODEMOS",14
9,"9112",113,75,73,2,2,"PODEMOS",5
9,"9316",104,83,80,1,3,"PODEMOS",4
9,"9071",45,34,34,0,0,"PODEMOS",5
9,"9388",36,31,30,1,1,"PODEMOS",6
9,"9098",516,396,388,6,8,"PODEMOS",55
9,"9220",76,62,61,2,1,"PODEMOS",9
9,"9485",55,43,43,1,0,"PODEMOS",0
9,"9273",53,41,40,1,1,"PODEMOS",9
9,"9403",96,78,76,1,2,"PODEMOS",2
9,"9439",1005,823,816,9,7,"PODEMOS",166
9,"9360",30,27,27,0,0,"PODEMOS",4
9,"9232",151,125,124,2,1,"PODEMOS",6
9,"9152",263,193,192,0,1,"PODEMOS",17
9,"9036",38,31,30,2,1,"PODEMOS",4
9,"9195",57,42,42,2,0,"PODEMOS",7
9,"9113",464,383,376,6,7,"PODEMOS",61
9,"9154",142,104,104,2,0,"PODEMOS",11
9,"9361",117,96,96,0,0,"PODEMOS",12
9,"9901",374,268,261,3,7,"PODEMOS",28
9,"9138",90,73,72,0,1,"PODEMOS",2
9,"9037",113,96,96,0,0,"PODEMOS",17
9,"9072",307,240,239,1,1,"PODEMOS",38
9,"9318",61,38,38,0,0,"PODEMOS",4
9,"9405",128,89,89,0,0,"PODEMOS",4
9,"9025",125,86,79,1,7,"PODEMOS",9
9,"9406",252,196,195,1,1,"PODEMOS",69
9,"9073",926,753,748,10,5,"PODEMOS",154
9,"9440",96,78,78,0,0,"PODEMOS",9
9,"9114",87,67,67,0,0,"PODEMOS",6
9,"9101",79,59,59,0,0,"PODEMOS",3
9,"9236",38,32,32,0,0,"PODEMOS",1
9,"9428",107,87,87,0,0,"PODEMOS",6
9,"9196",154,108,107,1,1,"PODEMOS",15
9,"9362",204,168,164,0,4,"PODEMOS",29
9,"9038",118,97,94,0,3,"PODEMOS",14
9,"9074",788,609,598,8,11,"PODEMOS",101
9,"9902",461,347,339,1,8,"PODEMOS",65
9,"9159",56,48,48,1,0,"PODEMOS",3
9,"9321",1640,1250,1237,5,13,"PODEMOS",106
9,"9115",92,69,68,0,1,"PODEMOS",9
9,"9407",27,23,23,1,0,"PODEMOS",6
9,"9903",3251,2359,2340,24,19,"PODEMOS",392
9,"9335",87,72,71,0,1,"PODEMOS",15
9,"9238",932,576,569,6,7,"PODEMOS",82
9,"9001",27,26,26,0,0,"PODEMOS",1
9,"9276",387,280,273,2,7,"PODEMOS",109
9,"9214",684,452,446,6,6,"PODEMOS",105
9,"9363",974,730,725,3,5,"PODEMOS",63
9,"9183",51,37,37,0,0,"PODEMOS",3
9,"9408",41,34,34,1,0,"PODEMOS",2
9,"9003",192,148,146,2,2,"PODEMOS",35
9,"9472",55,40,40,0,0,"PODEMOS",3
9,"9442",380,287,282,2,5,"PODEMOS",30
9,"9198",108,86,85,2,1,"PODEMOS",12
9,"9117",77,61,57,0,4,"PODEMOS",1
9,"9365",31,20,20,0,0,"PODEMOS",2
9,"9323",64,47,47,0,0,"PODEMOS",8
9,"9904",482,389,384,5,5,"PODEMOS",48
9,"9310",13,9,8,0,1,"PODEMOS",1
9,"9006",61,41,41,0,0,"PODEMOS",6
9,"9239",53,44,42,1,2,"PODEMOS",1
9,"9184",5,4,4,0,0,"PODEMOS",1
9,"9119",46,27,27,0,0,"PODEMOS",3
9,"9409",109,87,87,0,0,"PODEMOS",21
9,"9443",183,132,129,1,3,"PODEMOS",16
9,"9394",727,558,552,8,6,"PODEMOS",91
9,"9905",391,308,308,5,0,"PODEMOS",79
9,"9162",143,108,108,0,0,"PODEMOS",37
9,"9279",177,130,130,0,0,"PODEMOS",9
9,"9076",23,14,14,0,0,"PODEMOS",1
9,"9200",48,37,36,0,1,"PODEMOS",3
9,"9311",60,52,50,0,2,"PODEMOS",12
9,"9120",39,35,35,0,0,"PODEMOS",3
9,"9241",201,156,155,3,1,"PODEMOS",26
9,"9366",90,64,63,1,1,"PODEMOS",6
9,"9326",148,115,113,2,2,"PODEMOS",16
9,"9476",63,46,46,0,0,"PODEMOS",6
9,"9007",59,41,41,0,0,"PODEMOS",0
9,"9410",3051,2169,2153,18,16,"PODEMOS",618
9,"9077",36,26,26,1,0,"PODEMOS",3
9,"9368",22,14,14,1,0,"PODEMOS",0
9,"9906",1223,952,947,9,5,"PODEMOS",131
9,"9478",45,38,38,0,0,"PODEMOS",6
9,"9445",44,32,32,1,0,"PODEMOS",5
9,"9122",96,66,66,0,0,"PODEMOS",3
9,"9217",361,265,261,4,4,"PODEMOS",49
9,"9201",30,17,17,0,0,"PODEMOS",2
9,"9009",163,130,128,2,2,"PODEMOS",13
9,"9312",98,83,82,0,1,"PODEMOS",12
9,"9281",147,109,107,0,2,"PODEMOS",7
9,"9228",163,138,138,0,0,"PODEMOS",13
9,"9078",41,35,33,0,2,"PODEMOS",0
9,"9460",177,135,135,2,0,"PODEMOS",13
9,"9164",165,121,121,1,0,"PODEMOS",13
9,"9202",24,22,22,1,0,"PODEMOS",0
9,"9907",1420,1120,1115,13,5,"PODEMOS",236
9,"9079",46,40,37,0,3,"PODEMOS",0
9,"9045",267,186,183,2,3,"PODEMOS",35
9,"9314",95,80,79,1,1,"PODEMOS",6
9,"9243",75,56,54,1,2,"PODEMOS",8
9,"9123",40,35,35,0,0,"PODEMOS",6
9,"9908",469,314,309,2,5,"PODEMOS",75
9,"9244",47,26,26,1,0,"PODEMOS",5
9,"9010",32,23,23,2,0,"PODEMOS",0
9,"9283",46,29,28,0,1,"PODEMOS",2
9,"9482",34,29,28,0,1,"PODEMOS",4
9,"9206",61,52,50,3,2,"PODEMOS",1
9,"9110",80,49,49,1,0,"PODEMOS",1
9,"9011",69,49,49,0,0,"PODEMOS",5
9,"9124",1520,1113,1096,9,17,"PODEMOS",145
9,"9372",221,190,189,1,1,"PODEMOS",32
9,"9167",59,42,42,2,0,"PODEMOS",5
1,"1060",199,162,159,0,3,"PACMA",1
1,"1014",372,292,284,1,8,"PACMA",3
1,"1008",790,548,542,13,6,"PACMA",6
1,"1061",153,132,132,2,0,"PACMA",0
1,"1020",326,232,228,0,4,"PACMA",0
1,"1003",1186,842,833,19,9,"PACMA",2
1,"1047",964,713,702,13,11,"PACMA",8
1,"1016",439,255,249,3,6,"PACMA",0
1,"1019",144,112,111,2,1,"PACMA",0
1,"1018",1370,964,963,4,1,"PACMA",6
1,"1044",236,189,187,1,2,"PACMA",0
1,"1059",186354,135873,134633,948,1240,"PACMA",1099
1,"1056",218,141,140,1,1,"PACMA",1
1,"1049",140,108,108,0,0,"PACMA",0
1,"1032",522,368,361,0,7,"PACMA",2
1,"1037",586,425,419,2,6,"PACMA",1
1,"1023",269,197,195,2,2,"PACMA",0
1,"1039",202,161,156,0,5,"PACMA",0
1,"1028",1077,759,753,6,6,"PACMA",7
1,"1036",15034,10733,10619,73,114,"PACMA",68
1,"1004",1405,1026,1010,7,16,"PACMA",2
1,"1002",8139,5961,5878,32,83,"PACMA",30
1,"1022",805,593,587,3,6,"PACMA",3
1,"1052",244,188,186,1,2,"PACMA",0
1,"1902",738,537,528,4,9,"PACMA",6
1,"1001",1984,1426,1405,8,21,"PACMA",15
1,"1010",2275,1729,1717,17,12,"PACMA",10
1,"1057",245,203,202,0,1,"PACMA",1
1,"1055",836,564,552,8,12,"PACMA",2
1,"1033",649,512,508,5,4,"PACMA",4
1,"1901",2344,1688,1669,17,19,"PACMA",18
1,"1006",176,142,141,1,1,"PACMA",1
1,"1034",165,120,119,1,1,"PACMA",0
1,"1053",587,367,365,3,2,"PACMA",2
1,"1062",314,215,215,3,0,"PACMA",1
1,"1009",1281,908,898,2,10,"PACMA",6
1,"1041",153,105,100,1,5,"PACMA",1
1,"1027",416,268,268,0,0,"PACMA",4
1,"1013",711,486,483,3,3,"PACMA",4
1,"1046",594,445,435,3,10,"PACMA",3
1,"1021",460,336,332,1,4,"PACMA",6
1,"1058",1327,843,833,8,10,"PACMA",7
1,"1043",2318,1644,1624,8,20,"PACMA",9
1,"1031",1183,907,885,6,22,"PACMA",8
1,"1030",159,126,123,1,3,"PACMA",1
1,"1063",1799,1320,1309,10,11,"PACMA",3
1,"1042",901,653,650,11,3,"PACMA",6
1,"1051",3606,2413,2389,21,24,"PACMA",19
1,"1054",952,694,688,4,6,"PACMA",0
1,"1017",869,584,577,4,7,"PACMA",4
1,"1011",237,177,175,7,2,"PACMA",0
23,"23037",516,427,423,1,4,"UPYD",1
23,"23004",435,350,346,0,4,"UPYD",0
23,"23086",11537,8362,8242,91,120,"UPYD",20
23,"23001",993,826,820,1,6,"UPYD",1
23,"23055",47421,33170,32908,213,262,"UPYD",135
23,"23016",396,323,318,3,5,"UPYD",0
23,"23091",742,609,607,5,2,"UPYD",0
23,"23087",11313,8540,8454,64,86,"UPYD",34
23,"23093",3257,2534,2506,21,28,"UPYD",7
23,"23006",4636,3761,3714,25,47,"UPYD",4
23,"23069",5385,4406,4318,15,88,"UPYD",10
23,"23057",771,648,648,4,0,"UPYD",1
23,"23017",1584,1265,1253,4,12,"UPYD",3
23,"23082",1924,1420,1413,6,7,"UPYD",4
23,"23014",2561,1982,1959,8,23,"UPYD",2
23,"23098",875,728,722,2,6,"UPYD",1
23,"23094",3852,3097,3061,17,36,"UPYD",5
23,"23062",1461,1188,1181,1,7,"UPYD",0
23,"23047",1638,1311,1306,9,5,"UPYD",1
23,"23026",3636,2724,2685,11,39,"UPYD",2
23,"23071",1728,1337,1328,7,9,"UPYD",5
23,"23066",4376,3530,3508,46,22,"UPYD",18
23,"23092",27765,20688,20560,143,128,"UPYD",86
23,"23021",528,452,448,0,4,"UPYD",0
23,"23058",8665,6651,6585,47,66,"UPYD",14
23,"23060",19157,13567,13438,133,129,"UPYD",45
23,"23025",2813,2186,2163,7,23,"UPYD",4
23,"23048",860,636,630,1,6,"UPYD",0
23,"23038",3557,2851,2831,11,20,"UPYD",14
23,"23043",549,401,400,0,1,"UPYD",0
23,"23064",1659,1368,1364,1,4,"UPYD",2
23,"23010",14371,10249,10140,65,109,"UPYD",26
23,"23905",1861,1351,1345,7,6,"UPYD",2
23,"23012",4177,3016,2988,22,28,"UPYD",8
23,"23070",3931,2549,2533,11,16,"UPYD",6
23,"23034",2558,1987,1977,18,10,"UPYD",3
23,"23030",1232,1020,1007,10,13,"UPYD",2
23,"23059",5856,4498,4450,33,48,"UPYD",10
23,"23084",953,711,708,6,3,"UPYD",0
23,"23056",3108,2365,2343,14,22,"UPYD",8
23,"23088",6124,4764,4703,31,61,"UPYD",9
23,"23902",2327,1877,1857,9,20,"UPYD",2
23,"23076",837,672,658,4,14,"UPYD",1
23,"23096",2643,2174,2140,14,34,"UPYD",5
23,"23046",2405,1963,1934,3,29,"UPYD",2
23,"23050",91221,67753,67164,549,589,"UPYD",415
23,"23051",2762,2258,2231,9,27,"UPYD",6
23,"23065",1601,1222,1207,0,15,"UPYD",1
23,"23067",2489,1869,1847,18,22,"UPYD",11
23,"23040",1489,1226,1211,4,15,"UPYD",1
23,"23033",1356,1080,1065,8,15,"UPYD",0
23,"23079",3733,2994,2981,26,13,"UPYD",1
23,"23049",1834,1384,1378,7,6,"UPYD",3
23,"23007",3102,2381,2369,8,12,"UPYD",3
23,"23097",6445,4313,4290,30,23,"UPYD",17
23,"23075",3319,2640,2618,21,22,"UPYD",3
23,"23095",8737,6303,6268,34,35,"UPYD",20
23,"23080",1786,1347,1329,6,18,"UPYD",0
23,"23061",7520,5481,5405,55,76,"UPYD",12
23,"23003",8709,6520,6440,42,80,"UPYD",15
23,"23031",751,662,650,9,12,"UPYD",1
23,"23028",6203,4645,4585,33,60,"UPYD",18
23,"23901",1160,978,972,5,6,"UPYD",2
23,"23099",4734,3509,3459,23,50,"UPYD",7
23,"23027",727,577,576,8,1,"UPYD",0
23,"23052",1138,977,971,6,6,"UPYD",0
23,"23002",17450,13199,12986,92,213,"UPYD",38
23,"23015",1393,1061,1052,3,9,"UPYD",0
23,"23063",3845,2934,2898,24,36,"UPYD",4
23,"23032",575,461,457,1,4,"UPYD",1
23,"23045",2139,1560,1551,9,9,"UPYD",0
23,"23009",12866,9787,9667,64,120,"UPYD",23
23,"23077",637,515,514,3,1,"UPYD",0
23,"23054",382,276,275,0,1,"UPYD",0
23,"23044",4847,3801,3740,26,61,"UPYD",12
23,"23005",30539,21840,21629,176,211,"UPYD",69
23,"23024",12512,9391,9182,79,209,"UPYD",28
23,"23903",3550,2742,2721,19,21,"UPYD",6
23,"23008",1518,1185,1173,18,12,"UPYD",2
23,"23019",1562,1249,1227,4,22,"UPYD",10
23,"23090",1316,1077,1071,8,6,"UPYD",2
23,"23053",9526,6783,6736,49,47,"UPYD",11
23,"23081",1546,1145,1132,6,13,"UPYD",3
23,"23029",854,631,623,2,8,"UPYD",0
23,"23085",2273,1833,1814,3,19,"UPYD",0
23,"23101",388,281,279,0,2,"UPYD",0
23,"23904",2852,1784,1764,14,20,"UPYD",3
23,"23011",2193,1616,1600,11,16,"UPYD",5
23,"23074",3030,2368,2353,12,15,"UPYD",3
23,"23018",2326,1678,1668,5,10,"UPYD",0
23,"23073",4558,3427,3402,11,25,"UPYD",6
23,"23035",1095,871,867,8,4,"UPYD",1
23,"23039",2220,1658,1626,8,32,"UPYD",4
23,"23020",1584,1376,1366,5,10,"UPYD",4
23,"23041",504,396,392,1,4,"UPYD",1
23,"23042",299,220,220,1,0,"UPYD",1
23,"23072",2002,1593,1582,6,11,"UPYD",2
37,"37307",160,103,103,0,0,"PACMA",2
37,"37125",228,158,156,3,2,"PACMA",0
37,"37195",48,35,35,1,0,"PACMA",0
37,"37121",584,434,430,5,4,"PACMA",1
37,"37136",667,453,448,2,5,"PACMA",1
37,"37026",192,158,154,2,4,"PACMA",0
37,"37034",84,66,66,3,0,"PACMA",0
37,"37041",74,48,48,0,0,"PACMA",0
37,"37364",836,598,583,6,15,"PACMA",0
37,"37309",45,28,28,0,0,"PACMA",0
37,"37006",135,91,90,1,1,"PACMA",0
37,"37077",260,234,230,0,4,"PACMA",0
37,"37323",521,387,385,8,2,"PACMA",0
37,"37288",258,211,210,7,1,"PACMA",2
37,"37261",227,165,161,2,4,"PACMA",0
37,"37135",1211,932,925,10,7,"PACMA",2
37,"37162",206,151,149,2,2,"PACMA",0
37,"37083",179,159,159,0,0,"PACMA",2
37,"37278",753,573,568,7,5,"PACMA",8
37,"37114",88,67,66,1,1,"PACMA",0
37,"37226",156,121,119,1,2,"PACMA",0
37,"37203",165,118,118,0,0,"PACMA",0
37,"37031",365,258,257,1,1,"PACMA",0
37,"37341",56,43,41,0,2,"PACMA",1
37,"37009",216,161,160,3,1,"PACMA",0
37,"37239",229,196,194,6,2,"PACMA",1
37,"37103",446,326,325,4,1,"PACMA",2
37,"37303",188,152,151,1,1,"PACMA",0
37,"37293",118,84,84,0,0,"PACMA",0
37,"37327",185,157,157,5,0,"PACMA",0
37,"37260",154,126,126,1,0,"PACMA",1
37,"37004",32,22,22,0,0,"PACMA",0
37,"37333",225,143,142,4,1,"PACMA",0
37,"37262",78,64,64,1,0,"PACMA",0
37,"37036",63,46,46,0,0,"PACMA",0
37,"37087",855,681,676,8,5,"PACMA",8
37,"37126",30,24,24,0,0,"PACMA",0
37,"37110",117,92,89,1,3,"PACMA",0
37,"37115",123,89,87,0,2,"PACMA",1
37,"37143",385,301,299,1,2,"PACMA",1
37,"37346",267,222,220,1,2,"PACMA",0
37,"37033",98,63,63,0,0,"PACMA",0
37,"37161",138,109,107,0,2,"PACMA",0
37,"37245",345,252,246,7,6,"PACMA",0
37,"37297",420,342,331,4,11,"PACMA",3
37,"37022",268,220,219,2,1,"PACMA",1
37,"37351",281,239,238,0,1,"PACMA",0
37,"37165",33,27,27,0,0,"PACMA",0
37,"37344",246,184,183,1,1,"PACMA",1
37,"37089",67,50,49,0,1,"PACMA",2
37,"37243",102,76,76,0,0,"PACMA",0
37,"37015",222,145,143,3,2,"PACMA",1
37,"37222",97,66,66,1,0,"PACMA",0
37,"37154",141,116,112,0,4,"PACMA",0
37,"37102",411,291,289,3,2,"PACMA",1
37,"37185",591,450,443,4,7,"PACMA",6
37,"37357",276,216,215,0,1,"PACMA",0
37,"37011",122,91,89,0,2,"PACMA",0
37,"37082",799,570,560,1,10,"PACMA",0
37,"37060",245,192,192,0,0,"PACMA",4
37,"37147",191,141,136,0,5,"PACMA",0
37,"37159",91,74,74,0,0,"PACMA",1
37,"37170",1479,1055,1031,10,24,"PACMA",2
37,"37078",823,670,657,8,13,"PACMA",2
37,"37149",70,63,63,0,0,"PACMA",1
37,"37340",150,105,104,1,1,"PACMA",0
37,"37168",443,319,311,2,8,"PACMA",1
37,"37068",366,272,271,5,1,"PACMA",0
37,"37198",206,161,160,3,1,"PACMA",2
37,"37289",240,182,182,2,0,"PACMA",0
37,"37281",37,34,33,0,1,"PACMA",0
37,"37017",251,186,184,2,2,"PACMA",1
37,"37233",65,45,45,0,0,"PACMA",0
37,"37277",73,55,55,0,0,"PACMA",1
37,"37035",194,161,161,0,0,"PACMA",1
37,"37208",81,49,48,0,1,"PACMA",0
37,"37097",36,30,30,0,0,"PACMA",0
37,"37042",42,29,29,2,0,"PACMA",0
37,"37156",4310,3173,3126,27,47,"PACMA",18
37,"37172",878,580,576,3,4,"PACMA",1
37,"37313",555,415,411,1,4,"PACMA",0
37,"37003",119,93,90,0,3,"PACMA",0
37,"37046",11336,8300,8171,62,129,"PACMA",54
37,"37080",232,176,176,1,0,"PACMA",0
37,"37187",565,431,426,4,5,"PACMA",0
37,"37029",213,155,152,0,3,"PACMA",0
37,"37050",67,47,46,1,1,"PACMA",1
37,"37325",91,68,63,0,5,"PACMA",1
37,"37096",220,174,174,5,0,"PACMA",0
37,"37256",220,158,157,1,1,"PACMA",0
37,"37157",77,62,62,0,0,"PACMA",0
37,"37249",44,33,33,1,0,"PACMA",0
37,"37257",53,43,43,0,0,"PACMA",0
37,"37218",71,33,33,2,0,"PACMA",0
37,"37018",105,80,80,1,0,"PACMA",0
37,"37130",173,155,153,5,2,"PACMA",1
37,"37311",226,182,182,2,0,"PACMA",0
37,"37150",43,35,35,0,0,"PACMA",0
37,"37265",217,180,178,2,2,"PACMA",0
37,"37334",79,42,42,1,0,"PACMA",0
37,"37291",268,206,206,1,0,"PACMA",0
37,"37056",41,30,30,0,0,"PACMA",0
37,"37132",351,272,269,2,3,"PACMA",1
37,"37374",1178,971,943,8,28,"PACMA",4
37,"37254",183,153,149,0,4,"PACMA",0
37,"37232",390,349,348,0,1,"PACMA",1
37,"37133",108,82,79,4,3,"PACMA",1
37,"37192",353,245,242,2,3,"PACMA",1
37,"37236",139,94,89,0,5,"PACMA",1
37,"37052",274,197,197,2,0,"PACMA",0
37,"37207",303,234,233,0,1,"PACMA",4
37,"37361",84,56,55,0,1,"PACMA",0
37,"37339",316,257,257,4,0,"PACMA",1
37,"37189",125,97,97,0,0,"PACMA",0
37,"37057",213,168,167,0,1,"PACMA",0
37,"37365",174,147,144,0,3,"PACMA",0
37,"37118",125,96,96,0,0,"PACMA",0
37,"37007",439,321,313,4,8,"PACMA",1
37,"37005",77,58,56,0,2,"PACMA",0
37,"37183",417,305,301,2,4,"PACMA",0
37,"37134",230,175,173,1,2,"PACMA",0
37,"37145",257,190,187,0,3,"PACMA",0
37,"37054",261,199,198,1,1,"PACMA",2
37,"37085",4704,3475,3432,35,43,"PACMA",28
37,"37225",106,94,92,0,2,"PACMA",2
37,"37142",592,453,451,2,2,"PACMA",1
37,"37112",161,115,114,0,1,"PACMA",0
37,"37202",978,773,763,7,10,"PACMA",5
37,"37058",61,43,42,0,1,"PACMA",0
37,"37317",306,246,243,1,3,"PACMA",0
37,"37127",221,158,158,4,0,"PACMA",1
37,"37377",249,199,195,3,4,"PACMA",0
37,"37173",1526,1138,1125,5,13,"PACMA",0
37,"37211",223,163,163,4,0,"PACMA",0
37,"37337",139,120,120,2,0,"PACMA",0
37,"37008",4298,3312,3272,16,40,"PACMA",18
37,"37302",294,216,214,1,2,"PACMA",0
37,"37264",67,43,43,0,0,"PACMA",0
37,"37001",195,147,144,0,3,"PACMA",0
37,"37315",93,69,67,1,2,"PACMA",1
37,"37228",367,301,299,1,2,"PACMA",0
37,"37306",271,171,171,0,0,"PACMA",0
37,"37375",705,593,582,11,11,"PACMA",1
37,"37166",213,142,142,1,0,"PACMA",0
37,"37051",80,54,53,0,1,"PACMA",1
37,"37069",976,713,699,9,14,"PACMA",1
37,"37335",415,301,293,2,8,"PACMA",0
37,"37073",583,449,442,8,7,"PACMA",1
37,"37182",77,62,62,0,0,"PACMA",0
37,"37021",80,62,62,0,0,"PACMA",0
37,"37122",202,158,156,3,2,"PACMA",1
37,"37171",411,321,317,1,4,"PACMA",3
37,"37229",143,102,102,1,0,"PACMA",1
37,"37353",129,92,92,1,0,"PACMA",0
37,"37284",325,245,244,2,1,"PACMA",1
37,"37200",190,134,133,2,1,"PACMA",1
37,"37040",393,320,317,3,3,"PACMA",0
37,"37014",1161,850,847,5,3,"PACMA",1
37,"37045",27,20,20,0,0,"PACMA",0
37,"37282",209,136,136,0,0,"PACMA",0
37,"37074",153,109,103,4,6,"PACMA",0
37,"37320",93,71,71,1,0,"PACMA",0
37,"37201",262,179,177,0,2,"PACMA",0
37,"37205",233,201,197,1,4,"PACMA",0
37,"37037",119,81,81,0,0,"PACMA",0
37,"37373",755,548,545,3,3,"PACMA",1
37,"37380",55,46,46,2,0,"PACMA",0
37,"37116",69,51,51,0,0,"PACMA",1
37,"37241",172,128,126,1,2,"PACMA",0
37,"37355",189,147,146,1,1,"PACMA",0
37,"37120",99,77,76,1,1,"PACMA",0
37,"37318",209,156,155,1,1,"PACMA",0
37,"37100",81,68,67,1,1,"PACMA",0
37,"37352",204,148,147,0,1,"PACMA",0
37,"37314",87,74,72,0,2,"PACMA",1
37,"37214",125,88,88,1,0,"PACMA",0
37,"37272",136,97,96,0,1,"PACMA",0
37,"37188",185,127,125,3,2,"PACMA",0
37,"37322",2472,1691,1676,12,15,"PACMA",14
37,"37012",150,117,115,0,2,"PACMA",0
37,"37371",281,183,177,1,6,"PACMA",0
37,"37184",345,247,244,1,3,"PACMA",15
37,"37117",1458,1075,1068,14,7,"PACMA",13
37,"37059",124,100,98,0,2,"PACMA",0
37,"37177",298,223,221,1,2,"PACMA",0
37,"37140",678,440,435,2,5,"PACMA",4
37,"37109",182,119,118,0,1,"PACMA",0
37,"37039",304,213,213,4,0,"PACMA",0
37,"37251",126,87,87,2,0,"PACMA",0
37,"37144",370,288,284,2,4,"PACMA",0
37,"37342",256,210,208,1,2,"PACMA",0
37,"37197",87,55,55,2,0,"PACMA",0
37,"37300",575,427,423,3,4,"PACMA",4
37,"37091",176,114,113,2,1,"PACMA",1
37,"37255",51,38,38,0,0,"PACMA",1
37,"37224",210,183,179,2,4,"PACMA",0
37,"37032",543,411,410,1,1,"PACMA",7
37,"37221",434,328,323,2,5,"PACMA",0
37,"37119",109,86,86,1,0,"PACMA",0
37,"37088",204,152,152,3,0,"PACMA",0
37,"37152",424,290,283,2,7,"PACMA",2
37,"37267",199,151,147,2,4,"PACMA",0
37,"37354",5182,3955,3915,50,40,"PACMA",32
37,"37369",140,96,96,0,0,"PACMA",0
37,"37336",55,47,47,0,0,"PACMA",0
37,"37092",1731,1264,1250,11,14,"PACMA",9
37,"37099",73,45,45,2,0,"PACMA",0
37,"37305",216,170,169,2,1,"PACMA",1
37,"37234",357,224,222,1,2,"PACMA",0
37,"37191",116,78,76,0,2,"PACMA",0
37,"37298",184,125,125,1,0,"PACMA",0
37,"37180",73,52,52,1,0,"PACMA",0
37,"37301",73,62,62,0,0,"PACMA",1
37,"37081",933,720,714,4,6,"PACMA",5
37,"37113",430,340,340,3,0,"PACMA",1
37,"37027",228,187,187,0,0,"PACMA",0
37,"37231",259,208,207,4,1,"PACMA",0
37,"37169",176,139,137,0,2,"PACMA",0
37,"37370",337,258,255,3,3,"PACMA",1
37,"37063",74,59,59,1,0,"PACMA",0
37,"37023",1378,1116,1105,9,11,"PACMA",16
37,"37360",230,167,166,2,1,"PACMA",0
37,"37223",109,90,87,0,3,"PACMA",0
37,"37287",318,237,237,3,0,"PACMA",0
37,"37294",11680,8850,8760,84,90,"PACMA",71
37,"37356",86,73,71,1,2,"PACMA",1
37,"37163",42,33,33,0,0,"PACMA",0
37,"37269",452,328,328,2,0,"PACMA",0
37,"37219",179,110,110,0,0,"PACMA",0
37,"37296",338,258,255,4,3,"PACMA",0
37,"37258",180,117,115,1,2,"PACMA",1
37,"37350",421,324,320,4,4,"PACMA",2
37,"37098",335,237,237,1,0,"PACMA",0
37,"37247",199,162,154,3,8,"PACMA",0
37,"37304",170,114,109,4,5,"PACMA",0
37,"37319",117,78,77,0,1,"PACMA",1
37,"37244",134,91,90,1,1,"PACMA",0
37,"37237",325,250,248,4,2,"PACMA",0
37,"37292",103,72,72,1,0,"PACMA",0
37,"37044",470,353,341,1,12,"PACMA",0
37,"37376",2251,1588,1568,9,20,"PACMA",3
37,"37213",87,73,73,0,0,"PACMA",1
37,"37324",371,284,279,4,5,"PACMA",0
37,"37175",407,316,314,5,2,"PACMA",1
37,"37329",36,28,28,0,0,"PACMA",0
37,"37190",219,167,167,0,0,"PACMA",0
37,"37286",206,156,156,4,0,"PACMA",0
37,"37366",43,27,27,0,0,"PACMA",0
37,"37071",78,73,72,1,1,"PACMA",0
37,"37263",348,252,251,1,1,"PACMA",2
37,"37146",122,100,99,1,1,"PACMA",0
37,"37049",147,98,98,2,0,"PACMA",0
37,"37158",248,183,181,0,2,"PACMA",0
37,"37086",98,80,80,2,0,"PACMA",0
37,"37381",139,98,92,0,6,"PACMA",0
37,"37019",151,114,111,0,3,"PACMA",1
37,"37108",101,81,79,2,2,"PACMA",0
37,"37275",123,87,86,1,1,"PACMA",0
37,"37139",205,163,162,2,1,"PACMA",2
37,"37253",135,110,110,1,0,"PACMA",2
37,"37206",94,71,71,4,0,"PACMA",0
37,"37283",120,88,88,1,0,"PACMA",2
37,"37250",358,223,223,1,0,"PACMA",2
37,"37155",73,54,54,1,0,"PACMA",0
37,"37276",149,100,99,0,1,"PACMA",0
37,"37141",156,127,127,1,0,"PACMA",0
37,"37020",430,340,334,3,6,"PACMA",2
37,"37079",74,64,63,0,1,"PACMA",2
37,"37024",92,77,77,0,0,"PACMA",0
37,"37216",310,264,257,4,7,"PACMA",1
37,"37331",217,150,148,1,2,"PACMA",0
37,"37106",266,172,166,1,6,"PACMA",1
37,"37148",425,304,295,6,9,"PACMA",1
37,"37240",907,646,636,5,10,"PACMA",5
37,"37013",121,87,86,3,1,"PACMA",0
37,"37312",262,211,210,3,1,"PACMA",0
37,"37273",108,77,77,0,0,"PACMA",0
37,"37010",956,716,708,3,8,"PACMA",1
37,"37131",190,140,139,0,1,"PACMA",0
37,"37160",627,450,443,7,7,"PACMA",0
37,"37186",106,78,78,3,0,"PACMA",0
37,"37332",69,53,52,0,1,"PACMA",0
37,"37030",84,68,66,0,2,"PACMA",0
37,"37164",256,200,195,1,5,"PACMA",2
37,"37343",62,49,49,0,0,"PACMA",0
37,"37285",412,311,305,2,6,"PACMA",1
37,"37107",10855,7694,7598,96,96,"PACMA",31
37,"37362",4592,3442,3403,48,39,"PACMA",27
37,"37310",180,129,128,2,1,"PACMA",0
37,"37209",406,281,280,7,1,"PACMA",1
37,"37194",252,191,190,2,1,"PACMA",0
37,"37290",140,116,116,0,0,"PACMA",2
37,"37061",226,166,164,1,2,"PACMA",1
37,"37090",52,38,36,0,2,"PACMA",0
37,"37055",123,105,98,0,7,"PACMA",0
37,"37065",323,237,235,0,2,"PACMA",0
37,"37363",120,98,94,0,4,"PACMA",0
37,"37072",166,133,132,2,1,"PACMA",0
37,"37242",91,71,71,0,0,"PACMA",0
37,"37367",199,160,158,7,2,"PACMA",0
37,"37345",166,135,133,3,2,"PACMA",1
37,"37215",136,102,101,2,1,"PACMA",0
37,"37128",264,211,201,4,10,"PACMA",0
37,"37330",335,262,258,4,4,"PACMA",1
37,"37016",573,451,447,3,4,"PACMA",4
37,"37259",45,30,30,0,0,"PACMA",0
37,"37070",533,403,396,4,7,"PACMA",0
37,"37372",146,117,115,0,2,"PACMA",1
37,"37358",168,136,135,2,1,"PACMA",2
37,"37266",84,55,55,1,0,"PACMA",1
37,"37129",251,199,194,1,5,"PACMA",1
37,"37280",79,50,50,0,0,"PACMA",0
37,"37379",173,134,134,2,0,"PACMA",0
37,"37316",751,584,577,5,7,"PACMA",3
37,"37002",144,87,87,0,0,"PACMA",0
37,"37062",84,67,66,1,1,"PACMA",1
37,"37238",112,88,85,2,3,"PACMA",2
37,"37274",119148,88959,88152,853,807,"PACMA",541
37,"37230",221,167,167,2,0,"PACMA",0
37,"37179",215,173,170,0,3,"PACMA",0
37,"37138",199,155,154,4,1,"PACMA",1
37,"37123",182,141,138,0,3,"PACMA",0
37,"37268",116,71,70,0,1,"PACMA",0
37,"37321",170,131,129,2,2,"PACMA",0
37,"37347",477,365,359,3,6,"PACMA",6
37,"37067",3125,2551,2523,22,28,"PACMA",22
37,"37025",258,223,221,2,2,"PACMA",0
37,"37252",116,89,89,0,0,"PACMA",0
37,"37378",111,74,70,2,4,"PACMA",1
37,"37199",142,108,108,0,0,"PACMA",1
37,"37181",291,209,207,1,2,"PACMA",0
37,"37382",180,133,133,4,0,"PACMA",0
37,"37270",190,142,139,1,3,"PACMA",0
37,"37246",5335,4190,4152,41,38,"PACMA",14
37,"37248",152,127,126,2,1,"PACMA",2
37,"37328",189,142,140,0,2,"PACMA",0
37,"37212",111,83,83,1,0,"PACMA",2
37,"37101",163,122,122,2,0,"PACMA",0
37,"37124",219,149,148,0,1,"PACMA",0
37,"37167",173,150,144,2,6,"PACMA",0
37,"37193",399,279,278,6,1,"PACMA",0
37,"37271",361,283,276,3,7,"PACMA",0
37,"37217",56,46,44,1,2,"PACMA",0
37,"37174",1065,838,826,3,12,"PACMA",3
37,"37137",105,73,73,0,0,"PACMA",0
37,"37359",184,131,129,0,2,"PACMA",0
37,"37349",112,83,82,0,1,"PACMA",0
37,"37176",137,100,98,0,2,"PACMA",0
37,"37204",280,214,211,1,3,"PACMA",1
37,"37338",78,66,66,1,0,"PACMA",0
37,"37196",77,54,53,0,1,"PACMA",0
37,"37368",16,15,15,0,0,"PACMA",0
37,"37028",150,111,110,1,1,"PACMA",1
37,"37038",789,628,616,5,12,"PACMA",4
37,"37299",221,170,163,1,7,"PACMA",1
37,"37178",99,84,81,0,3,"PACMA",0
37,"37151",146,116,115,2,1,"PACMA",0
37,"37279",763,572,562,11,10,"PACMA",4
37,"37348",113,91,91,1,0,"PACMA",0
37,"37235",223,168,163,1,5,"PACMA",0
37,"37104",27,21,21,0,0,"PACMA",0
37,"37047",167,83,83,0,0,"PACMA",0
27,"27002",1651,1224,1200,8,24,"PSdeG-PSOE",441
27,"27041",2377,1737,1722,16,15,"PSdeG-PSOE",350
27,"27901",2404,1647,1624,25,23,"PSdeG-PSOE",340
27,"27016",7204,5069,4987,65,82,"PSdeG-PSOE",1072
27,"27051",8102,5883,5784,71,99,"PSdeG-PSOE",1147
27,"27024",1624,1250,1226,8,24,"PSdeG-PSOE",406
27,"27034",1154,720,710,6,10,"PSdeG-PSOE",252
27,"27031",15650,10901,10710,106,191,"PSdeG-PSOE",2744
27,"27030",3361,2333,2290,27,43,"PSdeG-PSOE",544
27,"27028",79061,57271,56444,702,827,"PSdeG-PSOE",12533
27,"27019",8120,6041,5936,82,105,"PSdeG-PSOE",1463
27,"27032",3313,2269,2230,29,39,"PSdeG-PSOE",457
27,"27043",1313,875,855,14,20,"PSdeG-PSOE",224
27,"27056",1268,899,886,11,13,"PSdeG-PSOE",220
27,"27035",190,121,121,2,0,"PSdeG-PSOE",41
27,"27008",1377,1011,992,11,19,"PSdeG-PSOE",235
27,"27047",1643,1116,1104,10,12,"PSdeG-PSOE",297
27,"27027",1937,1458,1425,19,33,"PSdeG-PSOE",452
27,"27061",1045,821,796,10,25,"PSdeG-PSOE",265
27,"27055",1320,869,855,3,14,"PSdeG-PSOE",281
27,"27020",3539,2954,2896,38,58,"PSdeG-PSOE",678
27,"27045",1049,667,658,9,9,"PSdeG-PSOE",349
27,"27059",2202,1640,1605,19,35,"PSdeG-PSOE",305
27,"27063",1761,1340,1299,12,41,"PSdeG-PSOE",436
27,"27005",2615,1942,1918,16,24,"PSdeG-PSOE",315
27,"27052",918,659,649,3,10,"PSdeG-PSOE",250
27,"27039",4372,3327,3244,56,83,"PSdeG-PSOE",562
27,"27038",945,679,674,9,5,"PSdeG-PSOE",270
27,"27004",1251,846,828,2,18,"PSdeG-PSOE",232
27,"27011",2490,1623,1592,14,31,"PSdeG-PSOE",526
27,"27018",3514,2279,2255,17,24,"PSdeG-PSOE",876
27,"27009",2110,1595,1573,11,22,"PSdeG-PSOE",318
27,"27017",1017,674,666,6,8,"PSdeG-PSOE",176
27,"27048",2176,1658,1626,19,32,"PSdeG-PSOE",607
27,"27040",3225,2454,2415,22,39,"PSdeG-PSOE",573
27,"27064",1593,1179,1153,14,26,"PSdeG-PSOE",211
27,"27026",2423,1667,1602,12,65,"PSdeG-PSOE",564
27,"27029",1475,1142,1116,19,26,"PSdeG-PSOE",326
27,"27003",1913,1372,1351,16,21,"PSdeG-PSOE",271
27,"27001",2401,1346,1313,24,33,"PSdeG-PSOE",239
27,"27049",1422,969,958,8,11,"PSdeG-PSOE",212
27,"27057",11176,7921,7709,99,212,"PSdeG-PSOE",1903
27,"27046",1538,1119,1099,10,20,"PSdeG-PSOE",419
27,"27037",1075,736,723,12,13,"PSdeG-PSOE",213
27,"27062",619,468,465,6,3,"PSdeG-PSOE",141
27,"27007",2833,2211,2144,34,67,"PSdeG-PSOE",431
27,"27023",2593,1981,1942,24,39,"PSdeG-PSOE",466
27,"27012",1366,778,769,5,9,"PSdeG-PSOE",292
27,"27010",4363,3072,2990,45,82,"PSdeG-PSOE",651
27,"27050",2993,2241,2203,16,38,"PSdeG-PSOE",410
27,"27902",7196,5017,4921,55,96,"PSdeG-PSOE",1010
27,"27044",2901,1891,1832,28,59,"PSdeG-PSOE",416
27,"27013",3782,3067,3007,21,60,"PSdeG-PSOE",665
27,"27014",3284,2187,2148,29,39,"PSdeG-PSOE",637
27,"27022",4859,3324,3251,38,73,"PSdeG-PSOE",926
27,"27065",12528,8701,8483,150,218,"PSdeG-PSOE",1824
27,"27066",12767,9200,9039,102,161,"PSdeG-PSOE",2322
27,"27006",2611,1752,1723,26,29,"PSdeG-PSOE",487
27,"27033",631,454,449,8,5,"PSdeG-PSOE",154
27,"27025",2859,2293,2243,17,50,"PSdeG-PSOE",402
27,"27060",2651,1761,1729,12,32,"PSdeG-PSOE",358
27,"27054",1205,920,906,7,14,"PSdeG-PSOE",212
27,"27015",4304,3063,2985,41,78,"PSdeG-PSOE",649
27,"27058",3577,2669,2632,37,37,"PSdeG-PSOE",622
27,"27053",546,349,349,1,0,"PSdeG-PSOE",157
27,"27042",1759,1258,1235,21,23,"PSdeG-PSOE",283
27,"27021",1772,1167,1136,21,31,"PSdeG-PSOE",303
27,"27005",2615,1942,1918,16,24,"C's",93
27,"27059",2202,1640,1605,19,35,"C's",75
27,"27043",1313,875,855,14,20,"C's",62
27,"27029",1475,1142,1116,19,26,"C's",69
27,"27040",3225,2454,2415,22,39,"C's",120
27,"27006",2611,1752,1723,26,29,"C's",93
27,"27061",1045,821,796,10,25,"C's",41
27,"27057",11176,7921,7709,99,212,"C's",631
27,"27032",3313,2269,2230,29,39,"C's",220
27,"27037",1075,736,723,12,13,"C's",35
27,"27026",2423,1667,1602,12,65,"C's",88
27,"27038",945,679,674,9,5,"C's",43
27,"27031",15650,10901,10710,106,191,"C's",884
27,"27001",2401,1346,1313,24,33,"C's",59
27,"27004",1251,846,828,2,18,"C's",31
27,"27902",7196,5017,4921,55,96,"C's",442
27,"27039",4372,3327,3244,56,83,"C's",278
27,"27044",2901,1891,1832,28,59,"C's",54
27,"27048",2176,1658,1626,19,32,"C's",79
27,"27030",3361,2333,2290,27,43,"C's",97
27,"27049",1422,969,958,8,11,"C's",69
27,"27015",4304,3063,2985,41,78,"C's",136
27,"27008",1377,1011,992,11,19,"C's",42
27,"27047",1643,1116,1104,10,12,"C's",49
27,"27055",1320,869,855,3,14,"C's",36
27,"27053",546,349,349,1,0,"C's",15
27,"27018",3514,2279,2255,17,24,"C's",99
27,"27064",1593,1179,1153,14,26,"C's",77
27,"27058",3577,2669,2632,37,37,"C's",123
27,"27034",1154,720,710,6,10,"C's",17
27,"27002",1651,1224,1200,8,24,"C's",44
27,"27066",12767,9200,9039,102,161,"C's",708
27,"27063",1761,1340,1299,12,41,"C's",54
27,"27021",1772,1167,1136,21,31,"C's",70
27,"27024",1624,1250,1226,8,24,"C's",23
27,"27025",2859,2293,2243,17,50,"C's",148
27,"27027",1937,1458,1425,19,33,"C's",74
27,"27019",8120,6041,5936,82,105,"C's",476
27,"27028",79061,57271,56444,702,827,"C's",6237
27,"27035",190,121,121,2,0,"C's",14
27,"27011",2490,1623,1592,14,31,"C's",77
27,"27022",4859,3324,3251,38,73,"C's",172
27,"27045",1049,667,658,9,9,"C's",35
27,"27051",8102,5883,5784,71,99,"C's",510
27,"27013",3782,3067,3007,21,60,"C's",143
27,"27065",12528,8701,8483,150,218,"C's",501
27,"27041",2377,1737,1722,16,15,"C's",94
27,"27046",1538,1119,1099,10,20,"C's",48
27,"27042",1759,1258,1235,21,23,"C's",53
27,"27012",1366,778,769,5,9,"C's",28
27,"27901",2404,1647,1624,25,23,"C's",90
27,"27060",2651,1761,1729,12,32,"C's",100
27,"27050",2993,2241,2203,16,38,"C's",92
27,"27003",1913,1372,1351,16,21,"C's",89
27,"27016",7204,5069,4987,65,82,"C's",383
27,"27062",619,468,465,6,3,"C's",18
27,"27014",3284,2187,2148,29,39,"C's",149
27,"27009",2110,1595,1573,11,22,"C's",81
27,"27052",918,659,649,3,10,"C's",37
27,"27017",1017,674,666,6,8,"C's",20
27,"27033",631,454,449,8,5,"C's",14
27,"27007",2833,2211,2144,34,67,"C's",130
27,"27054",1205,920,906,7,14,"C's",27
27,"27023",2593,1981,1942,24,39,"C's",92
27,"27020",3539,2954,2896,38,58,"C's",116
27,"27010",4363,3072,2990,45,82,"C's",172
27,"27056",1268,899,886,11,13,"C's",70
22,"22006",298,217,215,1,2,"IU-CHA-UPeC",20
22,"22222",527,390,389,5,1,"IU-CHA-UPeC",25
22,"22053",787,541,535,12,6,"IU-CHA-UPeC",23
22,"22025",1071,726,712,13,14,"IU-CHA-UPeC",26
22,"22058",190,152,151,2,1,"IU-CHA-UPeC",6
22,"22099",490,378,377,4,1,"IU-CHA-UPeC",25
22,"22062",162,113,113,3,0,"IU-CHA-UPeC",5
22,"22905",294,224,224,2,0,"IU-CHA-UPeC",7
22,"22102",184,160,159,1,1,"IU-CHA-UPeC",3
22,"22225",2691,1849,1817,24,32,"IU-CHA-UPeC",64
22,"22217",395,307,301,3,6,"IU-CHA-UPeC",5
22,"22109",265,207,206,2,1,"IU-CHA-UPeC",10
22,"22078",453,323,319,6,4,"IU-CHA-UPeC",26
22,"22001",226,166,166,0,0,"IU-CHA-UPeC",4
22,"22018",332,243,242,3,1,"IU-CHA-UPeC",16
22,"22074",315,229,226,3,3,"IU-CHA-UPeC",11
22,"22014",245,184,183,2,1,"IU-CHA-UPeC",5
22,"22243",45,32,32,0,0,"IU-CHA-UPeC",2
22,"22133",117,89,89,4,0,"IU-CHA-UPeC",3
22,"22197",479,378,373,6,5,"IU-CHA-UPeC",27
22,"22181",93,62,62,1,0,"IU-CHA-UPeC",2
22,"22227",211,153,151,3,2,"IU-CHA-UPeC",9
22,"22085",107,92,90,2,2,"IU-CHA-UPeC",4
22,"22164",35,26,26,1,0,"IU-CHA-UPeC",1
22,"22139",83,65,64,0,1,"IU-CHA-UPeC",3
22,"22037",116,95,94,1,1,"IU-CHA-UPeC",11
22,"22019",180,156,155,0,1,"IU-CHA-UPeC",7
22,"22087",72,48,48,1,0,"IU-CHA-UPeC",0
22,"22061",6685,4796,4740,38,56,"IU-CHA-UPeC",200
22,"22095",73,48,48,1,0,"IU-CHA-UPeC",0
22,"22150",464,348,348,1,0,"IU-CHA-UPeC",18
22,"22136",815,596,595,6,1,"IU-CHA-UPeC",28
22,"22088",157,116,116,1,0,"IU-CHA-UPeC",5
22,"22904",835,600,594,6,6,"IU-CHA-UPeC",29
22,"22089",315,227,222,6,5,"IU-CHA-UPeC",0
22,"22114",123,80,79,4,1,"IU-CHA-UPeC",1
22,"22209",159,127,127,4,0,"IU-CHA-UPeC",6
22,"22141",118,90,89,1,1,"IU-CHA-UPeC",2
22,"22003",143,119,119,0,0,"IU-CHA-UPeC",6
22,"22004",136,79,79,0,0,"IU-CHA-UPeC",1
22,"22122",62,49,49,1,0,"IU-CHA-UPeC",5
22,"22043",94,71,70,0,1,"IU-CHA-UPeC",2
22,"22172",560,399,396,2,3,"IU-CHA-UPeC",14
22,"22086",215,162,162,4,0,"IU-CHA-UPeC",12
22,"22081",252,179,177,1,2,"IU-CHA-UPeC",2
22,"22012",111,84,82,0,2,"IU-CHA-UPeC",5
22,"22168",20,15,15,1,0,"IU-CHA-UPeC",0
22,"22175",197,140,140,0,0,"IU-CHA-UPeC",2
22,"22046",740,578,570,6,8,"IU-CHA-UPeC",33
22,"22160",209,161,161,3,0,"IU-CHA-UPeC",5
22,"22020",114,90,90,2,0,"IU-CHA-UPeC",3
22,"22242",64,45,44,1,1,"IU-CHA-UPeC",0
22,"22072",192,148,147,1,1,"IU-CHA-UPeC",12
22,"22067",65,45,45,1,0,"IU-CHA-UPeC",3
22,"22009",619,463,461,5,2,"IU-CHA-UPeC",10
22,"22226",774,591,589,2,2,"IU-CHA-UPeC",20
22,"22903",654,542,536,3,6,"IU-CHA-UPeC",15
22,"22049",78,61,61,1,0,"IU-CHA-UPeC",1
22,"22234",802,600,597,7,3,"IU-CHA-UPeC",5
22,"22111",152,114,113,0,1,"IU-CHA-UPeC",3
22,"22131",83,63,63,3,0,"IU-CHA-UPeC",4
22,"22007",797,607,603,13,4,"IU-CHA-UPeC",10
22,"22113",494,362,361,3,1,"IU-CHA-UPeC",18
22,"22176",174,140,140,1,0,"IU-CHA-UPeC",2
22,"22112",9592,6871,6820,76,51,"IU-CHA-UPeC",211
22,"22202",136,112,112,0,0,"IU-CHA-UPeC",5
22,"22212",84,70,70,1,0,"IU-CHA-UPeC",8
22,"22187",286,224,221,1,3,"IU-CHA-UPeC",21
22,"22011",89,70,70,1,0,"IU-CHA-UPeC",1
22,"22162",129,101,101,0,0,"IU-CHA-UPeC",7
22,"22200",251,191,189,0,2,"IU-CHA-UPeC",18
22,"22115",364,270,267,4,3,"IU-CHA-UPeC",6
22,"22182",256,177,176,2,1,"IU-CHA-UPeC",12
22,"22220",169,123,122,2,1,"IU-CHA-UPeC",5
22,"22155",77,58,58,2,0,"IU-CHA-UPeC",1
22,"22079",118,86,86,2,0,"IU-CHA-UPeC",0
22,"22008",173,138,138,3,0,"IU-CHA-UPeC",6
22,"22129",183,128,127,2,1,"IU-CHA-UPeC",6
22,"22127",505,387,386,3,1,"IU-CHA-UPeC",20
22,"22907",1459,1112,1104,21,8,"IU-CHA-UPeC",74
22,"22076",305,224,223,0,1,"IU-CHA-UPeC",8
22,"22130",10106,6957,6909,57,48,"IU-CHA-UPeC",461
22,"22223",79,63,62,0,1,"IU-CHA-UPeC",3
22,"22901",754,521,513,9,8,"IU-CHA-UPeC",28
22,"22248",118,92,91,0,1,"IU-CHA-UPeC",1
22,"22117",2497,1788,1770,16,18,"IU-CHA-UPeC",74
22,"22066",707,512,508,8,4,"IU-CHA-UPeC",26
22,"22084",534,413,411,3,2,"IU-CHA-UPeC",23
22,"22206",201,141,140,2,1,"IU-CHA-UPeC",8
22,"22126",91,65,65,0,0,"IU-CHA-UPeC",0
22,"22116",1443,1048,1038,12,10,"IU-CHA-UPeC",32
22,"22249",119,97,97,1,0,"IU-CHA-UPeC",5
22,"22029",127,101,100,2,1,"IU-CHA-UPeC",6
22,"22039",869,682,681,5,1,"IU-CHA-UPeC",45
22,"22254",1129,804,792,9,12,"IU-CHA-UPeC",10
22,"22246",77,51,50,0,1,"IU-CHA-UPeC",4
22,"22094",101,77,77,1,0,"IU-CHA-UPeC",2
22,"22190",113,83,83,2,0,"IU-CHA-UPeC",3
22,"22199",7029,5024,4977,55,47,"IU-CHA-UPeC",321
22,"22142",98,81,79,1,2,"IU-CHA-UPeC",0
22,"22022",558,431,427,2,4,"IU-CHA-UPeC",28
22,"22157",194,151,151,1,0,"IU-CHA-UPeC",9
22,"22047",247,213,212,2,1,"IU-CHA-UPeC",15
22,"22024",225,174,173,0,1,"IU-CHA-UPeC",18
22,"22203",82,68,67,0,1,"IU-CHA-UPeC",5
22,"22230",290,224,223,2,1,"IU-CHA-UPeC",16
22,"22218",43,35,35,0,0,"IU-CHA-UPeC",2
22,"22909",318,238,234,2,4,"IU-CHA-UPeC",4
22,"22213",3029,2225,2181,17,44,"IU-CHA-UPeC",136
22,"22077",381,295,293,5,2,"IU-CHA-UPeC",10
22,"22107",123,79,78,2,1,"IU-CHA-UPeC",3
22,"22023",430,329,329,2,0,"IU-CHA-UPeC",3
22,"22233",82,61,61,0,0,"IU-CHA-UPeC",2
22,"22178",104,87,87,1,0,"IU-CHA-UPeC",3
22,"22052",942,743,741,9,2,"IU-CHA-UPeC",28
22,"22252",122,93,91,1,2,"IU-CHA-UPeC",2
22,"22165",490,375,372,2,3,"IU-CHA-UPeC",13
22,"22075",126,82,81,2,1,"IU-CHA-UPeC",3
22,"22083",474,400,396,1,4,"IU-CHA-UPeC",9
22,"22069",435,340,338,3,2,"IU-CHA-UPeC",18
22,"22186",186,139,137,3,2,"IU-CHA-UPeC",6
22,"22021",1970,1485,1469,14,16,"IU-CHA-UPeC",73
22,"22028",379,297,293,1,4,"IU-CHA-UPeC",14
22,"22201",269,189,189,0,0,"IU-CHA-UPeC",9
22,"22135",192,146,144,0,2,"IU-CHA-UPeC",6
22,"22215",129,91,91,0,0,"IU-CHA-UPeC",3
22,"22906",180,146,143,1,3,"IU-CHA-UPeC",10
22,"22059",1137,839,828,7,11,"IU-CHA-UPeC",41
22,"22253",61,51,50,0,1,"IU-CHA-UPeC",3
22,"22251",371,283,281,4,2,"IU-CHA-UPeC",6
22,"22051",101,84,84,1,0,"IU-CHA-UPeC",4
22,"22193",283,235,234,3,1,"IU-CHA-UPeC",4
22,"22235",100,77,77,0,0,"IU-CHA-UPeC",2
22,"22042",118,102,100,1,2,"IU-CHA-UPeC",3
22,"22228",505,409,407,3,2,"IU-CHA-UPeC",21
22,"22149",302,236,236,2,0,"IU-CHA-UPeC",11
22,"22045",89,66,66,0,0,"IU-CHA-UPeC",6
22,"22032",107,74,71,0,3,"IU-CHA-UPeC",1
22,"22060",1165,885,879,3,6,"IU-CHA-UPeC",47
22,"22016",613,447,444,8,3,"IU-CHA-UPeC",20
22,"22055",325,252,245,5,7,"IU-CHA-UPeC",7
22,"22208",178,142,140,0,2,"IU-CHA-UPeC",22
22,"22041",163,127,126,4,1,"IU-CHA-UPeC",1
22,"22064",165,115,115,1,0,"IU-CHA-UPeC",6
22,"22205",434,334,333,2,1,"IU-CHA-UPeC",4
22,"22173",234,158,157,0,1,"IU-CHA-UPeC",7
22,"22143",213,147,147,3,0,"IU-CHA-UPeC",4
22,"22106",24,17,17,0,0,"IU-CHA-UPeC",0
22,"22054",1542,1126,1106,20,20,"IU-CHA-UPeC",60
22,"22027",325,218,214,0,4,"IU-CHA-UPeC",4
22,"22189",184,140,137,1,3,"IU-CHA-UPeC",10
22,"22144",248,195,195,0,0,"IU-CHA-UPeC",9
22,"22057",364,260,259,1,1,"IU-CHA-UPeC",19
22,"22245",306,258,257,3,1,"IU-CHA-UPeC",5
22,"22239",89,78,76,4,2,"IU-CHA-UPeC",1
22,"22035",244,171,168,3,3,"IU-CHA-UPeC",7
22,"22063",175,140,140,2,0,"IU-CHA-UPeC",18
22,"22125",38845,28287,27998,283,289,"IU-CHA-UPeC",1893
22,"22013",295,235,233,2,2,"IU-CHA-UPeC",8
22,"22221",80,60,59,0,1,"IU-CHA-UPeC",2
22,"22156",264,202,200,3,2,"IU-CHA-UPeC",8
22,"22040",148,123,121,2,2,"IU-CHA-UPeC",1
22,"22036",91,82,82,0,0,"IU-CHA-UPeC",1
22,"22902",219,162,160,1,2,"IU-CHA-UPeC",7
22,"22015",324,238,236,3,2,"IU-CHA-UPeC",12
22,"22119",1296,950,940,3,10,"IU-CHA-UPeC",36
22,"22002",109,94,93,0,1,"IU-CHA-UPeC",3
22,"22090",102,75,75,0,0,"IU-CHA-UPeC",3
22,"22044",254,191,188,3,3,"IU-CHA-UPeC",8
22,"22158",12005,8628,8554,78,74,"IU-CHA-UPeC",518
22,"22110",751,563,558,3,5,"IU-CHA-UPeC",42
22,"22250",347,258,256,5,2,"IU-CHA-UPeC",12
22,"22050",89,78,78,0,0,"IU-CHA-UPeC",0
22,"22247",30,23,22,0,1,"IU-CHA-UPeC",1
22,"22174",485,400,396,6,4,"IU-CHA-UPeC",6
22,"22017",864,658,651,7,7,"IU-CHA-UPeC",28
22,"22195",235,190,189,2,1,"IU-CHA-UPeC",5
22,"22908",207,144,140,1,4,"IU-CHA-UPeC",15
22,"22048",12633,9215,9141,90,74,"IU-CHA-UPeC",436
22,"22163",426,360,356,3,4,"IU-CHA-UPeC",16
22,"22151",93,68,68,0,0,"IU-CHA-UPeC",2
22,"22096",297,248,248,0,0,"IU-CHA-UPeC",9
22,"22229",114,81,81,0,0,"IU-CHA-UPeC",2
22,"22080",283,217,215,6,2,"IU-CHA-UPeC",5
22,"22244",52,38,38,0,0,"IU-CHA-UPeC",0
22,"22177",102,77,77,2,0,"IU-CHA-UPeC",3
22,"22105",118,87,86,1,1,"IU-CHA-UPeC",4
22,"22124",204,143,142,1,1,"IU-CHA-UPeC",4
22,"22082",298,222,220,2,2,"IU-CHA-UPeC",17
22,"22128",187,146,142,1,4,"IU-CHA-UPeC",2
22,"22170",642,518,509,4,9,"IU-CHA-UPeC",33
22,"22207",125,89,88,3,1,"IU-CHA-UPeC",5
22,"22068",82,65,65,3,0,"IU-CHA-UPeC",9
22,"22184",188,156,156,2,0,"IU-CHA-UPeC",6
22,"22188",87,66,66,1,0,"IU-CHA-UPeC",1
22,"22232",96,73,70,2,3,"IU-CHA-UPeC",2
22,"22214",128,94,92,0,2,"IU-CHA-UPeC",6
22,"22236",249,198,198,1,0,"IU-CHA-UPeC",1
22,"22137",1071,729,719,6,10,"IU-CHA-UPeC",37
22,"22103",680,527,522,8,5,"IU-CHA-UPeC",31
22,"22204",1095,816,805,10,11,"IU-CHA-UPeC",49
22,"22167",498,397,388,7,9,"IU-CHA-UPeC",17
34,"34055",280,204,202,2,2,"FE de las J",0
34,"34091",123,97,95,1,2,"FE de las J",0
34,"34217",1200,954,934,6,20,"FE de las J",5
34,"34229",67,55,55,1,0,"FE de las J",0
34,"34079",1601,1285,1269,11,16,"FE de las J",1
34,"34141",182,148,147,4,1,"FE de las J",1
34,"34189",57,45,45,1,0,"FE de las J",0
34,"34066",58,45,45,0,0,"FE de las J",0
34,"34101",54,42,42,0,0,"FE de las J",0
34,"34106",114,94,94,2,0,"FE de las J",0
34,"34158",290,190,188,3,2,"FE de las J",0
34,"34104",247,203,199,0,4,"FE de las J",0
34,"34171",982,720,710,7,10,"FE de las J",0
34,"34170",62,49,49,0,0,"FE de las J",0
34,"34082",84,71,71,0,0,"FE de las J",1
34,"34133",107,85,82,0,3,"FE de las J",0
34,"34177",179,149,148,1,1,"FE de las J",1
34,"34120",64404,49403,48884,379,519,"FE de las J",85
34,"34134",53,37,37,2,0,"FE de las J",0
34,"34186",51,45,45,0,0,"FE de las J",0
34,"34070",160,117,115,2,2,"FE de las J",0
34,"34228",81,66,66,0,0,"FE de las J",1
34,"34137",28,24,24,1,0,"FE de las J",0
34,"34113",37,36,36,0,0,"FE de las J",0
34,"34004",5626,4226,4178,41,48,"FE de las J",10
34,"34125",88,69,68,1,1,"FE de las J",1
34,"34069",2285,1711,1692,25,19,"FE de las J",2
34,"34901",1126,881,865,6,16,"FE de las J",1
34,"34103",96,78,77,2,1,"FE de las J",0
34,"34084",140,110,108,1,2,"FE de las J",0
34,"34225",4903,3830,3784,41,46,"FE de las J",8
34,"34180",68,56,56,2,0,"FE de las J",3
34,"34124",61,47,46,0,1,"FE de las J",1
34,"34216",67,52,51,0,1,"FE de las J",0
34,"34121",192,155,154,2,1,"FE de las J",0
34,"34023",5265,3948,3918,38,30,"FE de las J",8
34,"34052",178,148,147,3,1,"FE de las J",1
34,"34041",89,71,71,1,0,"FE de las J",1
34,"34236",162,126,126,1,0,"FE de las J",1
34,"34176",134,102,100,2,2,"FE de las J",0
34,"34208",53,41,41,1,0,"FE de las J",1
34,"34204",47,39,39,2,0,"FE de las J",0
34,"34025",61,44,44,1,0,"FE de las J",0
34,"34114",212,147,146,2,1,"FE de las J",0
34,"34109",59,48,47,0,1,"FE de las J",0
34,"34050",202,160,160,0,0,"FE de las J",0
34,"34184",55,46,42,0,4,"FE de las J",0
34,"34129",179,139,137,2,2,"FE de las J",1
34,"34215",163,148,148,2,0,"FE de las J",1
34,"34001",35,28,28,2,0,"FE de las J",0
34,"34056",2003,1502,1487,12,15,"FE de las J",2
34,"34009",33,29,26,1,3,"FE de las J",0
34,"34027",1096,786,781,11,5,"FE de las J",2
34,"34003",163,127,125,0,2,"FE de las J",1
34,"34139",168,126,124,6,2,"FE de las J",0
34,"34048",76,64,64,1,0,"FE de las J",0
34,"34168",55,51,51,1,0,"FE de las J",0
34,"34036",216,167,165,1,2,"FE de las J",0
34,"34067",129,95,95,0,0,"FE de las J",0
34,"34135",391,296,291,4,5,"FE de las J",1
34,"34022",1095,915,909,8,6,"FE de las J",0
34,"34071",172,140,139,4,1,"FE de las J",0
34,"34163",49,40,40,0,0,"FE de las J",0
34,"34076",597,494,490,3,4,"FE de las J",1
34,"34098",780,587,582,2,5,"FE de las J",1
34,"34015",39,32,31,1,1,"FE de las J",0
34,"34039",61,46,45,0,1,"FE de las J",0
34,"34136",182,121,120,1,1,"FE de las J",0
34,"34110",91,78,78,2,0,"FE de las J",0
34,"34202",31,20,19,0,1,"FE de las J",1
34,"34199",1248,955,937,18,18,"FE de las J",1
34,"34174",205,162,162,4,0,"FE de las J",0
34,"34157",2460,1872,1836,26,36,"FE de las J",7
34,"34182",792,632,620,3,12,"FE de las J",1
34,"34127",95,64,64,2,0,"FE de las J",0
34,"34068",25,24,24,1,0,"FE de las J",0
34,"34037",310,218,217,4,1,"FE de las J",1
34,"34196",91,70,69,1,1,"FE de las J",1
34,"34241",18,13,12,2,1,"FE de las J",0
34,"34904",319,241,240,3,1,"FE de las J",0
34,"34167",114,89,89,0,0,"FE de las J",0
34,"34094",61,42,40,1,2,"FE de las J",0
34,"34161",23,14,14,0,0,"FE de las J",0
34,"34005",858,670,651,6,19,"FE de las J",1
34,"34221",179,135,132,3,3,"FE de las J",1
34,"34034",126,93,93,1,0,"FE de las J",1
34,"34237",597,472,465,5,7,"FE de las J",1
34,"34155",135,105,104,1,1,"FE de las J",0
34,"34903",198,128,127,1,1,"FE de las J",0
34,"34218",469,353,349,2,4,"FE de las J",0
34,"34190",56,40,40,3,0,"FE de las J",0
34,"34151",167,111,111,3,0,"FE de las J",1
34,"34243",326,263,258,2,5,"FE de las J",0
34,"34233",131,116,116,1,0,"FE de las J",0
34,"34012",362,277,272,4,5,"FE de las J",0
34,"34083",1773,1259,1244,8,15,"FE de las J",2
34,"34116",62,41,41,0,0,"FE de las J",0
34,"34042",300,247,244,4,3,"FE de las J",0
34,"34059",422,348,341,6,7,"FE de las J",3
34,"34234",72,57,55,0,2,"FE de las J",0
34,"34220",144,129,128,0,1,"FE de las J",0
34,"34222",120,82,82,2,0,"FE de las J",0
34,"34088",231,192,190,2,2,"FE de las J",3
34,"34019",125,103,101,1,2,"FE de las J",0
34,"34240",90,71,70,2,1,"FE de las J",2
34,"34086",105,91,88,1,3,"FE de las J",1
34,"34093",90,72,70,0,2,"FE de las J",0
34,"34132",115,93,92,0,1,"FE de las J",1
34,"34072",160,142,140,1,2,"FE de las J",0
34,"34010",570,437,429,5,8,"FE de las J",1
34,"34102",205,172,170,1,2,"FE de las J",0
34,"34053",209,170,168,4,2,"FE de las J",1
34,"34099",61,51,50,0,1,"FE de las J",0
34,"34232",748,601,586,11,15,"FE de las J",1
34,"34140",107,63,62,0,1,"FE de las J",0
34,"34033",18,17,17,0,0,"FE de las J",0
34,"34089",157,124,122,1,2,"FE de las J",0
34,"34073",187,150,149,0,1,"FE de las J",0
34,"34031",29,28,28,1,0,"FE de las J",0
34,"34080",5626,3906,3835,39,71,"FE de las J",5
34,"34038",277,202,202,3,0,"FE de las J",0
34,"34214",186,150,149,1,1,"FE de las J",1
34,"34112",47,38,38,0,0,"FE de las J",0
34,"34126",279,218,218,2,0,"FE de las J",0
34,"34074",719,552,545,8,7,"FE de las J",2
34,"34154",76,54,52,0,2,"FE de las J",0
34,"34242",95,74,73,1,1,"FE de las J",0
34,"34143",172,127,126,3,1,"FE de las J",0
34,"34011",398,326,326,3,0,"FE de las J",0
34,"34108",537,453,446,5,7,"FE de las J",0
34,"34018",209,169,166,3,3,"FE de las J",1
34,"34159",363,277,269,4,8,"FE de las J",0
34,"34152",124,102,99,1,3,"FE de las J",0
34,"34049",369,280,274,1,6,"FE de las J",2
34,"34178",113,92,91,5,1,"FE de las J",1
34,"34046",43,31,29,0,2,"FE de las J",0
34,"34092",297,236,231,2,5,"FE de las J",0
34,"34032",41,32,31,0,1,"FE de las J",0
34,"34146",55,42,42,0,0,"FE de las J",0
34,"34169",404,302,300,2,2,"FE de las J",1
34,"34035",113,90,89,1,1,"FE de las J",0
34,"34063",86,80,79,1,1,"FE de las J",0
34,"34231",232,167,167,4,0,"FE de las J",0
34,"34201",193,163,161,2,2,"FE de las J",0
34,"34107",81,49,49,3,0,"FE de las J",0
34,"34246",64,49,47,1,2,"FE de las J",0
34,"34206",879,688,680,3,8,"FE de las J",0
34,"34185",65,46,44,2,2,"FE de las J",0
34,"34057",476,339,334,3,5,"FE de las J",0
34,"34060",137,113,112,1,1,"FE de las J",0
34,"34192",93,76,76,0,0,"FE de las J",0
34,"34077",349,253,246,0,7,"FE de las J",0
34,"34160",143,112,110,1,2,"FE de las J",1
34,"34156",49,42,41,3,1,"FE de las J",0
34,"34175",89,75,74,1,1,"FE de las J",0
34,"34061",108,80,80,0,0,"FE de las J",0
34,"34020",53,39,39,0,0,"FE de las J",0
34,"34096",57,46,46,3,0,"FE de las J",0
34,"34181",453,343,337,3,6,"FE de las J",1
34,"34230",15,12,12,0,0,"FE de las J",0
34,"34081",61,50,49,0,1,"FE de las J",0
34,"34062",176,111,111,3,0,"FE de las J",1
34,"34179",29,22,20,0,2,"FE de las J",0
34,"34058",184,167,167,0,0,"FE de las J",0
34,"34017",920,763,745,2,18,"FE de las J",3
34,"34131",59,50,48,0,2,"FE de las J",1
34,"34224",45,31,31,0,0,"FE de las J",0
34,"34123",1668,1346,1319,20,27,"FE de las J",2
34,"34047",1803,1402,1380,15,22,"FE de las J",10
34,"34006",80,69,66,1,3,"FE de las J",0
34,"34045",77,65,65,2,0,"FE de las J",0
34,"34902",140,115,114,0,1,"FE de las J",0
34,"34245",311,213,209,4,4,"FE de las J",2
34,"34205",59,45,45,0,0,"FE de las J",1
34,"34227",76,62,62,1,0,"FE de las J",0
34,"34211",180,151,149,3,2,"FE de las J",0
34,"34210",102,90,89,0,1,"FE de las J",0
34,"34122",84,66,65,0,1,"FE de las J",0
34,"34028",144,121,119,1,2,"FE de las J",0
34,"34149",20,15,15,0,0,"FE de las J",0
34,"34029",727,596,582,4,14,"FE de las J",0
34,"34223",219,159,158,1,1,"FE de las J",1
34,"34130",213,175,172,2,3,"FE de las J",0
34,"34147",167,120,120,1,0,"FE de las J",0
34,"34165",66,59,59,0,0,"FE de las J",0
34,"34051",102,90,88,1,2,"FE de las J",1
34,"34024",32,19,19,0,0,"FE de las J",0
34,"34087",127,109,108,1,1,"FE de las J",0
34,"34238",341,279,276,1,3,"FE de las J",0
34,"34213",58,43,42,2,1,"FE de las J",0
34,"34100",142,116,115,5,1,"FE de las J",5
45,"45026",225,171,169,1,2,"UPYD",0
45,"45154",1483,1114,1107,5,7,"UPYD",4
45,"45003",572,431,423,1,8,"UPYD",0
45,"45074",412,327,322,0,5,"UPYD",0
45,"45166",1629,1345,1332,5,13,"UPYD",1
45,"45077",542,428,423,0,5,"UPYD",2
45,"45195",2161,1709,1686,12,23,"UPYD",4
45,"45172",719,559,556,2,3,"UPYD",2
45,"45125",2329,1920,1898,10,22,"UPYD",3
45,"45034",1360,1098,1083,4,15,"UPYD",4
45,"45127",708,524,519,1,5,"UPYD",4
45,"45115",2563,2089,2048,5,41,"UPYD",4
45,"45198",1832,1521,1508,6,13,"UPYD",6
45,"45029",205,169,169,0,0,"UPYD",2
45,"45090",376,299,295,4,4,"UPYD",1
45,"45138",1110,903,887,6,16,"UPYD",3
45,"45153",1613,1263,1248,11,15,"UPYD",6
45,"45051",1594,1264,1248,6,16,"UPYD",4
45,"45199",2963,2055,2027,5,28,"UPYD",18
45,"45014",3984,2824,2802,24,22,"UPYD",6
45,"45081",17646,13309,13166,72,143,"UPYD",77
45,"45094",395,312,308,0,4,"UPYD",0
45,"45156",3441,2863,2825,13,38,"UPYD",5
45,"45129",136,100,97,0,3,"UPYD",1
45,"45126",260,169,167,1,2,"UPYD",0
45,"45061",2457,1718,1699,7,19,"UPYD",4
45,"45158",2534,1885,1868,8,17,"UPYD",6
45,"45140",1093,885,876,4,9,"UPYD",0
45,"45018",495,352,348,0,4,"UPYD",2
45,"45901",769,577,571,1,6,"UPYD",2
45,"45080",6,6,6,0,0,"UPYD",0
45,"45116",694,531,523,2,8,"UPYD",0
45,"45164",186,160,160,0,0,"UPYD",0
45,"45136",5859,4249,4177,24,72,"UPYD",7
45,"45002",2549,1810,1784,7,26,"UPYD",4
45,"45045",1316,945,935,1,10,"UPYD",2
45,"45049",435,330,326,0,4,"UPYD",1
45,"45184",201,124,123,1,1,"UPYD",0
45,"45082",1246,1046,1036,9,10,"UPYD",2
45,"45001",1852,1395,1355,9,40,"UPYD",3
45,"45052",2914,2389,2372,23,17,"UPYD",19
45,"45174",309,247,247,1,0,"UPYD",0
45,"45149",573,486,484,0,2,"UPYD",1
45,"45025",1198,921,910,2,11,"UPYD",2
45,"45043",793,663,655,1,8,"UPYD",3
45,"45117",754,610,602,2,8,"UPYD",2
45,"45133",2818,2184,2146,19,38,"UPYD",6
45,"45121",6766,4860,4798,30,62,"UPYD",23
45,"45171",1382,1090,1075,4,15,"UPYD",5
45,"45050",471,354,351,2,3,"UPYD",0
45,"45088",2102,1438,1423,4,15,"UPYD",6
45,"45079",367,285,285,3,0,"UPYD",0
45,"45006",1425,1022,1013,4,9,"UPYD",1
45,"45089",1516,1157,1139,6,18,"UPYD",2
45,"45148",307,229,219,1,10,"UPYD",1
45,"45048",360,281,277,1,4,"UPYD",1
45,"45100",197,166,164,2,2,"UPYD",0
45,"45038",3335,2525,2490,8,35,"UPYD",14
45,"45193",626,543,530,2,13,"UPYD",0
45,"45021",2459,1862,1833,21,29,"UPYD",4
45,"45131",287,242,242,0,0,"UPYD",1
45,"45030",482,364,361,4,3,"UPYD",2
45,"45124",2156,1750,1712,16,38,"UPYD",3
45,"45187",4078,3405,3353,14,52,"UPYD",18
45,"45015",622,461,455,2,6,"UPYD",7
45,"45019",7356,5539,5484,35,55,"UPYD",39
45,"45023",2160,1669,1654,9,15,"UPYD",18
45,"45093",151,117,117,0,0,"UPYD",0
45,"45204",643,519,513,0,6,"UPYD",2
45,"45012",670,521,506,4,15,"UPYD",0
45,"45060",179,131,129,1,2,"UPYD",0
45,"45165",62857,46607,46141,313,466,"UPYD",276
45,"45161",13474,9618,9496,63,122,"UPYD",90
45,"45152",597,476,476,2,0,"UPYD",1
45,"45145",2539,1830,1811,11,19,"UPYD",3
45,"45027",362,275,270,0,5,"UPYD",0
45,"45078",1392,1187,1179,8,8,"UPYD",1
45,"45058",384,304,301,4,3,"UPYD",2
45,"45111",60,47,47,0,0,"UPYD",0
45,"45005",241,207,205,2,2,"UPYD",4
45,"45066",7589,5716,5637,30,79,"UPYD",20
45,"45139",172,135,133,0,2,"UPYD",0
45,"45160",1111,908,895,6,13,"UPYD",6
45,"45099",3512,2514,2459,9,55,"UPYD",6
45,"45189",597,467,458,2,9,"UPYD",2
45,"45013",1786,1428,1412,7,16,"UPYD",8
45,"45101",3761,3090,3048,15,42,"UPYD",10
45,"45123",3075,2261,2222,11,39,"UPYD",16
45,"45004",568,436,430,1,6,"UPYD",4
45,"45042",190,145,145,0,0,"UPYD",0
45,"45108",521,415,414,2,1,"UPYD",1
45,"45144",794,643,640,2,3,"UPYD",4
45,"45132",2096,1631,1616,7,15,"UPYD",16
45,"45177",2142,1757,1731,11,26,"UPYD",7
45,"45112",1939,1302,1268,6,34,"UPYD",3
45,"45186",3083,2369,2341,14,28,"UPYD",11
45,"45169",193,136,136,1,0,"UPYD",0
45,"45072",670,499,499,2,0,"UPYD",2
45,"45137",1623,1106,1093,9,13,"UPYD",7
45,"45201",3450,2212,2173,14,39,"UPYD",20
45,"45041",3725,2698,2665,18,33,"UPYD",18
45,"45128",2498,1794,1774,7,20,"UPYD",2
45,"45191",549,477,475,0,2,"UPYD",1
45,"45007",697,566,560,1,6,"UPYD",1
45,"45031",2723,1935,1896,10,39,"UPYD",5
45,"45113",1948,1409,1386,14,23,"UPYD",1
45,"45085",1501,1086,1067,6,19,"UPYD",6
45,"45162",683,515,510,0,5,"UPYD",1
45,"45103",397,325,322,0,3,"UPYD",0
45,"45114",595,461,457,1,4,"UPYD",0
45,"45016",4179,3290,3268,30,22,"UPYD",28
45,"45065",276,227,223,0,4,"UPYD",0
45,"45039",226,197,193,1,4,"UPYD",0
45,"45179",546,406,403,3,3,"UPYD",1
45,"45068",173,138,135,0,3,"UPYD",0
45,"45143",1180,924,912,3,12,"UPYD",0
45,"45180",2725,2060,2028,7,32,"UPYD",6
45,"45024",1075,828,824,5,4,"UPYD",5
45,"45017",262,221,219,0,2,"UPYD",0
45,"45155",371,297,296,1,1,"UPYD",1
45,"45205",6745,4708,4657,35,51,"UPYD",18
45,"45084",2280,1777,1747,12,30,"UPYD",2
45,"45095",697,529,520,1,9,"UPYD",4
45,"45009",545,336,333,1,3,"UPYD",0
45,"45185",7734,6057,5973,27,84,"UPYD",23
45,"45067",2324,1871,1841,13,30,"UPYD",6
45,"45055",1032,857,841,2,16,"UPYD",1
45,"45192",2503,2164,2141,7,23,"UPYD",10
45,"45087",8345,6184,6091,34,93,"UPYD",23
45,"45176",3665,2747,2712,15,35,"UPYD",21
45,"45063",428,320,310,2,10,"UPYD",0
45,"45047",2563,1775,1751,13,24,"UPYD",11
45,"45096",1015,832,817,7,15,"UPYD",3
45,"45010",436,335,333,2,2,"UPYD",1
45,"45134",1600,1214,1200,4,14,"UPYD",6
45,"45141",897,735,727,4,8,"UPYD",2
45,"45076",574,382,378,1,4,"UPYD",0
45,"45056",2210,1384,1370,11,14,"UPYD",9
45,"45092",233,197,194,0,3,"UPYD",0
45,"45203",2574,1938,1908,10,30,"UPYD",11
45,"45173",9477,7145,7061,40,84,"UPYD",51
45,"45135",4302,3509,3453,21,56,"UPYD",10
45,"45183",2253,1581,1569,8,12,"UPYD",34
45,"45170",235,183,176,4,7,"UPYD",1
45,"45073",307,238,235,0,3,"UPYD",1
45,"45150",454,366,364,1,2,"UPYD",0
45,"45119",3348,2306,2264,14,42,"UPYD",7
45,"45033",351,253,247,3,6,"UPYD",0
45,"45147",581,475,469,4,6,"UPYD",4
45,"45057",221,187,182,0,5,"UPYD",0
45,"45110",1799,1394,1380,4,14,"UPYD",1
45,"45008",142,114,114,2,0,"UPYD",0
45,"45106",7524,5882,5784,55,98,"UPYD",16
45,"45070",1461,1223,1202,7,21,"UPYD",1
45,"45104",440,345,341,1,4,"UPYD",0
45,"45062",1121,910,894,10,16,"UPYD",2
45,"45098",2186,1686,1649,10,37,"UPYD",3
45,"45054",3995,2997,2968,8,29,"UPYD",11
45,"45197",1921,1500,1480,12,20,"UPYD",5
45,"45059",1723,1413,1388,4,25,"UPYD",2
45,"45105",405,284,279,3,5,"UPYD",0
45,"45182",1045,854,844,3,10,"UPYD",3
45,"45037",1635,1216,1202,4,14,"UPYD",3
45,"45071",1863,1550,1530,8,20,"UPYD",3
45,"45075",146,108,105,0,3,"UPYD",0
45,"45181",2313,1755,1728,12,27,"UPYD",3
45,"45142",7858,6249,6164,57,85,"UPYD",27
45,"45040",1396,871,862,4,9,"UPYD",3
45,"45091",407,301,299,2,2,"UPYD",0
45,"45102",3629,2685,2644,15,41,"UPYD",4
45,"45109",2913,2295,2218,16,77,"UPYD",8
45,"45069",1876,1446,1428,8,18,"UPYD",0
45,"45097",1047,877,869,3,8,"UPYD",0
45,"45122",5164,4112,4067,18,45,"UPYD",33
45,"45035",298,225,221,2,4,"UPYD",1
45,"45194",67,50,49,0,1,"UPYD",0
45,"45202",3905,2962,2920,12,42,"UPYD",3
45,"45022",392,297,293,8,4,"UPYD",0
45,"45053",8045,6446,6370,44,76,"UPYD",41
45,"45083",465,393,388,5,5,"UPYD",2
45,"45159",86,75,72,1,3,"UPYD",0
45,"45175",665,541,532,5,9,"UPYD",3
45,"45118",2002,1470,1456,3,14,"UPYD",4
45,"45167",1458,1197,1187,5,10,"UPYD",5
45,"45130",319,258,252,1,6,"UPYD",0
45,"45163",8338,6270,6142,57,128,"UPYD",20
45,"45120",134,105,105,1,0,"UPYD",0
45,"45036",658,500,496,2,4,"UPYD",0
45,"45151",586,444,437,1,7,"UPYD",3
45,"45064",3839,2915,2884,19,31,"UPYD",18
45,"45200",4627,3678,3588,29,90,"UPYD",12
45,"45107",3238,2628,2597,15,31,"UPYD",9
45,"45168",62226,48889,48446,327,443,"UPYD",361
45,"45046",2421,1815,1796,8,19,"UPYD",4
45,"45020",1313,1062,1046,5,16,"UPYD",3
45,"45028",3680,2919,2880,23,39,"UPYD",8
45,"45032",436,317,313,0,4,"UPYD",5
45,"45086",503,375,369,3,6,"UPYD",0
45,"45196",1388,1066,1054,13,12,"UPYD",7
45,"45188",2783,2161,2127,9,34,"UPYD",16
45,"45190",483,397,387,2,10,"UPYD",1
45,"45011",288,246,241,1,5,"UPYD",3
45,"45157",2125,1531,1509,14,22,"UPYD",8
45,"45146",108,85,85,0,0,"UPYD",1
37,"37328",189,142,140,0,2,"C's",5
37,"37245",345,252,246,7,6,"C's",15
37,"37106",266,172,166,1,6,"C's",22
37,"37292",103,72,72,1,0,"C's",12
37,"37239",229,196,194,6,2,"C's",21
37,"37196",77,54,53,0,1,"C's",8
37,"37244",134,91,90,1,1,"C's",13
37,"37074",153,109,103,4,6,"C's",3
37,"37150",43,35,35,0,0,"C's",1
37,"37289",240,182,182,2,0,"C's",25
37,"37215",136,102,101,2,1,"C's",8
37,"37009",216,161,160,3,1,"C's",20
37,"37179",215,173,170,0,3,"C's",6
37,"37306",271,171,171,0,0,"C's",27
37,"37070",533,403,396,4,7,"C's",54
37,"37194",252,191,190,2,1,"C's",10
37,"37208",81,49,48,0,1,"C's",4
37,"37232",390,349,348,0,1,"C's",41
37,"37225",106,94,92,0,2,"C's",12
37,"37071",78,73,72,1,1,"C's",10
37,"37124",219,149,148,0,1,"C's",10
37,"37318",209,156,155,1,1,"C's",28
37,"37021",80,62,62,0,0,"C's",4
37,"37313",555,415,411,1,4,"C's",43
37,"37237",325,250,248,4,2,"C's",23
37,"37248",152,127,126,2,1,"C's",16
37,"37033",98,63,63,0,0,"C's",10
37,"37298",184,125,125,1,0,"C's",12
37,"37178",99,84,81,0,3,"C's",9
37,"37238",112,88,85,2,3,"C's",14
37,"37345",166,135,133,3,2,"C's",20
37,"37192",353,245,242,2,3,"C's",51
37,"37012",150,117,115,0,2,"C's",12
37,"37128",264,211,201,4,10,"C's",27
37,"37147",191,141,136,0,5,"C's",20
37,"37113",430,340,340,3,0,"C's",37
37,"37034",84,66,66,3,0,"C's",13
37,"37183",417,305,301,2,4,"C's",23
37,"37136",667,453,448,2,5,"C's",66
37,"37035",194,161,161,0,0,"C's",15
37,"37079",74,64,63,0,1,"C's",10
37,"37319",117,78,77,0,1,"C's",11
37,"37102",411,291,289,3,2,"C's",38
37,"37348",113,91,91,1,0,"C's",11
37,"37133",108,82,79,4,3,"C's",6
37,"37167",173,150,144,2,6,"C's",13
37,"37112",161,115,114,0,1,"C's",7
37,"37126",30,24,24,0,0,"C's",3
37,"37085",4704,3475,3432,35,43,"C's",950
37,"37025",258,223,221,2,2,"C's",23
37,"37014",1161,850,847,5,3,"C's",102
37,"37036",63,46,46,0,0,"C's",4
37,"37168",443,319,311,2,8,"C's",32
37,"37320",93,71,71,1,0,"C's",3
37,"37213",87,73,73,0,0,"C's",11
37,"37191",116,78,76,0,2,"C's",5
37,"37251",126,87,87,2,0,"C's",17
37,"37218",71,33,33,2,0,"C's",2
37,"37173",1526,1138,1125,5,13,"C's",149
37,"37008",4298,3312,3272,16,40,"C's",478
37,"37019",151,114,111,0,3,"C's",16
37,"37089",67,50,49,0,1,"C's",9
37,"37355",189,147,146,1,1,"C's",19
37,"37072",166,133,132,2,1,"C's",11
37,"37283",120,88,88,1,0,"C's",3
37,"37250",358,223,223,1,0,"C's",24
37,"37199",142,108,108,0,0,"C's",23
37,"37287",318,237,237,3,0,"C's",36
37,"37184",345,247,244,1,3,"C's",27
37,"37231",259,208,207,4,1,"C's",30
37,"37081",933,720,714,4,6,"C's",60
37,"37293",118,84,84,0,0,"C's",13
37,"37300",575,427,423,3,4,"C's",67
37,"37118",125,96,96,0,0,"C's",11
37,"37038",789,628,616,5,12,"C's",73
37,"37323",521,387,385,8,2,"C's",52
37,"37291",268,206,206,1,0,"C's",25
37,"37240",907,646,636,5,10,"C's",146
37,"37129",251,199,194,1,5,"C's",30
37,"37357",276,216,215,0,1,"C's",22
37,"37255",51,38,38,0,0,"C's",4
37,"37091",176,114,113,2,1,"C's",15
37,"37144",370,288,284,2,4,"C's",22
37,"37103",446,326,325,4,1,"C's",39
37,"37257",53,43,43,0,0,"C's",6
37,"37077",260,234,230,0,4,"C's",28
37,"37122",202,158,156,3,2,"C's",28
37,"37141",156,127,127,1,0,"C's",12
37,"37088",204,152,152,3,0,"C's",17
37,"37092",1731,1264,1250,11,14,"C's",376
37,"37221",434,328,323,2,5,"C's",16
37,"37164",256,200,195,1,5,"C's",24
37,"37007",439,321,313,4,8,"C's",41
37,"37198",206,161,160,3,1,"C's",19
37,"37301",73,62,62,0,0,"C's",6
37,"37108",101,81,79,2,2,"C's",8
37,"37006",135,91,90,1,1,"C's",6
37,"37333",225,143,142,4,1,"C's",28
37,"37331",217,150,148,1,2,"C's",16
37,"37310",180,129,128,2,1,"C's",5
37,"37249",44,33,33,1,0,"C's",3
37,"37222",97,66,66,1,0,"C's",6
37,"37302",294,216,214,1,2,"C's",36
37,"37359",184,131,129,0,2,"C's",13
37,"37321",170,131,129,2,2,"C's",16
37,"37117",1458,1075,1068,14,7,"C's",277
37,"37146",122,100,99,1,1,"C's",7
37,"37143",385,301,299,1,2,"C's",28
37,"37235",223,168,163,1,5,"C's",25
37,"37324",371,284,279,4,5,"C's",28
37,"37120",99,77,76,1,1,"C's",6
37,"37282",209,136,136,0,0,"C's",10
37,"37073",583,449,442,8,7,"C's",77
37,"37087",855,681,676,8,5,"C's",177
37,"37258",180,117,115,1,2,"C's",13
37,"37114",88,67,66,1,1,"C's",8
37,"37284",325,245,244,2,1,"C's",26
37,"37082",799,570,560,1,10,"C's",68
37,"37224",210,183,179,2,4,"C's",24
37,"37212",111,83,83,1,0,"C's",15
37,"37315",93,69,67,1,2,"C's",3
37,"37098",335,237,237,1,0,"C's",25
37,"37346",267,222,220,1,2,"C's",24
37,"37189",125,97,97,0,0,"C's",15
37,"37149",70,63,63,0,0,"C's",2
37,"37190",219,167,167,0,0,"C's",11
37,"37115",123,89,87,0,2,"C's",1
37,"37350",421,324,320,4,4,"C's",65
37,"37080",232,176,176,1,0,"C's",24
37,"37281",37,34,33,0,1,"C's",0
37,"37316",751,584,577,5,7,"C's",90
37,"37145",257,190,187,0,3,"C's",21
37,"37032",543,411,410,1,1,"C's",74
37,"37351",281,239,238,0,1,"C's",44
37,"37011",122,91,89,0,2,"C's",12
37,"37123",182,141,138,0,3,"C's",12
37,"37226",156,121,119,1,2,"C's",16
37,"37259",45,30,30,0,0,"C's",7
37,"37040",393,320,317,3,3,"C's",41
37,"37329",36,28,28,0,0,"C's",7
37,"37187",565,431,426,4,5,"C's",49
37,"37158",248,183,181,0,2,"C's",23
37,"37317",306,246,243,1,3,"C's",22
37,"37045",27,20,20,0,0,"C's",5
37,"37260",154,126,126,1,0,"C's",14
37,"37290",140,116,116,0,0,"C's",22
37,"37090",52,38,36,0,2,"C's",2
37,"37261",227,165,161,2,4,"C's",10
37,"37352",204,148,147,0,1,"C's",33
37,"37363",120,98,94,0,4,"C's",8
37,"37180",73,52,52,1,0,"C's",7
37,"37294",11680,8850,8760,84,90,"C's",1914
37,"37303",188,152,151,1,1,"C's",37
37,"37155",73,54,54,1,0,"C's",3
37,"37001",195,147,144,0,3,"C's",16
37,"37159",91,74,74,0,0,"C's",14
37,"37219",179,110,110,0,0,"C's",21
37,"37364",836,598,583,6,15,"C's",63
37,"37193",399,279,278,6,1,"C's",32
37,"37262",78,64,64,1,0,"C's",6
37,"37229",143,102,102,1,0,"C's",10
37,"37353",129,92,92,1,0,"C's",8
37,"37083",179,159,159,0,0,"C's",21
37,"37216",310,264,257,4,7,"C's",42
37,"37296",338,258,255,4,3,"C's",8
37,"37182",77,62,62,0,0,"C's",13
37,"37010",956,716,708,3,8,"C's",94
37,"37354",5182,3955,3915,50,40,"C's",918
37,"37217",56,46,44,1,2,"C's",6
37,"37160",627,450,443,7,7,"C's",38
37,"37049",147,98,98,2,0,"C's",11
37,"37332",69,53,52,0,1,"C's",8
37,"37365",174,147,144,0,3,"C's",24
37,"37003",119,93,90,0,3,"C's",16
37,"37263",348,252,251,1,1,"C's",24
37,"37285",412,311,305,2,6,"C's",24
37,"37286",206,156,156,4,0,"C's",13
37,"37116",69,51,51,0,0,"C's",6
37,"37252",116,89,89,0,0,"C's",9
37,"37127",221,158,158,4,0,"C's",14
37,"37214",125,88,88,1,0,"C's",16
37,"37161",138,109,107,0,2,"C's",8
37,"37344",246,184,183,1,1,"C's",33
37,"37015",222,145,143,3,2,"C's",23
37,"37004",32,22,22,0,0,"C's",2
37,"37086",98,80,80,2,0,"C's",10
37,"37228",367,301,299,1,2,"C's",31
37,"37253",135,110,110,1,0,"C's",21
37,"37334",79,42,42,1,0,"C's",2
37,"37162",206,151,149,2,2,"C's",14
37,"37356",86,73,71,1,2,"C's",7
37,"37299",221,170,163,1,7,"C's",31
37,"37046",11336,8300,8171,62,129,"C's",1346
37,"37330",335,262,258,4,4,"C's",30
37,"37185",591,450,443,4,7,"C's",107
37,"37051",80,54,53,0,1,"C's",1
37,"37181",291,209,207,1,2,"C's",21
37,"37265",217,180,178,2,2,"C's",22
37,"37016",573,451,447,3,4,"C's",110
37,"37052",274,197,197,2,0,"C's",20
37,"37335",415,301,293,2,8,"C's",49
37,"37163",42,33,33,0,0,"C's",8
37,"37368",16,15,15,0,0,"C's",4
37,"37186",106,78,78,3,0,"C's",11
37,"37197",87,55,55,2,0,"C's",6
37,"37039",304,213,213,4,0,"C's",22
37,"37013",121,87,86,3,1,"C's",10
37,"37288",258,211,210,7,1,"C's",56
37,"37358",168,136,135,2,1,"C's",30
37,"37266",84,55,55,1,0,"C's",3
37,"37054",261,199,198,1,1,"C's",13
37,"37336",55,47,47,0,0,"C's",3
37,"37152",424,290,283,2,7,"C's",45
37,"37234",357,224,222,1,2,"C's",12
37,"37369",140,96,96,0,0,"C's",9
37,"37130",173,155,153,5,2,"C's",26
37,"37256",220,158,157,1,1,"C's",16
37,"37029",213,155,152,0,3,"C's",22
37,"37131",190,140,139,0,1,"C's",25
37,"37370",337,258,255,3,3,"C's",35
37,"37037",119,81,81,0,0,"C's",14
37,"37325",91,68,63,0,5,"C's",2
37,"37165",33,27,27,0,0,"C's",5
37,"37154",141,116,112,0,4,"C's",6
37,"37337",139,120,120,2,0,"C's",26
37,"37195",48,35,35,1,0,"C's",3
37,"37367",199,160,158,7,2,"C's",15
37,"37030",84,68,66,0,2,"C's",9
37,"37223",109,90,87,0,3,"C's",5
37,"37188",185,127,125,3,2,"C's",18
37,"37166",213,142,142,1,0,"C's",16
37,"37327",185,157,157,5,0,"C's",34
37,"37078",823,670,657,8,13,"C's",68
37,"37360",230,167,166,2,1,"C's",31
37,"37338",78,66,66,1,0,"C's",5
37,"37371",281,183,177,1,6,"C's",20
37,"37151",146,116,115,2,1,"C's",14
37,"37247",199,162,154,3,8,"C's",13
37,"37236",139,94,89,0,5,"C's",12
37,"37200",190,134,133,2,1,"C's",10
37,"37156",4310,3173,3126,27,47,"C's",490
37,"37020",430,340,334,3,6,"C's",40
37,"37042",42,29,29,2,0,"C's",6
37,"37269",452,328,328,2,0,"C's",55
37,"37304",170,114,109,4,5,"C's",9
37,"37057",213,168,167,0,1,"C's",11
37,"37110",117,92,89,1,3,"C's",11
37,"37372",146,117,115,0,2,"C's",15
37,"37361",84,56,55,0,1,"C's",4
37,"37044",470,353,341,1,12,"C's",65
37,"37270",190,142,139,1,3,"C's",19
37,"37099",73,45,45,2,0,"C's",1
37,"37339",316,257,257,4,0,"C's",15
37,"37362",4592,3442,3403,48,39,"C's",883
37,"37201",262,179,177,0,2,"C's",44
37,"37305",216,170,169,2,1,"C's",25
37,"37271",361,283,276,3,7,"C's",28
37,"37022",268,220,219,2,1,"C's",26
37,"37157",77,62,62,0,0,"C's",11
37,"37134",230,175,173,1,2,"C's",20
37,"37340",150,105,104,1,1,"C's",14
37,"37202",978,773,763,7,10,"C's",175
37,"37373",755,548,545,3,3,"C's",67
37,"37100",81,68,67,1,1,"C's",19
37,"37058",61,43,42,0,1,"C's",1
37,"37169",176,139,137,0,2,"C's",26
37,"37055",123,105,98,0,7,"C's",5
37,"37341",56,43,41,0,2,"C's",3
37,"37272",136,97,96,0,1,"C's",10
37,"37023",1378,1116,1105,9,11,"C's",325
37,"37203",165,118,118,0,0,"C's",11
37,"37374",1178,971,943,8,28,"C's",106
37,"37132",351,272,269,2,3,"C's",18
37,"37101",163,122,122,2,0,"C's",6
37,"37059",124,100,98,0,2,"C's",9
37,"37125",228,158,156,3,2,"C's",22
37,"37170",1479,1055,1031,10,24,"C's",194
37,"37047",167,83,83,0,0,"C's",7
37,"37024",92,77,77,0,0,"C's",6
37,"37002",144,87,87,0,0,"C's",10
37,"37060",245,192,192,0,0,"C's",46
37,"37273",108,77,77,0,0,"C's",4
37,"37342",256,210,208,1,2,"C's",41
37,"37375",705,593,582,11,11,"C's",62
37,"37307",160,103,103,0,0,"C's",5
37,"37171",411,321,317,1,4,"C's",49
37,"37376",2251,1588,1568,9,20,"C's",276
37,"37204",280,214,211,1,3,"C's",21
37,"37309",45,28,28,0,0,"C's",2
37,"37148",425,304,295,6,9,"C's",32
37,"37274",119148,88959,88152,853,807,"C's",15432
37,"37137",105,73,73,0,0,"C's",12
37,"37061",226,166,164,1,2,"C's",27
37,"37172",878,580,576,3,4,"C's",75
37,"37297",420,342,331,4,11,"C's",29
37,"37241",172,128,126,1,2,"C's",10
37,"37343",62,49,49,0,0,"C's",19
37,"37205",233,201,197,1,4,"C's",24
37,"37230",221,167,167,2,0,"C's",18
37,"37050",67,47,46,1,1,"C's",2
37,"37062",84,67,66,1,1,"C's",9
37,"37366",43,27,27,0,0,"C's",2
37,"37242",91,71,71,0,0,"C's",8
37,"37138",199,155,154,4,1,"C's",11
37,"37377",249,199,195,3,4,"C's",19
37,"37026",192,158,154,2,4,"C's",22
37,"37135",1211,932,925,10,7,"C's",128
37,"37206",94,71,71,4,0,"C's",10
37,"37264",67,43,43,0,0,"C's",7
37,"37139",205,163,162,2,1,"C's",42
37,"37063",74,59,59,1,0,"C's",8
37,"37104",27,21,21,0,0,"C's",2
37,"37311",226,182,182,2,0,"C's",31
37,"37378",111,74,70,2,4,"C's",3
37,"37005",77,58,56,0,2,"C's",5
37,"37322",2472,1691,1676,12,15,"C's",279
37,"37027",228,187,187,0,0,"C's",26
37,"37243",102,76,76,0,0,"C's",8
37,"37174",1065,838,826,3,12,"C's",108
37,"37254",183,153,149,0,4,"C's",23
37,"37276",149,100,99,0,1,"C's",22
37,"37140",678,440,435,2,5,"C's",84
37,"37207",303,234,233,0,1,"C's",59
37,"37028",150,111,110,1,1,"C's",3
37,"37233",65,45,45,0,0,"C's",1
37,"37379",173,134,134,2,0,"C's",23
37,"37312",262,211,210,3,1,"C's",16
37,"37277",73,55,55,0,0,"C's",9
37,"37017",251,186,184,2,2,"C's",26
37,"37107",10855,7694,7598,96,96,"C's",1198
37,"37065",323,237,235,0,2,"C's",19
37,"37175",407,316,314,5,2,"C's",27
37,"37119",109,86,86,1,0,"C's",6
37,"37267",199,151,147,2,4,"C's",30
37,"37380",55,46,46,2,0,"C's",11
37,"37209",406,281,280,7,1,"C's",39
37,"37347",477,365,359,3,6,"C's",65
37,"37018",105,80,80,1,0,"C's",9
37,"37278",753,573,568,7,5,"C's",177
37,"37067",3125,2551,2523,22,28,"C's",596
37,"37381",139,98,92,0,6,"C's",15
37,"37176",137,100,98,0,2,"C's",7
37,"37096",220,174,174,5,0,"C's",27
37,"37314",87,74,72,0,2,"C's",10
37,"37268",116,71,70,0,1,"C's",12
37,"37246",5335,4190,4152,41,38,"C's",683
37,"37275",123,87,86,1,1,"C's",2
37,"37142",592,453,451,2,2,"C's",107
37,"37041",74,48,48,0,0,"C's",13
37,"37177",298,223,221,1,2,"C's",29
37,"37068",366,272,271,5,1,"C's",23
37,"37279",763,572,562,11,10,"C's",81
37,"37211",223,163,163,4,0,"C's",29
37,"37109",182,119,118,0,1,"C's",14
37,"37056",41,30,30,0,0,"C's",4
37,"37382",180,133,133,4,0,"C's",6
37,"37031",365,258,257,1,1,"C's",38
37,"37097",36,30,30,0,0,"C's",1
37,"37121",584,434,430,5,4,"C's",47
37,"37280",79,50,50,0,0,"C's",4
37,"37349",112,83,82,0,1,"C's",13
37,"37069",976,713,699,9,14,"C's",112
21,"21058",2602,1904,1886,8,18,"PACMA",6
21,"21032",1805,1378,1359,15,19,"PACMA",3
21,"21031",1209,845,828,3,17,"PACMA",2
21,"21055",6914,5286,5218,34,68,"PACMA",40
21,"21029",1564,1166,1126,16,40,"PACMA",4
21,"21010",14684,8766,8698,92,68,"PACMA",80
21,"21047",1914,1213,1179,19,34,"PACMA",11
21,"21043",1858,1356,1341,13,15,"PACMA",13
21,"21075",351,270,266,2,4,"PACMA",0
21,"21050",12448,8431,8382,86,49,"PACMA",58
21,"21025",4049,2682,2653,25,29,"PACMA",21
21,"21014",4041,3203,3170,15,33,"PACMA",13
21,"21076",2123,1549,1532,13,17,"PACMA",5
21,"21060",11959,7565,7488,103,77,"PACMA",80
21,"21059",220,167,165,3,2,"PACMA",0
21,"21007",6231,4285,4227,45,58,"PACMA",30
21,"21033",536,399,395,0,4,"PACMA",3
21,"21017",3643,2301,2269,17,32,"PACMA",11
21,"21018",1780,1152,1131,10,21,"PACMA",3
21,"21023",2147,1379,1357,6,22,"PACMA",8
21,"21074",2660,1869,1844,18,25,"PACMA",5
21,"21042",15349,7802,7708,106,94,"PACMA",68
21,"21069",1715,1186,1175,7,11,"PACMA",5
21,"21003",695,533,525,1,8,"PACMA",2
21,"21052",4618,2837,2773,20,64,"PACMA",23
21,"21036",192,138,138,1,0,"PACMA",1
21,"21009",860,571,555,6,16,"PACMA",5
21,"21038",1082,732,719,8,13,"PACMA",0
21,"21062",1395,936,926,9,10,"PACMA",0
21,"21016",1034,777,764,2,13,"PACMA",0
21,"21021",12233,7551,7470,94,81,"PACMA",53
21,"21004",1641,1070,1047,10,23,"PACMA",12
21,"21044",17552,10820,10692,106,128,"PACMA",105
21,"21077",1722,1261,1246,5,15,"PACMA",7
21,"21027",49,36,36,1,0,"PACMA",0
21,"21045",253,192,190,0,2,"PACMA",0
21,"21053",3316,2257,2219,25,38,"PACMA",3
21,"21071",204,160,158,2,2,"PACMA",0
21,"21078",2763,1928,1907,12,21,"PACMA",8
21,"21006",3402,2398,2359,13,39,"PACMA",6
21,"21005",15486,10310,10189,64,121,"PACMA",61
21,"21008",2662,1847,1831,14,16,"PACMA",3
21,"21028",381,290,287,0,3,"PACMA",1
21,"21061",5092,3471,3429,32,42,"PACMA",14
21,"21056",2912,2115,2024,20,91,"PACMA",11
21,"21063",2614,2044,2034,12,10,"PACMA",6
21,"21022",174,115,109,1,6,"PACMA",1
21,"21026",270,184,178,1,6,"PACMA",2
21,"21057",1045,641,640,8,1,"PACMA",2
21,"21072",10280,7869,7777,76,92,"PACMA",48
21,"21068",998,606,605,14,1,"PACMA",2
21,"21001",648,479,469,4,10,"PACMA",3
21,"21070",6296,4450,4397,38,53,"PACMA",35
21,"21051",245,176,173,1,3,"PACMA",0
21,"21012",322,234,227,0,7,"PACMA",1
21,"21041",113604,74902,74244,718,658,"PACMA",1024
21,"21013",10597,7220,7061,69,159,"PACMA",84
21,"21040",3158,2386,2345,15,41,"PACMA",24
21,"21039",308,223,222,2,1,"PACMA",1
21,"21067",415,309,303,0,6,"PACMA",0
21,"21064",6526,4544,4492,51,52,"PACMA",43
21,"21030",1824,1491,1472,11,19,"PACMA",7
21,"21048",305,220,220,3,0,"PACMA",1
21,"21019",590,433,423,4,10,"PACMA",2
21,"21002",15348,10939,10864,80,75,"PACMA",170
21,"21054",8105,6025,5919,41,106,"PACMA",42
21,"21046",1703,1200,1173,15,27,"PACMA",4
21,"21035",9622,6399,6313,69,86,"PACMA",44
21,"21079",731,526,522,3,4,"PACMA",0
21,"21024",495,350,344,5,6,"PACMA",1
21,"21049",3372,2162,2108,15,54,"PACMA",11
21,"21073",1871,1134,1120,12,14,"PACMA",3
21,"21065",287,202,196,0,6,"PACMA",0
21,"21020",372,241,238,2,3,"PACMA",2
21,"21037",472,364,360,2,4,"PACMA",0
21,"21015",683,425,420,6,5,"PACMA",1
21,"21011",3464,2536,2518,19,18,"PACMA",22
21,"21066",507,408,405,1,3,"PACMA",1
21,"21034",1207,848,838,8,10,"PACMA",5
23,"23026",3636,2724,2685,11,39,"SAIn",2
23,"23082",1924,1420,1413,6,7,"SAIn",0
23,"23067",2489,1869,1847,18,22,"SAIn",1
23,"23050",91221,67753,67164,549,589,"SAIn",80
23,"23016",396,323,318,3,5,"SAIn",0
23,"23075",3319,2640,2618,21,22,"SAIn",1
23,"23086",11537,8362,8242,91,120,"SAIn",5
23,"23064",1659,1368,1364,1,4,"SAIn",0
23,"23097",6445,4313,4290,30,23,"SAIn",3
23,"23002",17450,13199,12986,92,213,"SAIn",5
23,"23087",11313,8540,8454,64,86,"SAIn",4
23,"23079",3733,2994,2981,26,13,"SAIn",0
23,"23096",2643,2174,2140,14,34,"SAIn",0
23,"23903",3550,2742,2721,19,21,"SAIn",0
23,"23066",4376,3530,3508,46,22,"SAIn",2
23,"23902",2327,1877,1857,9,20,"SAIn",0
23,"23032",575,461,457,1,4,"SAIn",0
23,"23081",1546,1145,1132,6,13,"SAIn",0
23,"23041",504,396,392,1,4,"SAIn",0
23,"23062",1461,1188,1181,1,7,"SAIn",0
23,"23015",1393,1061,1052,3,9,"SAIn",0
23,"23052",1138,977,971,6,6,"SAIn",1
23,"23093",3257,2534,2506,21,28,"SAIn",0
23,"23035",1095,871,867,8,4,"SAIn",0
23,"23060",19157,13567,13438,133,129,"SAIn",3
23,"23080",1786,1347,1329,6,18,"SAIn",0
23,"23091",742,609,607,5,2,"SAIn",0
23,"23028",6203,4645,4585,33,60,"SAIn",1
23,"23046",2405,1963,1934,3,29,"SAIn",0
23,"23017",1584,1265,1253,4,12,"SAIn",0
23,"23099",4734,3509,3459,23,50,"SAIn",0
23,"23049",1834,1384,1378,7,6,"SAIn",0
23,"23018",2326,1678,1668,5,10,"SAIn",0
23,"23001",993,826,820,1,6,"SAIn",0
23,"23008",1518,1185,1173,18,12,"SAIn",0
23,"23061",7520,5481,5405,55,76,"SAIn",0
23,"23030",1232,1020,1007,10,13,"SAIn",0
23,"23070",3931,2549,2533,11,16,"SAIn",2
23,"23063",3845,2934,2898,24,36,"SAIn",0
23,"23088",6124,4764,4703,31,61,"SAIn",0
23,"23047",1638,1311,1306,9,5,"SAIn",0
23,"23074",3030,2368,2353,12,15,"SAIn",2
23,"23055",47421,33170,32908,213,262,"SAIn",11
23,"23027",727,577,576,8,1,"SAIn",0
23,"23069",5385,4406,4318,15,88,"SAIn",4
23,"23090",1316,1077,1071,8,6,"SAIn",1
23,"23042",299,220,220,1,0,"SAIn",0
23,"23038",3557,2851,2831,11,20,"SAIn",0
23,"23094",3852,3097,3061,17,36,"SAIn",0
23,"23012",4177,3016,2988,22,28,"SAIn",2
23,"23033",1356,1080,1065,8,15,"SAIn",0
23,"23085",2273,1833,1814,3,19,"SAIn",0
23,"23095",8737,6303,6268,34,35,"SAIn",5
23,"23905",1861,1351,1345,7,6,"SAIn",1
23,"23043",549,401,400,0,1,"SAIn",0
23,"23044",4847,3801,3740,26,61,"SAIn",1
23,"23003",8709,6520,6440,42,80,"SAIn",2
23,"23901",1160,978,972,5,6,"SAIn",1
23,"23101",388,281,279,0,2,"SAIn",1
23,"23065",1601,1222,1207,0,15,"SAIn",1
23,"23058",8665,6651,6585,47,66,"SAIn",1
23,"23098",875,728,722,2,6,"SAIn",0
23,"23072",2002,1593,1582,6,11,"SAIn",0
23,"23054",382,276,275,0,1,"SAIn",0
23,"23007",3102,2381,2369,8,12,"SAIn",0
23,"23045",2139,1560,1551,9,9,"SAIn",0
23,"23009",12866,9787,9667,64,120,"SAIn",10
23,"23904",2852,1784,1764,14,20,"SAIn",0
23,"23039",2220,1658,1626,8,32,"SAIn",2
23,"23014",2561,1982,1959,8,23,"SAIn",0
23,"23056",3108,2365,2343,14,22,"SAIn",0
23,"23010",14371,10249,10140,65,109,"SAIn",1
23,"23077",637,515,514,3,1,"SAIn",0
23,"23084",953,711,708,6,3,"SAIn",0
23,"23051",2762,2258,2231,9,27,"SAIn",1
23,"23057",771,648,648,4,0,"SAIn",0
23,"23029",854,631,623,2,8,"SAIn",0
23,"23048",860,636,630,1,6,"SAIn",0
23,"23031",751,662,650,9,12,"SAIn",0
23,"23019",1562,1249,1227,4,22,"SAIn",0
23,"23076",837,672,658,4,14,"SAIn",0
23,"23037",516,427,423,1,4,"SAIn",0
23,"23053",9526,6783,6736,49,47,"SAIn",2
23,"23005",30539,21840,21629,176,211,"SAIn",12
23,"23020",1584,1376,1366,5,10,"SAIn",0
23,"23004",435,350,346,0,4,"SAIn",0
23,"23024",12512,9391,9182,79,209,"SAIn",0
23,"23011",2193,1616,1600,11,16,"SAIn",0
23,"23073",4558,3427,3402,11,25,"SAIn",0
23,"23025",2813,2186,2163,7,23,"SAIn",3
23,"23059",5856,4498,4450,33,48,"SAIn",0
23,"23021",528,452,448,0,4,"SAIn",0
23,"23071",1728,1337,1328,7,9,"SAIn",1
23,"23040",1489,1226,1211,4,15,"SAIn",1
23,"23034",2558,1987,1977,18,10,"SAIn",0
23,"23006",4636,3761,3714,25,47,"SAIn",1
23,"23092",27765,20688,20560,143,128,"SAIn",20
24,"24213",158,117,117,0,0,"RECORTES CE",3
24,"24209",2790,1907,1884,15,23,"RECORTES CE",4
24,"24902",354,273,272,2,1,"RECORTES CE",0
24,"24065",2106,1573,1545,16,28,"RECORTES CE",5
24,"24034",3419,2596,2556,27,40,"RECORTES CE",2
24,"24077",227,195,192,1,3,"RECORTES CE",0
24,"24156",243,169,169,1,0,"RECORTES CE",0
24,"24014",7474,5375,5321,56,54,"RECORTES CE",11
24,"24095",314,246,244,1,2,"RECORTES CE",0
24,"24184",206,121,120,0,1,"RECORTES CE",0
24,"24006",488,351,342,4,9,"RECORTES CE",0
24,"24093",380,249,248,3,1,"RECORTES CE",0
24,"24087",645,469,466,11,3,"RECORTES CE",0
24,"24015",2279,1693,1658,22,35,"RECORTES CE",3
24,"24011",209,113,112,0,1,"RECORTES CE",0
24,"24107",244,184,183,2,1,"RECORTES CE",0
24,"24153",233,173,172,3,1,"RECORTES CE",0
24,"24230",423,329,324,2,5,"RECORTES CE",0
24,"24097",225,146,145,1,1,"RECORTES CE",1
24,"24187",876,642,631,6,11,"RECORTES CE",0
24,"24024",695,496,494,4,2,"RECORTES CE",2
24,"24059",887,520,512,8,8,"RECORTES CE",1
24,"24019",359,293,291,3,2,"RECORTES CE",0
24,"24212",1029,784,774,7,10,"RECORTES CE",1
24,"24229",427,330,324,8,6,"RECORTES CE",0
24,"24108",377,279,273,3,6,"RECORTES CE",1
24,"24198",602,411,402,4,9,"RECORTES CE",0
24,"24203",96,73,72,1,1,"RECORTES CE",0
24,"24227",1617,1146,1142,14,4,"RECORTES CE",2
24,"24054",433,308,303,4,5,"RECORTES CE",0
24,"24151",492,357,357,1,0,"RECORTES CE",1
24,"24160",692,506,498,2,8,"RECORTES CE",0
24,"24222",14249,10663,10532,119,131,"RECORTES CE",16
24,"24109",996,667,652,7,15,"RECORTES CE",0
24,"24051",433,308,307,1,1,"RECORTES CE",1
24,"24157",2580,2013,1983,25,30,"RECORTES CE",2
24,"24106",258,178,173,1,5,"RECORTES CE",0
24,"24193",384,277,276,4,1,"RECORTES CE",0
24,"24211",276,210,206,4,4,"RECORTES CE",0
24,"24158",323,210,207,0,3,"RECORTES CE",0
24,"24162",1671,1314,1303,21,11,"RECORTES CE",4
24,"24161",291,218,212,2,6,"RECORTES CE",0
24,"24112",318,207,207,0,0,"RECORTES CE",0
24,"24052",171,109,108,0,1,"RECORTES CE",0
24,"24092",809,619,609,1,10,"RECORTES CE",2
24,"24104",266,180,179,0,1,"RECORTES CE",0
24,"24010",8426,5980,5888,61,92,"RECORTES CE",14
24,"24194",292,230,229,1,1,"RECORTES CE",0
24,"24021",1688,1213,1189,6,24,"RECORTES CE",0
24,"24141",98,76,75,0,1,"RECORTES CE",0
24,"24132",628,397,390,6,7,"RECORTES CE",0
24,"24159",1832,1407,1391,17,16,"RECORTES CE",1
24,"24146",271,195,194,0,1,"RECORTES CE",0
24,"24150",243,175,175,3,0,"RECORTES CE",0
24,"24175",1825,1381,1372,13,9,"RECORTES CE",2
24,"24125",475,285,282,2,3,"RECORTES CE",0
24,"24166",1413,1043,1014,7,29,"RECORTES CE",3
24,"24228",666,455,449,2,6,"RECORTES CE",1
24,"24096",124,74,74,0,0,"RECORTES CE",0
24,"24018",177,143,141,0,2,"RECORTES CE",0
24,"24183",805,528,522,5,6,"RECORTES CE",0
24,"24223",2640,2012,2012,53,0,"RECORTES CE",4
24,"24099",173,133,133,2,0,"RECORTES CE",0
24,"24131",742,499,497,5,2,"RECORTES CE",2
24,"24210",510,347,347,0,0,"RECORTES CE",1
24,"24117",446,333,331,2,2,"RECORTES CE",0
24,"24182",420,289,287,6,2,"RECORTES CE",0
24,"24036",301,181,180,0,1,"RECORTES CE",0
24,"24020",463,294,291,5,3,"RECORTES CE",0
24,"24029",754,545,539,2,6,"RECORTES CE",1
24,"24173",943,678,673,3,5,"RECORTES CE",1
24,"24007",764,578,576,3,2,"RECORTES CE",2
24,"24190",167,115,115,2,0,"RECORTES CE",0
24,"24124",374,249,246,4,3,"RECORTES CE",1
24,"24110",1253,932,926,7,6,"RECORTES CE",0
24,"24016",478,287,285,1,2,"RECORTES CE",1
24,"24217",136,110,109,1,1,"RECORTES CE",0
24,"24055",705,510,507,6,3,"RECORTES CE",1
24,"24152",462,302,301,2,1,"RECORTES CE",1
24,"24115",54290,39886,39486,325,400,"RECORTES CE",63
24,"24207",296,245,241,3,4,"RECORTES CE",0
24,"24196",2082,1529,1513,15,16,"RECORTES CE",0
24,"24044",171,125,118,0,7,"RECORTES CE",0
24,"24105",1443,1087,1065,10,22,"RECORTES CE",3
24,"24145",655,445,443,8,2,"RECORTES CE",0
24,"24225",1020,786,773,6,13,"RECORTES CE",0
24,"24164",373,190,190,1,0,"RECORTES CE",0
24,"24028",386,304,302,3,2,"RECORTES CE",0
24,"24081",142,97,97,0,0,"RECORTES CE",0
24,"24025",300,233,228,0,5,"RECORTES CE",0
24,"24031",216,169,167,1,2,"RECORTES CE",0
24,"24062",142,105,105,1,0,"RECORTES CE",0
24,"24191",111,84,84,1,0,"RECORTES CE",0
24,"24181",1519,1135,1117,10,18,"RECORTES CE",0
24,"24116",424,276,273,0,3,"RECORTES CE",0
24,"24144",704,487,478,5,9,"RECORTES CE",1
24,"24039",2077,1604,1600,39,4,"RECORTES CE",4
24,"24100",769,569,561,4,8,"RECORTES CE",2
24,"24103",292,160,160,1,0,"RECORTES CE",0
24,"24102",655,495,492,2,3,"RECORTES CE",0
24,"24206",1732,1303,1288,8,15,"RECORTES CE",2
24,"24216",732,533,522,2,11,"RECORTES CE",0
24,"24134",3465,2628,2583,27,45,"RECORTES CE",3
24,"24063",391,260,259,1,1,"RECORTES CE",0
24,"24189",6016,4187,4134,58,53,"RECORTES CE",16
24,"24023",268,189,188,2,1,"RECORTES CE",38
24,"24043",135,69,67,0,2,"RECORTES CE",0
24,"24154",1010,750,729,7,21,"RECORTES CE",3
24,"24067",645,383,379,2,4,"RECORTES CE",0
24,"24017",582,434,433,9,1,"RECORTES CE",2
24,"24136",544,391,390,8,1,"RECORTES CE",1
24,"24121",655,481,477,0,4,"RECORTES CE",0
24,"24179",299,202,201,8,1,"RECORTES CE",0
24,"24114",3107,2174,2155,7,19,"RECORTES CE",0
24,"24084",162,119,119,1,0,"RECORTES CE",0
24,"24033",211,154,151,1,3,"RECORTES CE",0
24,"24047",782,533,527,7,6,"RECORTES CE",1
24,"24037",369,251,251,0,0,"RECORTES CE",0
24,"24089",103315,77803,77038,779,765,"RECORTES CE",123
24,"24053",439,303,298,2,5,"RECORTES CE",1
24,"24168",461,383,379,4,4,"RECORTES CE",0
24,"24061",1702,1244,1231,13,13,"RECORTES CE",1
24,"24155",478,380,371,0,9,"RECORTES CE",0
24,"24027",1214,881,860,8,21,"RECORTES CE",1
24,"24901",908,660,653,4,7,"RECORTES CE",0
24,"24218",454,331,329,3,2,"RECORTES CE",0
24,"24058",205,137,134,0,3,"RECORTES CE",1
24,"24082",870,692,682,10,10,"RECORTES CE",0
24,"24137",1114,811,804,9,7,"RECORTES CE",2
24,"24038",3107,2383,2354,30,29,"RECORTES CE",2
24,"24201",1086,765,757,5,8,"RECORTES CE",1
24,"24188",3843,2962,2899,48,63,"RECORTES CE",9
24,"24064",1525,1165,1151,10,14,"RECORTES CE",2
24,"24002",236,182,180,3,2,"RECORTES CE",0
24,"24215",156,119,118,1,1,"RECORTES CE",0
24,"24022",342,227,227,0,0,"RECORTES CE",2
24,"24040",453,315,309,2,6,"RECORTES CE",0
24,"24163",3929,3076,3044,49,32,"RECORTES CE",7
24,"24009",322,161,161,1,0,"RECORTES CE",0
24,"24113",366,282,275,3,7,"RECORTES CE",1
24,"24042",61,48,48,1,0,"RECORTES CE",0
24,"24197",770,545,537,6,8,"RECORTES CE",2
24,"24139",2186,1608,1570,24,38,"RECORTES CE",2
24,"24185",482,357,349,4,8,"RECORTES CE",0
24,"24091",657,440,437,2,3,"RECORTES CE",0
24,"24008",9319,6964,6852,77,112,"RECORTES CE",7
24,"24180",1128,825,814,12,11,"RECORTES CE",0
24,"24130",437,319,315,1,4,"RECORTES CE",3
24,"24071",1006,747,738,9,9,"RECORTES CE",1
24,"24076",1279,972,953,7,19,"RECORTES CE",1
24,"24032",111,82,82,1,0,"RECORTES CE",0
24,"24129",122,85,85,1,0,"RECORTES CE",0
24,"24221",790,568,558,6,10,"RECORTES CE",2
24,"24202",8098,5654,5582,51,72,"RECORTES CE",4
24,"24001",188,108,108,0,0,"RECORTES CE",1
24,"24070",4159,3206,3162,31,44,"RECORTES CE",5
24,"24030",4297,3226,3180,16,46,"RECORTES CE",3
24,"24177",481,328,327,1,1,"RECORTES CE",0
24,"24219",527,390,387,2,3,"RECORTES CE",0
24,"24178",71,58,57,0,1,"RECORTES CE",0
24,"24119",702,491,480,6,11,"RECORTES CE",0
24,"24149",155,123,121,0,2,"RECORTES CE",0
24,"24005",387,267,259,6,8,"RECORTES CE",0
24,"24041",548,384,381,5,3,"RECORTES CE",0
24,"24199",433,284,281,3,3,"RECORTES CE",0
24,"24174",495,362,357,3,5,"RECORTES CE",0
24,"24142",25160,18503,18262,205,241,"RECORTES CE",23
24,"24079",922,654,645,9,9,"RECORTES CE",1
24,"24090",348,226,224,1,2,"RECORTES CE",1
24,"24046",953,662,645,6,17,"RECORTES CE",1
24,"24205",967,714,706,9,8,"RECORTES CE",1
24,"24224",621,452,445,7,7,"RECORTES CE",0
24,"24078",388,286,284,4,2,"RECORTES CE",0
24,"24172",420,218,216,1,2,"RECORTES CE",0
24,"24060",615,361,359,0,2,"RECORTES CE",0
24,"24012",297,212,211,4,1,"RECORTES CE",0
24,"24101",404,264,262,2,2,"RECORTES CE",0
24,"24120",345,214,214,1,0,"RECORTES CE",0
24,"24094",1392,1048,1038,11,10,"RECORTES CE",5
24,"24066",504,367,361,3,6,"RECORTES CE",0
24,"24003",652,442,435,5,7,"RECORTES CE",2
24,"24165",373,254,250,2,4,"RECORTES CE",1
24,"24069",42,36,36,0,0,"RECORTES CE",0
24,"24068",464,343,339,5,4,"RECORTES CE",0
24,"24056",2910,2102,2068,31,34,"RECORTES CE",3
24,"24004",469,349,349,6,0,"RECORTES CE",1
24,"24148",1684,1268,1256,9,12,"RECORTES CE",1
24,"24049",1493,1152,1138,8,14,"RECORTES CE",0
24,"24170",1934,1436,1424,13,12,"RECORTES CE",3
24,"24127",301,239,239,3,0,"RECORTES CE",0
24,"24073",481,343,340,3,3,"RECORTES CE",1
24,"24086",271,200,198,1,2,"RECORTES CE",0
24,"24098",1205,880,874,8,6,"RECORTES CE",0
24,"24122",1351,965,948,9,17,"RECORTES CE",0
24,"24169",2976,2256,2236,12,20,"RECORTES CE",1
24,"24143",514,391,379,4,12,"RECORTES CE",0
24,"24123",757,499,497,4,2,"RECORTES CE",1
24,"24133",350,259,258,3,1,"RECORTES CE",0
24,"24171",364,219,217,1,2,"RECORTES CE",0
24,"24214",669,492,490,1,2,"RECORTES CE",0
24,"24167",763,509,504,9,5,"RECORTES CE",1
24,"24118",127,84,84,1,0,"RECORTES CE",0
24,"24176",318,244,243,5,1,"RECORTES CE",0
24,"24074",99,77,76,1,1,"RECORTES CE",0
24,"24050",102,77,77,1,0,"RECORTES CE",0
24,"24088",1037,804,797,8,7,"RECORTES CE",1
24,"24080",218,170,162,3,8,"RECORTES CE",0
24,"24083",1077,764,755,4,9,"RECORTES CE",2
24,"24226",204,138,136,0,2,"RECORTES CE",0
24,"24026",1203,908,898,19,10,"RECORTES CE",0
24,"24057",1366,1103,1076,11,27,"RECORTES CE",0
20,"20050",263,160,160,4,0,"RECORTES CE",0
20,"20059",8863,6091,6072,30,19,"RECORTES CE",3
20,"20036",13148,9191,9132,85,59,"RECORTES CE",33
20,"20010",1494,1055,1053,4,2,"RECORTES CE",3
20,"20008",721,382,376,5,6,"RECORTES CE",0
20,"20072",4731,3132,3123,23,9,"RECORTES CE",10
20,"20016",1514,885,884,5,1,"RECORTES CE",1
20,"20080",7900,5517,5487,33,30,"RECORTES CE",30
20,"20042",3251,2170,2152,23,18,"RECORTES CE",1
20,"20075",4359,2852,2833,16,19,"RECORTES CE",3
20,"20905",141,105,105,0,0,"RECORTES CE",0
20,"20048",176,104,104,2,0,"RECORTES CE",1
20,"20005",1261,811,805,7,6,"RECORTES CE",1
20,"20046",1167,797,794,4,3,"RECORTES CE",2
20,"20045",46691,32759,32560,222,199,"RECORTES CE",71
20,"20003",541,334,334,3,0,"RECORTES CE",1
20,"20029",4258,3005,2992,17,13,"RECORTES CE",8
20,"20044",368,264,259,0,5,"RECORTES CE",0
20,"20041",258,148,148,2,0,"RECORTES CE",0
20,"20057",201,122,121,0,1,"RECORTES CE",0
20,"20021",199,110,110,2,0,"RECORTES CE",0
20,"20017",8580,5807,5770,37,37,"RECORTES CE",16
20,"20011",1660,1283,1278,9,5,"RECORTES CE",1
20,"20025",1144,774,767,5,7,"RECORTES CE",0
20,"20069",147189,106909,106506,699,403,"RECORTES CE",229
20,"20078",1155,866,864,6,2,"RECORTES CE",1
20,"20040",15321,10260,10176,69,84,"RECORTES CE",31
20,"20067",30825,21606,21512,113,94,"RECORTES CE",44
20,"20034",3157,2145,2141,7,4,"RECORTES CE",7
20,"20038",392,284,281,1,3,"RECORTES CE",0
20,"20060",89,76,75,2,1,"RECORTES CE",0
20,"20066",461,279,276,3,3,"RECORTES CE",0
20,"20043",1740,1157,1152,6,5,"RECORTES CE",1
20,"20004",252,135,135,2,0,"RECORTES CE",0
20,"20023",445,258,258,2,0,"RECORTES CE",1
20,"20009",11528,7997,7955,57,42,"RECORTES CE",18
20,"20074",11610,8382,8320,43,62,"RECORTES CE",17
20,"20015",1272,924,921,9,3,"RECORTES CE",0
20,"20058",746,547,546,3,1,"RECORTES CE",2
20,"20073",4677,3219,3208,21,11,"RECORTES CE",1
20,"20024",393,226,226,2,0,"RECORTES CE",1
20,"20001",242,138,137,1,1,"RECORTES CE",0
20,"20052",1091,797,792,6,5,"RECORTES CE",0
20,"20904",96,62,62,0,0,"RECORTES CE",0
20,"20070",1099,749,744,4,5,"RECORTES CE",0
20,"20006",262,161,159,1,2,"RECORTES CE",0
20,"20032",8785,6115,6076,45,39,"RECORTES CE",11
20,"20056",4104,2654,2633,12,21,"RECORTES CE",8
20,"20906",121,84,84,1,0,"RECORTES CE",0
20,"20020",129,71,71,0,0,"RECORTES CE",0
20,"20027",2816,1842,1833,11,9,"RECORTES CE",1
20,"20030",21515,15110,15019,108,91,"RECORTES CE",24
20,"20063",7990,5449,5415,23,34,"RECORTES CE",11
20,"20022",834,499,494,7,5,"RECORTES CE",1
20,"20049",4124,2793,2780,22,13,"RECORTES CE",9
20,"20028",2255,1503,1494,17,9,"RECORTES CE",0
20,"20012",144,108,108,3,0,"RECORTES CE",0
20,"20019",10053,6876,6844,72,32,"RECORTES CE",29
20,"20033",864,629,625,3,4,"RECORTES CE",1
20,"20039",2111,1539,1532,13,7,"RECORTES CE",0
20,"20076",6978,4975,4958,39,17,"RECORTES CE",9
20,"20071",14818,10095,10057,62,38,"RECORTES CE",19
20,"20081",7460,5187,5159,33,28,"RECORTES CE",7
20,"20026",202,141,129,4,12,"RECORTES CE",0
20,"20037",97,59,59,1,0,"RECORTES CE",0
20,"20068",183,117,115,0,2,"RECORTES CE",0
20,"20051",6904,5001,4975,31,26,"RECORTES CE",10
20,"20035",482,329,328,4,1,"RECORTES CE",0
20,"20055",17522,12125,12043,52,82,"RECORTES CE",12
20,"20002",343,227,226,10,1,"RECORTES CE",0
20,"20054",447,301,297,5,4,"RECORTES CE",0
20,"20062",982,685,684,3,1,"RECORTES CE",2
20,"20047",477,329,329,2,0,"RECORTES CE",0
20,"20901",1441,982,979,2,3,"RECORTES CE",1
20,"20064",12526,8429,8387,59,42,"RECORTES CE",13
20,"20065",3006,2104,2089,18,15,"RECORTES CE",5
20,"20903",4247,2846,2826,9,20,"RECORTES CE",3
20,"20079",17835,12650,12587,81,63,"RECORTES CE",16
20,"20053",4765,3150,3132,18,18,"RECORTES CE",3
20,"20031",180,105,102,1,3,"RECORTES CE",0
20,"20014",1111,635,632,4,3,"RECORTES CE",1
20,"20007",304,209,209,5,0,"RECORTES CE",0
20,"20013",5427,3901,3875,19,26,"RECORTES CE",5
20,"20061",4273,2832,2816,21,16,"RECORTES CE",4
20,"20018",11074,7100,7059,29,41,"RECORTES CE",5
20,"20902",14193,10263,10219,56,44,"RECORTES CE",19
20,"20077",5243,3792,3777,25,15,"RECORTES CE",7
20,"20907",120,85,84,2,1,"RECORTES CE",0
27,"27008",1377,1011,992,11,19,"PT",0
27,"27001",2401,1346,1313,24,33,"PT",2
27,"27060",2651,1761,1729,12,32,"PT",5
27,"27048",2176,1658,1626,19,32,"PT",4
27,"27045",1049,667,658,9,9,"PT",0
27,"27009",2110,1595,1573,11,22,"PT",4
27,"27057",11176,7921,7709,99,212,"PT",12
27,"27035",190,121,121,2,0,"PT",2
27,"27003",1913,1372,1351,16,21,"PT",0
27,"27020",3539,2954,2896,38,58,"PT",4
27,"27024",1624,1250,1226,8,24,"PT",0
27,"27032",3313,2269,2230,29,39,"PT",4
27,"27026",2423,1667,1602,12,65,"PT",1
27,"27017",1017,674,666,6,8,"PT",2
27,"27061",1045,821,796,10,25,"PT",1
27,"27050",2993,2241,2203,16,38,"PT",1
27,"27059",2202,1640,1605,19,35,"PT",6
27,"27040",3225,2454,2415,22,39,"PT",3
27,"27014",3284,2187,2148,29,39,"PT",0
27,"27013",3782,3067,3007,21,60,"PT",6
27,"27047",1643,1116,1104,10,12,"PT",0
27,"27064",1593,1179,1153,14,26,"PT",1
27,"27039",4372,3327,3244,56,83,"PT",3
27,"27021",1772,1167,1136,21,31,"PT",2
27,"27010",4363,3072,2990,45,82,"PT",8
27,"27031",15650,10901,10710,106,191,"PT",18
27,"27063",1761,1340,1299,12,41,"PT",1
27,"27023",2593,1981,1942,24,39,"PT",4
27,"27015",4304,3063,2985,41,78,"PT",5
27,"27049",1422,969,958,8,11,"PT",1
27,"27037",1075,736,723,12,13,"PT",1
27,"27041",2377,1737,1722,16,15,"PT",5
27,"27053",546,349,349,1,0,"PT",0
27,"27033",631,454,449,8,5,"PT",0
27,"27025",2859,2293,2243,17,50,"PT",5
27,"27012",1366,778,769,5,9,"PT",1
27,"27004",1251,846,828,2,18,"PT",2
27,"27022",4859,3324,3251,38,73,"PT",12
27,"27054",1205,920,906,7,14,"PT",1
27,"27011",2490,1623,1592,14,31,"PT",3
27,"27066",12767,9200,9039,102,161,"PT",16
27,"27058",3577,2669,2632,37,37,"PT",4
27,"27029",1475,1142,1116,19,26,"PT",3
27,"27062",619,468,465,6,3,"PT",6
27,"27046",1538,1119,1099,10,20,"PT",3
27,"27038",945,679,674,9,5,"PT",0
27,"27028",79061,57271,56444,702,827,"PT",137
27,"27065",12528,8701,8483,150,218,"PT",18
27,"27042",1759,1258,1235,21,23,"PT",2
27,"27043",1313,875,855,14,20,"PT",1
27,"27016",7204,5069,4987,65,82,"PT",8
27,"27901",2404,1647,1624,25,23,"PT",0
27,"27055",1320,869,855,3,14,"PT",8
27,"27006",2611,1752,1723,26,29,"PT",1
27,"27034",1154,720,710,6,10,"PT",0
27,"27002",1651,1224,1200,8,24,"PT",3
27,"27030",3361,2333,2290,27,43,"PT",5
27,"27018",3514,2279,2255,17,24,"PT",5
27,"27056",1268,899,886,11,13,"PT",1
27,"27052",918,659,649,3,10,"PT",1
27,"27005",2615,1942,1918,16,24,"PT",3
27,"27044",2901,1891,1832,28,59,"PT",6
27,"27019",8120,6041,5936,82,105,"PT",10
27,"27051",8102,5883,5784,71,99,"PT",9
27,"27027",1937,1458,1425,19,33,"PT",0
27,"27902",7196,5017,4921,55,96,"PT",12
27,"27007",2833,2211,2144,34,67,"PT",2
11,"11016",14880,9945,9848,124,97,"P-LIB",5
11,"11012",100460,72741,72128,590,613,"P-LIB",56
11,"11002",4287,3245,3238,15,7,"P-LIB",0
11,"11022",48778,26546,26333,277,213,"P-LIB",13
11,"11004",88617,55218,54733,581,485,"P-LIB",40
11,"11019",1830,1413,1371,5,42,"P-LIB",0
11,"11025",4370,3174,3123,29,51,"P-LIB",0
11,"11005",4560,3203,3143,21,60,"P-LIB",1
11,"11001",4377,2949,2900,17,49,"P-LIB",2
11,"11024",6735,5114,5065,33,49,"P-LIB",2
11,"11018",1485,1109,1090,10,19,"P-LIB",1
11,"11029",5433,3112,3067,27,45,"P-LIB",0
11,"11038",13803,10593,10441,121,152,"P-LIB",7
11,"11021",6777,4826,4779,52,47,"P-LIB",1
11,"11009",602,426,422,5,4,"P-LIB",0
11,"11030",22796,15377,15222,145,155,"P-LIB",6
11,"11020",165400,113865,113092,1184,773,"P-LIB",96
11,"11031",76452,51850,51456,568,394,"P-LIB",33
11,"11017",3207,2389,2362,28,27,"P-LIB",1
11,"11013",2324,1687,1653,16,34,"P-LIB",0
11,"11028",32532,23191,22981,274,210,"P-LIB",8
11,"11035",13569,9000,8908,93,92,"P-LIB",10
11,"11027",68010,46675,46322,400,353,"P-LIB",40
11,"11039",10044,6684,6623,98,61,"P-LIB",4
11,"11032",53898,32432,32172,371,260,"P-LIB",17
11,"11010",6420,4423,4362,63,61,"P-LIB",3
11,"11901",5653,4132,4088,84,44,"P-LIB",3
11,"11006",24504,16649,16486,176,163,"P-LIB",7
11,"11023",9354,6990,6928,86,62,"P-LIB",0
11,"11034",2345,1606,1594,10,12,"P-LIB",0
11,"11041",9856,7043,6967,85,76,"P-LIB",4
11,"11008",17460,11800,11615,151,185,"P-LIB",7
11,"11014",16791,11255,11146,166,109,"P-LIB",9
11,"11003",1270,907,899,12,8,"P-LIB",0
11,"11036",694,439,437,13,2,"P-LIB",0
11,"11033",20773,13487,13333,171,154,"P-LIB",8
11,"11040",398,326,317,3,9,"P-LIB",0
11,"11015",62337,40342,40012,407,330,"P-LIB",23
11,"11026",4804,3581,3511,31,70,"P-LIB",5
11,"11007",18036,10832,10678,181,154,"P-LIB",8
11,"11037",5678,4491,4426,20,65,"P-LIB",0
11,"11042",1189,877,868,5,9,"P-LIB",0
11,"11902",3619,2431,2410,17,21,"P-LIB",2
11,"11011",1688,1239,1205,14,34,"P-LIB",0
34,"34004",5626,4226,4178,41,48,"RECORTES CE",7
34,"34147",167,120,120,1,0,"RECORTES CE",0
34,"34245",311,213,209,4,4,"RECORTES CE",0
34,"34221",179,135,132,3,3,"RECORTES CE",0
34,"34047",1803,1402,1380,15,22,"RECORTES CE",1
34,"34081",61,50,49,0,1,"RECORTES CE",0
34,"34017",920,763,745,2,18,"RECORTES CE",1
34,"34132",115,93,92,0,1,"RECORTES CE",0
34,"34163",49,40,40,0,0,"RECORTES CE",0
34,"34084",140,110,108,1,2,"RECORTES CE",0
34,"34110",91,78,78,2,0,"RECORTES CE",0
34,"34060",137,113,112,1,1,"RECORTES CE",0
34,"34230",15,12,12,0,0,"RECORTES CE",0
34,"34098",780,587,582,2,5,"RECORTES CE",1
34,"34029",727,596,582,4,14,"RECORTES CE",0
34,"34050",202,160,160,0,0,"RECORTES CE",0
34,"34126",279,218,218,2,0,"RECORTES CE",1
34,"34170",62,49,49,0,0,"RECORTES CE",0
34,"34225",4903,3830,3784,41,46,"RECORTES CE",1
34,"34242",95,74,73,1,1,"RECORTES CE",0
34,"34103",96,78,77,2,1,"RECORTES CE",0
34,"34169",404,302,300,2,2,"RECORTES CE",0
34,"34031",29,28,28,1,0,"RECORTES CE",0
34,"34127",95,64,64,2,0,"RECORTES CE",0
34,"34186",51,45,45,0,0,"RECORTES CE",0
34,"34184",55,46,42,0,4,"RECORTES CE",0
34,"34023",5265,3948,3918,38,30,"RECORTES CE",6
34,"34096",57,46,46,3,0,"RECORTES CE",0
34,"34091",123,97,95,1,2,"RECORTES CE",0
34,"34089",157,124,122,1,2,"RECORTES CE",0
34,"34202",31,20,19,0,1,"RECORTES CE",0
34,"34035",113,90,89,1,1,"RECORTES CE",0
34,"34140",107,63,62,0,1,"RECORTES CE",1
34,"34058",184,167,167,0,0,"RECORTES CE",1
34,"34143",172,127,126,3,1,"RECORTES CE",0
34,"34179",29,22,20,0,2,"RECORTES CE",0
34,"34237",597,472,465,5,7,"RECORTES CE",1
34,"34107",81,49,49,3,0,"RECORTES CE",0
34,"34216",67,52,51,0,1,"RECORTES CE",0
34,"34073",187,150,149,0,1,"RECORTES CE",0
34,"34070",160,117,115,2,2,"RECORTES CE",0
34,"34176",134,102,100,2,2,"RECORTES CE",0
34,"34041",89,71,71,1,0,"RECORTES CE",0
34,"34215",163,148,148,2,0,"RECORTES CE",0
34,"34100",142,116,115,5,1,"RECORTES CE",0
34,"34038",277,202,202,3,0,"RECORTES CE",0
34,"34003",163,127,125,0,2,"RECORTES CE",0
34,"34167",114,89,89,0,0,"RECORTES CE",0
34,"34113",37,36,36,0,0,"RECORTES CE",0
34,"34180",68,56,56,2,0,"RECORTES CE",0
34,"34131",59,50,48,0,2,"RECORTES CE",0
34,"34056",2003,1502,1487,12,15,"RECORTES CE",2
34,"34045",77,65,65,2,0,"RECORTES CE",0
34,"34092",297,236,231,2,5,"RECORTES CE",0
34,"34156",49,42,41,3,1,"RECORTES CE",0
34,"34190",56,40,40,3,0,"RECORTES CE",0
34,"34079",1601,1285,1269,11,16,"RECORTES CE",2
34,"34135",391,296,291,4,5,"RECORTES CE",0
34,"34178",113,92,91,5,1,"RECORTES CE",0
34,"34243",326,263,258,2,5,"RECORTES CE",1
34,"34185",65,46,44,2,2,"RECORTES CE",1
34,"34052",178,148,147,3,1,"RECORTES CE",0
34,"34182",792,632,620,3,12,"RECORTES CE",1
34,"34228",81,66,66,0,0,"RECORTES CE",0
34,"34010",570,437,429,5,8,"RECORTES CE",2
34,"34057",476,339,334,3,5,"RECORTES CE",0
34,"34106",114,94,94,2,0,"RECORTES CE",0
34,"34152",124,102,99,1,3,"RECORTES CE",0
34,"34181",453,343,337,3,6,"RECORTES CE",0
34,"34076",597,494,490,3,4,"RECORTES CE",0
34,"34141",182,148,147,4,1,"RECORTES CE",0
34,"34102",205,172,170,1,2,"RECORTES CE",0
34,"34061",108,80,80,0,0,"RECORTES CE",0
34,"34196",91,70,69,1,1,"RECORTES CE",0
34,"34011",398,326,326,3,0,"RECORTES CE",0
34,"34025",61,44,44,1,0,"RECORTES CE",0
34,"34094",61,42,40,1,2,"RECORTES CE",0
34,"34086",105,91,88,1,3,"RECORTES CE",0
34,"34033",18,17,17,0,0,"RECORTES CE",0
34,"34205",59,45,45,0,0,"RECORTES CE",0
34,"34199",1248,955,937,18,18,"RECORTES CE",0
34,"34171",982,720,710,7,10,"RECORTES CE",1
34,"34082",84,71,71,0,0,"RECORTES CE",0
34,"34233",131,116,116,1,0,"RECORTES CE",0
34,"34001",35,28,28,2,0,"RECORTES CE",0
34,"34018",209,169,166,3,3,"RECORTES CE",0
34,"34222",120,82,82,2,0,"RECORTES CE",0
34,"34055",280,204,202,2,2,"RECORTES CE",0
34,"34083",1773,1259,1244,8,15,"RECORTES CE",4
34,"34123",1668,1346,1319,20,27,"RECORTES CE",0
34,"34059",422,348,341,6,7,"RECORTES CE",0
34,"34210",102,90,89,0,1,"RECORTES CE",0
34,"34125",88,69,68,1,1,"RECORTES CE",0
34,"34032",41,32,31,0,1,"RECORTES CE",0
34,"34080",5626,3906,3835,39,71,"RECORTES CE",4
34,"34201",193,163,161,2,2,"RECORTES CE",0
34,"34238",341,279,276,1,3,"RECORTES CE",0
34,"34124",61,47,46,0,1,"RECORTES CE",0
34,"34049",369,280,274,1,6,"RECORTES CE",0
34,"34192",93,76,76,0,0,"RECORTES CE",0
34,"34072",160,142,140,1,2,"RECORTES CE",0
34,"34109",59,48,47,0,1,"RECORTES CE",0
34,"34019",125,103,101,1,2,"RECORTES CE",0
34,"34160",143,112,110,1,2,"RECORTES CE",0
34,"34159",363,277,269,4,8,"RECORTES CE",0
34,"34101",54,42,42,0,0,"RECORTES CE",0
34,"34174",205,162,162,4,0,"RECORTES CE",0
34,"34229",67,55,55,1,0,"RECORTES CE",0
34,"34069",2285,1711,1692,25,19,"RECORTES CE",4
34,"34240",90,71,70,2,1,"RECORTES CE",0
34,"34024",32,19,19,0,0,"RECORTES CE",0
34,"34034",126,93,93,1,0,"RECORTES CE",0
34,"34130",213,175,172,2,3,"RECORTES CE",0
34,"34137",28,24,24,1,0,"RECORTES CE",0
34,"34133",107,85,82,0,3,"RECORTES CE",0
34,"34020",53,39,39,0,0,"RECORTES CE",0
34,"34037",310,218,217,4,1,"RECORTES CE",2
34,"34161",23,14,14,0,0,"RECORTES CE",0
34,"34009",33,29,26,1,3,"RECORTES CE",0
34,"34151",167,111,111,3,0,"RECORTES CE",0
34,"34155",135,105,104,1,1,"RECORTES CE",0
34,"34146",55,42,42,0,0,"RECORTES CE",0
34,"34022",1095,915,909,8,6,"RECORTES CE",0
34,"34154",76,54,52,0,2,"RECORTES CE",0
34,"34904",319,241,240,3,1,"RECORTES CE",0
34,"34149",20,15,15,0,0,"RECORTES CE",0
34,"34139",168,126,124,6,2,"RECORTES CE",0
34,"34246",64,49,47,1,2,"RECORTES CE",0
34,"34067",129,95,95,0,0,"RECORTES CE",0
34,"34012",362,277,272,4,5,"RECORTES CE",0
34,"34108",537,453,446,5,7,"RECORTES CE",1
34,"34213",58,43,42,2,1,"RECORTES CE",0
34,"34088",231,192,190,2,2,"RECORTES CE",1
34,"34104",247,203,199,0,4,"RECORTES CE",0
34,"34071",172,140,139,4,1,"RECORTES CE",0
34,"34068",25,24,24,1,0,"RECORTES CE",0
34,"34063",86,80,79,1,1,"RECORTES CE",0
34,"34053",209,170,168,4,2,"RECORTES CE",0
34,"34077",349,253,246,0,7,"RECORTES CE",0
34,"34231",232,167,167,4,0,"RECORTES CE",0
34,"34223",219,159,158,1,1,"RECORTES CE",0
34,"34227",76,62,62,1,0,"RECORTES CE",0
34,"34015",39,32,31,1,1,"RECORTES CE",0
34,"34028",144,121,119,1,2,"RECORTES CE",0
34,"34175",89,75,74,1,1,"RECORTES CE",0
34,"34122",84,66,65,0,1,"RECORTES CE",0
34,"34211",180,151,149,3,2,"RECORTES CE",0
34,"34208",53,41,41,1,0,"RECORTES CE",0
34,"34120",64404,49403,48884,379,519,"RECORTES CE",97
34,"34129",179,139,137,2,2,"RECORTES CE",0
34,"34217",1200,954,934,6,20,"RECORTES CE",5
34,"34241",18,13,12,2,1,"RECORTES CE",0
34,"34006",80,69,66,1,3,"RECORTES CE",0
34,"34232",748,601,586,11,15,"RECORTES CE",2
34,"34157",2460,1872,1836,26,36,"RECORTES CE",1
34,"34114",212,147,146,2,1,"RECORTES CE",0
34,"34189",57,45,45,1,0,"RECORTES CE",0
34,"34224",45,31,31,0,0,"RECORTES CE",0
34,"34121",192,155,154,2,1,"RECORTES CE",0
34,"34099",61,51,50,0,1,"RECORTES CE",0
34,"34039",61,46,45,0,1,"RECORTES CE",0
34,"34062",176,111,111,3,0,"RECORTES CE",1
34,"34204",47,39,39,2,0,"RECORTES CE",0
34,"34218",469,353,349,2,4,"RECORTES CE",0
34,"34074",719,552,545,8,7,"RECORTES CE",0
34,"34066",58,45,45,0,0,"RECORTES CE",0
34,"34168",55,51,51,1,0,"RECORTES CE",0
34,"34177",179,149,148,1,1,"RECORTES CE",0
34,"34036",216,167,165,1,2,"RECORTES CE",0
34,"34134",53,37,37,2,0,"RECORTES CE",0
34,"34027",1096,786,781,11,5,"RECORTES CE",1
34,"34236",162,126,126,1,0,"RECORTES CE",2
34,"34901",1126,881,865,6,16,"RECORTES CE",0
34,"34093",90,72,70,0,2,"RECORTES CE",0
34,"34903",198,128,127,1,1,"RECORTES CE",0
34,"34165",66,59,59,0,0,"RECORTES CE",0
34,"34116",62,41,41,0,0,"RECORTES CE",0
34,"34206",879,688,680,3,8,"RECORTES CE",0
34,"34220",144,129,128,0,1,"RECORTES CE",0
34,"34051",102,90,88,1,2,"RECORTES CE",0
34,"34005",858,670,651,6,19,"RECORTES CE",1
34,"34214",186,150,149,1,1,"RECORTES CE",0
34,"34087",127,109,108,1,1,"RECORTES CE",0
34,"34046",43,31,29,0,2,"RECORTES CE",0
34,"34136",182,121,120,1,1,"RECORTES CE",0
34,"34158",290,190,188,3,2,"RECORTES CE",0
34,"34902",140,115,114,0,1,"RECORTES CE",0
34,"34112",47,38,38,0,0,"RECORTES CE",0
34,"34042",300,247,244,4,3,"RECORTES CE",0
34,"34234",72,57,55,0,2,"RECORTES CE",0
34,"34048",76,64,64,1,0,"RECORTES CE",0
37,"37022",268,220,219,2,1,"UPYD",0
37,"37272",136,97,96,0,1,"UPYD",1
37,"37136",667,453,448,2,5,"UPYD",5
37,"37073",583,449,442,8,7,"UPYD",8
37,"37369",140,96,96,0,0,"UPYD",0
37,"37237",325,250,248,4,2,"UPYD",0
37,"37248",152,127,126,2,1,"UPYD",1
37,"37355",189,147,146,1,1,"UPYD",0
37,"37324",371,284,279,4,5,"UPYD",1
37,"37080",232,176,176,1,0,"UPYD",1
37,"37036",63,46,46,0,0,"UPYD",0
37,"37328",189,142,140,0,2,"UPYD",0
37,"37049",147,98,98,2,0,"UPYD",1
37,"37215",136,102,101,2,1,"UPYD",0
37,"37264",67,43,43,0,0,"UPYD",0
37,"37254",183,153,149,0,4,"UPYD",0
37,"37232",390,349,348,0,1,"UPYD",0
37,"37278",753,573,568,7,5,"UPYD",7
37,"37373",755,548,545,3,3,"UPYD",1
37,"37213",87,73,73,0,0,"UPYD",0
37,"37147",191,141,136,0,5,"UPYD",1
37,"37364",836,598,583,6,15,"UPYD",0
37,"37159",91,74,74,0,0,"UPYD",0
37,"37338",78,66,66,1,0,"UPYD",1
37,"37042",42,29,29,2,0,"UPYD",0
37,"37370",337,258,255,3,3,"UPYD",4
37,"37101",163,122,122,2,0,"UPYD",1
37,"37024",92,77,77,0,0,"UPYD",0
37,"37320",93,71,71,1,0,"UPYD",0
37,"37148",425,304,295,6,9,"UPYD",1
37,"37366",43,27,27,0,0,"UPYD",0
37,"37164",256,200,195,1,5,"UPYD",1
37,"37323",521,387,385,8,2,"UPYD",2
37,"37037",119,81,81,0,0,"UPYD",0
37,"37013",121,87,86,3,1,"UPYD",1
37,"37273",108,77,77,0,0,"UPYD",0
37,"37067",3125,2551,2523,22,28,"UPYD",27
37,"37380",55,46,46,2,0,"UPYD",2
37,"37371",281,183,177,1,6,"UPYD",0
37,"37003",119,93,90,0,3,"UPYD",1
37,"37285",412,311,305,2,6,"UPYD",0
37,"37077",260,234,230,0,4,"UPYD",2
37,"37103",446,326,325,4,1,"UPYD",2
37,"37071",78,73,72,1,1,"UPYD",0
37,"37180",73,52,52,1,0,"UPYD",0
37,"37241",172,128,126,1,2,"UPYD",0
37,"37205",233,201,197,1,4,"UPYD",1
37,"37132",351,272,269,2,3,"UPYD",0
37,"37011",122,91,89,0,2,"UPYD",1
37,"37211",223,163,163,4,0,"UPYD",1
37,"37114",88,67,66,1,1,"UPYD",0
37,"37115",123,89,87,0,2,"UPYD",0
37,"37124",219,149,148,0,1,"UPYD",1
37,"37035",194,161,161,0,0,"UPYD",1
37,"37247",199,162,154,3,8,"UPYD",1
37,"37327",185,157,157,5,0,"UPYD",0
37,"37331",217,150,148,1,2,"UPYD",0
37,"37375",705,593,582,11,11,"UPYD",3
37,"37319",117,78,77,0,1,"UPYD",1
37,"37257",53,43,43,0,0,"UPYD",1
37,"37194",252,191,190,2,1,"UPYD",0
37,"37177",298,223,221,1,2,"UPYD",0
37,"37277",73,55,55,0,0,"UPYD",0
37,"37152",424,290,283,2,7,"UPYD",1
37,"37192",353,245,242,2,3,"UPYD",0
37,"37353",129,92,92,1,0,"UPYD",0
37,"37255",51,38,38,0,0,"UPYD",0
37,"37357",276,216,215,0,1,"UPYD",0
37,"37007",439,321,313,4,8,"UPYD",0
37,"37358",168,136,135,2,1,"UPYD",1
37,"37074",153,109,103,4,6,"UPYD",2
37,"37186",106,78,78,3,0,"UPYD",0
37,"37002",144,87,87,0,0,"UPYD",0
37,"37198",206,161,160,3,1,"UPYD",1
37,"37234",357,224,222,1,2,"UPYD",3
37,"37015",222,145,143,3,2,"UPYD",0
37,"37026",192,158,154,2,4,"UPYD",0
37,"37365",174,147,144,0,3,"UPYD",1
37,"37039",304,213,213,4,0,"UPYD",1
37,"37321",170,131,129,2,2,"UPYD",0
37,"37286",206,156,156,4,0,"UPYD",0
37,"37245",345,252,246,7,6,"UPYD",0
37,"37253",135,110,110,1,0,"UPYD",0
37,"37363",120,98,94,0,4,"UPYD",1
37,"37146",122,100,99,1,1,"UPYD",0
37,"37347",477,365,359,3,6,"UPYD",1
37,"37121",584,434,430,5,4,"UPYD",2
37,"37287",318,237,237,3,0,"UPYD",4
37,"37195",48,35,35,1,0,"UPYD",0
37,"37299",221,170,163,1,7,"UPYD",0
37,"37009",216,161,160,3,1,"UPYD",1
37,"37349",112,83,82,0,1,"UPYD",0
37,"37199",142,108,108,0,0,"UPYD",0
37,"37038",789,628,616,5,12,"UPYD",4
37,"37087",855,681,676,8,5,"UPYD",12
37,"37090",52,38,36,0,2,"UPYD",0
37,"37140",678,440,435,2,5,"UPYD",5
37,"37017",251,186,184,2,2,"UPYD",2
37,"37052",274,197,197,2,0,"UPYD",0
37,"37118",125,96,96,0,0,"UPYD",0
37,"37028",150,111,110,1,1,"UPYD",1
37,"37332",69,53,52,0,1,"UPYD",0
37,"37224",210,183,179,2,4,"UPYD",2
37,"37182",77,62,62,0,0,"UPYD",1
37,"37119",109,86,86,1,0,"UPYD",0
37,"37189",125,97,97,0,0,"UPYD",0
37,"37133",108,82,79,4,3,"UPYD",0
37,"37361",84,56,55,0,1,"UPYD",0
37,"37021",80,62,62,0,0,"UPYD",1
37,"37362",4592,3442,3403,48,39,"UPYD",29
37,"37085",4704,3475,3432,35,43,"UPYD",32
37,"37010",956,716,708,3,8,"UPYD",8
37,"37033",98,63,63,0,0,"UPYD",2
37,"37157",77,62,62,0,0,"UPYD",0
37,"37225",106,94,92,0,2,"UPYD",2
37,"37256",220,158,157,1,1,"UPYD",0
37,"37249",44,33,33,1,0,"UPYD",1
37,"37040",393,320,317,3,3,"UPYD",3
37,"37138",199,155,154,4,1,"UPYD",3
37,"37329",36,28,28,0,0,"UPYD",0
37,"37142",592,453,451,2,2,"UPYD",4
37,"37191",116,78,76,0,2,"UPYD",1
37,"37271",361,283,276,3,7,"UPYD",2
37,"37173",1526,1138,1125,5,13,"UPYD",1
37,"37206",94,71,71,4,0,"UPYD",0
37,"37318",209,156,155,1,1,"UPYD",0
37,"37374",1178,971,943,8,28,"UPYD",4
37,"37055",123,105,98,0,7,"UPYD",0
37,"37235",223,168,163,1,5,"UPYD",1
37,"37242",91,71,71,0,0,"UPYD",1
37,"37125",228,158,156,3,2,"UPYD",2
37,"37046",11336,8300,8171,62,129,"UPYD",55
37,"37034",84,66,66,3,0,"UPYD",2
37,"37382",180,133,133,4,0,"UPYD",0
37,"37016",573,451,447,3,4,"UPYD",1
37,"37246",5335,4190,4152,41,38,"UPYD",11
37,"37005",77,58,56,0,2,"UPYD",1
37,"37360",230,167,166,2,1,"UPYD",0
37,"37296",338,258,255,4,3,"UPYD",1
37,"37031",365,258,257,1,1,"UPYD",0
37,"37047",167,83,83,0,0,"UPYD",0
37,"37065",323,237,235,0,2,"UPYD",1
37,"37354",5182,3955,3915,50,40,"UPYD",39
37,"37216",310,264,257,4,7,"UPYD",1
37,"37044",470,353,341,1,12,"UPYD",1
37,"37006",135,91,90,1,1,"UPYD",0
37,"37088",204,152,152,3,0,"UPYD",0
37,"37251",126,87,87,2,0,"UPYD",2
37,"37014",1161,850,847,5,3,"UPYD",12
37,"37126",30,24,24,0,0,"UPYD",0
37,"37160",627,450,443,7,7,"UPYD",1
37,"37230",221,167,167,2,0,"UPYD",0
37,"37025",258,223,221,2,2,"UPYD",2
37,"37343",62,49,49,0,0,"UPYD",0
37,"37313",555,415,411,1,4,"UPYD",0
37,"37172",878,580,576,3,4,"UPYD",3
37,"37116",69,51,51,0,0,"UPYD",0
37,"37089",67,50,49,0,1,"UPYD",0
37,"37135",1211,932,925,10,7,"UPYD",3
37,"37298",184,125,125,1,0,"UPYD",0
37,"37305",216,170,169,2,1,"UPYD",2
37,"37231",259,208,207,4,1,"UPYD",0
37,"37344",246,184,183,1,1,"UPYD",3
37,"37218",71,33,33,2,0,"UPYD",1
37,"37223",109,90,87,0,3,"UPYD",0
37,"37359",184,131,129,0,2,"UPYD",2
37,"37378",111,74,70,2,4,"UPYD",0
37,"37306",271,171,171,0,0,"UPYD",1
37,"37012",150,117,115,0,2,"UPYD",0
37,"37059",124,100,98,0,2,"UPYD",0
37,"37239",229,196,194,6,2,"UPYD",0
37,"37279",763,572,562,11,10,"UPYD",3
37,"37063",74,59,59,1,0,"UPYD",1
37,"37203",165,118,118,0,0,"UPYD",2
37,"37082",799,570,560,1,10,"UPYD",8
37,"37181",291,209,207,1,2,"UPYD",0
37,"37166",213,142,142,1,0,"UPYD",0
37,"37170",1479,1055,1031,10,24,"UPYD",7
37,"37379",173,134,134,2,0,"UPYD",1
37,"37229",143,102,102,1,0,"UPYD",0
37,"37265",217,180,178,2,2,"UPYD",0
37,"37266",84,55,55,1,0,"UPYD",0
37,"37185",591,450,443,4,7,"UPYD",0
37,"37312",262,211,210,3,1,"UPYD",2
37,"37346",267,222,220,1,2,"UPYD",0
37,"37339",316,257,257,4,0,"UPYD",0
37,"37288",258,211,210,7,1,"UPYD",0
37,"37092",1731,1264,1250,11,14,"UPYD",13
37,"37098",335,237,237,1,0,"UPYD",2
37,"37336",55,47,47,0,0,"UPYD",0
37,"37233",65,45,45,0,0,"UPYD",0
37,"37301",73,62,62,0,0,"UPYD",0
37,"37130",173,155,153,5,2,"UPYD",0
37,"37244",134,91,90,1,1,"UPYD",0
37,"37179",215,173,170,0,3,"UPYD",5
37,"37208",81,49,48,0,1,"UPYD",0
37,"37267",199,151,147,2,4,"UPYD",1
37,"37209",406,281,280,7,1,"UPYD",1
37,"37158",248,183,181,0,2,"UPYD",2
37,"37081",933,720,714,4,6,"UPYD",3
37,"37183",417,305,301,2,4,"UPYD",1
37,"37222",97,66,66,1,0,"UPYD",0
37,"37289",240,182,182,2,0,"UPYD",1
37,"37068",366,272,271,5,1,"UPYD",0
37,"37238",112,88,85,2,3,"UPYD",1
37,"37226",156,121,119,1,2,"UPYD",1
37,"37108",101,81,79,2,2,"UPYD",0
37,"37302",294,216,214,1,2,"UPYD",2
37,"37334",79,42,42,1,0,"UPYD",0
37,"37117",1458,1075,1068,14,7,"UPYD",5
37,"37356",86,73,71,1,2,"UPYD",0
37,"37352",204,148,147,0,1,"UPYD",1
37,"37056",41,30,30,0,0,"UPYD",1
37,"37109",182,119,118,0,1,"UPYD",2
37,"37294",11680,8850,8760,84,90,"UPYD",111
37,"37027",228,187,187,0,0,"UPYD",0
37,"37174",1065,838,826,3,12,"UPYD",5
37,"37079",74,64,63,0,1,"UPYD",1
37,"37020",430,340,334,3,6,"UPYD",4
37,"37196",77,54,53,0,1,"UPYD",0
37,"37269",452,328,328,2,0,"UPYD",3
37,"37280",79,50,50,0,0,"UPYD",0
37,"37122",202,158,156,3,2,"UPYD",0
37,"37291",268,206,206,1,0,"UPYD",3
37,"37307",160,103,103,0,0,"UPYD",0
37,"37163",42,33,33,0,0,"UPYD",0
37,"37212",111,83,83,1,0,"UPYD",2
37,"37316",751,584,577,5,7,"UPYD",4
37,"37141",156,127,127,1,0,"UPYD",1
37,"37281",37,34,33,0,1,"UPYD",0
37,"37134",230,175,173,1,2,"UPYD",1
37,"37168",443,319,311,2,8,"UPYD",4
37,"37057",213,168,167,0,1,"UPYD",0
37,"37201",262,179,177,0,2,"UPYD",0
37,"37252",116,89,89,0,0,"UPYD",0
37,"37099",73,45,45,2,0,"UPYD",0
37,"37259",45,30,30,0,0,"UPYD",0
37,"37260",154,126,126,1,0,"UPYD",1
37,"37149",70,63,63,0,0,"UPYD",0
37,"37169",176,139,137,0,2,"UPYD",1
37,"37058",61,43,42,0,1,"UPYD",0
37,"37161",138,109,107,0,2,"UPYD",0
37,"37062",84,67,66,1,1,"UPYD",1
37,"37072",166,133,132,2,1,"UPYD",2
37,"37019",151,114,111,0,3,"UPYD",0
37,"37348",113,91,91,1,0,"UPYD",0
37,"37100",81,68,67,1,1,"UPYD",1
37,"37001",195,147,144,0,3,"UPYD",0
37,"37268",116,71,70,0,1,"UPYD",0
37,"37290",140,116,116,0,0,"UPYD",2
37,"37341",56,43,41,0,2,"UPYD",1
37,"37261",227,165,161,2,4,"UPYD",1
37,"37250",358,223,223,1,0,"UPYD",0
37,"37228",367,301,299,1,2,"UPYD",0
37,"37322",2472,1691,1676,12,15,"UPYD",8
37,"37097",36,30,30,0,0,"UPYD",0
37,"37078",823,670,657,8,13,"UPYD",3
37,"37091",176,114,113,2,1,"UPYD",0
37,"37335",415,301,293,2,8,"UPYD",1
37,"37342",256,210,208,1,2,"UPYD",3
37,"37240",907,646,636,5,10,"UPYD",9
37,"37204",280,214,211,1,3,"UPYD",0
37,"37284",325,245,244,2,1,"UPYD",1
37,"37293",118,84,84,0,0,"UPYD",0
37,"37262",78,64,64,1,0,"UPYD",1
37,"37372",146,117,115,0,2,"UPYD",1
37,"37156",4310,3173,3126,27,47,"UPYD",10
37,"37061",226,166,164,1,2,"UPYD",1
37,"37236",139,94,89,0,5,"UPYD",0
37,"37200",190,134,133,2,1,"UPYD",0
37,"37137",105,73,73,0,0,"UPYD",0
37,"37376",2251,1588,1568,9,20,"UPYD",6
37,"37274",119148,88959,88152,853,807,"UPYD",864
37,"37102",411,291,289,3,2,"UPYD",2
37,"37112",161,115,114,0,1,"UPYD",1
37,"37270",190,142,139,1,3,"UPYD",1
37,"37008",4298,3312,3272,16,40,"UPYD",19
37,"37309",45,28,28,0,0,"UPYD",0
37,"37275",123,87,86,1,1,"UPYD",0
37,"37127",221,158,158,4,0,"UPYD",0
37,"37004",32,22,22,0,0,"UPYD",1
37,"37041",74,48,48,0,0,"UPYD",0
37,"37131",190,140,139,0,1,"UPYD",0
37,"37184",345,247,244,1,3,"UPYD",2
37,"37187",565,431,426,4,5,"UPYD",0
37,"37018",105,80,80,1,0,"UPYD",1
37,"37325",91,68,63,0,5,"UPYD",0
37,"37381",139,98,92,0,6,"UPYD",0
37,"37023",1378,1116,1105,9,11,"UPYD",7
37,"37207",303,234,233,0,1,"UPYD",3
37,"37310",180,129,128,2,1,"UPYD",0
37,"37300",575,427,423,3,4,"UPYD",11
37,"37086",98,80,80,2,0,"UPYD",0
37,"37188",185,127,125,3,2,"UPYD",0
37,"37155",73,54,54,1,0,"UPYD",0
37,"37282",209,136,136,0,0,"UPYD",1
37,"37096",220,174,174,5,0,"UPYD",0
37,"37069",976,713,699,9,14,"UPYD",3
37,"37258",180,117,115,1,2,"UPYD",0
37,"37151",146,116,115,2,1,"UPYD",0
37,"37106",266,172,166,1,6,"UPYD",1
37,"37178",99,84,81,0,3,"UPYD",0
37,"37263",348,252,251,1,1,"UPYD",0
37,"37303",188,152,151,1,1,"UPYD",1
37,"37311",226,182,182,2,0,"UPYD",1
37,"37193",399,279,278,6,1,"UPYD",0
37,"37083",179,159,159,0,0,"UPYD",0
37,"37167",173,150,144,2,6,"UPYD",0
37,"37283",120,88,88,1,0,"UPYD",0
37,"37377",249,199,195,3,4,"UPYD",0
37,"37175",407,316,314,5,2,"UPYD",2
37,"37107",10855,7694,7598,96,96,"UPYD",44
37,"37197",87,55,55,2,0,"UPYD",0
37,"37054",261,199,198,1,1,"UPYD",0
37,"37217",56,46,44,1,2,"UPYD",0
37,"37154",141,116,112,0,4,"UPYD",0
37,"37350",421,324,320,4,4,"UPYD",2
37,"37110",117,92,89,1,3,"UPYD",1
37,"37315",93,69,67,1,2,"UPYD",0
37,"37045",27,20,20,0,0,"UPYD",0
37,"37123",182,141,138,0,3,"UPYD",4
37,"37292",103,72,72,1,0,"UPYD",1
37,"37113",430,340,340,3,0,"UPYD",0
37,"37337",139,120,120,2,0,"UPYD",0
37,"37051",80,54,53,0,1,"UPYD",0
37,"37129",251,199,194,1,5,"UPYD",3
37,"37120",99,77,76,1,1,"UPYD",1
37,"37202",978,773,763,7,10,"UPYD",13
37,"37368",16,15,15,0,0,"UPYD",0
37,"37176",137,100,98,0,2,"UPYD",0
37,"37162",206,151,149,2,2,"UPYD",0
37,"37214",125,88,88,1,0,"UPYD",0
37,"37050",67,47,46,1,1,"UPYD",0
37,"37330",335,262,258,4,4,"UPYD",1
37,"37333",225,143,142,4,1,"UPYD",1
37,"37243",102,76,76,0,0,"UPYD",1
37,"37276",149,100,99,0,1,"UPYD",1
37,"37030",84,68,66,0,2,"UPYD",0
37,"37032",543,411,410,1,1,"UPYD",3
37,"37128",264,211,201,4,10,"UPYD",1
37,"37070",533,403,396,4,7,"UPYD",0
37,"37029",213,155,152,0,3,"UPYD",2
37,"37345",166,135,133,3,2,"UPYD",0
37,"37145",257,190,187,0,3,"UPYD",0
37,"37314",87,74,72,0,2,"UPYD",1
37,"37340",150,105,104,1,1,"UPYD",0
37,"37060",245,192,192,0,0,"UPYD",5
37,"37297",420,342,331,4,11,"UPYD",2
37,"37171",411,321,317,1,4,"UPYD",2
37,"37351",281,239,238,0,1,"UPYD",2
37,"37190",219,167,167,0,0,"UPYD",1
37,"37219",179,110,110,0,0,"UPYD",1
37,"37221",434,328,323,2,5,"UPYD",0
37,"37143",385,301,299,1,2,"UPYD",2
37,"37165",33,27,27,0,0,"UPYD",0
37,"37139",205,163,162,2,1,"UPYD",0
37,"37367",199,160,158,7,2,"UPYD",0
37,"37317",306,246,243,1,3,"UPYD",0
37,"37150",43,35,35,0,0,"UPYD",0
37,"37304",170,114,109,4,5,"UPYD",0
37,"37104",27,21,21,0,0,"UPYD",0
37,"37144",370,288,284,2,4,"UPYD",2
19,"19195",40,30,26,1,4,"PODEMOS",5
19,"19288",23,22,22,0,0,"PODEMOS",0
19,"19250",21,16,15,0,1,"PODEMOS",1
19,"19182",39,28,27,0,1,"PODEMOS",11
19,"19135",105,82,82,0,0,"PODEMOS",3
19,"19281",22,18,18,0,0,"PODEMOS",1
19,"19308",65,54,54,0,0,"PODEMOS",5
19,"19223",110,76,76,3,0,"PODEMOS",6
19,"19040",51,41,41,0,0,"PODEMOS",9
19,"19145",48,42,42,2,0,"PODEMOS",2
19,"19176",237,181,181,0,0,"PODEMOS",10
19,"19286",725,557,551,1,6,"PODEMOS",93
19,"19008",37,28,28,0,0,"PODEMOS",13
19,"19018",163,122,119,2,3,"PODEMOS",12
19,"19248",83,66,66,1,0,"PODEMOS",8
19,"19036",271,230,229,1,1,"PODEMOS",26
19,"19220",2305,1613,1600,9,13,"PODEMOS",475
19,"19201",59,51,51,1,0,"PODEMOS",3
19,"19282",161,115,112,0,3,"PODEMOS",8
19,"19174",111,79,78,0,1,"PODEMOS",20
19,"19326",1749,1248,1237,5,11,"PODEMOS",249
19,"19194",98,68,66,0,2,"PODEMOS",9
19,"19233",91,71,71,1,0,"PODEMOS",21
19,"19246",46,36,36,0,0,"PODEMOS",6
19,"19199",19,16,16,1,0,"PODEMOS",1
19,"19269",100,80,79,0,1,"PODEMOS",4
19,"19108",112,90,90,1,0,"PODEMOS",19
19,"19264",38,29,29,0,0,"PODEMOS",5
19,"19245",1179,913,893,6,20,"PODEMOS",94
19,"19121",257,209,208,0,1,"PODEMOS",25
19,"19285",25,16,16,2,0,"PODEMOS",1
19,"19007",479,364,360,2,4,"PODEMOS",42
19,"19148",45,37,37,1,0,"PODEMOS",4
19,"19090",97,77,77,1,0,"PODEMOS",11
19,"19016",64,42,42,0,0,"PODEMOS",8
19,"19046",21452,16321,16151,91,170,"PODEMOS",3500
19,"19261",38,25,25,0,0,"PODEMOS",0
19,"19255",78,61,61,0,0,"PODEMOS",8
19,"19175",34,26,26,1,0,"PODEMOS",2
19,"19132",93,74,74,0,0,"PODEMOS",5
19,"19225",835,645,638,2,7,"PODEMOS",133
19,"19042",26,25,25,0,0,"PODEMOS",5
19,"19095",12,10,10,0,0,"PODEMOS",0
19,"19023",117,101,99,1,2,"PODEMOS",16
19,"19105",2332,1809,1794,11,15,"PODEMOS",365
19,"19331",2611,2010,1982,18,28,"PODEMOS",283
19,"19127",89,56,56,0,0,"PODEMOS",2
19,"19238",42,32,31,2,1,"PODEMOS",3
19,"19119",81,71,71,0,0,"PODEMOS",9
19,"19034",22,18,18,0,0,"PODEMOS",1
19,"19221",50,35,35,0,0,"PODEMOS",0
19,"19123",44,38,38,0,0,"PODEMOS",7
19,"19107",302,262,260,0,2,"PODEMOS",28
19,"19086",1495,1158,1149,7,9,"PODEMOS",127
19,"19057",72,53,52,0,1,"PODEMOS",22
19,"19152",589,448,439,2,9,"PODEMOS",65
19,"19043",80,74,72,0,2,"PODEMOS",2
19,"19013",128,106,106,0,0,"PODEMOS",22
19,"19298",64,49,49,0,0,"PODEMOS",9
19,"19134",26,18,18,0,0,"PODEMOS",4
19,"19071",7746,5748,5678,34,70,"PODEMOS",1042
19,"19293",1868,1379,1364,9,15,"PODEMOS",346
19,"19103",255,205,201,0,4,"PODEMOS",16
19,"19054",190,165,163,3,2,"PODEMOS",7
19,"19333",121,86,83,2,3,"PODEMOS",13
19,"19116",13,11,11,0,0,"PODEMOS",2
19,"19050",15,13,13,0,0,"PODEMOS",2
19,"19163",61,44,43,1,1,"PODEMOS",9
19,"19079",8,7,7,0,0,"PODEMOS",0
19,"19154",66,52,51,0,1,"PODEMOS",2
19,"19139",31,23,23,1,0,"PODEMOS",4
19,"19231",12,8,8,1,0,"PODEMOS",1
19,"19204",154,106,106,3,0,"PODEMOS",13
19,"19020",43,27,26,2,1,"PODEMOS",2
19,"19066",61,49,47,0,2,"PODEMOS",7
19,"19252",67,58,58,0,0,"PODEMOS",5
19,"19258",97,73,73,1,0,"PODEMOS",4
19,"19106",92,67,64,0,3,"PODEMOS",8
19,"19096",93,66,66,0,0,"PODEMOS",14
19,"19314",52,35,34,1,1,"PODEMOS",1
19,"19311",83,58,57,0,1,"PODEMOS",3
19,"19262",139,111,109,0,2,"PODEMOS",11
19,"19006",768,545,538,0,7,"PODEMOS",93
19,"19166",158,125,124,0,1,"PODEMOS",24
19,"19263",27,17,15,0,2,"PODEMOS",2
19,"19067",70,51,50,2,1,"PODEMOS",13
19,"19133",86,73,73,1,0,"PODEMOS",5
19,"19296",30,21,21,0,0,"PODEMOS",2
19,"19048",17,10,10,1,0,"PODEMOS",2
19,"19168",297,227,224,2,3,"PODEMOS",35
19,"19159",94,77,77,0,0,"PODEMOS",6
19,"19185",31,18,18,0,0,"PODEMOS",3
19,"19260",41,38,38,1,0,"PODEMOS",3
19,"19017",69,56,56,0,0,"PODEMOS",9
19,"19259",28,18,18,0,0,"PODEMOS",2
19,"19241",46,35,35,1,0,"PODEMOS",6
19,"19189",120,91,90,2,1,"PODEMOS",14
19,"19251",42,29,28,0,1,"PODEMOS",1
19,"19049",12,11,11,0,0,"PODEMOS",0
19,"19203",31,25,25,0,0,"PODEMOS",7
19,"19045",145,119,117,1,2,"PODEMOS",3
19,"19001",53,36,36,1,0,"PODEMOS",0
19,"19015",81,68,68,0,0,"PODEMOS",10
19,"19257",3446,2532,2499,36,33,"PODEMOS",347
19,"19901",41,37,36,1,1,"PODEMOS",5
19,"19302",58,45,45,1,0,"PODEMOS",5
19,"19187",50,46,44,0,2,"PODEMOS",3
19,"19098",21,20,20,0,0,"PODEMOS",6
19,"19109",43,32,32,3,0,"PODEMOS",0
19,"19244",81,61,59,2,2,"PODEMOS",2
19,"19113",471,365,365,2,0,"PODEMOS",37
19,"19294",23,19,19,1,0,"PODEMOS",3
19,"19024",8143,6017,5944,33,73,"PODEMOS",1296
19,"19211",394,297,291,1,6,"PODEMOS",37
19,"19307",25,23,23,1,0,"PODEMOS",1
19,"19021",1051,788,774,7,14,"PODEMOS",105
19,"19126",1620,1242,1216,5,26,"PODEMOS",259
19,"19078",53,44,44,0,0,"PODEMOS",9
19,"19249",31,27,27,0,0,"PODEMOS",0
19,"19334",36,30,29,0,1,"PODEMOS",0
19,"19321",38,26,26,0,0,"PODEMOS",3
19,"19325",128,89,88,0,1,"PODEMOS",5
19,"19208",43,31,31,0,0,"PODEMOS",5
19,"19138",272,197,196,0,1,"PODEMOS",41
19,"19330",71,64,64,0,0,"PODEMOS",8
19,"19217",59,39,37,0,2,"PODEMOS",4
19,"19061",56,47,47,0,0,"PODEMOS",5
19,"19290",853,568,560,3,8,"PODEMOS",150
19,"19074",73,63,63,0,0,"PODEMOS",26
19,"19291",1215,883,868,0,15,"PODEMOS",147
19,"19242",93,66,62,2,4,"PODEMOS",2
19,"19209",40,28,27,1,1,"PODEMOS",1
19,"19198",17,10,10,0,0,"PODEMOS",1
19,"19283",29,23,23,0,0,"PODEMOS",1
19,"19268",36,26,25,0,1,"PODEMOS",5
19,"19226",48,35,35,0,0,"PODEMOS",7
19,"19279",57,54,54,0,0,"PODEMOS",2
19,"19218",52,35,34,0,1,"PODEMOS",7
19,"19129",29,25,25,0,0,"PODEMOS",4
19,"19104",18,13,13,1,0,"PODEMOS",1
19,"19120",104,92,92,1,0,"PODEMOS",16
19,"19280",3451,2620,2581,14,39,"PODEMOS",609
19,"19041",160,133,132,0,1,"PODEMOS",34
19,"19214",74,54,54,0,0,"PODEMOS",4
19,"19274",895,673,664,8,9,"PODEMOS",103
19,"19124",382,256,253,0,3,"PODEMOS",53
19,"19005",95,71,69,1,2,"PODEMOS",21
19,"19076",31,20,20,0,0,"PODEMOS",0
19,"19289",28,21,21,0,0,"PODEMOS",8
19,"19303",46,39,38,0,1,"PODEMOS",1
19,"19191",13,12,12,0,0,"PODEMOS",4
19,"19299",95,74,74,1,0,"PODEMOS",5
19,"19329",58,49,49,0,0,"PODEMOS",3
19,"19324",179,136,135,0,1,"PODEMOS",4
19,"19219",13,9,9,0,0,"PODEMOS",2
19,"19060",150,115,114,1,1,"PODEMOS",60
19,"19179",72,52,52,1,0,"PODEMOS",5
19,"19162",65,49,49,0,0,"PODEMOS",6
19,"19216",134,97,97,0,0,"PODEMOS",27
19,"19073",24,19,19,0,0,"PODEMOS",4
19,"19002",73,56,54,0,2,"PODEMOS",4
19,"19212",727,562,551,8,11,"PODEMOS",71
19,"19110",57,46,45,2,1,"PODEMOS",4
19,"19027",148,116,115,1,1,"PODEMOS",19
19,"19193",23,22,21,0,1,"PODEMOS",3
19,"19181",55,37,37,0,0,"PODEMOS",4
19,"19172",55,44,44,0,0,"PODEMOS",10
19,"19224",93,80,80,0,0,"PODEMOS",2
19,"19213",72,53,51,0,2,"PODEMOS",1
19,"19111",158,123,121,0,2,"PODEMOS",8
19,"19301",38,30,30,0,0,"PODEMOS",0
19,"19197",25,20,20,0,0,"PODEMOS",7
19,"19044",309,248,246,3,2,"PODEMOS",30
19,"19150",126,94,93,0,1,"PODEMOS",9
19,"19064",73,62,62,0,0,"PODEMOS",6
19,"19190",2405,1852,1833,14,19,"PODEMOS",360
19,"19058",6786,5451,5415,29,36,"PODEMOS",1107
19,"19210",21,19,19,2,0,"PODEMOS",1
19,"19097",17,13,13,0,0,"PODEMOS",2
19,"19173",47,40,37,0,3,"PODEMOS",5
19,"19265",136,104,104,0,0,"PODEMOS",11
19,"19306",28,20,20,0,0,"PODEMOS",1
19,"19318",25,19,19,0,0,"PODEMOS",1
19,"19170",193,140,140,0,0,"PODEMOS",28
19,"19155",66,54,53,0,1,"PODEMOS",13
19,"19065",127,103,102,1,1,"PODEMOS",24
19,"19222",115,87,86,1,1,"PODEMOS",11
19,"19332",93,68,68,0,0,"PODEMOS",9
19,"19010",9,9,9,0,0,"PODEMOS",1
19,"19215",165,142,141,0,1,"PODEMOS",6
19,"19319",4425,3336,3304,21,32,"PODEMOS",761
19,"19125",45,40,40,0,0,"PODEMOS",5
19,"19184",75,48,46,0,2,"PODEMOS",3
19,"19278",29,28,28,2,0,"PODEMOS",0
19,"19171",4884,3824,3778,24,46,"PODEMOS",778
19,"19082",85,62,62,0,0,"PODEMOS",17
19,"19142",260,189,186,2,3,"PODEMOS",45
19,"19300",762,628,624,3,4,"PODEMOS",157
19,"19122",93,72,72,3,0,"PODEMOS",9
19,"19167",132,106,103,0,3,"PODEMOS",11
19,"19188",50,34,32,1,2,"PODEMOS",3
19,"19270",22,18,18,0,0,"PODEMOS",4
19,"19039",60,55,54,1,1,"PODEMOS",3
19,"19003",41,37,35,0,2,"PODEMOS",15
19,"19271",47,30,30,0,0,"PODEMOS",0
19,"19052",27,18,18,1,0,"PODEMOS",0
19,"19019",19,17,16,0,1,"PODEMOS",1
19,"19114",39,26,26,0,0,"PODEMOS",2
19,"19011",254,191,191,2,0,"PODEMOS",29
19,"19323",42,33,33,0,0,"PODEMOS",7
19,"19115",24,14,14,1,0,"PODEMOS",0
19,"19192",1723,1354,1342,9,12,"PODEMOS",89
19,"19277",18,12,12,0,0,"PODEMOS",2
19,"19004",66,51,50,1,1,"PODEMOS",2
19,"19022",632,477,468,3,9,"PODEMOS",54
19,"19317",141,107,103,0,4,"PODEMOS",19
19,"19146",42,34,34,0,0,"PODEMOS",4
19,"19009",261,193,190,5,3,"PODEMOS",13
19,"19239",100,70,69,1,1,"PODEMOS",4
19,"19147",46,34,33,0,1,"PODEMOS",8
19,"19310",11,7,7,0,0,"PODEMOS",3
19,"19284",10,8,8,0,0,"PODEMOS",1
19,"19304",220,161,161,1,0,"PODEMOS",47
19,"19112",57,49,49,0,0,"PODEMOS",6
19,"19335",54,45,45,0,0,"PODEMOS",3
19,"19235",97,63,62,0,1,"PODEMOS",12
19,"19143",1733,1371,1352,9,19,"PODEMOS",177
19,"19169",43,36,36,0,0,"PODEMOS",9
19,"19033",64,49,49,3,0,"PODEMOS",6
19,"19156",983,743,735,5,8,"PODEMOS",63
19,"19117",1580,1183,1167,11,16,"PODEMOS",228
19,"19161",218,151,151,1,0,"PODEMOS",27
19,"19102",101,84,84,0,0,"PODEMOS",6
19,"19237",47,35,34,1,1,"PODEMOS",12
19,"19099",299,206,205,1,1,"PODEMOS",42
19,"19243",43,36,36,0,0,"PODEMOS",9
19,"19200",75,53,53,1,0,"PODEMOS",12
19,"19160",899,601,597,2,4,"PODEMOS",163
19,"19153",23,22,22,0,0,"PODEMOS",10
19,"19267",19,12,12,0,0,"PODEMOS",0
19,"19254",49,36,36,1,0,"PODEMOS",5
19,"19297",31,21,21,1,0,"PODEMOS",0
19,"19087",18,17,17,0,0,"PODEMOS",0
19,"19228",29,21,20,0,1,"PODEMOS",8
19,"19165",48,40,40,0,0,"PODEMOS",11
19,"19151",1075,779,764,5,15,"PODEMOS",113
19,"19051",70,65,65,0,0,"PODEMOS",6
19,"19070",79,59,59,0,0,"PODEMOS",6
19,"19080",73,51,50,0,1,"PODEMOS",6
19,"19157",57,45,45,0,0,"PODEMOS",11
19,"19136",18,15,15,0,0,"PODEMOS",2
19,"19075",63,37,36,0,1,"PODEMOS",2
19,"19227",74,49,49,0,0,"PODEMOS",9
19,"19031",15,10,9,0,1,"PODEMOS",2
19,"19081",31,21,21,0,0,"PODEMOS",1
19,"19059",79,60,59,0,1,"PODEMOS",2
19,"19177",78,60,57,1,3,"PODEMOS",8
19,"19178",39,25,25,0,0,"PODEMOS",6
19,"19287",144,109,109,0,0,"PODEMOS",3
19,"19202",13,12,12,0,0,"PODEMOS",3
19,"19327",431,348,342,3,6,"PODEMOS",12
19,"19037",146,113,113,1,0,"PODEMOS",8
19,"19055",53,34,33,2,1,"PODEMOS",4
19,"19266",241,201,199,2,2,"PODEMOS",10
19,"19229",69,60,60,1,0,"PODEMOS",7
19,"19032",175,131,124,1,7,"PODEMOS",23
19,"19186",81,63,63,1,0,"PODEMOS",6
19,"19234",46,38,38,0,0,"PODEMOS",5
19,"19247",148,106,102,1,4,"PODEMOS",24
19,"19053",2024,1479,1464,13,15,"PODEMOS",158
19,"19091",29,20,20,0,0,"PODEMOS",0
19,"19230",504,383,376,4,7,"PODEMOS",85
19,"19047",67,60,60,1,0,"PODEMOS",18
19,"19089",28,17,17,0,0,"PODEMOS",1
19,"19272",72,59,59,1,0,"PODEMOS",8
19,"19118",13,10,10,0,0,"PODEMOS",3
19,"19183",83,74,73,0,1,"PODEMOS",11
19,"19092",417,316,312,4,4,"PODEMOS",35
19,"19309",26,22,22,0,0,"PODEMOS",8
19,"19088",84,68,68,0,0,"PODEMOS",10
19,"19305",162,129,128,1,1,"PODEMOS",9
19,"19256",44,35,35,0,0,"PODEMOS",2
19,"19038",28,23,23,0,0,"PODEMOS",2
19,"19232",79,60,59,1,1,"PODEMOS",3
19,"19196",106,86,80,0,6,"PODEMOS",9
19,"19322",31,26,26,0,0,"PODEMOS",2
19,"19130",59955,47034,46504,383,530,"PODEMOS",7336
19,"19240",52,38,37,0,1,"PODEMOS",5
9,"9225",84,57,56,1,1,"RECORTES CE",0
9,"9228",163,138,138,0,0,"RECORTES CE",0
9,"9430",24,19,19,0,0,"RECORTES CE",1
9,"9109",1068,698,669,10,29,"RECORTES CE",9
9,"9140",128,88,87,0,1,"RECORTES CE",0
9,"9386",58,44,43,2,1,"RECORTES CE",0
9,"9294",111,88,86,0,2,"RECORTES CE",1
9,"9257",92,80,78,4,2,"RECORTES CE",1
9,"9242",81,65,63,2,2,"RECORTES CE",0
9,"9191",39,32,30,0,2,"RECORTES CE",0
9,"9136",192,151,147,2,4,"RECORTES CE",0
9,"9180",136,102,100,2,2,"RECORTES CE",0
9,"9016",85,64,64,2,0,"RECORTES CE",0
9,"9061",166,124,123,1,1,"RECORTES CE",0
9,"9122",96,66,66,0,0,"RECORTES CE",0
9,"9356",42,31,31,0,0,"RECORTES CE",0
9,"9152",263,193,192,0,1,"RECORTES CE",0
9,"9149",34,25,24,0,1,"RECORTES CE",0
9,"9190",91,56,55,0,1,"RECORTES CE",0
9,"9217",361,265,261,4,4,"RECORTES CE",0
9,"9208",211,139,136,3,3,"RECORTES CE",0
9,"9478",45,38,38,0,0,"RECORTES CE",0
9,"9280",27,17,17,0,0,"RECORTES CE",0
9,"9154",142,104,104,2,0,"RECORTES CE",1
9,"9433",60,52,51,0,1,"RECORTES CE",0
9,"9423",27,25,25,0,0,"RECORTES CE",0
9,"9389",77,56,56,0,0,"RECORTES CE",0
9,"9338",219,173,171,1,2,"RECORTES CE",1
9,"9403",96,78,76,1,2,"RECORTES CE",0
9,"9098",516,396,388,6,8,"RECORTES CE",1
9,"9201",30,17,17,0,0,"RECORTES CE",0
9,"9431",119,99,98,0,1,"RECORTES CE",1
9,"9123",40,35,35,0,0,"RECORTES CE",0
9,"9467",66,46,46,3,0,"RECORTES CE",0
9,"9392",53,40,40,0,0,"RECORTES CE",0
9,"9036",38,31,30,2,1,"RECORTES CE",0
9,"9388",36,31,30,1,1,"RECORTES CE",1
9,"9330",1523,1166,1148,15,18,"RECORTES CE",1
9,"9256",362,261,255,2,6,"RECORTES CE",2
9,"9273",53,41,40,1,1,"RECORTES CE",0
9,"9130",79,63,62,1,1,"RECORTES CE",0
9,"9239",53,44,42,1,2,"RECORTES CE",0
9,"9485",55,43,43,1,0,"RECORTES CE",0
9,"9083",37,33,33,0,0,"RECORTES CE",0
9,"9088",66,44,42,1,2,"RECORTES CE",0
9,"9323",64,47,47,0,0,"RECORTES CE",0
9,"9347",141,113,109,4,4,"RECORTES CE",0
9,"9246",622,458,455,5,3,"RECORTES CE",2
9,"9068",29,23,22,0,1,"RECORTES CE",0
9,"9314",95,80,79,1,1,"RECORTES CE",0
9,"9079",46,40,37,0,3,"RECORTES CE",0
9,"9328",77,55,55,1,0,"RECORTES CE",0
9,"9438",544,446,444,3,2,"RECORTES CE",2
9,"9151",458,364,363,3,1,"RECORTES CE",0
9,"9425",514,369,366,2,3,"RECORTES CE",0
9,"9220",76,62,61,2,1,"RECORTES CE",0
9,"9276",387,280,273,2,7,"RECORTES CE",1
9,"9407",27,23,23,1,0,"RECORTES CE",0
9,"9110",80,49,49,1,0,"RECORTES CE",0
9,"9050",72,54,54,0,0,"RECORTES CE",0
9,"9270",163,122,121,1,1,"RECORTES CE",0
9,"9065",147,124,123,2,1,"RECORTES CE",0
9,"9181",302,231,225,3,6,"RECORTES CE",0
9,"9102",37,31,31,0,0,"RECORTES CE",0
9,"9444",72,48,48,2,0,"RECORTES CE",0
9,"9428",107,87,87,0,0,"RECORTES CE",0
9,"9231",70,49,49,3,0,"RECORTES CE",0
9,"9358",249,191,191,1,0,"RECORTES CE",0
9,"9281",147,109,107,0,2,"RECORTES CE",0
9,"9904",482,389,384,5,5,"RECORTES CE",2
9,"9138",90,73,72,0,1,"RECORTES CE",0
9,"9458",466,380,377,3,3,"RECORTES CE",4
9,"9200",48,37,36,0,1,"RECORTES CE",0
9,"9159",56,48,48,1,0,"RECORTES CE",0
9,"9418",82,63,62,3,1,"RECORTES CE",0
9,"9214",684,452,446,6,6,"RECORTES CE",0
9,"9039",58,38,38,0,0,"RECORTES CE",0
9,"9238",932,576,569,6,7,"RECORTES CE",1
9,"9442",380,287,282,2,5,"RECORTES CE",0
9,"9312",98,83,82,0,1,"RECORTES CE",0
9,"9113",464,383,376,6,7,"RECORTES CE",0
9,"9414",201,148,147,1,1,"RECORTES CE",1
9,"9451",238,199,198,1,1,"RECORTES CE",0
9,"9059",136713,106605,105601,976,1004,"RECORTES CE",247
9,"9289",1466,1027,1013,6,14,"RECORTES CE",0
9,"9168",296,233,231,1,2,"RECORTES CE",1
9,"9466",134,99,99,0,0,"RECORTES CE",0
9,"9450",27,21,20,1,1,"RECORTES CE",0
9,"9334",48,39,38,0,1,"RECORTES CE",0
9,"9248",78,57,57,0,0,"RECORTES CE",0
9,"9223",46,39,39,0,0,"RECORTES CE",0
9,"9440",96,78,78,0,0,"RECORTES CE",0
9,"9215",377,264,260,0,4,"RECORTES CE",1
9,"9439",1005,823,816,9,7,"RECORTES CE",4
9,"9117",77,61,57,0,4,"RECORTES CE",0
9,"9183",51,37,37,0,0,"RECORTES CE",0
9,"9295",60,37,37,0,0,"RECORTES CE",0
9,"9133",40,34,34,0,0,"RECORTES CE",0
9,"9427",1428,1014,1003,12,11,"RECORTES CE",0
9,"9311",60,52,50,0,2,"RECORTES CE",0
9,"9132",173,132,130,0,2,"RECORTES CE",1
9,"9211",1462,1086,1070,11,16,"RECORTES CE",2
9,"9227",119,97,95,0,2,"RECORTES CE",0
9,"9339",128,103,103,0,0,"RECORTES CE",0
9,"9170",203,152,149,1,3,"RECORTES CE",1
9,"9023",1096,848,840,9,8,"RECORTES CE",4
9,"9275",192,138,137,1,1,"RECORTES CE",1
9,"9272",294,206,203,1,3,"RECORTES CE",0
9,"9387",118,96,95,0,1,"RECORTES CE",0
9,"9316",104,83,80,1,3,"RECORTES CE",0
9,"9029",168,134,132,3,2,"RECORTES CE",0
9,"9432",189,143,140,1,3,"RECORTES CE",0
9,"9026",397,314,311,1,3,"RECORTES CE",1
9,"9382",33,30,29,1,1,"RECORTES CE",1
9,"9301",616,513,506,5,7,"RECORTES CE",0
9,"9411",149,111,111,0,0,"RECORTES CE",0
9,"9108",378,290,287,2,3,"RECORTES CE",1
9,"9194",2024,1550,1530,17,20,"RECORTES CE",3
9,"9340",76,49,49,0,0,"RECORTES CE",0
9,"9454",47,34,34,0,0,"RECORTES CE",0
9,"9041",28,28,28,1,0,"RECORTES CE",0
9,"9176",61,45,44,0,1,"RECORTES CE",0
9,"9033",89,75,75,0,0,"RECORTES CE",0
9,"9001",27,26,26,0,0,"RECORTES CE",0
9,"9086",687,475,471,0,4,"RECORTES CE",0
9,"9360",30,27,27,0,0,"RECORTES CE",0
9,"9054",100,73,72,3,1,"RECORTES CE",0
9,"9006",61,41,41,0,0,"RECORTES CE",0
9,"9119",46,27,27,0,0,"RECORTES CE",0
9,"9277",119,101,100,0,1,"RECORTES CE",0
9,"9218",360,272,271,2,1,"RECORTES CE",1
9,"9177",1117,830,825,5,5,"RECORTES CE",1
9,"9058",393,293,289,2,4,"RECORTES CE",0
9,"9279",177,130,130,0,0,"RECORTES CE",0
9,"9128",82,66,66,0,0,"RECORTES CE",0
9,"9007",59,41,41,0,0,"RECORTES CE",0
9,"9134",228,152,152,2,0,"RECORTES CE",0
9,"9164",165,121,121,1,0,"RECORTES CE",0
9,"9419",78,45,44,0,1,"RECORTES CE",0
9,"9143",27,20,20,0,0,"RECORTES CE",0
9,"9076",23,14,14,0,0,"RECORTES CE",0
9,"9105",107,88,86,0,2,"RECORTES CE",0
9,"9091",732,516,512,7,4,"RECORTES CE",0
9,"9038",118,97,94,0,3,"RECORTES CE",0
9,"9353",73,57,56,0,1,"RECORTES CE",0
9,"9390",611,478,477,3,1,"RECORTES CE",1
9,"9125",596,435,433,3,2,"RECORTES CE",1
9,"9483",212,161,161,1,0,"RECORTES CE",0
9,"9095",86,62,62,0,0,"RECORTES CE",0
9,"9071",45,34,34,0,0,"RECORTES CE",0
9,"9241",201,156,155,3,1,"RECORTES CE",1
9,"9378",31,21,21,1,0,"RECORTES CE",0
9,"9020",262,187,180,2,7,"RECORTES CE",0
9,"9115",92,69,68,0,1,"RECORTES CE",1
9,"9009",163,130,128,2,2,"RECORTES CE",4
9,"9027",47,44,41,0,3,"RECORTES CE",0
9,"9304",202,166,163,1,3,"RECORTES CE",0
9,"9172",125,102,102,2,0,"RECORTES CE",0
9,"9351",60,46,45,1,1,"RECORTES CE",1
9,"9093",154,133,128,1,5,"RECORTES CE",0
9,"9327",25,22,22,0,0,"RECORTES CE",0
9,"9247",23,19,19,0,0,"RECORTES CE",0
9,"9405",128,89,89,0,0,"RECORTES CE",0
9,"9035",313,243,240,0,3,"RECORTES CE",0
9,"9127",55,40,40,0,0,"RECORTES CE",0
9,"9003",192,148,146,2,2,"RECORTES CE",0
9,"9261",463,339,330,8,9,"RECORTES CE",0
9,"9274",1098,880,872,9,8,"RECORTES CE",0
9,"9021",56,33,31,0,2,"RECORTES CE",0
9,"9369",442,331,328,1,3,"RECORTES CE",1
9,"9317",16,14,14,0,0,"RECORTES CE",0
9,"9226",66,55,53,0,2,"RECORTES CE",0
9,"9141",610,499,493,4,6,"RECORTES CE",0
9,"9460",177,135,135,2,0,"RECORTES CE",0
9,"9352",116,97,97,0,0,"RECORTES CE",0
9,"9372",221,190,189,1,1,"RECORTES CE",0
9,"9024",156,117,114,0,3,"RECORTES CE",1
9,"9139",101,75,73,2,2,"RECORTES CE",0
9,"9030",109,76,76,3,0,"RECORTES CE",0
9,"9216",385,283,280,8,3,"RECORTES CE",0
9,"9394",727,558,552,8,6,"RECORTES CE",0
9,"9413",447,333,333,5,0,"RECORTES CE",0
9,"9101",79,59,59,0,0,"RECORTES CE",0
9,"9043",189,132,132,2,0,"RECORTES CE",0
9,"9329",123,86,86,1,0,"RECORTES CE",0
9,"9253",111,96,94,1,2,"RECORTES CE",0
9,"9085",475,352,350,2,2,"RECORTES CE",0
9,"9129",105,87,87,0,0,"RECORTES CE",0
9,"9265",38,31,31,0,0,"RECORTES CE",0
9,"9258",173,139,136,4,3,"RECORTES CE",0
9,"9112",113,75,73,2,2,"RECORTES CE",0
9,"9321",1640,1250,1237,5,13,"RECORTES CE",0
9,"9308",67,43,43,1,0,"RECORTES CE",0
9,"9255",86,66,62,0,4,"RECORTES CE",0
9,"9350",480,358,347,5,11,"RECORTES CE",2
9,"9268",95,73,72,0,1,"RECORTES CE",0
9,"9182",78,63,61,2,2,"RECORTES CE",0
9,"9197",148,108,104,1,4,"RECORTES CE",0
9,"9446",12,7,7,0,0,"RECORTES CE",0
9,"9103",221,185,184,2,1,"RECORTES CE",0
9,"9472",55,40,40,0,0,"RECORTES CE",0
9,"9075",111,83,83,1,0,"RECORTES CE",0
9,"9017",89,67,62,0,5,"RECORTES CE",0
9,"9363",974,730,725,3,5,"RECORTES CE",0
9,"9422",18,10,10,0,0,"RECORTES CE",0
9,"9243",75,56,54,1,2,"RECORTES CE",0
9,"9380",78,59,57,0,2,"RECORTES CE",0
9,"9018",24702,18365,18158,174,207,"RECORTES CE",26
9,"9013",47,41,41,0,0,"RECORTES CE",0
9,"9449",87,72,71,1,1,"RECORTES CE",0
9,"9266",91,72,70,0,2,"RECORTES CE",0
9,"9249",47,37,37,1,0,"RECORTES CE",0
9,"9398",75,54,54,1,0,"RECORTES CE",0
9,"9174",809,575,565,10,10,"RECORTES CE",0
9,"9090",57,51,51,1,0,"RECORTES CE",0
9,"9406",252,196,195,1,1,"RECORTES CE",0
9,"9297",323,265,261,5,4,"RECORTES CE",0
9,"9421",237,172,172,2,0,"RECORTES CE",0
9,"9381",32,23,22,0,1,"RECORTES CE",0
9,"9409",109,87,87,0,0,"RECORTES CE",0
9,"9196",154,108,107,1,1,"RECORTES CE",0
9,"9318",61,38,38,0,0,"RECORTES CE",0
9,"9120",39,35,35,0,0,"RECORTES CE",0
9,"9447",42,38,38,0,0,"RECORTES CE",0
9,"9410",3051,2169,2153,18,16,"RECORTES CE",3
9,"9292",92,72,70,0,2,"RECORTES CE",0
9,"9373",440,285,282,3,3,"RECORTES CE",0
9,"9012",93,68,66,1,2,"RECORTES CE",1
9,"9032",108,73,73,0,0,"RECORTES CE",0
9,"9250",273,218,218,4,0,"RECORTES CE",1
9,"9335",87,72,71,0,1,"RECORTES CE",1
9,"9044",46,38,37,0,1,"RECORTES CE",0
9,"9063",213,184,182,2,2,"RECORTES CE",0
9,"9052",31,22,21,1,1,"RECORTES CE",0
9,"9395",136,96,95,0,1,"RECORTES CE",0
9,"9056",4931,3634,3602,35,32,"RECORTES CE",4
9,"9144",52,40,40,0,0,"RECORTES CE",0
9,"9343",97,70,69,0,1,"RECORTES CE",0
9,"9221",445,337,335,1,2,"RECORTES CE",1
9,"9269",39,33,32,0,1,"RECORTES CE",0
9,"9354",33,30,30,1,0,"RECORTES CE",0
9,"9072",307,240,239,1,1,"RECORTES CE",1
9,"9045",267,186,183,2,3,"RECORTES CE",0
9,"9148",86,73,69,5,4,"RECORTES CE",0
9,"9195",57,42,42,2,0,"RECORTES CE",0
9,"9048",1484,1120,1106,4,14,"RECORTES CE",3
9,"9332",140,107,107,1,0,"RECORTES CE",1
9,"9057",144,116,115,0,1,"RECORTES CE",0
9,"9100",59,51,50,0,1,"RECORTES CE",0
9,"9160",90,71,70,0,1,"RECORTES CE",0
9,"9902",461,347,339,1,8,"RECORTES CE",2
9,"9175",129,92,92,0,0,"RECORTES CE",0
9,"9064",332,275,275,3,0,"RECORTES CE",0
9,"9473",85,62,61,1,1,"RECORTES CE",0
9,"9480",110,89,88,1,1,"RECORTES CE",0
9,"9348",146,116,114,1,2,"RECORTES CE",1
9,"9901",374,268,261,3,7,"RECORTES CE",0
9,"9283",46,29,28,0,1,"RECORTES CE",0
9,"9437",286,227,226,5,1,"RECORTES CE",3
9,"9192",55,47,46,0,1,"RECORTES CE",0
9,"9310",13,9,8,0,1,"RECORTES CE",0
9,"9366",90,64,63,1,1,"RECORTES CE",0
9,"9424",32,26,26,1,0,"RECORTES CE",0
9,"9066",65,51,51,0,0,"RECORTES CE",0
9,"9169",99,83,81,0,2,"RECORTES CE",0
9,"9905",391,308,308,5,0,"RECORTES CE",0
9,"9236",38,32,32,0,0,"RECORTES CE",0
9,"9082",40,35,35,0,0,"RECORTES CE",0
9,"9448",216,180,178,1,2,"RECORTES CE",0
9,"9417",40,30,30,0,0,"RECORTES CE",0
9,"9070",34,31,30,3,1,"RECORTES CE",1
9,"9441",74,66,66,0,0,"RECORTES CE",1
9,"9377",625,478,471,5,7,"RECORTES CE",0
9,"9429",56,41,41,0,0,"RECORTES CE",0
9,"9445",44,32,32,1,0,"RECORTES CE",0
9,"9906",1223,952,947,9,5,"RECORTES CE",2
9,"9412",803,552,550,2,2,"RECORTES CE",0
9,"9206",61,52,50,3,2,"RECORTES CE",0
9,"9365",31,20,20,0,0,"RECORTES CE",0
9,"9209",4511,3368,3301,37,67,"RECORTES CE",7
9,"9078",41,35,33,0,2,"RECORTES CE",0
9,"9047",56,45,45,2,0,"RECORTES CE",0
9,"9060",148,123,123,0,0,"RECORTES CE",0
9,"9288",91,70,69,1,1,"RECORTES CE",1
9,"9907",1420,1120,1115,13,5,"RECORTES CE",5
9,"9229",201,146,145,0,1,"RECORTES CE",1
9,"9337",115,84,82,0,2,"RECORTES CE",0
9,"9137",167,128,128,1,0,"RECORTES CE",0
9,"9198",108,86,85,2,1,"RECORTES CE",0
9,"9014",213,127,126,1,1,"RECORTES CE",0
9,"9298",82,62,62,0,0,"RECORTES CE",0
9,"9262",161,129,129,0,0,"RECORTES CE",0
9,"9219",27590,19903,19724,166,179,"RECORTES CE",49
9,"9355",101,75,73,0,2,"RECORTES CE",0
9,"9167",59,42,42,2,0,"RECORTES CE",0
9,"9199",91,65,65,2,0,"RECORTES CE",0
9,"9267",115,101,100,3,1,"RECORTES CE",0
9,"9073",926,753,748,10,5,"RECORTES CE",1
9,"9114",87,67,67,0,0,"RECORTES CE",0
9,"9062",51,44,44,1,0,"RECORTES CE",0
9,"9224",157,122,122,0,0,"RECORTES CE",0
9,"9022",67,57,57,1,0,"RECORTES CE",0
9,"9368",22,14,14,1,0,"RECORTES CE",0
9,"9084",189,150,148,7,2,"RECORTES CE",0
9,"9173",123,93,93,1,0,"RECORTES CE",0
9,"9010",32,23,23,2,0,"RECORTES CE",0
9,"9034",280,237,233,5,4,"RECORTES CE",0
9,"9302",116,87,87,0,0,"RECORTES CE",0
9,"9362",204,168,164,0,4,"RECORTES CE",1
9,"9400",317,258,256,3,2,"RECORTES CE",0
9,"9391",361,264,263,2,1,"RECORTES CE",0
9,"9163",602,479,472,5,7,"RECORTES CE",0
9,"9077",36,26,26,1,0,"RECORTES CE",0
9,"9384",293,199,194,0,5,"RECORTES CE",0
9,"9074",788,609,598,8,11,"RECORTES CE",2
9,"9408",41,34,34,1,0,"RECORTES CE",0
9,"9463",262,206,206,3,0,"RECORTES CE",1
9,"9025",125,86,79,1,7,"RECORTES CE",0
9,"9287",208,170,168,2,2,"RECORTES CE",0
9,"9104",54,43,43,0,0,"RECORTES CE",0
9,"9476",63,46,46,0,0,"RECORTES CE",0
9,"9396",152,118,118,1,0,"RECORTES CE",0
9,"9179",43,35,34,0,1,"RECORTES CE",0
9,"9903",3251,2359,2340,24,19,"RECORTES CE",5
9,"9456",129,90,90,2,0,"RECORTES CE",0
9,"9415",267,166,165,0,1,"RECORTES CE",0
9,"9326",148,115,113,2,2,"RECORTES CE",0
9,"9309",306,216,211,2,5,"RECORTES CE",0
9,"9051",168,133,132,1,1,"RECORTES CE",0
9,"9325",195,125,123,2,2,"RECORTES CE",1
9,"9166",97,79,78,3,1,"RECORTES CE",0
9,"9434",1221,985,970,10,15,"RECORTES CE",0
9,"9155",26,20,20,1,0,"RECORTES CE",0
9,"9135",41,33,33,1,0,"RECORTES CE",0
9,"9471",151,117,117,0,0,"RECORTES CE",0
9,"9131",460,381,373,5,8,"RECORTES CE",0
9,"9464",36,24,24,0,0,"RECORTES CE",0
9,"9189",130,88,86,2,2,"RECORTES CE",0
9,"9019",147,103,102,1,1,"RECORTES CE",1
9,"9213",320,223,220,4,3,"RECORTES CE",0
9,"9184",5,4,4,0,0,"RECORTES CE",0
9,"9306",113,91,91,1,0,"RECORTES CE",0
9,"9416",52,39,39,0,0,"RECORTES CE",0
9,"9202",24,22,22,1,0,"RECORTES CE",0
9,"9908",469,314,309,2,5,"RECORTES CE",1
9,"9094",51,42,41,0,1,"RECORTES CE",0
9,"9374",90,79,77,2,2,"RECORTES CE",0
9,"9178",52,36,36,1,0,"RECORTES CE",0
9,"9315",379,269,267,2,2,"RECORTES CE",0
9,"9345",124,92,92,0,0,"RECORTES CE",0
9,"9244",47,26,26,1,0,"RECORTES CE",0
9,"9455",44,34,33,0,1,"RECORTES CE",0
9,"9046",30,26,26,0,0,"RECORTES CE",0
9,"9259",233,184,184,3,0,"RECORTES CE",0
9,"9230",38,31,31,0,0,"RECORTES CE",0
9,"9232",151,125,124,2,1,"RECORTES CE",0
9,"9055",52,39,38,0,1,"RECORTES CE",0
9,"9375",35,27,27,0,0,"RECORTES CE",0
9,"9011",69,49,49,0,0,"RECORTES CE",0
9,"9067",442,308,303,9,5,"RECORTES CE",0
9,"9251",371,273,271,3,2,"RECORTES CE",1
9,"9303",92,72,71,0,1,"RECORTES CE",0
9,"9361",117,96,96,0,0,"RECORTES CE",1
9,"9235",160,124,123,0,1,"RECORTES CE",0
9,"9037",113,96,96,0,0,"RECORTES CE",0
9,"9346",93,71,69,0,2,"RECORTES CE",0
9,"9307",113,91,91,0,0,"RECORTES CE",0
9,"9482",34,29,28,0,1,"RECORTES CE",0
9,"9124",1520,1113,1096,9,17,"RECORTES CE",1
9,"9443",183,132,129,1,3,"RECORTES CE",0
9,"9162",143,108,108,0,0,"RECORTES CE",1
43,"43177",298,236,232,5,4,"PACMA",6
43,"43130",196,128,127,2,1,"PACMA",1
43,"43169",457,364,356,3,8,"PACMA",4
43,"43147",521,379,377,1,2,"PACMA",2
43,"43012",3580,2669,2658,22,11,"PACMA",48
43,"43002",1821,1294,1266,12,28,"PACMA",15
43,"43158",89,55,53,3,2,"PACMA",1
43,"43057",40,25,25,1,0,"PACMA",0
43,"43065",395,266,265,4,1,"PACMA",2
43,"43063",560,363,360,8,3,"PACMA",2
43,"43162",4313,3132,3101,26,31,"PACMA",31
43,"43061",48,31,29,0,2,"PACMA",1
43,"43101",148,107,107,4,0,"PACMA",0
43,"43060",2887,2019,1990,16,29,"PACMA",16
43,"43046",100,77,72,2,5,"PACMA",0
43,"43094",2175,1506,1480,11,26,"PACMA",7
43,"43073",85,60,59,0,1,"PACMA",2
43,"43152",450,338,330,2,8,"PACMA",0
43,"43159",80,57,57,0,0,"PACMA",0
43,"43089",281,211,211,1,0,"PACMA",3
43,"43170",857,603,599,8,4,"PACMA",5
43,"43052",954,662,653,9,9,"PACMA",4
43,"43124",484,347,343,6,4,"PACMA",5
43,"43078",856,640,632,11,8,"PACMA",1
43,"43003",322,234,233,3,1,"PACMA",1
43,"43150",1300,940,913,5,27,"PACMA",7
43,"43163",25252,17001,16847,74,154,"PACMA",215
43,"43122",106,84,84,0,0,"PACMA",0
43,"43035",262,167,164,0,3,"PACMA",5
43,"43098",343,249,249,4,0,"PACMA",2
43,"43178",1335,939,933,9,6,"PACMA",13
43,"43117",144,110,109,1,1,"PACMA",0
43,"43022",1508,1028,1015,20,13,"PACMA",2
43,"43083",140,95,94,0,1,"PACMA",1
43,"43010",316,253,251,2,2,"PACMA",3
43,"43014",14293,9441,9319,118,122,"PACMA",64
43,"43069",184,144,143,1,1,"PACMA",0
43,"43051",8545,5813,5735,26,78,"PACMA",62
43,"43128",908,623,616,4,7,"PACMA",10
43,"43106",810,544,532,7,12,"PACMA",1
43,"43166",1568,1117,1111,4,6,"PACMA",18
43,"43135",342,252,251,3,1,"PACMA",3
43,"43054",2836,1873,1852,21,21,"PACMA",11
43,"43017",126,100,97,1,3,"PACMA",2
43,"43165",578,431,428,2,3,"PACMA",4
43,"43108",1775,1238,1229,8,9,"PACMA",13
43,"43043",3128,2201,2186,11,15,"PACMA",33
43,"43040",338,255,247,2,8,"PACMA",1
43,"43112",284,178,178,0,0,"PACMA",1
43,"43026",797,579,574,2,5,"PACMA",6
43,"43164",300,218,217,0,1,"PACMA",3
43,"43903",2383,1420,1407,20,13,"PACMA",4
43,"43144",1258,914,911,3,3,"PACMA",22
43,"43031",1466,1062,1056,8,6,"PACMA",6
43,"43103",892,644,640,6,4,"PACMA",4
43,"43024",1522,1044,1034,3,10,"PACMA",18
43,"43045",152,121,121,0,0,"PACMA",0
43,"43085",226,178,178,2,0,"PACMA",2
43,"43034",480,366,358,4,8,"PACMA",4
43,"43076",447,318,317,0,1,"PACMA",5
43,"43086",5237,3507,3476,27,31,"PACMA",39
43,"43132",365,269,264,1,5,"PACMA",3
43,"43042",2148,1585,1573,7,12,"PACMA",18
43,"43105",162,115,115,3,0,"PACMA",0
43,"43091",136,94,94,2,0,"PACMA",1
43,"43053",191,149,147,1,2,"PACMA",2
43,"43168",93,64,64,2,0,"PACMA",0
43,"43056",871,532,521,6,11,"PACMA",5
43,"43005",3615,2376,2354,17,22,"PACMA",18
43,"43066",155,109,107,1,2,"PACMA",0
43,"43175",566,390,387,3,3,"PACMA",5
43,"43100",3268,2360,2352,16,8,"PACMA",33
43,"43009",1431,968,958,5,10,"PACMA",22
43,"43138",2677,1821,1786,22,35,"PACMA",7
43,"43154",132,101,100,1,1,"PACMA",1
43,"43145",4084,2991,2954,36,37,"PACMA",31
43,"43104",1798,1285,1268,14,17,"PACMA",2
43,"43099",305,234,233,1,1,"PACMA",4
43,"43058",93,68,67,1,1,"PACMA",0
43,"43016",3418,2534,2512,15,22,"PACMA",24
43,"43090",1070,625,620,4,5,"PACMA",9
43,"43088",1966,1382,1372,6,10,"PACMA",16
43,"43129",4618,3148,3107,24,41,"PACMA",30
43,"43139",2053,1332,1321,16,11,"PACMA",6
43,"43029",323,237,237,4,0,"PACMA",0
43,"43027",165,133,133,2,0,"PACMA",1
43,"43074",1749,1284,1275,7,9,"PACMA",10
43,"43070",236,194,193,0,1,"PACMA",1
43,"43025",604,431,428,5,3,"PACMA",0
43,"43172",351,243,242,8,1,"PACMA",5
43,"43008",309,185,181,5,4,"PACMA",1
43,"43011",1083,824,819,5,5,"PACMA",10
43,"43071",924,650,639,5,11,"PACMA",4
43,"43004",6326,4274,4227,38,47,"PACMA",21
43,"43125",942,692,685,4,7,"PACMA",0
43,"43007",637,481,479,3,2,"PACMA",5
43,"43096",101,81,81,0,0,"PACMA",2
43,"43116",455,326,321,1,5,"PACMA",2
43,"43082",372,291,285,0,6,"PACMA",1
43,"43055",1975,1471,1459,16,12,"PACMA",7
43,"43036",843,545,542,0,3,"PACMA",9
43,"43155",22874,15046,14893,137,153,"PACMA",128
43,"43032",523,371,365,7,6,"PACMA",0
43,"43142",1114,781,771,4,10,"PACMA",5
43,"43006",683,463,458,10,5,"PACMA",2
43,"43157",352,273,271,3,2,"PACMA",0
43,"43161",17217,11541,11478,67,63,"PACMA",130
43,"43120",444,293,288,0,5,"PACMA",1
43,"43079",364,258,257,1,1,"PACMA",2
43,"43151",109,82,82,1,0,"PACMA",3
43,"43019",1371,904,886,4,18,"PACMA",3
43,"43176",799,565,562,5,3,"PACMA",3
43,"43114",388,264,262,1,2,"PACMA",1
43,"43111",2049,1383,1366,9,17,"PACMA",19
43,"43134",283,226,224,2,2,"PACMA",5
43,"43118",413,313,308,1,5,"PACMA",0
43,"43048",807,569,564,8,5,"PACMA",3
43,"43092",7059,4603,4563,21,40,"PACMA",55
43,"43141",111,71,68,0,3,"PACMA",3
43,"43059",253,195,195,2,0,"PACMA",1
43,"43067",555,434,430,1,4,"PACMA",2
43,"43038",21385,14375,14276,117,99,"PACMA",178
43,"43153",10676,7241,7190,29,51,"PACMA",100
43,"43033",778,576,569,5,7,"PACMA",9
43,"43093",3909,2625,2597,44,28,"PACMA",32
43,"43064",2017,1384,1367,16,17,"PACMA",5
43,"43013",4425,2975,2938,21,37,"PACMA",28
43,"43039",102,73,73,0,0,"PACMA",0
43,"43906",2117,1454,1441,3,13,"PACMA",7
43,"43050",2521,1654,1640,11,14,"PACMA",27
43,"43131",4623,3059,3031,16,28,"PACMA",30
43,"43102",485,337,332,2,5,"PACMA",3
43,"43126",1177,848,844,8,4,"PACMA",10
43,"43140",2366,1731,1717,7,14,"PACMA",16
43,"43020",2202,1631,1614,13,17,"PACMA",37
43,"43137",1881,1344,1332,9,12,"PACMA",16
43,"43075",89,62,62,1,0,"PACMA",0
43,"43015",112,91,91,1,0,"PACMA",2
43,"43068",528,346,338,2,8,"PACMA",0
43,"43907",4382,3174,3147,14,27,"PACMA",57
43,"43021",360,248,247,6,1,"PACMA",6
43,"43049",746,546,543,1,3,"PACMA",3
43,"43171",14593,10107,10049,46,58,"PACMA",150
43,"43902",2760,1775,1739,22,36,"PACMA",1
43,"43018",410,320,316,1,4,"PACMA",0
43,"43001",695,474,472,4,2,"PACMA",1
43,"43905",14371,9191,9136,41,55,"PACMA",157
43,"43167",383,287,286,2,1,"PACMA",5
43,"43030",430,311,308,1,3,"PACMA",6
43,"43097",390,301,300,0,1,"PACMA",4
43,"43133",5697,3726,3685,26,41,"PACMA",28
43,"43148",90177,64180,63784,349,396,"PACMA",755
43,"43113",408,306,305,2,1,"PACMA",2
43,"43904",2908,1799,1760,38,39,"PACMA",14
43,"43127",765,554,548,2,6,"PACMA",8
43,"43081",597,425,418,4,7,"PACMA",6
43,"43115",155,116,116,2,0,"PACMA",0
43,"43121",604,393,387,4,6,"PACMA",1
43,"43080",244,184,184,2,0,"PACMA",1
43,"43072",105,77,77,1,0,"PACMA",0
43,"43110",272,169,167,1,2,"PACMA",0
43,"43028",2717,1727,1715,7,12,"PACMA",24
43,"43037",16725,10917,10822,61,95,"PACMA",153
43,"43044",3975,2793,2758,34,35,"PACMA",18
43,"43160",1273,888,879,7,9,"PACMA",13
43,"43173",101,63,60,0,3,"PACMA",1
43,"43156",3982,2748,2704,26,44,"PACMA",7
43,"43143",56,47,47,1,0,"PACMA",0
43,"43077",463,307,305,7,2,"PACMA",1
43,"43109",2560,1717,1700,13,17,"PACMA",30
43,"43123",70276,47897,47547,302,350,"PACMA",642
43,"43062",274,223,219,7,4,"PACMA",3
43,"43084",526,404,399,5,5,"PACMA",3
43,"43149",699,483,472,7,11,"PACMA",6
43,"43023",231,173,171,3,2,"PACMA",2
43,"43119",793,559,556,7,3,"PACMA",13
43,"43041",226,160,156,0,4,"PACMA",0
43,"43107",377,265,260,4,5,"PACMA",3
43,"43901",8765,5306,5212,81,94,"PACMA",23
43,"43095",2493,1723,1703,13,20,"PACMA",25
43,"43047",4128,2688,2652,19,36,"PACMA",28
43,"43146",38,30,30,1,0,"PACMA",2
43,"43136",10353,6670,6622,50,48,"PACMA",32
43,"43174",138,99,99,1,0,"PACMA",0
40,"40044",144,116,115,6,1,"C's",20
40,"40048",38,30,30,0,0,"C's",1
40,"40003",143,109,104,1,5,"C's",10
40,"40075",163,130,130,0,0,"C's",16
40,"40164",180,139,137,0,2,"C's",6
40,"40193",230,171,168,5,3,"C's",18
40,"40084",61,49,49,2,0,"C's",5
40,"40053",88,64,64,3,0,"C's",9
40,"40224",24,18,18,0,0,"C's",1
40,"40051",45,33,33,0,0,"C's",1
40,"40162",396,305,299,0,6,"C's",37
40,"40220",66,50,45,2,5,"C's",8
40,"40046",90,69,69,0,0,"C's",15
40,"40087",93,70,70,2,0,"C's",9
40,"40062",60,50,49,0,1,"C's",13
40,"40184",253,210,210,3,0,"C's",34
40,"40057",1488,1240,1228,14,12,"C's",122
40,"40212",30,21,19,0,2,"C's",1
40,"40138",2174,1739,1710,13,29,"C's",219
40,"40097",124,105,105,0,0,"C's",21
40,"40906",1973,1645,1627,16,18,"C's",360
40,"40006",21,17,17,0,0,"C's",2
40,"40234",407,326,322,3,4,"C's",57
40,"40196",34,26,26,1,0,"C's",2
40,"40076",6550,5029,4942,29,87,"C's",905
40,"40119",170,142,140,0,2,"C's",36
40,"40210",100,74,74,0,0,"C's",9
40,"40157",50,43,43,0,0,"C's",12
40,"40183",130,113,112,1,1,"C's",5
40,"40170",1315,1037,1026,9,11,"C's",155
40,"40126",85,65,63,0,2,"C's",3
40,"40135",289,242,237,1,5,"C's",21
40,"40189",513,403,391,3,12,"C's",38
40,"40068",24,22,22,0,0,"C's",4
40,"40109",75,49,46,1,3,"C's",6
40,"40219",590,448,437,6,11,"C's",70
40,"40120",192,167,166,1,1,"C's",29
40,"40089",218,163,159,0,4,"C's",20
40,"40901",377,307,300,1,7,"C's",69
40,"40129",179,143,138,2,5,"C's",10
40,"40139",281,218,216,1,2,"C's",37
40,"40145",1111,917,903,8,14,"C's",108
40,"40165",80,62,60,1,2,"C's",3
40,"40171",33,24,24,0,0,"C's",2
40,"40063",7132,5389,5297,56,92,"C's",755
40,"40012",271,205,202,3,3,"C's",25
40,"40222",174,147,147,0,0,"C's",18
40,"40149",528,401,390,7,11,"C's",36
40,"40061",70,55,54,0,1,"C's",5
40,"40228",507,401,396,0,5,"C's",30
40,"40154",21,13,13,0,0,"C's",0
40,"40103",157,128,128,0,0,"C's",26
40,"40078",161,129,128,2,1,"C's",16
40,"40158",18,12,12,0,0,"C's",3
40,"40094",372,283,277,1,6,"C's",31
40,"40182",184,139,136,1,3,"C's",13
40,"40041",987,791,777,18,14,"C's",124
40,"40211",75,63,63,1,0,"C's",17
40,"40218",97,69,69,0,0,"C's",10
40,"40186",41,32,32,0,0,"C's",2
40,"40163",55,39,38,1,1,"C's",2
40,"40036",519,424,411,9,13,"C's",68
40,"40112",2525,2054,2034,18,20,"C's",497
40,"40070",147,111,107,1,4,"C's",9
40,"40131",48,45,44,0,1,"C's",13
40,"40088",292,219,218,0,1,"C's",24
40,"40192",157,130,128,1,2,"C's",17
40,"40004",472,371,368,2,3,"C's",46
40,"40215",89,66,66,0,0,"C's",10
40,"40160",105,76,74,2,2,"C's",11
40,"40092",119,89,89,0,0,"C's",8
40,"40047",31,24,24,0,0,"C's",5
40,"40151",44,35,35,0,0,"C's",4
40,"40176",402,319,317,3,2,"C's",37
40,"40019",37,32,31,0,1,"C's",5
40,"40037",43,28,27,0,1,"C's",2
40,"40010",124,95,94,2,1,"C's",11
40,"40101",874,672,669,11,3,"C's",168
40,"40113",428,345,341,5,4,"C's",50
40,"40204",167,127,126,2,1,"C's",22
40,"40016",57,47,45,0,2,"C's",7
40,"40080",61,49,49,0,0,"C's",7
40,"40148",240,201,200,1,1,"C's",24
40,"40033",59,48,48,4,0,"C's",10
40,"40030",476,394,389,8,5,"C's",31
40,"40121",286,230,225,3,5,"C's",23
40,"40035",140,109,108,3,1,"C's",23
40,"40020",168,130,129,2,1,"C's",24
40,"40233",419,340,336,2,4,"C's",42
40,"40058",331,273,270,1,3,"C's",33
40,"40150",71,61,61,0,0,"C's",12
40,"40172",44,29,29,0,0,"C's",1
40,"40014",58,46,45,0,1,"C's",4
40,"40008",46,38,38,0,0,"C's",3
40,"40159",141,104,104,0,0,"C's",14
40,"40144",19,15,15,0,0,"C's",3
40,"40130",130,108,107,1,1,"C's",7
40,"40082",115,90,88,4,2,"C's",10
40,"40017",92,77,76,1,1,"C's",18
40,"40107",104,83,81,1,2,"C's",14
40,"40904",353,307,307,2,0,"C's",61
40,"40018",90,70,68,0,2,"C's",13
40,"40173",139,115,110,1,5,"C's",30
40,"40198",24,19,19,0,0,"C's",3
40,"40001",715,588,580,4,8,"C's",86
40,"40230",94,75,72,2,3,"C's",7
40,"40055",36,25,23,0,2,"C's",3
40,"40056",34,27,27,1,0,"C's",0
40,"40079",234,182,181,1,1,"C's",29
40,"40104",258,193,192,1,1,"C's",28
40,"40124",244,190,185,6,5,"C's",14
40,"40071",46,42,39,0,3,"C's",3
40,"40156",330,239,234,2,5,"C's",33
40,"40002",37,33,33,1,0,"C's",5
40,"40024",872,676,660,9,16,"C's",79
40,"40161",34,28,28,0,0,"C's",4
40,"40091",116,89,89,0,0,"C's",25
40,"40073",405,345,339,4,6,"C's",48
40,"40007",77,62,62,0,0,"C's",6
40,"40195",910,709,702,13,7,"C's",76
40,"40206",178,141,135,0,6,"C's",15
40,"40902",125,102,102,0,0,"C's",4
40,"40152",763,637,627,1,10,"C's",112
40,"40190",51,46,45,0,1,"C's",14
40,"40143",88,76,75,1,1,"C's",12
40,"40225",1134,907,890,8,17,"C's",127
40,"40207",753,612,607,2,5,"C's",168
40,"40221",49,42,41,0,1,"C's",19
40,"40095",475,376,370,7,6,"C's",36
40,"40141",856,626,616,7,10,"C's",67
40,"40059",112,96,96,2,0,"C's",16
40,"40009",50,41,41,0,0,"C's",5
40,"40028",103,90,89,2,1,"C's",16
40,"40208",768,606,596,5,10,"C's",107
40,"40049",62,45,45,0,0,"C's",2
40,"40054",112,83,83,0,0,"C's",5
40,"40026",113,106,106,0,0,"C's",20
40,"40013",65,51,50,0,1,"C's",5
40,"40108",116,80,79,2,1,"C's",13
40,"40191",222,163,161,2,2,"C's",19
40,"40118",52,39,38,2,1,"C's",6
40,"40022",207,162,160,3,2,"C's",26
40,"40174",361,252,250,0,2,"C's",42
40,"40146",255,211,209,0,2,"C's",38
40,"40052",81,62,62,0,0,"C's",4
40,"40069",84,67,67,0,0,"C's",4
40,"40201",49,41,41,0,0,"C's",6
40,"40229",38,28,28,0,0,"C's",4
40,"40128",132,97,95,4,2,"C's",5
40,"40060",81,59,59,0,0,"C's",2
40,"40043",1825,1455,1429,16,26,"C's",196
40,"40216",755,628,621,7,7,"C's",164
40,"40142",53,43,43,0,0,"C's",7
40,"40202",63,41,41,0,0,"C's",0
40,"40072",200,167,163,3,4,"C's",42
40,"40115",104,80,79,0,1,"C's",7
40,"40045",112,89,88,1,1,"C's",14
40,"40905",133,96,95,0,1,"C's",8
40,"40168",34,27,27,0,0,"C's",3
40,"40205",266,194,192,2,2,"C's",19
40,"40903",91,68,68,1,0,"C's",3
40,"40122",514,416,403,0,13,"C's",50
40,"40134",729,587,573,8,14,"C's",94
40,"40180",299,244,239,2,5,"C's",33
40,"40213",89,71,71,1,0,"C's",8
40,"40177",153,121,120,3,1,"C's",15
40,"40086",698,591,580,11,11,"C's",95
40,"40106",214,175,174,1,1,"C's",11
40,"40105",48,43,43,1,0,"C's",8
40,"40032",394,302,300,6,2,"C's",71
40,"40132",66,32,30,1,2,"C's",0
40,"40031",515,417,413,2,4,"C's",88
40,"40200",41,31,31,0,0,"C's",6
40,"40155",3480,2762,2723,29,39,"C's",746
40,"40093",77,67,67,5,0,"C's",10
40,"40181",4258,3391,3329,23,62,"C's",555
40,"40074",266,226,223,2,3,"C's",33
40,"40214",210,174,172,2,2,"C's",23
40,"40015",30,21,21,1,0,"C's",2
40,"40203",895,722,716,6,6,"C's",169
40,"40021",27,26,26,0,0,"C's",1
40,"40185",882,657,644,9,13,"C's",47
40,"40065",496,389,381,8,8,"C's",67
40,"40077",805,633,625,6,8,"C's",158
40,"40123",148,122,113,3,9,"C's",27
40,"40136",114,84,81,3,3,"C's",14
40,"40034",81,62,62,0,0,"C's",19
40,"40140",97,72,71,8,1,"C's",0
40,"40179",631,533,525,3,8,"C's",59
40,"40029",32,28,27,1,1,"C's",1
40,"40178",103,70,68,0,2,"C's",7
40,"40231",108,93,93,1,0,"C's",10
40,"40188",95,70,70,1,0,"C's",8
40,"40111",61,51,51,0,0,"C's",5
40,"40125",90,67,63,0,4,"C's",10
40,"40166",260,224,222,2,2,"C's",29
40,"40100",275,224,214,2,10,"C's",26
40,"40223",226,173,169,0,4,"C's",23
40,"40199",106,83,83,0,0,"C's",30
40,"40005",31,26,26,0,0,"C's",1
40,"40099",60,50,48,1,2,"C's",4
40,"40025",142,119,117,0,2,"C's",12
40,"40127",33,22,20,1,2,"C's",1
40,"40083",77,54,53,1,1,"C's",4
40,"40081",126,94,90,1,4,"C's",7
40,"40194",39796,30886,30516,287,370,"C's",5800
40,"40040",2626,1847,1835,19,12,"C's",287
40,"40039",213,167,165,2,2,"C's",24
40,"40110",349,272,272,1,0,"C's",24
26,"26001",197,163,155,3,8,"EB",0
26,"26005",2343,1607,1590,19,17,"EB",2
26,"26113",37,34,32,0,2,"EB",0
26,"26126",31,29,29,0,0,"EB",0
26,"26074",105,86,85,1,1,"EB",0
26,"26087",208,157,154,4,3,"EB",0
26,"26013",356,264,262,3,2,"EB",0
26,"26141",112,85,83,1,2,"EB",0
26,"26171",179,136,126,1,10,"EB",0
26,"26101",46,34,34,0,0,"EB",0
26,"26014",466,319,319,0,0,"EB",0
26,"26127",215,182,179,2,3,"EB",0
26,"26114",80,71,71,2,0,"EB",0
26,"26153",12,11,10,0,1,"EB",0
26,"26088",36,32,31,0,1,"EB",0
26,"26002",840,615,608,6,7,"EB",0
26,"26128",104,80,79,0,1,"EB",0
26,"26102",6128,4673,4585,42,88,"EB",7
26,"26039",38,35,35,0,0,"EB",0
26,"26154",11,8,8,0,0,"EB",0
26,"26142",780,618,613,1,5,"EB",1
26,"26051",254,202,201,2,1,"EB",0
26,"26115",17,14,14,0,0,"EB",0
26,"26003",416,336,330,2,6,"EB",0
26,"26076",128,111,110,2,1,"EB",0
26,"26132",111,88,88,1,0,"EB",0
26,"26015",193,151,149,0,2,"EB",1
26,"26155",162,138,137,0,1,"EB",0
26,"26143",217,178,177,0,1,"EB",0
26,"26134",87,65,65,1,0,"EB",0
26,"26129",971,768,757,2,11,"EB",1
26,"26016",28,24,24,1,0,"EB",0
26,"26174",147,122,112,0,10,"EB",0
26,"26040",68,62,62,0,0,"EB",0
26,"26020",483,356,344,2,12,"EB",0
26,"26004",68,53,53,1,0,"EB",0
26,"26117",2168,1695,1662,19,33,"EB",1
26,"26170",448,346,344,8,2,"EB",0
26,"26077",27,25,25,0,0,"EB",0
26,"26091",166,141,138,0,3,"EB",0
26,"26157",296,236,232,3,4,"EB",0
26,"26081",16,14,14,0,0,"EB",0
26,"26041",134,97,94,1,3,"EB",0
26,"26176",54,46,43,1,3,"EB",0
26,"26082",109,92,89,0,3,"EB",0
26,"26118",61,49,49,1,0,"EB",0
26,"26054",324,255,254,3,1,"EB",0
26,"26078",83,68,68,0,0,"EB",0
26,"26163",143,117,117,2,0,"EB",0
26,"26066",265,217,209,3,8,"EB",0
26,"26010",98,78,78,1,0,"EB",0
26,"26131",34,33,33,1,0,"EB",0
26,"26119",202,163,162,4,1,"EB",0
26,"26042",836,645,635,5,10,"EB",1
26,"26018",10469,8216,8110,71,106,"EB",9
26,"26106",88,78,78,0,0,"EB",0
26,"26089",110513,85146,84302,712,844,"EB",207
26,"26164",61,41,41,0,0,"EB",0
26,"26098",94,72,71,1,1,"EB",0
26,"26006",1809,1420,1410,14,10,"EB",2
26,"26172",30,25,25,0,0,"EB",0
26,"26160",715,569,567,3,2,"EB",1
26,"26120",1457,1144,1133,9,11,"EB",2
26,"26173",6,6,6,1,0,"EB",0
26,"26146",101,78,77,0,1,"EB",0
26,"26084",6630,5015,4952,27,63,"EB",5
26,"26044",51,46,45,0,1,"EB",0
26,"26007",523,406,401,2,5,"EB",0
26,"26161",7,7,7,0,0,"EB",0
26,"26053",208,161,160,1,1,"EB",1
26,"26147",30,26,26,0,0,"EB",0
26,"26012",23,23,23,0,0,"EB",0
26,"26100",52,43,43,0,0,"EB",0
26,"26056",425,357,353,6,4,"EB",0
26,"26139",54,46,46,0,0,"EB",0
26,"26148",171,147,145,0,2,"EB",0
26,"26045",12,12,12,0,0,"EB",0
26,"26166",142,131,128,1,3,"EB",0
26,"26008",1862,1442,1425,7,17,"EB",4
26,"26122",119,104,102,2,2,"EB",0
26,"26033",172,143,142,2,1,"EB",0
26,"26037",131,111,111,1,0,"EB",0
26,"26110",162,135,134,0,1,"EB",1
26,"26180",221,182,179,0,3,"EB",0
26,"26075",334,268,264,2,4,"EB",0
26,"26021",2819,2113,2077,23,36,"EB",2
26,"26070",186,154,153,1,1,"EB",0
26,"26009",414,326,319,3,7,"EB",0
26,"26167",59,45,45,1,0,"EB",0
26,"26096",244,199,197,3,2,"EB",0
26,"26092",108,83,82,0,1,"EB",0
26,"26046",1594,1221,1209,3,12,"EB",4
26,"26123",130,111,108,0,3,"EB",1
26,"26022",198,159,158,0,1,"EB",0
26,"26058",150,114,113,0,1,"EB",1
26,"26177",309,266,264,2,2,"EB",1
26,"26019",351,282,281,1,1,"EB",0
26,"26125",2708,2013,1988,22,25,"EB",7
26,"26064",2278,1736,1715,17,21,"EB",6
26,"26083",289,213,213,1,0,"EB",0
26,"26111",248,195,192,1,3,"EB",0
26,"26150",117,98,98,1,0,"EB",0
26,"26047",1969,1614,1596,14,18,"EB",4
26,"26124",824,664,659,8,5,"EB",0
26,"26011",7336,5309,5255,57,54,"EB",11
26,"26103",789,626,616,3,10,"EB",0
26,"26165",364,315,311,1,4,"EB",0
26,"26060",85,67,67,1,0,"EB",0
26,"26168",5318,3853,3802,36,51,"EB",4
26,"26067",23,20,20,0,0,"EB",0
26,"26151",446,380,375,1,5,"EB",0
26,"26080",475,392,388,6,4,"EB",0
26,"26049",174,127,121,0,6,"EB",0
26,"26024",236,183,183,0,0,"EB",0
26,"26072",289,259,258,2,1,"EB",0
26,"26178",80,64,63,1,1,"EB",0
26,"26086",15,15,15,0,0,"EB",0
26,"26057",51,47,45,0,2,"EB",0
26,"26028",133,112,111,0,1,"EB",0
26,"26104",14,9,9,0,0,"EB",0
26,"26140",260,221,218,1,3,"EB",0
26,"26094",85,71,68,0,3,"EB",0
26,"26052",158,125,125,0,0,"EB",0
26,"26034",660,522,513,1,9,"EB",0
26,"26169",64,60,60,0,0,"EB",0
26,"26121",27,21,21,0,0,"EB",0
26,"26130",203,167,166,1,1,"EB",0
26,"26025",85,71,71,1,0,"EB",0
26,"26017",383,302,301,4,1,"EB",1
26,"26179",42,34,33,0,1,"EB",1
26,"26149",61,48,48,0,0,"EB",0
26,"26175",52,44,44,2,0,"EB",1
26,"26062",90,73,71,0,2,"EB",0
26,"26026",1323,1070,1060,8,10,"EB",0
26,"26065",50,40,40,0,0,"EB",0
26,"26093",57,44,44,0,0,"EB",0
26,"26183",65,50,50,0,0,"EB",0
26,"26038",95,66,65,0,1,"EB",1
26,"26030",12,12,12,0,0,"EB",0
26,"26135",167,120,119,0,1,"EB",0
26,"26027",157,127,127,1,0,"EB",2
26,"26031",106,81,81,0,0,"EB",0
26,"26063",122,97,96,0,1,"EB",0
26,"26055",42,33,33,0,0,"EB",0
26,"26181",15,13,13,0,0,"EB",0
26,"26099",1259,1038,1024,7,14,"EB",1
26,"26068",82,68,66,0,2,"EB",1
26,"26050",117,86,86,0,0,"EB",0
26,"26162",121,106,106,2,0,"EB",0
26,"26048",22,22,21,0,1,"EB",0
26,"26145",245,202,201,3,1,"EB",1
26,"26108",268,207,205,5,2,"EB",0
26,"26036",16990,12136,11984,98,152,"EB",37
26,"26073",98,83,83,0,0,"EB",0
26,"26061",1548,1179,1160,14,19,"EB",1
26,"26069",240,201,199,0,2,"EB",1
26,"26144",194,150,148,2,2,"EB",0
26,"26029",37,31,31,0,0,"EB",0
26,"26109",85,76,74,1,2,"EB",1
26,"26059",1117,850,840,9,10,"EB",0
26,"26071",8477,6115,6029,51,86,"EB",13
26,"26035",16,12,12,0,0,"EB",0
26,"26023",468,358,355,4,3,"EB",0
26,"26105",2187,1722,1696,16,26,"EB",6
26,"26158",265,220,217,4,3,"EB",0
26,"26032",53,40,40,0,0,"EB",0
26,"26107",92,75,75,0,0,"EB",0
26,"26095",101,78,77,1,1,"EB",0
26,"26136",103,73,72,1,1,"EB",0
26,"26152",31,24,23,0,1,"EB",0
26,"26079",639,536,527,2,9,"EB",0
26,"26112",243,192,191,1,1,"EB",0
26,"26138",4600,3374,3325,28,49,"EB",3
26,"26043",373,284,282,4,2,"EB",0
7,"7001",3556,2682,2657,21,25,"EL PI",83
7,"7023",3628,2611,2573,45,38,"EL PI",73
7,"7056",5012,3632,3592,40,40,"EL PI",111
7,"7002",6367,4466,4401,36,65,"EL PI",42
7,"7017",844,625,618,6,7,"EL PI",103
7,"7034",991,774,765,2,9,"EL PI",36
7,"7012",1877,1421,1408,13,13,"EL PI",67
7,"7038",2032,1515,1503,10,12,"EL PI",37
7,"7045",1288,996,992,13,4,"EL PI",18
7,"7016",2786,1992,1969,30,23,"EL PI",101
7,"7031",23747,15538,15401,130,137,"EL PI",410
7,"7046",15649,9532,9443,70,89,"EL PI",342
7,"7013",6832,4879,4775,34,104,"EL PI",334
7,"7051",5225,3322,3279,38,43,"EL PI",170
7,"7032",20039,13156,13033,136,123,"EL PI",110
7,"7035",1517,1188,1181,3,7,"EL PI",121
7,"7036",26936,19563,19392,156,171,"EL PI",340
7,"7014",7277,4301,4261,37,40,"EL PI",66
7,"7061",9831,6618,6546,54,72,"EL PI",204
7,"7024",7019,3579,3544,39,35,"EL PI",27
7,"7057",7170,4736,4668,44,68,"EL PI",203
7,"7037",3232,1894,1881,16,13,"EL PI",12
7,"7039",4880,3473,3412,27,61,"EL PI",287
7,"7010",4858,3518,3463,52,55,"EL PI",69
7,"7054",22371,12930,12779,104,151,"EL PI",105
7,"7003",11742,6924,6837,43,87,"EL PI",551
7,"7059",2998,2119,2084,11,35,"EL PI",142
7,"7011",27781,18282,18180,135,102,"EL PI",218
7,"7047",2236,1602,1584,7,18,"EL PI",246
7,"7902",1072,730,712,18,18,"EL PI",13
7,"7018",389,271,265,3,6,"EL PI",4
7,"7058",2804,2138,2118,15,20,"EL PI",95
7,"7040",279737,181078,179570,1280,1508,"EL PI",2241
7,"7048",17339,10192,10101,104,91,"EL PI",91
7,"7050",3321,2161,2134,33,27,"EL PI",19
7,"7026",31158,18670,18537,161,133,"EL PI",181
7,"7029",4137,3088,3048,34,40,"EL PI",230
7,"7063",1420,1084,1072,8,12,"EL PI",36
7,"7033",27017,16370,16205,143,165,"EL PI",688
7,"7027",20667,13784,13673,106,111,"EL PI",609
7,"7025",478,377,376,1,1,"EL PI",12
7,"7004",3861,2657,2630,24,27,"EL PI",66
7,"7064",5361,3588,3546,20,42,"EL PI",69
7,"7044",8457,6079,5963,59,116,"EL PI",898
7,"7009",749,552,550,1,2,"EL PI",44
7,"7005",6659,4400,4357,23,43,"EL PI",154
7,"7060",2577,1825,1807,20,18,"EL PI",96
7,"7021",234,188,188,0,0,"EL PI",6
7,"7007",437,308,304,1,4,"EL PI",35
7,"7020",3597,2652,2622,27,30,"EL PI",45
7,"7015",21076,13304,13169,162,135,"EL PI",187
7,"7008",5681,4203,4153,22,50,"EL PI",108
7,"7028",892,617,611,2,6,"EL PI",28
7,"7041",2039,1566,1540,5,26,"EL PI",102
7,"7030",1573,1151,1129,10,22,"EL PI",101
7,"7006",5175,3559,3528,33,31,"EL PI",213
7,"7052",4705,2993,2971,34,22,"EL PI",36
7,"7049",1498,1080,1071,12,9,"EL PI",146
7,"7053",1171,957,946,8,11,"EL PI",34
7,"7065",2079,1462,1451,13,11,"EL PI",64
7,"7062",7539,4371,4312,40,59,"EL PI",60
7,"7022",11575,7827,7730,85,97,"EL PI",395
7,"7901",611,476,469,6,7,"EL PI",120
7,"7019",192,146,146,0,0,"EL PI",12
7,"7042",10666,7023,6967,59,56,"EL PI",411
7,"7055",7474,4796,4740,48,56,"EL PI",323
7,"7043",3422,2435,2410,13,25,"EL PI",302
37,"37203",165,118,118,0,0,"VOX",0
37,"37124",219,149,148,0,1,"VOX",0
37,"37357",276,216,215,0,1,"VOX",1
37,"37127",221,158,158,4,0,"VOX",0
37,"37002",144,87,87,0,0,"VOX",0
37,"37293",118,84,84,0,0,"VOX",1
37,"37073",583,449,442,8,7,"VOX",1
37,"37026",192,158,154,2,4,"VOX",1
37,"37342",256,210,208,1,2,"VOX",0
37,"37302",294,216,214,1,2,"VOX",0
37,"37013",121,87,86,3,1,"VOX",1
37,"37039",304,213,213,4,0,"VOX",0
37,"37335",415,301,293,2,8,"VOX",2
37,"37200",190,134,133,2,1,"VOX",1
37,"37116",69,51,51,0,0,"VOX",0
37,"37282",209,136,136,0,0,"VOX",0
37,"37291",268,206,206,1,0,"VOX",1
37,"37058",61,43,42,0,1,"VOX",0
37,"37353",129,92,92,1,0,"VOX",2
37,"37178",99,84,81,0,3,"VOX",0
37,"37221",434,328,323,2,5,"VOX",0
37,"37108",101,81,79,2,2,"VOX",0
37,"37338",78,66,66,1,0,"VOX",0
37,"37300",575,427,423,3,4,"VOX",0
37,"37187",565,431,426,4,5,"VOX",0
37,"37079",74,64,63,0,1,"VOX",0
37,"37313",555,415,411,1,4,"VOX",0
37,"37373",755,548,545,3,3,"VOX",0
37,"37222",97,66,66,1,0,"VOX",0
37,"37161",138,109,107,0,2,"VOX",0
37,"37352",204,148,147,0,1,"VOX",0
37,"37169",176,139,137,0,2,"VOX",0
37,"37362",4592,3442,3403,48,39,"VOX",18
37,"37045",27,20,20,0,0,"VOX",0
37,"37044",470,353,341,1,12,"VOX",0
37,"37115",123,89,87,0,2,"VOX",0
37,"37215",136,102,101,2,1,"VOX",0
37,"37014",1161,850,847,5,3,"VOX",0
37,"37054",261,199,198,1,1,"VOX",0
37,"37123",182,141,138,0,3,"VOX",0
37,"37250",358,223,223,1,0,"VOX",1
37,"37321",170,131,129,2,2,"VOX",0
37,"37192",353,245,242,2,3,"VOX",1
37,"37096",220,174,174,5,0,"VOX",0
37,"37046",11336,8300,8171,62,129,"VOX",26
37,"37114",88,67,66,1,1,"VOX",1
37,"37181",291,209,207,1,2,"VOX",0
37,"37156",4310,3173,3126,27,47,"VOX",9
37,"37077",260,234,230,0,4,"VOX",1
37,"37252",116,89,89,0,0,"VOX",0
37,"37060",245,192,192,0,0,"VOX",0
37,"37018",105,80,80,1,0,"VOX",0
37,"37183",417,305,301,2,4,"VOX",1
37,"37344",246,184,183,1,1,"VOX",1
37,"37276",149,100,99,0,1,"VOX",0
37,"37176",137,100,98,0,2,"VOX",0
37,"37024",92,77,77,0,0,"VOX",0
37,"37317",306,246,243,1,3,"VOX",0
37,"37089",67,50,49,0,1,"VOX",0
37,"37290",140,116,116,0,0,"VOX",2
37,"37310",180,129,128,2,1,"VOX",0
37,"37159",91,74,74,0,0,"VOX",1
37,"37147",191,141,136,0,5,"VOX",0
37,"37334",79,42,42,1,0,"VOX",0
37,"37249",44,33,33,1,0,"VOX",0
37,"37331",217,150,148,1,2,"VOX",0
37,"37117",1458,1075,1068,14,7,"VOX",4
37,"37379",173,134,134,2,0,"VOX",0
37,"37247",199,162,154,3,8,"VOX",0
37,"37049",147,98,98,2,0,"VOX",0
37,"37125",228,158,156,3,2,"VOX",1
37,"37188",185,127,125,3,2,"VOX",0
37,"37143",385,301,299,1,2,"VOX",1
37,"37219",179,110,110,0,0,"VOX",0
37,"37006",135,91,90,1,1,"VOX",0
37,"37152",424,290,283,2,7,"VOX",0
37,"37032",543,411,410,1,1,"VOX",2
37,"37078",823,670,657,8,13,"VOX",1
37,"37309",45,28,28,0,0,"VOX",0
37,"37198",206,161,160,3,1,"VOX",0
37,"37040",393,320,317,3,3,"VOX",0
37,"37007",439,321,313,4,8,"VOX",2
37,"37267",199,151,147,2,4,"VOX",0
37,"37138",199,155,154,4,1,"VOX",2
37,"37242",91,71,71,0,0,"VOX",0
37,"37320",93,71,71,1,0,"VOX",0
37,"37329",36,28,28,0,0,"VOX",0
37,"37337",139,120,120,2,0,"VOX",0
37,"37356",86,73,71,1,2,"VOX",0
37,"37015",222,145,143,3,2,"VOX",1
37,"37129",251,199,194,1,5,"VOX",0
37,"37257",53,43,43,0,0,"VOX",0
37,"37063",74,59,59,1,0,"VOX",0
37,"37231",259,208,207,4,1,"VOX",0
37,"37056",41,30,30,0,0,"VOX",0
37,"37287",318,237,237,3,0,"VOX",0
37,"37367",199,160,158,7,2,"VOX",0
37,"37090",52,38,36,0,2,"VOX",0
37,"37154",141,116,112,0,4,"VOX",0
37,"37023",1378,1116,1105,9,11,"VOX",8
37,"37047",167,83,83,0,0,"VOX",0
37,"37322",2472,1691,1676,12,15,"VOX",4
37,"37232",390,349,348,0,1,"VOX",0
37,"37132",351,272,269,2,3,"VOX",1
37,"37236",139,94,89,0,5,"VOX",0
37,"37288",258,211,210,7,1,"VOX",1
37,"37354",5182,3955,3915,50,40,"VOX",18
37,"37175",407,316,314,5,2,"VOX",2
37,"37368",16,15,15,0,0,"VOX",0
37,"37312",262,211,210,3,1,"VOX",0
37,"37091",176,114,113,2,1,"VOX",1
37,"37228",367,301,299,1,2,"VOX",1
37,"37380",55,46,46,2,0,"VOX",0
37,"37148",425,304,295,6,9,"VOX",0
37,"37134",230,175,173,1,2,"VOX",0
37,"37010",956,716,708,3,8,"VOX",0
37,"37259",45,30,30,0,0,"VOX",0
37,"37217",56,46,44,1,2,"VOX",0
37,"37347",477,365,359,3,6,"VOX",2
37,"37168",443,319,311,2,8,"VOX",1
37,"37190",219,167,167,0,0,"VOX",0
37,"37225",106,94,92,0,2,"VOX",0
37,"37351",281,239,238,0,1,"VOX",0
37,"37358",168,136,135,2,1,"VOX",0
37,"37172",878,580,576,3,4,"VOX",1
37,"37085",4704,3475,3432,35,43,"VOX",23
37,"37355",189,147,146,1,1,"VOX",1
37,"37099",73,45,45,2,0,"VOX",0
37,"37214",125,88,88,1,0,"VOX",0
37,"37195",48,35,35,1,0,"VOX",0
37,"37253",135,110,110,1,0,"VOX",0
37,"37150",43,35,35,0,0,"VOX",0
37,"37001",195,147,144,0,3,"VOX",0
37,"37223",109,90,87,0,3,"VOX",0
37,"37341",56,43,41,0,2,"VOX",0
37,"37294",11680,8850,8760,84,90,"VOX",39
37,"37072",166,133,132,2,1,"VOX",0
37,"37382",180,133,133,4,0,"VOX",0
37,"37136",667,453,448,2,5,"VOX",0
37,"37269",452,328,328,2,0,"VOX",0
37,"37086",98,80,80,2,0,"VOX",0
37,"37315",93,69,67,1,2,"VOX",0
37,"37280",79,50,50,0,0,"VOX",0
37,"37027",228,187,187,0,0,"VOX",1
37,"37174",1065,838,826,3,12,"VOX",3
37,"37035",194,161,161,0,0,"VOX",0
37,"37240",907,646,636,5,10,"VOX",8
37,"37375",705,593,582,11,11,"VOX",1
37,"37204",280,214,211,1,3,"VOX",0
37,"37009",216,161,160,3,1,"VOX",0
37,"37070",533,403,396,4,7,"VOX",2
37,"37171",411,321,317,1,4,"VOX",0
37,"37304",170,114,109,4,5,"VOX",0
37,"37233",65,45,45,0,0,"VOX",0
37,"37332",69,53,52,0,1,"VOX",0
37,"37088",204,152,152,3,0,"VOX",0
37,"37160",627,450,443,7,7,"VOX",0
37,"37179",215,173,170,0,3,"VOX",1
37,"37297",420,342,331,4,11,"VOX",0
37,"37285",412,311,305,2,6,"VOX",0
37,"37230",221,167,167,2,0,"VOX",0
37,"37234",357,224,222,1,2,"VOX",0
37,"37377",249,199,195,3,4,"VOX",0
37,"37226",156,121,119,1,2,"VOX",1
37,"37131",190,140,139,0,1,"VOX",1
37,"37366",43,27,27,0,0,"VOX",1
37,"37022",268,220,219,2,1,"VOX",0
37,"37165",33,27,27,0,0,"VOX",0
37,"37041",74,48,48,0,0,"VOX",0
37,"37264",67,43,43,0,0,"VOX",0
37,"37004",32,22,22,0,0,"VOX",0
37,"37180",73,52,52,1,0,"VOX",0
37,"37019",151,114,111,0,3,"VOX",2
37,"37146",122,100,99,1,1,"VOX",2
37,"37128",264,211,201,4,10,"VOX",1
37,"37104",27,21,21,0,0,"VOX",0
37,"37038",789,628,616,5,12,"VOX",0
37,"37319",117,78,77,0,1,"VOX",0
37,"37173",1526,1138,1125,5,13,"VOX",3
37,"37239",229,196,194,6,2,"VOX",0
37,"37042",42,29,29,2,0,"VOX",0
37,"37371",281,183,177,1,6,"VOX",1
37,"37311",226,182,182,2,0,"VOX",0
37,"37265",217,180,178,2,2,"VOX",0
37,"37097",36,30,30,0,0,"VOX",0
37,"37346",267,222,220,1,2,"VOX",2
37,"37163",42,33,33,0,0,"VOX",0
37,"37254",183,153,149,0,4,"VOX",0
37,"37244",134,91,90,1,1,"VOX",0
37,"37106",266,172,166,1,6,"VOX",0
37,"37193",399,279,278,6,1,"VOX",0
37,"37251",126,87,87,2,0,"VOX",1
37,"37003",119,93,90,0,3,"VOX",0
37,"37057",213,168,167,0,1,"VOX",0
37,"37336",55,47,47,0,0,"VOX",0
37,"37080",232,176,176,1,0,"VOX",2
37,"37119",109,86,86,1,0,"VOX",0
37,"37256",220,158,157,1,1,"VOX",1
37,"37289",240,182,182,2,0,"VOX",0
37,"37092",1731,1264,1250,11,14,"VOX",4
37,"37029",213,155,152,0,3,"VOX",2
37,"37241",172,128,126,1,2,"VOX",0
37,"37301",73,62,62,0,0,"VOX",0
37,"37142",592,453,451,2,2,"VOX",1
37,"37201",262,179,177,0,2,"VOX",0
37,"37033",98,63,63,0,0,"VOX",0
37,"37263",348,252,251,1,1,"VOX",0
37,"37050",67,47,46,1,1,"VOX",0
37,"37260",154,126,126,1,0,"VOX",0
37,"37081",933,720,714,4,6,"VOX",34
37,"37120",99,77,76,1,1,"VOX",0
37,"37037",119,81,81,0,0,"VOX",0
37,"37068",366,272,271,5,1,"VOX",0
37,"37199",142,108,108,0,0,"VOX",0
37,"37055",123,105,98,0,7,"VOX",1
37,"37268",116,71,70,0,1,"VOX",0
37,"37008",4298,3312,3272,16,40,"VOX",8
37,"37139",205,163,162,2,1,"VOX",0
37,"37235",223,168,163,1,5,"VOX",0
37,"37020",430,340,334,3,6,"VOX",1
37,"37272",136,97,96,0,1,"VOX",0
37,"37170",1479,1055,1031,10,24,"VOX",2
37,"37349",112,83,82,0,1,"VOX",0
37,"37016",573,451,447,3,4,"VOX",0
37,"37243",102,76,76,0,0,"VOX",0
37,"37109",182,119,118,0,1,"VOX",0
37,"37339",316,257,257,4,0,"VOX",0
37,"37303",188,152,151,1,1,"VOX",0
37,"37133",108,82,79,4,3,"VOX",0
37,"37350",421,324,320,4,4,"VOX",0
37,"37266",84,55,55,1,0,"VOX",0
37,"37323",521,387,385,8,2,"VOX",4
37,"37361",84,56,55,0,1,"VOX",0
37,"37296",338,258,255,4,3,"VOX",0
37,"37083",179,159,159,0,0,"VOX",1
37,"37292",103,72,72,1,0,"VOX",0
37,"37328",189,142,140,0,2,"VOX",0
37,"37021",80,62,62,0,0,"VOX",0
37,"37145",257,190,187,0,3,"VOX",0
37,"37071",78,73,72,1,1,"VOX",0
37,"37213",87,73,73,0,0,"VOX",0
37,"37278",753,573,568,7,5,"VOX",2
37,"37067",3125,2551,2523,22,28,"VOX",7
37,"37157",77,62,62,0,0,"VOX",0
37,"37149",70,63,63,0,0,"VOX",0
37,"37333",225,143,142,4,1,"VOX",0
37,"37103",446,326,325,4,1,"VOX",0
37,"37305",216,170,169,2,1,"VOX",0
37,"37205",233,201,197,1,4,"VOX",10
37,"37005",77,58,56,0,2,"VOX",1
37,"37011",122,91,89,0,2,"VOX",0
37,"37363",120,98,94,0,4,"VOX",0
37,"37271",361,283,276,3,7,"VOX",1
37,"37261",227,165,161,2,4,"VOX",0
37,"37191",116,78,76,0,2,"VOX",0
37,"37238",112,88,85,2,3,"VOX",0
37,"37374",1178,971,943,8,28,"VOX",6
37,"37202",978,773,763,7,10,"VOX",4
37,"37135",1211,932,925,10,7,"VOX",4
37,"37034",84,66,66,3,0,"VOX",0
37,"37360",230,167,166,2,1,"VOX",0
37,"37155",73,54,54,1,0,"VOX",0
37,"37107",10855,7694,7598,96,96,"VOX",12
37,"37197",87,55,55,2,0,"VOX",0
37,"37345",166,135,133,3,2,"VOX",0
37,"37031",365,258,257,1,1,"VOX",0
37,"37087",855,681,676,8,5,"VOX",2
37,"37284",325,245,244,2,1,"VOX",0
37,"37273",108,77,77,0,0,"VOX",0
37,"37101",163,122,122,2,0,"VOX",0
37,"37017",251,186,184,2,2,"VOX",0
37,"37216",310,264,257,4,7,"VOX",0
37,"37365",174,147,144,0,3,"VOX",3
37,"37028",150,111,110,1,1,"VOX",0
37,"37118",125,96,96,0,0,"VOX",0
37,"37274",119148,88959,88152,853,807,"VOX",435
37,"37122",202,158,156,3,2,"VOX",1
37,"37343",62,49,49,0,0,"VOX",0
37,"37102",411,291,289,3,2,"VOX",0
37,"37376",2251,1588,1568,9,20,"VOX",5
37,"37126",30,24,24,0,0,"VOX",0
37,"37340",150,105,104,1,1,"VOX",0
37,"37162",206,151,149,2,2,"VOX",0
37,"37036",63,46,46,0,0,"VOX",0
37,"37218",71,33,33,2,0,"VOX",0
37,"37245",345,252,246,7,6,"VOX",1
37,"37378",111,74,70,2,4,"VOX",0
37,"37062",84,67,66,1,1,"VOX",0
37,"37082",799,570,560,1,10,"VOX",1
37,"37211",223,163,163,4,0,"VOX",0
37,"37209",406,281,280,7,1,"VOX",0
37,"37286",206,156,156,4,0,"VOX",0
37,"37100",81,68,67,1,1,"VOX",0
37,"37325",91,68,63,0,5,"VOX",0
37,"37206",94,71,71,4,0,"VOX",0
37,"37207",303,234,233,0,1,"VOX",2
37,"37184",345,247,244,1,3,"VOX",1
37,"37258",180,117,115,1,2,"VOX",0
37,"37051",80,54,53,0,1,"VOX",0
37,"37307",160,103,103,0,0,"VOX",0
37,"37283",120,88,88,1,0,"VOX",0
37,"37229",143,102,102,1,0,"VOX",2
37,"37324",371,284,279,4,5,"VOX",0
37,"37110",117,92,89,1,3,"VOX",0
37,"37098",335,237,237,1,0,"VOX",0
37,"37164",256,200,195,1,5,"VOX",1
37,"37275",123,87,86,1,1,"VOX",0
37,"37369",140,96,96,0,0,"VOX",0
37,"37194",252,191,190,2,1,"VOX",0
37,"37151",146,116,115,2,1,"VOX",0
37,"37318",209,156,155,1,1,"VOX",0
37,"37065",323,237,235,0,2,"VOX",1
37,"37237",325,250,248,4,2,"VOX",0
37,"37144",370,288,284,2,4,"VOX",1
37,"37279",763,572,562,11,10,"VOX",0
37,"37370",337,258,255,3,3,"VOX",1
37,"37348",113,91,91,1,0,"VOX",3
37,"37186",106,78,78,3,0,"VOX",0
37,"37306",271,171,171,0,0,"VOX",0
37,"37212",111,83,83,1,0,"VOX",1
37,"37166",213,142,142,1,0,"VOX",0
37,"37381",139,98,92,0,6,"VOX",0
37,"37177",298,223,221,1,2,"VOX",1
37,"37372",146,117,115,0,2,"VOX",0
37,"37112",161,115,114,0,1,"VOX",0
37,"37121",584,434,430,5,4,"VOX",0
37,"37248",152,127,126,2,1,"VOX",0
37,"37141",156,127,127,1,0,"VOX",1
37,"37030",84,68,66,0,2,"VOX",0
37,"37182",77,62,62,0,0,"VOX",0
37,"37189",125,97,97,0,0,"VOX",0
37,"37167",173,150,144,2,6,"VOX",2
37,"37158",248,183,181,0,2,"VOX",0
37,"37140",678,440,435,2,5,"VOX",3
37,"37137",105,73,73,0,0,"VOX",0
37,"37196",77,54,53,0,1,"VOX",0
37,"37208",81,49,48,0,1,"VOX",0
37,"37052",274,197,197,2,0,"VOX",0
37,"37113",430,340,340,3,0,"VOX",0
37,"37359",184,131,129,0,2,"VOX",0
37,"37025",258,223,221,2,2,"VOX",0
37,"37364",836,598,583,6,15,"VOX",1
37,"37316",751,584,577,5,7,"VOX",1
37,"37059",124,100,98,0,2,"VOX",0
37,"37270",190,142,139,1,3,"VOX",0
37,"37012",150,117,115,0,2,"VOX",0
37,"37074",153,109,103,4,6,"VOX",0
37,"37262",78,64,64,1,0,"VOX",0
37,"37327",185,157,157,5,0,"VOX",0
37,"37330",335,262,258,4,4,"VOX",0
37,"37185",591,450,443,4,7,"VOX",0
37,"37246",5335,4190,4152,41,38,"VOX",7
37,"37277",73,55,55,0,0,"VOX",1
37,"37281",37,34,33,0,1,"VOX",0
37,"37061",226,166,164,1,2,"VOX",0
37,"37255",51,38,38,0,0,"VOX",0
37,"37130",173,155,153,5,2,"VOX",1
37,"37299",221,170,163,1,7,"VOX",1
37,"37298",184,125,125,1,0,"VOX",0
37,"37224",210,183,179,2,4,"VOX",0
37,"37314",87,74,72,0,2,"VOX",1
37,"37069",976,713,699,9,14,"VOX",2
23,"23001",993,826,820,1,6,"CILUS",4
23,"23053",9526,6783,6736,49,47,"CILUS",11
23,"23064",1659,1368,1364,1,4,"CILUS",1
23,"23059",5856,4498,4450,33,48,"CILUS",4
23,"23010",14371,10249,10140,65,109,"CILUS",44
23,"23027",727,577,576,8,1,"CILUS",2
23,"23071",1728,1337,1328,7,9,"CILUS",2
23,"23002",17450,13199,12986,92,213,"CILUS",54
23,"23019",1562,1249,1227,4,22,"CILUS",3
23,"23094",3852,3097,3061,17,36,"CILUS",5
23,"23055",47421,33170,32908,213,262,"CILUS",244
23,"23099",4734,3509,3459,23,50,"CILUS",7
23,"23065",1601,1222,1207,0,15,"CILUS",2
23,"23030",1232,1020,1007,10,13,"CILUS",0
23,"23902",2327,1877,1857,9,20,"CILUS",5
23,"23096",2643,2174,2140,14,34,"CILUS",3
23,"23069",5385,4406,4318,15,88,"CILUS",14
23,"23016",396,323,318,3,5,"CILUS",0
23,"23035",1095,871,867,8,4,"CILUS",0
23,"23087",11313,8540,8454,64,86,"CILUS",18
23,"23039",2220,1658,1626,8,32,"CILUS",2
23,"23032",575,461,457,1,4,"CILUS",1
23,"23079",3733,2994,2981,26,13,"CILUS",18
23,"23041",504,396,392,1,4,"CILUS",0
23,"23051",2762,2258,2231,9,27,"CILUS",8
23,"23101",388,281,279,0,2,"CILUS",0
23,"23004",435,350,346,0,4,"CILUS",1
23,"23040",1489,1226,1211,4,15,"CILUS",1
23,"23093",3257,2534,2506,21,28,"CILUS",3
23,"23007",3102,2381,2369,8,12,"CILUS",5
23,"23045",2139,1560,1551,9,9,"CILUS",4
23,"23076",837,672,658,4,14,"CILUS",1
23,"23067",2489,1869,1847,18,22,"CILUS",6
23,"23905",1861,1351,1345,7,6,"CILUS",6
23,"23057",771,648,648,4,0,"CILUS",1
23,"23072",2002,1593,1582,6,11,"CILUS",3
23,"23020",1584,1376,1366,5,10,"CILUS",2
23,"23097",6445,4313,4290,30,23,"CILUS",23
23,"23061",7520,5481,5405,55,76,"CILUS",16
23,"23084",953,711,708,6,3,"CILUS",12
23,"23088",6124,4764,4703,31,61,"CILUS",16
23,"23049",1834,1384,1378,7,6,"CILUS",1
23,"23070",3931,2549,2533,11,16,"CILUS",10
23,"23056",3108,2365,2343,14,22,"CILUS",6
23,"23082",1924,1420,1413,6,7,"CILUS",2
23,"23011",2193,1616,1600,11,16,"CILUS",5
23,"23028",6203,4645,4585,33,60,"CILUS",12
23,"23044",4847,3801,3740,26,61,"CILUS",12
23,"23081",1546,1145,1132,6,13,"CILUS",4
23,"23006",4636,3761,3714,25,47,"CILUS",10
23,"23029",854,631,623,2,8,"CILUS",0
23,"23090",1316,1077,1071,8,6,"CILUS",3
23,"23073",4558,3427,3402,11,25,"CILUS",4
23,"23047",1638,1311,1306,9,5,"CILUS",2
23,"23086",11537,8362,8242,91,120,"CILUS",19
23,"23080",1786,1347,1329,6,18,"CILUS",4
23,"23066",4376,3530,3508,46,22,"CILUS",16
23,"23903",3550,2742,2721,19,21,"CILUS",1
23,"23033",1356,1080,1065,8,15,"CILUS",2
23,"23085",2273,1833,1814,3,19,"CILUS",4
23,"23005",30539,21840,21629,176,211,"CILUS",61
23,"23012",4177,3016,2988,22,28,"CILUS",13
23,"23060",19157,13567,13438,133,129,"CILUS",47
23,"23025",2813,2186,2163,7,23,"CILUS",6
23,"23037",516,427,423,1,4,"CILUS",0
23,"23018",2326,1678,1668,5,10,"CILUS",1
23,"23077",637,515,514,3,1,"CILUS",3
23,"23043",549,401,400,0,1,"CILUS",3
23,"23017",1584,1265,1253,4,12,"CILUS",2
23,"23058",8665,6651,6585,47,66,"CILUS",15
23,"23095",8737,6303,6268,34,35,"CILUS",14
23,"23048",860,636,630,1,6,"CILUS",0
23,"23026",3636,2724,2685,11,39,"CILUS",7
23,"23015",1393,1061,1052,3,9,"CILUS",1
23,"23050",91221,67753,67164,549,589,"CILUS",152
23,"23062",1461,1188,1181,1,7,"CILUS",3
23,"23091",742,609,607,5,2,"CILUS",1
23,"23031",751,662,650,9,12,"CILUS",0
23,"23003",8709,6520,6440,42,80,"CILUS",19
23,"23042",299,220,220,1,0,"CILUS",1
23,"23038",3557,2851,2831,11,20,"CILUS",10
23,"23901",1160,978,972,5,6,"CILUS",6
23,"23092",27765,20688,20560,143,128,"CILUS",63
23,"23063",3845,2934,2898,24,36,"CILUS",7
23,"23034",2558,1987,1977,18,10,"CILUS",4
23,"23054",382,276,275,0,1,"CILUS",1
23,"23046",2405,1963,1934,3,29,"CILUS",5
23,"23052",1138,977,971,6,6,"CILUS",1
23,"23014",2561,1982,1959,8,23,"CILUS",3
23,"23098",875,728,722,2,6,"CILUS",1
23,"23009",12866,9787,9667,64,120,"CILUS",15
23,"23075",3319,2640,2618,21,22,"CILUS",8
23,"23008",1518,1185,1173,18,12,"CILUS",2
23,"23021",528,452,448,0,4,"CILUS",0
23,"23074",3030,2368,2353,12,15,"CILUS",3
23,"23904",2852,1784,1764,14,20,"CILUS",9
23,"23024",12512,9391,9182,79,209,"CILUS",32
33,"33049",6388,4229,4182,48,47,"PACMA",27
33,"33045",4503,3249,3216,26,33,"PACMA",12
33,"33072",1601,1012,1002,4,10,"PACMA",2
33,"33034",10693,6796,6725,72,71,"PACMA",45
33,"33020",13297,9527,9445,86,82,"PACMA",57
33,"33019",3094,2079,2054,15,25,"PACMA",10
33,"33065",1109,743,735,16,8,"PACMA",3
33,"33025",9261,6116,6062,58,54,"PACMA",43
33,"33055",1511,1150,1129,9,21,"PACMA",3
33,"33023",3315,2295,2267,35,28,"PACMA",14
33,"33041",7270,5138,5093,53,45,"PACMA",28
33,"33064",231,181,179,4,2,"PACMA",5
33,"33068",1114,627,623,2,4,"PACMA",1
33,"33009",899,606,601,4,5,"PACMA",1
33,"33037",34841,24271,24054,200,217,"PACMA",194
33,"33048",156,99,99,2,0,"PACMA",0
33,"33076",12270,8265,8203,89,62,"PACMA",40
33,"33039",1672,1261,1257,14,4,"PACMA",2
33,"33024",227211,166618,165475,1240,1143,"PACMA",1407
33,"33002",10122,7056,6977,55,79,"PACMA",28
33,"33014",9101,6398,6352,46,46,"PACMA",35
33,"33005",1479,945,932,12,13,"PACMA",5
33,"33040",4564,3125,3091,28,34,"PACMA",21
33,"33063",419,330,326,1,4,"PACMA",0
33,"33022",906,604,599,3,5,"PACMA",3
33,"33053",1157,767,762,12,5,"PACMA",2
33,"33051",7167,4810,4772,57,38,"PACMA",35
33,"33015",1561,1042,1031,8,11,"PACMA",1
33,"33042",4316,3143,3105,35,38,"PACMA",25
33,"33070",3347,2473,2441,31,32,"PACMA",19
33,"33052",730,517,512,1,5,"PACMA",0
33,"33001",1622,867,852,16,15,"PACMA",1
33,"33047",1126,868,861,12,7,"PACMA",5
33,"33057",1593,1134,1123,17,11,"PACMA",7
33,"33010",1828,1220,1215,16,5,"PACMA",11
33,"33018",2896,2068,2041,18,27,"PACMA",15
33,"33044",178724,130938,130010,1254,928,"PACMA",991
33,"33027",849,544,543,8,1,"PACMA",5
33,"33071",617,459,452,8,7,"PACMA",0
33,"33006",1556,1043,1036,17,7,"PACMA",3
33,"33046",508,375,365,4,10,"PACMA",1
33,"33028",1289,685,682,9,3,"PACMA",0
33,"33021",4576,3133,3090,33,43,"PACMA",25
33,"33011",11373,6279,6214,104,65,"PACMA",17
33,"33033",9943,6851,6803,61,48,"PACMA",23
33,"33031",35453,23848,23595,242,253,"PACMA",181
33,"33017",3180,2196,2168,30,28,"PACMA",11
33,"33038",2298,1690,1675,12,15,"PACMA",7
33,"33003",665,386,384,7,2,"PACMA",1
33,"33077",1220,849,840,11,9,"PACMA",0
33,"33013",456,336,331,6,5,"PACMA",1
33,"33075",275,161,155,2,6,"PACMA",2
33,"33061",379,194,190,1,4,"PACMA",0
33,"33004",67136,48699,48354,389,345,"PACMA",414
33,"33073",8631,5015,4948,47,67,"PACMA",10
33,"33032",11483,8036,7921,82,115,"PACMA",39
33,"33062",409,242,239,1,3,"PACMA",1
33,"33008",1808,1268,1247,6,21,"PACMA",3
33,"33029",363,199,198,1,1,"PACMA",0
33,"33043",682,465,460,2,5,"PACMA",2
33,"33036",11572,8208,8133,80,75,"PACMA",46
33,"33016",19201,14177,14074,115,103,"PACMA",115
33,"33007",1524,991,980,10,11,"PACMA",1
33,"33078",147,98,98,0,0,"PACMA",2
33,"33067",785,608,598,5,10,"PACMA",2
33,"33026",8621,5600,5555,71,45,"PACMA",26
33,"33074",3523,2422,2390,36,32,"PACMA",12
33,"33035",11299,8048,7981,67,67,"PACMA",56
33,"33060",14750,10307,10206,82,101,"PACMA",64
33,"33054",1688,1159,1146,8,13,"PACMA",8
33,"33012",5230,3595,3568,27,27,"PACMA",13
33,"33050",603,374,357,0,17,"PACMA",1
33,"33059",4702,3228,3185,42,43,"PACMA",8
33,"33058",1821,1319,1305,10,14,"PACMA",5
33,"33069",3513,2577,2554,15,23,"PACMA",14
33,"33030",899,689,687,10,2,"PACMA",2
33,"33056",5015,3435,3405,32,30,"PACMA",19
33,"33066",43034,29901,29610,261,291,"PACMA",244
34,"34081",61,50,49,0,1,"IU-UPeC",0
34,"34106",114,94,94,2,0,"IU-UPeC",6
34,"34005",858,670,651,6,19,"IU-UPeC",34
34,"34161",23,14,14,0,0,"IU-UPeC",0
34,"34132",115,93,92,0,1,"IU-UPeC",0
34,"34141",182,148,147,4,1,"IU-UPeC",0
34,"34220",144,129,128,0,1,"IU-UPeC",2
34,"34143",172,127,126,3,1,"IU-UPeC",1
34,"34221",179,135,132,3,3,"IU-UPeC",7
34,"34019",125,103,101,1,2,"IU-UPeC",3
34,"34134",53,37,37,2,0,"IU-UPeC",0
34,"34184",55,46,42,0,4,"IU-UPeC",0
34,"34189",57,45,45,1,0,"IU-UPeC",0
34,"34208",53,41,41,1,0,"IU-UPeC",2
34,"34094",61,42,40,1,2,"IU-UPeC",1
34,"34004",5626,4226,4178,41,48,"IU-UPeC",215
34,"34046",43,31,29,0,2,"IU-UPeC",1
34,"34186",51,45,45,0,0,"IU-UPeC",0
34,"34133",107,85,82,0,3,"IU-UPeC",1
34,"34169",404,302,300,2,2,"IU-UPeC",5
34,"34171",982,720,710,7,10,"IU-UPeC",37
34,"34129",179,139,137,2,2,"IU-UPeC",3
34,"34082",84,71,71,0,0,"IU-UPeC",1
34,"34126",279,218,218,2,0,"IU-UPeC",10
34,"34901",1126,881,865,6,16,"IU-UPeC",27
34,"34151",167,111,111,3,0,"IU-UPeC",2
34,"34204",47,39,39,2,0,"IU-UPeC",0
34,"34160",143,112,110,1,2,"IU-UPeC",5
34,"34070",160,117,115,2,2,"IU-UPeC",2
34,"34020",53,39,39,0,0,"IU-UPeC",0
34,"34157",2460,1872,1836,26,36,"IU-UPeC",76
34,"34059",422,348,341,6,7,"IU-UPeC",7
34,"34158",290,190,188,3,2,"IU-UPeC",2
34,"34060",137,113,112,1,1,"IU-UPeC",5
34,"34177",179,149,148,1,1,"IU-UPeC",3
34,"34241",18,13,12,2,1,"IU-UPeC",0
34,"34180",68,56,56,2,0,"IU-UPeC",0
34,"34218",469,353,349,2,4,"IU-UPeC",11
34,"34087",127,109,108,1,1,"IU-UPeC",5
34,"34185",65,46,44,2,2,"IU-UPeC",5
34,"34079",1601,1285,1269,11,16,"IU-UPeC",46
34,"34027",1096,786,781,11,5,"IU-UPeC",50
34,"34066",58,45,45,0,0,"IU-UPeC",0
34,"34104",247,203,199,0,4,"IU-UPeC",2
34,"34201",193,163,161,2,2,"IU-UPeC",2
34,"34088",231,192,190,2,2,"IU-UPeC",6
34,"34031",29,28,28,1,0,"IU-UPeC",0
34,"34230",15,12,12,0,0,"IU-UPeC",0
34,"34246",64,49,47,1,2,"IU-UPeC",1
34,"34028",144,121,119,1,2,"IU-UPeC",2
34,"34147",167,120,120,1,0,"IU-UPeC",2
34,"34181",453,343,337,3,6,"IU-UPeC",12
34,"34216",67,52,51,0,1,"IU-UPeC",3
34,"34206",879,688,680,3,8,"IU-UPeC",14
34,"34024",32,19,19,0,0,"IU-UPeC",1
34,"34224",45,31,31,0,0,"IU-UPeC",0
34,"34202",31,20,19,0,1,"IU-UPeC",0
34,"34067",129,95,95,0,0,"IU-UPeC",7
34,"34156",49,42,41,3,1,"IU-UPeC",0
34,"34035",113,90,89,1,1,"IU-UPeC",3
34,"34072",160,142,140,1,2,"IU-UPeC",2
34,"34242",95,74,73,1,1,"IU-UPeC",0
34,"34154",76,54,52,0,2,"IU-UPeC",3
34,"34058",184,167,167,0,0,"IU-UPeC",6
34,"34217",1200,954,934,6,20,"IU-UPeC",37
34,"34116",62,41,41,0,0,"IU-UPeC",1
34,"34047",1803,1402,1380,15,22,"IU-UPeC",20
34,"34003",163,127,125,0,2,"IU-UPeC",2
34,"34025",61,44,44,1,0,"IU-UPeC",1
34,"34149",20,15,15,0,0,"IU-UPeC",1
34,"34236",162,126,126,1,0,"IU-UPeC",0
34,"34176",134,102,100,2,2,"IU-UPeC",0
34,"34001",35,28,28,2,0,"IU-UPeC",5
34,"34120",64404,49403,48884,379,519,"IU-UPeC",2549
34,"34038",277,202,202,3,0,"IU-UPeC",12
34,"34006",80,69,66,1,3,"IU-UPeC",1
34,"34210",102,90,89,0,1,"IU-UPeC",1
34,"34034",126,93,93,1,0,"IU-UPeC",4
34,"34205",59,45,45,0,0,"IU-UPeC",0
34,"34048",76,64,64,1,0,"IU-UPeC",4
34,"34178",113,92,91,5,1,"IU-UPeC",5
34,"34018",209,169,166,3,3,"IU-UPeC",6
34,"34045",77,65,65,2,0,"IU-UPeC",0
34,"34023",5265,3948,3918,38,30,"IU-UPeC",273
34,"34238",341,279,276,1,3,"IU-UPeC",11
34,"34009",33,29,26,1,3,"IU-UPeC",1
34,"34223",219,159,158,1,1,"IU-UPeC",1
34,"34098",780,587,582,2,5,"IU-UPeC",37
34,"34215",163,148,148,2,0,"IU-UPeC",6
34,"34056",2003,1502,1487,12,15,"IU-UPeC",62
34,"34015",39,32,31,1,1,"IU-UPeC",0
34,"34146",55,42,42,0,0,"IU-UPeC",2
34,"34121",192,155,154,2,1,"IU-UPeC",0
34,"34170",62,49,49,0,0,"IU-UPeC",2
34,"34084",140,110,108,1,2,"IU-UPeC",0
34,"34052",178,148,147,3,1,"IU-UPeC",8
34,"34017",920,763,745,2,18,"IU-UPeC",16
34,"34089",157,124,122,1,2,"IU-UPeC",8
34,"34182",792,632,620,3,12,"IU-UPeC",14
34,"34041",89,71,71,1,0,"IU-UPeC",0
34,"34061",108,80,80,0,0,"IU-UPeC",2
34,"34099",61,51,50,0,1,"IU-UPeC",1
34,"34196",91,70,69,1,1,"IU-UPeC",0
34,"34050",202,160,160,0,0,"IU-UPeC",1
34,"34213",58,43,42,2,1,"IU-UPeC",0
34,"34137",28,24,24,1,0,"IU-UPeC",0
34,"34168",55,51,51,1,0,"IU-UPeC",1
34,"34042",300,247,244,4,3,"IU-UPeC",5
34,"34211",180,151,149,3,2,"IU-UPeC",0
34,"34190",56,40,40,3,0,"IU-UPeC",0
34,"34022",1095,915,909,8,6,"IU-UPeC",26
34,"34055",280,204,202,2,2,"IU-UPeC",4
34,"34237",597,472,465,5,7,"IU-UPeC",16
34,"34123",1668,1346,1319,20,27,"IU-UPeC",34
34,"34131",59,50,48,0,2,"IU-UPeC",0
34,"34225",4903,3830,3784,41,46,"IU-UPeC",247
34,"34051",102,90,88,1,2,"IU-UPeC",1
34,"34163",49,40,40,0,0,"IU-UPeC",0
34,"34233",131,116,116,1,0,"IU-UPeC",0
34,"34049",369,280,274,1,6,"IU-UPeC",9
34,"34032",41,32,31,0,1,"IU-UPeC",1
34,"34080",5626,3906,3835,39,71,"IU-UPeC",160
34,"34114",212,147,146,2,1,"IU-UPeC",1
34,"34062",176,111,111,3,0,"IU-UPeC",2
34,"34159",363,277,269,4,8,"IU-UPeC",16
34,"34127",95,64,64,2,0,"IU-UPeC",0
34,"34101",54,42,42,0,0,"IU-UPeC",1
34,"34234",72,57,55,0,2,"IU-UPeC",2
34,"34109",59,48,47,0,1,"IU-UPeC",0
34,"34092",297,236,231,2,5,"IU-UPeC",0
34,"34076",597,494,490,3,4,"IU-UPeC",10
34,"34063",86,80,79,1,1,"IU-UPeC",0
34,"34130",213,175,172,2,3,"IU-UPeC",12
34,"34110",91,78,78,2,0,"IU-UPeC",4
34,"34140",107,63,62,0,1,"IU-UPeC",3
34,"34124",61,47,46,0,1,"IU-UPeC",0
34,"34012",362,277,272,4,5,"IU-UPeC",11
34,"34112",47,38,38,0,0,"IU-UPeC",1
34,"34175",89,75,74,1,1,"IU-UPeC",0
34,"34228",81,66,66,0,0,"IU-UPeC",3
34,"34029",727,596,582,4,14,"IU-UPeC",9
34,"34167",114,89,89,0,0,"IU-UPeC",2
34,"34086",105,91,88,1,3,"IU-UPeC",11
34,"34037",310,218,217,4,1,"IU-UPeC",7
34,"34107",81,49,49,3,0,"IU-UPeC",1
34,"34083",1773,1259,1244,8,15,"IU-UPeC",65
34,"34174",205,162,162,4,0,"IU-UPeC",5
34,"34222",120,82,82,2,0,"IU-UPeC",1
34,"34179",29,22,20,0,2,"IU-UPeC",0
34,"34165",66,59,59,0,0,"IU-UPeC",0
34,"34096",57,46,46,3,0,"IU-UPeC",3
34,"34100",142,116,115,5,1,"IU-UPeC",3
34,"34136",182,121,120,1,1,"IU-UPeC",1
34,"34229",67,55,55,1,0,"IU-UPeC",1
34,"34113",37,36,36,0,0,"IU-UPeC",0
34,"34011",398,326,326,3,0,"IU-UPeC",7
34,"34243",326,263,258,2,5,"IU-UPeC",11
34,"34199",1248,955,937,18,18,"IU-UPeC",45
34,"34069",2285,1711,1692,25,19,"IU-UPeC",101
34,"34231",232,167,167,4,0,"IU-UPeC",2
34,"34192",93,76,76,0,0,"IU-UPeC",2
34,"34135",391,296,291,4,5,"IU-UPeC",9
34,"34227",76,62,62,1,0,"IU-UPeC",0
34,"34068",25,24,24,1,0,"IU-UPeC",0
34,"34071",172,140,139,4,1,"IU-UPeC",3
34,"34093",90,72,70,0,2,"IU-UPeC",2
34,"34057",476,339,334,3,5,"IU-UPeC",7
34,"34240",90,71,70,2,1,"IU-UPeC",0
34,"34245",311,213,209,4,4,"IU-UPeC",2
34,"34074",719,552,545,8,7,"IU-UPeC",11
34,"34036",216,167,165,1,2,"IU-UPeC",2
34,"34073",187,150,149,0,1,"IU-UPeC",6
34,"34103",96,78,77,2,1,"IU-UPeC",4
34,"34053",209,170,168,4,2,"IU-UPeC",2
34,"34125",88,69,68,1,1,"IU-UPeC",1
34,"34902",140,115,114,0,1,"IU-UPeC",4
34,"34152",124,102,99,1,3,"IU-UPeC",4
34,"34903",198,128,127,1,1,"IU-UPeC",0
34,"34155",135,105,104,1,1,"IU-UPeC",2
34,"34122",84,66,65,0,1,"IU-UPeC",1
34,"34139",168,126,124,6,2,"IU-UPeC",2
34,"34904",319,241,240,3,1,"IU-UPeC",9
34,"34039",61,46,45,0,1,"IU-UPeC",0
34,"34091",123,97,95,1,2,"IU-UPeC",1
34,"34108",537,453,446,5,7,"IU-UPeC",10
34,"34102",205,172,170,1,2,"IU-UPeC",1
34,"34077",349,253,246,0,7,"IU-UPeC",7
34,"34232",748,601,586,11,15,"IU-UPeC",3
34,"34214",186,150,149,1,1,"IU-UPeC",4
34,"34010",570,437,429,5,8,"IU-UPeC",3
34,"34033",18,17,17,0,0,"IU-UPeC",0
43,"43128",908,623,616,4,7,"UPYD",0
43,"43032",523,371,365,7,6,"UPYD",0
43,"43022",1508,1028,1015,20,13,"UPYD",0
43,"43174",138,99,99,1,0,"UPYD",0
43,"43035",262,167,164,0,3,"UPYD",0
43,"43026",797,579,574,2,5,"UPYD",2
43,"43157",352,273,271,3,2,"UPYD",0
43,"43154",132,101,100,1,1,"UPYD",0
43,"43123",70276,47897,47547,302,350,"UPYD",99
43,"43075",89,62,62,1,0,"UPYD",0
43,"43144",1258,914,911,3,3,"UPYD",0
43,"43045",152,121,121,0,0,"UPYD",0
43,"43036",843,545,542,0,3,"UPYD",1
43,"43175",566,390,387,3,3,"UPYD",0
43,"43095",2493,1723,1703,13,20,"UPYD",2
43,"43134",283,226,224,2,2,"UPYD",1
43,"43151",109,82,82,1,0,"UPYD",0
43,"43006",683,463,458,10,5,"UPYD",0
43,"43106",810,544,532,7,12,"UPYD",4
43,"43158",89,55,53,3,2,"UPYD",0
43,"43130",196,128,127,2,1,"UPYD",0
43,"43118",413,313,308,1,5,"UPYD",2
43,"43133",5697,3726,3685,26,41,"UPYD",5
43,"43906",2117,1454,1441,3,13,"UPYD",1
43,"43058",93,68,67,1,1,"UPYD",0
43,"43055",1975,1471,1459,16,12,"UPYD",0
43,"43063",560,363,360,8,3,"UPYD",0
43,"43008",309,185,181,5,4,"UPYD",0
43,"43018",410,320,316,1,4,"UPYD",0
43,"43009",1431,968,958,5,10,"UPYD",3
43,"43030",430,311,308,1,3,"UPYD",0
43,"43111",2049,1383,1366,9,17,"UPYD",1
43,"43104",1798,1285,1268,14,17,"UPYD",1
43,"43168",93,64,64,2,0,"UPYD",0
43,"43025",604,431,428,5,3,"UPYD",0
43,"43019",1371,904,886,4,18,"UPYD",1
43,"43091",136,94,94,2,0,"UPYD",0
43,"43138",2677,1821,1786,22,35,"UPYD",1
43,"43048",807,569,564,8,5,"UPYD",0
43,"43103",892,644,640,6,4,"UPYD",0
43,"43155",22874,15046,14893,137,153,"UPYD",18
43,"43067",555,434,430,1,4,"UPYD",0
43,"43108",1775,1238,1229,8,9,"UPYD",1
43,"43124",484,347,343,6,4,"UPYD",3
43,"43122",106,84,84,0,0,"UPYD",0
43,"43115",155,116,116,2,0,"UPYD",0
43,"43129",4618,3148,3107,24,41,"UPYD",2
43,"43016",3418,2534,2512,15,22,"UPYD",2
43,"43003",322,234,233,3,1,"UPYD",0
43,"43166",1568,1117,1111,4,6,"UPYD",0
43,"43064",2017,1384,1367,16,17,"UPYD",2
43,"43904",2908,1799,1760,38,39,"UPYD",1
43,"43105",162,115,115,3,0,"UPYD",0
43,"43013",4425,2975,2938,21,37,"UPYD",5
43,"43033",778,576,569,5,7,"UPYD",0
43,"43004",6326,4274,4227,38,47,"UPYD",7
43,"43068",528,346,338,2,8,"UPYD",0
43,"43051",8545,5813,5735,26,78,"UPYD",21
43,"43143",56,47,47,1,0,"UPYD",0
43,"43065",395,266,265,4,1,"UPYD",0
43,"43041",226,160,156,0,4,"UPYD",0
43,"43150",1300,940,913,5,27,"UPYD",0
43,"43001",695,474,472,4,2,"UPYD",2
43,"43078",856,640,632,11,8,"UPYD",2
43,"43093",3909,2625,2597,44,28,"UPYD",2
43,"43062",274,223,219,7,4,"UPYD",0
43,"43121",604,393,387,4,6,"UPYD",0
43,"43140",2366,1731,1717,7,14,"UPYD",4
43,"43162",4313,3132,3101,26,31,"UPYD",9
43,"43043",3128,2201,2186,11,15,"UPYD",5
43,"43039",102,73,73,0,0,"UPYD",0
43,"43012",3580,2669,2658,22,11,"UPYD",8
43,"43042",2148,1585,1573,7,12,"UPYD",3
43,"43097",390,301,300,0,1,"UPYD",0
43,"43056",871,532,521,6,11,"UPYD",2
43,"43069",184,144,143,1,1,"UPYD",0
43,"43165",578,431,428,2,3,"UPYD",0
43,"43066",155,109,107,1,2,"UPYD",0
43,"43178",1335,939,933,9,6,"UPYD",3
43,"43011",1083,824,819,5,5,"UPYD",0
43,"43094",2175,1506,1480,11,26,"UPYD",2
43,"43901",8765,5306,5212,81,94,"UPYD",6
43,"43005",3615,2376,2354,17,22,"UPYD",3
43,"43073",85,60,59,0,1,"UPYD",0
43,"43053",191,149,147,1,2,"UPYD",0
43,"43135",342,252,251,3,1,"UPYD",0
43,"43149",699,483,472,7,11,"UPYD",0
43,"43152",450,338,330,2,8,"UPYD",1
43,"43098",343,249,249,4,0,"UPYD",1
43,"43023",231,173,171,3,2,"UPYD",1
43,"43020",2202,1631,1614,13,17,"UPYD",4
43,"43160",1273,888,879,7,9,"UPYD",2
43,"43046",100,77,72,2,5,"UPYD",0
43,"43037",16725,10917,10822,61,95,"UPYD",22
43,"43101",148,107,107,4,0,"UPYD",0
43,"43080",244,184,184,2,0,"UPYD",0
43,"43109",2560,1717,1700,13,17,"UPYD",4
43,"43167",383,287,286,2,1,"UPYD",0
43,"43126",1177,848,844,8,4,"UPYD",1
43,"43147",521,379,377,1,2,"UPYD",0
43,"43110",272,169,167,1,2,"UPYD",1
43,"43136",10353,6670,6622,50,48,"UPYD",4
43,"43038",21385,14375,14276,117,99,"UPYD",33
43,"43031",1466,1062,1056,8,6,"UPYD",0
43,"43177",298,236,232,5,4,"UPYD",0
43,"43085",226,178,178,2,0,"UPYD",0
43,"43137",1881,1344,1332,9,12,"UPYD",2
43,"43052",954,662,653,9,9,"UPYD",1
43,"43907",4382,3174,3147,14,27,"UPYD",5
43,"43114",388,264,262,1,2,"UPYD",0
43,"43107",377,265,260,4,5,"UPYD",0
43,"43079",364,258,257,1,1,"UPYD",0
43,"43127",765,554,548,2,6,"UPYD",0
43,"43116",455,326,321,1,5,"UPYD",0
43,"43141",111,71,68,0,3,"UPYD",0
43,"43090",1070,625,620,4,5,"UPYD",4
43,"43086",5237,3507,3476,27,31,"UPYD",2
43,"43029",323,237,237,4,0,"UPYD",0
43,"43059",253,195,195,2,0,"UPYD",0
43,"43076",447,318,317,0,1,"UPYD",0
43,"43049",746,546,543,1,3,"UPYD",0
43,"43096",101,81,81,0,0,"UPYD",0
43,"43145",4084,2991,2954,36,37,"UPYD",4
43,"43070",236,194,193,0,1,"UPYD",0
43,"43083",140,95,94,0,1,"UPYD",0
43,"43024",1522,1044,1034,3,10,"UPYD",2
43,"43171",14593,10107,10049,46,58,"UPYD",24
43,"43139",2053,1332,1321,16,11,"UPYD",1
43,"43054",2836,1873,1852,21,21,"UPYD",4
43,"43125",942,692,685,4,7,"UPYD",1
43,"43074",1749,1284,1275,7,9,"UPYD",0
43,"43044",3975,2793,2758,34,35,"UPYD",8
43,"43119",793,559,556,7,3,"UPYD",0
43,"43156",3982,2748,2704,26,44,"UPYD",4
43,"43002",1821,1294,1266,12,28,"UPYD",1
43,"43034",480,366,358,4,8,"UPYD",0
43,"43092",7059,4603,4563,21,40,"UPYD",8
43,"43007",637,481,479,3,2,"UPYD",1
43,"43015",112,91,91,1,0,"UPYD",0
43,"43170",857,603,599,8,4,"UPYD",0
43,"43021",360,248,247,6,1,"UPYD",1
43,"43120",444,293,288,0,5,"UPYD",0
43,"43169",457,364,356,3,8,"UPYD",0
43,"43088",1966,1382,1372,6,10,"UPYD",3
43,"43164",300,218,217,0,1,"UPYD",1
43,"43903",2383,1420,1407,20,13,"UPYD",4
43,"43061",48,31,29,0,2,"UPYD",0
43,"43099",305,234,233,1,1,"UPYD",0
43,"43100",3268,2360,2352,16,8,"UPYD",5
43,"43161",17217,11541,11478,67,63,"UPYD",19
43,"43028",2717,1727,1715,7,12,"UPYD",2
43,"43113",408,306,305,2,1,"UPYD",0
43,"43089",281,211,211,1,0,"UPYD",0
43,"43057",40,25,25,1,0,"UPYD",0
43,"43148",90177,64180,63784,349,396,"UPYD",157
43,"43084",526,404,399,5,5,"UPYD",0
43,"43071",924,650,639,5,11,"UPYD",0
43,"43131",4623,3059,3031,16,28,"UPYD",4
43,"43146",38,30,30,1,0,"UPYD",0
43,"43176",799,565,562,5,3,"UPYD",0
43,"43117",144,110,109,1,1,"UPYD",0
43,"43047",4128,2688,2652,19,36,"UPYD",7
43,"43172",351,243,242,8,1,"UPYD",0
43,"43159",80,57,57,0,0,"UPYD",0
43,"43072",105,77,77,1,0,"UPYD",0
43,"43132",365,269,264,1,5,"UPYD",1
43,"43010",316,253,251,2,2,"UPYD",0
43,"43163",25252,17001,16847,74,154,"UPYD",34
43,"43112",284,178,178,0,0,"UPYD",0
43,"43082",372,291,285,0,6,"UPYD",0
43,"43077",463,307,305,7,2,"UPYD",0
43,"43060",2887,2019,1990,16,29,"UPYD",5
43,"43014",14293,9441,9319,118,122,"UPYD",12
43,"43173",101,63,60,0,3,"UPYD",0
43,"43040",338,255,247,2,8,"UPYD",0
43,"43905",14371,9191,9136,41,55,"UPYD",27
43,"43081",597,425,418,4,7,"UPYD",0
43,"43017",126,100,97,1,3,"UPYD",0
43,"43027",165,133,133,2,0,"UPYD",0
43,"43102",485,337,332,2,5,"UPYD",0
43,"43142",1114,781,771,4,10,"UPYD",0
43,"43902",2760,1775,1739,22,36,"UPYD",3
43,"43153",10676,7241,7190,29,51,"UPYD",13
43,"43050",2521,1654,1640,11,14,"UPYD",1
51,"51001",59213,33213,32720,413,493,"RECORTES CE",144
40,"40005",31,26,26,0,0,"PSOE",2
40,"40089",218,163,159,0,4,"PSOE",19
40,"40155",3480,2762,2723,29,39,"PSOE",479
40,"40178",103,70,68,0,2,"PSOE",4
40,"40032",394,302,300,6,2,"PSOE",51
40,"40072",200,167,163,3,4,"PSOE",24
40,"40104",258,193,192,1,1,"PSOE",44
40,"40131",48,45,44,0,1,"PSOE",11
40,"40170",1315,1037,1026,9,11,"PSOE",201
40,"40120",192,167,166,1,1,"PSOE",44
40,"40100",275,224,214,2,10,"PSOE",30
40,"40215",89,66,66,0,0,"PSOE",7
40,"40199",106,83,83,0,0,"PSOE",7
40,"40145",1111,917,903,8,14,"PSOE",186
40,"40088",292,219,218,0,1,"PSOE",37
40,"40014",58,46,45,0,1,"PSOE",13
40,"40192",157,130,128,1,2,"PSOE",35
40,"40031",515,417,413,2,4,"PSOE",82
40,"40044",144,116,115,6,1,"PSOE",24
40,"40129",179,143,138,2,5,"PSOE",25
40,"40099",60,50,48,1,2,"PSOE",11
40,"40094",372,283,277,1,6,"PSOE",64
40,"40134",729,587,573,8,14,"PSOE",174
40,"40904",353,307,307,2,0,"PSOE",21
40,"40111",61,51,51,0,0,"PSOE",6
40,"40060",81,59,59,0,0,"PSOE",5
40,"40230",94,75,72,2,3,"PSOE",23
40,"40084",61,49,49,2,0,"PSOE",8
40,"40157",50,43,43,0,0,"PSOE",6
40,"40010",124,95,94,2,1,"PSOE",11
40,"40201",49,41,41,0,0,"PSOE",3
40,"40160",105,76,74,2,2,"PSOE",4
40,"40028",103,90,89,2,1,"PSOE",9
40,"40025",142,119,117,0,2,"PSOE",15
40,"40057",1488,1240,1228,14,12,"PSOE",384
40,"40017",92,77,76,1,1,"PSOE",12
40,"40220",66,50,45,2,5,"PSOE",2
40,"40184",253,210,210,3,0,"PSOE",22
40,"40136",114,84,81,3,3,"PSOE",8
40,"40078",161,129,128,2,1,"PSOE",38
40,"40009",50,41,41,0,0,"PSOE",3
40,"40055",36,25,23,0,2,"PSOE",8
40,"40183",130,113,112,1,1,"PSOE",2
40,"40002",37,33,33,1,0,"PSOE",3
40,"40061",70,55,54,0,1,"PSOE",8
40,"40165",80,62,60,1,2,"PSOE",23
40,"40003",143,109,104,1,5,"PSOE",9
40,"40108",116,80,79,2,1,"PSOE",17
40,"40210",100,74,74,0,0,"PSOE",13
40,"40125",90,67,63,0,4,"PSOE",7
40,"40172",44,29,29,0,0,"PSOE",6
40,"40056",34,27,27,1,0,"PSOE",4
40,"40124",244,190,185,6,5,"PSOE",42
40,"40068",24,22,22,0,0,"PSOE",0
40,"40202",63,41,41,0,0,"PSOE",9
40,"40053",88,64,64,3,0,"PSOE",20
40,"40222",174,147,147,0,0,"PSOE",42
40,"40026",113,106,106,0,0,"PSOE",18
40,"40045",112,89,88,1,1,"PSOE",13
40,"40204",167,127,126,2,1,"PSOE",22
40,"40906",1973,1645,1627,16,18,"PSOE",336
40,"40121",286,230,225,3,5,"PSOE",55
40,"40004",472,371,368,2,3,"PSOE",104
40,"40168",34,27,27,0,0,"PSOE",7
40,"40208",768,606,596,5,10,"PSOE",99
40,"40162",396,305,299,0,6,"PSOE",42
40,"40049",62,45,45,0,0,"PSOE",7
40,"40141",856,626,616,7,10,"PSOE",149
40,"40018",90,70,68,0,2,"PSOE",12
40,"40219",590,448,437,6,11,"PSOE",20
40,"40001",715,588,580,4,8,"PSOE",153
40,"40196",34,26,26,1,0,"PSOE",3
40,"40046",90,69,69,0,0,"PSOE",16
40,"40127",33,22,20,1,2,"PSOE",3
40,"40083",77,54,53,1,1,"PSOE",5
40,"40047",31,24,24,0,0,"PSOE",3
40,"40142",53,43,43,0,0,"PSOE",9
40,"40079",234,182,181,1,1,"PSOE",36
40,"40223",226,173,169,0,4,"PSOE",38
40,"40173",139,115,110,1,5,"PSOE",18
40,"40905",133,96,95,0,1,"PSOE",11
40,"40019",37,32,31,0,1,"PSOE",6
40,"40113",428,345,341,5,4,"PSOE",84
40,"40171",33,24,24,0,0,"PSOE",4
40,"40015",30,21,21,1,0,"PSOE",2
40,"40143",88,76,75,1,1,"PSOE",11
40,"40130",130,108,107,1,1,"PSOE",26
40,"40106",214,175,174,1,1,"PSOE",60
40,"40221",49,42,41,0,1,"PSOE",3
40,"40216",755,628,621,7,7,"PSOE",141
40,"40190",51,46,45,0,1,"PSOE",4
40,"40211",75,63,63,1,0,"PSOE",9
40,"40176",402,319,317,3,2,"PSOE",93
40,"40012",271,205,202,3,3,"PSOE",61
40,"40203",895,722,716,6,6,"PSOE",122
40,"40194",39796,30886,30516,287,370,"PSOE",6789
40,"40016",57,47,45,0,2,"PSOE",4
40,"40058",331,273,270,1,3,"PSOE",48
40,"40035",140,109,108,3,1,"PSOE",16
40,"40063",7132,5389,5297,56,92,"PSOE",1154
40,"40107",104,83,81,1,2,"PSOE",5
40,"40228",507,401,396,0,5,"PSOE",107
40,"40087",93,70,70,2,0,"PSOE",5
40,"40140",97,72,71,8,1,"PSOE",19
40,"40218",97,69,69,0,0,"PSOE",6
40,"40212",30,21,19,0,2,"PSOE",2
40,"40233",419,340,336,2,4,"PSOE",80
40,"40119",170,142,140,0,2,"PSOE",20
40,"40191",222,163,161,2,2,"PSOE",19
40,"40074",266,226,223,2,3,"PSOE",41
40,"40182",184,139,136,1,3,"PSOE",27
40,"40059",112,96,96,2,0,"PSOE",14
40,"40198",24,19,19,0,0,"PSOE",2
40,"40051",45,33,33,0,0,"PSOE",9
40,"40132",66,32,30,1,2,"PSOE",5
40,"40052",81,62,62,0,0,"PSOE",13
40,"40033",59,48,48,4,0,"PSOE",4
40,"40065",496,389,381,8,8,"PSOE",67
40,"40213",89,71,71,1,0,"PSOE",19
40,"40901",377,307,300,1,7,"PSOE",51
40,"40151",44,35,35,0,0,"PSOE",4
40,"40109",75,49,46,1,3,"PSOE",4
40,"40189",513,403,391,3,12,"PSOE",140
40,"40128",132,97,95,4,2,"PSOE",23
40,"40006",21,17,17,0,0,"PSOE",3
40,"40166",260,224,222,2,2,"PSOE",38
40,"40126",85,65,63,0,2,"PSOE",4
40,"40158",18,12,12,0,0,"PSOE",0
40,"40076",6550,5029,4942,29,87,"PSOE",1009
40,"40161",34,28,28,0,0,"PSOE",1
40,"40007",77,62,62,0,0,"PSOE",8
40,"40075",163,130,130,0,0,"PSOE",34
40,"40062",60,50,49,0,1,"PSOE",7
40,"40231",108,93,93,1,0,"PSOE",18
40,"40086",698,591,580,11,11,"PSOE",124
40,"40054",112,83,83,0,0,"PSOE",20
40,"40081",126,94,90,1,4,"PSOE",19
40,"40091",116,89,89,0,0,"PSOE",19
40,"40179",631,533,525,3,8,"PSOE",132
40,"40036",519,424,411,9,13,"PSOE",67
40,"40193",230,171,168,5,3,"PSOE",57
40,"40159",141,104,104,0,0,"PSOE",25
40,"40163",55,39,38,1,1,"PSOE",2
40,"40186",41,32,32,0,0,"PSOE",4
40,"40021",27,26,26,0,0,"PSOE",4
40,"40008",46,38,38,0,0,"PSOE",6
40,"40135",289,242,237,1,5,"PSOE",77
40,"40092",119,89,89,0,0,"PSOE",15
40,"40214",210,174,172,2,2,"PSOE",41
40,"40070",147,111,107,1,4,"PSOE",18
40,"40103",157,128,128,0,0,"PSOE",33
40,"40110",349,272,272,1,0,"PSOE",80
40,"40034",81,62,62,0,0,"PSOE",11
40,"40040",2626,1847,1835,19,12,"PSOE",404
40,"40022",207,162,160,3,2,"PSOE",28
40,"40234",407,326,322,3,4,"PSOE",89
40,"40024",872,676,660,9,16,"PSOE",131
40,"40156",330,239,234,2,5,"PSOE",37
40,"40138",2174,1739,1710,13,29,"PSOE",415
40,"40029",32,28,27,1,1,"PSOE",7
40,"40164",180,139,137,0,2,"PSOE",23
40,"40224",24,18,18,0,0,"PSOE",2
40,"40180",299,244,239,2,5,"PSOE",48
40,"40206",178,141,135,0,6,"PSOE",12
40,"40041",987,791,777,18,14,"PSOE",189
40,"40177",153,121,120,3,1,"PSOE",21
40,"40115",104,80,79,0,1,"PSOE",21
40,"40077",805,633,625,6,8,"PSOE",92
40,"40039",213,167,165,2,2,"PSOE",18
40,"40152",763,637,627,1,10,"PSOE",158
40,"40105",48,43,43,1,0,"PSOE",7
40,"40185",882,657,644,9,13,"PSOE",156
40,"40181",4258,3391,3329,23,62,"PSOE",987
40,"40902",125,102,102,0,0,"PSOE",13
40,"40139",281,218,216,1,2,"PSOE",57
40,"40095",475,376,370,7,6,"PSOE",45
40,"40225",1134,907,890,8,17,"PSOE",218
40,"40030",476,394,389,8,5,"PSOE",129
40,"40112",2525,2054,2034,18,20,"PSOE",361
40,"40097",124,105,105,0,0,"PSOE",38
40,"40082",115,90,88,4,2,"PSOE",20
40,"40195",910,709,702,13,7,"PSOE",159
40,"40154",21,13,13,0,0,"PSOE",6
40,"40048",38,30,30,0,0,"PSOE",7
40,"40069",84,67,67,0,0,"PSOE",9
40,"40150",71,61,61,0,0,"PSOE",9
40,"40149",528,401,390,7,11,"PSOE",54
40,"40101",874,672,669,11,3,"PSOE",163
40,"40071",46,42,39,0,3,"PSOE",6
40,"40118",52,39,38,2,1,"PSOE",8
40,"40200",41,31,31,0,0,"PSOE",10
40,"40188",95,70,70,1,0,"PSOE",12
40,"40148",240,201,200,1,1,"PSOE",40
40,"40229",38,28,28,0,0,"PSOE",7
40,"40123",148,122,113,3,9,"PSOE",18
40,"40093",77,67,67,5,0,"PSOE",3
40,"40144",19,15,15,0,0,"PSOE",1
40,"40080",61,49,49,0,0,"PSOE",11
40,"40043",1825,1455,1429,16,26,"PSOE",297
40,"40207",753,612,607,2,5,"PSOE",97
40,"40073",405,345,339,4,6,"PSOE",78
40,"40013",65,51,50,0,1,"PSOE",4
40,"40903",91,68,68,1,0,"PSOE",13
40,"40020",168,130,129,2,1,"PSOE",27
40,"40146",255,211,209,0,2,"PSOE",53
40,"40122",514,416,403,0,13,"PSOE",89
40,"40037",43,28,27,0,1,"PSOE",3
40,"40174",361,252,250,0,2,"PSOE",29
40,"40205",266,194,192,2,2,"PSOE",40
9,"9166",97,79,78,3,1,"UPYD",0
9,"9018",24702,18365,18158,174,207,"UPYD",217
9,"9266",91,72,70,0,2,"UPYD",0
9,"9414",201,148,147,1,1,"UPYD",0
9,"9198",108,86,85,2,1,"UPYD",0
9,"9041",28,28,28,1,0,"UPYD",0
9,"9440",96,78,78,0,0,"UPYD",1
9,"9103",221,185,184,2,1,"UPYD",0
9,"9235",160,124,123,0,1,"UPYD",0
9,"9025",125,86,79,1,7,"UPYD",0
9,"9079",46,40,37,0,3,"UPYD",0
9,"9328",77,55,55,1,0,"UPYD",1
9,"9244",47,26,26,1,0,"UPYD",0
9,"9229",201,146,145,0,1,"UPYD",0
9,"9021",56,33,31,0,2,"UPYD",1
9,"9011",69,49,49,0,0,"UPYD",2
9,"9270",163,122,121,1,1,"UPYD",3
9,"9060",148,123,123,0,0,"UPYD",2
9,"9164",165,121,121,1,0,"UPYD",1
9,"9098",516,396,388,6,8,"UPYD",2
9,"9388",36,31,30,1,1,"UPYD",0
9,"9392",53,40,40,0,0,"UPYD",0
9,"9904",482,389,384,5,5,"UPYD",2
9,"9372",221,190,189,1,1,"UPYD",1
9,"9152",263,193,192,0,1,"UPYD",0
9,"9183",51,37,37,0,0,"UPYD",0
9,"9046",30,26,26,0,0,"UPYD",0
9,"9310",13,9,8,0,1,"UPYD",0
9,"9048",1484,1120,1106,4,14,"UPYD",12
9,"9903",3251,2359,2340,24,19,"UPYD",14
9,"9398",75,54,54,1,0,"UPYD",0
9,"9179",43,35,34,0,1,"UPYD",0
9,"9454",47,34,34,0,0,"UPYD",0
9,"9304",202,166,163,1,3,"UPYD",0
9,"9251",371,273,271,3,2,"UPYD",0
9,"9093",154,133,128,1,5,"UPYD",0
9,"9176",61,45,44,0,1,"UPYD",2
9,"9191",39,32,30,0,2,"UPYD",0
9,"9072",307,240,239,1,1,"UPYD",5
9,"9403",96,78,76,1,2,"UPYD",2
9,"9418",82,63,62,3,1,"UPYD",0
9,"9174",809,575,565,10,10,"UPYD",9
9,"9101",79,59,59,0,0,"UPYD",0
9,"9273",53,41,40,1,1,"UPYD",0
9,"9908",469,314,309,2,5,"UPYD",3
9,"9058",393,293,289,2,4,"UPYD",2
9,"9330",1523,1166,1148,15,18,"UPYD",9
9,"9112",113,75,73,2,2,"UPYD",0
9,"9220",76,62,61,2,1,"UPYD",0
9,"9231",70,49,49,3,0,"UPYD",0
9,"9445",44,32,32,1,0,"UPYD",0
9,"9281",147,109,107,0,2,"UPYD",2
9,"9209",4511,3368,3301,37,67,"UPYD",24
9,"9274",1098,880,872,9,8,"UPYD",6
9,"9374",90,79,77,2,2,"UPYD",2
9,"9363",974,730,725,3,5,"UPYD",9
9,"9100",59,51,50,0,1,"UPYD",1
9,"9384",293,199,194,0,5,"UPYD",2
9,"9289",1466,1027,1013,6,14,"UPYD",12
9,"9345",124,92,92,0,0,"UPYD",0
9,"9208",211,139,136,3,3,"UPYD",1
9,"9102",37,31,31,0,0,"UPYD",2
9,"9247",23,19,19,0,0,"UPYD",0
9,"9068",29,23,22,0,1,"UPYD",0
9,"9109",1068,698,669,10,29,"UPYD",5
9,"9213",320,223,220,4,3,"UPYD",1
9,"9340",76,49,49,0,0,"UPYD",0
9,"9124",1520,1113,1096,9,17,"UPYD",7
9,"9034",280,237,233,5,4,"UPYD",3
9,"9088",66,44,42,1,2,"UPYD",0
9,"9361",117,96,96,0,0,"UPYD",1
9,"9466",134,99,99,0,0,"UPYD",3
9,"9130",79,63,62,1,1,"UPYD",0
9,"9140",128,88,87,0,1,"UPYD",0
9,"9352",116,97,97,0,0,"UPYD",0
9,"9258",173,139,136,4,3,"UPYD",2
9,"9327",25,22,22,0,0,"UPYD",0
9,"9009",163,130,128,2,2,"UPYD",1
9,"9325",195,125,123,2,2,"UPYD",2
9,"9169",99,83,81,0,2,"UPYD",0
9,"9228",163,138,138,0,0,"UPYD",2
9,"9225",84,57,56,1,1,"UPYD",1
9,"9394",727,558,552,8,6,"UPYD",10
9,"9159",56,48,48,1,0,"UPYD",0
9,"9226",66,55,53,0,2,"UPYD",0
9,"9295",60,37,37,0,0,"UPYD",1
9,"9416",52,39,39,0,0,"UPYD",1
9,"9387",118,96,95,0,1,"UPYD",3
9,"9059",136713,106605,105601,976,1004,"UPYD",1309
9,"9217",361,265,261,4,4,"UPYD",1
9,"9195",57,42,42,2,0,"UPYD",0
9,"9144",52,40,40,0,0,"UPYD",0
9,"9255",86,66,62,0,4,"UPYD",1
9,"9460",177,135,135,2,0,"UPYD",1
9,"9467",66,46,46,3,0,"UPYD",1
9,"9311",60,52,50,0,2,"UPYD",0
9,"9065",147,124,123,2,1,"UPYD",0
9,"9316",104,83,80,1,3,"UPYD",0
9,"9104",54,43,43,0,0,"UPYD",0
9,"9035",313,243,240,0,3,"UPYD",1
9,"9323",64,47,47,0,0,"UPYD",0
9,"9214",684,452,446,6,6,"UPYD",4
9,"9464",36,24,24,0,0,"UPYD",0
9,"9321",1640,1250,1237,5,13,"UPYD",9
9,"9261",463,339,330,8,9,"UPYD",2
9,"9317",16,14,14,0,0,"UPYD",0
9,"9268",95,73,72,0,1,"UPYD",1
9,"9182",78,63,61,2,2,"UPYD",0
9,"9122",96,66,66,0,0,"UPYD",0
9,"9312",98,83,82,0,1,"UPYD",0
9,"9386",58,44,43,2,1,"UPYD",0
9,"9265",38,31,31,0,0,"UPYD",1
9,"9003",192,148,146,2,2,"UPYD",0
9,"9055",52,39,38,0,1,"UPYD",0
9,"9329",123,86,86,1,0,"UPYD",1
9,"9197",148,108,104,1,4,"UPYD",0
9,"9354",33,30,30,1,0,"UPYD",1
9,"9047",56,45,45,2,0,"UPYD",1
9,"9201",30,17,17,0,0,"UPYD",0
9,"9277",119,101,100,0,1,"UPYD",1
9,"9180",136,102,100,2,2,"UPYD",1
9,"9369",442,331,328,1,3,"UPYD",5
9,"9094",51,42,41,0,1,"UPYD",0
9,"9378",31,21,21,1,0,"UPYD",0
9,"9202",24,22,22,1,0,"UPYD",0
9,"9306",113,91,91,1,0,"UPYD",2
9,"9039",58,38,38,0,0,"UPYD",0
9,"9429",56,41,41,0,0,"UPYD",1
9,"9038",118,97,94,0,3,"UPYD",0
9,"9246",622,458,455,5,3,"UPYD",2
9,"9248",78,57,57,0,0,"UPYD",2
9,"9029",168,134,132,3,2,"UPYD",1
9,"9451",238,199,198,1,1,"UPYD",1
9,"9407",27,23,23,1,0,"UPYD",0
9,"9056",4931,3634,3602,35,32,"UPYD",41
9,"9163",602,479,472,5,7,"UPYD",1
9,"9238",932,576,569,6,7,"UPYD",3
9,"9172",125,102,102,2,0,"UPYD",3
9,"9358",249,191,191,1,0,"UPYD",1
9,"9276",387,280,273,2,7,"UPYD",0
9,"9309",306,216,211,2,5,"UPYD",0
9,"9434",1221,985,970,10,15,"UPYD",9
9,"9287",208,170,168,2,2,"UPYD",2
9,"9417",40,30,30,0,0,"UPYD",0
9,"9052",31,22,21,1,1,"UPYD",0
9,"9408",41,34,34,1,0,"UPYD",0
9,"9134",228,152,152,2,0,"UPYD",2
9,"9221",445,337,335,1,2,"UPYD",2
9,"9224",157,122,122,0,0,"UPYD",1
9,"9439",1005,823,816,9,7,"UPYD",10
9,"9199",91,65,65,2,0,"UPYD",0
9,"9037",113,96,96,0,0,"UPYD",0
9,"9297",323,265,261,5,4,"UPYD",2
9,"9455",44,34,33,0,1,"UPYD",0
9,"9419",78,45,44,0,1,"UPYD",0
9,"9442",380,287,282,2,5,"UPYD",2
9,"9380",78,59,57,0,2,"UPYD",0
9,"9365",31,20,20,0,0,"UPYD",0
9,"9086",687,475,471,0,4,"UPYD",5
9,"9298",82,62,62,0,0,"UPYD",1
9,"9432",189,143,140,1,3,"UPYD",0
9,"9138",90,73,72,0,1,"UPYD",1
9,"9275",192,138,137,1,1,"UPYD",0
9,"9077",36,26,26,1,0,"UPYD",0
9,"9377",625,478,471,5,7,"UPYD",1
9,"9017",89,67,62,0,5,"UPYD",0
9,"9272",294,206,203,1,3,"UPYD",0
9,"9346",93,71,69,0,2,"UPYD",0
9,"9194",2024,1550,1530,17,20,"UPYD",18
9,"9250",273,218,218,4,0,"UPYD",4
9,"9253",111,96,94,1,2,"UPYD",0
9,"9013",47,41,41,0,0,"UPYD",0
9,"9375",35,27,27,0,0,"UPYD",0
9,"9368",22,14,14,1,0,"UPYD",0
9,"9478",45,38,38,0,0,"UPYD",0
9,"9906",1223,952,947,9,5,"UPYD",11
9,"9175",129,92,92,0,0,"UPYD",0
9,"9472",55,40,40,0,0,"UPYD",0
9,"9308",67,43,43,1,0,"UPYD",0
9,"9063",213,184,182,2,2,"UPYD",1
9,"9067",442,308,303,9,5,"UPYD",2
9,"9458",466,380,377,3,3,"UPYD",5
9,"9054",100,73,72,3,1,"UPYD",2
9,"9083",37,33,33,0,0,"UPYD",0
9,"9422",18,10,10,0,0,"UPYD",0
9,"9301",616,513,506,5,7,"UPYD",2
9,"9215",377,264,260,0,4,"UPYD",3
9,"9006",61,41,41,0,0,"UPYD",0
9,"9131",460,381,373,5,8,"UPYD",2
9,"9218",360,272,271,2,1,"UPYD",5
9,"9010",32,23,23,2,0,"UPYD",0
9,"9064",332,275,275,3,0,"UPYD",1
9,"9149",34,25,24,0,1,"UPYD",0
9,"9113",464,383,376,6,7,"UPYD",4
9,"9090",57,51,51,1,0,"UPYD",0
9,"9302",116,87,87,0,0,"UPYD",3
9,"9480",110,89,88,1,1,"UPYD",0
9,"9427",1428,1014,1003,12,11,"UPYD",10
9,"9127",55,40,40,0,0,"UPYD",1
9,"9267",115,101,100,3,1,"UPYD",0
9,"9905",391,308,308,5,0,"UPYD",7
9,"9395",136,96,95,0,1,"UPYD",1
9,"9105",107,88,86,0,2,"UPYD",0
9,"9456",129,90,90,2,0,"UPYD",0
9,"9421",237,172,172,2,0,"UPYD",4
9,"9249",47,37,37,1,0,"UPYD",1
9,"9115",92,69,68,0,1,"UPYD",2
9,"9236",38,32,32,0,0,"UPYD",0
9,"9129",105,87,87,0,0,"UPYD",0
9,"9125",596,435,433,3,2,"UPYD",5
9,"9326",148,115,113,2,2,"UPYD",3
9,"9303",92,72,71,0,1,"UPYD",1
9,"9413",447,333,333,5,0,"UPYD",6
9,"9410",3051,2169,2153,18,16,"UPYD",18
9,"9108",378,290,287,2,3,"UPYD",2
9,"9200",48,37,36,0,1,"UPYD",0
9,"9216",385,283,280,8,3,"UPYD",0
9,"9242",81,65,63,2,2,"UPYD",0
9,"9027",47,44,41,0,3,"UPYD",0
9,"9348",146,116,114,1,2,"UPYD",3
9,"9351",60,46,45,1,1,"UPYD",3
9,"9160",90,71,70,0,1,"UPYD",0
9,"9269",39,33,32,0,1,"UPYD",0
9,"9294",111,88,86,0,2,"UPYD",2
9,"9141",610,499,493,4,6,"UPYD",8
9,"9256",362,261,255,2,6,"UPYD",6
9,"9412",803,552,550,2,2,"UPYD",2
9,"9907",1420,1120,1115,13,5,"UPYD",10
9,"9057",144,116,115,0,1,"UPYD",0
9,"9901",374,268,261,3,7,"UPYD",0
9,"9024",156,117,114,0,3,"UPYD",0
9,"9343",97,70,69,0,1,"UPYD",0
9,"9307",113,91,91,0,0,"UPYD",0
9,"9051",168,133,132,1,1,"UPYD",4
9,"9425",514,369,366,2,3,"UPYD",0
9,"9448",216,180,178,1,2,"UPYD",2
9,"9337",115,84,82,0,2,"UPYD",1
9,"9315",379,269,267,2,2,"UPYD",0
9,"9091",732,516,512,7,4,"UPYD",1
9,"9366",90,64,63,1,1,"UPYD",1
9,"9262",161,129,129,0,0,"UPYD",0
9,"9227",119,97,95,0,2,"UPYD",0
9,"9095",86,62,62,0,0,"UPYD",1
9,"9181",302,231,225,3,6,"UPYD",3
9,"9016",85,64,64,2,0,"UPYD",0
9,"9154",142,104,104,2,0,"UPYD",0
9,"9123",40,35,35,0,0,"UPYD",0
9,"9085",475,352,350,2,2,"UPYD",9
9,"9362",204,168,164,0,4,"UPYD",0
9,"9391",361,264,263,2,1,"UPYD",1
9,"9471",151,117,117,0,0,"UPYD",1
9,"9902",461,347,339,1,8,"UPYD",3
9,"9335",87,72,71,0,1,"UPYD",0
9,"9044",46,38,37,0,1,"UPYD",0
9,"9020",262,187,180,2,7,"UPYD",1
9,"9382",33,30,29,1,1,"UPYD",0
9,"9133",40,34,34,0,0,"UPYD",0
9,"9339",128,103,103,0,0,"UPYD",1
9,"9189",130,88,86,2,2,"UPYD",0
9,"9155",26,20,20,1,0,"UPYD",0
9,"9022",67,57,57,1,0,"UPYD",1
9,"9206",61,52,50,3,2,"UPYD",2
9,"9075",111,83,83,1,0,"UPYD",0
9,"9405",128,89,89,0,0,"UPYD",2
9,"9423",27,25,25,0,0,"UPYD",0
9,"9084",189,150,148,7,2,"UPYD",1
9,"9061",166,124,123,1,1,"UPYD",2
9,"9415",267,166,165,0,1,"UPYD",1
9,"9360",30,27,27,0,0,"UPYD",0
9,"9239",53,44,42,1,2,"UPYD",0
9,"9033",89,75,75,0,0,"UPYD",2
9,"9019",147,103,102,1,1,"UPYD",0
9,"9148",86,73,69,5,4,"UPYD",1
9,"9119",46,27,27,0,0,"UPYD",1
9,"9350",480,358,347,5,11,"UPYD",3
9,"9001",27,26,26,0,0,"UPYD",0
9,"9283",46,29,28,0,1,"UPYD",0
9,"9257",92,80,78,4,2,"UPYD",1
9,"9443",183,132,129,1,3,"UPYD",0
9,"9476",63,46,46,0,0,"UPYD",0
9,"9431",119,99,98,0,1,"UPYD",3
9,"9062",51,44,44,1,0,"UPYD",3
9,"9292",92,72,70,0,2,"UPYD",0
9,"9178",52,36,36,1,0,"UPYD",0
9,"9430",24,19,19,0,0,"UPYD",2
9,"9073",926,753,748,10,5,"UPYD",6
9,"9114",87,67,67,0,0,"UPYD",0
9,"9446",12,7,7,0,0,"UPYD",0
9,"9441",74,66,66,0,0,"UPYD",0
9,"9023",1096,848,840,9,8,"UPYD",12
9,"9070",34,31,30,3,1,"UPYD",1
9,"9074",788,609,598,8,11,"UPYD",7
9,"9280",27,17,17,0,0,"UPYD",0
9,"9190",91,56,55,0,1,"UPYD",0
9,"9066",65,51,51,0,0,"UPYD",0
9,"9444",72,48,48,2,0,"UPYD",0
9,"9353",73,57,56,0,1,"UPYD",1
9,"9139",101,75,73,2,2,"UPYD",2
9,"9241",201,156,155,3,1,"UPYD",1
9,"9279",177,130,130,0,0,"UPYD",3
9,"9110",80,49,49,1,0,"UPYD",0
9,"9334",48,39,38,0,1,"UPYD",0
9,"9433",60,52,51,0,1,"UPYD",0
9,"9117",77,61,57,0,4,"UPYD",0
9,"9449",87,72,71,1,1,"UPYD",1
9,"9173",123,93,93,1,0,"UPYD",0
9,"9356",42,31,31,0,0,"UPYD",0
9,"9243",75,56,54,1,2,"UPYD",0
9,"9473",85,62,61,1,1,"UPYD",0
9,"9314",95,80,79,1,1,"UPYD",1
9,"9045",267,186,183,2,3,"UPYD",3
9,"9078",41,35,33,0,2,"UPYD",0
9,"9259",233,184,184,3,0,"UPYD",1
9,"9132",173,132,130,0,2,"UPYD",0
9,"9211",1462,1086,1070,11,16,"UPYD",9
9,"9438",544,446,444,3,2,"UPYD",1
9,"9135",41,33,33,1,0,"UPYD",1
9,"9406",252,196,195,1,1,"UPYD",1
9,"9120",39,35,35,0,0,"UPYD",0
9,"9396",152,118,118,1,0,"UPYD",0
9,"9390",611,478,477,3,1,"UPYD",0
9,"9450",27,21,20,1,1,"UPYD",0
9,"9424",32,26,26,1,0,"UPYD",0
9,"9014",213,127,126,1,1,"UPYD",2
9,"9184",5,4,4,0,0,"UPYD",0
9,"9128",82,66,66,0,0,"UPYD",1
9,"9026",397,314,311,1,3,"UPYD",2
9,"9151",458,364,363,3,1,"UPYD",1
9,"9082",40,35,35,0,0,"UPYD",0
9,"9032",108,73,73,0,0,"UPYD",0
9,"9050",72,54,54,0,0,"UPYD",0
9,"9355",101,75,73,0,2,"UPYD",1
9,"9447",42,38,38,0,0,"UPYD",0
9,"9347",141,113,109,4,4,"UPYD",0
9,"9338",219,173,171,1,2,"UPYD",1
9,"9036",38,31,30,2,1,"UPYD",1
9,"9332",140,107,107,1,0,"UPYD",1
9,"9232",151,125,124,2,1,"UPYD",0
9,"9170",203,152,149,1,3,"UPYD",4
9,"9043",189,132,132,2,0,"UPYD",1
9,"9168",296,233,231,1,2,"UPYD",3
9,"9076",23,14,14,0,0,"UPYD",0
9,"9007",59,41,41,0,0,"UPYD",1
9,"9437",286,227,226,5,1,"UPYD",4
9,"9223",46,39,39,0,0,"UPYD",0
9,"9219",27590,19903,19724,166,179,"UPYD",181
9,"9463",262,206,206,3,0,"UPYD",0
9,"9071",45,34,34,0,0,"UPYD",1
9,"9483",212,161,161,1,0,"UPYD",1
9,"9143",27,20,20,0,0,"UPYD",0
9,"9167",59,42,42,2,0,"UPYD",1
9,"9411",149,111,111,0,0,"UPYD",2
9,"9288",91,70,69,1,1,"UPYD",0
9,"9381",32,23,22,0,1,"UPYD",0
9,"9485",55,43,43,1,0,"UPYD",0
9,"9192",55,47,46,0,1,"UPYD",0
9,"9030",109,76,76,3,0,"UPYD",2
9,"9137",167,128,128,1,0,"UPYD",1
9,"9400",317,258,256,3,2,"UPYD",4
9,"9196",154,108,107,1,1,"UPYD",3
9,"9230",38,31,31,0,0,"UPYD",0
9,"9012",93,68,66,1,2,"UPYD",2
9,"9177",1117,830,825,5,5,"UPYD",4
9,"9373",440,285,282,3,3,"UPYD",3
9,"9318",61,38,38,0,0,"UPYD",1
9,"9389",77,56,56,0,0,"UPYD",2
9,"9428",107,87,87,0,0,"UPYD",3
9,"9409",109,87,87,0,0,"UPYD",0
9,"9482",34,29,28,0,1,"UPYD",2
9,"9136",192,151,147,2,4,"UPYD",1
9,"9162",143,108,108,0,0,"UPYD",1
20,"20056",4104,2654,2633,12,21,"IU-UPeC",36
20,"20048",176,104,104,2,0,"IU-UPeC",0
20,"20020",129,71,71,0,0,"IU-UPeC",0
20,"20902",14193,10263,10219,56,44,"IU-UPeC",295
20,"20071",14818,10095,10057,62,38,"IU-UPeC",188
20,"20010",1494,1055,1053,4,2,"IU-UPeC",7
20,"20006",262,161,159,1,2,"IU-UPeC",3
20,"20008",721,382,376,5,6,"IU-UPeC",6
20,"20032",8785,6115,6076,45,39,"IU-UPeC",106
20,"20904",96,62,62,0,0,"IU-UPeC",0
20,"20031",180,105,102,1,3,"IU-UPeC",1
20,"20053",4765,3150,3132,18,18,"IU-UPeC",65
20,"20061",4273,2832,2816,21,16,"IU-UPeC",44
20,"20057",201,122,121,0,1,"IU-UPeC",2
20,"20070",1099,749,744,4,5,"IU-UPeC",6
20,"20063",7990,5449,5415,23,34,"IU-UPeC",94
20,"20065",3006,2104,2089,18,15,"IU-UPeC",37
20,"20003",541,334,334,3,0,"IU-UPeC",0
20,"20064",12526,8429,8387,59,42,"IU-UPeC",240
20,"20055",17522,12125,12043,52,82,"IU-UPeC",423
20,"20073",4677,3219,3208,21,11,"IU-UPeC",40
20,"20067",30825,21606,21512,113,94,"IU-UPeC",787
20,"20011",1660,1283,1278,9,5,"IU-UPeC",20
20,"20058",746,547,546,3,1,"IU-UPeC",9
20,"20036",13148,9191,9132,85,59,"IU-UPeC",361
20,"20066",461,279,276,3,3,"IU-UPeC",1
20,"20021",199,110,110,2,0,"IU-UPeC",2
20,"20017",8580,5807,5770,37,37,"IU-UPeC",93
20,"20028",2255,1503,1494,17,9,"IU-UPeC",20
20,"20081",7460,5187,5159,33,28,"IU-UPeC",87
20,"20030",21515,15110,15019,108,91,"IU-UPeC",469
20,"20041",258,148,148,2,0,"IU-UPeC",2
20,"20907",120,85,84,2,1,"IU-UPeC",2
20,"20019",10053,6876,6844,72,32,"IU-UPeC",228
20,"20046",1167,797,794,4,3,"IU-UPeC",12
20,"20034",3157,2145,2141,7,4,"IU-UPeC",79
20,"20905",141,105,105,0,0,"IU-UPeC",0
20,"20059",8863,6091,6072,30,19,"IU-UPeC",73
20,"20042",3251,2170,2152,23,18,"IU-UPeC",37
20,"20044",368,264,259,0,5,"IU-UPeC",1
20,"20012",144,108,108,3,0,"IU-UPeC",0
20,"20076",6978,4975,4958,39,17,"IU-UPeC",126
20,"20038",392,284,281,1,3,"IU-UPeC",4
20,"20015",1272,924,921,9,3,"IU-UPeC",8
20,"20075",4359,2852,2833,16,19,"IU-UPeC",63
20,"20068",183,117,115,0,2,"IU-UPeC",2
20,"20079",17835,12650,12587,81,63,"IU-UPeC",245
20,"20054",447,301,297,5,4,"IU-UPeC",0
20,"20001",242,138,137,1,1,"IU-UPeC",0
20,"20022",834,499,494,7,5,"IU-UPeC",3
20,"20007",304,209,209,5,0,"IU-UPeC",2
20,"20043",1740,1157,1152,6,5,"IU-UPeC",7
20,"20049",4124,2793,2780,22,13,"IU-UPeC",43
20,"20906",121,84,84,1,0,"IU-UPeC",4
20,"20033",864,629,625,3,4,"IU-UPeC",9
20,"20037",97,59,59,1,0,"IU-UPeC",0
20,"20026",202,141,129,4,12,"IU-UPeC",2
20,"20002",343,227,226,10,1,"IU-UPeC",2
20,"20045",46691,32759,32560,222,199,"IU-UPeC",1304
20,"20080",7900,5517,5487,33,30,"IU-UPeC",227
20,"20051",6904,5001,4975,31,26,"IU-UPeC",152
20,"20050",263,160,160,4,0,"IU-UPeC",2
20,"20004",252,135,135,2,0,"IU-UPeC",2
20,"20078",1155,866,864,6,2,"IU-UPeC",4
20,"20903",4247,2846,2826,9,20,"IU-UPeC",66
20,"20901",1441,982,979,2,3,"IU-UPeC",20
20,"20069",147189,106909,106506,699,403,"IU-UPeC",3296
20,"20016",1514,885,884,5,1,"IU-UPeC",7
20,"20005",1261,811,805,7,6,"IU-UPeC",10
20,"20023",445,258,258,2,0,"IU-UPeC",2
20,"20052",1091,797,792,6,5,"IU-UPeC",15
20,"20040",15321,10260,10176,69,84,"IU-UPeC",201
20,"20027",2816,1842,1833,11,9,"IU-UPeC",16
20,"20009",11528,7997,7955,57,42,"IU-UPeC",257
20,"20077",5243,3792,3777,25,15,"IU-UPeC",125
20,"20060",89,76,75,2,1,"IU-UPeC",0
20,"20062",982,685,684,3,1,"IU-UPeC",8
20,"20039",2111,1539,1532,13,7,"IU-UPeC",11
20,"20025",1144,774,767,5,7,"IU-UPeC",8
20,"20029",4258,3005,2992,17,13,"IU-UPeC",64
20,"20047",477,329,329,2,0,"IU-UPeC",2
20,"20018",11074,7100,7059,29,41,"IU-UPeC",46
20,"20014",1111,635,632,4,3,"IU-UPeC",11
20,"20013",5427,3901,3875,19,26,"IU-UPeC",123
20,"20074",11610,8382,8320,43,62,"IU-UPeC",181
20,"20035",482,329,328,4,1,"IU-UPeC",5
20,"20072",4731,3132,3123,23,9,"IU-UPeC",67
20,"20024",393,226,226,2,0,"IU-UPeC",2
25,"25185",681,421,418,8,3,"C's",24
25,"25205",562,413,402,2,11,"C's",33
25,"25155",667,463,459,5,4,"C's",21
25,"25010",212,131,130,6,1,"C's",3
25,"25156",791,574,571,7,3,"C's",35
25,"25088",96,76,75,0,1,"C's",5
25,"25212",234,173,171,1,2,"C's",19
25,"25114",97,87,87,0,0,"C's",0
25,"25152",140,100,98,4,2,"C's",4
25,"25227",641,398,395,3,3,"C's",13
25,"25902",570,390,379,3,11,"C's",22
25,"25218",84,66,66,0,0,"C's",1
25,"25118",350,223,223,8,0,"C's",13
25,"25016",2114,1417,1411,8,6,"C's",43
25,"25158",1639,1163,1150,26,13,"C's",70
25,"25073",588,374,371,8,3,"C's",21
25,"25051",1522,990,983,10,7,"C's",51
25,"25041",569,380,374,7,6,"C's",15
25,"25234",4290,2645,2621,25,24,"C's",183
25,"25181",177,138,137,5,1,"C's",4
25,"25006",346,214,212,6,2,"C's",29
25,"25136",98,71,70,0,1,"C's",0
25,"25182",1043,738,727,13,11,"C's",62
25,"25126",286,214,210,5,4,"C's",4
25,"25142",368,252,251,3,1,"C's",11
25,"25127",212,135,134,3,1,"C's",1
25,"25901",292,186,181,4,5,"C's",6
25,"25067",730,483,479,4,4,"C's",44
25,"25048",1644,1151,1138,8,13,"C's",89
25,"25230",1573,1100,1081,13,19,"C's",73
25,"25254",738,507,493,6,14,"C's",33
25,"25222",67,52,52,1,0,"C's",3
25,"25149",1382,1010,993,7,17,"C's",45
25,"25904",155,118,118,0,0,"C's",4
25,"25068",558,372,369,9,3,"C's",13
25,"25119",2259,1582,1569,22,13,"C's",68
25,"25046",421,292,286,1,6,"C's",11
25,"25089",106,58,58,0,0,"C's",2
25,"25103",131,80,80,3,0,"C's",3
25,"25003",3782,2390,2372,24,18,"C's",165
25,"25124",169,118,116,2,2,"C's",7
25,"25121",642,415,413,8,2,"C's",52
25,"25165",280,194,190,4,4,"C's",6
25,"25064",112,85,85,3,0,"C's",2
25,"25189",2106,1392,1381,16,11,"C's",131
25,"25175",194,132,132,7,0,"C's",9
25,"25151",670,466,459,3,7,"C's",32
25,"25202",101,72,72,0,0,"C's",2
25,"25179",161,115,114,0,1,"C's",6
25,"25217",10594,7016,6950,119,66,"C's",468
25,"25055",172,118,116,2,2,"C's",6
25,"25105",130,95,93,4,2,"C's",1
25,"25069",453,289,286,6,3,"C's",5
25,"25110",2796,1828,1807,30,21,"C's",111
25,"25092",132,93,89,1,4,"C's",0
25,"25128",142,89,89,0,0,"C's",8
25,"25059",801,590,584,11,6,"C's",100
25,"25130",197,117,117,3,0,"C's",5
25,"25251",710,495,494,3,1,"C's",33
25,"25094",139,111,109,0,2,"C's",3
25,"25052",1573,1132,1122,16,10,"C's",35
25,"25004",571,425,423,5,2,"C's",25
25,"25228",3043,2140,2118,21,22,"C's",272
25,"25035",397,287,286,3,1,"C's",36
25,"25226",251,156,153,3,3,"C's",3
25,"25908",228,138,137,3,1,"C's",2
25,"25140",774,468,465,4,3,"C's",22
25,"25057",206,152,151,2,1,"C's",23
25,"25011",5256,3190,3161,36,29,"C's",317
25,"25033",1106,777,767,7,10,"C's",40
25,"25036",184,126,121,0,5,"C's",5
25,"25204",1241,843,827,3,16,"C's",51
25,"25194",426,278,273,0,5,"C's",10
25,"25081",318,213,210,2,3,"C's",9
25,"25219",144,106,105,3,1,"C's",8
25,"25906",226,144,143,0,1,"C's",8
25,"25148",220,155,153,0,2,"C's",10
25,"25096",912,586,572,9,14,"C's",16
25,"25075",117,82,82,0,0,"C's",2
25,"25249",183,118,118,2,0,"C's",8
25,"25132",130,97,95,1,2,"C's",5
25,"25079",305,216,214,5,2,"C's",4
25,"25164",381,264,262,2,2,"C's",8
25,"25082",280,169,167,3,2,"C's",6
25,"25122",1916,1274,1264,15,10,"C's",74
25,"25154",120,68,68,1,0,"C's",3
25,"25007",1410,1005,996,13,9,"C's",103
25,"25168",508,392,391,2,1,"C's",33
25,"25071",51,31,31,0,0,"C's",0
25,"25044",189,136,136,3,0,"C's",13
25,"25063",91,55,55,0,0,"C's",5
25,"25216",226,150,150,0,0,"C's",10
25,"25201",115,70,67,0,3,"C's",6
25,"25008",1135,828,819,11,9,"C's",39
25,"25037",385,245,241,2,4,"C's",9
25,"25023",4527,3111,3073,20,38,"C's",405
25,"25002",484,323,321,2,2,"C's",9
25,"25005",277,183,182,2,1,"C's",11
25,"25027",1001,687,681,3,6,"C's",22
25,"25020",292,203,200,2,3,"C's",14
25,"25206",257,164,164,3,0,"C's",1
25,"25913",87,69,69,1,0,"C's",1
25,"25145",85,64,64,2,0,"C's",4
25,"25200",336,218,218,0,0,"C's",2
25,"25017",239,160,159,2,1,"C's",2
25,"25243",3612,2449,2423,30,26,"C's",430
25,"25153",198,141,137,0,4,"C's",10
25,"25099",1260,804,793,8,11,"C's",41
25,"25112",272,189,189,2,0,"C's",12
25,"25141",156,101,99,1,2,"C's",3
25,"25150",185,127,124,1,3,"C's",7
25,"25223",922,614,598,8,16,"C's",17
25,"25024",356,233,230,1,3,"C's",4
25,"25113",1163,854,845,12,9,"C's",33
25,"25077",460,272,269,2,3,"C's",8
25,"25021",2618,1655,1639,32,16,"C's",83
25,"25104",125,86,86,3,0,"C's",5
25,"25239",608,320,319,1,1,"C's",37
25,"25169",188,125,124,3,1,"C's",7
25,"25167",236,158,156,3,2,"C's",3
25,"25174",398,299,296,3,3,"C's",19
25,"25208",316,191,189,1,2,"C's",4
25,"25231",490,382,382,2,0,"C's",16
25,"25093",639,451,445,11,6,"C's",43
25,"25171",2190,1461,1444,4,17,"C's",62
25,"25192",767,510,496,11,14,"C's",24
25,"25045",52,36,36,0,0,"C's",4
25,"25100",212,134,134,3,0,"C's",5
25,"25062",757,521,516,4,5,"C's",35
25,"25097",87,62,62,4,0,"C's",2
25,"25053",1059,762,759,10,3,"C's",68
25,"25238",217,151,151,6,0,"C's",10
25,"25172",1805,1230,1214,8,16,"C's",43
25,"25225",575,395,393,6,2,"C's",22
25,"25137",8577,5630,5591,45,39,"C's",471
25,"25120",92243,61433,61005,533,428,"C's",8142
25,"25101",565,393,388,9,5,"C's",12
25,"25060",70,45,45,2,0,"C's",4
25,"25012",2296,1504,1488,8,16,"C's",186
25,"25177",372,258,258,2,0,"C's",21
25,"25009",631,465,460,3,5,"C's",22
25,"25042",208,143,142,0,1,"C's",7
25,"25215",334,244,243,2,1,"C's",26
25,"25015",355,258,257,3,1,"C's",6
25,"25111",115,83,83,1,0,"C's",4
25,"25233",278,193,191,2,2,"C's",16
25,"25170",264,182,179,1,3,"C's",6
25,"25910",101,64,62,0,2,"C's",0
25,"25109",238,168,168,1,0,"C's",3
25,"25134",635,418,414,4,4,"C's",11
25,"25086",533,373,372,5,1,"C's",12
25,"25131",412,271,261,8,10,"C's",10
25,"25049",151,104,104,1,0,"C's",7
25,"25056",243,151,150,2,1,"C's",2
25,"25022",106,76,76,2,0,"C's",1
25,"25173",1702,1180,1171,5,9,"C's",116
25,"25138",576,415,408,6,7,"C's",19
25,"25248",891,622,616,3,6,"C's",13
25,"25245",441,313,313,0,0,"C's",30
25,"25911",452,301,299,7,2,"C's",7
25,"25025",1346,966,956,10,10,"C's",160
25,"25183",501,332,331,4,1,"C's",13
25,"25074",182,145,141,0,4,"C's",6
25,"25135",1032,707,701,7,6,"C's",40
25,"25146",224,150,148,2,2,"C's",8
25,"25115",824,551,549,12,2,"C's",25
25,"25029",1662,1156,1147,13,9,"C's",26
25,"25038",1564,1075,1062,11,13,"C's",63
25,"25031",52,31,31,0,0,"C's",17
25,"25220",1028,709,701,9,8,"C's",25
25,"25224",126,86,86,1,0,"C's",0
25,"25232",1421,961,950,10,11,"C's",61
25,"25912",868,618,617,5,1,"C's",109
25,"25209",1517,1035,1019,6,16,"C's",51
25,"25013",2171,1380,1366,10,14,"C's",99
25,"25078",1007,720,717,6,3,"C's",42
25,"25203",8976,5588,5526,53,62,"C's",514
25,"25161",368,234,232,3,2,"C's",10
25,"25250",344,236,234,0,2,"C's",2
25,"25072",5858,3878,3835,45,43,"C's",336
25,"25098",253,163,160,2,3,"C's",3
25,"25180",239,151,151,0,0,"C's",3
25,"25210",1104,779,767,9,12,"C's",58
25,"25129",176,113,110,6,3,"C's",4
25,"25176",312,239,235,7,4,"C's",15
25,"25240",1407,1006,995,10,11,"C's",82
25,"25039",280,182,180,0,2,"C's",7
25,"25197",137,97,97,2,0,"C's",7
25,"25207",6216,4062,4031,45,31,"C's",219
25,"25252",548,399,398,6,1,"C's",24
25,"25034",2331,1516,1505,20,11,"C's",71
25,"25909",155,89,89,3,0,"C's",2
25,"25244",369,252,248,3,4,"C's",25
25,"25193",765,520,514,3,6,"C's",11
25,"25247",123,72,72,0,0,"C's",21
25,"25196",119,74,74,0,0,"C's",2
25,"25166",177,123,121,1,2,"C's",3
25,"25157",181,139,137,1,2,"C's",14
25,"25905",386,260,255,4,5,"C's",14
25,"25047",1010,730,722,6,8,"C's",39
25,"25102",712,473,467,10,6,"C's",55
25,"25061",82,53,53,0,0,"C's",4
25,"25087",61,46,45,0,1,"C's",0
25,"25123",193,131,130,0,1,"C's",9
25,"25221",130,76,76,0,0,"C's",6
25,"25019",4565,3001,2965,36,36,"C's",337
25,"25085",152,106,106,0,0,"C's",9
25,"25255",426,308,302,4,6,"C's",17
25,"25133",713,469,464,1,5,"C's",11
25,"25125",424,279,273,4,6,"C's",14
25,"25043",794,505,501,3,4,"C's",13
25,"25001",139,88,87,1,1,"C's",2
25,"25139",479,325,324,3,1,"C's",20
25,"25076",146,84,84,1,0,"C's",1
25,"25186",214,141,138,2,3,"C's",5
25,"25903",237,154,152,3,2,"C's",6
25,"25070",817,584,573,14,11,"C's",26
25,"25058",4378,2810,2793,27,17,"C's",157
25,"25143",87,58,57,1,1,"C's",4
25,"25211",683,427,422,4,5,"C's",25
25,"25032",61,44,43,0,1,"C's",0
25,"25242",732,480,477,4,3,"C's",22
25,"25907",498,317,314,3,3,"C's",9
25,"25050",3253,2064,2048,27,16,"C's",88
25,"25163",228,143,142,5,1,"C's",7
25,"25030",131,86,86,2,0,"C's",1
25,"25191",332,225,222,3,3,"C's",12
25,"25014",254,177,174,4,3,"C's",3
25,"25040",10532,6837,6762,81,75,"C's",556
25,"25253",163,125,124,0,1,"C's",3
25,"25190",263,195,195,4,0,"C's",9
37,"37300",575,427,423,3,4,"PREPAL",0
37,"37110",117,92,89,1,3,"PREPAL",0
37,"37201",262,179,177,0,2,"PREPAL",0
37,"37011",122,91,89,0,2,"PREPAL",0
37,"37209",406,281,280,7,1,"PREPAL",0
37,"37152",424,290,283,2,7,"PREPAL",1
37,"37313",555,415,411,1,4,"PREPAL",2
37,"37335",415,301,293,2,8,"PREPAL",0
37,"37077",260,234,230,0,4,"PREPAL",0
37,"37281",37,34,33,0,1,"PREPAL",0
37,"37324",371,284,279,4,5,"PREPAL",0
37,"37222",97,66,66,1,0,"PREPAL",0
37,"37133",108,82,79,4,3,"PREPAL",0
37,"37140",678,440,435,2,5,"PREPAL",0
37,"37119",109,86,86,1,0,"PREPAL",1
37,"37014",1161,850,847,5,3,"PREPAL",0
37,"37323",521,387,385,8,2,"PREPAL",1
37,"37318",209,156,155,1,1,"PREPAL",3
37,"37090",52,38,36,0,2,"PREPAL",0
37,"37316",751,584,577,5,7,"PREPAL",1
37,"37112",161,115,114,0,1,"PREPAL",0
37,"37010",956,716,708,3,8,"PREPAL",3
37,"37305",216,170,169,2,1,"PREPAL",1
37,"37114",88,67,66,1,1,"PREPAL",0
37,"37123",182,141,138,0,3,"PREPAL",0
37,"37341",56,43,41,0,2,"PREPAL",0
37,"37003",119,93,90,0,3,"PREPAL",0
37,"37083",179,159,159,0,0,"PREPAL",0
37,"37106",266,172,166,1,6,"PREPAL",0
37,"37191",116,78,76,0,2,"PREPAL",0
37,"37170",1479,1055,1031,10,24,"PREPAL",2
37,"37377",249,199,195,3,4,"PREPAL",0
37,"37214",125,88,88,1,0,"PREPAL",0
37,"37296",338,258,255,4,3,"PREPAL",0
37,"37216",310,264,257,4,7,"PREPAL",0
37,"37182",77,62,62,0,0,"PREPAL",0
37,"37373",755,548,545,3,3,"PREPAL",0
37,"37259",45,30,30,0,0,"PREPAL",0
37,"37372",146,117,115,0,2,"PREPAL",0
37,"37046",11336,8300,8171,62,129,"PREPAL",8
37,"37050",67,47,46,1,1,"PREPAL",0
37,"37096",220,174,174,5,0,"PREPAL",0
37,"37219",179,110,110,0,0,"PREPAL",0
37,"37298",184,125,125,1,0,"PREPAL",1
37,"37125",228,158,156,3,2,"PREPAL",0
37,"37239",229,196,194,6,2,"PREPAL",0
37,"37134",230,175,173,1,2,"PREPAL",0
37,"37217",56,46,44,1,2,"PREPAL",0
37,"37320",93,71,71,1,0,"PREPAL",0
37,"37270",190,142,139,1,3,"PREPAL",0
37,"37364",836,598,583,6,15,"PREPAL",0
37,"37297",420,342,331,4,11,"PREPAL",0
37,"37070",533,403,396,4,7,"PREPAL",0
37,"37024",92,77,77,0,0,"PREPAL",2
37,"37284",325,245,244,2,1,"PREPAL",0
37,"37275",123,87,86,1,1,"PREPAL",0
37,"37200",190,134,133,2,1,"PREPAL",0
37,"37249",44,33,33,1,0,"PREPAL",0
37,"37302",294,216,214,1,2,"PREPAL",0
37,"37184",345,247,244,1,3,"PREPAL",0
37,"37282",209,136,136,0,0,"PREPAL",0
37,"37146",122,100,99,1,1,"PREPAL",0
37,"37205",233,201,197,1,4,"PREPAL",0
37,"37089",67,50,49,0,1,"PREPAL",0
37,"37268",116,71,70,0,1,"PREPAL",1
37,"37223",109,90,87,0,3,"PREPAL",0
37,"37199",142,108,108,0,0,"PREPAL",0
37,"37238",112,88,85,2,3,"PREPAL",0
37,"37171",411,321,317,1,4,"PREPAL",0
37,"37202",978,773,763,7,10,"PREPAL",2
37,"37060",245,192,192,0,0,"PREPAL",0
37,"37311",226,182,182,2,0,"PREPAL",0
37,"37016",573,451,447,3,4,"PREPAL",0
37,"37196",77,54,53,0,1,"PREPAL",0
37,"37052",274,197,197,2,0,"PREPAL",0
37,"37185",591,450,443,4,7,"PREPAL",0
37,"37352",204,148,147,0,1,"PREPAL",0
37,"37151",146,116,115,2,1,"PREPAL",0
37,"37303",188,152,151,1,1,"PREPAL",0
37,"37288",258,211,210,7,1,"PREPAL",0
37,"37144",370,288,284,2,4,"PREPAL",0
37,"37137",105,73,73,0,0,"PREPAL",1
37,"37228",367,301,299,1,2,"PREPAL",0
37,"37074",153,109,103,4,6,"PREPAL",0
37,"37197",87,55,55,2,0,"PREPAL",1
37,"37380",55,46,46,2,0,"PREPAL",0
37,"37248",152,127,126,2,1,"PREPAL",0
37,"37301",73,62,62,0,0,"PREPAL",0
37,"37018",105,80,80,1,0,"PREPAL",0
37,"37243",102,76,76,0,0,"PREPAL",0
37,"37029",213,155,152,0,3,"PREPAL",0
37,"37289",240,182,182,2,0,"PREPAL",0
37,"37369",140,96,96,0,0,"PREPAL",0
37,"37122",202,158,156,3,2,"PREPAL",0
37,"37131",190,140,139,0,1,"PREPAL",0
37,"37002",144,87,87,0,0,"PREPAL",0
37,"37218",71,33,33,2,0,"PREPAL",0
37,"37206",94,71,71,4,0,"PREPAL",0
37,"37169",176,139,137,0,2,"PREPAL",0
37,"37278",753,573,568,7,5,"PREPAL",0
37,"37253",135,110,110,1,0,"PREPAL",0
37,"37231",259,208,207,4,1,"PREPAL",1
37,"37187",565,431,426,4,5,"PREPAL",1
37,"37334",79,42,42,1,0,"PREPAL",0
37,"37283",120,88,88,1,0,"PREPAL",0
37,"37136",667,453,448,2,5,"PREPAL",3
37,"37086",98,80,80,2,0,"PREPAL",1
37,"37287",318,237,237,3,0,"PREPAL",0
37,"37198",206,161,160,3,1,"PREPAL",0
37,"37181",291,209,207,1,2,"PREPAL",0
37,"37104",27,21,21,0,0,"PREPAL",0
37,"37360",230,167,166,2,1,"PREPAL",0
37,"37178",99,84,81,0,3,"PREPAL",0
37,"37315",93,69,67,1,2,"PREPAL",0
37,"37013",121,87,86,3,1,"PREPAL",0
37,"37262",78,64,64,1,0,"PREPAL",0
37,"37319",117,78,77,0,1,"PREPAL",0
37,"37057",213,168,167,0,1,"PREPAL",0
37,"37353",129,92,92,1,0,"PREPAL",0
37,"37020",430,340,334,3,6,"PREPAL",0
37,"37244",134,91,90,1,1,"PREPAL",0
37,"37079",74,64,63,0,1,"PREPAL",0
37,"37126",30,24,24,0,0,"PREPAL",0
37,"37156",4310,3173,3126,27,47,"PREPAL",3
37,"37102",411,291,289,3,2,"PREPAL",0
37,"37328",189,142,140,0,2,"PREPAL",1
37,"37071",78,73,72,1,1,"PREPAL",1
37,"37351",281,239,238,0,1,"PREPAL",0
37,"37179",215,173,170,0,3,"PREPAL",0
37,"37190",219,167,167,0,0,"PREPAL",0
37,"37044",470,353,341,1,12,"PREPAL",0
37,"37058",61,43,42,0,1,"PREPAL",0
37,"37085",4704,3475,3432,35,43,"PREPAL",3
37,"37245",345,252,246,7,6,"PREPAL",0
37,"37329",36,28,28,0,0,"PREPAL",0
37,"37154",141,116,112,0,4,"PREPAL",0
37,"37108",101,81,79,2,2,"PREPAL",0
37,"37234",357,224,222,1,2,"PREPAL",0
37,"37286",206,156,156,4,0,"PREPAL",0
37,"37022",268,220,219,2,1,"PREPAL",0
37,"37158",248,183,181,0,2,"PREPAL",0
37,"37226",156,121,119,1,2,"PREPAL",0
37,"37330",335,262,258,4,4,"PREPAL",1
37,"37306",271,171,171,0,0,"PREPAL",0
37,"37019",151,114,111,0,3,"PREPAL",0
37,"37055",123,105,98,0,7,"PREPAL",0
37,"37117",1458,1075,1068,14,7,"PREPAL",0
37,"37235",223,168,163,1,5,"PREPAL",0
37,"37166",213,142,142,1,0,"PREPAL",0
37,"37109",182,119,118,0,1,"PREPAL",0
37,"37056",41,30,30,0,0,"PREPAL",0
37,"37147",191,141,136,0,5,"PREPAL",0
37,"37001",195,147,144,0,3,"PREPAL",0
37,"37250",358,223,223,1,0,"PREPAL",0
37,"37342",256,210,208,1,2,"PREPAL",0
37,"37276",149,100,99,0,1,"PREPAL",0
37,"37265",217,180,178,2,2,"PREPAL",0
37,"37229",143,102,102,1,0,"PREPAL",1
37,"37379",173,134,134,2,0,"PREPAL",0
37,"37204",280,214,211,1,3,"PREPAL",0
37,"37189",125,97,97,0,0,"PREPAL",1
37,"37212",111,83,83,1,0,"PREPAL",0
37,"37357",276,216,215,0,1,"PREPAL",0
37,"37193",399,279,278,6,1,"PREPAL",1
37,"37160",627,450,443,7,7,"PREPAL",0
37,"37343",62,49,49,0,0,"PREPAL",0
37,"37025",258,223,221,2,2,"PREPAL",0
37,"37252",116,89,89,0,0,"PREPAL",1
37,"37274",119148,88959,88152,853,807,"PREPAL",113
37,"37354",5182,3955,3915,50,40,"PREPAL",5
37,"37116",69,51,51,0,0,"PREPAL",0
37,"37183",417,305,301,2,4,"PREPAL",0
37,"37285",412,311,305,2,6,"PREPAL",0
37,"37260",154,126,126,1,0,"PREPAL",0
37,"37321",170,131,129,2,2,"PREPAL",0
37,"37149",70,63,63,0,0,"PREPAL",0
37,"37103",446,326,325,4,1,"PREPAL",0
37,"37033",98,63,63,0,0,"PREPAL",0
37,"37124",219,149,148,0,1,"PREPAL",0
37,"37310",180,129,128,2,1,"PREPAL",0
37,"37195",48,35,35,1,0,"PREPAL",0
37,"37161",138,109,107,0,2,"PREPAL",0
37,"37294",11680,8850,8760,84,90,"PREPAL",6
37,"37333",225,143,142,4,1,"PREPAL",0
37,"37261",227,165,161,2,4,"PREPAL",0
37,"37100",81,68,67,1,1,"PREPAL",0
37,"37290",140,116,116,0,0,"PREPAL",0
37,"37034",84,66,66,3,0,"PREPAL",0
37,"37051",80,54,53,0,1,"PREPAL",0
37,"37192",353,245,242,2,3,"PREPAL",0
37,"37012",150,117,115,0,2,"PREPAL",0
37,"37038",789,628,616,5,12,"PREPAL",0
37,"37078",823,670,657,8,13,"PREPAL",0
37,"37063",74,59,59,1,0,"PREPAL",0
37,"37378",111,74,70,2,4,"PREPAL",0
37,"37375",705,593,582,11,11,"PREPAL",2
37,"37251",126,87,87,2,0,"PREPAL",0
37,"37027",228,187,187,0,0,"PREPAL",0
37,"37247",199,162,154,3,8,"PREPAL",0
37,"37338",78,66,66,1,0,"PREPAL",1
37,"37167",173,150,144,2,6,"PREPAL",0
37,"37118",125,96,96,0,0,"PREPAL",1
37,"37307",160,103,103,0,0,"PREPAL",0
37,"37006",135,91,90,1,1,"PREPAL",0
37,"37277",73,55,55,0,0,"PREPAL",0
37,"37028",150,111,110,1,1,"PREPAL",1
37,"37175",407,316,314,5,2,"PREPAL",0
37,"37017",251,186,184,2,2,"PREPAL",0
37,"37221",434,328,323,2,5,"PREPAL",0
37,"37080",232,176,176,1,0,"PREPAL",0
37,"37164",256,200,195,1,5,"PREPAL",0
37,"37256",220,158,157,1,1,"PREPAL",0
37,"37092",1731,1264,1250,11,14,"PREPAL",2
37,"37067",3125,2551,2523,22,28,"PREPAL",4
37,"37358",168,136,135,2,1,"PREPAL",0
37,"37359",184,131,129,0,2,"PREPAL",0
37,"37165",33,27,27,0,0,"PREPAL",0
37,"37062",84,67,66,1,1,"PREPAL",0
37,"37337",139,120,120,2,0,"PREPAL",0
37,"37081",933,720,714,4,6,"PREPAL",1
37,"37381",139,98,92,0,6,"PREPAL",0
37,"37340",150,105,104,1,1,"PREPAL",0
37,"37004",32,22,22,0,0,"PREPAL",0
37,"37279",763,572,562,11,10,"PREPAL",0
37,"37026",192,158,154,2,4,"PREPAL",0
37,"37246",5335,4190,4152,41,38,"PREPAL",5
37,"37264",67,43,43,0,0,"PREPAL",0
37,"37139",205,163,162,2,1,"PREPAL",0
37,"37121",584,434,430,5,4,"PREPAL",0
37,"37097",36,30,30,0,0,"PREPAL",0
37,"37008",4298,3312,3272,16,40,"PREPAL",3
37,"37155",73,54,54,1,0,"PREPAL",2
37,"37211",223,163,163,4,0,"PREPAL",0
37,"37082",799,570,560,1,10,"PREPAL",0
37,"37009",216,161,160,3,1,"PREPAL",0
37,"37327",185,157,157,5,0,"PREPAL",1
37,"37272",136,97,96,0,1,"PREPAL",0
37,"37382",180,133,133,4,0,"PREPAL",0
37,"37273",108,77,77,0,0,"PREPAL",0
37,"37254",183,153,149,0,4,"PREPAL",0
37,"37073",583,449,442,8,7,"PREPAL",0
37,"37098",335,237,237,1,0,"PREPAL",0
37,"37047",167,83,83,0,0,"PREPAL",1
37,"37148",425,304,295,6,9,"PREPAL",0
37,"37032",543,411,410,1,1,"PREPAL",0
37,"37292",103,72,72,1,0,"PREPAL",0
37,"37350",421,324,320,4,4,"PREPAL",1
37,"37304",170,114,109,4,5,"PREPAL",0
37,"37213",87,73,73,0,0,"PREPAL",1
37,"37339",316,257,257,4,0,"PREPAL",1
37,"37157",77,62,62,0,0,"PREPAL",0
37,"37347",477,365,359,3,6,"PREPAL",0
37,"37168",443,319,311,2,8,"PREPAL",0
37,"37127",221,158,158,4,0,"PREPAL",1
37,"37230",221,167,167,2,0,"PREPAL",0
37,"37293",118,84,84,0,0,"PREPAL",0
37,"37145",257,190,187,0,3,"PREPAL",0
37,"37037",119,81,81,0,0,"PREPAL",0
37,"37317",306,246,243,1,3,"PREPAL",0
37,"37271",361,283,276,3,7,"PREPAL",2
37,"37045",27,20,20,0,0,"PREPAL",0
37,"37344",246,184,183,1,1,"PREPAL",1
37,"37054",261,199,198,1,1,"PREPAL",0
37,"37135",1211,932,925,10,7,"PREPAL",2
37,"37242",91,71,71,0,0,"PREPAL",0
37,"37314",87,74,72,0,2,"PREPAL",0
37,"37041",74,48,48,0,0,"PREPAL",0
37,"37132",351,272,269,2,3,"PREPAL",2
37,"37068",366,272,271,5,1,"PREPAL",0
37,"37173",1526,1138,1125,5,13,"PREPAL",1
37,"37203",165,118,118,0,0,"PREPAL",0
37,"37374",1178,971,943,8,28,"PREPAL",0
37,"37215",136,102,101,2,1,"PREPAL",0
37,"37101",163,122,122,2,0,"PREPAL",0
37,"37059",124,100,98,0,2,"PREPAL",0
37,"37269",452,328,328,2,0,"PREPAL",0
37,"37005",77,58,56,0,2,"PREPAL",0
37,"37087",855,681,676,8,5,"PREPAL",0
37,"37091",176,114,113,2,1,"PREPAL",0
37,"37291",268,206,206,1,0,"PREPAL",0
37,"37142",592,453,451,2,2,"PREPAL",1
37,"37240",907,646,636,5,10,"PREPAL",1
37,"37241",172,128,126,1,2,"PREPAL",0
37,"37065",323,237,235,0,2,"PREPAL",0
37,"37233",65,45,45,0,0,"PREPAL",0
37,"37061",226,166,164,1,2,"PREPAL",0
37,"37036",63,46,46,0,0,"PREPAL",0
37,"37049",147,98,98,2,0,"PREPAL",3
37,"37332",69,53,52,0,1,"PREPAL",0
37,"37141",156,127,127,1,0,"PREPAL",1
37,"37255",51,38,38,0,0,"PREPAL",0
37,"37257",53,43,43,0,0,"PREPAL",0
37,"37263",348,252,251,1,1,"PREPAL",0
37,"37207",303,234,233,0,1,"PREPAL",0
37,"37040",393,320,317,3,3,"PREPAL",0
37,"37348",113,91,91,1,0,"PREPAL",0
37,"37355",189,147,146,1,1,"PREPAL",0
37,"37007",439,321,313,4,8,"PREPAL",1
37,"37172",878,580,576,3,4,"PREPAL",2
37,"37099",73,45,45,2,0,"PREPAL",0
37,"37267",199,151,147,2,4,"PREPAL",0
37,"37120",99,77,76,1,1,"PREPAL",0
37,"37345",166,135,133,3,2,"PREPAL",0
37,"37031",365,258,257,1,1,"PREPAL",0
37,"37224",210,183,179,2,4,"PREPAL",0
37,"37015",222,145,143,3,2,"PREPAL",0
37,"37107",10855,7694,7598,96,96,"PREPAL",9
37,"37188",185,127,125,3,2,"PREPAL",0
37,"37138",199,155,154,4,1,"PREPAL",0
37,"37370",337,258,255,3,3,"PREPAL",0
37,"37150",43,35,35,0,0,"PREPAL",0
37,"37356",86,73,71,1,2,"PREPAL",0
37,"37232",390,349,348,0,1,"PREPAL",0
37,"37163",42,33,33,0,0,"PREPAL",0
37,"37299",221,170,163,1,7,"PREPAL",1
37,"37130",173,155,153,5,2,"PREPAL",0
37,"37225",106,94,92,0,2,"PREPAL",0
37,"37237",325,250,248,4,2,"PREPAL",0
37,"37177",298,223,221,1,2,"PREPAL",0
37,"37143",385,301,299,1,2,"PREPAL",0
37,"37331",217,150,148,1,2,"PREPAL",0
37,"37346",267,222,220,1,2,"PREPAL",0
37,"37186",106,78,78,3,0,"PREPAL",0
37,"37088",204,152,152,3,0,"PREPAL",0
37,"37236",139,94,89,0,5,"PREPAL",0
37,"37367",199,160,158,7,2,"PREPAL",0
37,"37309",45,28,28,0,0,"PREPAL",0
37,"37039",304,213,213,4,0,"PREPAL",0
37,"37258",180,117,115,1,2,"PREPAL",0
37,"37194",252,191,190,2,1,"PREPAL",0
37,"37336",55,47,47,0,0,"PREPAL",1
37,"37129",251,199,194,1,5,"PREPAL",0
37,"37176",137,100,98,0,2,"PREPAL",0
37,"37312",262,211,210,3,1,"PREPAL",0
37,"37208",81,49,48,0,1,"PREPAL",0
37,"37280",79,50,50,0,0,"PREPAL",0
37,"37180",73,52,52,1,0,"PREPAL",0
37,"37069",976,713,699,9,14,"PREPAL",2
37,"37030",84,68,66,0,2,"PREPAL",0
37,"37368",16,15,15,0,0,"PREPAL",0
37,"37376",2251,1588,1568,9,20,"PREPAL",0
37,"37365",174,147,144,0,3,"PREPAL",0
37,"37362",4592,3442,3403,48,39,"PREPAL",2
37,"37349",112,83,82,0,1,"PREPAL",2
37,"37113",430,340,340,3,0,"PREPAL",0
37,"37042",42,29,29,2,0,"PREPAL",0
37,"37021",80,62,62,0,0,"PREPAL",0
37,"37174",1065,838,826,3,12,"PREPAL",1
37,"37023",1378,1116,1105,9,11,"PREPAL",3
37,"37322",2472,1691,1676,12,15,"PREPAL",0
37,"37159",91,74,74,0,0,"PREPAL",0
37,"37366",43,27,27,0,0,"PREPAL",0
37,"37115",123,89,87,0,2,"PREPAL",0
37,"37266",84,55,55,1,0,"PREPAL",0
37,"37162",206,151,149,2,2,"PREPAL",0
37,"37361",84,56,55,0,1,"PREPAL",0
37,"37325",91,68,63,0,5,"PREPAL",0
37,"37072",166,133,132,2,1,"PREPAL",0
37,"37035",194,161,161,0,0,"PREPAL",0
37,"37363",120,98,94,0,4,"PREPAL",0
37,"37128",264,211,201,4,10,"PREPAL",0
37,"37371",281,183,177,1,6,"PREPAL",0
41,"41005",9057,6781,6693,58,88,"VOX",3
41,"41071",5620,3974,3898,17,76,"VOX",6
41,"41007",12386,8552,8403,90,149,"VOX",10
41,"41064",5601,3766,3715,42,51,"VOX",2
41,"41049",9301,7147,7070,63,77,"VOX",5
41,"41048",2244,1625,1598,22,27,"VOX",2
41,"41019",4654,3267,3224,34,43,"VOX",9
41,"41086",16102,10743,10665,93,78,"VOX",23
41,"41079",9343,7111,7029,68,82,"VOX",5
41,"41058",17304,12982,12751,133,231,"VOX",48
41,"41062",2235,1805,1790,10,15,"VOX",1
41,"41090",3541,2774,2721,17,53,"VOX",2
41,"41067",7115,5248,5178,46,70,"VOX",6
41,"41023",7919,5852,5788,34,64,"VOX",4
41,"41089",6504,4759,4691,51,68,"VOX",9
41,"41035",1112,887,876,5,11,"VOX",0
41,"41043",636,439,435,3,4,"VOX",0
41,"41022",4300,2918,2891,30,27,"VOX",1
41,"41034",23033,15936,15711,189,225,"VOX",24
41,"41038",99637,71611,71050,727,561,"VOX",187
41,"41044",7392,5562,5526,40,36,"VOX",14
41,"41024",22662,15742,15521,137,221,"VOX",39
41,"41061",2218,1769,1742,5,27,"VOX",3
41,"41052",3006,2264,2209,8,55,"VOX",1
41,"41011",15395,11527,11341,114,186,"VOX",6
41,"41014",2510,1981,1958,8,23,"VOX",0
41,"41060",15279,10611,10447,91,164,"VOX",21
41,"41066",1363,1019,1007,7,12,"VOX",0
41,"41063",2683,1942,1922,21,20,"VOX",5
41,"41069",29070,20827,20558,355,269,"VOX",43
41,"41033",5102,3655,3613,25,42,"VOX",5
41,"41053",21252,16022,15770,121,252,"VOX",33
41,"41051",2170,1650,1611,8,39,"VOX",0
41,"41026",4325,3551,3516,18,35,"VOX",2
41,"41042",5868,4612,4583,37,29,"VOX",2
41,"41036",3971,2846,2806,14,40,"VOX",0
41,"41025",2041,1456,1430,17,26,"VOX",2
41,"41080",1270,954,938,8,16,"VOX",1
41,"41073",1715,1194,1169,9,25,"VOX",2
41,"41091",541928,401177,398212,3487,2965,"VOX",1451
41,"41050",5158,4123,4078,37,45,"VOX",2
41,"41078",2522,1888,1874,5,14,"VOX",0
41,"41027",3941,2766,2709,28,57,"VOX",1
41,"41100",1025,770,751,5,19,"VOX",1
41,"41099",3998,2597,2577,19,20,"VOX",5
41,"41097",3135,2339,2317,19,22,"VOX",0
41,"41037",3203,2473,2449,18,24,"VOX",0
41,"41009",1229,811,803,5,8,"VOX",0
41,"41074",3033,2362,2341,8,21,"VOX",2
41,"41083",1154,893,888,3,5,"VOX",0
41,"41008",1063,820,805,3,15,"VOX",0
41,"41018",9490,6997,6930,45,67,"VOX",4
41,"41096",6166,4811,4752,39,59,"VOX",6
41,"41016",7310,5473,5410,50,63,"VOX",6
41,"41101",5932,4454,4421,27,33,"VOX",3
41,"41092",7749,5715,5647,57,68,"VOX",12
41,"41056",3691,3069,3042,21,27,"VOX",3
41,"41072",4052,3115,3041,18,74,"VOX",2
41,"41082",3432,2809,2781,12,28,"VOX",3
41,"41015",5310,3799,3710,38,89,"VOX",4
41,"41065",22868,15933,15784,172,149,"VOX",16
41,"41006",2740,1909,1897,13,12,"VOX",2
41,"41045",5749,4121,4066,49,55,"VOX",1
41,"41054",688,587,570,2,17,"VOX",1
41,"41081",29164,21631,21410,218,221,"VOX",25
41,"41017",15052,11074,10964,99,110,"VOX",33
41,"41057",275,193,191,0,2,"VOX",0
41,"41029",13423,9979,9880,84,99,"VOX",24
41,"41076",2184,1442,1432,19,10,"VOX",0
41,"41001",1597,1262,1248,5,14,"VOX",0
41,"41093",18487,14687,14594,117,93,"VOX",54
41,"41039",31674,23240,22982,196,258,"VOX",19
41,"41002",1469,1085,1061,12,24,"VOX",1
41,"41020",12872,8820,8723,92,97,"VOX",3
41,"41901",2676,2222,2190,31,32,"VOX",0
41,"41030",516,409,395,2,14,"VOX",0
41,"41102",14635,10904,10655,148,249,"VOX",28
41,"41055",15009,10393,10292,82,101,"VOX",14
41,"41012",3286,2268,2235,15,33,"VOX",4
41,"41068",13948,10269,10150,75,119,"VOX",19
41,"41046",3017,2416,2381,12,35,"VOX",4
41,"41021",21249,15031,14854,152,177,"VOX",19
41,"41094",6288,4726,4653,36,73,"VOX",7
41,"41902",4675,3051,3019,20,32,"VOX",3
41,"41040",10411,7959,7892,53,67,"VOX",28
41,"41098",4952,3762,3704,24,58,"VOX",4
41,"41084",2850,2205,2157,15,48,"VOX",0
41,"41077",8728,6423,6308,28,115,"VOX",25
41,"41041",9743,7620,7482,39,138,"VOX",17
41,"41059",33977,26158,25965,230,193,"VOX",89
41,"41087",10202,7160,7033,51,127,"VOX",14
41,"41003",2319,1782,1754,8,28,"VOX",6
41,"41031",1257,838,836,8,2,"VOX",0
41,"41095",41137,28987,28731,302,256,"VOX",40
41,"41028",1971,1574,1562,11,12,"VOX",14
41,"41075",10225,7387,7283,55,104,"VOX",12
41,"41010",4394,3203,3160,19,43,"VOX",8
41,"41047",10086,7758,7663,80,95,"VOX",27
41,"41013",4842,3491,3461,22,30,"VOX",1
41,"41085",4086,3223,3178,31,45,"VOX",3
41,"41070",6021,4504,4456,44,48,"VOX",9
41,"41004",56552,40018,39623,515,395,"VOX",91
41,"41903",6747,4926,4854,43,72,"VOX",1
41,"41032",4019,2943,2875,17,68,"VOX",3
41,"41088",518,381,377,0,4,"VOX",0
38,"38031",28697,21546,21202,140,344,"CCa-PNC",1640
38,"38052",1281,853,844,2,9,"CCa-PNC",110
38,"38021",1643,1014,1002,5,12,"CCa-PNC",224
38,"38036",6553,4604,4529,45,75,"CCa-PNC",862
38,"38011",20435,13760,13627,82,133,"CCa-PNC",1415
38,"38022",18468,12230,12085,86,145,"CCa-PNC",1981
38,"38038",162030,105122,104174,667,948,"CCa-PNC",10359
38,"38019",13217,8168,8075,54,93,"CCa-PNC",996
38,"38009",4127,2842,2793,15,49,"CCa-PNC",363
38,"38046",9107,6755,6682,45,73,"CCa-PNC",822
38,"38013",2915,1865,1847,12,18,"CCa-PNC",438
38,"38044",2206,1317,1303,10,14,"CCa-PNC",222
38,"38012",2378,1620,1606,6,14,"CCa-PNC",246
38,"38030",1923,1309,1300,5,9,"CCa-PNC",250
38,"38003",1440,970,960,2,10,"CCa-PNC",104
38,"38014",1351,935,929,3,6,"CCa-PNC",167
38,"38027",5386,3685,3615,29,70,"CCa-PNC",615
38,"38023",121610,81337,80453,527,884,"CCa-PNC",10772
38,"38018",4405,3053,3005,21,48,"CCa-PNC",580
38,"38010",4014,2726,2678,15,48,"CCa-PNC",174
38,"38051",7217,5147,5089,31,58,"CCa-PNC",944
38,"38032",13257,8969,8902,72,67,"CCa-PNC",687
38,"38008",5513,3683,3609,17,74,"CCa-PNC",557
38,"38035",9299,5558,5500,35,58,"CCa-PNC",812
38,"38039",10584,7532,7462,77,70,"CCa-PNC",1189
38,"38015",4158,2864,2818,12,46,"CCa-PNC",774
38,"38041",6808,4869,4835,42,34,"CCa-PNC",1230
38,"38001",20166,11307,11195,55,112,"CCa-PNC",708
38,"38043",18918,12883,12737,109,146,"CCa-PNC",1439
38,"38002",942,701,674,14,27,"CCa-PNC",142
38,"38024",15055,9612,9485,77,127,"CCa-PNC",1163
38,"38049",2653,1683,1658,8,25,"CCa-PNC",415
38,"38048",3878,2664,2624,20,40,"CCa-PNC",649
38,"38006",39553,21159,20940,124,219,"CCa-PNC",1672
38,"38020",15021,9813,9693,51,120,"CCa-PNC",1151
38,"38047",1789,1228,1208,5,20,"CCa-PNC",211
38,"38040",4990,3061,3031,16,30,"CCa-PNC",428
38,"38034",4041,2853,2814,17,39,"CCa-PNC",508
38,"38004",4442,2980,2939,20,41,"CCa-PNC",374
38,"38017",28037,16236,16076,100,160,"CCa-PNC",1954
38,"38029",1533,776,763,7,13,"CCa-PNC",36
38,"38042",3784,2692,2673,16,19,"CCa-PNC",240
38,"38045",3987,2152,2132,23,20,"CCa-PNC",371
38,"38901",1387,883,876,4,7,"CCa-PNC",237
38,"38050",2471,1616,1590,8,26,"CCa-PNC",459
38,"38005",5463,3443,3417,24,26,"CCa-PNC",498
38,"38037",12997,8126,7997,46,129,"CCa-PNC",657
38,"38016",1215,654,641,4,13,"CCa-PNC",80
38,"38028",22063,15095,14954,89,141,"CCa-PNC",1230
38,"38026",32918,24984,24727,174,257,"CCa-PNC",5587
38,"38007",1689,1143,1119,3,24,"CCa-PNC",108
38,"38053",3754,2419,2370,15,49,"CCa-PNC",364
38,"38025",6860,4836,4761,49,75,"CCa-PNC",431
38,"38033",3721,2552,2504,15,48,"CCa-PNC",350
40,"40062",60,50,49,0,1,"PP",22
40,"40223",226,173,169,0,4,"PP",71
40,"40070",147,111,107,1,4,"PP",49
40,"40131",48,45,44,0,1,"PP",15
40,"40004",472,371,368,2,3,"PP",168
40,"40125",90,67,63,0,4,"PP",30
40,"40092",119,89,89,0,0,"PP",57
40,"40016",57,47,45,0,2,"PP",25
40,"40905",133,96,95,0,1,"PP",69
40,"40086",698,591,580,11,11,"PP",232
40,"40195",910,709,702,13,7,"PP",355
40,"40127",33,22,20,1,2,"PP",14
40,"40213",89,71,71,1,0,"PP",32
40,"40088",292,219,218,0,1,"PP",120
40,"40021",27,26,26,0,0,"PP",16
40,"40141",856,626,616,7,10,"PP",295
40,"40123",148,122,113,3,9,"PP",40
40,"40121",286,230,225,3,5,"PP",120
40,"40215",89,66,66,0,0,"PP",41
40,"40193",230,171,168,5,3,"PP",66
40,"40111",61,51,51,0,0,"PP",30
40,"40048",38,30,30,0,0,"PP",18
40,"40177",153,121,120,3,1,"PP",63
40,"40044",144,116,115,6,1,"PP",58
40,"40206",178,141,135,0,6,"PP",62
40,"40221",49,42,41,0,1,"PP",14
40,"40231",108,93,93,1,0,"PP",48
40,"40134",729,587,573,8,14,"PP",215
40,"40118",52,39,38,2,1,"PP",18
40,"40143",88,76,75,1,1,"PP",40
40,"40045",112,89,88,1,1,"PP",38
40,"40073",405,345,339,4,6,"PP",176
40,"40216",755,628,621,7,7,"PP",213
40,"40184",253,210,210,3,0,"PP",126
40,"40103",157,128,128,0,0,"PP",41
40,"40173",139,115,110,1,5,"PP",37
40,"40172",44,29,29,0,0,"PP",18
40,"40082",115,90,88,4,2,"PP",53
40,"40008",46,38,38,0,0,"PP",25
40,"40087",93,70,70,2,0,"PP",49
40,"40155",3480,2762,2723,29,39,"PP",734
40,"40089",218,163,159,0,4,"PP",93
40,"40036",519,424,411,9,13,"PP",229
40,"40188",95,70,70,1,0,"PP",33
40,"40047",31,24,24,0,0,"PP",12
40,"40183",130,113,112,1,1,"PP",99
40,"40065",496,389,381,8,8,"PP",183
40,"40052",81,62,62,0,0,"PP",28
40,"40099",60,50,48,1,2,"PP",26
40,"40198",24,19,19,0,0,"PP",13
40,"40224",24,18,18,0,0,"PP",12
40,"40211",75,63,63,1,0,"PP",26
40,"40138",2174,1739,1710,13,29,"PP",696
40,"40006",21,17,17,0,0,"PP",7
40,"40145",1111,917,903,8,14,"PP",376
40,"40179",631,533,525,3,8,"PP",231
40,"40189",513,403,391,3,12,"PP",131
40,"40165",80,62,60,1,2,"PP",24
40,"40129",179,143,138,2,5,"PP",90
40,"40225",1134,907,890,8,17,"PP",421
40,"40013",65,51,50,0,1,"PP",36
40,"40057",1488,1240,1228,14,12,"PP",430
40,"40152",763,637,627,1,10,"PP",198
40,"40007",77,62,62,0,0,"PP",44
40,"40077",805,633,625,6,8,"PP",176
40,"40091",116,89,89,0,0,"PP",41
40,"40058",331,273,270,1,3,"PP",170
40,"40202",63,41,41,0,0,"PP",30
40,"40019",37,32,31,0,1,"PP",14
40,"40031",515,417,413,2,4,"PP",120
40,"40054",112,83,83,0,0,"PP",36
40,"40158",18,12,12,0,0,"PP",7
40,"40149",528,401,390,7,11,"PP",205
40,"40068",24,22,22,0,0,"PP",15
40,"40078",161,129,128,2,1,"PP",52
40,"40074",266,226,223,2,3,"PP",111
40,"40046",90,69,69,0,0,"PP",22
40,"40122",514,416,403,0,13,"PP",145
40,"40222",174,147,147,0,0,"PP",59
40,"40126",85,65,63,0,2,"PP",44
40,"40904",353,307,307,2,0,"PP",144
40,"40166",260,224,222,2,2,"PP",136
40,"40205",266,194,192,2,2,"PP",95
40,"40150",71,61,61,0,0,"PP",30
40,"40051",45,33,33,0,0,"PP",18
40,"40119",170,142,140,0,2,"PP",68
40,"40029",32,28,27,1,1,"PP",12
40,"40079",234,182,181,1,1,"PP",82
40,"40146",255,211,209,0,2,"PP",98
40,"40230",94,75,72,2,3,"PP",22
40,"40132",66,32,30,1,2,"PP",21
40,"40108",116,80,79,2,1,"PP",35
40,"40083",77,54,53,1,1,"PP",40
40,"40901",377,307,300,1,7,"PP",95
40,"40136",114,84,81,3,3,"PP",32
40,"40220",66,50,45,2,5,"PP",20
40,"40015",30,21,21,1,0,"PP",16
40,"40171",33,24,24,0,0,"PP",17
40,"40034",81,62,62,0,0,"PP",26
40,"40105",48,43,43,1,0,"PP",19
40,"40030",476,394,389,8,5,"PP",136
40,"40139",281,218,216,1,2,"PP",92
40,"40212",30,21,19,0,2,"PP",9
40,"40020",168,130,129,2,1,"PP",44
40,"40061",70,55,54,0,1,"PP",31
40,"40069",84,67,67,0,0,"PP",47
40,"40185",882,657,644,9,13,"PP",349
40,"40024",872,676,660,9,16,"PP",334
40,"40115",104,80,79,0,1,"PP",42
40,"40130",130,108,107,1,1,"PP",64
40,"40144",19,15,15,0,0,"PP",9
40,"40135",289,242,237,1,5,"PP",119
40,"40035",140,109,108,3,1,"PP",38
40,"40162",396,305,299,0,6,"PP",174
40,"40903",91,68,68,1,0,"PP",46
40,"40154",21,13,13,0,0,"PP",7
40,"40228",507,401,396,0,5,"PP",216
40,"40192",157,130,128,1,2,"PP",61
40,"40233",419,340,336,2,4,"PP",127
40,"40124",244,190,185,6,5,"PP",75
40,"40159",141,104,104,0,0,"PP",53
40,"40059",112,96,96,2,0,"PP",52
40,"40018",90,70,68,0,2,"PP",35
40,"40170",1315,1037,1026,9,11,"PP",530
40,"40005",31,26,26,0,0,"PP",20
40,"40093",77,67,67,5,0,"PP",28
40,"40037",43,28,27,0,1,"PP",16
40,"40128",132,97,95,4,2,"PP",42
40,"40001",715,588,580,4,8,"PP",276
40,"40009",50,41,41,0,0,"PP",24
40,"40012",271,205,202,3,3,"PP",95
40,"40075",163,130,130,0,0,"PP",59
40,"40203",895,722,716,6,6,"PP",220
40,"40164",180,139,137,0,2,"PP",99
40,"40033",59,48,48,4,0,"PP",15
40,"40100",275,224,214,2,10,"PP",123
40,"40120",192,167,166,1,1,"PP",63
40,"40161",34,28,28,0,0,"PP",18
40,"40110",349,272,272,1,0,"PP",110
40,"40072",200,167,163,3,4,"PP",42
40,"40039",213,167,165,2,2,"PP",90
40,"40084",61,49,49,2,0,"PP",24
40,"40208",768,606,596,5,10,"PP",299
40,"40218",97,69,69,0,0,"PP",46
40,"40181",4258,3391,3329,23,62,"PP",882
40,"40097",124,105,105,0,0,"PP",29
40,"40902",125,102,102,0,0,"PP",75
40,"40906",1973,1645,1627,16,18,"PP",482
40,"40106",214,175,174,1,1,"PP",80
40,"40049",62,45,45,0,0,"PP",29
40,"40095",475,376,370,7,6,"PP",247
40,"40163",55,39,38,1,1,"PP",29
40,"40210",100,74,74,0,0,"PP",35
40,"40040",2626,1847,1835,19,12,"PP",866
40,"40200",41,31,31,0,0,"PP",12
40,"40156",330,239,234,2,5,"PP",114
40,"40043",1825,1455,1429,16,26,"PP",715
40,"40196",34,26,26,1,0,"PP",19
40,"40076",6550,5029,4942,29,87,"PP",1783
40,"40113",428,345,341,5,4,"PP",85
40,"40204",167,127,126,2,1,"PP",65
40,"40219",590,448,437,6,11,"PP",279
40,"40107",104,83,81,1,2,"PP",53
40,"40201",49,41,41,0,0,"PP",30
40,"40190",51,46,45,0,1,"PP",18
40,"40101",874,672,669,11,3,"PP",159
40,"40214",210,174,172,2,2,"PP",85
40,"40056",34,27,27,1,0,"PP",20
40,"40080",61,49,49,0,0,"PP",28
40,"40060",81,59,59,0,0,"PP",50
40,"40199",106,83,83,0,0,"PP",29
40,"40174",361,252,250,0,2,"PP",152
40,"40053",88,64,64,3,0,"PP",23
40,"40010",124,95,94,2,1,"PP",63
40,"40142",53,43,43,0,0,"PP",22
40,"40081",126,94,90,1,4,"PP",47
40,"40180",299,244,239,2,5,"PP",130
40,"40063",7132,5389,5297,56,92,"PP",2055
40,"40041",987,791,777,18,14,"PP",328
40,"40176",402,319,317,3,2,"PP",126
40,"40002",37,33,33,1,0,"PP",15
40,"40026",113,106,106,0,0,"PP",29
40,"40148",240,201,200,1,1,"PP",92
40,"40017",92,77,76,1,1,"PP",33
40,"40112",2525,2054,2034,18,20,"PP",702
40,"40207",753,612,607,2,5,"PP",157
40,"40182",184,139,136,1,3,"PP",64
40,"40094",372,283,277,1,6,"PP",134
40,"40168",34,27,27,0,0,"PP",9
40,"40140",97,72,71,8,1,"PP",34
40,"40191",222,163,161,2,2,"PP",88
40,"40025",142,119,117,0,2,"PP",75
40,"40178",103,70,68,0,2,"PP",50
40,"40234",407,326,322,3,4,"PP",133
40,"40151",44,35,35,0,0,"PP",20
40,"40071",46,42,39,0,3,"PP",17
40,"40160",105,76,74,2,2,"PP",53
40,"40109",75,49,46,1,3,"PP",32
40,"40014",58,46,45,0,1,"PP",23
40,"40032",394,302,300,6,2,"PP",130
40,"40104",258,193,192,1,1,"PP",64
40,"40194",39796,30886,30516,287,370,"PP",10669
40,"40157",50,43,43,0,0,"PP",19
40,"40003",143,109,104,1,5,"PP",78
40,"40055",36,25,23,0,2,"PP",10
40,"40028",103,90,89,2,1,"PP",47
40,"40186",41,32,32,0,0,"PP",20
40,"40229",38,28,28,0,0,"PP",12
40,"40022",207,162,160,3,2,"PP",55
45,"45120",134,105,105,1,0,"VOX",1
45,"45183",2253,1581,1569,8,12,"VOX",12
45,"45063",428,320,310,2,10,"VOX",1
45,"45061",2457,1718,1699,7,19,"VOX",2
45,"45062",1121,910,894,10,16,"VOX",5
45,"45172",719,559,556,2,3,"VOX",0
45,"45001",1852,1395,1355,9,40,"VOX",4
45,"45146",108,85,85,0,0,"VOX",0
45,"45034",1360,1098,1083,4,15,"VOX",0
45,"45179",546,406,403,3,3,"VOX",1
45,"45023",2160,1669,1654,9,15,"VOX",3
45,"45018",495,352,348,0,4,"VOX",2
45,"45135",4302,3509,3453,21,56,"VOX",14
45,"45025",1198,921,910,2,11,"VOX",0
45,"45029",205,169,169,0,0,"VOX",0
45,"45170",235,183,176,4,7,"VOX",0
45,"45137",1623,1106,1093,9,13,"VOX",3
45,"45133",2818,2184,2146,19,38,"VOX",7
45,"45098",2186,1686,1649,10,37,"VOX",5
45,"45143",1180,924,912,3,12,"VOX",1
45,"45041",3725,2698,2665,18,33,"VOX",4
45,"45184",201,124,123,1,1,"VOX",0
45,"45104",440,345,341,1,4,"VOX",1
45,"45040",1396,871,862,4,9,"VOX",2
45,"45024",1075,828,824,5,4,"VOX",0
45,"45115",2563,2089,2048,5,41,"VOX",17
45,"45114",595,461,457,1,4,"VOX",1
45,"45005",241,207,205,2,2,"VOX",0
45,"45026",225,171,169,1,2,"VOX",0
45,"45067",2324,1871,1841,13,30,"VOX",4
45,"45011",288,246,241,1,5,"VOX",1
45,"45112",1939,1302,1268,6,34,"VOX",3
45,"45100",197,166,164,2,2,"VOX",2
45,"45047",2563,1775,1751,13,24,"VOX",13
45,"45190",483,397,387,2,10,"VOX",1
45,"45169",193,136,136,1,0,"VOX",0
45,"45002",2549,1810,1784,7,26,"VOX",3
45,"45181",2313,1755,1728,12,27,"VOX",2
45,"45173",9477,7145,7061,40,84,"VOX",25
45,"45151",586,444,437,1,7,"VOX",0
45,"45028",3680,2919,2880,23,39,"VOX",7
45,"45116",694,531,523,2,8,"VOX",3
45,"45107",3238,2628,2597,15,31,"VOX",14
45,"45032",436,317,313,0,4,"VOX",1
45,"45060",179,131,129,1,2,"VOX",0
45,"45056",2210,1384,1370,11,14,"VOX",2
45,"45068",173,138,135,0,3,"VOX",1
45,"45191",549,477,475,0,2,"VOX",0
45,"45043",793,663,655,1,8,"VOX",1
45,"45182",1045,854,844,3,10,"VOX",3
45,"45006",1425,1022,1013,4,9,"VOX",3
45,"45174",309,247,247,1,0,"VOX",0
45,"45122",5164,4112,4067,18,45,"VOX",16
45,"45103",397,325,322,0,3,"VOX",0
45,"45013",1786,1428,1412,7,16,"VOX",2
45,"45171",1382,1090,1075,4,15,"VOX",10
45,"45033",351,253,247,3,6,"VOX",0
45,"45027",362,275,270,0,5,"VOX",0
45,"45138",1110,903,887,6,16,"VOX",3
45,"45020",1313,1062,1046,5,16,"VOX",8
45,"45175",665,541,532,5,9,"VOX",0
45,"45066",7589,5716,5637,30,79,"VOX",15
45,"45102",3629,2685,2644,15,41,"VOX",5
45,"45070",1461,1223,1202,7,21,"VOX",2
45,"45193",626,543,530,2,13,"VOX",2
45,"45155",371,297,296,1,1,"VOX",1
45,"45065",276,227,223,0,4,"VOX",0
45,"45142",7858,6249,6164,57,85,"VOX",19
45,"45037",1635,1216,1202,4,14,"VOX",6
45,"45130",319,258,252,1,6,"VOX",1
45,"45036",658,500,496,2,4,"VOX",6
45,"45152",597,476,476,2,0,"VOX",1
45,"45010",436,335,333,2,2,"VOX",0
45,"45148",307,229,219,1,10,"VOX",0
45,"45071",1863,1550,1530,8,20,"VOX",3
45,"45022",392,297,293,8,4,"VOX",2
45,"45075",146,108,105,0,3,"VOX",0
45,"45084",2280,1777,1747,12,30,"VOX",1
45,"45080",6,6,6,0,0,"VOX",0
45,"45082",1246,1046,1036,9,10,"VOX",2
45,"45139",172,135,133,0,2,"VOX",0
45,"45072",670,499,499,2,0,"VOX",1
45,"45136",5859,4249,4177,24,72,"VOX",41
45,"45185",7734,6057,5973,27,84,"VOX",17
45,"45105",405,284,279,3,5,"VOX",4
45,"45109",2913,2295,2218,16,77,"VOX",6
45,"45157",2125,1531,1509,14,22,"VOX",8
45,"45035",298,225,221,2,4,"VOX",0
45,"45158",2534,1885,1868,8,17,"VOX",2
45,"45195",2161,1709,1686,12,23,"VOX",4
45,"45134",1600,1214,1200,4,14,"VOX",2
45,"45085",1501,1086,1067,6,19,"VOX",2
45,"45150",454,366,364,1,2,"VOX",0
45,"45097",1047,877,869,3,8,"VOX",1
45,"45049",435,330,326,0,4,"VOX",1
45,"45188",2783,2161,2127,9,34,"VOX",4
45,"45073",307,238,235,0,3,"VOX",1
45,"45045",1316,945,935,1,10,"VOX",0
45,"45192",2503,2164,2141,7,23,"VOX",3
45,"45110",1799,1394,1380,4,14,"VOX",1
45,"45050",471,354,351,2,3,"VOX",1
45,"45196",1388,1066,1054,13,12,"VOX",2
45,"45106",7524,5882,5784,55,98,"VOX",27
45,"45046",2421,1815,1796,8,19,"VOX",0
45,"45099",3512,2514,2459,9,55,"VOX",6
45,"45147",581,475,469,4,6,"VOX",1
45,"45086",503,375,369,3,6,"VOX",0
45,"45074",412,327,322,0,5,"VOX",0
45,"45176",3665,2747,2712,15,35,"VOX",8
45,"45140",1093,885,876,4,9,"VOX",0
45,"45009",545,336,333,1,3,"VOX",1
45,"45156",3441,2863,2825,13,38,"VOX",10
45,"45124",2156,1750,1712,16,38,"VOX",3
45,"45108",521,415,414,2,1,"VOX",0
45,"45160",1111,908,895,6,13,"VOX",4
45,"45198",1832,1521,1508,6,13,"VOX",3
45,"45083",465,393,388,5,5,"VOX",6
45,"45051",1594,1264,1248,6,16,"VOX",2
45,"45014",3984,2824,2802,24,22,"VOX",1
45,"45038",3335,2525,2490,8,35,"VOX",20
45,"45161",13474,9618,9496,63,122,"VOX",44
45,"45064",3839,2915,2884,19,31,"VOX",12
45,"45149",573,486,484,0,2,"VOX",4
45,"45019",7356,5539,5484,35,55,"VOX",21
45,"45125",2329,1920,1898,10,22,"VOX",6
45,"45076",574,382,378,1,4,"VOX",0
45,"45052",2914,2389,2372,23,17,"VOX",11
45,"45199",2963,2055,2027,5,28,"VOX",18
45,"45101",3761,3090,3048,15,42,"VOX",13
45,"45015",622,461,455,2,6,"VOX",2
45,"45039",226,197,193,1,4,"VOX",0
45,"45162",683,515,510,0,5,"VOX",0
45,"45003",572,431,423,1,8,"VOX",2
45,"45089",1516,1157,1139,6,18,"VOX",1
45,"45187",4078,3405,3353,14,52,"VOX",4
45,"45200",4627,3678,3588,29,90,"VOX",8
45,"45053",8045,6446,6370,44,76,"VOX",16
45,"45077",542,428,423,0,5,"VOX",0
45,"45012",670,521,506,4,15,"VOX",2
45,"45078",1392,1187,1179,8,8,"VOX",2
45,"45126",260,169,167,1,2,"VOX",0
45,"45004",568,436,430,1,6,"VOX",4
45,"45159",86,75,72,1,3,"VOX",0
45,"45016",4179,3290,3268,30,22,"VOX",17
45,"45163",8338,6270,6142,57,128,"VOX",15
45,"45054",3995,2997,2968,8,29,"VOX",0
45,"45201",3450,2212,2173,14,39,"VOX",14
45,"45017",262,221,219,0,2,"VOX",0
45,"45111",60,47,47,0,0,"VOX",0
45,"45123",3075,2261,2222,11,39,"VOX",2
45,"45087",8345,6184,6091,34,93,"VOX",21
45,"45197",1921,1500,1480,12,20,"VOX",3
45,"45164",186,160,160,0,0,"VOX",0
45,"45042",190,145,145,0,0,"VOX",0
45,"45055",1032,857,841,2,16,"VOX",6
45,"45202",3905,2962,2920,12,42,"VOX",16
45,"45186",3083,2369,2341,14,28,"VOX",3
45,"45079",367,285,285,3,0,"VOX",1
45,"45165",62857,46607,46141,313,466,"VOX",194
45,"45088",2102,1438,1423,4,15,"VOX",6
45,"45177",2142,1757,1731,11,26,"VOX",5
45,"45128",2498,1794,1774,7,20,"VOX",5
45,"45030",482,364,361,4,3,"VOX",1
45,"45113",1948,1409,1386,14,23,"VOX",3
45,"45153",1613,1263,1248,11,15,"VOX",1
45,"45117",754,610,602,2,8,"VOX",1
45,"45141",897,735,727,4,8,"VOX",0
45,"45203",2574,1938,1908,10,30,"VOX",2
45,"45129",136,100,97,0,3,"VOX",0
45,"45166",1629,1345,1332,5,13,"VOX",0
45,"45031",2723,1935,1896,10,39,"VOX",2
45,"45069",1876,1446,1428,8,18,"VOX",10
45,"45057",221,187,182,0,5,"VOX",1
45,"45154",1483,1114,1107,5,7,"VOX",8
45,"45093",151,117,117,0,0,"VOX",0
45,"45007",697,566,560,1,6,"VOX",1
45,"45081",17646,13309,13166,72,143,"VOX",72
45,"45118",2002,1470,1456,3,14,"VOX",4
45,"45204",643,519,513,0,6,"VOX",2
45,"45167",1458,1197,1187,5,10,"VOX",5
45,"45180",2725,2060,2028,7,32,"VOX",3
45,"45094",395,312,308,0,4,"VOX",0
45,"45090",376,299,295,4,4,"VOX",0
45,"45119",3348,2306,2264,14,42,"VOX",2
45,"45008",142,114,114,2,0,"VOX",0
45,"45058",384,304,301,4,3,"VOX",0
45,"45021",2459,1862,1833,21,29,"VOX",6
45,"45131",287,242,242,0,0,"VOX",0
45,"45091",407,301,299,2,2,"VOX",0
45,"45189",597,467,458,2,9,"VOX",0
45,"45127",708,524,519,1,5,"VOX",2
45,"45132",2096,1631,1616,7,15,"VOX",3
45,"45205",6745,4708,4657,35,51,"VOX",10
45,"45144",794,643,640,2,3,"VOX",4
45,"45059",1723,1413,1388,4,25,"VOX",4
45,"45095",697,529,520,1,9,"VOX",1
45,"45194",67,50,49,0,1,"VOX",0
45,"45168",62226,48889,48446,327,443,"VOX",336
45,"45901",769,577,571,1,6,"VOX",3
45,"45092",233,197,194,0,3,"VOX",0
45,"45096",1015,832,817,7,15,"VOX",5
45,"45145",2539,1830,1811,11,19,"VOX",14
45,"45048",360,281,277,1,4,"VOX",1
45,"45121",6766,4860,4798,30,62,"VOX",43
1,"1001",1984,1426,1405,8,21,"IU-UPeC",47
1,"1901",2344,1688,1669,17,19,"IU-UPeC",72
1,"1032",522,368,361,0,7,"IU-UPeC",10
1,"1052",244,188,186,1,2,"IU-UPeC",3
1,"1014",372,292,284,1,8,"IU-UPeC",15
1,"1042",901,653,650,11,3,"IU-UPeC",7
1,"1047",964,713,702,13,11,"IU-UPeC",17
1,"1054",952,694,688,4,6,"IU-UPeC",9
1,"1036",15034,10733,10619,73,114,"IU-UPeC",298
1,"1059",186354,135873,134633,948,1240,"IU-UPeC",5550
1,"1030",159,126,123,1,3,"IU-UPeC",3
1,"1011",237,177,175,7,2,"IU-UPeC",1
1,"1006",176,142,141,1,1,"IU-UPeC",4
1,"1055",836,564,552,8,12,"IU-UPeC",11
1,"1063",1799,1320,1309,10,11,"IU-UPeC",29
1,"1020",326,232,228,0,4,"IU-UPeC",5
1,"1004",1405,1026,1010,7,16,"IU-UPeC",20
1,"1060",199,162,159,0,3,"IU-UPeC",5
1,"1057",245,203,202,0,1,"IU-UPeC",2
1,"1009",1281,908,898,2,10,"IU-UPeC",23
1,"1037",586,425,419,2,6,"IU-UPeC",6
1,"1043",2318,1644,1624,8,20,"IU-UPeC",64
1,"1018",1370,964,963,4,1,"IU-UPeC",27
1,"1051",3606,2413,2389,21,24,"IU-UPeC",65
1,"1039",202,161,156,0,5,"IU-UPeC",6
1,"1027",416,268,268,0,0,"IU-UPeC",12
1,"1041",153,105,100,1,5,"IU-UPeC",2
1,"1033",649,512,508,5,4,"IU-UPeC",14
1,"1023",269,197,195,2,2,"IU-UPeC",10
1,"1013",711,486,483,3,3,"IU-UPeC",10
1,"1022",805,593,587,3,6,"IU-UPeC",44
1,"1049",140,108,108,0,0,"IU-UPeC",2
1,"1021",460,336,332,1,4,"IU-UPeC",8
1,"1019",144,112,111,2,1,"IU-UPeC",1
1,"1002",8139,5961,5878,32,83,"IU-UPeC",161
1,"1003",1186,842,833,19,9,"IU-UPeC",15
1,"1008",790,548,542,13,6,"IU-UPeC",14
1,"1058",1327,843,833,8,10,"IU-UPeC",19
1,"1017",869,584,577,4,7,"IU-UPeC",8
1,"1031",1183,907,885,6,22,"IU-UPeC",21
1,"1046",594,445,435,3,10,"IU-UPeC",16
1,"1902",738,537,528,4,9,"IU-UPeC",23
1,"1010",2275,1729,1717,17,12,"IU-UPeC",36
1,"1034",165,120,119,1,1,"IU-UPeC",1
1,"1016",439,255,249,3,6,"IU-UPeC",6
1,"1028",1077,759,753,6,6,"IU-UPeC",52
1,"1061",153,132,132,2,0,"IU-UPeC",1
1,"1056",218,141,140,1,1,"IU-UPeC",1
1,"1053",587,367,365,3,2,"IU-UPeC",7
1,"1044",236,189,187,1,2,"IU-UPeC",4
1,"1062",314,215,215,3,0,"IU-UPeC",7
36,"36003",9979,7496,7401,81,95,"PP",2921
36,"36015",4205,2941,2885,32,56,"PP",1153
36,"36016",1173,724,716,7,8,"PP",501
36,"36032",3655,2745,2699,21,46,"PP",1198
36,"36029",16129,12262,12078,101,184,"PP",3590
36,"36043",4736,3347,3297,22,50,"PP",1335
36,"36027",4452,3328,3274,23,54,"PP",1671
36,"36051",14272,10230,10072,95,158,"PP",4267
36,"36017",17866,13133,12910,137,223,"PP",5712
36,"36005",8120,5839,5747,64,92,"PP",2161
36,"36055",13643,10361,10145,106,216,"PP",4018
36,"36053",5693,4321,4265,41,56,"PP",1557
36,"36007",1689,1168,1148,12,20,"PP",551
36,"36028",4139,3094,3045,22,49,"PP",1434
36,"36044",2556,1786,1747,13,39,"PP",699
36,"36001",2593,1968,1952,6,16,"PP",976
36,"36038",66390,49943,49439,522,504,"PP",16266
36,"36046",4055,3189,3139,30,50,"PP",1278
36,"36008",21736,16270,16094,160,176,"PP",4525
36,"36021",12033,9035,8879,99,156,"PP",2993
36,"36045",24570,18613,18365,184,248,"PP",5280
36,"36050",7562,5567,5457,44,110,"PP",1766
36,"36030",4220,3041,2994,32,47,"PP",1172
36,"36041",13428,9842,9710,96,132,"PP",3838
36,"36002",3151,2290,2255,19,35,"PP",1033
36,"36042",17922,12993,12760,116,233,"PP",3979
36,"36033",12347,9515,9336,76,179,"PP",3124
36,"36059",4937,3379,3318,46,61,"PP",1766
36,"36039",15350,11581,11349,119,232,"PP",3840
36,"36054",10996,8116,7965,84,151,"PP",2926
36,"36019",1625,1127,1119,12,8,"PP",359
36,"36006",11537,8885,8740,79,145,"PP",3790
36,"36011",1842,1185,1169,9,16,"PP",680
36,"36056",5108,3856,3783,34,73,"PP",1838
36,"36048",5348,3970,3892,44,78,"PP",1423
36,"36052",7298,5298,5175,37,123,"PP",2305
36,"36010",2862,2195,2177,18,18,"PP",700
36,"36022",9056,6635,6514,48,121,"PP",1781
36,"36031",558,464,454,9,10,"PP",191
36,"36047",2492,1719,1704,16,15,"PP",890
36,"36036",2511,1923,1892,17,31,"PP",762
36,"36057",236957,177555,175758,1730,1797,"PP",48673
36,"36023",8420,6287,6180,55,107,"PP",2297
36,"36024",16433,12239,12016,115,223,"PP",6301
36,"36035",14430,10832,10680,86,152,"PP",3863
36,"36004",10178,7351,7224,69,127,"PP",2650
36,"36025",2292,1396,1389,9,7,"PP",778
36,"36061",8651,6594,6445,58,149,"PP",3287
36,"36009",4908,3167,3114,25,53,"PP",1570
36,"36049",6761,5193,5069,54,124,"PP",1887
36,"36013",2412,1602,1586,12,16,"PP",856
36,"36040",2600,1907,1869,13,38,"PP",825
36,"36020",2351,1748,1721,20,27,"PP",1023
36,"36037",2607,1862,1838,16,24,"PP",845
36,"36060",30350,22032,21753,193,279,"PP",7026
36,"36012",3735,2818,2777,21,41,"PP",1143
36,"36058",4992,3495,3441,48,54,"PP",1119
36,"36014",1980,1464,1442,7,22,"PP",807
36,"36901",4095,3344,3293,22,51,"PP",841
36,"36018",3272,2288,2262,17,26,"PP",1185
36,"36034",3477,2499,2470,15,29,"PP",1052
36,"36026",20203,14399,14189,144,210,"PP",5525
40,"40049",62,45,45,0,0,"FE de las J",0
40,"40173",139,115,110,1,5,"FE de las J",0
40,"40123",148,122,113,3,9,"FE de las J",0
40,"40200",41,31,31,0,0,"FE de las J",0
40,"40138",2174,1739,1710,13,29,"FE de las J",3
40,"40016",57,47,45,0,2,"FE de las J",0
40,"40901",377,307,300,1,7,"FE de las J",3
40,"40060",81,59,59,0,0,"FE de las J",0
40,"40059",112,96,96,2,0,"FE de las J",0
40,"40105",48,43,43,1,0,"FE de las J",0
40,"40230",94,75,72,2,3,"FE de las J",0
40,"40084",61,49,49,2,0,"FE de las J",0
40,"40054",112,83,83,0,0,"FE de las J",1
40,"40010",124,95,94,2,1,"FE de las J",0
40,"40157",50,43,43,0,0,"FE de las J",0
40,"40166",260,224,222,2,2,"FE de las J",1
40,"40045",112,89,88,1,1,"FE de las J",1
40,"40076",6550,5029,4942,29,87,"FE de las J",20
40,"40149",528,401,390,7,11,"FE de las J",2
40,"40118",52,39,38,2,1,"FE de las J",0
40,"40208",768,606,596,5,10,"FE de las J",1
40,"40003",143,109,104,1,5,"FE de las J",0
40,"40007",77,62,62,0,0,"FE de las J",0
40,"40134",729,587,573,8,14,"FE de las J",1
40,"40214",210,174,172,2,2,"FE de las J",0
40,"40028",103,90,89,2,1,"FE de las J",1
40,"40206",178,141,135,0,6,"FE de las J",0
40,"40014",58,46,45,0,1,"FE de las J",0
40,"40122",514,416,403,0,13,"FE de las J",0
40,"40004",472,371,368,2,3,"FE de las J",1
40,"40178",103,70,68,0,2,"FE de las J",2
40,"40228",507,401,396,0,5,"FE de las J",0
40,"40168",34,27,27,0,0,"FE de las J",0
40,"40019",37,32,31,0,1,"FE de las J",0
40,"40154",21,13,13,0,0,"FE de las J",0
40,"40204",167,127,126,2,1,"FE de las J",0
40,"40170",1315,1037,1026,9,11,"FE de las J",1
40,"40015",30,21,21,1,0,"FE de las J",0
40,"40071",46,42,39,0,3,"FE de las J",0
40,"40074",266,226,223,2,3,"FE de las J",1
40,"40089",218,163,159,0,4,"FE de las J",2
40,"40165",80,62,60,1,2,"FE de las J",0
40,"40127",33,22,20,1,2,"FE de las J",0
40,"40008",46,38,38,0,0,"FE de las J",0
40,"40006",21,17,17,0,0,"FE de las J",0
40,"40022",207,162,160,3,2,"FE de las J",0
40,"40100",275,224,214,2,10,"FE de las J",0
40,"40057",1488,1240,1228,14,12,"FE de las J",2
40,"40132",66,32,30,1,2,"FE de las J",0
40,"40025",142,119,117,0,2,"FE de las J",0
40,"40012",271,205,202,3,3,"FE de las J",0
40,"40177",153,121,120,3,1,"FE de las J",0
40,"40115",104,80,79,0,1,"FE de las J",0
40,"40906",1973,1645,1627,16,18,"FE de las J",2
40,"40094",372,283,277,1,6,"FE de las J",1
40,"40002",37,33,33,1,0,"FE de las J",0
40,"40106",214,175,174,1,1,"FE de las J",0
40,"40144",19,15,15,0,0,"FE de las J",0
40,"40021",27,26,26,0,0,"FE de las J",0
40,"40077",805,633,625,6,8,"FE de las J",0
40,"40213",89,71,71,1,0,"FE de las J",1
40,"40143",88,76,75,1,1,"FE de las J",0
40,"40031",515,417,413,2,4,"FE de las J",1
40,"40182",184,139,136,1,3,"FE de las J",0
40,"40026",113,106,106,0,0,"FE de las J",1
40,"40119",170,142,140,0,2,"FE de las J",1
40,"40234",407,326,322,3,4,"FE de las J",1
40,"40159",141,104,104,0,0,"FE de las J",1
40,"40188",95,70,70,1,0,"FE de las J",0
40,"40131",48,45,44,0,1,"FE de las J",0
40,"40145",1111,917,903,8,14,"FE de las J",0
40,"40160",105,76,74,2,2,"FE de las J",0
40,"40005",31,26,26,0,0,"FE de las J",0
40,"40164",180,139,137,0,2,"FE de las J",0
40,"40162",396,305,299,0,6,"FE de las J",5
40,"40151",44,35,35,0,0,"FE de las J",0
40,"40033",59,48,48,4,0,"FE de las J",1
40,"40192",157,130,128,1,2,"FE de las J",0
40,"40093",77,67,67,5,0,"FE de las J",1
40,"40161",34,28,28,0,0,"FE de las J",0
40,"40043",1825,1455,1429,16,26,"FE de las J",2
40,"40056",34,27,27,1,0,"FE de las J",0
40,"40215",89,66,66,0,0,"FE de las J",0
40,"40113",428,345,341,5,4,"FE de las J",2
40,"40152",763,637,627,1,10,"FE de las J",3
40,"40148",240,201,200,1,1,"FE de las J",0
40,"40020",168,130,129,2,1,"FE de las J",3
40,"40189",513,403,391,3,12,"FE de las J",3
40,"40048",38,30,30,0,0,"FE de las J",0
40,"40030",476,394,389,8,5,"FE de las J",0
40,"40034",81,62,62,0,0,"FE de las J",1
40,"40125",90,67,63,0,4,"FE de las J",0
40,"40053",88,64,64,3,0,"FE de las J",0
40,"40190",51,46,45,0,1,"FE de las J",0
40,"40158",18,12,12,0,0,"FE de las J",0
40,"40233",419,340,336,2,4,"FE de las J",1
40,"40181",4258,3391,3329,23,62,"FE de las J",2
40,"40017",92,77,76,1,1,"FE de las J",0
40,"40086",698,591,580,11,11,"FE de las J",1
40,"40069",84,67,67,0,0,"FE de las J",1
40,"40035",140,109,108,3,1,"FE de las J",0
40,"40075",163,130,130,0,0,"FE de las J",0
40,"40150",71,61,61,0,0,"FE de las J",0
40,"40103",157,128,128,0,0,"FE de las J",1
40,"40046",90,69,69,0,0,"FE de las J",0
40,"40107",104,83,81,1,2,"FE de las J",0
40,"40111",61,51,51,0,0,"FE de las J",0
40,"40155",3480,2762,2723,29,39,"FE de las J",4
40,"40195",910,709,702,13,7,"FE de las J",4
40,"40112",2525,2054,2034,18,20,"FE de las J",8
40,"40099",60,50,48,1,2,"FE de las J",0
40,"40163",55,39,38,1,1,"FE de las J",0
40,"40136",114,84,81,3,3,"FE de las J",0
40,"40223",226,173,169,0,4,"FE de las J",0
40,"40902",125,102,102,0,0,"FE de las J",0
40,"40196",34,26,26,1,0,"FE de las J",0
40,"40108",116,80,79,2,1,"FE de las J",0
40,"40183",130,113,112,1,1,"FE de las J",0
40,"40156",330,239,234,2,5,"FE de las J",1
40,"40037",43,28,27,0,1,"FE de las J",0
40,"40120",192,167,166,1,1,"FE de las J",0
40,"40142",53,43,43,0,0,"FE de las J",0
40,"40029",32,28,27,1,1,"FE de las J",0
40,"40224",24,18,18,0,0,"FE de las J",0
40,"40211",75,63,63,1,0,"FE de las J",0
40,"40171",33,24,24,0,0,"FE de las J",0
40,"40180",299,244,239,2,5,"FE de las J",0
40,"40140",97,72,71,8,1,"FE de las J",0
40,"40139",281,218,216,1,2,"FE de las J",0
40,"40207",753,612,607,2,5,"FE de las J",4
40,"40184",253,210,210,3,0,"FE de las J",0
40,"40185",882,657,644,9,13,"FE de las J",1
40,"40101",874,672,669,11,3,"FE de las J",3
40,"40110",349,272,272,1,0,"FE de las J",0
40,"40039",213,167,165,2,2,"FE de las J",1
40,"40062",60,50,49,0,1,"FE de las J",0
40,"40058",331,273,270,1,3,"FE de las J",0
40,"40199",106,83,83,0,0,"FE de las J",0
40,"40081",126,94,90,1,4,"FE de las J",0
40,"40104",258,193,192,1,1,"FE de las J",1
40,"40063",7132,5389,5297,56,92,"FE de las J",14
40,"40001",715,588,580,4,8,"FE de las J",1
40,"40097",124,105,105,0,0,"FE de las J",1
40,"40135",289,242,237,1,5,"FE de las J",0
40,"40216",755,628,621,7,7,"FE de las J",1
40,"40082",115,90,88,4,2,"FE de las J",0
40,"40186",41,32,32,0,0,"FE de las J",0
40,"40087",93,70,70,2,0,"FE de las J",0
40,"40092",119,89,89,0,0,"FE de las J",0
40,"40032",394,302,300,6,2,"FE de las J",3
40,"40229",38,28,28,0,0,"FE de las J",0
40,"40201",49,41,41,0,0,"FE de las J",0
40,"40080",61,49,49,0,0,"FE de las J",0
40,"40072",200,167,163,3,4,"FE de las J",0
40,"40202",63,41,41,0,0,"FE de las J",0
40,"40146",255,211,209,0,2,"FE de las J",1
40,"40210",100,74,74,0,0,"FE de las J",0
40,"40047",31,24,24,0,0,"FE de las J",0
40,"40065",496,389,381,8,8,"FE de las J",1
40,"40083",77,54,53,1,1,"FE de las J",0
40,"40052",81,62,62,0,0,"FE de las J",0
40,"40124",244,190,185,6,5,"FE de las J",1
40,"40220",66,50,45,2,5,"FE de las J",1
40,"40109",75,49,46,1,3,"FE de las J",0
40,"40126",85,65,63,0,2,"FE de las J",0
40,"40078",161,129,128,2,1,"FE de las J",0
40,"40009",50,41,41,0,0,"FE de las J",0
40,"40176",402,319,317,3,2,"FE de las J",0
40,"40198",24,19,19,0,0,"FE de las J",0
40,"40129",179,143,138,2,5,"FE de las J",1
40,"40121",286,230,225,3,5,"FE de las J",0
40,"40203",895,722,716,6,6,"FE de las J",6
40,"40231",108,93,93,1,0,"FE de las J",0
40,"40068",24,22,22,0,0,"FE de las J",0
40,"40073",405,345,339,4,6,"FE de las J",1
40,"40130",130,108,107,1,1,"FE de las J",0
40,"40172",44,29,29,0,0,"FE de las J",0
40,"40070",147,111,107,1,4,"FE de las J",1
40,"40194",39796,30886,30516,287,370,"FE de las J",67
40,"40219",590,448,437,6,11,"FE de las J",0
40,"40225",1134,907,890,8,17,"FE de las J",0
40,"40036",519,424,411,9,13,"FE de las J",1
40,"40218",97,69,69,0,0,"FE de las J",1
40,"40191",222,163,161,2,2,"FE de las J",0
40,"40018",90,70,68,0,2,"FE de las J",1
40,"40141",856,626,616,7,10,"FE de las J",2
40,"40051",45,33,33,0,0,"FE de las J",0
40,"40091",116,89,89,0,0,"FE de las J",0
40,"40088",292,219,218,0,1,"FE de las J",0
40,"40205",266,194,192,2,2,"FE de las J",0
40,"40221",49,42,41,0,1,"FE de las J",1
40,"40079",234,182,181,1,1,"FE de las J",0
40,"40904",353,307,307,2,0,"FE de las J",0
40,"40128",132,97,95,4,2,"FE de las J",0
40,"40044",144,116,115,6,1,"FE de las J",0
40,"40055",36,25,23,0,2,"FE de las J",0
40,"40095",475,376,370,7,6,"FE de las J",0
40,"40024",872,676,660,9,16,"FE de las J",2
40,"40061",70,55,54,0,1,"FE de las J",0
40,"40013",65,51,50,0,1,"FE de las J",0
40,"40905",133,96,95,0,1,"FE de las J",0
40,"40212",30,21,19,0,2,"FE de las J",0
40,"40040",2626,1847,1835,19,12,"FE de las J",5
40,"40174",361,252,250,0,2,"FE de las J",0
40,"40041",987,791,777,18,14,"FE de las J",2
40,"40193",230,171,168,5,3,"FE de las J",0
40,"40179",631,533,525,3,8,"FE de las J",2
40,"40903",91,68,68,1,0,"FE de las J",0
40,"40222",174,147,147,0,0,"FE de las J",0
29,"29044",811,557,556,3,1,"IULV-CA, UP",14
29,"29084",27393,19096,18886,192,210,"IULV-CA, UP",986
29,"29033",1132,808,804,2,4,"IULV-CA, UP",35
29,"29066",346,252,251,2,1,"IULV-CA, UP",27
29,"29080",6704,4812,4766,44,46,"IULV-CA, UP",425
29,"29077",208,156,153,0,3,"IULV-CA, UP",6
29,"29061",1018,833,820,4,13,"IULV-CA, UP",267
29,"29025",39210,26938,26747,160,191,"IULV-CA, UP",1633
29,"29904",428,363,360,2,3,"IULV-CA, UP",15
29,"29031",1633,1115,1106,6,9,"IULV-CA, UP",247
29,"29038",17555,11638,11562,124,76,"IULV-CA, UP",655
29,"29034",466,361,359,0,2,"IULV-CA, UP",14
29,"29011",2920,1962,1946,5,16,"IULV-CA, UP",94
29,"29010",1667,1336,1310,1,26,"IULV-CA, UP",120
29,"29037",212,166,165,1,1,"IULV-CA, UP",1
29,"29029",420,322,315,4,7,"IULV-CA, UP",11
29,"29100",2437,1775,1760,12,15,"IULV-CA, UP",66
29,"29902",2560,1735,1709,13,26,"IULV-CA, UP",60
29,"29091",8966,6437,6346,57,91,"IULV-CA, UP",654
29,"29094",57313,39393,39052,280,341,"IULV-CA, UP",2118
29,"29057",376,285,284,2,1,"IULV-CA, UP",3
29,"29016",253,188,188,1,0,"IULV-CA, UP",19
29,"29018",2026,1560,1519,15,41,"IULV-CA, UP",181
29,"29040",1964,1321,1301,12,20,"IULV-CA, UP",57
29,"29021",162,114,107,13,7,"IULV-CA, UP",3
29,"29088",2720,1930,1883,21,47,"IULV-CA, UP",62
29,"29070",39913,26993,26751,203,242,"IULV-CA, UP",1306
29,"29083",2114,1587,1568,10,19,"IULV-CA, UP",63
29,"29046",2690,1974,1954,17,20,"IULV-CA, UP",106
29,"29063",336,255,251,2,4,"IULV-CA, UP",10
29,"29093",2235,1689,1667,12,22,"IULV-CA, UP",151
29,"29036",636,481,475,3,6,"IULV-CA, UP",59
29,"29043",2503,1671,1638,17,33,"IULV-CA, UP",99
29,"29022",185,143,143,1,0,"IULV-CA, UP",11
29,"29035",1587,1218,1208,0,10,"IULV-CA, UP",205
29,"29020",3265,2531,2504,17,27,"IULV-CA, UP",700
29,"29071",938,640,633,6,7,"IULV-CA, UP",100
29,"29017",6610,5001,4938,25,63,"IULV-CA, UP",434
29,"29024",393,271,256,4,15,"IULV-CA, UP",6
29,"29009",1477,1113,1100,3,13,"IULV-CA, UP",280
29,"29081",258,205,200,1,5,"IULV-CA, UP",1
29,"29054",41888,29228,29022,205,206,"IULV-CA, UP",1305
29,"29023",2047,1385,1369,2,16,"IULV-CA, UP",40
29,"29051",40201,27168,26842,229,326,"IULV-CA, UP",1313
29,"29098",1257,991,977,12,14,"IULV-CA, UP",49
29,"29056",1107,815,807,8,8,"IULV-CA, UP",25
29,"29041",3146,2251,2216,26,35,"IULV-CA, UP",459
29,"29082",31505,23154,22990,127,164,"IULV-CA, UP",1923
29,"29015",31884,23160,22943,188,217,"IULV-CA, UP",1009
29,"29073",1560,1126,1120,5,6,"IULV-CA, UP",135
29,"29099",960,741,734,3,7,"IULV-CA, UP",16
29,"29092",567,423,415,4,8,"IULV-CA, UP",90
29,"29001",4196,3276,3253,26,23,"IULV-CA, UP",488
29,"29069",85333,56398,55854,443,544,"IULV-CA, UP",2795
29,"29097",4117,2996,2947,43,49,"IULV-CA, UP",174
29,"29086",795,497,490,3,7,"IULV-CA, UP",26
29,"29067",424770,295944,294094,2117,1850,"IULV-CA, UP",20621
29,"29013",1612,1282,1272,6,10,"IULV-CA, UP",217
29,"29047",1131,927,914,4,13,"IULV-CA, UP",192
29,"29053",1702,1178,1160,17,18,"IULV-CA, UP",62
29,"29074",785,612,611,4,1,"IULV-CA, UP",17
29,"29006",680,482,474,3,8,"IULV-CA, UP",3
29,"29004",328,240,238,2,2,"IULV-CA, UP",11
29,"29068",6885,4580,4511,43,69,"IULV-CA, UP",214
29,"29087",380,283,276,1,7,"IULV-CA, UP",91
29,"29003",1002,777,769,1,8,"IULV-CA, UP",81
29,"29050",425,313,309,1,4,"IULV-CA, UP",9
29,"29095",3350,2523,2467,17,56,"IULV-CA, UP",290
29,"29901",43601,30325,30130,188,195,"IULV-CA, UP",1637
29,"29049",2987,2204,2185,25,19,"IULV-CA, UP",160
29,"29019",888,675,672,0,3,"IULV-CA, UP",213
29,"29026",1065,776,766,4,10,"IULV-CA, UP",102
29,"29008",14541,9954,9820,90,134,"IULV-CA, UP",484
29,"29048",1428,1168,1155,9,13,"IULV-CA, UP",303
29,"29064",506,372,365,2,7,"IULV-CA, UP",15
29,"29039",2662,1948,1931,22,17,"IULV-CA, UP",464
29,"29012",9765,7029,6944,58,85,"IULV-CA, UP",608
29,"29027",2343,1737,1722,6,15,"IULV-CA, UP",178
29,"29085",151,99,98,1,1,"IULV-CA, UP",5
29,"29090",1704,1174,1165,10,9,"IULV-CA, UP",34
29,"29062",658,564,561,0,3,"IULV-CA, UP",8
29,"29058",1463,986,975,6,11,"IULV-CA, UP",49
29,"29055",1808,1415,1396,13,19,"IULV-CA, UP",117
29,"29903",525,394,389,2,5,"IULV-CA, UP",25
29,"29065",194,134,134,1,0,"IULV-CA, UP",1
29,"29005",4342,2946,2908,22,38,"IULV-CA, UP",133
29,"29076",2163,1508,1482,8,26,"IULV-CA, UP",45
29,"29059",2590,2100,2058,11,42,"IULV-CA, UP",452
29,"29089",3254,2465,2438,10,27,"IULV-CA, UP",730
29,"29045",1685,1232,1223,4,9,"IULV-CA, UP",80
29,"29030",809,653,651,2,2,"IULV-CA, UP",188
29,"29096",2806,2065,2034,19,31,"IULV-CA, UP",144
29,"29002",1203,855,842,6,13,"IULV-CA, UP",19
29,"29028",1249,881,881,4,0,"IULV-CA, UP",89
29,"29007",27319,19557,19395,179,162,"IULV-CA, UP",1228
29,"29032",6708,5341,5265,26,76,"IULV-CA, UP",728
29,"29014",219,138,138,1,0,"IULV-CA, UP",11
29,"29060",706,524,516,0,8,"IULV-CA, UP",3
29,"29072",3250,2466,2434,11,32,"IULV-CA, UP",112
29,"29075",12952,8681,8619,55,62,"IULV-CA, UP",511
29,"29052",226,155,152,0,3,"IULV-CA, UP",7
29,"29079",2444,1880,1846,3,34,"IULV-CA, UP",227
29,"29042",14078,9890,9776,75,114,"IULV-CA, UP",578
28,"28001",64,48,48,3,0,"PH",0
28,"28023",4697,3835,3817,20,18,"PH",1
28,"28039",130,97,97,0,0,"PH",0
28,"28146",1773,1274,1262,9,12,"PH",3
28,"28154",5420,3966,3899,17,67,"PH",1
28,"28129",7913,6175,6124,30,51,"PH",1
28,"28122",518,388,385,2,3,"PH",0
28,"28169",1427,1164,1158,1,6,"PH",0
28,"28069",54,43,43,1,0,"PH",0
28,"28024",152,129,128,1,1,"PH",0
28,"28147",968,751,745,2,6,"PH",0
28,"28078",36,34,34,0,0,"PH",0
28,"28177",10192,8271,8234,51,37,"PH",0
28,"28162",2549,2039,2025,13,14,"PH",1
28,"28050",4077,3032,3006,15,26,"PH",0
28,"28027",1199,897,882,5,15,"PH",0
28,"28002",2966,2186,2175,9,11,"PH",0
28,"28055",899,682,676,4,6,"PH",0
28,"28047",40783,31308,31072,171,236,"PH",11
28,"28097",124,85,84,1,1,"PH",0
28,"28123",56464,47181,46948,257,233,"PH",12
28,"28107",435,326,321,0,5,"PH",0
28,"28084",15839,12028,11925,53,103,"PH",7
28,"28070",119,91,91,0,0,"PH",0
28,"28148",85022,65597,65111,368,486,"PH",39
28,"28170",2486,1757,1740,9,17,"PH",0
28,"28063",252,195,194,2,1,"PH",0
28,"28126",39,25,25,0,0,"PH",0
28,"28048",499,406,401,2,5,"PH",0
28,"28013",40409,30141,29905,164,236,"PH",14
28,"28131",12971,9828,9755,57,73,"PH",4
28,"28010",9853,7959,7914,35,45,"PH",2
28,"28082",5664,4526,4492,25,34,"PH",1
28,"28003",181,141,141,3,0,"PH",0
28,"28061",21200,16698,16600,75,98,"PH",2
28,"28033",3824,2854,2832,11,22,"PH",1
28,"28071",60,47,46,0,1,"PH",0
28,"28099",1731,1283,1278,8,5,"PH",0
28,"28903",32480,27640,27525,161,115,"PH",6
28,"28083",8880,6801,6759,47,42,"PH",2
28,"28156",998,751,743,3,8,"PH",2
28,"28172",8965,7255,7219,44,36,"PH",5
28,"28088",262,180,179,2,1,"PH",0
28,"28026",6237,4893,4853,32,40,"PH",3
28,"28124",76,56,54,0,2,"PH",0
28,"28072",5657,4465,4441,20,24,"PH",0
28,"28034",352,270,269,1,1,"PH",0
28,"28159",588,469,468,6,1,"PH",1
28,"28057",1439,1125,1120,5,5,"PH",1
28,"28012",883,702,691,4,11,"PH",1
28,"28112",167,132,132,0,0,"PH",0
28,"28007",124358,99423,98711,554,712,"PH",33
28,"28073",12505,9485,9384,64,101,"PH",5
28,"28004",6179,4377,4345,15,32,"PH",1
28,"28157",595,448,442,1,6,"PH",0
28,"28125",2965,2210,2188,13,22,"PH",0
28,"28100",4169,3076,3048,12,28,"PH",2
28,"28173",520,409,408,3,1,"PH",0
28,"28045",33019,25531,25313,146,218,"PH",13
28,"28110",1949,1543,1525,2,18,"PH",1
28,"28005",134211,104575,103819,667,756,"PH",62
28,"28150",3084,2415,2381,13,34,"PH",0
28,"28181",20344,16669,16572,95,97,"PH",9
28,"28030",1716,1342,1316,2,26,"PH",0
28,"28066",7175,5598,5561,28,37,"PH",1
28,"28136",640,540,532,0,8,"PH",0
28,"28035",1362,1042,1033,3,9,"PH",2
28,"28028",1730,1347,1326,8,21,"PH",0
28,"28111",592,489,483,0,6,"PH",0
28,"28056",860,653,647,6,6,"PH",0
28,"28151",3143,2352,2314,6,38,"PH",1
28,"28134",60511,47566,47229,233,337,"PH",33
28,"28085",3908,3106,3078,7,28,"PH",1
28,"28074",138742,110456,109579,581,877,"PH",61
28,"28044",5766,4623,4584,22,39,"PH",1
28,"28051",1542,1240,1232,5,8,"PH",1
28,"28116",700,544,544,3,0,"PH",0
28,"28102",881,659,650,3,9,"PH",0
28,"28132",11645,8605,8520,55,85,"PH",3
28,"28167",8308,6605,6545,35,60,"PH",3
28,"28029",530,426,424,3,2,"PH",0
28,"28174",1788,1277,1267,2,10,"PH",1
28,"28014",32852,24749,24571,120,178,"PH",8
28,"28006",78564,61796,61456,334,340,"PH",154
28,"28149",5653,4516,4469,19,47,"PH",2
28,"28152",16026,13269,13202,46,67,"PH",2
28,"28127",64513,53125,52932,300,193,"PH",14
28,"28144",5929,4776,4744,29,32,"PH",0
28,"28065",125384,101604,100872,477,732,"PH",52
28,"28160",8227,6295,6251,26,44,"PH",1
28,"28060",1509,1194,1183,8,11,"PH",2
28,"28104",13836,11414,11349,54,65,"PH",3
28,"28091",5436,3827,3786,23,41,"PH",3
28,"28128",439,323,320,2,3,"PH",0
28,"28075",5581,4380,4350,15,30,"PH",3
28,"28040",15691,10833,10728,45,105,"PH",3
28,"28037",1566,1175,1168,5,7,"PH",0
28,"28163",438,357,354,1,3,"PH",1
28,"28175",850,696,692,2,4,"PH",0
28,"28120",1217,918,904,4,14,"PH",0
28,"28020",148,99,97,1,2,"PH",0
28,"28046",4432,3562,3538,19,24,"PH",2
28,"28053",6458,5299,5263,29,36,"PH",1
28,"28113",34305,27077,26881,156,196,"PH",17
28,"28161",48368,37462,37161,190,301,"PH",14
28,"28031",2055,1538,1519,4,19,"PH",0
28,"28009",14046,11014,10932,51,82,"PH",6
28,"28143",70,59,59,1,0,"PH",0
28,"28079",2371327,1817203,1806970,9067,10233,"PH",834
28,"28153",703,510,507,2,3,"PH",0
28,"28008",1768,1293,1282,4,11,"PH",1
28,"28076",406,322,319,1,3,"PH",0
28,"28176",12288,9809,9763,50,46,"PH",2
28,"28115",60579,50819,50657,246,162,"PH",8
28,"28164",2986,2281,2263,12,18,"PH",0
28,"28016",80,57,57,0,0,"PH",1
28,"28067",4057,3220,3188,12,32,"PH",3
28,"28054",11166,8649,8584,36,65,"PH",4
28,"28080",48226,39753,39570,172,183,"PH",12
28,"28138",69,54,54,0,0,"PH",0
28,"28011",445,339,338,0,1,"PH",0
28,"28137",1644,1301,1283,7,18,"PH",1
28,"28059",4312,3256,3237,11,19,"PH",0
28,"28086",5055,3627,3600,21,27,"PH",4
28,"28109",1591,1113,1111,3,2,"PH",0
28,"28118",58,49,48,1,1,"PH",0
28,"28032",4749,3653,3607,19,46,"PH",2
28,"28042",1153,882,874,5,8,"PH",0
28,"28155",507,420,420,0,0,"PH",0
28,"28022",32949,27473,27379,169,94,"PH",4
28,"28108",3330,2536,2528,17,8,"PH",3
28,"28178",1066,850,846,2,4,"PH",0
28,"28141",5806,4532,4486,24,46,"PH",2
28,"28165",1788,1332,1321,5,11,"PH",1
28,"28092",151511,117869,116968,641,901,"PH",71
28,"28130",28243,22649,22458,135,191,"PH",10
28,"28049",58688,48006,47660,286,346,"PH",24
28,"28171",4238,3002,2962,18,40,"PH",1
28,"28145",2370,1824,1809,12,15,"PH",1
28,"28043",5922,4063,4008,29,55,"PH",0
28,"28058",139289,108214,107323,612,891,"PH",62
28,"28090",8405,6792,6751,34,41,"PH",4
28,"28064",134,105,105,0,0,"PH",0
28,"28021",544,387,387,2,0,"PH",1
28,"28121",198,166,164,2,2,"PH",0
28,"28041",4452,3572,3550,24,22,"PH",1
28,"28158",662,545,543,3,2,"PH",0
28,"28114",149,103,103,1,0,"PH",0
28,"28094",825,636,634,3,2,"PH",0
28,"28038",4935,3858,3815,17,43,"PH",0
28,"28018",3739,3071,3046,12,25,"PH",0
28,"28133",6002,4259,4204,12,55,"PH",2
28,"28019",1237,952,938,2,14,"PH",0
28,"28117",95,84,84,0,0,"PH",0
28,"28135",971,740,735,4,5,"PH",0
28,"28179",1441,1082,1071,7,11,"PH",0
28,"28119",2074,1641,1625,9,16,"PH",3
28,"28052",3883,2801,2758,18,43,"PH",0
28,"28166",318,258,255,1,3,"PH",0
28,"28168",1226,910,900,1,10,"PH",0
28,"28036",2514,1974,1949,12,25,"PH",2
28,"28140",2981,2383,2357,14,26,"PH",1
28,"28068",10928,8389,8315,43,74,"PH",3
28,"28182",214,174,170,0,4,"PH",0
28,"28015",18233,14725,14653,81,72,"PH",9
28,"28095",1508,1177,1167,6,10,"PH",0
28,"28902",468,352,347,2,5,"PH",0
28,"28087",3176,2545,2528,15,17,"PH",0
28,"28062",308,244,241,3,3,"PH",0
28,"28180",5242,4040,3999,11,41,"PH",0
28,"28183",1050,770,763,2,7,"PH",0
28,"28025",427,329,326,1,3,"PH",0
28,"28089",3703,2961,2933,19,28,"PH",0
28,"28101",218,180,180,0,0,"PH",0
28,"28017",1210,954,943,6,11,"PH",0
28,"28096",18161,13784,13647,57,137,"PH",2
28,"28106",76612,56555,56006,346,549,"PH",45
28,"28901",789,590,584,2,6,"PH",0
28,"28093",2043,1681,1661,9,20,"PH",0
40,"40001",715,588,580,4,8,"UPYD",9
40,"40155",3480,2762,2723,29,39,"UPYD",34
40,"40010",124,95,94,2,1,"UPYD",2
40,"40230",94,75,72,2,3,"UPYD",2
40,"40051",45,33,33,0,0,"UPYD",0
40,"40005",31,26,26,0,0,"UPYD",0
40,"40032",394,302,300,6,2,"UPYD",5
40,"40115",104,80,79,0,1,"UPYD",0
40,"40020",168,130,129,2,1,"UPYD",5
40,"40165",80,62,60,1,2,"UPYD",0
40,"40212",30,21,19,0,2,"UPYD",0
40,"40039",213,167,165,2,2,"UPYD",0
40,"40146",255,211,209,0,2,"UPYD",1
40,"40206",178,141,135,0,6,"UPYD",4
40,"40105",48,43,43,1,0,"UPYD",1
40,"40015",30,21,21,1,0,"UPYD",0
40,"40108",116,80,79,2,1,"UPYD",1
40,"40157",50,43,43,0,0,"UPYD",0
40,"40176",402,319,317,3,2,"UPYD",2
40,"40160",105,76,74,2,2,"UPYD",0
40,"40222",174,147,147,0,0,"UPYD",1
40,"40003",143,109,104,1,5,"UPYD",0
40,"40054",112,83,83,0,0,"UPYD",1
40,"40106",214,175,174,1,1,"UPYD",1
40,"40128",132,97,95,4,2,"UPYD",2
40,"40179",631,533,525,3,8,"UPYD",5
40,"40228",507,401,396,0,5,"UPYD",1
40,"40149",528,401,390,7,11,"UPYD",6
40,"40136",114,84,81,3,3,"UPYD",0
40,"40088",292,219,218,0,1,"UPYD",1
40,"40131",48,45,44,0,1,"UPYD",1
40,"40055",36,25,23,0,2,"UPYD",0
40,"40134",729,587,573,8,14,"UPYD",14
40,"40025",142,119,117,0,2,"UPYD",0
40,"40080",61,49,49,0,0,"UPYD",1
40,"40223",226,173,169,0,4,"UPYD",0
40,"40204",167,127,126,2,1,"UPYD",2
40,"40234",407,326,322,3,4,"UPYD",0
40,"40174",361,252,250,0,2,"UPYD",3
40,"40065",496,389,381,8,8,"UPYD",3
40,"40142",53,43,43,0,0,"UPYD",0
40,"40009",50,41,41,0,0,"UPYD",0
40,"40093",77,67,67,5,0,"UPYD",3
40,"40099",60,50,48,1,2,"UPYD",0
40,"40029",32,28,27,1,1,"UPYD",0
40,"40224",24,18,18,0,0,"UPYD",1
40,"40047",31,24,24,0,0,"UPYD",0
40,"40028",103,90,89,2,1,"UPYD",0
40,"40127",33,22,20,1,2,"UPYD",0
40,"40170",1315,1037,1026,9,11,"UPYD",6
40,"40036",519,424,411,9,13,"UPYD",1
40,"40084",61,49,49,2,0,"UPYD",2
40,"40044",144,116,115,6,1,"UPYD",1
40,"40030",476,394,389,8,5,"UPYD",4
40,"40072",200,167,163,3,4,"UPYD",2
40,"40095",475,376,370,7,6,"UPYD",1
40,"40189",513,403,391,3,12,"UPYD",5
40,"40057",1488,1240,1228,14,12,"UPYD",3
40,"40181",4258,3391,3329,23,62,"UPYD",49
40,"40166",260,224,222,2,2,"UPYD",0
40,"40043",1825,1455,1429,16,26,"UPYD",17
40,"40132",66,32,30,1,2,"UPYD",0
40,"40041",987,791,777,18,14,"UPYD",11
40,"40200",41,31,31,0,0,"UPYD",0
40,"40208",768,606,596,5,10,"UPYD",7
40,"40021",27,26,26,0,0,"UPYD",1
40,"40092",119,89,89,0,0,"UPYD",1
40,"40182",184,139,136,1,3,"UPYD",2
40,"40017",92,77,76,1,1,"UPYD",3
40,"40145",1111,917,903,8,14,"UPYD",17
40,"40178",103,70,68,0,2,"UPYD",0
40,"40107",104,83,81,1,2,"UPYD",0
40,"40014",58,46,45,0,1,"UPYD",0
40,"40046",90,69,69,0,0,"UPYD",2
40,"40059",112,96,96,2,0,"UPYD",3
40,"40162",396,305,299,0,6,"UPYD",6
40,"40082",115,90,88,4,2,"UPYD",0
40,"40104",258,193,192,1,1,"UPYD",1
40,"40219",590,448,437,6,11,"UPYD",4
40,"40205",266,194,192,2,2,"UPYD",3
40,"40229",38,28,28,0,0,"UPYD",0
40,"40905",133,96,95,0,1,"UPYD",3
40,"40056",34,27,27,1,0,"UPYD",0
40,"40201",49,41,41,0,0,"UPYD",0
40,"40120",192,167,166,1,1,"UPYD",1
40,"40075",163,130,130,0,0,"UPYD",2
40,"40151",44,35,35,0,0,"UPYD",1
40,"40094",372,283,277,1,6,"UPYD",1
40,"40214",210,174,172,2,2,"UPYD",2
40,"40198",24,19,19,0,0,"UPYD",0
40,"40171",33,24,24,0,0,"UPYD",0
40,"40061",70,55,54,0,1,"UPYD",0
40,"40906",1973,1645,1627,16,18,"UPYD",20
40,"40007",77,62,62,0,0,"UPYD",0
40,"40089",218,163,159,0,4,"UPYD",2
40,"40076",6550,5029,4942,29,87,"UPYD",37
40,"40139",281,218,216,1,2,"UPYD",0
40,"40048",38,30,30,0,0,"UPYD",0
40,"40143",88,76,75,1,1,"UPYD",2
40,"40121",286,230,225,3,5,"UPYD",1
40,"40177",153,121,120,3,1,"UPYD",1
40,"40220",66,50,45,2,5,"UPYD",0
40,"40185",882,657,644,9,13,"UPYD",7
40,"40049",62,45,45,0,0,"UPYD",0
40,"40213",89,71,71,1,0,"UPYD",2
40,"40058",331,273,270,1,3,"UPYD",2
40,"40158",18,12,12,0,0,"UPYD",0
40,"40118",52,39,38,2,1,"UPYD",0
40,"40186",41,32,32,0,0,"UPYD",0
40,"40141",856,626,616,7,10,"UPYD",9
40,"40173",139,115,110,1,5,"UPYD",1
40,"40195",910,709,702,13,7,"UPYD",7
40,"40074",266,226,223,2,3,"UPYD",2
40,"40087",93,70,70,2,0,"UPYD",1
40,"40022",207,162,160,3,2,"UPYD",2
40,"40078",161,129,128,2,1,"UPYD",2
40,"40033",59,48,48,4,0,"UPYD",0
40,"40196",34,26,26,1,0,"UPYD",0
40,"40018",90,70,68,0,2,"UPYD",1
40,"40150",71,61,61,0,0,"UPYD",0
40,"40164",180,139,137,0,2,"UPYD",0
40,"40079",234,182,181,1,1,"UPYD",0
40,"40138",2174,1739,1710,13,29,"UPYD",18
40,"40052",81,62,62,0,0,"UPYD",2
40,"40037",43,28,27,0,1,"UPYD",0
40,"40183",130,113,112,1,1,"UPYD",2
40,"40215",89,66,66,0,0,"UPYD",1
40,"40060",81,59,59,0,0,"UPYD",0
40,"40100",275,224,214,2,10,"UPYD",2
40,"40190",51,46,45,0,1,"UPYD",0
40,"40024",872,676,660,9,16,"UPYD",2
40,"40124",244,190,185,6,5,"UPYD",1
40,"40161",34,28,28,0,0,"UPYD",0
40,"40193",230,171,168,5,3,"UPYD",2
40,"40202",63,41,41,0,0,"UPYD",0
40,"40068",24,22,22,0,0,"UPYD",1
40,"40006",21,17,17,0,0,"UPYD",0
40,"40207",753,612,607,2,5,"UPYD",11
40,"40012",271,205,202,3,3,"UPYD",2
40,"40081",126,94,90,1,4,"UPYD",1
40,"40125",90,67,63,0,4,"UPYD",1
40,"40045",112,89,88,1,1,"UPYD",0
40,"40168",34,27,27,0,0,"UPYD",1
40,"40154",21,13,13,0,0,"UPYD",0
40,"40086",698,591,580,11,11,"UPYD",6
40,"40013",65,51,50,0,1,"UPYD",2
40,"40122",514,416,403,0,13,"UPYD",10
40,"40062",60,50,49,0,1,"UPYD",0
40,"40191",222,163,161,2,2,"UPYD",0
40,"40004",472,371,368,2,3,"UPYD",2
40,"40903",91,68,68,1,0,"UPYD",1
40,"40063",7132,5389,5297,56,92,"UPYD",51
40,"40163",55,39,38,1,1,"UPYD",1
40,"40135",289,242,237,1,5,"UPYD",2
40,"40901",377,307,300,1,7,"UPYD",8
40,"40231",108,93,93,1,0,"UPYD",2
40,"40180",299,244,239,2,5,"UPYD",3
40,"40211",75,63,63,1,0,"UPYD",0
40,"40083",77,54,53,1,1,"UPYD",0
40,"40148",240,201,200,1,1,"UPYD",6
40,"40210",100,74,74,0,0,"UPYD",0
40,"40156",330,239,234,2,5,"UPYD",2
40,"40071",46,42,39,0,3,"UPYD",3
40,"40112",2525,2054,2034,18,20,"UPYD",44
40,"40904",353,307,307,2,0,"UPYD",4
40,"40070",147,111,107,1,4,"UPYD",1
40,"40113",428,345,341,5,4,"UPYD",8
40,"40101",874,672,669,11,3,"UPYD",11
40,"40203",895,722,716,6,6,"UPYD",13
40,"40016",57,47,45,0,2,"UPYD",0
40,"40031",515,417,413,2,4,"UPYD",7
40,"40184",253,210,210,3,0,"UPYD",7
40,"40172",44,29,29,0,0,"UPYD",1
40,"40002",37,33,33,1,0,"UPYD",0
40,"40130",130,108,107,1,1,"UPYD",0
40,"40026",113,106,106,0,0,"UPYD",2
40,"40152",763,637,627,1,10,"UPYD",20
40,"40109",75,49,46,1,3,"UPYD",0
40,"40119",170,142,140,0,2,"UPYD",0
40,"40034",81,62,62,0,0,"UPYD",1
40,"40221",49,42,41,0,1,"UPYD",0
40,"40144",19,15,15,0,0,"UPYD",1
40,"40159",141,104,104,0,0,"UPYD",0
40,"40199",106,83,83,0,0,"UPYD",4
40,"40035",140,109,108,3,1,"UPYD",2
40,"40097",124,105,105,0,0,"UPYD",1
40,"40218",97,69,69,0,0,"UPYD",0
40,"40192",157,130,128,1,2,"UPYD",0
40,"40126",85,65,63,0,2,"UPYD",0
40,"40069",84,67,67,0,0,"UPYD",0
40,"40233",419,340,336,2,4,"UPYD",3
40,"40216",755,628,621,7,7,"UPYD",6
40,"40008",46,38,38,0,0,"UPYD",0
40,"40140",97,72,71,8,1,"UPYD",1
40,"40129",179,143,138,2,5,"UPYD",1
40,"40902",125,102,102,0,0,"UPYD",3
40,"40091",116,89,89,0,0,"UPYD",0
40,"40040",2626,1847,1835,19,12,"UPYD",13
40,"40188",95,70,70,1,0,"UPYD",1
40,"40077",805,633,625,6,8,"UPYD",12
40,"40053",88,64,64,3,0,"UPYD",0
40,"40123",148,122,113,3,9,"UPYD",0
40,"40194",39796,30886,30516,287,370,"UPYD",563
40,"40019",37,32,31,0,1,"UPYD",0
40,"40111",61,51,51,0,0,"UPYD",1
40,"40073",405,345,339,4,6,"UPYD",6
40,"40110",349,272,272,1,0,"UPYD",2
40,"40225",1134,907,890,8,17,"UPYD",7
40,"40103",157,128,128,0,0,"UPYD",3
41,"41013",4842,3491,3461,22,30,"P-LIB",1
41,"41036",3971,2846,2806,14,40,"P-LIB",4
41,"41089",6504,4759,4691,51,68,"P-LIB",2
41,"41037",3203,2473,2449,18,24,"P-LIB",0
41,"41002",1469,1085,1061,12,24,"P-LIB",0
41,"41012",3286,2268,2235,15,33,"P-LIB",1
41,"41090",3541,2774,2721,17,53,"P-LIB",0
41,"41039",31674,23240,22982,196,258,"P-LIB",9
41,"41102",14635,10904,10655,148,249,"P-LIB",7
41,"41079",9343,7111,7029,68,82,"P-LIB",4
41,"41009",1229,811,803,5,8,"P-LIB",1
41,"41005",9057,6781,6693,58,88,"P-LIB",1
41,"41023",7919,5852,5788,34,64,"P-LIB",1
41,"41055",15009,10393,10292,82,101,"P-LIB",5
41,"41021",21249,15031,14854,152,177,"P-LIB",6
41,"41073",1715,1194,1169,9,25,"P-LIB",0
41,"41014",2510,1981,1958,8,23,"P-LIB",0
41,"41091",541928,401177,398212,3487,2965,"P-LIB",162
41,"41054",688,587,570,2,17,"P-LIB",0
41,"41029",13423,9979,9880,84,99,"P-LIB",2
41,"41067",7115,5248,5178,46,70,"P-LIB",1
41,"41003",2319,1782,1754,8,28,"P-LIB",0
41,"41051",2170,1650,1611,8,39,"P-LIB",0
41,"41078",2522,1888,1874,5,14,"P-LIB",1
41,"41028",1971,1574,1562,11,12,"P-LIB",1
41,"41020",12872,8820,8723,92,97,"P-LIB",1
41,"41008",1063,820,805,3,15,"P-LIB",0
41,"41076",2184,1442,1432,19,10,"P-LIB",0
41,"41058",17304,12982,12751,133,231,"P-LIB",179
41,"41026",4325,3551,3516,18,35,"P-LIB",1
41,"41032",4019,2943,2875,17,68,"P-LIB",1
41,"41042",5868,4612,4583,37,29,"P-LIB",2
41,"41098",4952,3762,3704,24,58,"P-LIB",2
41,"41070",6021,4504,4456,44,48,"P-LIB",1
41,"41030",516,409,395,2,14,"P-LIB",0
41,"41086",16102,10743,10665,93,78,"P-LIB",8
41,"41071",5620,3974,3898,17,76,"P-LIB",3
41,"41024",22662,15742,15521,137,221,"P-LIB",0
41,"41040",10411,7959,7892,53,67,"P-LIB",1
41,"41087",10202,7160,7033,51,127,"P-LIB",4
41,"41902",4675,3051,3019,20,32,"P-LIB",0
41,"41034",23033,15936,15711,189,225,"P-LIB",9
41,"41074",3033,2362,2341,8,21,"P-LIB",0
41,"41094",6288,4726,4653,36,73,"P-LIB",2
41,"41081",29164,21631,21410,218,221,"P-LIB",11
41,"41085",4086,3223,3178,31,45,"P-LIB",1
41,"41031",1257,838,836,8,2,"P-LIB",0
41,"41025",2041,1456,1430,17,26,"P-LIB",0
41,"41010",4394,3203,3160,19,43,"P-LIB",0
41,"41050",5158,4123,4078,37,45,"P-LIB",2
41,"41059",33977,26158,25965,230,193,"P-LIB",13
41,"41044",7392,5562,5526,40,36,"P-LIB",1
41,"41035",1112,887,876,5,11,"P-LIB",0
41,"41088",518,381,377,0,4,"P-LIB",0
41,"41015",5310,3799,3710,38,89,"P-LIB",2
41,"41069",29070,20827,20558,355,269,"P-LIB",10
41,"41038",99637,71611,71050,727,561,"P-LIB",31
41,"41041",9743,7620,7482,39,138,"P-LIB",0
41,"41056",3691,3069,3042,21,27,"P-LIB",0
41,"41075",10225,7387,7283,55,104,"P-LIB",4
41,"41011",15395,11527,11341,114,186,"P-LIB",1
41,"41061",2218,1769,1742,5,27,"P-LIB",0
41,"41082",3432,2809,2781,12,28,"P-LIB",0
41,"41048",2244,1625,1598,22,27,"P-LIB",0
41,"41096",6166,4811,4752,39,59,"P-LIB",1
41,"41093",18487,14687,14594,117,93,"P-LIB",2
41,"41072",4052,3115,3041,18,74,"P-LIB",1
41,"41097",3135,2339,2317,19,22,"P-LIB",0
41,"41060",15279,10611,10447,91,164,"P-LIB",3
41,"41066",1363,1019,1007,7,12,"P-LIB",1
41,"41062",2235,1805,1790,10,15,"P-LIB",0
41,"41033",5102,3655,3613,25,42,"P-LIB",2
41,"41006",2740,1909,1897,13,12,"P-LIB",1
41,"41080",1270,954,938,8,16,"P-LIB",1
41,"41901",2676,2222,2190,31,32,"P-LIB",0
41,"41068",13948,10269,10150,75,119,"P-LIB",6
41,"41077",8728,6423,6308,28,115,"P-LIB",0
41,"41053",21252,16022,15770,121,252,"P-LIB",3
41,"41017",15052,11074,10964,99,110,"P-LIB",4
41,"41001",1597,1262,1248,5,14,"P-LIB",2
41,"41027",3941,2766,2709,28,57,"P-LIB",2
41,"41019",4654,3267,3224,34,43,"P-LIB",2
41,"41064",5601,3766,3715,42,51,"P-LIB",3
41,"41092",7749,5715,5647,57,68,"P-LIB",1
41,"41084",2850,2205,2157,15,48,"P-LIB",0
41,"41063",2683,1942,1922,21,20,"P-LIB",0
41,"41052",3006,2264,2209,8,55,"P-LIB",1
41,"41903",6747,4926,4854,43,72,"P-LIB",1
41,"41018",9490,6997,6930,45,67,"P-LIB",3
41,"41099",3998,2597,2577,19,20,"P-LIB",0
41,"41057",275,193,191,0,2,"P-LIB",0
41,"41065",22868,15933,15784,172,149,"P-LIB",2
41,"41022",4300,2918,2891,30,27,"P-LIB",0
41,"41100",1025,770,751,5,19,"P-LIB",0
41,"41046",3017,2416,2381,12,35,"P-LIB",1
41,"41045",5749,4121,4066,49,55,"P-LIB",1
41,"41101",5932,4454,4421,27,33,"P-LIB",0
41,"41047",10086,7758,7663,80,95,"P-LIB",3
41,"41095",41137,28987,28731,302,256,"P-LIB",69
41,"41016",7310,5473,5410,50,63,"P-LIB",1
41,"41083",1154,893,888,3,5,"P-LIB",0
41,"41007",12386,8552,8403,90,149,"P-LIB",6
41,"41049",9301,7147,7070,63,77,"P-LIB",0
41,"41004",56552,40018,39623,515,395,"P-LIB",29
41,"41043",636,439,435,3,4,"P-LIB",1
26,"26126",31,29,29,0,0,"RECORTES CE",0
26,"26132",111,88,88,1,0,"RECORTES CE",0
26,"26068",82,68,66,0,2,"RECORTES CE",0
26,"26057",51,47,45,0,2,"RECORTES CE",0
26,"26094",85,71,68,0,3,"RECORTES CE",0
26,"26183",65,50,50,0,0,"RECORTES CE",0
26,"26178",80,64,63,1,1,"RECORTES CE",0
26,"26093",57,44,44,0,0,"RECORTES CE",0
26,"26072",289,259,258,2,1,"RECORTES CE",0
26,"26130",203,167,166,1,1,"RECORTES CE",0
26,"26120",1457,1144,1133,9,11,"RECORTES CE",2
26,"26063",122,97,96,0,1,"RECORTES CE",1
26,"26049",174,127,121,0,6,"RECORTES CE",0
26,"26046",1594,1221,1209,3,12,"RECORTES CE",0
26,"26048",22,22,21,0,1,"RECORTES CE",0
26,"26071",8477,6115,6029,51,86,"RECORTES CE",17
26,"26135",167,120,119,0,1,"RECORTES CE",2
26,"26059",1117,850,840,9,10,"RECORTES CE",0
26,"26149",61,48,48,0,0,"RECORTES CE",0
26,"26152",31,24,23,0,1,"RECORTES CE",0
26,"26161",7,7,7,0,0,"RECORTES CE",0
26,"26117",2168,1695,1662,19,33,"RECORTES CE",2
26,"26051",254,202,201,2,1,"RECORTES CE",1
26,"26065",50,40,40,0,0,"RECORTES CE",0
26,"26054",324,255,254,3,1,"RECORTES CE",0
26,"26106",88,78,78,0,0,"RECORTES CE",0
26,"26173",6,6,6,1,0,"RECORTES CE",0
26,"26066",265,217,209,3,8,"RECORTES CE",0
26,"26160",715,569,567,3,2,"RECORTES CE",4
26,"26114",80,71,71,2,0,"RECORTES CE",0
26,"26064",2278,1736,1715,17,21,"RECORTES CE",2
26,"26146",101,78,77,0,1,"RECORTES CE",0
26,"26136",103,73,72,1,1,"RECORTES CE",0
26,"26151",446,380,375,1,5,"RECORTES CE",0
26,"26004",68,53,53,1,0,"RECORTES CE",0
26,"26055",42,33,33,0,0,"RECORTES CE",1
26,"26180",221,182,179,0,3,"RECORTES CE",0
26,"26034",660,522,513,1,9,"RECORTES CE",0
26,"26101",46,34,34,0,0,"RECORTES CE",0
26,"26041",134,97,94,1,3,"RECORTES CE",0
26,"26036",16990,12136,11984,98,152,"RECORTES CE",28
26,"26095",101,78,77,1,1,"RECORTES CE",1
26,"26181",15,13,13,0,0,"RECORTES CE",0
26,"26104",14,9,9,0,0,"RECORTES CE",0
26,"26081",16,14,14,0,0,"RECORTES CE",0
26,"26045",12,12,12,0,0,"RECORTES CE",0
26,"26157",296,236,232,3,4,"RECORTES CE",0
26,"26113",37,34,32,0,2,"RECORTES CE",0
26,"26179",42,34,33,0,1,"RECORTES CE",0
26,"26170",448,346,344,8,2,"RECORTES CE",1
26,"26111",248,195,192,1,3,"RECORTES CE",0
26,"26167",59,45,45,1,0,"RECORTES CE",0
26,"26092",108,83,82,0,1,"RECORTES CE",0
26,"26145",245,202,201,3,1,"RECORTES CE",0
26,"26131",34,33,33,1,0,"RECORTES CE",0
26,"26176",54,46,43,1,3,"RECORTES CE",0
26,"26127",215,182,179,2,3,"RECORTES CE",0
26,"26014",466,319,319,0,0,"RECORTES CE",0
26,"26022",198,159,158,0,1,"RECORTES CE",0
26,"26141",112,85,83,1,2,"RECORTES CE",0
26,"26006",1809,1420,1410,14,10,"RECORTES CE",4
26,"26008",1862,1442,1425,7,17,"RECORTES CE",5
26,"26096",244,199,197,3,2,"RECORTES CE",0
26,"26082",109,92,89,0,3,"RECORTES CE",0
26,"26015",193,151,149,0,2,"RECORTES CE",0
26,"26150",117,98,98,1,0,"RECORTES CE",0
26,"26128",104,80,79,0,1,"RECORTES CE",1
26,"26099",1259,1038,1024,7,14,"RECORTES CE",0
26,"26086",15,15,15,0,0,"RECORTES CE",0
26,"26007",523,406,401,2,5,"RECORTES CE",0
26,"26019",351,282,281,1,1,"RECORTES CE",1
26,"26084",6630,5015,4952,27,63,"RECORTES CE",8
26,"26169",64,60,60,0,0,"RECORTES CE",0
26,"26103",789,626,616,3,10,"RECORTES CE",2
26,"26056",425,357,353,6,4,"RECORTES CE",1
26,"26142",780,618,613,1,5,"RECORTES CE",1
26,"26016",28,24,24,1,0,"RECORTES CE",0
26,"26091",166,141,138,0,3,"RECORTES CE",0
26,"26020",483,356,344,2,12,"RECORTES CE",0
26,"26148",171,147,145,0,2,"RECORTES CE",0
26,"26108",268,207,205,5,2,"RECORTES CE",0
26,"26058",150,114,113,0,1,"RECORTES CE",0
26,"26010",98,78,78,1,0,"RECORTES CE",0
26,"26050",117,86,86,0,0,"RECORTES CE",0
26,"26017",383,302,301,4,1,"RECORTES CE",0
26,"26069",240,201,199,0,2,"RECORTES CE",0
26,"26030",12,12,12,0,0,"RECORTES CE",0
26,"26171",179,136,126,1,10,"RECORTES CE",1
26,"26012",23,23,23,0,0,"RECORTES CE",0
26,"26053",208,161,160,1,1,"RECORTES CE",0
26,"26074",105,86,85,1,1,"RECORTES CE",0
26,"26038",95,66,65,0,1,"RECORTES CE",0
26,"26009",414,326,319,3,7,"RECORTES CE",1
26,"26021",2819,2113,2077,23,36,"RECORTES CE",2
26,"26138",4600,3374,3325,28,49,"RECORTES CE",5
26,"26100",52,43,43,0,0,"RECORTES CE",0
26,"26158",265,220,217,4,3,"RECORTES CE",0
26,"26018",10469,8216,8110,71,106,"RECORTES CE",9
26,"26102",6128,4673,4585,42,88,"RECORTES CE",3
26,"26125",2708,2013,1988,22,25,"RECORTES CE",0
26,"26098",94,72,71,1,1,"RECORTES CE",0
26,"26115",17,14,14,0,0,"RECORTES CE",0
26,"26023",468,358,355,4,3,"RECORTES CE",0
26,"26039",38,35,35,0,0,"RECORTES CE",0
26,"26067",23,20,20,0,0,"RECORTES CE",0
26,"26002",840,615,608,6,7,"RECORTES CE",0
26,"26061",1548,1179,1160,14,19,"RECORTES CE",1
26,"26060",85,67,67,1,0,"RECORTES CE",0
26,"26005",2343,1607,1590,19,17,"RECORTES CE",1
26,"26032",53,40,40,0,0,"RECORTES CE",0
26,"26163",143,117,117,2,0,"RECORTES CE",0
26,"26139",54,46,46,0,0,"RECORTES CE",0
26,"26073",98,83,83,0,0,"RECORTES CE",0
26,"26044",51,46,45,0,1,"RECORTES CE",0
26,"26165",364,315,311,1,4,"RECORTES CE",2
26,"26040",68,62,62,0,0,"RECORTES CE",0
26,"26076",128,111,110,2,1,"RECORTES CE",0
26,"26129",971,768,757,2,11,"RECORTES CE",1
26,"26028",133,112,111,0,1,"RECORTES CE",0
26,"26062",90,73,71,0,2,"RECORTES CE",0
26,"26087",208,157,154,4,3,"RECORTES CE",1
26,"26174",147,122,112,0,10,"RECORTES CE",0
26,"26078",83,68,68,0,0,"RECORTES CE",0
26,"26105",2187,1722,1696,16,26,"RECORTES CE",3
26,"26162",121,106,106,2,0,"RECORTES CE",1
26,"26042",836,645,635,5,10,"RECORTES CE",2
26,"26168",5318,3853,3802,36,51,"RECORTES CE",12
26,"26144",194,150,148,2,2,"RECORTES CE",0
26,"26001",197,163,155,3,8,"RECORTES CE",0
26,"26122",119,104,102,2,2,"RECORTES CE",0
26,"26037",131,111,111,1,0,"RECORTES CE",0
26,"26070",186,154,153,1,1,"RECORTES CE",0
26,"26147",30,26,26,0,0,"RECORTES CE",0
26,"26140",260,221,218,1,3,"RECORTES CE",0
26,"26119",202,163,162,4,1,"RECORTES CE",0
26,"26024",236,183,183,0,0,"RECORTES CE",0
26,"26112",243,192,191,1,1,"RECORTES CE",0
26,"26026",1323,1070,1060,8,10,"RECORTES CE",1
26,"26003",416,336,330,2,6,"RECORTES CE",0
26,"26134",87,65,65,1,0,"RECORTES CE",0
26,"26177",309,266,264,2,2,"RECORTES CE",0
26,"26172",30,25,25,0,0,"RECORTES CE",0
26,"26079",639,536,527,2,9,"RECORTES CE",0
26,"26043",373,284,282,4,2,"RECORTES CE",0
26,"26124",824,664,659,8,5,"RECORTES CE",0
26,"26121",27,21,21,0,0,"RECORTES CE",0
26,"26013",356,264,262,3,2,"RECORTES CE",1
26,"26118",61,49,49,1,0,"RECORTES CE",1
26,"26109",85,76,74,1,2,"RECORTES CE",1
26,"26164",61,41,41,0,0,"RECORTES CE",0
26,"26153",12,11,10,0,1,"RECORTES CE",0
26,"26155",162,138,137,0,1,"RECORTES CE",0
26,"26077",27,25,25,0,0,"RECORTES CE",0
26,"26143",217,178,177,0,1,"RECORTES CE",0
26,"26011",7336,5309,5255,57,54,"RECORTES CE",5
26,"26166",142,131,128,1,3,"RECORTES CE",0
26,"26047",1969,1614,1596,14,18,"RECORTES CE",1
26,"26083",289,213,213,1,0,"RECORTES CE",0
26,"26154",11,8,8,0,0,"RECORTES CE",0
26,"26089",110513,85146,84302,712,844,"RECORTES CE",217
26,"26123",130,111,108,0,3,"RECORTES CE",0
26,"26052",158,125,125,0,0,"RECORTES CE",0
26,"26027",157,127,127,1,0,"RECORTES CE",0
26,"26075",334,268,264,2,4,"RECORTES CE",0
26,"26025",85,71,71,1,0,"RECORTES CE",0
26,"26175",52,44,44,2,0,"RECORTES CE",0
26,"26033",172,143,142,2,1,"RECORTES CE",0
26,"26035",16,12,12,0,0,"RECORTES CE",0
26,"26088",36,32,31,0,1,"RECORTES CE",0
26,"26110",162,135,134,0,1,"RECORTES CE",0
26,"26107",92,75,75,0,0,"RECORTES CE",0
26,"26029",37,31,31,0,0,"RECORTES CE",0
26,"26031",106,81,81,0,0,"RECORTES CE",0
26,"26080",475,392,388,6,4,"RECORTES CE",0
23,"23050",91221,67753,67164,549,589,"IULV-CA,UPe",2107
23,"23080",1786,1347,1329,6,18,"IULV-CA,UPe",18
23,"23084",953,711,708,6,3,"IULV-CA,UPe",5
23,"23027",727,577,576,8,1,"IULV-CA,UPe",4
23,"23015",1393,1061,1052,3,9,"IULV-CA,UPe",22
23,"23018",2326,1678,1668,5,10,"IULV-CA,UPe",158
23,"23097",6445,4313,4290,30,23,"IULV-CA,UPe",97
23,"23032",575,461,457,1,4,"IULV-CA,UPe",12
23,"23066",4376,3530,3508,46,22,"IULV-CA,UPe",85
23,"23052",1138,977,971,6,6,"IULV-CA,UPe",24
23,"23060",19157,13567,13438,133,129,"IULV-CA,UPe",462
23,"23046",2405,1963,1934,3,29,"IULV-CA,UPe",56
23,"23004",435,350,346,0,4,"IULV-CA,UPe",5
23,"23016",396,323,318,3,5,"IULV-CA,UPe",27
23,"23079",3733,2994,2981,26,13,"IULV-CA,UPe",63
23,"23088",6124,4764,4703,31,61,"IULV-CA,UPe",258
23,"23081",1546,1145,1132,6,13,"IULV-CA,UPe",38
23,"23029",854,631,623,2,8,"IULV-CA,UPe",7
23,"23024",12512,9391,9182,79,209,"IULV-CA,UPe",295
23,"23054",382,276,275,0,1,"IULV-CA,UPe",5
23,"23090",1316,1077,1071,8,6,"IULV-CA,UPe",14
23,"23007",3102,2381,2369,8,12,"IULV-CA,UPe",62
23,"23070",3931,2549,2533,11,16,"IULV-CA,UPe",61
23,"23063",3845,2934,2898,24,36,"IULV-CA,UPe",113
23,"23056",3108,2365,2343,14,22,"IULV-CA,UPe",293
23,"23041",504,396,392,1,4,"IULV-CA,UPe",9
23,"23065",1601,1222,1207,0,15,"IULV-CA,UPe",20
23,"23037",516,427,423,1,4,"IULV-CA,UPe",7
23,"23039",2220,1658,1626,8,32,"IULV-CA,UPe",32
23,"23087",11313,8540,8454,64,86,"IULV-CA,UPe",1473
23,"23059",5856,4498,4450,33,48,"IULV-CA,UPe",121
23,"23049",1834,1384,1378,7,6,"IULV-CA,UPe",134
23,"23019",1562,1249,1227,4,22,"IULV-CA,UPe",166
23,"23069",5385,4406,4318,15,88,"IULV-CA,UPe",167
23,"23086",11537,8362,8242,91,120,"IULV-CA,UPe",475
23,"23057",771,648,648,4,0,"IULV-CA,UPe",101
23,"23058",8665,6651,6585,47,66,"IULV-CA,UPe",212
23,"23028",6203,4645,4585,33,60,"IULV-CA,UPe",159
23,"23031",751,662,650,9,12,"IULV-CA,UPe",31
23,"23901",1160,978,972,5,6,"IULV-CA,UPe",15
23,"23009",12866,9787,9667,64,120,"IULV-CA,UPe",382
23,"23008",1518,1185,1173,18,12,"IULV-CA,UPe",66
23,"23098",875,728,722,2,6,"IULV-CA,UPe",18
23,"23006",4636,3761,3714,25,47,"IULV-CA,UPe",96
23,"23076",837,672,658,4,14,"IULV-CA,UPe",8
23,"23047",1638,1311,1306,9,5,"IULV-CA,UPe",27
23,"23075",3319,2640,2618,21,22,"IULV-CA,UPe",112
23,"23091",742,609,607,5,2,"IULV-CA,UPe",7
23,"23040",1489,1226,1211,4,15,"IULV-CA,UPe",232
23,"23026",3636,2724,2685,11,39,"IULV-CA,UPe",47
23,"23902",2327,1877,1857,9,20,"IULV-CA,UPe",31
23,"23020",1584,1376,1366,5,10,"IULV-CA,UPe",327
23,"23077",637,515,514,3,1,"IULV-CA,UPe",10
23,"23099",4734,3509,3459,23,50,"IULV-CA,UPe",81
23,"23082",1924,1420,1413,6,7,"IULV-CA,UPe",56
23,"23071",1728,1337,1328,7,9,"IULV-CA,UPe",17
23,"23010",14371,10249,10140,65,109,"IULV-CA,UPe",214
23,"23093",3257,2534,2506,21,28,"IULV-CA,UPe",64
23,"23061",7520,5481,5405,55,76,"IULV-CA,UPe",77
23,"23005",30539,21840,21629,176,211,"IULV-CA,UPe",820
23,"23003",8709,6520,6440,42,80,"IULV-CA,UPe",116
23,"23048",860,636,630,1,6,"IULV-CA,UPe",7
23,"23042",299,220,220,1,0,"IULV-CA,UPe",3
23,"23011",2193,1616,1600,11,16,"IULV-CA,UPe",96
23,"23021",528,452,448,0,4,"IULV-CA,UPe",18
23,"23101",388,281,279,0,2,"IULV-CA,UPe",12
23,"23043",549,401,400,0,1,"IULV-CA,UPe",6
23,"23033",1356,1080,1065,8,15,"IULV-CA,UPe",17
23,"23903",3550,2742,2721,19,21,"IULV-CA,UPe",198
23,"23053",9526,6783,6736,49,47,"IULV-CA,UPe",588
23,"23072",2002,1593,1582,6,11,"IULV-CA,UPe",17
23,"23030",1232,1020,1007,10,13,"IULV-CA,UPe",9
23,"23096",2643,2174,2140,14,34,"IULV-CA,UPe",100
23,"23055",47421,33170,32908,213,262,"IULV-CA,UPe",1899
23,"23062",1461,1188,1181,1,7,"IULV-CA,UPe",13
23,"23001",993,826,820,1,6,"IULV-CA,UPe",10
23,"23051",2762,2258,2231,9,27,"IULV-CA,UPe",29
23,"23034",2558,1987,1977,18,10,"IULV-CA,UPe",27
23,"23073",4558,3427,3402,11,25,"IULV-CA,UPe",79
23,"23095",8737,6303,6268,34,35,"IULV-CA,UPe",156
23,"23044",4847,3801,3740,26,61,"IULV-CA,UPe",406
23,"23038",3557,2851,2831,11,20,"IULV-CA,UPe",87
23,"23092",27765,20688,20560,143,128,"IULV-CA,UPe",907
23,"23904",2852,1784,1764,14,20,"IULV-CA,UPe",47
23,"23012",4177,3016,2988,22,28,"IULV-CA,UPe",76
23,"23002",17450,13199,12986,92,213,"IULV-CA,UPe",473
23,"23094",3852,3097,3061,17,36,"IULV-CA,UPe",315
23,"23017",1584,1265,1253,4,12,"IULV-CA,UPe",39
23,"23014",2561,1982,1959,8,23,"IULV-CA,UPe",161
23,"23045",2139,1560,1551,9,9,"IULV-CA,UPe",277
23,"23025",2813,2186,2163,7,23,"IULV-CA,UPe",20
23,"23085",2273,1833,1814,3,19,"IULV-CA,UPe",35
23,"23067",2489,1869,1847,18,22,"IULV-CA,UPe",193
23,"23074",3030,2368,2353,12,15,"IULV-CA,UPe",126
23,"23905",1861,1351,1345,7,6,"IULV-CA,UPe",22
23,"23035",1095,871,867,8,4,"IULV-CA,UPe",18
23,"23064",1659,1368,1364,1,4,"IULV-CA,UPe",12
5,"5902",288,227,227,0,0,"IU-UPeC",5
5,"5218",121,97,95,0,2,"IU-UPeC",13
5,"5048",120,104,103,0,1,"IU-UPeC",2
5,"5022",1611,1279,1271,4,8,"IU-UPeC",17
5,"5104",34,23,22,1,1,"IU-UPeC",0
5,"5266",102,89,89,0,0,"IU-UPeC",0
5,"5243",88,61,61,1,0,"IU-UPeC",0
5,"5108",51,30,30,0,0,"IU-UPeC",0
5,"5174",69,55,55,1,0,"IU-UPeC",3
5,"5107",64,39,39,1,0,"IU-UPeC",0
5,"5242",681,538,527,10,11,"IU-UPeC",8
5,"5253",88,70,70,0,0,"IU-UPeC",3
5,"5140",116,97,96,0,1,"IU-UPeC",1
5,"5047",4199,3287,3244,7,43,"IU-UPeC",44
5,"5224",106,87,86,0,1,"IU-UPeC",4
5,"5129",129,78,78,0,0,"IU-UPeC",1
5,"5127",650,539,535,4,4,"IU-UPeC",15
5,"5249",107,82,82,0,0,"IU-UPeC",10
5,"5046",45,38,38,1,0,"IU-UPeC",0
5,"5204",611,473,471,1,2,"IU-UPeC",26
5,"5099",497,398,381,3,17,"IU-UPeC",2
5,"5134",48,40,40,0,0,"IU-UPeC",0
5,"5012",135,110,108,0,2,"IU-UPeC",1
5,"5181",43,31,31,1,0,"IU-UPeC",0
5,"5065",469,388,385,6,3,"IU-UPeC",5
5,"5166",188,135,134,1,1,"IU-UPeC",3
5,"5139",76,66,66,0,0,"IU-UPeC",1
5,"5229",84,67,67,0,0,"IU-UPeC",0
5,"5251",68,40,40,0,0,"IU-UPeC",1
5,"5115",532,392,386,2,6,"IU-UPeC",24
5,"5092",155,120,120,0,0,"IU-UPeC",7
5,"5008",227,180,176,2,4,"IU-UPeC",5
5,"5062",184,155,154,2,1,"IU-UPeC",1
5,"5258",113,98,97,0,1,"IU-UPeC",2
5,"5125",57,45,44,0,1,"IU-UPeC",0
5,"5119",33,20,20,0,0,"IU-UPeC",0
5,"5123",96,69,66,2,3,"IU-UPeC",3
5,"5168",3565,2740,2711,17,29,"IU-UPeC",42
5,"5254",196,166,166,0,0,"IU-UPeC",7
5,"5041",1001,772,765,10,7,"IU-UPeC",35
5,"5164",27,19,19,1,0,"IU-UPeC",0
5,"5165",380,291,283,5,8,"IU-UPeC",9
5,"5014",5422,4137,4084,30,53,"IU-UPeC",158
5,"5133",67,55,55,1,0,"IU-UPeC",4
5,"5227",373,250,248,0,2,"IU-UPeC",9
5,"5025",96,73,72,1,1,"IU-UPeC",3
5,"5215",169,126,122,2,4,"IU-UPeC",4
5,"5018",29,21,21,0,0,"IU-UPeC",2
5,"5089",478,377,365,0,12,"IU-UPeC",4
5,"5208",40,34,34,0,0,"IU-UPeC",3
5,"5182",801,559,546,9,13,"IU-UPeC",8
5,"5261",42,26,26,0,0,"IU-UPeC",1
5,"5122",144,115,113,1,2,"IU-UPeC",1
5,"5198",73,59,59,0,0,"IU-UPeC",0
5,"5257",140,98,98,0,0,"IU-UPeC",0
5,"5087",137,93,93,0,0,"IU-UPeC",2
5,"5197",98,90,90,0,0,"IU-UPeC",4
5,"5147",162,119,116,0,3,"IU-UPeC",5
5,"5903",157,108,107,0,1,"IU-UPeC",2
5,"5093",417,313,311,1,2,"IU-UPeC",14
5,"5024",231,169,163,5,6,"IU-UPeC",5
5,"5171",73,58,57,2,1,"IU-UPeC",1
5,"5106",36,27,27,0,0,"IU-UPeC",0
5,"5167",265,209,199,0,10,"IU-UPeC",19
5,"5026",197,170,169,1,1,"IU-UPeC",24
5,"5145",52,41,41,0,0,"IU-UPeC",0
5,"5084",74,56,56,1,0,"IU-UPeC",3
5,"5116",118,95,93,1,2,"IU-UPeC",2
5,"5231",160,126,124,1,2,"IU-UPeC",1
5,"5105",349,279,270,3,9,"IU-UPeC",13
5,"5054",1238,953,933,1,20,"IU-UPeC",32
5,"5904",133,92,91,1,1,"IU-UPeC",5
5,"5160",323,263,260,1,3,"IU-UPeC",11
5,"5219",39,28,28,0,0,"IU-UPeC",0
5,"5259",125,107,106,3,1,"IU-UPeC",9
5,"5067",83,66,59,1,7,"IU-UPeC",2
5,"5138",311,241,239,3,2,"IU-UPeC",7
5,"5121",241,186,185,3,1,"IU-UPeC",11
5,"5042",155,126,125,0,1,"IU-UPeC",0
5,"5905",214,150,150,1,0,"IU-UPeC",21
5,"5095",266,220,218,0,2,"IU-UPeC",21
5,"5233",226,179,177,0,2,"IU-UPeC",6
5,"5189",443,340,336,3,4,"IU-UPeC",9
5,"5086",82,66,64,1,2,"IU-UPeC",0
5,"5225",372,316,315,5,1,"IU-UPeC",7
5,"5901",273,187,185,5,2,"IU-UPeC",11
5,"5157",240,170,167,1,3,"IU-UPeC",12
5,"5035",107,84,84,1,0,"IU-UPeC",2
5,"5148",27,17,17,0,0,"IU-UPeC",1
5,"5056",96,73,73,0,0,"IU-UPeC",2
5,"5265",82,70,70,0,0,"IU-UPeC",0
5,"5083",145,108,100,2,8,"IU-UPeC",3
5,"5075",107,67,67,0,0,"IU-UPeC",1
5,"5120",35,26,26,0,0,"IU-UPeC",0
5,"5019",44606,34903,34564,285,339,"IU-UPeC",1728
5,"5221",353,270,264,3,6,"IU-UPeC",33
5,"5030",46,37,37,0,0,"IU-UPeC",7
5,"5036",123,97,97,0,0,"IU-UPeC",0
5,"5234",51,46,46,1,0,"IU-UPeC",4
5,"5238",787,565,556,4,9,"IU-UPeC",25
5,"5080",59,42,40,0,2,"IU-UPeC",1
5,"5213",101,83,83,0,0,"IU-UPeC",0
5,"5163",1756,1351,1345,1,6,"IU-UPeC",24
5,"5136",97,74,73,5,1,"IU-UPeC",3
5,"5151",93,70,70,1,0,"IU-UPeC",1
5,"5187",1755,1409,1395,11,14,"IU-UPeC",78
5,"5001",194,153,152,1,1,"IU-UPeC",3
5,"5045",95,70,70,0,0,"IU-UPeC",0
5,"5112",97,72,70,1,2,"IU-UPeC",1
5,"5206",29,22,21,0,1,"IU-UPeC",0
5,"5013",876,733,723,2,10,"IU-UPeC",12
5,"5222",159,126,126,0,0,"IU-UPeC",4
5,"5085",38,29,29,0,0,"IU-UPeC",0
5,"5172",123,104,102,2,2,"IU-UPeC",4
5,"5244",51,38,38,0,0,"IU-UPeC",1
5,"5152",690,561,558,3,3,"IU-UPeC",9
5,"5192",100,82,81,1,1,"IU-UPeC",4
5,"5113",78,58,58,1,0,"IU-UPeC",0
5,"5156",249,163,161,0,2,"IU-UPeC",4
5,"5143",66,55,55,1,0,"IU-UPeC",4
5,"5245",348,293,288,0,5,"IU-UPeC",12
5,"5185",94,80,80,1,0,"IU-UPeC",1
5,"5082",528,437,427,5,10,"IU-UPeC",6
5,"5237",164,131,126,1,5,"IU-UPeC",4
5,"5090",84,69,68,1,1,"IU-UPeC",1
5,"5130",95,82,82,0,0,"IU-UPeC",4
5,"5260",104,84,83,1,1,"IU-UPeC",3
5,"5193",194,163,163,1,0,"IU-UPeC",1
5,"5079",70,54,54,0,0,"IU-UPeC",1
5,"5216",224,155,155,2,0,"IU-UPeC",1
5,"5126",70,59,59,0,0,"IU-UPeC",0
5,"5061",253,198,196,4,2,"IU-UPeC",12
5,"5175",159,130,130,0,0,"IU-UPeC",0
5,"5200",49,28,28,0,0,"IU-UPeC",0
5,"5220",382,298,294,1,4,"IU-UPeC",4
5,"5070",32,26,26,0,0,"IU-UPeC",0
5,"5040",68,45,45,0,0,"IU-UPeC",1
5,"5205",75,58,58,0,0,"IU-UPeC",0
5,"5217",58,45,45,0,0,"IU-UPeC",0
5,"5170",52,46,46,0,0,"IU-UPeC",3
5,"5021",1932,1478,1456,12,22,"IU-UPeC",71
5,"5016",6335,4873,4775,39,98,"IU-UPeC",213
5,"5005",187,150,149,0,1,"IU-UPeC",4
5,"5247",250,147,146,1,1,"IU-UPeC",6
5,"5049",399,301,291,1,10,"IU-UPeC",11
5,"5263",172,137,137,0,0,"IU-UPeC",3
5,"5236",128,85,84,0,1,"IU-UPeC",2
5,"5159",254,175,174,2,1,"IU-UPeC",1
5,"5180",88,68,68,1,0,"IU-UPeC",1
5,"5066",458,365,364,3,1,"IU-UPeC",26
5,"5103",78,56,56,0,0,"IU-UPeC",2
5,"5017",85,75,75,0,0,"IU-UPeC",4
5,"5128",350,289,284,4,5,"IU-UPeC",30
5,"5007",113,74,74,1,0,"IU-UPeC",0
5,"5211",465,375,373,2,2,"IU-UPeC",5
5,"5232",98,83,81,1,2,"IU-UPeC",3
5,"5081",39,33,31,0,2,"IU-UPeC",1
5,"5117",201,178,174,2,4,"IU-UPeC",2
5,"5118",84,57,57,0,0,"IU-UPeC",2
5,"5153",108,78,77,3,1,"IU-UPeC",3
5,"5034",15,12,12,1,0,"IU-UPeC",2
5,"5100",285,229,228,0,1,"IU-UPeC",9
5,"5241",3081,2143,2115,17,28,"IU-UPeC",113
5,"5201",529,439,431,2,8,"IU-UPeC",17
5,"5256",116,92,92,1,0,"IU-UPeC",2
5,"5039",56,43,42,0,1,"IU-UPeC",0
5,"5010",149,119,118,1,1,"IU-UPeC",3
5,"5173",60,45,45,0,0,"IU-UPeC",1
5,"5161",586,483,473,2,10,"IU-UPeC",14
5,"5015",87,66,65,1,1,"IU-UPeC",1
5,"5194",138,122,121,5,1,"IU-UPeC",1
5,"5239",207,163,162,1,1,"IU-UPeC",4
5,"5179",215,184,180,0,4,"IU-UPeC",2
5,"5072",87,70,69,1,1,"IU-UPeC",3
5,"5043",84,67,67,0,0,"IU-UPeC",6
5,"5023",173,153,153,5,0,"IU-UPeC",0
5,"5077",161,137,136,2,1,"IU-UPeC",1
5,"5209",83,63,63,0,0,"IU-UPeC",2
5,"5246",60,42,42,0,0,"IU-UPeC",1
5,"5044",259,180,180,0,0,"IU-UPeC",3
5,"5053",86,58,58,0,0,"IU-UPeC",2
5,"5230",65,56,54,1,2,"IU-UPeC",2
5,"5226",77,57,57,0,0,"IU-UPeC",0
5,"5235",124,111,110,1,1,"IU-UPeC",4
5,"5142",104,88,82,1,6,"IU-UPeC",5
5,"5240",3393,2354,2335,9,19,"IU-UPeC",97
5,"5114",1359,1131,1115,5,16,"IU-UPeC",10
5,"5135",425,325,322,1,3,"IU-UPeC",3
5,"5088",33,24,24,0,0,"IU-UPeC",0
5,"5207",697,553,548,0,5,"IU-UPeC",15
5,"5210",85,72,72,1,0,"IU-UPeC",0
5,"5196",53,39,39,0,0,"IU-UPeC",0
5,"5055",576,476,467,0,9,"IU-UPeC",4
5,"5132",992,678,672,2,6,"IU-UPeC",28
5,"5038",116,87,85,0,2,"IU-UPeC",1
5,"5094",140,110,110,0,0,"IU-UPeC",2
5,"5059",109,79,76,1,3,"IU-UPeC",1
5,"5212",233,157,155,1,2,"IU-UPeC",6
5,"5162",87,60,60,2,0,"IU-UPeC",5
5,"5097",474,324,317,3,7,"IU-UPeC",4
5,"5169",226,178,176,1,2,"IU-UPeC",1
5,"5096",79,57,57,0,0,"IU-UPeC",0
5,"5101",316,240,238,1,2,"IU-UPeC",4
5,"5109",454,378,362,3,16,"IU-UPeC",14
5,"5177",160,128,128,1,0,"IU-UPeC",3
5,"5060",120,99,99,1,0,"IU-UPeC",1
5,"5052",99,89,88,0,1,"IU-UPeC",2
5,"5078",115,100,99,3,1,"IU-UPeC",1
5,"5264",62,43,42,1,1,"IU-UPeC",3
5,"5178",371,295,289,0,6,"IU-UPeC",6
5,"5058",78,55,55,2,0,"IU-UPeC",3
5,"5141",95,86,86,2,0,"IU-UPeC",1
5,"5074",693,543,540,1,3,"IU-UPeC",6
5,"5057",2470,1977,1953,14,24,"IU-UPeC",44
5,"5149",105,76,75,0,1,"IU-UPeC",2
5,"5191",126,104,104,1,0,"IU-UPeC",14
5,"5183",140,114,113,1,1,"IU-UPeC",1
5,"5195",224,162,161,1,1,"IU-UPeC",9
5,"5102",1807,1431,1412,7,19,"IU-UPeC",43
5,"5063",34,24,24,0,0,"IU-UPeC",0
5,"5188",45,38,38,0,0,"IU-UPeC",0
5,"5131",105,70,69,1,1,"IU-UPeC",0
5,"5076",481,401,387,5,14,"IU-UPeC",17
5,"5184",250,197,192,0,5,"IU-UPeC",5
5,"5267",100,65,64,0,1,"IU-UPeC",5
5,"5262",358,278,277,1,1,"IU-UPeC",3
5,"5051",181,152,147,3,5,"IU-UPeC",9
5,"5176",234,190,187,2,3,"IU-UPeC",6
5,"5069",74,58,58,0,0,"IU-UPeC",1
5,"5214",38,27,26,0,1,"IU-UPeC",2
5,"5124",107,83,81,1,2,"IU-UPeC",0
5,"5064",103,87,87,1,0,"IU-UPeC",1
5,"5154",36,30,30,0,0,"IU-UPeC",0
5,"5002",1954,1471,1450,9,21,"IU-UPeC",62
5,"5186",1572,1240,1222,9,18,"IU-UPeC",32
5,"5252",64,45,45,0,0,"IU-UPeC",0
5,"5190",55,42,42,2,0,"IU-UPeC",0
5,"5144",79,62,60,2,2,"IU-UPeC",0
5,"5155",52,37,37,0,0,"IU-UPeC",4
5,"5029",123,92,89,0,3,"IU-UPeC",0
5,"5037",261,165,163,3,2,"IU-UPeC",5
5,"5199",39,32,32,0,0,"IU-UPeC",2
5,"5073",297,243,238,4,5,"IU-UPeC",7
5,"5027",269,220,218,2,2,"IU-UPeC",9
5,"5228",179,126,126,0,0,"IU-UPeC",0
5,"5033",174,139,138,0,1,"IU-UPeC",4
5,"5158",371,289,287,1,2,"IU-UPeC",7
5,"5110",721,559,552,3,7,"IU-UPeC",9
19,"19145",48,42,42,2,0,"UPYD",0
19,"19330",71,64,64,0,0,"UPYD",1
19,"19046",21452,16321,16151,91,170,"UPYD",158
19,"19138",272,197,196,0,1,"UPYD",1
19,"19092",417,316,312,4,4,"UPYD",1
19,"19262",139,111,109,0,2,"UPYD",1
19,"19183",83,74,73,0,1,"UPYD",1
19,"19208",43,31,31,0,0,"UPYD",0
19,"19045",145,119,117,1,2,"UPYD",0
19,"19308",65,54,54,0,0,"UPYD",1
19,"19193",23,22,21,0,1,"UPYD",0
19,"19285",25,16,16,2,0,"UPYD",0
19,"19178",39,25,25,0,0,"UPYD",0
19,"19136",18,15,15,0,0,"UPYD",0
19,"19031",15,10,9,0,1,"UPYD",0
19,"19286",725,557,551,1,6,"UPYD",3
19,"19073",24,19,19,0,0,"UPYD",0
19,"19050",15,13,13,0,0,"UPYD",0
19,"19118",13,10,10,0,0,"UPYD",0
19,"19044",309,248,246,3,2,"UPYD",0
19,"19263",27,17,15,0,2,"UPYD",1
19,"19255",78,61,61,0,0,"UPYD",0
19,"19152",589,448,439,2,9,"UPYD",2
19,"19306",28,20,20,0,0,"UPYD",0
19,"19091",29,20,20,0,0,"UPYD",0
19,"19064",73,62,62,0,0,"UPYD",0
19,"19251",42,29,28,0,1,"UPYD",0
19,"19021",1051,788,774,7,14,"UPYD",3
19,"19160",899,601,597,2,4,"UPYD",5
19,"19003",41,37,35,0,2,"UPYD",0
19,"19061",56,47,47,0,0,"UPYD",0
19,"19041",160,133,132,0,1,"UPYD",0
19,"19146",42,34,34,0,0,"UPYD",1
19,"19086",1495,1158,1149,7,9,"UPYD",1
19,"19329",58,49,49,0,0,"UPYD",0
19,"19110",57,46,45,2,1,"UPYD",0
19,"19300",762,628,624,3,4,"UPYD",3
19,"19216",134,97,97,0,0,"UPYD",1
19,"19231",12,8,8,1,0,"UPYD",0
19,"19076",31,20,20,0,0,"UPYD",0
19,"19217",59,39,37,0,2,"UPYD",0
19,"19065",127,103,102,1,1,"UPYD",0
19,"19281",22,18,18,0,0,"UPYD",0
19,"19226",48,35,35,0,0,"UPYD",0
19,"19240",52,38,37,0,1,"UPYD",0
19,"19020",43,27,26,2,1,"UPYD",0
19,"19001",53,36,36,1,0,"UPYD",0
19,"19269",100,80,79,0,1,"UPYD",1
19,"19214",74,54,54,0,0,"UPYD",0
19,"19133",86,73,73,1,0,"UPYD",0
19,"19213",72,53,51,0,2,"UPYD",0
19,"19220",2305,1613,1600,9,13,"UPYD",9
19,"19122",93,72,72,3,0,"UPYD",3
19,"19237",47,35,34,1,1,"UPYD",0
19,"19192",1723,1354,1342,9,12,"UPYD",5
19,"19241",46,35,35,1,0,"UPYD",0
19,"19157",57,45,45,0,0,"UPYD",1
19,"19057",72,53,52,0,1,"UPYD",0
19,"19036",271,230,229,1,1,"UPYD",0
19,"19233",91,71,71,1,0,"UPYD",2
19,"19079",8,7,7,0,0,"UPYD",0
19,"19331",2611,2010,1982,18,28,"UPYD",17
19,"19134",26,18,18,0,0,"UPYD",0
19,"19059",79,60,59,0,1,"UPYD",0
19,"19209",40,28,27,1,1,"UPYD",1
19,"19250",21,16,15,0,1,"UPYD",0
19,"19229",69,60,60,1,0,"UPYD",0
19,"19186",81,63,63,1,0,"UPYD",0
19,"19155",66,54,53,0,1,"UPYD",1
19,"19176",237,181,181,0,0,"UPYD",0
19,"19103",255,205,201,0,4,"UPYD",0
19,"19287",144,109,109,0,0,"UPYD",2
19,"19151",1075,779,764,5,15,"UPYD",1
19,"19139",31,23,23,1,0,"UPYD",0
19,"19203",31,25,25,0,0,"UPYD",0
19,"19189",120,91,90,2,1,"UPYD",0
19,"19153",23,22,22,0,0,"UPYD",0
19,"19170",193,140,140,0,0,"UPYD",0
19,"19166",158,125,124,0,1,"UPYD",3
19,"19195",40,30,26,1,4,"UPYD",0
19,"19265",136,104,104,0,0,"UPYD",0
19,"19121",257,209,208,0,1,"UPYD",0
19,"19184",75,48,46,0,2,"UPYD",0
19,"19161",218,151,151,1,0,"UPYD",0
19,"19016",64,42,42,0,0,"UPYD",0
19,"19060",150,115,114,1,1,"UPYD",0
19,"19249",31,27,27,0,0,"UPYD",0
19,"19005",95,71,69,1,2,"UPYD",0
19,"19098",21,20,20,0,0,"UPYD",0
19,"19052",27,18,18,1,0,"UPYD",0
19,"19277",18,12,12,0,0,"UPYD",2
19,"19290",853,568,560,3,8,"UPYD",5
19,"19066",61,49,47,0,2,"UPYD",0
19,"19132",93,74,74,0,0,"UPYD",0
19,"19106",92,67,64,0,3,"UPYD",1
19,"19314",52,35,34,1,1,"UPYD",0
19,"19017",69,56,56,0,0,"UPYD",2
19,"19048",17,10,10,1,0,"UPYD",0
19,"19067",70,51,50,2,1,"UPYD",0
19,"19278",29,28,28,2,0,"UPYD",0
19,"19225",835,645,638,2,7,"UPYD",2
19,"19040",51,41,41,0,0,"UPYD",1
19,"19037",146,113,113,1,0,"UPYD",1
19,"19282",161,115,112,0,3,"UPYD",0
19,"19198",17,10,10,0,0,"UPYD",0
19,"19097",17,13,13,0,0,"UPYD",0
19,"19022",632,477,468,3,9,"UPYD",1
19,"19326",1749,1248,1237,5,11,"UPYD",21
19,"19119",81,71,71,0,0,"UPYD",1
19,"19080",73,51,50,0,1,"UPYD",0
19,"19023",117,101,99,1,2,"UPYD",1
19,"19291",1215,883,868,0,15,"UPYD",5
19,"19182",39,28,27,0,1,"UPYD",0
19,"19070",79,59,59,0,0,"UPYD",0
19,"19104",18,13,13,1,0,"UPYD",0
19,"19168",297,227,224,2,3,"UPYD",1
19,"19323",42,33,33,0,0,"UPYD",0
19,"19302",58,45,45,1,0,"UPYD",0
19,"19088",84,68,68,0,0,"UPYD",0
19,"19009",261,193,190,5,3,"UPYD",0
19,"19234",46,38,38,0,0,"UPYD",0
19,"19142",260,189,186,2,3,"UPYD",0
19,"19274",895,673,664,8,9,"UPYD",1
19,"19223",110,76,76,3,0,"UPYD",1
19,"19333",121,86,83,2,3,"UPYD",1
19,"19324",179,136,135,0,1,"UPYD",1
19,"19038",28,23,23,0,0,"UPYD",0
19,"19010",9,9,9,0,0,"UPYD",0
19,"19298",64,49,49,0,0,"UPYD",1
19,"19095",12,10,10,0,0,"UPYD",0
19,"19114",39,26,26,0,0,"UPYD",0
19,"19043",80,74,72,0,2,"UPYD",0
19,"19228",29,21,20,0,1,"UPYD",0
19,"19232",79,60,59,1,1,"UPYD",0
19,"19307",25,23,23,1,0,"UPYD",0
19,"19212",727,562,551,8,11,"UPYD",3
19,"19201",59,51,51,1,0,"UPYD",1
19,"19224",93,80,80,0,0,"UPYD",0
19,"19034",22,18,18,0,0,"UPYD",0
19,"19011",254,191,191,2,0,"UPYD",4
19,"19325",128,89,88,0,1,"UPYD",0
19,"19090",97,77,77,1,0,"UPYD",0
19,"19127",89,56,56,0,0,"UPYD",0
19,"19096",93,66,66,0,0,"UPYD",0
19,"19202",13,12,12,0,0,"UPYD",0
19,"19172",55,44,44,0,0,"UPYD",1
19,"19123",44,38,38,0,0,"UPYD",0
19,"19150",126,94,93,0,1,"UPYD",0
19,"19058",6786,5451,5415,29,36,"UPYD",48
19,"19087",18,17,17,0,0,"UPYD",0
19,"19256",44,35,35,0,0,"UPYD",0
19,"19268",36,26,25,0,1,"UPYD",0
19,"19053",2024,1479,1464,13,15,"UPYD",3
19,"19177",78,60,57,1,3,"UPYD",0
19,"19310",11,7,7,0,0,"UPYD",0
19,"19332",93,68,68,0,0,"UPYD",2
19,"19032",175,131,124,1,7,"UPYD",1
19,"19199",19,16,16,1,0,"UPYD",0
19,"19243",43,36,36,0,0,"UPYD",0
19,"19327",431,348,342,3,6,"UPYD",1
19,"19108",112,90,90,1,0,"UPYD",1
19,"19024",8143,6017,5944,33,73,"UPYD",64
19,"19191",13,12,12,0,0,"UPYD",0
19,"19252",67,58,58,0,0,"UPYD",0
19,"19293",1868,1379,1364,9,15,"UPYD",12
19,"19244",81,61,59,2,2,"UPYD",0
19,"19319",4425,3336,3304,21,32,"UPYD",25
19,"19211",394,297,291,1,6,"UPYD",1
19,"19188",50,34,32,1,2,"UPYD",0
19,"19167",132,106,103,0,3,"UPYD",0
19,"19258",97,73,73,1,0,"UPYD",0
19,"19204",154,106,106,3,0,"UPYD",0
19,"19270",22,18,18,0,0,"UPYD",0
19,"19082",85,62,62,0,0,"UPYD",0
19,"19148",45,37,37,1,0,"UPYD",0
19,"19078",53,44,44,0,0,"UPYD",0
19,"19102",101,84,84,0,0,"UPYD",0
19,"19267",19,12,12,0,0,"UPYD",0
19,"19321",38,26,26,0,0,"UPYD",0
19,"19154",66,52,51,0,1,"UPYD",0
19,"19246",46,36,36,0,0,"UPYD",1
19,"19126",1620,1242,1216,5,26,"UPYD",7
19,"19074",73,63,63,0,0,"UPYD",0
19,"19008",37,28,28,0,0,"UPYD",0
19,"19159",94,77,77,0,0,"UPYD",0
19,"19112",57,49,49,0,0,"UPYD",2
19,"19322",31,26,26,0,0,"UPYD",0
19,"19248",83,66,66,1,0,"UPYD",4
19,"19042",26,25,25,0,0,"UPYD",1
19,"19018",163,122,119,2,3,"UPYD",2
19,"19049",12,11,11,0,0,"UPYD",1
19,"19004",66,51,50,1,1,"UPYD",0
19,"19222",115,87,86,1,1,"UPYD",1
19,"19194",98,68,66,0,2,"UPYD",1
19,"19169",43,36,36,0,0,"UPYD",2
19,"19210",21,19,19,2,0,"UPYD",0
19,"19260",41,38,38,1,0,"UPYD",0
19,"19075",63,37,36,0,1,"UPYD",0
19,"19171",4884,3824,3778,24,46,"UPYD",46
19,"19019",19,17,16,0,1,"UPYD",1
19,"19055",53,34,33,2,1,"UPYD",1
19,"19051",70,65,65,0,0,"UPYD",0
19,"19125",45,40,40,0,0,"UPYD",1
19,"19109",43,32,32,3,0,"UPYD",0
19,"19033",64,49,49,3,0,"UPYD",0
19,"19196",106,86,80,0,6,"UPYD",0
19,"19215",165,142,141,0,1,"UPYD",1
19,"19294",23,19,19,1,0,"UPYD",0
19,"19130",59955,47034,46504,383,530,"UPYD",357
19,"19303",46,39,38,0,1,"UPYD",0
19,"19006",768,545,538,0,7,"UPYD",2
19,"19296",30,21,21,0,0,"UPYD",0
19,"19289",28,21,21,0,0,"UPYD",0
19,"19054",190,165,163,3,2,"UPYD",0
19,"19179",72,52,52,1,0,"UPYD",0
19,"19200",75,53,53,1,0,"UPYD",0
19,"19245",1179,913,893,6,20,"UPYD",1
19,"19047",67,60,60,1,0,"UPYD",0
19,"19129",29,25,25,0,0,"UPYD",0
19,"19185",31,18,18,0,0,"UPYD",0
19,"19238",42,32,31,2,1,"UPYD",1
19,"19259",28,18,18,0,0,"UPYD",0
19,"19271",47,30,30,0,0,"UPYD",0
19,"19242",93,66,62,2,4,"UPYD",0
19,"19318",25,19,19,0,0,"UPYD",0
19,"19120",104,92,92,1,0,"UPYD",0
19,"19266",241,201,199,2,2,"UPYD",0
19,"19099",299,206,205,1,1,"UPYD",1
19,"19288",23,22,22,0,0,"UPYD",0
19,"19297",31,21,21,1,0,"UPYD",0
19,"19173",47,40,37,0,3,"UPYD",0
19,"19156",983,743,735,5,8,"UPYD",3
19,"19115",24,14,14,1,0,"UPYD",0
19,"19305",162,129,128,1,1,"UPYD",4
19,"19247",148,106,102,1,4,"UPYD",1
19,"19264",38,29,29,0,0,"UPYD",0
19,"19230",504,383,376,4,7,"UPYD",5
19,"19089",28,17,17,0,0,"UPYD",1
19,"19027",148,116,115,1,1,"UPYD",0
19,"19124",382,256,253,0,3,"UPYD",2
19,"19162",65,49,49,0,0,"UPYD",1
19,"19254",49,36,36,1,0,"UPYD",0
19,"19071",7746,5748,5678,34,70,"UPYD",37
19,"19261",38,25,25,0,0,"UPYD",1
19,"19039",60,55,54,1,1,"UPYD",1
19,"19280",3451,2620,2581,14,39,"UPYD",13
19,"19081",31,21,21,0,0,"UPYD",0
19,"19235",97,63,62,0,1,"UPYD",0
19,"19219",13,9,9,0,0,"UPYD",0
19,"19227",74,49,49,0,0,"UPYD",1
19,"19002",73,56,54,0,2,"UPYD",0
19,"19197",25,20,20,0,0,"UPYD",0
19,"19304",220,161,161,1,0,"UPYD",0
19,"19015",81,68,68,0,0,"UPYD",0
19,"19334",36,30,29,0,1,"UPYD",0
19,"19284",10,8,8,0,0,"UPYD",0
19,"19181",55,37,37,0,0,"UPYD",0
19,"19279",57,54,54,0,0,"UPYD",0
19,"19013",128,106,106,0,0,"UPYD",2
19,"19143",1733,1371,1352,9,19,"UPYD",6
19,"19311",83,58,57,0,1,"UPYD",0
19,"19299",95,74,74,1,0,"UPYD",0
19,"19165",48,40,40,0,0,"UPYD",0
19,"19221",50,35,35,0,0,"UPYD",0
19,"19175",34,26,26,1,0,"UPYD",0
19,"19163",61,44,43,1,1,"UPYD",0
19,"19272",72,59,59,1,0,"UPYD",0
19,"19117",1580,1183,1167,11,16,"UPYD",11
19,"19283",29,23,23,0,0,"UPYD",0
19,"19218",52,35,34,0,1,"UPYD",0
19,"19147",46,34,33,0,1,"UPYD",0
19,"19187",50,46,44,0,2,"UPYD",0
19,"19309",26,22,22,0,0,"UPYD",0
19,"19105",2332,1809,1794,11,15,"UPYD",23
19,"19174",111,79,78,0,1,"UPYD",0
19,"19190",2405,1852,1833,14,19,"UPYD",9
19,"19007",479,364,360,2,4,"UPYD",0
19,"19257",3446,2532,2499,36,33,"UPYD",15
19,"19301",38,30,30,0,0,"UPYD",0
19,"19116",13,11,11,0,0,"UPYD",0
19,"19901",41,37,36,1,1,"UPYD",2
19,"19317",141,107,103,0,4,"UPYD",0
19,"19111",158,123,121,0,2,"UPYD",0
19,"19239",100,70,69,1,1,"UPYD",0
19,"19113",471,365,365,2,0,"UPYD",1
19,"19335",54,45,45,0,0,"UPYD",1
19,"19107",302,262,260,0,2,"UPYD",0
19,"19135",105,82,82,0,0,"UPYD",0
11,"11029",5433,3112,3067,27,45,"PCPE",11
11,"11018",1485,1109,1090,10,19,"PCPE",1
11,"11009",602,426,422,5,4,"PCPE",0
11,"11040",398,326,317,3,9,"PCPE",0
11,"11027",68010,46675,46322,400,353,"PCPE",55
11,"11039",10044,6684,6623,98,61,"PCPE",10
11,"11033",20773,13487,13333,171,154,"PCPE",24
11,"11038",13803,10593,10441,121,152,"PCPE",12
11,"11006",24504,16649,16486,176,163,"PCPE",27
11,"11013",2324,1687,1653,16,34,"PCPE",1
11,"11015",62337,40342,40012,407,330,"PCPE",39
11,"11010",6420,4423,4362,63,61,"PCPE",4
11,"11023",9354,6990,6928,86,62,"PCPE",2
11,"11042",1189,877,868,5,9,"PCPE",2
11,"11011",1688,1239,1205,14,34,"PCPE",0
11,"11025",4370,3174,3123,29,51,"PCPE",5
11,"11012",100460,72741,72128,590,613,"PCPE",70
11,"11005",4560,3203,3143,21,60,"PCPE",1
11,"11014",16791,11255,11146,166,109,"PCPE",11
11,"11003",1270,907,899,12,8,"PCPE",2
11,"11036",694,439,437,13,2,"PCPE",0
11,"11020",165400,113865,113092,1184,773,"PCPE",132
11,"11008",17460,11800,11615,151,185,"PCPE",15
11,"11002",4287,3245,3238,15,7,"PCPE",4
11,"11031",76452,51850,51456,568,394,"PCPE",46
11,"11004",88617,55218,54733,581,485,"PCPE",73
11,"11037",5678,4491,4426,20,65,"PCPE",11
11,"11016",14880,9945,9848,124,97,"PCPE",13
11,"11034",2345,1606,1594,10,12,"PCPE",2
11,"11035",13569,9000,8908,93,92,"PCPE",16
11,"11019",1830,1413,1371,5,42,"PCPE",4
11,"11024",6735,5114,5065,33,49,"PCPE",8
11,"11022",48778,26546,26333,277,213,"PCPE",31
11,"11901",5653,4132,4088,84,44,"PCPE",7
11,"11041",9856,7043,6967,85,76,"PCPE",5
11,"11007",18036,10832,10678,181,154,"PCPE",26
11,"11032",53898,32432,32172,371,260,"PCPE",47
11,"11902",3619,2431,2410,17,21,"PCPE",1
11,"11021",6777,4826,4779,52,47,"PCPE",7
11,"11017",3207,2389,2362,28,27,"PCPE",0
11,"11028",32532,23191,22981,274,210,"PCPE",23
11,"11001",4377,2949,2900,17,49,"PCPE",6
11,"11030",22796,15377,15222,145,155,"PCPE",19
11,"11026",4804,3581,3511,31,70,"PCPE",5
19,"19189",120,91,90,2,1,"VOX",0
19,"19194",98,68,66,0,2,"VOX",1
19,"19228",29,21,20,0,1,"VOX",0
19,"19011",254,191,191,2,0,"VOX",0
19,"19115",24,14,14,1,0,"VOX",0
19,"19221",50,35,35,0,0,"VOX",0
19,"19036",271,230,229,1,1,"VOX",0
19,"19178",39,25,25,0,0,"VOX",0
19,"19018",163,122,119,2,3,"VOX",0
19,"19270",22,18,18,0,0,"VOX",1
19,"19279",57,54,54,0,0,"VOX",0
19,"19050",15,13,13,0,0,"VOX",0
19,"19061",56,47,47,0,0,"VOX",1
19,"19290",853,568,560,3,8,"VOX",4
19,"19331",2611,2010,1982,18,28,"VOX",5
19,"19182",39,28,27,0,1,"VOX",0
19,"19017",69,56,56,0,0,"VOX",0
19,"19310",11,7,7,0,0,"VOX",0
19,"19238",42,32,31,2,1,"VOX",0
19,"19244",81,61,59,2,2,"VOX",0
19,"19099",299,206,205,1,1,"VOX",2
19,"19127",89,56,56,0,0,"VOX",0
19,"19143",1733,1371,1352,9,19,"VOX",3
19,"19021",1051,788,774,7,14,"VOX",1
19,"19013",128,106,106,0,0,"VOX",0
19,"19113",471,365,365,2,0,"VOX",1
19,"19016",64,42,42,0,0,"VOX",0
19,"19053",2024,1479,1464,13,15,"VOX",4
19,"19325",128,89,88,0,1,"VOX",1
19,"19271",47,30,30,0,0,"VOX",0
19,"19259",28,18,18,0,0,"VOX",0
19,"19257",3446,2532,2499,36,33,"VOX",7
19,"19119",81,71,71,0,0,"VOX",0
19,"19048",17,10,10,1,0,"VOX",0
19,"19065",127,103,102,1,1,"VOX",0
19,"19092",417,316,312,4,4,"VOX",1
19,"19168",297,227,224,2,3,"VOX",1
19,"19090",97,77,77,1,0,"VOX",0
19,"19296",30,21,21,0,0,"VOX",0
19,"19181",55,37,37,0,0,"VOX",0
19,"19255",78,61,61,0,0,"VOX",0
19,"19023",117,101,99,1,2,"VOX",0
19,"19015",81,68,68,0,0,"VOX",0
19,"19005",95,71,69,1,2,"VOX",0
19,"19186",81,63,63,1,0,"VOX",0
19,"19174",111,79,78,0,1,"VOX",0
19,"19191",13,12,12,0,0,"VOX",0
19,"19136",18,15,15,0,0,"VOX",0
19,"19254",49,36,36,1,0,"VOX",1
19,"19118",13,10,10,0,0,"VOX",0
19,"19047",67,60,60,1,0,"VOX",0
19,"19179",72,52,52,1,0,"VOX",0
19,"19192",1723,1354,1342,9,12,"VOX",1
19,"19020",43,27,26,2,1,"VOX",0
19,"19232",79,60,59,1,1,"VOX",0
19,"19086",1495,1158,1149,7,9,"VOX",2
19,"19301",38,30,30,0,0,"VOX",2
19,"19332",93,68,68,0,0,"VOX",0
19,"19122",93,72,72,3,0,"VOX",0
19,"19003",41,37,35,0,2,"VOX",0
19,"19176",237,181,181,0,0,"VOX",0
19,"19004",66,51,50,1,1,"VOX",0
19,"19034",22,18,18,0,0,"VOX",0
19,"19264",38,29,29,0,0,"VOX",1
19,"19330",71,64,64,0,0,"VOX",0
19,"19145",48,42,42,2,0,"VOX",0
19,"19267",19,12,12,0,0,"VOX",0
19,"19019",19,17,16,0,1,"VOX",0
19,"19323",42,33,33,0,0,"VOX",1
19,"19009",261,193,190,5,3,"VOX",0
19,"19052",27,18,18,1,0,"VOX",0
19,"19133",86,73,73,1,0,"VOX",1
19,"19198",17,10,10,0,0,"VOX",0
19,"19284",10,8,8,0,0,"VOX",0
19,"19166",158,125,124,0,1,"VOX",0
19,"19187",50,46,44,0,2,"VOX",0
19,"19038",28,23,23,0,0,"VOX",0
19,"19111",158,123,121,0,2,"VOX",0
19,"19046",21452,16321,16151,91,170,"VOX",81
19,"19226",48,35,35,0,0,"VOX",0
19,"19286",725,557,551,1,6,"VOX",0
19,"19319",4425,3336,3304,21,32,"VOX",14
19,"19211",394,297,291,1,6,"VOX",0
19,"19265",136,104,104,0,0,"VOX",0
19,"19251",42,29,28,0,1,"VOX",0
19,"19901",41,37,36,1,1,"VOX",0
19,"19082",85,62,62,0,0,"VOX",0
19,"19334",36,30,29,0,1,"VOX",0
19,"19078",53,44,44,0,0,"VOX",0
19,"19208",43,31,31,0,0,"VOX",0
19,"19237",47,35,34,1,1,"VOX",0
19,"19197",25,20,20,0,0,"VOX",0
19,"19125",45,40,40,0,0,"VOX",0
19,"19071",7746,5748,5678,34,70,"VOX",42
19,"19278",29,28,28,2,0,"VOX",0
19,"19229",69,60,60,1,0,"VOX",0
19,"19216",134,97,97,0,0,"VOX",0
19,"19163",61,44,43,1,1,"VOX",0
19,"19245",1179,913,893,6,20,"VOX",2
19,"19091",29,20,20,0,0,"VOX",0
19,"19246",46,36,36,0,0,"VOX",0
19,"19213",72,53,51,0,2,"VOX",0
19,"19087",18,17,17,0,0,"VOX",0
19,"19202",13,12,12,0,0,"VOX",0
19,"19327",431,348,342,3,6,"VOX",1
19,"19314",52,35,34,1,1,"VOX",0
19,"19057",72,53,52,0,1,"VOX",1
19,"19116",13,11,11,0,0,"VOX",0
19,"19269",100,80,79,0,1,"VOX",0
19,"19230",504,383,376,4,7,"VOX",3
19,"19298",64,49,49,0,0,"VOX",1
19,"19110",57,46,45,2,1,"VOX",0
19,"19139",31,23,23,1,0,"VOX",0
19,"19306",28,20,20,0,0,"VOX",0
19,"19274",895,673,664,8,9,"VOX",3
19,"19120",104,92,92,1,0,"VOX",0
19,"19203",31,25,25,0,0,"VOX",0
19,"19188",50,34,32,1,2,"VOX",1
19,"19059",79,60,59,0,1,"VOX",0
19,"19151",1075,779,764,5,15,"VOX",2
19,"19299",95,74,74,1,0,"VOX",0
19,"19277",18,12,12,0,0,"VOX",0
19,"19055",53,34,33,2,1,"VOX",0
19,"19002",73,56,54,0,2,"VOX",0
19,"19075",63,37,36,0,1,"VOX",0
19,"19258",97,73,73,1,0,"VOX",0
19,"19106",92,67,64,0,3,"VOX",0
19,"19089",28,17,17,0,0,"VOX",0
19,"19066",61,49,47,0,2,"VOX",0
19,"19157",57,45,45,0,0,"VOX",0
19,"19095",12,10,10,0,0,"VOX",0
19,"19282",161,115,112,0,3,"VOX",0
19,"19252",67,58,58,0,0,"VOX",0
19,"19138",272,197,196,0,1,"VOX",0
19,"19304",220,161,161,1,0,"VOX",1
19,"19193",23,22,21,0,1,"VOX",0
19,"19326",1749,1248,1237,5,11,"VOX",5
19,"19233",91,71,71,1,0,"VOX",0
19,"19322",31,26,26,0,0,"VOX",0
19,"19079",8,7,7,0,0,"VOX",0
19,"19022",632,477,468,3,9,"VOX",2
19,"19064",73,62,62,0,0,"VOX",0
19,"19044",309,248,246,3,2,"VOX",0
19,"19317",141,107,103,0,4,"VOX",0
19,"19155",66,54,53,0,1,"VOX",0
19,"19051",70,65,65,0,0,"VOX",0
19,"19260",41,38,38,1,0,"VOX",0
19,"19243",43,36,36,0,0,"VOX",1
19,"19318",25,19,19,0,0,"VOX",0
19,"19272",72,59,59,1,0,"VOX",0
19,"19104",18,13,13,1,0,"VOX",0
19,"19195",40,30,26,1,4,"VOX",0
19,"19129",29,25,25,0,0,"VOX",0
19,"19124",382,256,253,0,3,"VOX",3
19,"19293",1868,1379,1364,9,15,"VOX",6
19,"19235",97,63,62,0,1,"VOX",0
19,"19170",193,140,140,0,0,"VOX",1
19,"19329",58,49,49,0,0,"VOX",0
19,"19223",110,76,76,3,0,"VOX",0
19,"19033",64,49,49,3,0,"VOX",0
19,"19183",83,74,73,0,1,"VOX",0
19,"19227",74,49,49,0,0,"VOX",0
19,"19248",83,66,66,1,0,"VOX",0
19,"19333",121,86,83,2,3,"VOX",0
19,"19060",150,115,114,1,1,"VOX",0
19,"19262",139,111,109,0,2,"VOX",0
19,"19167",132,106,103,0,3,"VOX",4
19,"19220",2305,1613,1600,9,13,"VOX",9
19,"19308",65,54,54,0,0,"VOX",0
19,"19148",45,37,37,1,0,"VOX",0
19,"19171",4884,3824,3778,24,46,"VOX",20
19,"19212",727,562,551,8,11,"VOX",0
19,"19102",101,84,84,0,0,"VOX",1
19,"19159",94,77,77,0,0,"VOX",0
19,"19043",80,74,72,0,2,"VOX",1
19,"19040",51,41,41,0,0,"VOX",0
19,"19263",27,17,15,0,2,"VOX",0
19,"19172",55,44,44,0,0,"VOX",0
19,"19074",73,63,63,0,0,"VOX",0
19,"19225",835,645,638,2,7,"VOX",2
19,"19008",37,28,28,0,0,"VOX",0
19,"19305",162,129,128,1,1,"VOX",0
19,"19154",66,52,51,0,1,"VOX",0
19,"19165",48,40,40,0,0,"VOX",0
19,"19250",21,16,15,0,1,"VOX",0
19,"19209",40,28,27,1,1,"VOX",0
19,"19070",79,59,59,0,0,"VOX",0
19,"19199",19,16,16,1,0,"VOX",0
19,"19173",47,40,37,0,3,"VOX",0
19,"19058",6786,5451,5415,29,36,"VOX",27
19,"19160",899,601,597,2,4,"VOX",1
19,"19146",42,34,34,0,0,"VOX",0
19,"19210",21,19,19,2,0,"VOX",0
19,"19088",84,68,68,0,0,"VOX",0
19,"19218",52,35,34,0,1,"VOX",1
19,"19081",31,21,21,0,0,"VOX",0
19,"19112",57,49,49,0,0,"VOX",0
19,"19024",8143,6017,5944,33,73,"VOX",20
19,"19161",218,151,151,1,0,"VOX",2
19,"19042",26,25,25,0,0,"VOX",0
19,"19147",46,34,33,0,1,"VOX",0
19,"19076",31,20,20,0,0,"VOX",0
19,"19175",34,26,26,1,0,"VOX",0
19,"19135",105,82,82,0,0,"VOX",0
19,"19289",28,21,21,0,0,"VOX",0
19,"19281",22,18,18,0,0,"VOX",0
19,"19321",38,26,26,0,0,"VOX",0
19,"19027",148,116,115,1,1,"VOX",0
19,"19285",25,16,16,2,0,"VOX",0
19,"19121",257,209,208,0,1,"VOX",0
19,"19150",126,94,93,0,1,"VOX",0
19,"19241",46,35,35,1,0,"VOX",0
19,"19007",479,364,360,2,4,"VOX",0
19,"19067",70,51,50,2,1,"VOX",0
19,"19153",23,22,22,0,0,"VOX",0
19,"19300",762,628,624,3,4,"VOX",4
19,"19096",93,66,66,0,0,"VOX",0
19,"19201",59,51,51,1,0,"VOX",3
19,"19256",44,35,35,0,0,"VOX",0
19,"19239",100,70,69,1,1,"VOX",0
19,"19247",148,106,102,1,4,"VOX",1
19,"19037",146,113,113,1,0,"VOX",3
19,"19073",24,19,19,0,0,"VOX",0
19,"19132",93,74,74,0,0,"VOX",0
19,"19297",31,21,21,1,0,"VOX",0
19,"19123",44,38,38,0,0,"VOX",0
19,"19045",145,119,117,1,2,"VOX",0
19,"19032",175,131,124,1,7,"VOX",1
19,"19177",78,60,57,1,3,"VOX",0
19,"19302",58,45,45,1,0,"VOX",0
19,"19001",53,36,36,1,0,"VOX",0
19,"19039",60,55,54,1,1,"VOX",0
19,"19006",768,545,538,0,7,"VOX",3
19,"19204",154,106,106,3,0,"VOX",2
19,"19249",31,27,27,0,0,"VOX",0
19,"19288",23,22,22,0,0,"VOX",0
19,"19162",65,49,49,0,0,"VOX",0
19,"19307",25,23,23,1,0,"VOX",0
19,"19117",1580,1183,1167,11,16,"VOX",0
19,"19152",589,448,439,2,9,"VOX",10
19,"19219",13,9,9,0,0,"VOX",0
19,"19156",983,743,735,5,8,"VOX",0
19,"19324",179,136,135,0,1,"VOX",0
19,"19196",106,86,80,0,6,"VOX",0
19,"19097",17,13,13,0,0,"VOX",0
19,"19080",73,51,50,0,1,"VOX",0
19,"19108",112,90,90,1,0,"VOX",1
19,"19098",21,20,20,0,0,"VOX",0
19,"19266",241,201,199,2,2,"VOX",1
19,"19268",36,26,25,0,1,"VOX",0
19,"19215",165,142,141,0,1,"VOX",1
19,"19309",26,22,22,0,0,"VOX",0
19,"19190",2405,1852,1833,14,19,"VOX",1
19,"19287",144,109,109,0,0,"VOX",0
19,"19114",39,26,26,0,0,"VOX",0
19,"19185",31,18,18,0,0,"VOX",0
19,"19126",1620,1242,1216,5,26,"VOX",3
19,"19049",12,11,11,0,0,"VOX",0
19,"19234",46,38,38,0,0,"VOX",0
19,"19105",2332,1809,1794,11,15,"VOX",6
19,"19184",75,48,46,0,2,"VOX",0
19,"19214",74,54,54,0,0,"VOX",0
19,"19010",9,9,9,0,0,"VOX",2
19,"19169",43,36,36,0,0,"VOX",0
19,"19222",115,87,86,1,1,"VOX",0
19,"19283",29,23,23,0,0,"VOX",0
19,"19280",3451,2620,2581,14,39,"VOX",20
19,"19231",12,8,8,1,0,"VOX",0
19,"19134",26,18,18,0,0,"VOX",0
19,"19107",302,262,260,0,2,"VOX",2
19,"19130",59955,47034,46504,383,530,"VOX",271
19,"19031",15,10,9,0,1,"VOX",0
19,"19303",46,39,38,0,1,"VOX",0
19,"19294",23,19,19,1,0,"VOX",0
19,"19109",43,32,32,3,0,"VOX",0
19,"19142",260,189,186,2,3,"VOX",0
19,"19335",54,45,45,0,0,"VOX",0
19,"19261",38,25,25,0,0,"VOX",0
19,"19224",93,80,80,0,0,"VOX",0
19,"19041",160,133,132,0,1,"VOX",0
19,"19311",83,58,57,0,1,"VOX",0
19,"19291",1215,883,868,0,15,"VOX",5
19,"19054",190,165,163,3,2,"VOX",1
19,"19103",255,205,201,0,4,"VOX",2
19,"19200",75,53,53,1,0,"VOX",0
19,"19217",59,39,37,0,2,"VOX",0
19,"19240",52,38,37,0,1,"VOX",0
19,"19242",93,66,62,2,4,"VOX",0
3,"3090",17087,12723,12602,69,121,"PACMA",130
3,"3065",166944,126831,126024,773,807,"PACMA",1209
3,"3013",1114,914,906,5,8,"PACMA",7
3,"3089",9599,7100,6980,39,120,"PACMA",68
3,"3095",4602,3628,3605,27,23,"PACMA",20
3,"3077",1374,1139,1126,11,13,"PACMA",7
3,"3113",4254,3159,3120,17,39,"PACMA",21
3,"3047",9161,6622,6534,35,88,"PACMA",58
3,"3137",653,516,515,5,1,"PACMA",3
3,"3014",237548,173040,172027,866,1013,"PACMA",1717
3,"3010",325,278,276,0,2,"PACMA",2
3,"3079",18235,14578,14388,114,190,"PACMA",113
3,"3103",278,240,237,1,3,"PACMA",1
3,"3036",91,80,79,2,1,"PACMA",0
3,"3109",2850,2301,2275,11,26,"PACMA",19
3,"3002",3610,2714,2682,18,32,"PACMA",23
3,"3076",8485,6251,6194,37,57,"PACMA",39
3,"3096",5811,4539,4492,19,47,"PACMA",30
3,"3110",289,239,239,1,0,"PACMA",1
3,"3094",9033,6702,6657,32,45,"PACMA",83
3,"3098",507,403,394,3,9,"PACMA",3
3,"3136",446,361,361,2,0,"PACMA",1
3,"3029",242,186,183,1,3,"PACMA",0
3,"3068",46,41,40,0,1,"PACMA",0
3,"3006",497,401,393,4,8,"PACMA",4
3,"3122",42227,31379,31186,160,193,"PACMA",367
3,"3012",1072,862,849,3,13,"PACMA",6
3,"3127",352,279,277,1,2,"PACMA",1
3,"3132",536,426,423,0,3,"PACMA",6
3,"3112",653,522,517,2,5,"PACMA",2
3,"3039",85,61,59,0,2,"PACMA",0
3,"3037",352,296,293,3,3,"PACMA",1
3,"3021",5627,4691,4613,23,78,"PACMA",23
3,"3004",585,455,454,1,1,"PACMA",4
3,"3045",216,182,179,1,3,"PACMA",1
3,"3071",3980,3134,3106,28,28,"PACMA",26
3,"3063",26383,19376,19255,105,121,"PACMA",147
3,"3038",358,292,285,2,7,"PACMA",2
3,"3901",1129,855,853,5,2,"PACMA",10
3,"3078",486,398,397,3,1,"PACMA",2
3,"3060",108,92,90,1,2,"PACMA",1
3,"3030",513,432,424,0,8,"PACMA",4
3,"3117",370,325,322,0,3,"PACMA",0
3,"3018",12212,9129,9040,64,89,"PACMA",63
3,"3125",346,263,262,0,1,"PACMA",1
3,"3017",376,317,312,3,5,"PACMA",3
3,"3028",1006,833,823,1,10,"PACMA",3
3,"3099",42365,31612,31259,220,353,"PACMA",211
3,"3050",18601,13710,13610,61,100,"PACMA",136
3,"3904",1393,1065,1057,8,8,"PACMA",9
3,"3111",5411,4044,3967,14,77,"PACMA",23
3,"3084",543,478,476,4,2,"PACMA",0
3,"3041",5945,4393,4344,28,49,"PACMA",29
3,"3129",1187,991,984,8,7,"PACMA",9
3,"3031",41486,28059,27851,152,208,"PACMA",244
3,"3140",26176,19795,19509,155,286,"PACMA",163
3,"3092",6749,5398,5342,40,56,"PACMA",49
3,"3042",1367,1045,1033,5,12,"PACMA",5
3,"3066",42291,31010,30781,190,229,"PACMA",324
3,"3082",12542,8709,8597,48,112,"PACMA",68
3,"3055",5168,3949,3899,13,50,"PACMA",26
3,"3091",247,217,215,1,2,"PACMA",2
3,"3088",5498,4078,4030,42,48,"PACMA",29
3,"3052",969,804,794,6,10,"PACMA",2
3,"3073",236,202,202,1,0,"PACMA",0
3,"3128",4097,2972,2942,12,30,"PACMA",26
3,"3135",214,176,174,0,2,"PACMA",0
3,"3023",1410,1221,1201,8,20,"PACMA",3
3,"3119",16534,12466,12363,69,103,"PACMA",125
3,"3072",351,288,287,2,1,"PACMA",0
3,"3064",5040,3887,3834,16,53,"PACMA",26
3,"3020",102,79,79,0,0,"PACMA",1
3,"3120",2416,1814,1783,13,31,"PACMA",12
3,"3102",7271,5762,5687,46,75,"PACMA",30
3,"3070",2038,1526,1499,5,27,"PACMA",17
3,"3044",4512,3639,3586,16,53,"PACMA",20
3,"3130",47,30,30,0,0,"PACMA",0
3,"3107",2459,1807,1791,5,16,"PACMA",13
3,"3104",27134,21080,20902,156,178,"PACMA",196
3,"3022",142,120,120,2,0,"PACMA",0
3,"3027",159,135,132,0,3,"PACMA",2
3,"3105",5387,4089,4017,21,72,"PACMA",29
3,"3100",508,446,442,1,4,"PACMA",2
3,"3034",1367,1095,1079,4,16,"PACMA",9
3,"3134",148,132,132,2,0,"PACMA",1
3,"3009",46817,36581,36258,240,323,"PACMA",365
3,"3075",156,139,139,0,0,"PACMA",2
3,"3074",1706,1400,1382,3,18,"PACMA",10
3,"3051",350,310,305,1,5,"PACMA",0
3,"3062",213,176,175,0,1,"PACMA",2
3,"3138",3154,2406,2378,10,28,"PACMA",13
3,"3011",7729,5651,5595,29,56,"PACMA",64
3,"3106",596,503,501,1,2,"PACMA",2
3,"3116",1159,892,886,2,6,"PACMA",7
3,"3046",1594,1185,1178,9,7,"PACMA",8
3,"3097",990,817,811,8,6,"PACMA",3
3,"3083",5607,4160,4106,36,54,"PACMA",42
3,"3085",270,226,225,1,1,"PACMA",0
3,"3001",337,289,286,3,3,"PACMA",3
3,"3025",1270,1003,996,3,7,"PACMA",3
3,"3053",7196,5800,5736,37,64,"PACMA",35
3,"3093",19661,15155,14988,84,167,"PACMA",204
3,"3133",41763,26236,26039,134,197,"PACMA",299
3,"3024",3904,3109,3060,17,49,"PACMA",14
3,"3101",4765,3708,3659,13,49,"PACMA",31
3,"3121",21269,14932,14795,78,137,"PACMA",195
3,"3008",167,132,131,0,1,"PACMA",1
3,"3115",248,219,219,2,0,"PACMA",3
3,"3081",1433,1130,1118,5,12,"PACMA",8
3,"3026",1224,970,949,6,21,"PACMA",4
3,"3056",8737,6809,6731,33,78,"PACMA",55
3,"3007",168,142,138,0,4,"PACMA",1
3,"3124",469,400,394,5,6,"PACMA",0
3,"3054",338,274,268,4,6,"PACMA",0
3,"3069",3060,2187,2168,9,19,"PACMA",16
3,"3032",106,90,89,1,1,"PACMA",0
3,"3035",663,543,538,1,5,"PACMA",2
3,"3123",7472,5748,5680,38,68,"PACMA",36
3,"3057",191,148,148,2,0,"PACMA",2
3,"3003",455,393,388,3,5,"PACMA",2
3,"3033",113,97,97,2,0,"PACMA",2
3,"3903",2482,1945,1926,16,19,"PACMA",23
3,"3015",12544,9478,9388,58,90,"PACMA",53
3,"3902",10213,7091,6997,52,94,"PACMA",56
3,"3019",15261,11921,11804,98,117,"PACMA",89
3,"3080",1299,1065,1036,3,29,"PACMA",6
3,"3059",20538,15653,15522,79,131,"PACMA",128
3,"3118",2452,1732,1714,9,18,"PACMA",14
3,"3131",175,159,153,0,6,"PACMA",1
3,"3048",4858,3785,3735,25,50,"PACMA",36
3,"3043",2900,2516,2483,18,33,"PACMA",6
3,"3086",153,134,134,1,0,"PACMA",0
3,"3067",98,82,81,1,1,"PACMA",1
3,"3061",1057,828,816,2,12,"PACMA",7
3,"3005",7753,6158,6118,38,40,"PACMA",61
3,"3040",257,222,222,0,0,"PACMA",0
3,"3016",94,79,79,0,0,"PACMA",0
3,"3114",1568,1216,1203,8,13,"PACMA",4
3,"3058",4947,4015,3978,21,37,"PACMA",28
3,"3049",12082,9341,9236,69,105,"PACMA",66
3,"3139",22357,15787,15624,101,163,"PACMA",146
27,"27057",11176,7921,7709,99,212,"PACMA",42
27,"27030",3361,2333,2290,27,43,"PACMA",19
27,"27058",3577,2669,2632,37,37,"PACMA",7
27,"27043",1313,875,855,14,20,"PACMA",2
27,"27054",1205,920,906,7,14,"PACMA",3
27,"27066",12767,9200,9039,102,161,"PACMA",99
27,"27027",1937,1458,1425,19,33,"PACMA",6
27,"27014",3284,2187,2148,29,39,"PACMA",7
27,"27017",1017,674,666,6,8,"PACMA",2
27,"27047",1643,1116,1104,10,12,"PACMA",5
27,"27035",190,121,121,2,0,"PACMA",2
27,"27901",2404,1647,1624,25,23,"PACMA",4
27,"27010",4363,3072,2990,45,82,"PACMA",22
27,"27055",1320,869,855,3,14,"PACMA",4
27,"27005",2615,1942,1918,16,24,"PACMA",11
27,"27016",7204,5069,4987,65,82,"PACMA",34
27,"27040",3225,2454,2415,22,39,"PACMA",7
27,"27044",2901,1891,1832,28,59,"PACMA",16
27,"27007",2833,2211,2144,34,67,"PACMA",5
27,"27064",1593,1179,1153,14,26,"PACMA",11
27,"27041",2377,1737,1722,16,15,"PACMA",12
27,"27008",1377,1011,992,11,19,"PACMA",7
27,"27024",1624,1250,1226,8,24,"PACMA",4
27,"27052",918,659,649,3,10,"PACMA",2
27,"27056",1268,899,886,11,13,"PACMA",6
27,"27029",1475,1142,1116,19,26,"PACMA",4
27,"27002",1651,1224,1200,8,24,"PACMA",9
27,"27020",3539,2954,2896,38,58,"PACMA",11
27,"27026",2423,1667,1602,12,65,"PACMA",4
27,"27039",4372,3327,3244,56,83,"PACMA",18
27,"27001",2401,1346,1313,24,33,"PACMA",4
27,"27059",2202,1640,1605,19,35,"PACMA",9
27,"27021",1772,1167,1136,21,31,"PACMA",4
27,"27065",12528,8701,8483,150,218,"PACMA",47
27,"27006",2611,1752,1723,26,29,"PACMA",13
27,"27061",1045,821,796,10,25,"PACMA",2
27,"27048",2176,1658,1626,19,32,"PACMA",5
27,"27025",2859,2293,2243,17,50,"PACMA",19
27,"27902",7196,5017,4921,55,96,"PACMA",81
27,"27060",2651,1761,1729,12,32,"PACMA",6
27,"27063",1761,1340,1299,12,41,"PACMA",9
27,"27053",546,349,349,1,0,"PACMA",0
27,"27038",945,679,674,9,5,"PACMA",2
27,"27032",3313,2269,2230,29,39,"PACMA",19
27,"27031",15650,10901,10710,106,191,"PACMA",106
27,"27019",8120,6041,5936,82,105,"PACMA",60
27,"27037",1075,736,723,12,13,"PACMA",3
27,"27012",1366,778,769,5,9,"PACMA",4
27,"27033",631,454,449,8,5,"PACMA",0
27,"27034",1154,720,710,6,10,"PACMA",1
27,"27013",3782,3067,3007,21,60,"PACMA",29
27,"27022",4859,3324,3251,38,73,"PACMA",9
27,"27050",2993,2241,2203,16,38,"PACMA",14
27,"27004",1251,846,828,2,18,"PACMA",1
27,"27042",1759,1258,1235,21,23,"PACMA",1
27,"27009",2110,1595,1573,11,22,"PACMA",3
27,"27051",8102,5883,5784,71,99,"PACMA",69
27,"27046",1538,1119,1099,10,20,"PACMA",4
27,"27018",3514,2279,2255,17,24,"PACMA",12
27,"27028",79061,57271,56444,702,827,"PACMA",633
27,"27011",2490,1623,1592,14,31,"PACMA",7
27,"27062",619,468,465,6,3,"PACMA",0
27,"27049",1422,969,958,8,11,"PACMA",1
27,"27015",4304,3063,2985,41,78,"PACMA",5
27,"27045",1049,667,658,9,9,"PACMA",2
27,"27003",1913,1372,1351,16,21,"PACMA",7
27,"27023",2593,1981,1942,24,39,"PACMA",4
29,"29084",27393,19096,18886,192,210,"P-LIB",1
29,"29099",960,741,734,3,7,"P-LIB",0
29,"29036",636,481,475,3,6,"P-LIB",0
29,"29042",14078,9890,9776,75,114,"P-LIB",3
29,"29096",2806,2065,2034,19,31,"P-LIB",0
29,"29003",1002,777,769,1,8,"P-LIB",0
29,"29044",811,557,556,3,1,"P-LIB",0
29,"29073",1560,1126,1120,5,6,"P-LIB",1
29,"29039",2662,1948,1931,22,17,"P-LIB",1
29,"29074",785,612,611,4,1,"P-LIB",0
29,"29077",208,156,153,0,3,"P-LIB",0
29,"29067",424770,295944,294094,2117,1850,"P-LIB",120
29,"29071",938,640,633,6,7,"P-LIB",0
29,"29075",12952,8681,8619,55,62,"P-LIB",3
29,"29026",1065,776,766,4,10,"P-LIB",0
29,"29062",658,564,561,0,3,"P-LIB",0
29,"29087",380,283,276,1,7,"P-LIB",0
29,"29025",39210,26938,26747,160,191,"P-LIB",8
29,"29021",162,114,107,13,7,"P-LIB",0
29,"29082",31505,23154,22990,127,164,"P-LIB",10
29,"29034",466,361,359,0,2,"P-LIB",0
29,"29009",1477,1113,1100,3,13,"P-LIB",0
29,"29902",2560,1735,1709,13,26,"P-LIB",1
29,"29041",3146,2251,2216,26,35,"P-LIB",4
29,"29079",2444,1880,1846,3,34,"P-LIB",0
29,"29008",14541,9954,9820,90,134,"P-LIB",1
29,"29016",253,188,188,1,0,"P-LIB",0
29,"29020",3265,2531,2504,17,27,"P-LIB",0
29,"29024",393,271,256,4,15,"P-LIB",0
29,"29019",888,675,672,0,3,"P-LIB",0
29,"29050",425,313,309,1,4,"P-LIB",0
29,"29038",17555,11638,11562,124,76,"P-LIB",2
29,"29037",212,166,165,1,1,"P-LIB",0
29,"29097",4117,2996,2947,43,49,"P-LIB",1
29,"29006",680,482,474,3,8,"P-LIB",0
29,"29095",3350,2523,2467,17,56,"P-LIB",3
29,"29053",1702,1178,1160,17,18,"P-LIB",1
29,"29047",1131,927,914,4,13,"P-LIB",0
29,"29032",6708,5341,5265,26,76,"P-LIB",14
29,"29013",1612,1282,1272,6,10,"P-LIB",1
29,"29011",2920,1962,1946,5,16,"P-LIB",0
29,"29063",336,255,251,2,4,"P-LIB",0
29,"29092",567,423,415,4,8,"P-LIB",0
29,"29031",1633,1115,1106,6,9,"P-LIB",0
29,"29048",1428,1168,1155,9,13,"P-LIB",0
29,"29012",9765,7029,6944,58,85,"P-LIB",0
29,"29080",6704,4812,4766,44,46,"P-LIB",7
29,"29066",346,252,251,2,1,"P-LIB",0
29,"29029",420,322,315,4,7,"P-LIB",0
29,"29022",185,143,143,1,0,"P-LIB",0
29,"29056",1107,815,807,8,8,"P-LIB",0
29,"29046",2690,1974,1954,17,20,"P-LIB",2
29,"29059",2590,2100,2058,11,42,"P-LIB",0
29,"29064",506,372,365,2,7,"P-LIB",0
29,"29051",40201,27168,26842,229,326,"P-LIB",7
29,"29093",2235,1689,1667,12,22,"P-LIB",0
29,"29060",706,524,516,0,8,"P-LIB",0
29,"29040",1964,1321,1301,12,20,"P-LIB",0
29,"29094",57313,39393,39052,280,341,"P-LIB",19
29,"29100",2437,1775,1760,12,15,"P-LIB",0
29,"29070",39913,26993,26751,203,242,"P-LIB",11
29,"29023",2047,1385,1369,2,16,"P-LIB",0
29,"29090",1704,1174,1165,10,9,"P-LIB",0
29,"29086",795,497,490,3,7,"P-LIB",0
29,"29030",809,653,651,2,2,"P-LIB",1
29,"29076",2163,1508,1482,8,26,"P-LIB",0
29,"29043",2503,1671,1638,17,33,"P-LIB",0
29,"29049",2987,2204,2185,25,19,"P-LIB",0
29,"29904",428,363,360,2,3,"P-LIB",0
29,"29088",2720,1930,1883,21,47,"P-LIB",0
29,"29901",43601,30325,30130,188,195,"P-LIB",9
29,"29057",376,285,284,2,1,"P-LIB",0
29,"29098",1257,991,977,12,14,"P-LIB",0
29,"29072",3250,2466,2434,11,32,"P-LIB",1
29,"29068",6885,4580,4511,43,69,"P-LIB",0
29,"29017",6610,5001,4938,25,63,"P-LIB",0
29,"29055",1808,1415,1396,13,19,"P-LIB",1
29,"29014",219,138,138,1,0,"P-LIB",0
29,"29027",2343,1737,1722,6,15,"P-LIB",1
29,"29028",1249,881,881,4,0,"P-LIB",0
29,"29065",194,134,134,1,0,"P-LIB",0
29,"29091",8966,6437,6346,57,91,"P-LIB",0
29,"29015",31884,23160,22943,188,217,"P-LIB",6
29,"29035",1587,1218,1208,0,10,"P-LIB",0
29,"29005",4342,2946,2908,22,38,"P-LIB",0
29,"29007",27319,19557,19395,179,162,"P-LIB",3
29,"29069",85333,56398,55854,443,544,"P-LIB",23
29,"29903",525,394,389,2,5,"P-LIB",0
29,"29058",1463,986,975,6,11,"P-LIB",0
29,"29004",328,240,238,2,2,"P-LIB",0
29,"29052",226,155,152,0,3,"P-LIB",0
29,"29083",2114,1587,1568,10,19,"P-LIB",0
29,"29001",4196,3276,3253,26,23,"P-LIB",0
29,"29054",41888,29228,29022,205,206,"P-LIB",16
29,"29089",3254,2465,2438,10,27,"P-LIB",0
29,"29033",1132,808,804,2,4,"P-LIB",0
29,"29002",1203,855,842,6,13,"P-LIB",0
29,"29045",1685,1232,1223,4,9,"P-LIB",2
29,"29081",258,205,200,1,5,"P-LIB",0
29,"29010",1667,1336,1310,1,26,"P-LIB",0
29,"29018",2026,1560,1519,15,41,"P-LIB",1
29,"29061",1018,833,820,4,13,"P-LIB",0
29,"29085",151,99,98,1,1,"P-LIB",0
6,"6086",1233,884,874,3,10,"PODEMOS",96
6,"6141",1741,1246,1223,13,23,"PODEMOS",111
6,"6059",1858,1361,1342,12,19,"PODEMOS",156
6,"6154",2798,2001,1975,17,26,"PODEMOS",120
6,"6128",4445,3137,3116,36,21,"PODEMOS",410
6,"6053",607,459,450,2,9,"PODEMOS",48
6,"6901",2114,1648,1625,28,23,"PODEMOS",184
6,"6140",633,493,482,6,11,"PODEMOS",18
6,"6083",46111,32608,32276,235,332,"PODEMOS",5128
6,"6123",4644,3420,3357,22,63,"PODEMOS",495
6,"6097",2390,1814,1798,7,16,"PODEMOS",196
6,"6045",499,378,378,4,0,"PODEMOS",19
6,"6124",1739,1309,1287,15,22,"PODEMOS",148
6,"6005",1717,1271,1258,10,13,"PODEMOS",109
6,"6132",855,634,627,4,7,"PODEMOS",124
6,"6090",877,661,642,7,19,"PODEMOS",80
6,"6033",1330,1037,1025,10,12,"PODEMOS",95
6,"6039",1838,1546,1517,9,29,"PODEMOS",133
6,"6007",1483,1076,1068,6,8,"PODEMOS",78
6,"6058",2055,1512,1494,14,18,"PODEMOS",134
6,"6145",916,717,711,9,6,"PODEMOS",50
6,"6060",5798,4346,4261,23,85,"PODEMOS",505
6,"6036",5085,3797,3739,29,58,"PODEMOS",359
6,"6130",195,174,170,0,4,"PODEMOS",16
6,"6071",247,208,203,0,5,"PODEMOS",7
6,"6094",1483,1025,1014,6,11,"PODEMOS",50
6,"6020",1822,1435,1406,12,29,"PODEMOS",177
6,"6051",1573,1235,1222,6,13,"PODEMOS",55
6,"6006",4595,3365,3318,27,47,"PODEMOS",571
6,"6902",1672,1239,1224,6,15,"PODEMOS",131
6,"6099",1148,768,749,5,19,"PODEMOS",47
6,"6135",1103,904,888,9,16,"PODEMOS",69
6,"6095",9493,6973,6839,97,134,"PODEMOS",798
6,"6016",2978,2258,2235,14,23,"PODEMOS",206
6,"6009",206,156,156,1,0,"PODEMOS",24
6,"6014",6688,4651,4586,22,65,"PODEMOS",400
6,"6015",116673,82152,81388,677,764,"PODEMOS",11601
6,"6133",1775,1351,1334,9,17,"PODEMOS",52
6,"6078",510,414,407,1,7,"PODEMOS",30
6,"6022",2660,2159,2140,12,19,"PODEMOS",224
6,"6139",553,442,436,1,6,"PODEMOS",61
6,"6002",4335,3084,3006,33,78,"PODEMOS",379
6,"6107",1591,1114,1107,4,7,"PODEMOS",88
6,"6114",148,116,116,0,0,"PODEMOS",3
6,"6142",276,215,207,0,8,"PODEMOS",18
6,"6146",1094,848,837,5,11,"PODEMOS",86
6,"6034",174,126,125,2,1,"PODEMOS",9
6,"6062",612,450,441,4,9,"PODEMOS",48
6,"6082",382,312,306,3,6,"PODEMOS",36
6,"6042",1012,711,703,3,8,"PODEMOS",82
6,"6076",837,632,624,2,8,"PODEMOS",57
6,"6075",477,401,389,2,12,"PODEMOS",23
6,"6105",631,448,443,0,5,"PODEMOS",67
6,"6136",1578,1182,1168,8,14,"PODEMOS",123
6,"6026",837,632,623,2,9,"PODEMOS",47
6,"6087",2127,1612,1592,16,20,"PODEMOS",146
6,"6035",957,700,690,4,10,"PODEMOS",52
6,"6008",634,562,558,1,4,"PODEMOS",38
6,"6004",1604,1265,1248,10,17,"PODEMOS",102
6,"6143",3338,2548,2508,23,40,"PODEMOS",190
6,"6106",428,295,293,2,2,"PODEMOS",30
6,"6151",1094,809,801,8,8,"PODEMOS",87
6,"6157",453,316,315,0,1,"PODEMOS",21
6,"6046",1248,989,978,4,11,"PODEMOS",47
6,"6013",265,230,224,1,6,"PODEMOS",26
6,"6126",2183,1594,1582,9,12,"PODEMOS",116
6,"6108",2299,1714,1683,13,31,"PODEMOS",260
6,"6127",2893,2188,2158,13,30,"PODEMOS",171
6,"6003",830,656,647,6,9,"PODEMOS",69
6,"6144",562,450,447,3,3,"PODEMOS",83
6,"6027",681,586,576,1,10,"PODEMOS",48
6,"6117",1417,1044,1031,3,13,"PODEMOS",52
6,"6068",453,349,344,3,5,"PODEMOS",17
6,"6080",1931,1498,1480,9,18,"PODEMOS",156
6,"6161",315,236,231,1,5,"PODEMOS",14
6,"6010",1111,877,863,7,14,"PODEMOS",90
6,"6037",1768,1176,1160,5,16,"PODEMOS",85
6,"6113",2725,2091,2054,9,37,"PODEMOS",270
6,"6073",745,507,497,5,10,"PODEMOS",110
6,"6028",4253,3716,3631,30,85,"PODEMOS",273
6,"6054",5442,4185,4098,32,87,"PODEMOS",389
6,"6032",66,54,54,2,0,"PODEMOS",10
6,"6156",1169,903,898,2,5,"PODEMOS",64
6,"6119",701,519,514,1,5,"PODEMOS",38
6,"6092",582,402,392,3,10,"PODEMOS",19
6,"6056",481,401,399,2,2,"PODEMOS",35
6,"6065",309,257,247,0,10,"PODEMOS",15
6,"6029",1213,892,875,8,17,"PODEMOS",108
6,"6155",1890,1337,1315,15,22,"PODEMOS",193
6,"6115",1260,867,853,7,14,"PODEMOS",101
6,"6084",1100,857,842,4,15,"PODEMOS",41
6,"6129",591,466,462,3,4,"PODEMOS",42
6,"6147",362,285,281,0,4,"PODEMOS",56
6,"6019",2090,1519,1488,11,31,"PODEMOS",173
6,"6031",466,321,316,2,5,"PODEMOS",9
6,"6021",928,668,656,9,12,"PODEMOS",35
6,"6066",1776,1260,1245,2,15,"PODEMOS",74
6,"6012",3280,2358,2343,12,15,"PODEMOS",180
6,"6044",28899,20862,20681,153,181,"PODEMOS",2585
6,"6120",3393,2635,2600,14,35,"PODEMOS",196
6,"6125",1754,1327,1304,7,23,"PODEMOS",82
6,"6049",1021,747,733,2,14,"PODEMOS",59
6,"6096",226,188,182,1,6,"PODEMOS",34
6,"6085",3427,2563,2524,21,39,"PODEMOS",461
6,"6112",393,335,333,0,2,"PODEMOS",41
6,"6063",3038,2413,2391,15,22,"PODEMOS",149
6,"6072",2334,1813,1792,20,21,"PODEMOS",156
6,"6134",545,325,323,3,2,"PODEMOS",23
6,"6103",4781,3519,3459,40,60,"PODEMOS",306
6,"6153",20417,15129,14934,112,195,"PODEMOS",1711
6,"6023",4362,3200,3168,11,32,"PODEMOS",305
6,"6137",987,811,805,4,6,"PODEMOS",83
6,"6047",855,664,654,2,10,"PODEMOS",87
6,"6162",2938,2278,2239,17,39,"PODEMOS",194
6,"6150",806,658,650,6,8,"PODEMOS",126
6,"6110",151,107,104,0,3,"PODEMOS",7
6,"6050",4124,3178,3110,30,68,"PODEMOS",322
6,"6064",841,672,671,6,1,"PODEMOS",101
6,"6118",206,165,164,1,1,"PODEMOS",9
6,"6067",1984,1408,1377,9,31,"PODEMOS",70
6,"6040",1002,758,754,4,4,"PODEMOS",53
6,"6061",1092,899,890,6,9,"PODEMOS",66
6,"6098",545,408,402,1,6,"PODEMOS",14
6,"6017",274,229,228,1,1,"PODEMOS",17
6,"6138",1059,795,773,3,22,"PODEMOS",95
6,"6116",1607,1168,1149,10,19,"PODEMOS",61
6,"6159",2339,1429,1407,14,22,"PODEMOS",158
6,"6101",466,386,382,0,4,"PODEMOS",20
6,"6148",973,739,730,5,9,"PODEMOS",96
6,"6088",12639,8992,8885,68,107,"PODEMOS",1269
6,"6079",645,502,488,1,14,"PODEMOS",20
6,"6121",3383,2518,2483,21,35,"PODEMOS",216
6,"6041",460,378,375,3,3,"PODEMOS",21
6,"6109",3957,3258,3177,22,81,"PODEMOS",287
6,"6048",848,716,700,0,16,"PODEMOS",41
6,"6903",2017,1509,1475,11,34,"PODEMOS",218
6,"6081",1078,850,839,4,11,"PODEMOS",146
6,"6149",10342,8013,7897,70,116,"PODEMOS",1016
6,"6104",677,533,529,6,4,"PODEMOS",36
6,"6152",1322,964,951,1,13,"PODEMOS",93
6,"6089",598,491,488,3,3,"PODEMOS",39
6,"6038",801,558,551,5,7,"PODEMOS",37
6,"6131",1074,887,885,2,2,"PODEMOS",107
6,"6122",6651,4654,4553,29,101,"PODEMOS",532
6,"6055",2058,1557,1527,21,30,"PODEMOS",141
6,"6077",347,276,272,3,4,"PODEMOS",38
6,"6030",172,138,138,0,0,"PODEMOS",5
6,"6102",1055,843,830,3,13,"PODEMOS",61
6,"6024",1181,955,942,5,13,"PODEMOS",67
6,"6052",4051,3071,3009,31,62,"PODEMOS",275
6,"6093",4472,3476,3416,22,60,"PODEMOS",233
6,"6160",3154,2324,2292,12,32,"PODEMOS",203
6,"6025",5126,3833,3783,37,50,"PODEMOS",341
6,"6111",507,360,359,2,1,"PODEMOS",30
6,"6001",696,526,521,1,5,"PODEMOS",59
6,"6018",761,543,539,3,4,"PODEMOS",88
6,"6011",24721,17683,17506,172,177,"PODEMOS",1885
6,"6074",4814,3717,3659,37,58,"PODEMOS",552
6,"6069",3079,2164,2137,21,27,"PODEMOS",170
6,"6091",3782,2728,2690,32,38,"PODEMOS",234
6,"6057",573,471,466,1,5,"PODEMOS",16
6,"6158",13305,9965,9802,91,163,"PODEMOS",1629
6,"6100",938,776,763,2,13,"PODEMOS",43
6,"6070",7753,5773,5645,52,128,"PODEMOS",787
6,"6043",673,542,535,5,7,"PODEMOS",65
10,"10153",318,238,231,3,7,"PODEMOS",25
10,"10167",306,240,237,0,3,"PODEMOS",14
10,"10193",1421,1150,1130,10,20,"PODEMOS",86
10,"10033",430,304,301,1,3,"PODEMOS",5
10,"10010",2322,1446,1431,12,15,"PODEMOS",175
10,"10012",599,494,489,1,5,"PODEMOS",50
10,"10017",841,606,589,4,17,"PODEMOS",34
10,"10124",862,692,678,7,14,"PODEMOS",83
10,"10043",814,594,590,2,4,"PODEMOS",71
10,"10118",289,257,257,1,0,"PODEMOS",20
10,"10042",85,70,70,0,0,"PODEMOS",12
10,"10154",184,138,134,1,4,"PODEMOS",17
10,"10161",75,53,53,0,0,"PODEMOS",4
10,"10013",282,228,223,2,5,"PODEMOS",21
10,"10006",1275,1024,1004,7,20,"PODEMOS",64
10,"10140",1114,860,848,6,12,"PODEMOS",53
10,"10021",5198,3960,3878,40,82,"PODEMOS",624
10,"10177",1703,1331,1296,10,35,"PODEMOS",188
10,"10189",2656,2006,1971,10,35,"PODEMOS",297
10,"10047",972,783,777,1,6,"PODEMOS",169
10,"10079",901,703,695,2,8,"PODEMOS",75
10,"10155",1140,856,842,3,14,"PODEMOS",146
10,"10024",687,538,533,6,5,"PODEMOS",80
10,"10016",329,262,259,1,3,"PODEMOS",30
10,"10190",561,401,397,2,4,"PODEMOS",34
10,"10007",646,488,478,3,10,"PODEMOS",24
10,"10066",158,128,127,1,1,"PODEMOS",11
10,"10001",285,226,225,2,1,"PODEMOS",31
10,"10117",260,127,127,0,0,"PODEMOS",8
10,"10054",545,427,426,6,1,"PODEMOS",51
10,"10045",1031,786,781,11,5,"PODEMOS",117
10,"10055",719,554,546,3,8,"PODEMOS",78
10,"10129",363,272,266,4,6,"PODEMOS",45
10,"10059",369,258,255,0,3,"PODEMOS",10
10,"10119",630,461,455,2,6,"PODEMOS",73
10,"10125",903,648,638,2,10,"PODEMOS",56
10,"10169",544,430,423,0,7,"PODEMOS",29
10,"10181",694,571,558,7,13,"PODEMOS",75
10,"10120",176,125,125,2,0,"PODEMOS",17
10,"10198",1160,1022,1009,6,13,"PODEMOS",40
10,"10128",5752,4219,4146,39,73,"PODEMOS",455
10,"10009",270,173,170,1,3,"PODEMOS",9
10,"10085",335,248,244,1,4,"PODEMOS",24
10,"10030",477,316,304,1,12,"PODEMOS",22
10,"10040",443,344,342,4,2,"PODEMOS",55
10,"10048",245,163,161,1,2,"PODEMOS",10
10,"10098",385,294,286,0,8,"PODEMOS",45
10,"10134",565,395,393,1,2,"PODEMOS",16
10,"10188",500,381,373,2,8,"PODEMOS",36
10,"10094",232,203,203,3,0,"PODEMOS",8
10,"10023",846,647,637,1,10,"PODEMOS",37
10,"10162",579,483,476,0,7,"PODEMOS",54
10,"10088",205,117,117,0,0,"PODEMOS",13
10,"10192",841,592,584,0,8,"PODEMOS",51
10,"10022",435,371,366,1,5,"PODEMOS",43
10,"10082",1893,1528,1484,13,44,"PODEMOS",213
10,"10159",323,235,232,2,3,"PODEMOS",12
10,"10084",1370,934,906,7,28,"PODEMOS",115
10,"10168",320,240,237,0,3,"PODEMOS",14
10,"10053",289,231,224,1,7,"PODEMOS",13
10,"10083",90,69,69,0,0,"PODEMOS",10
10,"10130",1761,1322,1308,5,14,"PODEMOS",277
10,"10099",592,417,413,7,4,"PODEMOS",32
10,"10160",225,172,170,0,2,"PODEMOS",22
10,"10050",1062,853,846,5,7,"PODEMOS",32
10,"10019",1510,1134,1121,8,13,"PODEMOS",159
10,"10132",400,258,256,0,2,"PODEMOS",17
10,"10081",179,133,129,0,4,"PODEMOS",21
10,"10173",581,432,426,4,6,"PODEMOS",66
10,"10046",201,176,173,2,3,"PODEMOS",26
10,"10180",4159,2765,2734,12,31,"PODEMOS",271
10,"10026",646,507,494,5,13,"PODEMOS",83
10,"10133",1210,1007,989,2,18,"PODEMOS",156
10,"10063",179,145,145,1,0,"PODEMOS",18
10,"10148",32985,23666,23394,189,272,"PODEMOS",4024
10,"10076",820,608,595,3,13,"PODEMOS",50
10,"10027",78,66,66,0,0,"PODEMOS",5
10,"10038",86,70,70,0,0,"PODEMOS",3
10,"10197",134,94,93,0,1,"PODEMOS",9
10,"10166",307,220,219,0,1,"PODEMOS",17
10,"10086",329,259,256,1,3,"PODEMOS",9
10,"10064",1490,1142,1119,9,23,"PODEMOS",73
10,"10089",1376,1004,988,2,16,"PODEMOS",148
10,"10034",350,263,262,1,1,"PODEMOS",16
10,"10056",591,456,452,5,4,"PODEMOS",65
10,"10060",973,620,607,5,13,"PODEMOS",66
10,"10175",1434,1054,1028,7,26,"PODEMOS",148
10,"10102",531,413,410,4,3,"PODEMOS",31
10,"10207",502,352,349,5,3,"PODEMOS",33
10,"10122",231,166,163,0,3,"PODEMOS",25
10,"10137",399,344,343,4,1,"PODEMOS",25
10,"10178",781,567,562,1,5,"PODEMOS",80
10,"10156",96,71,70,1,1,"PODEMOS",14
10,"10209",296,195,193,1,2,"PODEMOS",34
10,"10163",356,302,299,1,3,"PODEMOS",16
10,"10025",402,341,328,2,13,"PODEMOS",48
10,"10090",522,386,382,5,4,"PODEMOS",35
10,"10037",76403,58422,57811,329,611,"PODEMOS",10142
10,"10196",306,234,233,1,1,"PODEMOS",27
10,"10127",4724,3529,3463,15,66,"PODEMOS",421
10,"10049",3849,3185,3111,27,74,"PODEMOS",331
10,"10115",3578,2857,2811,20,46,"PODEMOS",480
10,"10029",418,345,341,1,4,"PODEMOS",40
10,"10103",454,342,338,1,4,"PODEMOS",29
10,"10018",1722,1255,1240,6,15,"PODEMOS",183
10,"10121",7970,5884,5816,33,68,"PODEMOS",654
10,"10194",536,441,433,5,8,"PODEMOS",55
10,"10201",176,146,145,0,1,"PODEMOS",6
10,"10152",470,361,357,3,4,"PODEMOS",28
10,"10213",571,483,478,1,5,"PODEMOS",24
10,"10067",10486,7796,7692,54,104,"PODEMOS",1074
10,"10116",3784,2839,2801,21,38,"PODEMOS",495
10,"10104",5169,3766,3703,21,63,"PODEMOS",447
10,"10214",208,172,170,0,2,"PODEMOS",14
10,"10092",301,238,236,2,2,"PODEMOS",11
10,"10080",368,276,272,1,4,"PODEMOS",17
10,"10202",621,495,478,2,17,"PODEMOS",58
10,"10165",259,212,209,0,3,"PODEMOS",8
10,"10164",742,513,508,1,5,"PODEMOS",63
10,"10008",1331,1052,1047,6,5,"PODEMOS",91
10,"10174",175,141,139,0,2,"PODEMOS",14
10,"10031",167,138,137,1,1,"PODEMOS",9
10,"10105",2519,1745,1714,11,31,"PODEMOS",206
10,"10044",1451,1100,1087,7,13,"PODEMOS",141
10,"10020",1619,1240,1214,9,26,"PODEMOS",116
10,"10199",166,120,119,3,1,"PODEMOS",9
10,"10093",406,333,324,2,9,"PODEMOS",34
10,"10191",532,417,415,12,2,"PODEMOS",55
10,"10032",1705,1296,1277,10,19,"PODEMOS",78
10,"10215",442,320,320,0,0,"PODEMOS",45
10,"10142",824,620,616,5,4,"PODEMOS",109
10,"10052",193,127,126,1,1,"PODEMOS",10
10,"10100",795,602,595,4,7,"PODEMOS",104
10,"10139",111,84,83,0,1,"PODEMOS",12
10,"10069",831,647,637,2,10,"PODEMOS",52
10,"10106",134,111,111,1,0,"PODEMOS",11
10,"10057",150,112,111,0,1,"PODEMOS",12
10,"10143",158,121,121,0,0,"PODEMOS",7
10,"10095",350,269,267,1,2,"PODEMOS",19
10,"10216",1543,1200,1192,9,8,"PODEMOS",131
10,"10176",374,274,268,1,6,"PODEMOS",51
10,"10204",442,345,342,5,3,"PODEMOS",58
10,"10107",1033,825,815,11,10,"PODEMOS",129
10,"10058",1025,747,737,5,10,"PODEMOS",95
10,"10087",1701,1233,1215,7,18,"PODEMOS",106
10,"10141",268,190,189,2,1,"PODEMOS",13
10,"10091",378,304,304,0,0,"PODEMOS",43
10,"10070",720,548,540,0,8,"PODEMOS",40
10,"10217",533,431,427,1,4,"PODEMOS",20
10,"10108",218,122,120,0,2,"PODEMOS",5
10,"10205",2034,1413,1386,5,27,"PODEMOS",294
10,"10157",273,209,205,1,4,"PODEMOS",35
10,"10071",144,100,100,2,0,"PODEMOS",10
10,"10218",1143,828,814,2,14,"PODEMOS",36
10,"10096",3443,2503,2464,14,39,"PODEMOS",485
10,"10206",212,161,160,3,1,"PODEMOS",23
10,"10145",126,101,100,1,1,"PODEMOS",3
10,"10109",1804,1233,1212,2,21,"PODEMOS",125
10,"10144",996,755,748,3,7,"PODEMOS",74
10,"10035",1880,1390,1372,6,18,"PODEMOS",208
10,"10068",746,601,586,3,15,"PODEMOS",101
10,"10170",263,204,202,2,2,"PODEMOS",22
10,"10158",335,252,251,0,1,"PODEMOS",19
10,"10097",106,79,79,0,0,"PODEMOS",7
10,"10072",862,644,639,2,5,"PODEMOS",87
10,"10203",4600,3268,3215,14,53,"PODEMOS",353
10,"10110",2298,1682,1638,10,44,"PODEMOS",201
10,"10219",1290,860,843,1,17,"PODEMOS",112
10,"10036",327,247,244,2,3,"PODEMOS",33
10,"10146",1509,1018,1004,4,14,"PODEMOS",119
10,"10171",340,262,261,1,1,"PODEMOS",8
10,"10182",129,95,95,0,0,"PODEMOS",13
10,"10179",301,247,247,0,0,"PODEMOS",41
10,"10073",715,536,530,3,6,"PODEMOS",54
10,"10208",124,100,98,1,2,"PODEMOS",7
10,"10147",1275,985,937,6,48,"PODEMOS",175
10,"10183",993,763,761,4,2,"PODEMOS",96
10,"10111",1364,995,978,9,17,"PODEMOS",121
10,"10061",1664,1143,1131,8,12,"PODEMOS",131
10,"10901",1184,851,835,2,16,"PODEMOS",104
10,"10131",12850,9036,8977,44,59,"PODEMOS",1288
10,"10135",1329,981,958,1,23,"PODEMOS",80
10,"10123",585,480,468,1,12,"PODEMOS",59
10,"10184",778,620,610,6,10,"PODEMOS",82
10,"10136",318,234,234,4,0,"PODEMOS",30
10,"10172",718,501,493,2,8,"PODEMOS",80
10,"10062",413,345,341,3,4,"PODEMOS",48
10,"10075",256,178,177,1,1,"PODEMOS",36
10,"10902",730,546,536,2,10,"PODEMOS",26
10,"10002",368,278,275,0,3,"PODEMOS",44
10,"10185",572,433,427,5,6,"PODEMOS",57
10,"10014",1874,1430,1401,11,29,"PODEMOS",151
10,"10112",1583,1203,1176,7,27,"PODEMOS",78
10,"10039",427,295,290,0,5,"PODEMOS",41
10,"10149",435,315,307,1,8,"PODEMOS",33
10,"10051",440,318,314,1,4,"PODEMOS",13
10,"10210",551,380,373,1,7,"PODEMOS",21
10,"10186",994,830,816,4,14,"PODEMOS",63
10,"10903",819,629,624,7,5,"PODEMOS",87
10,"10113",2354,1800,1778,20,22,"PODEMOS",299
10,"10011",570,450,443,2,7,"PODEMOS",16
10,"10150",354,301,295,4,6,"PODEMOS",22
10,"10003",557,401,396,2,5,"PODEMOS",51
10,"10101",185,147,147,1,0,"PODEMOS",17
10,"10138",544,445,437,2,8,"PODEMOS",90
10,"10015",687,500,491,2,9,"PODEMOS",66
10,"10904",750,522,520,5,2,"PODEMOS",69
10,"10028",98,72,71,0,1,"PODEMOS",10
10,"10187",443,316,311,1,5,"PODEMOS",65
10,"10077",689,511,504,2,7,"PODEMOS",56
10,"10126",1572,1123,1107,3,16,"PODEMOS",62
10,"10195",7768,5818,5723,58,95,"PODEMOS",625
10,"10114",968,721,711,4,10,"PODEMOS",163
10,"10211",454,352,339,2,13,"PODEMOS",28
10,"10004",713,551,543,1,8,"PODEMOS",33
10,"10065",205,154,154,1,0,"PODEMOS",40
10,"10078",414,325,319,3,6,"PODEMOS",37
10,"10905",651,458,456,0,2,"PODEMOS",61
10,"10212",1691,1303,1280,8,23,"PODEMOS",319
10,"10151",213,163,161,0,2,"PODEMOS",7
10,"10041",1056,823,811,4,12,"PODEMOS",89
10,"10005",537,411,398,3,13,"PODEMOS",17
10,"10200",417,308,305,0,3,"PODEMOS",13
3,"3072",351,288,287,2,1,"UPYD",0
3,"3005",7753,6158,6118,38,40,"UPYD",50
3,"3012",1072,862,849,3,13,"UPYD",2
3,"3048",4858,3785,3735,25,50,"UPYD",27
3,"3071",3980,3134,3106,28,28,"UPYD",9
3,"3044",4512,3639,3586,16,53,"UPYD",14
3,"3094",9033,6702,6657,32,45,"UPYD",30
3,"3013",1114,914,906,5,8,"UPYD",0
3,"3006",497,401,393,4,8,"UPYD",1
3,"3068",46,41,40,0,1,"UPYD",0
3,"3096",5811,4539,4492,19,47,"UPYD",22
3,"3004",585,455,454,1,1,"UPYD",0
3,"3100",508,446,442,1,4,"UPYD",2
3,"3103",278,240,237,1,3,"UPYD",0
3,"3102",7271,5762,5687,46,75,"UPYD",27
3,"3123",7472,5748,5680,38,68,"UPYD",34
3,"3098",507,403,394,3,9,"UPYD",2
3,"3129",1187,991,984,8,7,"UPYD",7
3,"3069",3060,2187,2168,9,19,"UPYD",13
3,"3127",352,279,277,1,2,"UPYD",1
3,"3130",47,30,30,0,0,"UPYD",0
3,"3014",237548,173040,172027,866,1013,"UPYD",1380
3,"3067",98,82,81,1,1,"UPYD",0
3,"3077",1374,1139,1126,11,13,"UPYD",5
3,"3091",247,217,215,1,2,"UPYD",0
3,"3055",5168,3949,3899,13,50,"UPYD",8
3,"3111",5411,4044,3967,14,77,"UPYD",21
3,"3050",18601,13710,13610,61,100,"UPYD",101
3,"3112",653,522,517,2,5,"UPYD",5
3,"3119",16534,12466,12363,69,103,"UPYD",80
3,"3084",543,478,476,4,2,"UPYD",2
3,"3063",26383,19376,19255,105,121,"UPYD",105
3,"3046",1594,1185,1178,9,7,"UPYD",6
3,"3122",42227,31379,31186,160,193,"UPYD",232
3,"3021",5627,4691,4613,23,78,"UPYD",23
3,"3075",156,139,139,0,0,"UPYD",0
3,"3008",167,132,131,0,1,"UPYD",0
3,"3027",159,135,132,0,3,"UPYD",1
3,"3029",242,186,183,1,3,"UPYD",0
3,"3020",102,79,79,0,0,"UPYD",0
3,"3125",346,263,262,0,1,"UPYD",0
3,"3134",148,132,132,2,0,"UPYD",0
3,"3095",4602,3628,3605,27,23,"UPYD",16
3,"3136",446,361,361,2,0,"UPYD",0
3,"3104",27134,21080,20902,156,178,"UPYD",148
3,"3081",1433,1130,1118,5,12,"UPYD",2
3,"3076",8485,6251,6194,37,57,"UPYD",14
3,"3901",1129,855,853,5,2,"UPYD",3
3,"3059",20538,15653,15522,79,131,"UPYD",104
3,"3132",536,426,423,0,3,"UPYD",1
3,"3140",26176,19795,19509,155,286,"UPYD",106
3,"3047",9161,6622,6534,35,88,"UPYD",33
3,"3106",596,503,501,1,2,"UPYD",2
3,"3066",42291,31010,30781,190,229,"UPYD",220
3,"3089",9599,7100,6980,39,120,"UPYD",28
3,"3028",1006,833,823,1,10,"UPYD",1
3,"3041",5945,4393,4344,28,49,"UPYD",25
3,"3038",358,292,285,2,7,"UPYD",0
3,"3135",214,176,174,0,2,"UPYD",0
3,"3121",21269,14932,14795,78,137,"UPYD",93
3,"3107",2459,1807,1791,5,16,"UPYD",10
3,"3090",17087,12723,12602,69,121,"UPYD",72
3,"3083",5607,4160,4106,36,54,"UPYD",22
3,"3032",106,90,89,1,1,"UPYD",0
3,"3037",352,296,293,3,3,"UPYD",3
3,"3092",6749,5398,5342,40,56,"UPYD",26
3,"3128",4097,2972,2942,12,30,"UPYD",16
3,"3034",1367,1095,1079,4,16,"UPYD",5
3,"3017",376,317,312,3,5,"UPYD",4
3,"3052",969,804,794,6,10,"UPYD",4
3,"3904",1393,1065,1057,8,8,"UPYD",0
3,"3073",236,202,202,1,0,"UPYD",0
3,"3903",2482,1945,1926,16,19,"UPYD",12
3,"3093",19661,15155,14988,84,167,"UPYD",173
3,"3035",663,543,538,1,5,"UPYD",3
3,"3120",2416,1814,1783,13,31,"UPYD",10
3,"3031",41486,28059,27851,152,208,"UPYD",174
3,"3045",216,182,179,1,3,"UPYD",3
3,"3009",46817,36581,36258,240,323,"UPYD",197
3,"3109",2850,2301,2275,11,26,"UPYD",5
3,"3137",653,516,515,5,1,"UPYD",1
3,"3033",113,97,97,2,0,"UPYD",0
3,"3099",42365,31612,31259,220,353,"UPYD",190
3,"3022",142,120,120,2,0,"UPYD",1
3,"3054",338,274,268,4,6,"UPYD",0
3,"3011",7729,5651,5595,29,56,"UPYD",31
3,"3124",469,400,394,5,6,"UPYD",1
3,"3115",248,219,219,2,0,"UPYD",1
3,"3010",325,278,276,0,2,"UPYD",5
3,"3105",5387,4089,4017,21,72,"UPYD",13
3,"3018",12212,9129,9040,64,89,"UPYD",55
3,"3080",1299,1065,1036,3,29,"UPYD",6
3,"3001",337,289,286,3,3,"UPYD",0
3,"3902",10213,7091,6997,52,94,"UPYD",32
3,"3025",1270,1003,996,3,7,"UPYD",3
3,"3139",22357,15787,15624,101,163,"UPYD",91
3,"3056",8737,6809,6731,33,78,"UPYD",22
3,"3133",41763,26236,26039,134,197,"UPYD",121
3,"3036",91,80,79,2,1,"UPYD",0
3,"3030",513,432,424,0,8,"UPYD",0
3,"3065",166944,126831,126024,773,807,"UPYD",740
3,"3101",4765,3708,3659,13,49,"UPYD",10
3,"3016",94,79,79,0,0,"UPYD",1
3,"3026",1224,970,949,6,21,"UPYD",2
3,"3117",370,325,322,0,3,"UPYD",1
3,"3064",5040,3887,3834,16,53,"UPYD",18
3,"3085",270,226,225,1,1,"UPYD",0
3,"3015",12544,9478,9388,58,90,"UPYD",45
3,"3019",15261,11921,11804,98,117,"UPYD",65
3,"3113",4254,3159,3120,17,39,"UPYD",14
3,"3002",3610,2714,2682,18,32,"UPYD",9
3,"3070",2038,1526,1499,5,27,"UPYD",6
3,"3003",455,393,388,3,5,"UPYD",0
3,"3088",5498,4078,4030,42,48,"UPYD",34
3,"3116",1159,892,886,2,6,"UPYD",4
3,"3138",3154,2406,2378,10,28,"UPYD",13
3,"3114",1568,1216,1203,8,13,"UPYD",3
3,"3042",1367,1045,1033,5,12,"UPYD",4
3,"3079",18235,14578,14388,114,190,"UPYD",100
3,"3057",191,148,148,2,0,"UPYD",0
3,"3060",108,92,90,1,2,"UPYD",0
3,"3074",1706,1400,1382,3,18,"UPYD",2
3,"3082",12542,8709,8597,48,112,"UPYD",56
3,"3049",12082,9341,9236,69,105,"UPYD",25
3,"3061",1057,828,816,2,12,"UPYD",2
3,"3062",213,176,175,0,1,"UPYD",1
3,"3086",153,134,134,1,0,"UPYD",0
3,"3024",3904,3109,3060,17,49,"UPYD",5
3,"3007",168,142,138,0,4,"UPYD",0
3,"3043",2900,2516,2483,18,33,"UPYD",8
3,"3053",7196,5800,5736,37,64,"UPYD",28
3,"3097",990,817,811,8,6,"UPYD",2
3,"3131",175,159,153,0,6,"UPYD",1
3,"3058",4947,4015,3978,21,37,"UPYD",23
3,"3039",85,61,59,0,2,"UPYD",0
3,"3023",1410,1221,1201,8,20,"UPYD",3
3,"3051",350,310,305,1,5,"UPYD",1
3,"3040",257,222,222,0,0,"UPYD",0
3,"3078",486,398,397,3,1,"UPYD",0
3,"3110",289,239,239,1,0,"UPYD",1
3,"3118",2452,1732,1714,9,18,"UPYD",7
24,"24001",188,108,108,0,0,"UPYD",1
24,"24061",1702,1244,1231,13,13,"UPYD",10
24,"24227",1617,1146,1142,14,4,"UPYD",10
24,"24095",314,246,244,1,2,"UPYD",2
24,"24121",655,481,477,0,4,"UPYD",2
24,"24187",876,642,631,6,11,"UPYD",4
24,"24092",809,619,609,1,10,"UPYD",2
24,"24901",908,660,653,4,7,"UPYD",2
24,"24217",136,110,109,1,1,"UPYD",0
24,"24183",805,528,522,5,6,"UPYD",6
24,"24145",655,445,443,8,2,"UPYD",0
24,"24041",548,384,381,5,3,"UPYD",3
24,"24034",3419,2596,2556,27,40,"UPYD",6
24,"24002",236,182,180,3,2,"UPYD",0
24,"24093",380,249,248,3,1,"UPYD",6
24,"24196",2082,1529,1513,15,16,"UPYD",2
24,"24122",1351,965,948,9,17,"UPYD",4
24,"24062",142,105,105,1,0,"UPYD",0
24,"24156",243,169,169,1,0,"UPYD",0
24,"24184",206,121,120,0,1,"UPYD",0
24,"24218",454,331,329,3,2,"UPYD",2
24,"24056",2910,2102,2068,31,34,"UPYD",12
24,"24113",366,282,275,3,7,"UPYD",0
24,"24042",61,48,48,1,0,"UPYD",1
24,"24134",3465,2628,2583,27,45,"UPYD",21
24,"24031",216,169,167,1,2,"UPYD",2
24,"24185",482,357,349,4,8,"UPYD",2
24,"24123",757,499,497,4,2,"UPYD",4
24,"24063",391,260,259,1,1,"UPYD",1
24,"24053",439,303,298,2,5,"UPYD",4
24,"24032",111,82,82,1,0,"UPYD",0
24,"24094",1392,1048,1038,11,10,"UPYD",5
24,"24197",770,545,537,6,8,"UPYD",4
24,"24006",488,351,342,4,9,"UPYD",1
24,"24003",652,442,435,5,7,"UPYD",1
24,"24189",6016,4187,4134,58,53,"UPYD",30
24,"24054",433,308,303,4,5,"UPYD",0
24,"24104",266,180,179,0,1,"UPYD",2
24,"24014",7474,5375,5321,56,54,"UPYD",34
24,"24004",469,349,349,6,0,"UPYD",3
24,"24033",211,154,151,1,3,"UPYD",0
24,"24221",790,568,558,6,10,"UPYD",1
24,"24124",374,249,246,4,3,"UPYD",1
24,"24129",122,85,85,1,0,"UPYD",2
24,"24055",705,510,507,6,3,"UPYD",1
24,"24214",669,492,490,1,2,"UPYD",4
24,"24158",323,210,207,0,3,"UPYD",3
24,"24098",1205,880,874,8,6,"UPYD",3
24,"24044",171,125,118,0,7,"UPYD",1
24,"24211",276,210,206,4,4,"UPYD",1
24,"24064",1525,1165,1151,10,14,"UPYD",4
24,"24086",271,200,198,1,2,"UPYD",0
24,"24099",173,133,133,2,0,"UPYD",1
24,"24162",1671,1314,1303,21,11,"UPYD",14
24,"24005",387,267,259,6,8,"UPYD",3
24,"24199",433,284,281,3,3,"UPYD",1
24,"24068",464,343,339,5,4,"UPYD",1
24,"24159",1832,1407,1391,17,16,"UPYD",11
24,"24096",124,74,74,0,0,"UPYD",0
24,"24137",1114,811,804,9,7,"UPYD",4
24,"24188",3843,2962,2899,48,63,"UPYD",13
24,"24019",359,293,291,3,2,"UPYD",1
24,"24125",475,285,282,2,3,"UPYD",0
24,"24222",14249,10663,10532,119,131,"UPYD",106
24,"24009",322,161,161,1,0,"UPYD",0
24,"24153",233,173,172,3,1,"UPYD",0
24,"24097",225,146,145,1,1,"UPYD",0
24,"24066",504,367,361,3,6,"UPYD",0
24,"24160",692,506,498,2,8,"UPYD",6
24,"24127",301,239,239,3,0,"UPYD",3
24,"24046",953,662,645,6,17,"UPYD",4
24,"24201",1086,765,757,5,8,"UPYD",3
24,"24223",2640,2012,2012,53,0,"UPYD",11
24,"24144",704,487,478,5,9,"UPYD",3
24,"24047",782,533,527,7,6,"UPYD",3
24,"24163",3929,3076,3044,49,32,"UPYD",32
24,"24069",42,36,36,0,0,"UPYD",1
24,"24101",404,264,262,2,2,"UPYD",0
24,"24007",764,578,576,3,2,"UPYD",0
24,"24190",167,115,115,2,0,"UPYD",0
24,"24017",582,434,433,9,1,"UPYD",1
24,"24057",1366,1103,1076,11,27,"UPYD",8
24,"24117",446,333,331,2,2,"UPYD",0
24,"24081",142,97,97,0,0,"UPYD",1
24,"24078",388,286,284,4,2,"UPYD",0
24,"24010",8426,5980,5888,61,92,"UPYD",49
24,"24152",462,302,301,2,1,"UPYD",2
24,"24194",292,230,229,1,1,"UPYD",1
24,"24224",621,452,445,7,7,"UPYD",6
24,"24067",645,383,379,2,4,"UPYD",1
24,"24171",364,219,217,1,2,"UPYD",0
24,"24038",3107,2383,2354,30,29,"UPYD",5
24,"24082",870,692,682,10,10,"UPYD",8
24,"24177",481,328,327,1,1,"UPYD",0
24,"24008",9319,6964,6852,77,112,"UPYD",29
24,"24076",1279,972,953,7,19,"UPYD",7
24,"24207",296,245,241,3,4,"UPYD",1
24,"24191",111,84,84,1,0,"UPYD",0
24,"24079",922,654,645,9,9,"UPYD",0
24,"24090",348,226,224,1,2,"UPYD",0
24,"24143",514,391,379,4,12,"UPYD",0
24,"24229",427,330,324,8,6,"UPYD",1
24,"24028",386,304,302,3,2,"UPYD",4
24,"24205",967,714,706,9,8,"UPYD",5
24,"24902",354,273,272,2,1,"UPYD",1
24,"24132",628,397,390,6,7,"UPYD",5
24,"24226",204,138,136,0,2,"UPYD",1
24,"24172",420,218,216,1,2,"UPYD",2
24,"24100",769,569,561,4,8,"UPYD",0
24,"24193",384,277,276,4,1,"UPYD",1
24,"24080",218,170,162,3,8,"UPYD",1
24,"24083",1077,764,755,4,9,"UPYD",1
24,"24131",742,499,497,5,2,"UPYD",3
24,"24176",318,244,243,5,1,"UPYD",4
24,"24020",463,294,291,5,3,"UPYD",4
24,"24073",481,343,340,3,3,"UPYD",2
24,"24170",1934,1436,1424,13,12,"UPYD",3
24,"24110",1253,932,926,7,6,"UPYD",3
24,"24030",4297,3226,3180,16,46,"UPYD",9
24,"24210",510,347,347,0,0,"UPYD",2
24,"24182",420,289,287,6,2,"UPYD",1
24,"24136",544,391,390,8,1,"UPYD",3
24,"24040",453,315,309,2,6,"UPYD",2
24,"24051",433,308,307,1,1,"UPYD",1
24,"24198",602,411,402,4,9,"UPYD",1
24,"24118",127,84,84,1,0,"UPYD",1
24,"24074",99,77,76,1,1,"UPYD",0
24,"24149",155,123,121,0,2,"UPYD",0
24,"24059",887,520,512,8,8,"UPYD",0
24,"24070",4159,3206,3162,31,44,"UPYD",8
24,"24102",655,495,492,2,3,"UPYD",0
24,"24058",205,137,134,0,3,"UPYD",0
24,"24115",54290,39886,39486,325,400,"UPYD",276
24,"24018",177,143,141,0,2,"UPYD",0
24,"24165",373,254,250,2,4,"UPYD",0
24,"24142",25160,18503,18262,205,241,"UPYD",122
24,"24024",695,496,494,4,2,"UPYD",3
24,"24112",318,207,207,0,0,"UPYD",0
24,"24011",209,113,112,0,1,"UPYD",1
24,"24133",350,259,258,3,1,"UPYD",3
24,"24022",342,227,227,0,0,"UPYD",0
24,"24060",615,361,359,0,2,"UPYD",2
24,"24181",1519,1135,1117,10,18,"UPYD",1
24,"24173",943,678,673,3,5,"UPYD",2
24,"24071",1006,747,738,9,9,"UPYD",0
24,"24084",162,119,119,1,0,"UPYD",4
24,"24103",292,160,160,1,0,"UPYD",0
24,"24012",297,212,211,4,1,"UPYD",0
24,"24166",1413,1043,1014,7,29,"UPYD",10
24,"24016",478,287,285,1,2,"UPYD",2
24,"24219",527,390,387,2,3,"UPYD",0
24,"24169",2976,2256,2236,12,20,"UPYD",8
24,"24148",1684,1268,1256,9,12,"UPYD",6
24,"24206",1732,1303,1288,8,15,"UPYD",3
24,"24025",300,233,228,0,5,"UPYD",2
24,"24175",1825,1381,1372,13,9,"UPYD",10
24,"24049",1493,1152,1138,8,14,"UPYD",3
24,"24026",1203,908,898,19,10,"UPYD",7
24,"24015",2279,1693,1658,22,35,"UPYD",15
24,"24088",1037,804,797,8,7,"UPYD",2
24,"24043",135,69,67,0,2,"UPYD",0
24,"24180",1128,825,814,12,11,"UPYD",6
24,"24167",763,509,504,9,5,"UPYD",2
24,"24023",268,189,188,2,1,"UPYD",0
24,"24202",8098,5654,5582,51,72,"UPYD",23
24,"24168",461,383,379,4,4,"UPYD",1
24,"24089",103315,77803,77038,779,765,"UPYD",744
24,"24212",1029,784,774,7,10,"UPYD",4
24,"24146",271,195,194,0,1,"UPYD",1
24,"24039",2077,1604,1600,39,4,"UPYD",13
24,"24203",96,73,72,1,1,"UPYD",2
24,"24021",1688,1213,1189,6,24,"UPYD",8
24,"24029",754,545,539,2,6,"UPYD",3
24,"24108",377,279,273,3,6,"UPYD",1
24,"24178",71,58,57,0,1,"UPYD",0
24,"24027",1214,881,860,8,21,"UPYD",9
24,"24130",437,319,315,1,4,"UPYD",1
24,"24052",171,109,108,0,1,"UPYD",1
24,"24065",2106,1573,1545,16,28,"UPYD",10
24,"24105",1443,1087,1065,10,22,"UPYD",6
24,"24141",98,76,75,0,1,"UPYD",1
24,"24161",291,218,212,2,6,"UPYD",2
24,"24216",732,533,522,2,11,"UPYD",2
24,"24139",2186,1608,1570,24,38,"UPYD",19
24,"24116",424,276,273,0,3,"UPYD",5
24,"24109",996,667,652,7,15,"UPYD",0
24,"24106",258,178,173,1,5,"UPYD",2
24,"24120",345,214,214,1,0,"UPYD",0
24,"24179",299,202,201,8,1,"UPYD",1
24,"24215",156,119,118,1,1,"UPYD",0
24,"24114",3107,2174,2155,7,19,"UPYD",7
24,"24174",495,362,357,3,5,"UPYD",1
24,"24107",244,184,183,2,1,"UPYD",0
24,"24213",158,117,117,0,0,"UPYD",0
24,"24077",227,195,192,1,3,"UPYD",0
24,"24225",1020,786,773,6,13,"UPYD",3
24,"24164",373,190,190,1,0,"UPYD",0
24,"24228",666,455,449,2,6,"UPYD",3
24,"24230",423,329,324,2,5,"UPYD",3
24,"24209",2790,1907,1884,15,23,"UPYD",5
24,"24157",2580,2013,1983,25,30,"UPYD",14
24,"24091",657,440,437,2,3,"UPYD",1
24,"24151",492,357,357,1,0,"UPYD",6
24,"24119",702,491,480,6,11,"UPYD",1
24,"24050",102,77,77,1,0,"UPYD",0
24,"24037",369,251,251,0,0,"UPYD",2
24,"24036",301,181,180,0,1,"UPYD",0
24,"24155",478,380,371,0,9,"UPYD",2
24,"24087",645,469,466,11,3,"UPYD",3
24,"24154",1010,750,729,7,21,"UPYD",2
24,"24150",243,175,175,3,0,"UPYD",2
33,"33030",899,689,687,10,2,"EB",1
33,"33048",156,99,99,2,0,"EB",0
33,"33043",682,465,460,2,5,"EB",0
33,"33065",1109,743,735,16,8,"EB",2
33,"33049",6388,4229,4182,48,47,"EB",3
33,"33052",730,517,512,1,5,"EB",0
33,"33010",1828,1220,1215,16,5,"EB",1
33,"33051",7167,4810,4772,57,38,"EB",15
33,"33018",2896,2068,2041,18,27,"EB",9
33,"33033",9943,6851,6803,61,48,"EB",10
33,"33076",12270,8265,8203,89,62,"EB",27
33,"33037",34841,24271,24054,200,217,"EB",71
33,"33063",419,330,326,1,4,"EB",1
33,"33014",9101,6398,6352,46,46,"EB",14
33,"33038",2298,1690,1675,12,15,"EB",6
33,"33020",13297,9527,9445,86,82,"EB",30
33,"33070",3347,2473,2441,31,32,"EB",5
33,"33008",1808,1268,1247,6,21,"EB",1
33,"33022",906,604,599,3,5,"EB",1
33,"33069",3513,2577,2554,15,23,"EB",4
33,"33054",1688,1159,1146,8,13,"EB",4
33,"33034",10693,6796,6725,72,71,"EB",23
33,"33053",1157,767,762,12,5,"EB",3
33,"33013",456,336,331,6,5,"EB",1
33,"33025",9261,6116,6062,58,54,"EB",11
33,"33044",178724,130938,130010,1254,928,"EB",456
33,"33068",1114,627,623,2,4,"EB",3
33,"33072",1601,1012,1002,4,10,"EB",2
33,"33077",1220,849,840,11,9,"EB",6
33,"33067",785,608,598,5,10,"EB",2
33,"33056",5015,3435,3405,32,30,"EB",7
33,"33071",617,459,452,8,7,"EB",0
33,"33036",11572,8208,8133,80,75,"EB",10
33,"33046",508,375,365,4,10,"EB",0
33,"33021",4576,3133,3090,33,43,"EB",6
33,"33001",1622,867,852,16,15,"EB",3
33,"33035",11299,8048,7981,67,67,"EB",18
33,"33006",1556,1043,1036,17,7,"EB",1
33,"33023",3315,2295,2267,35,28,"EB",4
33,"33073",8631,5015,4948,47,67,"EB",19
33,"33028",1289,685,682,9,3,"EB",0
33,"33019",3094,2079,2054,15,25,"EB",5
33,"33031",35453,23848,23595,242,253,"EB",49
33,"33016",19201,14177,14074,115,103,"EB",46
33,"33029",363,199,198,1,1,"EB",2
33,"33075",275,161,155,2,6,"EB",1
33,"33057",1593,1134,1123,17,11,"EB",3
33,"33009",899,606,601,4,5,"EB",0
33,"33066",43034,29901,29610,261,291,"EB",103
33,"33005",1479,945,932,12,13,"EB",0
33,"33059",4702,3228,3185,42,43,"EB",9
33,"33058",1821,1319,1305,10,14,"EB",2
33,"33055",1511,1150,1129,9,21,"EB",1
33,"33078",147,98,98,0,0,"EB",0
33,"33024",227211,166618,165475,1240,1143,"EB",568
33,"33040",4564,3125,3091,28,34,"EB",4
33,"33004",67136,48699,48354,389,345,"EB",134
33,"33011",11373,6279,6214,104,65,"EB",15
33,"33026",8621,5600,5555,71,45,"EB",19
33,"33060",14750,10307,10206,82,101,"EB",28
33,"33007",1524,991,980,10,11,"EB",1
33,"33047",1126,868,861,12,7,"EB",0
33,"33012",5230,3595,3568,27,27,"EB",2
33,"33041",7270,5138,5093,53,45,"EB",10
33,"33042",4316,3143,3105,35,38,"EB",13
33,"33032",11483,8036,7921,82,115,"EB",30
33,"33027",849,544,543,8,1,"EB",3
33,"33045",4503,3249,3216,26,33,"EB",7
33,"33064",231,181,179,4,2,"EB",0
33,"33003",665,386,384,7,2,"EB",0
33,"33074",3523,2422,2390,36,32,"EB",3
33,"33015",1561,1042,1031,8,11,"EB",2
33,"33062",409,242,239,1,3,"EB",3
33,"33017",3180,2196,2168,30,28,"EB",3
33,"33039",1672,1261,1257,14,4,"EB",1
33,"33050",603,374,357,0,17,"EB",1
33,"33061",379,194,190,1,4,"EB",0
33,"33002",10122,7056,6977,55,79,"EB",13
40,"40028",103,90,89,2,1,"RECORTES CE",0
40,"40195",910,709,702,13,7,"RECORTES CE",2
40,"40012",271,205,202,3,3,"RECORTES CE",0
40,"40070",147,111,107,1,4,"RECORTES CE",0
40,"40207",753,612,607,2,5,"RECORTES CE",0
40,"40146",255,211,209,0,2,"RECORTES CE",0
40,"40089",218,163,159,0,4,"RECORTES CE",0
40,"40152",763,637,627,1,10,"RECORTES CE",1
40,"40233",419,340,336,2,4,"RECORTES CE",1
40,"40047",31,24,24,0,0,"RECORTES CE",0
40,"40171",33,24,24,0,0,"RECORTES CE",0
40,"40124",244,190,185,6,5,"RECORTES CE",0
40,"40143",88,76,75,1,1,"RECORTES CE",0
40,"40145",1111,917,903,8,14,"RECORTES CE",0
40,"40087",93,70,70,2,0,"RECORTES CE",0
40,"40151",44,35,35,0,0,"RECORTES CE",0
40,"40063",7132,5389,5297,56,92,"RECORTES CE",7
40,"40168",34,27,27,0,0,"RECORTES CE",0
40,"40172",44,29,29,0,0,"RECORTES CE",0
40,"40229",38,28,28,0,0,"RECORTES CE",0
40,"40100",275,224,214,2,10,"RECORTES CE",1
40,"40068",24,22,22,0,0,"RECORTES CE",0
40,"40074",266,226,223,2,3,"RECORTES CE",2
40,"40165",80,62,60,1,2,"RECORTES CE",0
40,"40030",476,394,389,8,5,"RECORTES CE",0
40,"40092",119,89,89,0,0,"RECORTES CE",1
40,"40157",50,43,43,0,0,"RECORTES CE",0
40,"40072",200,167,163,3,4,"RECORTES CE",1
40,"40159",141,104,104,0,0,"RECORTES CE",0
40,"40033",59,48,48,4,0,"RECORTES CE",0
40,"40170",1315,1037,1026,9,11,"RECORTES CE",0
40,"40173",139,115,110,1,5,"RECORTES CE",0
40,"40103",157,128,128,0,0,"RECORTES CE",0
40,"40130",130,108,107,1,1,"RECORTES CE",0
40,"40084",61,49,49,2,0,"RECORTES CE",0
40,"40002",37,33,33,1,0,"RECORTES CE",0
40,"40122",514,416,403,0,13,"RECORTES CE",1
40,"40004",472,371,368,2,3,"RECORTES CE",1
40,"40088",292,219,218,0,1,"RECORTES CE",0
40,"40903",91,68,68,1,0,"RECORTES CE",0
40,"40182",184,139,136,1,3,"RECORTES CE",0
40,"40079",234,182,181,1,1,"RECORTES CE",1
40,"40013",65,51,50,0,1,"RECORTES CE",0
40,"40091",116,89,89,0,0,"RECORTES CE",0
40,"40164",180,139,137,0,2,"RECORTES CE",0
40,"40179",631,533,525,3,8,"RECORTES CE",1
40,"40230",94,75,72,2,3,"RECORTES CE",0
40,"40215",89,66,66,0,0,"RECORTES CE",0
40,"40019",37,32,31,0,1,"RECORTES CE",0
40,"40213",89,71,71,1,0,"RECORTES CE",1
40,"40180",299,244,239,2,5,"RECORTES CE",0
40,"40161",34,28,28,0,0,"RECORTES CE",0
40,"40231",108,93,93,1,0,"RECORTES CE",2
40,"40076",6550,5029,4942,29,87,"RECORTES CE",10
40,"40017",92,77,76,1,1,"RECORTES CE",0
40,"40099",60,50,48,1,2,"RECORTES CE",0
40,"40904",353,307,307,2,0,"RECORTES CE",1
40,"40110",349,272,272,1,0,"RECORTES CE",1
40,"40020",168,130,129,2,1,"RECORTES CE",1
40,"40199",106,83,83,0,0,"RECORTES CE",0
40,"40062",60,50,49,0,1,"RECORTES CE",0
40,"40228",507,401,396,0,5,"RECORTES CE",0
40,"40189",513,403,391,3,12,"RECORTES CE",0
40,"40086",698,591,580,11,11,"RECORTES CE",3
40,"40073",405,345,339,4,6,"RECORTES CE",0
40,"40035",140,109,108,3,1,"RECORTES CE",1
40,"40049",62,45,45,0,0,"RECORTES CE",0
40,"40134",729,587,573,8,14,"RECORTES CE",0
40,"40129",179,143,138,2,5,"RECORTES CE",0
40,"40138",2174,1739,1710,13,29,"RECORTES CE",3
40,"40200",41,31,31,0,0,"RECORTES CE",0
40,"40178",103,70,68,0,2,"RECORTES CE",0
40,"40078",161,129,128,2,1,"RECORTES CE",0
40,"40119",170,142,140,0,2,"RECORTES CE",2
40,"40131",48,45,44,0,1,"RECORTES CE",0
40,"40058",331,273,270,1,3,"RECORTES CE",0
40,"40093",77,67,67,5,0,"RECORTES CE",0
40,"40065",496,389,381,8,8,"RECORTES CE",1
40,"40009",50,41,41,0,0,"RECORTES CE",0
40,"40205",266,194,192,2,2,"RECORTES CE",2
40,"40081",126,94,90,1,4,"RECORTES CE",0
40,"40107",104,83,81,1,2,"RECORTES CE",0
40,"40059",112,96,96,2,0,"RECORTES CE",0
40,"40201",49,41,41,0,0,"RECORTES CE",0
40,"40142",53,43,43,0,0,"RECORTES CE",0
40,"40132",66,32,30,1,2,"RECORTES CE",0
40,"40043",1825,1455,1429,16,26,"RECORTES CE",0
40,"40080",61,49,49,0,0,"RECORTES CE",0
40,"40206",178,141,135,0,6,"RECORTES CE",1
40,"40113",428,345,341,5,4,"RECORTES CE",0
40,"40060",81,59,59,0,0,"RECORTES CE",0
40,"40139",281,218,216,1,2,"RECORTES CE",0
40,"40193",230,171,168,5,3,"RECORTES CE",2
40,"40221",49,42,41,0,1,"RECORTES CE",0
40,"40025",142,119,117,0,2,"RECORTES CE",0
40,"40188",95,70,70,1,0,"RECORTES CE",0
40,"40121",286,230,225,3,5,"RECORTES CE",0
40,"40177",153,121,120,3,1,"RECORTES CE",1
40,"40125",90,67,63,0,4,"RECORTES CE",0
40,"40902",125,102,102,0,0,"RECORTES CE",0
40,"40053",88,64,64,3,0,"RECORTES CE",0
40,"40158",18,12,12,0,0,"RECORTES CE",1
40,"40203",895,722,716,6,6,"RECORTES CE",6
40,"40162",396,305,299,0,6,"RECORTES CE",1
40,"40185",882,657,644,9,13,"RECORTES CE",0
40,"40045",112,89,88,1,1,"RECORTES CE",0
40,"40149",528,401,390,7,11,"RECORTES CE",1
40,"40126",85,65,63,0,2,"RECORTES CE",0
40,"40198",24,19,19,0,0,"RECORTES CE",0
40,"40144",19,15,15,0,0,"RECORTES CE",0
40,"40218",97,69,69,0,0,"RECORTES CE",0
40,"40040",2626,1847,1835,19,12,"RECORTES CE",1
40,"40186",41,32,32,0,0,"RECORTES CE",0
40,"40191",222,163,161,2,2,"RECORTES CE",0
40,"40036",519,424,411,9,13,"RECORTES CE",2
40,"40082",115,90,88,4,2,"RECORTES CE",0
40,"40174",361,252,250,0,2,"RECORTES CE",2
40,"40083",77,54,53,1,1,"RECORTES CE",0
40,"40123",148,122,113,3,9,"RECORTES CE",1
40,"40192",157,130,128,1,2,"RECORTES CE",0
40,"40052",81,62,62,0,0,"RECORTES CE",0
40,"40026",113,106,106,0,0,"RECORTES CE",0
40,"40156",330,239,234,2,5,"RECORTES CE",0
40,"40901",377,307,300,1,7,"RECORTES CE",1
40,"40104",258,193,192,1,1,"RECORTES CE",0
40,"40056",34,27,27,1,0,"RECORTES CE",0
40,"40010",124,95,94,2,1,"RECORTES CE",0
40,"40224",24,18,18,0,0,"RECORTES CE",0
40,"40071",46,42,39,0,3,"RECORTES CE",0
40,"40024",872,676,660,9,16,"RECORTES CE",2
40,"40037",43,28,27,0,1,"RECORTES CE",0
40,"40105",48,43,43,1,0,"RECORTES CE",0
40,"40211",75,63,63,1,0,"RECORTES CE",0
40,"40057",1488,1240,1228,14,12,"RECORTES CE",3
40,"40906",1973,1645,1627,16,18,"RECORTES CE",1
40,"40016",57,47,45,0,2,"RECORTES CE",0
40,"40069",84,67,67,0,0,"RECORTES CE",0
40,"40007",77,62,62,0,0,"RECORTES CE",0
40,"40216",755,628,621,7,7,"RECORTES CE",1
40,"40044",144,116,115,6,1,"RECORTES CE",0
40,"40115",104,80,79,0,1,"RECORTES CE",0
40,"40003",143,109,104,1,5,"RECORTES CE",0
40,"40212",30,21,19,0,2,"RECORTES CE",1
40,"40095",475,376,370,7,6,"RECORTES CE",0
40,"40154",21,13,13,0,0,"RECORTES CE",0
40,"40054",112,83,83,0,0,"RECORTES CE",0
40,"40032",394,302,300,6,2,"RECORTES CE",0
40,"40166",260,224,222,2,2,"RECORTES CE",0
40,"40118",52,39,38,2,1,"RECORTES CE",0
40,"40163",55,39,38,1,1,"RECORTES CE",0
40,"40204",167,127,126,2,1,"RECORTES CE",0
40,"40222",174,147,147,0,0,"RECORTES CE",0
40,"40150",71,61,61,0,0,"RECORTES CE",0
40,"40008",46,38,38,0,0,"RECORTES CE",0
40,"40075",163,130,130,0,0,"RECORTES CE",0
40,"40219",590,448,437,6,11,"RECORTES CE",2
40,"40051",45,33,33,0,0,"RECORTES CE",0
40,"40210",100,74,74,0,0,"RECORTES CE",0
40,"40108",116,80,79,2,1,"RECORTES CE",0
40,"40202",63,41,41,0,0,"RECORTES CE",0
40,"40127",33,22,20,1,2,"RECORTES CE",0
40,"40120",192,167,166,1,1,"RECORTES CE",0
40,"40214",210,174,172,2,2,"RECORTES CE",0
40,"40001",715,588,580,4,8,"RECORTES CE",0
40,"40905",133,96,95,0,1,"RECORTES CE",0
40,"40148",240,201,200,1,1,"RECORTES CE",2
40,"40061",70,55,54,0,1,"RECORTES CE",0
40,"40155",3480,2762,2723,29,39,"RECORTES CE",10
40,"40220",66,50,45,2,5,"RECORTES CE",0
40,"40183",130,113,112,1,1,"RECORTES CE",0
40,"40181",4258,3391,3329,23,62,"RECORTES CE",5
40,"40021",27,26,26,0,0,"RECORTES CE",0
40,"40135",289,242,237,1,5,"RECORTES CE",0
40,"40034",81,62,62,0,0,"RECORTES CE",0
40,"40048",38,30,30,0,0,"RECORTES CE",0
40,"40176",402,319,317,3,2,"RECORTES CE",0
40,"40225",1134,907,890,8,17,"RECORTES CE",1
40,"40194",39796,30886,30516,287,370,"RECORTES CE",109
40,"40223",226,173,169,0,4,"RECORTES CE",2
40,"40055",36,25,23,0,2,"RECORTES CE",0
40,"40111",61,51,51,0,0,"RECORTES CE",0
40,"40005",31,26,26,0,0,"RECORTES CE",0
40,"40106",214,175,174,1,1,"RECORTES CE",1
40,"40112",2525,2054,2034,18,20,"RECORTES CE",5
40,"40046",90,69,69,0,0,"RECORTES CE",0
40,"40196",34,26,26,1,0,"RECORTES CE",0
40,"40022",207,162,160,3,2,"RECORTES CE",3
40,"40234",407,326,322,3,4,"RECORTES CE",0
40,"40141",856,626,616,7,10,"RECORTES CE",1
40,"40031",515,417,413,2,4,"RECORTES CE",1
40,"40018",90,70,68,0,2,"RECORTES CE",0
40,"40041",987,791,777,18,14,"RECORTES CE",1
40,"40160",105,76,74,2,2,"RECORTES CE",0
40,"40109",75,49,46,1,3,"RECORTES CE",0
40,"40101",874,672,669,11,3,"RECORTES CE",1
40,"40208",768,606,596,5,10,"RECORTES CE",0
40,"40140",97,72,71,8,1,"RECORTES CE",0
40,"40006",21,17,17,0,0,"RECORTES CE",0
40,"40039",213,167,165,2,2,"RECORTES CE",0
40,"40094",372,283,277,1,6,"RECORTES CE",1
40,"40015",30,21,21,1,0,"RECORTES CE",0
40,"40136",114,84,81,3,3,"RECORTES CE",0
40,"40014",58,46,45,0,1,"RECORTES CE",0
40,"40097",124,105,105,0,0,"RECORTES CE",0
40,"40128",132,97,95,4,2,"RECORTES CE",0
40,"40184",253,210,210,3,0,"RECORTES CE",0
40,"40029",32,28,27,1,1,"RECORTES CE",0
40,"40190",51,46,45,0,1,"RECORTES CE",0
40,"40077",805,633,625,6,8,"RECORTES CE",5
21,"21001",648,479,469,4,10,"C's",24
21,"21052",4618,2837,2773,20,64,"C's",158
21,"21037",472,364,360,2,4,"C's",29
21,"21071",204,160,158,2,2,"C's",18
21,"21049",3372,2162,2108,15,54,"C's",163
21,"21072",10280,7869,7777,76,92,"C's",899
21,"21034",1207,848,838,8,10,"C's",65
21,"21056",2912,2115,2024,20,91,"C's",139
21,"21060",11959,7565,7488,103,77,"C's",1056
21,"21061",5092,3471,3429,32,42,"C's",278
21,"21035",9622,6399,6313,69,86,"C's",574
21,"21057",1045,641,640,8,1,"C's",42
21,"21005",15486,10310,10189,64,121,"C's",904
21,"21064",6526,4544,4492,51,52,"C's",460
21,"21046",1703,1200,1173,15,27,"C's",84
21,"21079",731,526,522,3,4,"C's",18
21,"21002",15348,10939,10864,80,75,"C's",2139
21,"21068",998,606,605,14,1,"C's",43
21,"21003",695,533,525,1,8,"C's",16
21,"21039",308,223,222,2,1,"C's",20
21,"21038",1082,732,719,8,13,"C's",81
21,"21058",2602,1904,1886,8,18,"C's",95
21,"21044",17552,10820,10692,106,128,"C's",1337
21,"21047",1914,1213,1179,19,34,"C's",79
21,"21073",1871,1134,1120,12,14,"C's",104
21,"21021",12233,7551,7470,94,81,"C's",1051
21,"21070",6296,4450,4397,38,53,"C's",414
21,"21010",14684,8766,8698,92,68,"C's",1103
21,"21069",1715,1186,1175,7,11,"C's",103
21,"21014",4041,3203,3170,15,33,"C's",264
21,"21036",192,138,138,1,0,"C's",8
21,"21006",3402,2398,2359,13,39,"C's",150
21,"21059",220,167,165,3,2,"C's",5
21,"21024",495,350,344,5,6,"C's",14
21,"21027",49,36,36,1,0,"C's",1
21,"21042",15349,7802,7708,106,94,"C's",967
21,"21015",683,425,420,6,5,"C's",29
21,"21048",305,220,220,3,0,"C's",24
21,"21011",3464,2536,2518,19,18,"C's",228
21,"21041",113604,74902,74244,718,658,"C's",11453
21,"21004",1641,1070,1047,10,23,"C's",71
21,"21012",322,234,227,0,7,"C's",12
21,"21063",2614,2044,2034,12,10,"C's",140
21,"21075",351,270,266,2,4,"C's",17
21,"21051",245,176,173,1,3,"C's",15
21,"21031",1209,845,828,3,17,"C's",51
21,"21029",1564,1166,1126,16,40,"C's",102
21,"21009",860,571,555,6,16,"C's",26
21,"21019",590,433,423,4,10,"C's",35
21,"21016",1034,777,764,2,13,"C's",34
21,"21022",174,115,109,1,6,"C's",7
21,"21017",3643,2301,2269,17,32,"C's",150
21,"21028",381,290,287,0,3,"C's",86
21,"21032",1805,1378,1359,15,19,"C's",60
21,"21050",12448,8431,8382,86,49,"C's",928
21,"21013",10597,7220,7061,69,159,"C's",630
21,"21053",3316,2257,2219,25,38,"C's",229
21,"21018",1780,1152,1131,10,21,"C's",61
21,"21062",1395,936,926,9,10,"C's",73
21,"21045",253,192,190,0,2,"C's",19
21,"21043",1858,1356,1341,13,15,"C's",125
21,"21008",2662,1847,1831,14,16,"C's",146
21,"21074",2660,1869,1844,18,25,"C's",91
21,"21076",2123,1549,1532,13,17,"C's",92
21,"21007",6231,4285,4227,45,58,"C's",430
21,"21026",270,184,178,1,6,"C's",25
21,"21054",8105,6025,5919,41,106,"C's",928
21,"21066",507,408,405,1,3,"C's",26
21,"21040",3158,2386,2345,15,41,"C's",233
21,"21065",287,202,196,0,6,"C's",26
21,"21023",2147,1379,1357,6,22,"C's",80
21,"21020",372,241,238,2,3,"C's",10
21,"21078",2763,1928,1907,12,21,"C's",107
21,"21067",415,309,303,0,6,"C's",14
21,"21033",536,399,395,0,4,"C's",29
21,"21030",1824,1491,1472,11,19,"C's",82
21,"21025",4049,2682,2653,25,29,"C's",252
21,"21055",6914,5286,5218,34,68,"C's",546
21,"21077",1722,1261,1246,5,15,"C's",82
4,"4030",1140,828,826,8,2,"PACMA",5
4,"4088",2475,1717,1703,10,14,"PACMA",6
4,"4089",746,536,528,6,8,"PACMA",2
4,"4903",4345,2896,2875,35,21,"PACMA",11
4,"4092",2852,2192,2168,13,24,"PACMA",13
4,"4078",1095,784,779,7,5,"PACMA",9
4,"4016",2146,1584,1564,8,20,"PACMA",4
4,"4028",226,198,197,0,1,"PACMA",0
4,"4096",274,208,206,0,2,"PACMA",0
4,"4075",5152,3772,3715,19,57,"PACMA",19
4,"4085",395,302,298,0,4,"PACMA",2
4,"4080",226,185,182,2,3,"PACMA",1
4,"4026",70,60,60,0,0,"PACMA",0
4,"4904",1759,1185,1172,15,13,"PACMA",8
4,"4006",7016,4823,4786,33,37,"PACMA",6
4,"4017",1301,881,876,5,5,"PACMA",1
4,"4091",342,280,278,4,2,"PACMA",2
4,"4093",1872,1265,1252,10,13,"PACMA",8
4,"4029",8887,6103,6048,53,55,"PACMA",22
4,"4002",1063,765,760,1,5,"PACMA",3
4,"4031",2359,1791,1786,7,5,"PACMA",3
4,"4057",1337,941,933,2,8,"PACMA",0
4,"4048",1503,1104,1096,7,8,"PACMA",4
4,"4060",466,361,358,2,3,"PACMA",0
4,"4001",1083,812,796,6,16,"PACMA",5
4,"4098",1537,1157,1147,8,10,"PACMA",5
4,"4023",139,104,102,1,2,"PACMA",0
4,"4052",12246,8393,8353,84,40,"PACMA",74
4,"4007",736,553,551,0,2,"PACMA",3
4,"4062",4528,3610,3579,20,31,"PACMA",10
4,"4004",421,314,312,2,2,"PACMA",1
4,"4902",45373,28425,28220,249,205,"PACMA",200
4,"4050",830,597,594,3,3,"PACMA",3
4,"4033",139,100,97,3,3,"PACMA",0
4,"4034",173,108,108,3,0,"PACMA",0
4,"4024",3036,2325,2308,18,17,"PACMA",14
4,"4020",292,208,207,1,1,"PACMA",1
4,"4067",584,432,424,0,8,"PACMA",0
4,"4099",4988,3784,3714,26,70,"PACMA",14
4,"4043",546,466,462,3,4,"PACMA",2
4,"4037",1312,1019,1000,6,19,"PACMA",2
4,"4059",1100,752,745,7,7,"PACMA",1
4,"4077",303,277,274,2,3,"PACMA",0
4,"4061",618,495,491,5,4,"PACMA",0
4,"4018",274,245,242,0,3,"PACMA",2
4,"4063",1099,847,835,2,12,"PACMA",4
4,"4090",309,242,242,1,0,"PACMA",1
4,"4022",348,243,242,1,1,"PACMA",0
4,"4015",130,98,98,1,0,"PACMA",0
4,"4066",13573,8651,8570,65,81,"PACMA",30
4,"4019",251,199,198,0,1,"PACMA",1
4,"4032",5606,3789,3770,19,19,"PACMA",21
4,"4094",209,141,141,1,0,"PACMA",0
4,"4051",440,373,372,0,1,"PACMA",4
4,"4079",50800,33862,33629,200,233,"PACMA",266
4,"4003",17365,10931,10830,57,101,"PACMA",61
4,"4065",366,290,288,2,2,"PACMA",1
4,"4901",539,388,386,0,2,"PACMA",0
4,"4064",2779,2032,2009,8,23,"PACMA",9
4,"4038",3066,2169,2150,20,19,"PACMA",10
4,"4041",318,241,241,6,0,"PACMA",2
4,"4005",577,438,432,1,6,"PACMA",0
4,"4027",249,163,163,1,0,"PACMA",1
4,"4008",501,420,415,3,5,"PACMA",0
4,"4071",398,327,326,2,1,"PACMA",1
4,"4070",1623,1233,1229,7,4,"PACMA",4
4,"4095",726,466,463,2,3,"PACMA",2
4,"4103",1478,1051,1037,6,14,"PACMA",9
4,"4036",228,176,175,2,1,"PACMA",0
4,"4076",1296,1005,993,7,12,"PACMA",4
4,"4021",187,148,141,1,7,"PACMA",0
4,"4068",195,158,158,0,0,"PACMA",0
4,"4014",153,118,118,0,0,"PACMA",1
4,"4046",862,658,656,6,2,"PACMA",0
4,"4055",372,315,315,0,0,"PACMA",1
4,"4081",356,290,290,2,0,"PACMA",1
4,"4073",332,231,230,2,1,"PACMA",1
4,"4083",1790,1384,1379,8,5,"PACMA",5
4,"4054",363,297,292,1,5,"PACMA",1
4,"4100",8712,5545,5482,30,63,"PACMA",41
4,"4035",8375,6079,6031,28,48,"PACMA",25
4,"4087",189,140,139,1,1,"PACMA",1
4,"4074",2829,1965,1945,24,20,"PACMA",9
4,"4086",1792,1271,1258,8,13,"PACMA",6
4,"4097",254,196,194,0,2,"PACMA",2
4,"4044",1555,1253,1243,9,10,"PACMA",3
4,"4082",306,210,209,0,1,"PACMA",2
4,"4009",169,127,126,0,1,"PACMA",0
4,"4045",1777,1402,1392,9,10,"PACMA",3
4,"4084",337,264,261,1,3,"PACMA",1
4,"4102",13729,8987,8878,114,109,"PACMA",51
4,"4010",579,469,464,2,5,"PACMA",4
4,"4049",5280,3658,3623,20,35,"PACMA",22
4,"4101",4283,2969,2950,22,19,"PACMA",15
4,"4012",191,170,169,1,1,"PACMA",0
4,"4069",4692,3641,3607,29,34,"PACMA",8
4,"4011",2798,2244,2220,14,24,"PACMA",11
4,"4053",12333,9124,9040,66,84,"PACMA",27
4,"4058",369,292,291,2,1,"PACMA",0
4,"4013",141116,95203,94625,669,578,"PACMA",947
4,"4047",2278,1906,1891,13,15,"PACMA",7
4,"4072",311,247,244,14,3,"PACMA",0
4,"4056",147,123,120,0,3,"PACMA",0
40,"40213",89,71,71,1,0,"PCPE",0
40,"40040",2626,1847,1835,19,12,"PCPE",6
40,"40039",213,167,165,2,2,"PCPE",1
40,"40200",41,31,31,0,0,"PCPE",0
40,"40004",472,371,368,2,3,"PCPE",2
40,"40160",105,76,74,2,2,"PCPE",0
40,"40215",89,66,66,0,0,"PCPE",0
40,"40078",161,129,128,2,1,"PCPE",0
40,"40017",92,77,76,1,1,"PCPE",0
40,"40192",157,130,128,1,2,"PCPE",0
40,"40073",405,345,339,4,6,"PCPE",1
40,"40118",52,39,38,2,1,"PCPE",0
40,"40121",286,230,225,3,5,"PCPE",0
40,"40107",104,83,81,1,2,"PCPE",3
40,"40075",163,130,130,0,0,"PCPE",1
40,"40134",729,587,573,8,14,"PCPE",1
40,"40031",515,417,413,2,4,"PCPE",0
40,"40159",141,104,104,0,0,"PCPE",0
40,"40091",116,89,89,0,0,"PCPE",0
40,"40135",289,242,237,1,5,"PCPE",1
40,"40125",90,67,63,0,4,"PCPE",0
40,"40202",63,41,41,0,0,"PCPE",0
40,"40155",3480,2762,2723,29,39,"PCPE",6
40,"40021",27,26,26,0,0,"PCPE",0
40,"40119",170,142,140,0,2,"PCPE",0
40,"40092",119,89,89,0,0,"PCPE",0
40,"40173",139,115,110,1,5,"PCPE",0
40,"40041",987,791,777,18,14,"PCPE",4
40,"40037",43,28,27,0,1,"PCPE",0
40,"40006",21,17,17,0,0,"PCPE",0
40,"40206",178,141,135,0,6,"PCPE",0
40,"40045",112,89,88,1,1,"PCPE",0
40,"40124",244,190,185,6,5,"PCPE",0
40,"40148",240,201,200,1,1,"PCPE",0
40,"40127",33,22,20,1,2,"PCPE",0
40,"40052",81,62,62,0,0,"PCPE",0
40,"40033",59,48,48,4,0,"PCPE",0
40,"40220",66,50,45,2,5,"PCPE",0
40,"40211",75,63,63,1,0,"PCPE",0
40,"40094",372,283,277,1,6,"PCPE",1
40,"40214",210,174,172,2,2,"PCPE",2
40,"40012",271,205,202,3,3,"PCPE",0
40,"40034",81,62,62,0,0,"PCPE",0
40,"40077",805,633,625,6,8,"PCPE",1
40,"40203",895,722,716,6,6,"PCPE",1
40,"40120",192,167,166,1,1,"PCPE",0
40,"40132",66,32,30,1,2,"PCPE",0
40,"40165",80,62,60,1,2,"PCPE",0
40,"40049",62,45,45,0,0,"PCPE",0
40,"40144",19,15,15,0,0,"PCPE",0
40,"40013",65,51,50,0,1,"PCPE",0
40,"40081",126,94,90,1,4,"PCPE",0
40,"40126",85,65,63,0,2,"PCPE",0
40,"40035",140,109,108,3,1,"PCPE",0
40,"40082",115,90,88,4,2,"PCPE",0
40,"40054",112,83,83,0,0,"PCPE",0
40,"40218",97,69,69,0,0,"PCPE",0
40,"40044",144,116,115,6,1,"PCPE",0
40,"40194",39796,30886,30516,287,370,"PCPE",61
40,"40136",114,84,81,3,3,"PCPE",0
40,"40141",856,626,616,7,10,"PCPE",4
40,"40163",55,39,38,1,1,"PCPE",0
40,"40055",36,25,23,0,2,"PCPE",0
40,"40099",60,50,48,1,2,"PCPE",0
40,"40079",234,182,181,1,1,"PCPE",2
40,"40164",180,139,137,0,2,"PCPE",1
40,"40195",910,709,702,13,7,"PCPE",1
40,"40205",266,194,192,2,2,"PCPE",3
40,"40142",53,43,43,0,0,"PCPE",0
40,"40170",1315,1037,1026,9,11,"PCPE",1
40,"40001",715,588,580,4,8,"PCPE",0
40,"40036",519,424,411,9,13,"PCPE",0
40,"40019",37,32,31,0,1,"PCPE",0
40,"40043",1825,1455,1429,16,26,"PCPE",2
40,"40076",6550,5029,4942,29,87,"PCPE",4
40,"40057",1488,1240,1228,14,12,"PCPE",3
40,"40100",275,224,214,2,10,"PCPE",0
40,"40224",24,18,18,0,0,"PCPE",0
40,"40053",88,64,64,3,0,"PCPE",0
40,"40184",253,210,210,3,0,"PCPE",1
40,"40115",104,80,79,0,1,"PCPE",0
40,"40180",299,244,239,2,5,"PCPE",1
40,"40221",49,42,41,0,1,"PCPE",0
40,"40095",475,376,370,7,6,"PCPE",3
40,"40162",396,305,299,0,6,"PCPE",0
40,"40003",143,109,104,1,5,"PCPE",0
40,"40086",698,591,580,11,11,"PCPE",3
40,"40008",46,38,38,0,0,"PCPE",0
40,"40166",260,224,222,2,2,"PCPE",0
40,"40122",514,416,403,0,13,"PCPE",2
40,"40228",507,401,396,0,5,"PCPE",1
40,"40101",874,672,669,11,3,"PCPE",3
40,"40185",882,657,644,9,13,"PCPE",3
40,"40058",331,273,270,1,3,"PCPE",0
40,"40186",41,32,32,0,0,"PCPE",1
40,"40130",130,108,107,1,1,"PCPE",0
40,"40059",112,96,96,2,0,"PCPE",0
40,"40131",48,45,44,0,1,"PCPE",0
40,"40074",266,226,223,2,3,"PCPE",1
40,"40145",1111,917,903,8,14,"PCPE",2
40,"40046",90,69,69,0,0,"PCPE",0
40,"40168",34,27,27,0,0,"PCPE",0
40,"40087",93,70,70,2,0,"PCPE",1
40,"40229",38,28,28,0,0,"PCPE",0
40,"40083",77,54,53,1,1,"PCPE",0
40,"40005",31,26,26,0,0,"PCPE",0
40,"40201",49,41,41,0,0,"PCPE",0
40,"40018",90,70,68,0,2,"PCPE",0
40,"40104",258,193,192,1,1,"PCPE",0
40,"40230",94,75,72,2,3,"PCPE",0
40,"40146",255,211,209,0,2,"PCPE",0
40,"40060",81,59,59,0,0,"PCPE",0
40,"40128",132,97,95,4,2,"PCPE",0
40,"40174",361,252,250,0,2,"PCPE",0
40,"40010",124,95,94,2,1,"PCPE",0
40,"40047",31,24,24,0,0,"PCPE",0
40,"40176",402,319,317,3,2,"PCPE",0
40,"40105",48,43,43,1,0,"PCPE",0
40,"40161",34,28,28,0,0,"PCPE",0
40,"40231",108,93,93,1,0,"PCPE",0
40,"40089",218,163,159,0,4,"PCPE",1
40,"40216",755,628,621,7,7,"PCPE",1
40,"40171",33,24,24,0,0,"PCPE",0
40,"40212",30,21,19,0,2,"PCPE",0
40,"40106",214,175,174,1,1,"PCPE",1
40,"40061",70,55,54,0,1,"PCPE",0
40,"40048",38,30,30,0,0,"PCPE",0
40,"40172",44,29,29,0,0,"PCPE",0
40,"40007",77,62,62,0,0,"PCPE",0
40,"40140",97,72,71,8,1,"PCPE",1
40,"40177",153,121,120,3,1,"PCPE",0
40,"40190",51,46,45,0,1,"PCPE",0
40,"40149",528,401,390,7,11,"PCPE",1
40,"40233",419,340,336,2,4,"PCPE",2
40,"40062",60,50,49,0,1,"PCPE",0
40,"40204",167,127,126,2,1,"PCPE",0
40,"40063",7132,5389,5297,56,92,"PCPE",6
40,"40103",157,128,128,0,0,"PCPE",0
40,"40123",148,122,113,3,9,"PCPE",0
40,"40051",45,33,33,0,0,"PCPE",0
40,"40234",407,326,322,3,4,"PCPE",1
40,"40032",394,302,300,6,2,"PCPE",0
40,"40178",103,70,68,0,2,"PCPE",0
40,"40022",207,162,160,3,2,"PCPE",1
40,"40088",292,219,218,0,1,"PCPE",0
40,"40093",77,67,67,5,0,"PCPE",0
40,"40179",631,533,525,3,8,"PCPE",3
40,"40108",116,80,79,2,1,"PCPE",0
40,"40009",50,41,41,0,0,"PCPE",0
40,"40219",590,448,437,6,11,"PCPE",0
40,"40138",2174,1739,1710,13,29,"PCPE",1
40,"40901",377,307,300,1,7,"PCPE",0
40,"40188",95,70,70,1,0,"PCPE",1
40,"40065",496,389,381,8,8,"PCPE",1
40,"40189",513,403,391,3,12,"PCPE",0
40,"40024",872,676,660,9,16,"PCPE",1
40,"40151",44,35,35,0,0,"PCPE",0
40,"40139",281,218,216,1,2,"PCPE",1
40,"40109",75,49,46,1,3,"PCPE",0
40,"40080",61,49,49,0,0,"PCPE",0
40,"40025",142,119,117,0,2,"PCPE",0
40,"40193",230,171,168,5,3,"PCPE",0
40,"40110",349,272,272,1,0,"PCPE",0
40,"40152",763,637,627,1,10,"PCPE",0
40,"40068",24,22,22,0,0,"PCPE",1
40,"40154",21,13,13,0,0,"PCPE",0
40,"40207",753,612,607,2,5,"PCPE",1
40,"40902",125,102,102,0,0,"PCPE",0
40,"40199",106,83,83,0,0,"PCPE",0
40,"40020",168,130,129,2,1,"PCPE",0
40,"40069",84,67,67,0,0,"PCPE",0
40,"40026",113,106,106,0,0,"PCPE",0
40,"40181",4258,3391,3329,23,62,"PCPE",6
40,"40222",174,147,147,0,0,"PCPE",0
40,"40182",184,139,136,1,3,"PCPE",0
40,"40903",91,68,68,1,0,"PCPE",0
40,"40111",61,51,51,0,0,"PCPE",0
40,"40191",222,163,161,2,2,"PCPE",2
40,"40208",768,606,596,5,10,"PCPE",1
40,"40097",124,105,105,0,0,"PCPE",0
40,"40070",147,111,107,1,4,"PCPE",0
40,"40150",71,61,61,0,0,"PCPE",0
40,"40223",226,173,169,0,4,"PCPE",0
40,"40904",353,307,307,2,0,"PCPE",0
40,"40028",103,90,89,2,1,"PCPE",0
40,"40196",34,26,26,1,0,"PCPE",0
40,"40210",100,74,74,0,0,"PCPE",0
40,"40014",58,46,45,0,1,"PCPE",0
40,"40056",34,27,27,1,0,"PCPE",0
40,"40156",330,239,234,2,5,"PCPE",1
40,"40112",2525,2054,2034,18,20,"PCPE",1
40,"40071",46,42,39,0,3,"PCPE",0
40,"40183",130,113,112,1,1,"PCPE",0
40,"40113",428,345,341,5,4,"PCPE",1
40,"40905",133,96,95,0,1,"PCPE",0
40,"40084",61,49,49,2,0,"PCPE",0
40,"40015",30,21,21,1,0,"PCPE",0
40,"40198",24,19,19,0,0,"PCPE",0
40,"40029",32,28,27,1,1,"PCPE",0
40,"40002",37,33,33,1,0,"PCPE",0
40,"40157",50,43,43,0,0,"PCPE",0
40,"40129",179,143,138,2,5,"PCPE",1
40,"40030",476,394,389,8,5,"PCPE",3
40,"40072",200,167,163,3,4,"PCPE",0
40,"40906",1973,1645,1627,16,18,"PCPE",12
40,"40143",88,76,75,1,1,"PCPE",1
40,"40016",57,47,45,0,2,"PCPE",0
40,"40225",1134,907,890,8,17,"PCPE",0
40,"40158",18,12,12,0,0,"PCPE",0
26,"26017",383,302,301,4,1,"PODEMOS",65
26,"26018",10469,8216,8110,71,106,"PODEMOS",1302
26,"26091",166,141,138,0,3,"PODEMOS",7
26,"26135",167,120,119,0,1,"PODEMOS",18
26,"26061",1548,1179,1160,14,19,"PODEMOS",224
26,"26153",12,11,10,0,1,"PODEMOS",4
26,"26075",334,268,264,2,4,"PODEMOS",20
26,"26014",466,319,319,0,0,"PODEMOS",31
26,"26113",37,34,32,0,2,"PODEMOS",0
26,"26119",202,163,162,4,1,"PODEMOS",36
26,"26160",715,569,567,3,2,"PODEMOS",59
26,"26170",448,346,344,8,2,"PODEMOS",38
26,"26028",133,112,111,0,1,"PODEMOS",7
26,"26047",1969,1614,1596,14,18,"PODEMOS",120
26,"26129",971,768,757,2,11,"PODEMOS",67
26,"26069",240,201,199,0,2,"PODEMOS",15
26,"26001",197,163,155,3,8,"PODEMOS",12
26,"26029",37,31,31,0,0,"PODEMOS",3
26,"26057",51,47,45,0,2,"PODEMOS",5
26,"26130",203,167,166,1,1,"PODEMOS",7
26,"26030",12,12,12,0,0,"PODEMOS",0
26,"26114",80,71,71,2,0,"PODEMOS",4
26,"26020",483,356,344,2,12,"PODEMOS",30
26,"26016",28,24,24,1,0,"PODEMOS",0
26,"26044",51,46,45,0,1,"PODEMOS",5
26,"26027",157,127,127,1,0,"PODEMOS",12
26,"26143",217,178,177,0,1,"PODEMOS",32
26,"26019",351,282,281,1,1,"PODEMOS",31
26,"26034",660,522,513,1,9,"PODEMOS",77
26,"26181",15,13,13,0,0,"PODEMOS",0
26,"26037",131,111,111,1,0,"PODEMOS",8
26,"26073",98,83,83,0,0,"PODEMOS",23
26,"26062",90,73,71,0,2,"PODEMOS",12
26,"26122",119,104,102,2,2,"PODEMOS",22
26,"26033",172,143,142,2,1,"PODEMOS",21
26,"26078",83,68,68,0,0,"PODEMOS",6
26,"26174",147,122,112,0,10,"PODEMOS",16
26,"26115",17,14,14,0,0,"PODEMOS",1
26,"26100",52,43,43,0,0,"PODEMOS",2
26,"26123",130,111,108,0,3,"PODEMOS",14
26,"26162",121,106,106,2,0,"PODEMOS",20
26,"26045",12,12,12,0,0,"PODEMOS",0
26,"26065",50,40,40,0,0,"PODEMOS",6
26,"26136",103,73,72,1,1,"PODEMOS",23
26,"26071",8477,6115,6029,51,86,"PODEMOS",1238
26,"26038",95,66,65,0,1,"PODEMOS",8
26,"26093",57,44,44,0,0,"PODEMOS",9
26,"26168",5318,3853,3802,36,51,"PODEMOS",856
26,"26054",324,255,254,3,1,"PODEMOS",9
26,"26167",59,45,45,1,0,"PODEMOS",6
26,"26179",42,34,33,0,1,"PODEMOS",2
26,"26006",1809,1420,1410,14,10,"PODEMOS",138
26,"26177",309,266,264,2,2,"PODEMOS",25
26,"26164",61,41,41,0,0,"PODEMOS",3
26,"26125",2708,2013,1988,22,25,"PODEMOS",190
26,"26042",836,645,635,5,10,"PODEMOS",85
26,"26003",416,336,330,2,6,"PODEMOS",16
26,"26161",7,7,7,0,0,"PODEMOS",0
26,"26072",289,259,258,2,1,"PODEMOS",33
26,"26008",1862,1442,1425,7,17,"PODEMOS",107
26,"26064",2278,1736,1715,17,21,"PODEMOS",222
26,"26012",23,23,23,0,0,"PODEMOS",4
26,"26055",42,33,33,0,0,"PODEMOS",7
26,"26104",14,9,9,0,0,"PODEMOS",0
26,"26120",1457,1144,1133,9,11,"PODEMOS",142
26,"26112",243,192,191,1,1,"PODEMOS",19
26,"26039",38,35,35,0,0,"PODEMOS",5
26,"26041",134,97,94,1,3,"PODEMOS",1
26,"26089",110513,85146,84302,712,844,"PODEMOS",15312
26,"26081",16,14,14,0,0,"PODEMOS",0
26,"26144",194,150,148,2,2,"PODEMOS",5
26,"26183",65,50,50,0,0,"PODEMOS",7
26,"26025",85,71,71,1,0,"PODEMOS",7
26,"26053",208,161,160,1,1,"PODEMOS",23
26,"26074",105,86,85,1,1,"PODEMOS",7
26,"26046",1594,1221,1209,3,12,"PODEMOS",111
26,"26105",2187,1722,1696,16,26,"PODEMOS",209
26,"26024",236,183,183,0,0,"PODEMOS",24
26,"26087",208,157,154,4,3,"PODEMOS",16
26,"26145",245,202,201,3,1,"PODEMOS",24
26,"26127",215,182,179,2,3,"PODEMOS",16
26,"26157",296,236,232,3,4,"PODEMOS",26
26,"26022",198,159,158,0,1,"PODEMOS",11
26,"26131",34,33,33,1,0,"PODEMOS",4
26,"26066",265,217,209,3,8,"PODEMOS",26
26,"26117",2168,1695,1662,19,33,"PODEMOS",236
26,"26102",6128,4673,4585,42,88,"PODEMOS",540
26,"26138",4600,3374,3325,28,49,"PODEMOS",373
26,"26023",468,358,355,4,3,"PODEMOS",31
26,"26150",117,98,98,1,0,"PODEMOS",15
26,"26092",108,83,82,0,1,"PODEMOS",4
26,"26154",11,8,8,0,0,"PODEMOS",2
26,"26015",193,151,149,0,2,"PODEMOS",10
26,"26043",373,284,282,4,2,"PODEMOS",43
26,"26155",162,138,137,0,1,"PODEMOS",12
26,"26147",30,26,26,0,0,"PODEMOS",5
26,"26103",789,626,616,3,10,"PODEMOS",87
26,"26040",68,62,62,0,0,"PODEMOS",1
26,"26107",92,75,75,0,0,"PODEMOS",10
26,"26169",64,60,60,0,0,"PODEMOS",3
26,"26080",475,392,388,6,4,"PODEMOS",24
26,"26058",150,114,113,0,1,"PODEMOS",18
26,"26121",27,21,21,0,0,"PODEMOS",2
26,"26052",158,125,125,0,0,"PODEMOS",7
26,"26032",53,40,40,0,0,"PODEMOS",5
26,"26004",68,53,53,1,0,"PODEMOS",1
26,"26140",260,221,218,1,3,"PODEMOS",45
26,"26021",2819,2113,2077,23,36,"PODEMOS",217
26,"26148",171,147,145,0,2,"PODEMOS",26
26,"26079",639,536,527,2,9,"PODEMOS",51
26,"26077",27,25,25,0,0,"PODEMOS",2
26,"26141",112,85,83,1,2,"PODEMOS",9
26,"26109",85,76,74,1,2,"PODEMOS",6
26,"26009",414,326,319,3,7,"PODEMOS",65
26,"26128",104,80,79,0,1,"PODEMOS",13
26,"26149",61,48,48,0,0,"PODEMOS",11
26,"26175",52,44,44,2,0,"PODEMOS",4
26,"26158",265,220,217,4,3,"PODEMOS",11
26,"26171",179,136,126,1,10,"PODEMOS",3
26,"26163",143,117,117,2,0,"PODEMOS",16
26,"26082",109,92,89,0,3,"PODEMOS",13
26,"26063",122,97,96,0,1,"PODEMOS",10
26,"26142",780,618,613,1,5,"PODEMOS",69
26,"26083",289,213,213,1,0,"PODEMOS",29
26,"26051",254,202,201,2,1,"PODEMOS",36
26,"26173",6,6,6,1,0,"PODEMOS",0
26,"26110",162,135,134,0,1,"PODEMOS",16
26,"26048",22,22,21,0,1,"PODEMOS",4
26,"26035",16,12,12,0,0,"PODEMOS",3
26,"26132",111,88,88,1,0,"PODEMOS",6
26,"26172",30,25,25,0,0,"PODEMOS",3
26,"26011",7336,5309,5255,57,54,"PODEMOS",772
26,"26007",523,406,401,2,5,"PODEMOS",123
26,"26076",128,111,110,2,1,"PODEMOS",5
26,"26031",106,81,81,0,0,"PODEMOS",5
26,"26111",248,195,192,1,3,"PODEMOS",52
26,"26049",174,127,121,0,6,"PODEMOS",22
26,"26096",244,199,197,3,2,"PODEMOS",37
26,"26086",15,15,15,0,0,"PODEMOS",0
26,"26094",85,71,68,0,3,"PODEMOS",7
26,"26178",80,64,63,1,1,"PODEMOS",9
26,"26095",101,78,77,1,1,"PODEMOS",12
26,"26108",268,207,205,5,2,"PODEMOS",27
26,"26166",142,131,128,1,3,"PODEMOS",4
26,"26165",364,315,311,1,4,"PODEMOS",36
26,"26068",82,68,66,0,2,"PODEMOS",13
26,"26067",23,20,20,0,0,"PODEMOS",2
26,"26002",840,615,608,6,7,"PODEMOS",61
26,"26134",87,65,65,1,0,"PODEMOS",7
26,"26084",6630,5015,4952,27,63,"PODEMOS",797
26,"26005",2343,1607,1590,19,17,"PODEMOS",242
26,"26101",46,34,34,0,0,"PODEMOS",2
26,"26050",117,86,86,0,0,"PODEMOS",13
26,"26070",186,154,153,1,1,"PODEMOS",11
26,"26098",94,72,71,1,1,"PODEMOS",20
26,"26059",1117,850,840,9,10,"PODEMOS",85
26,"26099",1259,1038,1024,7,14,"PODEMOS",145
26,"26180",221,182,179,0,3,"PODEMOS",16
26,"26118",61,49,49,1,0,"PODEMOS",8
26,"26146",101,78,77,0,1,"PODEMOS",10
26,"26124",824,664,659,8,5,"PODEMOS",43
26,"26036",16990,12136,11984,98,152,"PODEMOS",1673
26,"26151",446,380,375,1,5,"PODEMOS",34
26,"26056",425,357,353,6,4,"PODEMOS",46
26,"26152",31,24,23,0,1,"PODEMOS",2
26,"26026",1323,1070,1060,8,10,"PODEMOS",60
26,"26106",88,78,78,0,0,"PODEMOS",13
26,"26088",36,32,31,0,1,"PODEMOS",4
26,"26139",54,46,46,0,0,"PODEMOS",4
26,"26013",356,264,262,3,2,"PODEMOS",48
26,"26060",85,67,67,1,0,"PODEMOS",12
26,"26126",31,29,29,0,0,"PODEMOS",1
26,"26176",54,46,43,1,3,"PODEMOS",1
26,"26010",98,78,78,1,0,"PODEMOS",3
20,"20040",15321,10260,10176,69,84,"PODEMOS-AHA",2863
20,"20018",11074,7100,7059,29,41,"PODEMOS-AHA",1006
20,"20016",1514,885,884,5,1,"PODEMOS-AHA",187
20,"20049",4124,2793,2780,22,13,"PODEMOS-AHA",550
20,"20031",180,105,102,1,3,"PODEMOS-AHA",15
20,"20005",1261,811,805,7,6,"PODEMOS-AHA",131
20,"20026",202,141,129,4,12,"PODEMOS-AHA",10
20,"20071",14818,10095,10057,62,38,"PODEMOS-AHA",2480
20,"20004",252,135,135,2,0,"PODEMOS-AHA",20
20,"20021",199,110,110,2,0,"PODEMOS-AHA",15
20,"20014",1111,635,632,4,3,"PODEMOS-AHA",127
20,"20024",393,226,226,2,0,"PODEMOS-AHA",35
20,"20054",447,301,297,5,4,"PODEMOS-AHA",24
20,"20041",258,148,148,2,0,"PODEMOS-AHA",30
20,"20074",11610,8382,8320,43,62,"PODEMOS-AHA",1973
20,"20006",262,161,159,1,2,"PODEMOS-AHA",25
20,"20064",12526,8429,8387,59,42,"PODEMOS-AHA",2597
20,"20036",13148,9191,9132,85,59,"PODEMOS-AHA",2471
20,"20009",11528,7997,7955,57,42,"PODEMOS-AHA",2339
20,"20043",1740,1157,1152,6,5,"PODEMOS-AHA",143
20,"20050",263,160,160,4,0,"PODEMOS-AHA",20
20,"20002",343,227,226,10,1,"PODEMOS-AHA",45
20,"20076",6978,4975,4958,39,17,"PODEMOS-AHA",1219
20,"20063",7990,5449,5415,23,34,"PODEMOS-AHA",1108
20,"20039",2111,1539,1532,13,7,"PODEMOS-AHA",217
20,"20022",834,499,494,7,5,"PODEMOS-AHA",73
20,"20046",1167,797,794,4,3,"PODEMOS-AHA",189
20,"20904",96,62,62,0,0,"PODEMOS-AHA",5
20,"20066",461,279,276,3,3,"PODEMOS-AHA",11
20,"20029",4258,3005,2992,17,13,"PODEMOS-AHA",616
20,"20037",97,59,59,1,0,"PODEMOS-AHA",10
20,"20069",147189,106909,106506,699,403,"PODEMOS-AHA",27478
20,"20011",1660,1283,1278,9,5,"PODEMOS-AHA",220
20,"20038",392,284,281,1,3,"PODEMOS-AHA",35
20,"20052",1091,797,792,6,5,"PODEMOS-AHA",175
20,"20048",176,104,104,2,0,"PODEMOS-AHA",28
20,"20075",4359,2852,2833,16,19,"PODEMOS-AHA",589
20,"20060",89,76,75,2,1,"PODEMOS-AHA",0
20,"20901",1441,982,979,2,3,"PODEMOS-AHA",261
20,"20907",120,85,84,2,1,"PODEMOS-AHA",23
20,"20072",4731,3132,3123,23,9,"PODEMOS-AHA",882
20,"20067",30825,21606,21512,113,94,"PODEMOS-AHA",7147
20,"20020",129,71,71,0,0,"PODEMOS-AHA",2
20,"20028",2255,1503,1494,17,9,"PODEMOS-AHA",308
20,"20007",304,209,209,5,0,"PODEMOS-AHA",30
20,"20061",4273,2832,2816,21,16,"PODEMOS-AHA",651
20,"20902",14193,10263,10219,56,44,"PODEMOS-AHA",2883
20,"20065",3006,2104,2089,18,15,"PODEMOS-AHA",384
20,"20905",141,105,105,0,0,"PODEMOS-AHA",15
20,"20059",8863,6091,6072,30,19,"PODEMOS-AHA",967
20,"20077",5243,3792,3777,25,15,"PODEMOS-AHA",772
20,"20068",183,117,115,0,2,"PODEMOS-AHA",19
20,"20042",3251,2170,2152,23,18,"PODEMOS-AHA",527
20,"20058",746,547,546,3,1,"PODEMOS-AHA",118
20,"20015",1272,924,921,9,3,"PODEMOS-AHA",111
20,"20073",4677,3219,3208,21,11,"PODEMOS-AHA",690
20,"20055",17522,12125,12043,52,82,"PODEMOS-AHA",3069
20,"20001",242,138,137,1,1,"PODEMOS-AHA",9
20,"20034",3157,2145,2141,7,4,"PODEMOS-AHA",497
20,"20053",4765,3150,3132,18,18,"PODEMOS-AHA",1054
20,"20044",368,264,259,0,5,"PODEMOS-AHA",53
20,"20070",1099,749,744,4,5,"PODEMOS-AHA",91
20,"20032",8785,6115,6076,45,39,"PODEMOS-AHA",1243
20,"20903",4247,2846,2826,9,20,"PODEMOS-AHA",825
20,"20012",144,108,108,3,0,"PODEMOS-AHA",9
20,"20906",121,84,84,1,0,"PODEMOS-AHA",16
20,"20078",1155,866,864,6,2,"PODEMOS-AHA",93
20,"20079",17835,12650,12587,81,63,"PODEMOS-AHA",3072
20,"20017",8580,5807,5770,37,37,"PODEMOS-AHA",1101
20,"20056",4104,2654,2633,12,21,"PODEMOS-AHA",525
20,"20013",5427,3901,3875,19,26,"PODEMOS-AHA",915
20,"20008",721,382,376,5,6,"PODEMOS-AHA",52
20,"20023",445,258,258,2,0,"PODEMOS-AHA",63
20,"20045",46691,32759,32560,222,199,"PODEMOS-AHA",10451
20,"20033",864,629,625,3,4,"PODEMOS-AHA",103
20,"20019",10053,6876,6844,72,32,"PODEMOS-AHA",1565
20,"20003",541,334,334,3,0,"PODEMOS-AHA",56
20,"20062",982,685,684,3,1,"PODEMOS-AHA",120
20,"20010",1494,1055,1053,4,2,"PODEMOS-AHA",247
20,"20030",21515,15110,15019,108,91,"PODEMOS-AHA",3750
20,"20047",477,329,329,2,0,"PODEMOS-AHA",61
20,"20057",201,122,121,0,1,"PODEMOS-AHA",21
20,"20051",6904,5001,4975,31,26,"PODEMOS-AHA",1016
20,"20027",2816,1842,1833,11,9,"PODEMOS-AHA",315
20,"20035",482,329,328,4,1,"PODEMOS-AHA",55
20,"20025",1144,774,767,5,7,"PODEMOS-AHA",98
20,"20080",7900,5517,5487,33,30,"PODEMOS-AHA",1223
20,"20081",7460,5187,5159,33,28,"PODEMOS-AHA",1222
40,"40903",91,68,68,1,0,"PODEMOS",3
40,"40092",119,89,89,0,0,"PODEMOS",5
40,"40163",55,39,38,1,1,"PODEMOS",2
40,"40126",85,65,63,0,2,"PODEMOS",11
40,"40233",419,340,336,2,4,"PODEMOS",70
40,"40002",37,33,33,1,0,"PODEMOS",9
40,"40176",402,319,317,3,2,"PODEMOS",45
40,"40036",519,424,411,9,13,"PODEMOS",27
40,"40086",698,591,580,11,11,"PODEMOS",61
40,"40022",207,162,160,3,2,"PODEMOS",30
40,"40228",507,401,396,0,5,"PODEMOS",33
40,"40100",275,224,214,2,10,"PODEMOS",17
40,"40171",33,24,24,0,0,"PODEMOS",1
40,"40057",1488,1240,1228,14,12,"PODEMOS",218
40,"40101",874,672,669,11,3,"PODEMOS",114
40,"40132",66,32,30,1,2,"PODEMOS",3
40,"40079",234,182,181,1,1,"PODEMOS",27
40,"40182",184,139,136,1,3,"PODEMOS",22
40,"40060",81,59,59,0,0,"PODEMOS",2
40,"40229",38,28,28,0,0,"PODEMOS",5
40,"40142",53,43,43,0,0,"PODEMOS",3
40,"40074",266,226,223,2,3,"PODEMOS",22
40,"40020",168,130,129,2,1,"PODEMOS",21
40,"40120",192,167,166,1,1,"PODEMOS",21
40,"40075",163,130,130,0,0,"PODEMOS",14
40,"40012",271,205,202,3,3,"PODEMOS",12
40,"40189",513,403,391,3,12,"PODEMOS",59
40,"40115",104,80,79,0,1,"PODEMOS",7
40,"40155",3480,2762,2723,29,39,"PODEMOS",514
40,"40216",755,628,621,7,7,"PODEMOS",72
40,"40047",31,24,24,0,0,"PODEMOS",2
40,"40136",114,84,81,3,3,"PODEMOS",18
40,"40009",50,41,41,0,0,"PODEMOS",2
40,"40149",528,401,390,7,11,"PODEMOS",57
40,"40157",50,43,43,0,0,"PODEMOS",5
40,"40033",59,48,48,4,0,"PODEMOS",8
40,"40076",6550,5029,4942,29,87,"PODEMOS",851
40,"40180",299,244,239,2,5,"PODEMOS",14
40,"40077",805,633,625,6,8,"PODEMOS",146
40,"40048",38,30,30,0,0,"PODEMOS",4
40,"40191",222,163,161,2,2,"PODEMOS",18
40,"40902",125,102,102,0,0,"PODEMOS",5
40,"40070",147,111,107,1,4,"PODEMOS",22
40,"40035",140,109,108,3,1,"PODEMOS",20
40,"40204",167,127,126,2,1,"PODEMOS",8
40,"40095",475,376,370,7,6,"PODEMOS",26
40,"40122",514,416,403,0,13,"PODEMOS",82
40,"40223",226,173,169,0,4,"PODEMOS",29
40,"40192",157,130,128,1,2,"PODEMOS",8
40,"40045",112,89,88,1,1,"PODEMOS",15
40,"40234",407,326,322,3,4,"PODEMOS",29
40,"40099",60,50,48,1,2,"PODEMOS",3
40,"40222",174,147,147,0,0,"PODEMOS",22
40,"40112",2525,2054,2034,18,20,"PODEMOS",292
40,"40196",34,26,26,1,0,"PODEMOS",1
40,"40174",361,252,250,0,2,"PODEMOS",14
40,"40183",130,113,112,1,1,"PODEMOS",2
40,"40211",75,63,63,1,0,"PODEMOS",8
40,"40195",910,709,702,13,7,"PODEMOS",69
40,"40065",496,389,381,8,8,"PODEMOS",42
40,"40193",230,171,168,5,3,"PODEMOS",15
40,"40061",70,55,54,0,1,"PODEMOS",8
40,"40159",141,104,104,0,0,"PODEMOS",8
40,"40128",132,97,95,4,2,"PODEMOS",16
40,"40198",24,19,19,0,0,"PODEMOS",0
40,"40129",179,143,138,2,5,"PODEMOS",8
40,"40053",88,64,64,3,0,"PODEMOS",5
40,"40080",61,49,49,0,0,"PODEMOS",1
40,"40194",39796,30886,30516,287,370,"PODEMOS",4725
40,"40007",77,62,62,0,0,"PODEMOS",2
40,"40034",81,62,62,0,0,"PODEMOS",0
40,"40154",21,13,13,0,0,"PODEMOS",0
40,"40044",144,116,115,6,1,"PODEMOS",5
40,"40221",49,42,41,0,1,"PODEMOS",2
40,"40073",405,345,339,4,6,"PODEMOS",19
40,"40165",80,62,60,1,2,"PODEMOS",8
40,"40172",44,29,29,0,0,"PODEMOS",1
40,"40186",41,32,32,0,0,"PODEMOS",4
40,"40190",51,46,45,0,1,"PODEMOS",6
40,"40107",104,83,81,1,2,"PODEMOS",5
40,"40200",41,31,31,0,0,"PODEMOS",2
40,"40178",103,70,68,0,2,"PODEMOS",2
40,"40213",89,71,71,1,0,"PODEMOS",4
40,"40004",472,371,368,2,3,"PODEMOS",32
40,"40097",124,105,105,0,0,"PODEMOS",12
40,"40164",180,139,137,0,2,"PODEMOS",7
40,"40040",2626,1847,1835,19,12,"PODEMOS",185
40,"40104",258,193,192,1,1,"PODEMOS",40
40,"40173",139,115,110,1,5,"PODEMOS",15
40,"40087",93,70,70,2,0,"PODEMOS",2
40,"40001",715,588,580,4,8,"PODEMOS",46
40,"40119",170,142,140,0,2,"PODEMOS",9
40,"40214",210,174,172,2,2,"PODEMOS",9
40,"40123",148,122,113,3,9,"PODEMOS",16
40,"40141",856,626,616,7,10,"PODEMOS",55
40,"40220",66,50,45,2,5,"PODEMOS",9
40,"40230",94,75,72,2,3,"PODEMOS",15
40,"40201",49,41,41,0,0,"PODEMOS",1
40,"40143",88,76,75,1,1,"PODEMOS",6
40,"40146",255,211,209,0,2,"PODEMOS",10
40,"40160",105,76,74,2,2,"PODEMOS",2
40,"40094",372,283,277,1,6,"PODEMOS",34
40,"40029",32,28,27,1,1,"PODEMOS",6
40,"40124",244,190,185,6,5,"PODEMOS",31
40,"40068",24,22,22,0,0,"PODEMOS",0
40,"40215",89,66,66,0,0,"PODEMOS",4
40,"40010",124,95,94,2,1,"PODEMOS",3
40,"40206",178,141,135,0,6,"PODEMOS",30
40,"40139",281,218,216,1,2,"PODEMOS",22
40,"40125",90,67,63,0,4,"PODEMOS",14
40,"40016",57,47,45,0,2,"PODEMOS",4
40,"40062",60,50,49,0,1,"PODEMOS",4
40,"40081",126,94,90,1,4,"PODEMOS",12
40,"40199",106,83,83,0,0,"PODEMOS",7
40,"40212",30,21,19,0,2,"PODEMOS",4
40,"40106",214,175,174,1,1,"PODEMOS",14
40,"40049",62,45,45,0,0,"PODEMOS",7
40,"40118",52,39,38,2,1,"PODEMOS",4
40,"40185",882,657,644,9,13,"PODEMOS",63
40,"40177",153,121,120,3,1,"PODEMOS",13
40,"40069",84,67,67,0,0,"PODEMOS",5
40,"40013",65,51,50,0,1,"PODEMOS",1
40,"40063",7132,5389,5297,56,92,"PODEMOS",809
40,"40026",113,106,106,0,0,"PODEMOS",27
40,"40151",44,35,35,0,0,"PODEMOS",5
40,"40093",77,67,67,5,0,"PODEMOS",12
40,"40138",2174,1739,1710,13,29,"PODEMOS",300
40,"40078",161,129,128,2,1,"PODEMOS",15
40,"40219",590,448,437,6,11,"PODEMOS",39
40,"40108",116,80,79,2,1,"PODEMOS",7
40,"40131",48,45,44,0,1,"PODEMOS",3
40,"40145",1111,917,903,8,14,"PODEMOS",118
40,"40904",353,307,307,2,0,"PODEMOS",59
40,"40014",58,46,45,0,1,"PODEMOS",3
40,"40901",377,307,300,1,7,"PODEMOS",62
40,"40043",1825,1455,1429,16,26,"PODEMOS",128
40,"40179",631,533,525,3,8,"PODEMOS",69
40,"40148",240,201,200,1,1,"PODEMOS",26
40,"40161",34,28,28,0,0,"PODEMOS",4
40,"40030",476,394,389,8,5,"PODEMOS",54
40,"40037",43,28,27,0,1,"PODEMOS",6
40,"40156",330,239,234,2,5,"PODEMOS",32
40,"40105",48,43,43,1,0,"PODEMOS",7
40,"40056",34,27,27,1,0,"PODEMOS",2
40,"40113",428,345,341,5,4,"PODEMOS",92
40,"40152",763,637,627,1,10,"PODEMOS",102
40,"40906",1973,1645,1627,16,18,"PODEMOS",321
40,"40905",133,96,95,0,1,"PODEMOS",4
40,"40109",75,49,46,1,3,"PODEMOS",3
40,"40134",729,587,573,8,14,"PODEMOS",50
40,"40224",24,18,18,0,0,"PODEMOS",2
40,"40188",95,70,70,1,0,"PODEMOS",13
40,"40005",31,26,26,0,0,"PODEMOS",2
40,"40039",213,167,165,2,2,"PODEMOS",21
40,"40225",1134,907,890,8,17,"PODEMOS",82
40,"40140",97,72,71,8,1,"PODEMOS",5
40,"40130",130,108,107,1,1,"PODEMOS",8
40,"40008",46,38,38,0,0,"PODEMOS",3
40,"40135",289,242,237,1,5,"PODEMOS",9
40,"40021",27,26,26,0,0,"PODEMOS",0
40,"40162",396,305,299,0,6,"PODEMOS",29
40,"40058",331,273,270,1,3,"PODEMOS",12
40,"40111",61,51,51,0,0,"PODEMOS",7
40,"40031",515,417,413,2,4,"PODEMOS",87
40,"40231",108,93,93,1,0,"PODEMOS",10
40,"40089",218,163,159,0,4,"PODEMOS",15
40,"40170",1315,1037,1026,9,11,"PODEMOS",95
40,"40052",81,62,62,0,0,"PODEMOS",12
40,"40041",987,791,777,18,14,"PODEMOS",69
40,"40127",33,22,20,1,2,"PODEMOS",0
40,"40046",90,69,69,0,0,"PODEMOS",14
40,"40205",266,194,192,2,2,"PODEMOS",21
40,"40082",115,90,88,4,2,"PODEMOS",1
40,"40168",34,27,27,0,0,"PODEMOS",4
40,"40028",103,90,89,2,1,"PODEMOS",11
40,"40083",77,54,53,1,1,"PODEMOS",3
40,"40088",292,219,218,0,1,"PODEMOS",31
40,"40019",37,32,31,0,1,"PODEMOS",5
40,"40018",90,70,68,0,2,"PODEMOS",5
40,"40025",142,119,117,0,2,"PODEMOS",11
40,"40071",46,42,39,0,3,"PODEMOS",6
40,"40006",21,17,17,0,0,"PODEMOS",2
40,"40084",61,49,49,2,0,"PODEMOS",6
40,"40015",30,21,21,1,0,"PODEMOS",0
40,"40166",260,224,222,2,2,"PODEMOS",12
40,"40072",200,167,163,3,4,"PODEMOS",45
40,"40091",116,89,89,0,0,"PODEMOS",3
40,"40203",895,722,716,6,6,"PODEMOS",131
40,"40181",4258,3391,3329,23,62,"PODEMOS",589
40,"40218",97,69,69,0,0,"PODEMOS",6
40,"40054",112,83,83,0,0,"PODEMOS",17
40,"40208",768,606,596,5,10,"PODEMOS",63
40,"40051",45,33,33,0,0,"PODEMOS",5
40,"40017",92,77,76,1,1,"PODEMOS",7
40,"40207",753,612,607,2,5,"PODEMOS",137
40,"40003",143,109,104,1,5,"PODEMOS",4
40,"40144",19,15,15,0,0,"PODEMOS",1
40,"40032",394,302,300,6,2,"PODEMOS",25
40,"40210",100,74,74,0,0,"PODEMOS",14
40,"40024",872,676,660,9,16,"PODEMOS",64
40,"40103",157,128,128,0,0,"PODEMOS",17
40,"40059",112,96,96,2,0,"PODEMOS",8
40,"40184",253,210,210,3,0,"PODEMOS",12
40,"40055",36,25,23,0,2,"PODEMOS",2
40,"40150",71,61,61,0,0,"PODEMOS",6
40,"40158",18,12,12,0,0,"PODEMOS",1
40,"40121",286,230,225,3,5,"PODEMOS",17
40,"40110",349,272,272,1,0,"PODEMOS",47
40,"40202",63,41,41,0,0,"PODEMOS",2
35,"35002",23129,15904,15675,74,229,"PP",4255
35,"35028",9705,5552,5478,64,74,"PP",1616
35,"35022",48059,30474,30134,219,340,"PP",7782
35,"35023",11680,8467,8295,75,172,"PP",2760
35,"35021",14942,10691,10537,80,154,"PP",3468
35,"35024",13621,8665,8555,76,110,"PP",1559
35,"35010",3548,2371,2336,20,35,"PP",470
35,"35020",6054,4073,4018,26,55,"PP",1054
35,"35006",30302,21967,21625,243,342,"PP",5633
35,"35034",7707,3921,3872,30,49,"PP",975
35,"35017",25447,15415,15079,127,336,"PP",3919
35,"35019",32253,19902,19621,126,281,"PP",5975
35,"35016",297974,198159,195935,1546,2224,"PP",55289
35,"35013",6609,4997,4881,51,116,"PP",2177
35,"35008",6109,4631,4542,37,89,"PP",1429
35,"35014",11169,6234,6107,59,127,"PP",1671
35,"35033",6378,4412,4354,24,58,"PP",1446
35,"35018",12463,7628,7546,56,82,"PP",1673
35,"35012",10331,5684,5610,32,74,"PP",2111
35,"35009",19832,14305,14036,97,269,"PP",4242
35,"35005",1071,718,711,6,7,"PP",262
35,"35011",23882,16369,16095,107,274,"PP",4454
35,"35031",7270,5184,5000,36,184,"PP",1837
35,"35004",38814,20869,20641,192,228,"PP",4306
35,"35007",515,332,330,2,2,"PP",114
35,"35027",10311,7497,7364,58,133,"PP",2652
35,"35025",1801,1239,1216,9,23,"PP",609
35,"35015",9870,5451,5368,29,83,"PP",1131
35,"35032",3432,2541,2498,19,43,"PP",1174
35,"35001",4599,3455,3396,27,59,"PP",1180
35,"35003",5125,2989,2929,21,60,"PP",861
35,"35030",9205,5602,5501,58,101,"PP",1467
35,"35029",4125,2545,2514,34,31,"PP",516
35,"35026",80806,53749,52665,450,1084,"PP",15173
1,"1023",269,197,195,2,2,"EB - AZ",0
1,"1051",3606,2413,2389,21,24,"EB - AZ",4
1,"1016",439,255,249,3,6,"EB - AZ",2
1,"1057",245,203,202,0,1,"EB - AZ",0
1,"1049",140,108,108,0,0,"EB - AZ",0
1,"1054",952,694,688,4,6,"EB - AZ",2
1,"1053",587,367,365,3,2,"EB - AZ",1
1,"1030",159,126,123,1,3,"EB - AZ",0
1,"1052",244,188,186,1,2,"EB - AZ",1
1,"1001",1984,1426,1405,8,21,"EB - AZ",5
1,"1010",2275,1729,1717,17,12,"EB - AZ",0
1,"1004",1405,1026,1010,7,16,"EB - AZ",2
1,"1039",202,161,156,0,5,"EB - AZ",0
1,"1036",15034,10733,10619,73,114,"EB - AZ",12
1,"1043",2318,1644,1624,8,20,"EB - AZ",0
1,"1063",1799,1320,1309,10,11,"EB - AZ",9
1,"1047",964,713,702,13,11,"EB - AZ",0
1,"1060",199,162,159,0,3,"EB - AZ",0
1,"1003",1186,842,833,19,9,"EB - AZ",1
1,"1027",416,268,268,0,0,"EB - AZ",1
1,"1021",460,336,332,1,4,"EB - AZ",1
1,"1011",237,177,175,7,2,"EB - AZ",0
1,"1031",1183,907,885,6,22,"EB - AZ",2
1,"1008",790,548,542,13,6,"EB - AZ",0
1,"1017",869,584,577,4,7,"EB - AZ",1
1,"1019",144,112,111,2,1,"EB - AZ",0
1,"1059",186354,135873,134633,948,1240,"EB - AZ",394
1,"1055",836,564,552,8,12,"EB - AZ",0
1,"1022",805,593,587,3,6,"EB - AZ",1
1,"1028",1077,759,753,6,6,"EB - AZ",0
1,"1058",1327,843,833,8,10,"EB - AZ",2
1,"1061",153,132,132,2,0,"EB - AZ",0
1,"1041",153,105,100,1,5,"EB - AZ",0
1,"1002",8139,5961,5878,32,83,"EB - AZ",8
1,"1014",372,292,284,1,8,"EB - AZ",1
1,"1009",1281,908,898,2,10,"EB - AZ",4
1,"1901",2344,1688,1669,17,19,"EB - AZ",7
1,"1046",594,445,435,3,10,"EB - AZ",0
1,"1044",236,189,187,1,2,"EB - AZ",0
1,"1032",522,368,361,0,7,"EB - AZ",0
1,"1006",176,142,141,1,1,"EB - AZ",2
1,"1013",711,486,483,3,3,"EB - AZ",1
1,"1020",326,232,228,0,4,"EB - AZ",1
1,"1033",649,512,508,5,4,"EB - AZ",0
1,"1042",901,653,650,11,3,"EB - AZ",2
1,"1056",218,141,140,1,1,"EB - AZ",0
1,"1062",314,215,215,3,0,"EB - AZ",0
1,"1902",738,537,528,4,9,"EB - AZ",0
1,"1018",1370,964,963,4,1,"EB - AZ",2
1,"1037",586,425,419,2,6,"EB - AZ",0
1,"1034",165,120,119,1,1,"EB - AZ",1
46,"46189",471,412,405,2,7,"IFem",1
46,"46076",587,489,483,2,6,"IFem",1
46,"46097",959,734,728,6,6,"IFem",1
46,"46221",339,305,303,0,2,"IFem",0
46,"46078",28126,20975,20850,127,125,"IFem",22
46,"46200",1909,1628,1609,5,19,"IFem",0
46,"46184",26467,20888,20675,138,213,"IFem",30
46,"46083",15467,11584,11443,79,141,"IFem",5
46,"46113",2436,1864,1849,11,15,"IFem",0
46,"46092",273,183,183,0,0,"IFem",0
46,"46102",19843,15783,15676,102,107,"IFem",15
46,"46172",5040,3629,3599,14,30,"IFem",1
46,"46205",14323,11325,11224,55,101,"IFem",10
46,"46033",197,169,168,1,1,"IFem",0
46,"46237",7227,5620,5571,33,49,"IFem",2
46,"46250",578668,455375,452638,2701,2737,"IFem",300
46,"46051",8347,6500,6442,27,58,"IFem",1
46,"46150",1839,1377,1362,10,15,"IFem",0
46,"46212",1612,1234,1214,5,20,"IFem",1
46,"46194",15552,11606,11505,69,101,"IFem",12
46,"46151",722,589,583,1,6,"IFem",0
46,"46037",1119,952,941,2,11,"IFem",0
46,"46021",23646,18220,18100,85,120,"IFem",16
46,"46068",354,305,297,1,8,"IFem",0
46,"46144",665,525,520,2,5,"IFem",1
46,"46128",1601,1316,1281,5,35,"IFem",1
46,"46106",1543,1177,1167,5,10,"IFem",0
46,"46235",21793,16577,16424,118,153,"IFem",16
46,"46159",22905,17498,17373,102,125,"IFem",16
46,"46140",349,288,284,2,4,"IFem",0
46,"46065",1588,1246,1227,5,19,"IFem",2
46,"46107",1915,1566,1553,2,13,"IFem",1
46,"46127",2706,2212,2175,10,37,"IFem",8
46,"46111",10876,8133,8050,35,83,"IFem",4
46,"46041",331,254,253,6,1,"IFem",0
46,"46202",16767,13171,13058,59,113,"IFem",9
46,"46121",105,92,91,2,1,"IFem",0
46,"46188",668,548,538,3,10,"IFem",1
46,"46017",33050,24762,24580,144,182,"IFem",12
46,"46226",48,44,44,0,0,"IFem",1
46,"46261",1720,1386,1369,10,17,"IFem",0
46,"46126",5555,4619,4574,26,45,"IFem",3
46,"46122",2701,2120,2109,18,11,"IFem",1
46,"46179",2182,1823,1788,13,35,"IFem",1
46,"46081",10180,8055,7984,32,71,"IFem",3
46,"46168",1938,1542,1530,11,12,"IFem",0
46,"46166",8155,6521,6450,41,71,"IFem",3
46,"46210",338,295,283,2,12,"IFem",1
46,"46178",4643,3465,3434,16,31,"IFem",1
46,"46022",15481,11422,11347,69,75,"IFem",16
46,"46134",2357,1811,1797,8,14,"IFem",1
46,"46203",3598,2962,2928,17,34,"IFem",0
46,"46215",1433,1152,1149,4,3,"IFem",0
46,"46182",1274,970,966,2,4,"IFem",1
46,"46204",6781,5421,5379,15,42,"IFem",4
46,"46035",6786,5382,5338,27,44,"IFem",12
46,"46135",9655,7845,7810,32,35,"IFem",2
46,"46242",340,291,285,1,6,"IFem",0
46,"46049",280,242,238,1,4,"IFem",0
46,"46216",5039,4207,4188,20,19,"IFem",1
46,"46129",521,435,434,2,1,"IFem",1
46,"46086",82,73,73,1,0,"IFem",0
46,"46145",21946,16629,16495,80,134,"IFem",14
46,"46042",3389,2886,2844,19,42,"IFem",1
46,"46082",4947,3843,3814,25,29,"IFem",2
46,"46013",17366,13952,13862,95,90,"IFem",12
46,"46192",767,573,568,1,5,"IFem",0
46,"46170",3451,2821,2775,16,46,"IFem",2
46,"46130",907,722,713,6,9,"IFem",1
46,"46059",1272,1066,1058,4,8,"IFem",0
46,"46054",11251,8795,8731,46,64,"IFem",6
46,"46183",6009,4624,4563,18,61,"IFem",3
46,"46231",2411,1759,1735,11,24,"IFem",1
46,"46247",1024,743,733,2,10,"IFem",0
46,"46053",560,454,451,2,3,"IFem",0
46,"46055",1273,1031,1021,4,10,"IFem",0
46,"46197",1956,1556,1543,8,13,"IFem",1
46,"46218",1074,930,912,1,18,"IFem",2
46,"46169",32396,25109,24953,169,156,"IFem",22
46,"46254",1012,786,775,1,11,"IFem",0
46,"46045",1261,1066,1041,3,25,"IFem",0
46,"46219",125,106,105,2,1,"IFem",0
46,"46060",9361,7285,7229,30,56,"IFem",8
46,"46256",6833,5087,5062,37,25,"IFem",6
46,"46156",2087,1712,1702,9,10,"IFem",0
46,"46005",22908,17565,17438,126,127,"IFem",8
46,"46198",846,702,693,1,9,"IFem",1
46,"46187",1310,1036,1028,6,8,"IFem",1
46,"46061",337,281,281,3,0,"IFem",0
46,"46063",1757,1399,1384,11,15,"IFem",0
46,"46006",4529,3803,3748,18,55,"IFem",3
46,"46230",13944,10746,10646,69,100,"IFem",8
46,"46087",127,99,99,1,0,"IFem",0
46,"46108",480,375,375,2,0,"IFem",0
46,"46011",7627,5496,5407,39,89,"IFem",3
46,"46016",1068,885,874,3,11,"IFem",0
46,"46196",153,131,130,0,1,"IFem",0
46,"46193",8795,7101,7061,40,40,"IFem",2
46,"46074",2690,2158,2145,18,13,"IFem",2
46,"46220",48393,35859,35571,250,288,"IFem",32
46,"46160",1912,1523,1514,3,9,"IFem",0
46,"46007",11953,9099,9038,65,61,"IFem",7
46,"46236",975,810,806,4,4,"IFem",1
46,"46047",525,443,435,2,8,"IFem",0
46,"46171",16587,12731,12627,79,104,"IFem",5
46,"46103",1270,1015,998,8,17,"IFem",0
46,"46232",894,715,712,5,3,"IFem",0
46,"46245",516,427,420,3,7,"IFem",0
46,"46207",6656,5355,5293,42,62,"IFem",4
46,"46162",1207,962,947,3,15,"IFem",0
46,"46075",149,132,130,2,2,"IFem",0
46,"46161",1481,1206,1194,6,12,"IFem",1
46,"46165",7115,5626,5576,31,50,"IFem",4
46,"46002",1175,947,935,5,12,"IFem",3
46,"46020",3784,3064,3012,15,52,"IFem",3
46,"46133",563,458,455,2,3,"IFem",0
46,"46259",503,410,406,2,4,"IFem",0
46,"46028",395,346,339,2,7,"IFem",0
46,"46143",4215,3219,3171,27,48,"IFem",3
46,"46009",3144,2579,2552,13,27,"IFem",3
46,"46026",1204,1044,1034,4,10,"IFem",0
46,"46260",2572,2100,2081,10,19,"IFem",2
46,"46091",115,101,100,1,1,"IFem",0
46,"46164",11777,8893,8798,54,95,"IFem",8
46,"46137",268,225,220,3,5,"IFem",0
46,"46036",583,384,381,8,3,"IFem",1
46,"46015",7231,5768,5711,33,57,"IFem",2
46,"46903",5985,4822,4796,24,26,"IFem",0
46,"46190",48824,36748,36542,238,206,"IFem",25
46,"46146",1670,1333,1318,11,15,"IFem",1
46,"46152",97,76,74,0,2,"IFem",0
46,"46904",802,662,654,7,8,"IFem",0
46,"46154",811,644,640,4,4,"IFem",0
46,"46069",161,126,122,0,4,"IFem",0
46,"46208",1114,931,922,3,9,"IFem",0
46,"46066",1255,1028,1020,6,8,"IFem",0
46,"46001",802,623,615,4,8,"IFem",1
46,"46217",886,724,712,3,12,"IFem",0
46,"46213",15476,11377,11246,110,131,"IFem",9
46,"46174",984,808,794,3,14,"IFem",0
46,"46101",858,731,723,4,8,"IFem",0
46,"46224",170,130,130,0,0,"IFem",0
46,"46227",915,771,765,5,6,"IFem",0
46,"46064",527,429,423,0,6,"IFem",0
46,"46080",1025,795,784,4,11,"IFem",0
46,"46032",5635,4529,4493,16,36,"IFem",0
46,"46120",1109,919,902,4,17,"IFem",0
46,"46131",49604,37767,37431,266,336,"IFem",21
46,"46225",346,299,290,0,9,"IFem",0
46,"46136",2534,2008,1990,13,18,"IFem",1
46,"46257",5579,4440,4391,26,49,"IFem",1
46,"46240",209,169,164,1,5,"IFem",0
46,"46141",438,359,348,4,11,"IFem",0
46,"46072",3625,2993,2931,37,62,"IFem",1
46,"46119",783,672,666,7,6,"IFem",0
46,"46148",1528,1206,1192,15,14,"IFem",0
46,"46094",20515,15885,15785,125,100,"IFem",12
46,"46043",145,131,131,0,0,"IFem",0
46,"46167",373,286,285,1,1,"IFem",0
46,"46004",1924,1582,1559,11,23,"IFem",1
46,"46177",4698,3715,3665,16,50,"IFem",3
46,"46158",1024,817,804,5,13,"IFem",0
46,"46023",328,294,287,2,7,"IFem",0
46,"46079",326,267,265,2,2,"IFem",0
46,"46241",400,324,314,1,10,"IFem",0
46,"46025",2502,2008,1993,6,15,"IFem",2
46,"46253",109,93,93,0,0,"IFem",0
46,"46089",2141,1649,1625,14,24,"IFem",1
46,"46902",379,314,313,3,1,"IFem",0
46,"46251",2490,2082,2045,11,37,"IFem",0
46,"46255",3145,2494,2470,19,24,"IFem",3
46,"46155",1035,865,846,2,19,"IFem",0
46,"46058",1779,1430,1409,10,21,"IFem",1
46,"46115",403,296,289,1,7,"IFem",0
46,"46088",176,140,138,0,2,"IFem",0
46,"46031",10520,7830,7759,70,71,"IFem",3
46,"46085",11147,8107,8033,57,74,"IFem",5
46,"46012",888,723,703,3,20,"IFem",0
46,"46039",2147,1746,1727,9,19,"IFem",0
46,"46195",1967,1612,1602,9,10,"IFem",3
46,"46138",345,292,292,0,0,"IFem",0
46,"46238",13324,10023,9939,50,84,"IFem",8
46,"46248",4873,3679,3639,18,40,"IFem",2
46,"46139",4495,3629,3577,26,52,"IFem",3
46,"46229",972,785,774,2,11,"IFem",1
46,"46234",354,289,287,2,2,"IFem",0
46,"46118",3795,2987,2962,18,25,"IFem",0
46,"46104",1956,1567,1543,6,24,"IFem",0
46,"46040",1098,914,907,4,7,"IFem",0
46,"46071",466,383,379,2,4,"IFem",0
46,"46252",126,95,93,0,2,"IFem",0
46,"46098",2491,1978,1950,14,28,"IFem",0
46,"46246",1066,856,838,7,18,"IFem",0
46,"46147",16843,12206,12099,56,107,"IFem",9
46,"46057",495,339,337,6,2,"IFem",0
46,"46114",575,488,484,3,4,"IFem",2
46,"46124",788,680,672,0,8,"IFem",0
46,"46199",5742,4458,4425,34,33,"IFem",3
46,"46038",345,255,255,0,0,"IFem",1
46,"46048",3448,2817,2790,8,27,"IFem",1
46,"46258",2676,2099,2078,9,21,"IFem",3
46,"46117",493,414,411,4,3,"IFem",0
46,"46044",4237,3347,3285,25,62,"IFem",3
46,"46228",2363,1854,1839,16,15,"IFem",0
46,"46093",2117,1721,1710,10,11,"IFem",0
46,"46211",1723,1441,1434,13,7,"IFem",0
46,"46233",3904,2974,2934,15,40,"IFem",3
46,"46262",232,172,168,0,4,"IFem",0
46,"46116",13153,10566,10518,62,48,"IFem",6
46,"46030",804,660,635,7,25,"IFem",0
46,"46112",552,466,464,1,2,"IFem",1
46,"46123",1838,1466,1447,4,19,"IFem",1
46,"46029",20649,15241,15110,113,131,"IFem",16
46,"46050",200,160,160,0,0,"IFem",0
46,"46090",1640,1440,1424,4,16,"IFem",2
46,"46034",1776,1441,1430,4,11,"IFem",1
46,"46018",635,531,522,3,9,"IFem",0
46,"46105",16249,11731,11629,59,102,"IFem",4
46,"46244",58586,43371,43098,257,273,"IFem",29
46,"46095",608,498,493,2,5,"IFem",0
46,"46003",963,841,815,1,26,"IFem",1
46,"46024",424,348,340,0,8,"IFem",0
46,"46153",441,358,354,0,4,"IFem",0
46,"46070",16903,13091,12999,64,92,"IFem",4
46,"46109",6195,4764,4682,23,82,"IFem",3
46,"46027",948,795,781,3,14,"IFem",0
46,"46180",682,581,572,1,9,"IFem",1
46,"46052",502,432,431,2,1,"IFem",0
46,"46249",9362,7163,7072,42,91,"IFem",3
46,"46149",362,288,287,2,1,"IFem",0
46,"46176",2025,1431,1416,10,15,"IFem",1
46,"46073",1097,903,892,6,11,"IFem",2
46,"46191",1970,1557,1533,6,24,"IFem",0
46,"46096",279,229,225,2,4,"IFem",0
46,"46062",4652,3650,3583,32,67,"IFem",3
46,"46175",459,403,396,1,7,"IFem",0
46,"46223",7814,6169,6129,33,40,"IFem",2
46,"46214",15730,12427,12334,56,93,"IFem",8
46,"46206",577,475,468,4,7,"IFem",1
46,"46125",857,709,701,5,8,"IFem",0
46,"46157",2978,2370,2343,19,27,"IFem",0
46,"46084",1576,1314,1298,6,16,"IFem",1
46,"46185",386,325,321,4,4,"IFem",0
46,"46239",451,353,351,3,2,"IFem",0
46,"46077",7569,6100,6010,41,90,"IFem",2
46,"46110",21260,16194,16084,76,110,"IFem",14
46,"46222",383,322,321,2,1,"IFem",0
46,"46014",3042,2456,2434,17,22,"IFem",0
46,"46142",797,619,608,2,11,"IFem",1
46,"46209",1955,1531,1508,7,23,"IFem",1
46,"46132",2148,1850,1830,12,20,"IFem",1
46,"46186",19033,15061,14950,70,111,"IFem",16
46,"46010",914,725,716,4,9,"IFem",1
46,"46067",1736,1457,1382,2,75,"IFem",1
46,"46046",896,697,686,1,11,"IFem",0
46,"46056",184,160,158,1,2,"IFem",0
46,"46181",17066,12779,12636,96,143,"IFem",9
46,"46019",8833,7183,7109,47,74,"IFem",1
46,"46099",922,693,685,0,8,"IFem",0
46,"46100",289,240,237,1,3,"IFem",0
46,"46201",67,49,49,0,0,"IFem",0
46,"46163",1847,1508,1489,8,19,"IFem",0
46,"46173",1336,1097,1080,9,17,"IFem",0
46,"46263",255,204,202,1,2,"IFem",0
46,"46008",2673,2201,2189,8,12,"IFem",0
46,"46243",141,122,120,0,2,"IFem",0
5,"5172",123,104,102,2,2,"UPYD",1
5,"5062",184,155,154,2,1,"UPYD",1
5,"5196",53,39,39,0,0,"UPYD",0
5,"5042",155,126,125,0,1,"UPYD",1
5,"5238",787,565,556,4,9,"UPYD",3
5,"5101",316,240,238,1,2,"UPYD",0
5,"5076",481,401,387,5,14,"UPYD",4
5,"5160",323,263,260,1,3,"UPYD",1
5,"5077",161,137,136,2,1,"UPYD",0
5,"5081",39,33,31,0,2,"UPYD",0
5,"5040",68,45,45,0,0,"UPYD",0
5,"5218",121,97,95,0,2,"UPYD",1
5,"5192",100,82,81,1,1,"UPYD",0
5,"5159",254,175,174,2,1,"UPYD",7
5,"5164",27,19,19,1,0,"UPYD",0
5,"5199",39,32,32,0,0,"UPYD",0
5,"5124",107,83,81,1,2,"UPYD",1
5,"5171",73,58,57,2,1,"UPYD",0
5,"5053",86,58,58,0,0,"UPYD",0
5,"5084",74,56,56,1,0,"UPYD",0
5,"5161",586,483,473,2,10,"UPYD",5
5,"5057",2470,1977,1953,14,24,"UPYD",2
5,"5168",3565,2740,2711,17,29,"UPYD",47
5,"5059",109,79,76,1,3,"UPYD",0
5,"5117",201,178,174,2,4,"UPYD",0
5,"5010",149,119,118,1,1,"UPYD",0
5,"5092",155,120,120,0,0,"UPYD",2
5,"5234",51,46,46,1,0,"UPYD",0
5,"5107",64,39,39,1,0,"UPYD",0
5,"5119",33,20,20,0,0,"UPYD",0
5,"5188",45,38,38,0,0,"UPYD",0
5,"5195",224,162,161,1,1,"UPYD",0
5,"5237",164,131,126,1,5,"UPYD",0
5,"5129",129,78,78,0,0,"UPYD",2
5,"5106",36,27,27,0,0,"UPYD",0
5,"5209",83,63,63,0,0,"UPYD",1
5,"5224",106,87,86,0,1,"UPYD",2
5,"5194",138,122,121,5,1,"UPYD",2
5,"5235",124,111,110,1,1,"UPYD",0
5,"5247",250,147,146,1,1,"UPYD",1
5,"5080",59,42,40,0,2,"UPYD",0
5,"5079",70,54,54,0,0,"UPYD",0
5,"5060",120,99,99,1,0,"UPYD",0
5,"5001",194,153,152,1,1,"UPYD",2
5,"5041",1001,772,765,10,7,"UPYD",3
5,"5157",240,170,167,1,3,"UPYD",3
5,"5220",382,298,294,1,4,"UPYD",2
5,"5085",38,29,29,0,0,"UPYD",0
5,"5013",876,733,723,2,10,"UPYD",2
5,"5029",123,92,89,0,3,"UPYD",0
5,"5132",992,678,672,2,6,"UPYD",0
5,"5211",465,375,373,2,2,"UPYD",1
5,"5008",227,180,176,2,4,"UPYD",2
5,"5122",144,115,113,1,2,"UPYD",0
5,"5191",126,104,104,1,0,"UPYD",0
5,"5252",64,45,45,0,0,"UPYD",0
5,"5187",1755,1409,1395,11,14,"UPYD",4
5,"5016",6335,4873,4775,39,98,"UPYD",52
5,"5135",425,325,322,1,3,"UPYD",7
5,"5175",159,130,130,0,0,"UPYD",0
5,"5210",85,72,72,1,0,"UPYD",0
5,"5075",107,67,67,0,0,"UPYD",0
5,"5058",78,55,55,2,0,"UPYD",0
5,"5096",79,57,57,0,0,"UPYD",1
5,"5212",233,157,155,1,2,"UPYD",1
5,"5162",87,60,60,2,0,"UPYD",1
5,"5174",69,55,55,1,0,"UPYD",3
5,"5094",140,110,110,0,0,"UPYD",1
5,"5200",49,28,28,0,0,"UPYD",0
5,"5176",234,190,187,2,3,"UPYD",3
5,"5051",181,152,147,3,5,"UPYD",2
5,"5214",38,27,26,0,1,"UPYD",0
5,"5125",57,45,44,0,1,"UPYD",0
5,"5133",67,55,55,1,0,"UPYD",0
5,"5045",95,70,70,0,0,"UPYD",0
5,"5018",29,21,21,0,0,"UPYD",0
5,"5017",85,75,75,0,0,"UPYD",1
5,"5163",1756,1351,1345,1,6,"UPYD",11
5,"5239",207,163,162,1,1,"UPYD",2
5,"5056",96,73,73,0,0,"UPYD",0
5,"5251",68,40,40,0,0,"UPYD",0
5,"5126",70,59,59,0,0,"UPYD",0
5,"5197",98,90,90,0,0,"UPYD",1
5,"5095",266,220,218,0,2,"UPYD",2
5,"5015",87,66,65,1,1,"UPYD",0
5,"5139",76,66,66,0,0,"UPYD",1
5,"5118",84,57,57,0,0,"UPYD",1
5,"5121",241,186,185,3,1,"UPYD",3
5,"5170",52,46,46,0,0,"UPYD",0
5,"5204",611,473,471,1,2,"UPYD",7
5,"5257",140,98,98,0,0,"UPYD",1
5,"5241",3081,2143,2115,17,28,"UPYD",10
5,"5048",120,104,103,0,1,"UPYD",0
5,"5205",75,58,58,0,0,"UPYD",3
5,"5127",650,539,535,4,4,"UPYD",2
5,"5166",188,135,134,1,1,"UPYD",0
5,"5115",532,392,386,2,6,"UPYD",2
5,"5167",265,209,199,0,10,"UPYD",0
5,"5217",58,45,45,0,0,"UPYD",0
5,"5179",215,184,180,0,4,"UPYD",2
5,"5102",1807,1431,1412,7,19,"UPYD",0
5,"5141",95,86,86,2,0,"UPYD",1
5,"5049",399,301,291,1,10,"UPYD",5
5,"5258",113,98,97,0,1,"UPYD",0
5,"5087",137,93,93,0,0,"UPYD",6
5,"5243",88,61,61,1,0,"UPYD",0
5,"5120",35,26,26,0,0,"UPYD",0
5,"5136",97,74,73,5,1,"UPYD",1
5,"5249",107,82,82,0,0,"UPYD",0
5,"5099",497,398,381,3,17,"UPYD",0
5,"5240",3393,2354,2335,9,19,"UPYD",7
5,"5089",478,377,365,0,12,"UPYD",3
5,"5206",29,22,21,0,1,"UPYD",0
5,"5259",125,107,106,3,1,"UPYD",0
5,"5046",45,38,38,1,0,"UPYD",0
5,"5090",84,69,68,1,1,"UPYD",1
5,"5219",39,28,28,0,0,"UPYD",0
5,"5088",33,24,24,0,0,"UPYD",0
5,"5173",60,45,45,0,0,"UPYD",0
5,"5215",169,126,122,2,4,"UPYD",2
5,"5207",697,553,548,0,5,"UPYD",0
5,"5134",48,40,40,0,0,"UPYD",0
5,"5177",160,128,128,1,0,"UPYD",0
5,"5100",285,229,228,0,1,"UPYD",3
5,"5216",224,155,155,2,0,"UPYD",0
5,"5208",40,34,34,0,0,"UPYD",2
5,"5165",380,291,283,5,8,"UPYD",2
5,"5052",99,89,88,0,1,"UPYD",2
5,"5019",44606,34903,34564,285,339,"UPYD",498
5,"5261",42,26,26,0,0,"UPYD",0
5,"5182",801,559,546,9,13,"UPYD",2
5,"5105",349,279,270,3,9,"UPYD",3
5,"5065",469,388,385,6,3,"UPYD",1
5,"5024",231,169,163,5,6,"UPYD",10
5,"5246",60,42,42,0,0,"UPYD",0
5,"5158",371,289,287,1,2,"UPYD",0
5,"5144",79,62,60,2,2,"UPYD",1
5,"5025",96,73,72,1,1,"UPYD",0
5,"5012",135,110,108,0,2,"UPYD",0
5,"5221",353,270,264,3,6,"UPYD",0
5,"5140",116,97,96,0,1,"UPYD",2
5,"5131",105,70,69,1,1,"UPYD",0
5,"5093",417,313,311,1,2,"UPYD",0
5,"5262",358,278,277,1,1,"UPYD",0
5,"5054",1238,953,933,1,20,"UPYD",4
5,"5183",140,114,113,1,1,"UPYD",1
5,"5145",52,41,41,0,0,"UPYD",0
5,"5066",458,365,364,3,1,"UPYD",3
5,"5184",250,197,192,0,5,"UPYD",1
5,"5244",51,38,38,0,0,"UPYD",0
5,"5222",159,126,126,0,0,"UPYD",1
5,"5067",83,66,59,1,7,"UPYD",0
5,"5147",162,119,116,0,3,"UPYD",0
5,"5055",576,476,467,0,9,"UPYD",1
5,"5023",173,153,153,5,0,"UPYD",0
5,"5014",5422,4137,4084,30,53,"UPYD",18
5,"5236",128,85,84,0,1,"UPYD",1
5,"5169",226,178,176,1,2,"UPYD",1
5,"5201",529,439,431,2,8,"UPYD",3
5,"5104",34,23,22,1,1,"UPYD",0
5,"5027",269,220,218,2,2,"UPYD",1
5,"5148",27,17,17,0,0,"UPYD",0
5,"5264",62,43,42,1,1,"UPYD",0
5,"5069",74,58,58,0,0,"UPYD",0
5,"5185",94,80,80,1,0,"UPYD",0
5,"5225",372,316,315,5,1,"UPYD",0
5,"5039",56,43,42,0,1,"UPYD",0
5,"5064",103,87,87,1,0,"UPYD",0
5,"5143",66,55,55,1,0,"UPYD",0
5,"5043",84,67,67,0,0,"UPYD",0
5,"5083",145,108,100,2,8,"UPYD",0
5,"5186",1572,1240,1222,9,18,"UPYD",6
5,"5265",82,70,70,0,0,"UPYD",4
5,"5044",259,180,180,0,0,"UPYD",0
5,"5109",454,378,362,3,16,"UPYD",0
5,"5226",77,57,57,0,0,"UPYD",0
5,"5030",46,37,37,0,0,"UPYD",0
5,"5070",32,26,26,0,0,"UPYD",0
5,"5110",721,559,552,3,7,"UPYD",3
5,"5149",105,76,75,0,1,"UPYD",0
5,"5123",96,69,66,2,3,"UPYD",1
5,"5213",101,83,83,0,0,"UPYD",0
5,"5097",474,324,317,3,7,"UPYD",6
5,"5266",102,89,89,0,0,"UPYD",0
5,"5033",174,139,138,0,1,"UPYD",1
5,"5253",88,70,70,0,0,"UPYD",0
5,"5072",87,70,69,1,1,"UPYD",0
5,"5112",97,72,70,1,2,"UPYD",1
5,"5267",100,65,64,0,1,"UPYD",0
5,"5026",197,170,169,1,1,"UPYD",0
5,"5151",93,70,70,1,0,"UPYD",0
5,"5227",373,250,248,0,2,"UPYD",5
5,"5073",297,243,238,4,5,"UPYD",1
5,"5152",690,561,558,3,3,"UPYD",2
5,"5263",172,137,137,0,0,"UPYD",0
5,"5034",15,12,12,1,0,"UPYD",0
5,"5228",179,126,126,0,0,"UPYD",1
5,"5082",528,437,427,5,10,"UPYD",0
5,"5086",82,66,64,1,2,"UPYD",0
5,"5108",51,30,30,0,0,"UPYD",0
5,"5113",78,58,58,1,0,"UPYD",0
5,"5901",273,187,185,5,2,"UPYD",1
5,"5047",4199,3287,3244,7,43,"UPYD",6
5,"5074",693,543,540,1,3,"UPYD",3
5,"5153",108,78,77,3,1,"UPYD",3
5,"5189",443,340,336,3,4,"UPYD",0
5,"5229",84,67,67,0,0,"UPYD",0
5,"5256",116,92,92,1,0,"UPYD",2
5,"5198",73,59,59,0,0,"UPYD",0
5,"5035",107,84,84,1,0,"UPYD",1
5,"5190",55,42,42,2,0,"UPYD",1
5,"5114",1359,1131,1115,5,16,"UPYD",0
5,"5902",288,227,227,0,0,"UPYD",1
5,"5178",371,295,289,0,6,"UPYD",2
5,"5002",1954,1471,1450,9,21,"UPYD",2
5,"5061",253,198,196,4,2,"UPYD",3
5,"5242",681,538,527,10,11,"UPYD",0
5,"5005",187,150,149,0,1,"UPYD",0
5,"5036",123,97,97,0,0,"UPYD",2
5,"5230",65,56,54,1,2,"UPYD",0
5,"5154",36,30,30,0,0,"UPYD",0
5,"5155",52,37,37,0,0,"UPYD",0
5,"5903",157,108,107,0,1,"UPYD",2
5,"5021",1932,1478,1456,12,22,"UPYD",10
5,"5231",160,126,124,1,2,"UPYD",5
5,"5128",350,289,284,4,5,"UPYD",2
5,"5037",261,165,163,3,2,"UPYD",0
5,"5007",113,74,74,1,0,"UPYD",1
5,"5103",78,56,56,0,0,"UPYD",0
5,"5254",196,166,166,0,0,"UPYD",0
5,"5904",133,92,91,1,1,"UPYD",0
5,"5063",34,24,24,0,0,"UPYD",0
5,"5022",1611,1279,1271,4,8,"UPYD",4
5,"5180",88,68,68,1,0,"UPYD",0
5,"5116",118,95,93,1,2,"UPYD",0
5,"5156",249,163,161,0,2,"UPYD",1
5,"5038",116,87,85,0,2,"UPYD",1
5,"5232",98,83,81,1,2,"UPYD",1
5,"5905",214,150,150,1,0,"UPYD",1
5,"5138",311,241,239,3,2,"UPYD",1
5,"5142",104,88,82,1,6,"UPYD",0
5,"5260",104,84,83,1,1,"UPYD",0
5,"5245",348,293,288,0,5,"UPYD",5
5,"5233",226,179,177,0,2,"UPYD",0
5,"5193",194,163,163,1,0,"UPYD",0
5,"5078",115,100,99,3,1,"UPYD",0
5,"5181",43,31,31,1,0,"UPYD",1
5,"5130",95,82,82,0,0,"UPYD",1
25,"25192",767,510,496,11,14,"DL",159
25,"25014",254,177,174,4,3,"DL",60
25,"25110",2796,1828,1807,30,21,"DL",502
25,"25250",344,236,234,0,2,"DL",77
25,"25902",570,390,379,3,11,"DL",124
25,"25158",1639,1163,1150,26,13,"DL",401
25,"25022",106,76,76,2,0,"DL",45
25,"25140",774,468,465,4,3,"DL",153
25,"25062",757,521,516,4,5,"DL",161
25,"25907",498,317,314,3,3,"DL",100
25,"25001",139,88,87,1,1,"DL",28
25,"25051",1522,990,983,10,7,"DL",312
25,"25141",156,101,99,1,2,"DL",32
25,"25217",10594,7016,6950,119,66,"DL",2014
25,"25224",126,86,86,1,0,"DL",31
25,"25006",346,214,212,6,2,"DL",28
25,"25212",234,173,171,1,2,"DL",61
25,"25247",123,72,72,0,0,"DL",5
25,"25230",1573,1100,1081,13,19,"DL",280
25,"25078",1007,720,717,6,3,"DL",222
25,"25112",272,189,189,2,0,"DL",49
25,"25222",67,52,52,1,0,"DL",24
25,"25208",316,191,189,1,2,"DL",40
25,"25010",212,131,130,6,1,"DL",36
25,"25255",426,308,302,4,6,"DL",87
25,"25041",569,380,374,7,6,"DL",103
25,"25203",8976,5588,5526,53,62,"DL",1270
25,"25145",85,64,64,2,0,"DL",32
25,"25254",738,507,493,6,14,"DL",113
25,"25002",484,323,321,2,2,"DL",91
25,"25165",280,194,190,4,4,"DL",86
25,"25104",125,86,86,3,0,"DL",38
25,"25156",791,574,571,7,3,"DL",188
25,"25225",575,395,393,6,2,"DL",149
25,"25007",1410,1005,996,13,9,"DL",198
25,"25115",824,551,549,12,2,"DL",240
25,"25092",132,93,89,1,4,"DL",34
25,"25220",1028,709,701,9,8,"DL",213
25,"25216",226,150,150,0,0,"DL",62
25,"25046",421,292,286,1,6,"DL",75
25,"25102",712,473,467,10,6,"DL",139
25,"25017",239,160,159,2,1,"DL",67
25,"25119",2259,1582,1569,22,13,"DL",548
25,"25903",237,154,152,3,2,"DL",57
25,"25130",197,117,117,3,0,"DL",48
25,"25909",155,89,89,3,0,"DL",34
25,"25202",101,72,72,0,0,"DL",16
25,"25093",639,451,445,11,6,"DL",157
25,"25132",130,97,95,1,2,"DL",23
25,"25067",730,483,479,4,4,"DL",115
25,"25105",130,95,93,4,2,"DL",45
25,"25227",641,398,395,3,3,"DL",151
25,"25037",385,245,241,2,4,"DL",77
25,"25139",479,325,324,3,1,"DL",99
25,"25142",368,252,251,3,1,"DL",49
25,"25082",280,169,167,3,2,"DL",52
25,"25151",670,466,459,3,7,"DL",170
25,"25087",61,46,45,0,1,"DL",17
25,"25153",198,141,137,0,4,"DL",28
25,"25240",1407,1006,995,10,11,"DL",241
25,"25069",453,289,286,6,3,"DL",91
25,"25120",92243,61433,61005,533,428,"DL",9076
25,"25123",193,131,130,0,1,"DL",39
25,"25089",106,58,58,0,0,"DL",9
25,"25015",355,258,257,3,1,"DL",76
25,"25218",84,66,66,0,0,"DL",32
25,"25049",151,104,104,1,0,"DL",40
25,"25027",1001,687,681,3,6,"DL",236
25,"25035",397,287,286,3,1,"DL",72
25,"25023",4527,3111,3073,20,38,"DL",710
25,"25215",334,244,243,2,1,"DL",50
25,"25004",571,425,423,5,2,"DL",136
25,"25906",226,144,143,0,1,"DL",40
25,"25243",3612,2449,2423,30,26,"DL",278
25,"25099",1260,804,793,8,11,"DL",310
25,"25252",548,399,398,6,1,"DL",121
25,"25113",1163,854,845,12,9,"DL",315
25,"25121",642,415,413,8,2,"DL",44
25,"25173",1702,1180,1171,5,9,"DL",185
25,"25053",1059,762,759,10,3,"DL",216
25,"25109",238,168,168,1,0,"DL",93
25,"25223",922,614,598,8,16,"DL",210
25,"25245",441,313,313,0,0,"DL",53
25,"25146",224,150,148,2,2,"DL",70
25,"25134",635,418,414,4,4,"DL",129
25,"25248",891,622,616,3,6,"DL",285
25,"25244",369,252,248,3,4,"DL",75
25,"25154",120,68,68,1,0,"DL",37
25,"25911",452,301,299,7,2,"DL",128
25,"25253",163,125,124,0,1,"DL",43
25,"25034",2331,1516,1505,20,11,"DL",580
25,"25125",424,279,273,4,6,"DL",67
25,"25100",212,134,134,3,0,"DL",62
25,"25031",52,31,31,0,0,"DL",3
25,"25171",2190,1461,1444,4,17,"DL",413
25,"25168",508,392,391,2,1,"DL",132
25,"25097",87,62,62,4,0,"DL",11
25,"25011",5256,3190,3161,36,29,"DL",645
25,"25183",501,332,331,4,1,"DL",110
25,"25122",1916,1274,1264,15,10,"DL",371
25,"25068",558,372,369,9,3,"DL",171
25,"25228",3043,2140,2118,21,22,"DL",539
25,"25111",115,83,83,1,0,"DL",41
25,"25155",667,463,459,5,4,"DL",163
25,"25008",1135,828,819,11,9,"DL",344
25,"25052",1573,1132,1122,16,10,"DL",355
25,"25149",1382,1010,993,7,17,"DL",405
25,"25038",1564,1075,1062,11,13,"DL",412
25,"25910",101,64,62,0,2,"DL",23
25,"25060",70,45,45,2,0,"DL",22
25,"25005",277,183,182,2,1,"DL",59
25,"25200",336,218,218,0,0,"DL",58
25,"25044",189,136,136,3,0,"DL",52
25,"25185",681,421,418,8,3,"DL",130
25,"25020",292,203,200,2,3,"DL",73
25,"25029",1662,1156,1147,13,9,"DL",360
25,"25009",631,465,460,3,5,"DL",158
25,"25076",146,84,84,1,0,"DL",23
25,"25138",576,415,408,6,7,"DL",133
25,"25040",10532,6837,6762,81,75,"DL",1635
25,"25124",169,118,116,2,2,"DL",45
25,"25210",1104,779,767,9,12,"DL",250
25,"25150",185,127,124,1,3,"DL",60
25,"25036",184,126,121,0,5,"DL",22
25,"25249",183,118,118,2,0,"DL",32
25,"25239",608,320,319,1,1,"DL",90
25,"25003",3782,2390,2372,24,18,"DL",692
25,"25157",181,139,137,1,2,"DL",45
25,"25234",4290,2645,2621,25,24,"DL",766
25,"25070",817,584,573,14,11,"DL",213
25,"25191",332,225,222,3,3,"DL",73
25,"25103",131,80,80,3,0,"DL",28
25,"25164",381,264,262,2,2,"DL",123
25,"25201",115,70,67,0,3,"DL",26
25,"25114",97,87,87,0,0,"DL",47
25,"25221",130,76,76,0,0,"DL",24
25,"25071",51,31,31,0,0,"DL",13
25,"25232",1421,961,950,10,11,"DL",225
25,"25189",2106,1392,1381,16,11,"DL",285
25,"25209",1517,1035,1019,6,16,"DL",289
25,"25143",87,58,57,1,1,"DL",21
25,"25152",140,100,98,4,2,"DL",31
25,"25175",194,132,132,7,0,"DL",34
25,"25133",713,469,464,1,5,"DL",205
25,"25048",1644,1151,1138,8,13,"DL",336
25,"25012",2296,1504,1488,8,16,"DL",279
25,"25056",243,151,150,2,1,"DL",60
25,"25064",112,85,85,3,0,"DL",47
25,"25024",356,233,230,1,3,"DL",68
25,"25233",278,193,191,2,2,"DL",49
25,"25075",117,82,82,0,0,"DL",31
25,"25176",312,239,235,7,4,"DL",89
25,"25063",91,55,55,0,0,"DL",5
25,"25131",412,271,261,8,10,"DL",43
25,"25039",280,182,180,0,2,"DL",45
25,"25207",6216,4062,4031,45,31,"DL",1109
25,"25057",206,152,151,2,1,"DL",14
25,"25226",251,156,153,3,3,"DL",55
25,"25094",139,111,109,0,2,"DL",48
25,"25043",794,505,501,3,4,"DL",147
25,"25025",1346,966,956,10,10,"DL",102
25,"25174",398,299,296,3,3,"DL",113
25,"25193",765,520,514,3,6,"DL",243
25,"25061",82,53,53,0,0,"DL",20
25,"25013",2171,1380,1366,10,14,"DL",246
25,"25047",1010,730,722,6,8,"DL",264
25,"25073",588,374,371,8,3,"DL",133
25,"25204",1241,843,827,3,16,"DL",226
25,"25058",4378,2810,2793,27,17,"DL",863
25,"25118",350,223,223,8,0,"DL",87
25,"25231",490,382,382,2,0,"DL",123
25,"25135",1032,707,701,7,6,"DL",267
25,"25074",182,145,141,0,4,"DL",49
25,"25101",565,393,388,9,5,"DL",112
25,"25251",710,495,494,3,1,"DL",146
25,"25016",2114,1417,1411,8,6,"DL",375
25,"25197",137,97,97,2,0,"DL",36
25,"25205",562,413,402,2,11,"DL",115
25,"25136",98,71,70,0,1,"DL",32
25,"25238",217,151,151,6,0,"DL",49
25,"25196",119,74,74,0,0,"DL",24
25,"25190",263,195,195,4,0,"DL",52
25,"25163",228,143,142,5,1,"DL",60
25,"25148",220,155,153,0,2,"DL",82
25,"25042",208,143,142,0,1,"DL",61
25,"25098",253,163,160,2,3,"DL",66
25,"25219",144,106,105,3,1,"DL",28
25,"25079",305,216,214,5,2,"DL",96
25,"25182",1043,738,727,13,11,"DL",144
25,"25126",286,214,210,5,4,"DL",50
25,"25045",52,36,36,0,0,"DL",4
25,"25085",152,106,106,0,0,"DL",32
25,"25186",214,141,138,2,3,"DL",58
25,"25161",368,234,232,3,2,"DL",68
25,"25170",264,182,179,1,3,"DL",54
25,"25181",177,138,137,5,1,"DL",51
25,"25086",533,373,372,5,1,"DL",128
25,"25127",212,135,134,3,1,"DL",50
25,"25033",1106,777,767,7,10,"DL",243
25,"25211",683,427,422,4,5,"DL",92
25,"25030",131,86,86,2,0,"DL",42
25,"25055",172,118,116,2,2,"DL",58
25,"25050",3253,2064,2048,27,16,"DL",652
25,"25072",5858,3878,3835,45,43,"DL",1025
25,"25194",426,278,273,0,5,"DL",132
25,"25032",61,44,43,0,1,"DL",8
25,"25077",460,272,269,2,3,"DL",75
25,"25129",176,113,110,6,3,"DL",50
25,"25096",912,586,572,9,14,"DL",162
25,"25177",372,258,258,2,0,"DL",82
25,"25169",188,125,124,3,1,"DL",36
25,"25059",801,590,584,11,6,"DL",49
25,"25179",161,115,114,0,1,"DL",54
25,"25088",96,76,75,0,1,"DL",40
25,"25167",236,158,156,3,2,"DL",61
25,"25912",868,618,617,5,1,"DL",78
25,"25137",8577,5630,5591,45,39,"DL",1568
25,"25019",4565,3001,2965,36,36,"DL",545
25,"25172",1805,1230,1214,8,16,"DL",398
25,"25206",257,164,164,3,0,"DL",72
25,"25908",228,138,137,3,1,"DL",42
25,"25128",142,89,89,0,0,"DL",26
25,"25166",177,123,121,1,2,"DL",43
25,"25021",2618,1655,1639,32,16,"DL",383
25,"25913",87,69,69,1,0,"DL",25
25,"25905",386,260,255,4,5,"DL",89
25,"25081",318,213,210,2,3,"DL",77
25,"25180",239,151,151,0,0,"DL",67
25,"25242",732,480,477,4,3,"DL",160
25,"25904",155,118,118,0,0,"DL",53
25,"25901",292,186,181,4,5,"DL",46
47,"47106",50,41,41,0,0,"RECORTES CE",0
47,"47053",116,96,96,1,0,"RECORTES CE",0
47,"47027",2746,2120,2095,8,25,"RECORTES CE",4
47,"47020",278,230,227,1,3,"RECORTES CE",0
47,"47190",93,80,78,4,2,"RECORTES CE",0
47,"47038",108,82,82,0,0,"RECORTES CE",0
47,"47135",84,76,76,2,0,"RECORTES CE",0
47,"47077",247,190,189,2,1,"RECORTES CE",0
47,"47132",45,37,35,0,2,"RECORTES CE",0
47,"47099",152,128,127,1,1,"RECORTES CE",0
47,"47006",190,145,144,1,1,"RECORTES CE",0
47,"47055",202,170,168,1,2,"RECORTES CE",0
47,"47028",33,20,20,0,0,"RECORTES CE",0
47,"47079",62,51,51,0,0,"RECORTES CE",0
47,"47080",30,22,22,0,0,"RECORTES CE",0
47,"47194",301,242,239,1,3,"RECORTES CE",0
47,"47122",2034,1666,1635,21,31,"RECORTES CE",2
47,"47111",1009,794,789,4,5,"RECORTES CE",2
47,"47213",115,83,83,0,0,"RECORTES CE",0
47,"47196",35,26,26,1,0,"RECORTES CE",0
47,"47219",42,36,34,2,2,"RECORTES CE",0
47,"47098",583,488,487,6,1,"RECORTES CE",0
47,"47137",29,28,28,1,0,"RECORTES CE",0
47,"47084",1171,911,898,15,13,"RECORTES CE",1
47,"47048",190,140,138,0,2,"RECORTES CE",0
47,"47044",330,291,287,0,4,"RECORTES CE",0
47,"47018",35,31,28,0,3,"RECORTES CE",0
47,"47025",120,97,97,2,0,"RECORTES CE",0
47,"47189",152,128,128,0,0,"RECORTES CE",0
47,"47014",50,45,45,0,0,"RECORTES CE",0
47,"47019",86,67,65,1,2,"RECORTES CE",0
47,"47224",91,74,74,1,0,"RECORTES CE",0
47,"47126",49,36,36,0,0,"RECORTES CE",0
47,"47149",43,33,32,1,1,"RECORTES CE",0
47,"47029",57,48,47,1,1,"RECORTES CE",0
47,"47046",121,93,93,0,0,"RECORTES CE",0
47,"47151",27,22,21,0,1,"RECORTES CE",0
47,"47022",57,50,46,0,4,"RECORTES CE",0
47,"47182",1342,1037,1023,16,14,"RECORTES CE",0
47,"47181",168,135,134,0,1,"RECORTES CE",0
47,"47113",156,121,121,0,0,"RECORTES CE",0
47,"47051",338,274,272,0,2,"RECORTES CE",0
47,"47139",1047,790,785,7,5,"RECORTES CE",1
47,"47158",906,686,668,3,18,"RECORTES CE",0
47,"47119",90,75,75,1,0,"RECORTES CE",0
47,"47168",31,28,27,0,1,"RECORTES CE",0
47,"47004",1199,946,938,11,8,"RECORTES CE",0
47,"47091",89,67,66,0,1,"RECORTES CE",0
47,"47015",199,151,151,0,0,"RECORTES CE",0
47,"47121",553,436,428,5,8,"RECORTES CE",0
47,"47138",237,180,176,1,4,"RECORTES CE",0
47,"47001",55,51,50,2,1,"RECORTES CE",0
47,"47086",3926,3065,3028,27,37,"RECORTES CE",3
47,"47005",548,426,421,4,5,"RECORTES CE",0
47,"47003",228,180,179,3,1,"RECORTES CE",0
47,"47056",82,58,57,0,1,"RECORTES CE",0
47,"47059",97,71,71,0,0,"RECORTES CE",0
47,"47127",135,98,96,1,2,"RECORTES CE",0
47,"47002",25,23,23,0,0,"RECORTES CE",0
47,"47226",161,128,127,1,1,"RECORTES CE",0
47,"47163",299,236,235,6,1,"RECORTES CE",1
47,"47133",2665,2140,2118,25,22,"RECORTES CE",0
47,"47177",107,78,76,0,2,"RECORTES CE",0
47,"47188",112,85,85,0,0,"RECORTES CE",0
47,"47065",863,681,671,4,10,"RECORTES CE",2
47,"47070",41,32,32,1,0,"RECORTES CE",0
47,"47153",108,74,73,1,1,"RECORTES CE",0
47,"47095",39,36,35,0,1,"RECORTES CE",0
47,"47192",105,80,79,1,1,"RECORTES CE",0
47,"47069",127,113,111,0,2,"RECORTES CE",0
47,"47140",119,101,100,1,1,"RECORTES CE",0
47,"47023",2999,2457,2445,20,12,"RECORTES CE",0
47,"47227",64,52,52,0,0,"RECORTES CE",0
47,"47161",3903,3200,3183,25,17,"RECORTES CE",3
47,"47118",161,119,118,0,1,"RECORTES CE",0
47,"47125",59,43,43,1,0,"RECORTES CE",1
47,"47026",49,40,40,0,0,"RECORTES CE",0
47,"47131",178,132,131,3,1,"RECORTES CE",0
47,"47207",277,216,212,3,4,"RECORTES CE",0
47,"47128",60,51,49,1,2,"RECORTES CE",0
47,"47087",379,318,314,4,4,"RECORTES CE",0
47,"47074",150,125,125,1,0,"RECORTES CE",0
47,"47193",1583,1313,1294,12,19,"RECORTES CE",1
47,"47009",106,80,80,1,0,"RECORTES CE",0
47,"47088",110,87,87,0,0,"RECORTES CE",0
47,"47047",202,157,157,3,0,"RECORTES CE",0
47,"47176",224,139,135,5,4,"RECORTES CE",0
47,"47179",398,299,295,3,4,"RECORTES CE",0
47,"47165",6987,5301,5115,63,186,"RECORTES CE",7
47,"47199",80,59,59,2,0,"RECORTES CE",0
47,"47097",331,268,263,1,5,"RECORTES CE",0
47,"47162",73,61,61,0,0,"RECORTES CE",0
47,"47142",148,114,113,0,1,"RECORTES CE",0
47,"47032",153,120,118,0,2,"RECORTES CE",0
47,"47157",515,442,441,3,1,"RECORTES CE",0
47,"47124",399,329,328,4,1,"RECORTES CE",0
47,"47191",110,74,74,0,0,"RECORTES CE",0
47,"47083",80,62,61,2,1,"RECORTES CE",0
47,"47228",445,359,357,4,2,"RECORTES CE",0
47,"47169",68,57,57,0,0,"RECORTES CE",0
47,"47172",148,120,120,1,0,"RECORTES CE",0
47,"47081",47,40,40,0,0,"RECORTES CE",0
47,"47217",1896,1436,1420,20,16,"RECORTES CE",4
47,"47043",302,239,239,3,0,"RECORTES CE",0
47,"47016",71,58,57,0,1,"RECORTES CE",0
47,"47166",265,203,199,3,4,"RECORTES CE",0
47,"47198",66,47,47,0,0,"RECORTES CE",0
47,"47034",76,59,58,1,1,"RECORTES CE",0
47,"47105",192,164,163,0,1,"RECORTES CE",0
47,"47090",2418,1805,1776,17,29,"RECORTES CE",1
47,"47066",1255,1005,996,7,9,"RECORTES CE",0
47,"47223",158,129,125,3,4,"RECORTES CE",0
47,"47184",576,463,462,2,1,"RECORTES CE",2
47,"47073",120,98,97,1,1,"RECORTES CE",0
47,"47167",242,201,197,3,4,"RECORTES CE",0
47,"47185",98,79,79,0,0,"RECORTES CE",1
47,"47164",377,309,307,2,2,"RECORTES CE",0
47,"47134",164,126,119,4,7,"RECORTES CE",0
47,"47076",17375,13778,13684,111,94,"RECORTES CE",27
47,"47187",89,57,56,2,1,"RECORTES CE",0
47,"47035",930,745,739,10,6,"RECORTES CE",0
47,"47085",16668,12248,12132,133,116,"RECORTES CE",12
47,"47064",31,29,28,2,1,"RECORTES CE",0
47,"47058",206,149,149,2,0,"RECORTES CE",0
47,"47210",372,289,286,1,3,"RECORTES CE",0
47,"47116",413,330,324,1,6,"RECORTES CE",0
47,"47100",140,119,117,2,2,"RECORTES CE",0
47,"47103",259,211,211,4,0,"RECORTES CE",1
47,"47175",6575,4991,4937,51,54,"RECORTES CE",7
47,"47147",119,91,91,0,0,"RECORTES CE",0
47,"47012",118,95,95,0,0,"RECORTES CE",0
47,"47057",248,194,194,2,0,"RECORTES CE",0
47,"47062",163,131,131,0,0,"RECORTES CE",0
47,"47130",99,78,78,1,0,"RECORTES CE",0
47,"47171",418,333,332,9,1,"RECORTES CE",0
47,"47075",4871,3802,3763,30,39,"RECORTES CE",8
47,"47068",36,27,27,0,0,"RECORTES CE",0
47,"47148",439,336,335,2,1,"RECORTES CE",0
47,"47183",130,105,105,0,0,"RECORTES CE",0
47,"47154",155,128,127,0,1,"RECORTES CE",1
47,"47109",171,131,130,1,1,"RECORTES CE",0
47,"47215",54,47,46,1,1,"RECORTES CE",0
47,"47220",166,124,124,1,0,"RECORTES CE",0
47,"47186",246602,193774,192412,1384,1362,"RECORTES CE",314
47,"47110",455,363,357,3,6,"RECORTES CE",0
47,"47071",417,348,344,2,4,"RECORTES CE",4
47,"47040",63,52,51,1,1,"RECORTES CE",0
47,"47155",3239,2400,2374,27,26,"RECORTES CE",5
47,"47104",2857,2313,2253,19,60,"RECORTES CE",1
47,"47031",186,145,144,1,1,"RECORTES CE",0
47,"47160",430,334,329,5,5,"RECORTES CE",0
47,"47011",568,469,464,1,5,"RECORTES CE",0
47,"47146",260,205,204,1,1,"RECORTES CE",1
47,"47212",388,322,322,3,0,"RECORTES CE",0
47,"47156",169,137,135,1,2,"RECORTES CE",0
47,"47204",260,199,193,2,6,"RECORTES CE",1
47,"47017",201,161,158,3,3,"RECORTES CE",0
47,"47231",4384,3457,3432,33,25,"RECORTES CE",6
47,"47061",258,216,214,2,2,"RECORTES CE",0
47,"47008",24,18,18,0,0,"RECORTES CE",0
47,"47230",302,243,241,0,2,"RECORTES CE",0
47,"47030",1006,785,770,10,15,"RECORTES CE",1
47,"47141",134,102,101,1,1,"RECORTES CE",0
47,"47173",883,686,675,4,11,"RECORTES CE",1
47,"47159",828,654,646,0,8,"RECORTES CE",0
47,"47218",995,760,754,6,6,"RECORTES CE",0
47,"47041",149,124,123,2,1,"RECORTES CE",0
47,"47205",385,281,274,7,7,"RECORTES CE",0
47,"47036",229,184,179,2,5,"RECORTES CE",0
47,"47010",13613,10963,10895,108,68,"RECORTES CE",11
47,"47225",81,61,60,2,1,"RECORTES CE",0
47,"47195",461,348,348,3,0,"RECORTES CE",0
47,"47143",127,99,99,0,0,"RECORTES CE",0
47,"47063",101,82,81,2,1,"RECORTES CE",0
47,"47078",164,129,124,1,5,"RECORTES CE",0
47,"47045",768,586,580,0,6,"RECORTES CE",0
47,"47174",275,222,218,2,4,"RECORTES CE",0
47,"47114",4074,2868,2826,20,42,"RECORTES CE",7
47,"47101",1720,1404,1388,10,16,"RECORTES CE",1
47,"47203",67,54,54,0,0,"RECORTES CE",0
47,"47178",175,146,146,1,0,"RECORTES CE",2
47,"47102",286,229,224,1,5,"RECORTES CE",0
47,"47021",76,65,65,1,0,"RECORTES CE",0
47,"47208",59,38,37,3,1,"RECORTES CE",1
47,"47052",6584,5222,5163,41,59,"RECORTES CE",10
47,"47206",95,81,81,0,0,"RECORTES CE",1
47,"47200",82,64,64,1,0,"RECORTES CE",0
47,"47117",297,219,216,4,3,"RECORTES CE",0
47,"47037",174,146,141,2,5,"RECORTES CE",0
47,"47060",262,218,214,0,4,"RECORTES CE",0
47,"47123",469,395,386,4,9,"RECORTES CE",1
47,"47093",817,654,642,9,12,"RECORTES CE",0
47,"47150",278,217,214,2,3,"RECORTES CE",0
47,"47216",115,101,99,2,2,"RECORTES CE",0
47,"47089",153,122,120,2,2,"RECORTES CE",0
47,"47211",49,39,37,1,2,"RECORTES CE",0
47,"47180",83,64,64,1,0,"RECORTES CE",2
47,"47039",188,149,148,1,1,"RECORTES CE",0
47,"47229",215,151,150,1,1,"RECORTES CE",0
47,"47096",135,108,107,2,1,"RECORTES CE",0
47,"47209",42,30,30,1,0,"RECORTES CE",0
47,"47050",3757,2829,2812,29,17,"RECORTES CE",8
47,"47067",178,126,126,3,0,"RECORTES CE",0
47,"47222",80,68,68,3,0,"RECORTES CE",0
47,"47144",78,66,65,2,1,"RECORTES CE",0
47,"47082",803,641,633,5,8,"RECORTES CE",1
47,"47221",109,91,91,0,0,"RECORTES CE",0
47,"47094",132,103,101,1,2,"RECORTES CE",0
47,"47054",638,501,496,6,5,"RECORTES CE",0
47,"47214",1420,1111,1093,9,18,"RECORTES CE",0
47,"47232",99,75,74,0,1,"RECORTES CE",0
47,"47170",36,30,29,2,1,"RECORTES CE",0
47,"47049",100,78,78,1,0,"RECORTES CE",0
47,"47033",199,154,153,3,1,"RECORTES CE",0
47,"47024",262,206,205,2,1,"RECORTES CE",0
47,"47092",110,93,92,0,1,"RECORTES CE",1
47,"47145",611,451,449,4,2,"RECORTES CE",0
47,"47007",3748,2869,2835,24,34,"RECORTES CE",5
47,"47129",879,700,688,6,12,"RECORTES CE",2
47,"47042",54,41,41,3,0,"RECORTES CE",0
47,"47152",86,64,64,1,0,"RECORTES CE",0
47,"47115",287,238,237,4,1,"RECORTES CE",0
47,"47013",99,74,73,0,1,"RECORTES CE",1
47,"47197",888,693,687,10,6,"RECORTES CE",0
47,"47112",2592,2063,2043,20,20,"RECORTES CE",2
51,"51001",59213,33213,32720,413,493,"UPYD",194
14,"14005",6358,4379,4272,56,107,"IULV-CA, UP",694
14,"14058",7973,5860,5791,49,69,"IULV-CA, UP",408
14,"14071",937,651,642,2,9,"IULV-CA, UP",21
14,"14026",2073,1437,1421,13,16,"IULV-CA, UP",59
14,"14043",7574,5571,5510,46,61,"IULV-CA, UP",374
14,"14036",3767,2911,2857,53,54,"IULV-CA, UP",103
14,"14042",18921,14842,14653,184,189,"IULV-CA, UP",1787
14,"14063",1065,803,797,4,6,"IULV-CA, UP",13
14,"14059",699,559,552,5,7,"IULV-CA, UP",19
14,"14054",13665,10923,10678,103,245,"IULV-CA, UP",472
14,"14062",1052,813,801,4,12,"IULV-CA, UP",19
14,"14052",9447,6250,6201,49,49,"IULV-CA, UP",370
14,"14017",10869,8130,8029,72,101,"IULV-CA, UP",360
14,"14073",2900,2068,2041,15,27,"IULV-CA, UP",58
14,"14019",6479,5131,5076,46,55,"IULV-CA, UP",808
14,"14057",6152,4973,4903,56,70,"IULV-CA, UP",703
14,"14018",3710,2882,2846,28,36,"IULV-CA, UP",256
14,"14024",1920,1522,1488,10,34,"IULV-CA, UP",58
14,"14049",16357,12206,12029,127,177,"IULV-CA, UP",784
14,"14033",1285,980,963,11,17,"IULV-CA, UP",41
14,"14064",331,252,244,2,8,"IULV-CA, UP",5
14,"14035",5992,4475,4437,44,38,"IULV-CA, UP",220
14,"14021",260189,188939,187558,1934,1381,"IULV-CA, UP",14743
14,"14010",4051,3003,2968,17,35,"IULV-CA, UP",190
14,"14048",1206,967,949,11,18,"IULV-CA, UP",52
14,"14012",6190,4574,4488,27,86,"IULV-CA, UP",358
14,"14001",3552,2861,2830,28,31,"IULV-CA, UP",293
14,"14007",15200,11064,10926,81,138,"IULV-CA, UP",691
14,"14032",425,347,335,3,12,"IULV-CA, UP",0
14,"14072",1079,834,830,5,4,"IULV-CA, UP",105
14,"14006",1331,1166,1137,7,29,"IULV-CA, UP",93
14,"14022",4036,3199,3169,9,30,"IULV-CA, UP",678
14,"14031",597,490,484,0,6,"IULV-CA, UP",20
14,"14016",1364,1047,1045,3,2,"IULV-CA, UP",118
14,"14015",2149,1637,1616,13,21,"IULV-CA, UP",187
14,"14067",3874,3033,2986,29,47,"IULV-CA, UP",275
14,"14004",2036,1502,1488,6,14,"IULV-CA, UP",37
14,"14074",2303,1940,1929,13,11,"IULV-CA, UP",153
14,"14060",4854,3695,3633,43,62,"IULV-CA, UP",218
14,"14050",2399,1886,1864,11,22,"IULV-CA, UP",352
14,"14002",10951,8231,8150,72,81,"IULV-CA, UP",692
14,"14023",2041,1742,1717,13,25,"IULV-CA, UP",30
14,"14041",3180,2404,2373,26,31,"IULV-CA, UP",748
14,"14045",3055,2486,2451,13,35,"IULV-CA, UP",98
14,"14014",2570,2104,2075,8,29,"IULV-CA, UP",191
14,"14068",545,410,407,6,3,"IULV-CA, UP",12
14,"14020",391,278,274,3,4,"IULV-CA, UP",10
14,"14056",23613,17016,16804,128,212,"IULV-CA, UP",821
14,"14051",1401,1095,1077,5,18,"IULV-CA, UP",22
14,"14029",4206,3170,3135,32,35,"IULV-CA, UP",84
14,"14066",5890,4366,4322,29,44,"IULV-CA, UP",631
14,"14055",18572,13587,13410,167,177,"IULV-CA, UP",553
14,"14038",32236,22982,22773,209,209,"IULV-CA, UP",994
14,"14027",7908,6085,6008,57,77,"IULV-CA, UP",890
14,"14034",318,260,252,2,8,"IULV-CA, UP",7
14,"14040",3792,3036,3010,23,26,"IULV-CA, UP",1110
14,"14025",2950,2460,2425,10,35,"IULV-CA, UP",727
14,"14028",320,246,244,2,2,"IULV-CA, UP",6
14,"14047",1654,1221,1211,17,10,"IULV-CA, UP",52
14,"14037",3344,2476,2442,20,34,"IULV-CA, UP",61
14,"14046",4484,3540,3487,22,53,"IULV-CA, UP",1180
14,"14044",1624,1285,1267,9,18,"IULV-CA, UP",41
14,"14069",7536,5574,5495,48,79,"IULV-CA, UP",258
14,"14075",581,463,446,6,17,"IULV-CA, UP",17
14,"14008",2871,2053,2034,11,19,"IULV-CA, UP",103
14,"14039",2628,2151,2123,11,28,"IULV-CA, UP",74
14,"14009",2779,1941,1934,13,7,"IULV-CA, UP",194
14,"14070",1343,1026,1008,9,18,"IULV-CA, UP",17
14,"14065",1861,1461,1446,12,15,"IULV-CA, UP",70
14,"14003",1265,981,970,6,11,"IULV-CA, UP",12
14,"14030",8580,6619,6542,66,77,"IULV-CA, UP",745
14,"14013",16845,12599,12414,146,185,"IULV-CA, UP",513
14,"14061",756,606,592,2,14,"IULV-CA, UP",34
14,"14011",584,477,476,3,1,"IULV-CA, UP",12
14,"14053",6050,4498,4427,56,71,"IULV-CA, UP",360
40,"40001",715,588,580,4,8,"IU-UPeC",5
40,"40127",33,22,20,1,2,"IU-UPeC",1
40,"40223",226,173,169,0,4,"IU-UPeC",6
40,"40141",856,626,616,7,10,"IU-UPeC",25
40,"40214",210,174,172,2,2,"IU-UPeC",8
40,"40112",2525,2054,2034,18,20,"IU-UPeC",86
40,"40170",1315,1037,1026,9,11,"IU-UPeC",27
40,"40099",60,50,48,1,2,"IU-UPeC",3
40,"40014",58,46,45,0,1,"IU-UPeC",2
40,"40083",77,54,53,1,1,"IU-UPeC",0
40,"40002",37,33,33,1,0,"IU-UPeC",0
40,"40015",30,21,21,1,0,"IU-UPeC",0
40,"40128",132,97,95,4,2,"IU-UPeC",1
40,"40184",253,210,210,3,0,"IU-UPeC",3
40,"40224",24,18,18,0,0,"IU-UPeC",0
40,"40043",1825,1455,1429,16,26,"IU-UPeC",52
40,"40084",61,49,49,2,0,"IU-UPeC",2
40,"40211",75,63,63,1,0,"IU-UPeC",1
40,"40171",33,24,24,0,0,"IU-UPeC",0
40,"40143",88,76,75,1,1,"IU-UPeC",2
40,"40057",1488,1240,1228,14,12,"IU-UPeC",45
40,"40044",144,116,115,6,1,"IU-UPeC",1
40,"40189",513,403,391,3,12,"IU-UPeC",11
40,"40101",874,672,669,11,3,"IU-UPeC",23
40,"40157",50,43,43,0,0,"IU-UPeC",1
40,"40906",1973,1645,1627,16,18,"IU-UPeC",67
40,"40129",179,143,138,2,5,"IU-UPeC",0
40,"40016",57,47,45,0,2,"IU-UPeC",5
40,"40058",331,273,270,1,3,"IU-UPeC",3
40,"40003",143,109,104,1,5,"IU-UPeC",2
40,"40130",130,108,107,1,1,"IU-UPeC",1
40,"40172",44,29,29,0,0,"IU-UPeC",2
40,"40031",515,417,413,2,4,"IU-UPeC",15
40,"40228",507,401,396,0,5,"IU-UPeC",6
40,"40004",472,371,368,2,3,"IU-UPeC",9
40,"40173",139,115,110,1,5,"IU-UPeC",6
40,"40087",93,70,70,2,0,"IU-UPeC",1
40,"40213",89,71,71,1,0,"IU-UPeC",3
40,"40032",394,302,300,6,2,"IU-UPeC",8
40,"40103",157,128,128,0,0,"IU-UPeC",7
40,"40186",41,32,32,0,0,"IU-UPeC",1
40,"40229",38,28,28,0,0,"IU-UPeC",0
40,"40131",48,45,44,0,1,"IU-UPeC",1
40,"40059",112,96,96,2,0,"IU-UPeC",1
40,"40136",114,84,81,3,3,"IU-UPeC",5
40,"40046",90,69,69,0,0,"IU-UPeC",0
40,"40060",81,59,59,0,0,"IU-UPeC",0
40,"40188",95,70,70,1,0,"IU-UPeC",1
40,"40047",31,24,24,0,0,"IU-UPeC",1
40,"40005",31,26,26,0,0,"IU-UPeC",1
40,"40174",361,252,250,0,2,"IU-UPeC",8
40,"40006",21,17,17,0,0,"IU-UPeC",3
40,"40089",218,163,159,0,4,"IU-UPeC",6
40,"40033",59,48,48,4,0,"IU-UPeC",6
40,"40160",105,76,74,2,2,"IU-UPeC",2
40,"40146",255,211,209,0,2,"IU-UPeC",8
40,"40132",66,32,30,1,2,"IU-UPeC",0
40,"40019",37,32,31,0,1,"IU-UPeC",1
40,"40230",94,75,72,2,3,"IU-UPeC",1
40,"40134",729,587,573,8,14,"IU-UPeC",15
40,"40020",168,130,129,2,1,"IU-UPeC",1
40,"40231",108,93,93,1,0,"IU-UPeC",2
40,"40068",24,22,22,0,0,"IU-UPeC",0
40,"40007",77,62,62,0,0,"IU-UPeC",2
40,"40190",51,46,45,0,1,"IU-UPeC",3
40,"40148",240,201,200,1,1,"IU-UPeC",8
40,"40149",528,401,390,7,11,"IU-UPeC",19
40,"40216",755,628,621,7,7,"IU-UPeC",9
40,"40012",271,205,202,3,3,"IU-UPeC",4
40,"40091",116,89,89,0,0,"IU-UPeC",1
40,"40135",289,242,237,1,5,"IU-UPeC",7
40,"40233",419,340,336,2,4,"IU-UPeC",8
40,"40218",97,69,69,0,0,"IU-UPeC",0
40,"40162",396,305,299,0,6,"IU-UPeC",5
40,"40021",27,26,26,0,0,"IU-UPeC",4
40,"40008",46,38,38,0,0,"IU-UPeC",1
40,"40051",45,33,33,0,0,"IU-UPeC",0
40,"40178",103,70,68,0,2,"IU-UPeC",3
40,"40036",519,424,411,9,13,"IU-UPeC",5
40,"40150",71,61,61,0,0,"IU-UPeC",4
40,"40063",7132,5389,5297,56,92,"IU-UPeC",377
40,"40182",184,139,136,1,3,"IU-UPeC",6
40,"40234",407,326,322,3,4,"IU-UPeC",9
40,"40123",148,122,113,3,9,"IU-UPeC",8
40,"40070",147,111,107,1,4,"IU-UPeC",5
40,"40201",49,41,41,0,0,"IU-UPeC",1
40,"40009",50,41,41,0,0,"IU-UPeC",7
40,"40179",631,533,525,3,8,"IU-UPeC",17
40,"40052",81,62,62,0,0,"IU-UPeC",3
40,"40164",180,139,137,0,2,"IU-UPeC",1
40,"40205",266,194,192,2,2,"IU-UPeC",5
40,"40093",77,67,67,5,0,"IU-UPeC",4
40,"40192",157,130,128,1,2,"IU-UPeC",6
40,"40029",32,28,27,1,1,"IU-UPeC",0
40,"40220",66,50,45,2,5,"IU-UPeC",2
40,"40901",377,307,300,1,7,"IU-UPeC",5
40,"40138",2174,1739,1710,13,29,"IU-UPeC",36
40,"40010",124,95,94,2,1,"IU-UPeC",1
40,"40094",372,283,277,1,6,"IU-UPeC",5
40,"40902",125,102,102,0,0,"IU-UPeC",2
40,"40053",88,64,64,3,0,"IU-UPeC",4
40,"40180",299,244,239,2,5,"IU-UPeC",8
40,"40061",70,55,54,0,1,"IU-UPeC",2
40,"40110",349,272,272,1,0,"IU-UPeC",5
40,"40139",281,218,216,1,2,"IU-UPeC",5
40,"40194",39796,30886,30516,287,370,"IU-UPeC",1262
40,"40106",214,175,174,1,1,"IU-UPeC",4
40,"40144",19,15,15,0,0,"IU-UPeC",0
40,"40199",106,83,83,0,0,"IU-UPeC",5
40,"40026",113,106,106,0,0,"IU-UPeC",9
40,"40903",91,68,68,1,0,"IU-UPeC",1
40,"40095",475,376,370,7,6,"IU-UPeC",4
40,"40054",112,83,83,0,0,"IU-UPeC",3
40,"40222",174,147,147,0,0,"IU-UPeC",5
40,"40140",97,72,71,8,1,"IU-UPeC",3
40,"40195",910,709,702,13,7,"IU-UPeC",15
40,"40111",61,51,51,0,0,"IU-UPeC",1
40,"40168",34,27,27,0,0,"IU-UPeC",3
40,"40013",65,51,50,0,1,"IU-UPeC",2
40,"40055",36,25,23,0,2,"IU-UPeC",0
40,"40041",987,791,777,18,14,"IU-UPeC",28
40,"40074",266,226,223,2,3,"IU-UPeC",7
40,"40210",100,74,74,0,0,"IU-UPeC",2
40,"40155",3480,2762,2723,29,39,"IU-UPeC",146
40,"40072",200,167,163,3,4,"IU-UPeC",2
40,"40108",116,80,79,2,1,"IU-UPeC",4
40,"40145",1111,917,903,8,14,"IU-UPeC",87
40,"40183",130,113,112,1,1,"IU-UPeC",1
40,"40028",103,90,89,2,1,"IU-UPeC",2
40,"40071",46,42,39,0,3,"IU-UPeC",4
40,"40056",34,27,27,1,0,"IU-UPeC",0
40,"40196",34,26,26,1,0,"IU-UPeC",0
40,"40105",48,43,43,1,0,"IU-UPeC",0
40,"40065",496,389,381,8,8,"IU-UPeC",7
40,"40198",24,19,19,0,0,"IU-UPeC",1
40,"40905",133,96,95,0,1,"IU-UPeC",0
40,"40142",53,43,43,0,0,"IU-UPeC",2
40,"40115",104,80,79,0,1,"IU-UPeC",2
40,"40100",275,224,214,2,10,"IU-UPeC",13
40,"40225",1134,907,890,8,17,"IU-UPeC",19
40,"40113",428,345,341,5,4,"IU-UPeC",13
40,"40176",402,319,317,3,2,"IU-UPeC",11
40,"40152",763,637,627,1,10,"IU-UPeC",29
40,"40165",80,62,60,1,2,"IU-UPeC",0
40,"40107",104,83,81,1,2,"IU-UPeC",0
40,"40161",34,28,28,0,0,"IU-UPeC",1
40,"40039",213,167,165,2,2,"IU-UPeC",8
40,"40121",286,230,225,3,5,"IU-UPeC",6
40,"40034",81,62,62,0,0,"IU-UPeC",2
40,"40073",405,345,339,4,6,"IU-UPeC",5
40,"40159",141,104,104,0,0,"IU-UPeC",0
40,"40017",92,77,76,1,1,"IU-UPeC",2
40,"40204",167,127,126,2,1,"IU-UPeC",5
40,"40086",698,591,580,11,11,"IU-UPeC",42
40,"40118",52,39,38,2,1,"IU-UPeC",0
40,"40097",124,105,105,0,0,"IU-UPeC",3
40,"40045",112,89,88,1,1,"IU-UPeC",1
40,"40119",170,142,140,0,2,"IU-UPeC",3
40,"40122",514,416,403,0,13,"IU-UPeC",19
40,"40208",768,606,596,5,10,"IU-UPeC",12
40,"40200",41,31,31,0,0,"IU-UPeC",1
40,"40078",161,129,128,2,1,"IU-UPeC",3
40,"40193",230,171,168,5,3,"IU-UPeC",3
40,"40076",6550,5029,4942,29,87,"IU-UPeC",257
40,"40077",805,633,625,6,8,"IU-UPeC",23
40,"40202",63,41,41,0,0,"IU-UPeC",0
40,"40079",234,182,181,1,1,"IU-UPeC",3
40,"40104",258,193,192,1,1,"IU-UPeC",10
40,"40904",353,307,307,2,0,"IU-UPeC",14
40,"40018",90,70,68,0,2,"IU-UPeC",1
40,"40221",49,42,41,0,1,"IU-UPeC",2
40,"40088",292,219,218,0,1,"IU-UPeC",2
40,"40151",44,35,35,0,0,"IU-UPeC",0
40,"40092",119,89,89,0,0,"IU-UPeC",2
40,"40203",895,722,716,6,6,"IU-UPeC",37
40,"40030",476,394,389,8,5,"IU-UPeC",24
40,"40025",142,119,117,0,2,"IU-UPeC",4
40,"40124",244,190,185,6,5,"IU-UPeC",13
40,"40125",90,67,63,0,4,"IU-UPeC",1
40,"40120",192,167,166,1,1,"IU-UPeC",6
40,"40215",89,66,66,0,0,"IU-UPeC",3
40,"40109",75,49,46,1,3,"IU-UPeC",0
40,"40206",178,141,135,0,6,"IU-UPeC",9
40,"40126",85,65,63,0,2,"IU-UPeC",1
40,"40082",115,90,88,4,2,"IU-UPeC",0
40,"40049",62,45,45,0,0,"IU-UPeC",0
40,"40069",84,67,67,0,0,"IU-UPeC",1
40,"40163",55,39,38,1,1,"IU-UPeC",1
40,"40081",126,94,90,1,4,"IU-UPeC",3
40,"40191",222,163,161,2,2,"IU-UPeC",9
40,"40212",30,21,19,0,2,"IU-UPeC",2
40,"40040",2626,1847,1835,19,12,"IU-UPeC",41
40,"40219",590,448,437,6,11,"IU-UPeC",16
40,"40075",163,130,130,0,0,"IU-UPeC",3
40,"40154",21,13,13,0,0,"IU-UPeC",0
40,"40035",140,109,108,3,1,"IU-UPeC",3
40,"40062",60,50,49,0,1,"IU-UPeC",3
40,"40037",43,28,27,0,1,"IU-UPeC",0
40,"40181",4258,3391,3329,23,62,"IU-UPeC",216
40,"40022",207,162,160,3,2,"IU-UPeC",12
40,"40080",61,49,49,0,0,"IU-UPeC",1
40,"40177",153,121,120,3,1,"IU-UPeC",3
40,"40024",872,676,660,9,16,"IU-UPeC",32
40,"40158",18,12,12,0,0,"IU-UPeC",0
40,"40156",330,239,234,2,5,"IU-UPeC",10
40,"40185",882,657,644,9,13,"IU-UPeC",9
40,"40207",753,612,607,2,5,"IU-UPeC",29
40,"40166",260,224,222,2,2,"IU-UPeC",4
40,"40048",38,30,30,0,0,"IU-UPeC",0
31,"31009",690,508,504,5,4,"IU-B-UPeC",21
31,"31102",146,66,66,1,0,"IU-B-UPeC",1
31,"31213",105,70,70,0,0,"IU-B-UPeC",0
31,"31024",102,52,52,0,0,"IU-B-UPeC",0
31,"31061",56,50,50,1,0,"IU-B-UPeC",3
31,"31036",921,664,657,5,7,"IU-B-UPeC",38
31,"31008",80,57,54,0,3,"IU-B-UPeC",1
31,"31126",357,235,232,0,3,"IU-B-UPeC",8
31,"31230",107,86,85,0,1,"IU-B-UPeC",4
31,"31004",35,22,22,1,0,"IU-B-UPeC",0
31,"31038",1348,1017,1005,13,12,"IU-B-UPeC",49
31,"31034",40,29,29,1,0,"IU-B-UPeC",5
31,"31228",496,382,381,2,1,"IU-B-UPeC",14
31,"31092",662,458,455,4,3,"IU-B-UPeC",17
31,"31193",1414,1103,1094,12,9,"IU-B-UPeC",38
31,"31105",1535,1208,1187,18,21,"IU-B-UPeC",21
31,"31249",1885,1350,1331,20,19,"IU-B-UPeC",34
31,"31035",63,45,43,1,2,"IU-B-UPeC",4
31,"31060",13723,10036,9970,78,66,"IU-B-UPeC",472
31,"31251",3110,2347,2327,19,20,"IU-B-UPeC",88
31,"31128",370,265,265,2,0,"IU-B-UPeC",19
31,"31108",1878,1487,1475,14,12,"IU-B-UPeC",56
31,"31114",362,272,269,6,3,"IU-B-UPeC",20
31,"31245",83,54,54,1,0,"IU-B-UPeC",1
31,"31117",620,390,385,1,5,"IU-B-UPeC",1
31,"31047",261,191,187,6,4,"IU-B-UPeC",1
31,"31212",151,118,118,7,0,"IU-B-UPeC",2
31,"31054",460,308,304,7,4,"IU-B-UPeC",3
31,"31094",112,82,82,1,0,"IU-B-UPeC",2
31,"31154",227,127,125,3,2,"IU-B-UPeC",6
31,"31210",199,146,145,2,1,"IU-B-UPeC",4
31,"31019",1809,1295,1288,23,7,"IU-B-UPeC",40
31,"31201",147803,110800,110079,1040,721,"IU-B-UPeC",4589
31,"31231",115,81,81,1,0,"IU-B-UPeC",2
31,"31014",274,197,197,4,0,"IU-B-UPeC",6
31,"31021",64,42,42,0,0,"IU-B-UPeC",1
31,"31063",88,72,68,2,4,"IU-B-UPeC",0
31,"31100",264,186,186,2,0,"IU-B-UPeC",2
31,"31058",215,153,153,2,0,"IU-B-UPeC",4
31,"31184",61,43,43,2,0,"IU-B-UPeC",0
31,"31139",159,102,101,3,1,"IU-B-UPeC",2
31,"31189",1170,739,731,10,8,"IU-B-UPeC",16
31,"31222",63,41,41,5,0,"IU-B-UPeC",1
31,"31030",145,107,107,3,0,"IU-B-UPeC",2
31,"31182",37,27,27,0,0,"IU-B-UPeC",2
31,"31132",146,115,113,1,2,"IU-B-UPeC",3
31,"31188",227,173,173,2,0,"IU-B-UPeC",1
31,"31051",253,176,176,2,0,"IU-B-UPeC",5
31,"31208",2569,2016,1992,21,24,"IU-B-UPeC",101
31,"31183",681,581,578,10,3,"IU-B-UPeC",15
31,"31255",102,75,74,2,1,"IU-B-UPeC",2
31,"31082",615,398,393,6,5,"IU-B-UPeC",2
31,"31040",194,130,128,1,2,"IU-B-UPeC",2
31,"31001",90,74,74,5,0,"IU-B-UPeC",1
31,"31103",46,32,32,1,0,"IU-B-UPeC",0
31,"31078",2447,1889,1861,25,28,"IU-B-UPeC",41
31,"31041",1583,1125,1110,14,15,"IU-B-UPeC",47
31,"31031",221,141,140,0,1,"IU-B-UPeC",0
31,"31042",2744,2081,2053,19,28,"IU-B-UPeC",30
31,"31107",1707,1303,1294,12,9,"IU-B-UPeC",24
31,"31150",213,154,152,1,2,"IU-B-UPeC",9
31,"31194",315,218,217,2,1,"IU-B-UPeC",13
31,"31130",310,214,213,7,1,"IU-B-UPeC",4
31,"31099",63,52,52,1,0,"IU-B-UPeC",0
31,"31069",847,643,636,4,7,"IU-B-UPeC",29
31,"31125",275,194,191,2,3,"IU-B-UPeC",5
31,"31164",582,464,457,3,7,"IU-B-UPeC",17
31,"31223",995,752,742,6,10,"IU-B-UPeC",23
31,"31209",157,108,108,0,0,"IU-B-UPeC",4
31,"31131",871,664,658,13,6,"IU-B-UPeC",12
31,"31013",661,439,437,1,2,"IU-B-UPeC",12
31,"31215",4649,3412,3359,35,53,"IU-B-UPeC",74
31,"31161",344,273,270,4,3,"IU-B-UPeC",13
31,"31244",156,87,84,1,3,"IU-B-UPeC",0
31,"31254",1920,1473,1458,7,15,"IU-B-UPeC",58
31,"31227",8226,6191,6109,53,82,"IU-B-UPeC",270
31,"31239",310,223,220,5,3,"IU-B-UPeC",0
31,"31065",1892,1420,1396,14,24,"IU-B-UPeC",39
31,"31153",2172,1463,1448,10,15,"IU-B-UPeC",24
31,"31122",4719,3671,3654,42,17,"IU-B-UPeC",122
31,"31115",166,108,108,2,0,"IU-B-UPeC",2
31,"31224",914,668,659,6,9,"IU-B-UPeC",28
31,"31095",76,66,64,1,2,"IU-B-UPeC",3
31,"31216",3882,2829,2810,31,19,"IU-B-UPeC",123
31,"31166",260,186,186,2,0,"IU-B-UPeC",10
31,"31196",39,34,34,0,0,"IU-B-UPeC",1
31,"31075",101,68,67,1,1,"IU-B-UPeC",0
31,"31258",7841,5961,5927,56,34,"IU-B-UPeC",269
31,"31207",271,194,190,0,4,"IU-B-UPeC",6
31,"31156",252,193,193,0,0,"IU-B-UPeC",7
31,"31248",295,174,168,2,6,"IU-B-UPeC",4
31,"31246",140,108,103,2,5,"IU-B-UPeC",10
31,"31136",444,320,318,6,2,"IU-B-UPeC",11
31,"31106",689,565,559,1,6,"IU-B-UPeC",28
31,"31005",296,205,204,0,1,"IU-B-UPeC",4
31,"31204",37,33,33,2,0,"IU-B-UPeC",0
31,"31096",115,95,92,2,3,"IU-B-UPeC",5
31,"31147",98,76,76,2,0,"IU-B-UPeC",8
31,"31127",143,97,97,2,0,"IU-B-UPeC",1
31,"31167",827,624,615,13,9,"IU-B-UPeC",32
31,"31113",137,86,85,1,1,"IU-B-UPeC",6
31,"31157",3546,2423,2399,32,24,"IU-B-UPeC",93
31,"31134",178,132,130,1,2,"IU-B-UPeC",3
31,"31066",867,647,638,8,9,"IU-B-UPeC",16
31,"31011",697,494,491,5,3,"IU-B-UPeC",17
31,"31191",3018,2324,2297,23,27,"IU-B-UPeC",81
31,"31006",1952,1423,1400,14,23,"IU-B-UPeC",60
31,"31124",210,162,162,2,0,"IU-B-UPeC",3
31,"31185",501,345,342,4,3,"IU-B-UPeC",4
31,"31226",585,346,344,1,2,"IU-B-UPeC",5
31,"31057",1812,1375,1360,17,15,"IU-B-UPeC",32
31,"31016",7642,5866,5822,52,44,"IU-B-UPeC",371
31,"31097",10436,7461,7395,96,66,"IU-B-UPeC",326
31,"31135",102,67,62,0,5,"IU-B-UPeC",2
31,"31195",180,129,128,0,1,"IU-B-UPeC",0
31,"31168",248,192,191,0,1,"IU-B-UPeC",7
31,"31162",47,29,27,0,2,"IU-B-UPeC",0
31,"31256",109,70,70,0,0,"IU-B-UPeC",0
31,"31199",150,101,101,3,0,"IU-B-UPeC",0
31,"31186",302,211,209,2,2,"IU-B-UPeC",7
31,"31098",1918,1489,1483,23,6,"IU-B-UPeC",42
31,"31064",1447,1161,1145,11,16,"IU-B-UPeC",23
31,"31159",1134,867,864,9,3,"IU-B-UPeC",45
31,"31129",393,265,261,2,4,"IU-B-UPeC",0
31,"31261",235,187,187,3,0,"IU-B-UPeC",6
31,"31190",44,36,36,1,0,"IU-B-UPeC",1
31,"31018",409,312,311,9,1,"IU-B-UPeC",3
31,"31200",764,558,546,11,12,"IU-B-UPeC",21
31,"31072",5288,3916,3846,32,70,"IU-B-UPeC",132
31,"31068",2893,2172,2138,27,34,"IU-B-UPeC",84
31,"31242",253,165,164,1,1,"IU-B-UPeC",2
31,"31197",70,60,59,0,1,"IU-B-UPeC",7
31,"31232",25152,18432,18220,199,212,"IU-B-UPeC",1231
31,"31109",1562,1184,1177,6,7,"IU-B-UPeC",49
31,"31160",107,81,80,0,1,"IU-B-UPeC",2
31,"31022",526,344,341,3,3,"IU-B-UPeC",2
31,"31062",1088,866,853,4,13,"IU-B-UPeC",47
31,"31214",93,70,69,0,1,"IU-B-UPeC",3
31,"31171",693,510,500,6,10,"IU-B-UPeC",15
31,"31170",49,39,39,1,0,"IU-B-UPeC",1
31,"31015",2001,1468,1449,18,19,"IU-B-UPeC",43
31,"31263",236,142,142,2,0,"IU-B-UPeC",2
31,"31080",510,412,411,8,1,"IU-B-UPeC",22
31,"31049",704,488,486,1,2,"IU-B-UPeC",7
31,"31046",60,38,38,0,0,"IU-B-UPeC",1
31,"31110",90,65,65,2,0,"IU-B-UPeC",5
31,"31120",394,264,263,5,1,"IU-B-UPeC",10
31,"31233",96,72,71,0,1,"IU-B-UPeC",4
31,"31148",93,70,70,3,0,"IU-B-UPeC",5
31,"31220",752,607,603,3,4,"IU-B-UPeC",13
31,"31020",454,235,232,2,3,"IU-B-UPeC",3
31,"31253",129,112,112,0,0,"IU-B-UPeC",4
31,"31070",2652,1907,1888,16,19,"IU-B-UPeC",187
31,"31264",179,117,115,5,2,"IU-B-UPeC",4
31,"31037",86,64,64,0,0,"IU-B-UPeC",0
31,"31202",4326,3045,3001,41,44,"IU-B-UPeC",191
31,"31165",2794,2057,2025,31,32,"IU-B-UPeC",125
31,"31172",367,293,286,6,7,"IU-B-UPeC",12
31,"31155",253,191,189,3,2,"IU-B-UPeC",6
31,"31017",361,248,246,4,2,"IU-B-UPeC",10
31,"31111",96,75,75,2,0,"IU-B-UPeC",3
31,"31010",5721,3986,3946,27,40,"IU-B-UPeC",124
31,"31081",342,239,239,2,0,"IU-B-UPeC",1
31,"31071",17,17,17,0,0,"IU-B-UPeC",1
31,"31203",40,29,29,0,0,"IU-B-UPeC",0
31,"31163",2017,1479,1447,15,32,"IU-B-UPeC",65
31,"31234",144,107,107,2,0,"IU-B-UPeC",1
31,"31142",1411,972,964,11,8,"IU-B-UPeC",24
31,"31112",94,67,66,0,1,"IU-B-UPeC",3
31,"31173",873,704,680,3,24,"IU-B-UPeC",16
31,"31052",88,65,64,0,1,"IU-B-UPeC",5
31,"31048",169,123,123,1,0,"IU-B-UPeC",4
31,"31265",86,61,61,0,0,"IU-B-UPeC",5
31,"31235",166,111,111,0,0,"IU-B-UPeC",4
31,"31225",36,29,29,0,0,"IU-B-UPeC",1
31,"31032",1733,1295,1285,26,10,"IU-B-UPeC",37
31,"31012",814,579,570,4,9,"IU-B-UPeC",27
31,"31133",44,30,30,1,0,"IU-B-UPeC",1
31,"31174",110,75,73,0,2,"IU-B-UPeC",1
31,"31143",98,59,58,1,1,"IU-B-UPeC",1
31,"31002",424,312,310,7,2,"IU-B-UPeC",5
31,"31123",654,430,419,7,11,"IU-B-UPeC",6
31,"31901",15475,11855,11771,121,84,"IU-B-UPeC",601
31,"31053",532,395,391,4,4,"IU-B-UPeC",15
31,"31043",38,30,30,0,0,"IU-B-UPeC",3
31,"31144",804,482,479,2,3,"IU-B-UPeC",5
31,"31033",49,29,29,1,0,"IU-B-UPeC",1
31,"31236",1324,943,933,12,10,"IU-B-UPeC",20
31,"31073",315,214,212,3,2,"IU-B-UPeC",4
31,"31192",159,132,131,0,1,"IU-B-UPeC",10
31,"31175",72,50,49,0,1,"IU-B-UPeC",4
31,"31023",6826,5609,5591,77,18,"IU-B-UPeC",183
31,"31902",4346,3247,3228,23,19,"IU-B-UPeC",155
31,"31247",152,112,109,0,3,"IU-B-UPeC",2
31,"31151",67,48,48,1,0,"IU-B-UPeC",3
31,"31205",427,330,326,7,4,"IU-B-UPeC",8
31,"31104",1876,1355,1338,10,17,"IU-B-UPeC",54
31,"31237",195,156,156,1,0,"IU-B-UPeC",6
31,"31091",347,217,217,0,0,"IU-B-UPeC",2
31,"31152",1347,999,990,16,9,"IU-B-UPeC",34
31,"31044",290,223,220,1,3,"IU-B-UPeC",3
31,"31074",394,301,298,5,3,"IU-B-UPeC",10
31,"31145",171,133,133,0,0,"IU-B-UPeC",3
31,"31085",471,353,351,3,2,"IU-B-UPeC",23
31,"31176",2856,2077,2040,33,37,"IU-B-UPeC",96
31,"31146",35,30,30,2,0,"IU-B-UPeC",0
31,"31055",259,177,173,2,4,"IU-B-UPeC",0
31,"31206",2095,1529,1513,19,16,"IU-B-UPeC",62
31,"31903",6593,4699,4660,28,39,"IU-B-UPeC",299
31,"31025",768,560,560,5,0,"IU-B-UPeC",19
31,"31116",65,51,51,1,0,"IU-B-UPeC",2
31,"31238",110,96,94,2,2,"IU-B-UPeC",3
31,"31217",337,233,230,1,3,"IU-B-UPeC",3
31,"31904",1559,1095,1084,8,11,"IU-B-UPeC",27
31,"31045",504,397,392,9,5,"IU-B-UPeC",19
31,"31259",485,325,324,3,1,"IU-B-UPeC",3
31,"31093",293,210,206,2,4,"IU-B-UPeC",7
31,"31039",83,58,57,0,1,"IU-B-UPeC",3
31,"31187",111,70,70,1,0,"IU-B-UPeC",0
31,"31229",50,40,40,0,0,"IU-B-UPeC",5
31,"31056",179,137,133,0,4,"IU-B-UPeC",3
31,"31177",262,171,170,3,1,"IU-B-UPeC",8
31,"31076",2407,2005,1986,28,19,"IU-B-UPeC",30
31,"31198",36,29,29,0,0,"IU-B-UPeC",2
31,"31137",208,93,93,3,0,"IU-B-UPeC",1
31,"31086",12987,10342,10270,114,72,"IU-B-UPeC",508
31,"31178",495,364,364,4,0,"IU-B-UPeC",7
31,"31026",147,128,128,1,0,"IU-B-UPeC",5
31,"31219",88,63,62,0,1,"IU-B-UPeC",1
31,"31257",866,657,648,8,9,"IU-B-UPeC",28
31,"31905",2847,2108,2093,11,15,"IU-B-UPeC",84
31,"31158",252,181,178,2,3,"IU-B-UPeC",11
31,"31087",169,131,127,2,4,"IU-B-UPeC",3
31,"31260",1245,859,857,15,2,"IU-B-UPeC",33
31,"31077",5384,4055,3999,49,56,"IU-B-UPeC",126
31,"31027",838,595,589,7,6,"IU-B-UPeC",5
31,"31240",531,355,351,6,4,"IU-B-UPeC",6
31,"31067",1938,1424,1415,15,9,"IU-B-UPeC",117
31,"31003",124,95,95,2,0,"IU-B-UPeC",2
31,"31084",1935,1389,1380,19,9,"IU-B-UPeC",10
31,"31118",165,122,121,2,1,"IU-B-UPeC",12
31,"31138",934,649,647,5,2,"IU-B-UPeC",7
31,"31007",136,94,93,1,1,"IU-B-UPeC",5
31,"31906",2553,1945,1930,21,15,"IU-B-UPeC",92
31,"31149",2338,1534,1525,16,9,"IU-B-UPeC",10
31,"31241",134,94,89,0,5,"IU-B-UPeC",8
31,"31169",2217,1508,1489,15,19,"IU-B-UPeC",25
31,"31088",5574,4194,4156,46,38,"IU-B-UPeC",178
31,"31179",509,361,355,5,6,"IU-B-UPeC",11
31,"31221",1211,844,825,4,19,"IU-B-UPeC",20
31,"31262",206,180,180,2,0,"IU-B-UPeC",15
31,"31180",216,173,173,5,0,"IU-B-UPeC",12
31,"31089",242,188,185,1,3,"IU-B-UPeC",7
31,"31907",10677,8568,8523,97,45,"IU-B-UPeC",336
31,"31028",211,133,133,0,0,"IU-B-UPeC",4
31,"31119",40,22,22,0,0,"IU-B-UPeC",3
31,"31252",87,68,68,0,0,"IU-B-UPeC",0
31,"31083",56,41,39,0,2,"IU-B-UPeC",2
31,"31140",116,82,82,2,0,"IU-B-UPeC",0
31,"31059",191,142,141,1,1,"IU-B-UPeC",4
31,"31908",1008,709,704,11,5,"IU-B-UPeC",12
31,"31079",76,53,53,0,0,"IU-B-UPeC",2
31,"31090",146,81,80,3,1,"IU-B-UPeC",1
31,"31181",150,116,116,0,0,"IU-B-UPeC",4
31,"31029",925,662,648,6,14,"IU-B-UPeC",35
31,"31050",6058,3902,3850,64,52,"IU-B-UPeC",34
31,"31211",25,12,12,2,0,"IU-B-UPeC",0
31,"31141",109,70,66,1,4,"IU-B-UPeC",2
31,"31243",314,236,234,5,2,"IU-B-UPeC",4
31,"31250",2832,1921,1899,20,22,"IU-B-UPeC",36
31,"31101",1390,1031,1028,11,3,"IU-B-UPeC",25
31,"31121",64,45,45,2,0,"IU-B-UPeC",4
39,"39003",299,219,217,0,2,"RECORTES CE",0
39,"39023",6316,4900,4827,37,73,"RECORTES CE",7
39,"39078",1413,1045,1032,10,13,"RECORTES CE",0
39,"39006",1728,1353,1337,12,16,"RECORTES CE",1
39,"39045",376,284,276,1,8,"RECORTES CE",0
39,"39017",571,385,377,2,8,"RECORTES CE",1
39,"39022",987,735,730,7,5,"RECORTES CE",1
39,"39048",1697,1372,1361,10,11,"RECORTES CE",2
39,"39068",659,486,479,2,7,"RECORTES CE",2
39,"39010",639,509,505,5,4,"RECORTES CE",0
39,"39094",854,644,637,9,7,"RECORTES CE",2
39,"39024",1882,1452,1438,14,14,"RECORTES CE",0
39,"39050",276,173,170,0,3,"RECORTES CE",0
39,"39041",1764,1416,1395,10,21,"RECORTES CE",0
39,"39037",2003,1570,1547,8,23,"RECORTES CE",3
39,"39064",1349,1036,1016,6,20,"RECORTES CE",2
39,"39080",3552,2734,2701,17,33,"RECORTES CE",1
39,"39002",3313,2430,2391,17,39,"RECORTES CE",2
39,"39086",357,260,258,1,2,"RECORTES CE",0
39,"39031",1235,873,863,5,10,"RECORTES CE",2
39,"39101",292,206,202,2,4,"RECORTES CE",2
39,"39027",3139,2493,2439,30,54,"RECORTES CE",6
39,"39084",843,608,604,5,4,"RECORTES CE",1
39,"39011",1602,1211,1202,13,9,"RECORTES CE",1
39,"39034",286,180,179,4,1,"RECORTES CE",2
39,"39021",495,399,391,4,8,"RECORTES CE",1
39,"39093",307,232,232,1,0,"RECORTES CE",0
39,"39102",2281,1647,1631,13,16,"RECORTES CE",2
39,"39059",8057,6049,5972,50,77,"RECORTES CE",10
39,"39054",4472,3478,3441,45,37,"RECORTES CE",6
39,"39020",23612,16515,16334,125,181,"RECORTES CE",43
39,"39097",713,409,400,10,9,"RECORTES CE",0
39,"39039",572,397,396,1,1,"RECORTES CE",0
39,"39001",2127,1651,1631,17,20,"RECORTES CE",2
39,"39052",18086,14014,13852,124,162,"RECORTES CE",25
39,"39061",3488,2746,2722,29,24,"RECORTES CE",4
39,"39069",1968,1586,1555,12,31,"RECORTES CE",4
39,"39012",6693,5213,5131,44,82,"RECORTES CE",5
39,"39092",916,668,663,4,5,"RECORTES CE",0
39,"39055",1118,838,826,6,12,"RECORTES CE",0
39,"39029",624,507,503,4,4,"RECORTES CE",2
39,"39073",9806,7636,7574,42,62,"RECORTES CE",12
39,"39063",973,725,720,7,5,"RECORTES CE",0
39,"39060",6705,5437,5339,46,98,"RECORTES CE",5
39,"39088",71,51,51,0,0,"RECORTES CE",0
39,"39077",246,186,182,0,4,"RECORTES CE",0
39,"39008",13932,10600,10506,92,94,"RECORTES CE",18
39,"39033",578,432,432,5,0,"RECORTES CE",0
39,"39013",515,378,375,1,3,"RECORTES CE",0
39,"39057",2321,1773,1746,13,27,"RECORTES CE",2
39,"39067",813,569,561,5,8,"RECORTES CE",0
39,"39047",1978,1463,1448,15,15,"RECORTES CE",1
39,"39066",868,697,688,7,9,"RECORTES CE",1
39,"39014",898,655,644,8,11,"RECORTES CE",0
39,"39038",1463,1039,1030,6,9,"RECORTES CE",2
39,"39007",434,298,297,1,1,"RECORTES CE",0
39,"39082",1658,1212,1202,15,10,"RECORTES CE",2
39,"39025",8693,6696,6583,58,113,"RECORTES CE",7
39,"39091",1947,1572,1552,9,20,"RECORTES CE",1
39,"39085",6834,5319,5265,37,54,"RECORTES CE",12
39,"39098",1422,1078,1074,11,4,"RECORTES CE",3
39,"39095",2268,1812,1789,9,23,"RECORTES CE",1
39,"39004",1539,1177,1160,12,17,"RECORTES CE",3
39,"39051",67,62,61,1,1,"RECORTES CE",0
39,"39018",4211,3389,3329,27,60,"RECORTES CE",11
39,"39062",1824,1400,1392,14,8,"RECORTES CE",0
39,"39075",137597,102862,102053,819,809,"RECORTES CE",137
39,"39081",435,349,342,3,7,"RECORTES CE",0
39,"39072",343,213,213,1,0,"RECORTES CE",0
39,"39026",1751,1303,1295,9,8,"RECORTES CE",2
39,"39019",2098,1669,1646,24,23,"RECORTES CE",3
39,"39070",146,111,109,3,2,"RECORTES CE",0
39,"39065",256,202,200,6,2,"RECORTES CE",0
39,"39089",149,104,103,1,1,"RECORTES CE",0
39,"39032",1476,1117,1100,8,17,"RECORTES CE",2
39,"39005",1396,1089,1084,4,5,"RECORTES CE",1
39,"39096",702,477,474,3,3,"RECORTES CE",0
39,"39076",3491,2696,2662,24,34,"RECORTES CE",4
39,"39046",1402,1015,985,11,30,"RECORTES CE",2
39,"39100",869,628,617,12,11,"RECORTES CE",1
39,"39099",3117,2446,2406,23,40,"RECORTES CE",5
39,"39036",983,774,770,8,4,"RECORTES CE",3
39,"39035",9587,7315,7214,56,101,"RECORTES CE",7
39,"39016",23860,18608,18405,149,203,"RECORTES CE",24
39,"39044",3833,2889,2860,26,29,"RECORTES CE",2
39,"39083",1139,747,739,6,8,"RECORTES CE",2
39,"39090",756,564,550,4,14,"RECORTES CE",1
39,"39049",330,251,248,1,3,"RECORTES CE",0
39,"39030",1894,1314,1290,9,24,"RECORTES CE",8
39,"39028",3733,2918,2877,17,41,"RECORTES CE",4
39,"39087",42262,32560,32124,234,436,"RECORTES CE",54
39,"39056",2326,1805,1775,17,30,"RECORTES CE",3
39,"39071",405,277,272,2,5,"RECORTES CE",0
39,"39042",5968,4614,4572,33,42,"RECORTES CE",8
39,"39043",1468,1167,1151,10,16,"RECORTES CE",3
39,"39015",862,650,643,6,7,"RECORTES CE",0
39,"39040",4290,3337,3309,22,28,"RECORTES CE",5
39,"39074",6905,5370,5288,52,82,"RECORTES CE",7
39,"39079",8951,6734,6657,54,77,"RECORTES CE",10
39,"39053",219,135,135,1,0,"RECORTES CE",1
39,"39058",831,594,592,6,2,"RECORTES CE",0
39,"39009",3223,2395,2370,22,25,"RECORTES CE",0
40,"40184",253,210,210,3,0,"PACMA",2
40,"40101",874,672,669,11,3,"PACMA",13
40,"40076",6550,5029,4942,29,87,"PACMA",37
40,"40003",143,109,104,1,5,"PACMA",0
40,"40044",144,116,115,6,1,"PACMA",0
40,"40016",57,47,45,0,2,"PACMA",0
40,"40206",178,141,135,0,6,"PACMA",2
40,"40065",496,389,381,8,8,"PACMA",1
40,"40019",37,32,31,0,1,"PACMA",0
40,"40172",44,29,29,0,0,"PACMA",0
40,"40061",70,55,54,0,1,"PACMA",0
40,"40021",27,26,26,0,0,"PACMA",0
40,"40010",124,95,94,2,1,"PACMA",1
40,"40149",528,401,390,7,11,"PACMA",2
40,"40173",139,115,110,1,5,"PACMA",2
40,"40148",240,201,200,1,1,"PACMA",1
40,"40107",104,83,81,1,2,"PACMA",0
40,"40136",114,84,81,3,3,"PACMA",1
40,"40171",33,24,24,0,0,"PACMA",0
40,"40008",46,38,38,0,0,"PACMA",0
40,"40105",48,43,43,1,0,"PACMA",0
40,"40159",141,104,104,0,0,"PACMA",3
40,"40160",105,76,74,2,2,"PACMA",0
40,"40082",115,90,88,4,2,"PACMA",0
40,"40219",590,448,437,6,11,"PACMA",1
40,"40087",93,70,70,2,0,"PACMA",0
40,"40177",153,121,120,3,1,"PACMA",0
40,"40156",330,239,234,2,5,"PACMA",2
40,"40123",148,122,113,3,9,"PACMA",0
40,"40902",125,102,102,0,0,"PACMA",0
40,"40072",200,167,163,3,4,"PACMA",2
40,"40196",34,26,26,1,0,"PACMA",0
40,"40905",133,96,95,0,1,"PACMA",0
40,"40097",124,105,105,0,0,"PACMA",0
40,"40055",36,25,23,0,2,"PACMA",0
40,"40130",130,108,107,1,1,"PACMA",0
40,"40052",81,62,62,0,0,"PACMA",0
40,"40080",61,49,49,0,0,"PACMA",0
40,"40134",729,587,573,8,14,"PACMA",1
40,"40046",90,69,69,0,0,"PACMA",0
40,"40054",112,83,83,0,0,"PACMA",0
40,"40126",85,65,63,0,2,"PACMA",0
40,"40199",106,83,83,0,0,"PACMA",1
40,"40185",882,657,644,9,13,"PACMA",0
40,"40113",428,345,341,5,4,"PACMA",1
40,"40100",275,224,214,2,10,"PACMA",0
40,"40225",1134,907,890,8,17,"PACMA",7
40,"40017",92,77,76,1,1,"PACMA",0
40,"40125",90,67,63,0,4,"PACMA",0
40,"40906",1973,1645,1627,16,18,"PACMA",10
40,"40195",910,709,702,13,7,"PACMA",1
40,"40127",33,22,20,1,2,"PACMA",0
40,"40012",271,205,202,3,3,"PACMA",0
40,"40063",7132,5389,5297,56,92,"PACMA",13
40,"40041",987,791,777,18,14,"PACMA",3
40,"40214",210,174,172,2,2,"PACMA",0
40,"40032",394,302,300,6,2,"PACMA",1
40,"40218",97,69,69,0,0,"PACMA",0
40,"40075",163,130,130,0,0,"PACMA",1
40,"40119",170,142,140,0,2,"PACMA",1
40,"40043",1825,1455,1429,16,26,"PACMA",4
40,"40026",113,106,106,0,0,"PACMA",0
40,"40155",3480,2762,2723,29,39,"PACMA",21
40,"40124",244,190,185,6,5,"PACMA",2
40,"40108",116,80,79,2,1,"PACMA",0
40,"40004",472,371,368,2,3,"PACMA",1
40,"40142",53,43,43,0,0,"PACMA",0
40,"40047",31,24,24,0,0,"PACMA",1
40,"40230",94,75,72,2,3,"PACMA",0
40,"40128",132,97,95,4,2,"PACMA",2
40,"40193",230,171,168,5,3,"PACMA",0
40,"40006",21,17,17,0,0,"PACMA",0
40,"40221",49,42,41,0,1,"PACMA",0
40,"40057",1488,1240,1228,14,12,"PACMA",4
40,"40157",50,43,43,0,0,"PACMA",0
40,"40110",349,272,272,1,0,"PACMA",2
40,"40091",116,89,89,0,0,"PACMA",0
40,"40202",63,41,41,0,0,"PACMA",0
40,"40139",281,218,216,1,2,"PACMA",1
40,"40062",60,50,49,0,1,"PACMA",0
40,"40007",77,62,62,0,0,"PACMA",0
40,"40077",805,633,625,6,8,"PACMA",6
40,"40121",286,230,225,3,5,"PACMA",0
40,"40049",62,45,45,0,0,"PACMA",0
40,"40031",515,417,413,2,4,"PACMA",10
40,"40203",895,722,716,6,6,"PACMA",5
40,"40035",140,109,108,3,1,"PACMA",2
40,"40186",41,32,32,0,0,"PACMA",0
40,"40213",89,71,71,1,0,"PACMA",0
40,"40182",184,139,136,1,3,"PACMA",1
40,"40059",112,96,96,2,0,"PACMA",0
40,"40036",519,424,411,9,13,"PACMA",2
40,"40163",55,39,38,1,1,"PACMA",0
40,"40178",103,70,68,0,2,"PACMA",0
40,"40234",407,326,322,3,4,"PACMA",0
40,"40104",258,193,192,1,1,"PACMA",3
40,"40014",58,46,45,0,1,"PACMA",0
40,"40009",50,41,41,0,0,"PACMA",0
40,"40150",71,61,61,0,0,"PACMA",0
40,"40051",45,33,33,0,0,"PACMA",0
40,"40024",872,676,660,9,16,"PACMA",4
40,"40223",226,173,169,0,4,"PACMA",0
40,"40174",361,252,250,0,2,"PACMA",0
40,"40229",38,28,28,0,0,"PACMA",0
40,"40179",631,533,525,3,8,"PACMA",3
40,"40220",66,50,45,2,5,"PACMA",1
40,"40037",43,28,27,0,1,"PACMA",0
40,"40151",44,35,35,0,0,"PACMA",1
40,"40211",75,63,63,1,0,"PACMA",1
40,"40901",377,307,300,1,7,"PACMA",5
40,"40033",59,48,48,4,0,"PACMA",0
40,"40180",299,244,239,2,5,"PACMA",0
40,"40143",88,76,75,1,1,"PACMA",0
40,"40204",167,127,126,2,1,"PACMA",0
40,"40048",38,30,30,0,0,"PACMA",0
40,"40212",30,21,19,0,2,"PACMA",0
40,"40053",88,64,64,3,0,"PACMA",0
40,"40231",108,93,93,1,0,"PACMA",0
40,"40129",179,143,138,2,5,"PACMA",0
40,"40165",80,62,60,1,2,"PACMA",1
40,"40207",753,612,607,2,5,"PACMA",1
40,"40086",698,591,580,11,11,"PACMA",2
40,"40181",4258,3391,3329,23,62,"PACMA",18
40,"40154",21,13,13,0,0,"PACMA",0
40,"40135",289,242,237,1,5,"PACMA",0
40,"40228",507,401,396,0,5,"PACMA",2
40,"40112",2525,2054,2034,18,20,"PACMA",20
40,"40168",34,27,27,0,0,"PACMA",0
40,"40200",41,31,31,0,0,"PACMA",0
40,"40078",161,129,128,2,1,"PACMA",0
40,"40208",768,606,596,5,10,"PACMA",2
40,"40070",147,111,107,1,4,"PACMA",1
40,"40152",763,637,627,1,10,"PACMA",3
40,"40131",48,45,44,0,1,"PACMA",0
40,"40056",34,27,27,1,0,"PACMA",0
40,"40141",856,626,616,7,10,"PACMA",2
40,"40201",49,41,41,0,0,"PACMA",0
40,"40145",1111,917,903,8,14,"PACMA",1
40,"40904",353,307,307,2,0,"PACMA",1
40,"40094",372,283,277,1,6,"PACMA",4
40,"40083",77,54,53,1,1,"PACMA",0
40,"40138",2174,1739,1710,13,29,"PACMA",6
40,"40088",292,219,218,0,1,"PACMA",3
40,"40192",157,130,128,1,2,"PACMA",0
40,"40170",1315,1037,1026,9,11,"PACMA",1
40,"40103",157,128,128,0,0,"PACMA",0
40,"40002",37,33,33,1,0,"PACMA",0
40,"40045",112,89,88,1,1,"PACMA",5
40,"40164",180,139,137,0,2,"PACMA",0
40,"40132",66,32,30,1,2,"PACMA",0
40,"40029",32,28,27,1,1,"PACMA",0
40,"40084",61,49,49,2,0,"PACMA",0
40,"40190",51,46,45,0,1,"PACMA",0
40,"40233",419,340,336,2,4,"PACMA",0
40,"40191",222,163,161,2,2,"PACMA",4
40,"40189",513,403,391,3,12,"PACMA",1
40,"40161",34,28,28,0,0,"PACMA",0
40,"40106",214,175,174,1,1,"PACMA",1
40,"40188",95,70,70,1,0,"PACMA",0
40,"40030",476,394,389,8,5,"PACMA",0
40,"40092",119,89,89,0,0,"PACMA",0
40,"40089",218,163,159,0,4,"PACMA",1
40,"40158",18,12,12,0,0,"PACMA",0
40,"40144",19,15,15,0,0,"PACMA",0
40,"40118",52,39,38,2,1,"PACMA",0
40,"40093",77,67,67,5,0,"PACMA",1
40,"40205",266,194,192,2,2,"PACMA",2
40,"40210",100,74,74,0,0,"PACMA",1
40,"40013",65,51,50,0,1,"PACMA",0
40,"40069",84,67,67,0,0,"PACMA",0
40,"40074",266,226,223,2,3,"PACMA",1
40,"40176",402,319,317,3,2,"PACMA",0
40,"40034",81,62,62,0,0,"PACMA",2
40,"40109",75,49,46,1,3,"PACMA",0
40,"40020",168,130,129,2,1,"PACMA",1
40,"40015",30,21,21,1,0,"PACMA",0
40,"40224",24,18,18,0,0,"PACMA",0
40,"40028",103,90,89,2,1,"PACMA",1
40,"40215",89,66,66,0,0,"PACMA",0
40,"40058",331,273,270,1,3,"PACMA",1
40,"40095",475,376,370,7,6,"PACMA",1
40,"40099",60,50,48,1,2,"PACMA",0
40,"40060",81,59,59,0,0,"PACMA",0
40,"40005",31,26,26,0,0,"PACMA",0
40,"40222",174,147,147,0,0,"PACMA",0
40,"40018",90,70,68,0,2,"PACMA",0
40,"40025",142,119,117,0,2,"PACMA",0
40,"40039",213,167,165,2,2,"PACMA",0
40,"40079",234,182,181,1,1,"PACMA",0
40,"40115",104,80,79,0,1,"PACMA",0
40,"40216",755,628,621,7,7,"PACMA",6
40,"40122",514,416,403,0,13,"PACMA",5
40,"40001",715,588,580,4,8,"PACMA",0
40,"40183",130,113,112,1,1,"PACMA",0
40,"40040",2626,1847,1835,19,12,"PACMA",8
40,"40140",97,72,71,8,1,"PACMA",0
40,"40068",24,22,22,0,0,"PACMA",1
40,"40166",260,224,222,2,2,"PACMA",0
40,"40903",91,68,68,1,0,"PACMA",0
40,"40162",396,305,299,0,6,"PACMA",0
40,"40194",39796,30886,30516,287,370,"PACMA",210
40,"40081",126,94,90,1,4,"PACMA",0
40,"40120",192,167,166,1,1,"PACMA",1
40,"40198",24,19,19,0,0,"PACMA",0
40,"40146",255,211,209,0,2,"PACMA",0
40,"40111",61,51,51,0,0,"PACMA",1
40,"40073",405,345,339,4,6,"PACMA",1
40,"40022",207,162,160,3,2,"PACMA",0
40,"40071",46,42,39,0,3,"PACMA",0
24,"24061",1702,1244,1231,13,13,"PREPAL",4
24,"24167",763,509,504,9,5,"PREPAL",5
24,"24157",2580,2013,1983,25,30,"PREPAL",10
24,"24098",1205,880,874,8,6,"PREPAL",2
24,"24191",111,84,84,1,0,"PREPAL",0
24,"24083",1077,764,755,4,9,"PREPAL",1
24,"24079",922,654,645,9,9,"PREPAL",1
24,"24107",244,184,183,2,1,"PREPAL",0
24,"24173",943,678,673,3,5,"PREPAL",1
24,"24094",1392,1048,1038,11,10,"PREPAL",8
24,"24044",171,125,118,0,7,"PREPAL",0
24,"24012",297,212,211,4,1,"PREPAL",2
24,"24209",2790,1907,1884,15,23,"PREPAL",2
24,"24060",615,361,359,0,2,"PREPAL",6
24,"24144",704,487,478,5,9,"PREPAL",4
24,"24112",318,207,207,0,0,"PREPAL",0
24,"24197",770,545,537,6,8,"PREPAL",4
24,"24027",1214,881,860,8,21,"PREPAL",0
24,"24117",446,333,331,2,2,"PREPAL",0
24,"24181",1519,1135,1117,10,18,"PREPAL",1
24,"24155",478,380,371,0,9,"PREPAL",0
24,"24091",657,440,437,2,3,"PREPAL",2
24,"24153",233,173,172,3,1,"PREPAL",1
24,"24024",695,496,494,4,2,"PREPAL",3
24,"24002",236,182,180,3,2,"PREPAL",2
24,"24074",99,77,76,1,1,"PREPAL",1
24,"24180",1128,825,814,12,11,"PREPAL",1
24,"24070",4159,3206,3162,31,44,"PREPAL",1
24,"24193",384,277,276,4,1,"PREPAL",0
24,"24090",348,226,224,1,2,"PREPAL",0
24,"24198",602,411,402,4,9,"PREPAL",0
24,"24032",111,82,82,1,0,"PREPAL",1
24,"24148",1684,1268,1256,9,12,"PREPAL",1
24,"24216",732,533,522,2,11,"PREPAL",2
24,"24131",742,499,497,5,2,"PREPAL",3
24,"24109",996,667,652,7,15,"PREPAL",3
24,"24123",757,499,497,4,2,"PREPAL",4
24,"24227",1617,1146,1142,14,4,"PREPAL",3
24,"24125",475,285,282,2,3,"PREPAL",0
24,"24041",548,384,381,5,3,"PREPAL",0
24,"24004",469,349,349,6,0,"PREPAL",0
24,"24058",205,137,134,0,3,"PREPAL",0
24,"24206",1732,1303,1288,8,15,"PREPAL",1
24,"24034",3419,2596,2556,27,40,"PREPAL",1
24,"24214",669,492,490,1,2,"PREPAL",0
24,"24218",454,331,329,3,2,"PREPAL",0
24,"24174",495,362,357,3,5,"PREPAL",1
24,"24028",386,304,302,3,2,"PREPAL",1
24,"24022",342,227,227,0,0,"PREPAL",0
24,"24092",809,619,609,1,10,"PREPAL",2
24,"24229",427,330,324,8,6,"PREPAL",1
24,"24166",1413,1043,1014,7,29,"PREPAL",1
24,"24127",301,239,239,3,0,"PREPAL",1
24,"24133",350,259,258,3,1,"PREPAL",3
24,"24158",323,210,207,0,3,"PREPAL",0
24,"24040",453,315,309,2,6,"PREPAL",1
24,"24036",301,181,180,0,1,"PREPAL",0
24,"24172",420,218,216,1,2,"PREPAL",0
24,"24141",98,76,75,0,1,"PREPAL",0
24,"24065",2106,1573,1545,16,28,"PREPAL",6
24,"24047",782,533,527,7,6,"PREPAL",1
24,"24017",582,434,433,9,1,"PREPAL",3
24,"24113",366,282,275,3,7,"PREPAL",2
24,"24023",268,189,188,2,1,"PREPAL",0
24,"24095",314,246,244,1,2,"PREPAL",0
24,"24202",8098,5654,5582,51,72,"PREPAL",5
24,"24224",621,452,445,7,7,"PREPAL",1
24,"24007",764,578,576,3,2,"PREPAL",0
24,"24170",1934,1436,1424,13,12,"PREPAL",1
24,"24187",876,642,631,6,11,"PREPAL",0
24,"24078",388,286,284,4,2,"PREPAL",1
24,"24067",645,383,379,2,4,"PREPAL",0
24,"24066",504,367,361,3,6,"PREPAL",1
24,"24901",908,660,653,4,7,"PREPAL",4
24,"24165",373,254,250,2,4,"PREPAL",0
24,"24088",1037,804,797,8,7,"PREPAL",1
24,"24211",276,210,206,4,4,"PREPAL",1
24,"24082",870,692,682,10,10,"PREPAL",2
24,"24001",188,108,108,0,0,"PREPAL",0
24,"24199",433,284,281,3,3,"PREPAL",0
24,"24142",25160,18503,18262,205,241,"PREPAL",81
24,"24076",1279,972,953,7,19,"PREPAL",0
24,"24146",271,195,194,0,1,"PREPAL",0
24,"24143",514,391,379,4,12,"PREPAL",0
24,"24008",9319,6964,6852,77,112,"PREPAL",23
24,"24038",3107,2383,2354,30,29,"PREPAL",3
24,"24156",243,169,169,1,0,"PREPAL",0
24,"24068",464,343,339,5,4,"PREPAL",2
24,"24169",2976,2256,2236,12,20,"PREPAL",0
24,"24042",61,48,48,1,0,"PREPAL",0
24,"24050",102,77,77,1,0,"PREPAL",0
24,"24159",1832,1407,1391,17,16,"PREPAL",5
24,"24059",887,520,512,8,8,"PREPAL",0
24,"24080",218,170,162,3,8,"PREPAL",0
24,"24046",953,662,645,6,17,"PREPAL",0
24,"24151",492,357,357,1,0,"PREPAL",1
24,"24205",967,714,706,9,8,"PREPAL",1
24,"24077",227,195,192,1,3,"PREPAL",0
24,"24081",142,97,97,0,0,"PREPAL",0
24,"24163",3929,3076,3044,49,32,"PREPAL",7
24,"24226",204,138,136,0,2,"PREPAL",0
24,"24189",6016,4187,4134,58,53,"PREPAL",6
24,"24176",318,244,243,5,1,"PREPAL",0
24,"24054",433,308,303,4,5,"PREPAL",1
24,"24185",482,357,349,4,8,"PREPAL",0
24,"24033",211,154,151,1,3,"PREPAL",2
24,"24129",122,85,85,1,0,"PREPAL",0
24,"24183",805,528,522,5,6,"PREPAL",3
24,"24051",433,308,307,1,1,"PREPAL",0
24,"24020",463,294,291,5,3,"PREPAL",1
24,"24030",4297,3226,3180,16,46,"PREPAL",0
24,"24190",167,115,115,2,0,"PREPAL",3
24,"24177",481,328,327,1,1,"PREPAL",1
24,"24089",103315,77803,77038,779,765,"PREPAL",271
24,"24071",1006,747,738,9,9,"PREPAL",1
24,"24149",155,123,121,0,2,"PREPAL",0
24,"24217",136,110,109,1,1,"PREPAL",0
24,"24037",369,251,251,0,0,"PREPAL",0
24,"24062",142,105,105,1,0,"PREPAL",0
24,"24049",1493,1152,1138,8,14,"PREPAL",0
24,"24203",96,73,72,1,1,"PREPAL",0
24,"24099",173,133,133,2,0,"PREPAL",0
24,"24178",71,58,57,0,1,"PREPAL",0
24,"24093",380,249,248,3,1,"PREPAL",1
24,"24184",206,121,120,0,1,"PREPAL",0
24,"24175",1825,1381,1372,13,9,"PREPAL",2
24,"24025",300,233,228,0,5,"PREPAL",1
24,"24150",243,175,175,3,0,"PREPAL",0
24,"24119",702,491,480,6,11,"PREPAL",0
24,"24056",2910,2102,2068,31,34,"PREPAL",16
24,"24212",1029,784,774,7,10,"PREPAL",2
24,"24018",177,143,141,0,2,"PREPAL",1
24,"24031",216,169,167,1,2,"PREPAL",0
24,"24106",258,178,173,1,5,"PREPAL",1
24,"24019",359,293,291,3,2,"PREPAL",0
24,"24100",769,569,561,4,8,"PREPAL",1
24,"24053",439,303,298,2,5,"PREPAL",0
24,"24069",42,36,36,0,0,"PREPAL",0
24,"24073",481,343,340,3,3,"PREPAL",1
24,"24103",292,160,160,1,0,"PREPAL",0
24,"24210",510,347,347,0,0,"PREPAL",2
24,"24110",1253,932,926,7,6,"PREPAL",0
24,"24003",652,442,435,5,7,"PREPAL",1
24,"24063",391,260,259,1,1,"PREPAL",1
24,"24139",2186,1608,1570,24,38,"PREPAL",1
24,"24026",1203,908,898,19,10,"PREPAL",9
24,"24136",544,391,390,8,1,"PREPAL",0
24,"24115",54290,39886,39486,325,400,"PREPAL",19
24,"24084",162,119,119,1,0,"PREPAL",0
24,"24114",3107,2174,2155,7,19,"PREPAL",6
24,"24014",7474,5375,5321,56,54,"PREPAL",8
24,"24101",404,264,262,2,2,"PREPAL",0
24,"24161",291,218,212,2,6,"PREPAL",0
24,"24055",705,510,507,6,3,"PREPAL",1
24,"24064",1525,1165,1151,10,14,"PREPAL",0
24,"24052",171,109,108,0,1,"PREPAL",1
24,"24010",8426,5980,5888,61,92,"PREPAL",31
24,"24168",461,383,379,4,4,"PREPAL",1
24,"24086",271,200,198,1,2,"PREPAL",0
24,"24188",3843,2962,2899,48,63,"PREPAL",11
24,"24011",209,113,112,0,1,"PREPAL",0
24,"24122",1351,965,948,9,17,"PREPAL",1
24,"24057",1366,1103,1076,11,27,"PREPAL",0
24,"24015",2279,1693,1658,22,35,"PREPAL",8
24,"24105",1443,1087,1065,10,22,"PREPAL",3
24,"24225",1020,786,773,6,13,"PREPAL",2
24,"24102",655,495,492,2,3,"PREPAL",0
24,"24222",14249,10663,10532,119,131,"PREPAL",156
24,"24096",124,74,74,0,0,"PREPAL",0
24,"24207",296,245,241,3,4,"PREPAL",2
24,"24104",266,180,179,0,1,"PREPAL",0
24,"24021",1688,1213,1189,6,24,"PREPAL",3
24,"24902",354,273,272,2,1,"PREPAL",0
24,"24228",666,455,449,2,6,"PREPAL",2
24,"24160",692,506,498,2,8,"PREPAL",4
24,"24215",156,119,118,1,1,"PREPAL",0
24,"24201",1086,765,757,5,8,"PREPAL",1
24,"24182",420,289,287,6,2,"PREPAL",1
24,"24179",299,202,201,8,1,"PREPAL",0
24,"24213",158,117,117,0,0,"PREPAL",1
24,"24009",322,161,161,1,0,"PREPAL",0
24,"24223",2640,2012,2012,53,0,"PREPAL",4
24,"24219",527,390,387,2,3,"PREPAL",2
24,"24221",790,568,558,6,10,"PREPAL",1
24,"24087",645,469,466,11,3,"PREPAL",3
24,"24230",423,329,324,2,5,"PREPAL",2
24,"24132",628,397,390,6,7,"PREPAL",0
24,"24005",387,267,259,6,8,"PREPAL",1
24,"24118",127,84,84,1,0,"PREPAL",1
24,"24152",462,302,301,2,1,"PREPAL",0
24,"24171",364,219,217,1,2,"PREPAL",1
24,"24043",135,69,67,0,2,"PREPAL",0
24,"24108",377,279,273,3,6,"PREPAL",0
24,"24029",754,545,539,2,6,"PREPAL",1
24,"24145",655,445,443,8,2,"PREPAL",1
24,"24164",373,190,190,1,0,"PREPAL",0
24,"24016",478,287,285,1,2,"PREPAL",0
24,"24137",1114,811,804,9,7,"PREPAL",4
24,"24116",424,276,273,0,3,"PREPAL",0
24,"24196",2082,1529,1513,15,16,"PREPAL",1
24,"24006",488,351,342,4,9,"PREPAL",0
24,"24097",225,146,145,1,1,"PREPAL",1
24,"24162",1671,1314,1303,21,11,"PREPAL",5
24,"24134",3465,2628,2583,27,45,"PREPAL",12
24,"24121",655,481,477,0,4,"PREPAL",0
24,"24120",345,214,214,1,0,"PREPAL",3
24,"24130",437,319,315,1,4,"PREPAL",5
24,"24124",374,249,246,4,3,"PREPAL",0
24,"24039",2077,1604,1600,39,4,"PREPAL",10
24,"24154",1010,750,729,7,21,"PREPAL",0
24,"24194",292,230,229,1,1,"PREPAL",1
39,"39054",4472,3478,3441,45,37,"PH",2
39,"39094",854,644,637,9,7,"PH",1
39,"39079",8951,6734,6657,54,77,"PH",4
39,"39099",3117,2446,2406,23,40,"PH",1
39,"39072",343,213,213,1,0,"PH",0
39,"39078",1413,1045,1032,10,13,"PH",2
39,"39098",1422,1078,1074,11,4,"PH",1
39,"39044",3833,2889,2860,26,29,"PH",3
39,"39053",219,135,135,1,0,"PH",0
39,"39041",1764,1416,1395,10,21,"PH",0
39,"39028",3733,2918,2877,17,41,"PH",0
39,"39091",1947,1572,1552,9,20,"PH",1
39,"39074",6905,5370,5288,52,82,"PH",4
39,"39014",898,655,644,8,11,"PH",1
39,"39090",756,564,550,4,14,"PH",0
39,"39042",5968,4614,4572,33,42,"PH",7
39,"39085",6834,5319,5265,37,54,"PH",2
39,"39001",2127,1651,1631,17,20,"PH",2
39,"39089",149,104,103,1,1,"PH",0
39,"39046",1402,1015,985,11,30,"PH",1
39,"39024",1882,1452,1438,14,14,"PH",2
39,"39093",307,232,232,1,0,"PH",0
39,"39004",1539,1177,1160,12,17,"PH",0
39,"39076",3491,2696,2662,24,34,"PH",1
39,"39045",376,284,276,1,8,"PH",0
39,"39071",405,277,272,2,5,"PH",0
39,"39057",2321,1773,1746,13,27,"PH",1
39,"39101",292,206,202,2,4,"PH",0
39,"39077",246,186,182,0,4,"PH",0
39,"39015",862,650,643,6,7,"PH",0
39,"39025",8693,6696,6583,58,113,"PH",5
39,"39006",1728,1353,1337,12,16,"PH",0
39,"39043",1468,1167,1151,10,16,"PH",0
39,"39007",434,298,297,1,1,"PH",0
39,"39061",3488,2746,2722,29,24,"PH",4
39,"39018",4211,3389,3329,27,60,"PH",4
39,"39017",571,385,377,2,8,"PH",1
39,"39086",357,260,258,1,2,"PH",0
39,"39016",23860,18608,18405,149,203,"PH",8
39,"39037",2003,1570,1547,8,23,"PH",0
39,"39008",13932,10600,10506,92,94,"PH",5
39,"39035",9587,7315,7214,56,101,"PH",3
39,"39039",572,397,396,1,1,"PH",0
39,"39033",578,432,432,5,0,"PH",0
39,"39088",71,51,51,0,0,"PH",0
39,"39050",276,173,170,0,3,"PH",0
39,"39047",1978,1463,1448,15,15,"PH",1
39,"39049",330,251,248,1,3,"PH",0
39,"39003",299,219,217,0,2,"PH",0
39,"39075",137597,102862,102053,819,809,"PH",73
39,"39034",286,180,179,4,1,"PH",0
39,"39020",23612,16515,16334,125,181,"PH",6
39,"39069",1968,1586,1555,12,31,"PH",1
39,"39066",868,697,688,7,9,"PH",0
39,"39058",831,594,592,6,2,"PH",0
39,"39021",495,399,391,4,8,"PH",0
39,"39011",1602,1211,1202,13,9,"PH",2
39,"39022",987,735,730,7,5,"PH",0
39,"39080",3552,2734,2701,17,33,"PH",2
39,"39036",983,774,770,8,4,"PH",0
39,"39084",843,608,604,5,4,"PH",0
39,"39027",3139,2493,2439,30,54,"PH",1
39,"39082",1658,1212,1202,15,10,"PH",0
39,"39073",9806,7636,7574,42,62,"PH",10
39,"39056",2326,1805,1775,17,30,"PH",3
39,"39064",1349,1036,1016,6,20,"PH",0
39,"39100",869,628,617,12,11,"PH",0
39,"39096",702,477,474,3,3,"PH",0
39,"39092",916,668,663,4,5,"PH",0
39,"39070",146,111,109,3,2,"PH",1
39,"39026",1751,1303,1295,9,8,"PH",1
39,"39052",18086,14014,13852,124,162,"PH",7
39,"39029",624,507,503,4,4,"PH",0
39,"39087",42262,32560,32124,234,436,"PH",28
39,"39097",713,409,400,10,9,"PH",0
39,"39063",973,725,720,7,5,"PH",0
39,"39010",639,509,505,5,4,"PH",1
39,"39060",6705,5437,5339,46,98,"PH",2
39,"39005",1396,1089,1084,4,5,"PH",0
39,"39083",1139,747,739,6,8,"PH",1
39,"39019",2098,1669,1646,24,23,"PH",3
39,"39062",1824,1400,1392,14,8,"PH",0
39,"39102",2281,1647,1631,13,16,"PH",1
39,"39032",1476,1117,1100,8,17,"PH",2
39,"39013",515,378,375,1,3,"PH",1
39,"39051",67,62,61,1,1,"PH",0
39,"39095",2268,1812,1789,9,23,"PH",0
39,"39040",4290,3337,3309,22,28,"PH",1
39,"39012",6693,5213,5131,44,82,"PH",3
39,"39048",1697,1372,1361,10,11,"PH",0
39,"39009",3223,2395,2370,22,25,"PH",4
39,"39030",1894,1314,1290,9,24,"PH",0
39,"39059",8057,6049,5972,50,77,"PH",7
39,"39002",3313,2430,2391,17,39,"PH",1
39,"39031",1235,873,863,5,10,"PH",0
39,"39055",1118,838,826,6,12,"PH",0
39,"39023",6316,4900,4827,37,73,"PH",4
39,"39065",256,202,200,6,2,"PH",1
39,"39068",659,486,479,2,7,"PH",0
39,"39038",1463,1039,1030,6,9,"PH",1
39,"39081",435,349,342,3,7,"PH",0
39,"39067",813,569,561,5,8,"PH",0
2,"2077",55,41,41,0,0,"UPYD",0
2,"2047",120,91,90,0,1,"UPYD",0
2,"2030",3059,2405,2377,11,28,"UPYD",3
2,"2067",1189,909,896,4,13,"UPYD",4
2,"2064",379,317,316,1,1,"UPYD",0
2,"2072",1560,1118,1098,4,20,"UPYD",2
2,"2032",281,217,216,1,1,"UPYD",1
2,"2004",621,504,500,5,4,"UPYD",0
2,"2053",2996,2370,2332,15,38,"UPYD",6
2,"2059",317,242,241,0,1,"UPYD",0
2,"2056",1729,1348,1323,10,25,"UPYD",8
2,"2009",19686,14909,14719,148,190,"UPYD",67
2,"2018",832,670,663,5,7,"UPYD",3
2,"2019",2412,1991,1959,13,32,"UPYD",7
2,"2070",411,337,330,1,7,"UPYD",0
2,"2057",2043,1593,1568,24,25,"UPYD",0
2,"2005",568,441,434,4,7,"UPYD",0
2,"2011",643,517,515,0,2,"UPYD",1
2,"2071",1056,890,884,7,6,"UPYD",1
2,"2034",1395,1131,1126,10,5,"UPYD",2
2,"2007",1050,824,811,7,13,"UPYD",4
2,"2041",350,274,272,1,2,"UPYD",1
2,"2068",343,265,262,2,3,"UPYD",2
2,"2083",217,194,194,0,0,"UPYD",1
2,"2069",11544,8969,8824,62,145,"UPYD",28
2,"2003",131959,101091,100433,730,658,"UPYD",714
2,"2040",586,507,505,1,2,"UPYD",0
2,"2039",1002,824,819,8,5,"UPYD",2
2,"2036",96,72,72,1,0,"UPYD",0
2,"2023",576,479,468,2,11,"UPYD",0
2,"2066",238,206,205,1,1,"UPYD",0
2,"2058",348,244,239,2,5,"UPYD",0
2,"2055",1157,757,753,9,4,"UPYD",3
2,"2024",3416,2694,2666,33,28,"UPYD",11
2,"2002",494,406,397,0,9,"UPYD",0
2,"2901",2202,1571,1563,16,8,"UPYD",5
2,"2001",660,521,510,4,11,"UPYD",2
2,"2061",641,534,530,7,4,"UPYD",1
2,"2016",581,445,441,0,4,"UPYD",1
2,"2043",1250,1020,1006,8,14,"UPYD",3
2,"2081",18334,14121,13932,116,189,"UPYD",46
2,"2033",1920,1551,1518,6,33,"UPYD",4
2,"2044",1128,806,798,2,8,"UPYD",0
2,"2060",1302,1007,1003,8,4,"UPYD",8
2,"2074",5998,4415,4363,20,52,"UPYD",11
2,"2063",1471,1161,1156,6,5,"UPYD",4
2,"2027",310,251,251,0,0,"UPYD",1
2,"2076",334,269,268,3,1,"UPYD",0
2,"2022",368,279,278,0,1,"UPYD",0
2,"2046",1135,936,917,15,19,"UPYD",2
2,"2084",325,228,221,2,7,"UPYD",2
2,"2028",132,103,102,0,1,"UPYD",0
2,"2031",574,447,440,1,7,"UPYD",0
2,"2042",850,698,693,2,5,"UPYD",2
2,"2037",22886,15400,15266,111,134,"UPYD",62
2,"2051",1690,1227,1211,12,16,"UPYD",0
2,"2021",1037,823,816,3,7,"UPYD",1
2,"2025",7502,5918,5785,41,133,"UPYD",29
2,"2079",2887,2312,2285,24,27,"UPYD",6
2,"2038",284,230,230,1,0,"UPYD",0
2,"2020",451,381,376,3,5,"UPYD",4
2,"2049",838,610,607,3,3,"UPYD",2
2,"2026",847,705,697,7,8,"UPYD",0
2,"2075",1684,1406,1397,10,9,"UPYD",1
2,"2010",1798,1491,1463,10,28,"UPYD",1
2,"2054",390,305,302,3,3,"UPYD",0
2,"2029",3306,2563,2533,17,30,"UPYD",12
2,"2014",368,300,295,1,5,"UPYD",0
2,"2017",845,611,607,1,4,"UPYD",0
2,"2073",4914,3777,3730,42,47,"UPYD",19
2,"2065",475,403,402,2,1,"UPYD",4
2,"2008",1227,923,909,9,14,"UPYD",4
2,"2035",1989,1607,1582,13,25,"UPYD",7
2,"2078",922,698,691,6,7,"UPYD",1
2,"2080",532,419,410,0,9,"UPYD",7
2,"2082",105,88,88,1,0,"UPYD",0
2,"2006",588,482,476,2,6,"UPYD",0
2,"2062",414,324,319,0,5,"UPYD",0
2,"2048",1251,1013,1004,9,9,"UPYD",0
2,"2052",473,399,398,3,1,"UPYD",1
2,"2012",1833,1595,1575,17,20,"UPYD",1
2,"2045",3706,3046,3009,17,37,"UPYD",14
2,"2085",321,268,266,4,2,"UPYD",0
2,"2086",2603,1797,1783,8,14,"UPYD",5
2,"2015",1444,1196,1179,7,17,"UPYD",1
2,"2013",132,105,104,0,1,"UPYD",0
2,"2050",103,87,87,0,0,"UPYD",0
2,"2020",451,381,376,3,5,"VOX",0
2,"2013",132,105,104,0,1,"VOX",0
2,"2028",132,103,102,0,1,"VOX",0
2,"2057",2043,1593,1568,24,25,"VOX",1
2,"2073",4914,3777,3730,42,47,"VOX",11
2,"2006",588,482,476,2,6,"VOX",0
2,"2082",105,88,88,1,0,"VOX",1
2,"2034",1395,1131,1126,10,5,"VOX",1
2,"2008",1227,923,909,9,14,"VOX",2
2,"2025",7502,5918,5785,41,133,"VOX",27
2,"2023",576,479,468,2,11,"VOX",0
2,"2077",55,41,41,0,0,"VOX",0
2,"2072",1560,1118,1098,4,20,"VOX",0
2,"2011",643,517,515,0,2,"VOX",0
2,"2042",850,698,693,2,5,"VOX",1
2,"2031",574,447,440,1,7,"VOX",1
2,"2083",217,194,194,0,0,"VOX",0
2,"2074",5998,4415,4363,20,52,"VOX",6
2,"2017",845,611,607,1,4,"VOX",1
2,"2051",1690,1227,1211,12,16,"VOX",2
2,"2052",473,399,398,3,1,"VOX",0
2,"2010",1798,1491,1463,10,28,"VOX",0
2,"2048",1251,1013,1004,9,9,"VOX",0
2,"2024",3416,2694,2666,33,28,"VOX",1
2,"2058",348,244,239,2,5,"VOX",2
2,"2067",1189,909,896,4,13,"VOX",1
2,"2016",581,445,441,0,4,"VOX",1
2,"2084",325,228,221,2,7,"VOX",0
2,"2066",238,206,205,1,1,"VOX",1
2,"2037",22886,15400,15266,111,134,"VOX",15
2,"2064",379,317,316,1,1,"VOX",0
2,"2070",411,337,330,1,7,"VOX",1
2,"2080",532,419,410,0,9,"VOX",3
2,"2053",2996,2370,2332,15,38,"VOX",3
2,"2056",1729,1348,1323,10,25,"VOX",1
2,"2075",1684,1406,1397,10,9,"VOX",0
2,"2086",2603,1797,1783,8,14,"VOX",1
2,"2901",2202,1571,1563,16,8,"VOX",1
2,"2062",414,324,319,0,5,"VOX",0
2,"2035",1989,1607,1582,13,25,"VOX",6
2,"2039",1002,824,819,8,5,"VOX",1
2,"2076",334,269,268,3,1,"VOX",1
2,"2036",96,72,72,1,0,"VOX",0
2,"2003",131959,101091,100433,730,658,"VOX",324
2,"2043",1250,1020,1006,8,14,"VOX",0
2,"2063",1471,1161,1156,6,5,"VOX",1
2,"2069",11544,8969,8824,62,145,"VOX",31
2,"2005",568,441,434,4,7,"VOX",0
2,"2021",1037,823,816,3,7,"VOX",1
2,"2054",390,305,302,3,3,"VOX",0
2,"2027",310,251,251,0,0,"VOX",0
2,"2068",343,265,262,2,3,"VOX",0
2,"2044",1128,806,798,2,8,"VOX",1
2,"2014",368,300,295,1,5,"VOX",1
2,"2050",103,87,87,0,0,"VOX",1
2,"2049",838,610,607,3,3,"VOX",1
2,"2040",586,507,505,1,2,"VOX",0
2,"2026",847,705,697,7,8,"VOX",0
2,"2018",832,670,663,5,7,"VOX",2
2,"2022",368,279,278,0,1,"VOX",2
2,"2004",621,504,500,5,4,"VOX",0
2,"2085",321,268,266,4,2,"VOX",0
2,"2001",660,521,510,4,11,"VOX",0
2,"2002",494,406,397,0,9,"VOX",0
2,"2032",281,217,216,1,1,"VOX",0
2,"2012",1833,1595,1575,17,20,"VOX",1
2,"2041",350,274,272,1,2,"VOX",0
2,"2030",3059,2405,2377,11,28,"VOX",9
2,"2079",2887,2312,2285,24,27,"VOX",4
2,"2060",1302,1007,1003,8,4,"VOX",3
2,"2047",120,91,90,0,1,"VOX",0
2,"2007",1050,824,811,7,13,"VOX",0
2,"2038",284,230,230,1,0,"VOX",0
2,"2015",1444,1196,1179,7,17,"VOX",0
2,"2055",1157,757,753,9,4,"VOX",0
2,"2081",18334,14121,13932,116,189,"VOX",17
2,"2059",317,242,241,0,1,"VOX",2
2,"2019",2412,1991,1959,13,32,"VOX",2
2,"2009",19686,14909,14719,148,190,"VOX",24
2,"2045",3706,3046,3009,17,37,"VOX",4
2,"2061",641,534,530,7,4,"VOX",0
2,"2033",1920,1551,1518,6,33,"VOX",1
2,"2065",475,403,402,2,1,"VOX",0
2,"2029",3306,2563,2533,17,30,"VOX",5
2,"2071",1056,890,884,7,6,"VOX",5
2,"2078",922,698,691,6,7,"VOX",1
2,"2046",1135,936,917,15,19,"VOX",2
39,"39034",286,180,179,4,1,"SAIn",0
39,"39044",3833,2889,2860,26,29,"SAIn",3
39,"39041",1764,1416,1395,10,21,"SAIn",0
39,"39017",571,385,377,2,8,"SAIn",0
39,"39003",299,219,217,0,2,"SAIn",1
39,"39089",149,104,103,1,1,"SAIn",0
39,"39042",5968,4614,4572,33,42,"SAIn",1
39,"39071",405,277,272,2,5,"SAIn",0
39,"39040",4290,3337,3309,22,28,"SAIn",0
39,"39036",983,774,770,8,4,"SAIn",0
39,"39081",435,349,342,3,7,"SAIn",0
39,"39010",639,509,505,5,4,"SAIn",1
39,"39018",4211,3389,3329,27,60,"SAIn",0
39,"39059",8057,6049,5972,50,77,"SAIn",2
39,"39001",2127,1651,1631,17,20,"SAIn",1
39,"39051",67,62,61,1,1,"SAIn",0
39,"39064",1349,1036,1016,6,20,"SAIn",0
39,"39046",1402,1015,985,11,30,"SAIn",0
39,"39077",246,186,182,0,4,"SAIn",0
39,"39027",3139,2493,2439,30,54,"SAIn",1
39,"39039",572,397,396,1,1,"SAIn",0
39,"39021",495,399,391,4,8,"SAIn",0
39,"39085",6834,5319,5265,37,54,"SAIn",0
39,"39100",869,628,617,12,11,"SAIn",0
39,"39008",13932,10600,10506,92,94,"SAIn",11
39,"39005",1396,1089,1084,4,5,"SAIn",0
39,"39016",23860,18608,18405,149,203,"SAIn",12
39,"39055",1118,838,826,6,12,"SAIn",0
39,"39004",1539,1177,1160,12,17,"SAIn",0
39,"39094",854,644,637,9,7,"SAIn",0
39,"39007",434,298,297,1,1,"SAIn",0
39,"39049",330,251,248,1,3,"SAIn",0
39,"39078",1413,1045,1032,10,13,"SAIn",0
39,"39035",9587,7315,7214,56,101,"SAIn",1
39,"39102",2281,1647,1631,13,16,"SAIn",1
39,"39076",3491,2696,2662,24,34,"SAIn",0
39,"39015",862,650,643,6,7,"SAIn",0
39,"39023",6316,4900,4827,37,73,"SAIn",3
39,"39058",831,594,592,6,2,"SAIn",0
39,"39095",2268,1812,1789,9,23,"SAIn",0
39,"39014",898,655,644,8,11,"SAIn",1
39,"39088",71,51,51,0,0,"SAIn",0
39,"39082",1658,1212,1202,15,10,"SAIn",1
39,"39073",9806,7636,7574,42,62,"SAIn",3
39,"39013",515,378,375,1,3,"SAIn",0
39,"39080",3552,2734,2701,17,33,"SAIn",2
39,"39024",1882,1452,1438,14,14,"SAIn",1
39,"39057",2321,1773,1746,13,27,"SAIn",1
39,"39074",6905,5370,5288,52,82,"SAIn",6
39,"39026",1751,1303,1295,9,8,"SAIn",0
39,"39052",18086,14014,13852,124,162,"SAIn",4
39,"39011",1602,1211,1202,13,9,"SAIn",1
39,"39020",23612,16515,16334,125,181,"SAIn",4
39,"39032",1476,1117,1100,8,17,"SAIn",0
39,"39068",659,486,479,2,7,"SAIn",0
39,"39084",843,608,604,5,4,"SAIn",0
39,"39054",4472,3478,3441,45,37,"SAIn",2
39,"39093",307,232,232,1,0,"SAIn",0
39,"39101",292,206,202,2,4,"SAIn",0
39,"39037",2003,1570,1547,8,23,"SAIn",3
39,"39028",3733,2918,2877,17,41,"SAIn",0
39,"39069",1968,1586,1555,12,31,"SAIn",1
39,"39092",916,668,663,4,5,"SAIn",0
39,"39025",8693,6696,6583,58,113,"SAIn",2
39,"39056",2326,1805,1775,17,30,"SAIn",1
39,"39060",6705,5437,5339,46,98,"SAIn",7
39,"39006",1728,1353,1337,12,16,"SAIn",2
39,"39083",1139,747,739,6,8,"SAIn",0
39,"39072",343,213,213,1,0,"SAIn",0
39,"39065",256,202,200,6,2,"SAIn",1
39,"39091",1947,1572,1552,9,20,"SAIn",0
39,"39096",702,477,474,3,3,"SAIn",0
39,"39067",813,569,561,5,8,"SAIn",0
39,"39053",219,135,135,1,0,"SAIn",0
39,"39098",1422,1078,1074,11,4,"SAIn",0
39,"39063",973,725,720,7,5,"SAIn",1
39,"39097",713,409,400,10,9,"SAIn",0
39,"39022",987,735,730,7,5,"SAIn",0
39,"39050",276,173,170,0,3,"SAIn",0
39,"39061",3488,2746,2722,29,24,"SAIn",0
39,"39033",578,432,432,5,0,"SAIn",0
39,"39048",1697,1372,1361,10,11,"SAIn",1
39,"39030",1894,1314,1290,9,24,"SAIn",1
39,"39002",3313,2430,2391,17,39,"SAIn",3
39,"39062",1824,1400,1392,14,8,"SAIn",1
39,"39086",357,260,258,1,2,"SAIn",0
39,"39087",42262,32560,32124,234,436,"SAIn",19
39,"39075",137597,102862,102053,819,809,"SAIn",56
39,"39031",1235,873,863,5,10,"SAIn",1
39,"39038",1463,1039,1030,6,9,"SAIn",0
39,"39009",3223,2395,2370,22,25,"SAIn",1
39,"39012",6693,5213,5131,44,82,"SAIn",1
39,"39019",2098,1669,1646,24,23,"SAIn",1
39,"39043",1468,1167,1151,10,16,"SAIn",0
39,"39090",756,564,550,4,14,"SAIn",0
39,"39070",146,111,109,3,2,"SAIn",0
39,"39045",376,284,276,1,8,"SAIn",0
39,"39047",1978,1463,1448,15,15,"SAIn",1
39,"39029",624,507,503,4,4,"SAIn",0
39,"39066",868,697,688,7,9,"SAIn",0
39,"39099",3117,2446,2406,23,40,"SAIn",0
39,"39079",8951,6734,6657,54,77,"SAIn",3
39,"39049",330,251,248,1,3,"PODEMOS",23
39,"39019",2098,1669,1646,24,23,"PODEMOS",331
39,"39013",515,378,375,1,3,"PODEMOS",31
39,"39042",5968,4614,4572,33,42,"PODEMOS",624
39,"39076",3491,2696,2662,24,34,"PODEMOS",406
39,"39034",286,180,179,4,1,"PODEMOS",12
39,"39088",71,51,51,0,0,"PODEMOS",7
39,"39064",1349,1036,1016,6,20,"PODEMOS",109
39,"39080",3552,2734,2701,17,33,"PODEMOS",387
39,"39083",1139,747,739,6,8,"PODEMOS",123
39,"39041",1764,1416,1395,10,21,"PODEMOS",274
39,"39012",6693,5213,5131,44,82,"PODEMOS",1044
39,"39044",3833,2889,2860,26,29,"PODEMOS",559
39,"39010",639,509,505,5,4,"PODEMOS",64
39,"39027",3139,2493,2439,30,54,"PODEMOS",322
39,"39093",307,232,232,1,0,"PODEMOS",43
39,"39035",9587,7315,7214,56,101,"PODEMOS",1278
39,"39003",299,219,217,0,2,"PODEMOS",35
39,"39043",1468,1167,1151,10,16,"PODEMOS",154
39,"39067",813,569,561,5,8,"PODEMOS",69
39,"39011",1602,1211,1202,13,9,"PODEMOS",155
39,"39075",137597,102862,102053,819,809,"PODEMOS",17211
39,"39054",4472,3478,3441,45,37,"PODEMOS",707
39,"39004",1539,1177,1160,12,17,"PODEMOS",182
39,"39030",1894,1314,1290,9,24,"PODEMOS",314
39,"39095",2268,1812,1789,9,23,"PODEMOS",265
39,"39096",702,477,474,3,3,"PODEMOS",34
39,"39062",1824,1400,1392,14,8,"PODEMOS",161
39,"39101",292,206,202,2,4,"PODEMOS",48
39,"39051",67,62,61,1,1,"PODEMOS",10
39,"39056",2326,1805,1775,17,30,"PODEMOS",269
39,"39046",1402,1015,985,11,30,"PODEMOS",191
39,"39082",1658,1212,1202,15,10,"PODEMOS",120
39,"39052",18086,14014,13852,124,162,"PODEMOS",2662
39,"39094",854,644,637,9,7,"PODEMOS",78
39,"39090",756,564,550,4,14,"PODEMOS",118
39,"39040",4290,3337,3309,22,28,"PODEMOS",551
39,"39091",1947,1572,1552,9,20,"PODEMOS",189
39,"39014",898,655,644,8,11,"PODEMOS",129
39,"39061",3488,2746,2722,29,24,"PODEMOS",438
39,"39017",571,385,377,2,8,"PODEMOS",31
39,"39092",916,668,663,4,5,"PODEMOS",72
39,"39045",376,284,276,1,8,"PODEMOS",32
39,"39018",4211,3389,3329,27,60,"PODEMOS",803
39,"39038",1463,1039,1030,6,9,"PODEMOS",202
39,"39008",13932,10600,10506,92,94,"PODEMOS",2088
39,"39098",1422,1078,1074,11,4,"PODEMOS",121
39,"39021",495,399,391,4,8,"PODEMOS",40
39,"39070",146,111,109,3,2,"PODEMOS",12
39,"39086",357,260,258,1,2,"PODEMOS",42
39,"39022",987,735,730,7,5,"PODEMOS",75
39,"39057",2321,1773,1746,13,27,"PODEMOS",317
39,"39073",9806,7636,7574,42,62,"PODEMOS",1356
39,"39025",8693,6696,6583,58,113,"PODEMOS",1113
39,"39020",23612,16515,16334,125,181,"PODEMOS",5077
39,"39077",246,186,182,0,4,"PODEMOS",14
39,"39047",1978,1463,1448,15,15,"PODEMOS",218
39,"39029",624,507,503,4,4,"PODEMOS",79
39,"39097",713,409,400,10,9,"PODEMOS",24
39,"39037",2003,1570,1547,8,23,"PODEMOS",231
39,"39006",1728,1353,1337,12,16,"PODEMOS",154
39,"39007",434,298,297,1,1,"PODEMOS",53
39,"39023",6316,4900,4827,37,73,"PODEMOS",790
39,"39087",42262,32560,32124,234,436,"PODEMOS",6577
39,"39026",1751,1303,1295,9,8,"PODEMOS",214
39,"39084",843,608,604,5,4,"PODEMOS",63
39,"39039",572,397,396,1,1,"PODEMOS",50
39,"39089",149,104,103,1,1,"PODEMOS",12
39,"39079",8951,6734,6657,54,77,"PODEMOS",820
39,"39015",862,650,643,6,7,"PODEMOS",60
39,"39001",2127,1651,1631,17,20,"PODEMOS",359
39,"39024",1882,1452,1438,14,14,"PODEMOS",296
39,"39071",405,277,272,2,5,"PODEMOS",14
39,"39031",1235,873,863,5,10,"PODEMOS",113
39,"39063",973,725,720,7,5,"PODEMOS",116
39,"39078",1413,1045,1032,10,13,"PODEMOS",158
39,"39053",219,135,135,1,0,"PODEMOS",14
39,"39074",6905,5370,5288,52,82,"PODEMOS",818
39,"39058",831,594,592,6,2,"PODEMOS",104
39,"39016",23860,18608,18405,149,203,"PODEMOS",3391
39,"39028",3733,2918,2877,17,41,"PODEMOS",502
39,"39099",3117,2446,2406,23,40,"PODEMOS",430
39,"39002",3313,2430,2391,17,39,"PODEMOS",357
39,"39055",1118,838,826,6,12,"PODEMOS",98
39,"39069",1968,1586,1555,12,31,"PODEMOS",264
39,"39060",6705,5437,5339,46,98,"PODEMOS",1173
39,"39009",3223,2395,2370,22,25,"PODEMOS",401
39,"39032",1476,1117,1100,8,17,"PODEMOS",109
39,"39065",256,202,200,6,2,"PODEMOS",37
39,"39033",578,432,432,5,0,"PODEMOS",64
39,"39059",8057,6049,5972,50,77,"PODEMOS",883
39,"39085",6834,5319,5265,37,54,"PODEMOS",923
39,"39072",343,213,213,1,0,"PODEMOS",22
39,"39100",869,628,617,12,11,"PODEMOS",71
39,"39068",659,486,479,2,7,"PODEMOS",80
39,"39081",435,349,342,3,7,"PODEMOS",33
39,"39102",2281,1647,1631,13,16,"PODEMOS",228
39,"39005",1396,1089,1084,4,5,"PODEMOS",155
39,"39048",1697,1372,1361,10,11,"PODEMOS",240
39,"39036",983,774,770,8,4,"PODEMOS",126
39,"39066",868,697,688,7,9,"PODEMOS",148
39,"39050",276,173,170,0,3,"PODEMOS",25
10,"10120",176,125,125,2,0,"EU-eX",3
10,"10132",400,258,256,0,2,"EU-eX",0
10,"10204",442,345,342,5,3,"EU-eX",1
10,"10192",841,592,584,0,8,"EU-eX",4
10,"10112",1583,1203,1176,7,27,"EU-eX",2
10,"10088",205,117,117,0,0,"EU-eX",6
10,"10141",268,190,189,2,1,"EU-eX",0
10,"10121",7970,5884,5816,33,68,"EU-eX",10
10,"10032",1705,1296,1277,10,19,"EU-eX",5
10,"10034",350,263,262,1,1,"EU-eX",0
10,"10189",2656,2006,1971,10,35,"EU-eX",7
10,"10100",795,602,595,4,7,"EU-eX",1
10,"10047",972,783,777,1,6,"EU-eX",4
10,"10155",1140,856,842,3,14,"EU-eX",2
10,"10053",289,231,224,1,7,"EU-eX",0
10,"10142",824,620,616,5,4,"EU-eX",0
10,"10181",694,571,558,7,13,"EU-eX",1
10,"10052",193,127,126,1,1,"EU-eX",0
10,"10014",1874,1430,1401,11,29,"EU-eX",8
10,"10124",862,692,678,7,14,"EU-eX",10
10,"10104",5169,3766,3703,21,63,"EU-eX",23
10,"10165",259,212,209,0,3,"EU-eX",0
10,"10038",86,70,70,0,0,"EU-eX",0
10,"10161",75,53,53,0,0,"EU-eX",0
10,"10092",301,238,236,2,2,"EU-eX",1
10,"10126",1572,1123,1107,3,16,"EU-eX",2
10,"10010",2322,1446,1431,12,15,"EU-eX",0
10,"10020",1619,1240,1214,9,26,"EU-eX",3
10,"10174",175,141,139,0,2,"EU-eX",0
10,"10060",973,620,607,5,13,"EU-eX",8
10,"10169",544,430,423,0,7,"EU-eX",1
10,"10153",318,238,231,3,7,"EU-eX",0
10,"10177",1703,1331,1296,10,35,"EU-eX",6
10,"10140",1114,860,848,6,12,"EU-eX",5
10,"10021",5198,3960,3878,40,82,"EU-eX",29
10,"10190",561,401,397,2,4,"EU-eX",1
10,"10023",846,647,637,1,10,"EU-eX",3
10,"10044",1451,1100,1087,7,13,"EU-eX",4
10,"10168",320,240,237,0,3,"EU-eX",0
10,"10207",502,352,349,5,3,"EU-eX",1
10,"10172",718,501,493,2,8,"EU-eX",3
10,"10066",158,128,127,1,1,"EU-eX",1
10,"10138",544,445,437,2,8,"EU-eX",0
10,"10073",715,536,530,3,6,"EU-eX",1
10,"10205",2034,1413,1386,5,27,"EU-eX",3
10,"10173",581,432,426,4,6,"EU-eX",5
10,"10050",1062,853,846,5,7,"EU-eX",0
10,"10157",273,209,205,1,4,"EU-eX",0
10,"10179",301,247,247,0,0,"EU-eX",1
10,"10041",1056,823,811,4,12,"EU-eX",0
10,"10123",585,480,468,1,12,"EU-eX",0
10,"10096",3443,2503,2464,14,39,"EU-eX",2
10,"10149",435,315,307,1,8,"EU-eX",1
10,"10036",327,247,244,2,3,"EU-eX",0
10,"10080",368,276,272,1,4,"EU-eX",1
10,"10903",819,629,624,7,5,"EU-eX",3
10,"10217",533,431,427,1,4,"EU-eX",1
10,"10046",201,176,173,2,3,"EU-eX",0
10,"10156",96,71,70,1,1,"EU-eX",1
10,"10118",289,257,257,1,0,"EU-eX",0
10,"10030",477,316,304,1,12,"EU-eX",1
10,"10193",1421,1150,1130,10,20,"EU-eX",8
10,"10164",742,513,508,1,5,"EU-eX",2
10,"10185",572,433,427,5,6,"EU-eX",0
10,"10048",245,163,161,1,2,"EU-eX",0
10,"10166",307,220,219,0,1,"EU-eX",2
10,"10002",368,278,275,0,3,"EU-eX",0
10,"10114",968,721,711,4,10,"EU-eX",11
10,"10170",263,204,202,2,2,"EU-eX",0
10,"10106",134,111,111,1,0,"EU-eX",1
10,"10215",442,320,320,0,0,"EU-eX",0
10,"10001",285,226,225,2,1,"EU-eX",0
10,"10018",1722,1255,1240,6,15,"EU-eX",3
10,"10162",579,483,476,0,7,"EU-eX",0
10,"10007",646,488,478,3,10,"EU-eX",5
10,"10198",1160,1022,1009,6,13,"EU-eX",1
10,"10039",427,295,290,0,5,"EU-eX",0
10,"10009",270,173,170,1,3,"EU-eX",0
10,"10216",1543,1200,1192,9,8,"EU-eX",1
10,"10134",565,395,393,1,2,"EU-eX",0
10,"10029",418,345,341,1,4,"EU-eX",0
10,"10005",537,411,398,3,13,"EU-eX",5
10,"10075",256,178,177,1,1,"EU-eX",1
10,"10160",225,172,170,0,2,"EU-eX",0
10,"10209",296,195,193,1,2,"EU-eX",1
10,"10058",1025,747,737,5,10,"EU-eX",1
10,"10062",413,345,341,3,4,"EU-eX",0
10,"10131",12850,9036,8977,44,59,"EU-eX",62
10,"10086",329,259,256,1,3,"EU-eX",1
10,"10045",1031,786,781,11,5,"EU-eX",2
10,"10213",571,483,478,1,5,"EU-eX",1
10,"10026",646,507,494,5,13,"EU-eX",11
10,"10071",144,100,100,2,0,"EU-eX",0
10,"10022",435,371,366,1,5,"EU-eX",0
10,"10108",218,122,120,0,2,"EU-eX",0
10,"10006",1275,1024,1004,7,20,"EU-eX",1
10,"10116",3784,2839,2801,21,38,"EU-eX",8
10,"10133",1210,1007,989,2,18,"EU-eX",1
10,"10902",730,546,536,2,10,"EU-eX",0
10,"10154",184,138,134,1,4,"EU-eX",0
10,"10180",4159,2765,2734,12,31,"EU-eX",6
10,"10083",90,69,69,0,0,"EU-eX",15
10,"10136",318,234,234,4,0,"EU-eX",0
10,"10130",1761,1322,1308,5,14,"EU-eX",0
10,"10150",354,301,295,4,6,"EU-eX",0
10,"10004",713,551,543,1,8,"EU-eX",5
10,"10122",231,166,163,0,3,"EU-eX",0
10,"10158",335,252,251,0,1,"EU-eX",0
10,"10016",329,262,259,1,3,"EU-eX",1
10,"10003",557,401,396,2,5,"EU-eX",0
10,"10028",98,72,71,0,1,"EU-eX",0
10,"10219",1290,860,843,1,17,"EU-eX",2
10,"10054",545,427,426,6,1,"EU-eX",1
10,"10015",687,500,491,2,9,"EU-eX",0
10,"10093",406,333,324,2,9,"EU-eX",0
10,"10043",814,594,590,2,4,"EU-eX",1
10,"10901",1184,851,835,2,16,"EU-eX",1
10,"10057",150,112,111,0,1,"EU-eX",1
10,"10094",232,203,203,3,0,"EU-eX",1
10,"10095",350,269,267,1,2,"EU-eX",6
10,"10139",111,84,83,0,1,"EU-eX",1
10,"10905",651,458,456,0,2,"EU-eX",3
10,"10079",901,703,695,2,8,"EU-eX",1
10,"10087",1701,1233,1215,7,18,"EU-eX",1
10,"10201",176,146,145,0,1,"EU-eX",0
10,"10069",831,647,637,2,10,"EU-eX",3
10,"10128",5752,4219,4146,39,73,"EU-eX",12
10,"10143",158,121,121,0,0,"EU-eX",0
10,"10119",630,461,455,2,6,"EU-eX",0
10,"10152",470,361,357,3,4,"EU-eX",0
10,"10206",212,161,160,3,1,"EU-eX",1
10,"10146",1509,1018,1004,4,14,"EU-eX",1
10,"10056",591,456,452,5,4,"EU-eX",2
10,"10197",134,94,93,0,1,"EU-eX",1
10,"10076",820,608,595,3,13,"EU-eX",0
10,"10068",746,601,586,3,15,"EU-eX",1
10,"10040",443,344,342,4,2,"EU-eX",4
10,"10218",1143,828,814,2,14,"EU-eX",1
10,"10176",374,274,268,1,6,"EU-eX",1
10,"10178",781,567,562,1,5,"EU-eX",3
10,"10091",378,304,304,0,0,"EU-eX",5
10,"10011",570,450,443,2,7,"EU-eX",14
10,"10117",260,127,127,0,0,"EU-eX",1
10,"10127",4724,3529,3463,15,66,"EU-eX",19
10,"10135",1329,981,958,1,23,"EU-eX",0
10,"10196",306,234,233,1,1,"EU-eX",0
10,"10199",166,120,119,3,1,"EU-eX",1
10,"10195",7768,5818,5723,58,95,"EU-eX",19
10,"10111",1364,995,978,9,17,"EU-eX",34
10,"10065",205,154,154,1,0,"EU-eX",0
10,"10203",4600,3268,3215,14,53,"EU-eX",12
10,"10148",32985,23666,23394,189,272,"EU-eX",118
10,"10110",2298,1682,1638,10,44,"EU-eX",12
10,"10051",440,318,314,1,4,"EU-eX",7
10,"10171",340,262,261,1,1,"EU-eX",0
10,"10037",76403,58422,57811,329,611,"EU-eX",248
10,"10182",129,95,95,0,0,"EU-eX",0
10,"10904",750,522,520,5,2,"EU-eX",2
10,"10113",2354,1800,1778,20,22,"EU-eX",8
10,"10082",1893,1528,1484,13,44,"EU-eX",4
10,"10084",1370,934,906,7,28,"EU-eX",3
10,"10144",996,755,748,3,7,"EU-eX",6
10,"10024",687,538,533,6,5,"EU-eX",1
10,"10115",3578,2857,2811,20,46,"EU-eX",9
10,"10211",454,352,339,2,13,"EU-eX",1
10,"10042",85,70,70,0,0,"EU-eX",1
10,"10137",399,344,343,4,1,"EU-eX",0
10,"10081",179,133,129,0,4,"EU-eX",0
10,"10125",903,648,638,2,10,"EU-eX",1
10,"10212",1691,1303,1280,8,23,"EU-eX",2
10,"10033",430,304,301,1,3,"EU-eX",0
10,"10175",1434,1054,1028,7,26,"EU-eX",5
10,"10085",335,248,244,1,4,"EU-eX",1
10,"10105",2519,1745,1714,11,31,"EU-eX",7
10,"10089",1376,1004,988,2,16,"EU-eX",8
10,"10151",213,163,161,0,2,"EU-eX",3
10,"10072",862,644,639,2,5,"EU-eX",5
10,"10013",282,228,223,2,5,"EU-eX",0
10,"10027",78,66,66,0,0,"EU-eX",1
10,"10064",1490,1142,1119,9,23,"EU-eX",3
10,"10097",106,79,79,0,0,"EU-eX",0
10,"10187",443,316,311,1,5,"EU-eX",1
10,"10031",167,138,137,1,1,"EU-eX",0
10,"10186",994,830,816,4,14,"EU-eX",1
10,"10019",1510,1134,1121,8,13,"EU-eX",1
10,"10202",621,495,478,2,17,"EU-eX",1
10,"10012",599,494,489,1,5,"EU-eX",0
10,"10188",500,381,373,2,8,"EU-eX",2
10,"10099",592,417,413,7,4,"EU-eX",1
10,"10184",778,620,610,6,10,"EU-eX",1
10,"10200",417,308,305,0,3,"EU-eX",1
10,"10090",522,386,382,5,4,"EU-eX",10
10,"10008",1331,1052,1047,6,5,"EU-eX",3
10,"10208",124,100,98,1,2,"EU-eX",0
10,"10055",719,554,546,3,8,"EU-eX",1
10,"10067",10486,7796,7692,54,104,"EU-eX",53
10,"10194",536,441,433,5,8,"EU-eX",1
10,"10025",402,341,328,2,13,"EU-eX",2
10,"10078",414,325,319,3,6,"EU-eX",2
10,"10063",179,145,145,1,0,"EU-eX",5
10,"10059",369,258,255,0,3,"EU-eX",0
10,"10109",1804,1233,1212,2,21,"EU-eX",2
10,"10077",689,511,504,2,7,"EU-eX",0
10,"10101",185,147,147,1,0,"EU-eX",0
10,"10102",531,413,410,4,3,"EU-eX",2
10,"10129",363,272,266,4,6,"EU-eX",1
10,"10049",3849,3185,3111,27,74,"EU-eX",7
10,"10191",532,417,415,12,2,"EU-eX",0
10,"10061",1664,1143,1131,8,12,"EU-eX",2
10,"10159",323,235,232,2,3,"EU-eX",0
10,"10035",1880,1390,1372,6,18,"EU-eX",1
10,"10103",454,342,338,1,4,"EU-eX",0
10,"10098",385,294,286,0,8,"EU-eX",0
10,"10214",208,172,170,0,2,"EU-eX",0
10,"10107",1033,825,815,11,10,"EU-eX",1
10,"10210",551,380,373,1,7,"EU-eX",2
10,"10183",993,763,761,4,2,"EU-eX",0
10,"10070",720,548,540,0,8,"EU-eX",0
10,"10167",306,240,237,0,3,"EU-eX",0
10,"10145",126,101,100,1,1,"EU-eX",0
10,"10163",356,302,299,1,3,"EU-eX",0
10,"10017",841,606,589,4,17,"EU-eX",0
10,"10147",1275,985,937,6,48,"EU-eX",2
27,"27026",2423,1667,1602,12,65,"UPYD",4
27,"27028",79061,57271,56444,702,827,"UPYD",396
27,"27035",190,121,121,2,0,"UPYD",0
27,"27004",1251,846,828,2,18,"UPYD",0
27,"27008",1377,1011,992,11,19,"UPYD",3
27,"27034",1154,720,710,6,10,"UPYD",4
27,"27051",8102,5883,5784,71,99,"UPYD",50
27,"27052",918,659,649,3,10,"UPYD",1
27,"27002",1651,1224,1200,8,24,"UPYD",3
27,"27021",1772,1167,1136,21,31,"UPYD",4
27,"27062",619,468,465,6,3,"UPYD",1
27,"27019",8120,6041,5936,82,105,"UPYD",33
27,"27066",12767,9200,9039,102,161,"UPYD",53
27,"27016",7204,5069,4987,65,82,"UPYD",23
27,"27020",3539,2954,2896,38,58,"UPYD",7
27,"27014",3284,2187,2148,29,39,"UPYD",7
27,"27017",1017,674,666,6,8,"UPYD",2
27,"27063",1761,1340,1299,12,41,"UPYD",4
27,"27048",2176,1658,1626,19,32,"UPYD",4
27,"27007",2833,2211,2144,34,67,"UPYD",6
27,"27901",2404,1647,1624,25,23,"UPYD",6
27,"27041",2377,1737,1722,16,15,"UPYD",3
27,"27902",7196,5017,4921,55,96,"UPYD",23
27,"27047",1643,1116,1104,10,12,"UPYD",4
27,"27058",3577,2669,2632,37,37,"UPYD",6
27,"27049",1422,969,958,8,11,"UPYD",4
27,"27045",1049,667,658,9,9,"UPYD",1
27,"27022",4859,3324,3251,38,73,"UPYD",9
27,"27039",4372,3327,3244,56,83,"UPYD",11
27,"27013",3782,3067,3007,21,60,"UPYD",6
27,"27054",1205,920,906,7,14,"UPYD",3
27,"27055",1320,869,855,3,14,"UPYD",0
27,"27011",2490,1623,1592,14,31,"UPYD",1
27,"27061",1045,821,796,10,25,"UPYD",3
27,"27023",2593,1981,1942,24,39,"UPYD",6
27,"27064",1593,1179,1153,14,26,"UPYD",3
27,"27032",3313,2269,2230,29,39,"UPYD",11
27,"27044",2901,1891,1832,28,59,"UPYD",6
27,"27030",3361,2333,2290,27,43,"UPYD",10
27,"27042",1759,1258,1235,21,23,"UPYD",4
27,"27025",2859,2293,2243,17,50,"UPYD",13
27,"27009",2110,1595,1573,11,22,"UPYD",2
27,"27003",1913,1372,1351,16,21,"UPYD",3
27,"27037",1075,736,723,12,13,"UPYD",2
27,"27024",1624,1250,1226,8,24,"UPYD",0
27,"27005",2615,1942,1918,16,24,"UPYD",6
27,"27060",2651,1761,1729,12,32,"UPYD",5
27,"27006",2611,1752,1723,26,29,"UPYD",6
27,"27038",945,679,674,9,5,"UPYD",1
27,"27018",3514,2279,2255,17,24,"UPYD",9
27,"27043",1313,875,855,14,20,"UPYD",2
27,"27050",2993,2241,2203,16,38,"UPYD",7
27,"27001",2401,1346,1313,24,33,"UPYD",5
27,"27057",11176,7921,7709,99,212,"UPYD",43
27,"27065",12528,8701,8483,150,218,"UPYD",33
27,"27046",1538,1119,1099,10,20,"UPYD",0
27,"27040",3225,2454,2415,22,39,"UPYD",7
27,"27056",1268,899,886,11,13,"UPYD",4
27,"27031",15650,10901,10710,106,191,"UPYD",30
27,"27053",546,349,349,1,0,"UPYD",2
27,"27010",4363,3072,2990,45,82,"UPYD",22
27,"27027",1937,1458,1425,19,33,"UPYD",7
27,"27029",1475,1142,1116,19,26,"UPYD",4
27,"27059",2202,1640,1605,19,35,"UPYD",1
27,"27012",1366,778,769,5,9,"UPYD",2
27,"27015",4304,3063,2985,41,78,"UPYD",13
27,"27033",631,454,449,8,5,"UPYD",0
2,"2012",1833,1595,1575,17,20,"RECORTES CE",1
2,"2016",581,445,441,0,4,"RECORTES CE",0
2,"2053",2996,2370,2332,15,38,"RECORTES CE",4
2,"2071",1056,890,884,7,6,"RECORTES CE",1
2,"2042",850,698,693,2,5,"RECORTES CE",2
2,"2037",22886,15400,15266,111,134,"RECORTES CE",23
2,"2033",1920,1551,1518,6,33,"RECORTES CE",2
2,"2034",1395,1131,1126,10,5,"RECORTES CE",0
2,"2003",131959,101091,100433,730,658,"RECORTES CE",179
2,"2079",2887,2312,2285,24,27,"RECORTES CE",5
2,"2028",132,103,102,0,1,"RECORTES CE",0
2,"2008",1227,923,909,9,14,"RECORTES CE",1
2,"2004",621,504,500,5,4,"RECORTES CE",0
2,"2082",105,88,88,1,0,"RECORTES CE",0
2,"2018",832,670,663,5,7,"RECORTES CE",0
2,"2049",838,610,607,3,3,"RECORTES CE",0
2,"2038",284,230,230,1,0,"RECORTES CE",0
2,"2080",532,419,410,0,9,"RECORTES CE",0
2,"2067",1189,909,896,4,13,"RECORTES CE",1
2,"2010",1798,1491,1463,10,28,"RECORTES CE",0
2,"2023",576,479,468,2,11,"RECORTES CE",1
2,"2066",238,206,205,1,1,"RECORTES CE",0
2,"2043",1250,1020,1006,8,14,"RECORTES CE",1
2,"2027",310,251,251,0,0,"RECORTES CE",0
2,"2005",568,441,434,4,7,"RECORTES CE",0
2,"2050",103,87,87,0,0,"RECORTES CE",0
2,"2054",390,305,302,3,3,"RECORTES CE",0
2,"2051",1690,1227,1211,12,16,"RECORTES CE",2
2,"2039",1002,824,819,8,5,"RECORTES CE",0
2,"2022",368,279,278,0,1,"RECORTES CE",0
2,"2020",451,381,376,3,5,"RECORTES CE",0
2,"2078",922,698,691,6,7,"RECORTES CE",0
2,"2026",847,705,697,7,8,"RECORTES CE",1
2,"2060",1302,1007,1003,8,4,"RECORTES CE",1
2,"2063",1471,1161,1156,6,5,"RECORTES CE",1
2,"2025",7502,5918,5785,41,133,"RECORTES CE",17
2,"2002",494,406,397,0,9,"RECORTES CE",0
2,"2062",414,324,319,0,5,"RECORTES CE",0
2,"2070",411,337,330,1,7,"RECORTES CE",0
2,"2052",473,399,398,3,1,"RECORTES CE",1
2,"2009",19686,14909,14719,148,190,"RECORTES CE",18
2,"2055",1157,757,753,9,4,"RECORTES CE",0
2,"2069",11544,8969,8824,62,145,"RECORTES CE",8
2,"2073",4914,3777,3730,42,47,"RECORTES CE",0
2,"2021",1037,823,816,3,7,"RECORTES CE",1
2,"2013",132,105,104,0,1,"RECORTES CE",0
2,"2083",217,194,194,0,0,"RECORTES CE",0
2,"2011",643,517,515,0,2,"RECORTES CE",0
2,"2040",586,507,505,1,2,"RECORTES CE",0
2,"2036",96,72,72,1,0,"RECORTES CE",0
2,"2035",1989,1607,1582,13,25,"RECORTES CE",0
2,"2024",3416,2694,2666,33,28,"RECORTES CE",3
2,"2046",1135,936,917,15,19,"RECORTES CE",0
2,"2072",1560,1118,1098,4,20,"RECORTES CE",1
2,"2032",281,217,216,1,1,"RECORTES CE",1
2,"2059",317,242,241,0,1,"RECORTES CE",0
2,"2006",588,482,476,2,6,"RECORTES CE",0
2,"2076",334,269,268,3,1,"RECORTES CE",0
2,"2058",348,244,239,2,5,"RECORTES CE",0
2,"2014",368,300,295,1,5,"RECORTES CE",0
2,"2015",1444,1196,1179,7,17,"RECORTES CE",0
2,"2048",1251,1013,1004,9,9,"RECORTES CE",2
2,"2056",1729,1348,1323,10,25,"RECORTES CE",1
2,"2019",2412,1991,1959,13,32,"RECORTES CE",2
2,"2001",660,521,510,4,11,"RECORTES CE",0
2,"2068",343,265,262,2,3,"RECORTES CE",0
2,"2007",1050,824,811,7,13,"RECORTES CE",0
2,"2045",3706,3046,3009,17,37,"RECORTES CE",0
2,"2065",475,403,402,2,1,"RECORTES CE",0
2,"2077",55,41,41,0,0,"RECORTES CE",0
2,"2081",18334,14121,13932,116,189,"RECORTES CE",7
2,"2041",350,274,272,1,2,"RECORTES CE",0
2,"2030",3059,2405,2377,11,28,"RECORTES CE",2
2,"2029",3306,2563,2533,17,30,"RECORTES CE",3
2,"2075",1684,1406,1397,10,9,"RECORTES CE",0
2,"2061",641,534,530,7,4,"RECORTES CE",0
2,"2901",2202,1571,1563,16,8,"RECORTES CE",0
2,"2017",845,611,607,1,4,"RECORTES CE",0
2,"2084",325,228,221,2,7,"RECORTES CE",0
2,"2064",379,317,316,1,1,"RECORTES CE",1
2,"2044",1128,806,798,2,8,"RECORTES CE",1
2,"2074",5998,4415,4363,20,52,"RECORTES CE",7
2,"2047",120,91,90,0,1,"RECORTES CE",0
2,"2086",2603,1797,1783,8,14,"RECORTES CE",1
2,"2057",2043,1593,1568,24,25,"RECORTES CE",2
2,"2031",574,447,440,1,7,"RECORTES CE",0
2,"2085",321,268,266,4,2,"RECORTES CE",0
2,"2019",2412,1991,1959,13,32,"PACMA",5
2,"2057",2043,1593,1568,24,25,"PACMA",9
2,"2070",411,337,330,1,7,"PACMA",5
2,"2064",379,317,316,1,1,"PACMA",1
2,"2030",3059,2405,2377,11,28,"PACMA",15
2,"2081",18334,14121,13932,116,189,"PACMA",88
2,"2035",1989,1607,1582,13,25,"PACMA",12
2,"2031",574,447,440,1,7,"PACMA",0
2,"2042",850,698,693,2,5,"PACMA",0
2,"2086",2603,1797,1783,8,14,"PACMA",0
2,"2059",317,242,241,0,1,"PACMA",0
2,"2083",217,194,194,0,0,"PACMA",0
2,"2028",132,103,102,0,1,"PACMA",0
2,"2079",2887,2312,2285,24,27,"PACMA",8
2,"2052",473,399,398,3,1,"PACMA",1
2,"2077",55,41,41,0,0,"PACMA",1
2,"2017",845,611,607,1,4,"PACMA",0
2,"2041",350,274,272,1,2,"PACMA",1
2,"2069",11544,8969,8824,62,145,"PACMA",39
2,"2007",1050,824,811,7,13,"PACMA",3
2,"2018",832,670,663,5,7,"PACMA",1
2,"2024",3416,2694,2666,33,28,"PACMA",25
2,"2076",334,269,268,3,1,"PACMA",2
2,"2012",1833,1595,1575,17,20,"PACMA",6
2,"2027",310,251,251,0,0,"PACMA",1
2,"2060",1302,1007,1003,8,4,"PACMA",9
2,"2074",5998,4415,4363,20,52,"PACMA",17
2,"2008",1227,923,909,9,14,"PACMA",2
2,"2061",641,534,530,7,4,"PACMA",1
2,"2037",22886,15400,15266,111,134,"PACMA",118
2,"2021",1037,823,816,3,7,"PACMA",3
2,"2072",1560,1118,1098,4,20,"PACMA",6
2,"2040",586,507,505,1,2,"PACMA",3
2,"2039",1002,824,819,8,5,"PACMA",1
2,"2054",390,305,302,3,3,"PACMA",2
2,"2032",281,217,216,1,1,"PACMA",1
2,"2050",103,87,87,0,0,"PACMA",1
2,"2013",132,105,104,0,1,"PACMA",3
2,"2048",1251,1013,1004,9,9,"PACMA",2
2,"2071",1056,890,884,7,6,"PACMA",4
2,"2053",2996,2370,2332,15,38,"PACMA",22
2,"2003",131959,101091,100433,730,658,"PACMA",869
2,"2068",343,265,262,2,3,"PACMA",0
2,"2046",1135,936,917,15,19,"PACMA",4
2,"2080",532,419,410,0,9,"PACMA",2
2,"2075",1684,1406,1397,10,9,"PACMA",5
2,"2066",238,206,205,1,1,"PACMA",0
2,"2084",325,228,221,2,7,"PACMA",0
2,"2078",922,698,691,6,7,"PACMA",3
2,"2022",368,279,278,0,1,"PACMA",0
2,"2063",1471,1161,1156,6,5,"PACMA",7
2,"2038",284,230,230,1,0,"PACMA",1
2,"2014",368,300,295,1,5,"PACMA",1
2,"2015",1444,1196,1179,7,17,"PACMA",2
2,"2011",643,517,515,0,2,"PACMA",1
2,"2020",451,381,376,3,5,"PACMA",0
2,"2034",1395,1131,1126,10,5,"PACMA",6
2,"2043",1250,1020,1006,8,14,"PACMA",0
2,"2036",96,72,72,1,0,"PACMA",0
2,"2067",1189,909,896,4,13,"PACMA",11
2,"2016",581,445,441,0,4,"PACMA",7
2,"2073",4914,3777,3730,42,47,"PACMA",10
2,"2082",105,88,88,1,0,"PACMA",1
2,"2049",838,610,607,3,3,"PACMA",1
2,"2025",7502,5918,5785,41,133,"PACMA",58
2,"2058",348,244,239,2,5,"PACMA",0
2,"2044",1128,806,798,2,8,"PACMA",3
2,"2009",19686,14909,14719,148,190,"PACMA",86
2,"2901",2202,1571,1563,16,8,"PACMA",5
2,"2047",120,91,90,0,1,"PACMA",0
2,"2029",3306,2563,2533,17,30,"PACMA",28
2,"2002",494,406,397,0,9,"PACMA",2
2,"2010",1798,1491,1463,10,28,"PACMA",2
2,"2004",621,504,500,5,4,"PACMA",0
2,"2085",321,268,266,4,2,"PACMA",0
2,"2045",3706,3046,3009,17,37,"PACMA",12
2,"2033",1920,1551,1518,6,33,"PACMA",8
2,"2062",414,324,319,0,5,"PACMA",0
2,"2051",1690,1227,1211,12,16,"PACMA",0
2,"2065",475,403,402,2,1,"PACMA",0
2,"2005",568,441,434,4,7,"PACMA",2
2,"2055",1157,757,753,9,4,"PACMA",2
2,"2026",847,705,697,7,8,"PACMA",1
2,"2056",1729,1348,1323,10,25,"PACMA",11
2,"2006",588,482,476,2,6,"PACMA",0
2,"2023",576,479,468,2,11,"PACMA",3
2,"2001",660,521,510,4,11,"PACMA",1
47,"47001",55,51,50,2,1,"UPeC-IU-IZC",0
47,"47162",73,61,61,0,0,"UPeC-IU-IZC",1
47,"47126",49,36,36,0,0,"UPeC-IU-IZC",1
47,"47116",413,330,324,1,6,"UPeC-IU-IZC",15
47,"47061",258,216,214,2,2,"UPeC-IU-IZC",11
47,"47027",2746,2120,2095,8,25,"UPeC-IU-IZC",96
47,"47106",50,41,41,0,0,"UPeC-IU-IZC",4
47,"47188",112,85,85,0,0,"UPeC-IU-IZC",1
47,"47053",116,96,96,1,0,"UPeC-IU-IZC",5
47,"47216",115,101,99,2,2,"UPeC-IU-IZC",1
47,"47145",611,451,449,4,2,"UPeC-IU-IZC",21
47,"47117",297,219,216,4,3,"UPeC-IU-IZC",9
47,"47217",1896,1436,1420,20,16,"UPeC-IU-IZC",71
47,"47127",135,98,96,1,2,"UPeC-IU-IZC",5
47,"47028",33,20,20,0,0,"UPeC-IU-IZC",0
47,"47089",153,122,120,2,2,"UPeC-IU-IZC",3
47,"47171",418,333,332,9,1,"UPeC-IU-IZC",10
47,"47010",13613,10963,10895,108,68,"UPeC-IU-IZC",527
47,"47172",148,120,120,1,0,"UPeC-IU-IZC",11
47,"47189",152,128,128,0,0,"UPeC-IU-IZC",1
47,"47011",568,469,464,1,5,"UPeC-IU-IZC",6
47,"47208",59,38,37,3,1,"UPeC-IU-IZC",1
47,"47081",47,40,40,0,0,"UPeC-IU-IZC",0
47,"47054",638,501,496,6,5,"UPeC-IU-IZC",15
47,"47163",299,236,235,6,1,"UPeC-IU-IZC",19
47,"47002",25,23,23,0,0,"UPeC-IU-IZC",0
47,"47164",377,309,307,2,2,"UPeC-IU-IZC",4
47,"47020",278,230,227,1,3,"UPeC-IU-IZC",0
47,"47198",66,47,47,0,0,"UPeC-IU-IZC",4
47,"47203",67,54,54,0,0,"UPeC-IU-IZC",0
47,"47218",995,760,754,6,6,"UPeC-IU-IZC",73
47,"47118",161,119,118,0,1,"UPeC-IU-IZC",10
47,"47155",3239,2400,2374,27,26,"UPeC-IU-IZC",150
47,"47055",202,170,168,1,2,"UPeC-IU-IZC",7
47,"47110",455,363,357,3,6,"UPeC-IU-IZC",13
47,"47073",120,98,97,1,1,"UPeC-IU-IZC",1
47,"47199",80,59,59,2,0,"UPeC-IU-IZC",3
47,"47029",57,48,47,1,1,"UPeC-IU-IZC",1
47,"47003",228,180,179,3,1,"UPeC-IU-IZC",1
47,"47190",93,80,78,4,2,"UPeC-IU-IZC",2
47,"47082",803,641,633,5,8,"UPeC-IU-IZC",16
47,"47182",1342,1037,1023,16,14,"UPeC-IU-IZC",14
47,"47004",1199,946,938,11,8,"UPeC-IU-IZC",16
47,"47165",6987,5301,5115,63,186,"UPeC-IU-IZC",248
47,"47191",110,74,74,0,0,"UPeC-IU-IZC",2
47,"47129",879,700,688,6,12,"UPeC-IU-IZC",12
47,"47083",80,62,61,2,1,"UPeC-IU-IZC",2
47,"47092",110,93,92,0,1,"UPeC-IU-IZC",2
47,"47210",372,289,286,1,3,"UPeC-IU-IZC",14
47,"47156",169,137,135,1,2,"UPeC-IU-IZC",2
47,"47056",82,58,57,0,1,"UPeC-IU-IZC",0
47,"47130",99,78,78,1,0,"UPeC-IU-IZC",0
47,"47139",1047,790,785,7,5,"UPeC-IU-IZC",35
47,"47219",42,36,34,2,2,"UPeC-IU-IZC",0
47,"47166",265,203,199,3,4,"UPeC-IU-IZC",2
47,"47084",1171,911,898,15,13,"UPeC-IU-IZC",24
47,"47065",863,681,671,4,10,"UPeC-IU-IZC",11
47,"47057",248,194,194,2,0,"UPeC-IU-IZC",7
47,"47174",275,222,218,2,4,"UPeC-IU-IZC",10
47,"47048",190,140,138,0,2,"UPeC-IU-IZC",4
47,"47192",105,80,79,1,1,"UPeC-IU-IZC",8
47,"47040",63,52,51,1,1,"UPeC-IU-IZC",2
47,"47087",379,318,314,4,4,"UPeC-IU-IZC",16
47,"47122",2034,1666,1635,21,31,"UPeC-IU-IZC",100
47,"47220",166,124,124,1,0,"UPeC-IU-IZC",2
47,"47017",201,161,158,3,3,"UPeC-IU-IZC",2
47,"47112",2592,2063,2043,20,20,"UPeC-IU-IZC",33
47,"47005",548,426,421,4,5,"UPeC-IU-IZC",18
47,"47140",119,101,100,1,1,"UPeC-IU-IZC",2
47,"47043",302,239,239,3,0,"UPeC-IU-IZC",4
47,"47014",50,45,45,0,0,"UPeC-IU-IZC",2
47,"47058",206,149,149,2,0,"UPeC-IU-IZC",6
47,"47006",190,145,144,1,1,"UPeC-IU-IZC",12
47,"47149",43,33,32,1,1,"UPeC-IU-IZC",4
47,"47085",16668,12248,12132,133,116,"UPeC-IU-IZC",471
47,"47167",242,201,197,3,4,"UPeC-IU-IZC",2
47,"47221",109,91,91,0,0,"UPeC-IU-IZC",3
47,"47049",100,78,78,1,0,"UPeC-IU-IZC",1
47,"47193",1583,1313,1294,12,19,"UPeC-IU-IZC",85
47,"47158",906,686,668,3,18,"UPeC-IU-IZC",34
47,"47032",153,120,118,0,2,"UPeC-IU-IZC",1
47,"47141",134,102,101,1,1,"UPeC-IU-IZC",1
47,"47024",262,206,205,2,1,"UPeC-IU-IZC",6
47,"47077",247,190,189,2,1,"UPeC-IU-IZC",2
47,"47114",4074,2868,2826,20,42,"UPeC-IU-IZC",108
47,"47059",97,71,71,0,0,"UPeC-IU-IZC",0
47,"47103",259,211,211,4,0,"UPeC-IU-IZC",2
47,"47007",3748,2869,2835,24,34,"UPeC-IU-IZC",138
47,"47168",31,28,27,0,1,"UPeC-IU-IZC",1
47,"47095",39,36,35,0,1,"UPeC-IU-IZC",2
47,"47042",54,41,41,3,0,"UPeC-IU-IZC",0
47,"47033",199,154,153,3,1,"UPeC-IU-IZC",1
47,"47222",80,68,68,3,0,"UPeC-IU-IZC",0
47,"47104",2857,2313,2253,19,60,"UPeC-IU-IZC",51
47,"47142",148,114,113,0,1,"UPeC-IU-IZC",5
47,"47194",301,242,239,1,3,"UPeC-IU-IZC",34
47,"47086",3926,3065,3028,27,37,"UPeC-IU-IZC",78
47,"47124",399,329,328,4,1,"UPeC-IU-IZC",9
47,"47169",68,57,57,0,0,"UPeC-IU-IZC",0
47,"47019",86,67,65,1,2,"UPeC-IU-IZC",0
47,"47205",385,281,274,7,7,"UPeC-IU-IZC",4
47,"47101",1720,1404,1388,10,16,"UPeC-IU-IZC",58
47,"47224",91,74,74,1,0,"UPeC-IU-IZC",4
47,"47115",287,238,237,4,1,"UPeC-IU-IZC",2
47,"47223",158,129,125,3,4,"UPeC-IU-IZC",2
47,"47037",174,146,141,2,5,"UPeC-IU-IZC",3
47,"47008",24,18,18,0,0,"UPeC-IU-IZC",2
47,"47195",461,348,348,3,0,"UPeC-IU-IZC",18
47,"47034",76,59,58,1,1,"UPeC-IU-IZC",2
47,"47175",6575,4991,4937,51,54,"UPeC-IU-IZC",329
47,"47060",262,218,214,0,4,"UPeC-IU-IZC",4
47,"47088",110,87,87,0,0,"UPeC-IU-IZC",5
47,"47196",35,26,26,1,0,"UPeC-IU-IZC",0
47,"47206",95,81,81,0,0,"UPeC-IU-IZC",4
47,"47232",99,75,74,0,1,"UPeC-IU-IZC",1
47,"47047",202,157,157,3,0,"UPeC-IU-IZC",3
47,"47144",78,66,65,2,1,"UPeC-IU-IZC",3
47,"47161",3903,3200,3183,25,17,"UPeC-IU-IZC",98
47,"47009",106,80,80,1,0,"UPeC-IU-IZC",3
47,"47170",36,30,29,2,1,"UPeC-IU-IZC",2
47,"47179",398,299,295,3,4,"UPeC-IU-IZC",12
47,"47070",41,32,32,1,0,"UPeC-IU-IZC",1
47,"47035",930,745,739,10,6,"UPeC-IU-IZC",5
47,"47080",30,22,22,0,0,"UPeC-IU-IZC",1
47,"47111",1009,794,789,4,5,"UPeC-IU-IZC",31
47,"47159",828,654,646,0,8,"UPeC-IU-IZC",26
47,"47062",163,131,131,0,0,"UPeC-IU-IZC",0
47,"47135",84,76,76,2,0,"UPeC-IU-IZC",0
47,"47186",246602,193774,192412,1384,1362,"UPeC-IU-IZC",11889
47,"47225",81,61,60,2,1,"UPeC-IU-IZC",1
47,"47197",888,693,687,10,6,"UPeC-IU-IZC",10
47,"47132",45,37,35,0,2,"UPeC-IU-IZC",0
47,"47098",583,488,487,6,1,"UPeC-IU-IZC",18
47,"47228",445,359,357,4,2,"UPeC-IU-IZC",5
47,"47151",27,22,21,0,1,"UPeC-IU-IZC",0
47,"47036",229,184,179,2,5,"UPeC-IU-IZC",3
47,"47045",768,586,580,0,6,"UPeC-IU-IZC",73
47,"47030",1006,785,770,10,15,"UPeC-IU-IZC",30
47,"47180",83,64,64,1,0,"UPeC-IU-IZC",1
47,"47022",57,50,46,0,4,"UPeC-IU-IZC",1
47,"47226",161,128,127,1,1,"UPeC-IU-IZC",2
47,"47173",883,686,675,4,11,"UPeC-IU-IZC",34
47,"47181",168,135,134,0,1,"UPeC-IU-IZC",9
47,"47071",417,348,344,2,4,"UPeC-IU-IZC",23
47,"47090",2418,1805,1776,17,29,"UPeC-IU-IZC",60
47,"47093",817,654,642,9,12,"UPeC-IU-IZC",32
47,"47137",29,28,28,1,0,"UPeC-IU-IZC",2
47,"47146",260,205,204,1,1,"UPeC-IU-IZC",10
47,"47102",286,229,224,1,5,"UPeC-IU-IZC",6
47,"47026",49,40,40,0,0,"UPeC-IU-IZC",1
47,"47105",192,164,163,0,1,"UPeC-IU-IZC",4
47,"47052",6584,5222,5163,41,59,"UPeC-IU-IZC",319
47,"47128",60,51,49,1,2,"UPeC-IU-IZC",2
47,"47066",1255,1005,996,7,9,"UPeC-IU-IZC",52
47,"47148",439,336,335,2,1,"UPeC-IU-IZC",12
47,"47015",199,151,151,0,0,"UPeC-IU-IZC",5
47,"47176",224,139,135,5,4,"UPeC-IU-IZC",2
47,"47204",260,199,193,2,6,"UPeC-IU-IZC",3
47,"47100",140,119,117,2,2,"UPeC-IU-IZC",2
47,"47091",89,67,66,0,1,"UPeC-IU-IZC",0
47,"47064",31,29,28,2,1,"UPeC-IU-IZC",0
47,"47119",90,75,75,1,0,"UPeC-IU-IZC",3
47,"47147",119,91,91,0,0,"UPeC-IU-IZC",0
47,"47012",118,95,95,0,0,"UPeC-IU-IZC",7
47,"47150",278,217,214,2,3,"UPeC-IU-IZC",3
47,"47013",99,74,73,0,1,"UPeC-IU-IZC",4
47,"47050",3757,2829,2812,29,17,"UPeC-IU-IZC",145
47,"47154",155,128,127,0,1,"UPeC-IU-IZC",8
47,"47068",36,27,27,0,0,"UPeC-IU-IZC",0
47,"47121",553,436,428,5,8,"UPeC-IU-IZC",6
47,"47094",132,103,101,1,2,"UPeC-IU-IZC",1
47,"47211",49,39,37,1,2,"UPeC-IU-IZC",0
47,"47213",115,83,83,0,0,"UPeC-IU-IZC",2
47,"47016",71,58,57,0,1,"UPeC-IU-IZC",1
47,"47075",4871,3802,3763,30,39,"UPeC-IU-IZC",111
47,"47078",164,129,124,1,5,"UPeC-IU-IZC",3
47,"47039",188,149,148,1,1,"UPeC-IU-IZC",4
47,"47183",130,105,105,0,0,"UPeC-IU-IZC",3
47,"47134",164,126,119,4,7,"UPeC-IU-IZC",1
47,"47231",4384,3457,3432,33,25,"UPeC-IU-IZC",171
47,"47143",127,99,99,0,0,"UPeC-IU-IZC",2
47,"47131",178,132,131,3,1,"UPeC-IU-IZC",4
47,"47209",42,30,30,1,0,"UPeC-IU-IZC",4
47,"47125",59,43,43,1,0,"UPeC-IU-IZC",1
47,"47079",62,51,51,0,0,"UPeC-IU-IZC",0
47,"47214",1420,1111,1093,9,18,"UPeC-IU-IZC",27
47,"47063",101,82,81,2,1,"UPeC-IU-IZC",5
47,"47229",215,151,150,1,1,"UPeC-IU-IZC",5
47,"47067",178,126,126,3,0,"UPeC-IU-IZC",1
47,"47152",86,64,64,1,0,"UPeC-IU-IZC",2
47,"47184",576,463,462,2,1,"UPeC-IU-IZC",21
47,"47074",150,125,125,1,0,"UPeC-IU-IZC",9
47,"47069",127,113,111,0,2,"UPeC-IU-IZC",2
47,"47157",515,442,441,3,1,"UPeC-IU-IZC",8
47,"47044",330,291,287,0,4,"UPeC-IU-IZC",12
47,"47021",76,65,65,1,0,"UPeC-IU-IZC",2
47,"47096",135,108,107,2,1,"UPeC-IU-IZC",1
47,"47178",175,146,146,1,0,"UPeC-IU-IZC",3
47,"47076",17375,13778,13684,111,94,"UPeC-IU-IZC",900
47,"47185",98,79,79,0,0,"UPeC-IU-IZC",4
47,"47097",331,268,263,1,5,"UPeC-IU-IZC",9
47,"47031",186,145,144,1,1,"UPeC-IU-IZC",0
47,"47123",469,395,386,4,9,"UPeC-IU-IZC",8
47,"47230",302,243,241,0,2,"UPeC-IU-IZC",7
47,"47025",120,97,97,2,0,"UPeC-IU-IZC",3
47,"47041",149,124,123,2,1,"UPeC-IU-IZC",5
47,"47212",388,322,322,3,0,"UPeC-IU-IZC",8
47,"47160",430,334,329,5,5,"UPeC-IU-IZC",9
47,"47200",82,64,64,1,0,"UPeC-IU-IZC",5
47,"47109",171,131,130,1,1,"UPeC-IU-IZC",2
47,"47046",121,93,93,0,0,"UPeC-IU-IZC",1
47,"47051",338,274,272,0,2,"UPeC-IU-IZC",14
47,"47099",152,128,127,1,1,"UPeC-IU-IZC",1
47,"47153",108,74,73,1,1,"UPeC-IU-IZC",0
47,"47018",35,31,28,0,3,"UPeC-IU-IZC",1
47,"47215",54,47,46,1,1,"UPeC-IU-IZC",6
47,"47177",107,78,76,0,2,"UPeC-IU-IZC",7
47,"47023",2999,2457,2445,20,12,"UPeC-IU-IZC",132
47,"47187",89,57,56,2,1,"UPeC-IU-IZC",3
47,"47227",64,52,52,0,0,"UPeC-IU-IZC",2
47,"47113",156,121,121,0,0,"UPeC-IU-IZC",3
47,"47038",108,82,82,0,0,"UPeC-IU-IZC",5
47,"47133",2665,2140,2118,25,22,"UPeC-IU-IZC",121
47,"47207",277,216,212,3,4,"UPeC-IU-IZC",3
47,"47138",237,180,176,1,4,"UPeC-IU-IZC",4
30,"30012",9101,7170,7091,46,79,"PACMA",65
30,"30002",9921,7263,7166,34,97,"PACMA",47
30,"30024",58529,42392,42072,275,320,"PACMA",219
30,"30009",12392,9724,9599,40,125,"PACMA",72
30,"30039",19199,13538,13405,101,133,"PACMA",98
30,"30005",29559,21408,21203,123,205,"PACMA",219
30,"30021",9101,6106,6034,25,72,"PACMA",26
30,"30006",803,683,681,2,2,"PACMA",2
30,"30034",1138,859,846,5,13,"PACMA",0
30,"30014",1598,1270,1258,5,12,"PACMA",20
30,"30029",11815,8365,8296,67,69,"PACMA",41
30,"30032",2849,2188,2161,10,27,"PACMA",5
30,"30027",47867,36054,35794,181,260,"PACMA",386
30,"30041",13640,9156,9092,52,64,"PACMA",93
30,"30031",498,424,421,2,3,"PACMA",3
30,"30010",6861,5287,5220,38,67,"PACMA",63
30,"30043",24972,19411,19139,154,272,"PACMA",139
30,"30901",10331,7925,7833,54,92,"PACMA",61
30,"30015",19154,13947,13835,77,112,"PACMA",83
30,"30040",727,627,620,1,7,"PACMA",4
30,"30038",15381,10881,10797,51,84,"PACMA",102
30,"30033",10144,7591,7505,86,86,"PACMA",50
30,"30030",312625,235232,233576,1438,1656,"PACMA",2447
30,"30902",8022,5454,5412,34,42,"PACMA",39
30,"30018",7903,5990,5912,29,78,"PACMA",58
30,"30035",18616,13185,13085,70,100,"PACMA",136
30,"30007",6415,4554,4515,19,39,"PACMA",51
30,"30036",14624,10139,9988,70,151,"PACMA",89
30,"30023",3762,2871,2837,14,34,"PACMA",24
30,"30013",7395,5320,5277,38,43,"PACMA",20
30,"30019",25921,18079,17894,121,185,"PACMA",113
30,"30004",1141,938,933,5,5,"PACMA",2
30,"30016",151577,103359,102538,620,821,"PACMA",1208
30,"30001",4596,3602,3572,20,30,"PACMA",12
30,"30028",6690,5005,4938,29,67,"PACMA",7
30,"30011",4706,3582,3541,20,41,"PACMA",26
30,"30037",18726,13183,13027,73,156,"PACMA",132
30,"30003",24305,16558,16419,122,139,"PACMA",92
30,"30026",15722,10147,10024,49,123,"PACMA",58
30,"30042",1918,1518,1500,6,18,"PACMA",10
30,"30017",11635,8718,8646,46,72,"PACMA",59
30,"30020",6261,4502,4459,25,43,"PACMA",13
30,"30022",16894,11661,11498,119,163,"PACMA",58
30,"30008",13860,10066,9945,74,121,"PACMA",82
30,"30025",4900,3777,3727,20,50,"PACMA",27
31,"31008",80,57,54,0,3,"RECORTES CE",0
31,"31092",662,458,455,4,3,"RECORTES CE",2
31,"31012",814,579,570,4,9,"RECORTES CE",3
31,"31022",526,344,341,3,3,"RECORTES CE",0
31,"31095",76,66,64,1,2,"RECORTES CE",0
31,"31115",166,108,108,2,0,"RECORTES CE",0
31,"31160",107,81,80,0,1,"RECORTES CE",0
31,"31221",1211,844,825,4,19,"RECORTES CE",1
31,"31065",1892,1420,1396,14,24,"RECORTES CE",1
31,"31215",4649,3412,3359,35,53,"RECORTES CE",12
31,"31046",60,38,38,0,0,"RECORTES CE",0
31,"31082",615,398,393,6,5,"RECORTES CE",0
31,"31232",25152,18432,18220,199,212,"RECORTES CE",51
31,"31127",143,97,97,2,0,"RECORTES CE",0
31,"31023",6826,5609,5591,77,18,"RECORTES CE",28
31,"31060",13723,10036,9970,78,66,"RECORTES CE",41
31,"31129",393,265,261,2,4,"RECORTES CE",0
31,"31136",444,320,318,6,2,"RECORTES CE",3
31,"31219",88,63,62,0,1,"RECORTES CE",0
31,"31088",5574,4194,4156,46,38,"RECORTES CE",21
31,"31099",63,52,52,1,0,"RECORTES CE",0
31,"31074",394,301,298,5,3,"RECORTES CE",0
31,"31217",337,233,230,1,3,"RECORTES CE",0
31,"31196",39,34,34,0,0,"RECORTES CE",0
31,"31229",50,40,40,0,0,"RECORTES CE",0
31,"31248",295,174,168,2,6,"RECORTES CE",1
31,"31165",2794,2057,2025,31,32,"RECORTES CE",7
31,"31045",504,397,392,9,5,"RECORTES CE",1
31,"31111",96,75,75,2,0,"RECORTES CE",0
31,"31185",501,345,342,4,3,"RECORTES CE",0
31,"31151",67,48,48,1,0,"RECORTES CE",0
31,"31167",827,624,615,13,9,"RECORTES CE",2
31,"31230",107,86,85,0,1,"RECORTES CE",0
31,"31069",847,643,636,4,7,"RECORTES CE",1
31,"31255",102,75,74,2,1,"RECORTES CE",0
31,"31020",454,235,232,2,3,"RECORTES CE",0
31,"31038",1348,1017,1005,13,12,"RECORTES CE",5
31,"31085",471,353,351,3,2,"RECORTES CE",0
31,"31142",1411,972,964,11,8,"RECORTES CE",2
31,"31241",134,94,89,0,5,"RECORTES CE",0
31,"31146",35,30,30,2,0,"RECORTES CE",0
31,"31200",764,558,546,11,12,"RECORTES CE",2
31,"31162",47,29,27,0,2,"RECORTES CE",0
31,"31102",146,66,66,1,0,"RECORTES CE",0
31,"31109",1562,1184,1177,6,7,"RECORTES CE",7
31,"31179",509,361,355,5,6,"RECORTES CE",0
31,"31040",194,130,128,1,2,"RECORTES CE",0
31,"31259",485,325,324,3,1,"RECORTES CE",0
31,"31171",693,510,500,6,10,"RECORTES CE",0
31,"31100",264,186,186,2,0,"RECORTES CE",0
31,"31083",56,41,39,0,2,"RECORTES CE",0
31,"31124",210,162,162,2,0,"RECORTES CE",3
31,"31210",199,146,145,2,1,"RECORTES CE",0
31,"31245",83,54,54,1,0,"RECORTES CE",0
31,"31112",94,67,66,0,1,"RECORTES CE",1
31,"31044",290,223,220,1,3,"RECORTES CE",0
31,"31199",150,101,101,3,0,"RECORTES CE",0
31,"31214",93,70,69,0,1,"RECORTES CE",2
31,"31168",248,192,191,0,1,"RECORTES CE",0
31,"31149",2338,1534,1525,16,9,"RECORTES CE",1
31,"31063",88,72,68,2,4,"RECORTES CE",1
31,"31121",64,45,45,2,0,"RECORTES CE",0
31,"31202",4326,3045,3001,41,44,"RECORTES CE",10
31,"31223",995,752,742,6,10,"RECORTES CE",0
31,"31150",213,154,152,1,2,"RECORTES CE",0
31,"31034",40,29,29,1,0,"RECORTES CE",0
31,"31028",211,133,133,0,0,"RECORTES CE",0
31,"31184",61,43,43,2,0,"RECORTES CE",0
31,"31235",166,111,111,0,0,"RECORTES CE",0
31,"31258",7841,5961,5927,56,34,"RECORTES CE",11
31,"31016",7642,5866,5822,52,44,"RECORTES CE",6
31,"31061",56,50,50,1,0,"RECORTES CE",0
31,"31257",866,657,648,8,9,"RECORTES CE",2
31,"31051",253,176,176,2,0,"RECORTES CE",0
31,"31024",102,52,52,0,0,"RECORTES CE",0
31,"31173",873,704,680,3,24,"RECORTES CE",0
31,"31053",532,395,391,4,4,"RECORTES CE",1
31,"31011",697,494,491,5,3,"RECORTES CE",5
31,"31147",98,76,76,2,0,"RECORTES CE",0
31,"31152",1347,999,990,16,9,"RECORTES CE",1
31,"31228",496,382,381,2,1,"RECORTES CE",1
31,"31159",1134,867,864,9,3,"RECORTES CE",2
31,"31058",215,153,153,2,0,"RECORTES CE",0
31,"31183",681,581,578,10,3,"RECORTES CE",1
31,"31246",140,108,103,2,5,"RECORTES CE",0
31,"31265",86,61,61,0,0,"RECORTES CE",0
31,"31076",2407,2005,1986,28,19,"RECORTES CE",3
31,"31191",3018,2324,2297,23,27,"RECORTES CE",7
31,"31204",37,33,33,2,0,"RECORTES CE",0
31,"31237",195,156,156,1,0,"RECORTES CE",0
31,"31049",704,488,486,1,2,"RECORTES CE",1
31,"31032",1733,1295,1285,26,10,"RECORTES CE",5
31,"31070",2652,1907,1888,16,19,"RECORTES CE",4
31,"31081",342,239,239,2,0,"RECORTES CE",2
31,"31107",1707,1303,1294,12,9,"RECORTES CE",2
31,"31194",315,218,217,2,1,"RECORTES CE",0
31,"31140",116,82,82,2,0,"RECORTES CE",1
31,"31080",510,412,411,8,1,"RECORTES CE",4
31,"31030",145,107,107,3,0,"RECORTES CE",2
31,"31128",370,265,265,2,0,"RECORTES CE",0
31,"31057",1812,1375,1360,17,15,"RECORTES CE",0
31,"31247",152,112,109,0,3,"RECORTES CE",1
31,"31216",3882,2829,2810,31,19,"RECORTES CE",7
31,"31227",8226,6191,6109,53,82,"RECORTES CE",23
31,"31064",1447,1161,1145,11,16,"RECORTES CE",2
31,"31256",109,70,70,0,0,"RECORTES CE",0
31,"31067",1938,1424,1415,15,9,"RECORTES CE",2
31,"31105",1535,1208,1187,18,21,"RECORTES CE",0
31,"31193",1414,1103,1094,12,9,"RECORTES CE",7
31,"31014",274,197,197,4,0,"RECORTES CE",1
31,"31004",35,22,22,1,0,"RECORTES CE",0
31,"31145",171,133,133,0,0,"RECORTES CE",1
31,"31010",5721,3986,3946,27,40,"RECORTES CE",12
31,"31206",2095,1529,1513,19,16,"RECORTES CE",4
31,"31189",1170,739,731,10,8,"RECORTES CE",1
31,"31015",2001,1468,1449,18,19,"RECORTES CE",2
31,"31211",25,12,12,2,0,"RECORTES CE",0
31,"31207",271,194,190,0,4,"RECORTES CE",0
31,"31003",124,95,95,2,0,"RECORTES CE",0
31,"31239",310,223,220,5,3,"RECORTES CE",0
31,"31110",90,65,65,2,0,"RECORTES CE",0
31,"31002",424,312,310,7,2,"RECORTES CE",0
31,"31164",582,464,457,3,7,"RECORTES CE",1
31,"31113",137,86,85,1,1,"RECORTES CE",0
31,"31901",15475,11855,11771,121,84,"RECORTES CE",32
31,"31062",1088,866,853,4,13,"RECORTES CE",1
31,"31073",315,214,212,3,2,"RECORTES CE",1
31,"31106",689,565,559,1,6,"RECORTES CE",3
31,"31263",236,142,142,2,0,"RECORTES CE",0
31,"31148",93,70,70,3,0,"RECORTES CE",0
31,"31123",654,430,419,7,11,"RECORTES CE",3
31,"31117",620,390,385,1,5,"RECORTES CE",1
31,"31026",147,128,128,1,0,"RECORTES CE",0
31,"31134",178,132,130,1,2,"RECORTES CE",0
31,"31071",17,17,17,0,0,"RECORTES CE",0
31,"31905",2847,2108,2093,11,15,"RECORTES CE",7
31,"31158",252,181,178,2,3,"RECORTES CE",0
31,"31138",934,649,647,5,2,"RECORTES CE",3
31,"31188",227,173,173,2,0,"RECORTES CE",0
31,"31161",344,273,270,4,3,"RECORTES CE",1
31,"31019",1809,1295,1288,23,7,"RECORTES CE",2
31,"31244",156,87,84,1,3,"RECORTES CE",0
31,"31059",191,142,141,1,1,"RECORTES CE",0
31,"31250",2832,1921,1899,20,22,"RECORTES CE",2
31,"31017",361,248,246,4,2,"RECORTES CE",0
31,"31220",752,607,603,3,4,"RECORTES CE",1
31,"31041",1583,1125,1110,14,15,"RECORTES CE",3
31,"31249",1885,1350,1331,20,19,"RECORTES CE",1
31,"31903",6593,4699,4660,28,39,"RECORTES CE",15
31,"31264",179,117,115,5,2,"RECORTES CE",1
31,"31007",136,94,93,1,1,"RECORTES CE",1
31,"31068",2893,2172,2138,27,34,"RECORTES CE",3
31,"31166",260,186,186,2,0,"RECORTES CE",1
31,"31078",2447,1889,1861,25,28,"RECORTES CE",2
31,"31096",115,95,92,2,3,"RECORTES CE",0
31,"31243",314,236,234,5,2,"RECORTES CE",0
31,"31116",65,51,51,1,0,"RECORTES CE",0
31,"31195",180,129,128,0,1,"RECORTES CE",0
31,"31187",111,70,70,1,0,"RECORTES CE",0
31,"31197",70,60,59,0,1,"RECORTES CE",0
31,"31156",252,193,193,0,0,"RECORTES CE",0
31,"31093",293,210,206,2,4,"RECORTES CE",1
31,"31072",5288,3916,3846,32,70,"RECORTES CE",8
31,"31252",87,68,68,0,0,"RECORTES CE",1
31,"31119",40,22,22,0,0,"RECORTES CE",0
31,"31163",2017,1479,1447,15,32,"RECORTES CE",2
31,"31086",12987,10342,10270,114,72,"RECORTES CE",36
31,"31253",129,112,112,0,0,"RECORTES CE",1
31,"31203",40,29,29,0,0,"RECORTES CE",0
31,"31050",6058,3902,3850,64,52,"RECORTES CE",7
31,"31029",925,662,648,6,14,"RECORTES CE",0
31,"31133",44,30,30,1,0,"RECORTES CE",0
31,"31103",46,32,32,1,0,"RECORTES CE",0
31,"31144",804,482,479,2,3,"RECORTES CE",2
31,"31033",49,29,29,1,0,"RECORTES CE",0
31,"31120",394,264,263,5,1,"RECORTES CE",0
31,"31908",1008,709,704,11,5,"RECORTES CE",0
31,"31154",227,127,125,3,2,"RECORTES CE",1
31,"31090",146,81,80,3,1,"RECORTES CE",0
31,"31013",661,439,437,1,2,"RECORTES CE",1
31,"31213",105,70,70,0,0,"RECORTES CE",0
31,"31170",49,39,39,1,0,"RECORTES CE",0
31,"31035",63,45,43,1,2,"RECORTES CE",0
31,"31226",585,346,344,1,2,"RECORTES CE",1
31,"31233",96,72,71,0,1,"RECORTES CE",0
31,"31108",1878,1487,1475,14,12,"RECORTES CE",4
31,"31125",275,194,191,2,3,"RECORTES CE",2
31,"31075",101,68,67,1,1,"RECORTES CE",0
31,"31091",347,217,217,0,0,"RECORTES CE",0
31,"31135",102,67,62,0,5,"RECORTES CE",0
31,"31224",914,668,659,6,9,"RECORTES CE",0
31,"31182",37,27,27,0,0,"RECORTES CE",0
31,"31261",235,187,187,3,0,"RECORTES CE",2
31,"31042",2744,2081,2053,19,28,"RECORTES CE",1
31,"31906",2553,1945,1930,21,15,"RECORTES CE",7
31,"31143",98,59,58,1,1,"RECORTES CE",0
31,"31157",3546,2423,2399,32,24,"RECORTES CE",6
31,"31904",1559,1095,1084,8,11,"RECORTES CE",0
31,"31242",253,165,164,1,1,"RECORTES CE",0
31,"31122",4719,3671,3654,42,17,"RECORTES CE",10
31,"31190",44,36,36,1,0,"RECORTES CE",0
31,"31055",259,177,173,2,4,"RECORTES CE",0
31,"31222",63,41,41,5,0,"RECORTES CE",0
31,"31001",90,74,74,5,0,"RECORTES CE",0
31,"31153",2172,1463,1448,10,15,"RECORTES CE",3
31,"31225",36,29,29,0,0,"RECORTES CE",0
31,"31178",495,364,364,4,0,"RECORTES CE",1
31,"31262",206,180,180,2,0,"RECORTES CE",0
31,"31052",88,65,64,0,1,"RECORTES CE",2
31,"31177",262,171,170,3,1,"RECORTES CE",1
31,"31079",76,53,53,0,0,"RECORTES CE",0
31,"31175",72,50,49,0,1,"RECORTES CE",0
31,"31208",2569,2016,1992,21,24,"RECORTES CE",2
31,"31036",921,664,657,5,7,"RECORTES CE",2
31,"31056",179,137,133,0,4,"RECORTES CE",0
31,"31130",310,214,213,7,1,"RECORTES CE",0
31,"31114",362,272,269,6,3,"RECORTES CE",1
31,"31198",36,29,29,0,0,"RECORTES CE",0
31,"31043",38,30,30,0,0,"RECORTES CE",0
31,"31234",144,107,107,2,0,"RECORTES CE",0
31,"31131",871,664,658,13,6,"RECORTES CE",4
31,"31260",1245,859,857,15,2,"RECORTES CE",5
31,"31094",112,82,82,1,0,"RECORTES CE",0
31,"31089",242,188,185,1,3,"RECORTES CE",1
31,"31025",768,560,560,5,0,"RECORTES CE",3
31,"31141",109,70,66,1,4,"RECORTES CE",0
31,"31054",460,308,304,7,4,"RECORTES CE",1
31,"31031",221,141,140,0,1,"RECORTES CE",0
31,"31132",146,115,113,1,2,"RECORTES CE",1
31,"31098",1918,1489,1483,23,6,"RECORTES CE",8
31,"31236",1324,943,933,12,10,"RECORTES CE",4
31,"31231",115,81,81,1,0,"RECORTES CE",0
31,"31018",409,312,311,9,1,"RECORTES CE",0
31,"31209",157,108,108,0,0,"RECORTES CE",0
31,"31176",2856,2077,2040,33,37,"RECORTES CE",8
31,"31126",357,235,232,0,3,"RECORTES CE",1
31,"31907",10677,8568,8523,97,45,"RECORTES CE",31
31,"31066",867,647,638,8,9,"RECORTES CE",2
31,"31077",5384,4055,3999,49,56,"RECORTES CE",6
31,"31039",83,58,57,0,1,"RECORTES CE",0
31,"31005",296,205,204,0,1,"RECORTES CE",0
31,"31139",159,102,101,3,1,"RECORTES CE",0
31,"31212",151,118,118,7,0,"RECORTES CE",0
31,"31087",169,131,127,2,4,"RECORTES CE",1
31,"31181",150,116,116,0,0,"RECORTES CE",0
31,"31097",10436,7461,7395,96,66,"RECORTES CE",21
31,"31027",838,595,589,7,6,"RECORTES CE",1
31,"31174",110,75,73,0,2,"RECORTES CE",1
31,"31006",1952,1423,1400,14,23,"RECORTES CE",3
31,"31037",86,64,64,0,0,"RECORTES CE",0
31,"31251",3110,2347,2327,19,20,"RECORTES CE",8
31,"31238",110,96,94,2,2,"RECORTES CE",0
31,"31180",216,173,173,5,0,"RECORTES CE",1
31,"31205",427,330,326,7,4,"RECORTES CE",1
31,"31254",1920,1473,1458,7,15,"RECORTES CE",4
31,"31137",208,93,93,3,0,"RECORTES CE",5
31,"31047",261,191,187,6,4,"RECORTES CE",0
31,"31104",1876,1355,1338,10,17,"RECORTES CE",4
31,"31084",1935,1389,1380,19,9,"RECORTES CE",1
31,"31240",531,355,351,6,4,"RECORTES CE",0
31,"31902",4346,3247,3228,23,19,"RECORTES CE",13
31,"31172",367,293,286,6,7,"RECORTES CE",5
31,"31118",165,122,121,2,1,"RECORTES CE",0
31,"31021",64,42,42,0,0,"RECORTES CE",1
31,"31169",2217,1508,1489,15,19,"RECORTES CE",0
31,"31155",253,191,189,3,2,"RECORTES CE",1
31,"31048",169,123,123,1,0,"RECORTES CE",0
31,"31009",690,508,504,5,4,"RECORTES CE",1
31,"31201",147803,110800,110079,1040,721,"RECORTES CE",275
31,"31186",302,211,209,2,2,"RECORTES CE",1
31,"31101",1390,1031,1028,11,3,"RECORTES CE",4
31,"31192",159,132,131,0,1,"RECORTES CE",1
47,"47193",1583,1313,1294,12,19,"PODEMOS",210
47,"47053",116,96,96,1,0,"PODEMOS",27
47,"47074",150,125,125,1,0,"PODEMOS",22
47,"47007",3748,2869,2835,24,34,"PODEMOS",574
47,"47173",883,686,675,4,11,"PODEMOS",117
47,"47180",83,64,64,1,0,"PODEMOS",4
47,"47111",1009,794,789,4,5,"PODEMOS",76
47,"47123",469,395,386,4,9,"PODEMOS",83
47,"47227",64,52,52,0,0,"PODEMOS",0
47,"47212",388,322,322,3,0,"PODEMOS",12
47,"47024",262,206,205,2,1,"PODEMOS",22
47,"47177",107,78,76,0,2,"PODEMOS",8
47,"47033",199,154,153,3,1,"PODEMOS",10
47,"47179",398,299,295,3,4,"PODEMOS",40
47,"47187",89,57,56,2,1,"PODEMOS",4
47,"47175",6575,4991,4937,51,54,"PODEMOS",900
47,"47135",84,76,76,2,0,"PODEMOS",2
47,"47230",302,243,241,0,2,"PODEMOS",23
47,"47002",25,23,23,0,0,"PODEMOS",3
47,"47068",36,27,27,0,0,"PODEMOS",2
47,"47031",186,145,144,1,1,"PODEMOS",5
47,"47190",93,80,78,4,2,"PODEMOS",3
47,"47100",140,119,117,2,2,"PODEMOS",3
47,"47058",206,149,149,2,0,"PODEMOS",14
47,"47113",156,121,121,0,0,"PODEMOS",8
47,"47014",50,45,45,0,0,"PODEMOS",1
47,"47001",55,51,50,2,1,"PODEMOS",4
47,"47116",413,330,324,1,6,"PODEMOS",19
47,"47061",258,216,214,2,2,"PODEMOS",21
47,"47165",6987,5301,5115,63,186,"PODEMOS",576
47,"47043",302,239,239,3,0,"PODEMOS",15
47,"47215",54,47,46,1,1,"PODEMOS",4
47,"47087",379,318,314,4,4,"PODEMOS",48
47,"47097",331,268,263,1,5,"PODEMOS",24
47,"47019",86,67,65,1,2,"PODEMOS",8
47,"47016",71,58,57,0,1,"PODEMOS",4
47,"47119",90,75,75,1,0,"PODEMOS",2
47,"47062",163,131,131,0,0,"PODEMOS",2
47,"47185",98,79,79,0,0,"PODEMOS",10
47,"47056",82,58,57,0,1,"PODEMOS",2
47,"47091",89,67,66,0,1,"PODEMOS",19
47,"47026",49,40,40,0,0,"PODEMOS",3
47,"47182",1342,1037,1023,16,14,"PODEMOS",137
47,"47078",164,129,124,1,5,"PODEMOS",7
47,"47226",161,128,127,1,1,"PODEMOS",16
47,"47130",99,78,78,1,0,"PODEMOS",6
47,"47157",515,442,441,3,1,"PODEMOS",54
47,"47134",164,126,119,4,7,"PODEMOS",3
47,"47181",168,135,134,0,1,"PODEMOS",15
47,"47102",286,229,224,1,5,"PODEMOS",8
47,"47052",6584,5222,5163,41,59,"PODEMOS",1006
47,"47037",174,146,141,2,5,"PODEMOS",1
47,"47020",278,230,227,1,3,"PODEMOS",7
47,"47218",995,760,754,6,6,"PODEMOS",142
47,"47188",112,85,85,0,0,"PODEMOS",3
47,"47098",583,488,487,6,1,"PODEMOS",58
47,"47028",33,20,20,0,0,"PODEMOS",1
47,"47126",49,36,36,0,0,"PODEMOS",4
47,"47169",68,57,57,0,0,"PODEMOS",3
47,"47084",1171,911,898,15,13,"PODEMOS",63
47,"47170",36,30,29,2,1,"PODEMOS",1
47,"47070",41,32,32,1,0,"PODEMOS",0
47,"47150",278,217,214,2,3,"PODEMOS",35
47,"47204",260,199,193,2,6,"PODEMOS",14
47,"47110",455,363,357,3,6,"PODEMOS",54
47,"47147",119,91,91,0,0,"PODEMOS",6
47,"47159",828,654,646,0,8,"PODEMOS",80
47,"47158",906,686,668,3,18,"PODEMOS",98
47,"47138",237,180,176,1,4,"PODEMOS",18
47,"47079",62,51,51,0,0,"PODEMOS",3
47,"47010",13613,10963,10895,108,68,"PODEMOS",1946
47,"47046",121,93,93,0,0,"PODEMOS",6
47,"47160",430,334,329,5,5,"PODEMOS",43
47,"47137",29,28,28,1,0,"PODEMOS",3
47,"47004",1199,946,938,11,8,"PODEMOS",53
47,"47129",879,700,688,6,12,"PODEMOS",82
47,"47054",638,501,496,6,5,"PODEMOS",42
47,"47231",4384,3457,3432,33,25,"PODEMOS",665
47,"47081",47,40,40,0,0,"PODEMOS",6
47,"47217",1896,1436,1420,20,16,"PODEMOS",252
47,"47145",611,451,449,4,2,"PODEMOS",61
47,"47162",73,61,61,0,0,"PODEMOS",7
47,"47030",1006,785,770,10,15,"PODEMOS",138
47,"47048",190,140,138,0,2,"PODEMOS",9
47,"47220",166,124,124,1,0,"PODEMOS",12
47,"47172",148,120,120,1,0,"PODEMOS",28
47,"47186",246602,193774,192412,1384,1362,"PODEMOS",30855
47,"47128",60,51,49,1,2,"PODEMOS",1
47,"47203",67,54,54,0,0,"PODEMOS",2
47,"47118",161,119,118,0,1,"PODEMOS",12
47,"47063",101,82,81,2,1,"PODEMOS",13
47,"47122",2034,1666,1635,21,31,"PODEMOS",185
47,"47141",134,102,101,1,1,"PODEMOS",3
47,"47221",109,91,91,0,0,"PODEMOS",5
47,"47064",31,29,28,2,1,"PODEMOS",8
47,"47167",242,201,197,3,4,"PODEMOS",6
47,"47088",110,87,87,0,0,"PODEMOS",6
47,"47044",330,291,287,0,4,"PODEMOS",39
47,"47067",178,126,126,3,0,"PODEMOS",10
47,"47144",78,66,65,2,1,"PODEMOS",5
47,"47006",190,145,144,1,1,"PODEMOS",39
47,"47003",228,180,179,3,1,"PODEMOS",11
47,"47027",2746,2120,2095,8,25,"PODEMOS",383
47,"47207",277,216,212,3,4,"PODEMOS",5
47,"47041",149,124,123,2,1,"PODEMOS",13
47,"47071",417,348,344,2,4,"PODEMOS",68
47,"47117",297,219,216,4,3,"PODEMOS",9
47,"47012",118,95,95,0,0,"PODEMOS",5
47,"47018",35,31,28,0,3,"PODEMOS",3
47,"47216",115,101,99,2,2,"PODEMOS",5
47,"47095",39,36,35,0,1,"PODEMOS",3
47,"47059",97,71,71,0,0,"PODEMOS",17
47,"47225",81,61,60,2,1,"PODEMOS",1
47,"47214",1420,1111,1093,9,18,"PODEMOS",111
47,"47089",153,122,120,2,2,"PODEMOS",8
47,"47013",99,74,73,0,1,"PODEMOS",5
47,"47205",385,281,274,7,7,"PODEMOS",19
47,"47121",553,436,428,5,8,"PODEMOS",22
47,"47125",59,43,43,1,0,"PODEMOS",3
47,"47073",120,98,97,1,1,"PODEMOS",0
47,"47192",105,80,79,1,1,"PODEMOS",10
47,"47183",130,105,105,0,0,"PODEMOS",6
47,"47184",576,463,462,2,1,"PODEMOS",42
47,"47075",4871,3802,3763,30,39,"PODEMOS",354
47,"47104",2857,2313,2253,19,60,"PODEMOS",182
47,"47209",42,30,30,1,0,"PODEMOS",9
47,"47163",299,236,235,6,1,"PODEMOS",27
47,"47133",2665,2140,2118,25,22,"PODEMOS",419
47,"47164",377,309,307,2,2,"PODEMOS",16
47,"47143",127,99,99,0,0,"PODEMOS",8
47,"47149",43,33,32,1,1,"PODEMOS",9
47,"47156",169,137,135,1,2,"PODEMOS",12
47,"47140",119,101,100,1,1,"PODEMOS",3
47,"47029",57,48,47,1,1,"PODEMOS",5
47,"47069",127,113,111,0,2,"PODEMOS",2
47,"47035",930,745,739,10,6,"PODEMOS",59
47,"47178",175,146,146,1,0,"PODEMOS",13
47,"47155",3239,2400,2374,27,26,"PODEMOS",450
47,"47161",3903,3200,3183,25,17,"PODEMOS",347
47,"47105",192,164,163,0,1,"PODEMOS",18
47,"47085",16668,12248,12132,133,116,"PODEMOS",1758
47,"47176",224,139,135,5,4,"PODEMOS",10
47,"47210",372,289,286,1,3,"PODEMOS",19
47,"47168",31,28,27,0,1,"PODEMOS",0
47,"47066",1255,1005,996,7,9,"PODEMOS",147
47,"47131",178,132,131,3,1,"PODEMOS",7
47,"47208",59,38,37,3,1,"PODEMOS",11
47,"47114",4074,2868,2826,20,42,"PODEMOS",283
47,"47197",888,693,687,10,6,"PODEMOS",50
47,"47094",132,103,101,1,2,"PODEMOS",13
47,"47096",135,108,107,2,1,"PODEMOS",6
47,"47036",229,184,179,2,5,"PODEMOS",7
47,"47194",301,242,239,1,3,"PODEMOS",62
47,"47050",3757,2829,2812,29,17,"PODEMOS",516
47,"47065",863,681,671,4,10,"PODEMOS",35
47,"47142",148,114,113,0,1,"PODEMOS",5
47,"47139",1047,790,785,7,5,"PODEMOS",68
47,"47082",803,641,633,5,8,"PODEMOS",63
47,"47195",461,348,348,3,0,"PODEMOS",66
47,"47093",817,654,642,9,12,"PODEMOS",102
47,"47189",152,128,128,0,0,"PODEMOS",4
47,"47211",49,39,37,1,2,"PODEMOS",1
47,"47011",568,469,464,1,5,"PODEMOS",25
47,"47060",262,218,214,0,4,"PODEMOS",36
47,"47045",768,586,580,0,6,"PODEMOS",62
47,"47229",215,151,150,1,1,"PODEMOS",16
47,"47051",338,274,272,0,2,"PODEMOS",43
47,"47057",248,194,194,2,0,"PODEMOS",26
47,"47040",63,52,51,1,1,"PODEMOS",4
47,"47099",152,128,127,1,1,"PODEMOS",5
47,"47222",80,68,68,3,0,"PODEMOS",2
47,"47039",188,149,148,1,1,"PODEMOS",11
47,"47017",201,161,158,3,3,"PODEMOS",12
47,"47090",2418,1805,1776,17,29,"PODEMOS",207
47,"47199",80,59,59,2,0,"PODEMOS",9
47,"47055",202,170,168,1,2,"PODEMOS",18
47,"47106",50,41,41,0,0,"PODEMOS",1
47,"47153",108,74,73,1,1,"PODEMOS",4
47,"47213",115,83,83,0,0,"PODEMOS",1
47,"47023",2999,2457,2445,20,12,"PODEMOS",449
47,"47032",153,120,118,0,2,"PODEMOS",6
47,"47038",108,82,82,0,0,"PODEMOS",7
47,"47015",199,151,151,0,0,"PODEMOS",14
47,"47109",171,131,130,1,1,"PODEMOS",21
47,"47132",45,37,35,0,2,"PODEMOS",4
47,"47022",57,50,46,0,4,"PODEMOS",1
47,"47228",445,359,357,4,2,"PODEMOS",31
47,"47166",265,203,199,3,4,"PODEMOS",8
47,"47127",135,98,96,1,2,"PODEMOS",15
47,"47047",202,157,157,3,0,"PODEMOS",8
47,"47198",66,47,47,0,0,"PODEMOS",1
47,"47171",418,333,332,9,1,"PODEMOS",17
47,"47174",275,222,218,2,4,"PODEMOS",47
47,"47191",110,74,74,0,0,"PODEMOS",15
47,"47103",259,211,211,4,0,"PODEMOS",17
47,"47148",439,336,335,2,1,"PODEMOS",17
47,"47021",76,65,65,1,0,"PODEMOS",5
47,"47005",548,426,421,4,5,"PODEMOS",35
47,"47009",106,80,80,1,0,"PODEMOS",7
47,"47196",35,26,26,1,0,"PODEMOS",0
47,"47076",17375,13778,13684,111,94,"PODEMOS",2639
47,"47124",399,329,328,4,1,"PODEMOS",30
47,"47154",155,128,127,0,1,"PODEMOS",21
47,"47080",30,22,22,0,0,"PODEMOS",1
47,"47101",1720,1404,1388,10,16,"PODEMOS",146
47,"47219",42,36,34,2,2,"PODEMOS",0
47,"47206",95,81,81,0,0,"PODEMOS",8
47,"47034",76,59,58,1,1,"PODEMOS",4
47,"47115",287,238,237,4,1,"PODEMOS",6
47,"47049",100,78,78,1,0,"PODEMOS",7
47,"47224",91,74,74,1,0,"PODEMOS",10
47,"47223",158,129,125,3,4,"PODEMOS",13
47,"47200",82,64,64,1,0,"PODEMOS",11
47,"47232",99,75,74,0,1,"PODEMOS",8
47,"47112",2592,2063,2043,20,20,"PODEMOS",156
47,"47083",80,62,61,2,1,"PODEMOS",12
47,"47077",247,190,189,2,1,"PODEMOS",9
47,"47092",110,93,92,0,1,"PODEMOS",6
47,"47151",27,22,21,0,1,"PODEMOS",2
47,"47152",86,64,64,1,0,"PODEMOS",15
47,"47146",260,205,204,1,1,"PODEMOS",28
47,"47025",120,97,97,2,0,"PODEMOS",3
47,"47042",54,41,41,3,0,"PODEMOS",8
47,"47008",24,18,18,0,0,"PODEMOS",2
47,"47086",3926,3065,3028,27,37,"PODEMOS",294
22,"22053",787,541,535,12,6,"UPYD",1
22,"22122",62,49,49,1,0,"UPYD",0
22,"22158",12005,8628,8554,78,74,"UPYD",52
22,"22907",1459,1112,1104,21,8,"UPYD",11
22,"22111",152,114,113,0,1,"UPYD",0
22,"22127",505,387,386,3,1,"UPYD",3
22,"22246",77,51,50,0,1,"UPYD",0
22,"22003",143,119,119,0,0,"UPYD",1
22,"22197",479,378,373,6,5,"UPYD",2
22,"22199",7029,5024,4977,55,47,"UPYD",25
22,"22032",107,74,71,0,3,"UPYD",0
22,"22220",169,123,122,2,1,"UPYD",2
22,"22077",381,295,293,5,2,"UPYD",3
22,"22215",129,91,91,0,0,"UPYD",2
22,"22064",165,115,115,1,0,"UPYD",2
22,"22200",251,191,189,0,2,"UPYD",2
22,"22126",91,65,65,0,0,"UPYD",0
22,"22142",98,81,79,1,2,"UPYD",0
22,"22021",1970,1485,1469,14,16,"UPYD",8
22,"22046",740,578,570,6,8,"UPYD",4
22,"22048",12633,9215,9141,90,74,"UPYD",72
22,"22175",197,140,140,0,0,"UPYD",1
22,"22006",298,217,215,1,2,"UPYD",4
22,"22162",129,101,101,0,0,"UPYD",1
22,"22903",654,542,536,3,6,"UPYD",1
22,"22117",2497,1788,1770,16,18,"UPYD",8
22,"22050",89,78,78,0,0,"UPYD",0
22,"22243",45,32,32,0,0,"UPYD",0
22,"22213",3029,2225,2181,17,44,"UPYD",8
22,"22014",245,184,183,2,1,"UPYD",1
22,"22227",211,153,151,3,2,"UPYD",0
22,"22201",269,189,189,0,0,"UPYD",1
22,"22060",1165,885,879,3,6,"UPYD",2
22,"22115",364,270,267,4,3,"UPYD",0
22,"22039",869,682,681,5,1,"UPYD",1
22,"22176",174,140,140,1,0,"UPYD",0
22,"22086",215,162,162,4,0,"UPYD",0
22,"22075",126,82,81,2,1,"UPYD",0
22,"22057",364,260,259,1,1,"UPYD",3
22,"22901",754,521,513,9,8,"UPYD",0
22,"22128",187,146,142,1,4,"UPYD",2
22,"22016",613,447,444,8,3,"UPYD",1
22,"22232",96,73,70,2,3,"UPYD",1
22,"22080",283,217,215,6,2,"UPYD",1
22,"22001",226,166,166,0,0,"UPYD",1
22,"22141",118,90,89,1,1,"UPYD",0
22,"22105",118,87,86,1,1,"UPYD",1
22,"22041",163,127,126,4,1,"UPYD",0
22,"22042",118,102,100,1,2,"UPYD",1
22,"22182",256,177,176,2,1,"UPYD",0
22,"22165",490,375,372,2,3,"UPYD",3
22,"22187",286,224,221,1,3,"UPYD",1
22,"22217",395,307,301,3,6,"UPYD",0
22,"22203",82,68,67,0,1,"UPYD",0
22,"22087",72,48,48,1,0,"UPYD",0
22,"22144",248,195,195,0,0,"UPYD",1
22,"22193",283,235,234,3,1,"UPYD",3
22,"22131",83,63,63,3,0,"UPYD",0
22,"22035",244,171,168,3,3,"UPYD",0
22,"22018",332,243,242,3,1,"UPYD",0
22,"22250",347,258,256,5,2,"UPYD",2
22,"22254",1129,804,792,9,12,"UPYD",4
22,"22043",94,71,70,0,1,"UPYD",0
22,"22133",117,89,89,4,0,"UPYD",0
22,"22012",111,84,82,0,2,"UPYD",0
22,"22205",434,334,333,2,1,"UPYD",1
22,"22051",101,84,84,1,0,"UPYD",0
22,"22136",815,596,595,6,1,"UPYD",2
22,"22022",558,431,427,2,4,"UPYD",4
22,"22248",118,92,91,0,1,"UPYD",0
22,"22129",183,128,127,2,1,"UPYD",2
22,"22225",2691,1849,1817,24,32,"UPYD",6
22,"22239",89,78,76,4,2,"UPYD",0
22,"22909",318,238,234,2,4,"UPYD",0
22,"22109",265,207,206,2,1,"UPYD",1
22,"22072",192,148,147,1,1,"UPYD",0
22,"22114",123,80,79,4,1,"UPYD",1
22,"22178",104,87,87,1,0,"UPYD",0
22,"22234",802,600,597,7,3,"UPYD",6
22,"22186",186,139,137,3,2,"UPYD",0
22,"22082",298,222,220,2,2,"UPYD",0
22,"22044",254,191,188,3,3,"UPYD",1
22,"22076",305,224,223,0,1,"UPYD",0
22,"22106",24,17,17,0,0,"UPYD",1
22,"22009",619,463,461,5,2,"UPYD",5
22,"22160",209,161,161,3,0,"UPYD",3
22,"22253",61,51,50,0,1,"UPYD",0
22,"22139",83,65,64,0,1,"UPYD",0
22,"22181",93,62,62,1,0,"UPYD",0
22,"22107",123,79,78,2,1,"UPYD",0
22,"22230",290,224,223,2,1,"UPYD",1
22,"22040",148,123,121,2,2,"UPYD",1
22,"22156",264,202,200,3,2,"UPYD",1
22,"22150",464,348,348,1,0,"UPYD",1
22,"22084",534,413,411,3,2,"UPYD",1
22,"22207",125,89,88,3,1,"UPYD",1
22,"22011",89,70,70,1,0,"UPYD",0
22,"22062",162,113,113,3,0,"UPYD",0
22,"22088",157,116,116,1,0,"UPYD",0
22,"22085",107,92,90,2,2,"UPYD",0
22,"22222",527,390,389,5,1,"UPYD",2
22,"22028",379,297,293,1,4,"UPYD",4
22,"22089",315,227,222,6,5,"UPYD",0
22,"22904",835,600,594,6,6,"UPYD",6
22,"22190",113,83,83,2,0,"UPYD",0
22,"22007",797,607,603,13,4,"UPYD",1
22,"22019",180,156,155,0,1,"UPYD",2
22,"22168",20,15,15,1,0,"UPYD",1
22,"22236",249,198,198,1,0,"UPYD",1
22,"22164",35,26,26,1,0,"UPYD",0
22,"22020",114,90,90,2,0,"UPYD",0
22,"22214",128,94,92,0,2,"UPYD",0
22,"22905",294,224,224,2,0,"UPYD",1
22,"22188",87,66,66,1,0,"UPYD",2
22,"22058",190,152,151,2,1,"UPYD",0
22,"22110",751,563,558,3,5,"UPYD",3
22,"22090",102,75,75,0,0,"UPYD",0
22,"22113",494,362,361,3,1,"UPYD",4
22,"22069",435,340,338,3,2,"UPYD",3
22,"22049",78,61,61,1,0,"UPYD",0
22,"22172",560,399,396,2,3,"UPYD",0
22,"22902",219,162,160,1,2,"UPYD",1
22,"22066",707,512,508,8,4,"UPYD",2
22,"22221",80,60,59,0,1,"UPYD",1
22,"22094",101,77,77,1,0,"UPYD",0
22,"22025",1071,726,712,13,14,"UPYD",2
22,"22063",175,140,140,2,0,"UPYD",1
22,"22015",324,238,236,3,2,"UPYD",7
22,"22242",64,45,44,1,1,"UPYD",0
22,"22102",184,160,159,1,1,"UPYD",1
22,"22008",173,138,138,3,0,"UPYD",0
22,"22059",1137,839,828,7,11,"UPYD",5
22,"22081",252,179,177,1,2,"UPYD",3
22,"22173",234,158,157,0,1,"UPYD",1
22,"22177",102,77,77,2,0,"UPYD",2
22,"22096",297,248,248,0,0,"UPYD",3
22,"22189",184,140,137,1,3,"UPYD",0
22,"22079",118,86,86,2,0,"UPYD",1
22,"22095",73,48,48,1,0,"UPYD",2
22,"22149",302,236,236,2,0,"UPYD",1
22,"22249",119,97,97,1,0,"UPYD",0
22,"22208",178,142,140,0,2,"UPYD",1
22,"22074",315,229,226,3,3,"UPYD",2
22,"22218",43,35,35,0,0,"UPYD",0
22,"22229",114,81,81,0,0,"UPYD",0
22,"22143",213,147,147,3,0,"UPYD",1
22,"22252",122,93,91,1,2,"UPYD",1
22,"22202",136,112,112,0,0,"UPYD",0
22,"22083",474,400,396,1,4,"UPYD",3
22,"22061",6685,4796,4740,38,56,"UPYD",29
22,"22045",89,66,66,0,0,"UPYD",0
22,"22013",295,235,233,2,2,"UPYD",1
22,"22068",82,65,65,3,0,"UPYD",0
22,"22233",82,61,61,0,0,"UPYD",2
22,"22017",864,658,651,7,7,"UPYD",6
22,"22024",225,174,173,0,1,"UPYD",2
22,"22130",10106,6957,6909,57,48,"UPYD",51
22,"22244",52,38,38,0,0,"UPYD",0
22,"22125",38845,28287,27998,283,289,"UPYD",269
22,"22184",188,156,156,2,0,"UPYD",3
22,"22228",505,409,407,3,2,"UPYD",2
22,"22151",93,68,68,0,0,"UPYD",1
22,"22052",942,743,741,9,2,"UPYD",2
22,"22163",426,360,356,3,4,"UPYD",3
22,"22226",774,591,589,2,2,"UPYD",7
22,"22099",490,378,377,4,1,"UPYD",1
22,"22908",207,144,140,1,4,"UPYD",0
22,"22103",680,527,522,8,5,"UPYD",3
22,"22235",100,77,77,0,0,"UPYD",0
22,"22067",65,45,45,1,0,"UPYD",0
22,"22155",77,58,58,2,0,"UPYD",1
22,"22204",1095,816,805,10,11,"UPYD",5
22,"22036",91,82,82,0,0,"UPYD",0
22,"22906",180,146,143,1,3,"UPYD",0
22,"22157",194,151,151,1,0,"UPYD",0
22,"22206",201,141,140,2,1,"UPYD",0
22,"22004",136,79,79,0,0,"UPYD",0
22,"22055",325,252,245,5,7,"UPYD",0
22,"22135",192,146,144,0,2,"UPYD",2
22,"22124",204,143,142,1,1,"UPYD",2
22,"22170",642,518,509,4,9,"UPYD",5
22,"22116",1443,1048,1038,12,10,"UPYD",9
22,"22212",84,70,70,1,0,"UPYD",0
22,"22023",430,329,329,2,0,"UPYD",0
22,"22223",79,63,62,0,1,"UPYD",1
22,"22167",498,397,388,7,9,"UPYD",1
22,"22054",1542,1126,1106,20,20,"UPYD",10
22,"22245",306,258,257,3,1,"UPYD",1
22,"22029",127,101,100,2,1,"UPYD",0
22,"22037",116,95,94,1,1,"UPYD",2
22,"22209",159,127,127,4,0,"UPYD",0
22,"22112",9592,6871,6820,76,51,"UPYD",32
22,"22027",325,218,214,0,4,"UPYD",2
22,"22137",1071,729,719,6,10,"UPYD",2
22,"22002",109,94,93,0,1,"UPYD",0
22,"22047",247,213,212,2,1,"UPYD",3
22,"22119",1296,950,940,3,10,"UPYD",4
22,"22174",485,400,396,6,4,"UPYD",2
22,"22078",453,323,319,6,4,"UPYD",5
22,"22247",30,23,22,0,1,"UPYD",0
22,"22195",235,190,189,2,1,"UPYD",2
22,"22251",371,283,281,4,2,"UPYD",0
17,"17119",68,59,59,0,0,"RECORTES CE",0
17,"17070",109,82,82,1,0,"RECORTES CE",0
17,"17191",146,114,113,1,1,"RECORTES CE",0
17,"17093",893,590,585,6,5,"RECORTES CE",2
17,"17047",4837,2997,2973,39,24,"RECORTES CE",6
17,"17154",92,62,62,0,0,"RECORTES CE",0
17,"17169",2475,1733,1724,11,9,"RECORTES CE",5
17,"17124",1638,1096,1083,10,13,"RECORTES CE",1
17,"17051",219,157,155,3,2,"RECORTES CE",1
17,"17005",401,263,260,5,3,"RECORTES CE",0
17,"17007",1730,1235,1224,4,11,"RECORTES CE",1
17,"17200",618,425,422,4,3,"RECORTES CE",0
17,"17037",104,65,65,0,0,"RECORTES CE",0
17,"17218",588,448,445,3,3,"RECORTES CE",0
17,"17220",811,563,555,3,8,"RECORTES CE",1
17,"17098",311,224,221,2,3,"RECORTES CE",0
17,"17054",375,249,249,2,0,"RECORTES CE",1
17,"17083",2935,2059,2042,17,17,"RECORTES CE",7
17,"17023",27347,18842,18610,118,232,"RECORTES CE",100
17,"17046",719,499,492,2,7,"RECORTES CE",2
17,"17121",221,157,156,1,1,"RECORTES CE",0
17,"17207",2373,1691,1673,18,18,"RECORTES CE",0
17,"17123",357,275,273,3,2,"RECORTES CE",1
17,"17128",302,224,223,4,1,"RECORTES CE",1
17,"17192",145,108,108,1,0,"RECORTES CE",0
17,"17096",178,115,114,0,1,"RECORTES CE",0
17,"17002",556,429,419,1,10,"RECORTES CE",1
17,"17084",236,160,160,7,0,"RECORTES CE",0
17,"17136",175,133,132,1,1,"RECORTES CE",0
17,"17198",430,282,281,4,1,"RECORTES CE",1
17,"17118",12824,8557,8477,57,80,"RECORTES CE",29
17,"17217",348,268,266,0,2,"RECORTES CE",0
17,"17162",147,91,90,0,1,"RECORTES CE",0
17,"17018",477,347,343,3,4,"RECORTES CE",0
17,"17126",308,252,250,2,2,"RECORTES CE",0
17,"17008",3636,2423,2395,15,28,"RECORTES CE",7
17,"17232",149,98,98,1,0,"RECORTES CE",0
17,"17157",126,104,102,1,2,"RECORTES CE",0
17,"17172",452,308,307,1,1,"RECORTES CE",0
17,"17025",1124,834,827,3,7,"RECORTES CE",0
17,"17203",154,110,110,0,0,"RECORTES CE",0
17,"17016",724,519,515,8,4,"RECORTES CE",1
17,"17115",277,195,195,0,0,"RECORTES CE",0
17,"17171",163,123,122,0,1,"RECORTES CE",0
17,"17010",330,247,246,5,1,"RECORTES CE",1
17,"17212",139,108,106,1,2,"RECORTES CE",0
17,"17224",314,214,213,3,1,"RECORTES CE",0
17,"17201",128,93,92,1,1,"RECORTES CE",0
17,"17196",214,151,151,2,0,"RECORTES CE",1
17,"17205",212,166,166,2,0,"RECORTES CE",0
17,"17189",1524,1126,1114,4,12,"RECORTES CE",2
17,"17107",268,189,188,2,1,"RECORTES CE",0
17,"17041",215,146,145,2,1,"RECORTES CE",0
17,"17227",128,95,95,0,0,"RECORTES CE",0
17,"17135",355,263,258,2,5,"RECORTES CE",0
17,"17043",158,119,117,1,2,"RECORTES CE",1
17,"17082",410,273,268,3,5,"RECORTES CE",0
17,"17004",510,371,368,0,3,"RECORTES CE",0
17,"17102",576,397,395,4,2,"RECORTES CE",0
17,"17039",1764,1229,1217,20,12,"RECORTES CE",1
17,"17116",348,243,240,4,3,"RECORTES CE",0
17,"17032",1713,1036,1020,13,16,"RECORTES CE",0
17,"17095",19593,12648,12554,81,94,"RECORTES CE",77
17,"17164",3996,2555,2543,23,12,"RECORTES CE",4
17,"17031",172,109,109,3,0,"RECORTES CE",0
17,"17052",124,83,83,1,0,"RECORTES CE",0
17,"17065",335,250,249,2,1,"RECORTES CE",1
17,"17106",139,108,106,0,2,"RECORTES CE",0
17,"17206",141,89,87,0,2,"RECORTES CE",0
17,"17001",585,417,413,2,4,"RECORTES CE",2
17,"17175",579,366,360,4,6,"RECORTES CE",1
17,"17049",3125,2251,2233,7,18,"RECORTES CE",8
17,"17146",2979,2030,2009,14,21,"RECORTES CE",5
17,"17040",538,392,391,4,1,"RECORTES CE",2
17,"17062",5970,3695,3657,31,38,"RECORTES CE",11
17,"17033",5293,3509,3476,28,33,"RECORTES CE",9
17,"17211",839,646,639,3,7,"RECORTES CE",0
17,"17092",3508,2373,2347,13,26,"RECORTES CE",11
17,"17216",165,112,110,0,2,"RECORTES CE",0
17,"17225",213,142,142,1,0,"RECORTES CE",1
17,"17184",1258,893,887,6,6,"RECORTES CE",1
17,"17215",2066,1588,1577,12,11,"RECORTES CE",2
17,"17143",146,109,107,1,2,"RECORTES CE",0
17,"17075",334,234,227,5,7,"RECORTES CE",2
17,"17167",2697,1876,1852,24,24,"RECORTES CE",1
17,"17159",627,439,434,2,5,"RECORTES CE",0
17,"17147",8112,5475,5422,43,53,"RECORTES CE",16
17,"17050",649,499,495,3,4,"RECORTES CE",0
17,"17067",697,500,495,7,5,"RECORTES CE",0
17,"17140",674,498,495,5,3,"RECORTES CE",0
17,"17148",1535,1056,1045,12,11,"RECORTES CE",1
17,"17036",2736,1857,1839,16,18,"RECORTES CE",7
17,"17081",244,165,163,0,2,"RECORTES CE",0
17,"17110",1325,953,945,5,8,"RECORTES CE",4
17,"17064",325,219,214,1,5,"RECORTES CE",0
17,"17168",374,273,272,1,1,"RECORTES CE",0
17,"17137",3411,2391,2369,15,22,"RECORTES CE",6
17,"17028",303,213,213,4,0,"RECORTES CE",0
17,"17187",621,468,464,6,4,"RECORTES CE",0
17,"17209",625,480,477,2,3,"RECORTES CE",0
17,"17149",363,267,264,0,3,"RECORTES CE",0
17,"17129",137,99,99,1,0,"RECORTES CE",0
17,"17234",183,124,124,1,0,"RECORTES CE",0
17,"17130",328,246,245,2,1,"RECORTES CE",0
17,"17103",4942,3150,3129,19,21,"RECORTES CE",14
17,"17090",542,410,408,3,2,"RECORTES CE",0
17,"17009",4042,2770,2738,18,32,"RECORTES CE",4
17,"17044",6767,4737,4694,36,43,"RECORTES CE",6
17,"17117",14280,9297,9223,75,74,"RECORTES CE",20
17,"17185",2293,1547,1527,12,20,"RECORTES CE",1
17,"17181",3380,2272,2251,15,21,"RECORTES CE",8
17,"17074",507,345,341,1,4,"RECORTES CE",1
17,"17153",186,140,140,0,0,"RECORTES CE",0
17,"17069",378,270,267,4,3,"RECORTES CE",1
17,"17006",1131,730,728,9,2,"RECORTES CE",1
17,"17014",61,47,47,1,0,"RECORTES CE",0
17,"17173",180,141,139,2,2,"RECORTES CE",0
17,"17101",543,364,362,3,2,"RECORTES CE",0
17,"17021",135,86,86,2,0,"RECORTES CE",0
17,"17152",10727,6804,6758,46,46,"RECORTES CE",14
17,"17011",646,463,462,7,1,"RECORTES CE",1
17,"17166",516,386,378,2,8,"RECORTES CE",1
17,"17097",199,149,148,5,1,"RECORTES CE",2
17,"17186",3771,2742,2712,18,30,"RECORTES CE",8
17,"17030",645,430,428,7,2,"RECORTES CE",1
17,"17105",255,170,170,2,0,"RECORTES CE",1
17,"17034",6874,4509,4477,32,32,"RECORTES CE",16
17,"17144",210,141,141,2,0,"RECORTES CE",0
17,"17063",166,115,113,0,2,"RECORTES CE",1
17,"17058",180,132,131,1,1,"RECORTES CE",0
17,"17056",1706,1200,1193,10,7,"RECORTES CE",1
17,"17042",414,288,286,2,2,"RECORTES CE",1
17,"17013",2787,1941,1926,17,15,"RECORTES CE",2
17,"17202",3803,2471,2449,13,22,"RECORTES CE",6
17,"17094",1049,646,641,3,5,"RECORTES CE",2
17,"17194",78,54,52,2,2,"RECORTES CE",0
17,"17091",411,282,273,5,9,"RECORTES CE",0
17,"17088",535,372,369,0,3,"RECORTES CE",0
17,"17015",12525,8550,8470,59,80,"RECORTES CE",15
17,"17020",3590,2531,2510,28,21,"RECORTES CE",2
17,"17183",274,186,186,3,0,"RECORTES CE",0
17,"17222",109,85,85,1,0,"RECORTES CE",0
17,"17087",222,169,169,3,0,"RECORTES CE",0
17,"17057",960,708,699,8,9,"RECORTES CE",2
17,"17180",8300,5429,5368,42,61,"RECORTES CE",11
17,"17903",897,647,638,0,9,"RECORTES CE",2
17,"17120",792,530,518,3,12,"RECORTES CE",1
17,"17226",856,572,557,5,15,"RECORTES CE",2
17,"17138",944,668,663,4,5,"RECORTES CE",1
17,"17099",80,60,59,0,1,"RECORTES CE",0
17,"17233",2287,1682,1664,21,18,"RECORTES CE",2
17,"17114",23020,15151,15024,105,127,"RECORTES CE",23
17,"17109",693,443,435,2,8,"RECORTES CE",1
17,"17158",464,284,281,0,3,"RECORTES CE",0
17,"17214",706,471,468,4,3,"RECORTES CE",0
17,"17029",203,131,131,2,0,"RECORTES CE",1
17,"17079",64159,44230,43902,271,328,"RECORTES CE",114
17,"17003",102,71,71,0,0,"RECORTES CE",0
17,"17048",6269,4072,4044,24,28,"RECORTES CE",12
17,"17151",174,124,123,3,1,"RECORTES CE",0
17,"17139",1382,972,963,9,9,"RECORTES CE",1
17,"17100",199,142,140,7,2,"RECORTES CE",0
17,"17150",1407,1074,1060,12,14,"RECORTES CE",1
17,"17178",1063,690,685,5,5,"RECORTES CE",1
17,"17132",1311,923,913,10,10,"RECORTES CE",2
17,"17038",369,255,253,2,2,"RECORTES CE",0
17,"17086",1744,1181,1170,10,11,"RECORTES CE",0
17,"17204",562,385,384,7,1,"RECORTES CE",0
17,"17155",14500,9167,9080,43,87,"RECORTES CE",31
17,"17223",807,528,520,6,8,"RECORTES CE",1
17,"17193",4216,2807,2768,26,39,"RECORTES CE",11
17,"17170",172,118,117,2,1,"RECORTES CE",0
17,"17230",463,343,339,2,4,"RECORTES CE",0
17,"17160",14740,9853,9795,68,58,"RECORTES CE",25
17,"17071",1131,810,803,8,7,"RECORTES CE",0
17,"17133",1268,887,877,6,10,"RECORTES CE",4
17,"17125",129,88,86,0,2,"RECORTES CE",0
17,"17902",1353,957,947,9,10,"RECORTES CE",1
17,"17221",4182,2882,2859,18,23,"RECORTES CE",5
17,"17228",295,211,210,1,1,"RECORTES CE",0
17,"17080",141,98,98,0,0,"RECORTES CE",0
17,"17085",293,223,221,1,2,"RECORTES CE",2
17,"17182",262,191,191,2,0,"RECORTES CE",2
17,"17026",536,381,380,6,1,"RECORTES CE",0
17,"17055",152,125,125,0,0,"RECORTES CE",0
17,"17197",137,105,105,2,0,"RECORTES CE",0
17,"17161",990,737,734,7,3,"RECORTES CE",1
17,"17195",338,256,251,2,5,"RECORTES CE",0
17,"17142",2561,1962,1950,13,12,"RECORTES CE",2
17,"17177",563,359,354,3,5,"RECORTES CE",0
17,"17076",123,90,88,2,2,"RECORTES CE",0
17,"17176",122,91,91,2,0,"RECORTES CE",0
17,"17022",6926,4626,4587,47,39,"RECORTES CE",6
17,"17078",330,225,225,5,0,"RECORTES CE",0
17,"17174",176,102,102,3,0,"RECORTES CE",0
17,"17165",653,445,443,2,2,"RECORTES CE",1
17,"17188",165,126,126,0,0,"RECORTES CE",0
17,"17027",2826,1993,1973,10,20,"RECORTES CE",6
17,"17077",555,386,383,5,3,"RECORTES CE",0
17,"17163",2609,1904,1890,18,14,"RECORTES CE",3
17,"17066",26551,16275,16166,140,109,"RECORTES CE",51
17,"17089",5490,3630,3591,20,39,"RECORTES CE",7
17,"17012",1142,763,757,6,6,"RECORTES CE",6
17,"17213",5372,3549,3517,17,32,"RECORTES CE",14
17,"17068",245,173,172,0,1,"RECORTES CE",0
17,"17145",1488,1003,986,9,17,"RECORTES CE",2
17,"17208",997,679,671,12,8,"RECORTES CE",1
17,"17901",989,696,686,7,10,"RECORTES CE",2
17,"17190",842,592,590,10,2,"RECORTES CE",0
17,"17019",1779,1279,1261,13,18,"RECORTES CE",0
17,"17210",551,378,376,2,2,"RECORTES CE",1
17,"17061",162,119,119,1,0,"RECORTES CE",1
17,"17199",6845,4527,4483,32,44,"RECORTES CE",9
17,"17141",5869,3688,3653,38,35,"RECORTES CE",19
17,"17111",873,643,641,12,2,"RECORTES CE",5
17,"17112",192,141,139,1,2,"RECORTES CE",0
17,"17035",544,400,399,4,1,"RECORTES CE",1
17,"17073",1875,1466,1460,11,6,"RECORTES CE",3
17,"17024",279,176,176,2,0,"RECORTES CE",0
17,"17134",234,163,161,2,2,"RECORTES CE",0
17,"17060",424,277,274,3,3,"RECORTES CE",0
19,"19001",53,36,36,1,0,"IU-UPeC",2
19,"19298",64,49,49,0,0,"IU-UPeC",2
19,"19256",44,35,35,0,0,"IU-UPeC",0
19,"19327",431,348,342,3,6,"IU-UPeC",1
19,"19178",39,25,25,0,0,"IU-UPeC",1
19,"19191",13,12,12,0,0,"IU-UPeC",0
19,"19134",26,18,18,0,0,"IU-UPeC",2
19,"19135",105,82,82,0,0,"IU-UPeC",3
19,"19269",100,80,79,0,1,"IU-UPeC",22
19,"19005",95,71,69,1,2,"IU-UPeC",4
19,"19203",31,25,25,0,0,"IU-UPeC",2
19,"19046",21452,16321,16151,91,170,"IU-UPeC",883
19,"19257",3446,2532,2499,36,33,"IU-UPeC",96
19,"19095",12,10,10,0,0,"IU-UPeC",1
19,"19002",73,56,54,0,2,"IU-UPeC",0
19,"19285",25,16,16,2,0,"IU-UPeC",0
19,"19258",97,73,73,1,0,"IU-UPeC",5
19,"19192",1723,1354,1342,9,12,"IU-UPeC",18
19,"19136",18,15,15,0,0,"IU-UPeC",0
19,"19109",43,32,32,3,0,"IU-UPeC",1
19,"19003",41,37,35,0,2,"IU-UPeC",3
19,"19179",72,52,52,1,0,"IU-UPeC",1
19,"19286",725,557,551,1,6,"IU-UPeC",39
19,"19193",23,22,21,0,1,"IU-UPeC",0
19,"19047",67,60,60,1,0,"IU-UPeC",6
19,"19181",55,37,37,0,0,"IU-UPeC",0
19,"19300",762,628,624,3,4,"IU-UPeC",36
19,"19314",52,35,34,1,1,"IU-UPeC",2
19,"19017",69,56,56,0,0,"IU-UPeC",1
19,"19317",141,107,103,0,4,"IU-UPeC",8
19,"19154",66,52,51,0,1,"IU-UPeC",0
19,"19259",28,18,18,0,0,"IU-UPeC",4
19,"19305",162,129,128,1,1,"IU-UPeC",6
19,"19048",17,10,10,1,0,"IU-UPeC",0
19,"19301",38,30,30,0,0,"IU-UPeC",0
19,"19138",272,197,196,0,1,"IU-UPeC",7
19,"19221",50,35,35,0,0,"IU-UPeC",1
19,"19194",98,68,66,0,2,"IU-UPeC",1
19,"19004",66,51,50,1,1,"IU-UPeC",0
19,"19139",31,23,23,1,0,"IU-UPeC",0
19,"19260",41,38,38,1,0,"IU-UPeC",2
19,"19049",12,11,11,0,0,"IU-UPeC",1
19,"19234",46,38,38,0,0,"IU-UPeC",2
19,"19222",115,87,86,1,1,"IU-UPeC",4
19,"19261",38,25,25,0,0,"IU-UPeC",1
19,"19247",148,106,102,1,4,"IU-UPeC",5
19,"19195",40,30,26,1,4,"IU-UPeC",0
19,"19098",21,20,20,0,0,"IU-UPeC",0
19,"19156",983,743,735,5,8,"IU-UPeC",11
19,"19240",52,38,37,0,1,"IU-UPeC",6
19,"19183",83,74,73,0,1,"IU-UPeC",3
19,"19142",260,189,186,2,3,"IU-UPeC",1
19,"19020",43,27,26,2,1,"IU-UPeC",1
19,"19289",28,21,21,0,0,"IU-UPeC",1
19,"19277",18,12,12,0,0,"IU-UPeC",0
19,"19006",768,545,538,0,7,"IU-UPeC",13
19,"19235",97,63,62,0,1,"IU-UPeC",1
19,"19147",46,34,33,0,1,"IU-UPeC",2
19,"19099",299,206,205,1,1,"IU-UPeC",4
19,"19303",46,39,38,0,1,"IU-UPeC",1
19,"19021",1051,788,774,7,14,"IU-UPeC",8
19,"19143",1733,1371,1352,9,19,"IU-UPeC",30
19,"19051",70,65,65,0,0,"IU-UPeC",0
19,"19262",139,111,109,0,2,"IU-UPeC",5
19,"19007",479,364,360,2,4,"IU-UPeC",8
19,"19263",27,17,15,0,2,"IU-UPeC",0
19,"19052",27,18,18,1,0,"IU-UPeC",3
19,"19145",48,42,42,2,0,"IU-UPeC",0
19,"19159",94,77,77,0,0,"IU-UPeC",4
19,"19197",25,20,20,0,0,"IU-UPeC",0
19,"19067",70,51,50,2,1,"IU-UPeC",0
19,"19102",101,84,84,0,0,"IU-UPeC",3
19,"19189",120,91,90,2,1,"IU-UPeC",7
19,"19322",31,26,26,0,0,"IU-UPeC",0
19,"19335",54,45,45,0,0,"IU-UPeC",1
19,"19022",632,477,468,3,9,"IU-UPeC",8
19,"19279",57,54,54,0,0,"IU-UPeC",1
19,"19008",37,28,28,0,0,"IU-UPeC",0
19,"19264",38,29,29,0,0,"IU-UPeC",0
19,"19103",255,205,201,0,4,"IU-UPeC",4
19,"19146",42,34,34,0,0,"IU-UPeC",6
19,"19186",81,63,63,1,0,"IU-UPeC",0
19,"19009",261,193,190,5,3,"IU-UPeC",9
19,"19053",2024,1479,1464,13,15,"IU-UPeC",89
19,"19306",28,20,20,0,0,"IU-UPeC",0
19,"19160",899,601,597,2,4,"IU-UPeC",24
19,"19187",50,46,44,0,2,"IU-UPeC",0
19,"19032",175,131,124,1,7,"IU-UPeC",6
19,"19161",218,151,151,1,0,"IU-UPeC",8
19,"19214",74,54,54,0,0,"IU-UPeC",1
19,"19280",3451,2620,2581,14,39,"IU-UPeC",103
19,"19054",190,165,163,3,2,"IU-UPeC",4
19,"19265",136,104,104,0,0,"IU-UPeC",1
19,"19105",2332,1809,1794,11,15,"IU-UPeC",60
19,"19307",25,23,23,1,0,"IU-UPeC",1
19,"19188",50,34,32,1,2,"IU-UPeC",0
19,"19010",9,9,9,0,0,"IU-UPeC",0
19,"19153",23,22,22,0,0,"IU-UPeC",3
19,"19162",65,49,49,0,0,"IU-UPeC",6
19,"19228",29,21,20,0,1,"IU-UPeC",1
19,"19325",128,89,88,0,1,"IU-UPeC",2
19,"19266",241,201,199,2,2,"IU-UPeC",3
19,"19089",28,17,17,0,0,"IU-UPeC",1
19,"19011",254,191,191,2,0,"IU-UPeC",3
19,"19027",148,116,115,1,1,"IU-UPeC",9
19,"19148",45,37,37,1,0,"IU-UPeC",0
19,"19267",19,12,12,0,0,"IU-UPeC",0
19,"19106",92,67,64,0,3,"IU-UPeC",0
19,"19216",134,97,97,0,0,"IU-UPeC",4
19,"19086",1495,1158,1149,7,9,"IU-UPeC",33
19,"19201",59,51,51,1,0,"IU-UPeC",2
19,"19150",126,94,93,0,1,"IU-UPeC",2
19,"19061",56,47,47,0,0,"IU-UPeC",1
19,"19309",26,22,22,0,0,"IU-UPeC",0
19,"19202",13,12,12,0,0,"IU-UPeC",1
19,"19229",69,60,60,1,0,"IU-UPeC",1
19,"19133",86,73,73,1,0,"IU-UPeC",1
19,"19013",128,106,106,0,0,"IU-UPeC",6
19,"19151",1075,779,764,5,15,"IU-UPeC",52
19,"19107",302,262,260,0,2,"IU-UPeC",2
19,"19075",63,37,36,0,1,"IU-UPeC",0
19,"19230",504,383,376,4,7,"IU-UPeC",16
19,"19015",81,68,68,0,0,"IU-UPeC",1
19,"19058",6786,5451,5415,29,36,"IU-UPeC",247
19,"19218",52,35,34,0,1,"IU-UPeC",1
19,"19165",48,40,40,0,0,"IU-UPeC",1
19,"19092",417,316,312,4,4,"IU-UPeC",7
19,"19210",21,19,19,2,0,"IU-UPeC",0
19,"19065",127,103,102,1,1,"IU-UPeC",2
19,"19112",57,49,49,0,0,"IU-UPeC",1
19,"19038",28,23,23,0,0,"IU-UPeC",0
19,"19170",193,140,140,0,0,"IU-UPeC",2
19,"19059",79,60,59,0,1,"IU-UPeC",2
19,"19016",64,42,42,0,0,"IU-UPeC",1
19,"19244",81,61,59,2,2,"IU-UPeC",0
19,"19152",589,448,439,2,9,"IU-UPeC",9
19,"19319",4425,3336,3304,21,32,"IU-UPeC",141
19,"19184",75,48,46,0,2,"IU-UPeC",0
19,"19033",64,49,49,3,0,"IU-UPeC",0
19,"19121",257,209,208,0,1,"IU-UPeC",3
19,"19034",22,18,18,0,0,"IU-UPeC",0
19,"19245",1179,913,893,6,20,"IU-UPeC",16
19,"19330",71,64,64,0,0,"IU-UPeC",0
19,"19224",93,80,80,0,0,"IU-UPeC",0
19,"19114",39,26,26,0,0,"IU-UPeC",0
19,"19060",150,115,114,1,1,"IU-UPeC",4
19,"19271",47,30,30,0,0,"IU-UPeC",1
19,"19232",79,60,59,1,1,"IU-UPeC",1
19,"19096",93,66,66,0,0,"IU-UPeC",1
19,"19321",38,26,26,0,0,"IU-UPeC",1
19,"19168",297,227,224,2,3,"IU-UPeC",6
19,"19208",43,31,31,0,0,"IU-UPeC",0
19,"19238",42,32,31,2,1,"IU-UPeC",0
19,"19119",81,71,71,0,0,"IU-UPeC",5
19,"19018",163,122,119,2,3,"IU-UPeC",0
19,"19272",72,59,59,1,0,"IU-UPeC",3
19,"19287",144,109,109,0,0,"IU-UPeC",0
19,"19080",73,51,50,0,1,"IU-UPeC",1
19,"19209",40,28,27,1,1,"IU-UPeC",0
19,"19123",44,38,38,0,0,"IU-UPeC",3
19,"19037",146,113,113,1,0,"IU-UPeC",0
19,"19155",66,54,53,0,1,"IU-UPeC",0
19,"19019",19,17,16,0,1,"IU-UPeC",2
19,"19288",23,22,22,0,0,"IU-UPeC",0
19,"19274",895,673,664,8,9,"IU-UPeC",45
19,"19064",73,62,62,0,0,"IU-UPeC",0
19,"19293",1868,1379,1364,9,15,"IU-UPeC",59
19,"19023",117,101,99,1,2,"IU-UPeC",3
19,"19088",84,68,68,0,0,"IU-UPeC",1
19,"19116",13,11,11,0,0,"IU-UPeC",1
19,"19237",47,35,34,1,1,"IU-UPeC",0
19,"19318",25,19,19,0,0,"IU-UPeC",0
19,"19113",471,365,365,2,0,"IU-UPeC",13
19,"19333",121,86,83,2,3,"IU-UPeC",3
19,"19174",111,79,78,0,1,"IU-UPeC",1
19,"19248",83,66,66,1,0,"IU-UPeC",1
19,"19175",34,26,26,1,0,"IU-UPeC",0
19,"19200",75,53,53,1,0,"IU-UPeC",2
19,"19024",8143,6017,5944,33,73,"IU-UPeC",238
19,"19196",106,86,80,0,6,"IU-UPeC",5
19,"19125",45,40,40,0,0,"IU-UPeC",2
19,"19039",60,55,54,1,1,"IU-UPeC",4
19,"19082",85,62,62,0,0,"IU-UPeC",4
19,"19087",18,17,17,0,0,"IU-UPeC",1
19,"19282",161,115,112,0,3,"IU-UPeC",3
19,"19157",57,45,45,0,0,"IU-UPeC",0
19,"19185",31,18,18,0,0,"IU-UPeC",3
19,"19278",29,28,28,2,0,"IU-UPeC",0
19,"19172",55,44,44,0,0,"IU-UPeC",1
19,"19304",220,161,161,1,0,"IU-UPeC",3
19,"19334",36,30,29,0,1,"IU-UPeC",5
19,"19212",727,562,551,8,11,"IU-UPeC",8
19,"19163",61,44,43,1,1,"IU-UPeC",4
19,"19331",2611,2010,1982,18,28,"IU-UPeC",88
19,"19225",835,645,638,2,7,"IU-UPeC",14
19,"19044",309,248,246,3,2,"IU-UPeC",3
19,"19294",23,19,19,1,0,"IU-UPeC",3
19,"19040",51,41,41,0,0,"IU-UPeC",0
19,"19070",79,59,59,0,0,"IU-UPeC",1
19,"19115",24,14,14,1,0,"IU-UPeC",0
19,"19239",100,70,69,1,1,"IU-UPeC",2
19,"19198",17,10,10,0,0,"IU-UPeC",0
19,"19226",48,35,35,0,0,"IU-UPeC",1
19,"19901",41,37,36,1,1,"IU-UPeC",0
19,"19251",42,29,28,0,1,"IU-UPeC",0
19,"19323",42,33,33,0,0,"IU-UPeC",0
19,"19120",104,92,92,1,0,"IU-UPeC",1
19,"19129",29,25,25,0,0,"IU-UPeC",0
19,"19241",46,35,35,1,0,"IU-UPeC",0
19,"19036",271,230,229,1,1,"IU-UPeC",1
19,"19326",1749,1248,1237,5,11,"IU-UPeC",44
19,"19111",158,123,121,0,2,"IU-UPeC",1
19,"19071",7746,5748,5678,34,70,"IU-UPeC",231
19,"19117",1580,1183,1167,11,16,"IU-UPeC",57
19,"19076",31,20,20,0,0,"IU-UPeC",0
19,"19284",10,8,8,0,0,"IU-UPeC",0
19,"19252",67,58,58,0,0,"IU-UPeC",0
19,"19171",4884,3824,3778,24,46,"IU-UPeC",160
19,"19167",132,106,103,0,3,"IU-UPeC",0
19,"19130",59955,47034,46504,383,530,"IU-UPeC",2024
19,"19281",22,18,18,0,0,"IU-UPeC",0
19,"19255",78,61,61,0,0,"IU-UPeC",1
19,"19324",179,136,135,0,1,"IU-UPeC",3
19,"19231",12,8,8,1,0,"IU-UPeC",0
19,"19329",58,49,49,0,0,"IU-UPeC",0
19,"19090",97,77,77,1,0,"IU-UPeC",3
19,"19074",73,63,63,0,0,"IU-UPeC",3
19,"19296",30,21,21,0,0,"IU-UPeC",1
19,"19132",93,74,74,0,0,"IU-UPeC",0
19,"19297",31,21,21,1,0,"IU-UPeC",0
19,"19091",29,20,20,0,0,"IU-UPeC",0
19,"19243",43,36,36,0,0,"IU-UPeC",0
19,"19110",57,46,45,2,1,"IU-UPeC",4
19,"19250",21,16,15,0,1,"IU-UPeC",1
19,"19310",11,7,7,0,0,"IU-UPeC",0
19,"19176",237,181,181,0,0,"IU-UPeC",1
19,"19057",72,53,52,0,1,"IU-UPeC",2
19,"19311",83,58,57,0,1,"IU-UPeC",3
19,"19182",39,28,27,0,1,"IU-UPeC",1
19,"19031",15,10,9,0,1,"IU-UPeC",1
19,"19283",29,23,23,0,0,"IU-UPeC",1
19,"19045",145,119,117,1,2,"IU-UPeC",1
19,"19199",19,16,16,1,0,"IU-UPeC",1
19,"19169",43,36,36,0,0,"IU-UPeC",1
19,"19227",74,49,49,0,0,"IU-UPeC",1
19,"19108",112,90,90,1,0,"IU-UPeC",5
19,"19173",47,40,37,0,3,"IU-UPeC",2
19,"19270",22,18,18,0,0,"IU-UPeC",3
19,"19211",394,297,291,1,6,"IU-UPeC",8
19,"19078",53,44,44,0,0,"IU-UPeC",1
19,"19050",15,13,13,0,0,"IU-UPeC",0
19,"19242",93,66,62,2,4,"IU-UPeC",4
19,"19302",58,45,45,1,0,"IU-UPeC",1
19,"19166",158,125,124,0,1,"IU-UPeC",5
19,"19217",59,39,37,0,2,"IU-UPeC",0
19,"19122",93,72,72,3,0,"IU-UPeC",6
19,"19219",13,9,9,0,0,"IU-UPeC",0
19,"19124",382,256,253,0,3,"IU-UPeC",6
19,"19073",24,19,19,0,0,"IU-UPeC",0
19,"19299",95,74,74,1,0,"IU-UPeC",1
19,"19118",13,10,10,0,0,"IU-UPeC",0
19,"19204",154,106,106,3,0,"IU-UPeC",3
19,"19290",853,568,560,3,8,"IU-UPeC",14
19,"19079",8,7,7,0,0,"IU-UPeC",0
19,"19097",17,13,13,0,0,"IU-UPeC",0
19,"19043",80,74,72,0,2,"IU-UPeC",0
19,"19291",1215,883,868,0,15,"IU-UPeC",35
19,"19268",36,26,25,0,1,"IU-UPeC",1
19,"19332",93,68,68,0,0,"IU-UPeC",2
19,"19126",1620,1242,1216,5,26,"IU-UPeC",43
19,"19041",160,133,132,0,1,"IU-UPeC",8
19,"19246",46,36,36,0,0,"IU-UPeC",0
19,"19233",91,71,71,1,0,"IU-UPeC",5
19,"19055",53,34,33,2,1,"IU-UPeC",1
19,"19190",2405,1852,1833,14,19,"IU-UPeC",86
19,"19104",18,13,13,1,0,"IU-UPeC",0
19,"19249",31,27,27,0,0,"IU-UPeC",0
19,"19215",165,142,141,0,1,"IU-UPeC",1
19,"19066",61,49,47,0,2,"IU-UPeC",3
19,"19223",110,76,76,3,0,"IU-UPeC",2
19,"19220",2305,1613,1600,9,13,"IU-UPeC",61
19,"19081",31,21,21,0,0,"IU-UPeC",1
19,"19308",65,54,54,0,0,"IU-UPeC",0
19,"19127",89,56,56,0,0,"IU-UPeC",0
19,"19254",49,36,36,1,0,"IU-UPeC",0
19,"19177",78,60,57,1,3,"IU-UPeC",1
19,"19213",72,53,51,0,2,"IU-UPeC",3
19,"19042",26,25,25,0,0,"IU-UPeC",1
5,"5156",249,163,161,0,2,"VOX",0
5,"5083",145,108,100,2,8,"VOX",0
5,"5096",79,57,57,0,0,"VOX",0
5,"5226",77,57,57,0,0,"VOX",0
5,"5008",227,180,176,2,4,"VOX",3
5,"5144",79,62,60,2,2,"VOX",0
5,"5007",113,74,74,1,0,"VOX",0
5,"5265",82,70,70,0,0,"VOX",2
5,"5199",39,32,32,0,0,"VOX",2
5,"5168",3565,2740,2711,17,29,"VOX",4
5,"5061",253,198,196,4,2,"VOX",1
5,"5087",137,93,93,0,0,"VOX",2
5,"5010",149,119,118,1,1,"VOX",1
5,"5107",64,39,39,1,0,"VOX",0
5,"5160",323,263,260,1,3,"VOX",1
5,"5140",116,97,96,0,1,"VOX",0
5,"5099",497,398,381,3,17,"VOX",0
5,"5238",787,565,556,4,9,"VOX",0
5,"5039",56,43,42,0,1,"VOX",0
5,"5240",3393,2354,2335,9,19,"VOX",12
5,"5051",181,152,147,3,5,"VOX",1
5,"5259",125,107,106,3,1,"VOX",0
5,"5190",55,42,42,2,0,"VOX",0
5,"5044",259,180,180,0,0,"VOX",0
5,"5094",140,110,110,0,0,"VOX",0
5,"5234",51,46,46,1,0,"VOX",0
5,"5213",101,83,83,0,0,"VOX",0
5,"5110",721,559,552,3,7,"VOX",0
5,"5017",85,75,75,0,0,"VOX",0
5,"5045",95,70,70,0,0,"VOX",0
5,"5206",29,22,21,0,1,"VOX",0
5,"5088",33,24,24,0,0,"VOX",0
5,"5153",108,78,77,3,1,"VOX",0
5,"5171",73,58,57,2,1,"VOX",0
5,"5125",57,45,44,0,1,"VOX",0
5,"5118",84,57,57,0,0,"VOX",0
5,"5101",316,240,238,1,2,"VOX",2
5,"5105",349,279,270,3,9,"VOX",1
5,"5154",36,30,30,0,0,"VOX",0
5,"5024",231,169,163,5,6,"VOX",1
5,"5159",254,175,174,2,1,"VOX",0
5,"5166",188,135,134,1,1,"VOX",2
5,"5158",371,289,287,1,2,"VOX",0
5,"5097",474,324,317,3,7,"VOX",0
5,"5249",107,82,82,0,0,"VOX",0
5,"5131",105,70,69,1,1,"VOX",1
5,"5180",88,68,68,1,0,"VOX",0
5,"5081",39,33,31,0,2,"VOX",0
5,"5133",67,55,55,1,0,"VOX",0
5,"5208",40,34,34,0,0,"VOX",0
5,"5055",576,476,467,0,9,"VOX",0
5,"5246",60,42,42,0,0,"VOX",0
5,"5196",53,39,39,0,0,"VOX",0
5,"5170",52,46,46,0,0,"VOX",0
5,"5132",992,678,672,2,6,"VOX",1
5,"5200",49,28,28,0,0,"VOX",0
5,"5244",51,38,38,0,0,"VOX",0
5,"5022",1611,1279,1271,4,8,"VOX",0
5,"5904",133,92,91,1,1,"VOX",0
5,"5052",99,89,88,0,1,"VOX",0
5,"5143",66,55,55,1,0,"VOX",0
5,"5220",382,298,294,1,4,"VOX",0
5,"5211",465,375,373,2,2,"VOX",0
5,"5252",64,45,45,0,0,"VOX",0
5,"5262",358,278,277,1,1,"VOX",0
5,"5070",32,26,26,0,0,"VOX",0
5,"5902",288,227,227,0,0,"VOX",0
5,"5251",68,40,40,0,0,"VOX",1
5,"5198",73,59,59,0,0,"VOX",0
5,"5123",96,69,66,2,3,"VOX",0
5,"5186",1572,1240,1222,9,18,"VOX",4
5,"5080",59,42,40,0,2,"VOX",0
5,"5016",6335,4873,4775,39,98,"VOX",11
5,"5119",33,20,20,0,0,"VOX",0
5,"5048",120,104,103,0,1,"VOX",0
5,"5194",138,122,121,5,1,"VOX",0
5,"5120",35,26,26,0,0,"VOX",0
5,"5162",87,60,60,2,0,"VOX",0
5,"5187",1755,1409,1395,11,14,"VOX",4
5,"5041",1001,772,765,10,7,"VOX",1
5,"5174",69,55,55,1,0,"VOX",0
5,"5176",234,190,187,2,3,"VOX",0
5,"5141",95,86,86,2,0,"VOX",0
5,"5235",124,111,110,1,1,"VOX",0
5,"5239",207,163,162,1,1,"VOX",1
5,"5073",297,243,238,4,5,"VOX",0
5,"5263",172,137,137,0,0,"VOX",0
5,"5254",196,166,166,0,0,"VOX",2
5,"5232",98,83,81,1,2,"VOX",0
5,"5113",78,58,58,1,0,"VOX",0
5,"5067",83,66,59,1,7,"VOX",0
5,"5181",43,31,31,1,0,"VOX",0
5,"5142",104,88,82,1,6,"VOX",0
5,"5093",417,313,311,1,2,"VOX",3
5,"5216",224,155,155,2,0,"VOX",0
5,"5121",241,186,185,3,1,"VOX",0
5,"5042",155,126,125,0,1,"VOX",0
5,"5126",70,59,59,0,0,"VOX",0
5,"5229",84,67,67,0,0,"VOX",1
5,"5086",82,66,64,1,2,"VOX",0
5,"5256",116,92,92,1,0,"VOX",0
5,"5060",120,99,99,1,0,"VOX",0
5,"5212",233,157,155,1,2,"VOX",0
5,"5241",3081,2143,2115,17,28,"VOX",4
5,"5092",155,120,120,0,0,"VOX",0
5,"5029",123,92,89,0,3,"VOX",0
5,"5134",48,40,40,0,0,"VOX",0
5,"5204",611,473,471,1,2,"VOX",1
5,"5242",681,538,527,10,11,"VOX",0
5,"5217",58,45,45,0,0,"VOX",0
5,"5205",75,58,58,0,0,"VOX",0
5,"5261",42,26,26,0,0,"VOX",0
5,"5179",215,184,180,0,4,"VOX",0
5,"5149",105,76,75,0,1,"VOX",0
5,"5102",1807,1431,1412,7,19,"VOX",1
5,"5247",250,147,146,1,1,"VOX",0
5,"5005",187,150,149,0,1,"VOX",1
5,"5054",1238,953,933,1,20,"VOX",2
5,"5903",157,108,107,0,1,"VOX",0
5,"5163",1756,1351,1345,1,6,"VOX",7
5,"5188",45,38,38,0,0,"VOX",0
5,"5076",481,401,387,5,14,"VOX",1
5,"5227",373,250,248,0,2,"VOX",0
5,"5033",174,139,138,0,1,"VOX",0
5,"5128",350,289,284,4,5,"VOX",1
5,"5049",399,301,291,1,10,"VOX",1
5,"5184",250,197,192,0,5,"VOX",1
5,"5038",116,87,85,0,2,"VOX",1
5,"5172",123,104,102,2,2,"VOX",1
5,"5267",100,65,64,0,1,"VOX",1
5,"5018",29,21,21,0,0,"VOX",0
5,"5264",62,43,42,1,1,"VOX",0
5,"5095",266,220,218,0,2,"VOX",0
5,"5108",51,30,30,0,0,"VOX",0
5,"5056",96,73,73,0,0,"VOX",0
5,"5047",4199,3287,3244,7,43,"VOX",5
5,"5139",76,66,66,0,0,"VOX",0
5,"5189",443,340,336,3,4,"VOX",0
5,"5237",164,131,126,1,5,"VOX",0
5,"5260",104,84,83,1,1,"VOX",1
5,"5245",348,293,288,0,5,"VOX",2
5,"5182",801,559,546,9,13,"VOX",0
5,"5078",115,100,99,3,1,"VOX",0
5,"5157",240,170,167,1,3,"VOX",0
5,"5109",454,378,362,3,16,"VOX",1
5,"5901",273,187,185,5,2,"VOX",0
5,"5148",27,17,17,0,0,"VOX",0
5,"5026",197,170,169,1,1,"VOX",0
5,"5114",1359,1131,1115,5,16,"VOX",1
5,"5079",70,54,54,0,0,"VOX",3
5,"5057",2470,1977,1953,14,24,"VOX",8
5,"5030",46,37,37,0,0,"VOX",0
5,"5065",469,388,385,6,3,"VOX",0
5,"5191",126,104,104,1,0,"VOX",0
5,"5053",86,58,58,0,0,"VOX",0
5,"5021",1932,1478,1456,12,22,"VOX",2
5,"5036",123,97,97,0,0,"VOX",1
5,"5243",88,61,61,1,0,"VOX",0
5,"5012",135,110,108,0,2,"VOX",0
5,"5066",458,365,364,3,1,"VOX",0
5,"5077",161,137,136,2,1,"VOX",0
5,"5183",140,114,113,1,1,"VOX",0
5,"5115",532,392,386,2,6,"VOX",1
5,"5136",97,74,73,5,1,"VOX",1
5,"5072",87,70,69,1,1,"VOX",0
5,"5155",52,37,37,0,0,"VOX",0
5,"5103",78,56,56,0,0,"VOX",0
5,"5013",876,733,723,2,10,"VOX",2
5,"5059",109,79,76,1,3,"VOX",0
5,"5082",528,437,427,5,10,"VOX",0
5,"5089",478,377,365,0,12,"VOX",1
5,"5215",169,126,122,2,4,"VOX",0
5,"5224",106,87,86,0,1,"VOX",0
5,"5266",102,89,89,0,0,"VOX",0
5,"5090",84,69,68,1,1,"VOX",1
5,"5069",74,58,58,0,0,"VOX",0
5,"5173",60,45,45,0,0,"VOX",0
5,"5001",194,153,152,1,1,"VOX",0
5,"5014",5422,4137,4084,30,53,"VOX",6
5,"5027",269,220,218,2,2,"VOX",0
5,"5197",98,90,90,0,0,"VOX",0
5,"5035",107,84,84,1,0,"VOX",0
5,"5195",224,162,161,1,1,"VOX",0
5,"5225",372,316,315,5,1,"VOX",0
5,"5019",44606,34903,34564,285,339,"VOX",191
5,"5253",88,70,70,0,0,"VOX",0
5,"5129",129,78,78,0,0,"VOX",0
5,"5214",38,27,26,0,1,"VOX",0
5,"5167",265,209,199,0,10,"VOX",0
5,"5230",65,56,54,1,2,"VOX",0
5,"5075",107,67,67,0,0,"VOX",0
5,"5178",371,295,289,0,6,"VOX",0
5,"5257",140,98,98,0,0,"VOX",0
5,"5192",100,82,81,1,1,"VOX",0
5,"5210",85,72,72,1,0,"VOX",0
5,"5116",118,95,93,1,2,"VOX",0
5,"5221",353,270,264,3,6,"VOX",0
5,"5145",52,41,41,0,0,"VOX",0
5,"5085",38,29,29,0,0,"VOX",0
5,"5127",650,539,535,4,4,"VOX",1
5,"5147",162,119,116,0,3,"VOX",1
5,"5236",128,85,84,0,1,"VOX",0
5,"5201",529,439,431,2,8,"VOX",0
5,"5037",261,165,163,3,2,"VOX",0
5,"5169",226,178,176,1,2,"VOX",0
5,"5058",78,55,55,2,0,"VOX",1
5,"5064",103,87,87,1,0,"VOX",0
5,"5177",160,128,128,1,0,"VOX",0
5,"5905",214,150,150,1,0,"VOX",0
5,"5074",693,543,540,1,3,"VOX",1
5,"5228",179,126,126,0,0,"VOX",0
5,"5015",87,66,65,1,1,"VOX",0
5,"5164",27,19,19,1,0,"VOX",0
5,"5218",121,97,95,0,2,"VOX",0
5,"5258",113,98,97,0,1,"VOX",0
5,"5152",690,561,558,3,3,"VOX",1
5,"5034",15,12,12,1,0,"VOX",0
5,"5117",201,178,174,2,4,"VOX",0
5,"5100",285,229,228,0,1,"VOX",0
5,"5062",184,155,154,2,1,"VOX",0
5,"5122",144,115,113,1,2,"VOX",0
5,"5231",160,126,124,1,2,"VOX",0
5,"5207",697,553,548,0,5,"VOX",0
5,"5002",1954,1471,1450,9,21,"VOX",6
5,"5151",93,70,70,1,0,"VOX",0
5,"5040",68,45,45,0,0,"VOX",0
5,"5112",97,72,70,1,2,"VOX",0
5,"5023",173,153,153,5,0,"VOX",1
5,"5025",96,73,72,1,1,"VOX",0
5,"5219",39,28,28,0,0,"VOX",1
5,"5046",45,38,38,1,0,"VOX",0
5,"5063",34,24,24,0,0,"VOX",0
5,"5165",380,291,283,5,8,"VOX",0
5,"5124",107,83,81,1,2,"VOX",0
5,"5233",226,179,177,0,2,"VOX",0
5,"5161",586,483,473,2,10,"VOX",0
5,"5106",36,27,27,0,0,"VOX",0
5,"5043",84,67,67,0,0,"VOX",0
5,"5193",194,163,163,1,0,"VOX",0
5,"5209",83,63,63,0,0,"VOX",0
5,"5222",159,126,126,0,0,"VOX",1
5,"5175",159,130,130,0,0,"VOX",0
5,"5135",425,325,322,1,3,"VOX",1
5,"5104",34,23,22,1,1,"VOX",0
5,"5130",95,82,82,0,0,"VOX",0
5,"5185",94,80,80,1,0,"VOX",0
5,"5138",311,241,239,3,2,"VOX",0
5,"5084",74,56,56,1,0,"VOX",0
11,"11041",9856,7043,6967,85,76,"VOX",1
11,"11033",20773,13487,13333,171,154,"VOX",23
11,"11008",17460,11800,11615,151,185,"VOX",21
11,"11022",48778,26546,26333,277,213,"VOX",72
11,"11032",53898,32432,32172,371,260,"VOX",47
11,"11016",14880,9945,9848,124,97,"VOX",25
11,"11037",5678,4491,4426,20,65,"VOX",1
11,"11027",68010,46675,46322,400,353,"VOX",180
11,"11015",62337,40342,40012,407,330,"VOX",110
11,"11006",24504,16649,16486,176,163,"VOX",27
11,"11004",88617,55218,54733,581,485,"VOX",122
11,"11002",4287,3245,3238,15,7,"VOX",2
11,"11021",6777,4826,4779,52,47,"VOX",8
11,"11012",100460,72741,72128,590,613,"VOX",180
11,"11035",13569,9000,8908,93,92,"VOX",12
11,"11026",4804,3581,3511,31,70,"VOX",8
11,"11007",18036,10832,10678,181,154,"VOX",12
11,"11010",6420,4423,4362,63,61,"VOX",4
11,"11901",5653,4132,4088,84,44,"VOX",0
11,"11005",4560,3203,3143,21,60,"VOX",2
11,"11902",3619,2431,2410,17,21,"VOX",5
11,"11042",1189,877,868,5,9,"VOX",1
11,"11030",22796,15377,15222,145,155,"VOX",16
11,"11019",1830,1413,1371,5,42,"VOX",0
11,"11023",9354,6990,6928,86,62,"VOX",9
11,"11001",4377,2949,2900,17,49,"VOX",5
11,"11039",10044,6684,6623,98,61,"VOX",8
11,"11038",13803,10593,10441,121,152,"VOX",14
11,"11024",6735,5114,5065,33,49,"VOX",3
11,"11034",2345,1606,1594,10,12,"VOX",5
11,"11011",1688,1239,1205,14,34,"VOX",4
11,"11031",76452,51850,51456,568,394,"VOX",201
11,"11040",398,326,317,3,9,"VOX",0
11,"11017",3207,2389,2362,28,27,"VOX",4
11,"11014",16791,11255,11146,166,109,"VOX",15
11,"11029",5433,3112,3067,27,45,"VOX",10
11,"11028",32532,23191,22981,274,210,"VOX",40
11,"11003",1270,907,899,12,8,"VOX",0
11,"11013",2324,1687,1653,16,34,"VOX",2
11,"11018",1485,1109,1090,10,19,"VOX",0
11,"11009",602,426,422,5,4,"VOX",1
11,"11036",694,439,437,13,2,"VOX",0
11,"11020",165400,113865,113092,1184,773,"VOX",284
11,"11025",4370,3174,3123,29,51,"VOX",2
11,"11001",4377,2949,2900,17,49,"PODEMOS",250
11,"11023",9354,6990,6928,86,62,"PODEMOS",755
11,"11012",100460,72741,72128,590,613,"PODEMOS",20970
11,"11038",13803,10593,10441,121,152,"PODEMOS",1123
11,"11015",62337,40342,40012,407,330,"PODEMOS",8328
11,"11008",17460,11800,11615,151,185,"PODEMOS",2221
11,"11005",4560,3203,3143,21,60,"PODEMOS",462
11,"11019",1830,1413,1371,5,42,"PODEMOS",143
11,"11030",22796,15377,15222,145,155,"PODEMOS",2728
11,"11022",48778,26546,26333,277,213,"PODEMOS",5189
11,"11033",20773,13487,13333,171,154,"PODEMOS",2390
11,"11009",602,426,422,5,4,"PODEMOS",43
11,"11010",6420,4423,4362,63,61,"PODEMOS",794
11,"11016",14880,9945,9848,124,97,"PODEMOS",1368
11,"11042",1189,877,868,5,9,"PODEMOS",59
11,"11002",4287,3245,3238,15,7,"PODEMOS",613
11,"11031",76452,51850,51456,568,394,"PODEMOS",11525
11,"11006",24504,16649,16486,176,163,"PODEMOS",2295
11,"11013",2324,1687,1653,16,34,"PODEMOS",242
11,"11018",1485,1109,1090,10,19,"PODEMOS",83
11,"11024",6735,5114,5065,33,49,"PODEMOS",611
11,"11035",13569,9000,8908,93,92,"PODEMOS",1425
11,"11028",32532,23191,22981,274,210,"PODEMOS",8238
11,"11032",53898,32432,32172,371,260,"PODEMOS",6401
11,"11014",16791,11255,11146,166,109,"PODEMOS",1807
11,"11003",1270,907,899,12,8,"PODEMOS",52
11,"11901",5653,4132,4088,84,44,"PODEMOS",549
11,"11004",88617,55218,54733,581,485,"PODEMOS",9633
11,"11011",1688,1239,1205,14,34,"PODEMOS",167
11,"11007",18036,10832,10678,181,154,"PODEMOS",2032
11,"11036",694,439,437,13,2,"PODEMOS",31
11,"11902",3619,2431,2410,17,21,"PODEMOS",237
11,"11037",5678,4491,4426,20,65,"PODEMOS",1113
11,"11027",68010,46675,46322,400,353,"PODEMOS",10222
11,"11040",398,326,317,3,9,"PODEMOS",20
11,"11017",3207,2389,2362,28,27,"PODEMOS",227
11,"11021",6777,4826,4779,52,47,"PODEMOS",625
11,"11026",4804,3581,3511,31,70,"PODEMOS",335
11,"11034",2345,1606,1594,10,12,"PODEMOS",125
11,"11020",165400,113865,113092,1184,773,"PODEMOS",22342
11,"11029",5433,3112,3067,27,45,"PODEMOS",391
11,"11025",4370,3174,3123,29,51,"PODEMOS",431
11,"11041",9856,7043,6967,85,76,"PODEMOS",899
11,"11039",10044,6684,6623,98,61,"PODEMOS",721
28,"28123",56464,47181,46948,257,233,"PODEMOS",14717
28,"28064",134,105,105,0,0,"PODEMOS",5
28,"28151",3143,2352,2314,6,38,"PODEMOS",445
28,"28157",595,448,442,1,6,"PODEMOS",85
28,"28091",5436,3827,3786,23,41,"PODEMOS",719
28,"28119",2074,1641,1625,9,16,"PODEMOS",286
28,"28137",1644,1301,1283,7,18,"PODEMOS",243
28,"28145",2370,1824,1809,12,15,"PODEMOS",372
28,"28104",13836,11414,11349,54,65,"PODEMOS",2128
28,"28003",181,141,141,3,0,"PODEMOS",29
28,"28167",8308,6605,6545,35,60,"PODEMOS",1450
28,"28022",32949,27473,27379,169,94,"PODEMOS",3265
28,"28903",32480,27640,27525,161,115,"PODEMOS",5869
28,"28066",7175,5598,5561,28,37,"PODEMOS",852
28,"28115",60579,50819,50657,246,162,"PODEMOS",5375
28,"28049",58688,48006,47660,286,346,"PODEMOS",12108
28,"28902",468,352,347,2,5,"PODEMOS",75
28,"28135",971,740,735,4,5,"PODEMOS",166
28,"28057",1439,1125,1120,5,5,"PODEMOS",247
28,"28118",58,49,48,1,1,"PODEMOS",12
28,"28085",3908,3106,3078,7,28,"PODEMOS",556
28,"28121",198,166,164,2,2,"PODEMOS",31
28,"28027",1199,897,882,5,15,"PODEMOS",147
28,"28028",1730,1347,1326,8,21,"PODEMOS",424
28,"28100",4169,3076,3048,12,28,"PODEMOS",771
28,"28102",881,659,650,3,9,"PODEMOS",103
28,"28006",78564,61796,61456,334,340,"PODEMOS",11120
28,"28052",3883,2801,2758,18,43,"PODEMOS",361
28,"28162",2549,2039,2025,13,14,"PODEMOS",323
28,"28133",6002,4259,4204,12,55,"PODEMOS",644
28,"28051",1542,1240,1232,5,8,"PODEMOS",232
28,"28034",352,270,269,1,1,"PODEMOS",34
28,"28002",2966,2186,2175,9,11,"PODEMOS",324
28,"28053",6458,5299,5263,29,36,"PODEMOS",1110
28,"28111",592,489,483,0,6,"PODEMOS",77
28,"28037",1566,1175,1168,5,7,"PODEMOS",125
28,"28082",5664,4526,4492,25,34,"PODEMOS",1329
28,"28013",40409,30141,29905,164,236,"PODEMOS",6059
28,"28131",12971,9828,9755,57,73,"PODEMOS",1813
28,"28070",119,91,91,0,0,"PODEMOS",22
28,"28061",21200,16698,16600,75,98,"PODEMOS",3325
28,"28144",5929,4776,4744,29,32,"PODEMOS",893
28,"28074",138742,110456,109579,581,877,"PODEMOS",26790
28,"28163",438,357,354,1,3,"PODEMOS",83
28,"28149",5653,4516,4469,19,47,"PODEMOS",895
28,"28180",5242,4040,3999,11,41,"PODEMOS",609
28,"28179",1441,1082,1071,7,11,"PODEMOS",230
28,"28120",1217,918,904,4,14,"PODEMOS",160
28,"28134",60511,47566,47229,233,337,"PODEMOS",9822
28,"28038",4935,3858,3815,17,43,"PODEMOS",874
28,"28023",4697,3835,3817,20,18,"PODEMOS",883
28,"28089",3703,2961,2933,19,28,"PODEMOS",521
28,"28176",12288,9809,9763,50,46,"PODEMOS",1158
28,"28012",883,702,691,4,11,"PODEMOS",110
28,"28159",588,469,468,6,1,"PODEMOS",62
28,"28174",1788,1277,1267,2,10,"PODEMOS",204
28,"28153",703,510,507,2,3,"PODEMOS",163
28,"28043",5922,4063,4008,29,55,"PODEMOS",689
28,"28108",3330,2536,2528,17,8,"PODEMOS",592
28,"28116",700,544,544,3,0,"PODEMOS",127
28,"28168",1226,910,900,1,10,"PODEMOS",195
28,"28026",6237,4893,4853,32,40,"PODEMOS",884
28,"28141",5806,4532,4486,24,46,"PODEMOS",917
28,"28090",8405,6792,6751,34,41,"PODEMOS",1394
28,"28042",1153,882,874,5,8,"PODEMOS",155
28,"28076",406,322,319,1,3,"PODEMOS",63
28,"28170",2486,1757,1740,9,17,"PODEMOS",212
28,"28073",12505,9485,9384,64,101,"PODEMOS",2041
28,"28107",435,326,321,0,5,"PODEMOS",40
28,"28087",3176,2545,2528,15,17,"PODEMOS",407
28,"28008",1768,1293,1282,4,11,"PODEMOS",247
28,"28010",9853,7959,7914,35,45,"PODEMOS",1605
28,"28165",1788,1332,1321,5,11,"PODEMOS",145
28,"28004",6179,4377,4345,15,32,"PODEMOS",808
28,"28175",850,696,692,2,4,"PODEMOS",125
28,"28158",662,545,543,3,2,"PODEMOS",97
28,"28147",968,751,745,2,6,"PODEMOS",148
28,"28136",640,540,532,0,8,"PODEMOS",93
28,"28161",48368,37462,37161,190,301,"PODEMOS",7624
28,"28005",134211,104575,103819,667,756,"PODEMOS",21432
28,"28155",507,420,420,0,0,"PODEMOS",38
28,"28171",4238,3002,2962,18,40,"PODEMOS",396
28,"28101",218,180,180,0,0,"PODEMOS",38
28,"28127",64513,53125,52932,300,193,"PODEMOS",6918
28,"28173",520,409,408,3,1,"PODEMOS",69
28,"28058",139289,108214,107323,612,891,"PODEMOS",25883
28,"28018",3739,3071,3046,12,25,"PODEMOS",553
28,"28007",124358,99423,98711,554,712,"PODEMOS",21653
28,"28183",1050,770,763,2,7,"PODEMOS",219
28,"28065",125384,101604,100872,477,732,"PODEMOS",24955
28,"28059",4312,3256,3237,11,19,"PODEMOS",559
28,"28143",70,59,59,1,0,"PODEMOS",3
28,"28083",8880,6801,6759,47,42,"PODEMOS",1446
28,"28048",499,406,401,2,5,"PODEMOS",108
28,"28080",48226,39753,39570,172,183,"PODEMOS",4795
28,"28099",1731,1283,1278,8,5,"PODEMOS",193
28,"28086",5055,3627,3600,21,27,"PODEMOS",648
28,"28092",151511,117869,116968,641,901,"PODEMOS",26838
28,"28015",18233,14725,14653,81,72,"PODEMOS",2885
28,"28068",10928,8389,8315,43,74,"PODEMOS",1542
28,"28110",1949,1543,1525,2,18,"PODEMOS",237
28,"28125",2965,2210,2188,13,22,"PODEMOS",382
28,"28062",308,244,241,3,3,"PODEMOS",46
28,"28063",252,195,194,2,1,"PODEMOS",43
28,"28055",899,682,676,4,6,"PODEMOS",64
28,"28050",4077,3032,3006,15,26,"PODEMOS",578
28,"28126",39,25,25,0,0,"PODEMOS",0
28,"28047",40783,31308,31072,171,236,"PODEMOS",6882
28,"28045",33019,25531,25313,146,218,"PODEMOS",5057
28,"28178",1066,850,846,2,4,"PODEMOS",171
28,"28009",14046,11014,10932,51,82,"PODEMOS",1898
28,"28117",95,84,84,0,0,"PODEMOS",17
28,"28114",149,103,103,1,0,"PODEMOS",14
28,"28154",5420,3966,3899,17,67,"PODEMOS",663
28,"28164",2986,2281,2263,12,18,"PODEMOS",421
28,"28130",28243,22649,22458,135,191,"PODEMOS",5561
28,"28140",2981,2383,2357,14,26,"PODEMOS",427
28,"28072",5657,4465,4441,20,24,"PODEMOS",817
28,"28017",1210,954,943,6,11,"PODEMOS",274
28,"28025",427,329,326,1,3,"PODEMOS",37
28,"28128",439,323,320,2,3,"PODEMOS",48
28,"28113",34305,27077,26881,156,196,"PODEMOS",6504
28,"28032",4749,3653,3607,19,46,"PODEMOS",644
28,"28152",16026,13269,13202,46,67,"PODEMOS",1886
28,"28148",85022,65597,65111,368,486,"PODEMOS",14452
28,"28011",445,339,338,0,1,"PODEMOS",66
28,"28014",32852,24749,24571,120,178,"PODEMOS",4800
28,"28122",518,388,385,2,3,"PODEMOS",64
28,"28124",76,56,54,0,2,"PODEMOS",14
28,"28001",64,48,48,3,0,"PODEMOS",6
28,"28181",20344,16669,16572,95,97,"PODEMOS",2250
28,"28016",80,57,57,0,0,"PODEMOS",7
28,"28093",2043,1681,1661,9,20,"PODEMOS",232
28,"28088",262,180,179,2,1,"PODEMOS",38
28,"28029",530,426,424,3,2,"PODEMOS",82
28,"28095",1508,1177,1167,6,10,"PODEMOS",255
28,"28019",1237,952,938,2,14,"PODEMOS",170
28,"28106",76612,56555,56006,346,549,"PODEMOS",14844
28,"28129",7913,6175,6124,30,51,"PODEMOS",1085
28,"28054",11166,8649,8584,36,65,"PODEMOS",1782
28,"28036",2514,1974,1949,12,25,"PODEMOS",477
28,"28177",10192,8271,8234,51,37,"PODEMOS",1197
28,"28030",1716,1342,1316,2,26,"PODEMOS",322
28,"28041",4452,3572,3550,24,22,"PODEMOS",578
28,"28060",1509,1194,1183,8,11,"PODEMOS",218
28,"28097",124,85,84,1,1,"PODEMOS",24
28,"28084",15839,12028,11925,53,103,"PODEMOS",2936
28,"28112",167,132,132,0,0,"PODEMOS",20
28,"28172",8965,7255,7219,44,36,"PODEMOS",1350
28,"28075",5581,4380,4350,15,30,"PODEMOS",946
28,"28078",36,34,34,0,0,"PODEMOS",11
28,"28146",1773,1274,1262,9,12,"PODEMOS",190
28,"28031",2055,1538,1519,4,19,"PODEMOS",182
28,"28040",15691,10833,10728,45,105,"PODEMOS",2400
28,"28024",152,129,128,1,1,"PODEMOS",13
28,"28094",825,636,634,3,2,"PODEMOS",185
28,"28035",1362,1042,1033,3,9,"PODEMOS",192
28,"28071",60,47,46,0,1,"PODEMOS",4
28,"28033",3824,2854,2832,11,22,"PODEMOS",432
28,"28069",54,43,43,1,0,"PODEMOS",13
28,"28166",318,258,255,1,3,"PODEMOS",59
28,"28096",18161,13784,13647,57,137,"PODEMOS",2574
28,"28132",11645,8605,8520,55,85,"PODEMOS",1850
28,"28160",8227,6295,6251,26,44,"PODEMOS",1210
28,"28039",130,97,97,0,0,"PODEMOS",16
28,"28079",2371327,1817203,1806970,9067,10233,"PODEMOS",376283
28,"28021",544,387,387,2,0,"PODEMOS",132
28,"28182",214,174,170,0,4,"PODEMOS",43
28,"28109",1591,1113,1111,3,2,"PODEMOS",184
28,"28020",148,99,97,1,2,"PODEMOS",37
28,"28044",5766,4623,4584,22,39,"PODEMOS",1021
28,"28169",1427,1164,1158,1,6,"PODEMOS",178
28,"28046",4432,3562,3538,19,24,"PODEMOS",707
28,"28067",4057,3220,3188,12,32,"PODEMOS",552
28,"28150",3084,2415,2381,13,34,"PODEMOS",476
28,"28156",998,751,743,3,8,"PODEMOS",147
28,"28138",69,54,54,0,0,"PODEMOS",16
28,"28901",789,590,584,2,6,"PODEMOS",121
28,"28056",860,653,647,6,6,"PODEMOS",173
41,"41089",6504,4759,4691,51,68,"PODEMOS",890
41,"41002",1469,1085,1061,12,24,"PODEMOS",114
41,"41055",15009,10393,10292,82,101,"PODEMOS",1294
41,"41061",2218,1769,1742,5,27,"PODEMOS",653
41,"41025",2041,1456,1430,17,26,"PODEMOS",181
41,"41037",3203,2473,2449,18,24,"PODEMOS",476
41,"41041",9743,7620,7482,39,138,"PODEMOS",1065
41,"41086",16102,10743,10665,93,78,"PODEMOS",2052
41,"41070",6021,4504,4456,44,48,"PODEMOS",1062
41,"41902",4675,3051,3019,20,32,"PODEMOS",378
41,"41066",1363,1019,1007,7,12,"PODEMOS",159
41,"41019",4654,3267,3224,34,43,"PODEMOS",558
41,"41011",15395,11527,11341,114,186,"PODEMOS",1606
41,"41014",2510,1981,1958,8,23,"PODEMOS",578
41,"41017",15052,11074,10964,99,110,"PODEMOS",2081
41,"41022",4300,2918,2891,30,27,"PODEMOS",445
41,"41033",5102,3655,3613,25,42,"PODEMOS",326
41,"41034",23033,15936,15711,189,225,"PODEMOS",3019
41,"41078",2522,1888,1874,5,14,"PODEMOS",192
41,"41056",3691,3069,3042,21,27,"PODEMOS",568
41,"41092",7749,5715,5647,57,68,"PODEMOS",734
41,"41073",1715,1194,1169,9,25,"PODEMOS",152
41,"41039",31674,23240,22982,196,258,"PODEMOS",3389
41,"41079",9343,7111,7029,68,82,"PODEMOS",1111
41,"41026",4325,3551,3516,18,35,"PODEMOS",635
41,"41094",6288,4726,4653,36,73,"PODEMOS",686
41,"41067",7115,5248,5178,46,70,"PODEMOS",759
41,"41064",5601,3766,3715,42,51,"PODEMOS",417
41,"41044",7392,5562,5526,40,36,"PODEMOS",1017
41,"41035",1112,887,876,5,11,"PODEMOS",82
41,"41071",5620,3974,3898,17,76,"PODEMOS",664
41,"41010",4394,3203,3160,19,43,"PODEMOS",760
41,"41032",4019,2943,2875,17,68,"PODEMOS",351
41,"41081",29164,21631,21410,218,221,"PODEMOS",5017
41,"41090",3541,2774,2721,17,53,"PODEMOS",343
41,"41075",10225,7387,7283,55,104,"PODEMOS",973
41,"41046",3017,2416,2381,12,35,"PODEMOS",603
41,"41012",3286,2268,2235,15,33,"PODEMOS",323
41,"41059",33977,26158,25965,230,193,"PODEMOS",6133
41,"41028",1971,1574,1562,11,12,"PODEMOS",379
41,"41097",3135,2339,2317,19,22,"PODEMOS",196
41,"41031",1257,838,836,8,2,"PODEMOS",79
41,"41008",1063,820,805,3,15,"PODEMOS",78
41,"41004",56552,40018,39623,515,395,"PODEMOS",8909
41,"41098",4952,3762,3704,24,58,"PODEMOS",549
41,"41013",4842,3491,3461,22,30,"PODEMOS",583
41,"41027",3941,2766,2709,28,57,"PODEMOS",553
41,"41015",5310,3799,3710,38,89,"PODEMOS",498
41,"41076",2184,1442,1432,19,10,"PODEMOS",229
41,"41052",3006,2264,2209,8,55,"PODEMOS",400
41,"41102",14635,10904,10655,148,249,"PODEMOS",1809
41,"41062",2235,1805,1790,10,15,"PODEMOS",655
41,"41074",3033,2362,2341,8,21,"PODEMOS",450
41,"41047",10086,7758,7663,80,95,"PODEMOS",1463
41,"41101",5932,4454,4421,27,33,"PODEMOS",622
41,"41901",2676,2222,2190,31,32,"PODEMOS",395
41,"41057",275,193,191,0,2,"PODEMOS",24
41,"41096",6166,4811,4752,39,59,"PODEMOS",976
41,"41036",3971,2846,2806,14,40,"PODEMOS",1176
41,"41088",518,381,377,0,4,"PODEMOS",57
41,"41006",2740,1909,1897,13,12,"PODEMOS",188
41,"41068",13948,10269,10150,75,119,"PODEMOS",1624
41,"41021",21249,15031,14854,152,177,"PODEMOS",3452
41,"41029",13423,9979,9880,84,99,"PODEMOS",1975
41,"41063",2683,1942,1922,21,20,"PODEMOS",536
41,"41038",99637,71611,71050,727,561,"PODEMOS",16385
41,"41100",1025,770,751,5,19,"PODEMOS",23
41,"41005",9057,6781,6693,58,88,"PODEMOS",985
41,"41065",22868,15933,15784,172,149,"PODEMOS",3570
41,"41077",8728,6423,6308,28,115,"PODEMOS",898
41,"41099",3998,2597,2577,19,20,"PODEMOS",380
41,"41048",2244,1625,1598,22,27,"PODEMOS",146
41,"41030",516,409,395,2,14,"PODEMOS",37
41,"41024",22662,15742,15521,137,221,"PODEMOS",2166
41,"41016",7310,5473,5410,50,63,"PODEMOS",873
41,"41087",10202,7160,7033,51,127,"PODEMOS",1222
41,"41051",2170,1650,1611,8,39,"PODEMOS",252
41,"41069",29070,20827,20558,355,269,"PODEMOS",3256
41,"41060",15279,10611,10447,91,164,"PODEMOS",1584
41,"41084",2850,2205,2157,15,48,"PODEMOS",266
41,"41053",21252,16022,15770,121,252,"PODEMOS",2545
41,"41042",5868,4612,4583,37,29,"PODEMOS",1038
41,"41091",541928,401177,398212,3487,2965,"PODEMOS",81056
41,"41058",17304,12982,12751,133,231,"PODEMOS",1855
41,"41023",7919,5852,5788,34,64,"PODEMOS",718
41,"41045",5749,4121,4066,49,55,"PODEMOS",720
41,"41040",10411,7959,7892,53,67,"PODEMOS",1374
41,"41049",9301,7147,7070,63,77,"PODEMOS",1382
41,"41001",1597,1262,1248,5,14,"PODEMOS",257
41,"41083",1154,893,888,3,5,"PODEMOS",143
41,"41093",18487,14687,14594,117,93,"PODEMOS",2704
41,"41018",9490,6997,6930,45,67,"PODEMOS",1382
41,"41095",41137,28987,28731,302,256,"PODEMOS",4691
41,"41080",1270,954,938,8,16,"PODEMOS",98
41,"41043",636,439,435,3,4,"PODEMOS",55
41,"41054",688,587,570,2,17,"PODEMOS",94
41,"41003",2319,1782,1754,8,28,"PODEMOS",193
41,"41050",5158,4123,4078,37,45,"PODEMOS",584
41,"41072",4052,3115,3041,18,74,"PODEMOS",911
41,"41009",1229,811,803,5,8,"PODEMOS",85
41,"41007",12386,8552,8403,90,149,"PODEMOS",1602
41,"41020",12872,8820,8723,92,97,"PODEMOS",1093
41,"41085",4086,3223,3178,31,45,"PODEMOS",552
41,"41082",3432,2809,2781,12,28,"PODEMOS",262
41,"41903",6747,4926,4854,43,72,"PODEMOS",476
23,"23042",299,220,220,1,0,"AJU",0
23,"23099",4734,3509,3459,23,50,"AJU",10
23,"23055",47421,33170,32908,213,262,"AJU",49
23,"23021",528,452,448,0,4,"AJU",0
23,"23008",1518,1185,1173,18,12,"AJU",0
23,"23049",1834,1384,1378,7,6,"AJU",2
23,"23005",30539,21840,21629,176,211,"AJU",53
23,"23053",9526,6783,6736,49,47,"AJU",7
23,"23018",2326,1678,1668,5,10,"AJU",0
23,"23065",1601,1222,1207,0,15,"AJU",1
23,"23075",3319,2640,2618,21,22,"AJU",1
23,"23037",516,427,423,1,4,"AJU",0
23,"23096",2643,2174,2140,14,34,"AJU",3
23,"23072",2002,1593,1582,6,11,"AJU",6
23,"23058",8665,6651,6585,47,66,"AJU",9
23,"23071",1728,1337,1328,7,9,"AJU",2
23,"23902",2327,1877,1857,9,20,"AJU",1
23,"23076",837,672,658,4,14,"AJU",2
23,"23905",1861,1351,1345,7,6,"AJU",3
23,"23073",4558,3427,3402,11,25,"AJU",5
23,"23082",1924,1420,1413,6,7,"AJU",19
23,"23009",12866,9787,9667,64,120,"AJU",8
23,"23059",5856,4498,4450,33,48,"AJU",7
23,"23039",2220,1658,1626,8,32,"AJU",1
23,"23080",1786,1347,1329,6,18,"AJU",0
23,"23084",953,711,708,6,3,"AJU",0
23,"23048",860,636,630,1,6,"AJU",0
23,"23027",727,577,576,8,1,"AJU",0
23,"23064",1659,1368,1364,1,4,"AJU",1
23,"23030",1232,1020,1007,10,13,"AJU",0
23,"23004",435,350,346,0,4,"AJU",1
23,"23050",91221,67753,67164,549,589,"AJU",143
23,"23069",5385,4406,4318,15,88,"AJU",17
23,"23047",1638,1311,1306,9,5,"AJU",0
23,"23066",4376,3530,3508,46,22,"AJU",6
23,"23026",3636,2724,2685,11,39,"AJU",0
23,"23024",12512,9391,9182,79,209,"AJU",11
23,"23010",14371,10249,10140,65,109,"AJU",21
23,"23017",1584,1265,1253,4,12,"AJU",0
23,"23901",1160,978,972,5,6,"AJU",0
23,"23041",504,396,392,1,4,"AJU",10
23,"23062",1461,1188,1181,1,7,"AJU",0
23,"23903",3550,2742,2721,19,21,"AJU",0
23,"23011",2193,1616,1600,11,16,"AJU",4
23,"23054",382,276,275,0,1,"AJU",1
23,"23090",1316,1077,1071,8,6,"AJU",0
23,"23032",575,461,457,1,4,"AJU",0
23,"23015",1393,1061,1052,3,9,"AJU",1
23,"23016",396,323,318,3,5,"AJU",0
23,"23057",771,648,648,4,0,"AJU",0
23,"23091",742,609,607,5,2,"AJU",1
23,"23087",11313,8540,8454,64,86,"AJU",14
23,"23085",2273,1833,1814,3,19,"AJU",14
23,"23077",637,515,514,3,1,"AJU",0
23,"23014",2561,1982,1959,8,23,"AJU",1
23,"23007",3102,2381,2369,8,12,"AJU",35
23,"23006",4636,3761,3714,25,47,"AJU",6
23,"23052",1138,977,971,6,6,"AJU",0
23,"23033",1356,1080,1065,8,15,"AJU",1
23,"23035",1095,871,867,8,4,"AJU",0
23,"23101",388,281,279,0,2,"AJU",0
23,"23028",6203,4645,4585,33,60,"AJU",9
23,"23092",27765,20688,20560,143,128,"AJU",82
23,"23031",751,662,650,9,12,"AJU",0
23,"23051",2762,2258,2231,9,27,"AJU",1
23,"23043",549,401,400,0,1,"AJU",0
23,"23019",1562,1249,1227,4,22,"AJU",1
23,"23040",1489,1226,1211,4,15,"AJU",2
23,"23046",2405,1963,1934,3,29,"AJU",2
23,"23074",3030,2368,2353,12,15,"AJU",0
23,"23097",6445,4313,4290,30,23,"AJU",10
23,"23063",3845,2934,2898,24,36,"AJU",2
23,"23094",3852,3097,3061,17,36,"AJU",1
23,"23044",4847,3801,3740,26,61,"AJU",6
23,"23056",3108,2365,2343,14,22,"AJU",1
23,"23060",19157,13567,13438,133,129,"AJU",20
23,"23029",854,631,623,2,8,"AJU",1
23,"23079",3733,2994,2981,26,13,"AJU",20
23,"23067",2489,1869,1847,18,22,"AJU",1
23,"23045",2139,1560,1551,9,9,"AJU",0
23,"23904",2852,1784,1764,14,20,"AJU",5
23,"23012",4177,3016,2988,22,28,"AJU",1
23,"23025",2813,2186,2163,7,23,"AJU",2
23,"23020",1584,1376,1366,5,10,"AJU",1
23,"23086",11537,8362,8242,91,120,"AJU",13
23,"23038",3557,2851,2831,11,20,"AJU",0
23,"23002",17450,13199,12986,92,213,"AJU",16
23,"23034",2558,1987,1977,18,10,"AJU",0
23,"23061",7520,5481,5405,55,76,"AJU",1
23,"23098",875,728,722,2,6,"AJU",0
23,"23070",3931,2549,2533,11,16,"AJU",2
23,"23093",3257,2534,2506,21,28,"AJU",2
23,"23081",1546,1145,1132,6,13,"AJU",1
23,"23003",8709,6520,6440,42,80,"AJU",12
23,"23001",993,826,820,1,6,"AJU",0
23,"23088",6124,4764,4703,31,61,"AJU",2
23,"23095",8737,6303,6268,34,35,"AJU",8
25,"25148",220,155,153,0,2,"RECORTES CE",0
25,"25029",1662,1156,1147,13,9,"RECORTES CE",0
25,"25007",1410,1005,996,13,9,"RECORTES CE",3
25,"25208",316,191,189,1,2,"RECORTES CE",0
25,"25224",126,86,86,1,0,"RECORTES CE",0
25,"25074",182,145,141,0,4,"RECORTES CE",0
25,"25073",588,374,371,8,3,"RECORTES CE",0
25,"25111",115,83,83,1,0,"RECORTES CE",0
25,"25096",912,586,572,9,14,"RECORTES CE",0
25,"25146",224,150,148,2,2,"RECORTES CE",0
25,"25064",112,85,85,3,0,"RECORTES CE",0
25,"25231",490,382,382,2,0,"RECORTES CE",0
25,"25058",4378,2810,2793,27,17,"RECORTES CE",3
25,"25085",152,106,106,0,0,"RECORTES CE",0
25,"25070",817,584,573,14,11,"RECORTES CE",0
25,"25904",155,118,118,0,0,"RECORTES CE",0
25,"25013",2171,1380,1366,10,14,"RECORTES CE",2
25,"25142",368,252,251,3,1,"RECORTES CE",0
25,"25175",194,132,132,7,0,"RECORTES CE",1
25,"25022",106,76,76,2,0,"RECORTES CE",0
25,"25193",765,520,514,3,6,"RECORTES CE",0
25,"25136",98,71,70,0,1,"RECORTES CE",0
25,"25243",3612,2449,2423,30,26,"RECORTES CE",9
25,"25039",280,182,180,0,2,"RECORTES CE",1
25,"25242",732,480,477,4,3,"RECORTES CE",0
25,"25172",1805,1230,1214,8,16,"RECORTES CE",3
25,"25078",1007,720,717,6,3,"RECORTES CE",1
25,"25089",106,58,58,0,0,"RECORTES CE",0
25,"25254",738,507,493,6,14,"RECORTES CE",0
25,"25025",1346,966,956,10,10,"RECORTES CE",3
25,"25189",2106,1392,1381,16,11,"RECORTES CE",1
25,"25115",824,551,549,12,2,"RECORTES CE",0
25,"25255",426,308,302,4,6,"RECORTES CE",1
25,"25170",264,182,179,1,3,"RECORTES CE",0
25,"25027",1001,687,681,3,6,"RECORTES CE",0
25,"25163",228,143,142,5,1,"RECORTES CE",0
25,"25092",132,93,89,1,4,"RECORTES CE",0
25,"25031",52,31,31,0,0,"RECORTES CE",0
25,"25004",571,425,423,5,2,"RECORTES CE",0
25,"25139",479,325,324,3,1,"RECORTES CE",0
25,"25037",385,245,241,2,4,"RECORTES CE",0
25,"25901",292,186,181,4,5,"RECORTES CE",2
25,"25240",1407,1006,995,10,11,"RECORTES CE",1
25,"25191",332,225,222,3,3,"RECORTES CE",0
25,"25050",3253,2064,2048,27,16,"RECORTES CE",3
25,"25086",533,373,372,5,1,"RECORTES CE",2
25,"25207",6216,4062,4031,45,31,"RECORTES CE",7
25,"25134",635,418,414,4,4,"RECORTES CE",1
25,"25152",140,100,98,4,2,"RECORTES CE",0
25,"25001",139,88,87,1,1,"RECORTES CE",0
25,"25137",8577,5630,5591,45,39,"RECORTES CE",7
25,"25205",562,413,402,2,11,"RECORTES CE",1
25,"25061",82,53,53,0,0,"RECORTES CE",0
25,"25043",794,505,501,3,4,"RECORTES CE",1
25,"25135",1032,707,701,7,6,"RECORTES CE",2
25,"25253",163,125,124,0,1,"RECORTES CE",0
25,"25051",1522,990,983,10,7,"RECORTES CE",2
25,"25247",123,72,72,0,0,"RECORTES CE",0
25,"25101",565,393,388,9,5,"RECORTES CE",1
25,"25179",161,115,114,0,1,"RECORTES CE",0
25,"25045",52,36,36,0,0,"RECORTES CE",1
25,"25020",292,203,200,2,3,"RECORTES CE",1
25,"25053",1059,762,759,10,3,"RECORTES CE",0
25,"25154",120,68,68,1,0,"RECORTES CE",0
25,"25168",508,392,391,2,1,"RECORTES CE",0
25,"25129",176,113,110,6,3,"RECORTES CE",0
25,"25097",87,62,62,4,0,"RECORTES CE",0
25,"25023",4527,3111,3073,20,38,"RECORTES CE",3
25,"25164",381,264,262,2,2,"RECORTES CE",2
25,"25141",156,101,99,1,2,"RECORTES CE",0
25,"25903",237,154,152,3,2,"RECORTES CE",0
25,"25052",1573,1132,1122,16,10,"RECORTES CE",2
25,"25233",278,193,191,2,2,"RECORTES CE",1
25,"25119",2259,1582,1569,22,13,"RECORTES CE",0
25,"25056",243,151,150,2,1,"RECORTES CE",0
25,"25223",922,614,598,8,16,"RECORTES CE",3
25,"25221",130,76,76,0,0,"RECORTES CE",0
25,"25910",101,64,62,0,2,"RECORTES CE",0
25,"25124",169,118,116,2,2,"RECORTES CE",0
25,"25200",336,218,218,0,0,"RECORTES CE",0
25,"25911",452,301,299,7,2,"RECORTES CE",0
25,"25128",142,89,89,0,0,"RECORTES CE",0
25,"25006",346,214,212,6,2,"RECORTES CE",3
25,"25194",426,278,273,0,5,"RECORTES CE",2
25,"25167",236,158,156,3,2,"RECORTES CE",0
25,"25010",212,131,130,6,1,"RECORTES CE",0
25,"25094",139,111,109,0,2,"RECORTES CE",1
25,"25076",146,84,84,1,0,"RECORTES CE",0
25,"25071",51,31,31,0,0,"RECORTES CE",0
25,"25153",198,141,137,0,4,"RECORTES CE",0
25,"25014",254,177,174,4,3,"RECORTES CE",0
25,"25227",641,398,395,3,3,"RECORTES CE",0
25,"25217",10594,7016,6950,119,66,"RECORTES CE",9
25,"25055",172,118,116,2,2,"RECORTES CE",0
25,"25034",2331,1516,1505,20,11,"RECORTES CE",3
25,"25151",670,466,459,3,7,"RECORTES CE",0
25,"25011",5256,3190,3161,36,29,"RECORTES CE",4
25,"25202",101,72,72,0,0,"RECORTES CE",0
25,"25087",61,46,45,0,1,"RECORTES CE",0
25,"25133",713,469,464,1,5,"RECORTES CE",0
25,"25228",3043,2140,2118,21,22,"RECORTES CE",2
25,"25907",498,317,314,3,3,"RECORTES CE",0
25,"25017",239,160,159,2,1,"RECORTES CE",0
25,"25093",639,451,445,11,6,"RECORTES CE",0
25,"25209",1517,1035,1019,6,16,"RECORTES CE",4
25,"25909",155,89,89,3,0,"RECORTES CE",0
25,"25068",558,372,369,9,3,"RECORTES CE",0
25,"25248",891,622,616,3,6,"RECORTES CE",3
25,"25156",791,574,571,7,3,"RECORTES CE",3
25,"25079",305,216,214,5,2,"RECORTES CE",0
25,"25251",710,495,494,3,1,"RECORTES CE",2
25,"25239",608,320,319,1,1,"RECORTES CE",0
25,"25140",774,468,465,4,3,"RECORTES CE",2
25,"25230",1573,1100,1081,13,19,"RECORTES CE",0
25,"25082",280,169,167,3,2,"RECORTES CE",1
25,"25104",125,86,86,3,0,"RECORTES CE",2
25,"25210",1104,779,767,9,12,"RECORTES CE",1
25,"25099",1260,804,793,8,11,"RECORTES CE",1
25,"25060",70,45,45,2,0,"RECORTES CE",0
25,"25176",312,239,235,7,4,"RECORTES CE",0
25,"25131",412,271,261,8,10,"RECORTES CE",0
25,"25121",642,415,413,8,2,"RECORTES CE",3
25,"25102",712,473,467,10,6,"RECORTES CE",2
25,"25109",238,168,168,1,0,"RECORTES CE",1
25,"25057",206,152,151,2,1,"RECORTES CE",0
25,"25036",184,126,121,0,5,"RECORTES CE",1
25,"25033",1106,777,767,7,10,"RECORTES CE",1
25,"25072",5858,3878,3835,45,43,"RECORTES CE",14
25,"25127",212,135,134,3,1,"RECORTES CE",0
25,"25905",386,260,255,4,5,"RECORTES CE",0
25,"25030",131,86,86,2,0,"RECORTES CE",2
25,"25021",2618,1655,1639,32,16,"RECORTES CE",4
25,"25047",1010,730,722,6,8,"RECORTES CE",0
25,"25250",344,236,234,0,2,"RECORTES CE",0
25,"25113",1163,854,845,12,9,"RECORTES CE",0
25,"25067",730,483,479,4,4,"RECORTES CE",1
25,"25238",217,151,151,6,0,"RECORTES CE",0
25,"25044",189,136,136,3,0,"RECORTES CE",0
25,"25008",1135,828,819,11,9,"RECORTES CE",0
25,"25062",757,521,516,4,5,"RECORTES CE",0
25,"25232",1421,961,950,10,11,"RECORTES CE",1
25,"25059",801,590,584,11,6,"RECORTES CE",3
25,"25902",570,390,379,3,11,"RECORTES CE",0
25,"25192",767,510,496,11,14,"RECORTES CE",2
25,"25218",84,66,66,0,0,"RECORTES CE",0
25,"25244",369,252,248,3,4,"RECORTES CE",0
25,"25161",368,234,232,3,2,"RECORTES CE",0
25,"25012",2296,1504,1488,8,16,"RECORTES CE",8
25,"25114",97,87,87,0,0,"RECORTES CE",0
25,"25005",277,183,182,2,1,"RECORTES CE",0
25,"25169",188,125,124,3,1,"RECORTES CE",2
25,"25180",239,151,151,0,0,"RECORTES CE",0
25,"25063",91,55,55,0,0,"RECORTES CE",0
25,"25166",177,123,121,1,2,"RECORTES CE",0
25,"25252",548,399,398,6,1,"RECORTES CE",0
25,"25024",356,233,230,1,3,"RECORTES CE",0
25,"25009",631,465,460,3,5,"RECORTES CE",0
25,"25149",1382,1010,993,7,17,"RECORTES CE",1
25,"25110",2796,1828,1807,30,21,"RECORTES CE",5
25,"25190",263,195,195,4,0,"RECORTES CE",0
25,"25016",2114,1417,1411,8,6,"RECORTES CE",2
25,"25226",251,156,153,3,3,"RECORTES CE",0
25,"25173",1702,1180,1171,5,9,"RECORTES CE",1
25,"25185",681,421,418,8,3,"RECORTES CE",2
25,"25100",212,134,134,3,0,"RECORTES CE",0
25,"25181",177,138,137,5,1,"RECORTES CE",0
25,"25171",2190,1461,1444,4,17,"RECORTES CE",2
25,"25040",10532,6837,6762,81,75,"RECORTES CE",10
25,"25103",131,80,80,3,0,"RECORTES CE",0
25,"25003",3782,2390,2372,24,18,"RECORTES CE",0
25,"25234",4290,2645,2621,25,24,"RECORTES CE",6
25,"25212",234,173,171,1,2,"RECORTES CE",1
25,"25158",1639,1163,1150,26,13,"RECORTES CE",0
25,"25177",372,258,258,2,0,"RECORTES CE",0
25,"25186",214,141,138,2,3,"RECORTES CE",0
25,"25245",441,313,313,0,0,"RECORTES CE",1
25,"25211",683,427,422,4,5,"RECORTES CE",1
25,"25035",397,287,286,3,1,"RECORTES CE",0
25,"25120",92243,61433,61005,533,428,"RECORTES CE",155
25,"25075",117,82,82,0,0,"RECORTES CE",0
25,"25222",67,52,52,1,0,"RECORTES CE",0
25,"25069",453,289,286,6,3,"RECORTES CE",1
25,"25906",226,144,143,0,1,"RECORTES CE",1
25,"25165",280,194,190,4,4,"RECORTES CE",0
25,"25220",1028,709,701,9,8,"RECORTES CE",1
25,"25122",1916,1274,1264,15,10,"RECORTES CE",2
25,"25215",334,244,243,2,1,"RECORTES CE",0
25,"25183",501,332,331,4,1,"RECORTES CE",1
25,"25130",197,117,117,3,0,"RECORTES CE",0
25,"25105",130,95,93,4,2,"RECORTES CE",0
25,"25912",868,618,617,5,1,"RECORTES CE",3
25,"25015",355,258,257,3,1,"RECORTES CE",1
25,"25216",226,150,150,0,0,"RECORTES CE",0
25,"25196",119,74,74,0,0,"RECORTES CE",0
25,"25204",1241,843,827,3,16,"RECORTES CE",0
25,"25112",272,189,189,2,0,"RECORTES CE",1
25,"25203",8976,5588,5526,53,62,"RECORTES CE",10
25,"25225",575,395,393,6,2,"RECORTES CE",0
25,"25174",398,299,296,3,3,"RECORTES CE",0
25,"25219",144,106,105,3,1,"RECORTES CE",0
25,"25049",151,104,104,1,0,"RECORTES CE",0
25,"25145",85,64,64,2,0,"RECORTES CE",0
25,"25048",1644,1151,1138,8,13,"RECORTES CE",4
25,"25088",96,76,75,0,1,"RECORTES CE",0
25,"25126",286,214,210,5,4,"RECORTES CE",0
25,"25155",667,463,459,5,4,"RECORTES CE",1
25,"25032",61,44,43,0,1,"RECORTES CE",0
25,"25019",4565,3001,2965,36,36,"RECORTES CE",4
25,"25908",228,138,137,3,1,"RECORTES CE",0
25,"25201",115,70,67,0,3,"RECORTES CE",0
25,"25132",130,97,95,1,2,"RECORTES CE",0
25,"25182",1043,738,727,13,11,"RECORTES CE",3
25,"25077",460,272,269,2,3,"RECORTES CE",0
25,"25081",318,213,210,2,3,"RECORTES CE",0
25,"25125",424,279,273,4,6,"RECORTES CE",2
25,"25041",569,380,374,7,6,"RECORTES CE",1
25,"25206",257,164,164,3,0,"RECORTES CE",0
25,"25197",137,97,97,2,0,"RECORTES CE",2
25,"25002",484,323,321,2,2,"RECORTES CE",0
25,"25042",208,143,142,0,1,"RECORTES CE",0
25,"25098",253,163,160,2,3,"RECORTES CE",0
25,"25138",576,415,408,6,7,"RECORTES CE",1
25,"25046",421,292,286,1,6,"RECORTES CE",1
25,"25143",87,58,57,1,1,"RECORTES CE",0
25,"25913",87,69,69,1,0,"RECORTES CE",0
25,"25123",193,131,130,0,1,"RECORTES CE",0
25,"25157",181,139,137,1,2,"RECORTES CE",1
25,"25118",350,223,223,8,0,"RECORTES CE",2
25,"25249",183,118,118,2,0,"RECORTES CE",0
25,"25038",1564,1075,1062,11,13,"RECORTES CE",0
25,"25150",185,127,124,1,3,"RECORTES CE",2
52,"52001",53255,28182,27819,299,363,"UNIDAD POPU",363
48,"48055",2662,1961,1938,16,23,"PCPE",1
48,"48016",5260,3856,3827,22,29,"PCPE",2
48,"48086",2073,1519,1504,15,15,"PCPE",0
48,"48908",245,200,199,1,1,"PCPE",0
48,"48067",1161,837,834,2,3,"PCPE",0
48,"48072",974,728,723,5,5,"PCPE",0
48,"48085",10301,7458,7407,50,51,"PCPE",4
48,"48015",33690,24299,24160,168,139,"PCPE",16
48,"48071",6118,4467,4412,32,55,"PCPE",3
48,"48063",373,289,288,1,1,"PCPE",0
48,"48006",289,246,245,3,1,"PCPE",0
48,"48052",1559,1215,1211,0,4,"PCPE",0
48,"48022",2355,1476,1468,9,8,"PCPE",0
48,"48093",900,673,664,4,9,"PCPE",0
48,"48083",6950,5128,5097,33,31,"PCPE",3
48,"48905",2565,1882,1847,2,35,"PCPE",2
48,"48050",198,153,150,0,3,"PCPE",2
48,"48037",678,518,509,2,9,"PCPE",0
48,"48088",135,97,96,0,1,"PCPE",0
48,"48079",425,322,321,4,1,"PCPE",0
48,"48001",5832,4191,4166,37,25,"PCPE",4
48,"48023",594,470,468,4,2,"PCPE",0
48,"48033",215,160,159,0,1,"PCPE",0
48,"48904",3504,2671,2650,18,21,"PCPE",0
48,"48021",1352,952,946,8,6,"PCPE",2
48,"48007",365,241,239,0,2,"PCPE",0
48,"48065",3315,2447,2433,19,14,"PCPE",0
48,"48010",457,311,307,1,4,"PCPE",0
48,"48090",6022,4544,4483,23,61,"PCPE",3
48,"48030",608,454,453,4,1,"PCPE",0
48,"48906",775,579,574,0,5,"PCPE",1
48,"48031",340,245,242,0,3,"PCPE",0
48,"48907",355,283,282,2,1,"PCPE",0
48,"48039",243,201,201,2,0,"PCPE",0
48,"48915",362,238,238,2,0,"PCPE",0
48,"48041",704,558,555,4,3,"PCPE",0
48,"48087",429,346,343,1,3,"PCPE",0
48,"48028",715,553,551,4,2,"PCPE",0
48,"48043",4403,3214,3186,28,28,"PCPE",1
48,"48012",2041,1571,1553,11,18,"PCPE",0
48,"48029",8332,6155,6119,35,36,"PCPE",3
48,"48066",346,256,256,1,0,"PCPE",0
48,"48061",762,584,581,4,3,"PCPE",0
48,"48004",334,229,227,1,2,"PCPE",0
48,"48914",330,275,275,1,0,"PCPE",1
48,"48082",37673,27006,26811,201,195,"PCPE",26
48,"48019",3594,2569,2544,16,25,"PCPE",0
48,"48075",1975,1440,1421,12,19,"PCPE",2
48,"48008",617,433,424,6,9,"PCPE",0
48,"48073",6952,4476,4435,43,41,"PCPE",0
48,"48045",5149,3940,3885,35,55,"PCPE",1
48,"48060",3645,2277,2274,7,3,"PCPE",0
48,"48057",5749,4093,4081,20,12,"PCPE",0
48,"48026",1134,861,853,7,8,"PCPE",0
48,"48080",9971,7148,7086,71,62,"PCPE",4
48,"48076",314,237,237,4,0,"PCPE",1
48,"48032",5735,4173,4151,32,22,"PCPE",3
48,"48910",2948,2126,2115,17,11,"PCPE",0
48,"48096",6608,5071,5011,43,60,"PCPE",3
48,"48068",1551,1178,1163,16,15,"PCPE",0
48,"48009",786,614,609,3,5,"PCPE",0
48,"48014",1218,870,866,8,4,"PCPE",1
48,"48047",161,112,112,0,0,"PCPE",0
48,"48005",117,76,76,0,0,"PCPE",0
48,"48053",900,676,670,8,6,"PCPE",0
48,"48094",3193,2210,2200,18,10,"PCPE",0
48,"48051",220,169,168,0,1,"PCPE",0
48,"48912",2308,1787,1746,27,41,"PCPE",1
48,"48077",3367,2438,2423,17,15,"PCPE",0
48,"48054",24135,17493,17374,124,119,"PCPE",15
48,"48091",1134,821,812,7,9,"PCPE",0
48,"48078",38742,28064,27837,231,227,"PCPE",28
48,"48013",79984,56928,56516,383,412,"PCPE",52
48,"48089",3266,2425,2406,23,19,"PCPE",2
48,"48056",978,733,732,7,1,"PCPE",0
48,"48002",7851,5767,5713,41,54,"PCPE",3
48,"48097",1303,907,898,10,9,"PCPE",1
48,"48024",1003,775,771,5,4,"PCPE",0
48,"48035",412,313,312,4,1,"PCPE",1
48,"48903",1838,1400,1385,4,15,"PCPE",0
48,"48048",562,399,394,3,5,"PCPE",0
48,"48069",12765,8985,8910,58,75,"PCPE",1
48,"48018",875,553,553,3,0,"PCPE",0
48,"48025",883,642,639,3,3,"PCPE",1
48,"48064",603,463,459,7,4,"PCPE",0
48,"48017",13290,8908,8856,42,52,"PCPE",2
48,"48049",548,433,431,0,2,"PCPE",0
48,"48913",1251,933,917,13,16,"PCPE",0
48,"48092",837,619,619,13,0,"PCPE",1
48,"48074",3333,2467,2428,20,39,"PCPE",1
48,"48011",9692,6891,6843,56,48,"PCPE",4
48,"48042",1384,1111,1091,7,20,"PCPE",0
48,"48059",402,317,314,1,3,"PCPE",0
48,"48084",22577,15689,15540,108,149,"PCPE",8
48,"48062",300,241,240,1,1,"PCPE",0
48,"48020",274076,193807,192607,1471,1200,"PCPE",109
48,"48081",1883,1412,1398,12,14,"PCPE",0
48,"48034",12902,9684,9613,79,71,"PCPE",19
48,"48902",19124,13344,13227,93,117,"PCPE",18
48,"48040",1299,896,884,5,12,"PCPE",0
48,"48095",2352,1658,1647,6,11,"PCPE",0
48,"48003",14338,10497,10414,76,83,"PCPE",4
48,"48058",972,691,687,4,4,"PCPE",0
48,"48911",382,291,286,2,5,"PCPE",0
48,"48046",12617,9037,8967,56,70,"PCPE",1
48,"48027",22033,15929,15825,113,104,"PCPE",10
48,"48901",4775,3602,3573,35,29,"PCPE",0
48,"48044",62989,46989,46783,385,206,"PCPE",29
48,"48070",545,378,374,2,4,"PCPE",0
48,"48036",24144,17085,16954,117,131,"PCPE",8
48,"48909",207,165,165,1,0,"PCPE",0
48,"48038",1122,834,824,0,10,"PCPE",0
51,"51001",59213,33213,32720,413,493,"IU-UPeC",428
28,"28063",252,195,194,2,1,"X LA IZQUIE",0
28,"28143",70,59,59,1,0,"X LA IZQUIE",0
28,"28123",56464,47181,46948,257,233,"X LA IZQUIE",60
28,"28082",5664,4526,4492,25,34,"X LA IZQUIE",4
28,"28102",881,659,650,3,9,"X LA IZQUIE",1
28,"28159",588,469,468,6,1,"X LA IZQUIE",0
28,"28017",1210,954,943,6,11,"X LA IZQUIE",2
28,"28084",15839,12028,11925,53,103,"X LA IZQUIE",18
28,"28006",78564,61796,61456,334,340,"X LA IZQUIE",71
28,"28025",427,329,326,1,3,"X LA IZQUIE",0
28,"28061",21200,16698,16600,75,98,"X LA IZQUIE",24
28,"28901",789,590,584,2,6,"X LA IZQUIE",0
28,"28126",39,25,25,0,0,"X LA IZQUIE",0
28,"28053",6458,5299,5263,29,36,"X LA IZQUIE",5
28,"28151",3143,2352,2314,6,38,"X LA IZQUIE",1
28,"28003",181,141,141,3,0,"X LA IZQUIE",0
28,"28121",198,166,164,2,2,"X LA IZQUIE",0
28,"28136",640,540,532,0,8,"X LA IZQUIE",0
28,"28044",5766,4623,4584,22,39,"X LA IZQUIE",7
28,"28034",352,270,269,1,1,"X LA IZQUIE",0
28,"28057",1439,1125,1120,5,5,"X LA IZQUIE",3
28,"28122",518,388,385,2,3,"X LA IZQUIE",0
28,"28116",700,544,544,3,0,"X LA IZQUIE",2
28,"28027",1199,897,882,5,15,"X LA IZQUIE",0
28,"28036",2514,1974,1949,12,25,"X LA IZQUIE",0
28,"28037",1566,1175,1168,5,7,"X LA IZQUIE",1
28,"28120",1217,918,904,4,14,"X LA IZQUIE",1
28,"28079",2371327,1817203,1806970,9067,10233,"X LA IZQUIE",2202
28,"28101",218,180,180,0,0,"X LA IZQUIE",0
28,"28046",4432,3562,3538,19,24,"X LA IZQUIE",4
28,"28083",8880,6801,6759,47,42,"X LA IZQUIE",7
28,"28090",8405,6792,6751,34,41,"X LA IZQUIE",7
28,"28039",130,97,97,0,0,"X LA IZQUIE",0
28,"28009",14046,11014,10932,51,82,"X LA IZQUIE",10
28,"28171",4238,3002,2962,18,40,"X LA IZQUIE",1
28,"28043",5922,4063,4008,29,55,"X LA IZQUIE",6
28,"28145",2370,1824,1809,12,15,"X LA IZQUIE",2
28,"28161",48368,37462,37161,190,301,"X LA IZQUIE",66
28,"28107",435,326,321,0,5,"X LA IZQUIE",0
28,"28115",60579,50819,50657,246,162,"X LA IZQUIE",48
28,"28087",3176,2545,2528,15,17,"X LA IZQUIE",3
28,"28056",860,653,647,6,6,"X LA IZQUIE",2
28,"28074",138742,110456,109579,581,877,"X LA IZQUIE",204
28,"28162",2549,2039,2025,13,14,"X LA IZQUIE",2
28,"28165",1788,1332,1321,5,11,"X LA IZQUIE",0
28,"28096",18161,13784,13647,57,137,"X LA IZQUIE",27
28,"28148",85022,65597,65111,368,486,"X LA IZQUIE",116
28,"28902",468,352,347,2,5,"X LA IZQUIE",1
28,"28072",5657,4465,4441,20,24,"X LA IZQUIE",9
28,"28177",10192,8271,8234,51,37,"X LA IZQUIE",7
28,"28113",34305,27077,26881,156,196,"X LA IZQUIE",44
28,"28163",438,357,354,1,3,"X LA IZQUIE",1
28,"28020",148,99,97,1,2,"X LA IZQUIE",0
28,"28131",12971,9828,9755,57,73,"X LA IZQUIE",9
28,"28176",12288,9809,9763,50,46,"X LA IZQUIE",15
28,"28903",32480,27640,27525,161,115,"X LA IZQUIE",25
28,"28067",4057,3220,3188,12,32,"X LA IZQUIE",8
28,"28085",3908,3106,3078,7,28,"X LA IZQUIE",0
28,"28015",18233,14725,14653,81,72,"X LA IZQUIE",12
28,"28100",4169,3076,3048,12,28,"X LA IZQUIE",4
28,"28019",1237,952,938,2,14,"X LA IZQUIE",0
28,"28175",850,696,692,2,4,"X LA IZQUIE",0
28,"28180",5242,4040,3999,11,41,"X LA IZQUIE",3
28,"28007",124358,99423,98711,554,712,"X LA IZQUIE",152
28,"28070",119,91,91,0,0,"X LA IZQUIE",0
28,"28068",10928,8389,8315,43,74,"X LA IZQUIE",13
28,"28052",3883,2801,2758,18,43,"X LA IZQUIE",1
28,"28144",5929,4776,4744,29,32,"X LA IZQUIE",2
28,"28049",58688,48006,47660,286,346,"X LA IZQUIE",102
28,"28147",968,751,745,2,6,"X LA IZQUIE",1
28,"28160",8227,6295,6251,26,44,"X LA IZQUIE",8
28,"28023",4697,3835,3817,20,18,"X LA IZQUIE",5
28,"28092",151511,117869,116968,641,901,"X LA IZQUIE",218
28,"28174",1788,1277,1267,2,10,"X LA IZQUIE",2
28,"28158",662,545,543,3,2,"X LA IZQUIE",0
28,"28146",1773,1274,1262,9,12,"X LA IZQUIE",1
28,"28153",703,510,507,2,3,"X LA IZQUIE",0
28,"28066",7175,5598,5561,28,37,"X LA IZQUIE",6
28,"28108",3330,2536,2528,17,8,"X LA IZQUIE",2
28,"28060",1509,1194,1183,8,11,"X LA IZQUIE",3
28,"28152",16026,13269,13202,46,67,"X LA IZQUIE",11
28,"28001",64,48,48,3,0,"X LA IZQUIE",0
28,"28179",1441,1082,1071,7,11,"X LA IZQUIE",3
28,"28047",40783,31308,31072,171,236,"X LA IZQUIE",47
28,"28111",592,489,483,0,6,"X LA IZQUIE",0
28,"28042",1153,882,874,5,8,"X LA IZQUIE",3
28,"28031",2055,1538,1519,4,19,"X LA IZQUIE",0
28,"28054",11166,8649,8584,36,65,"X LA IZQUIE",10
28,"28005",134211,104575,103819,667,756,"X LA IZQUIE",214
28,"28080",48226,39753,39570,172,183,"X LA IZQUIE",35
28,"28013",40409,30141,29905,164,236,"X LA IZQUIE",32
28,"28026",6237,4893,4853,32,40,"X LA IZQUIE",7
28,"28014",32852,24749,24571,120,178,"X LA IZQUIE",30
28,"28010",9853,7959,7914,35,45,"X LA IZQUIE",9
28,"28021",544,387,387,2,0,"X LA IZQUIE",0
28,"28073",12505,9485,9384,64,101,"X LA IZQUIE",12
28,"28004",6179,4377,4345,15,32,"X LA IZQUIE",9
28,"28138",69,54,54,0,0,"X LA IZQUIE",0
28,"28150",3084,2415,2381,13,34,"X LA IZQUIE",4
28,"28076",406,322,319,1,3,"X LA IZQUIE",1
28,"28012",883,702,691,4,11,"X LA IZQUIE",3
28,"28055",899,682,676,4,6,"X LA IZQUIE",0
28,"28114",149,103,103,1,0,"X LA IZQUIE",0
28,"28048",499,406,401,2,5,"X LA IZQUIE",0
28,"28127",64513,53125,52932,300,193,"X LA IZQUIE",57
28,"28040",15691,10833,10728,45,105,"X LA IZQUIE",15
28,"28002",2966,2186,2175,9,11,"X LA IZQUIE",6
28,"28069",54,43,43,1,0,"X LA IZQUIE",0
28,"28093",2043,1681,1661,9,20,"X LA IZQUIE",3
28,"28128",439,323,320,2,3,"X LA IZQUIE",0
28,"28168",1226,910,900,1,10,"X LA IZQUIE",0
28,"28033",3824,2854,2832,11,22,"X LA IZQUIE",4
28,"28172",8965,7255,7219,44,36,"X LA IZQUIE",13
28,"28018",3739,3071,3046,12,25,"X LA IZQUIE",5
28,"28088",262,180,179,2,1,"X LA IZQUIE",3
28,"28038",4935,3858,3815,17,43,"X LA IZQUIE",4
28,"28059",4312,3256,3237,11,19,"X LA IZQUIE",7
28,"28030",1716,1342,1316,2,26,"X LA IZQUIE",1
28,"28095",1508,1177,1167,6,10,"X LA IZQUIE",1
28,"28125",2965,2210,2188,13,22,"X LA IZQUIE",6
28,"28086",5055,3627,3600,21,27,"X LA IZQUIE",7
28,"28140",2981,2383,2357,14,26,"X LA IZQUIE",3
28,"28132",11645,8605,8520,55,85,"X LA IZQUIE",17
28,"28051",1542,1240,1232,5,8,"X LA IZQUIE",3
28,"28173",520,409,408,3,1,"X LA IZQUIE",0
28,"28112",167,132,132,0,0,"X LA IZQUIE",0
28,"28117",95,84,84,0,0,"X LA IZQUIE",0
28,"28016",80,57,57,0,0,"X LA IZQUIE",0
28,"28035",1362,1042,1033,3,9,"X LA IZQUIE",2
28,"28022",32949,27473,27379,169,94,"X LA IZQUIE",24
28,"28097",124,85,84,1,1,"X LA IZQUIE",0
28,"28154",5420,3966,3899,17,67,"X LA IZQUIE",3
28,"28062",308,244,241,3,3,"X LA IZQUIE",0
28,"28141",5806,4532,4486,24,46,"X LA IZQUIE",5
28,"28129",7913,6175,6124,30,51,"X LA IZQUIE",6
28,"28169",1427,1164,1158,1,6,"X LA IZQUIE",0
28,"28032",4749,3653,3607,19,46,"X LA IZQUIE",6
28,"28155",507,420,420,0,0,"X LA IZQUIE",0
28,"28029",530,426,424,3,2,"X LA IZQUIE",1
28,"28135",971,740,735,4,5,"X LA IZQUIE",0
28,"28071",60,47,46,0,1,"X LA IZQUIE",0
28,"28156",998,751,743,3,8,"X LA IZQUIE",1
28,"28133",6002,4259,4204,12,55,"X LA IZQUIE",6
28,"28028",1730,1347,1326,8,21,"X LA IZQUIE",2
28,"28045",33019,25531,25313,146,218,"X LA IZQUIE",37
28,"28104",13836,11414,11349,54,65,"X LA IZQUIE",12
28,"28181",20344,16669,16572,95,97,"X LA IZQUIE",13
28,"28157",595,448,442,1,6,"X LA IZQUIE",0
28,"28075",5581,4380,4350,15,30,"X LA IZQUIE",2
28,"28149",5653,4516,4469,19,47,"X LA IZQUIE",3
28,"28058",139289,108214,107323,612,891,"X LA IZQUIE",230
28,"28109",1591,1113,1111,3,2,"X LA IZQUIE",1
28,"28178",1066,850,846,2,4,"X LA IZQUIE",2
28,"28170",2486,1757,1740,9,17,"X LA IZQUIE",2
28,"28094",825,636,634,3,2,"X LA IZQUIE",1
28,"28089",3703,2961,2933,19,28,"X LA IZQUIE",2
28,"28119",2074,1641,1625,9,16,"X LA IZQUIE",0
28,"28041",4452,3572,3550,24,22,"X LA IZQUIE",0
28,"28099",1731,1283,1278,8,5,"X LA IZQUIE",2
28,"28078",36,34,34,0,0,"X LA IZQUIE",0
28,"28137",1644,1301,1283,7,18,"X LA IZQUIE",1
28,"28064",134,105,105,0,0,"X LA IZQUIE",0
28,"28118",58,49,48,1,1,"X LA IZQUIE",0
28,"28167",8308,6605,6545,35,60,"X LA IZQUIE",10
28,"28134",60511,47566,47229,233,337,"X LA IZQUIE",76
28,"28011",445,339,338,0,1,"X LA IZQUIE",1
28,"28110",1949,1543,1525,2,18,"X LA IZQUIE",1
28,"28166",318,258,255,1,3,"X LA IZQUIE",1
28,"28130",28243,22649,22458,135,191,"X LA IZQUIE",40
28,"28106",76612,56555,56006,346,549,"X LA IZQUIE",161
28,"28065",125384,101604,100872,477,732,"X LA IZQUIE",146
28,"28091",5436,3827,3786,23,41,"X LA IZQUIE",5
28,"28008",1768,1293,1282,4,11,"X LA IZQUIE",0
28,"28024",152,129,128,1,1,"X LA IZQUIE",1
28,"28164",2986,2281,2263,12,18,"X LA IZQUIE",4
28,"28183",1050,770,763,2,7,"X LA IZQUIE",1
28,"28182",214,174,170,0,4,"X LA IZQUIE",0
28,"28124",76,56,54,0,2,"X LA IZQUIE",0
28,"28050",4077,3032,3006,15,26,"X LA IZQUIE",1
17,"17211",839,646,639,3,7,"ERC-CATSÍ",204
17,"17232",149,98,98,1,0,"ERC-CATSÍ",32
17,"17196",214,151,151,2,0,"ERC-CATSÍ",53
17,"17049",3125,2251,2233,7,18,"ERC-CATSÍ",788
17,"17022",6926,4626,4587,47,39,"ERC-CATSÍ",1371
17,"17204",562,385,384,7,1,"ERC-CATSÍ",81
17,"17223",807,528,520,6,8,"ERC-CATSÍ",131
17,"17130",328,246,245,2,1,"ERC-CATSÍ",80
17,"17125",129,88,86,0,2,"ERC-CATSÍ",33
17,"17150",1407,1074,1060,12,14,"ERC-CATSÍ",274
17,"17014",61,47,47,1,0,"ERC-CATSÍ",16
17,"17157",126,104,102,1,2,"ERC-CATSÍ",26
17,"17012",1142,763,757,6,6,"ERC-CATSÍ",192
17,"17068",245,173,172,0,1,"ERC-CATSÍ",44
17,"17043",158,119,117,1,2,"ERC-CATSÍ",22
17,"17195",338,256,251,2,5,"ERC-CATSÍ",111
17,"17149",363,267,264,0,3,"ERC-CATSÍ",109
17,"17117",14280,9297,9223,75,74,"ERC-CATSÍ",1829
17,"17031",172,109,109,3,0,"ERC-CATSÍ",37
17,"17215",2066,1588,1577,12,11,"ERC-CATSÍ",570
17,"17139",1382,972,963,9,9,"ERC-CATSÍ",256
17,"17088",535,372,369,0,3,"ERC-CATSÍ",147
17,"17148",1535,1056,1045,12,11,"ERC-CATSÍ",230
17,"17018",477,347,343,3,4,"ERC-CATSÍ",112
17,"17115",277,195,195,0,0,"ERC-CATSÍ",66
17,"17164",3996,2555,2543,23,12,"ERC-CATSÍ",721
17,"17078",330,225,225,5,0,"ERC-CATSÍ",57
17,"17082",410,273,268,3,5,"ERC-CATSÍ",50
17,"17227",128,95,95,0,0,"ERC-CATSÍ",45
17,"17086",1744,1181,1170,10,11,"ERC-CATSÍ",209
17,"17177",563,359,354,3,5,"ERC-CATSÍ",93
17,"17188",165,126,126,0,0,"ERC-CATSÍ",34
17,"17200",618,425,422,4,3,"ERC-CATSÍ",128
17,"17213",5372,3549,3517,17,32,"ERC-CATSÍ",682
17,"17027",2826,1993,1973,10,20,"ERC-CATSÍ",662
17,"17103",4942,3150,3129,19,21,"ERC-CATSÍ",485
17,"17019",1779,1279,1261,13,18,"ERC-CATSÍ",355
17,"17168",374,273,272,1,1,"ERC-CATSÍ",96
17,"17041",215,146,145,2,1,"ERC-CATSÍ",54
17,"17023",27347,18842,18610,118,232,"ERC-CATSÍ",2361
17,"17183",274,186,186,3,0,"ERC-CATSÍ",47
17,"17230",463,343,339,2,4,"ERC-CATSÍ",77
17,"17187",621,468,464,6,4,"ERC-CATSÍ",140
17,"17137",3411,2391,2369,15,22,"ERC-CATSÍ",823
17,"17004",510,371,368,0,3,"ERC-CATSÍ",120
17,"17175",579,366,360,4,6,"ERC-CATSÍ",63
17,"17010",330,247,246,5,1,"ERC-CATSÍ",88
17,"17109",693,443,435,2,8,"ERC-CATSÍ",141
17,"17036",2736,1857,1839,16,18,"ERC-CATSÍ",448
17,"17119",68,59,59,0,0,"ERC-CATSÍ",17
17,"17181",3380,2272,2251,15,21,"ERC-CATSÍ",513
17,"17039",1764,1229,1217,20,12,"ERC-CATSÍ",294
17,"17047",4837,2997,2973,39,24,"ERC-CATSÍ",612
17,"17081",244,165,163,0,2,"ERC-CATSÍ",48
17,"17074",507,345,341,1,4,"ERC-CATSÍ",78
17,"17214",706,471,468,4,3,"ERC-CATSÍ",142
17,"17158",464,284,281,0,3,"ERC-CATSÍ",60
17,"17185",2293,1547,1527,12,20,"ERC-CATSÍ",389
17,"17124",1638,1096,1083,10,13,"ERC-CATSÍ",288
17,"17079",64159,44230,43902,271,328,"ERC-CATSÍ",10229
17,"17207",2373,1691,1673,18,18,"ERC-CATSÍ",581
17,"17173",180,141,139,2,2,"ERC-CATSÍ",46
17,"17121",221,157,156,1,1,"ERC-CATSÍ",47
17,"17170",172,118,117,2,1,"ERC-CATSÍ",58
17,"17189",1524,1126,1114,4,12,"ERC-CATSÍ",395
17,"17903",897,647,638,0,9,"ERC-CATSÍ",191
17,"17182",262,191,191,2,0,"ERC-CATSÍ",18
17,"17159",627,439,434,2,5,"ERC-CATSÍ",106
17,"17205",212,166,166,2,0,"ERC-CATSÍ",59
17,"17011",646,463,462,7,1,"ERC-CATSÍ",159
17,"17101",543,364,362,3,2,"ERC-CATSÍ",72
17,"17021",135,86,86,2,0,"ERC-CATSÍ",19
17,"17099",80,60,59,0,1,"ERC-CATSÍ",12
17,"17152",10727,6804,6758,46,46,"ERC-CATSÍ",938
17,"17145",1488,1003,986,9,17,"ERC-CATSÍ",282
17,"17147",8112,5475,5422,43,53,"ERC-CATSÍ",1300
17,"17178",1063,690,685,5,5,"ERC-CATSÍ",214
17,"17016",724,519,515,8,4,"ERC-CATSÍ",169
17,"17071",1131,810,803,8,7,"ERC-CATSÍ",285
17,"17194",78,54,52,2,2,"ERC-CATSÍ",23
17,"17176",122,91,91,2,0,"ERC-CATSÍ",28
17,"17080",141,98,98,0,0,"ERC-CATSÍ",34
17,"17161",990,737,734,7,3,"ERC-CATSÍ",263
17,"17084",236,160,160,7,0,"ERC-CATSÍ",53
17,"17044",6767,4737,4694,36,43,"ERC-CATSÍ",1453
17,"17174",176,102,102,3,0,"ERC-CATSÍ",39
17,"17095",19593,12648,12554,81,94,"ERC-CATSÍ",1522
17,"17073",1875,1466,1460,11,6,"ERC-CATSÍ",458
17,"17092",3508,2373,2347,13,26,"ERC-CATSÍ",562
17,"17217",348,268,266,0,2,"ERC-CATSÍ",105
17,"17135",355,263,258,2,5,"ERC-CATSÍ",83
17,"17085",293,223,221,1,2,"ERC-CATSÍ",90
17,"17026",536,381,380,6,1,"ERC-CATSÍ",103
17,"17208",997,679,671,12,8,"ERC-CATSÍ",212
17,"17100",199,142,140,7,2,"ERC-CATSÍ",29
17,"17003",102,71,71,0,0,"ERC-CATSÍ",27
17,"17162",147,91,90,0,1,"ERC-CATSÍ",26
17,"17097",199,149,148,5,1,"ERC-CATSÍ",49
17,"17202",3803,2471,2449,13,22,"ERC-CATSÍ",536
17,"17228",295,211,210,1,1,"ERC-CATSÍ",53
17,"17008",3636,2423,2395,15,28,"ERC-CATSÍ",668
17,"17055",152,125,125,0,0,"ERC-CATSÍ",55
17,"17110",1325,953,945,5,8,"ERC-CATSÍ",175
17,"17136",175,133,132,1,1,"ERC-CATSÍ",24
17,"17034",6874,4509,4477,32,32,"ERC-CATSÍ",976
17,"17197",137,105,105,2,0,"ERC-CATSÍ",21
17,"17160",14740,9853,9795,68,58,"ERC-CATSÍ",1834
17,"17155",14500,9167,9080,43,87,"ERC-CATSÍ",1718
17,"17093",893,590,585,6,5,"ERC-CATSÍ",168
17,"17123",357,275,273,3,2,"ERC-CATSÍ",58
17,"17098",311,224,221,2,3,"ERC-CATSÍ",63
17,"17226",856,572,557,5,15,"ERC-CATSÍ",61
17,"17048",6269,4072,4044,24,28,"ERC-CATSÍ",559
17,"17029",203,131,131,2,0,"ERC-CATSÍ",38
17,"17112",192,141,139,1,2,"ERC-CATSÍ",28
17,"17180",8300,5429,5368,42,61,"ERC-CATSÍ",1540
17,"17209",625,480,477,2,3,"ERC-CATSÍ",131
17,"17144",210,141,141,2,0,"ERC-CATSÍ",44
17,"17129",137,99,99,1,0,"ERC-CATSÍ",36
17,"17062",5970,3695,3657,31,38,"ERC-CATSÍ",746
17,"17169",2475,1733,1724,11,9,"ERC-CATSÍ",428
17,"17234",183,124,124,1,0,"ERC-CATSÍ",41
17,"17102",576,397,395,4,2,"ERC-CATSÍ",131
17,"17146",2979,2030,2009,14,21,"ERC-CATSÍ",413
17,"17075",334,234,227,5,7,"ERC-CATSÍ",72
17,"17216",165,112,110,0,2,"ERC-CATSÍ",41
17,"17171",163,123,122,0,1,"ERC-CATSÍ",36
17,"17020",3590,2531,2510,28,21,"ERC-CATSÍ",877
17,"17013",2787,1941,1926,17,15,"ERC-CATSÍ",370
17,"17069",378,270,267,4,3,"ERC-CATSÍ",63
17,"17172",452,308,307,1,1,"ERC-CATSÍ",97
17,"17107",268,189,188,2,1,"ERC-CATSÍ",55
17,"17166",516,386,378,2,8,"ERC-CATSÍ",151
17,"17118",12824,8557,8477,57,80,"ERC-CATSÍ",1983
17,"17222",109,85,85,1,0,"ERC-CATSÍ",34
17,"17218",588,448,445,3,3,"ERC-CATSÍ",144
17,"17163",2609,1904,1890,18,14,"ERC-CATSÍ",648
17,"17091",411,282,273,5,9,"ERC-CATSÍ",89
17,"17221",4182,2882,2859,18,23,"ERC-CATSÍ",497
17,"17140",674,498,495,5,3,"ERC-CATSÍ",111
17,"17901",989,696,686,7,10,"ERC-CATSÍ",206
17,"17051",219,157,155,3,2,"ERC-CATSÍ",46
17,"17001",585,417,413,2,4,"ERC-CATSÍ",144
17,"17154",92,62,62,0,0,"ERC-CATSÍ",21
17,"17030",645,430,428,7,2,"ERC-CATSÍ",106
17,"17064",325,219,214,1,5,"ERC-CATSÍ",68
17,"17133",1268,887,877,6,10,"ERC-CATSÍ",266
17,"17038",369,255,253,2,2,"ERC-CATSÍ",70
17,"17201",128,93,92,1,1,"ERC-CATSÍ",28
17,"17116",348,243,240,4,3,"ERC-CATSÍ",79
17,"17192",145,108,108,1,0,"ERC-CATSÍ",14
17,"17224",314,214,213,3,1,"ERC-CATSÍ",66
17,"17193",4216,2807,2768,26,39,"ERC-CATSÍ",496
17,"17067",697,500,495,7,5,"ERC-CATSÍ",169
17,"17056",1706,1200,1193,10,7,"ERC-CATSÍ",334
17,"17165",653,445,443,2,2,"ERC-CATSÍ",118
17,"17106",139,108,106,0,2,"ERC-CATSÍ",33
17,"17094",1049,646,641,3,5,"ERC-CATSÍ",150
17,"17203",154,110,110,0,0,"ERC-CATSÍ",42
17,"17054",375,249,249,2,0,"ERC-CATSÍ",74
17,"17033",5293,3509,3476,28,33,"ERC-CATSÍ",754
17,"17087",222,169,169,3,0,"ERC-CATSÍ",46
17,"17153",186,140,140,0,0,"ERC-CATSÍ",51
17,"17105",255,170,170,2,0,"ERC-CATSÍ",59
17,"17076",123,90,88,2,2,"ERC-CATSÍ",23
17,"17009",4042,2770,2738,18,32,"ERC-CATSÍ",871
17,"17132",1311,923,913,10,10,"ERC-CATSÍ",225
17,"17015",12525,8550,8470,59,80,"ERC-CATSÍ",2707
17,"17198",430,282,281,4,1,"ERC-CATSÍ",71
17,"17061",162,119,119,1,0,"ERC-CATSÍ",39
17,"17120",792,530,518,3,12,"ERC-CATSÍ",125
17,"17143",146,109,107,1,2,"ERC-CATSÍ",25
17,"17024",279,176,176,2,0,"ERC-CATSÍ",38
17,"17066",26551,16275,16166,140,109,"ERC-CATSÍ",2932
17,"17037",104,65,65,0,0,"ERC-CATSÍ",17
17,"17050",649,499,495,3,4,"ERC-CATSÍ",203
17,"17114",23020,15151,15024,105,127,"ERC-CATSÍ",3849
17,"17190",842,592,590,10,2,"ERC-CATSÍ",188
17,"17046",719,499,492,2,7,"ERC-CATSÍ",166
17,"17063",166,115,113,0,2,"ERC-CATSÍ",44
17,"17005",401,263,260,5,3,"ERC-CATSÍ",73
17,"17134",234,163,161,2,2,"ERC-CATSÍ",44
17,"17128",302,224,223,4,1,"ERC-CATSÍ",63
17,"17007",1730,1235,1224,4,11,"ERC-CATSÍ",385
17,"17083",2935,2059,2042,17,17,"ERC-CATSÍ",396
17,"17052",124,83,83,1,0,"ERC-CATSÍ",25
17,"17212",139,108,106,1,2,"ERC-CATSÍ",33
17,"17096",178,115,114,0,1,"ERC-CATSÍ",38
17,"17057",960,708,699,8,9,"ERC-CATSÍ",236
17,"17058",180,132,131,1,1,"ERC-CATSÍ",47
17,"17902",1353,957,947,9,10,"ERC-CATSÍ",271
17,"17002",556,429,419,1,10,"ERC-CATSÍ",119
17,"17028",303,213,213,4,0,"ERC-CATSÍ",71
17,"17151",174,124,123,3,1,"ERC-CATSÍ",45
17,"17167",2697,1876,1852,24,24,"ERC-CATSÍ",514
17,"17184",1258,893,887,6,6,"ERC-CATSÍ",279
17,"17070",109,82,82,1,0,"ERC-CATSÍ",18
17,"17040",538,392,391,4,1,"ERC-CATSÍ",122
17,"17032",1713,1036,1020,13,16,"ERC-CATSÍ",311
17,"17089",5490,3630,3591,20,39,"ERC-CATSÍ",905
17,"17111",873,643,641,12,2,"ERC-CATSÍ",179
17,"17126",308,252,250,2,2,"ERC-CATSÍ",103
17,"17025",1124,834,827,3,7,"ERC-CATSÍ",279
17,"17035",544,400,399,4,1,"ERC-CATSÍ",122
17,"17065",335,250,249,2,1,"ERC-CATSÍ",87
17,"17138",944,668,663,4,5,"ERC-CATSÍ",133
17,"17225",213,142,142,1,0,"ERC-CATSÍ",71
17,"17199",6845,4527,4483,32,44,"ERC-CATSÍ",1240
17,"17142",2561,1962,1950,13,12,"ERC-CATSÍ",471
17,"17006",1131,730,728,9,2,"ERC-CATSÍ",194
17,"17060",424,277,274,3,3,"ERC-CATSÍ",80
17,"17206",141,89,87,0,2,"ERC-CATSÍ",26
17,"17077",555,386,383,5,3,"ERC-CATSÍ",91
17,"17220",811,563,555,3,8,"ERC-CATSÍ",194
17,"17186",3771,2742,2712,18,30,"ERC-CATSÍ",696
17,"17042",414,288,286,2,2,"ERC-CATSÍ",67
17,"17210",551,378,376,2,2,"ERC-CATSÍ",108
17,"17191",146,114,113,1,1,"ERC-CATSÍ",33
17,"17233",2287,1682,1664,21,18,"ERC-CATSÍ",447
17,"17141",5869,3688,3653,38,35,"ERC-CATSÍ",619
17,"17090",542,410,408,3,2,"ERC-CATSÍ",126
14,"14004",2036,1502,1488,6,14,"EB",2
14,"14015",2149,1637,1616,13,21,"EB",1
14,"14047",1654,1221,1211,17,10,"EB",1
14,"14023",2041,1742,1717,13,25,"EB",3
14,"14036",3767,2911,2857,53,54,"EB",1
14,"14061",756,606,592,2,14,"EB",1
14,"14033",1285,980,963,11,17,"EB",1
14,"14068",545,410,407,6,3,"EB",2
14,"14041",3180,2404,2373,26,31,"EB",0
14,"14071",937,651,642,2,9,"EB",0
14,"14006",1331,1166,1137,7,29,"EB",0
14,"14027",7908,6085,6008,57,77,"EB",8
14,"14055",18572,13587,13410,167,177,"EB",12
14,"14008",2871,2053,2034,11,19,"EB",0
14,"14014",2570,2104,2075,8,29,"EB",3
14,"14010",4051,3003,2968,17,35,"EB",1
14,"14043",7574,5571,5510,46,61,"EB",3
14,"14060",4854,3695,3633,43,62,"EB",4
14,"14026",2073,1437,1421,13,16,"EB",1
14,"14064",331,252,244,2,8,"EB",0
14,"14069",7536,5574,5495,48,79,"EB",6
14,"14050",2399,1886,1864,11,22,"EB",1
14,"14013",16845,12599,12414,146,185,"EB",12
14,"14029",4206,3170,3135,32,35,"EB",2
14,"14042",18921,14842,14653,184,189,"EB",26
14,"14063",1065,803,797,4,6,"EB",1
14,"14039",2628,2151,2123,11,28,"EB",4
14,"14051",1401,1095,1077,5,18,"EB",0
14,"14059",699,559,552,5,7,"EB",1
14,"14025",2950,2460,2425,10,35,"EB",3
14,"14049",16357,12206,12029,127,177,"EB",11
14,"14040",3792,3036,3010,23,26,"EB",7
14,"14018",3710,2882,2846,28,36,"EB",0
14,"14019",6479,5131,5076,46,55,"EB",11
14,"14007",15200,11064,10926,81,138,"EB",8
14,"14037",3344,2476,2442,20,34,"EB",1
14,"14017",10869,8130,8029,72,101,"EB",7
14,"14044",1624,1285,1267,9,18,"EB",0
14,"14075",581,463,446,6,17,"EB",0
14,"14012",6190,4574,4488,27,86,"EB",4
14,"14032",425,347,335,3,12,"EB",0
14,"14057",6152,4973,4903,56,70,"EB",8
14,"14009",2779,1941,1934,13,7,"EB",2
14,"14001",3552,2861,2830,28,31,"EB",1
14,"14016",1364,1047,1045,3,2,"EB",0
14,"14038",32236,22982,22773,209,209,"EB",36
14,"14054",13665,10923,10678,103,245,"EB",4
14,"14074",2303,1940,1929,13,11,"EB",1
14,"14022",4036,3199,3169,9,30,"EB",1
14,"14046",4484,3540,3487,22,53,"EB",1
14,"14048",1206,967,949,11,18,"EB",3
14,"14067",3874,3033,2986,29,47,"EB",1
14,"14035",5992,4475,4437,44,38,"EB",2
14,"14066",5890,4366,4322,29,44,"EB",7
14,"14024",1920,1522,1488,10,34,"EB",0
14,"14072",1079,834,830,5,4,"EB",0
14,"14058",7973,5860,5791,49,69,"EB",4
14,"14053",6050,4498,4427,56,71,"EB",2
14,"14034",318,260,252,2,8,"EB",0
14,"14005",6358,4379,4272,56,107,"EB",4
14,"14070",1343,1026,1008,9,18,"EB",0
14,"14011",584,477,476,3,1,"EB",0
14,"14045",3055,2486,2451,13,35,"EB",2
14,"14028",320,246,244,2,2,"EB",0
14,"14002",10951,8231,8150,72,81,"EB",3
14,"14030",8580,6619,6542,66,77,"EB",7
14,"14003",1265,981,970,6,11,"EB",0
14,"14021",260189,188939,187558,1934,1381,"EB",365
14,"14073",2900,2068,2041,15,27,"EB",3
14,"14062",1052,813,801,4,12,"EB",1
14,"14031",597,490,484,0,6,"EB",0
14,"14056",23613,17016,16804,128,212,"EB",14
14,"14020",391,278,274,3,4,"EB",0
14,"14052",9447,6250,6201,49,49,"EB",3
14,"14065",1861,1461,1446,12,15,"EB",2
7,"7038",2032,1515,1503,10,12,"RECORTES CE",0
7,"7004",3861,2657,2630,24,27,"RECORTES CE",2
7,"7009",749,552,550,1,2,"RECORTES CE",0
7,"7043",3422,2435,2410,13,25,"RECORTES CE",1
7,"7062",7539,4371,4312,40,59,"RECORTES CE",9
7,"7040",279737,181078,179570,1280,1508,"RECORTES CE",522
7,"7016",2786,1992,1969,30,23,"RECORTES CE",3
7,"7025",478,377,376,1,1,"RECORTES CE",1
7,"7049",1498,1080,1071,12,9,"RECORTES CE",2
7,"7036",26936,19563,19392,156,171,"RECORTES CE",59
7,"7020",3597,2652,2622,27,30,"RECORTES CE",5
7,"7031",23747,15538,15401,130,137,"RECORTES CE",34
7,"7008",5681,4203,4153,22,50,"RECORTES CE",14
7,"7029",4137,3088,3048,34,40,"RECORTES CE",5
7,"7014",7277,4301,4261,37,40,"RECORTES CE",8
7,"7006",5175,3559,3528,33,31,"RECORTES CE",5
7,"7053",1171,957,946,8,11,"RECORTES CE",4
7,"7051",5225,3322,3279,38,43,"RECORTES CE",4
7,"7052",4705,2993,2971,34,22,"RECORTES CE",7
7,"7010",4858,3518,3463,52,55,"RECORTES CE",10
7,"7013",6832,4879,4775,34,104,"RECORTES CE",6
7,"7034",991,774,765,2,9,"RECORTES CE",0
7,"7063",1420,1084,1072,8,12,"RECORTES CE",5
7,"7047",2236,1602,1584,7,18,"RECORTES CE",3
7,"7017",844,625,618,6,7,"RECORTES CE",3
7,"7902",1072,730,712,18,18,"RECORTES CE",2
7,"7059",2998,2119,2084,11,35,"RECORTES CE",4
7,"7001",3556,2682,2657,21,25,"RECORTES CE",3
7,"7060",2577,1825,1807,20,18,"RECORTES CE",3
7,"7033",27017,16370,16205,143,165,"RECORTES CE",42
7,"7901",611,476,469,6,7,"RECORTES CE",0
7,"7039",4880,3473,3412,27,61,"RECORTES CE",2
7,"7012",1877,1421,1408,13,13,"RECORTES CE",0
7,"7064",5361,3588,3546,20,42,"RECORTES CE",14
7,"7042",10666,7023,6967,59,56,"RECORTES CE",18
7,"7007",437,308,304,1,4,"RECORTES CE",2
7,"7028",892,617,611,2,6,"RECORTES CE",1
7,"7048",17339,10192,10101,104,91,"RECORTES CE",33
7,"7046",15649,9532,9443,70,89,"RECORTES CE",20
7,"7019",192,146,146,0,0,"RECORTES CE",0
7,"7032",20039,13156,13033,136,123,"RECORTES CE",31
7,"7058",2804,2138,2118,15,20,"RECORTES CE",4
7,"7027",20667,13784,13673,106,111,"RECORTES CE",21
7,"7002",6367,4466,4401,36,65,"RECORTES CE",4
7,"7003",11742,6924,6837,43,87,"RECORTES CE",7
7,"7045",1288,996,992,13,4,"RECORTES CE",3
7,"7022",11575,7827,7730,85,97,"RECORTES CE",19
7,"7056",5012,3632,3592,40,40,"RECORTES CE",10
7,"7035",1517,1188,1181,3,7,"RECORTES CE",1
7,"7015",21076,13304,13169,162,135,"RECORTES CE",25
7,"7055",7474,4796,4740,48,56,"RECORTES CE",11
7,"7021",234,188,188,0,0,"RECORTES CE",0
7,"7005",6659,4400,4357,23,43,"RECORTES CE",10
7,"7026",31158,18670,18537,161,133,"RECORTES CE",54
7,"7037",3232,1894,1881,16,13,"RECORTES CE",5
7,"7024",7019,3579,3544,39,35,"RECORTES CE",20
7,"7018",389,271,265,3,6,"RECORTES CE",0
7,"7061",9831,6618,6546,54,72,"RECORTES CE",13
7,"7057",7170,4736,4668,44,68,"RECORTES CE",5
7,"7050",3321,2161,2134,33,27,"RECORTES CE",4
7,"7030",1573,1151,1129,10,22,"RECORTES CE",3
7,"7011",27781,18282,18180,135,102,"RECORTES CE",35
7,"7023",3628,2611,2573,45,38,"RECORTES CE",1
7,"7044",8457,6079,5963,59,116,"RECORTES CE",10
7,"7041",2039,1566,1540,5,26,"RECORTES CE",1
7,"7065",2079,1462,1451,13,11,"RECORTES CE",0
7,"7054",22371,12930,12779,104,151,"RECORTES CE",20
24,"24157",2580,2013,1983,25,30,"PODEMOS",258
24,"24165",373,254,250,2,4,"PODEMOS",31
24,"24134",3465,2628,2583,27,45,"PODEMOS",417
24,"24201",1086,765,757,5,8,"PODEMOS",88
24,"24217",136,110,109,1,1,"PODEMOS",5
24,"24183",805,528,522,5,6,"PODEMOS",88
24,"24219",527,390,387,2,3,"PODEMOS",59
24,"24094",1392,1048,1038,11,10,"PODEMOS",174
24,"24026",1203,908,898,19,10,"PODEMOS",64
24,"24178",71,58,57,0,1,"PODEMOS",9
24,"24009",322,161,161,1,0,"PODEMOS",44
24,"24188",3843,2962,2899,48,63,"PODEMOS",412
24,"24152",462,302,301,2,1,"PODEMOS",39
24,"24176",318,244,243,5,1,"PODEMOS",16
24,"24179",299,202,201,8,1,"PODEMOS",31
24,"24074",99,77,76,1,1,"PODEMOS",6
24,"24056",2910,2102,2068,31,34,"PODEMOS",270
24,"24139",2186,1608,1570,24,38,"PODEMOS",166
24,"24166",1413,1043,1014,7,29,"PODEMOS",118
24,"24004",469,349,349,6,0,"PODEMOS",31
24,"24065",2106,1573,1545,16,28,"PODEMOS",240
24,"24202",8098,5654,5582,51,72,"PODEMOS",1386
24,"24108",377,279,273,3,6,"PODEMOS",20
24,"24159",1832,1407,1391,17,16,"PODEMOS",107
24,"24193",384,277,276,4,1,"PODEMOS",59
24,"24185",482,357,349,4,8,"PODEMOS",40
24,"24077",227,195,192,1,3,"PODEMOS",14
24,"24018",177,143,141,0,2,"PODEMOS",13
24,"24199",433,284,281,3,3,"PODEMOS",57
24,"24229",427,330,324,8,6,"PODEMOS",14
24,"24093",380,249,248,3,1,"PODEMOS",25
24,"24222",14249,10663,10532,119,131,"PODEMOS",2128
24,"24090",348,226,224,1,2,"PODEMOS",32
24,"24019",359,293,291,3,2,"PODEMOS",53
24,"24087",645,469,466,11,3,"PODEMOS",49
24,"24136",544,391,390,8,1,"PODEMOS",34
24,"24097",225,146,145,1,1,"PODEMOS",20
24,"24158",323,210,207,0,3,"PODEMOS",23
24,"24092",809,619,609,1,10,"PODEMOS",92
24,"24118",127,84,84,1,0,"PODEMOS",12
24,"24225",1020,786,773,6,13,"PODEMOS",115
24,"24025",300,233,228,0,5,"PODEMOS",14
24,"24029",754,545,539,2,6,"PODEMOS",129
24,"24046",953,662,645,6,17,"PODEMOS",84
24,"24109",996,667,652,7,15,"PODEMOS",116
24,"24171",364,219,217,1,2,"PODEMOS",37
24,"24084",162,119,119,1,0,"PODEMOS",7
24,"24021",1688,1213,1189,6,24,"PODEMOS",185
24,"24043",135,69,67,0,2,"PODEMOS",8
24,"24121",655,481,477,0,4,"PODEMOS",72
24,"24032",111,82,82,1,0,"PODEMOS",11
24,"24054",433,308,303,4,5,"PODEMOS",17
24,"24088",1037,804,797,8,7,"PODEMOS",98
24,"24073",481,343,340,3,3,"PODEMOS",44
24,"24030",4297,3226,3180,16,46,"PODEMOS",681
24,"24129",122,85,85,1,0,"PODEMOS",4
24,"24095",314,246,244,1,2,"PODEMOS",20
24,"24206",1732,1303,1288,8,15,"PODEMOS",209
24,"24100",769,569,561,4,8,"PODEMOS",115
24,"24076",1279,972,953,7,19,"PODEMOS",201
24,"24156",243,169,169,1,0,"PODEMOS",17
24,"24218",454,331,329,3,2,"PODEMOS",57
24,"24107",244,184,183,2,1,"PODEMOS",20
24,"24221",790,568,558,6,10,"PODEMOS",70
24,"24089",103315,77803,77038,779,765,"PODEMOS",12844
24,"24052",171,109,108,0,1,"PODEMOS",11
24,"24194",292,230,229,1,1,"PODEMOS",20
24,"24162",1671,1314,1303,21,11,"PODEMOS",233
24,"24071",1006,747,738,9,9,"PODEMOS",146
24,"24116",424,276,273,0,3,"PODEMOS",33
24,"24042",61,48,48,1,0,"PODEMOS",1
24,"24175",1825,1381,1372,13,9,"PODEMOS",227
24,"24127",301,239,239,3,0,"PODEMOS",23
24,"24012",297,212,211,4,1,"PODEMOS",21
24,"24153",233,173,172,3,1,"PODEMOS",23
24,"24066",504,367,361,3,6,"PODEMOS",37
24,"24034",3419,2596,2556,27,40,"PODEMOS",594
24,"24196",2082,1529,1513,15,16,"PODEMOS",325
24,"24141",98,76,75,0,1,"PODEMOS",5
24,"24003",652,442,435,5,7,"PODEMOS",33
24,"24016",478,287,285,1,2,"PODEMOS",23
24,"24142",25160,18503,18262,205,241,"PODEMOS",3699
24,"24227",1617,1146,1142,14,4,"PODEMOS",174
24,"24081",142,97,97,0,0,"PODEMOS",2
24,"24070",4159,3206,3162,31,44,"PODEMOS",732
24,"24213",158,117,117,0,0,"PODEMOS",5
24,"24017",582,434,433,9,1,"PODEMOS",50
24,"24173",943,678,673,3,5,"PODEMOS",61
24,"24168",461,383,379,4,4,"PODEMOS",43
24,"24051",433,308,307,1,1,"PODEMOS",32
24,"24160",692,506,498,2,8,"PODEMOS",77
24,"24167",763,509,504,9,5,"PODEMOS",72
24,"24149",155,123,121,0,2,"PODEMOS",7
24,"24010",8426,5980,5888,61,92,"PODEMOS",725
24,"24022",342,227,227,0,0,"PODEMOS",54
24,"24228",666,455,449,2,6,"PODEMOS",50
24,"24145",655,445,443,8,2,"PODEMOS",61
24,"24112",318,207,207,0,0,"PODEMOS",36
24,"24038",3107,2383,2354,30,29,"PODEMOS",559
24,"24191",111,84,84,1,0,"PODEMOS",7
24,"24211",276,210,206,4,4,"PODEMOS",12
24,"24901",908,660,653,4,7,"PODEMOS",122
24,"24062",142,105,105,1,0,"PODEMOS",17
24,"24207",296,245,241,3,4,"PODEMOS",33
24,"24119",702,491,480,6,11,"PODEMOS",93
24,"24031",216,169,167,1,2,"PODEMOS",15
24,"24197",770,545,537,6,8,"PODEMOS",55
24,"24131",742,499,497,5,2,"PODEMOS",52
24,"24133",350,259,258,3,1,"PODEMOS",23
24,"24005",387,267,259,6,8,"PODEMOS",21
24,"24223",2640,2012,2012,53,0,"PODEMOS",261
24,"24172",420,218,216,1,2,"PODEMOS",38
24,"24205",967,714,706,9,8,"PODEMOS",111
24,"24226",204,138,136,0,2,"PODEMOS",19
24,"24148",1684,1268,1256,9,12,"PODEMOS",146
24,"24120",345,214,214,1,0,"PODEMOS",34
24,"24049",1493,1152,1138,8,14,"PODEMOS",188
24,"24110",1253,932,926,7,6,"PODEMOS",201
24,"24080",218,170,162,3,8,"PODEMOS",21
24,"24189",6016,4187,4134,58,53,"PODEMOS",797
24,"24154",1010,750,729,7,21,"PODEMOS",108
24,"24214",669,492,490,1,2,"PODEMOS",65
24,"24155",478,380,371,0,9,"PODEMOS",52
24,"24039",2077,1604,1600,39,4,"PODEMOS",164
24,"24104",266,180,179,0,1,"PODEMOS",20
24,"24020",463,294,291,5,3,"PODEMOS",32
24,"24064",1525,1165,1151,10,14,"PODEMOS",286
24,"24187",876,642,631,6,11,"PODEMOS",68
24,"24061",1702,1244,1231,13,13,"PODEMOS",212
24,"24230",423,329,324,2,5,"PODEMOS",41
24,"24101",404,264,262,2,2,"PODEMOS",38
24,"24180",1128,825,814,12,11,"PODEMOS",84
24,"24040",453,315,309,2,6,"PODEMOS",48
24,"24161",291,218,212,2,6,"PODEMOS",36
24,"24106",258,178,173,1,5,"PODEMOS",10
24,"24079",922,654,645,9,9,"PODEMOS",79
24,"24002",236,182,180,3,2,"PODEMOS",12
24,"24099",173,133,133,2,0,"PODEMOS",22
24,"24015",2279,1693,1658,22,35,"PODEMOS",168
24,"24130",437,319,315,1,4,"PODEMOS",33
24,"24008",9319,6964,6852,77,112,"PODEMOS",906
24,"24137",1114,811,804,9,7,"PODEMOS",133
24,"24105",1443,1087,1065,10,22,"PODEMOS",169
24,"24122",1351,965,948,9,17,"PODEMOS",113
24,"24086",271,200,198,1,2,"PODEMOS",6
24,"24184",206,121,120,0,1,"PODEMOS",29
24,"24059",887,520,512,8,8,"PODEMOS",74
24,"24068",464,343,339,5,4,"PODEMOS",49
24,"24069",42,36,36,0,0,"PODEMOS",1
24,"24209",2790,1907,1884,15,23,"PODEMOS",329
24,"24083",1077,764,755,4,9,"PODEMOS",139
24,"24114",3107,2174,2155,7,19,"PODEMOS",391
24,"24215",156,119,118,1,1,"PODEMOS",7
24,"24163",3929,3076,3044,49,32,"PODEMOS",522
24,"24053",439,303,298,2,5,"PODEMOS",30
24,"24060",615,361,359,0,2,"PODEMOS",45
24,"24057",1366,1103,1076,11,27,"PODEMOS",187
24,"24216",732,533,522,2,11,"PODEMOS",42
24,"24036",301,181,180,0,1,"PODEMOS",28
24,"24182",420,289,287,6,2,"PODEMOS",40
24,"24902",354,273,272,2,1,"PODEMOS",21
24,"24170",1934,1436,1424,13,12,"PODEMOS",336
24,"24028",386,304,302,3,2,"PODEMOS",42
24,"24151",492,357,357,1,0,"PODEMOS",36
24,"24096",124,74,74,0,0,"PODEMOS",12
24,"24014",7474,5375,5321,56,54,"PODEMOS",1117
24,"24047",782,533,527,7,6,"PODEMOS",54
24,"24001",188,108,108,0,0,"PODEMOS",10
24,"24124",374,249,246,4,3,"PODEMOS",17
24,"24067",645,383,379,2,4,"PODEMOS",21
24,"24033",211,154,151,1,3,"PODEMOS",12
24,"24082",870,692,682,10,10,"PODEMOS",114
24,"24058",205,137,134,0,3,"PODEMOS",8
24,"24174",495,362,357,3,5,"PODEMOS",51
24,"24123",757,499,497,4,2,"PODEMOS",56
24,"24212",1029,784,774,7,10,"PODEMOS",85
24,"24177",481,328,327,1,1,"PODEMOS",35
24,"24150",243,175,175,3,0,"PODEMOS",28
24,"24102",655,495,492,2,3,"PODEMOS",55
24,"24164",373,190,190,1,0,"PODEMOS",24
24,"24041",548,384,381,5,3,"PODEMOS",59
24,"24181",1519,1135,1117,10,18,"PODEMOS",71
24,"24113",366,282,275,3,7,"PODEMOS",13
24,"24037",369,251,251,0,0,"PODEMOS",37
24,"24144",704,487,478,5,9,"PODEMOS",62
24,"24169",2976,2256,2236,12,20,"PODEMOS",564
24,"24006",488,351,342,4,9,"PODEMOS",28
24,"24132",628,397,390,6,7,"PODEMOS",66
24,"24143",514,391,379,4,12,"PODEMOS",79
24,"24210",510,347,347,0,0,"PODEMOS",56
24,"24117",446,333,331,2,2,"PODEMOS",21
24,"24203",96,73,72,1,1,"PODEMOS",5
24,"24190",167,115,115,2,0,"PODEMOS",7
24,"24063",391,260,259,1,1,"PODEMOS",14
24,"24198",602,411,402,4,9,"PODEMOS",48
24,"24044",171,125,118,0,7,"PODEMOS",17
24,"24091",657,440,437,2,3,"PODEMOS",78
24,"24027",1214,881,860,8,21,"PODEMOS",188
24,"24024",695,496,494,4,2,"PODEMOS",66
24,"24023",268,189,188,2,1,"PODEMOS",0
24,"24115",54290,39886,39486,325,400,"PODEMOS",9623
24,"24078",388,286,284,4,2,"PODEMOS",44
24,"24224",621,452,445,7,7,"PODEMOS",60
24,"24011",209,113,112,0,1,"PODEMOS",9
24,"24050",102,77,77,1,0,"PODEMOS",3
24,"24103",292,160,160,1,0,"PODEMOS",10
24,"24055",705,510,507,6,3,"PODEMOS",47
24,"24125",475,285,282,2,3,"PODEMOS",31
24,"24007",764,578,576,3,2,"PODEMOS",142
24,"24146",271,195,194,0,1,"PODEMOS",21
24,"24098",1205,880,874,8,6,"PODEMOS",168
50,"50183",338,255,255,0,0,"IU-CHA-UPeC",3
50,"50032",273,190,189,0,1,"IU-CHA-UPeC",30
50,"50164",395,263,260,2,3,"IU-CHA-UPeC",16
50,"50256",84,46,46,0,0,"IU-CHA-UPeC",3
50,"50142",30,21,21,0,0,"IU-CHA-UPeC",8
50,"50280",340,260,258,0,2,"IU-CHA-UPeC",15
50,"50275",110,73,72,0,1,"IU-CHA-UPeC",0
50,"50147",788,577,576,4,1,"IU-CHA-UPeC",23
50,"50146",190,137,137,5,0,"IU-CHA-UPeC",4
50,"50129",245,164,164,1,0,"IU-CHA-UPeC",4
50,"50083",90,72,72,1,0,"IU-CHA-UPeC",0
50,"50069",76,53,52,0,1,"IU-CHA-UPeC",3
50,"50182",3352,2437,2409,26,28,"IU-CHA-UPeC",200
50,"50044",232,156,156,1,0,"IU-CHA-UPeC",16
50,"50228",270,211,210,5,1,"IU-CHA-UPeC",2
50,"50162",147,110,110,2,0,"IU-CHA-UPeC",8
50,"50248",521,407,406,1,1,"IU-CHA-UPeC",29
50,"50089",8144,6285,6249,50,36,"IU-CHA-UPeC",274
50,"50262",1187,931,930,13,1,"IU-CHA-UPeC",106
50,"50234",245,198,193,9,5,"IU-CHA-UPeC",11
50,"50167",232,194,193,0,1,"IU-CHA-UPeC",7
50,"50048",35,23,23,0,0,"IU-CHA-UPeC",1
50,"50177",315,251,249,3,2,"IU-CHA-UPeC",4
50,"50225",1568,996,985,2,11,"IU-CHA-UPeC",29
50,"50067",14055,10236,10109,123,127,"IU-CHA-UPeC",526
50,"50227",108,79,79,1,0,"IU-CHA-UPeC",3
50,"50260",35,32,32,0,0,"IU-CHA-UPeC",0
50,"50065",53,42,42,0,0,"IU-CHA-UPeC",4
50,"50258",56,34,34,1,0,"IU-CHA-UPeC",0
50,"50253",423,328,327,1,1,"IU-CHA-UPeC",19
50,"50033",75,65,65,0,0,"IU-CHA-UPeC",8
50,"50095",12366,8938,8856,94,82,"IU-CHA-UPeC",501
50,"50061",207,174,168,1,6,"IU-CHA-UPeC",2
50,"50271",256,187,184,4,3,"IU-CHA-UPeC",4
50,"50229",64,42,42,0,0,"IU-CHA-UPeC",2
50,"50169",362,264,262,0,2,"IU-CHA-UPeC",12
50,"50034",838,572,569,5,3,"IU-CHA-UPeC",21
50,"50261",215,159,159,1,0,"IU-CHA-UPeC",11
50,"50047",50,32,32,1,0,"IU-CHA-UPeC",5
50,"50199",341,242,241,4,1,"IU-CHA-UPeC",10
50,"50277",55,43,43,1,0,"IU-CHA-UPeC",7
50,"50139",319,239,238,2,1,"IU-CHA-UPeC",5
50,"50195",53,38,38,0,0,"IU-CHA-UPeC",3
50,"50241",593,426,418,1,8,"IU-CHA-UPeC",8
50,"50231",260,213,210,7,3,"IU-CHA-UPeC",9
50,"50072",174,124,122,2,2,"IU-CHA-UPeC",5
50,"50105",304,228,228,3,0,"IU-CHA-UPeC",3
50,"50041",12,10,10,0,0,"IU-CHA-UPeC",0
50,"50040",92,75,75,0,0,"IU-CHA-UPeC",1
50,"50264",158,111,111,0,0,"IU-CHA-UPeC",10
50,"50066",2613,1956,1951,21,5,"IU-CHA-UPeC",99
50,"50291",100,69,69,0,0,"IU-CHA-UPeC",2
50,"50042",16,13,13,0,0,"IU-CHA-UPeC",1
50,"50100",333,263,261,5,2,"IU-CHA-UPeC",8
50,"50175",1025,745,739,6,6,"IU-CHA-UPeC",54
50,"50134",128,88,88,5,0,"IU-CHA-UPeC",5
50,"50046",176,123,123,7,0,"IU-CHA-UPeC",4
50,"50263",197,123,121,6,2,"IU-CHA-UPeC",3
50,"50201",443,335,330,2,5,"IU-CHA-UPeC",7
50,"50283",72,55,54,0,1,"IU-CHA-UPeC",0
50,"50054",59,45,45,0,0,"IU-CHA-UPeC",6
50,"50166",260,192,189,2,3,"IU-CHA-UPeC",22
50,"50064",440,350,349,5,1,"IU-CHA-UPeC",9
50,"50039",507,400,398,3,2,"IU-CHA-UPeC",22
50,"50050",98,59,59,3,0,"IU-CHA-UPeC",8
50,"50198",56,30,30,0,0,"IU-CHA-UPeC",1
50,"50012",108,86,83,1,3,"IU-CHA-UPeC",7
50,"50002",148,105,102,0,3,"IU-CHA-UPeC",0
50,"50132",755,573,564,7,9,"IU-CHA-UPeC",20
50,"50222",1647,1135,1118,8,17,"IU-CHA-UPeC",42
50,"50165",1815,1333,1316,27,17,"IU-CHA-UPeC",41
50,"50104",351,283,282,3,1,"IU-CHA-UPeC",15
50,"50013",224,187,186,3,1,"IU-CHA-UPeC",5
50,"50284",151,115,113,0,2,"IU-CHA-UPeC",1
50,"50150",660,402,402,3,0,"IU-CHA-UPeC",17
50,"50223",915,747,741,8,6,"IU-CHA-UPeC",20
50,"50172",196,138,136,0,2,"IU-CHA-UPeC",2
50,"50202",158,96,92,1,4,"IU-CHA-UPeC",2
50,"50075",81,59,59,1,0,"IU-CHA-UPeC",0
50,"50108",47,37,37,0,0,"IU-CHA-UPeC",0
50,"50295",45,39,39,0,0,"IU-CHA-UPeC",4
50,"50079",254,186,184,3,2,"IU-CHA-UPeC",9
50,"50059",780,572,567,6,5,"IU-CHA-UPeC",30
50,"50014",146,99,99,1,0,"IU-CHA-UPeC",5
50,"50130",395,252,252,1,0,"IU-CHA-UPeC",15
50,"50203",1043,811,802,15,9,"IU-CHA-UPeC",52
50,"50255",214,163,163,0,0,"IU-CHA-UPeC",4
50,"50096",39,17,17,0,0,"IU-CHA-UPeC",0
50,"50285",648,473,469,3,4,"IU-CHA-UPeC",27
50,"50197",92,71,71,2,0,"IU-CHA-UPeC",3
50,"50232",171,120,118,0,2,"IU-CHA-UPeC",5
50,"50173",210,141,140,2,1,"IU-CHA-UPeC",7
50,"50141",114,85,84,0,1,"IU-CHA-UPeC",1
50,"50160",2245,1661,1648,10,13,"IU-CHA-UPeC",60
50,"50170",378,286,283,2,3,"IU-CHA-UPeC",10
50,"50035",74,53,52,0,1,"IU-CHA-UPeC",13
50,"50224",69,55,55,1,0,"IU-CHA-UPeC",2
50,"50194",84,52,52,0,0,"IU-CHA-UPeC",1
50,"50109",105,78,77,3,1,"IU-CHA-UPeC",1
50,"50015",98,63,63,0,0,"IU-CHA-UPeC",2
50,"50098",181,129,127,2,2,"IU-CHA-UPeC",6
50,"50174",92,70,70,0,0,"IU-CHA-UPeC",2
50,"50205",91,69,65,1,4,"IU-CHA-UPeC",4
50,"50077",226,175,174,5,1,"IU-CHA-UPeC",3
50,"50087",28,19,19,0,0,"IU-CHA-UPeC",0
50,"50236",104,82,82,2,0,"IU-CHA-UPeC",0
50,"50006",939,712,701,8,11,"IU-CHA-UPeC",40
50,"50154",119,92,91,0,1,"IU-CHA-UPeC",3
50,"50016",52,37,37,0,0,"IU-CHA-UPeC",5
50,"50254",181,130,129,2,1,"IU-CHA-UPeC",3
50,"50192",236,185,183,2,2,"IU-CHA-UPeC",8
50,"50287",274,197,195,4,2,"IU-CHA-UPeC",8
50,"50099",3087,2233,2216,15,17,"IU-CHA-UPeC",62
50,"50043",257,172,171,1,1,"IU-CHA-UPeC",11
50,"50237",103,73,73,2,0,"IU-CHA-UPeC",2
50,"50257",178,139,137,0,2,"IU-CHA-UPeC",21
50,"50206",466,379,376,2,3,"IU-CHA-UPeC",14
50,"50133",117,88,88,3,0,"IU-CHA-UPeC",1
50,"50288",3371,2566,2547,26,19,"IU-CHA-UPeC",127
50,"50140",165,106,106,0,0,"IU-CHA-UPeC",3
50,"50265",62,41,41,0,0,"IU-CHA-UPeC",3
50,"50037",139,92,91,1,1,"IU-CHA-UPeC",0
50,"50111",186,152,151,1,1,"IU-CHA-UPeC",2
50,"50007",46,37,37,1,0,"IU-CHA-UPeC",3
50,"50196",108,83,82,1,1,"IU-CHA-UPeC",5
50,"50017",1772,1301,1293,7,8,"IU-CHA-UPeC",86
50,"50038",1511,1167,1159,13,8,"IU-CHA-UPeC",86
50,"50238",97,74,73,0,1,"IU-CHA-UPeC",1
50,"50235",2323,1687,1675,7,12,"IU-CHA-UPeC",75
50,"50008",5085,3617,3574,30,43,"IU-CHA-UPeC",366
50,"50163",3655,2766,2740,34,26,"IU-CHA-UPeC",217
50,"50004",534,406,401,0,5,"IU-CHA-UPeC",23
50,"50296",398,297,293,2,4,"IU-CHA-UPeC",20
50,"50063",61,57,57,0,0,"IU-CHA-UPeC",1
50,"50070",60,29,29,1,0,"IU-CHA-UPeC",1
50,"50266",129,85,85,1,0,"IU-CHA-UPeC",3
50,"50080",32,25,25,0,0,"IU-CHA-UPeC",3
50,"50239",64,47,47,1,0,"IU-CHA-UPeC",0
50,"50018",948,717,712,6,5,"IU-CHA-UPeC",25
50,"50019",54,41,41,0,0,"IU-CHA-UPeC",1
50,"50114",124,94,94,2,0,"IU-CHA-UPeC",2
50,"50005",234,178,178,1,0,"IU-CHA-UPeC",4
50,"50178",302,197,196,9,1,"IU-CHA-UPeC",8
50,"50135",95,63,63,0,0,"IU-CHA-UPeC",0
50,"50102",863,665,654,6,11,"IU-CHA-UPeC",26
50,"50230",1176,853,849,11,4,"IU-CHA-UPeC",31
50,"50009",106,78,77,1,1,"IU-CHA-UPeC",1
50,"50290",387,288,287,4,1,"IU-CHA-UPeC",8
50,"50078",244,192,189,1,3,"IU-CHA-UPeC",2
50,"50110",369,258,257,0,1,"IU-CHA-UPeC",5
50,"50209",2560,1787,1774,12,13,"IU-CHA-UPeC",76
50,"50168",28,23,23,0,0,"IU-CHA-UPeC",2
50,"50092",298,256,251,3,5,"IU-CHA-UPeC",6
50,"50240",1034,749,737,10,12,"IU-CHA-UPeC",32
50,"50159",670,511,501,5,10,"IU-CHA-UPeC",18
50,"50010",69,57,57,0,0,"IU-CHA-UPeC",0
50,"50115",3248,2277,2262,31,15,"IU-CHA-UPeC",72
50,"50179",257,207,207,2,0,"IU-CHA-UPeC",3
50,"50052",90,71,71,0,0,"IU-CHA-UPeC",0
50,"50210",40,32,31,0,1,"IU-CHA-UPeC",3
50,"50082",89,58,57,0,1,"IU-CHA-UPeC",0
50,"50137",1025,793,786,6,7,"IU-CHA-UPeC",18
50,"50021",32,25,25,3,0,"IU-CHA-UPeC",2
50,"50148",324,240,236,0,4,"IU-CHA-UPeC",16
50,"50292",132,103,103,0,0,"IU-CHA-UPeC",3
50,"50073",2148,1649,1622,9,27,"IU-CHA-UPeC",97
50,"50252",5178,3746,3711,36,35,"IU-CHA-UPeC",153
50,"50113",618,506,496,4,10,"IU-CHA-UPeC",19
50,"50011",127,96,96,2,0,"IU-CHA-UPeC",5
50,"50149",36,23,23,0,0,"IU-CHA-UPeC",0
50,"50259",89,61,61,1,0,"IU-CHA-UPeC",1
50,"50101",879,615,609,5,6,"IU-CHA-UPeC",36
50,"50138",46,41,41,0,0,"IU-CHA-UPeC",3
50,"50211",252,187,186,0,1,"IU-CHA-UPeC",12
50,"50293",423,282,280,5,2,"IU-CHA-UPeC",21
50,"50117",125,91,90,1,1,"IU-CHA-UPeC",7
50,"50074",6397,4512,4408,38,104,"IU-CHA-UPeC",241
50,"50273",31,18,18,0,0,"IU-CHA-UPeC",1
50,"50191",476,327,325,3,2,"IU-CHA-UPeC",15
50,"50106",135,105,104,0,1,"IU-CHA-UPeC",3
50,"50212",41,37,37,0,0,"IU-CHA-UPeC",0
50,"50022",543,410,398,8,12,"IU-CHA-UPeC",8
50,"50171",108,70,69,0,1,"IU-CHA-UPeC",2
50,"50274",71,50,49,1,1,"IU-CHA-UPeC",0
50,"50118",2179,1575,1564,7,11,"IU-CHA-UPeC",90
50,"50136",579,420,413,0,7,"IU-CHA-UPeC",6
50,"50233",114,81,81,1,0,"IU-CHA-UPeC",1
50,"50023",223,175,173,3,2,"IU-CHA-UPeC",3
50,"50107",944,772,767,16,5,"IU-CHA-UPeC",40
50,"50294",73,58,58,0,0,"IU-CHA-UPeC",1
50,"50003",126,93,92,3,1,"IU-CHA-UPeC",4
50,"50244",205,157,157,3,0,"IU-CHA-UPeC",5
50,"50085",176,131,129,3,2,"IU-CHA-UPeC",4
50,"50213",98,77,72,0,5,"IU-CHA-UPeC",0
50,"50024",589,461,459,4,2,"IU-CHA-UPeC",13
50,"50086",184,128,128,1,0,"IU-CHA-UPeC",14
50,"50055",3612,2533,2490,34,43,"IU-CHA-UPeC",173
50,"50151",650,504,503,7,1,"IU-CHA-UPeC",15
50,"50152",1457,1032,1018,11,14,"IU-CHA-UPeC",29
50,"50119",930,698,691,7,7,"IU-CHA-UPeC",9
50,"50056",406,325,324,2,1,"IU-CHA-UPeC",11
50,"50245",90,60,60,1,0,"IU-CHA-UPeC",2
50,"50193",647,514,506,1,8,"IU-CHA-UPeC",38
50,"50045",1255,944,934,6,10,"IU-CHA-UPeC",37
50,"50053",688,535,522,6,13,"IU-CHA-UPeC",19
50,"50076",81,64,64,0,0,"IU-CHA-UPeC",3
50,"50204",2457,1830,1816,14,14,"IU-CHA-UPeC",97
50,"50242",92,81,79,1,2,"IU-CHA-UPeC",9
50,"50131",237,168,167,2,1,"IU-CHA-UPeC",7
50,"50153",941,737,734,7,3,"IU-CHA-UPeC",26
50,"50184",113,82,82,0,0,"IU-CHA-UPeC",1
50,"50214",27,16,16,1,0,"IU-CHA-UPeC",2
50,"50025",4547,3335,3295,45,40,"IU-CHA-UPeC",183
50,"50246",41,29,29,0,0,"IU-CHA-UPeC",0
50,"50120",49,36,36,3,0,"IU-CHA-UPeC",1
50,"50121",276,227,225,4,2,"IU-CHA-UPeC",9
50,"50276",129,108,107,0,1,"IU-CHA-UPeC",11
50,"50036",103,79,79,0,0,"IU-CHA-UPeC",3
50,"50057",1396,980,972,8,8,"IU-CHA-UPeC",42
50,"50026",442,358,353,6,5,"IU-CHA-UPeC",16
50,"50068",1998,1388,1378,17,10,"IU-CHA-UPeC",30
50,"50088",305,234,229,11,5,"IU-CHA-UPeC",9
50,"50243",340,259,254,1,5,"IU-CHA-UPeC",3
50,"50058",72,51,51,0,0,"IU-CHA-UPeC",3
50,"50267",605,424,420,4,4,"IU-CHA-UPeC",46
50,"50143",569,414,411,4,3,"IU-CHA-UPeC",63
50,"50122",68,54,54,2,0,"IU-CHA-UPeC",0
50,"50216",236,189,186,4,3,"IU-CHA-UPeC",3
50,"50185",132,110,110,1,0,"IU-CHA-UPeC",3
50,"50247",827,624,615,10,9,"IU-CHA-UPeC",19
50,"50278",198,145,144,1,1,"IU-CHA-UPeC",3
50,"50186",41,29,29,0,0,"IU-CHA-UPeC",2
50,"50268",47,40,39,0,1,"IU-CHA-UPeC",2
50,"50144",36,28,28,0,0,"IU-CHA-UPeC",4
50,"50176",228,158,157,0,1,"IU-CHA-UPeC",7
50,"50297",499531,377882,375565,3049,2317,"IU-CHA-UPeC",26349
50,"50217",455,334,334,1,0,"IU-CHA-UPeC",2
50,"50027",227,177,176,1,1,"IU-CHA-UPeC",3
50,"50155",102,78,78,0,0,"IU-CHA-UPeC",2
50,"50279",87,62,62,1,0,"IU-CHA-UPeC",6
50,"50289",52,39,39,1,0,"IU-CHA-UPeC",1
50,"50123",465,349,344,2,5,"IU-CHA-UPeC",15
50,"50286",77,54,54,0,0,"IU-CHA-UPeC",2
50,"50249",312,235,233,1,2,"IU-CHA-UPeC",9
50,"50207",109,88,88,1,0,"IU-CHA-UPeC",11
50,"50028",78,53,53,2,0,"IU-CHA-UPeC",6
50,"50156",214,173,170,2,3,"IU-CHA-UPeC",8
50,"50060",176,138,136,0,2,"IU-CHA-UPeC",6
50,"50187",70,38,38,0,0,"IU-CHA-UPeC",4
50,"50298",5353,4051,4013,32,38,"IU-CHA-UPeC",202
50,"50090",156,112,111,0,1,"IU-CHA-UPeC",1
50,"50188",30,23,19,0,4,"IU-CHA-UPeC",0
50,"50218",113,90,89,1,1,"IU-CHA-UPeC",3
50,"50081",512,376,372,6,4,"IU-CHA-UPeC",14
50,"50071",131,90,90,0,0,"IU-CHA-UPeC",2
50,"50208",1802,1349,1332,16,17,"IU-CHA-UPeC",128
50,"50124",417,312,312,9,0,"IU-CHA-UPeC",7
50,"50270",38,24,24,2,0,"IU-CHA-UPeC",0
50,"50029",627,469,468,4,1,"IU-CHA-UPeC",9
50,"50215",23,15,15,0,0,"IU-CHA-UPeC",8
50,"50051",828,640,637,8,3,"IU-CHA-UPeC",12
50,"50091",48,32,32,1,0,"IU-CHA-UPeC",0
50,"50157",301,211,207,2,4,"IU-CHA-UPeC",4
50,"50250",55,44,44,0,0,"IU-CHA-UPeC",4
50,"50020",822,560,555,5,5,"IU-CHA-UPeC",32
50,"50030",225,156,156,2,0,"IU-CHA-UPeC",7
50,"50901",137,101,101,0,0,"IU-CHA-UPeC",12
50,"50219",4098,3010,2980,27,30,"IU-CHA-UPeC",176
50,"50125",371,260,258,3,2,"IU-CHA-UPeC",5
50,"50189",712,574,559,4,15,"IU-CHA-UPeC",11
50,"50281",80,57,56,0,1,"IU-CHA-UPeC",1
50,"50902",87,78,78,1,0,"IU-CHA-UPeC",4
50,"50251",8300,6228,6167,62,61,"IU-CHA-UPeC",451
50,"50116",190,142,140,1,2,"IU-CHA-UPeC",3
50,"50062",1810,1407,1389,12,18,"IU-CHA-UPeC",74
50,"50220",46,32,32,0,0,"IU-CHA-UPeC",0
50,"50282",70,48,48,0,0,"IU-CHA-UPeC",0
50,"50180",120,97,96,0,1,"IU-CHA-UPeC",6
50,"50272",12913,9500,9415,80,85,"IU-CHA-UPeC",805
50,"50200",509,406,404,6,2,"IU-CHA-UPeC",20
50,"50269",288,185,183,0,2,"IU-CHA-UPeC",3
50,"50190",708,542,539,3,3,"IU-CHA-UPeC",19
50,"50126",2388,1726,1708,22,18,"IU-CHA-UPeC",56
50,"50093",94,73,73,1,0,"IU-CHA-UPeC",4
50,"50031",161,90,88,1,2,"IU-CHA-UPeC",6
50,"50221",33,20,20,0,0,"IU-CHA-UPeC",0
50,"50903",2225,1686,1669,21,17,"IU-CHA-UPeC",185
50,"50094",1626,1197,1178,22,19,"IU-CHA-UPeC",65
50,"50001",115,81,80,0,1,"IU-CHA-UPeC",0
50,"50084",79,56,56,1,0,"IU-CHA-UPeC",2
50,"50128",28,24,24,0,0,"IU-CHA-UPeC",0
50,"50181",1003,750,737,9,13,"IU-CHA-UPeC",29
50,"50161",117,76,76,0,0,"IU-CHA-UPeC",3
38,"38026",32918,24984,24727,174,257,"PODEMOS",3698
38,"38038",162030,105122,104174,667,948,"PODEMOS",25300
38,"38022",18468,12230,12085,86,145,"PODEMOS",1361
38,"38018",4405,3053,3005,21,48,"PODEMOS",383
38,"38036",6553,4604,4529,45,75,"PODEMOS",720
38,"38053",3754,2419,2370,15,49,"PODEMOS",315
38,"38046",9107,6755,6682,45,73,"PODEMOS",1708
38,"38048",3878,2664,2624,20,40,"PODEMOS",424
38,"38030",1923,1309,1300,5,9,"PODEMOS",142
38,"38001",20166,11307,11195,55,112,"PODEMOS",2441
38,"38008",5513,3683,3609,17,74,"PODEMOS",480
38,"38014",1351,935,929,3,6,"PODEMOS",110
38,"38019",13217,8168,8075,54,93,"PODEMOS",937
38,"38016",1215,654,641,4,13,"PODEMOS",135
38,"38009",4127,2842,2793,15,49,"PODEMOS",481
38,"38031",28697,21546,21202,140,344,"PODEMOS",2878
38,"38012",2378,1620,1606,6,14,"PODEMOS",319
38,"38052",1281,853,844,2,9,"PODEMOS",116
38,"38051",7217,5147,5089,31,58,"PODEMOS",473
38,"38050",2471,1616,1590,8,26,"PODEMOS",178
38,"38042",3784,2692,2673,16,19,"PODEMOS",362
38,"38047",1789,1228,1208,5,20,"PODEMOS",145
38,"38032",13257,8969,8902,72,67,"PODEMOS",1964
38,"38023",121610,81337,80453,527,884,"PODEMOS",20991
38,"38013",2915,1865,1847,12,18,"PODEMOS",215
38,"38037",12997,8126,7997,46,129,"PODEMOS",1337
38,"38035",9299,5558,5500,35,58,"PODEMOS",906
38,"38006",39553,21159,20940,124,219,"PODEMOS",4261
38,"38015",4158,2864,2818,12,46,"PODEMOS",300
38,"38040",4990,3061,3031,16,30,"PODEMOS",348
38,"38044",2206,1317,1303,10,14,"PODEMOS",100
38,"38021",1643,1014,1002,5,12,"PODEMOS",113
38,"38020",15021,9813,9693,51,120,"PODEMOS",1991
38,"38024",15055,9612,9485,77,127,"PODEMOS",1248
38,"38010",4014,2726,2678,15,48,"PODEMOS",565
38,"38043",18918,12883,12737,109,146,"PODEMOS",2538
38,"38034",4041,2853,2814,17,39,"PODEMOS",375
38,"38049",2653,1683,1658,8,25,"PODEMOS",222
38,"38004",4442,2980,2939,20,41,"PODEMOS",498
38,"38003",1440,970,960,2,10,"PODEMOS",118
38,"38901",1387,883,876,4,7,"PODEMOS",118
38,"38002",942,701,674,14,27,"PODEMOS",51
38,"38028",22063,15095,14954,89,141,"PODEMOS",2685
38,"38025",6860,4836,4761,49,75,"PODEMOS",632
38,"38045",3987,2152,2132,23,20,"PODEMOS",320
38,"38041",6808,4869,4835,42,34,"PODEMOS",914
38,"38005",5463,3443,3417,24,26,"PODEMOS",553
38,"38029",1533,776,763,7,13,"PODEMOS",115
38,"38033",3721,2552,2504,15,48,"PODEMOS",262
38,"38039",10584,7532,7462,77,70,"PODEMOS",914
38,"38011",20435,13760,13627,82,133,"PODEMOS",2988
38,"38017",28037,16236,16076,100,160,"PODEMOS",3444
38,"38007",1689,1143,1119,3,24,"PODEMOS",143
38,"38027",5386,3685,3615,29,70,"PODEMOS",450
52,"52001",53255,28182,27819,299,363,"PODEMOS",3206
23,"23061",7520,5481,5405,55,76,"PODEMOS",460
23,"23056",3108,2365,2343,14,22,"PODEMOS",334
23,"23003",8709,6520,6440,42,80,"PODEMOS",414
23,"23091",742,609,607,5,2,"PODEMOS",28
23,"23035",1095,871,867,8,4,"PODEMOS",66
23,"23025",2813,2186,2163,7,23,"PODEMOS",168
23,"23096",2643,2174,2140,14,34,"PODEMOS",240
23,"23010",14371,10249,10140,65,109,"PODEMOS",1256
23,"23094",3852,3097,3061,17,36,"PODEMOS",533
23,"23098",875,728,722,2,6,"PODEMOS",49
23,"23039",2220,1658,1626,8,32,"PODEMOS",146
23,"23085",2273,1833,1814,3,19,"PODEMOS",193
23,"23903",3550,2742,2721,19,21,"PODEMOS",296
23,"23088",6124,4764,4703,31,61,"PODEMOS",1352
23,"23032",575,461,457,1,4,"PODEMOS",39
23,"23037",516,427,423,1,4,"PODEMOS",33
23,"23093",3257,2534,2506,21,28,"PODEMOS",264
23,"23053",9526,6783,6736,49,47,"PODEMOS",1700
23,"23052",1138,977,971,6,6,"PODEMOS",30
23,"23005",30539,21840,21629,176,211,"PODEMOS",2607
23,"23063",3845,2934,2898,24,36,"PODEMOS",395
23,"23080",1786,1347,1329,6,18,"PODEMOS",66
23,"23014",2561,1982,1959,8,23,"PODEMOS",245
23,"23101",388,281,279,0,2,"PODEMOS",29
23,"23058",8665,6651,6585,47,66,"PODEMOS",916
23,"23086",11537,8362,8242,91,120,"PODEMOS",1040
23,"23006",4636,3761,3714,25,47,"PODEMOS",234
23,"23046",2405,1963,1934,3,29,"PODEMOS",243
23,"23067",2489,1869,1847,18,22,"PODEMOS",375
23,"23009",12866,9787,9667,64,120,"PODEMOS",915
23,"23057",771,648,648,4,0,"PODEMOS",122
23,"23062",1461,1188,1181,1,7,"PODEMOS",57
23,"23019",1562,1249,1227,4,22,"PODEMOS",96
23,"23034",2558,1987,1977,18,10,"PODEMOS",82
23,"23033",1356,1080,1065,8,15,"PODEMOS",41
23,"23902",2327,1877,1857,9,20,"PODEMOS",131
23,"23020",1584,1376,1366,5,10,"PODEMOS",148
23,"23072",2002,1593,1582,6,11,"PODEMOS",131
23,"23040",1489,1226,1211,4,15,"PODEMOS",180
23,"23082",1924,1420,1413,6,7,"PODEMOS",78
23,"23038",3557,2851,2831,11,20,"PODEMOS",383
23,"23069",5385,4406,4318,15,88,"PODEMOS",430
23,"23055",47421,33170,32908,213,262,"PODEMOS",5610
23,"23002",17450,13199,12986,92,213,"PODEMOS",1236
23,"23049",1834,1384,1378,7,6,"PODEMOS",226
23,"23070",3931,2549,2533,11,16,"PODEMOS",205
23,"23050",91221,67753,67164,549,589,"PODEMOS",10123
23,"23015",1393,1061,1052,3,9,"PODEMOS",106
23,"23024",12512,9391,9182,79,209,"PODEMOS",1556
23,"23099",4734,3509,3459,23,50,"PODEMOS",431
23,"23901",1160,978,972,5,6,"PODEMOS",66
23,"23008",1518,1185,1173,18,12,"PODEMOS",135
23,"23097",6445,4313,4290,30,23,"PODEMOS",408
23,"23011",2193,1616,1600,11,16,"PODEMOS",248
23,"23044",4847,3801,3740,26,61,"PODEMOS",452
23,"23043",549,401,400,0,1,"PODEMOS",31
23,"23051",2762,2258,2231,9,27,"PODEMOS",183
23,"23079",3733,2994,2981,26,13,"PODEMOS",238
23,"23027",727,577,576,8,1,"PODEMOS",17
23,"23029",854,631,623,2,8,"PODEMOS",18
23,"23084",953,711,708,6,3,"PODEMOS",35
23,"23073",4558,3427,3402,11,25,"PODEMOS",325
23,"23018",2326,1678,1668,5,10,"PODEMOS",165
23,"23904",2852,1784,1764,14,20,"PODEMOS",146
23,"23048",860,636,630,1,6,"PODEMOS",59
23,"23026",3636,2724,2685,11,39,"PODEMOS",188
23,"23017",1584,1265,1253,4,12,"PODEMOS",75
23,"23021",528,452,448,0,4,"PODEMOS",38
23,"23041",504,396,392,1,4,"PODEMOS",24
23,"23028",6203,4645,4585,33,60,"PODEMOS",614
23,"23066",4376,3530,3508,46,22,"PODEMOS",309
23,"23016",396,323,318,3,5,"PODEMOS",32
23,"23047",1638,1311,1306,9,5,"PODEMOS",167
23,"23065",1601,1222,1207,0,15,"PODEMOS",89
23,"23045",2139,1560,1551,9,9,"PODEMOS",209
23,"23075",3319,2640,2618,21,22,"PODEMOS",242
23,"23059",5856,4498,4450,33,48,"PODEMOS",419
23,"23077",637,515,514,3,1,"PODEMOS",33
23,"23074",3030,2368,2353,12,15,"PODEMOS",257
23,"23007",3102,2381,2369,8,12,"PODEMOS",170
23,"23060",19157,13567,13438,133,129,"PODEMOS",1230
23,"23042",299,220,220,1,0,"PODEMOS",14
23,"23071",1728,1337,1328,7,9,"PODEMOS",113
23,"23076",837,672,658,4,14,"PODEMOS",72
23,"23087",11313,8540,8454,64,86,"PODEMOS",935
23,"23054",382,276,275,0,1,"PODEMOS",18
23,"23095",8737,6303,6268,34,35,"PODEMOS",581
23,"23012",4177,3016,2988,22,28,"PODEMOS",271
23,"23090",1316,1077,1071,8,6,"PODEMOS",70
23,"23001",993,826,820,1,6,"PODEMOS",82
23,"23064",1659,1368,1364,1,4,"PODEMOS",66
23,"23004",435,350,346,0,4,"PODEMOS",32
23,"23092",27765,20688,20560,143,128,"PODEMOS",3176
23,"23030",1232,1020,1007,10,13,"PODEMOS",35
23,"23031",751,662,650,9,12,"PODEMOS",83
23,"23081",1546,1145,1132,6,13,"PODEMOS",113
23,"23905",1861,1351,1345,7,6,"PODEMOS",110
10,"10001",285,226,225,2,1,"IU-UPeC",5
10,"10147",1275,985,937,6,48,"IU-UPeC",36
10,"10184",778,620,610,6,10,"IU-UPeC",16
10,"10148",32985,23666,23394,189,272,"IU-UPeC",845
10,"10075",256,178,177,1,1,"IU-UPeC",6
10,"10160",225,172,170,0,2,"IU-UPeC",5
10,"10902",730,546,536,2,10,"IU-UPeC",6
10,"10013",282,228,223,2,5,"IU-UPeC",3
10,"10112",1583,1203,1176,7,27,"IU-UPeC",29
10,"10050",1062,853,846,5,7,"IU-UPeC",10
10,"10038",86,70,70,0,0,"IU-UPeC",0
10,"10185",572,433,427,5,6,"IU-UPeC",1
10,"10026",646,507,494,5,13,"IU-UPeC",21
10,"10209",296,195,193,1,2,"IU-UPeC",1
10,"10006",1275,1024,1004,7,20,"IU-UPeC",11
10,"10197",134,94,93,0,1,"IU-UPeC",0
10,"10043",814,594,590,2,4,"IU-UPeC",23
10,"10157",273,209,205,1,4,"IU-UPeC",9
10,"10002",368,278,275,0,3,"IU-UPeC",8
10,"10149",435,315,307,1,8,"IU-UPeC",10
10,"10161",75,53,53,0,0,"IU-UPeC",2
10,"10051",440,318,314,1,4,"IU-UPeC",0
10,"10003",557,401,396,2,5,"IU-UPeC",4
10,"10077",689,511,504,2,7,"IU-UPeC",12
10,"10039",427,295,290,0,5,"IU-UPeC",6
10,"10150",354,301,295,4,6,"IU-UPeC",5
10,"10101",185,147,147,1,0,"IU-UPeC",1
10,"10186",994,830,816,4,14,"IU-UPeC",23
10,"10114",968,721,711,4,10,"IU-UPeC",24
10,"10904",750,522,520,5,2,"IU-UPeC",7
10,"10064",1490,1142,1119,9,23,"IU-UPeC",11
10,"10008",1331,1052,1047,6,5,"IU-UPeC",37
10,"10016",329,262,259,1,3,"IU-UPeC",10
10,"10004",713,551,543,1,8,"IU-UPeC",6
10,"10199",166,120,119,3,1,"IU-UPeC",3
10,"10040",443,344,342,4,2,"IU-UPeC",4
10,"10151",213,163,161,0,2,"IU-UPeC",0
10,"10078",414,325,319,3,6,"IU-UPeC",14
10,"10167",306,240,237,0,3,"IU-UPeC",1
10,"10017",841,606,589,4,17,"IU-UPeC",8
10,"10163",356,302,299,1,3,"IU-UPeC",1
10,"10204",442,345,342,5,3,"IU-UPeC",12
10,"10115",3578,2857,2811,20,46,"IU-UPeC",64
10,"10905",651,458,456,0,2,"IU-UPeC",4
10,"10188",500,381,373,2,8,"IU-UPeC",1
10,"10152",470,361,357,3,4,"IU-UPeC",11
10,"10128",5752,4219,4146,39,73,"IU-UPeC",82
10,"10054",545,427,426,6,1,"IU-UPeC",12
10,"10042",85,70,70,0,0,"IU-UPeC",1
10,"10005",537,411,398,3,13,"IU-UPeC",5
10,"10116",3784,2839,2801,21,38,"IU-UPeC",137
10,"10066",158,128,127,1,1,"IU-UPeC",3
10,"10201",176,146,145,0,1,"IU-UPeC",2
10,"10153",318,238,231,3,7,"IU-UPeC",8
10,"10132",400,258,256,0,2,"IU-UPeC",9
10,"10092",301,238,236,2,2,"IU-UPeC",2
10,"10120",176,125,125,2,0,"IU-UPeC",5
10,"10129",363,272,266,4,6,"IU-UPeC",5
10,"10117",260,127,127,0,0,"IU-UPeC",2
10,"10080",368,276,272,1,4,"IU-UPeC",2
10,"10055",719,554,546,3,8,"IU-UPeC",14
10,"10165",259,212,209,0,3,"IU-UPeC",5
10,"10141",268,190,189,2,1,"IU-UPeC",0
10,"10019",1510,1134,1121,8,13,"IU-UPeC",38
10,"10031",167,138,137,1,1,"IU-UPeC",2
10,"10068",746,601,586,3,15,"IU-UPeC",10
10,"10154",184,138,134,1,4,"IU-UPeC",1
10,"10093",406,333,324,2,9,"IU-UPeC",6
10,"10190",561,401,397,2,4,"IU-UPeC",22
10,"10007",646,488,478,3,10,"IU-UPeC",6
10,"10044",1451,1100,1087,7,13,"IU-UPeC",28
10,"10024",687,538,533,6,5,"IU-UPeC",18
10,"10142",824,620,616,5,4,"IU-UPeC",24
10,"10179",301,247,247,0,0,"IU-UPeC",7
10,"10146",1509,1018,1004,4,14,"IU-UPeC",13
10,"10191",532,417,415,12,2,"IU-UPeC",17
10,"10118",289,257,257,1,0,"IU-UPeC",11
10,"10020",1619,1240,1214,9,26,"IU-UPeC",38
10,"10049",3849,3185,3111,27,74,"IU-UPeC",45
10,"10082",1893,1528,1484,13,44,"IU-UPeC",34
10,"10045",1031,786,781,11,5,"IU-UPeC",16
10,"10196",306,234,233,1,1,"IU-UPeC",0
10,"10155",1140,856,842,3,14,"IU-UPeC",11
10,"10119",630,461,455,2,6,"IU-UPeC",7
10,"10083",90,69,69,0,0,"IU-UPeC",0
10,"10192",841,592,584,0,8,"IU-UPeC",4
10,"10070",720,548,540,0,8,"IU-UPeC",15
10,"10180",4159,2765,2734,12,31,"IU-UPeC",92
10,"10168",320,240,237,0,3,"IU-UPeC",5
10,"10009",270,173,170,1,3,"IU-UPeC",1
10,"10156",96,71,70,1,1,"IU-UPeC",2
10,"10022",435,371,366,1,5,"IU-UPeC",12
10,"10010",2322,1446,1431,12,15,"IU-UPeC",34
10,"10046",201,176,173,2,3,"IU-UPeC",2
10,"10030",477,316,304,1,12,"IU-UPeC",4
10,"10059",369,258,255,0,3,"IU-UPeC",0
10,"10189",2656,2006,1971,10,35,"IU-UPeC",49
10,"10104",5169,3766,3703,21,63,"IU-UPeC",107
10,"10133",1210,1007,989,2,18,"IU-UPeC",21
10,"10035",1880,1390,1372,6,18,"IU-UPeC",71
10,"10084",1370,934,906,7,28,"IU-UPeC",12
10,"10169",544,430,423,0,7,"IU-UPeC",4
10,"10121",7970,5884,5816,33,68,"IU-UPeC",293
10,"10194",536,441,433,5,8,"IU-UPeC",5
10,"10027",78,66,66,0,0,"IU-UPeC",1
10,"10047",972,783,777,1,6,"IU-UPeC",21
10,"10011",570,450,443,2,7,"IU-UPeC",5
10,"10134",565,395,393,1,2,"IU-UPeC",2
10,"10048",245,163,161,1,2,"IU-UPeC",1
10,"10097",106,79,79,0,0,"IU-UPeC",0
10,"10036",327,247,244,2,3,"IU-UPeC",8
10,"10166",307,220,219,0,1,"IU-UPeC",4
10,"10060",973,620,607,5,13,"IU-UPeC",8
10,"10012",599,494,489,1,5,"IU-UPeC",14
10,"10052",193,127,126,1,1,"IU-UPeC",0
10,"10195",7768,5818,5723,58,95,"IU-UPeC",159
10,"10122",231,166,163,0,3,"IU-UPeC",1
10,"10098",385,294,286,0,8,"IU-UPeC",5
10,"10053",289,231,224,1,7,"IU-UPeC",2
10,"10123",585,480,468,1,12,"IU-UPeC",1
10,"10159",323,235,232,2,3,"IU-UPeC",1
10,"10212",1691,1303,1280,8,23,"IU-UPeC",67
10,"10073",715,536,530,3,6,"IU-UPeC",8
10,"10111",1364,995,978,9,17,"IU-UPeC",21
10,"10135",1329,981,958,1,23,"IU-UPeC",6
10,"10062",413,345,341,3,4,"IU-UPeC",25
10,"10172",718,501,493,2,8,"IU-UPeC",13
10,"10124",862,692,678,7,14,"IU-UPeC",15
10,"10025",402,341,328,2,13,"IU-UPeC",8
10,"10087",1701,1233,1215,7,18,"IU-UPeC",19
10,"10099",592,417,413,7,4,"IU-UPeC",6
10,"10205",2034,1413,1386,5,27,"IU-UPeC",27
10,"10014",1874,1430,1401,11,29,"IU-UPeC",10
10,"10100",795,602,595,4,7,"IU-UPeC",6
10,"10193",1421,1150,1130,10,20,"IU-UPeC",13
10,"10177",1703,1331,1296,10,35,"IU-UPeC",34
10,"10058",1025,747,737,5,10,"IU-UPeC",8
10,"10109",1804,1233,1212,2,21,"IU-UPeC",40
10,"10200",417,308,305,0,3,"IU-UPeC",0
10,"10214",208,172,170,0,2,"IU-UPeC",1
10,"10015",687,500,491,2,9,"IU-UPeC",14
10,"10076",820,608,595,3,13,"IU-UPeC",16
10,"10088",205,117,117,0,0,"IU-UPeC",2
10,"10162",579,483,476,0,7,"IU-UPeC",10
10,"10105",2519,1745,1714,11,31,"IU-UPeC",32
10,"10125",903,648,638,2,10,"IU-UPeC",16
10,"10138",544,445,437,2,8,"IU-UPeC",9
10,"10178",781,567,562,1,5,"IU-UPeC",8
10,"10126",1572,1123,1107,3,16,"IU-UPeC",18
10,"10198",1160,1022,1009,6,13,"IU-UPeC",3
10,"10127",4724,3529,3463,15,66,"IU-UPeC",228
10,"10021",5198,3960,3878,40,82,"IU-UPeC",268
10,"10056",591,456,452,5,4,"IU-UPeC",4
10,"10028",98,72,71,0,1,"IU-UPeC",0
10,"10215",442,320,320,0,0,"IU-UPeC",5
10,"10102",531,413,410,4,3,"IU-UPeC",6
10,"10090",522,386,382,5,4,"IU-UPeC",7
10,"10187",443,316,311,1,5,"IU-UPeC",6
10,"10219",1290,860,843,1,17,"IU-UPeC",12
10,"10110",2298,1682,1638,10,44,"IU-UPeC",57
10,"10029",418,345,341,1,4,"IU-UPeC",2
10,"10131",12850,9036,8977,44,59,"IU-UPeC",318
10,"10094",232,203,203,3,0,"IU-UPeC",13
10,"10203",4600,3268,3215,14,53,"IU-UPeC",79
10,"10207",502,352,349,5,3,"IU-UPeC",9
10,"10079",901,703,695,2,8,"IU-UPeC",9
10,"10091",378,304,304,0,0,"IU-UPeC",7
10,"10140",1114,860,848,6,12,"IU-UPeC",11
10,"10176",374,274,268,1,6,"IU-UPeC",5
10,"10164",742,513,508,1,5,"IU-UPeC",8
10,"10018",1722,1255,1240,6,15,"IU-UPeC",23
10,"10213",571,483,478,1,5,"IU-UPeC",6
10,"10181",694,571,558,7,13,"IU-UPeC",9
10,"10144",996,755,748,3,7,"IU-UPeC",7
10,"10072",862,644,639,2,5,"IU-UPeC",0
10,"10034",350,263,262,1,1,"IU-UPeC",2
10,"10037",76403,58422,57811,329,611,"IU-UPeC",1834
10,"10067",10486,7796,7692,54,104,"IU-UPeC",218
10,"10057",150,112,111,0,1,"IU-UPeC",5
10,"10106",134,111,111,1,0,"IU-UPeC",3
10,"10096",3443,2503,2464,14,39,"IU-UPeC",127
10,"10202",621,495,478,2,17,"IU-UPeC",9
10,"10145",126,101,100,1,1,"IU-UPeC",0
10,"10218",1143,828,814,2,14,"IU-UPeC",6
10,"10206",212,161,160,3,1,"IU-UPeC",13
10,"10108",218,122,120,0,2,"IU-UPeC",3
10,"10113",2354,1800,1778,20,22,"IU-UPeC",97
10,"10216",1543,1200,1192,9,8,"IU-UPeC",25
10,"10182",129,95,95,0,0,"IU-UPeC",3
10,"10081",179,133,129,0,4,"IU-UPeC",4
10,"10033",430,304,301,1,3,"IU-UPeC",0
10,"10086",329,259,256,1,3,"IU-UPeC",3
10,"10901",1184,851,835,2,16,"IU-UPeC",23
10,"10143",158,121,121,0,0,"IU-UPeC",1
10,"10137",399,344,343,4,1,"IU-UPeC",2
10,"10136",318,234,234,4,0,"IU-UPeC",4
10,"10130",1761,1322,1308,5,14,"IU-UPeC",45
10,"10171",340,262,261,1,1,"IU-UPeC",6
10,"10210",551,380,373,1,7,"IU-UPeC",4
10,"10089",1376,1004,988,2,16,"IU-UPeC",25
10,"10173",581,432,426,4,6,"IU-UPeC",12
10,"10139",111,84,83,0,1,"IU-UPeC",0
10,"10095",350,269,267,1,2,"IU-UPeC",8
10,"10170",263,204,202,2,2,"IU-UPeC",1
10,"10158",335,252,251,0,1,"IU-UPeC",2
10,"10208",124,100,98,1,2,"IU-UPeC",0
10,"10217",533,431,427,1,4,"IU-UPeC",5
10,"10183",993,763,761,4,2,"IU-UPeC",24
10,"10023",846,647,637,1,10,"IU-UPeC",16
10,"10174",175,141,139,0,2,"IU-UPeC",4
10,"10903",819,629,624,7,5,"IU-UPeC",11
10,"10063",179,145,145,1,0,"IU-UPeC",3
10,"10175",1434,1054,1028,7,26,"IU-UPeC",33
10,"10032",1705,1296,1277,10,19,"IU-UPeC",76
10,"10071",144,100,100,2,0,"IU-UPeC",1
10,"10041",1056,823,811,4,12,"IU-UPeC",13
10,"10065",205,154,154,1,0,"IU-UPeC",1
10,"10211",454,352,339,2,13,"IU-UPeC",9
10,"10103",454,342,338,1,4,"IU-UPeC",3
10,"10061",1664,1143,1131,8,12,"IU-UPeC",20
10,"10107",1033,825,815,11,10,"IU-UPeC",16
10,"10069",831,647,637,2,10,"IU-UPeC",12
10,"10085",335,248,244,1,4,"IU-UPeC",0
48,"48092",837,619,619,13,0,"EB-AZ",0
48,"48004",334,229,227,1,2,"EB-AZ",0
48,"48028",715,553,551,4,2,"EB-AZ",2
48,"48094",3193,2210,2200,18,10,"EB-AZ",0
48,"48015",33690,24299,24160,168,139,"EB-AZ",22
48,"48062",300,241,240,1,1,"EB-AZ",1
48,"48050",198,153,150,0,3,"EB-AZ",0
48,"48033",215,160,159,0,1,"EB-AZ",0
48,"48075",1975,1440,1421,12,19,"EB-AZ",4
48,"48019",3594,2569,2544,16,25,"EB-AZ",6
48,"48001",5832,4191,4166,37,25,"EB-AZ",2
48,"48020",274076,193807,192607,1471,1200,"EB-AZ",404
48,"48045",5149,3940,3885,35,55,"EB-AZ",3
48,"48905",2565,1882,1847,2,35,"EB-AZ",2
48,"48011",9692,6891,6843,56,48,"EB-AZ",19
48,"48041",704,558,555,4,3,"EB-AZ",0
48,"48071",6118,4467,4412,32,55,"EB-AZ",4
48,"48087",429,346,343,1,3,"EB-AZ",1
48,"48085",10301,7458,7407,50,51,"EB-AZ",9
48,"48048",562,399,394,3,5,"EB-AZ",0
48,"48082",37673,27006,26811,201,195,"EB-AZ",39
48,"48076",314,237,237,4,0,"EB-AZ",0
48,"48067",1161,837,834,2,3,"EB-AZ",1
48,"48057",5749,4093,4081,20,12,"EB-AZ",1
48,"48061",762,584,581,4,3,"EB-AZ",0
48,"48021",1352,952,946,8,6,"EB-AZ",1
48,"48051",220,169,168,0,1,"EB-AZ",0
48,"48002",7851,5767,5713,41,54,"EB-AZ",6
48,"48080",9971,7148,7086,71,62,"EB-AZ",1
48,"48090",6022,4544,4483,23,61,"EB-AZ",3
48,"48068",1551,1178,1163,16,15,"EB-AZ",2
48,"48029",8332,6155,6119,35,36,"EB-AZ",10
48,"48073",6952,4476,4435,43,41,"EB-AZ",10
48,"48069",12765,8985,8910,58,75,"EB-AZ",13
48,"48077",3367,2438,2423,17,15,"EB-AZ",3
48,"48024",1003,775,771,5,4,"EB-AZ",4
48,"48040",1299,896,884,5,12,"EB-AZ",0
48,"48065",3315,2447,2433,19,14,"EB-AZ",1
48,"48084",22577,15689,15540,108,149,"EB-AZ",23
48,"48074",3333,2467,2428,20,39,"EB-AZ",3
48,"48095",2352,1658,1647,6,11,"EB-AZ",2
48,"48079",425,322,321,4,1,"EB-AZ",0
48,"48018",875,553,553,3,0,"EB-AZ",2
48,"48055",2662,1961,1938,16,23,"EB-AZ",1
48,"48060",3645,2277,2274,7,3,"EB-AZ",4
48,"48909",207,165,165,1,0,"EB-AZ",0
48,"48901",4775,3602,3573,35,29,"EB-AZ",8
48,"48072",974,728,723,5,5,"EB-AZ",1
48,"48913",1251,933,917,13,16,"EB-AZ",1
48,"48059",402,317,314,1,3,"EB-AZ",0
48,"48070",545,378,374,2,4,"EB-AZ",0
48,"48906",775,579,574,0,5,"EB-AZ",1
48,"48088",135,97,96,0,1,"EB-AZ",0
48,"48091",1134,821,812,7,9,"EB-AZ",0
48,"48912",2308,1787,1746,27,41,"EB-AZ",1
48,"48097",1303,907,898,10,9,"EB-AZ",2
48,"48007",365,241,239,0,2,"EB-AZ",1
48,"48006",289,246,245,3,1,"EB-AZ",0
48,"48056",978,733,732,7,1,"EB-AZ",0
48,"48042",1384,1111,1091,7,20,"EB-AZ",0
48,"48911",382,291,286,2,5,"EB-AZ",1
48,"48046",12617,9037,8967,56,70,"EB-AZ",9
48,"48096",6608,5071,5011,43,60,"EB-AZ",3
48,"48915",362,238,238,2,0,"EB-AZ",0
48,"48052",1559,1215,1211,0,4,"EB-AZ",5
48,"48037",678,518,509,2,9,"EB-AZ",1
48,"48066",346,256,256,1,0,"EB-AZ",0
48,"48031",340,245,242,0,3,"EB-AZ",1
48,"48003",14338,10497,10414,76,83,"EB-AZ",17
48,"48063",373,289,288,1,1,"EB-AZ",0
48,"48017",13290,8908,8856,42,52,"EB-AZ",11
48,"48008",617,433,424,6,9,"EB-AZ",0
48,"48022",2355,1476,1468,9,8,"EB-AZ",2
48,"48093",900,673,664,4,9,"EB-AZ",1
48,"48904",3504,2671,2650,18,21,"EB-AZ",10
48,"48035",412,313,312,4,1,"EB-AZ",0
48,"48010",457,311,307,1,4,"EB-AZ",0
48,"48016",5260,3856,3827,22,29,"EB-AZ",5
48,"48038",1122,834,824,0,10,"EB-AZ",0
48,"48026",1134,861,853,7,8,"EB-AZ",0
48,"48907",355,283,282,2,1,"EB-AZ",0
48,"48005",117,76,76,0,0,"EB-AZ",3
48,"48039",243,201,201,2,0,"EB-AZ",0
48,"48023",594,470,468,4,2,"EB-AZ",1
48,"48009",786,614,609,3,5,"EB-AZ",0
48,"48014",1218,870,866,8,4,"EB-AZ",2
48,"48013",79984,56928,56516,383,412,"EB-AZ",71
48,"48086",2073,1519,1504,15,15,"EB-AZ",5
48,"48908",245,200,199,1,1,"EB-AZ",1
48,"48058",972,691,687,4,4,"EB-AZ",2
48,"48034",12902,9684,9613,79,71,"EB-AZ",11
48,"48089",3266,2425,2406,23,19,"EB-AZ",2
48,"48030",608,454,453,4,1,"EB-AZ",0
48,"48903",1838,1400,1385,4,15,"EB-AZ",0
48,"48064",603,463,459,7,4,"EB-AZ",0
48,"48081",1883,1412,1398,12,14,"EB-AZ",1
48,"48902",19124,13344,13227,93,117,"EB-AZ",20
48,"48044",62989,46989,46783,385,206,"EB-AZ",85
48,"48914",330,275,275,1,0,"EB-AZ",0
48,"48910",2948,2126,2115,17,11,"EB-AZ",3
48,"48032",5735,4173,4151,32,22,"EB-AZ",8
48,"48027",22033,15929,15825,113,104,"EB-AZ",32
48,"48036",24144,17085,16954,117,131,"EB-AZ",21
48,"48049",548,433,431,0,2,"EB-AZ",1
48,"48025",883,642,639,3,3,"EB-AZ",0
48,"48053",900,676,670,8,6,"EB-AZ",0
48,"48043",4403,3214,3186,28,28,"EB-AZ",8
48,"48078",38742,28064,27837,231,227,"EB-AZ",37
48,"48012",2041,1571,1553,11,18,"EB-AZ",2
48,"48083",6950,5128,5097,33,31,"EB-AZ",6
48,"48047",161,112,112,0,0,"EB-AZ",0
48,"48054",24135,17493,17374,124,119,"EB-AZ",23
32,"32017",1272,862,849,5,13,"NÓS",1
32,"32081",2097,1566,1553,6,13,"NÓS",24
32,"32019",11529,8038,7906,78,132,"NÓS",214
32,"32083",860,580,574,4,6,"NÓS",9
32,"32007",1527,1078,1070,7,8,"NÓS",196
32,"32056",1610,1159,1146,9,13,"NÓS",10
32,"32048",906,573,564,6,9,"NÓS",20
32,"32050",2455,1874,1855,17,19,"NÓS",58
32,"32037",742,544,532,8,12,"NÓS",7
32,"32047",1818,1345,1329,3,16,"NÓS",49
32,"32086",2671,1731,1712,10,19,"NÓS",142
32,"32062",832,646,644,7,2,"NÓS",8
32,"32041",772,511,505,5,6,"NÓS",5
32,"32054",87290,63653,62823,671,830,"NÓS",1584
32,"32034",1141,880,873,4,7,"NÓS",57
32,"32088",1632,1062,1042,8,20,"NÓS",17
32,"32077",1188,813,796,8,17,"NÓS",17
32,"32070",566,335,330,3,5,"NÓS",3
32,"32069",4333,3324,3261,25,63,"NÓS",147
32,"32090",791,558,556,2,2,"NÓS",225
32,"32068",1424,974,969,8,5,"NÓS",60
32,"32013",2213,1447,1431,8,16,"NÓS",28
32,"32009",10783,7555,7468,60,87,"NÓS",128
32,"32039",1275,989,976,5,13,"NÓS",35
32,"32021",956,664,662,2,2,"NÓS",42
32,"32058",5209,3808,3750,27,58,"NÓS",80
32,"32045",2484,1820,1795,19,25,"NÓS",19
32,"32029",480,349,346,5,3,"NÓS",7
32,"32033",750,504,500,4,4,"NÓS",10
32,"32089",1332,917,904,5,13,"NÓS",30
32,"32072",3833,2799,2761,26,38,"NÓS",83
32,"32084",925,657,650,3,7,"NÓS",17
32,"32059",1849,1357,1339,16,18,"NÓS",23
32,"32076",2121,1509,1489,12,20,"NÓS",74
32,"32005",869,676,671,7,5,"NÓS",11
32,"32044",900,658,647,5,11,"NÓS",12
32,"32003",886,661,653,6,8,"NÓS",8
32,"32051",1458,1141,1137,4,4,"NÓS",26
32,"32027",1072,765,747,3,18,"NÓS",9
32,"32091",1909,1389,1375,8,14,"NÓS",28
32,"32016",825,559,556,3,3,"NÓS",1
32,"32074",1064,731,719,4,12,"NÓS",12
32,"32030",1015,702,689,3,13,"NÓS",16
32,"32085",10709,7489,7403,81,86,"NÓS",381
32,"32049",775,502,495,5,7,"NÓS",10
32,"32025",1094,821,809,3,12,"NÓS",20
32,"32022",1377,963,951,7,12,"NÓS",108
32,"32036",1369,1053,1040,5,13,"NÓS",35
32,"32001",4978,3644,3607,31,37,"NÓS",874
32,"32060",845,609,598,6,11,"NÓS",11
32,"32032",8101,5993,5881,74,112,"NÓS",187
32,"32004",1826,900,897,8,3,"NÓS",11
32,"32052",1904,1450,1426,6,24,"NÓS",18
32,"32046",1179,840,832,5,8,"NÓS",24
32,"32038",456,299,297,2,2,"NÓS",7
32,"32057",575,414,412,5,2,"NÓS",14
32,"32015",899,586,581,5,5,"NÓS",7
32,"32035",1484,944,938,7,6,"NÓS",24
32,"32011",934,559,548,5,11,"NÓS",4
32,"32061",1093,852,840,3,12,"NÓS",17
32,"32078",1243,876,869,6,7,"NÓS",7
32,"32067",1300,838,824,15,14,"NÓS",12
32,"32066",567,435,434,2,1,"NÓS",1
32,"32002",2016,1474,1460,11,14,"NÓS",30
32,"32079",1343,1000,987,9,13,"NÓS",9
32,"32082",1259,905,887,6,18,"NÓS",9
32,"32071",1496,1013,1004,1,9,"NÓS",31
32,"32024",4839,3424,3368,35,56,"NÓS",139
32,"32023",1217,884,877,6,7,"NÓS",16
32,"32012",811,535,533,3,2,"NÓS",7
32,"32065",669,494,482,3,12,"NÓS",1
32,"32043",2555,1824,1793,15,31,"NÓS",47
32,"32008",8188,5923,5845,44,78,"NÓS",237
32,"32020",2625,1997,1974,10,23,"NÓS",106
32,"32073",1332,976,965,4,11,"NÓS",21
32,"32026",2736,2039,1998,25,41,"NÓS",30
32,"32042",1585,1120,1104,13,16,"NÓS",9
32,"32028",1643,1195,1174,18,21,"NÓS",18
32,"32006",1571,1140,1127,10,13,"NÓS",18
32,"32063",1939,1329,1314,16,15,"NÓS",19
32,"32064",526,397,395,1,2,"NÓS",6
32,"32040",1472,1112,1089,9,23,"NÓS",41
32,"32031",1079,826,812,5,14,"NÓS",15
32,"32080",333,266,265,0,1,"NÓS",6
32,"32055",1310,952,936,7,16,"NÓS",22
32,"32075",4188,3257,3206,43,51,"NÓS",54
32,"32010",394,299,298,0,1,"NÓS",3
32,"32014",1170,855,845,7,10,"NÓS",41
32,"32053",1447,1140,1128,12,12,"NÓS",43
32,"32087",1798,1421,1397,7,24,"NÓS",21
32,"32092",528,337,334,4,3,"NÓS",14
32,"32018",1261,956,945,3,11,"NÓS",35
31,"31166",260,186,186,2,0,"Ln",0
31,"31251",3110,2347,2327,19,20,"Ln",1
31,"31065",1892,1420,1396,14,24,"Ln",10
31,"31030",145,107,107,3,0,"Ln",0
31,"31055",259,177,173,2,4,"Ln",0
31,"31115",166,108,108,2,0,"Ln",0
31,"31179",509,361,355,5,6,"Ln",1
31,"31078",2447,1889,1861,25,28,"Ln",2
31,"31109",1562,1184,1177,6,7,"Ln",2
31,"31210",199,146,145,2,1,"Ln",0
31,"31077",5384,4055,3999,49,56,"Ln",1
31,"31263",236,142,142,2,0,"Ln",0
31,"31163",2017,1479,1447,15,32,"Ln",0
31,"31183",681,581,578,10,3,"Ln",2
31,"31012",814,579,570,4,9,"Ln",1
31,"31130",310,214,213,7,1,"Ln",0
31,"31051",253,176,176,2,0,"Ln",0
31,"31023",6826,5609,5591,77,18,"Ln",39
31,"31031",221,141,140,0,1,"Ln",0
31,"31224",914,668,659,6,9,"Ln",0
31,"31142",1411,972,964,11,8,"Ln",2
31,"31228",496,382,381,2,1,"Ln",1
31,"31207",271,194,190,0,4,"Ln",0
31,"31071",17,17,17,0,0,"Ln",0
31,"31238",110,96,94,2,2,"Ln",0
31,"31236",1324,943,933,12,10,"Ln",3
31,"31160",107,81,80,0,1,"Ln",1
31,"31176",2856,2077,2040,33,37,"Ln",3
31,"31151",67,48,48,1,0,"Ln",0
31,"31206",2095,1529,1513,19,16,"Ln",1
31,"31196",39,34,34,0,0,"Ln",0
31,"31148",93,70,70,3,0,"Ln",0
31,"31033",49,29,29,1,0,"Ln",0
31,"31168",248,192,191,0,1,"Ln",0
31,"31024",102,52,52,0,0,"Ln",0
31,"31011",697,494,491,5,3,"Ln",0
31,"31188",227,173,173,2,0,"Ln",1
31,"31244",156,87,84,1,3,"Ln",0
31,"31094",112,82,82,1,0,"Ln",0
31,"31257",866,657,648,8,9,"Ln",2
31,"31137",208,93,93,3,0,"Ln",0
31,"31164",582,464,457,3,7,"Ln",0
31,"31083",56,41,39,0,2,"Ln",0
31,"31040",194,130,128,1,2,"Ln",0
31,"31172",367,293,286,6,7,"Ln",1
31,"31903",6593,4699,4660,28,39,"Ln",7
31,"31068",2893,2172,2138,27,34,"Ln",3
31,"31026",147,128,128,1,0,"Ln",0
31,"31118",165,122,121,2,1,"Ln",0
31,"31129",393,265,261,2,4,"Ln",1
31,"31019",1809,1295,1288,23,7,"Ln",0
31,"31146",35,30,30,2,0,"Ln",0
31,"31258",7841,5961,5927,56,34,"Ln",15
31,"31122",4719,3671,3654,42,17,"Ln",23
31,"31119",40,22,22,0,0,"Ln",0
31,"31087",169,131,127,2,4,"Ln",0
31,"31105",1535,1208,1187,18,21,"Ln",2
31,"31158",252,181,178,2,3,"Ln",0
31,"31060",13723,10036,9970,78,66,"Ln",29
31,"31215",4649,3412,3359,35,53,"Ln",2
31,"31261",235,187,187,3,0,"Ln",0
31,"31149",2338,1534,1525,16,9,"Ln",4
31,"31156",252,193,193,0,0,"Ln",0
31,"31067",1938,1424,1415,15,9,"Ln",5
31,"31046",60,38,38,0,0,"Ln",0
31,"31908",1008,709,704,11,5,"Ln",0
31,"31194",315,218,217,2,1,"Ln",0
31,"31069",847,643,636,4,7,"Ln",1
31,"31186",302,211,209,2,2,"Ln",0
31,"31136",444,320,318,6,2,"Ln",0
31,"31021",64,42,42,0,0,"Ln",0
31,"31237",195,156,156,1,0,"Ln",0
31,"31102",146,66,66,1,0,"Ln",0
31,"31104",1876,1355,1338,10,17,"Ln",1
31,"31902",4346,3247,3228,23,19,"Ln",0
31,"31050",6058,3902,3850,64,52,"Ln",5
31,"31209",157,108,108,0,0,"Ln",0
31,"31202",4326,3045,3001,41,44,"Ln",0
31,"31260",1245,859,857,15,2,"Ln",1
31,"31905",2847,2108,2093,11,15,"Ln",7
31,"31013",661,439,437,1,2,"Ln",1
31,"31073",315,214,212,3,2,"Ln",0
31,"31022",526,344,341,3,3,"Ln",0
31,"31131",871,664,658,13,6,"Ln",0
31,"31063",88,72,68,2,4,"Ln",0
31,"31036",921,664,657,5,7,"Ln",2
31,"31041",1583,1125,1110,14,15,"Ln",2
31,"31132",146,115,113,1,2,"Ln",0
31,"31081",342,239,239,2,0,"Ln",7
31,"31198",36,29,29,0,0,"Ln",0
31,"31221",1211,844,825,4,19,"Ln",2
31,"31044",290,223,220,1,3,"Ln",1
31,"31167",827,624,615,13,9,"Ln",3
31,"31147",98,76,76,2,0,"Ln",1
31,"31169",2217,1508,1489,15,19,"Ln",1
31,"31124",210,162,162,2,0,"Ln",0
31,"31254",1920,1473,1458,7,15,"Ln",0
31,"31004",35,22,22,1,0,"Ln",0
31,"31007",136,94,93,1,1,"Ln",0
31,"31097",10436,7461,7395,96,66,"Ln",9
31,"31229",50,40,40,0,0,"Ln",0
31,"31178",495,364,364,4,0,"Ln",0
31,"31208",2569,2016,1992,21,24,"Ln",1
31,"31204",37,33,33,2,0,"Ln",0
31,"31219",88,63,62,0,1,"Ln",0
31,"31101",1390,1031,1028,11,3,"Ln",1
31,"31070",2652,1907,1888,16,19,"Ln",4
31,"31214",93,70,69,0,1,"Ln",1
31,"31048",169,123,123,1,0,"Ln",1
31,"31006",1952,1423,1400,14,23,"Ln",0
31,"31144",804,482,479,2,3,"Ln",0
31,"31239",310,223,220,5,3,"Ln",1
31,"31248",295,174,168,2,6,"Ln",1
31,"31247",152,112,109,0,3,"Ln",1
31,"31145",171,133,133,0,0,"Ln",0
31,"31125",275,194,191,2,3,"Ln",1
31,"31154",227,127,125,3,2,"Ln",0
31,"31053",532,395,391,4,4,"Ln",0
31,"31191",3018,2324,2297,23,27,"Ln",2
31,"31120",394,264,263,5,1,"Ln",0
31,"31084",1935,1389,1380,19,9,"Ln",0
31,"31127",143,97,97,2,0,"Ln",2
31,"31211",25,12,12,2,0,"Ln",0
31,"31034",40,29,29,1,0,"Ln",0
31,"31010",5721,3986,3946,27,40,"Ln",3
31,"31233",96,72,71,0,1,"Ln",0
31,"31009",690,508,504,5,4,"Ln",1
31,"31110",90,65,65,2,0,"Ln",0
31,"31161",344,273,270,4,3,"Ln",3
31,"31058",215,153,153,2,0,"Ln",3
31,"31165",2794,2057,2025,31,32,"Ln",1
31,"31226",585,346,344,1,2,"Ln",1
31,"31155",253,191,189,3,2,"Ln",0
31,"31059",191,142,141,1,1,"Ln",0
31,"31112",94,67,66,0,1,"Ln",0
31,"31255",102,75,74,2,1,"Ln",0
31,"31141",109,70,66,1,4,"Ln",0
31,"31139",159,102,101,3,1,"Ln",0
31,"31121",64,45,45,2,0,"Ln",0
31,"31193",1414,1103,1094,12,9,"Ln",2
31,"31264",179,117,115,5,2,"Ln",0
31,"31088",5574,4194,4156,46,38,"Ln",4
31,"31072",5288,3916,3846,32,70,"Ln",3
31,"31056",179,137,133,0,4,"Ln",0
31,"31180",216,173,173,5,0,"Ln",0
31,"31015",2001,1468,1449,18,19,"Ln",1
31,"31114",362,272,269,6,3,"Ln",2
31,"31100",264,186,186,2,0,"Ln",0
31,"31133",44,30,30,1,0,"Ln",0
31,"31079",76,53,53,0,0,"Ln",0
31,"31246",140,108,103,2,5,"Ln",0
31,"31259",485,325,324,3,1,"Ln",0
31,"31080",510,412,411,8,1,"Ln",1
31,"31195",180,129,128,0,1,"Ln",0
31,"31113",137,86,85,1,1,"Ln",1
31,"31185",501,345,342,4,3,"Ln",5
31,"31057",1812,1375,1360,17,15,"Ln",18
31,"31212",151,118,118,7,0,"Ln",0
31,"31117",620,390,385,1,5,"Ln",0
31,"31106",689,565,559,1,6,"Ln",0
31,"31181",150,116,116,0,0,"Ln",1
31,"31205",427,330,326,7,4,"Ln",1
31,"31103",46,32,32,1,0,"Ln",0
31,"31216",3882,2829,2810,31,19,"Ln",9
31,"31037",86,64,64,0,0,"Ln",0
31,"31227",8226,6191,6109,53,82,"Ln",8
31,"31199",150,101,101,3,0,"Ln",0
31,"31174",110,75,73,0,2,"Ln",1
31,"31091",347,217,217,0,0,"Ln",0
31,"31095",76,66,64,1,2,"Ln",0
31,"31017",361,248,246,4,2,"Ln",0
31,"31086",12987,10342,10270,114,72,"Ln",13
31,"31182",37,27,27,0,0,"Ln",0
31,"31093",293,210,206,2,4,"Ln",0
31,"31190",44,36,36,1,0,"Ln",0
31,"31014",274,197,197,4,0,"Ln",0
31,"31116",65,51,51,1,0,"Ln",0
31,"31126",357,235,232,0,3,"Ln",0
31,"31184",61,43,43,2,0,"Ln",0
31,"31045",504,397,392,9,5,"Ln",0
31,"31064",1447,1161,1145,11,16,"Ln",0
31,"31062",1088,866,853,4,13,"Ln",0
31,"31140",116,82,82,2,0,"Ln",0
31,"31123",654,430,419,7,11,"Ln",0
31,"31134",178,132,130,1,2,"Ln",0
31,"31157",3546,2423,2399,32,24,"Ln",6
31,"31192",159,132,131,0,1,"Ln",0
31,"31076",2407,2005,1986,28,19,"Ln",5
31,"31250",2832,1921,1899,20,22,"Ln",2
31,"31002",424,312,310,7,2,"Ln",0
31,"31901",15475,11855,11771,121,84,"Ln",17
31,"31222",63,41,41,5,0,"Ln",0
31,"31177",262,171,170,3,1,"Ln",0
31,"31107",1707,1303,1294,12,9,"Ln",1
31,"31171",693,510,500,6,10,"Ln",0
31,"31029",925,662,648,6,14,"Ln",1
31,"31043",38,30,30,0,0,"Ln",1
31,"31230",107,86,85,0,1,"Ln",0
31,"31049",704,488,486,1,2,"Ln",0
31,"31904",1559,1095,1084,8,11,"Ln",0
31,"31066",867,647,638,8,9,"Ln",0
31,"31242",253,165,164,1,1,"Ln",0
31,"31020",454,235,232,2,3,"Ln",0
31,"31213",105,70,70,0,0,"Ln",1
31,"31061",56,50,50,1,0,"Ln",0
31,"31108",1878,1487,1475,14,12,"Ln",1
31,"31111",96,75,75,2,0,"Ln",0
31,"31159",1134,867,864,9,3,"Ln",2
31,"31054",460,308,304,7,4,"Ln",0
31,"31162",47,29,27,0,2,"Ln",2
31,"31096",115,95,92,2,3,"Ln",1
31,"31223",995,752,742,6,10,"Ln",0
31,"31252",87,68,68,0,0,"Ln",0
31,"31232",25152,18432,18220,199,212,"Ln",21
31,"31089",242,188,185,1,3,"Ln",0
31,"31018",409,312,311,9,1,"Ln",0
31,"31038",1348,1017,1005,13,12,"Ln",6
31,"31241",134,94,89,0,5,"Ln",0
31,"31028",211,133,133,0,0,"Ln",0
31,"31231",115,81,81,1,0,"Ln",0
31,"31042",2744,2081,2053,19,28,"Ln",2
31,"31008",80,57,54,0,3,"Ln",1
31,"31265",86,61,61,0,0,"Ln",0
31,"31253",129,112,112,0,0,"Ln",0
31,"31099",63,52,52,1,0,"Ln",0
31,"31197",70,60,59,0,1,"Ln",0
31,"31170",49,39,39,1,0,"Ln",0
31,"31035",63,45,43,1,2,"Ln",1
31,"31150",213,154,152,1,2,"Ln",0
31,"31187",111,70,70,1,0,"Ln",0
31,"31256",109,70,70,0,0,"Ln",0
31,"31175",72,50,49,0,1,"Ln",1
31,"31090",146,81,80,3,1,"Ln",1
31,"31039",83,58,57,0,1,"Ln",0
31,"31016",7642,5866,5822,52,44,"Ln",9
31,"31243",314,236,234,5,2,"Ln",0
31,"31135",102,67,62,0,5,"Ln",0
31,"31189",1170,739,731,10,8,"Ln",2
31,"31001",90,74,74,5,0,"Ln",0
31,"31153",2172,1463,1448,10,15,"Ln",2
31,"31173",873,704,680,3,24,"Ln",0
31,"31152",1347,999,990,16,9,"Ln",2
31,"31203",40,29,29,0,0,"Ln",0
31,"31128",370,265,265,2,0,"Ln",1
31,"31143",98,59,58,1,1,"Ln",0
31,"31052",88,65,64,0,1,"Ln",0
31,"31074",394,301,298,5,3,"Ln",1
31,"31047",261,191,187,6,4,"Ln",0
31,"31138",934,649,647,5,2,"Ln",2
31,"31075",101,68,67,1,1,"Ln",0
31,"31025",768,560,560,5,0,"Ln",1
31,"31027",838,595,589,7,6,"Ln",0
31,"31082",615,398,393,6,5,"Ln",0
31,"31907",10677,8568,8523,97,45,"Ln",14
31,"31245",83,54,54,1,0,"Ln",1
31,"31092",662,458,455,4,3,"Ln",2
31,"31225",36,29,29,0,0,"Ln",0
31,"31201",147803,110800,110079,1040,721,"Ln",143
31,"31235",166,111,111,0,0,"Ln",1
31,"31217",337,233,230,1,3,"Ln",1
31,"31032",1733,1295,1285,26,10,"Ln",1
31,"31085",471,353,351,3,2,"Ln",0
31,"31249",1885,1350,1331,20,19,"Ln",1
31,"31234",144,107,107,2,0,"Ln",0
31,"31098",1918,1489,1483,23,6,"Ln",2
31,"31220",752,607,603,3,4,"Ln",0
31,"31240",531,355,351,6,4,"Ln",0
31,"31906",2553,1945,1930,21,15,"Ln",6
31,"31262",206,180,180,2,0,"Ln",1
31,"31003",124,95,95,2,0,"Ln",0
31,"31005",296,205,204,0,1,"Ln",1
31,"31200",764,558,546,11,12,"Ln",0
49,"49083",52,43,41,1,2,"PCPE",0
49,"49227",316,259,255,4,4,"PCPE",0
49,"49169",35,29,29,0,0,"PCPE",1
49,"49088",92,70,70,0,0,"PCPE",0
49,"49241",256,190,186,0,4,"PCPE",0
49,"49082",364,306,304,6,2,"PCPE",0
49,"49192",134,114,114,2,0,"PCPE",0
49,"49242",455,373,365,8,8,"PCPE",0
49,"49059",93,61,61,0,0,"PCPE",0
49,"49197",180,127,123,2,4,"PCPE",0
49,"49229",130,98,97,1,1,"PCPE",0
49,"49153",172,124,123,1,1,"PCPE",0
49,"49108",476,359,352,4,7,"PCPE",0
49,"49121",372,269,265,4,4,"PCPE",0
49,"49008",468,346,342,6,4,"PCPE",0
49,"49214",707,529,523,7,6,"PCPE",1
49,"49116",389,272,266,4,6,"PCPE",0
49,"49233",95,60,57,0,3,"PCPE",0
49,"49038",99,74,74,1,0,"PCPE",0
49,"49043",300,226,225,2,1,"PCPE",0
49,"49117",458,336,328,3,8,"PCPE",0
49,"49105",155,121,121,0,0,"PCPE",0
49,"49037",185,156,156,0,0,"PCPE",0
49,"49040",117,99,99,1,0,"PCPE",0
49,"49123",547,414,410,0,4,"PCPE",0
49,"49248",188,145,144,0,1,"PCPE",0
49,"49032",326,251,250,0,1,"PCPE",0
49,"49100",303,216,215,1,1,"PCPE",1
49,"49101",153,106,101,3,5,"PCPE",0
49,"49095",297,233,231,1,2,"PCPE",0
49,"49078",174,143,143,0,0,"PCPE",0
49,"49246",233,190,185,1,5,"PCPE",1
49,"49062",121,82,81,1,1,"PCPE",0
49,"49154",131,79,78,0,1,"PCPE",0
49,"49167",205,147,144,0,3,"PCPE",0
49,"49190",64,49,49,0,0,"PCPE",0
49,"49084",290,241,238,5,3,"PCPE",0
49,"49033",728,530,528,4,2,"PCPE",0
49,"49191",272,215,213,1,2,"PCPE",0
49,"49252",326,260,255,7,5,"PCPE",0
49,"49237",170,120,120,3,0,"PCPE",0
49,"49158",215,164,161,3,3,"PCPE",0
49,"49203",319,245,236,1,9,"PCPE",0
49,"49002",64,48,48,1,0,"PCPE",1
49,"49239",673,488,476,6,12,"PCPE",1
49,"49205",382,296,294,8,2,"PCPE",0
49,"49091",269,202,202,0,0,"PCPE",0
49,"49243",111,97,95,0,2,"PCPE",0
49,"49183",101,80,80,4,0,"PCPE",0
49,"49122",773,578,569,7,9,"PCPE",1
49,"49076",325,253,250,2,3,"PCPE",0
49,"49160",48,36,32,0,4,"PCPE",0
49,"49170",104,70,68,1,2,"PCPE",0
49,"49010",346,285,282,3,3,"PCPE",0
49,"49130",180,137,132,5,5,"PCPE",0
49,"49036",521,375,371,3,4,"PCPE",0
49,"49171",648,507,500,5,7,"PCPE",2
49,"49052",191,144,139,1,5,"PCPE",0
49,"49005",142,93,93,0,0,"PCPE",0
49,"49094",243,149,149,1,0,"PCPE",0
49,"49102",198,148,145,1,3,"PCPE",0
49,"49256",256,207,206,2,1,"PCPE",0
49,"49077",189,115,115,0,0,"PCPE",0
49,"49046",272,209,206,3,3,"PCPE",0
49,"49157",214,167,162,1,5,"PCPE",1
49,"49238",258,202,201,0,1,"PCPE",0
49,"49044",85,56,55,0,1,"PCPE",0
49,"49131",269,186,181,1,5,"PCPE",0
49,"49086",119,98,97,1,1,"PCPE",0
49,"49180",156,101,101,0,0,"PCPE",0
49,"49042",244,199,195,2,4,"PCPE",0
49,"49184",179,117,114,1,3,"PCPE",0
49,"49251",166,126,119,0,7,"PCPE",0
49,"49133",306,218,217,1,1,"PCPE",0
49,"49186",263,189,187,0,2,"PCPE",0
49,"49096",175,134,127,1,7,"PCPE",0
49,"49194",377,229,228,2,1,"PCPE",0
49,"49009",400,290,286,4,4,"PCPE",0
49,"49092",132,92,91,1,1,"PCPE",0
49,"49219",7519,5407,5331,58,76,"PCPE",7
49,"49014",112,83,82,1,1,"PCPE",0
49,"49258",115,96,95,2,1,"PCPE",1
49,"49173",379,229,227,5,2,"PCPE",0
49,"49054",908,668,651,13,17,"PCPE",1
49,"49066",498,336,328,4,8,"PCPE",0
49,"49156",237,185,183,2,2,"PCPE",0
49,"49068",472,292,289,2,3,"PCPE",0
49,"49240",218,168,159,3,9,"PCPE",0
49,"49220",146,116,114,1,2,"PCPE",0
49,"49035",236,205,200,0,5,"PCPE",0
49,"49080",692,523,518,6,5,"PCPE",0
49,"49221",258,142,135,1,7,"PCPE",0
49,"49003",904,631,624,4,7,"PCPE",0
49,"49199",259,203,200,1,3,"PCPE",1
49,"49162",192,140,138,1,2,"PCPE",0
49,"49115",185,140,139,4,1,"PCPE",0
49,"49069",384,243,242,6,1,"PCPE",0
49,"49111",130,96,96,6,0,"PCPE",0
49,"49004",128,92,88,2,4,"PCPE",0
49,"49260",774,597,593,12,4,"PCPE",0
49,"49135",635,450,449,5,1,"PCPE",0
49,"49085",1033,708,701,0,7,"PCPE",0
49,"49041",440,315,307,1,8,"PCPE",0
49,"49012",72,47,47,1,0,"PCPE",0
49,"49136",324,228,222,4,6,"PCPE",0
49,"49208",395,255,250,1,5,"PCPE",2
49,"49128",557,428,424,2,4,"PCPE",0
49,"49013",254,172,168,4,4,"PCPE",0
49,"49222",387,294,289,7,5,"PCPE",1
49,"49204",64,45,44,0,1,"PCPE",0
49,"49193",472,323,316,4,7,"PCPE",1
49,"49017",251,169,169,2,0,"PCPE",0
49,"49257",279,187,184,1,3,"PCPE",2
49,"49137",176,140,137,2,3,"PCPE",0
49,"49164",158,120,118,1,2,"PCPE",0
49,"49125",1400,977,957,10,20,"PCPE",1
49,"49247",454,301,296,3,5,"PCPE",0
49,"49209",510,347,345,5,2,"PCPE",0
49,"49113",172,144,142,1,2,"PCPE",0
49,"49087",523,322,319,0,3,"PCPE",0
49,"49223",766,628,616,5,12,"PCPE",0
49,"49165",60,59,58,2,1,"PCPE",0
49,"49126",236,158,157,4,1,"PCPE",0
49,"49206",854,611,595,6,16,"PCPE",0
49,"49134",187,115,110,0,5,"PCPE",0
49,"49007",371,267,254,6,13,"PCPE",0
49,"49224",160,109,106,4,3,"PCPE",0
49,"49244",45,28,28,0,0,"PCPE",0
49,"49166",1225,945,934,11,11,"PCPE",2
49,"49031",145,115,113,0,2,"PCPE",0
49,"49055",104,85,85,2,0,"PCPE",1
49,"49263",54,41,41,0,0,"PCPE",0
49,"49114",44,31,30,0,1,"PCPE",0
49,"49019",246,187,181,5,6,"PCPE",0
49,"49178",699,503,487,4,16,"PCPE",0
49,"49207",237,156,155,0,1,"PCPE",0
49,"49127",2369,1752,1731,22,21,"PCPE",1
49,"49225",153,95,92,2,3,"PCPE",0
49,"49139",170,139,136,0,3,"PCPE",0
49,"49090",194,148,147,1,1,"PCPE",1
49,"49250",1254,974,952,11,22,"PCPE",2
49,"49264",592,395,391,4,4,"PCPE",2
49,"49020",294,226,223,5,3,"PCPE",0
49,"49179",393,265,263,0,2,"PCPE",0
49,"49021",14387,10353,10196,117,157,"PCPE",18
49,"49226",253,203,200,1,3,"PCPE",8
49,"49103",412,333,330,4,3,"PCPE",0
49,"49056",295,220,211,4,9,"PCPE",0
49,"49155",83,64,63,1,1,"PCPE",0
49,"49141",348,251,249,3,2,"PCPE",1
49,"49200",950,737,719,9,18,"PCPE",0
49,"49129",861,626,617,10,9,"PCPE",1
49,"49168",90,73,73,2,0,"PCPE",0
49,"49265",128,91,91,1,0,"PCPE",1
49,"49142",247,182,180,5,2,"PCPE",0
49,"49022",287,230,226,3,4,"PCPE",0
49,"49261",1546,1171,1154,9,17,"PCPE",0
49,"49057",106,77,76,0,1,"PCPE",0
49,"49266",75,60,60,0,0,"PCPE",0
49,"49034",446,337,333,3,4,"PCPE",0
49,"49181",369,274,274,2,0,"PCPE",0
49,"49104",353,224,223,0,1,"PCPE",0
49,"49228",56,43,41,0,2,"PCPE",0
49,"49079",105,80,76,2,4,"PCPE",0
49,"49210",478,365,358,4,7,"PCPE",1
49,"49143",225,161,157,2,4,"PCPE",0
49,"49063",341,274,274,2,0,"PCPE",0
49,"49262",392,268,266,1,2,"PCPE",0
49,"49093",287,233,231,2,2,"PCPE",0
49,"49048",134,84,84,0,0,"PCPE",0
49,"49249",68,60,59,1,1,"PCPE",0
49,"49267",91,75,74,1,1,"PCPE",0
49,"49064",521,343,339,2,4,"PCPE",0
49,"49023",977,702,697,9,5,"PCPE",2
49,"49011",230,183,180,7,3,"PCPE",0
49,"49145",235,145,137,2,8,"PCPE",1
49,"49050",513,349,348,3,1,"PCPE",0
49,"49107",131,98,97,2,1,"PCPE",0
49,"49119",236,172,172,0,0,"PCPE",0
49,"49081",1365,1071,1057,7,14,"PCPE",2
49,"49268",416,307,305,5,2,"PCPE",1
49,"49146",296,232,228,2,4,"PCPE",0
49,"49024",667,464,457,7,7,"PCPE",0
49,"49216",162,138,137,0,1,"PCPE",0
49,"49025",174,128,126,0,2,"PCPE",0
49,"49120",74,53,51,0,2,"PCPE",0
49,"49230",103,82,81,1,1,"PCPE",0
49,"49061",150,113,113,1,0,"PCPE",0
49,"49065",1121,850,835,8,15,"PCPE",0
49,"49172",536,347,341,1,6,"PCPE",0
49,"49159",276,220,216,2,4,"PCPE",2
49,"49132",327,242,236,0,6,"PCPE",0
49,"49053",938,737,729,5,8,"PCPE",2
49,"49231",330,216,212,1,4,"PCPE",0
49,"49147",267,190,189,2,1,"PCPE",0
49,"49109",626,491,490,4,1,"PCPE",0
49,"49269",230,165,163,4,2,"PCPE",0
49,"49047",111,78,77,0,1,"PCPE",0
49,"49201",306,250,248,4,2,"PCPE",0
49,"49270",138,100,99,0,1,"PCPE",0
49,"49026",233,182,179,0,3,"PCPE",0
49,"49148",249,143,141,0,2,"PCPE",1
49,"49067",372,258,256,3,2,"PCPE",0
49,"49039",333,259,252,1,7,"PCPE",0
49,"49027",150,116,116,5,0,"PCPE",0
49,"49110",366,215,215,5,0,"PCPE",0
49,"49097",90,47,47,0,0,"PCPE",0
49,"49118",206,167,167,0,0,"PCPE",1
49,"49174",130,95,94,2,1,"PCPE",0
49,"49232",97,74,73,0,1,"PCPE",0
49,"49255",426,330,327,4,3,"PCPE",0
49,"49187",1251,956,946,8,10,"PCPE",0
49,"49202",190,138,136,2,2,"PCPE",0
49,"49015",233,189,188,1,1,"PCPE",0
49,"49245",261,178,174,0,4,"PCPE",0
49,"49271",204,154,154,3,0,"PCPE",0
49,"49259",93,70,63,0,7,"PCPE",0
49,"49175",234,183,182,2,1,"PCPE",1
49,"49028",122,103,102,1,1,"PCPE",0
49,"49272",88,73,73,1,0,"PCPE",0
49,"49149",392,275,271,3,4,"PCPE",0
49,"49150",145,109,104,2,5,"PCPE",0
49,"49016",256,185,179,2,6,"PCPE",0
49,"49098",222,167,166,2,1,"PCPE",0
49,"49163",230,166,160,1,6,"PCPE",0
49,"49188",115,92,91,1,1,"PCPE",0
49,"49234",410,336,334,1,2,"PCPE",0
49,"49185",162,125,121,0,4,"PCPE",0
49,"49189",202,130,130,5,0,"PCPE",1
49,"49029",623,494,482,4,12,"PCPE",1
49,"49099",132,85,85,1,0,"PCPE",0
49,"49124",254,179,176,2,3,"PCPE",1
49,"49112",128,85,85,1,0,"PCPE",0
49,"49235",450,330,321,5,9,"PCPE",2
49,"49071",770,505,502,6,3,"PCPE",1
49,"49176",681,446,444,2,2,"PCPE",0
49,"49273",189,120,118,0,2,"PCPE",0
49,"49151",627,473,467,4,6,"PCPE",1
49,"49275",52483,38405,37981,427,424,"PCPE",32
49,"49177",284,190,189,1,1,"PCPE",0
49,"49030",84,69,67,1,2,"PCPE",1
49,"49152",532,346,344,9,2,"PCPE",2
49,"49006",154,116,112,0,4,"PCPE",0
49,"49138",231,164,163,1,1,"PCPE",0
49,"49018",331,252,245,1,7,"PCPE",2
49,"49058",316,252,250,0,2,"PCPE",0
49,"49236",76,54,53,0,1,"PCPE",0
49,"49075",140,109,106,1,3,"PCPE",0
49,"49256",256,207,206,2,1,"PODEMOS",27
49,"49012",72,47,47,1,0,"PODEMOS",4
49,"49081",1365,1071,1057,7,14,"PODEMOS",124
49,"49184",179,117,114,1,3,"PODEMOS",4
49,"49163",230,166,160,1,6,"PODEMOS",19
49,"49091",269,202,202,0,0,"PODEMOS",21
49,"49221",258,142,135,1,7,"PODEMOS",19
49,"49014",112,83,82,1,1,"PODEMOS",7
49,"49262",392,268,266,1,2,"PODEMOS",42
49,"49239",673,488,476,6,12,"PODEMOS",50
49,"49018",331,252,245,1,7,"PODEMOS",14
49,"49260",774,597,593,12,4,"PODEMOS",48
49,"49085",1033,708,701,0,7,"PODEMOS",88
49,"49270",138,100,99,0,1,"PODEMOS",15
49,"49028",122,103,102,1,1,"PODEMOS",11
49,"49172",536,347,341,1,6,"PODEMOS",13
49,"49250",1254,974,952,11,22,"PODEMOS",88
49,"49127",2369,1752,1731,22,21,"PODEMOS",327
49,"49114",44,31,30,0,1,"PODEMOS",4
49,"49083",52,43,41,1,2,"PODEMOS",2
49,"49155",83,64,63,1,1,"PODEMOS",1
49,"49160",48,36,32,0,4,"PODEMOS",3
49,"49169",35,29,29,0,0,"PODEMOS",6
49,"49068",472,292,289,2,3,"PODEMOS",24
49,"49173",379,229,227,5,2,"PODEMOS",20
49,"49020",294,226,223,5,3,"PODEMOS",25
49,"49036",521,375,371,3,4,"PODEMOS",76
49,"49216",162,138,137,0,1,"PODEMOS",18
49,"49244",45,28,28,0,0,"PODEMOS",2
49,"49053",938,737,729,5,8,"PODEMOS",84
49,"49111",130,96,96,6,0,"PODEMOS",11
49,"49203",319,245,236,1,9,"PODEMOS",7
49,"49121",372,269,265,4,4,"PODEMOS",42
49,"49227",316,259,255,4,4,"PODEMOS",29
49,"49263",54,41,41,0,0,"PODEMOS",0
49,"49123",547,414,410,0,4,"PODEMOS",50
49,"49054",908,668,651,13,17,"PODEMOS",56
49,"49005",142,93,93,0,0,"PODEMOS",3
49,"49204",64,45,44,0,1,"PODEMOS",2
49,"49120",74,53,51,0,2,"PODEMOS",4
49,"49271",204,154,154,3,0,"PODEMOS",18
49,"49032",326,251,250,0,1,"PODEMOS",9
49,"49237",170,120,120,3,0,"PODEMOS",9
49,"49209",510,347,345,5,2,"PODEMOS",27
49,"49180",156,101,101,0,0,"PODEMOS",15
49,"49245",261,178,174,0,4,"PODEMOS",43
49,"49166",1225,945,934,11,11,"PODEMOS",206
49,"49265",128,91,91,1,0,"PODEMOS",2
49,"49078",174,143,143,0,0,"PODEMOS",27
49,"49206",854,611,595,6,16,"PODEMOS",47
49,"49109",626,491,490,4,1,"PODEMOS",26
49,"49248",188,145,144,0,1,"PODEMOS",16
49,"49030",84,69,67,1,2,"PODEMOS",3
49,"49261",1546,1171,1154,9,17,"PODEMOS",199
49,"49136",324,228,222,4,6,"PODEMOS",13
49,"49095",297,233,231,1,2,"PODEMOS",35
49,"49055",104,85,85,2,0,"PODEMOS",7
49,"49102",198,148,145,1,3,"PODEMOS",12
49,"49139",170,139,136,0,3,"PODEMOS",21
49,"49105",155,121,121,0,0,"PODEMOS",14
49,"49080",692,523,518,6,5,"PODEMOS",41
49,"49122",773,578,569,7,9,"PODEMOS",96
49,"49038",99,74,74,1,0,"PODEMOS",9
49,"49149",392,275,271,3,4,"PODEMOS",17
49,"49233",95,60,57,0,3,"PODEMOS",1
49,"49099",132,85,85,1,0,"PODEMOS",5
49,"49024",667,464,457,7,7,"PODEMOS",36
49,"49190",64,49,49,0,0,"PODEMOS",1
49,"49126",236,158,157,4,1,"PODEMOS",17
49,"49112",128,85,85,1,0,"PODEMOS",18
49,"49168",90,73,73,2,0,"PODEMOS",4
49,"49219",7519,5407,5331,58,76,"PODEMOS",791
49,"49179",393,265,263,0,2,"PODEMOS",23
49,"49090",194,148,147,1,1,"PODEMOS",11
49,"49113",172,144,142,1,2,"PODEMOS",5
49,"49019",246,187,181,5,6,"PODEMOS",15
49,"49181",369,274,274,2,0,"PODEMOS",11
49,"49238",258,202,201,0,1,"PODEMOS",13
49,"49002",64,48,48,1,0,"PODEMOS",1
49,"49185",162,125,121,0,4,"PODEMOS",3
49,"49044",85,56,55,0,1,"PODEMOS",4
49,"49064",521,343,339,2,4,"PODEMOS",39
49,"49050",513,349,348,3,1,"PODEMOS",35
49,"49107",131,98,97,2,1,"PODEMOS",11
49,"49171",648,507,500,5,7,"PODEMOS",71
49,"49157",214,167,162,1,5,"PODEMOS",27
49,"49093",287,233,231,2,2,"PODEMOS",17
49,"49174",130,95,94,2,1,"PODEMOS",8
49,"49167",205,147,144,0,3,"PODEMOS",21
49,"49210",478,365,358,4,7,"PODEMOS",57
49,"49100",303,216,215,1,1,"PODEMOS",29
49,"49088",92,70,70,0,0,"PODEMOS",3
49,"49087",523,322,319,0,3,"PODEMOS",18
49,"49108",476,359,352,4,7,"PODEMOS",36
49,"49061",150,113,113,1,0,"PODEMOS",15
49,"49082",364,306,304,6,2,"PODEMOS",31
49,"49025",174,128,126,0,2,"PODEMOS",13
49,"49103",412,333,330,4,3,"PODEMOS",30
49,"49158",215,164,161,3,3,"PODEMOS",23
49,"49094",243,149,149,1,0,"PODEMOS",31
49,"49016",256,185,179,2,6,"PODEMOS",24
49,"49129",861,626,617,10,9,"PODEMOS",73
49,"49062",121,82,81,1,1,"PODEMOS",10
49,"49059",93,61,61,0,0,"PODEMOS",4
49,"49077",189,115,115,0,0,"PODEMOS",9
49,"49131",269,186,181,1,5,"PODEMOS",18
49,"49225",153,95,92,2,3,"PODEMOS",13
49,"49137",176,140,137,2,3,"PODEMOS",12
49,"49240",218,168,159,3,9,"PODEMOS",21
49,"49010",346,285,282,3,3,"PODEMOS",59
49,"49063",341,274,274,2,0,"PODEMOS",25
49,"49189",202,130,130,5,0,"PODEMOS",8
49,"49205",382,296,294,8,2,"PODEMOS",20
49,"49134",187,115,110,0,5,"PODEMOS",23
49,"49110",366,215,215,5,0,"PODEMOS",32
49,"49084",290,241,238,5,3,"PODEMOS",46
49,"49147",267,190,189,2,1,"PODEMOS",5
49,"49266",75,60,60,0,0,"PODEMOS",2
49,"49230",103,82,81,1,1,"PODEMOS",6
49,"49234",410,336,334,1,2,"PODEMOS",30
49,"49170",104,70,68,1,2,"PODEMOS",7
49,"49101",153,106,101,3,5,"PODEMOS",9
49,"49188",115,92,91,1,1,"PODEMOS",15
49,"49040",117,99,99,1,0,"PODEMOS",9
49,"49162",192,140,138,1,2,"PODEMOS",13
49,"49224",160,109,106,4,3,"PODEMOS",19
49,"49098",222,167,166,2,1,"PODEMOS",14
49,"49125",1400,977,957,10,20,"PODEMOS",165
49,"49207",237,156,155,0,1,"PODEMOS",16
49,"49058",316,252,250,0,2,"PODEMOS",11
49,"49039",333,259,252,1,7,"PODEMOS",43
49,"49186",263,189,187,0,2,"PODEMOS",14
49,"49194",377,229,228,2,1,"PODEMOS",32
49,"49029",623,494,482,4,12,"PODEMOS",44
49,"49200",950,737,719,9,18,"PODEMOS",102
49,"49128",557,428,424,2,4,"PODEMOS",62
49,"49176",681,446,444,2,2,"PODEMOS",15
49,"49066",498,336,328,4,8,"PODEMOS",32
49,"49272",88,73,73,1,0,"PODEMOS",5
49,"49247",454,301,296,3,5,"PODEMOS",37
49,"49191",272,215,213,1,2,"PODEMOS",21
49,"49151",627,473,467,4,6,"PODEMOS",102
49,"49159",276,220,216,2,4,"PODEMOS",38
49,"49231",330,216,212,1,4,"PODEMOS",19
49,"49076",325,253,250,2,3,"PODEMOS",22
49,"49187",1251,956,946,8,10,"PODEMOS",93
49,"49267",91,75,74,1,1,"PODEMOS",8
49,"49097",90,47,47,0,0,"PODEMOS",4
49,"49148",249,143,141,0,2,"PODEMOS",32
49,"49201",306,250,248,4,2,"PODEMOS",18
49,"49096",175,134,127,1,7,"PODEMOS",17
49,"49251",166,126,119,0,7,"PODEMOS",14
49,"49228",56,43,41,0,2,"PODEMOS",2
49,"49199",259,203,200,1,3,"PODEMOS",37
49,"49152",532,346,344,9,2,"PODEMOS",39
49,"49236",76,54,53,0,1,"PODEMOS",0
49,"49138",231,164,163,1,1,"PODEMOS",15
49,"49041",440,315,307,1,8,"PODEMOS",41
49,"49246",233,190,185,1,5,"PODEMOS",13
49,"49154",131,79,78,0,1,"PODEMOS",3
49,"49146",296,232,228,2,4,"PODEMOS",37
49,"49241",256,190,186,0,4,"PODEMOS",5
49,"49192",134,114,114,2,0,"PODEMOS",10
49,"49229",130,98,97,1,1,"PODEMOS",13
49,"49255",426,330,327,4,3,"PODEMOS",24
49,"49153",172,124,123,1,1,"PODEMOS",15
49,"49021",14387,10353,10196,117,157,"PODEMOS",1548
49,"49047",111,78,77,0,1,"PODEMOS",7
49,"49269",230,165,163,4,2,"PODEMOS",14
49,"49193",472,323,316,4,7,"PODEMOS",36
49,"49026",233,182,179,0,3,"PODEMOS",18
49,"49034",446,337,333,3,4,"PODEMOS",35
49,"49257",279,187,184,1,3,"PODEMOS",24
49,"49003",904,631,624,4,7,"PODEMOS",40
49,"49017",251,169,169,2,0,"PODEMOS",16
49,"49069",384,243,242,6,1,"PODEMOS",14
49,"49208",395,255,250,1,5,"PODEMOS",13
49,"49071",770,505,502,6,3,"PODEMOS",28
49,"49086",119,98,97,1,1,"PODEMOS",10
49,"49007",371,267,254,6,13,"PODEMOS",42
49,"49183",101,80,80,4,0,"PODEMOS",4
49,"49252",326,260,255,7,5,"PODEMOS",30
49,"49164",158,120,118,1,2,"PODEMOS",13
49,"49259",93,70,63,0,7,"PODEMOS",1
49,"49141",348,251,249,3,2,"PODEMOS",25
49,"49249",68,60,59,1,1,"PODEMOS",2
49,"49242",455,373,365,8,8,"PODEMOS",37
49,"49023",977,702,697,9,5,"PODEMOS",72
49,"49042",244,199,195,2,4,"PODEMOS",28
49,"49006",154,116,112,0,4,"PODEMOS",18
49,"49104",353,224,223,0,1,"PODEMOS",11
49,"49156",237,185,183,2,2,"PODEMOS",18
49,"49145",235,145,137,2,8,"PODEMOS",17
49,"49116",389,272,266,4,6,"PODEMOS",39
49,"49057",106,77,76,0,1,"PODEMOS",9
49,"49015",233,189,188,1,1,"PODEMOS",10
49,"49124",254,179,176,2,3,"PODEMOS",32
49,"49130",180,137,132,5,5,"PODEMOS",13
49,"49009",400,290,286,4,4,"PODEMOS",33
49,"49165",60,59,58,2,1,"PODEMOS",5
49,"49273",189,120,118,0,2,"PODEMOS",10
49,"49178",699,503,487,4,16,"PODEMOS",116
49,"49115",185,140,139,4,1,"PODEMOS",17
49,"49135",635,450,449,5,1,"PODEMOS",58
49,"49037",185,156,156,0,0,"PODEMOS",17
49,"49142",247,182,180,5,2,"PODEMOS",39
49,"49011",230,183,180,7,3,"PODEMOS",21
49,"49202",190,138,136,2,2,"PODEMOS",24
49,"49223",766,628,616,5,12,"PODEMOS",34
49,"49043",300,226,225,2,1,"PODEMOS",23
49,"49022",287,230,226,3,4,"PODEMOS",42
49,"49243",111,97,95,0,2,"PODEMOS",9
49,"49052",191,144,139,1,5,"PODEMOS",9
49,"49197",180,127,123,2,4,"PODEMOS",27
49,"49056",295,220,211,4,9,"PODEMOS",21
49,"49268",416,307,305,5,2,"PODEMOS",18
49,"49226",253,203,200,1,3,"PODEMOS",23
49,"49258",115,96,95,2,1,"PODEMOS",13
49,"49232",97,74,73,0,1,"PODEMOS",3
49,"49132",327,242,236,0,6,"PODEMOS",15
49,"49177",284,190,189,1,1,"PODEMOS",26
49,"49220",146,116,114,1,2,"PODEMOS",15
49,"49075",140,109,106,1,3,"PODEMOS",0
49,"49013",254,172,168,4,4,"PODEMOS",26
49,"49222",387,294,289,7,5,"PODEMOS",55
49,"49092",132,92,91,1,1,"PODEMOS",10
49,"49175",234,183,182,2,1,"PODEMOS",13
49,"49046",272,209,206,3,3,"PODEMOS",17
49,"49119",236,172,172,0,0,"PODEMOS",36
49,"49067",372,258,256,3,2,"PODEMOS",22
49,"49008",468,346,342,6,4,"PODEMOS",32
49,"49275",52483,38405,37981,427,424,"PODEMOS",6721
49,"49079",105,80,76,2,4,"PODEMOS",8
49,"49027",150,116,116,5,0,"PODEMOS",12
49,"49235",450,330,321,5,9,"PODEMOS",59
49,"49133",306,218,217,1,1,"PODEMOS",19
49,"49150",145,109,104,2,5,"PODEMOS",5
49,"49033",728,530,528,4,2,"PODEMOS",66
49,"49214",707,529,523,7,6,"PODEMOS",55
49,"49031",145,115,113,0,2,"PODEMOS",0
49,"49118",206,167,167,0,0,"PODEMOS",11
49,"49264",592,395,391,4,4,"PODEMOS",32
49,"49035",236,205,200,0,5,"PODEMOS",41
49,"49143",225,161,157,2,4,"PODEMOS",9
49,"49117",458,336,328,3,8,"PODEMOS",40
49,"49065",1121,850,835,8,15,"PODEMOS",49
49,"49004",128,92,88,2,4,"PODEMOS",11
49,"49048",134,84,84,0,0,"PODEMOS",8
16,"16033",1729,1385,1365,7,20,"RECORTES CE",1
16,"16124",1870,1536,1518,7,18,"RECORTES CE",1
16,"16024",130,100,98,0,2,"RECORTES CE",0
16,"16072",147,103,102,0,1,"RECORTES CE",1
16,"16046",250,181,180,1,1,"RECORTES CE",0
16,"16163",74,63,63,0,0,"RECORTES CE",0
16,"16212",255,208,206,1,2,"RECORTES CE",0
16,"16067",127,92,91,3,1,"RECORTES CE",0
16,"16042",1192,1021,1005,6,16,"RECORTES CE",2
16,"16049",156,121,121,0,0,"RECORTES CE",0
16,"16032",287,230,230,1,0,"RECORTES CE",0
16,"16056",465,333,322,0,11,"RECORTES CE",2
16,"16094",132,101,99,1,2,"RECORTES CE",0
16,"16065",406,323,319,3,4,"RECORTES CE",0
16,"16271",637,535,533,3,2,"RECORTES CE",1
16,"16093",64,52,52,0,0,"RECORTES CE",0
16,"16172",350,270,270,2,0,"RECORTES CE",0
16,"16043",99,73,73,1,0,"RECORTES CE",0
16,"16160",61,46,45,1,1,"RECORTES CE",1
16,"16150",94,67,67,1,0,"RECORTES CE",0
16,"16206",208,163,162,4,1,"RECORTES CE",0
16,"16068",145,117,114,2,3,"RECORTES CE",0
16,"16278",73,55,55,0,0,"RECORTES CE",1
16,"16085",136,108,108,2,0,"RECORTES CE",0
16,"16274",127,100,100,0,0,"RECORTES CE",0
16,"16169",58,33,32,0,1,"RECORTES CE",0
16,"16166",247,182,177,0,5,"RECORTES CE",0
16,"16053",429,352,348,5,4,"RECORTES CE",0
16,"16234",30,19,19,1,0,"RECORTES CE",0
16,"16162",43,35,35,0,0,"RECORTES CE",0
16,"16003",127,111,109,0,2,"RECORTES CE",1
16,"16108",49,43,42,0,1,"RECORTES CE",0
16,"16100",684,587,580,5,7,"RECORTES CE",0
16,"16197",65,37,37,0,0,"RECORTES CE",0
16,"16270",167,141,141,0,0,"RECORTES CE",0
16,"16272",228,167,167,1,0,"RECORTES CE",0
16,"16906",82,67,67,1,0,"RECORTES CE",0
16,"16111",171,138,137,2,1,"RECORTES CE",1
16,"16253",357,279,279,1,0,"RECORTES CE",0
16,"16050",251,195,194,1,1,"RECORTES CE",0
16,"16130",575,451,446,0,5,"RECORTES CE",2
16,"16097",162,135,135,1,0,"RECORTES CE",0
16,"16248",872,711,696,11,15,"RECORTES CE",0
16,"16008",95,72,72,0,0,"RECORTES CE",0
16,"16176",39,28,28,0,0,"RECORTES CE",0
16,"16079",32,21,20,0,1,"RECORTES CE",0
16,"16086",888,768,762,10,6,"RECORTES CE",0
16,"16015",376,286,285,7,1,"RECORTES CE",1
16,"16019",217,168,166,1,2,"RECORTES CE",0
16,"16039",398,275,271,1,4,"RECORTES CE",1
16,"16011",28,19,19,0,0,"RECORTES CE",0
16,"16064",681,588,581,1,7,"RECORTES CE",1
16,"16034",183,153,153,1,0,"RECORTES CE",0
16,"16047",230,176,176,2,0,"RECORTES CE",0
16,"16029",96,73,71,0,2,"RECORTES CE",0
16,"16001",75,60,60,0,0,"RECORTES CE",0
16,"16215",248,177,172,1,5,"RECORTES CE",0
16,"16071",20,20,20,0,0,"RECORTES CE",0
16,"16126",783,654,648,2,6,"RECORTES CE",0
16,"16016",234,173,172,2,1,"RECORTES CE",0
16,"16132",34,26,26,0,0,"RECORTES CE",0
16,"16087",212,186,186,5,0,"RECORTES CE",0
16,"16237",113,89,87,0,2,"RECORTES CE",0
16,"16211",377,253,250,3,3,"RECORTES CE",0
16,"16218",189,155,154,1,1,"RECORTES CE",0
16,"16175",5113,4203,4124,35,79,"RECORTES CE",3
16,"16133",4391,3539,3509,27,30,"RECORTES CE",2
16,"16017",370,300,296,2,4,"RECORTES CE",0
16,"16204",272,207,207,1,0,"RECORTES CE",3
16,"16259",30,26,26,1,0,"RECORTES CE",0
16,"16246",484,382,375,1,7,"RECORTES CE",0
16,"16057",78,60,60,0,0,"RECORTES CE",0
16,"16171",1818,1514,1498,5,16,"RECORTES CE",1
16,"16224",84,68,67,1,1,"RECORTES CE",0
16,"16116",84,62,62,0,0,"RECORTES CE",1
16,"16908",197,154,154,1,0,"RECORTES CE",0
16,"16227",112,84,84,0,0,"RECORTES CE",0
16,"16026",85,56,53,0,3,"RECORTES CE",1
16,"16006",119,96,94,1,2,"RECORTES CE",0
16,"16089",379,299,299,4,0,"RECORTES CE",0
16,"16265",21,16,16,0,0,"RECORTES CE",0
16,"16044",39,28,27,0,1,"RECORTES CE",0
16,"16242",325,281,278,1,3,"RECORTES CE",0
16,"16020",17,11,11,0,0,"RECORTES CE",0
16,"16280",189,160,157,2,3,"RECORTES CE",0
16,"16194",259,208,200,0,8,"RECORTES CE",1
16,"16038",38,28,28,0,0,"RECORTES CE",0
16,"16061",964,798,790,13,8,"RECORTES CE",0
16,"16099",208,157,152,0,5,"RECORTES CE",0
16,"16141",145,113,112,1,1,"RECORTES CE",0
16,"16905",1217,965,956,9,9,"RECORTES CE",4
16,"16217",75,58,58,0,0,"RECORTES CE",0
16,"16199",31,24,24,0,0,"RECORTES CE",0
16,"16240",108,79,79,0,0,"RECORTES CE",0
16,"16903",1081,824,816,6,8,"RECORTES CE",0
16,"16904",478,387,381,5,6,"RECORTES CE",0
16,"16255",141,119,119,0,0,"RECORTES CE",0
16,"16104",54,40,40,0,0,"RECORTES CE",0
16,"16174",192,155,155,1,0,"RECORTES CE",0
16,"16192",50,30,29,0,1,"RECORTES CE",0
16,"16188",90,63,62,0,1,"RECORTES CE",0
16,"16113",3080,2309,2278,15,31,"RECORTES CE",3
16,"16031",46,30,30,2,0,"RECORTES CE",0
16,"16066",2333,1917,1872,24,45,"RECORTES CE",0
16,"16040",85,71,71,0,0,"RECORTES CE",0
16,"16096",273,249,244,2,5,"RECORTES CE",0
16,"16110",97,71,70,0,1,"RECORTES CE",0
16,"16149",153,130,129,0,1,"RECORTES CE",0
16,"16062",24,21,21,0,0,"RECORTES CE",0
16,"16216",317,275,267,0,8,"RECORTES CE",0
16,"16129",104,82,79,1,3,"RECORTES CE",0
16,"16146",87,62,62,1,0,"RECORTES CE",0
16,"16009",66,48,48,0,0,"RECORTES CE",0
16,"16228",177,132,131,1,1,"RECORTES CE",0
16,"16275",11,11,11,1,0,"RECORTES CE",0
16,"16045",221,166,164,1,2,"RECORTES CE",0
16,"16125",1676,1338,1326,9,12,"RECORTES CE",1
16,"16140",27,15,15,0,0,"RECORTES CE",0
16,"16134",4369,3412,3369,23,43,"RECORTES CE",7
16,"16247",71,52,51,0,1,"RECORTES CE",0
16,"16107",120,87,87,1,0,"RECORTES CE",0
16,"16070",32,31,31,0,0,"RECORTES CE",0
16,"16118",1405,1147,1136,11,11,"RECORTES CE",1
16,"16181",64,53,53,0,0,"RECORTES CE",0
16,"16254",216,181,179,5,2,"RECORTES CE",1
16,"16239",141,110,107,0,3,"RECORTES CE",0
16,"16135",139,109,108,0,1,"RECORTES CE",0
16,"16266",373,279,273,1,6,"RECORTES CE",1
16,"16158",546,437,431,7,6,"RECORTES CE",0
16,"16191",926,760,752,6,8,"RECORTES CE",1
16,"16007",1192,964,959,8,5,"RECORTES CE",0
16,"16091",68,51,49,0,2,"RECORTES CE",0
16,"16195",498,380,376,1,4,"RECORTES CE",0
16,"16159",225,170,168,0,2,"RECORTES CE",0
16,"16013",31,28,28,0,0,"RECORTES CE",0
16,"16189",256,192,191,2,1,"RECORTES CE",0
16,"16106",2729,2130,2095,19,35,"RECORTES CE",2
16,"16203",9960,7515,7418,43,97,"RECORTES CE",11
16,"16202",783,573,566,3,7,"RECORTES CE",0
16,"16155",506,415,414,2,1,"RECORTES CE",0
16,"16250",76,57,57,0,0,"RECORTES CE",0
16,"16902",141,105,105,1,0,"RECORTES CE",0
16,"16035",258,192,192,3,0,"RECORTES CE",0
16,"16052",548,420,420,1,0,"RECORTES CE",1
16,"16213",35,28,28,1,0,"RECORTES CE",0
16,"16139",333,255,251,4,4,"RECORTES CE",0
16,"16143",16,12,12,2,0,"RECORTES CE",0
16,"16018",401,328,328,1,0,"RECORTES CE",1
16,"16245",418,338,333,2,5,"RECORTES CE",2
16,"16137",56,34,33,0,1,"RECORTES CE",0
16,"16901",707,520,513,3,7,"RECORTES CE",0
16,"16263",961,754,745,4,9,"RECORTES CE",1
16,"16115",44,33,33,0,0,"RECORTES CE",0
16,"16185",44,35,33,0,2,"RECORTES CE",0
16,"16041",354,284,282,0,2,"RECORTES CE",1
16,"16014",613,493,487,1,6,"RECORTES CE",1
16,"16243",412,354,348,0,6,"RECORTES CE",1
16,"16010",154,114,110,1,4,"RECORTES CE",0
16,"16251",1858,1450,1420,8,30,"RECORTES CE",1
16,"16167",324,275,271,2,4,"RECORTES CE",0
16,"16082",305,224,224,0,0,"RECORTES CE",0
16,"16022",78,63,61,0,2,"RECORTES CE",0
16,"16119",169,121,120,0,1,"RECORTES CE",0
16,"16101",160,130,129,0,1,"RECORTES CE",0
16,"16277",118,86,84,0,2,"RECORTES CE",0
16,"16231",48,38,38,0,0,"RECORTES CE",0
16,"16154",4904,3776,3730,47,46,"RECORTES CE",7
16,"16103",265,217,217,0,0,"RECORTES CE",0
16,"16244",722,625,617,2,8,"RECORTES CE",0
16,"16170",698,524,517,1,7,"RECORTES CE",2
16,"16055",703,512,509,7,3,"RECORTES CE",0
16,"16074",40,31,31,0,0,"RECORTES CE",0
16,"16131",134,97,97,1,0,"RECORTES CE",0
16,"16083",55,28,28,0,0,"RECORTES CE",0
16,"16186",465,394,387,2,7,"RECORTES CE",0
16,"16095",84,71,68,0,3,"RECORTES CE",0
16,"16012",82,69,69,0,0,"RECORTES CE",0
16,"16048",412,312,310,1,2,"RECORTES CE",0
16,"16025",25,21,21,1,0,"RECORTES CE",0
16,"16030",25,22,22,1,0,"RECORTES CE",0
16,"16147",62,43,43,0,0,"RECORTES CE",0
16,"16004",274,212,206,0,6,"RECORTES CE",0
16,"16157",213,185,182,0,3,"RECORTES CE",0
16,"16123",82,54,53,0,1,"RECORTES CE",0
16,"16236",914,694,689,6,5,"RECORTES CE",0
16,"16092",161,130,129,1,1,"RECORTES CE",0
16,"16909",706,537,534,3,3,"RECORTES CE",0
16,"16187",77,52,52,1,0,"RECORTES CE",1
16,"16264",433,374,370,2,4,"RECORTES CE",0
16,"16156",101,76,75,0,1,"RECORTES CE",0
16,"16173",207,155,154,1,1,"RECORTES CE",0
16,"16269",426,351,349,3,2,"RECORTES CE",0
16,"16190",5127,4088,4025,42,63,"RECORTES CE",3
16,"16058",105,81,80,0,1,"RECORTES CE",0
16,"16005",256,191,187,1,4,"RECORTES CE",0
16,"16165",63,51,50,1,1,"RECORTES CE",0
16,"16023",468,344,343,3,1,"RECORTES CE",1
16,"16098",571,468,461,5,7,"RECORTES CE",0
16,"16258",198,143,142,0,1,"RECORTES CE",0
16,"16073",188,158,158,0,0,"RECORTES CE",0
16,"16121",259,205,205,3,0,"RECORTES CE",0
16,"16122",254,200,198,4,2,"RECORTES CE",1
16,"16205",114,89,88,0,1,"RECORTES CE",0
16,"16078",41427,31365,31095,268,270,"RECORTES CE",72
16,"16177",78,63,63,0,0,"RECORTES CE",1
16,"16196",633,538,527,2,11,"RECORTES CE",1
16,"16112",1505,1088,1072,9,16,"RECORTES CE",1
16,"16081",49,38,37,0,1,"RECORTES CE",0
16,"16063",98,87,87,0,0,"RECORTES CE",0
16,"16109",43,32,32,0,0,"RECORTES CE",0
16,"16276",21,17,17,0,0,"RECORTES CE",0
16,"16910",96,70,70,0,0,"RECORTES CE",0
16,"16198",1365,1067,1052,12,15,"RECORTES CE",0
16,"16161",58,53,53,0,0,"RECORTES CE",0
16,"16002",192,172,172,0,0,"RECORTES CE",0
16,"16117",1057,814,808,2,6,"RECORTES CE",0
16,"16225",76,58,57,0,1,"RECORTES CE",0
16,"16148",587,511,511,1,0,"RECORTES CE",0
16,"16128",63,54,54,2,0,"RECORTES CE",0
16,"16051",147,118,118,0,0,"RECORTES CE",0
16,"16273",324,252,252,2,0,"RECORTES CE",0
16,"16060",760,600,593,5,7,"RECORTES CE",0
16,"16209",118,100,100,1,0,"RECORTES CE",0
16,"16151",64,60,60,0,0,"RECORTES CE",0
16,"16238",509,442,434,2,8,"RECORTES CE",0
16,"16084",49,37,32,0,5,"RECORTES CE",0
16,"16153",955,797,780,5,17,"RECORTES CE",0
16,"16088",114,92,92,0,0,"RECORTES CE",0
16,"16102",1231,922,911,8,11,"RECORTES CE",0
16,"16193",70,57,57,1,0,"RECORTES CE",0
16,"16279",213,146,143,0,3,"RECORTES CE",0
16,"16142",139,110,109,2,1,"RECORTES CE",0
16,"16027",709,567,562,4,5,"RECORTES CE",0
16,"16145",464,389,387,2,2,"RECORTES CE",0
16,"16249",1986,1593,1570,8,23,"RECORTES CE",5
16,"16219",91,72,72,0,0,"RECORTES CE",0
16,"16152",40,35,35,0,0,"RECORTES CE",0
16,"16036",128,104,102,2,2,"RECORTES CE",0
49,"49248",188,145,144,0,1,"IU-UPeC",3
49,"49141",348,251,249,3,2,"IU-UPeC",10
49,"49165",60,59,58,2,1,"IU-UPeC",2
49,"49220",146,116,114,1,2,"IU-UPeC",0
49,"49181",369,274,274,2,0,"IU-UPeC",4
49,"49244",45,28,28,0,0,"IU-UPeC",0
49,"49266",75,60,60,0,0,"IU-UPeC",0
49,"49224",160,109,106,4,3,"IU-UPeC",3
49,"49014",112,83,82,1,1,"IU-UPeC",3
49,"49219",7519,5407,5331,58,76,"IU-UPeC",234
49,"49128",557,428,424,2,4,"IU-UPeC",10
49,"49083",52,43,41,1,2,"IU-UPeC",1
49,"49173",379,229,227,5,2,"IU-UPeC",4
49,"49201",306,250,248,4,2,"IU-UPeC",3
49,"49039",333,259,252,1,7,"IU-UPeC",10
49,"49226",253,203,200,1,3,"IU-UPeC",0
49,"49102",198,148,145,1,3,"IU-UPeC",7
49,"49030",84,69,67,1,2,"IU-UPeC",1
49,"49177",284,190,189,1,1,"IU-UPeC",11
49,"49032",326,251,250,0,1,"IU-UPeC",8
49,"49174",130,95,94,2,1,"IU-UPeC",0
49,"49264",592,395,391,4,4,"IU-UPeC",8
49,"49123",547,414,410,0,4,"IU-UPeC",25
49,"49046",272,209,206,3,3,"IU-UPeC",4
49,"49167",205,147,144,0,3,"IU-UPeC",4
49,"49216",162,138,137,0,1,"IU-UPeC",6
49,"49018",331,252,245,1,7,"IU-UPeC",4
49,"49020",294,226,223,5,3,"IU-UPeC",22
49,"49075",140,109,106,1,3,"IU-UPeC",1
49,"49227",316,259,255,4,4,"IU-UPeC",8
49,"49088",92,70,70,0,0,"IU-UPeC",3
49,"49175",234,183,182,2,1,"IU-UPeC",1
49,"49179",393,265,263,0,2,"IU-UPeC",3
49,"49033",728,530,528,4,2,"IU-UPeC",7
49,"49008",468,346,342,6,4,"IU-UPeC",9
49,"49061",150,113,113,1,0,"IU-UPeC",7
49,"49147",267,190,189,2,1,"IU-UPeC",4
49,"49149",392,275,271,3,4,"IU-UPeC",10
49,"49262",392,268,266,1,2,"IU-UPeC",9
49,"49163",230,166,160,1,6,"IU-UPeC",6
49,"49268",416,307,305,5,2,"IU-UPeC",5
49,"49190",64,49,49,0,0,"IU-UPeC",1
49,"49138",231,164,163,1,1,"IU-UPeC",6
49,"49256",256,207,206,2,1,"IU-UPeC",2
49,"49171",648,507,500,5,7,"IU-UPeC",10
49,"49016",256,185,179,2,6,"IU-UPeC",4
49,"49012",72,47,47,1,0,"IU-UPeC",2
49,"49188",115,92,91,1,1,"IU-UPeC",2
49,"49047",111,78,77,0,1,"IU-UPeC",2
49,"49162",192,140,138,1,2,"IU-UPeC",2
49,"49041",440,315,307,1,8,"IU-UPeC",5
49,"49108",476,359,352,4,7,"IU-UPeC",12
49,"49022",287,230,226,3,4,"IU-UPeC",9
49,"49079",105,80,76,2,4,"IU-UPeC",3
49,"49002",64,48,48,1,0,"IU-UPeC",3
49,"49233",95,60,57,0,3,"IU-UPeC",0
49,"49247",454,301,296,3,5,"IU-UPeC",9
49,"49076",325,253,250,2,3,"IU-UPeC",5
49,"49202",190,138,136,2,2,"IU-UPeC",4
49,"49094",243,149,149,1,0,"IU-UPeC",1
49,"49115",185,140,139,4,1,"IU-UPeC",3
49,"49237",170,120,120,3,0,"IU-UPeC",3
49,"49077",189,115,115,0,0,"IU-UPeC",3
49,"49038",99,74,74,1,0,"IU-UPeC",0
49,"49137",176,140,137,2,3,"IU-UPeC",0
49,"49059",93,61,61,0,0,"IU-UPeC",2
49,"49036",521,375,371,3,4,"IU-UPeC",9
49,"49157",214,167,162,1,5,"IU-UPeC",7
49,"49104",353,224,223,0,1,"IU-UPeC",2
49,"49223",766,628,616,5,12,"IU-UPeC",9
49,"49096",175,134,127,1,7,"IU-UPeC",10
49,"49229",130,98,97,1,1,"IU-UPeC",0
49,"49168",90,73,73,2,0,"IU-UPeC",1
49,"49192",134,114,114,2,0,"IU-UPeC",1
49,"49251",166,126,119,0,7,"IU-UPeC",4
49,"49129",861,626,617,10,9,"IU-UPeC",39
49,"49114",44,31,30,0,1,"IU-UPeC",0
49,"49019",246,187,181,5,6,"IU-UPeC",7
49,"49250",1254,974,952,11,22,"IU-UPeC",28
49,"49154",131,79,78,0,1,"IU-UPeC",1
49,"49056",295,220,211,4,9,"IU-UPeC",1
49,"49050",513,349,348,3,1,"IU-UPeC",7
49,"49170",104,70,68,1,2,"IU-UPeC",1
49,"49120",74,53,51,0,2,"IU-UPeC",0
49,"49034",446,337,333,3,4,"IU-UPeC",12
49,"49145",235,145,137,2,8,"IU-UPeC",1
49,"49193",472,323,316,4,7,"IU-UPeC",14
49,"49119",236,172,172,0,0,"IU-UPeC",11
49,"49143",225,161,157,2,4,"IU-UPeC",5
49,"49037",185,156,156,0,0,"IU-UPeC",4
49,"49238",258,202,201,0,1,"IU-UPeC",12
49,"49087",523,322,319,0,3,"IU-UPeC",5
49,"49231",330,216,212,1,4,"IU-UPeC",4
49,"49209",510,347,345,5,2,"IU-UPeC",8
49,"49169",35,29,29,0,0,"IU-UPeC",0
49,"49186",263,189,187,0,2,"IU-UPeC",10
49,"49205",382,296,294,8,2,"IU-UPeC",6
49,"49068",472,292,289,2,3,"IU-UPeC",2
49,"49043",300,226,225,2,1,"IU-UPeC",12
49,"49197",180,127,123,2,4,"IU-UPeC",1
49,"49103",412,333,330,4,3,"IU-UPeC",3
49,"49044",85,56,55,0,1,"IU-UPeC",1
49,"49082",364,306,304,6,2,"IU-UPeC",12
49,"49235",450,330,321,5,9,"IU-UPeC",21
49,"49206",854,611,595,6,16,"IU-UPeC",28
49,"49007",371,267,254,6,13,"IU-UPeC",10
49,"49122",773,578,569,7,9,"IU-UPeC",25
49,"49245",261,178,174,0,4,"IU-UPeC",4
49,"49055",104,85,85,2,0,"IU-UPeC",1
49,"49187",1251,956,946,8,10,"IU-UPeC",19
49,"49222",387,294,289,7,5,"IU-UPeC",19
49,"49221",258,142,135,1,7,"IU-UPeC",5
49,"49097",90,47,47,0,0,"IU-UPeC",0
49,"49107",131,98,97,2,1,"IU-UPeC",2
49,"49099",132,85,85,1,0,"IU-UPeC",3
49,"49183",101,80,80,4,0,"IU-UPeC",0
49,"49093",287,233,231,2,2,"IU-UPeC",1
49,"49150",145,109,104,2,5,"IU-UPeC",0
49,"49272",88,73,73,1,0,"IU-UPeC",1
49,"49013",254,172,168,4,4,"IU-UPeC",3
49,"49204",64,45,44,0,1,"IU-UPeC",0
49,"49230",103,82,81,1,1,"IU-UPeC",1
49,"49010",346,285,282,3,3,"IU-UPeC",20
49,"49121",372,269,265,4,4,"IU-UPeC",9
49,"49261",1546,1171,1154,9,17,"IU-UPeC",88
49,"49180",156,101,101,0,0,"IU-UPeC",5
49,"49172",536,347,341,1,6,"IU-UPeC",5
49,"49040",117,99,99,1,0,"IU-UPeC",3
49,"49255",426,330,327,4,3,"IU-UPeC",5
49,"49225",153,95,92,2,3,"IU-UPeC",3
49,"49189",202,130,130,5,0,"IU-UPeC",1
49,"49057",106,77,76,0,1,"IU-UPeC",2
49,"49100",303,216,215,1,1,"IU-UPeC",8
49,"49263",54,41,41,0,0,"IU-UPeC",0
49,"49191",272,215,213,1,2,"IU-UPeC",6
49,"49006",154,116,112,0,4,"IU-UPeC",7
49,"49166",1225,945,934,11,11,"IU-UPeC",41
49,"49184",179,117,114,1,3,"IU-UPeC",2
49,"49054",908,668,651,13,17,"IU-UPeC",19
49,"49258",115,96,95,2,1,"IU-UPeC",0
49,"49062",121,82,81,1,1,"IU-UPeC",0
49,"49009",400,290,286,4,4,"IU-UPeC",2
49,"49042",244,199,195,2,4,"IU-UPeC",2
49,"49160",48,36,32,0,4,"IU-UPeC",3
49,"49134",187,115,110,0,5,"IU-UPeC",2
49,"49126",236,158,157,4,1,"IU-UPeC",2
49,"49242",455,373,365,8,8,"IU-UPeC",9
49,"49178",699,503,487,4,16,"IU-UPeC",27
49,"49080",692,523,518,6,5,"IU-UPeC",15
49,"49164",158,120,118,1,2,"IU-UPeC",2
49,"49132",327,242,236,0,6,"IU-UPeC",2
49,"49153",172,124,123,1,1,"IU-UPeC",10
49,"49090",194,148,147,1,1,"IU-UPeC",1
49,"49203",319,245,236,1,9,"IU-UPeC",2
49,"49095",297,233,231,1,2,"IU-UPeC",4
49,"49275",52483,38405,37981,427,424,"IU-UPeC",2968
49,"49207",237,156,155,0,1,"IU-UPeC",5
49,"49131",269,186,181,1,5,"IU-UPeC",7
49,"49199",259,203,200,1,3,"IU-UPeC",3
49,"49113",172,144,142,1,2,"IU-UPeC",2
49,"49111",130,96,96,6,0,"IU-UPeC",0
49,"49158",215,164,161,3,3,"IU-UPeC",8
49,"49027",150,116,116,5,0,"IU-UPeC",4
49,"49214",707,529,523,7,6,"IU-UPeC",15
49,"49116",389,272,266,4,6,"IU-UPeC",5
49,"49200",950,737,719,9,18,"IU-UPeC",4
49,"49142",247,182,180,5,2,"IU-UPeC",3
49,"49130",180,137,132,5,5,"IU-UPeC",7
49,"49257",279,187,184,1,3,"IU-UPeC",14
49,"49185",162,125,121,0,4,"IU-UPeC",6
49,"49025",174,128,126,0,2,"IU-UPeC",4
49,"49152",532,346,344,9,2,"IU-UPeC",21
49,"49148",249,143,141,0,2,"IU-UPeC",5
49,"49151",627,473,467,4,6,"IU-UPeC",19
49,"49011",230,183,180,7,3,"IU-UPeC",7
49,"49098",222,167,166,2,1,"IU-UPeC",2
49,"49052",191,144,139,1,5,"IU-UPeC",1
49,"49271",204,154,154,3,0,"IU-UPeC",3
49,"49135",635,450,449,5,1,"IU-UPeC",24
49,"49270",138,100,99,0,1,"IU-UPeC",6
49,"49267",91,75,74,1,1,"IU-UPeC",0
49,"49155",83,64,63,1,1,"IU-UPeC",0
49,"49023",977,702,697,9,5,"IU-UPeC",26
49,"49236",76,54,53,0,1,"IU-UPeC",0
49,"49127",2369,1752,1731,22,21,"IU-UPeC",79
49,"49004",128,92,88,2,4,"IU-UPeC",2
49,"49228",56,43,41,0,2,"IU-UPeC",0
49,"49015",233,189,188,1,1,"IU-UPeC",4
49,"49259",93,70,63,0,7,"IU-UPeC",0
49,"49085",1033,708,701,0,7,"IU-UPeC",23
49,"49246",233,190,185,1,5,"IU-UPeC",6
49,"49146",296,232,228,2,4,"IU-UPeC",8
49,"49024",667,464,457,7,7,"IU-UPeC",11
49,"49005",142,93,93,0,0,"IU-UPeC",2
49,"49105",155,121,121,0,0,"IU-UPeC",4
49,"49125",1400,977,957,10,20,"IU-UPeC",55
49,"49176",681,446,444,2,2,"IU-UPeC",2
49,"49210",478,365,358,4,7,"IU-UPeC",21
49,"49240",218,168,159,3,9,"IU-UPeC",6
49,"49003",904,631,624,4,7,"IU-UPeC",14
49,"49065",1121,850,835,8,15,"IU-UPeC",8
49,"49078",174,143,143,0,0,"IU-UPeC",6
49,"49031",145,115,113,0,2,"IU-UPeC",0
49,"49029",623,494,482,4,12,"IU-UPeC",7
49,"49064",521,343,339,2,4,"IU-UPeC",13
49,"49136",324,228,222,4,6,"IU-UPeC",5
49,"49092",132,92,91,1,1,"IU-UPeC",0
49,"49159",276,220,216,2,4,"IU-UPeC",11
49,"49048",134,84,84,0,0,"IU-UPeC",3
49,"49084",290,241,238,5,3,"IU-UPeC",16
49,"49021",14387,10353,10196,117,157,"IU-UPeC",520
49,"49101",153,106,101,3,5,"IU-UPeC",2
49,"49026",233,182,179,0,3,"IU-UPeC",3
49,"49035",236,205,200,0,5,"IU-UPeC",3
49,"49117",458,336,328,3,8,"IU-UPeC",13
49,"49139",170,139,136,0,3,"IU-UPeC",3
49,"49110",366,215,215,5,0,"IU-UPeC",4
49,"49081",1365,1071,1057,7,14,"IU-UPeC",38
49,"49249",68,60,59,1,1,"IU-UPeC",3
49,"49058",316,252,250,0,2,"IU-UPeC",7
49,"49017",251,169,169,2,0,"IU-UPeC",2
49,"49243",111,97,95,0,2,"IU-UPeC",1
49,"49208",395,255,250,1,5,"IU-UPeC",2
49,"49124",254,179,176,2,3,"IU-UPeC",5
49,"49086",119,98,97,1,1,"IU-UPeC",2
49,"49239",673,488,476,6,12,"IU-UPeC",12
49,"49194",377,229,228,2,1,"IU-UPeC",3
49,"49118",206,167,167,0,0,"IU-UPeC",3
49,"49269",230,165,163,4,2,"IU-UPeC",5
49,"49091",269,202,202,0,0,"IU-UPeC",12
49,"49028",122,103,102,1,1,"IU-UPeC",3
49,"49053",938,737,729,5,8,"IU-UPeC",23
49,"49071",770,505,502,6,3,"IU-UPeC",11
49,"49063",341,274,274,2,0,"IU-UPeC",8
49,"49232",97,74,73,0,1,"IU-UPeC",5
49,"49112",128,85,85,1,0,"IU-UPeC",2
49,"49252",326,260,255,7,5,"IU-UPeC",9
49,"49241",256,190,186,0,4,"IU-UPeC",3
49,"49067",372,258,256,3,2,"IU-UPeC",1
49,"49133",306,218,217,1,1,"IU-UPeC",11
49,"49234",410,336,334,1,2,"IU-UPeC",7
49,"49109",626,491,490,4,1,"IU-UPeC",4
49,"49265",128,91,91,1,0,"IU-UPeC",2
49,"49156",237,185,183,2,2,"IU-UPeC",3
49,"49273",189,120,118,0,2,"IU-UPeC",3
49,"49260",774,597,593,12,4,"IU-UPeC",18
49,"49066",498,336,328,4,8,"IU-UPeC",4
49,"49069",384,243,242,6,1,"IU-UPeC",2
28,"28059",4312,3256,3237,11,19,"SAIn",0
28,"28177",10192,8271,8234,51,37,"SAIn",4
28,"28060",1509,1194,1183,8,11,"SAIn",0
28,"28003",181,141,141,3,0,"SAIn",0
28,"28102",881,659,650,3,9,"SAIn",0
28,"28166",318,258,255,1,3,"SAIn",0
28,"28051",1542,1240,1232,5,8,"SAIn",0
28,"28074",138742,110456,109579,581,877,"SAIn",38
28,"28104",13836,11414,11349,54,65,"SAIn",0
28,"28084",15839,12028,11925,53,103,"SAIn",5
28,"28035",1362,1042,1033,3,9,"SAIn",0
28,"28070",119,91,91,0,0,"SAIn",0
28,"28073",12505,9485,9384,64,101,"SAIn",2
28,"28100",4169,3076,3048,12,28,"SAIn",7
28,"28094",825,636,634,3,2,"SAIn",0
28,"28065",125384,101604,100872,477,732,"SAIn",20
28,"28002",2966,2186,2175,9,11,"SAIn",0
28,"28052",3883,2801,2758,18,43,"SAIn",2
28,"28130",28243,22649,22458,135,191,"SAIn",6
28,"28116",700,544,544,3,0,"SAIn",1
28,"28146",1773,1274,1262,9,12,"SAIn",0
28,"28138",69,54,54,0,0,"SAIn",0
28,"28076",406,322,319,1,3,"SAIn",0
28,"28164",2986,2281,2263,12,18,"SAIn",1
28,"28180",5242,4040,3999,11,41,"SAIn",2
28,"28149",5653,4516,4469,19,47,"SAIn",0
28,"28009",14046,11014,10932,51,82,"SAIn",2
28,"28125",2965,2210,2188,13,22,"SAIn",0
28,"28047",40783,31308,31072,171,236,"SAIn",18
28,"28150",3084,2415,2381,13,34,"SAIn",0
28,"28072",5657,4465,4441,20,24,"SAIn",4
28,"28032",4749,3653,3607,19,46,"SAIn",0
28,"28006",78564,61796,61456,334,340,"SAIn",13
28,"28082",5664,4526,4492,25,34,"SAIn",0
28,"28153",703,510,507,2,3,"SAIn",7
28,"28117",95,84,84,0,0,"SAIn",0
28,"28155",507,420,420,0,0,"SAIn",1
28,"28043",5922,4063,4008,29,55,"SAIn",0
28,"28007",124358,99423,98711,554,712,"SAIn",28
28,"28012",883,702,691,4,11,"SAIn",0
28,"28141",5806,4532,4486,24,46,"SAIn",0
28,"28167",8308,6605,6545,35,60,"SAIn",1
28,"28115",60579,50819,50657,246,162,"SAIn",14
28,"28019",1237,952,938,2,14,"SAIn",0
28,"28080",48226,39753,39570,172,183,"SAIn",8
28,"28087",3176,2545,2528,15,17,"SAIn",0
28,"28050",4077,3032,3006,15,26,"SAIn",0
28,"28053",6458,5299,5263,29,36,"SAIn",4
28,"28124",76,56,54,0,2,"SAIn",0
28,"28062",308,244,241,3,3,"SAIn",0
28,"28126",39,25,25,0,0,"SAIn",0
28,"28075",5581,4380,4350,15,30,"SAIn",2
28,"28147",968,751,745,2,6,"SAIn",0
28,"28140",2981,2383,2357,14,26,"SAIn",0
28,"28131",12971,9828,9755,57,73,"SAIn",3
28,"28183",1050,770,763,2,7,"SAIn",0
28,"28903",32480,27640,27525,161,115,"SAIn",11
28,"28058",139289,108214,107323,612,891,"SAIn",32
28,"28044",5766,4623,4584,22,39,"SAIn",4
28,"28173",520,409,408,3,1,"SAIn",0
28,"28162",2549,2039,2025,13,14,"SAIn",0
28,"28107",435,326,321,0,5,"SAIn",0
28,"28090",8405,6792,6751,34,41,"SAIn",1
28,"28091",5436,3827,3786,23,41,"SAIn",0
28,"28027",1199,897,882,5,15,"SAIn",0
28,"28127",64513,53125,52932,300,193,"SAIn",15
28,"28144",5929,4776,4744,29,32,"SAIn",0
28,"28112",167,132,132,0,0,"SAIn",0
28,"28045",33019,25531,25313,146,218,"SAIn",6
28,"28101",218,180,180,0,0,"SAIn",0
28,"28066",7175,5598,5561,28,37,"SAIn",0
28,"28169",1427,1164,1158,1,6,"SAIn",0
28,"28069",54,43,43,1,0,"SAIn",0
28,"28018",3739,3071,3046,12,25,"SAIn",1
28,"28109",1591,1113,1111,3,2,"SAIn",3
28,"28151",3143,2352,2314,6,38,"SAIn",1
28,"28099",1731,1283,1278,8,5,"SAIn",0
28,"28123",56464,47181,46948,257,233,"SAIn",17
28,"28037",1566,1175,1168,5,7,"SAIn",0
28,"28152",16026,13269,13202,46,67,"SAIn",0
28,"28013",40409,30141,29905,164,236,"SAIn",3
28,"28079",2371327,1817203,1806970,9067,10233,"SAIn",604
28,"28048",499,406,401,2,5,"SAIn",0
28,"28179",1441,1082,1071,7,11,"SAIn",1
28,"28172",8965,7255,7219,44,36,"SAIn",1
28,"28011",445,339,338,0,1,"SAIn",0
28,"28067",4057,3220,3188,12,32,"SAIn",0
28,"28014",32852,24749,24571,120,178,"SAIn",5
28,"28064",134,105,105,0,0,"SAIn",1
28,"28093",2043,1681,1661,9,20,"SAIn",0
28,"28176",12288,9809,9763,50,46,"SAIn",5
28,"28096",18161,13784,13647,57,137,"SAIn",1
28,"28088",262,180,179,2,1,"SAIn",0
28,"28181",20344,16669,16572,95,97,"SAIn",2
28,"28143",70,59,59,1,0,"SAIn",0
28,"28128",439,323,320,2,3,"SAIn",0
28,"28004",6179,4377,4345,15,32,"SAIn",0
28,"28083",8880,6801,6759,47,42,"SAIn",4
28,"28119",2074,1641,1625,9,16,"SAIn",0
28,"28010",9853,7959,7914,35,45,"SAIn",2
28,"28055",899,682,676,4,6,"SAIn",0
28,"28085",3908,3106,3078,7,28,"SAIn",1
28,"28106",76612,56555,56006,346,549,"SAIn",16
28,"28122",518,388,385,2,3,"SAIn",0
28,"28022",32949,27473,27379,169,94,"SAIn",3
28,"28168",1226,910,900,1,10,"SAIn",0
28,"28034",352,270,269,1,1,"SAIn",0
28,"28902",468,352,347,2,5,"SAIn",0
28,"28029",530,426,424,3,2,"SAIn",0
28,"28135",971,740,735,4,5,"SAIn",0
28,"28134",60511,47566,47229,233,337,"SAIn",10
28,"28163",438,357,354,1,3,"SAIn",0
28,"28145",2370,1824,1809,12,15,"SAIn",0
28,"28054",11166,8649,8584,36,65,"SAIn",3
28,"28174",1788,1277,1267,2,10,"SAIn",0
28,"28178",1066,850,846,2,4,"SAIn",0
28,"28108",3330,2536,2528,17,8,"SAIn",0
28,"28171",4238,3002,2962,18,40,"SAIn",0
28,"28159",588,469,468,6,1,"SAIn",0
28,"28157",595,448,442,1,6,"SAIn",0
28,"28023",4697,3835,3817,20,18,"SAIn",0
28,"28086",5055,3627,3600,21,27,"SAIn",1
28,"28041",4452,3572,3550,24,22,"SAIn",5
28,"28057",1439,1125,1120,5,5,"SAIn",0
28,"28182",214,174,170,0,4,"SAIn",0
28,"28005",134211,104575,103819,667,756,"SAIn",60
28,"28046",4432,3562,3538,19,24,"SAIn",1
28,"28156",998,751,743,3,8,"SAIn",0
28,"28133",6002,4259,4204,12,55,"SAIn",0
28,"28042",1153,882,874,5,8,"SAIn",0
28,"28089",3703,2961,2933,19,28,"SAIn",0
28,"28025",427,329,326,1,3,"SAIn",0
28,"28049",58688,48006,47660,286,346,"SAIn",4
28,"28095",1508,1177,1167,6,10,"SAIn",0
28,"28170",2486,1757,1740,9,17,"SAIn",0
28,"28017",1210,954,943,6,11,"SAIn",0
28,"28033",3824,2854,2832,11,22,"SAIn",3
28,"28165",1788,1332,1321,5,11,"SAIn",0
28,"28028",1730,1347,1326,8,21,"SAIn",1
28,"28137",1644,1301,1283,7,18,"SAIn",0
28,"28063",252,195,194,2,1,"SAIn",0
28,"28024",152,129,128,1,1,"SAIn",0
28,"28097",124,85,84,1,1,"SAIn",0
28,"28158",662,545,543,3,2,"SAIn",0
28,"28160",8227,6295,6251,26,44,"SAIn",3
28,"28020",148,99,97,1,2,"SAIn",0
28,"28068",10928,8389,8315,43,74,"SAIn",9
28,"28129",7913,6175,6124,30,51,"SAIn",1
28,"28030",1716,1342,1316,2,26,"SAIn",0
28,"28114",149,103,103,1,0,"SAIn",0
28,"28136",640,540,532,0,8,"SAIn",0
28,"28001",64,48,48,3,0,"SAIn",0
28,"28092",151511,117869,116968,641,901,"SAIn",30
28,"28038",4935,3858,3815,17,43,"SAIn",3
28,"28026",6237,4893,4853,32,40,"SAIn",0
28,"28111",592,489,483,0,6,"SAIn",0
28,"28132",11645,8605,8520,55,85,"SAIn",1
28,"28036",2514,1974,1949,12,25,"SAIn",0
28,"28040",15691,10833,10728,45,105,"SAIn",3
28,"28016",80,57,57,0,0,"SAIn",0
28,"28015",18233,14725,14653,81,72,"SAIn",2
28,"28008",1768,1293,1282,4,11,"SAIn",0
28,"28154",5420,3966,3899,17,67,"SAIn",3
28,"28071",60,47,46,0,1,"SAIn",0
28,"28056",860,653,647,6,6,"SAIn",0
28,"28061",21200,16698,16600,75,98,"SAIn",7
28,"28118",58,49,48,1,1,"SAIn",0
28,"28031",2055,1538,1519,4,19,"SAIn",1
28,"28021",544,387,387,2,0,"SAIn",0
28,"28121",198,166,164,2,2,"SAIn",0
28,"28148",85022,65597,65111,368,486,"SAIn",23
28,"28110",1949,1543,1525,2,18,"SAIn",0
28,"28120",1217,918,904,4,14,"SAIn",3
28,"28161",48368,37462,37161,190,301,"SAIn",13
28,"28039",130,97,97,0,0,"SAIn",0
28,"28113",34305,27077,26881,156,196,"SAIn",5
28,"28078",36,34,34,0,0,"SAIn",0
28,"28175",850,696,692,2,4,"SAIn",0
28,"28901",789,590,584,2,6,"SAIn",0
32,"32060",845,609,598,6,11,"RECORTES CE",1
32,"32072",3833,2799,2761,26,38,"RECORTES CE",6
32,"32001",4978,3644,3607,31,37,"RECORTES CE",8
32,"32002",2016,1474,1460,11,14,"RECORTES CE",3
32,"32070",566,335,330,3,5,"RECORTES CE",0
32,"32073",1332,976,965,4,11,"RECORTES CE",3
32,"32065",669,494,482,3,12,"RECORTES CE",0
32,"32029",480,349,346,5,3,"RECORTES CE",2
32,"32034",1141,880,873,4,7,"RECORTES CE",1
32,"32061",1093,852,840,3,12,"RECORTES CE",1
32,"32056",1610,1159,1146,9,13,"RECORTES CE",1
32,"32009",10783,7555,7468,60,87,"RECORTES CE",14
32,"32031",1079,826,812,5,14,"RECORTES CE",1
32,"32025",1094,821,809,3,12,"RECORTES CE",1
32,"32010",394,299,298,0,1,"RECORTES CE",0
32,"32064",526,397,395,1,2,"RECORTES CE",0
32,"32062",832,646,644,7,2,"RECORTES CE",0
32,"32083",860,580,574,4,6,"RECORTES CE",0
32,"32024",4839,3424,3368,35,56,"RECORTES CE",5
32,"32045",2484,1820,1795,19,25,"RECORTES CE",4
32,"32037",742,544,532,8,12,"RECORTES CE",1
32,"32078",1243,876,869,6,7,"RECORTES CE",1
32,"32022",1377,963,951,7,12,"RECORTES CE",0
32,"32015",899,586,581,5,5,"RECORTES CE",0
32,"32076",2121,1509,1489,12,20,"RECORTES CE",0
32,"32012",811,535,533,3,2,"RECORTES CE",0
32,"32032",8101,5993,5881,74,112,"RECORTES CE",12
32,"32046",1179,840,832,5,8,"RECORTES CE",2
32,"32085",10709,7489,7403,81,86,"RECORTES CE",15
32,"32038",456,299,297,2,2,"RECORTES CE",1
32,"32011",934,559,548,5,11,"RECORTES CE",0
32,"32013",2213,1447,1431,8,16,"RECORTES CE",2
32,"32040",1472,1112,1089,9,23,"RECORTES CE",2
32,"32023",1217,884,877,6,7,"RECORTES CE",1
32,"32086",2671,1731,1712,10,19,"RECORTES CE",4
32,"32050",2455,1874,1855,17,19,"RECORTES CE",2
32,"32087",1798,1421,1397,7,24,"RECORTES CE",2
32,"32005",869,676,671,7,5,"RECORTES CE",1
32,"32084",925,657,650,3,7,"RECORTES CE",0
32,"32042",1585,1120,1104,13,16,"RECORTES CE",0
32,"32080",333,266,265,0,1,"RECORTES CE",0
32,"32068",1424,974,969,8,5,"RECORTES CE",0
32,"32077",1188,813,796,8,17,"RECORTES CE",0
32,"32071",1496,1013,1004,1,9,"RECORTES CE",1
32,"32063",1939,1329,1314,16,15,"RECORTES CE",3
32,"32075",4188,3257,3206,43,51,"RECORTES CE",4
32,"32074",1064,731,719,4,12,"RECORTES CE",0
32,"32043",2555,1824,1793,15,31,"RECORTES CE",2
32,"32027",1072,765,747,3,18,"RECORTES CE",0
32,"32089",1332,917,904,5,13,"RECORTES CE",1
32,"32092",528,337,334,4,3,"RECORTES CE",1
32,"32090",791,558,556,2,2,"RECORTES CE",0
32,"32039",1275,989,976,5,13,"RECORTES CE",0
32,"32004",1826,900,897,8,3,"RECORTES CE",1
32,"32057",575,414,412,5,2,"RECORTES CE",2
32,"32047",1818,1345,1329,3,16,"RECORTES CE",1
32,"32044",900,658,647,5,11,"RECORTES CE",1
32,"32052",1904,1450,1426,6,24,"RECORTES CE",4
32,"32016",825,559,556,3,3,"RECORTES CE",0
32,"32053",1447,1140,1128,12,12,"RECORTES CE",1
32,"32028",1643,1195,1174,18,21,"RECORTES CE",0
32,"32018",1261,956,945,3,11,"RECORTES CE",0
32,"32066",567,435,434,2,1,"RECORTES CE",0
32,"32008",8188,5923,5845,44,78,"RECORTES CE",24
32,"32019",11529,8038,7906,78,132,"RECORTES CE",17
32,"32049",775,502,495,5,7,"RECORTES CE",0
32,"32054",87290,63653,62823,671,830,"RECORTES CE",170
32,"32030",1015,702,689,3,13,"RECORTES CE",0
32,"32006",1571,1140,1127,10,13,"RECORTES CE",2
32,"32021",956,664,662,2,2,"RECORTES CE",0
32,"32088",1632,1062,1042,8,20,"RECORTES CE",1
32,"32041",772,511,505,5,6,"RECORTES CE",0
32,"32036",1369,1053,1040,5,13,"RECORTES CE",1
32,"32059",1849,1357,1339,16,18,"RECORTES CE",5
32,"32082",1259,905,887,6,18,"RECORTES CE",3
32,"32014",1170,855,845,7,10,"RECORTES CE",0
32,"32079",1343,1000,987,9,13,"RECORTES CE",4
32,"32048",906,573,564,6,9,"RECORTES CE",0
32,"32091",1909,1389,1375,8,14,"RECORTES CE",0
32,"32055",1310,952,936,7,16,"RECORTES CE",1
32,"32067",1300,838,824,15,14,"RECORTES CE",3
32,"32058",5209,3808,3750,27,58,"RECORTES CE",12
32,"32081",2097,1566,1553,6,13,"RECORTES CE",1
32,"32026",2736,2039,1998,25,41,"RECORTES CE",2
32,"32051",1458,1141,1137,4,4,"RECORTES CE",0
32,"32035",1484,944,938,7,6,"RECORTES CE",1
32,"32007",1527,1078,1070,7,8,"RECORTES CE",2
32,"32017",1272,862,849,5,13,"RECORTES CE",1
32,"32020",2625,1997,1974,10,23,"RECORTES CE",3
32,"32033",750,504,500,4,4,"RECORTES CE",1
32,"32069",4333,3324,3261,25,63,"RECORTES CE",8
32,"32003",886,661,653,6,8,"RECORTES CE",1
30,"30002",9921,7263,7166,34,97,"PP",3421
30,"30034",1138,859,846,5,13,"PP",391
30,"30010",6861,5287,5220,38,67,"PP",2363
30,"30027",47867,36054,35794,181,260,"PP",13348
30,"30021",9101,6106,6034,25,72,"PP",2907
30,"30043",24972,19411,19139,154,272,"PP",7721
30,"30024",58529,42392,42072,275,320,"PP",17300
30,"30016",151577,103359,102538,620,821,"PP",39711
30,"30042",1918,1518,1500,6,18,"PP",655
30,"30039",19199,13538,13405,101,133,"PP",5693
30,"30004",1141,938,933,5,5,"PP",419
30,"30037",18726,13183,13027,73,156,"PP",5890
30,"30012",9101,7170,7091,46,79,"PP",2199
30,"30011",4706,3582,3541,20,41,"PP",1663
30,"30006",803,683,681,2,2,"PP",377
30,"30036",14624,10139,9988,70,151,"PP",4595
30,"30032",2849,2188,2161,10,27,"PP",986
30,"30007",6415,4554,4515,19,39,"PP",1941
30,"30017",11635,8718,8646,46,72,"PP",3598
30,"30901",10331,7925,7833,54,92,"PP",3127
30,"30019",25921,18079,17894,121,185,"PP",7681
30,"30031",498,424,421,2,3,"PP",229
30,"30015",19154,13947,13835,77,112,"PP",5727
30,"30030",312625,235232,233576,1438,1656,"PP",95693
30,"30009",12392,9724,9599,40,125,"PP",4117
30,"30038",15381,10881,10797,51,84,"PP",4597
30,"30028",6690,5005,4938,29,67,"PP",1440
30,"30014",1598,1270,1258,5,12,"PP",430
30,"30005",29559,21408,21203,123,205,"PP",8684
30,"30026",15722,10147,10024,49,123,"PP",4271
30,"30902",8022,5454,5412,34,42,"PP",2127
30,"30029",11815,8365,8296,67,69,"PP",3293
30,"30023",3762,2871,2837,14,34,"PP",1088
30,"30035",18616,13185,13085,70,100,"PP",5519
30,"30020",6261,4502,4459,25,43,"PP",2136
30,"30003",24305,16558,16419,122,139,"PP",6213
30,"30033",10144,7591,7505,86,86,"PP",3243
30,"30040",727,627,620,1,7,"PP",295
30,"30041",13640,9156,9092,52,64,"PP",3192
30,"30001",4596,3602,3572,20,30,"PP",1794
30,"30025",4900,3777,3727,20,50,"PP",1300
30,"30018",7903,5990,5912,29,78,"PP",2269
30,"30008",13860,10066,9945,74,121,"PP",3686
30,"30013",7395,5320,5277,38,43,"PP",1569
30,"30022",16894,11661,11498,119,163,"PP",4648
46,"46001",802,623,615,4,8,"UPYD",3
46,"46206",577,475,468,4,7,"UPYD",3
46,"46160",1912,1523,1514,3,9,"UPYD",3
46,"46115",403,296,289,1,7,"UPYD",3
46,"46198",846,702,693,1,9,"UPYD",10
46,"46082",4947,3843,3814,25,29,"UPYD",36
46,"46079",326,267,265,2,2,"UPYD",0
46,"46069",161,126,122,0,4,"UPYD",0
46,"46255",3145,2494,2470,19,24,"UPYD",12
46,"46231",2411,1759,1735,11,24,"UPYD",5
46,"46183",6009,4624,4563,18,61,"UPYD",13
46,"46054",11251,8795,8731,46,64,"UPYD",51
46,"46024",424,348,340,0,8,"UPYD",2
46,"46229",972,785,774,2,11,"UPYD",0
46,"46062",4652,3650,3583,32,67,"UPYD",15
46,"46138",345,292,292,0,0,"UPYD",2
46,"46146",1670,1333,1318,11,15,"UPYD",7
46,"46055",1273,1031,1021,4,10,"UPYD",5
46,"46002",1175,947,935,5,12,"UPYD",4
46,"46207",6656,5355,5293,42,62,"UPYD",28
46,"46047",525,443,435,2,8,"UPYD",1
46,"46161",1481,1206,1194,6,12,"UPYD",8
46,"46070",16903,13091,12999,64,92,"UPYD",112
46,"46256",6833,5087,5062,37,25,"UPYD",32
46,"46232",894,715,712,5,3,"UPYD",7
46,"46071",466,383,379,2,4,"UPYD",4
46,"46257",5579,4440,4391,26,49,"UPYD",25
46,"46025",2502,2008,1993,6,15,"UPYD",7
46,"46230",13944,10746,10646,69,100,"UPYD",65
46,"46223",7814,6169,6129,33,40,"UPYD",40
46,"46104",1956,1567,1543,6,24,"UPYD",1
46,"46180",682,581,572,1,9,"UPYD",5
46,"46252",126,95,93,0,2,"UPYD",0
46,"46139",4495,3629,3577,26,52,"UPYD",16
46,"46048",3448,2817,2790,8,27,"UPYD",6
46,"46140",349,288,284,2,4,"UPYD",1
46,"46049",280,242,238,1,4,"UPYD",0
46,"46003",963,841,815,1,26,"UPYD",2
46,"46208",1114,931,922,3,9,"UPYD",1
46,"46034",1776,1441,1430,4,11,"UPYD",7
46,"46239",451,353,351,3,2,"UPYD",3
46,"46155",1035,865,846,2,19,"UPYD",1
46,"46201",67,49,49,0,0,"UPYD",1
46,"46127",2706,2212,2175,10,37,"UPYD",9
46,"46903",5985,4822,4796,24,26,"UPYD",51
46,"46026",1204,1044,1034,4,10,"UPYD",4
46,"46260",2572,2100,2081,10,19,"UPYD",9
46,"46064",527,429,423,0,6,"UPYD",1
46,"46072",3625,2993,2931,37,62,"UPYD",13
46,"46258",2676,2099,2078,9,21,"UPYD",11
46,"46029",20649,15241,15110,113,131,"UPYD",82
46,"46186",19033,15061,14950,70,111,"UPYD",110
46,"46057",495,339,337,6,2,"UPYD",1
46,"46095",608,498,493,2,5,"UPYD",2
46,"46141",438,359,348,4,11,"UPYD",0
46,"46050",200,160,160,0,0,"UPYD",1
46,"46004",1924,1582,1559,11,23,"UPYD",10
46,"46209",1955,1531,1508,7,23,"UPYD",4
46,"46080",1025,795,784,4,11,"UPYD",1
46,"46904",802,662,654,7,8,"UPYD",2
46,"46027",948,795,781,3,14,"UPYD",1
46,"46261",1720,1386,1369,10,17,"UPYD",5
46,"46065",1588,1246,1227,5,19,"UPYD",0
46,"46251",2490,2082,2045,11,37,"UPYD",6
46,"46073",1097,903,892,6,11,"UPYD",3
46,"46259",503,410,406,2,4,"UPYD",1
46,"46240",209,169,164,1,5,"UPYD",1
46,"46187",1310,1036,1028,6,8,"UPYD",3
46,"46220",48393,35859,35571,250,288,"UPYD",329
46,"46175",459,403,396,1,7,"UPYD",0
46,"46149",362,288,287,2,1,"UPYD",0
46,"46096",279,229,225,2,4,"UPYD",2
46,"46005",22908,17565,17438,126,127,"UPYD",95
46,"46210",338,295,283,2,12,"UPYD",0
46,"46172",5040,3629,3599,14,30,"UPYD",31
46,"46006",4529,3803,3748,18,55,"UPYD",10
46,"46211",1723,1441,1434,13,7,"UPYD",6
46,"46165",7115,5626,5576,31,50,"UPYD",39
46,"46120",1109,919,902,4,17,"UPYD",1
46,"46158",1024,817,804,5,13,"UPYD",7
46,"46203",3598,2962,2928,17,34,"UPYD",6
46,"46135",9655,7845,7810,32,35,"UPYD",58
46,"46074",2690,2158,2145,18,13,"UPYD",9
46,"46236",975,810,806,4,4,"UPYD",3
46,"46112",552,466,464,1,2,"UPYD",1
46,"46188",668,548,538,3,10,"UPYD",0
46,"46226",48,44,44,0,0,"UPYD",0
46,"46234",354,289,287,2,2,"UPYD",2
46,"46151",722,589,583,1,6,"UPYD",3
46,"46143",4215,3219,3171,27,48,"UPYD",11
46,"46105",16249,11731,11629,59,102,"UPYD",52
46,"46007",11953,9099,9038,65,61,"UPYD",73
46,"46212",1612,1234,1214,5,20,"UPYD",7
46,"46045",1261,1066,1041,3,25,"UPYD",6
46,"46052",502,432,431,2,1,"UPYD",0
46,"46128",1601,1316,1281,5,35,"UPYD",6
46,"46075",149,132,130,2,2,"UPYD",1
46,"46237",7227,5620,5571,33,49,"UPYD",44
46,"46076",587,489,483,2,6,"UPYD",1
46,"46262",232,172,168,0,4,"UPYD",0
46,"46030",804,660,635,7,25,"UPYD",3
46,"46235",21793,16577,16424,118,153,"UPYD",85
46,"46061",337,281,281,3,0,"UPYD",1
46,"46099",922,693,685,0,8,"UPYD",4
46,"46063",1757,1399,1384,11,15,"UPYD",2
46,"46225",346,299,290,0,9,"UPYD",0
46,"46111",10876,8133,8050,35,83,"UPYD",52
46,"46144",665,525,520,2,5,"UPYD",3
46,"46053",560,454,451,2,3,"UPYD",5
46,"46167",373,286,285,1,1,"UPYD",1
46,"46038",345,255,255,0,0,"UPYD",1
46,"46008",2673,2201,2189,8,12,"UPYD",8
46,"46213",15476,11377,11246,110,131,"UPYD",112
46,"46077",7569,6100,6010,41,90,"UPYD",31
46,"46263",255,204,202,1,2,"UPYD",1
46,"46122",2701,2120,2109,18,11,"UPYD",11
46,"46153",441,358,354,0,4,"UPYD",3
46,"46249",9362,7163,7072,42,91,"UPYD",47
46,"46009",3144,2579,2552,13,27,"UPYD",13
46,"46031",10520,7830,7759,70,71,"UPYD",38
46,"46036",583,384,381,8,3,"UPYD",3
46,"46193",8795,7101,7061,40,40,"UPYD",26
46,"46145",21946,16629,16495,80,134,"UPYD",70
46,"46221",339,305,303,0,2,"UPYD",0
46,"46178",4643,3465,3434,16,31,"UPYD",18
46,"46191",1970,1557,1533,6,24,"UPYD",3
46,"46148",1528,1206,1192,15,14,"UPYD",10
46,"46100",289,240,237,1,3,"UPYD",1
46,"46176",2025,1431,1416,10,15,"UPYD",5
46,"46012",888,723,703,3,20,"UPYD",1
46,"46182",1274,970,966,2,4,"UPYD",5
46,"46214",15730,12427,12334,56,93,"UPYD",70
46,"46245",516,427,420,3,7,"UPYD",1
46,"46085",11147,8107,8033,57,74,"UPYD",39
46,"46032",5635,4529,4493,16,36,"UPYD",20
46,"46156",2087,1712,1702,9,10,"UPYD",6
46,"46194",15552,11606,11505,69,101,"UPYD",59
46,"46078",28126,20975,20850,127,125,"UPYD",152
46,"46902",379,314,313,3,1,"UPYD",0
46,"46154",811,644,640,4,4,"UPYD",1
46,"46147",16843,12206,12099,56,107,"UPYD",82
46,"46185",386,325,321,4,4,"UPYD",0
46,"46020",3784,3064,3012,15,52,"UPYD",10
46,"46244",58586,43371,43098,257,273,"UPYD",327
46,"46106",1543,1177,1167,5,10,"UPYD",5
46,"46142",797,619,608,2,11,"UPYD",6
46,"46010",914,725,716,4,9,"UPYD",6
46,"46215",1433,1152,1149,4,3,"UPYD",1
46,"46011",7627,5496,5407,39,89,"UPYD",21
46,"46216",5039,4207,4188,20,19,"UPYD",33
46,"46170",3451,2821,2775,16,46,"UPYD",7
46,"46041",331,254,253,6,1,"UPYD",2
46,"46246",1066,856,838,7,18,"UPYD",1
46,"46125",857,709,701,5,8,"UPYD",1
46,"46217",886,724,712,3,12,"UPYD",1
46,"46219",125,106,105,2,1,"UPYD",0
46,"46088",176,140,138,0,2,"UPYD",0
46,"46171",16587,12731,12627,79,104,"UPYD",102
46,"46241",400,324,314,1,10,"UPYD",6
46,"46117",493,414,411,4,3,"UPYD",4
46,"46102",19843,15783,15676,102,107,"UPYD",94
46,"46107",1915,1566,1553,2,13,"UPYD",9
46,"46118",3795,2987,2962,18,25,"UPYD",11
46,"46022",15481,11422,11347,69,75,"UPYD",58
46,"46224",170,130,130,0,0,"UPYD",0
46,"46181",17066,12779,12636,96,143,"UPYD",56
46,"46015",7231,5768,5711,33,57,"UPYD",30
46,"46195",1967,1612,1602,9,10,"UPYD",8
46,"46126",5555,4619,4574,26,45,"UPYD",29
46,"46166",8155,6521,6450,41,71,"UPYD",30
46,"46042",3389,2886,2844,19,42,"UPYD",10
46,"46247",1024,743,733,2,10,"UPYD",5
46,"46133",563,458,455,2,3,"UPYD",1
46,"46199",5742,4458,4425,34,33,"UPYD",19
46,"46043",145,131,131,0,0,"UPYD",1
46,"46150",1839,1377,1362,10,15,"UPYD",1
46,"46157",2978,2370,2343,19,27,"UPYD",5
46,"46081",10180,8055,7984,32,71,"UPYD",39
46,"46066",1255,1028,1020,6,8,"UPYD",5
46,"46089",2141,1649,1625,14,24,"UPYD",9
46,"46132",2148,1850,1830,12,20,"UPYD",16
46,"46179",2182,1823,1788,13,35,"UPYD",7
46,"46068",354,305,297,1,8,"UPYD",3
46,"46083",15467,11584,11443,79,141,"UPYD",51
46,"46058",1779,1430,1409,10,21,"UPYD",4
46,"46177",4698,3715,3665,16,50,"UPYD",17
46,"46091",115,101,100,1,1,"UPYD",0
46,"46250",578668,455375,452638,2701,2737,"UPYD",3863
46,"46123",1838,1466,1447,4,19,"UPYD",8
46,"46013",17366,13952,13862,95,90,"UPYD",135
46,"46218",1074,930,912,1,18,"UPYD",5
46,"46253",109,93,93,0,0,"UPYD",0
46,"46014",3042,2456,2434,17,22,"UPYD",11
46,"46254",1012,786,775,1,11,"UPYD",4
46,"46109",6195,4764,4682,23,82,"UPYD",27
46,"46093",2117,1721,1710,10,11,"UPYD",22
46,"46242",340,291,285,1,6,"UPYD",1
46,"46159",22905,17498,17373,102,125,"UPYD",114
46,"46021",23646,18220,18100,85,120,"UPYD",145
46,"46204",6781,5421,5379,15,42,"UPYD",43
46,"46086",82,73,73,1,0,"UPYD",0
46,"46017",33050,24762,24580,144,182,"UPYD",142
46,"46067",1736,1457,1382,2,75,"UPYD",4
46,"46228",2363,1854,1839,16,15,"UPYD",14
46,"46192",767,573,568,1,5,"UPYD",12
46,"46173",1336,1097,1080,9,17,"UPYD",2
46,"46137",268,225,220,3,5,"UPYD",2
46,"46119",783,672,666,7,6,"UPYD",2
46,"46040",1098,914,907,4,7,"UPYD",0
46,"46131",49604,37767,37431,266,336,"UPYD",236
46,"46037",1119,952,941,2,11,"UPYD",4
46,"46101",858,731,723,4,8,"UPYD",0
46,"46169",32396,25109,24953,169,156,"UPYD",168
46,"46243",141,122,120,0,2,"UPYD",0
46,"46227",915,771,765,5,6,"UPYD",4
46,"46197",1956,1556,1543,8,13,"UPYD",10
46,"46084",1576,1314,1298,6,16,"UPYD",2
46,"46130",907,722,713,6,9,"UPYD",3
46,"46196",153,131,130,0,1,"UPYD",0
46,"46060",9361,7285,7229,30,56,"UPYD",32
46,"46035",6786,5382,5338,27,44,"UPYD",23
46,"46090",1640,1440,1424,4,16,"UPYD",9
46,"46174",984,808,794,3,14,"UPYD",0
46,"46136",2534,2008,1990,13,18,"UPYD",11
46,"46016",1068,885,874,3,11,"UPYD",0
46,"46018",635,531,522,3,9,"UPYD",1
46,"46152",97,76,74,0,2,"UPYD",0
46,"46039",2147,1746,1727,9,19,"UPYD",9
46,"46116",13153,10566,10518,62,48,"UPYD",65
46,"46114",575,488,484,3,4,"UPYD",4
46,"46233",3904,2974,2934,15,40,"UPYD",10
46,"46190",48824,36748,36542,238,206,"UPYD",268
46,"46238",13324,10023,9939,50,84,"UPYD",49
46,"46103",1270,1015,998,8,17,"UPYD",3
46,"46164",11777,8893,8798,54,95,"UPYD",49
46,"46019",8833,7183,7109,47,74,"UPYD",22
46,"46168",1938,1542,1530,11,12,"UPYD",8
46,"46163",1847,1508,1489,8,19,"UPYD",16
46,"46162",1207,962,947,3,15,"UPYD",1
46,"46051",8347,6500,6442,27,58,"UPYD",26
46,"46222",383,322,321,2,1,"UPYD",0
46,"46028",395,346,339,2,7,"UPYD",2
46,"46098",2491,1978,1950,14,28,"UPYD",4
46,"46023",328,294,287,2,7,"UPYD",1
46,"46087",127,99,99,1,0,"UPYD",1
46,"46121",105,92,91,2,1,"UPYD",0
46,"46202",16767,13171,13058,59,113,"UPYD",91
46,"46108",480,375,375,2,0,"UPYD",1
46,"46124",788,680,672,0,8,"UPYD",8
46,"46110",21260,16194,16084,76,110,"UPYD",124
46,"46033",197,169,168,1,1,"UPYD",0
46,"46044",4237,3347,3285,25,62,"UPYD",21
46,"46200",1909,1628,1609,5,19,"UPYD",15
46,"46113",2436,1864,1849,11,15,"UPYD",10
46,"46189",471,412,405,2,7,"UPYD",4
46,"46097",959,734,728,6,6,"UPYD",4
46,"46046",896,697,686,1,11,"UPYD",1
46,"46248",4873,3679,3639,18,40,"UPYD",12
46,"46059",1272,1066,1058,4,8,"UPYD",0
46,"46129",521,435,434,2,1,"UPYD",1
46,"46184",26467,20888,20675,138,213,"UPYD",116
46,"46094",20515,15885,15785,125,100,"UPYD",119
46,"46134",2357,1811,1797,8,14,"UPYD",26
46,"46205",14323,11325,11224,55,101,"UPYD",83
46,"46056",184,160,158,1,2,"UPYD",1
46,"46092",273,183,183,0,0,"UPYD",0
28,"28167",8308,6605,6545,35,60,"FE de las J",14
28,"28149",5653,4516,4469,19,47,"FE de las J",7
28,"28051",1542,1240,1232,5,8,"FE de las J",3
28,"28017",1210,954,943,6,11,"FE de las J",2
28,"28009",14046,11014,10932,51,82,"FE de las J",23
28,"28109",1591,1113,1111,3,2,"FE de las J",3
28,"28004",6179,4377,4345,15,32,"FE de las J",7
28,"28099",1731,1283,1278,8,5,"FE de las J",3
28,"28132",11645,8605,8520,55,85,"FE de las J",24
28,"28052",3883,2801,2758,18,43,"FE de las J",5
28,"28119",2074,1641,1625,9,16,"FE de las J",2
28,"28058",139289,108214,107323,612,891,"FE de las J",194
28,"28104",13836,11414,11349,54,65,"FE de las J",16
28,"28055",899,682,676,4,6,"FE de las J",4
28,"28059",4312,3256,3237,11,19,"FE de las J",7
28,"28116",700,544,544,3,0,"FE de las J",7
28,"28066",7175,5598,5561,28,37,"FE de las J",5
28,"28072",5657,4465,4441,20,24,"FE de las J",7
28,"28092",151511,117869,116968,641,901,"FE de las J",160
28,"28127",64513,53125,52932,300,193,"FE de las J",50
28,"28084",15839,12028,11925,53,103,"FE de las J",25
28,"28178",1066,850,846,2,4,"FE de las J",2
28,"28039",130,97,97,0,0,"FE de las J",0
28,"28123",56464,47181,46948,257,233,"FE de las J",41
28,"28141",5806,4532,4486,24,46,"FE de las J",8
28,"28114",149,103,103,1,0,"FE de las J",5
28,"28038",4935,3858,3815,17,43,"FE de las J",5
28,"28093",2043,1681,1661,9,20,"FE de las J",4
28,"28046",4432,3562,3538,19,24,"FE de las J",5
28,"28044",5766,4623,4584,22,39,"FE de las J",15
28,"28148",85022,65597,65111,368,486,"FE de las J",103
28,"28131",12971,9828,9755,57,73,"FE de las J",17
28,"28067",4057,3220,3188,12,32,"FE de las J",8
28,"28063",252,195,194,2,1,"FE de las J",0
28,"28165",1788,1332,1321,5,11,"FE de las J",0
28,"28115",60579,50819,50657,246,162,"FE de las J",42
28,"28155",507,420,420,0,0,"FE de las J",1
28,"28037",1566,1175,1168,5,7,"FE de las J",0
28,"28028",1730,1347,1326,8,21,"FE de las J",4
28,"28049",58688,48006,47660,286,346,"FE de las J",52
28,"28054",11166,8649,8584,36,65,"FE de las J",12
28,"28075",5581,4380,4350,15,30,"FE de las J",11
28,"28020",148,99,97,1,2,"FE de las J",0
28,"28011",445,339,338,0,1,"FE de las J",6
28,"28012",883,702,691,4,11,"FE de las J",4
28,"28118",58,49,48,1,1,"FE de las J",0
28,"28121",198,166,164,2,2,"FE de las J",1
28,"28015",18233,14725,14653,81,72,"FE de las J",28
28,"28136",640,540,532,0,8,"FE de las J",0
28,"28143",70,59,59,1,0,"FE de las J",0
28,"28089",3703,2961,2933,19,28,"FE de las J",9
28,"28177",10192,8271,8234,51,37,"FE de las J",5
28,"28023",4697,3835,3817,20,18,"FE de las J",5
28,"28176",12288,9809,9763,50,46,"FE de las J",15
28,"28166",318,258,255,1,3,"FE de las J",0
28,"28113",34305,27077,26881,156,196,"FE de las J",43
28,"28151",3143,2352,2314,6,38,"FE de las J",3
28,"28026",6237,4893,4853,32,40,"FE de las J",5
28,"28140",2981,2383,2357,14,26,"FE de las J",9
28,"28100",4169,3076,3048,12,28,"FE de las J",6
28,"28120",1217,918,904,4,14,"FE de las J",1
28,"28901",789,590,584,2,6,"FE de las J",1
28,"28179",1441,1082,1071,7,11,"FE de las J",2
28,"28043",5922,4063,4008,29,55,"FE de las J",9
28,"28018",3739,3071,3046,12,25,"FE de las J",3
28,"28014",32852,24749,24571,120,178,"FE de las J",42
28,"28071",60,47,46,0,1,"FE de las J",0
28,"28074",138742,110456,109579,581,877,"FE de las J",155
28,"28094",825,636,634,3,2,"FE de las J",2
28,"28107",435,326,321,0,5,"FE de las J",4
28,"28150",3084,2415,2381,13,34,"FE de las J",7
28,"28010",9853,7959,7914,35,45,"FE de las J",3
28,"28031",2055,1538,1519,4,19,"FE de las J",1
28,"28152",16026,13269,13202,46,67,"FE de las J",16
28,"28033",3824,2854,2832,11,22,"FE de las J",3
28,"28050",4077,3032,3006,15,26,"FE de las J",6
28,"28144",5929,4776,4744,29,32,"FE de las J",3
28,"28003",181,141,141,3,0,"FE de las J",0
28,"28013",40409,30141,29905,164,236,"FE de las J",40
28,"28082",5664,4526,4492,25,34,"FE de las J",3
28,"28183",1050,770,763,2,7,"FE de las J",4
28,"28053",6458,5299,5263,29,36,"FE de las J",10
28,"28048",499,406,401,2,5,"FE de las J",1
28,"28125",2965,2210,2188,13,22,"FE de las J",3
28,"28112",167,132,132,0,0,"FE de las J",0
28,"28168",1226,910,900,1,10,"FE de las J",0
28,"28160",8227,6295,6251,26,44,"FE de las J",9
28,"28101",218,180,180,0,0,"FE de las J",0
28,"28181",20344,16669,16572,95,97,"FE de las J",15
28,"28007",124358,99423,98711,554,712,"FE de las J",85
28,"28002",2966,2186,2175,9,11,"FE de las J",9
28,"28171",4238,3002,2962,18,40,"FE de las J",5
28,"28134",60511,47566,47229,233,337,"FE de las J",57
28,"28159",588,469,468,6,1,"FE de las J",0
28,"28126",39,25,25,0,0,"FE de las J",0
28,"28106",76612,56555,56006,346,549,"FE de las J",143
28,"28006",78564,61796,61456,334,340,"FE de las J",68
28,"28122",518,388,385,2,3,"FE de las J",1
28,"28173",520,409,408,3,1,"FE de las J",0
28,"28117",95,84,84,0,0,"FE de las J",0
28,"28153",703,510,507,2,3,"FE de las J",1
28,"28096",18161,13784,13647,57,137,"FE de las J",24
28,"28086",5055,3627,3600,21,27,"FE de las J",8
28,"28073",12505,9485,9384,64,101,"FE de las J",17
28,"28128",439,323,320,2,3,"FE de las J",0
28,"28029",530,426,424,3,2,"FE de las J",1
28,"28130",28243,22649,22458,135,191,"FE de las J",32
28,"28170",2486,1757,1740,9,17,"FE de las J",4
28,"28135",971,740,735,4,5,"FE de las J",1
28,"28138",69,54,54,0,0,"FE de las J",0
28,"28076",406,322,319,1,3,"FE de las J",1
28,"28172",8965,7255,7219,44,36,"FE de las J",15
28,"28040",15691,10833,10728,45,105,"FE de las J",22
28,"28164",2986,2281,2263,12,18,"FE de las J",6
28,"28045",33019,25531,25313,146,218,"FE de las J",43
28,"28097",124,85,84,1,1,"FE de las J",0
28,"28016",80,57,57,0,0,"FE de las J",0
28,"28158",662,545,543,3,2,"FE de las J",0
28,"28108",3330,2536,2528,17,8,"FE de las J",2
28,"28163",438,357,354,1,3,"FE de las J",1
28,"28090",8405,6792,6751,34,41,"FE de las J",12
28,"28030",1716,1342,1316,2,26,"FE de las J",1
28,"28146",1773,1274,1262,9,12,"FE de las J",6
28,"28064",134,105,105,0,0,"FE de las J",0
28,"28110",1949,1543,1525,2,18,"FE de las J",2
28,"28065",125384,101604,100872,477,732,"FE de las J",142
28,"28022",32949,27473,27379,169,94,"FE de las J",27
28,"28060",1509,1194,1183,8,11,"FE de las J",3
28,"28078",36,34,34,0,0,"FE de las J",0
28,"28124",76,56,54,0,2,"FE de las J",0
28,"28137",1644,1301,1283,7,18,"FE de las J",3
28,"28147",968,751,745,2,6,"FE de las J",1
28,"28024",152,129,128,1,1,"FE de las J",0
28,"28057",1439,1125,1120,5,5,"FE de las J",3
28,"28032",4749,3653,3607,19,46,"FE de las J",7
28,"28019",1237,952,938,2,14,"FE de las J",7
28,"28902",468,352,347,2,5,"FE de las J",0
28,"28175",850,696,692,2,4,"FE de las J",5
28,"28001",64,48,48,3,0,"FE de las J",0
28,"28027",1199,897,882,5,15,"FE de las J",1
28,"28005",134211,104575,103819,667,756,"FE de las J",218
28,"28157",595,448,442,1,6,"FE de las J",0
28,"28085",3908,3106,3078,7,28,"FE de las J",1
28,"28145",2370,1824,1809,12,15,"FE de las J",5
28,"28180",5242,4040,3999,11,41,"FE de las J",5
28,"28087",3176,2545,2528,15,17,"FE de las J",5
28,"28034",352,270,269,1,1,"FE de las J",1
28,"28062",308,244,241,3,3,"FE de las J",0
28,"28903",32480,27640,27525,161,115,"FE de las J",31
28,"28056",860,653,647,6,6,"FE de las J",0
28,"28021",544,387,387,2,0,"FE de las J",0
28,"28156",998,751,743,3,8,"FE de las J",3
28,"28047",40783,31308,31072,171,236,"FE de las J",58
28,"28041",4452,3572,3550,24,22,"FE de las J",3
28,"28025",427,329,326,1,3,"FE de las J",0
28,"28035",1362,1042,1033,3,9,"FE de las J",1
28,"28154",5420,3966,3899,17,67,"FE de las J",21
28,"28111",592,489,483,0,6,"FE de las J",0
28,"28169",1427,1164,1158,1,6,"FE de las J",2
28,"28129",7913,6175,6124,30,51,"FE de las J",6
28,"28083",8880,6801,6759,47,42,"FE de las J",19
28,"28133",6002,4259,4204,12,55,"FE de las J",7
28,"28161",48368,37462,37161,190,301,"FE de las J",80
28,"28091",5436,3827,3786,23,41,"FE de las J",12
28,"28162",2549,2039,2025,13,14,"FE de las J",3
28,"28068",10928,8389,8315,43,74,"FE de las J",21
28,"28069",54,43,43,1,0,"FE de las J",0
28,"28102",881,659,650,3,9,"FE de las J",0
28,"28042",1153,882,874,5,8,"FE de las J",2
28,"28036",2514,1974,1949,12,25,"FE de las J",3
28,"28070",119,91,91,0,0,"FE de las J",0
28,"28008",1768,1293,1282,4,11,"FE de las J",6
28,"28182",214,174,170,0,4,"FE de las J",0
28,"28079",2371327,1817203,1806970,9067,10233,"FE de las J",1831
28,"28095",1508,1177,1167,6,10,"FE de las J",6
28,"28061",21200,16698,16600,75,98,"FE de las J",18
28,"28088",262,180,179,2,1,"FE de las J",0
28,"28080",48226,39753,39570,172,183,"FE de las J",40
28,"28174",1788,1277,1267,2,10,"FE de las J",2
6,"6065",309,257,247,0,10,"EU-eX",1
6,"6091",3782,2728,2690,32,38,"EU-eX",5
6,"6100",938,776,763,2,13,"EU-eX",1
6,"6152",1322,964,951,1,13,"EU-eX",2
6,"6074",4814,3717,3659,37,58,"EU-eX",7
6,"6124",1739,1309,1287,15,22,"EU-eX",1
6,"6115",1260,867,853,7,14,"EU-eX",2
6,"6008",634,562,558,1,4,"EU-eX",0
6,"6123",4644,3420,3357,22,63,"EU-eX",6
6,"6002",4335,3084,3006,33,78,"EU-eX",5
6,"6089",598,491,488,3,3,"EU-eX",1
6,"6047",855,664,654,2,10,"EU-eX",0
6,"6129",591,466,462,3,4,"EU-eX",1
6,"6161",315,236,231,1,5,"EU-eX",0
6,"6085",3427,2563,2524,21,39,"EU-eX",5
6,"6102",1055,843,830,3,13,"EU-eX",0
6,"6139",553,442,436,1,6,"EU-eX",0
6,"6032",66,54,54,2,0,"EU-eX",0
6,"6153",20417,15129,14934,112,195,"EU-eX",34
6,"6014",6688,4651,4586,22,65,"EU-eX",7
6,"6126",2183,1594,1582,9,12,"EU-eX",0
6,"6136",1578,1182,1168,8,14,"EU-eX",0
6,"6112",393,335,333,0,2,"EU-eX",0
6,"6151",1094,809,801,8,8,"EU-eX",0
6,"6094",1483,1025,1014,6,11,"EU-eX",4
6,"6101",466,386,382,0,4,"EU-eX",0
6,"6059",1858,1361,1342,12,19,"EU-eX",2
6,"6030",172,138,138,0,0,"EU-eX",1
6,"6075",477,401,389,2,12,"EU-eX",0
6,"6087",2127,1612,1592,16,20,"EU-eX",3
6,"6033",1330,1037,1025,10,12,"EU-eX",0
6,"6079",645,502,488,1,14,"EU-eX",0
6,"6133",1775,1351,1334,9,17,"EU-eX",2
6,"6046",1248,989,978,4,11,"EU-eX",9
6,"6160",3154,2324,2292,12,32,"EU-eX",2
6,"6025",5126,3833,3783,37,50,"EU-eX",3
6,"6132",855,634,627,4,7,"EU-eX",4
6,"6036",5085,3797,3739,29,58,"EU-eX",6
6,"6052",4051,3071,3009,31,62,"EU-eX",4
6,"6159",2339,1429,1407,14,22,"EU-eX",2
6,"6140",633,493,482,6,11,"EU-eX",0
6,"6157",453,316,315,0,1,"EU-eX",0
6,"6026",837,632,623,2,9,"EU-eX",0
6,"6080",1931,1498,1480,9,18,"EU-eX",4
6,"6147",362,285,281,0,4,"EU-eX",0
6,"6156",1169,903,898,2,5,"EU-eX",1
6,"6106",428,295,293,2,2,"EU-eX",3
6,"6058",2055,1512,1494,14,18,"EU-eX",7
6,"6062",612,450,441,4,9,"EU-eX",0
6,"6130",195,174,170,0,4,"EU-eX",0
6,"6082",382,312,306,3,6,"EU-eX",1
6,"6121",3383,2518,2483,21,35,"EU-eX",2
6,"6090",877,661,642,7,19,"EU-eX",2
6,"6069",3079,2164,2137,21,27,"EU-eX",2
6,"6128",4445,3137,3116,36,21,"EU-eX",1
6,"6068",453,349,344,3,5,"EU-eX",0
6,"6099",1148,768,749,5,19,"EU-eX",1
6,"6095",9493,6973,6839,97,134,"EU-eX",9
6,"6104",677,533,529,6,4,"EU-eX",2
6,"6158",13305,9965,9802,91,163,"EU-eX",22
6,"6005",1717,1271,1258,10,13,"EU-eX",1
6,"6073",745,507,497,5,10,"EU-eX",0
6,"6083",46111,32608,32276,235,332,"EU-eX",92
6,"6901",2114,1648,1625,28,23,"EU-eX",5
6,"6055",2058,1557,1527,21,30,"EU-eX",0
6,"6015",116673,82152,81388,677,764,"EU-eX",245
6,"6022",2660,2159,2140,12,19,"EU-eX",11
6,"6144",562,450,447,3,3,"EU-eX",1
6,"6127",2893,2188,2158,13,30,"EU-eX",3
6,"6096",226,188,182,1,6,"EU-eX",0
6,"6146",1094,848,837,5,11,"EU-eX",1
6,"6119",701,519,514,1,5,"EU-eX",1
6,"6051",1573,1235,1222,6,13,"EU-eX",1
6,"6088",12639,8992,8885,68,107,"EU-eX",23
6,"6043",673,542,535,5,7,"EU-eX",3
6,"6067",1984,1408,1377,9,31,"EU-eX",1
6,"6134",545,325,323,3,2,"EU-eX",1
6,"6072",2334,1813,1792,20,21,"EU-eX",2
6,"6138",1059,795,773,3,22,"EU-eX",1
6,"6010",1111,877,863,7,14,"EU-eX",2
6,"6060",5798,4346,4261,23,85,"EU-eX",10
6,"6120",3393,2635,2600,14,35,"EU-eX",6
6,"6084",1100,857,842,4,15,"EU-eX",1
6,"6044",28899,20862,20681,153,181,"EU-eX",34
6,"6098",545,408,402,1,6,"EU-eX",2
6,"6050",4124,3178,3110,30,68,"EU-eX",4
6,"6013",265,230,224,1,6,"EU-eX",0
6,"6076",837,632,624,2,8,"EU-eX",0
6,"6122",6651,4654,4553,29,101,"EU-eX",13
6,"6110",151,107,104,0,3,"EU-eX",0
6,"6086",1233,884,874,3,10,"EU-eX",1
6,"6081",1078,850,839,4,11,"EU-eX",0
6,"6063",3038,2413,2391,15,22,"EU-eX",1
6,"6027",681,586,576,1,10,"EU-eX",0
6,"6023",4362,3200,3168,11,32,"EU-eX",3
6,"6045",499,378,378,4,0,"EU-eX",0
6,"6135",1103,904,888,9,16,"EU-eX",1
6,"6041",460,378,375,3,3,"EU-eX",0
6,"6020",1822,1435,1406,12,29,"EU-eX",5
6,"6137",987,811,805,4,6,"EU-eX",1
6,"6131",1074,887,885,2,2,"EU-eX",1
6,"6061",1092,899,890,6,9,"EU-eX",0
6,"6017",274,229,228,1,1,"EU-eX",0
6,"6001",696,526,521,1,5,"EU-eX",2
6,"6141",1741,1246,1223,13,23,"EU-eX",1
6,"6154",2798,2001,1975,17,26,"EU-eX",1
6,"6024",1181,955,942,5,13,"EU-eX",1
6,"6143",3338,2548,2508,23,40,"EU-eX",7
6,"6150",806,658,650,6,8,"EU-eX",0
6,"6114",148,116,116,0,0,"EU-eX",0
6,"6006",4595,3365,3318,27,47,"EU-eX",4
6,"6125",1754,1327,1304,7,23,"EU-eX",1
6,"6108",2299,1714,1683,13,31,"EU-eX",33
6,"6038",801,558,551,5,7,"EU-eX",3
6,"6071",247,208,203,0,5,"EU-eX",0
6,"6066",1776,1260,1245,2,15,"EU-eX",0
6,"6093",4472,3476,3416,22,60,"EU-eX",14
6,"6035",957,700,690,4,10,"EU-eX",0
6,"6902",1672,1239,1224,6,15,"EU-eX",21
6,"6116",1607,1168,1149,10,19,"EU-eX",1
6,"6113",2725,2091,2054,9,37,"EU-eX",4
6,"6021",928,668,656,9,12,"EU-eX",1
6,"6034",174,126,125,2,1,"EU-eX",0
6,"6162",2938,2278,2239,17,39,"EU-eX",6
6,"6011",24721,17683,17506,172,177,"EU-eX",53
6,"6078",510,414,407,1,7,"EU-eX",0
6,"6107",1591,1114,1107,4,7,"EU-eX",0
6,"6049",1021,747,733,2,14,"EU-eX",13
6,"6103",4781,3519,3459,40,60,"EU-eX",7
6,"6004",1604,1265,1248,10,17,"EU-eX",1
6,"6145",916,717,711,9,6,"EU-eX",0
6,"6016",2978,2258,2235,14,23,"EU-eX",2
6,"6092",582,402,392,3,10,"EU-eX",0
6,"6105",631,448,443,0,5,"EU-eX",0
6,"6009",206,156,156,1,0,"EU-eX",0
6,"6149",10342,8013,7897,70,116,"EU-eX",19
6,"6029",1213,892,875,8,17,"EU-eX",0
6,"6118",206,165,164,1,1,"EU-eX",0
6,"6039",1838,1546,1517,9,29,"EU-eX",2
6,"6097",2390,1814,1798,7,16,"EU-eX",3
6,"6064",841,672,671,6,1,"EU-eX",1
6,"6053",607,459,450,2,9,"EU-eX",0
6,"6028",4253,3716,3631,30,85,"EU-eX",1
6,"6042",1012,711,703,3,8,"EU-eX",0
6,"6018",761,543,539,3,4,"EU-eX",0
6,"6155",1890,1337,1315,15,22,"EU-eX",4
6,"6012",3280,2358,2343,12,15,"EU-eX",7
6,"6054",5442,4185,4098,32,87,"EU-eX",6
6,"6056",481,401,399,2,2,"EU-eX",0
6,"6077",347,276,272,3,4,"EU-eX",0
6,"6007",1483,1076,1068,6,8,"EU-eX",0
6,"6019",2090,1519,1488,11,31,"EU-eX",2
6,"6117",1417,1044,1031,3,13,"EU-eX",1
6,"6070",7753,5773,5645,52,128,"EU-eX",5
6,"6031",466,321,316,2,5,"EU-eX",2
6,"6040",1002,758,754,4,4,"EU-eX",7
6,"6057",573,471,466,1,5,"EU-eX",2
6,"6903",2017,1509,1475,11,34,"EU-eX",5
6,"6048",848,716,700,0,16,"EU-eX",1
6,"6109",3957,3258,3177,22,81,"EU-eX",47
6,"6037",1768,1176,1160,5,16,"EU-eX",2
6,"6003",830,656,647,6,9,"EU-eX",0
6,"6142",276,215,207,0,8,"EU-eX",1
6,"6148",973,739,730,5,9,"EU-eX",0
6,"6111",507,360,359,2,1,"EU-eX",0
6,"6123",4644,3420,3357,22,63,"UPYD",9
6,"6059",1858,1361,1342,12,19,"UPYD",5
6,"6118",206,165,164,1,1,"UPYD",0
6,"6006",4595,3365,3318,27,47,"UPYD",10
6,"6046",1248,989,978,4,11,"UPYD",3
6,"6131",1074,887,885,2,2,"UPYD",1
6,"6139",553,442,436,1,6,"UPYD",0
6,"6157",453,316,315,0,1,"UPYD",2
6,"6091",3782,2728,2690,32,38,"UPYD",3
6,"6146",1094,848,837,5,11,"UPYD",0
6,"6078",510,414,407,1,7,"UPYD",0
6,"6015",116673,82152,81388,677,764,"UPYD",496
6,"6158",13305,9965,9802,91,163,"UPYD",63
6,"6150",806,658,650,6,8,"UPYD",0
6,"6060",5798,4346,4261,23,85,"UPYD",11
6,"6140",633,493,482,6,11,"UPYD",0
6,"6017",274,229,228,1,1,"UPYD",0
6,"6029",1213,892,875,8,17,"UPYD",2
6,"6086",1233,884,874,3,10,"UPYD",0
6,"6113",2725,2091,2054,9,37,"UPYD",8
6,"6037",1768,1176,1160,5,16,"UPYD",4
6,"6009",206,156,156,1,0,"UPYD",0
6,"6090",877,661,642,7,19,"UPYD",1
6,"6097",2390,1814,1798,7,16,"UPYD",10
6,"6141",1741,1246,1223,13,23,"UPYD",1
6,"6128",4445,3137,3116,36,21,"UPYD",7
6,"6077",347,276,272,3,4,"UPYD",2
6,"6106",428,295,293,2,2,"UPYD",2
6,"6099",1148,768,749,5,19,"UPYD",3
6,"6055",2058,1557,1527,21,30,"UPYD",4
6,"6143",3338,2548,2508,23,40,"UPYD",2
6,"6083",46111,32608,32276,235,332,"UPYD",221
6,"6151",1094,809,801,8,8,"UPYD",2
6,"6124",1739,1309,1287,15,22,"UPYD",1
6,"6100",938,776,763,2,13,"UPYD",3
6,"6051",1573,1235,1222,6,13,"UPYD",1
6,"6063",3038,2413,2391,15,22,"UPYD",6
6,"6901",2114,1648,1625,28,23,"UPYD",5
6,"6036",5085,3797,3739,29,58,"UPYD",15
6,"6005",1717,1271,1258,10,13,"UPYD",2
6,"6032",66,54,54,2,0,"UPYD",0
6,"6042",1012,711,703,3,8,"UPYD",0
6,"6115",1260,867,853,7,14,"UPYD",1
6,"6085",3427,2563,2524,21,39,"UPYD",4
6,"6030",172,138,138,0,0,"UPYD",0
6,"6040",1002,758,754,4,4,"UPYD",2
6,"6130",195,174,170,0,4,"UPYD",0
6,"6102",1055,843,830,3,13,"UPYD",1
6,"6903",2017,1509,1475,11,34,"UPYD",1
6,"6105",631,448,443,0,5,"UPYD",1
6,"6016",2978,2258,2235,14,23,"UPYD",6
6,"6074",4814,3717,3659,37,58,"UPYD",11
6,"6065",309,257,247,0,10,"UPYD",0
6,"6026",837,632,623,2,9,"UPYD",2
6,"6089",598,491,488,3,3,"UPYD",4
6,"6112",393,335,333,0,2,"UPYD",0
6,"6044",28899,20862,20681,153,181,"UPYD",94
6,"6008",634,562,558,1,4,"UPYD",1
6,"6002",4335,3084,3006,33,78,"UPYD",10
6,"6019",2090,1519,1488,11,31,"UPYD",4
6,"6054",5442,4185,4098,32,87,"UPYD",13
6,"6045",499,378,378,4,0,"UPYD",0
6,"6081",1078,850,839,4,11,"UPYD",2
6,"6162",2938,2278,2239,17,39,"UPYD",6
6,"6153",20417,15129,14934,112,195,"UPYD",54
6,"6126",2183,1594,1582,9,12,"UPYD",3
6,"6068",453,349,344,3,5,"UPYD",2
6,"6144",562,450,447,3,3,"UPYD",0
6,"6122",6651,4654,4553,29,101,"UPYD",18
6,"6095",9493,6973,6839,97,134,"UPYD",20
6,"6070",7753,5773,5645,52,128,"UPYD",19
6,"6148",973,739,730,5,9,"UPYD",1
6,"6052",4051,3071,3009,31,62,"UPYD",9
6,"6104",677,533,529,6,4,"UPYD",0
6,"6041",460,378,375,3,3,"UPYD",0
6,"6145",916,717,711,9,6,"UPYD",0
6,"6109",3957,3258,3177,22,81,"UPYD",3
6,"6087",2127,1612,1592,16,20,"UPYD",2
6,"6096",226,188,182,1,6,"UPYD",0
6,"6154",2798,2001,1975,17,26,"UPYD",7
6,"6007",1483,1076,1068,6,8,"UPYD",1
6,"6155",1890,1337,1315,15,22,"UPYD",1
6,"6069",3079,2164,2137,21,27,"UPYD",5
6,"6053",607,459,450,2,9,"UPYD",0
6,"6092",582,402,392,3,10,"UPYD",1
6,"6116",1607,1168,1149,10,19,"UPYD",3
6,"6160",3154,2324,2292,12,32,"UPYD",5
6,"6025",5126,3833,3783,37,50,"UPYD",4
6,"6133",1775,1351,1334,9,17,"UPYD",1
6,"6003",830,656,647,6,9,"UPYD",1
6,"6021",928,668,656,9,12,"UPYD",0
6,"6048",848,716,700,0,16,"UPYD",0
6,"6134",545,325,323,3,2,"UPYD",1
6,"6039",1838,1546,1517,9,29,"UPYD",1
6,"6107",1591,1114,1107,4,7,"UPYD",3
6,"6138",1059,795,773,3,22,"UPYD",2
6,"6093",4472,3476,3416,22,60,"UPYD",3
6,"6103",4781,3519,3459,40,60,"UPYD",5
6,"6101",466,386,382,0,4,"UPYD",1
6,"6022",2660,2159,2140,12,19,"UPYD",2
6,"6080",1931,1498,1480,9,18,"UPYD",2
6,"6027",681,586,576,1,10,"UPYD",3
6,"6031",466,321,316,2,5,"UPYD",0
6,"6049",1021,747,733,2,14,"UPYD",0
6,"6050",4124,3178,3110,30,68,"UPYD",7
6,"6135",1103,904,888,9,16,"UPYD",4
6,"6108",2299,1714,1683,13,31,"UPYD",3
6,"6058",2055,1512,1494,14,18,"UPYD",6
6,"6038",801,558,551,5,7,"UPYD",0
6,"6011",24721,17683,17506,172,177,"UPYD",104
6,"6149",10342,8013,7897,70,116,"UPYD",23
6,"6076",837,632,624,2,8,"UPYD",0
6,"6127",2893,2188,2158,13,30,"UPYD",4
6,"6028",4253,3716,3631,30,85,"UPYD",6
6,"6010",1111,877,863,7,14,"UPYD",0
6,"6035",957,700,690,4,10,"UPYD",2
6,"6132",855,634,627,4,7,"UPYD",1
6,"6159",2339,1429,1407,14,22,"UPYD",0
6,"6034",174,126,125,2,1,"UPYD",0
6,"6125",1754,1327,1304,7,23,"UPYD",7
6,"6020",1822,1435,1406,12,29,"UPYD",5
6,"6084",1100,857,842,4,15,"UPYD",4
6,"6066",1776,1260,1245,2,15,"UPYD",0
6,"6142",276,215,207,0,8,"UPYD",0
6,"6088",12639,8992,8885,68,107,"UPYD",31
6,"6902",1672,1239,1224,6,15,"UPYD",3
6,"6056",481,401,399,2,2,"UPYD",0
6,"6062",612,450,441,4,9,"UPYD",1
6,"6023",4362,3200,3168,11,32,"UPYD",10
6,"6129",591,466,462,3,4,"UPYD",0
6,"6120",3393,2635,2600,14,35,"UPYD",1
6,"6013",265,230,224,1,6,"UPYD",1
6,"6018",761,543,539,3,4,"UPYD",3
6,"6147",362,285,281,0,4,"UPYD",1
6,"6119",701,519,514,1,5,"UPYD",1
6,"6033",1330,1037,1025,10,12,"UPYD",3
6,"6098",545,408,402,1,6,"UPYD",0
6,"6047",855,664,654,2,10,"UPYD",0
6,"6082",382,312,306,3,6,"UPYD",0
6,"6064",841,672,671,6,1,"UPYD",0
6,"6073",745,507,497,5,10,"UPYD",5
6,"6024",1181,955,942,5,13,"UPYD",0
6,"6094",1483,1025,1014,6,11,"UPYD",1
6,"6121",3383,2518,2483,21,35,"UPYD",6
6,"6012",3280,2358,2343,12,15,"UPYD",4
6,"6161",315,236,231,1,5,"UPYD",0
6,"6072",2334,1813,1792,20,21,"UPYD",2
6,"6071",247,208,203,0,5,"UPYD",1
6,"6114",148,116,116,0,0,"UPYD",0
6,"6137",987,811,805,4,6,"UPYD",4
6,"6111",507,360,359,2,1,"UPYD",1
6,"6043",673,542,535,5,7,"UPYD",5
6,"6061",1092,899,890,6,9,"UPYD",0
6,"6136",1578,1182,1168,8,14,"UPYD",0
6,"6152",1322,964,951,1,13,"UPYD",2
6,"6014",6688,4651,4586,22,65,"UPYD",15
6,"6079",645,502,488,1,14,"UPYD",0
6,"6067",1984,1408,1377,9,31,"UPYD",8
6,"6057",573,471,466,1,5,"UPYD",0
6,"6156",1169,903,898,2,5,"UPYD",1
6,"6075",477,401,389,2,12,"UPYD",1
6,"6004",1604,1265,1248,10,17,"UPYD",0
6,"6110",151,107,104,0,3,"UPYD",0
6,"6001",696,526,521,1,5,"UPYD",0
6,"6117",1417,1044,1031,3,13,"UPYD",1
30,"30036",14624,10139,9988,70,151,"PODEMOS",1471
30,"30042",1918,1518,1500,6,18,"PODEMOS",204
30,"30034",1138,859,846,5,13,"PODEMOS",85
30,"30041",13640,9156,9092,52,64,"PODEMOS",1467
30,"30001",4596,3602,3572,20,30,"PODEMOS",260
30,"30025",4900,3777,3727,20,50,"PODEMOS",526
30,"30033",10144,7591,7505,86,86,"PODEMOS",977
30,"30021",9101,6106,6034,25,72,"PODEMOS",537
30,"30009",12392,9724,9599,40,125,"PODEMOS",1367
30,"30007",6415,4554,4515,19,39,"PODEMOS",604
30,"30010",6861,5287,5220,38,67,"PODEMOS",649
30,"30032",2849,2188,2161,10,27,"PODEMOS",239
30,"30020",6261,4502,4459,25,43,"PODEMOS",547
30,"30005",29559,21408,21203,123,205,"PODEMOS",3114
30,"30039",19199,13538,13405,101,133,"PODEMOS",1727
30,"30008",13860,10066,9945,74,121,"PODEMOS",1827
30,"30018",7903,5990,5912,29,78,"PODEMOS",765
30,"30030",312625,235232,233576,1438,1656,"PODEMOS",38363
30,"30017",11635,8718,8646,46,72,"PODEMOS",1033
30,"30024",58529,42392,42072,275,320,"PODEMOS",5205
30,"30038",15381,10881,10797,51,84,"PODEMOS",1525
30,"30902",8022,5454,5412,34,42,"PODEMOS",937
30,"30026",15722,10147,10024,49,123,"PODEMOS",1298
30,"30011",4706,3582,3541,20,41,"PODEMOS",490
30,"30015",19154,13947,13835,77,112,"PODEMOS",1459
30,"30040",727,627,620,1,7,"PODEMOS",79
30,"30031",498,424,421,2,3,"PODEMOS",37
30,"30037",18726,13183,13027,73,156,"PODEMOS",1490
30,"30004",1141,938,933,5,5,"PODEMOS",69
30,"30002",9921,7263,7166,34,97,"PODEMOS",797
30,"30023",3762,2871,2837,14,34,"PODEMOS",532
30,"30043",24972,19411,19139,154,272,"PODEMOS",2904
30,"30028",6690,5005,4938,29,67,"PODEMOS",698
30,"30006",803,683,681,2,2,"PODEMOS",57
30,"30013",7395,5320,5277,38,43,"PODEMOS",661
30,"30035",18616,13185,13085,70,100,"PODEMOS",2095
30,"30016",151577,103359,102538,620,821,"PODEMOS",17536
30,"30901",10331,7925,7833,54,92,"PODEMOS",1270
30,"30029",11815,8365,8296,67,69,"PODEMOS",963
30,"30003",24305,16558,16419,122,139,"PODEMOS",2379
30,"30019",25921,18079,17894,121,185,"PODEMOS",2815
30,"30012",9101,7170,7091,46,79,"PODEMOS",1155
30,"30022",16894,11661,11498,119,163,"PODEMOS",1362
30,"30014",1598,1270,1258,5,12,"PODEMOS",148
30,"30027",47867,36054,35794,181,260,"PODEMOS",6411
12,"12102",536,452,437,1,15,"EUPV-UPeC",10
12,"12121",1127,955,928,6,27,"EUPV-UPeC",12
12,"12129",1840,1391,1360,19,31,"EUPV-UPeC",66
12,"12058",74,60,59,2,1,"EUPV-UPeC",0
12,"12099",542,434,405,9,29,"EUPV-UPeC",8
12,"12001",1054,798,786,8,12,"EUPV-UPeC",14
12,"12078",339,250,247,1,3,"EUPV-UPeC",5
12,"12073",156,132,131,0,1,"EUPV-UPeC",7
12,"12010",259,216,209,6,7,"EUPV-UPeC",3
12,"12101",363,282,273,3,9,"EUPV-UPeC",4
12,"12049",455,348,339,5,9,"EUPV-UPeC",9
12,"12085",5061,3310,3264,20,46,"EUPV-UPeC",77
12,"12026",894,697,676,14,21,"EUPV-UPeC",16
12,"12100",1345,1115,1098,6,17,"EUPV-UPeC",20
12,"12029",717,572,566,6,6,"EUPV-UPeC",23
12,"12040",117832,89135,88464,525,671,"EUPV-UPeC",2736
12,"12091",185,145,141,3,4,"EUPV-UPeC",2
12,"12057",606,495,487,3,8,"EUPV-UPeC",19
12,"12077",4625,3443,3387,20,56,"EUPV-UPeC",91
12,"12142",161,124,123,0,1,"EUPV-UPeC",2
12,"12132",486,407,398,2,9,"EUPV-UPeC",6
12,"12070",524,418,408,8,10,"EUPV-UPeC",13
12,"12052",590,464,442,5,22,"EUPV-UPeC",1
12,"12107",351,313,309,3,4,"EUPV-UPeC",6
12,"12094",851,688,674,2,14,"EUPV-UPeC",30
12,"12137",37,26,26,1,0,"EUPV-UPeC",1
12,"12056",285,243,238,3,5,"EUPV-UPeC",7
12,"12081",611,503,493,3,10,"EUPV-UPeC",20
12,"12083",95,82,80,0,2,"EUPV-UPeC",0
12,"12016",1582,1311,1295,9,16,"EUPV-UPeC",14
12,"12123",47,32,32,0,0,"EUPV-UPeC",3
12,"12046",193,154,153,3,1,"EUPV-UPeC",4
12,"12092",112,84,84,0,0,"EUPV-UPeC",1
12,"12082",9655,7570,7492,38,78,"EUPV-UPeC",221
12,"12074",784,690,678,9,12,"EUPV-UPeC",11
12,"12128",1400,1102,1091,11,11,"EUPV-UPeC",19
12,"12112",99,81,79,1,2,"EUPV-UPeC",1
12,"12087",26,18,18,3,0,"EUPV-UPeC",1
12,"12104",6954,5571,5470,26,101,"EUPV-UPeC",194
12,"12007",758,672,667,7,5,"EUPV-UPeC",22
12,"12111",375,314,310,0,4,"EUPV-UPeC",1
12,"12012",2695,2236,2204,6,32,"EUPV-UPeC",95
12,"12113",85,69,69,2,0,"EUPV-UPeC",2
12,"12025",137,106,106,0,0,"EUPV-UPeC",3
12,"12110",244,173,170,1,3,"EUPV-UPeC",2
12,"12033",1907,1483,1436,11,47,"EUPV-UPeC",18
12,"12028",12566,9902,9830,55,72,"EUPV-UPeC",322
12,"12043",581,470,459,4,11,"EUPV-UPeC",13
12,"12134",138,97,96,0,1,"EUPV-UPeC",2
12,"12071",1280,1002,988,5,14,"EUPV-UPeC",57
12,"12050",1320,1044,1032,8,12,"EUPV-UPeC",24
12,"12041",97,77,77,0,0,"EUPV-UPeC",1
12,"12072",1117,962,937,8,25,"EUPV-UPeC",20
12,"12124",1853,1411,1394,20,17,"EUPV-UPeC",13
12,"12095",974,789,784,8,5,"EUPV-UPeC",21
12,"12109",647,531,520,1,11,"EUPV-UPeC",13
12,"12060",446,367,360,2,7,"EUPV-UPeC",7
12,"12120",184,155,154,1,1,"EUPV-UPeC",3
12,"12088",69,58,58,0,0,"EUPV-UPeC",0
12,"12011",4587,3530,3480,30,50,"EUPV-UPeC",114
12,"12027",17217,12263,12122,77,141,"EUPV-UPeC",312
12,"12117",3576,2786,2747,17,39,"EUPV-UPeC",43
12,"12133",60,49,49,0,0,"EUPV-UPeC",0
12,"12004",4204,3174,3130,19,44,"EUPV-UPeC",77
12,"12008",231,192,190,2,2,"EUPV-UPeC",11
12,"12080",1955,1647,1624,13,23,"EUPV-UPeC",42
12,"12005",8090,6113,6027,57,86,"EUPV-UPeC",192
12,"12018",293,244,235,2,9,"EUPV-UPeC",4
12,"12031",3830,3049,2987,20,62,"EUPV-UPeC",105
12,"12042",621,520,512,13,8,"EUPV-UPeC",6
12,"12130",404,339,332,0,7,"EUPV-UPeC",2
12,"12126",24480,18885,18687,115,198,"EUPV-UPeC",1145
12,"12115",217,169,167,2,2,"EUPV-UPeC",2
12,"12068",49,34,34,1,0,"EUPV-UPeC",1
12,"12020",124,104,103,1,1,"EUPV-UPeC",1
12,"12037",16,14,14,0,0,"EUPV-UPeC",0
12,"12024",139,115,113,1,2,"EUPV-UPeC",4
12,"12034",1430,1078,1053,4,25,"EUPV-UPeC",13
12,"12090",109,94,93,2,1,"EUPV-UPeC",2
12,"12097",67,55,54,0,1,"EUPV-UPeC",3
12,"12127",77,56,56,0,0,"EUPV-UPeC",5
12,"12125",214,185,183,2,2,"EUPV-UPeC",4
12,"12084",17599,13146,13022,98,124,"EUPV-UPeC",393
12,"12009",17430,12600,12501,77,99,"EUPV-UPeC",292
12,"12075",123,94,92,1,2,"EUPV-UPeC",1
12,"12051",477,337,335,2,2,"EUPV-UPeC",4
12,"12069",74,50,49,0,1,"EUPV-UPeC",2
12,"12140",1140,961,950,5,11,"EUPV-UPeC",41
12,"12064",97,83,82,0,1,"EUPV-UPeC",5
12,"12032",23508,17400,17279,89,121,"EUPV-UPeC",496
12,"12061",378,275,275,4,0,"EUPV-UPeC",8
12,"12038",171,121,120,1,1,"EUPV-UPeC",3
12,"12119",147,100,100,1,0,"EUPV-UPeC",2
12,"12015",96,83,81,0,2,"EUPV-UPeC",26
12,"12103",89,69,68,2,1,"EUPV-UPeC",1
12,"12139",322,239,237,1,2,"EUPV-UPeC",3
12,"12122",805,660,647,4,13,"EUPV-UPeC",11
12,"12118",74,60,59,0,1,"EUPV-UPeC",3
12,"12006",176,140,140,1,0,"EUPV-UPeC",4
12,"12067",543,442,424,1,18,"EUPV-UPeC",20
12,"12108",463,395,390,0,5,"EUPV-UPeC",9
12,"12089",4331,3103,3050,25,53,"EUPV-UPeC",60
12,"12902",2148,1562,1536,9,26,"EUPV-UPeC",29
12,"12131",65,53,53,0,0,"EUPV-UPeC",0
12,"12106",1170,983,967,16,16,"EUPV-UPeC",40
12,"12901",3433,2691,2664,27,27,"EUPV-UPeC",53
12,"12014",184,140,136,1,4,"EUPV-UPeC",2
12,"12003",991,762,752,10,10,"EUPV-UPeC",15
12,"12138",19064,13610,13456,135,154,"EUPV-UPeC",434
12,"12065",192,166,166,0,0,"EUPV-UPeC",0
12,"12136",2657,2302,2252,22,50,"EUPV-UPeC",26
12,"12135",35749,27015,26806,174,209,"EUPV-UPeC",823
12,"12021",4442,3486,3432,25,54,"EUPV-UPeC",187
12,"12079",405,318,312,4,6,"EUPV-UPeC",3
12,"12055",106,79,79,2,0,"EUPV-UPeC",2
12,"12063",42,35,34,2,1,"EUPV-UPeC",1
12,"12017",164,133,132,1,1,"EUPV-UPeC",0
12,"12076",87,70,70,1,0,"EUPV-UPeC",1
12,"12013",148,119,116,4,3,"EUPV-UPeC",1
12,"12114",200,150,149,1,1,"EUPV-UPeC",3
12,"12116",67,49,49,0,0,"EUPV-UPeC",0
12,"12002",116,98,96,0,2,"EUPV-UPeC",13
12,"12053",2069,1691,1677,8,14,"EUPV-UPeC",65
12,"12059",244,190,189,1,1,"EUPV-UPeC",6
12,"12096",775,587,580,12,7,"EUPV-UPeC",8
12,"12098",588,479,473,4,6,"EUPV-UPeC",3
12,"12039",840,726,719,2,7,"EUPV-UPeC",10
12,"12093",189,147,145,1,2,"EUPV-UPeC",2
12,"12022",340,273,269,1,4,"EUPV-UPeC",6
12,"12105",851,666,659,5,7,"EUPV-UPeC",10
12,"12044",483,438,431,4,7,"EUPV-UPeC",4
12,"12045",354,282,279,2,3,"EUPV-UPeC",11
12,"12141",101,80,80,0,0,"EUPV-UPeC",1
12,"12036",593,448,445,2,3,"EUPV-UPeC",15
12,"12048",249,196,192,1,4,"EUPV-UPeC",3
13,"13061",5723,4210,4149,49,61,"UPYD",20
13,"13040",892,720,710,3,10,"UPYD",2
13,"13082",25841,17702,17561,154,141,"UPYD",101
13,"13065",2888,2004,1970,19,34,"UPYD",5
13,"13035",986,791,784,7,7,"UPYD",1
13,"13044",2675,1959,1920,12,39,"UPYD",10
13,"13055",666,495,490,0,5,"UPYD",1
13,"13038",1649,1317,1294,15,23,"UPYD",2
13,"13031",2455,1940,1914,9,26,"UPYD",7
13,"13018",824,667,662,7,5,"UPYD",4
13,"13008",441,317,311,2,6,"UPYD",3
13,"13033",1653,1395,1378,4,17,"UPYD",8
13,"13059",204,156,156,1,0,"UPYD",1
13,"13001",1270,985,977,8,8,"UPYD",3
13,"13015",5494,4146,4106,18,40,"UPYD",13
13,"13095",83,65,65,1,0,"UPYD",0
13,"13004",1052,827,816,1,11,"UPYD",1
13,"13062",575,471,466,4,5,"UPYD",3
13,"13019",5179,3887,3830,35,57,"UPYD",14
13,"13048",515,418,416,3,2,"UPYD",0
13,"13052",6497,4715,4648,71,67,"UPYD",18
13,"13016",665,537,529,4,8,"UPYD",1
13,"13094",308,253,249,3,4,"UPYD",2
13,"13010",887,673,665,0,8,"UPYD",0
13,"13068",1058,787,782,5,5,"UPYD",0
13,"13013",7086,5419,5340,45,79,"UPYD",19
13,"13066",2519,2057,2026,14,31,"UPYD",8
13,"13070",765,612,605,4,7,"UPYD",4
13,"13003",487,367,363,2,4,"UPYD",2
13,"13901",895,676,660,4,16,"UPYD",6
13,"13042",928,696,688,3,8,"UPYD",3
13,"13053",14389,10624,10521,79,103,"UPYD",107
13,"13005",23330,18245,18030,164,215,"UPYD",91
13,"13025",302,250,246,0,4,"UPYD",0
13,"13026",452,374,372,1,2,"UPYD",0
13,"13093",4111,3056,3014,21,42,"UPYD",8
13,"13092",1860,1544,1529,11,15,"UPYD",4
13,"13075",213,157,153,1,4,"UPYD",0
13,"13039",14383,10833,10684,100,149,"UPYD",57
13,"13051",350,281,278,2,3,"UPYD",0
13,"13054",4970,3911,3866,44,45,"UPYD",24
13,"13012",411,294,292,0,2,"UPYD",1
13,"13071",39775,28222,28052,175,170,"UPYD",131
13,"13049",814,585,579,0,6,"UPYD",4
13,"13041",253,182,180,0,2,"UPYD",0
13,"13080",350,265,265,1,0,"UPYD",0
13,"13030",143,110,110,0,0,"UPYD",1
13,"13056",11354,8732,8634,48,98,"UPYD",58
13,"13060",269,212,209,1,3,"UPYD",0
13,"13021",436,376,374,0,2,"UPYD",0
13,"13076",488,415,408,1,7,"UPYD",0
13,"13020",4792,3494,3451,26,43,"UPYD",21
13,"13089",1728,1410,1381,6,29,"UPYD",6
13,"13088",610,501,495,5,6,"UPYD",0
13,"13057",1172,980,970,1,10,"UPYD",2
13,"13007",1273,1056,1028,10,28,"UPYD",1
13,"13902",479,374,367,0,7,"UPYD",1
13,"13090",1110,872,849,6,23,"UPYD",0
13,"13903",539,437,432,4,5,"UPYD",0
13,"13027",3446,2543,2498,15,45,"UPYD",7
13,"13086",189,146,146,1,0,"UPYD",0
13,"13904",527,411,406,8,5,"UPYD",4
13,"13064",1684,1288,1283,13,5,"UPYD",8
13,"13047",5785,4462,4406,23,56,"UPYD",24
13,"13009",1459,1167,1156,4,11,"UPYD",2
13,"13037",865,678,667,2,11,"UPYD",3
13,"13046",740,575,570,3,5,"UPYD",1
13,"13063",3728,2708,2685,9,23,"UPYD",8
13,"13024",898,643,637,7,6,"UPYD",1
13,"13072",775,570,565,5,5,"UPYD",5
13,"13097",2282,1783,1768,12,15,"UPYD",7
13,"13050",501,403,399,2,4,"UPYD",2
13,"13029",86,69,69,0,0,"UPYD",0
13,"13006",608,487,479,4,8,"UPYD",2
13,"13034",58010,44627,44241,332,386,"UPYD",370
13,"13045",679,532,522,7,10,"UPYD",3
13,"13077",3518,2443,2378,12,65,"UPYD",8
13,"13083",2453,1729,1690,14,39,"UPYD",7
13,"13014",496,404,398,2,6,"UPYD",0
13,"13079",12273,9195,9036,79,159,"UPYD",27
13,"13098",2124,1633,1591,15,42,"UPYD",4
13,"13028",10416,8309,8171,77,138,"UPYD",76
13,"13011",4866,3346,3312,15,34,"UPYD",11
13,"13087",23161,16812,16595,145,217,"UPYD",136
13,"13036",800,620,614,3,6,"UPYD",2
13,"13074",982,843,833,3,10,"UPYD",1
13,"13084",908,725,708,5,17,"UPYD",1
13,"13096",7677,5743,5661,51,82,"UPYD",16
13,"13058",4110,3157,3127,28,30,"UPYD",10
13,"13023",9003,6578,6517,86,61,"UPYD",28
13,"13078",9089,6661,6584,44,77,"UPYD",53
13,"13069",666,518,508,3,10,"UPYD",0
13,"13085",2365,2011,1983,6,28,"UPYD",7
13,"13091",552,466,459,3,7,"UPYD",0
13,"13073",542,409,405,0,4,"UPYD",1
13,"13017",267,205,203,1,2,"UPYD",0
13,"13022",351,280,280,2,0,"UPYD",1
13,"13081",652,525,508,2,17,"UPYD",0
13,"13043",231,186,185,5,1,"UPYD",0
13,"13032",1150,878,870,9,8,"UPYD",1
13,"13067",360,298,294,2,4,"UPYD",0
13,"13002",1500,1003,993,9,10,"UPYD",2
28,"28116",700,544,544,3,0,"P-LIB",0
28,"28149",5653,4516,4469,19,47,"P-LIB",0
28,"28059",4312,3256,3237,11,19,"P-LIB",1
28,"28056",860,653,647,6,6,"P-LIB",0
28,"28013",40409,30141,29905,164,236,"P-LIB",3
28,"28099",1731,1283,1278,8,5,"P-LIB",2
28,"28018",3739,3071,3046,12,25,"P-LIB",2
28,"28043",5922,4063,4008,29,55,"P-LIB",2
28,"28063",252,195,194,2,1,"P-LIB",0
28,"28147",968,751,745,2,6,"P-LIB",1
28,"28143",70,59,59,1,0,"P-LIB",0
28,"28023",4697,3835,3817,20,18,"P-LIB",1
28,"28154",5420,3966,3899,17,67,"P-LIB",2
28,"28126",39,25,25,0,0,"P-LIB",0
28,"28131",12971,9828,9755,57,73,"P-LIB",5
28,"28036",2514,1974,1949,12,25,"P-LIB",0
28,"28026",6237,4893,4853,32,40,"P-LIB",1
28,"28038",4935,3858,3815,17,43,"P-LIB",0
28,"28108",3330,2536,2528,17,8,"P-LIB",1
28,"28128",439,323,320,2,3,"P-LIB",0
28,"28017",1210,954,943,6,11,"P-LIB",0
28,"28066",7175,5598,5561,28,37,"P-LIB",1
28,"28171",4238,3002,2962,18,40,"P-LIB",1
28,"28084",15839,12028,11925,53,103,"P-LIB",4
28,"28065",125384,101604,100872,477,732,"P-LIB",26
28,"28044",5766,4623,4584,22,39,"P-LIB",4
28,"28124",76,56,54,0,2,"P-LIB",0
28,"28144",5929,4776,4744,29,32,"P-LIB",0
28,"28123",56464,47181,46948,257,233,"P-LIB",9
28,"28101",218,180,180,0,0,"P-LIB",0
28,"28175",850,696,692,2,4,"P-LIB",0
28,"28145",2370,1824,1809,12,15,"P-LIB",0
28,"28180",5242,4040,3999,11,41,"P-LIB",1
28,"28032",4749,3653,3607,19,46,"P-LIB",0
28,"28166",318,258,255,1,3,"P-LIB",0
28,"28031",2055,1538,1519,4,19,"P-LIB",0
28,"28016",80,57,57,0,0,"P-LIB",0
28,"28106",76612,56555,56006,346,549,"P-LIB",17
28,"28075",5581,4380,4350,15,30,"P-LIB",3
28,"28115",60579,50819,50657,246,162,"P-LIB",19
28,"28173",520,409,408,3,1,"P-LIB",0
28,"28064",134,105,105,0,0,"P-LIB",0
28,"28028",1730,1347,1326,8,21,"P-LIB",0
28,"28008",1768,1293,1282,4,11,"P-LIB",1
28,"28060",1509,1194,1183,8,11,"P-LIB",0
28,"28053",6458,5299,5263,29,36,"P-LIB",1
28,"28002",2966,2186,2175,9,11,"P-LIB",1
28,"28025",427,329,326,1,3,"P-LIB",0
28,"28168",1226,910,900,1,10,"P-LIB",0
28,"28029",530,426,424,3,2,"P-LIB",0
28,"28058",139289,108214,107323,612,891,"P-LIB",31
28,"28005",134211,104575,103819,667,756,"P-LIB",28
28,"28051",1542,1240,1232,5,8,"P-LIB",0
28,"28033",3824,2854,2832,11,22,"P-LIB",0
28,"28093",2043,1681,1661,9,20,"P-LIB",0
28,"28163",438,357,354,1,3,"P-LIB",0
28,"28068",10928,8389,8315,43,74,"P-LIB",4
28,"28110",1949,1543,1525,2,18,"P-LIB",0
28,"28001",64,48,48,3,0,"P-LIB",0
28,"28901",789,590,584,2,6,"P-LIB",0
28,"28148",85022,65597,65111,368,486,"P-LIB",14
28,"28030",1716,1342,1316,2,26,"P-LIB",1
28,"28090",8405,6792,6751,34,41,"P-LIB",1
28,"28164",2986,2281,2263,12,18,"P-LIB",1
28,"28140",2981,2383,2357,14,26,"P-LIB",0
28,"28021",544,387,387,2,0,"P-LIB",0
28,"28179",1441,1082,1071,7,11,"P-LIB",0
28,"28146",1773,1274,1262,9,12,"P-LIB",0
28,"28007",124358,99423,98711,554,712,"P-LIB",26
28,"28009",14046,11014,10932,51,82,"P-LIB",4
28,"28052",3883,2801,2758,18,43,"P-LIB",1
28,"28150",3084,2415,2381,13,34,"P-LIB",0
28,"28035",1362,1042,1033,3,9,"P-LIB",0
28,"28137",1644,1301,1283,7,18,"P-LIB",1
28,"28003",181,141,141,3,0,"P-LIB",0
28,"28037",1566,1175,1168,5,7,"P-LIB",0
28,"28172",8965,7255,7219,44,36,"P-LIB",5
28,"28042",1153,882,874,5,8,"P-LIB",0
28,"28024",152,129,128,1,1,"P-LIB",0
28,"28138",69,54,54,0,0,"P-LIB",0
28,"28136",640,540,532,0,8,"P-LIB",0
28,"28072",5657,4465,4441,20,24,"P-LIB",4
28,"28117",95,84,84,0,0,"P-LIB",0
28,"28097",124,85,84,1,1,"P-LIB",0
28,"28155",507,420,420,0,0,"P-LIB",0
28,"28012",883,702,691,4,11,"P-LIB",0
28,"28120",1217,918,904,4,14,"P-LIB",0
28,"28121",198,166,164,2,2,"P-LIB",0
28,"28113",34305,27077,26881,156,196,"P-LIB",4
28,"28153",703,510,507,2,3,"P-LIB",0
28,"28041",4452,3572,3550,24,22,"P-LIB",1
28,"28049",58688,48006,47660,286,346,"P-LIB",11
28,"28170",2486,1757,1740,9,17,"P-LIB",0
28,"28004",6179,4377,4345,15,32,"P-LIB",2
28,"28047",40783,31308,31072,171,236,"P-LIB",7
28,"28067",4057,3220,3188,12,32,"P-LIB",1
28,"28034",352,270,269,1,1,"P-LIB",0
28,"28019",1237,952,938,2,14,"P-LIB",0
28,"28174",1788,1277,1267,2,10,"P-LIB",2
28,"28006",78564,61796,61456,334,340,"P-LIB",26
28,"28151",3143,2352,2314,6,38,"P-LIB",3
28,"28074",138742,110456,109579,581,877,"P-LIB",24
28,"28011",445,339,338,0,1,"P-LIB",0
28,"28159",588,469,468,6,1,"P-LIB",0
28,"28071",60,47,46,0,1,"P-LIB",0
28,"28141",5806,4532,4486,24,46,"P-LIB",0
28,"28069",54,43,43,1,0,"P-LIB",0
28,"28135",971,740,735,4,5,"P-LIB",0
28,"28039",130,97,97,0,0,"P-LIB",0
28,"28080",48226,39753,39570,172,183,"P-LIB",10
28,"28183",1050,770,763,2,7,"P-LIB",0
28,"28014",32852,24749,24571,120,178,"P-LIB",2
28,"28127",64513,53125,52932,300,193,"P-LIB",14
28,"28165",1788,1332,1321,5,11,"P-LIB",0
28,"28133",6002,4259,4204,12,55,"P-LIB",0
28,"28091",5436,3827,3786,23,41,"P-LIB",2
28,"28181",20344,16669,16572,95,97,"P-LIB",6
28,"28112",167,132,132,0,0,"P-LIB",0
28,"28162",2549,2039,2025,13,14,"P-LIB",1
28,"28086",5055,3627,3600,21,27,"P-LIB",0
28,"28902",468,352,347,2,5,"P-LIB",0
28,"28083",8880,6801,6759,47,42,"P-LIB",2
28,"28176",12288,9809,9763,50,46,"P-LIB",2
28,"28073",12505,9485,9384,64,101,"P-LIB",5
28,"28903",32480,27640,27525,161,115,"P-LIB",13
28,"28134",60511,47566,47229,233,337,"P-LIB",16
28,"28132",11645,8605,8520,55,85,"P-LIB",5
28,"28107",435,326,321,0,5,"P-LIB",0
28,"28104",13836,11414,11349,54,65,"P-LIB",2
28,"28169",1427,1164,1158,1,6,"P-LIB",0
28,"28161",48368,37462,37161,190,301,"P-LIB",11
28,"28114",149,103,103,1,0,"P-LIB",0
28,"28167",8308,6605,6545,35,60,"P-LIB",3
28,"28057",1439,1125,1120,5,5,"P-LIB",0
28,"28079",2371327,1817203,1806970,9067,10233,"P-LIB",552
28,"28054",11166,8649,8584,36,65,"P-LIB",4
28,"28078",36,34,34,0,0,"P-LIB",0
28,"28160",8227,6295,6251,26,44,"P-LIB",2
28,"28087",3176,2545,2528,15,17,"P-LIB",1
28,"28050",4077,3032,3006,15,26,"P-LIB",0
28,"28129",7913,6175,6124,30,51,"P-LIB",3
28,"28062",308,244,241,3,3,"P-LIB",0
28,"28094",825,636,634,3,2,"P-LIB",0
28,"28089",3703,2961,2933,19,28,"P-LIB",0
28,"28100",4169,3076,3048,12,28,"P-LIB",0
28,"28070",119,91,91,0,0,"P-LIB",0
28,"28055",899,682,676,4,6,"P-LIB",0
28,"28102",881,659,650,3,9,"P-LIB",0
28,"28027",1199,897,882,5,15,"P-LIB",0
28,"28125",2965,2210,2188,13,22,"P-LIB",0
28,"28158",662,545,543,3,2,"P-LIB",1
28,"28046",4432,3562,3538,19,24,"P-LIB",2
28,"28152",16026,13269,13202,46,67,"P-LIB",6
28,"28022",32949,27473,27379,169,94,"P-LIB",5
28,"28178",1066,850,846,2,4,"P-LIB",0
28,"28182",214,174,170,0,4,"P-LIB",0
28,"28082",5664,4526,4492,25,34,"P-LIB",0
28,"28076",406,322,319,1,3,"P-LIB",0
28,"28122",518,388,385,2,3,"P-LIB",0
28,"28088",262,180,179,2,1,"P-LIB",0
28,"28095",1508,1177,1167,6,10,"P-LIB",0
28,"28010",9853,7959,7914,35,45,"P-LIB",3
28,"28092",151511,117869,116968,641,901,"P-LIB",51
28,"28156",998,751,743,3,8,"P-LIB",0
28,"28096",18161,13784,13647,57,137,"P-LIB",3
28,"28015",18233,14725,14653,81,72,"P-LIB",4
28,"28061",21200,16698,16600,75,98,"P-LIB",5
28,"28157",595,448,442,1,6,"P-LIB",0
28,"28109",1591,1113,1111,3,2,"P-LIB",1
28,"28085",3908,3106,3078,7,28,"P-LIB",0
28,"28045",33019,25531,25313,146,218,"P-LIB",3
28,"28130",28243,22649,22458,135,191,"P-LIB",4
28,"28118",58,49,48,1,1,"P-LIB",0
28,"28119",2074,1641,1625,9,16,"P-LIB",2
28,"28040",15691,10833,10728,45,105,"P-LIB",3
28,"28177",10192,8271,8234,51,37,"P-LIB",2
28,"28020",148,99,97,1,2,"P-LIB",0
28,"28111",592,489,483,0,6,"P-LIB",0
28,"28048",499,406,401,2,5,"P-LIB",0
1,"1060",199,162,159,0,3,"RECORTES CE",0
1,"1032",522,368,361,0,7,"RECORTES CE",0
1,"1010",2275,1729,1717,17,12,"RECORTES CE",4
1,"1058",1327,843,833,8,10,"RECORTES CE",2
1,"1042",901,653,650,11,3,"RECORTES CE",0
1,"1049",140,108,108,0,0,"RECORTES CE",1
1,"1022",805,593,587,3,6,"RECORTES CE",1
1,"1030",159,126,123,1,3,"RECORTES CE",1
1,"1004",1405,1026,1010,7,16,"RECORTES CE",2
1,"1028",1077,759,753,6,6,"RECORTES CE",1
1,"1008",790,548,542,13,6,"RECORTES CE",4
1,"1901",2344,1688,1669,17,19,"RECORTES CE",5
1,"1061",153,132,132,2,0,"RECORTES CE",0
1,"1051",3606,2413,2389,21,24,"RECORTES CE",7
1,"1041",153,105,100,1,5,"RECORTES CE",1
1,"1014",372,292,284,1,8,"RECORTES CE",0
1,"1034",165,120,119,1,1,"RECORTES CE",0
1,"1902",738,537,528,4,9,"RECORTES CE",0
1,"1016",439,255,249,3,6,"RECORTES CE",0
1,"1001",1984,1426,1405,8,21,"RECORTES CE",8
1,"1046",594,445,435,3,10,"RECORTES CE",0
1,"1044",236,189,187,1,2,"RECORTES CE",0
1,"1033",649,512,508,5,4,"RECORTES CE",1
1,"1019",144,112,111,2,1,"RECORTES CE",0
1,"1036",15034,10733,10619,73,114,"RECORTES CE",16
1,"1017",869,584,577,4,7,"RECORTES CE",1
1,"1052",244,188,186,1,2,"RECORTES CE",0
1,"1059",186354,135873,134633,948,1240,"RECORTES CE",481
1,"1053",587,367,365,3,2,"RECORTES CE",3
1,"1018",1370,964,963,4,1,"RECORTES CE",0
1,"1055",836,564,552,8,12,"RECORTES CE",0
1,"1031",1183,907,885,6,22,"RECORTES CE",1
1,"1057",245,203,202,0,1,"RECORTES CE",1
1,"1013",711,486,483,3,3,"RECORTES CE",0
1,"1027",416,268,268,0,0,"RECORTES CE",0
1,"1009",1281,908,898,2,10,"RECORTES CE",2
1,"1020",326,232,228,0,4,"RECORTES CE",0
1,"1021",460,336,332,1,4,"RECORTES CE",2
1,"1062",314,215,215,3,0,"RECORTES CE",0
1,"1023",269,197,195,2,2,"RECORTES CE",0
1,"1047",964,713,702,13,11,"RECORTES CE",0
1,"1063",1799,1320,1309,10,11,"RECORTES CE",2
1,"1039",202,161,156,0,5,"RECORTES CE",0
1,"1011",237,177,175,7,2,"RECORTES CE",0
1,"1003",1186,842,833,19,9,"RECORTES CE",1
1,"1006",176,142,141,1,1,"RECORTES CE",1
1,"1054",952,694,688,4,6,"RECORTES CE",1
1,"1037",586,425,419,2,6,"RECORTES CE",1
1,"1043",2318,1644,1624,8,20,"RECORTES CE",4
1,"1002",8139,5961,5878,32,83,"RECORTES CE",3
1,"1056",218,141,140,1,1,"RECORTES CE",0
30,"30034",1138,859,846,5,13,"SAIn",0
30,"30018",7903,5990,5912,29,78,"SAIn",2
30,"30043",24972,19411,19139,154,272,"SAIn",6
30,"30022",16894,11661,11498,119,163,"SAIn",2
30,"30014",1598,1270,1258,5,12,"SAIn",0
30,"30013",7395,5320,5277,38,43,"SAIn",2
30,"30025",4900,3777,3727,20,50,"SAIn",0
30,"30023",3762,2871,2837,14,34,"SAIn",0
30,"30039",19199,13538,13405,101,133,"SAIn",1
30,"30036",14624,10139,9988,70,151,"SAIn",5
30,"30037",18726,13183,13027,73,156,"SAIn",5
30,"30032",2849,2188,2161,10,27,"SAIn",0
30,"30005",29559,21408,21203,123,205,"SAIn",7
30,"30010",6861,5287,5220,38,67,"SAIn",4
30,"30030",312625,235232,233576,1438,1656,"SAIn",179
30,"30024",58529,42392,42072,275,320,"SAIn",16
30,"30007",6415,4554,4515,19,39,"SAIn",1
30,"30016",151577,103359,102538,620,821,"SAIn",30
30,"30008",13860,10066,9945,74,121,"SAIn",1
30,"30038",15381,10881,10797,51,84,"SAIn",1
30,"30012",9101,7170,7091,46,79,"SAIn",2
30,"30902",8022,5454,5412,34,42,"SAIn",4
30,"30020",6261,4502,4459,25,43,"SAIn",0
30,"30002",9921,7263,7166,34,97,"SAIn",1
30,"30041",13640,9156,9092,52,64,"SAIn",1
30,"30027",47867,36054,35794,181,260,"SAIn",11
30,"30004",1141,938,933,5,5,"SAIn",0
30,"30015",19154,13947,13835,77,112,"SAIn",15
30,"30035",18616,13185,13085,70,100,"SAIn",3
30,"30040",727,627,620,1,7,"SAIn",0
30,"30042",1918,1518,1500,6,18,"SAIn",0
30,"30031",498,424,421,2,3,"SAIn",1
30,"30001",4596,3602,3572,20,30,"SAIn",1
30,"30017",11635,8718,8646,46,72,"SAIn",2
30,"30033",10144,7591,7505,86,86,"SAIn",1
30,"30028",6690,5005,4938,29,67,"SAIn",1
30,"30011",4706,3582,3541,20,41,"SAIn",2
30,"30901",10331,7925,7833,54,92,"SAIn",6
30,"30006",803,683,681,2,2,"SAIn",0
30,"30026",15722,10147,10024,49,123,"SAIn",1
30,"30003",24305,16558,16419,122,139,"SAIn",6
30,"30009",12392,9724,9599,40,125,"SAIn",2
30,"30019",25921,18079,17894,121,185,"SAIn",8
30,"30029",11815,8365,8296,67,69,"SAIn",0
30,"30021",9101,6106,6034,25,72,"SAIn",0
41,"41083",1154,893,888,3,5,"UPYD",6
41,"41069",29070,20827,20558,355,269,"UPYD",82
41,"41091",541928,401177,398212,3487,2965,"UPYD",2853
41,"41030",516,409,395,2,14,"UPYD",0
41,"41089",6504,4759,4691,51,68,"UPYD",22
41,"41007",12386,8552,8403,90,149,"UPYD",34
41,"41042",5868,4612,4583,37,29,"UPYD",25
41,"41070",6021,4504,4456,44,48,"UPYD",30
41,"41044",7392,5562,5526,40,36,"UPYD",39
41,"41086",16102,10743,10665,93,78,"UPYD",73
41,"41002",1469,1085,1061,12,24,"UPYD",3
41,"41039",31674,23240,22982,196,258,"UPYD",79
41,"41053",21252,16022,15770,121,252,"UPYD",62
41,"41014",2510,1981,1958,8,23,"UPYD",2
41,"41021",21249,15031,14854,152,177,"UPYD",158
41,"41901",2676,2222,2190,31,32,"UPYD",4
41,"41085",4086,3223,3178,31,45,"UPYD",19
41,"41076",2184,1442,1432,19,10,"UPYD",1
41,"41075",10225,7387,7283,55,104,"UPYD",22
41,"41095",41137,28987,28731,302,256,"UPYD",246
41,"41038",99637,71611,71050,727,561,"UPYD",472
41,"41077",8728,6423,6308,28,115,"UPYD",115
41,"41060",15279,10611,10447,91,164,"UPYD",36
41,"41051",2170,1650,1611,8,39,"UPYD",4
41,"41015",5310,3799,3710,38,89,"UPYD",21
41,"41028",1971,1574,1562,11,12,"UPYD",23
41,"41099",3998,2597,2577,19,20,"UPYD",2
41,"41024",22662,15742,15521,137,221,"UPYD",71
41,"41097",3135,2339,2317,19,22,"UPYD",7
41,"41027",3941,2766,2709,28,57,"UPYD",12
41,"41087",10202,7160,7033,51,127,"UPYD",41
41,"41092",7749,5715,5647,57,68,"UPYD",23
41,"41082",3432,2809,2781,12,28,"UPYD",3
41,"41064",5601,3766,3715,42,51,"UPYD",5
41,"41058",17304,12982,12751,133,231,"UPYD",57
41,"41045",5749,4121,4066,49,55,"UPYD",26
41,"41037",3203,2473,2449,18,24,"UPYD",0
41,"41036",3971,2846,2806,14,40,"UPYD",3
41,"41101",5932,4454,4421,27,33,"UPYD",12
41,"41018",9490,6997,6930,45,67,"UPYD",16
41,"41032",4019,2943,2875,17,68,"UPYD",7
41,"41062",2235,1805,1790,10,15,"UPYD",1
41,"41001",1597,1262,1248,5,14,"UPYD",3
41,"41029",13423,9979,9880,84,99,"UPYD",69
41,"41098",4952,3762,3704,24,58,"UPYD",16
41,"41003",2319,1782,1754,8,28,"UPYD",4
41,"41019",4654,3267,3224,34,43,"UPYD",11
41,"41902",4675,3051,3019,20,32,"UPYD",5
41,"41050",5158,4123,4078,37,45,"UPYD",18
41,"41035",1112,887,876,5,11,"UPYD",2
41,"41084",2850,2205,2157,15,48,"UPYD",4
41,"41055",15009,10393,10292,82,101,"UPYD",13
41,"41013",4842,3491,3461,22,30,"UPYD",3
41,"41011",15395,11527,11341,114,186,"UPYD",31
41,"41025",2041,1456,1430,17,26,"UPYD",10
41,"41043",636,439,435,3,4,"UPYD",0
41,"41096",6166,4811,4752,39,59,"UPYD",22
41,"41026",4325,3551,3516,18,35,"UPYD",7
41,"41080",1270,954,938,8,16,"UPYD",6
41,"41048",2244,1625,1598,22,27,"UPYD",4
41,"41006",2740,1909,1897,13,12,"UPYD",7
41,"41094",6288,4726,4653,36,73,"UPYD",18
41,"41004",56552,40018,39623,515,395,"UPYD",328
41,"41022",4300,2918,2891,30,27,"UPYD",7
41,"41047",10086,7758,7663,80,95,"UPYD",38
41,"41005",9057,6781,6693,58,88,"UPYD",32
41,"41041",9743,7620,7482,39,138,"UPYD",36
41,"41016",7310,5473,5410,50,63,"UPYD",23
41,"41034",23033,15936,15711,189,225,"UPYD",78
41,"41054",688,587,570,2,17,"UPYD",0
41,"41067",7115,5248,5178,46,70,"UPYD",12
41,"41017",15052,11074,10964,99,110,"UPYD",80
41,"41063",2683,1942,1922,21,20,"UPYD",7
41,"41068",13948,10269,10150,75,119,"UPYD",25
41,"41012",3286,2268,2235,15,33,"UPYD",4
41,"41093",18487,14687,14594,117,93,"UPYD",118
41,"41079",9343,7111,7029,68,82,"UPYD",38
41,"41065",22868,15933,15784,172,149,"UPYD",41
41,"41020",12872,8820,8723,92,97,"UPYD",12
41,"41023",7919,5852,5788,34,64,"UPYD",30
41,"41059",33977,26158,25965,230,193,"UPYD",197
41,"41078",2522,1888,1874,5,14,"UPYD",2
41,"41052",3006,2264,2209,8,55,"UPYD",4
41,"41031",1257,838,836,8,2,"UPYD",1
41,"41903",6747,4926,4854,43,72,"UPYD",7
41,"41102",14635,10904,10655,148,249,"UPYD",53
41,"41049",9301,7147,7070,63,77,"UPYD",21
41,"41088",518,381,377,0,4,"UPYD",1
41,"41033",5102,3655,3613,25,42,"UPYD",6
41,"41010",4394,3203,3160,19,43,"UPYD",16
41,"41073",1715,1194,1169,9,25,"UPYD",1
41,"41057",275,193,191,0,2,"UPYD",0
41,"41071",5620,3974,3898,17,76,"UPYD",8
41,"41081",29164,21631,21410,218,221,"UPYD",101
41,"41046",3017,2416,2381,12,35,"UPYD",7
41,"41072",4052,3115,3041,18,74,"UPYD",0
41,"41040",10411,7959,7892,53,67,"UPYD",62
41,"41090",3541,2774,2721,17,53,"UPYD",5
41,"41061",2218,1769,1742,5,27,"UPYD",1
41,"41100",1025,770,751,5,19,"UPYD",10
41,"41056",3691,3069,3042,21,27,"UPYD",7
41,"41066",1363,1019,1007,7,12,"UPYD",1
41,"41008",1063,820,805,3,15,"UPYD",2
41,"41074",3033,2362,2341,8,21,"UPYD",5
41,"41009",1229,811,803,5,8,"UPYD",1
12,"12102",536,452,437,1,15,"RECORTES CE",0
12,"12142",161,124,123,0,1,"RECORTES CE",0
12,"12076",87,70,70,1,0,"RECORTES CE",0
12,"12139",322,239,237,1,2,"RECORTES CE",0
12,"12129",1840,1391,1360,19,31,"RECORTES CE",1
12,"12092",112,84,84,0,0,"RECORTES CE",0
12,"12108",463,395,390,0,5,"RECORTES CE",0
12,"12105",851,666,659,5,7,"RECORTES CE",0
12,"12104",6954,5571,5470,26,101,"RECORTES CE",6
12,"12036",593,448,445,2,3,"RECORTES CE",0
12,"12057",606,495,487,3,8,"RECORTES CE",1
12,"12031",3830,3049,2987,20,62,"RECORTES CE",3
12,"12069",74,50,49,0,1,"RECORTES CE",0
12,"12074",784,690,678,9,12,"RECORTES CE",0
12,"12072",1117,962,937,8,25,"RECORTES CE",0
12,"12101",363,282,273,3,9,"RECORTES CE",1
12,"12099",542,434,405,9,29,"RECORTES CE",0
12,"12012",2695,2236,2204,6,32,"RECORTES CE",3
12,"12091",185,145,141,3,4,"RECORTES CE",0
12,"12043",581,470,459,4,11,"RECORTES CE",0
12,"12117",3576,2786,2747,17,39,"RECORTES CE",5
12,"12082",9655,7570,7492,38,78,"RECORTES CE",4
12,"12901",3433,2691,2664,27,27,"RECORTES CE",4
12,"12015",96,83,81,0,2,"RECORTES CE",0
12,"12052",590,464,442,5,22,"RECORTES CE",0
12,"12087",26,18,18,3,0,"RECORTES CE",0
12,"12123",47,32,32,0,0,"RECORTES CE",0
12,"12080",1955,1647,1624,13,23,"RECORTES CE",4
12,"12005",8090,6113,6027,57,86,"RECORTES CE",8
12,"12034",1430,1078,1053,4,25,"RECORTES CE",0
12,"12110",244,173,170,1,3,"RECORTES CE",0
12,"12109",647,531,520,1,11,"RECORTES CE",0
12,"12140",1140,961,950,5,11,"RECORTES CE",0
12,"12085",5061,3310,3264,20,46,"RECORTES CE",10
12,"12100",1345,1115,1098,6,17,"RECORTES CE",0
12,"12061",378,275,275,4,0,"RECORTES CE",1
12,"12020",124,104,103,1,1,"RECORTES CE",0
12,"12113",85,69,69,2,0,"RECORTES CE",0
12,"12053",2069,1691,1677,8,14,"RECORTES CE",2
12,"12033",1907,1483,1436,11,47,"RECORTES CE",2
12,"12018",293,244,235,2,9,"RECORTES CE",1
12,"12049",455,348,339,5,9,"RECORTES CE",0
12,"12011",4587,3530,3480,30,50,"RECORTES CE",4
12,"12128",1400,1102,1091,11,11,"RECORTES CE",0
12,"12050",1320,1044,1032,8,12,"RECORTES CE",1
12,"12048",249,196,192,1,4,"RECORTES CE",0
12,"12032",23508,17400,17279,89,121,"RECORTES CE",32
12,"12042",621,520,512,13,8,"RECORTES CE",1
12,"12021",4442,3486,3432,25,54,"RECORTES CE",3
12,"12107",351,313,309,3,4,"RECORTES CE",0
12,"12112",99,81,79,1,2,"RECORTES CE",0
12,"12040",117832,89135,88464,525,671,"RECORTES CE",184
12,"12056",285,243,238,3,5,"RECORTES CE",1
12,"12029",717,572,566,6,6,"RECORTES CE",0
12,"12118",74,60,59,0,1,"RECORTES CE",0
12,"12093",189,147,145,1,2,"RECORTES CE",0
12,"12004",4204,3174,3130,19,44,"RECORTES CE",5
12,"12134",138,97,96,0,1,"RECORTES CE",0
12,"12098",588,479,473,4,6,"RECORTES CE",0
12,"12001",1054,798,786,8,12,"RECORTES CE",1
12,"12073",156,132,131,0,1,"RECORTES CE",0
12,"12046",193,154,153,3,1,"RECORTES CE",0
12,"12058",74,60,59,2,1,"RECORTES CE",0
12,"12127",77,56,56,0,0,"RECORTES CE",0
12,"12124",1853,1411,1394,20,17,"RECORTES CE",1
12,"12016",1582,1311,1295,9,16,"RECORTES CE",1
12,"12135",35749,27015,26806,174,209,"RECORTES CE",49
12,"12902",2148,1562,1536,9,26,"RECORTES CE",3
12,"12089",4331,3103,3050,25,53,"RECORTES CE",5
12,"12133",60,49,49,0,0,"RECORTES CE",0
12,"12119",147,100,100,1,0,"RECORTES CE",0
12,"12131",65,53,53,0,0,"RECORTES CE",0
12,"12024",139,115,113,1,2,"RECORTES CE",0
12,"12064",97,83,82,0,1,"RECORTES CE",0
12,"12120",184,155,154,1,1,"RECORTES CE",0
12,"12067",543,442,424,1,18,"RECORTES CE",0
12,"12006",176,140,140,1,0,"RECORTES CE",0
12,"12038",171,121,120,1,1,"RECORTES CE",1
12,"12116",67,49,49,0,0,"RECORTES CE",0
12,"12041",97,77,77,0,0,"RECORTES CE",0
12,"12126",24480,18885,18687,115,198,"RECORTES CE",16
12,"12130",404,339,332,0,7,"RECORTES CE",0
12,"12017",164,133,132,1,1,"RECORTES CE",0
12,"12115",217,169,167,2,2,"RECORTES CE",0
12,"12010",259,216,209,6,7,"RECORTES CE",0
12,"12068",49,34,34,1,0,"RECORTES CE",0
12,"12055",106,79,79,2,0,"RECORTES CE",0
12,"12028",12566,9902,9830,55,72,"RECORTES CE",20
12,"12077",4625,3443,3387,20,56,"RECORTES CE",3
12,"12121",1127,955,928,6,27,"RECORTES CE",0
12,"12002",116,98,96,0,2,"RECORTES CE",0
12,"12136",2657,2302,2252,22,50,"RECORTES CE",1
12,"12071",1280,1002,988,5,14,"RECORTES CE",2
12,"12137",37,26,26,1,0,"RECORTES CE",0
12,"12106",1170,983,967,16,16,"RECORTES CE",3
12,"12014",184,140,136,1,4,"RECORTES CE",0
12,"12008",231,192,190,2,2,"RECORTES CE",0
12,"12003",991,762,752,10,10,"RECORTES CE",1
12,"12039",840,726,719,2,7,"RECORTES CE",0
12,"12081",611,503,493,3,10,"RECORTES CE",2
12,"12007",758,672,667,7,5,"RECORTES CE",0
12,"12132",486,407,398,2,9,"RECORTES CE",0
12,"12122",805,660,647,4,13,"RECORTES CE",1
12,"12025",137,106,106,0,0,"RECORTES CE",0
12,"12125",214,185,183,2,2,"RECORTES CE",1
12,"12111",375,314,310,0,4,"RECORTES CE",0
12,"12090",109,94,93,2,1,"RECORTES CE",0
12,"12094",851,688,674,2,14,"RECORTES CE",2
12,"12070",524,418,408,8,10,"RECORTES CE",0
12,"12095",974,789,784,8,5,"RECORTES CE",0
12,"12078",339,250,247,1,3,"RECORTES CE",0
12,"12027",17217,12263,12122,77,141,"RECORTES CE",17
12,"12059",244,190,189,1,1,"RECORTES CE",0
12,"12037",16,14,14,0,0,"RECORTES CE",0
12,"12114",200,150,149,1,1,"RECORTES CE",1
12,"12022",340,273,269,1,4,"RECORTES CE",0
12,"12060",446,367,360,2,7,"RECORTES CE",0
12,"12097",67,55,54,0,1,"RECORTES CE",1
12,"12051",477,337,335,2,2,"RECORTES CE",0
12,"12079",405,318,312,4,6,"RECORTES CE",0
12,"12013",148,119,116,4,3,"RECORTES CE",1
12,"12009",17430,12600,12501,77,99,"RECORTES CE",20
12,"12065",192,166,166,0,0,"RECORTES CE",0
12,"12083",95,82,80,0,2,"RECORTES CE",0
12,"12026",894,697,676,14,21,"RECORTES CE",0
12,"12088",69,58,58,0,0,"RECORTES CE",0
12,"12063",42,35,34,2,1,"RECORTES CE",1
12,"12096",775,587,580,12,7,"RECORTES CE",1
12,"12141",101,80,80,0,0,"RECORTES CE",0
12,"12044",483,438,431,4,7,"RECORTES CE",0
12,"12138",19064,13610,13456,135,154,"RECORTES CE",20
12,"12103",89,69,68,2,1,"RECORTES CE",0
12,"12084",17599,13146,13022,98,124,"RECORTES CE",22
12,"12045",354,282,279,2,3,"RECORTES CE",0
12,"12075",123,94,92,1,2,"RECORTES CE",0
20,"20042",3251,2170,2152,23,18,"Ln",2
20,"20076",6978,4975,4958,39,17,"Ln",1
20,"20032",8785,6115,6076,45,39,"Ln",2
20,"20047",477,329,329,2,0,"Ln",1
20,"20044",368,264,259,0,5,"Ln",0
20,"20048",176,104,104,2,0,"Ln",0
20,"20014",1111,635,632,4,3,"Ln",0
20,"20053",4765,3150,3132,18,18,"Ln",2
20,"20052",1091,797,792,6,5,"Ln",0
20,"20070",1099,749,744,4,5,"Ln",2
20,"20080",7900,5517,5487,33,30,"Ln",4
20,"20009",11528,7997,7955,57,42,"Ln",7
20,"20069",147189,106909,106506,699,403,"Ln",45
20,"20004",252,135,135,2,0,"Ln",0
20,"20065",3006,2104,2089,18,15,"Ln",0
20,"20024",393,226,226,2,0,"Ln",0
20,"20027",2816,1842,1833,11,9,"Ln",1
20,"20067",30825,21606,21512,113,94,"Ln",10
20,"20013",5427,3901,3875,19,26,"Ln",1
20,"20902",14193,10263,10219,56,44,"Ln",3
20,"20078",1155,866,864,6,2,"Ln",0
20,"20010",1494,1055,1053,4,2,"Ln",2
20,"20045",46691,32759,32560,222,199,"Ln",16
20,"20063",7990,5449,5415,23,34,"Ln",73
20,"20030",21515,15110,15019,108,91,"Ln",6
20,"20026",202,141,129,4,12,"Ln",0
20,"20015",1272,924,921,9,3,"Ln",0
20,"20077",5243,3792,3777,25,15,"Ln",2
20,"20012",144,108,108,3,0,"Ln",0
20,"20038",392,284,281,1,3,"Ln",0
20,"20008",721,382,376,5,6,"Ln",0
20,"20023",445,258,258,2,0,"Ln",0
20,"20040",15321,10260,10176,69,84,"Ln",7
20,"20061",4273,2832,2816,21,16,"Ln",4
20,"20074",11610,8382,8320,43,62,"Ln",0
20,"20022",834,499,494,7,5,"Ln",0
20,"20064",12526,8429,8387,59,42,"Ln",8
20,"20079",17835,12650,12587,81,63,"Ln",6
20,"20020",129,71,71,0,0,"Ln",0
20,"20904",96,62,62,0,0,"Ln",0
20,"20025",1144,774,767,5,7,"Ln",0
20,"20029",4258,3005,2992,17,13,"Ln",2
20,"20006",262,161,159,1,2,"Ln",0
20,"20046",1167,797,794,4,3,"Ln",0
20,"20036",13148,9191,9132,85,59,"Ln",3
20,"20005",1261,811,805,7,6,"Ln",0
20,"20073",4677,3219,3208,21,11,"Ln",3
20,"20049",4124,2793,2780,22,13,"Ln",2
20,"20031",180,105,102,1,3,"Ln",0
20,"20033",864,629,625,3,4,"Ln",1
20,"20011",1660,1283,1278,9,5,"Ln",0
20,"20043",1740,1157,1152,6,5,"Ln",1
20,"20037",97,59,59,1,0,"Ln",0
20,"20081",7460,5187,5159,33,28,"Ln",2
20,"20059",8863,6091,6072,30,19,"Ln",1
20,"20021",199,110,110,2,0,"Ln",0
20,"20062",982,685,684,3,1,"Ln",1
20,"20034",3157,2145,2141,7,4,"Ln",3
20,"20050",263,160,160,4,0,"Ln",0
20,"20017",8580,5807,5770,37,37,"Ln",14
20,"20060",89,76,75,2,1,"Ln",0
20,"20018",11074,7100,7059,29,41,"Ln",3
20,"20071",14818,10095,10057,62,38,"Ln",4
20,"20901",1441,982,979,2,3,"Ln",0
20,"20055",17522,12125,12043,52,82,"Ln",6
20,"20056",4104,2654,2633,12,21,"Ln",1
20,"20066",461,279,276,3,3,"Ln",0
20,"20007",304,209,209,5,0,"Ln",0
20,"20039",2111,1539,1532,13,7,"Ln",1
20,"20906",121,84,84,1,0,"Ln",0
20,"20057",201,122,121,0,1,"Ln",0
20,"20058",746,547,546,3,1,"Ln",0
20,"20075",4359,2852,2833,16,19,"Ln",2
20,"20054",447,301,297,5,4,"Ln",0
20,"20905",141,105,105,0,0,"Ln",0
20,"20907",120,85,84,2,1,"Ln",0
20,"20903",4247,2846,2826,9,20,"Ln",1
20,"20072",4731,3132,3123,23,9,"Ln",2
20,"20068",183,117,115,0,2,"Ln",0
20,"20002",343,227,226,10,1,"Ln",0
20,"20019",10053,6876,6844,72,32,"Ln",4
20,"20003",541,334,334,3,0,"Ln",1
20,"20028",2255,1503,1494,17,9,"Ln",1
20,"20041",258,148,148,2,0,"Ln",0
20,"20001",242,138,137,1,1,"Ln",0
20,"20035",482,329,328,4,1,"Ln",0
20,"20051",6904,5001,4975,31,26,"Ln",103
20,"20016",1514,885,884,5,1,"Ln",0
7,"7015",21076,13304,13169,162,135,"UPB: IU-UPe",407
7,"7028",892,617,611,2,6,"UPB: IU-UPe",11
7,"7902",1072,730,712,18,18,"UPB: IU-UPe",32
7,"7025",478,377,376,1,1,"UPB: IU-UPe",7
7,"7005",6659,4400,4357,23,43,"UPB: IU-UPe",66
7,"7026",31158,18670,18537,161,133,"UPB: IU-UPe",612
7,"7011",27781,18282,18180,135,102,"UPB: IU-UPe",407
7,"7021",234,188,188,0,0,"UPB: IU-UPe",3
7,"7016",2786,1992,1969,30,23,"UPB: IU-UPe",25
7,"7003",11742,6924,6837,43,87,"UPB: IU-UPe",143
7,"7901",611,476,469,6,7,"UPB: IU-UPe",4
7,"7012",1877,1421,1408,13,13,"UPB: IU-UPe",25
7,"7036",26936,19563,19392,156,171,"UPB: IU-UPe",476
7,"7038",2032,1515,1503,10,12,"UPB: IU-UPe",20
7,"7062",7539,4371,4312,40,59,"UPB: IU-UPe",133
7,"7050",3321,2161,2134,33,27,"UPB: IU-UPe",42
7,"7064",5361,3588,3546,20,42,"UPB: IU-UPe",138
7,"7061",9831,6618,6546,54,72,"UPB: IU-UPe",124
7,"7030",1573,1151,1129,10,22,"UPB: IU-UPe",7
7,"7013",6832,4879,4775,34,104,"UPB: IU-UPe",53
7,"7056",5012,3632,3592,40,40,"UPB: IU-UPe",72
7,"7009",749,552,550,1,2,"UPB: IU-UPe",6
7,"7058",2804,2138,2118,15,20,"UPB: IU-UPe",26
7,"7035",1517,1188,1181,3,7,"UPB: IU-UPe",9
7,"7048",17339,10192,10101,104,91,"UPB: IU-UPe",389
7,"7004",3861,2657,2630,24,27,"UPB: IU-UPe",42
7,"7054",22371,12930,12779,104,151,"UPB: IU-UPe",434
7,"7044",8457,6079,5963,59,116,"UPB: IU-UPe",55
7,"7055",7474,4796,4740,48,56,"UPB: IU-UPe",63
7,"7052",4705,2993,2971,34,22,"UPB: IU-UPe",103
7,"7022",11575,7827,7730,85,97,"UPB: IU-UPe",130
7,"7024",7019,3579,3544,39,35,"UPB: IU-UPe",194
7,"7007",437,308,304,1,4,"UPB: IU-UPe",5
7,"7059",2998,2119,2084,11,35,"UPB: IU-UPe",29
7,"7001",3556,2682,2657,21,25,"UPB: IU-UPe",51
7,"7017",844,625,618,6,7,"UPB: IU-UPe",10
7,"7032",20039,13156,13033,136,123,"UPB: IU-UPe",473
7,"7027",20667,13784,13673,106,111,"UPB: IU-UPe",220
7,"7049",1498,1080,1071,12,9,"UPB: IU-UPe",12
7,"7042",10666,7023,6967,59,56,"UPB: IU-UPe",137
7,"7031",23747,15538,15401,130,137,"UPB: IU-UPe",317
7,"7020",3597,2652,2622,27,30,"UPB: IU-UPe",53
7,"7018",389,271,265,3,6,"UPB: IU-UPe",2
7,"7010",4858,3518,3463,52,55,"UPB: IU-UPe",84
7,"7047",2236,1602,1584,7,18,"UPB: IU-UPe",32
7,"7060",2577,1825,1807,20,18,"UPB: IU-UPe",18
7,"7065",2079,1462,1451,13,11,"UPB: IU-UPe",18
7,"7046",15649,9532,9443,70,89,"UPB: IU-UPe",261
7,"7033",27017,16370,16205,143,165,"UPB: IU-UPe",276
7,"7043",3422,2435,2410,13,25,"UPB: IU-UPe",28
7,"7039",4880,3473,3412,27,61,"UPB: IU-UPe",31
7,"7051",5225,3322,3279,38,43,"UPB: IU-UPe",63
7,"7014",7277,4301,4261,37,40,"UPB: IU-UPe",125
7,"7053",1171,957,946,8,11,"UPB: IU-UPe",22
7,"7041",2039,1566,1540,5,26,"UPB: IU-UPe",13
7,"7019",192,146,146,0,0,"UPB: IU-UPe",0
7,"7002",6367,4466,4401,36,65,"UPB: IU-UPe",155
7,"7045",1288,996,992,13,4,"UPB: IU-UPe",22
7,"7037",3232,1894,1881,16,13,"UPB: IU-UPe",62
7,"7063",1420,1084,1072,8,12,"UPB: IU-UPe",19
7,"7040",279737,181078,179570,1280,1508,"UPB: IU-UPe",4309
7,"7006",5175,3559,3528,33,31,"UPB: IU-UPe",49
7,"7029",4137,3088,3048,34,40,"UPB: IU-UPe",37
7,"7023",3628,2611,2573,45,38,"UPB: IU-UPe",127
7,"7057",7170,4736,4668,44,68,"UPB: IU-UPe",55
7,"7008",5681,4203,4153,22,50,"UPB: IU-UPe",54
7,"7034",991,774,765,2,9,"UPB: IU-UPe",12
3,"3127",352,279,277,1,2,"CENTRO MODE",2
3,"3071",3980,3134,3106,28,28,"CENTRO MODE",4
3,"3122",42227,31379,31186,160,193,"CENTRO MODE",160
3,"3095",4602,3628,3605,27,23,"CENTRO MODE",6
3,"3076",8485,6251,6194,37,57,"CENTRO MODE",8
3,"3004",585,455,454,1,1,"CENTRO MODE",0
3,"3006",497,401,393,4,8,"CENTRO MODE",0
3,"3131",175,159,153,0,6,"CENTRO MODE",0
3,"3056",8737,6809,6731,33,78,"CENTRO MODE",7
3,"3018",12212,9129,9040,64,89,"CENTRO MODE",20
3,"3066",42291,31010,30781,190,229,"CENTRO MODE",151
3,"3128",4097,2972,2942,12,30,"CENTRO MODE",4
3,"3027",159,135,132,0,3,"CENTRO MODE",0
3,"3022",142,120,120,2,0,"CENTRO MODE",0
3,"3011",7729,5651,5595,29,56,"CENTRO MODE",15
3,"3117",370,325,322,0,3,"CENTRO MODE",0
3,"3012",1072,862,849,3,13,"CENTRO MODE",2
3,"3020",102,79,79,0,0,"CENTRO MODE",1
3,"3055",5168,3949,3899,13,50,"CENTRO MODE",10
3,"3902",10213,7091,6997,52,94,"CENTRO MODE",15
3,"3008",167,132,131,0,1,"CENTRO MODE",0
3,"3017",376,317,312,3,5,"CENTRO MODE",0
3,"3044",4512,3639,3586,16,53,"CENTRO MODE",11
3,"3106",596,503,501,1,2,"CENTRO MODE",0
3,"3103",278,240,237,1,3,"CENTRO MODE",0
3,"3121",21269,14932,14795,78,137,"CENTRO MODE",52
3,"3031",41486,28059,27851,152,208,"CENTRO MODE",85
3,"3077",1374,1139,1126,11,13,"CENTRO MODE",2
3,"3110",289,239,239,1,0,"CENTRO MODE",0
3,"3074",1706,1400,1382,3,18,"CENTRO MODE",2
3,"3134",148,132,132,2,0,"CENTRO MODE",0
3,"3013",1114,914,906,5,8,"CENTRO MODE",2
3,"3005",7753,6158,6118,38,40,"CENTRO MODE",19
3,"3097",990,817,811,8,6,"CENTRO MODE",5
3,"3120",2416,1814,1783,13,31,"CENTRO MODE",7
3,"3111",5411,4044,3967,14,77,"CENTRO MODE",17
3,"3133",41763,26236,26039,134,197,"CENTRO MODE",141
3,"3124",469,400,394,5,6,"CENTRO MODE",1
3,"3080",1299,1065,1036,3,29,"CENTRO MODE",0
3,"3083",5607,4160,4106,36,54,"CENTRO MODE",17
3,"3118",2452,1732,1714,9,18,"CENTRO MODE",7
3,"3100",508,446,442,1,4,"CENTRO MODE",2
3,"3089",9599,7100,6980,39,120,"CENTRO MODE",20
3,"3045",216,182,179,1,3,"CENTRO MODE",0
3,"3102",7271,5762,5687,46,75,"CENTRO MODE",13
3,"3116",1159,892,886,2,6,"CENTRO MODE",3
3,"3061",1057,828,816,2,12,"CENTRO MODE",7
3,"3009",46817,36581,36258,240,323,"CENTRO MODE",114
3,"3082",12542,8709,8597,48,112,"CENTRO MODE",22
3,"3014",237548,173040,172027,866,1013,"CENTRO MODE",640
3,"3073",236,202,202,1,0,"CENTRO MODE",0
3,"3136",446,361,361,2,0,"CENTRO MODE",2
3,"3025",1270,1003,996,3,7,"CENTRO MODE",5
3,"3090",17087,12723,12602,69,121,"CENTRO MODE",41
3,"3098",507,403,394,3,9,"CENTRO MODE",0
3,"3904",1393,1065,1057,8,8,"CENTRO MODE",3
3,"3135",214,176,174,0,2,"CENTRO MODE",1
3,"3129",1187,991,984,8,7,"CENTRO MODE",4
3,"3137",653,516,515,5,1,"CENTRO MODE",1
3,"3028",1006,833,823,1,10,"CENTRO MODE",1
3,"3063",26383,19376,19255,105,121,"CENTRO MODE",59
3,"3085",270,226,225,1,1,"CENTRO MODE",0
3,"3060",108,92,90,1,2,"CENTRO MODE",0
3,"3052",969,804,794,6,10,"CENTRO MODE",2
3,"3030",513,432,424,0,8,"CENTRO MODE",1
3,"3094",9033,6702,6657,32,45,"CENTRO MODE",15
3,"3047",9161,6622,6534,35,88,"CENTRO MODE",30
3,"3113",4254,3159,3120,17,39,"CENTRO MODE",8
3,"3104",27134,21080,20902,156,178,"CENTRO MODE",77
3,"3026",1224,970,949,6,21,"CENTRO MODE",1
3,"3016",94,79,79,0,0,"CENTRO MODE",0
3,"3091",247,217,215,1,2,"CENTRO MODE",1
3,"3042",1367,1045,1033,5,12,"CENTRO MODE",2
3,"3139",22357,15787,15624,101,163,"CENTRO MODE",87
3,"3036",91,80,79,2,1,"CENTRO MODE",1
3,"3033",113,97,97,2,0,"CENTRO MODE",0
3,"3099",42365,31612,31259,220,353,"CENTRO MODE",87
3,"3038",358,292,285,2,7,"CENTRO MODE",0
3,"3138",3154,2406,2378,10,28,"CENTRO MODE",6
3,"3040",257,222,222,0,0,"CENTRO MODE",0
3,"3112",653,522,517,2,5,"CENTRO MODE",2
3,"3039",85,61,59,0,2,"CENTRO MODE",0
3,"3132",536,426,423,0,3,"CENTRO MODE",0
3,"3075",156,139,139,0,0,"CENTRO MODE",0
3,"3029",242,186,183,1,3,"CENTRO MODE",0
3,"3037",352,296,293,3,3,"CENTRO MODE",0
3,"3050",18601,13710,13610,61,100,"CENTRO MODE",82
3,"3053",7196,5800,5736,37,64,"CENTRO MODE",18
3,"3015",12544,9478,9388,58,90,"CENTRO MODE",13
3,"3096",5811,4539,4492,19,47,"CENTRO MODE",19
3,"3119",16534,12466,12363,69,103,"CENTRO MODE",44
3,"3003",455,393,388,3,5,"CENTRO MODE",1
3,"3101",4765,3708,3659,13,49,"CENTRO MODE",9
3,"3903",2482,1945,1926,16,19,"CENTRO MODE",2
3,"3043",2900,2516,2483,18,33,"CENTRO MODE",8
3,"3062",213,176,175,0,1,"CENTRO MODE",0
3,"3035",663,543,538,1,5,"CENTRO MODE",0
3,"3001",337,289,286,3,3,"CENTRO MODE",0
3,"3114",1568,1216,1203,8,13,"CENTRO MODE",2
3,"3034",1367,1095,1079,4,16,"CENTRO MODE",1
3,"3058",4947,4015,3978,21,37,"CENTRO MODE",5
3,"3065",166944,126831,126024,773,807,"CENTRO MODE",527
3,"3079",18235,14578,14388,114,190,"CENTRO MODE",43
3,"3041",5945,4393,4344,28,49,"CENTRO MODE",12
3,"3901",1129,855,853,5,2,"CENTRO MODE",1
3,"3130",47,30,30,0,0,"CENTRO MODE",0
3,"3081",1433,1130,1118,5,12,"CENTRO MODE",1
3,"3093",19661,15155,14988,84,167,"CENTRO MODE",49
3,"3024",3904,3109,3060,17,49,"CENTRO MODE",6
3,"3059",20538,15653,15522,79,131,"CENTRO MODE",41
3,"3109",2850,2301,2275,11,26,"CENTRO MODE",8
3,"3115",248,219,219,2,0,"CENTRO MODE",0
3,"3092",6749,5398,5342,40,56,"CENTRO MODE",9
3,"3069",3060,2187,2168,9,19,"CENTRO MODE",9
3,"3007",168,142,138,0,4,"CENTRO MODE",1
3,"3002",3610,2714,2682,18,32,"CENTRO MODE",8
3,"3049",12082,9341,9236,69,105,"CENTRO MODE",23
3,"3107",2459,1807,1791,5,16,"CENTRO MODE",8
3,"3088",5498,4078,4030,42,48,"CENTRO MODE",11
3,"3046",1594,1185,1178,9,7,"CENTRO MODE",2
3,"3084",543,478,476,4,2,"CENTRO MODE",0
3,"3105",5387,4089,4017,21,72,"CENTRO MODE",10
3,"3070",2038,1526,1499,5,27,"CENTRO MODE",4
3,"3125",346,263,262,0,1,"CENTRO MODE",0
3,"3078",486,398,397,3,1,"CENTRO MODE",0
3,"3019",15261,11921,11804,98,117,"CENTRO MODE",61
3,"3068",46,41,40,0,1,"CENTRO MODE",0
3,"3057",191,148,148,2,0,"CENTRO MODE",0
3,"3064",5040,3887,3834,16,53,"CENTRO MODE",8
3,"3086",153,134,134,1,0,"CENTRO MODE",1
3,"3021",5627,4691,4613,23,78,"CENTRO MODE",11
3,"3067",98,82,81,1,1,"CENTRO MODE",0
3,"3054",338,274,268,4,6,"CENTRO MODE",0
3,"3023",1410,1221,1201,8,20,"CENTRO MODE",2
3,"3072",351,288,287,2,1,"CENTRO MODE",0
3,"3048",4858,3785,3735,25,50,"CENTRO MODE",12
3,"3010",325,278,276,0,2,"CENTRO MODE",0
3,"3140",26176,19795,19509,155,286,"CENTRO MODE",132
3,"3032",106,90,89,1,1,"CENTRO MODE",3
3,"3051",350,310,305,1,5,"CENTRO MODE",2
3,"3123",7472,5748,5680,38,68,"CENTRO MODE",14
12,"12043",581,470,459,4,11,"PACMA",5
12,"12128",1400,1102,1091,11,11,"PACMA",2
12,"12119",147,100,100,1,0,"PACMA",2
12,"12014",184,140,136,1,4,"PACMA",1
12,"12080",1955,1647,1624,13,23,"PACMA",5
12,"12017",164,133,132,1,1,"PACMA",1
12,"12056",285,243,238,3,5,"PACMA",0
12,"12001",1054,798,786,8,12,"PACMA",0
12,"12126",24480,18885,18687,115,198,"PACMA",113
12,"12002",116,98,96,0,2,"PACMA",0
12,"12058",74,60,59,2,1,"PACMA",1
12,"12012",2695,2236,2204,6,32,"PACMA",8
12,"12107",351,313,309,3,4,"PACMA",1
12,"12068",49,34,34,1,0,"PACMA",0
12,"12138",19064,13610,13456,135,154,"PACMA",126
12,"12025",137,106,106,0,0,"PACMA",0
12,"12071",1280,1002,988,5,14,"PACMA",5
12,"12063",42,35,34,2,1,"PACMA",0
12,"12116",67,49,49,0,0,"PACMA",0
12,"12082",9655,7570,7492,38,78,"PACMA",52
12,"12129",1840,1391,1360,19,31,"PACMA",2
12,"12121",1127,955,928,6,27,"PACMA",2
12,"12098",588,479,473,4,6,"PACMA",1
12,"12052",590,464,442,5,22,"PACMA",0
12,"12015",96,83,81,0,2,"PACMA",1
12,"12041",97,77,77,0,0,"PACMA",0
12,"12003",991,762,752,10,10,"PACMA",3
12,"12122",805,660,647,4,13,"PACMA",1
12,"12087",26,18,18,3,0,"PACMA",0
12,"12020",124,104,103,1,1,"PACMA",0
12,"12100",1345,1115,1098,6,17,"PACMA",12
12,"12099",542,434,405,9,29,"PACMA",3
12,"12089",4331,3103,3050,25,53,"PACMA",32
12,"12033",1907,1483,1436,11,47,"PACMA",12
12,"12134",138,97,96,0,1,"PACMA",1
12,"12077",4625,3443,3387,20,56,"PACMA",23
12,"12115",217,169,167,2,2,"PACMA",0
12,"12902",2148,1562,1536,9,26,"PACMA",15
12,"12120",184,155,154,1,1,"PACMA",0
12,"12053",2069,1691,1677,8,14,"PACMA",8
12,"12135",35749,27015,26806,174,209,"PACMA",228
12,"12022",340,273,269,1,4,"PACMA",0
12,"12013",148,119,116,4,3,"PACMA",0
12,"12060",446,367,360,2,7,"PACMA",0
12,"12045",354,282,279,2,3,"PACMA",0
12,"12108",463,395,390,0,5,"PACMA",0
12,"12110",244,173,170,1,3,"PACMA",0
12,"12073",156,132,131,0,1,"PACMA",0
12,"12057",606,495,487,3,8,"PACMA",0
12,"12009",17430,12600,12501,77,99,"PACMA",110
12,"12081",611,503,493,3,10,"PACMA",2
12,"12046",193,154,153,3,1,"PACMA",0
12,"12016",1582,1311,1295,9,16,"PACMA",8
12,"12101",363,282,273,3,9,"PACMA",1
12,"12061",378,275,275,4,0,"PACMA",2
12,"12092",112,84,84,0,0,"PACMA",0
12,"12027",17217,12263,12122,77,141,"PACMA",111
12,"12142",161,124,123,0,1,"PACMA",0
12,"12109",647,531,520,1,11,"PACMA",7
12,"12117",3576,2786,2747,17,39,"PACMA",20
12,"12093",189,147,145,1,2,"PACMA",0
12,"12024",139,115,113,1,2,"PACMA",0
12,"12067",543,442,424,1,18,"PACMA",1
12,"12085",5061,3310,3264,20,46,"PACMA",30
12,"12097",67,55,54,0,1,"PACMA",1
12,"12127",77,56,56,0,0,"PACMA",0
12,"12004",4204,3174,3130,19,44,"PACMA",32
12,"12059",244,190,189,1,1,"PACMA",0
12,"12139",322,239,237,1,2,"PACMA",0
12,"12079",405,318,312,4,6,"PACMA",2
12,"12005",8090,6113,6027,57,86,"PACMA",35
12,"12131",65,53,53,0,0,"PACMA",0
12,"12064",97,83,82,0,1,"PACMA",0
12,"12084",17599,13146,13022,98,124,"PACMA",102
12,"12051",477,337,335,2,2,"PACMA",0
12,"12036",593,448,445,2,3,"PACMA",0
12,"12094",851,688,674,2,14,"PACMA",2
12,"12102",536,452,437,1,15,"PACMA",5
12,"12065",192,166,166,0,0,"PACMA",2
12,"12136",2657,2302,2252,22,50,"PACMA",8
12,"12026",894,697,676,14,21,"PACMA",0
12,"12034",1430,1078,1053,4,25,"PACMA",4
12,"12039",840,726,719,2,7,"PACMA",3
12,"12049",455,348,339,5,9,"PACMA",4
12,"12006",176,140,140,1,0,"PACMA",1
12,"12103",89,69,68,2,1,"PACMA",0
12,"12112",99,81,79,1,2,"PACMA",0
12,"12011",4587,3530,3480,30,50,"PACMA",21
12,"12095",974,789,784,8,5,"PACMA",5
12,"12021",4442,3486,3432,25,54,"PACMA",16
12,"12111",375,314,310,0,4,"PACMA",1
12,"12028",12566,9902,9830,55,72,"PACMA",77
12,"12901",3433,2691,2664,27,27,"PACMA",16
12,"12137",37,26,26,1,0,"PACMA",1
12,"12133",60,49,49,0,0,"PACMA",0
12,"12040",117832,89135,88464,525,671,"PACMA",702
12,"12078",339,250,247,1,3,"PACMA",2
12,"12104",6954,5571,5470,26,101,"PACMA",28
12,"12055",106,79,79,2,0,"PACMA",0
12,"12010",259,216,209,6,7,"PACMA",0
12,"12008",231,192,190,2,2,"PACMA",3
12,"12105",851,666,659,5,7,"PACMA",1
12,"12124",1853,1411,1394,20,17,"PACMA",5
12,"12091",185,145,141,3,4,"PACMA",1
12,"12132",486,407,398,2,9,"PACMA",4
12,"12096",775,587,580,12,7,"PACMA",3
12,"12106",1170,983,967,16,16,"PACMA",4
12,"12050",1320,1044,1032,8,12,"PACMA",4
12,"12090",109,94,93,2,1,"PACMA",0
12,"12044",483,438,431,4,7,"PACMA",0
12,"12038",171,121,120,1,1,"PACMA",1
12,"12029",717,572,566,6,6,"PACMA",4
12,"12125",214,185,183,2,2,"PACMA",0
12,"12141",101,80,80,0,0,"PACMA",0
12,"12118",74,60,59,0,1,"PACMA",0
12,"12042",621,520,512,13,8,"PACMA",1
12,"12031",3830,3049,2987,20,62,"PACMA",17
12,"12007",758,672,667,7,5,"PACMA",1
12,"12088",69,58,58,0,0,"PACMA",0
12,"12083",95,82,80,0,2,"PACMA",0
12,"12048",249,196,192,1,4,"PACMA",0
12,"12114",200,150,149,1,1,"PACMA",0
12,"12130",404,339,332,0,7,"PACMA",1
12,"12070",524,418,408,8,10,"PACMA",2
12,"12032",23508,17400,17279,89,121,"PACMA",152
12,"12037",16,14,14,0,0,"PACMA",0
12,"12069",74,50,49,0,1,"PACMA",0
12,"12140",1140,961,950,5,11,"PACMA",4
12,"12123",47,32,32,0,0,"PACMA",0
12,"12072",1117,962,937,8,25,"PACMA",2
12,"12018",293,244,235,2,9,"PACMA",0
12,"12074",784,690,678,9,12,"PACMA",0
12,"12076",87,70,70,1,0,"PACMA",1
12,"12113",85,69,69,2,0,"PACMA",0
12,"12075",123,94,92,1,2,"PACMA",0
35,"35005",1071,718,711,6,7,"VOX",0
35,"35022",48059,30474,30134,219,340,"VOX",23
35,"35003",5125,2989,2929,21,60,"VOX",7
35,"35026",80806,53749,52665,450,1084,"VOX",48
35,"35025",1801,1239,1216,9,23,"VOX",0
35,"35028",9705,5552,5478,64,74,"VOX",6
35,"35019",32253,19902,19621,126,281,"VOX",9
35,"35021",14942,10691,10537,80,154,"VOX",16
35,"35030",9205,5602,5501,58,101,"VOX",9
35,"35023",11680,8467,8295,75,172,"VOX",8
35,"35017",25447,15415,15079,127,336,"VOX",37
35,"35006",30302,21967,21625,243,342,"VOX",28
35,"35004",38814,20869,20641,192,228,"VOX",41
35,"35018",12463,7628,7546,56,82,"VOX",9
35,"35034",7707,3921,3872,30,49,"VOX",4
35,"35014",11169,6234,6107,59,127,"VOX",8
35,"35008",6109,4631,4542,37,89,"VOX",15
35,"35016",297974,198159,195935,1546,2224,"VOX",391
35,"35033",6378,4412,4354,24,58,"VOX",9
35,"35001",4599,3455,3396,27,59,"VOX",1
35,"35011",23882,16369,16095,107,274,"VOX",26
35,"35015",9870,5451,5368,29,83,"VOX",4
35,"35020",6054,4073,4018,26,55,"VOX",1
35,"35010",3548,2371,2336,20,35,"VOX",2
35,"35007",515,332,330,2,2,"VOX",0
35,"35002",23129,15904,15675,74,229,"VOX",17
35,"35013",6609,4997,4881,51,116,"VOX",8
35,"35031",7270,5184,5000,36,184,"VOX",11
35,"35027",10311,7497,7364,58,133,"VOX",6
35,"35012",10331,5684,5610,32,74,"VOX",6
35,"35032",3432,2541,2498,19,43,"VOX",0
35,"35029",4125,2545,2514,34,31,"VOX",2
35,"35024",13621,8665,8555,76,110,"VOX",10
35,"35009",19832,14305,14036,97,269,"VOX",9
32,"32001",4978,3644,3607,31,37,"PT",4
32,"32006",1571,1140,1127,10,13,"PT",0
32,"32037",742,544,532,8,12,"PT",1
32,"32074",1064,731,719,4,12,"PT",4
32,"32086",2671,1731,1712,10,19,"PT",1
32,"32025",1094,821,809,3,12,"PT",8
32,"32038",456,299,297,2,2,"PT",0
32,"32062",832,646,644,7,2,"PT",0
32,"32030",1015,702,689,3,13,"PT",1
32,"32078",1243,876,869,6,7,"PT",0
32,"32002",2016,1474,1460,11,14,"PT",4
32,"32082",1259,905,887,6,18,"PT",3
32,"32070",566,335,330,3,5,"PT",0
32,"32075",4188,3257,3206,43,51,"PT",4
32,"32084",925,657,650,3,7,"PT",1
32,"32014",1170,855,845,7,10,"PT",0
32,"32087",1798,1421,1397,7,24,"PT",2
32,"32039",1275,989,976,5,13,"PT",3
32,"32051",1458,1141,1137,4,4,"PT",1
32,"32015",899,586,581,5,5,"PT",0
32,"32019",11529,8038,7906,78,132,"PT",11
32,"32007",1527,1078,1070,7,8,"PT",0
32,"32043",2555,1824,1793,15,31,"PT",3
32,"32027",1072,765,747,3,18,"PT",1
32,"32031",1079,826,812,5,14,"PT",0
32,"32003",886,661,653,6,8,"PT",0
32,"32056",1610,1159,1146,9,13,"PT",1
32,"32049",775,502,495,5,7,"PT",1
32,"32076",2121,1509,1489,12,20,"PT",2
32,"32032",8101,5993,5881,74,112,"PT",15
32,"32080",333,266,265,0,1,"PT",0
32,"32008",8188,5923,5845,44,78,"PT",13
32,"32016",825,559,556,3,3,"PT",0
32,"32089",1332,917,904,5,13,"PT",3
32,"32065",669,494,482,3,12,"PT",0
32,"32040",1472,1112,1089,9,23,"PT",3
32,"32004",1826,900,897,8,3,"PT",1
32,"32053",1447,1140,1128,12,12,"PT",2
32,"32045",2484,1820,1795,19,25,"PT",5
32,"32041",772,511,505,5,6,"PT",1
32,"32077",1188,813,796,8,17,"PT",0
32,"32052",1904,1450,1426,6,24,"PT",2
32,"32017",1272,862,849,5,13,"PT",0
32,"32033",750,504,500,4,4,"PT",1
32,"32069",4333,3324,3261,25,63,"PT",2
32,"32067",1300,838,824,15,14,"PT",2
32,"32005",869,676,671,7,5,"PT",0
32,"32090",791,558,556,2,2,"PT",5
32,"32029",480,349,346,5,3,"PT",0
32,"32034",1141,880,873,4,7,"PT",1
32,"32058",5209,3808,3750,27,58,"PT",3
32,"32050",2455,1874,1855,17,19,"PT",0
32,"32092",528,337,334,4,3,"PT",0
32,"32079",1343,1000,987,9,13,"PT",2
32,"32020",2625,1997,1974,10,23,"PT",2
32,"32091",1909,1389,1375,8,14,"PT",0
32,"32018",1261,956,945,3,11,"PT",2
32,"32047",1818,1345,1329,3,16,"PT",2
32,"32011",934,559,548,5,11,"PT",0
32,"32071",1496,1013,1004,1,9,"PT",0
32,"32023",1217,884,877,6,7,"PT",1
32,"32061",1093,852,840,3,12,"PT",2
32,"32060",845,609,598,6,11,"PT",0
32,"32055",1310,952,936,7,16,"PT",1
32,"32012",811,535,533,3,2,"PT",0
32,"32048",906,573,564,6,9,"PT",2
32,"32085",10709,7489,7403,81,86,"PT",8
32,"32013",2213,1447,1431,8,16,"PT",6
32,"32072",3833,2799,2761,26,38,"PT",3
32,"32044",900,658,647,5,11,"PT",3
32,"32028",1643,1195,1174,18,21,"PT",2
32,"32073",1332,976,965,4,11,"PT",1
32,"32081",2097,1566,1553,6,13,"PT",5
32,"32066",567,435,434,2,1,"PT",0
32,"32009",10783,7555,7468,60,87,"PT",12
32,"32021",956,664,662,2,2,"PT",3
32,"32064",526,397,395,1,2,"PT",1
32,"32022",1377,963,951,7,12,"PT",0
32,"32046",1179,840,832,5,8,"PT",3
32,"32035",1484,944,938,7,6,"PT",3
32,"32010",394,299,298,0,1,"PT",0
32,"32042",1585,1120,1104,13,16,"PT",0
32,"32059",1849,1357,1339,16,18,"PT",2
32,"32083",860,580,574,4,6,"PT",3
32,"32068",1424,974,969,8,5,"PT",3
32,"32088",1632,1062,1042,8,20,"PT",4
32,"32057",575,414,412,5,2,"PT",1
32,"32063",1939,1329,1314,16,15,"PT",2
32,"32026",2736,2039,1998,25,41,"PT",5
32,"32036",1369,1053,1040,5,13,"PT",2
32,"32024",4839,3424,3368,35,56,"PT",6
32,"32054",87290,63653,62823,671,830,"PT",125
36,"36026",20203,14399,14189,144,210,"UPYD",100
36,"36002",3151,2290,2255,19,35,"UPYD",4
36,"36025",2292,1396,1389,9,7,"UPYD",4
36,"36045",24570,18613,18365,184,248,"UPYD",113
36,"36043",4736,3347,3297,22,50,"UPYD",5
36,"36055",13643,10361,10145,106,216,"UPYD",51
36,"36010",2862,2195,2177,18,18,"UPYD",6
36,"36019",1625,1127,1119,12,8,"UPYD",3
36,"36007",1689,1168,1148,12,20,"UPYD",5
36,"36039",15350,11581,11349,119,232,"UPYD",51
36,"36015",4205,2941,2885,32,56,"UPYD",20
36,"36014",1980,1464,1442,7,22,"UPYD",5
36,"36029",16129,12262,12078,101,184,"UPYD",77
36,"36052",7298,5298,5175,37,123,"UPYD",15
36,"36018",3272,2288,2262,17,26,"UPYD",1
36,"36050",7562,5567,5457,44,110,"UPYD",19
36,"36020",2351,1748,1721,20,27,"UPYD",4
36,"36057",236957,177555,175758,1730,1797,"UPYD",1173
36,"36037",2607,1862,1838,16,24,"UPYD",9
36,"36027",4452,3328,3274,23,54,"UPYD",23
36,"36049",6761,5193,5069,54,124,"UPYD",23
36,"36038",66390,49943,49439,522,504,"UPYD",313
36,"36060",30350,22032,21753,193,279,"UPYD",139
36,"36009",4908,3167,3114,25,53,"UPYD",6
36,"36005",8120,5839,5747,64,92,"UPYD",25
36,"36031",558,464,454,9,10,"UPYD",4
36,"36901",4095,3344,3293,22,51,"UPYD",7
36,"36044",2556,1786,1747,13,39,"UPYD",7
36,"36053",5693,4321,4265,41,56,"UPYD",11
36,"36011",1842,1185,1169,9,16,"UPYD",3
36,"36003",9979,7496,7401,81,95,"UPYD",36
36,"36051",14272,10230,10072,95,158,"UPYD",43
36,"36035",14430,10832,10680,86,152,"UPYD",49
36,"36058",4992,3495,3441,48,54,"UPYD",19
36,"36059",4937,3379,3318,46,61,"UPYD",12
36,"36054",10996,8116,7965,84,151,"UPYD",38
36,"36006",11537,8885,8740,79,145,"UPYD",22
36,"36028",4139,3094,3045,22,49,"UPYD",8
36,"36008",21736,16270,16094,160,176,"UPYD",99
36,"36034",3477,2499,2470,15,29,"UPYD",11
36,"36046",4055,3189,3139,30,50,"UPYD",14
36,"36017",17866,13133,12910,137,223,"UPYD",58
36,"36030",4220,3041,2994,32,47,"UPYD",11
36,"36061",8651,6594,6445,58,149,"UPYD",32
36,"36032",3655,2745,2699,21,46,"UPYD",12
36,"36040",2600,1907,1869,13,38,"UPYD",8
36,"36047",2492,1719,1704,16,15,"UPYD",1
36,"36056",5108,3856,3783,34,73,"UPYD",19
36,"36022",9056,6635,6514,48,121,"UPYD",33
36,"36021",12033,9035,8879,99,156,"UPYD",40
36,"36013",2412,1602,1586,12,16,"UPYD",3
36,"36004",10178,7351,7224,69,127,"UPYD",30
36,"36033",12347,9515,9336,76,179,"UPYD",50
36,"36041",13428,9842,9710,96,132,"UPYD",58
36,"36023",8420,6287,6180,55,107,"UPYD",26
36,"36042",17922,12993,12760,116,233,"UPYD",84
36,"36048",5348,3970,3892,44,78,"UPYD",15
36,"36001",2593,1968,1952,6,16,"UPYD",9
36,"36012",3735,2818,2777,21,41,"UPYD",16
36,"36016",1173,724,716,7,8,"UPYD",2
36,"36024",16433,12239,12016,115,223,"UPYD",57
36,"36036",2511,1923,1892,17,31,"UPYD",5
47,"47145",611,451,449,4,2,"CCD",2
47,"47085",16668,12248,12132,133,116,"CCD",60
47,"47207",277,216,212,3,4,"CCD",2
47,"47129",879,700,688,6,12,"CCD",3
47,"47044",330,291,287,0,4,"CCD",0
47,"47113",156,121,121,0,0,"CCD",0
47,"47077",247,190,189,2,1,"CCD",2
47,"47068",36,27,27,0,0,"CCD",0
47,"47148",439,336,335,2,1,"CCD",1
47,"47013",99,74,73,0,1,"CCD",0
47,"47035",930,745,739,10,6,"CCD",7
47,"47015",199,151,151,0,0,"CCD",0
47,"47106",50,41,41,0,0,"CCD",0
47,"47005",548,426,421,4,5,"CCD",0
47,"47204",260,199,193,2,6,"CCD",2
47,"47047",202,157,157,3,0,"CCD",1
47,"47178",175,146,146,1,0,"CCD",0
47,"47100",140,119,117,2,2,"CCD",1
47,"47096",135,108,107,2,1,"CCD",0
47,"47042",54,41,41,3,0,"CCD",0
47,"47128",60,51,49,1,2,"CCD",0
47,"47046",121,93,93,0,0,"CCD",0
47,"47112",2592,2063,2043,20,20,"CCD",14
47,"47057",248,194,194,2,0,"CCD",1
47,"47182",1342,1037,1023,16,14,"CCD",3
47,"47157",515,442,441,3,1,"CCD",6
47,"47213",115,83,83,0,0,"CCD",0
47,"47172",148,120,120,1,0,"CCD",0
47,"47017",201,161,158,3,3,"CCD",0
47,"47146",260,205,204,1,1,"CCD",0
47,"47143",127,99,99,0,0,"CCD",1
47,"47079",62,51,51,0,0,"CCD",0
47,"47055",202,170,168,1,2,"CCD",3
47,"47080",30,22,22,0,0,"CCD",0
47,"47105",192,164,163,0,1,"CCD",0
47,"47224",91,74,74,1,0,"CCD",0
47,"47165",6987,5301,5115,63,186,"CCD",45
47,"47111",1009,794,789,4,5,"CCD",4
47,"47004",1199,946,938,11,8,"CCD",9
47,"47097",331,268,263,1,5,"CCD",0
47,"47054",638,501,496,6,5,"CCD",5
47,"47223",158,129,125,3,4,"CCD",0
47,"47102",286,229,224,1,5,"CCD",1
47,"47216",115,101,99,2,2,"CCD",1
47,"47222",80,68,68,3,0,"CCD",0
47,"47086",3926,3065,3028,27,37,"CCD",11
47,"47019",86,67,65,1,2,"CCD",0
47,"47081",47,40,40,0,0,"CCD",0
47,"47007",3748,2869,2835,24,34,"CCD",39
47,"47170",36,30,29,2,1,"CCD",0
47,"47094",132,103,101,1,2,"CCD",1
47,"47190",93,80,78,4,2,"CCD",0
47,"47036",229,184,179,2,5,"CCD",0
47,"47092",110,93,92,0,1,"CCD",0
47,"47060",262,218,214,0,4,"CCD",0
47,"47162",73,61,61,0,0,"CCD",1
47,"47125",59,43,43,1,0,"CCD",0
47,"47028",33,20,20,0,0,"CCD",1
47,"47045",768,586,580,0,6,"CCD",2
47,"47084",1171,911,898,15,13,"CCD",3
47,"47161",3903,3200,3183,25,17,"CCD",7
47,"47037",174,146,141,2,5,"CCD",0
47,"47124",399,329,328,4,1,"CCD",0
47,"47203",67,54,54,0,0,"CCD",2
47,"47067",178,126,126,3,0,"CCD",0
47,"47050",3757,2829,2812,29,17,"CCD",15
47,"47064",31,29,28,2,1,"CCD",0
47,"47001",55,51,50,2,1,"CCD",0
47,"47189",152,128,128,0,0,"CCD",0
47,"47199",80,59,59,2,0,"CCD",0
47,"47144",78,66,65,2,1,"CCD",2
47,"47018",35,31,28,0,3,"CCD",0
47,"47091",89,67,66,0,1,"CCD",1
47,"47196",35,26,26,1,0,"CCD",0
47,"47119",90,75,75,1,0,"CCD",0
47,"47103",259,211,211,4,0,"CCD",0
47,"47010",13613,10963,10895,108,68,"CCD",35
47,"47158",906,686,668,3,18,"CCD",1
47,"47155",3239,2400,2374,27,26,"CCD",15
47,"47219",42,36,34,2,2,"CCD",0
47,"47076",17375,13778,13684,111,94,"CCD",115
47,"47153",108,74,73,1,1,"CCD",0
47,"47132",45,37,35,0,2,"CCD",0
47,"47188",112,85,85,0,0,"CCD",0
47,"47168",31,28,27,0,1,"CCD",0
47,"47197",888,693,687,10,6,"CCD",7
47,"47048",190,140,138,0,2,"CCD",0
47,"47228",445,359,357,4,2,"CCD",1
47,"47022",57,50,46,0,4,"CCD",0
47,"47082",803,641,633,5,8,"CCD",10
47,"47179",398,299,295,3,4,"CCD",0
47,"47074",150,125,125,1,0,"CCD",2
47,"47002",25,23,23,0,0,"CCD",1
47,"47185",98,79,79,0,0,"CCD",1
47,"47130",99,78,78,1,0,"CCD",0
47,"47031",186,145,144,1,1,"CCD",1
47,"47078",164,129,124,1,5,"CCD",0
47,"47166",265,203,199,3,4,"CCD",0
47,"47104",2857,2313,2253,19,60,"CCD",10
47,"47137",29,28,28,1,0,"CCD",0
47,"47014",50,45,45,0,0,"CCD",0
47,"47164",377,309,307,2,2,"CCD",2
47,"47230",302,243,241,0,2,"CCD",0
47,"47093",817,654,642,9,12,"CCD",3
47,"47023",2999,2457,2445,20,12,"CCD",10
47,"47212",388,322,322,3,0,"CCD",2
47,"47063",101,82,81,2,1,"CCD",2
47,"47218",995,760,754,6,6,"CCD",5
47,"47110",455,363,357,3,6,"CCD",2
47,"47012",118,95,95,0,0,"CCD",0
47,"47221",109,91,91,0,0,"CCD",1
47,"47003",228,180,179,3,1,"CCD",1
47,"47187",89,57,56,2,1,"CCD",0
47,"47029",57,48,47,1,1,"CCD",0
47,"47041",149,124,123,2,1,"CCD",3
47,"47121",553,436,428,5,8,"CCD",4
47,"47030",1006,785,770,10,15,"CCD",0
47,"47075",4871,3802,3763,30,39,"CCD",27
47,"47227",64,52,52,0,0,"CCD",0
47,"47024",262,206,205,2,1,"CCD",1
47,"47142",148,114,113,0,1,"CCD",0
47,"47156",169,137,135,1,2,"CCD",0
47,"47126",49,36,36,0,0,"CCD",1
47,"47039",188,149,148,1,1,"CCD",0
47,"47071",417,348,344,2,4,"CCD",1
47,"47160",430,334,329,5,5,"CCD",6
47,"47151",27,22,21,0,1,"CCD",0
47,"47139",1047,790,785,7,5,"CCD",7
47,"47109",171,131,130,1,1,"CCD",1
47,"47118",161,119,118,0,1,"CCD",0
47,"47152",86,64,64,1,0,"CCD",0
47,"47192",105,80,79,1,1,"CCD",0
47,"47195",461,348,348,3,0,"CCD",4
47,"47090",2418,1805,1776,17,29,"CCD",7
47,"47101",1720,1404,1388,10,16,"CCD",12
47,"47211",49,39,37,1,2,"CCD",0
47,"47220",166,124,124,1,0,"CCD",0
47,"47043",302,239,239,3,0,"CCD",0
47,"47116",413,330,324,1,6,"CCD",1
47,"47206",95,81,81,0,0,"CCD",0
47,"47020",278,230,227,1,3,"CCD",1
47,"47058",206,149,149,2,0,"CCD",1
47,"47175",6575,4991,4937,51,54,"CCD",18
47,"47191",110,74,74,0,0,"CCD",0
47,"47115",287,238,237,4,1,"CCD",2
47,"47011",568,469,464,1,5,"CCD",3
47,"47184",576,463,462,2,1,"CCD",5
47,"47173",883,686,675,4,11,"CCD",1
47,"47138",237,180,176,1,4,"CCD",0
47,"47167",242,201,197,3,4,"CCD",1
47,"47059",97,71,71,0,0,"CCD",1
47,"47016",71,58,57,0,1,"CCD",1
47,"47147",119,91,91,0,0,"CCD",0
47,"47021",76,65,65,1,0,"CCD",2
47,"47114",4074,2868,2826,20,42,"CCD",16
47,"47193",1583,1313,1294,12,19,"CCD",6
47,"47099",152,128,127,1,1,"CCD",0
47,"47231",4384,3457,3432,33,25,"CCD",24
47,"47133",2665,2140,2118,25,22,"CCD",14
47,"47083",80,62,61,2,1,"CCD",0
47,"47038",108,82,82,0,0,"CCD",0
47,"47123",469,395,386,4,9,"CCD",0
47,"47159",828,654,646,0,8,"CCD",1
47,"47169",68,57,57,0,0,"CCD",0
47,"47040",63,52,51,1,1,"CCD",0
47,"47027",2746,2120,2095,8,25,"CCD",10
47,"47154",155,128,127,0,1,"CCD",0
47,"47141",134,102,101,1,1,"CCD",0
47,"47177",107,78,76,0,2,"CCD",0
47,"47225",81,61,60,2,1,"CCD",0
47,"47073",120,98,97,1,1,"CCD",0
47,"47049",100,78,78,1,0,"CCD",2
47,"47205",385,281,274,7,7,"CCD",1
47,"47217",1896,1436,1420,20,16,"CCD",7
47,"47008",24,18,18,0,0,"CCD",0
47,"47095",39,36,35,0,1,"CCD",1
47,"47009",106,80,80,1,0,"CCD",0
47,"47135",84,76,76,2,0,"CCD",0
47,"47052",6584,5222,5163,41,59,"CCD",31
47,"47006",190,145,144,1,1,"CCD",2
47,"47200",82,64,64,1,0,"CCD",1
47,"47214",1420,1111,1093,9,18,"CCD",12
47,"47215",54,47,46,1,1,"CCD",0
47,"47181",168,135,134,0,1,"CCD",1
47,"47127",135,98,96,1,2,"CCD",1
47,"47229",215,151,150,1,1,"CCD",1
47,"47208",59,38,37,3,1,"CCD",0
47,"47062",163,131,131,0,0,"CCD",0
47,"47176",224,139,135,5,4,"CCD",0
47,"47171",418,333,332,9,1,"CCD",3
47,"47117",297,219,216,4,3,"CCD",2
47,"47098",583,488,487,6,1,"CCD",1
47,"47053",116,96,96,1,0,"CCD",0
47,"47026",49,40,40,0,0,"CCD",0
47,"47183",130,105,105,0,0,"CCD",0
47,"47209",42,30,30,1,0,"CCD",0
47,"47186",246602,193774,192412,1384,1362,"CCD",799
47,"47070",41,32,32,1,0,"CCD",0
47,"47033",199,154,153,3,1,"CCD",4
47,"47034",76,59,58,1,1,"CCD",0
47,"47061",258,216,214,2,2,"CCD",0
47,"47032",153,120,118,0,2,"CCD",0
47,"47226",161,128,127,1,1,"CCD",1
47,"47198",66,47,47,0,0,"CCD",0
47,"47066",1255,1005,996,7,9,"CCD",5
47,"47131",178,132,131,3,1,"CCD",0
47,"47150",278,217,214,2,3,"CCD",2
47,"47089",153,122,120,2,2,"CCD",0
47,"47056",82,58,57,0,1,"CCD",1
47,"47210",372,289,286,1,3,"CCD",2
47,"47174",275,222,218,2,4,"CCD",1
47,"47122",2034,1666,1635,21,31,"CCD",5
47,"47065",863,681,671,4,10,"CCD",7
47,"47051",338,274,272,0,2,"CCD",4
47,"47088",110,87,87,0,0,"CCD",0
47,"47194",301,242,239,1,3,"CCD",1
47,"47087",379,318,314,4,4,"CCD",0
47,"47025",120,97,97,2,0,"CCD",0
47,"47149",43,33,32,1,1,"CCD",0
47,"47069",127,113,111,0,2,"CCD",0
47,"47163",299,236,235,6,1,"CCD",2
47,"47134",164,126,119,4,7,"CCD",0
47,"47180",83,64,64,1,0,"CCD",2
47,"47140",119,101,100,1,1,"CCD",0
47,"47232",99,75,74,0,1,"CCD",0
15,"15048",4855,3582,3534,41,48,"PACMA",33
15,"15019",25902,18111,17866,232,245,"PACMA",108
15,"15068",5096,3518,3476,39,42,"PACMA",15
15,"15061",5646,3945,3894,35,51,"PACMA",28
15,"15021",5099,3673,3611,43,62,"PACMA",24
15,"15049",1099,765,755,12,10,"PACMA",1
15,"15041",9627,7409,7291,79,118,"PACMA",45
15,"15044",1309,955,941,5,14,"PACMA",3
15,"15053",7783,5386,5314,47,72,"PACMA",30
15,"15046",6345,4625,4532,53,93,"PACMA",24
15,"15036",58409,40932,40506,484,426,"PACMA",329
15,"15027",1540,1224,1203,6,21,"PACMA",3
15,"15072",9626,7024,6920,52,104,"PACMA",51
15,"15015",2840,2126,2100,21,26,"PACMA",18
15,"15074",4061,2983,2947,24,36,"PACMA",18
15,"15002",22929,16941,16742,205,199,"PACMA",132
15,"15033",2489,1953,1931,13,22,"PACMA",8
15,"15047",2463,1669,1633,21,36,"PACMA",4
15,"15037",4087,2775,2733,18,42,"PACMA",8
15,"15054",32177,22065,21778,349,287,"PACMA",240
15,"15052",4351,3122,3063,26,59,"PACMA",15
15,"15071",7965,5559,5483,37,76,"PACMA",43
15,"15013",6126,4315,4257,43,58,"PACMA",37
15,"15028",1415,1085,1070,10,15,"PACMA",7
15,"15010",1913,1355,1338,21,17,"PACMA",4
15,"15076",2649,1827,1802,24,25,"PACMA",12
15,"15008",5650,4239,4175,42,64,"PACMA",35
15,"15051",4651,3343,3297,38,46,"PACMA",24
15,"15001",4805,3466,3419,45,47,"PACMA",25
15,"15065",7345,5517,5412,46,105,"PACMA",42
15,"15014",4034,2809,2757,34,52,"PACMA",15
15,"15007",3352,2469,2453,24,16,"PACMA",9
15,"15045",3803,2382,2354,15,28,"PACMA",5
15,"15083",1100,809,795,5,14,"PACMA",0
15,"15066",4039,2950,2894,34,56,"PACMA",6
15,"15058",27623,21002,20788,257,214,"PACMA",180
15,"15038",2236,1556,1530,18,26,"PACMA",4
15,"15093",4265,2856,2814,35,42,"PACMA",10
15,"15031",23321,17319,17152,218,167,"PACMA",166
15,"15006",5353,3534,3469,49,65,"PACMA",11
15,"15018",1156,817,806,7,11,"PACMA",3
15,"15057",12169,8853,8729,88,124,"PACMA",70
15,"15092",6523,4518,4449,54,69,"PACMA",24
15,"15050",1843,1089,1070,19,19,"PACMA",3
15,"15084",3312,2361,2326,28,35,"PACMA",8
15,"15025",1069,662,654,5,8,"PACMA",3
15,"15073",21884,14792,14587,149,205,"PACMA",114
15,"15004",4855,3594,3535,28,59,"PACMA",25
15,"15902",4660,3352,3296,30,56,"PACMA",14
15,"15089",4317,3238,3188,24,50,"PACMA",13
15,"15056",5757,4167,4108,43,59,"PACMA",20
15,"15070",9117,6514,6390,98,124,"PACMA",57
15,"15075",12279,9076,8952,117,124,"PACMA",75
15,"15034",2897,1931,1909,14,22,"PACMA",7
15,"15091",1119,807,784,12,23,"PACMA",3
15,"15079",1562,1092,1075,16,17,"PACMA",9
15,"15069",6785,5107,5032,54,75,"PACMA",34
15,"15062",5936,4047,3993,31,54,"PACMA",28
15,"15035",11517,8305,8192,144,113,"PACMA",79
15,"15022",5817,4026,3981,29,45,"PACMA",29
15,"15059",10406,7710,7553,91,157,"PACMA",35
15,"15016",4806,3291,3222,21,69,"PACMA",12
15,"15901",3595,2401,2374,30,27,"PACMA",20
15,"15085",3346,2365,2311,26,54,"PACMA",14
15,"15080",1760,1215,1197,11,18,"PACMA",4
15,"15060",5780,4245,4167,48,78,"PACMA",22
15,"15009",10780,8075,7957,70,118,"PACMA",58
15,"15005",24459,16742,16482,215,260,"PACMA",183
15,"15090",1182,868,861,13,7,"PACMA",1
15,"15087",5804,3942,3901,49,41,"PACMA",20
15,"15023",6481,4658,4595,44,63,"PACMA",22
15,"15043",5147,3834,3764,36,70,"PACMA",17
15,"15012",3666,2787,2721,40,66,"PACMA",16
15,"15029",5761,3994,3928,47,66,"PACMA",11
15,"15030",200245,148692,147426,1699,1266,"PACMA",1290
15,"15039",1271,935,917,8,18,"PACMA",7
15,"15017",19380,14272,14098,156,174,"PACMA",161
15,"15077",8303,5648,5544,57,104,"PACMA",19
15,"15064",2207,1680,1650,22,30,"PACMA",15
15,"15011",15463,11105,10890,92,215,"PACMA",113
15,"15082",15162,11273,11134,135,139,"PACMA",93
15,"15078",78093,58164,57487,673,677,"PACMA",371
15,"15067",8073,6067,6000,45,67,"PACMA",62
15,"15088",3550,2398,2372,18,26,"PACMA",6
15,"15020",3844,2651,2629,17,22,"PACMA",15
15,"15024",4412,3325,3278,35,47,"PACMA",18
15,"15040",2763,2050,2017,10,33,"PACMA",9
15,"15086",2918,2109,2077,19,32,"PACMA",12
15,"15081",1042,819,814,12,5,"PACMA",2
15,"15042",3060,2170,2127,21,43,"PACMA",14
15,"15003",1818,1326,1302,18,24,"PACMA",6
15,"15032",3455,2438,2391,26,47,"PACMA",8
15,"15055",4618,3208,3159,49,49,"PACMA",32
38,"38001",20166,11307,11195,55,112,"PP",2753
38,"38004",4442,2980,2939,20,41,"PP",789
38,"38041",6808,4869,4835,42,34,"PP",1189
38,"38048",3878,2664,2624,20,40,"PP",737
38,"38039",10584,7532,7462,77,70,"PP",2911
38,"38021",1643,1014,1002,5,12,"PP",282
38,"38031",28697,21546,21202,140,344,"PP",7809
38,"38020",15021,9813,9693,51,120,"PP",2924
38,"38038",162030,105122,104174,667,948,"PP",28278
38,"38011",20435,13760,13627,82,133,"PP",3627
38,"38052",1281,853,844,2,9,"PP",327
38,"38033",3721,2552,2504,15,48,"PP",791
38,"38028",22063,15095,14954,89,141,"PP",4719
38,"38032",13257,8969,8902,72,67,"PP",2542
38,"38042",3784,2692,2673,16,19,"PP",875
38,"38046",9107,6755,6682,45,73,"PP",1873
38,"38025",6860,4836,4761,49,75,"PP",1551
38,"38023",121610,81337,80453,527,884,"PP",19784
38,"38022",18468,12230,12085,86,145,"PP",4417
38,"38009",4127,2842,2793,15,49,"PP",986
38,"38018",4405,3053,3005,21,48,"PP",1005
38,"38043",18918,12883,12737,109,146,"PP",3961
38,"38002",942,701,674,14,27,"PP",152
38,"38012",2378,1620,1606,6,14,"PP",387
38,"38024",15055,9612,9485,77,127,"PP",3523
38,"38014",1351,935,929,3,6,"PP",312
38,"38053",3754,2419,2370,15,49,"PP",781
38,"38006",39553,21159,20940,124,219,"PP",6185
38,"38016",1215,654,641,4,13,"PP",182
38,"38049",2653,1683,1658,8,25,"PP",447
38,"38044",2206,1317,1303,10,14,"PP",475
38,"38047",1789,1228,1208,5,20,"PP",407
38,"38027",5386,3685,3615,29,70,"PP",1264
38,"38045",3987,2152,2132,23,20,"PP",545
38,"38019",13217,8168,8075,54,93,"PP",2275
38,"38003",1440,970,960,2,10,"PP",253
38,"38035",9299,5558,5500,35,58,"PP",1618
38,"38017",28037,16236,16076,100,160,"PP",4338
38,"38901",1387,883,876,4,7,"PP",188
38,"38037",12997,8126,7997,46,129,"PP",2704
38,"38034",4041,2853,2814,17,39,"PP",897
38,"38036",6553,4604,4529,45,75,"PP",897
38,"38008",5513,3683,3609,17,74,"PP",1175
38,"38051",7217,5147,5089,31,58,"PP",1941
38,"38030",1923,1309,1300,5,9,"PP",317
38,"38026",32918,24984,24727,174,257,"PP",7089
38,"38015",4158,2864,2818,12,46,"PP",868
38,"38040",4990,3061,3031,16,30,"PP",1338
38,"38013",2915,1865,1847,12,18,"PP",608
38,"38005",5463,3443,3417,24,26,"PP",886
38,"38050",2471,1616,1590,8,26,"PP",396
38,"38010",4014,2726,2678,15,48,"PP",835
38,"38007",1689,1143,1119,3,24,"PP",416
38,"38029",1533,776,763,7,13,"PP",243
31,"31021",64,42,42,0,0,"UPYD",0
31,"31139",159,102,101,3,1,"UPYD",0
31,"31028",211,133,133,0,0,"UPYD",0
31,"31110",90,65,65,2,0,"UPYD",1
31,"31056",179,137,133,0,4,"UPYD",0
31,"31102",146,66,66,1,0,"UPYD",0
31,"31234",144,107,107,2,0,"UPYD",3
31,"31078",2447,1889,1861,25,28,"UPYD",9
31,"31156",252,193,193,0,0,"UPYD",1
31,"31196",39,34,34,0,0,"UPYD",1
31,"31142",1411,972,964,11,8,"UPYD",0
31,"31147",98,76,76,2,0,"UPYD",1
31,"31075",101,68,67,1,1,"UPYD",0
31,"31031",221,141,140,0,1,"UPYD",0
31,"31023",6826,5609,5591,77,18,"UPYD",22
31,"31044",290,223,220,1,3,"UPYD",0
31,"31202",4326,3045,3001,41,44,"UPYD",22
31,"31191",3018,2324,2297,23,27,"UPYD",13
31,"31048",169,123,123,1,0,"UPYD",0
31,"31186",302,211,209,2,2,"UPYD",1
31,"31019",1809,1295,1288,23,7,"UPYD",14
31,"31172",367,293,286,6,7,"UPYD",0
31,"31229",50,40,40,0,0,"UPYD",0
31,"31134",178,132,130,1,2,"UPYD",0
31,"31002",424,312,310,7,2,"UPYD",2
31,"31039",83,58,57,0,1,"UPYD",1
31,"31244",156,87,84,1,3,"UPYD",1
31,"31004",35,22,22,1,0,"UPYD",0
31,"31906",2553,1945,1930,21,15,"UPYD",7
31,"31064",1447,1161,1145,11,16,"UPYD",1
31,"31007",136,94,93,1,1,"UPYD",2
31,"31166",260,186,186,2,0,"UPYD",1
31,"31136",444,320,318,6,2,"UPYD",1
31,"31054",460,308,304,7,4,"UPYD",0
31,"31127",143,97,97,2,0,"UPYD",1
31,"31176",2856,2077,2040,33,37,"UPYD",5
31,"31215",4649,3412,3359,35,53,"UPYD",10
31,"31027",838,595,589,7,6,"UPYD",1
31,"31129",393,265,261,2,4,"UPYD",0
31,"31085",471,353,351,3,2,"UPYD",0
31,"31017",361,248,246,4,2,"UPYD",5
31,"31157",3546,2423,2399,32,24,"UPYD",9
31,"31119",40,22,22,0,0,"UPYD",0
31,"31194",315,218,217,2,1,"UPYD",1
31,"31246",140,108,103,2,5,"UPYD",0
31,"31237",195,156,156,1,0,"UPYD",1
31,"31097",10436,7461,7395,96,66,"UPYD",26
31,"31903",6593,4699,4660,28,39,"UPYD",17
31,"31174",110,75,73,0,2,"UPYD",0
31,"31038",1348,1017,1005,13,12,"UPYD",3
31,"31081",342,239,239,2,0,"UPYD",0
31,"31041",1583,1125,1110,14,15,"UPYD",3
31,"31208",2569,2016,1992,21,24,"UPYD",5
31,"31160",107,81,80,0,1,"UPYD",0
31,"31169",2217,1508,1489,15,19,"UPYD",1
31,"31059",191,142,141,1,1,"UPYD",0
31,"31111",96,75,75,2,0,"UPYD",0
31,"31047",261,191,187,6,4,"UPYD",0
31,"31204",37,33,33,2,0,"UPYD",0
31,"31155",253,191,189,3,2,"UPYD",1
31,"31036",921,664,657,5,7,"UPYD",3
31,"31135",102,67,62,0,5,"UPYD",3
31,"31254",1920,1473,1458,7,15,"UPYD",2
31,"31061",56,50,50,1,0,"UPYD",0
31,"31230",107,86,85,0,1,"UPYD",1
31,"31122",4719,3671,3654,42,17,"UPYD",22
31,"31073",315,214,212,3,2,"UPYD",1
31,"31170",49,39,39,1,0,"UPYD",0
31,"31199",150,101,101,3,0,"UPYD",0
31,"31193",1414,1103,1094,12,9,"UPYD",7
31,"31261",235,187,187,3,0,"UPYD",2
31,"31260",1245,859,857,15,2,"UPYD",5
31,"31210",199,146,145,2,1,"UPYD",0
31,"31071",17,17,17,0,0,"UPYD",0
31,"31093",293,210,206,2,4,"UPYD",0
31,"31029",925,662,648,6,14,"UPYD",1
31,"31009",690,508,504,5,4,"UPYD",0
31,"31014",274,197,197,4,0,"UPYD",0
31,"31074",394,301,298,5,3,"UPYD",0
31,"31065",1892,1420,1396,14,24,"UPYD",8
31,"31209",157,108,108,0,0,"UPYD",0
31,"31179",509,361,355,5,6,"UPYD",3
31,"31035",63,45,43,1,2,"UPYD",0
31,"31015",2001,1468,1449,18,19,"UPYD",8
31,"31089",242,188,185,1,3,"UPYD",14
31,"31249",1885,1350,1331,20,19,"UPYD",2
31,"31080",510,412,411,8,1,"UPYD",1
31,"31216",3882,2829,2810,31,19,"UPYD",21
31,"31034",40,29,29,1,0,"UPYD",0
31,"31258",7841,5961,5927,56,34,"UPYD",18
31,"31206",2095,1529,1513,19,16,"UPYD",7
31,"31037",86,64,64,0,0,"UPYD",1
31,"31221",1211,844,825,4,19,"UPYD",3
31,"31090",146,81,80,3,1,"UPYD",0
31,"31226",585,346,344,1,2,"UPYD",0
31,"31148",93,70,70,3,0,"UPYD",0
31,"31144",804,482,479,2,3,"UPYD",0
31,"31152",1347,999,990,16,9,"UPYD",4
31,"31003",124,95,95,2,0,"UPYD",2
31,"31094",112,82,82,1,0,"UPYD",0
31,"31154",227,127,125,3,2,"UPYD",0
31,"31107",1707,1303,1294,12,9,"UPYD",14
31,"31016",7642,5866,5822,52,44,"UPYD",20
31,"31198",36,29,29,0,0,"UPYD",0
31,"31241",134,94,89,0,5,"UPYD",0
31,"31006",1952,1423,1400,14,23,"UPYD",8
31,"31053",532,395,391,4,4,"UPYD",1
31,"31220",752,607,603,3,4,"UPYD",3
31,"31259",485,325,324,3,1,"UPYD",3
31,"31095",76,66,64,1,2,"UPYD",0
31,"31238",110,96,94,2,2,"UPYD",1
31,"31203",40,29,29,0,0,"UPYD",0
31,"31235",166,111,111,0,0,"UPYD",1
31,"31105",1535,1208,1187,18,21,"UPYD",5
31,"31132",146,115,113,1,2,"UPYD",1
31,"31084",1935,1389,1380,19,9,"UPYD",1
31,"31213",105,70,70,0,0,"UPYD",0
31,"31067",1938,1424,1415,15,9,"UPYD",5
31,"31088",5574,4194,4156,46,38,"UPYD",18
31,"31178",495,364,364,4,0,"UPYD",1
31,"31904",1559,1095,1084,8,11,"UPYD",4
31,"31223",995,752,742,6,10,"UPYD",4
31,"31180",216,173,173,5,0,"UPYD",1
31,"31069",847,643,636,4,7,"UPYD",1
31,"31225",36,29,29,0,0,"UPYD",2
31,"31079",76,53,53,0,0,"UPYD",0
31,"31177",262,171,170,3,1,"UPYD",1
31,"31137",208,93,93,3,0,"UPYD",1
31,"31032",1733,1295,1285,26,10,"UPYD",3
31,"31171",693,510,500,6,10,"UPYD",4
31,"31112",94,67,66,0,1,"UPYD",0
31,"31063",88,72,68,2,4,"UPYD",0
31,"31087",169,131,127,2,4,"UPYD",0
31,"31233",96,72,71,0,1,"UPYD",1
31,"31143",98,59,58,1,1,"UPYD",0
31,"31185",501,345,342,4,3,"UPYD",0
31,"31151",67,48,48,1,0,"UPYD",0
31,"31205",427,330,326,7,4,"UPYD",0
31,"31189",1170,739,731,10,8,"UPYD",0
31,"31168",248,192,191,0,1,"UPYD",2
31,"31224",914,668,659,6,9,"UPYD",1
31,"31263",236,142,142,2,0,"UPYD",0
31,"31264",179,117,115,5,2,"UPYD",0
31,"31253",129,112,112,0,0,"UPYD",0
31,"31091",347,217,217,0,0,"UPYD",0
31,"31175",72,50,49,0,1,"UPYD",0
31,"31161",344,273,270,4,3,"UPYD",1
31,"31195",180,129,128,0,1,"UPYD",0
31,"31222",63,41,41,5,0,"UPYD",0
31,"31219",88,63,62,0,1,"UPYD",1
31,"31106",689,565,559,1,6,"UPYD",3
31,"31125",275,194,191,2,3,"UPYD",1
31,"31217",337,233,230,1,3,"UPYD",1
31,"31190",44,36,36,1,0,"UPYD",0
31,"31024",102,52,52,0,0,"UPYD",0
31,"31045",504,397,392,9,5,"UPYD",4
31,"31145",171,133,133,0,0,"UPYD",0
31,"31212",151,118,118,7,0,"UPYD",0
31,"31120",394,264,263,5,1,"UPYD",0
31,"31251",3110,2347,2327,19,20,"UPYD",12
31,"31245",83,54,54,1,0,"UPYD",0
31,"31236",1324,943,933,12,10,"UPYD",1
31,"31114",362,272,269,6,3,"UPYD",0
31,"31033",49,29,29,1,0,"UPYD",0
31,"31201",147803,110800,110079,1040,721,"UPYD",432
31,"31256",109,70,70,0,0,"UPYD",0
31,"31164",582,464,457,3,7,"UPYD",4
31,"31005",296,205,204,0,1,"UPYD",2
31,"31113",137,86,85,1,1,"UPYD",0
31,"31043",38,30,30,0,0,"UPYD",0
31,"31115",166,108,108,2,0,"UPYD",0
31,"31077",5384,4055,3999,49,56,"UPYD",23
31,"31901",15475,11855,11771,121,84,"UPYD",53
31,"31905",2847,2108,2093,11,15,"UPYD",16
31,"31008",80,57,54,0,3,"UPYD",1
31,"31103",46,32,32,1,0,"UPYD",0
31,"31242",253,165,164,1,1,"UPYD",0
31,"31243",314,236,234,5,2,"UPYD",0
31,"31104",1876,1355,1338,10,17,"UPYD",4
31,"31030",145,107,107,3,0,"UPYD",2
31,"31192",159,132,131,0,1,"UPYD",0
31,"31162",47,29,27,0,2,"UPYD",0
31,"31247",152,112,109,0,3,"UPYD",0
31,"31117",620,390,385,1,5,"UPYD",0
31,"31072",5288,3916,3846,32,70,"UPYD",12
31,"31250",2832,1921,1899,20,22,"UPYD",4
31,"31108",1878,1487,1475,14,12,"UPYD",5
31,"31188",227,173,173,2,0,"UPYD",1
31,"31158",252,181,178,2,3,"UPYD",0
31,"31239",310,223,220,5,3,"UPYD",0
31,"31130",310,214,213,7,1,"UPYD",2
31,"31146",35,30,30,2,0,"UPYD",0
31,"31187",111,70,70,1,0,"UPYD",0
31,"31062",1088,866,853,4,13,"UPYD",1
31,"31248",295,174,168,2,6,"UPYD",2
31,"31018",409,312,311,9,1,"UPYD",4
31,"31121",64,45,45,2,0,"UPYD",2
31,"31124",210,162,162,2,0,"UPYD",0
31,"31153",2172,1463,1448,10,15,"UPYD",1
31,"31022",526,344,341,3,3,"UPYD",0
31,"31100",264,186,186,2,0,"UPYD",1
31,"31011",697,494,491,5,3,"UPYD",6
31,"31908",1008,709,704,11,5,"UPYD",1
31,"31197",70,60,59,0,1,"UPYD",0
31,"31141",109,70,66,1,4,"UPYD",0
31,"31060",13723,10036,9970,78,66,"UPYD",26
31,"31083",56,41,39,0,2,"UPYD",0
31,"31257",866,657,648,8,9,"UPYD",3
31,"31046",60,38,38,0,0,"UPYD",0
31,"31049",704,488,486,1,2,"UPYD",0
31,"31068",2893,2172,2138,27,34,"UPYD",12
31,"31140",116,82,82,2,0,"UPYD",0
31,"31183",681,581,578,10,3,"UPYD",5
31,"31181",150,116,116,0,0,"UPYD",0
31,"31131",871,664,658,13,6,"UPYD",1
31,"31167",827,624,615,13,9,"UPYD",2
31,"31150",213,154,152,1,2,"UPYD",0
31,"31207",271,194,190,0,4,"UPYD",1
31,"31232",25152,18432,18220,199,212,"UPYD",132
31,"31013",661,439,437,1,2,"UPYD",0
31,"31252",87,68,68,0,0,"UPYD",0
31,"31182",37,27,27,0,0,"UPYD",1
31,"31010",5721,3986,3946,27,40,"UPYD",7
31,"31214",93,70,69,0,1,"UPYD",0
31,"31165",2794,2057,2025,31,32,"UPYD",4
31,"31057",1812,1375,1360,17,15,"UPYD",3
31,"31118",165,122,121,2,1,"UPYD",0
31,"31163",2017,1479,1447,15,32,"UPYD",7
31,"31066",867,647,638,8,9,"UPYD",1
31,"31123",654,430,419,7,11,"UPYD",3
31,"31211",25,12,12,2,0,"UPYD",0
31,"31902",4346,3247,3228,23,19,"UPYD",16
31,"31070",2652,1907,1888,16,19,"UPYD",12
31,"31138",934,649,647,5,2,"UPYD",2
31,"31058",215,153,153,2,0,"UPYD",1
31,"31231",115,81,81,1,0,"UPYD",0
31,"31184",61,43,43,2,0,"UPYD",0
31,"31149",2338,1534,1525,16,9,"UPYD",1
31,"31012",814,579,570,4,9,"UPYD",6
31,"31042",2744,2081,2053,19,28,"UPYD",2
31,"31240",531,355,351,6,4,"UPYD",0
31,"31092",662,458,455,4,3,"UPYD",0
31,"31025",768,560,560,5,0,"UPYD",0
31,"31096",115,95,92,2,3,"UPYD",1
31,"31055",259,177,173,2,4,"UPYD",0
31,"31116",65,51,51,1,0,"UPYD",0
31,"31086",12987,10342,10270,114,72,"UPYD",47
31,"31098",1918,1489,1483,23,6,"UPYD",2
31,"31026",147,128,128,1,0,"UPYD",1
31,"31227",8226,6191,6109,53,82,"UPYD",16
31,"31099",63,52,52,1,0,"UPYD",0
31,"31262",206,180,180,2,0,"UPYD",0
31,"31109",1562,1184,1177,6,7,"UPYD",6
31,"31173",873,704,680,3,24,"UPYD",2
31,"31126",357,235,232,0,3,"UPYD",0
31,"31020",454,235,232,2,3,"UPYD",0
31,"31082",615,398,393,6,5,"UPYD",1
31,"31052",88,65,64,0,1,"UPYD",0
31,"31133",44,30,30,1,0,"UPYD",0
31,"31228",496,382,381,2,1,"UPYD",1
31,"31050",6058,3902,3850,64,52,"UPYD",4
31,"31128",370,265,265,2,0,"UPYD",1
31,"31200",764,558,546,11,12,"UPYD",3
31,"31101",1390,1031,1028,11,3,"UPYD",6
31,"31159",1134,867,864,9,3,"UPYD",3
31,"31040",194,130,128,1,2,"UPYD",0
31,"31076",2407,2005,1986,28,19,"UPYD",8
31,"31907",10677,8568,8523,97,45,"UPYD",49
31,"31255",102,75,74,2,1,"UPYD",0
31,"31051",253,176,176,2,0,"UPYD",2
31,"31001",90,74,74,5,0,"UPYD",1
31,"31265",86,61,61,0,0,"UPYD",0
3,"3001",337,289,286,3,3,"SOMVAL",1
3,"3099",42365,31612,31259,220,353,"SOMVAL",11
3,"3093",19661,15155,14988,84,167,"SOMVAL",11
3,"3009",46817,36581,36258,240,323,"SOMVAL",19
3,"3049",12082,9341,9236,69,105,"SOMVAL",11
3,"3060",108,92,90,1,2,"SOMVAL",0
3,"3104",27134,21080,20902,156,178,"SOMVAL",3
3,"3052",969,804,794,6,10,"SOMVAL",0
3,"3025",1270,1003,996,3,7,"SOMVAL",1
3,"3082",12542,8709,8597,48,112,"SOMVAL",6
3,"3902",10213,7091,6997,52,94,"SOMVAL",1
3,"3079",18235,14578,14388,114,190,"SOMVAL",11
3,"3128",4097,2972,2942,12,30,"SOMVAL",6
3,"3020",102,79,79,0,0,"SOMVAL",0
3,"3004",585,455,454,1,1,"SOMVAL",0
3,"3074",1706,1400,1382,3,18,"SOMVAL",0
3,"3058",4947,4015,3978,21,37,"SOMVAL",2
3,"3109",2850,2301,2275,11,26,"SOMVAL",2
3,"3023",1410,1221,1201,8,20,"SOMVAL",0
3,"3050",18601,13710,13610,61,100,"SOMVAL",5
3,"3026",1224,970,949,6,21,"SOMVAL",5
3,"3125",346,263,262,0,1,"SOMVAL",0
3,"3010",325,278,276,0,2,"SOMVAL",0
3,"3100",508,446,442,1,4,"SOMVAL",0
3,"3018",12212,9129,9040,64,89,"SOMVAL",8
3,"3092",6749,5398,5342,40,56,"SOMVAL",3
3,"3002",3610,2714,2682,18,32,"SOMVAL",1
3,"3127",352,279,277,1,2,"SOMVAL",0
3,"3118",2452,1732,1714,9,18,"SOMVAL",0
3,"3075",156,139,139,0,0,"SOMVAL",0
3,"3029",242,186,183,1,3,"SOMVAL",0
3,"3059",20538,15653,15522,79,131,"SOMVAL",6
3,"3067",98,82,81,1,1,"SOMVAL",0
3,"3051",350,310,305,1,5,"SOMVAL",0
3,"3024",3904,3109,3060,17,49,"SOMVAL",0
3,"3110",289,239,239,1,0,"SOMVAL",1
3,"3043",2900,2516,2483,18,33,"SOMVAL",2
3,"3088",5498,4078,4030,42,48,"SOMVAL",2
3,"3136",446,361,361,2,0,"SOMVAL",0
3,"3027",159,135,132,0,3,"SOMVAL",0
3,"3003",455,393,388,3,5,"SOMVAL",0
3,"3101",4765,3708,3659,13,49,"SOMVAL",3
3,"3084",543,478,476,4,2,"SOMVAL",0
3,"3076",8485,6251,6194,37,57,"SOMVAL",1
3,"3068",46,41,40,0,1,"SOMVAL",0
3,"3030",513,432,424,0,8,"SOMVAL",0
3,"3014",237548,173040,172027,866,1013,"SOMVAL",46
3,"3053",7196,5800,5736,37,64,"SOMVAL",4
3,"3044",4512,3639,3586,16,53,"SOMVAL",0
3,"3107",2459,1807,1791,5,16,"SOMVAL",1
3,"3036",91,80,79,2,1,"SOMVAL",0
3,"3134",148,132,132,2,0,"SOMVAL",0
3,"3071",3980,3134,3106,28,28,"SOMVAL",10
3,"3103",278,240,237,1,3,"SOMVAL",0
3,"3054",338,274,268,4,6,"SOMVAL",0
3,"3028",1006,833,823,1,10,"SOMVAL",0
3,"3102",7271,5762,5687,46,75,"SOMVAL",13
3,"3077",1374,1139,1126,11,13,"SOMVAL",0
3,"3040",257,222,222,0,0,"SOMVAL",0
3,"3007",168,142,138,0,4,"SOMVAL",0
3,"3095",4602,3628,3605,27,23,"SOMVAL",6
3,"3086",153,134,134,1,0,"SOMVAL",0
3,"3089",9599,7100,6980,39,120,"SOMVAL",1
3,"3080",1299,1065,1036,3,29,"SOMVAL",0
3,"3034",1367,1095,1079,4,16,"SOMVAL",0
3,"3045",216,182,179,1,3,"SOMVAL",0
3,"3070",2038,1526,1499,5,27,"SOMVAL",1
3,"3130",47,30,30,0,0,"SOMVAL",0
3,"3021",5627,4691,4613,23,78,"SOMVAL",3
3,"3005",7753,6158,6118,38,40,"SOMVAL",0
3,"3056",8737,6809,6731,33,78,"SOMVAL",5
3,"3038",358,292,285,2,7,"SOMVAL",0
3,"3078",486,398,397,3,1,"SOMVAL",0
3,"3032",106,90,89,1,1,"SOMVAL",1
3,"3105",5387,4089,4017,21,72,"SOMVAL",3
3,"3123",7472,5748,5680,38,68,"SOMVAL",0
3,"3096",5811,4539,4492,19,47,"SOMVAL",3
3,"3055",5168,3949,3899,13,50,"SOMVAL",3
3,"3046",1594,1185,1178,9,7,"SOMVAL",0
3,"3097",990,817,811,8,6,"SOMVAL",2
3,"3016",94,79,79,0,0,"SOMVAL",0
3,"3113",4254,3159,3120,17,39,"SOMVAL",0
3,"3133",41763,26236,26039,134,197,"SOMVAL",3
3,"3022",142,120,120,2,0,"SOMVAL",0
3,"3111",5411,4044,3967,14,77,"SOMVAL",3
3,"3065",166944,126831,126024,773,807,"SOMVAL",37
3,"3135",214,176,174,0,2,"SOMVAL",0
3,"3112",653,522,517,2,5,"SOMVAL",0
3,"3006",497,401,393,4,8,"SOMVAL",0
3,"3069",3060,2187,2168,9,19,"SOMVAL",2
3,"3061",1057,828,816,2,12,"SOMVAL",0
3,"3119",16534,12466,12363,69,103,"SOMVAL",3
3,"3098",507,403,394,3,9,"SOMVAL",0
3,"3081",1433,1130,1118,5,12,"SOMVAL",1
3,"3008",167,132,131,0,1,"SOMVAL",0
3,"3031",41486,28059,27851,152,208,"SOMVAL",6
3,"3131",175,159,153,0,6,"SOMVAL",0
3,"3037",352,296,293,3,3,"SOMVAL",0
3,"3120",2416,1814,1783,13,31,"SOMVAL",0
3,"3039",85,61,59,0,2,"SOMVAL",0
3,"3072",351,288,287,2,1,"SOMVAL",1
3,"3114",1568,1216,1203,8,13,"SOMVAL",0
3,"3904",1393,1065,1057,8,8,"SOMVAL",0
3,"3015",12544,9478,9388,58,90,"SOMVAL",3
3,"3091",247,217,215,1,2,"SOMVAL",0
3,"3124",469,400,394,5,6,"SOMVAL",2
3,"3042",1367,1045,1033,5,12,"SOMVAL",1
3,"3033",113,97,97,2,0,"SOMVAL",0
3,"3132",536,426,423,0,3,"SOMVAL",0
3,"3062",213,176,175,0,1,"SOMVAL",0
3,"3901",1129,855,853,5,2,"SOMVAL",1
3,"3017",376,317,312,3,5,"SOMVAL",0
3,"3129",1187,991,984,8,7,"SOMVAL",0
3,"3047",9161,6622,6534,35,88,"SOMVAL",8
3,"3122",42227,31379,31186,160,193,"SOMVAL",13
3,"3085",270,226,225,1,1,"SOMVAL",0
3,"3117",370,325,322,0,3,"SOMVAL",1
3,"3073",236,202,202,1,0,"SOMVAL",0
3,"3063",26383,19376,19255,105,121,"SOMVAL",27
3,"3066",42291,31010,30781,190,229,"SOMVAL",8
3,"3139",22357,15787,15624,101,163,"SOMVAL",10
3,"3106",596,503,501,1,2,"SOMVAL",0
3,"3019",15261,11921,11804,98,117,"SOMVAL",3
3,"3115",248,219,219,2,0,"SOMVAL",2
3,"3064",5040,3887,3834,16,53,"SOMVAL",0
3,"3121",21269,14932,14795,78,137,"SOMVAL",8
3,"3035",663,543,538,1,5,"SOMVAL",0
3,"3116",1159,892,886,2,6,"SOMVAL",1
3,"3083",5607,4160,4106,36,54,"SOMVAL",3
3,"3011",7729,5651,5595,29,56,"SOMVAL",1
3,"3012",1072,862,849,3,13,"SOMVAL",0
3,"3094",9033,6702,6657,32,45,"SOMVAL",1
3,"3057",191,148,148,2,0,"SOMVAL",0
3,"3140",26176,19795,19509,155,286,"SOMVAL",5
3,"3137",653,516,515,5,1,"SOMVAL",1
3,"3090",17087,12723,12602,69,121,"SOMVAL",9
3,"3048",4858,3785,3735,25,50,"SOMVAL",2
3,"3013",1114,914,906,5,8,"SOMVAL",1
3,"3903",2482,1945,1926,16,19,"SOMVAL",1
3,"3041",5945,4393,4344,28,49,"SOMVAL",5
3,"3138",3154,2406,2378,10,28,"SOMVAL",0
43,"43064",2017,1384,1367,16,17,"PCPC",0
43,"43047",4128,2688,2652,19,36,"PCPC",9
43,"43178",1335,939,933,9,6,"PCPC",1
43,"43108",1775,1238,1229,8,9,"PCPC",2
43,"43125",942,692,685,4,7,"PCPC",1
43,"43905",14371,9191,9136,41,55,"PCPC",18
43,"43042",2148,1585,1573,7,12,"PCPC",0
43,"43070",236,194,193,0,1,"PCPC",0
43,"43143",56,47,47,1,0,"PCPC",0
43,"43901",8765,5306,5212,81,94,"PCPC",5
43,"43098",343,249,249,4,0,"PCPC",1
43,"43123",70276,47897,47547,302,350,"PCPC",113
43,"43052",954,662,653,9,9,"PCPC",3
43,"43117",144,110,109,1,1,"PCPC",0
43,"43088",1966,1382,1372,6,10,"PCPC",2
43,"43904",2908,1799,1760,38,39,"PCPC",3
43,"43130",196,128,127,2,1,"PCPC",1
43,"43027",165,133,133,2,0,"PCPC",0
43,"43095",2493,1723,1703,13,20,"PCPC",5
43,"43107",377,265,260,4,5,"PCPC",0
43,"43128",908,623,616,4,7,"PCPC",3
43,"43023",231,173,171,3,2,"PCPC",1
43,"43150",1300,940,913,5,27,"PCPC",1
43,"43074",1749,1284,1275,7,9,"PCPC",5
43,"43159",80,57,57,0,0,"PCPC",0
43,"43105",162,115,115,3,0,"PCPC",0
43,"43011",1083,824,819,5,5,"PCPC",0
43,"43133",5697,3726,3685,26,41,"PCPC",4
43,"43177",298,236,232,5,4,"PCPC",1
43,"43158",89,55,53,3,2,"PCPC",0
43,"43044",3975,2793,2758,34,35,"PCPC",6
43,"43033",778,576,569,5,7,"PCPC",0
43,"43175",566,390,387,3,3,"PCPC",1
43,"43115",155,116,116,2,0,"PCPC",0
43,"43100",3268,2360,2352,16,8,"PCPC",3
43,"43091",136,94,94,2,0,"PCPC",0
43,"43162",4313,3132,3101,26,31,"PCPC",3
43,"43116",455,326,321,1,5,"PCPC",2
43,"43138",2677,1821,1786,22,35,"PCPC",1
43,"43012",3580,2669,2658,22,11,"PCPC",4
43,"43055",1975,1471,1459,16,12,"PCPC",0
43,"43039",102,73,73,0,0,"PCPC",0
43,"43066",155,109,107,1,2,"PCPC",0
43,"43176",799,565,562,5,3,"PCPC",0
43,"43024",1522,1044,1034,3,10,"PCPC",2
43,"43137",1881,1344,1332,9,12,"PCPC",1
43,"43149",699,483,472,7,11,"PCPC",0
43,"43112",284,178,178,0,0,"PCPC",0
43,"43148",90177,64180,63784,349,396,"PCPC",142
43,"43051",8545,5813,5735,26,78,"PCPC",13
43,"43907",4382,3174,3147,14,27,"PCPC",8
43,"43163",25252,17001,16847,74,154,"PCPC",32
43,"43019",1371,904,886,4,18,"PCPC",1
43,"43029",323,237,237,4,0,"PCPC",1
43,"43034",480,366,358,4,8,"PCPC",1
43,"43118",413,313,308,1,5,"PCPC",1
43,"43111",2049,1383,1366,9,17,"PCPC",0
43,"43169",457,364,356,3,8,"PCPC",0
43,"43119",793,559,556,7,3,"PCPC",4
43,"43121",604,393,387,4,6,"PCPC",0
43,"43147",521,379,377,1,2,"PCPC",1
43,"43022",1508,1028,1015,20,13,"PCPC",0
43,"43013",4425,2975,2938,21,37,"PCPC",5
43,"43172",351,243,242,8,1,"PCPC",1
43,"43127",765,554,548,2,6,"PCPC",0
43,"43173",101,63,60,0,3,"PCPC",0
43,"43902",2760,1775,1739,22,36,"PCPC",5
43,"43072",105,77,77,1,0,"PCPC",0
43,"43089",281,211,211,1,0,"PCPC",1
43,"43077",463,307,305,7,2,"PCPC",0
43,"43038",21385,14375,14276,117,99,"PCPC",24
43,"43018",410,320,316,1,4,"PCPC",0
43,"43080",244,184,184,2,0,"PCPC",1
43,"43145",4084,2991,2954,36,37,"PCPC",3
43,"43008",309,185,181,5,4,"PCPC",0
43,"43142",1114,781,771,4,10,"PCPC",4
43,"43165",578,431,428,2,3,"PCPC",0
43,"43067",555,434,430,1,4,"PCPC",2
43,"43154",132,101,100,1,1,"PCPC",1
43,"43141",111,71,68,0,3,"PCPC",0
43,"43026",797,579,574,2,5,"PCPC",0
43,"43903",2383,1420,1407,20,13,"PCPC",3
43,"43076",447,318,317,0,1,"PCPC",1
43,"43053",191,149,147,1,2,"PCPC",0
43,"43104",1798,1285,1268,14,17,"PCPC",2
43,"43007",637,481,479,3,2,"PCPC",2
43,"43058",93,68,67,1,1,"PCPC",0
43,"43059",253,195,195,2,0,"PCPC",0
43,"43025",604,431,428,5,3,"PCPC",1
43,"43161",17217,11541,11478,67,63,"PCPC",17
43,"43167",383,287,286,2,1,"PCPC",0
43,"43063",560,363,360,8,3,"PCPC",0
43,"43046",100,77,72,2,5,"PCPC",0
43,"43010",316,253,251,2,2,"PCPC",1
43,"43050",2521,1654,1640,11,14,"PCPC",1
43,"43073",85,60,59,0,1,"PCPC",0
43,"43156",3982,2748,2704,26,44,"PCPC",0
43,"43030",430,311,308,1,3,"PCPC",1
43,"43152",450,338,330,2,8,"PCPC",1
43,"43043",3128,2201,2186,11,15,"PCPC",1
43,"43099",305,234,233,1,1,"PCPC",0
43,"43083",140,95,94,0,1,"PCPC",0
43,"43164",300,218,217,0,1,"PCPC",2
43,"43001",695,474,472,4,2,"PCPC",2
43,"43140",2366,1731,1717,7,14,"PCPC",2
43,"43160",1273,888,879,7,9,"PCPC",0
43,"43144",1258,914,911,3,3,"PCPC",3
43,"43151",109,82,82,1,0,"PCPC",0
43,"43021",360,248,247,6,1,"PCPC",1
43,"43081",597,425,418,4,7,"PCPC",1
43,"43014",14293,9441,9319,118,122,"PCPC",23
43,"43075",89,62,62,1,0,"PCPC",0
43,"43135",342,252,251,3,1,"PCPC",0
43,"43085",226,178,178,2,0,"PCPC",0
43,"43045",152,121,121,0,0,"PCPC",0
43,"43106",810,544,532,7,12,"PCPC",2
43,"43102",485,337,332,2,5,"PCPC",0
43,"43103",892,644,640,6,4,"PCPC",0
43,"43035",262,167,164,0,3,"PCPC",0
43,"43002",1821,1294,1266,12,28,"PCPC",4
43,"43109",2560,1717,1700,13,17,"PCPC",3
43,"43020",2202,1631,1614,13,17,"PCPC",3
43,"43906",2117,1454,1441,3,13,"PCPC",1
43,"43036",843,545,542,0,3,"PCPC",2
43,"43056",871,532,521,6,11,"PCPC",0
43,"43120",444,293,288,0,5,"PCPC",0
43,"43134",283,226,224,2,2,"PCPC",0
43,"43006",683,463,458,10,5,"PCPC",1
43,"43101",148,107,107,4,0,"PCPC",0
43,"43005",3615,2376,2354,17,22,"PCPC",7
43,"43132",365,269,264,1,5,"PCPC",0
43,"43060",2887,2019,1990,16,29,"PCPC",5
43,"43092",7059,4603,4563,21,40,"PCPC",16
43,"43057",40,25,25,1,0,"PCPC",0
43,"43069",184,144,143,1,1,"PCPC",0
43,"43032",523,371,365,7,6,"PCPC",0
43,"43122",106,84,84,0,0,"PCPC",0
43,"43084",526,404,399,5,5,"PCPC",0
43,"43003",322,234,233,3,1,"PCPC",0
43,"43126",1177,848,844,8,4,"PCPC",1
43,"43040",338,255,247,2,8,"PCPC",0
43,"43017",126,100,97,1,3,"PCPC",0
43,"43168",93,64,64,2,0,"PCPC",0
43,"43071",924,650,639,5,11,"PCPC",0
43,"43155",22874,15046,14893,137,153,"PCPC",18
43,"43110",272,169,167,1,2,"PCPC",0
43,"43062",274,223,219,7,4,"PCPC",0
43,"43078",856,640,632,11,8,"PCPC",0
43,"43114",388,264,262,1,2,"PCPC",2
43,"43048",807,569,564,8,5,"PCPC",1
43,"43028",2717,1727,1715,7,12,"PCPC",6
43,"43090",1070,625,620,4,5,"PCPC",3
43,"43174",138,99,99,1,0,"PCPC",1
43,"43113",408,306,305,2,1,"PCPC",0
43,"43153",10676,7241,7190,29,51,"PCPC",14
43,"43146",38,30,30,1,0,"PCPC",0
43,"43016",3418,2534,2512,15,22,"PCPC",6
43,"43124",484,347,343,6,4,"PCPC",1
43,"43009",1431,968,958,5,10,"PCPC",4
43,"43131",4623,3059,3031,16,28,"PCPC",2
43,"43079",364,258,257,1,1,"PCPC",2
43,"43139",2053,1332,1321,16,11,"PCPC",0
43,"43015",112,91,91,1,0,"PCPC",0
43,"43170",857,603,599,8,4,"PCPC",1
43,"43129",4618,3148,3107,24,41,"PCPC",1
43,"43037",16725,10917,10822,61,95,"PCPC",16
43,"43086",5237,3507,3476,27,31,"PCPC",10
43,"43097",390,301,300,0,1,"PCPC",1
43,"43093",3909,2625,2597,44,28,"PCPC",4
43,"43096",101,81,81,0,0,"PCPC",0
43,"43136",10353,6670,6622,50,48,"PCPC",12
43,"43041",226,160,156,0,4,"PCPC",0
43,"43004",6326,4274,4227,38,47,"PCPC",5
43,"43094",2175,1506,1480,11,26,"PCPC",2
43,"43054",2836,1873,1852,21,21,"PCPC",2
43,"43157",352,273,271,3,2,"PCPC",0
43,"43065",395,266,265,4,1,"PCPC",1
43,"43166",1568,1117,1111,4,6,"PCPC",0
43,"43031",1466,1062,1056,8,6,"PCPC",1
43,"43171",14593,10107,10049,46,58,"PCPC",18
43,"43049",746,546,543,1,3,"PCPC",0
43,"43061",48,31,29,0,2,"PCPC",0
43,"43068",528,346,338,2,8,"PCPC",1
43,"43082",372,291,285,0,6,"PCPC",0
47,"47097",331,268,263,1,5,"DN",0
47,"47006",190,145,144,1,1,"DN",0
47,"47126",49,36,36,0,0,"DN",0
47,"47135",84,76,76,2,0,"DN",0
47,"47106",50,41,41,0,0,"DN",0
47,"47041",149,124,123,2,1,"DN",0
47,"47058",206,149,149,2,0,"DN",0
47,"47138",237,180,176,1,4,"DN",0
47,"47086",3926,3065,3028,27,37,"DN",1
47,"47122",2034,1666,1635,21,31,"DN",0
47,"47077",247,190,189,2,1,"DN",0
47,"47062",163,131,131,0,0,"DN",0
47,"47183",130,105,105,0,0,"DN",0
47,"47031",186,145,144,1,1,"DN",0
47,"47172",148,120,120,1,0,"DN",0
47,"47035",930,745,739,10,6,"DN",4
47,"47115",287,238,237,4,1,"DN",0
47,"47044",330,291,287,0,4,"DN",0
47,"47224",91,74,74,1,0,"DN",0
47,"47173",883,686,675,4,11,"DN",1
47,"47123",469,395,386,4,9,"DN",0
47,"47060",262,218,214,0,4,"DN",1
47,"47156",169,137,135,1,2,"DN",0
47,"47194",301,242,239,1,3,"DN",0
47,"47158",906,686,668,3,18,"DN",1
47,"47009",106,80,80,1,0,"DN",0
47,"47061",258,216,214,2,2,"DN",1
47,"47210",372,289,286,1,3,"DN",0
47,"47174",275,222,218,2,4,"DN",1
47,"47129",879,700,688,6,12,"DN",4
47,"47186",246602,193774,192412,1384,1362,"DN",169
47,"47175",6575,4991,4937,51,54,"DN",3
47,"47057",248,194,194,2,0,"DN",1
47,"47220",166,124,124,1,0,"DN",0
47,"47160",430,334,329,5,5,"DN",0
47,"47208",59,38,37,3,1,"DN",0
47,"47152",86,64,64,1,0,"DN",1
47,"47133",2665,2140,2118,25,22,"DN",1
47,"47178",175,146,146,1,0,"DN",0
47,"47181",168,135,134,0,1,"DN",0
47,"47225",81,61,60,2,1,"DN",0
47,"47229",215,151,150,1,1,"DN",0
47,"47128",60,51,49,1,2,"DN",0
47,"47023",2999,2457,2445,20,12,"DN",0
47,"47098",583,488,487,6,1,"DN",0
47,"47127",135,98,96,1,2,"DN",0
47,"47189",152,128,128,0,0,"DN",0
47,"47207",277,216,212,3,4,"DN",0
47,"47005",548,426,421,4,5,"DN",0
47,"47196",35,26,26,1,0,"DN",0
47,"47029",57,48,47,1,1,"DN",0
47,"47085",16668,12248,12132,133,116,"DN",6
47,"47176",224,139,135,5,4,"DN",0
47,"47150",278,217,214,2,3,"DN",0
47,"47171",418,333,332,9,1,"DN",0
47,"47038",108,82,82,0,0,"DN",0
47,"47222",80,68,68,3,0,"DN",0
47,"47118",161,119,118,0,1,"DN",0
47,"47022",57,50,46,0,4,"DN",0
47,"47101",1720,1404,1388,10,16,"DN",1
47,"47139",1047,790,785,7,5,"DN",0
47,"47070",41,32,32,1,0,"DN",0
47,"47078",164,129,124,1,5,"DN",0
47,"47016",71,58,57,0,1,"DN",0
47,"47214",1420,1111,1093,9,18,"DN",0
47,"47039",188,149,148,1,1,"DN",0
47,"47065",863,681,671,4,10,"DN",0
47,"47182",1342,1037,1023,16,14,"DN",1
47,"47119",90,75,75,1,0,"DN",0
47,"47109",171,131,130,1,1,"DN",0
47,"47132",45,37,35,0,2,"DN",0
47,"47110",455,363,357,3,6,"DN",1
47,"47164",377,309,307,2,2,"DN",1
47,"47096",135,108,107,2,1,"DN",0
47,"47130",99,78,78,1,0,"DN",0
47,"47195",461,348,348,3,0,"DN",0
47,"47217",1896,1436,1420,20,16,"DN",0
47,"47099",152,128,127,1,1,"DN",0
47,"47028",33,20,20,0,0,"DN",0
47,"47020",278,230,227,1,3,"DN",0
47,"47205",385,281,274,7,7,"DN",0
47,"47179",398,299,295,3,4,"DN",0
47,"47204",260,199,193,2,6,"DN",0
47,"47079",62,51,51,0,0,"DN",0
47,"47184",576,463,462,2,1,"DN",0
47,"47087",379,318,314,4,4,"DN",0
47,"47076",17375,13778,13684,111,94,"DN",6
47,"47088",110,87,87,0,0,"DN",0
47,"47018",35,31,28,0,3,"DN",0
47,"47227",64,52,52,0,0,"DN",0
47,"47113",156,121,121,0,0,"DN",0
47,"47055",202,170,168,1,2,"DN",1
47,"47067",178,126,126,3,0,"DN",0
47,"47089",153,122,120,2,2,"DN",0
47,"47053",116,96,96,1,0,"DN",0
47,"47219",42,36,34,2,2,"DN",0
47,"47165",6987,5301,5115,63,186,"DN",5
47,"47014",50,45,45,0,0,"DN",0
47,"47082",803,641,633,5,8,"DN",0
47,"47056",82,58,57,0,1,"DN",0
47,"47050",3757,2829,2812,29,17,"DN",2
47,"47027",2746,2120,2095,8,25,"DN",0
47,"47001",55,51,50,2,1,"DN",0
47,"47080",30,22,22,0,0,"DN",0
47,"47216",115,101,99,2,2,"DN",0
47,"47231",4384,3457,3432,33,25,"DN",3
47,"47071",417,348,344,2,4,"DN",0
47,"47019",86,67,65,1,2,"DN",0
47,"47054",638,501,496,6,5,"DN",0
47,"47104",2857,2313,2253,19,60,"DN",1
47,"47153",108,74,73,1,1,"DN",0
47,"47064",31,29,28,2,1,"DN",0
47,"47157",515,442,441,3,1,"DN",2
47,"47011",568,469,464,1,5,"DN",0
47,"47081",47,40,40,0,0,"DN",0
47,"47002",25,23,23,0,0,"DN",0
47,"47069",127,113,111,0,2,"DN",0
47,"47198",66,47,47,0,0,"DN",0
47,"47040",63,52,51,1,1,"DN",0
47,"47209",42,30,30,1,0,"DN",0
47,"47090",2418,1805,1776,17,29,"DN",0
47,"47046",121,93,93,0,0,"DN",0
47,"47052",6584,5222,5163,41,59,"DN",5
47,"47155",3239,2400,2374,27,26,"DN",6
47,"47137",29,28,28,1,0,"DN",0
47,"47199",80,59,59,2,0,"DN",0
47,"47144",78,66,65,2,1,"DN",1
47,"47131",178,132,131,3,1,"DN",0
47,"47073",120,98,97,1,1,"DN",0
47,"47091",89,67,66,0,1,"DN",0
47,"47100",140,119,117,2,2,"DN",0
47,"47094",132,103,101,1,2,"DN",0
47,"47048",190,140,138,0,2,"DN",0
47,"47213",115,83,83,0,0,"DN",0
47,"47033",199,154,153,3,1,"DN",0
47,"47047",202,157,157,3,0,"DN",1
47,"47083",80,62,61,2,1,"DN",0
47,"47026",49,40,40,0,0,"DN",0
47,"47159",828,654,646,0,8,"DN",1
47,"47010",13613,10963,10895,108,68,"DN",9
47,"47074",150,125,125,1,0,"DN",0
47,"47004",1199,946,938,11,8,"DN",0
47,"47188",112,85,85,0,0,"DN",0
47,"47180",83,64,64,1,0,"DN",0
47,"47024",262,206,205,2,1,"DN",0
47,"47167",242,201,197,3,4,"DN",0
47,"47211",49,39,37,1,2,"DN",0
47,"47190",93,80,78,4,2,"DN",0
47,"47121",553,436,428,5,8,"DN",0
47,"47166",265,203,199,3,4,"DN",0
47,"47021",76,65,65,1,0,"DN",0
47,"47008",24,18,18,0,0,"DN",0
47,"47042",54,41,41,3,0,"DN",0
47,"47075",4871,3802,3763,30,39,"DN",1
47,"47140",119,101,100,1,1,"DN",0
47,"47066",1255,1005,996,7,9,"DN",0
47,"47143",127,99,99,0,0,"DN",0
47,"47206",95,81,81,0,0,"DN",0
47,"47170",36,30,29,2,1,"DN",0
47,"47218",995,760,754,6,6,"DN",1
47,"47015",199,151,151,0,0,"DN",0
47,"47221",109,91,91,0,0,"DN",0
47,"47063",101,82,81,2,1,"DN",0
47,"47203",67,54,54,0,0,"DN",0
47,"47149",43,33,32,1,1,"DN",0
47,"47032",153,120,118,0,2,"DN",0
47,"47003",228,180,179,3,1,"DN",0
47,"47116",413,330,324,1,6,"DN",0
47,"47102",286,229,224,1,5,"DN",1
47,"47215",54,47,46,1,1,"DN",0
47,"47049",100,78,78,1,0,"DN",0
47,"47185",98,79,79,0,0,"DN",0
47,"47145",611,451,449,4,2,"DN",0
47,"47030",1006,785,770,10,15,"DN",0
47,"47200",82,64,64,1,0,"DN",1
47,"47059",97,71,71,0,0,"DN",0
47,"47151",27,22,21,0,1,"DN",0
47,"47230",302,243,241,0,2,"DN",0
47,"47162",73,61,61,0,0,"DN",0
47,"47111",1009,794,789,4,5,"DN",1
47,"47168",31,28,27,0,1,"DN",0
47,"47103",259,211,211,4,0,"DN",1
47,"47013",99,74,73,0,1,"DN",0
47,"47114",4074,2868,2826,20,42,"DN",21
47,"47124",399,329,328,4,1,"DN",2
47,"47134",164,126,119,4,7,"DN",0
47,"47045",768,586,580,0,6,"DN",0
47,"47161",3903,3200,3183,25,17,"DN",2
47,"47226",161,128,127,1,1,"DN",0
47,"47095",39,36,35,0,1,"DN",0
47,"47025",120,97,97,2,0,"DN",0
47,"47112",2592,2063,2043,20,20,"DN",0
47,"47148",439,336,335,2,1,"DN",0
47,"47146",260,205,204,1,1,"DN",0
47,"47163",299,236,235,6,1,"DN",0
47,"47051",338,274,272,0,2,"DN",0
47,"47193",1583,1313,1294,12,19,"DN",0
47,"47187",89,57,56,2,1,"DN",0
47,"47125",59,43,43,1,0,"DN",0
47,"47141",134,102,101,1,1,"DN",0
47,"47017",201,161,158,3,3,"DN",0
47,"47142",148,114,113,0,1,"DN",0
47,"47154",155,128,127,0,1,"DN",0
47,"47147",119,91,91,0,0,"DN",0
47,"47191",110,74,74,0,0,"DN",1
47,"47012",118,95,95,0,0,"DN",0
47,"47037",174,146,141,2,5,"DN",2
47,"47223",158,129,125,3,4,"DN",0
47,"47192",105,80,79,1,1,"DN",0
47,"47034",76,59,58,1,1,"DN",0
47,"47068",36,27,27,0,0,"DN",0
47,"47117",297,219,216,4,3,"DN",0
47,"47084",1171,911,898,15,13,"DN",1
47,"47093",817,654,642,9,12,"DN",0
47,"47212",388,322,322,3,0,"DN",3
47,"47177",107,78,76,0,2,"DN",1
47,"47036",229,184,179,2,5,"DN",0
47,"47043",302,239,239,3,0,"DN",0
47,"47007",3748,2869,2835,24,34,"DN",5
47,"47169",68,57,57,0,0,"DN",0
47,"47197",888,693,687,10,6,"DN",0
47,"47105",192,164,163,0,1,"DN",0
47,"47228",445,359,357,4,2,"DN",0
47,"47232",99,75,74,0,1,"DN",0
47,"47092",110,93,92,0,1,"DN",0
15,"15031",23321,17319,17152,218,167,"UPYD",103
15,"15074",4061,2983,2947,24,36,"UPYD",5
15,"15022",5817,4026,3981,29,45,"UPYD",12
15,"15012",3666,2787,2721,40,66,"UPYD",15
15,"15052",4351,3122,3063,26,59,"UPYD",7
15,"15050",1843,1089,1070,19,19,"UPYD",3
15,"15086",2918,2109,2077,19,32,"UPYD",5
15,"15060",5780,4245,4167,48,78,"UPYD",28
15,"15007",3352,2469,2453,24,16,"UPYD",9
15,"15037",4087,2775,2733,18,42,"UPYD",7
15,"15058",27623,21002,20788,257,214,"UPYD",153
15,"15020",3844,2651,2629,17,22,"UPYD",6
15,"15064",2207,1680,1650,22,30,"UPYD",3
15,"15051",4651,3343,3297,38,46,"UPYD",8
15,"15082",15162,11273,11134,135,139,"UPYD",71
15,"15017",19380,14272,14098,156,174,"UPYD",97
15,"15071",7965,5559,5483,37,76,"UPYD",23
15,"15003",1818,1326,1302,18,24,"UPYD",0
15,"15065",7345,5517,5412,46,105,"UPYD",26
15,"15054",32177,22065,21778,349,287,"UPYD",141
15,"15089",4317,3238,3188,24,50,"UPYD",9
15,"15006",5353,3534,3469,49,65,"UPYD",10
15,"15087",5804,3942,3901,49,41,"UPYD",15
15,"15014",4034,2809,2757,34,52,"UPYD",11
15,"15091",1119,807,784,12,23,"UPYD",7
15,"15068",5096,3518,3476,39,42,"UPYD",13
15,"15013",6126,4315,4257,43,58,"UPYD",20
15,"15018",1156,817,806,7,11,"UPYD",5
15,"15066",4039,2950,2894,34,56,"UPYD",9
15,"15046",6345,4625,4532,53,93,"UPYD",18
15,"15043",5147,3834,3764,36,70,"UPYD",12
15,"15081",1042,819,814,12,5,"UPYD",5
15,"15010",1913,1355,1338,21,17,"UPYD",2
15,"15023",6481,4658,4595,44,63,"UPYD",18
15,"15072",9626,7024,6920,52,104,"UPYD",19
15,"15077",8303,5648,5544,57,104,"UPYD",20
15,"15069",6785,5107,5032,54,75,"UPYD",19
15,"15067",8073,6067,6000,45,67,"UPYD",15
15,"15016",4806,3291,3222,21,69,"UPYD",7
15,"15048",4855,3582,3534,41,48,"UPYD",11
15,"15093",4265,2856,2814,35,42,"UPYD",10
15,"15073",21884,14792,14587,149,205,"UPYD",68
15,"15029",5761,3994,3928,47,66,"UPYD",8
15,"15061",5646,3945,3894,35,51,"UPYD",8
15,"15001",4805,3466,3419,45,47,"UPYD",14
15,"15079",1562,1092,1075,16,17,"UPYD",2
15,"15009",10780,8075,7957,70,118,"UPYD",36
15,"15005",24459,16742,16482,215,260,"UPYD",95
15,"15041",9627,7409,7291,79,118,"UPYD",30
15,"15088",3550,2398,2372,18,26,"UPYD",7
15,"15032",3455,2438,2391,26,47,"UPYD",12
15,"15011",15463,11105,10890,92,215,"UPYD",58
15,"15027",1540,1224,1203,6,21,"UPYD",8
15,"15084",3312,2361,2326,28,35,"UPYD",8
15,"15021",5099,3673,3611,43,62,"UPYD",20
15,"15040",2763,2050,2017,10,33,"UPYD",0
15,"15025",1069,662,654,5,8,"UPYD",2
15,"15057",12169,8853,8729,88,124,"UPYD",28
15,"15053",7783,5386,5314,47,72,"UPYD",20
15,"15008",5650,4239,4175,42,64,"UPYD",20
15,"15092",6523,4518,4449,54,69,"UPYD",9
15,"15038",2236,1556,1530,18,26,"UPYD",4
15,"15070",9117,6514,6390,98,124,"UPYD",37
15,"15055",4618,3208,3159,49,49,"UPYD",9
15,"15028",1415,1085,1070,10,15,"UPYD",4
15,"15056",5757,4167,4108,43,59,"UPYD",6
15,"15078",78093,58164,57487,673,677,"UPYD",319
15,"15015",2840,2126,2100,21,26,"UPYD",4
15,"15002",22929,16941,16742,205,199,"UPYD",130
15,"15047",2463,1669,1633,21,36,"UPYD",8
15,"15042",3060,2170,2127,21,43,"UPYD",6
15,"15004",4855,3594,3535,28,59,"UPYD",7
15,"15090",1182,868,861,13,7,"UPYD",0
15,"15083",1100,809,795,5,14,"UPYD",5
15,"15034",2897,1931,1909,14,22,"UPYD",3
15,"15080",1760,1215,1197,11,18,"UPYD",1
15,"15076",2649,1827,1802,24,25,"UPYD",5
15,"15035",11517,8305,8192,144,113,"UPYD",28
15,"15901",3595,2401,2374,30,27,"UPYD",6
15,"15036",58409,40932,40506,484,426,"UPYD",298
15,"15039",1271,935,917,8,18,"UPYD",3
15,"15024",4412,3325,3278,35,47,"UPYD",11
15,"15075",12279,9076,8952,117,124,"UPYD",42
15,"15030",200245,148692,147426,1699,1266,"UPYD",978
15,"15045",3803,2382,2354,15,28,"UPYD",2
15,"15033",2489,1953,1931,13,22,"UPYD",9
15,"15044",1309,955,941,5,14,"UPYD",3
15,"15062",5936,4047,3993,31,54,"UPYD",12
15,"15019",25902,18111,17866,232,245,"UPYD",69
15,"15085",3346,2365,2311,26,54,"UPYD",6
15,"15902",4660,3352,3296,30,56,"UPYD",17
15,"15049",1099,765,755,12,10,"UPYD",3
15,"15059",10406,7710,7553,91,157,"UPYD",28
35,"35007",515,332,330,2,2,"PH",0
35,"35003",5125,2989,2929,21,60,"PH",5
35,"35026",80806,53749,52665,450,1084,"PH",47
35,"35004",38814,20869,20641,192,228,"PH",18
35,"35019",32253,19902,19621,126,281,"PH",13
35,"35009",19832,14305,14036,97,269,"PH",5
35,"35034",7707,3921,3872,30,49,"PH",4
35,"35028",9705,5552,5478,64,74,"PH",3
35,"35010",3548,2371,2336,20,35,"PH",0
35,"35008",6109,4631,4542,37,89,"PH",5
35,"35030",9205,5602,5501,58,101,"PH",3
35,"35027",10311,7497,7364,58,133,"PH",9
35,"35012",10331,5684,5610,32,74,"PH",3
35,"35017",25447,15415,15079,127,336,"PH",11
35,"35023",11680,8467,8295,75,172,"PH",7
35,"35006",30302,21967,21625,243,342,"PH",25
35,"35033",6378,4412,4354,24,58,"PH",5
35,"35018",12463,7628,7546,56,82,"PH",8
35,"35020",6054,4073,4018,26,55,"PH",2
35,"35032",3432,2541,2498,19,43,"PH",3
35,"35031",7270,5184,5000,36,184,"PH",8
35,"35001",4599,3455,3396,27,59,"PH",1
35,"35013",6609,4997,4881,51,116,"PH",1
35,"35002",23129,15904,15675,74,229,"PH",9
35,"35005",1071,718,711,6,7,"PH",0
35,"35022",48059,30474,30134,219,340,"PH",16
35,"35015",9870,5451,5368,29,83,"PH",5
35,"35029",4125,2545,2514,34,31,"PH",1
35,"35016",297974,198159,195935,1546,2224,"PH",192
35,"35025",1801,1239,1216,9,23,"PH",1
35,"35021",14942,10691,10537,80,154,"PH",10
35,"35024",13621,8665,8555,76,110,"PH",5
35,"35011",23882,16369,16095,107,274,"PH",9
35,"35014",11169,6234,6107,59,127,"PH",4
25,"25031",52,31,31,0,0,"EN COMÚ",2
25,"25038",1564,1075,1062,11,13,"EN COMÚ",81
25,"25155",667,463,459,5,4,"EN COMÚ",45
25,"25053",1059,762,759,10,3,"EN COMÚ",110
25,"25113",1163,854,845,12,9,"EN COMÚ",77
25,"25243",3612,2449,2423,30,26,"EN COMÚ",457
25,"25911",452,301,299,7,2,"EN COMÚ",25
25,"25041",569,380,374,7,6,"EN COMÚ",39
25,"25143",87,58,57,1,1,"EN COMÚ",3
25,"25251",710,495,494,3,1,"EN COMÚ",73
25,"25048",1644,1151,1138,8,13,"EN COMÚ",137
25,"25141",156,101,99,1,2,"EN COMÚ",16
25,"25183",501,332,331,4,1,"EN COMÚ",47
25,"25163",228,143,142,5,1,"EN COMÚ",12
25,"25138",576,415,408,6,7,"EN COMÚ",26
25,"25202",101,72,72,0,0,"EN COMÚ",21
25,"25057",206,152,151,2,1,"EN COMÚ",32
25,"25245",441,313,313,0,0,"EN COMÚ",56
25,"25221",130,76,76,0,0,"EN COMÚ",16
25,"25210",1104,779,767,9,12,"EN COMÚ",57
25,"25056",243,151,150,2,1,"EN COMÚ",13
25,"25068",558,372,369,9,3,"EN COMÚ",29
25,"25165",280,194,190,4,4,"EN COMÚ",11
25,"25110",2796,1828,1807,30,21,"EN COMÚ",254
25,"25233",278,193,191,2,2,"EN COMÚ",34
25,"25118",350,223,223,8,0,"EN COMÚ",20
25,"25037",385,245,241,2,4,"EN COMÚ",25
25,"25039",280,182,180,0,2,"EN COMÚ",40
25,"25033",1106,777,767,7,10,"EN COMÚ",132
25,"25013",2171,1380,1366,10,14,"EN COMÚ",240
25,"25909",155,89,89,3,0,"EN COMÚ",23
25,"25076",146,84,84,1,0,"EN COMÚ",13
25,"25171",2190,1461,1444,4,17,"EN COMÚ",189
25,"25196",119,74,74,0,0,"EN COMÚ",13
25,"25254",738,507,493,6,14,"EN COMÚ",68
25,"25228",3043,2140,2118,21,22,"EN COMÚ",312
25,"25189",2106,1392,1381,16,11,"EN COMÚ",295
25,"25045",52,36,36,0,0,"EN COMÚ",6
25,"25011",5256,3190,3161,36,29,"EN COMÚ",573
25,"25140",774,468,465,4,3,"EN COMÚ",73
25,"25179",161,115,114,0,1,"EN COMÚ",10
25,"25253",163,125,124,0,1,"EN COMÚ",11
25,"25212",234,173,171,1,2,"EN COMÚ",17
25,"25904",155,118,118,0,0,"EN COMÚ",17
25,"25224",126,86,86,1,0,"EN COMÚ",8
25,"25901",292,186,181,4,5,"EN COMÚ",28
25,"25096",912,586,572,9,14,"EN COMÚ",66
25,"25255",426,308,302,4,6,"EN COMÚ",36
25,"25219",144,106,105,3,1,"EN COMÚ",11
25,"25192",767,510,496,11,14,"EN COMÚ",60
25,"25222",67,52,52,1,0,"EN COMÚ",2
25,"25046",421,292,286,1,6,"EN COMÚ",32
25,"25081",318,213,210,2,3,"EN COMÚ",34
25,"25139",479,325,324,3,1,"EN COMÚ",39
25,"25063",91,55,55,0,0,"EN COMÚ",8
25,"25906",226,144,143,0,1,"EN COMÚ",18
25,"25099",1260,804,793,8,11,"EN COMÚ",91
25,"25216",226,150,150,0,0,"EN COMÚ",15
25,"25217",10594,7016,6950,119,66,"EN COMÚ",1079
25,"25175",194,132,132,7,0,"EN COMÚ",21
25,"25205",562,413,402,2,11,"EN COMÚ",70
25,"25129",176,113,110,6,3,"EN COMÚ",4
25,"25226",251,156,153,3,3,"EN COMÚ",19
25,"25238",217,151,151,6,0,"EN COMÚ",23
25,"25133",713,469,464,1,5,"EN COMÚ",33
25,"25098",253,163,160,2,3,"EN COMÚ",19
25,"25101",565,393,388,9,5,"EN COMÚ",42
25,"25067",730,483,479,4,4,"EN COMÚ",61
25,"25077",460,272,269,2,3,"EN COMÚ",27
25,"25097",87,62,62,4,0,"EN COMÚ",4
25,"25025",1346,966,956,10,10,"EN COMÚ",213
25,"25021",2618,1655,1639,32,16,"EN COMÚ",251
25,"25030",131,86,86,2,0,"EN COMÚ",6
25,"25008",1135,828,819,11,9,"EN COMÚ",64
25,"25029",1662,1156,1147,13,9,"EN COMÚ",143
25,"25250",344,236,234,0,2,"EN COMÚ",25
25,"25169",188,125,124,3,1,"EN COMÚ",18
25,"25089",106,58,58,0,0,"EN COMÚ",15
25,"25207",6216,4062,4031,45,31,"EN COMÚ",499
25,"25185",681,421,418,8,3,"EN COMÚ",57
25,"25005",277,183,182,2,1,"EN COMÚ",30
25,"25197",137,97,97,2,0,"EN COMÚ",10
25,"25114",97,87,87,0,0,"EN COMÚ",5
25,"25130",197,117,117,3,0,"EN COMÚ",8
25,"25227",641,398,395,3,3,"EN COMÚ",42
25,"25122",1916,1274,1264,15,10,"EN COMÚ",121
25,"25050",3253,2064,2048,27,16,"EN COMÚ",249
25,"25044",189,136,136,3,0,"EN COMÚ",11
25,"25042",208,143,142,0,1,"EN COMÚ",12
25,"25004",571,425,423,5,2,"EN COMÚ",46
25,"25078",1007,720,717,6,3,"EN COMÚ",105
25,"25001",139,88,87,1,1,"EN COMÚ",13
25,"25017",239,160,159,2,1,"EN COMÚ",18
25,"25176",312,239,235,7,4,"EN COMÚ",22
25,"25200",336,218,218,0,0,"EN COMÚ",20
25,"25252",548,399,398,6,1,"EN COMÚ",52
25,"25173",1702,1180,1171,5,9,"EN COMÚ",271
25,"25016",2114,1417,1411,8,6,"EN COMÚ",211
25,"25121",642,415,413,8,2,"EN COMÚ",73
25,"25034",2331,1516,1505,20,11,"EN COMÚ",90
25,"25072",5858,3878,3835,45,43,"EN COMÚ",561
25,"25126",286,214,210,5,4,"EN COMÚ",40
25,"25153",198,141,137,0,4,"EN COMÚ",23
25,"25085",152,106,106,0,0,"EN COMÚ",9
25,"25131",412,271,261,8,10,"EN COMÚ",30
25,"25247",123,72,72,0,0,"EN COMÚ",22
25,"25092",132,93,89,1,4,"EN COMÚ",5
25,"25242",732,480,477,4,3,"EN COMÚ",70
25,"25014",254,177,174,4,3,"EN COMÚ",16
25,"25912",868,618,617,5,1,"EN COMÚ",107
25,"25905",386,260,255,4,5,"EN COMÚ",22
25,"25186",214,141,138,2,3,"EN COMÚ",10
25,"25211",683,427,422,4,5,"EN COMÚ",52
25,"25191",332,225,222,3,3,"EN COMÚ",17
25,"25049",151,104,104,1,0,"EN COMÚ",10
25,"25136",98,71,70,0,1,"EN COMÚ",4
25,"25182",1043,738,727,13,11,"EN COMÚ",119
25,"25172",1805,1230,1214,8,16,"EN COMÚ",122
25,"25248",891,622,616,3,6,"EN COMÚ",36
25,"25093",639,451,445,11,6,"EN COMÚ",38
25,"25022",106,76,76,2,0,"EN COMÚ",7
25,"25075",117,82,82,0,0,"EN COMÚ",8
25,"25239",608,320,319,1,1,"EN COMÚ",41
25,"25012",2296,1504,1488,8,16,"EN COMÚ",299
25,"25105",130,95,93,4,2,"EN COMÚ",16
25,"25148",220,155,153,0,2,"EN COMÚ",1
25,"25007",1410,1005,996,13,9,"EN COMÚ",221
25,"25074",182,145,141,0,4,"EN COMÚ",4
25,"25032",61,44,43,0,1,"EN COMÚ",8
25,"25244",369,252,248,3,4,"EN COMÚ",25
25,"25249",183,118,118,2,0,"EN COMÚ",1
25,"25082",280,169,167,3,2,"EN COMÚ",13
25,"25036",184,126,121,0,5,"EN COMÚ",20
25,"25180",239,151,151,0,0,"EN COMÚ",20
25,"25115",824,551,549,12,2,"EN COMÚ",43
25,"25006",346,214,212,6,2,"EN COMÚ",24
25,"25112",272,189,189,2,0,"EN COMÚ",23
25,"25145",85,64,64,2,0,"EN COMÚ",2
25,"25156",791,574,571,7,3,"EN COMÚ",82
25,"25201",115,70,67,0,3,"EN COMÚ",7
25,"25002",484,323,321,2,2,"EN COMÚ",33
25,"25167",236,158,156,3,2,"EN COMÚ",18
25,"25043",794,505,501,3,4,"EN COMÚ",104
25,"25902",570,390,379,3,11,"EN COMÚ",25
25,"25060",70,45,45,2,0,"EN COMÚ",5
25,"25047",1010,730,722,6,8,"EN COMÚ",56
25,"25132",130,97,95,1,2,"EN COMÚ",16
25,"25040",10532,6837,6762,81,75,"EN COMÚ",1070
25,"25100",212,134,134,3,0,"EN COMÚ",25
25,"25204",1241,843,827,3,16,"EN COMÚ",81
25,"25051",1522,990,983,10,7,"EN COMÚ",102
25,"25055",172,118,116,2,2,"EN COMÚ",11
25,"25079",305,216,214,5,2,"EN COMÚ",11
25,"25102",712,473,467,10,6,"EN COMÚ",61
25,"25087",61,46,45,0,1,"EN COMÚ",4
25,"25152",140,100,98,4,2,"EN COMÚ",6
25,"25009",631,465,460,3,5,"EN COMÚ",50
25,"25073",588,374,371,8,3,"EN COMÚ",48
25,"25104",125,86,86,3,0,"EN COMÚ",6
25,"25168",508,392,391,2,1,"EN COMÚ",24
25,"25149",1382,1010,993,7,17,"EN COMÚ",100
25,"25190",263,195,195,4,0,"EN COMÚ",29
25,"25158",1639,1163,1150,26,13,"EN COMÚ",140
25,"25232",1421,961,950,10,11,"EN COMÚ",133
25,"25203",8976,5588,5526,53,62,"EN COMÚ",909
25,"25062",757,521,516,4,5,"EN COMÚ",67
25,"25151",670,466,459,3,7,"EN COMÚ",45
25,"25910",101,64,62,0,2,"EN COMÚ",9
25,"25061",82,53,53,0,0,"EN COMÚ",4
25,"25194",426,278,273,0,5,"EN COMÚ",17
25,"25020",292,203,200,2,3,"EN COMÚ",10
25,"25023",4527,3111,3073,20,38,"EN COMÚ",529
25,"25064",112,85,85,3,0,"EN COMÚ",3
25,"25170",264,182,179,1,3,"EN COMÚ",19
25,"25164",381,264,262,2,2,"EN COMÚ",22
25,"25069",453,289,286,6,3,"EN COMÚ",38
25,"25027",1001,687,681,3,6,"EN COMÚ",79
25,"25059",801,590,584,11,6,"EN COMÚ",73
25,"25209",1517,1035,1019,6,16,"EN COMÚ",189
25,"25135",1032,707,701,7,6,"EN COMÚ",84
25,"25019",4565,3001,2965,36,36,"EN COMÚ",621
25,"25230",1573,1100,1081,13,19,"EN COMÚ",108
25,"25123",193,131,130,0,1,"EN COMÚ",21
25,"25231",490,382,382,2,0,"EN COMÚ",35
25,"25146",224,150,148,2,2,"EN COMÚ",11
25,"25223",922,614,598,8,16,"EN COMÚ",70
25,"25119",2259,1582,1569,22,13,"EN COMÚ",162
25,"25120",92243,61433,61005,533,428,"EN COMÚ",11672
25,"25908",228,138,137,3,1,"EN COMÚ",14
25,"25134",635,418,414,4,4,"EN COMÚ",59
25,"25161",368,234,232,3,2,"EN COMÚ",38
25,"25154",120,68,68,1,0,"EN COMÚ",4
25,"25035",397,287,286,3,1,"EN COMÚ",49
25,"25215",334,244,243,2,1,"EN COMÚ",52
25,"25913",87,69,69,1,0,"EN COMÚ",6
25,"25218",84,66,66,0,0,"EN COMÚ",5
25,"25111",115,83,83,1,0,"EN COMÚ",3
25,"25174",398,299,296,3,3,"EN COMÚ",48
25,"25052",1573,1132,1122,16,10,"EN COMÚ",115
25,"25166",177,123,121,1,2,"EN COMÚ",2
25,"25128",142,89,89,0,0,"EN COMÚ",15
25,"25124",169,118,116,2,2,"EN COMÚ",11
25,"25103",131,80,80,3,0,"EN COMÚ",10
25,"25010",212,131,130,6,1,"EN COMÚ",16
25,"25127",212,135,134,3,1,"EN COMÚ",10
25,"25220",1028,709,701,9,8,"EN COMÚ",69
25,"25024",356,233,230,1,3,"EN COMÚ",33
25,"25206",257,164,164,3,0,"EN COMÚ",9
25,"25071",51,31,31,0,0,"EN COMÚ",1
25,"25088",96,76,75,0,1,"EN COMÚ",3
25,"25240",1407,1006,995,10,11,"EN COMÚ",152
25,"25234",4290,2645,2621,25,24,"EN COMÚ",356
25,"25058",4378,2810,2793,27,17,"EN COMÚ",308
25,"25225",575,395,393,6,2,"EN COMÚ",30
25,"25142",368,252,251,3,1,"EN COMÚ",36
25,"25903",237,154,152,3,2,"EN COMÚ",15
25,"25094",139,111,109,0,2,"EN COMÚ",16
25,"25177",372,258,258,2,0,"EN COMÚ",29
25,"25015",355,258,257,3,1,"EN COMÚ",41
25,"25137",8577,5630,5591,45,39,"EN COMÚ",830
25,"25109",238,168,168,1,0,"EN COMÚ",11
25,"25193",765,520,514,3,6,"EN COMÚ",24
25,"25157",181,139,137,1,2,"EN COMÚ",12
25,"25086",533,373,372,5,1,"EN COMÚ",38
25,"25125",424,279,273,4,6,"EN COMÚ",24
25,"25150",185,127,124,1,3,"EN COMÚ",7
25,"25003",3782,2390,2372,24,18,"EN COMÚ",262
25,"25208",316,191,189,1,2,"EN COMÚ",59
25,"25907",498,317,314,3,3,"EN COMÚ",39
25,"25181",177,138,137,5,1,"EN COMÚ",21
25,"25070",817,584,573,14,11,"EN COMÚ",47
17,"17212",139,108,106,1,2,"EN COMÚ",9
17,"17216",165,112,110,0,2,"EN COMÚ",13
17,"17233",2287,1682,1664,21,18,"EN COMÚ",203
17,"17075",334,234,227,5,7,"EN COMÚ",32
17,"17085",293,223,221,1,2,"EN COMÚ",20
17,"17230",463,343,339,2,4,"EN COMÚ",31
17,"17047",4837,2997,2973,39,24,"EN COMÚ",498
17,"17185",2293,1547,1527,12,20,"EN COMÚ",150
17,"17082",410,273,268,3,5,"EN COMÚ",25
17,"17081",244,165,163,0,2,"EN COMÚ",16
17,"17144",210,141,141,2,0,"EN COMÚ",16
17,"17160",14740,9853,9795,68,58,"EN COMÚ",2048
17,"17041",215,146,145,2,1,"EN COMÚ",20
17,"17097",199,149,148,5,1,"EN COMÚ",19
17,"17110",1325,953,945,5,8,"EN COMÚ",169
17,"17132",1311,923,913,10,10,"EN COMÚ",90
17,"17090",542,410,408,3,2,"EN COMÚ",36
17,"17064",325,219,214,1,5,"EN COMÚ",26
17,"17105",255,170,170,2,0,"EN COMÚ",28
17,"17214",706,471,468,4,3,"EN COMÚ",45
17,"17183",274,186,186,3,0,"EN COMÚ",21
17,"17141",5869,3688,3653,38,35,"EN COMÚ",570
17,"17178",1063,690,685,5,5,"EN COMÚ",79
17,"17168",374,273,272,1,1,"EN COMÚ",22
17,"17005",401,263,260,5,3,"EN COMÚ",39
17,"17181",3380,2272,2251,15,21,"EN COMÚ",387
17,"17226",856,572,557,5,15,"EN COMÚ",77
17,"17228",295,211,210,1,1,"EN COMÚ",29
17,"17051",219,157,155,3,2,"EN COMÚ",15
17,"17078",330,225,225,5,0,"EN COMÚ",7
17,"17207",2373,1691,1673,18,18,"EN COMÚ",163
17,"17164",3996,2555,2543,23,12,"EN COMÚ",263
17,"17067",697,500,495,7,5,"EN COMÚ",54
17,"17210",551,378,376,2,2,"EN COMÚ",40
17,"17073",1875,1466,1460,11,6,"EN COMÚ",138
17,"17903",897,647,638,0,9,"EN COMÚ",74
17,"17071",1131,810,803,8,7,"EN COMÚ",94
17,"17170",172,118,117,2,1,"EN COMÚ",4
17,"17215",2066,1588,1577,12,11,"EN COMÚ",200
17,"17015",12525,8550,8470,59,80,"EN COMÚ",1026
17,"17166",516,386,378,2,8,"EN COMÚ",38
17,"17188",165,126,126,0,0,"EN COMÚ",25
17,"17177",563,359,354,3,5,"EN COMÚ",35
17,"17115",277,195,195,0,0,"EN COMÚ",28
17,"17018",477,347,343,3,4,"EN COMÚ",35
17,"17061",162,119,119,1,0,"EN COMÚ",8
17,"17148",1535,1056,1045,12,11,"EN COMÚ",174
17,"17120",792,530,518,3,12,"EN COMÚ",64
17,"17121",221,157,156,1,1,"EN COMÚ",16
17,"17084",236,160,160,7,0,"EN COMÚ",13
17,"17116",348,243,240,4,3,"EN COMÚ",29
17,"17083",2935,2059,2042,17,17,"EN COMÚ",497
17,"17119",68,59,59,0,0,"EN COMÚ",19
17,"17213",5372,3549,3517,17,32,"EN COMÚ",674
17,"17208",997,679,671,12,8,"EN COMÚ",64
17,"17024",279,176,176,2,0,"EN COMÚ",20
17,"17016",724,519,515,8,4,"EN COMÚ",59
17,"17138",944,668,663,4,5,"EN COMÚ",96
17,"17027",2826,1993,1973,10,20,"EN COMÚ",293
17,"17095",19593,12648,12554,81,94,"EN COMÚ",2744
17,"17048",6269,4072,4044,24,28,"EN COMÚ",707
17,"17153",186,140,140,0,0,"EN COMÚ",20
17,"17203",154,110,110,0,0,"EN COMÚ",16
17,"17057",960,708,699,8,9,"EN COMÚ",80
17,"17184",1258,893,887,6,6,"EN COMÚ",89
17,"17052",124,83,83,1,0,"EN COMÚ",15
17,"17173",180,141,139,2,2,"EN COMÚ",18
17,"17234",183,124,124,1,0,"EN COMÚ",16
17,"17010",330,247,246,5,1,"EN COMÚ",42
17,"17211",839,646,639,3,7,"EN COMÚ",58
17,"17117",14280,9297,9223,75,74,"EN COMÚ",1546
17,"17902",1353,957,947,9,10,"EN COMÚ",105
17,"17146",2979,2030,2009,14,21,"EN COMÚ",558
17,"17014",61,47,47,1,0,"EN COMÚ",1
17,"17077",555,386,383,5,3,"EN COMÚ",47
17,"17062",5970,3695,3657,31,38,"EN COMÚ",626
17,"17197",137,105,105,2,0,"EN COMÚ",23
17,"17004",510,371,368,0,3,"EN COMÚ",59
17,"17050",649,499,495,3,4,"EN COMÚ",42
17,"17023",27347,18842,18610,118,232,"EN COMÚ",4959
17,"17193",4216,2807,2768,26,39,"EN COMÚ",542
17,"17123",357,275,273,3,2,"EN COMÚ",36
17,"17159",627,439,434,2,5,"EN COMÚ",76
17,"17136",175,133,132,1,1,"EN COMÚ",29
17,"17020",3590,2531,2510,28,21,"EN COMÚ",332
17,"17205",212,166,166,2,0,"EN COMÚ",16
17,"17079",64159,44230,43902,271,328,"EN COMÚ",7221
17,"17037",104,65,65,0,0,"EN COMÚ",1
17,"17039",1764,1229,1217,20,12,"EN COMÚ",128
17,"17086",1744,1181,1170,10,11,"EN COMÚ",184
17,"17107",268,189,188,2,1,"EN COMÚ",16
17,"17102",576,397,395,4,2,"EN COMÚ",40
17,"17152",10727,6804,6758,46,46,"EN COMÚ",1097
17,"17129",137,99,99,1,0,"EN COMÚ",11
17,"17012",1142,763,757,6,6,"EN COMÚ",162
17,"17209",625,480,477,2,3,"EN COMÚ",71
17,"17187",621,468,464,6,4,"EN COMÚ",88
17,"17009",4042,2770,2738,18,32,"EN COMÚ",348
17,"17217",348,268,266,0,2,"EN COMÚ",32
17,"17040",538,392,391,4,1,"EN COMÚ",46
17,"17092",3508,2373,2347,13,26,"EN COMÚ",335
17,"17165",653,445,443,2,2,"EN COMÚ",58
17,"17202",3803,2471,2449,13,22,"EN COMÚ",438
17,"17157",126,104,102,1,2,"EN COMÚ",12
17,"17176",122,91,91,2,0,"EN COMÚ",9
17,"17112",192,141,139,1,2,"EN COMÚ",14
17,"17169",2475,1733,1724,11,9,"EN COMÚ",273
17,"17013",2787,1941,1926,17,15,"EN COMÚ",323
17,"17135",355,263,258,2,5,"EN COMÚ",44
17,"17096",178,115,114,0,1,"EN COMÚ",20
17,"17002",556,429,419,1,10,"EN COMÚ",58
17,"17109",693,443,435,2,8,"EN COMÚ",68
17,"17022",6926,4626,4587,47,39,"EN COMÚ",755
17,"17196",214,151,151,2,0,"EN COMÚ",27
17,"17046",719,499,492,2,7,"EN COMÚ",54
17,"17070",109,82,82,1,0,"EN COMÚ",2
17,"17162",147,91,90,0,1,"EN COMÚ",25
17,"17182",262,191,191,2,0,"EN COMÚ",25
17,"17011",646,463,462,7,1,"EN COMÚ",35
17,"17063",166,115,113,0,2,"EN COMÚ",12
17,"17066",26551,16275,16166,140,109,"EN COMÚ",2699
17,"17151",174,124,123,3,1,"EN COMÚ",12
17,"17220",811,563,555,3,8,"EN COMÚ",32
17,"17089",5490,3630,3591,20,39,"EN COMÚ",598
17,"17227",128,95,95,0,0,"EN COMÚ",8
17,"17008",3636,2423,2395,15,28,"EN COMÚ",293
17,"17140",674,498,495,5,3,"EN COMÚ",50
17,"17171",163,123,122,0,1,"EN COMÚ",16
17,"17174",176,102,102,3,0,"EN COMÚ",12
17,"17137",3411,2391,2369,15,22,"EN COMÚ",243
17,"17133",1268,887,877,6,10,"EN COMÚ",60
17,"17091",411,282,273,5,9,"EN COMÚ",19
17,"17198",430,282,281,4,1,"EN COMÚ",53
17,"17001",585,417,413,2,4,"EN COMÚ",70
17,"17028",303,213,213,4,0,"EN COMÚ",25
17,"17124",1638,1096,1083,10,13,"EN COMÚ",106
17,"17111",873,643,641,12,2,"EN COMÚ",87
17,"17056",1706,1200,1193,10,7,"EN COMÚ",139
17,"17080",141,98,98,0,0,"EN COMÚ",8
17,"17195",338,256,251,2,5,"EN COMÚ",26
17,"17180",8300,5429,5368,42,61,"EN COMÚ",797
17,"17065",335,250,249,2,1,"EN COMÚ",28
17,"17029",203,131,131,2,0,"EN COMÚ",20
17,"17222",109,85,85,1,0,"EN COMÚ",9
17,"17038",369,255,253,2,2,"EN COMÚ",19
17,"17103",4942,3150,3129,19,21,"EN COMÚ",818
17,"17069",378,270,267,4,3,"EN COMÚ",33
17,"17025",1124,834,827,3,7,"EN COMÚ",92
17,"17149",363,267,264,0,3,"EN COMÚ",26
17,"17232",149,98,98,1,0,"EN COMÚ",20
17,"17218",588,448,445,3,3,"EN COMÚ",70
17,"17006",1131,730,728,9,2,"EN COMÚ",119
17,"17021",135,86,86,2,0,"EN COMÚ",21
17,"17032",1713,1036,1020,13,16,"EN COMÚ",198
17,"17074",507,345,341,1,4,"EN COMÚ",69
17,"17026",536,381,380,6,1,"EN COMÚ",33
17,"17058",180,132,131,1,1,"EN COMÚ",21
17,"17106",139,108,106,0,2,"EN COMÚ",12
17,"17147",8112,5475,5422,43,53,"EN COMÚ",747
17,"17019",1779,1279,1261,13,18,"EN COMÚ",99
17,"17224",314,214,213,3,1,"EN COMÚ",9
17,"17118",12824,8557,8477,57,80,"EN COMÚ",1405
17,"17093",893,590,585,6,5,"EN COMÚ",77
17,"17125",129,88,86,0,2,"EN COMÚ",2
17,"17043",158,119,117,1,2,"EN COMÚ",16
17,"17033",5293,3509,3476,28,33,"EN COMÚ",778
17,"17068",245,173,172,0,1,"EN COMÚ",21
17,"17186",3771,2742,2712,18,30,"EN COMÚ",506
17,"17128",302,224,223,4,1,"EN COMÚ",15
17,"17201",128,93,92,1,1,"EN COMÚ",7
17,"17225",213,142,142,1,0,"EN COMÚ",3
17,"17094",1049,646,641,3,5,"EN COMÚ",69
17,"17167",2697,1876,1852,24,24,"EN COMÚ",195
17,"17076",123,90,88,2,2,"EN COMÚ",17
17,"17194",78,54,52,2,2,"EN COMÚ",7
17,"17199",6845,4527,4483,32,44,"EN COMÚ",557
17,"17126",308,252,250,2,2,"EN COMÚ",23
17,"17130",328,246,245,2,1,"EN COMÚ",19
17,"17161",990,737,734,7,3,"EN COMÚ",65
17,"17003",102,71,71,0,0,"EN COMÚ",10
17,"17099",80,60,59,0,1,"EN COMÚ",6
17,"17191",146,114,113,1,1,"EN COMÚ",7
17,"17134",234,163,161,2,2,"EN COMÚ",43
17,"17158",464,284,281,0,3,"EN COMÚ",32
17,"17139",1382,972,963,9,9,"EN COMÚ",102
17,"17142",2561,1962,1950,13,12,"EN COMÚ",326
17,"17172",452,308,307,1,1,"EN COMÚ",66
17,"17150",1407,1074,1060,12,14,"EN COMÚ",121
17,"17204",562,385,384,7,1,"EN COMÚ",53
17,"17192",145,108,108,1,0,"EN COMÚ",7
17,"17901",989,696,686,7,10,"EN COMÚ",110
17,"17034",6874,4509,4477,32,32,"EN COMÚ",859
17,"17042",414,288,286,2,2,"EN COMÚ",48
17,"17036",2736,1857,1839,16,18,"EN COMÚ",315
17,"17100",199,142,140,7,2,"EN COMÚ",15
17,"17044",6767,4737,4694,36,43,"EN COMÚ",581
17,"17114",23020,15151,15024,105,127,"EN COMÚ",1881
17,"17088",535,372,369,0,3,"EN COMÚ",54
17,"17163",2609,1904,1890,18,14,"EN COMÚ",230
17,"17055",152,125,125,0,0,"EN COMÚ",20
17,"17145",1488,1003,986,9,17,"EN COMÚ",116
17,"17200",618,425,422,4,3,"EN COMÚ",71
17,"17007",1730,1235,1224,4,11,"EN COMÚ",108
17,"17101",543,364,362,3,2,"EN COMÚ",83
17,"17087",222,169,169,3,0,"EN COMÚ",29
17,"17206",141,89,87,0,2,"EN COMÚ",8
17,"17054",375,249,249,2,0,"EN COMÚ",32
17,"17143",146,109,107,1,2,"EN COMÚ",15
17,"17154",92,62,62,0,0,"EN COMÚ",21
17,"17035",544,400,399,4,1,"EN COMÚ",31
17,"17223",807,528,520,6,8,"EN COMÚ",100
17,"17155",14500,9167,9080,43,87,"EN COMÚ",1749
17,"17175",579,366,360,4,6,"EN COMÚ",57
17,"17031",172,109,109,3,0,"EN COMÚ",21
17,"17049",3125,2251,2233,7,18,"EN COMÚ",402
17,"17030",645,430,428,7,2,"EN COMÚ",50
17,"17189",1524,1126,1114,4,12,"EN COMÚ",104
17,"17098",311,224,221,2,3,"EN COMÚ",47
17,"17190",842,592,590,10,2,"EN COMÚ",75
17,"17221",4182,2882,2859,18,23,"EN COMÚ",439
17,"17060",424,277,274,3,3,"EN COMÚ",35
31,"31162",47,29,27,0,2,"EH Bildu",3
31,"31169",2217,1508,1489,15,19,"EH Bildu",15
31,"31203",40,29,29,0,0,"EH Bildu",0
31,"31200",764,558,546,11,12,"EH Bildu",90
31,"31173",873,704,680,3,24,"EH Bildu",9
31,"31164",582,464,457,3,7,"EH Bildu",2
31,"31058",215,153,153,2,0,"EH Bildu",25
31,"31159",1134,867,864,9,3,"EH Bildu",142
31,"31051",253,176,176,2,0,"EH Bildu",16
31,"31144",804,482,479,2,3,"EH Bildu",183
31,"31045",504,397,392,9,5,"EH Bildu",25
31,"31132",146,115,113,1,2,"EH Bildu",27
31,"31209",157,108,108,0,0,"EH Bildu",13
31,"31129",393,265,261,2,4,"EH Bildu",122
31,"31183",681,581,578,10,3,"EH Bildu",51
31,"31019",1809,1295,1288,23,7,"EH Bildu",349
31,"31222",63,41,41,5,0,"EH Bildu",10
31,"31039",83,58,57,0,1,"EH Bildu",11
31,"31234",144,107,107,2,0,"EH Bildu",10
31,"31081",342,239,239,2,0,"EH Bildu",72
31,"31107",1707,1303,1294,12,9,"EH Bildu",13
31,"31017",361,248,246,4,2,"EH Bildu",43
31,"31240",531,355,351,6,4,"EH Bildu",120
31,"31248",295,174,168,2,6,"EH Bildu",24
31,"31206",2095,1529,1513,19,16,"EH Bildu",203
31,"31105",1535,1208,1187,18,21,"EH Bildu",9
31,"31213",105,70,70,0,0,"EH Bildu",24
31,"31259",485,325,324,3,1,"EH Bildu",81
31,"31121",64,45,45,2,0,"EH Bildu",1
31,"31044",290,223,220,1,3,"EH Bildu",92
31,"31078",2447,1889,1861,25,28,"EH Bildu",32
31,"31033",49,29,29,1,0,"EH Bildu",6
31,"31172",367,293,286,6,7,"EH Bildu",19
31,"31176",2856,2077,2040,33,37,"EH Bildu",29
31,"31098",1918,1489,1483,23,6,"EH Bildu",200
31,"31224",914,668,659,6,9,"EH Bildu",9
31,"31047",261,191,187,6,4,"EH Bildu",22
31,"31193",1414,1103,1094,12,9,"EH Bildu",166
31,"31903",6593,4699,4660,28,39,"EH Bildu",684
31,"31106",689,565,559,1,6,"EH Bildu",7
31,"31115",166,108,108,2,0,"EH Bildu",26
31,"31152",1347,999,990,16,9,"EH Bildu",41
31,"31246",140,108,103,2,5,"EH Bildu",12
31,"31215",4649,3412,3359,35,53,"EH Bildu",27
31,"31207",271,194,190,0,4,"EH Bildu",60
31,"31188",227,173,173,2,0,"EH Bildu",25
31,"31093",293,210,206,2,4,"EH Bildu",52
31,"31036",921,664,657,5,7,"EH Bildu",49
31,"31168",248,192,191,0,1,"EH Bildu",26
31,"31264",179,117,115,5,2,"EH Bildu",31
31,"31221",1211,844,825,4,19,"EH Bildu",198
31,"31069",847,643,636,4,7,"EH Bildu",63
31,"31202",4326,3045,3001,41,44,"EH Bildu",59
31,"31191",3018,2324,2297,23,27,"EH Bildu",76
31,"31100",264,186,186,2,0,"EH Bildu",16
31,"31042",2744,2081,2053,19,28,"EH Bildu",11
31,"31232",25152,18432,18220,199,212,"EH Bildu",374
31,"31063",88,72,68,2,4,"EH Bildu",14
31,"31192",159,132,131,0,1,"EH Bildu",11
31,"31236",1324,943,933,12,10,"EH Bildu",155
31,"31031",221,141,140,0,1,"EH Bildu",59
31,"31182",37,27,27,0,0,"EH Bildu",4
31,"31104",1876,1355,1338,10,17,"EH Bildu",51
31,"31906",2553,1945,1930,21,15,"EH Bildu",151
31,"31122",4719,3671,3654,42,17,"EH Bildu",476
31,"31075",101,68,67,1,1,"EH Bildu",10
31,"31111",96,75,75,2,0,"EH Bildu",17
31,"31243",314,236,234,5,2,"EH Bildu",42
31,"31257",866,657,648,8,9,"EH Bildu",53
31,"31186",302,211,209,2,2,"EH Bildu",61
31,"31095",76,66,64,1,2,"EH Bildu",24
31,"31073",315,214,212,3,2,"EH Bildu",91
31,"31074",394,301,298,5,3,"EH Bildu",82
31,"31178",495,364,364,4,0,"EH Bildu",3
31,"31256",109,70,70,0,0,"EH Bildu",29
31,"31084",1935,1389,1380,19,9,"EH Bildu",603
31,"31158",252,181,178,2,3,"EH Bildu",25
31,"31118",165,122,121,2,1,"EH Bildu",8
31,"31185",501,345,342,4,3,"EH Bildu",85
31,"31088",5574,4194,4156,46,38,"EH Bildu",276
31,"31128",370,265,265,2,0,"EH Bildu",59
31,"31004",35,22,22,1,0,"EH Bildu",3
31,"31048",169,123,123,1,0,"EH Bildu",0
31,"31096",115,95,92,2,3,"EH Bildu",17
31,"31035",63,45,43,1,2,"EH Bildu",2
31,"31018",409,312,311,9,1,"EH Bildu",29
31,"31021",64,42,42,0,0,"EH Bildu",12
31,"31014",274,197,197,4,0,"EH Bildu",36
31,"31195",180,129,128,0,1,"EH Bildu",45
31,"31068",2893,2172,2138,27,34,"EH Bildu",39
31,"31149",2338,1534,1525,16,9,"EH Bildu",676
31,"31027",838,595,589,7,6,"EH Bildu",253
31,"31130",310,214,213,7,1,"EH Bildu",52
31,"31214",93,70,69,0,1,"EH Bildu",14
31,"31025",768,560,560,5,0,"EH Bildu",119
31,"31076",2407,2005,1986,28,19,"EH Bildu",113
31,"31174",110,75,73,0,2,"EH Bildu",9
31,"31097",10436,7461,7395,96,66,"EH Bildu",893
31,"31201",147803,110800,110079,1040,721,"EH Bildu",10689
31,"31208",2569,2016,1992,21,24,"EH Bildu",25
31,"31263",236,142,142,2,0,"EH Bildu",67
31,"31251",3110,2347,2327,19,20,"EH Bildu",107
31,"31198",36,29,29,0,0,"EH Bildu",11
31,"31205",427,330,326,7,4,"EH Bildu",17
31,"31086",12987,10342,10270,114,72,"EH Bildu",757
31,"31138",934,649,647,5,2,"EH Bildu",226
31,"31124",210,162,162,2,0,"EH Bildu",16
31,"31003",124,95,95,2,0,"EH Bildu",34
31,"31233",96,72,71,0,1,"EH Bildu",0
31,"31250",2832,1921,1899,20,22,"EH Bildu",429
31,"31006",1952,1423,1400,14,23,"EH Bildu",23
31,"31196",39,34,34,0,0,"EH Bildu",8
31,"31254",1920,1473,1458,7,15,"EH Bildu",53
31,"31024",102,52,52,0,0,"EH Bildu",21
31,"31016",7642,5866,5822,52,44,"EH Bildu",770
31,"31241",134,94,89,0,5,"EH Bildu",9
31,"31070",2652,1907,1888,16,19,"EH Bildu",42
31,"31148",93,70,70,3,0,"EH Bildu",2
31,"31179",509,361,355,5,6,"EH Bildu",14
31,"31249",1885,1350,1331,20,19,"EH Bildu",13
31,"31239",310,223,220,5,3,"EH Bildu",29
31,"31242",253,165,164,1,1,"EH Bildu",24
31,"31265",86,61,61,0,0,"EH Bildu",10
31,"31041",1583,1125,1110,14,15,"EH Bildu",92
31,"31139",159,102,101,3,1,"EH Bildu",8
31,"31065",1892,1420,1396,14,24,"EH Bildu",47
31,"31238",110,96,94,2,2,"EH Bildu",14
31,"31244",156,87,84,1,3,"EH Bildu",14
31,"31905",2847,2108,2093,11,15,"EH Bildu",75
31,"31057",1812,1375,1360,17,15,"EH Bildu",3
31,"31154",227,127,125,3,2,"EH Bildu",19
31,"31204",37,33,33,2,0,"EH Bildu",3
31,"31077",5384,4055,3999,49,56,"EH Bildu",49
31,"31053",532,395,391,4,4,"EH Bildu",24
31,"31043",38,30,30,0,0,"EH Bildu",0
31,"31908",1008,709,704,11,5,"EH Bildu",136
31,"31194",315,218,217,2,1,"EH Bildu",40
31,"31066",867,647,638,8,9,"EH Bildu",11
31,"31117",620,390,385,1,5,"EH Bildu",257
31,"31049",704,488,486,1,2,"EH Bildu",217
31,"31002",424,312,310,7,2,"EH Bildu",32
31,"31142",1411,972,964,11,8,"EH Bildu",113
31,"31090",146,81,80,3,1,"EH Bildu",6
31,"31054",460,308,304,7,4,"EH Bildu",83
31,"31134",178,132,130,1,2,"EH Bildu",21
31,"31901",15475,11855,11771,121,84,"EH Bildu",1005
31,"31005",296,205,204,0,1,"EH Bildu",12
31,"31029",925,662,648,6,14,"EH Bildu",41
31,"31902",4346,3247,3228,23,19,"EH Bildu",284
31,"31171",693,510,500,6,10,"EH Bildu",20
31,"31141",109,70,66,1,4,"EH Bildu",0
31,"31030",145,107,107,3,0,"EH Bildu",26
31,"31155",253,191,189,3,2,"EH Bildu",8
31,"31101",1390,1031,1028,11,3,"EH Bildu",166
31,"31080",510,412,411,8,1,"EH Bildu",50
31,"31175",72,50,49,0,1,"EH Bildu",2
31,"31012",814,579,570,4,9,"EH Bildu",28
31,"31123",654,430,419,7,11,"EH Bildu",89
31,"31151",67,48,48,1,0,"EH Bildu",4
31,"31028",211,133,133,0,0,"EH Bildu",41
31,"31046",60,38,38,0,0,"EH Bildu",2
31,"31184",61,43,43,2,0,"EH Bildu",12
31,"31225",36,29,29,0,0,"EH Bildu",1
31,"31904",1559,1095,1084,8,11,"EH Bildu",204
31,"31235",166,111,111,0,0,"EH Bildu",27
31,"31082",615,398,393,6,5,"EH Bildu",119
31,"31252",87,68,68,0,0,"EH Bildu",18
31,"31125",275,194,191,2,3,"EH Bildu",19
31,"31110",90,65,65,2,0,"EH Bildu",3
31,"31229",50,40,40,0,0,"EH Bildu",6
31,"31026",147,128,128,1,0,"EH Bildu",5
31,"31072",5288,3916,3846,32,70,"EH Bildu",42
31,"31153",2172,1463,1448,10,15,"EH Bildu",421
31,"31103",46,32,32,1,0,"EH Bildu",3
31,"31177",262,171,170,3,1,"EH Bildu",9
31,"31094",112,82,82,1,0,"EH Bildu",4
31,"31237",195,156,156,1,0,"EH Bildu",6
31,"31083",56,41,39,0,2,"EH Bildu",9
31,"31226",585,346,344,1,2,"EH Bildu",86
31,"31032",1733,1295,1285,26,10,"EH Bildu",17
31,"31219",88,63,62,0,1,"EH Bildu",1
31,"31091",347,217,217,0,0,"EH Bildu",75
31,"31037",86,64,64,0,0,"EH Bildu",24
31,"31199",150,101,101,3,0,"EH Bildu",22
31,"31060",13723,10036,9970,78,66,"EH Bildu",1076
31,"31161",344,273,270,4,3,"EH Bildu",38
31,"31113",137,86,85,1,1,"EH Bildu",6
31,"31262",206,180,180,2,0,"EH Bildu",18
31,"31137",208,93,93,3,0,"EH Bildu",13
31,"31089",242,188,185,1,3,"EH Bildu",6
31,"31165",2794,2057,2025,31,32,"EH Bildu",20
31,"31216",3882,2829,2810,31,19,"EH Bildu",200
31,"31020",454,235,232,2,3,"EH Bildu",112
31,"31145",171,133,133,0,0,"EH Bildu",1
31,"31133",44,30,30,1,0,"EH Bildu",12
31,"31092",662,458,455,4,3,"EH Bildu",91
31,"31001",90,74,74,5,0,"EH Bildu",11
31,"31230",107,86,85,0,1,"EH Bildu",4
31,"31163",2017,1479,1447,15,32,"EH Bildu",20
31,"31255",102,75,74,2,1,"EH Bildu",4
31,"31143",98,59,58,1,1,"EH Bildu",2
31,"31120",394,264,263,5,1,"EH Bildu",47
31,"31253",129,112,112,0,0,"EH Bildu",40
31,"31079",76,53,53,0,0,"EH Bildu",0
31,"31156",252,193,193,0,0,"EH Bildu",49
31,"31217",337,233,230,1,3,"EH Bildu",18
31,"31245",83,54,54,1,0,"EH Bildu",10
31,"31009",690,508,504,5,4,"EH Bildu",62
31,"31157",3546,2423,2399,32,24,"EH Bildu",81
31,"31181",150,116,116,0,0,"EH Bildu",40
31,"31055",259,177,173,2,4,"EH Bildu",49
31,"31189",1170,739,731,10,8,"EH Bildu",213
31,"31146",35,30,30,2,0,"EH Bildu",2
31,"31228",496,382,381,2,1,"EH Bildu",15
31,"31022",526,344,341,3,3,"EH Bildu",133
31,"31180",216,173,173,5,0,"EH Bildu",10
31,"31023",6826,5609,5591,77,18,"EH Bildu",316
31,"31140",116,82,82,2,0,"EH Bildu",8
31,"31056",179,137,133,0,4,"EH Bildu",16
31,"31052",88,65,64,0,1,"EH Bildu",1
31,"31061",56,50,50,1,0,"EH Bildu",1
31,"31227",8226,6191,6109,53,82,"EH Bildu",913
31,"31050",6058,3902,3850,64,52,"EH Bildu",931
31,"31013",661,439,437,1,2,"EH Bildu",57
31,"31011",697,494,491,5,3,"EH Bildu",55
31,"31114",362,272,269,6,3,"EH Bildu",24
31,"31112",94,67,66,0,1,"EH Bildu",12
31,"31126",357,235,232,0,3,"EH Bildu",71
31,"31015",2001,1468,1449,18,19,"EH Bildu",48
31,"31211",25,12,12,2,0,"EH Bildu",0
31,"31220",752,607,603,3,4,"EH Bildu",12
31,"31108",1878,1487,1475,14,12,"EH Bildu",19
31,"31034",40,29,29,1,0,"EH Bildu",9
31,"31085",471,353,351,3,2,"EH Bildu",99
31,"31258",7841,5961,5927,56,34,"EH Bildu",1037
31,"31116",65,51,51,1,0,"EH Bildu",2
31,"31109",1562,1184,1177,6,7,"EH Bildu",150
31,"31087",169,131,127,2,4,"EH Bildu",40
31,"31136",444,320,318,6,2,"EH Bildu",67
31,"31007",136,94,93,1,1,"EH Bildu",11
31,"31099",63,52,52,1,0,"EH Bildu",7
31,"31170",49,39,39,1,0,"EH Bildu",5
31,"31147",98,76,76,2,0,"EH Bildu",5
31,"31160",107,81,80,0,1,"EH Bildu",8
31,"31231",115,81,81,1,0,"EH Bildu",0
31,"31190",44,36,36,1,0,"EH Bildu",5
31,"31127",143,97,97,2,0,"EH Bildu",19
31,"31135",102,67,62,0,5,"EH Bildu",0
31,"31071",17,17,17,0,0,"EH Bildu",0
31,"31247",152,112,109,0,3,"EH Bildu",33
31,"31131",871,664,658,13,6,"EH Bildu",54
31,"31223",995,752,742,6,10,"EH Bildu",100
31,"31260",1245,859,857,15,2,"EH Bildu",134
31,"31197",70,60,59,0,1,"EH Bildu",5
31,"31008",80,57,54,0,3,"EH Bildu",4
31,"31038",1348,1017,1005,13,12,"EH Bildu",49
31,"31040",194,130,128,1,2,"EH Bildu",32
31,"31907",10677,8568,8523,97,45,"EH Bildu",751
31,"31150",213,154,152,1,2,"EH Bildu",37
31,"31010",5721,3986,3946,27,40,"EH Bildu",636
31,"31067",1938,1424,1415,15,9,"EH Bildu",47
31,"31187",111,70,70,1,0,"EH Bildu",18
31,"31064",1447,1161,1145,11,16,"EH Bildu",33
31,"31166",260,186,186,2,0,"EH Bildu",18
31,"31062",1088,866,853,4,13,"EH Bildu",12
31,"31102",146,66,66,1,0,"EH Bildu",22
31,"31210",199,146,145,2,1,"EH Bildu",26
31,"31119",40,22,22,0,0,"EH Bildu",3
31,"31261",235,187,187,3,0,"EH Bildu",9
31,"31212",151,118,118,7,0,"EH Bildu",1
31,"31167",827,624,615,13,9,"EH Bildu",66
31,"31059",191,142,141,1,1,"EH Bildu",38
11,"11024",6735,5114,5065,33,49,"IULV-CA, UP",352
11,"11038",13803,10593,10441,121,152,"IULV-CA, UP",443
11,"11033",20773,13487,13333,171,154,"IULV-CA, UP",617
11,"11027",68010,46675,46322,400,353,"IULV-CA, UP",2785
11,"11019",1830,1413,1371,5,42,"IULV-CA, UP",120
11,"11028",32532,23191,22981,274,210,"IULV-CA, UP",1863
11,"11030",22796,15377,15222,145,155,"IULV-CA, UP",721
11,"11007",18036,10832,10678,181,154,"IULV-CA, UP",646
11,"11040",398,326,317,3,9,"IULV-CA, UP",15
11,"11017",3207,2389,2362,28,27,"IULV-CA, UP",358
11,"11022",48778,26546,26333,277,213,"IULV-CA, UP",975
11,"11902",3619,2431,2410,17,21,"IULV-CA, UP",81
11,"11042",1189,877,868,5,9,"IULV-CA, UP",22
11,"11039",10044,6684,6623,98,61,"IULV-CA, UP",357
11,"11016",14880,9945,9848,124,97,"IULV-CA, UP",844
11,"11035",13569,9000,8908,93,92,"IULV-CA, UP",490
11,"11013",2324,1687,1653,16,34,"IULV-CA, UP",95
11,"11025",4370,3174,3123,29,51,"IULV-CA, UP",153
11,"11014",16791,11255,11146,166,109,"IULV-CA, UP",1448
11,"11005",4560,3203,3143,21,60,"IULV-CA, UP",201
11,"11012",100460,72741,72128,590,613,"IULV-CA, UP",3830
11,"11004",88617,55218,54733,581,485,"IULV-CA, UP",2276
11,"11034",2345,1606,1594,10,12,"IULV-CA, UP",77
11,"11008",17460,11800,11615,151,185,"IULV-CA, UP",527
11,"11002",4287,3245,3238,15,7,"IULV-CA, UP",968
11,"11001",4377,2949,2900,17,49,"IULV-CA, UP",123
11,"11037",5678,4491,4426,20,65,"IULV-CA, UP",1625
11,"11009",602,426,422,5,4,"IULV-CA, UP",31
11,"11041",9856,7043,6967,85,76,"IULV-CA, UP",369
11,"11011",1688,1239,1205,14,34,"IULV-CA, UP",76
11,"11026",4804,3581,3511,31,70,"IULV-CA, UP",139
11,"11031",76452,51850,51456,568,394,"IULV-CA, UP",2095
11,"11015",62337,40342,40012,407,330,"IULV-CA, UP",1884
11,"11006",24504,16649,16486,176,163,"IULV-CA, UP",662
11,"11018",1485,1109,1090,10,19,"IULV-CA, UP",35
11,"11020",165400,113865,113092,1184,773,"IULV-CA, UP",6148
11,"11010",6420,4423,4362,63,61,"IULV-CA, UP",394
11,"11023",9354,6990,6928,86,62,"IULV-CA, UP",1100
11,"11003",1270,907,899,12,8,"IULV-CA, UP",47
11,"11032",53898,32432,32172,371,260,"IULV-CA, UP",2633
11,"11029",5433,3112,3067,27,45,"IULV-CA, UP",395
11,"11036",694,439,437,13,2,"IULV-CA, UP",41
11,"11021",6777,4826,4779,52,47,"IULV-CA, UP",442
11,"11901",5653,4132,4088,84,44,"IULV-CA, UP",295
47,"47122",2034,1666,1635,21,31,"PCPE",2
47,"47103",259,211,211,4,0,"PCPE",0
47,"47170",36,30,29,2,1,"PCPE",0
47,"47026",49,40,40,0,0,"PCPE",0
47,"47012",118,95,95,0,0,"PCPE",0
47,"47041",149,124,123,2,1,"PCPE",0
47,"47081",47,40,40,0,0,"PCPE",0
47,"47186",246602,193774,192412,1384,1362,"PCPE",247
47,"47035",930,745,739,10,6,"PCPE",2
47,"47187",89,57,56,2,1,"PCPE",0
47,"47162",73,61,61,0,0,"PCPE",0
47,"47044",330,291,287,0,4,"PCPE",0
47,"47029",57,48,47,1,1,"PCPE",0
47,"47166",265,203,199,3,4,"PCPE",0
47,"47126",49,36,36,0,0,"PCPE",0
47,"47195",461,348,348,3,0,"PCPE",1
47,"47036",229,184,179,2,5,"PCPE",0
47,"47204",260,199,193,2,6,"PCPE",0
47,"47025",120,97,97,2,0,"PCPE",0
47,"47211",49,39,37,1,2,"PCPE",2
47,"47057",248,194,194,2,0,"PCPE",0
47,"47133",2665,2140,2118,25,22,"PCPE",2
47,"47097",331,268,263,1,5,"PCPE",1
47,"47173",883,686,675,4,11,"PCPE",1
47,"47032",153,120,118,0,2,"PCPE",0
47,"47217",1896,1436,1420,20,16,"PCPE",1
47,"47018",35,31,28,0,3,"PCPE",0
47,"47087",379,318,314,4,4,"PCPE",0
47,"47001",55,51,50,2,1,"PCPE",0
47,"47061",258,216,214,2,2,"PCPE",0
47,"47077",247,190,189,2,1,"PCPE",0
47,"47100",140,119,117,2,2,"PCPE",0
47,"47135",84,76,76,2,0,"PCPE",0
47,"47165",6987,5301,5115,63,186,"PCPE",13
47,"47207",277,216,212,3,4,"PCPE",0
47,"47174",275,222,218,2,4,"PCPE",0
47,"47216",115,101,99,2,2,"PCPE",0
47,"47158",906,686,668,3,18,"PCPE",0
47,"47213",115,83,83,0,0,"PCPE",0
47,"47071",417,348,344,2,4,"PCPE",0
47,"47164",377,309,307,2,2,"PCPE",2
47,"47180",83,64,64,1,0,"PCPE",0
47,"47189",152,128,128,0,0,"PCPE",0
47,"47153",108,74,73,1,1,"PCPE",0
47,"47205",385,281,274,7,7,"PCPE",0
47,"47157",515,442,441,3,1,"PCPE",0
47,"47056",82,58,57,0,1,"PCPE",0
47,"47188",112,85,85,0,0,"PCPE",0
47,"47127",135,98,96,1,2,"PCPE",1
47,"47019",86,67,65,1,2,"PCPE",0
47,"47070",41,32,32,1,0,"PCPE",0
47,"47002",25,23,23,0,0,"PCPE",0
47,"47160",430,334,329,5,5,"PCPE",1
47,"47048",190,140,138,0,2,"PCPE",0
47,"47093",817,654,642,9,12,"PCPE",0
47,"47131",178,132,131,3,1,"PCPE",0
47,"47073",120,98,97,1,1,"PCPE",0
47,"47053",116,96,96,1,0,"PCPE",0
47,"47178",175,146,146,1,0,"PCPE",1
47,"47014",50,45,45,0,0,"PCPE",0
47,"47082",803,641,633,5,8,"PCPE",1
47,"47128",60,51,49,1,2,"PCPE",0
47,"47099",152,128,127,1,1,"PCPE",0
47,"47221",109,91,91,0,0,"PCPE",0
47,"47110",455,363,357,3,6,"PCPE",0
47,"47105",192,164,163,0,1,"PCPE",0
47,"47190",93,80,78,4,2,"PCPE",0
47,"47085",16668,12248,12132,133,116,"PCPE",13
47,"47047",202,157,157,3,0,"PCPE",0
47,"47058",206,149,149,2,0,"PCPE",0
47,"47006",190,145,144,1,1,"PCPE",0
47,"47050",3757,2829,2812,29,17,"PCPE",4
47,"47222",80,68,68,3,0,"PCPE",0
47,"47159",828,654,646,0,8,"PCPE",0
47,"47156",169,137,135,1,2,"PCPE",1
47,"47185",98,79,79,0,0,"PCPE",0
47,"47154",155,128,127,0,1,"PCPE",0
47,"47200",82,64,64,1,0,"PCPE",0
47,"47191",110,74,74,0,0,"PCPE",0
47,"47021",76,65,65,1,0,"PCPE",0
47,"47027",2746,2120,2095,8,25,"PCPE",3
47,"47078",164,129,124,1,5,"PCPE",0
47,"47168",31,28,27,0,1,"PCPE",0
47,"47004",1199,946,938,11,8,"PCPE",2
47,"47045",768,586,580,0,6,"PCPE",1
47,"47142",148,114,113,0,1,"PCPE",0
47,"47098",583,488,487,6,1,"PCPE",0
47,"47163",299,236,235,6,1,"PCPE",0
47,"47005",548,426,421,4,5,"PCPE",0
47,"47084",1171,911,898,15,13,"PCPE",1
47,"47075",4871,3802,3763,30,39,"PCPE",4
47,"47101",1720,1404,1388,10,16,"PCPE",2
47,"47130",99,78,78,1,0,"PCPE",0
47,"47060",262,218,214,0,4,"PCPE",0
47,"47008",24,18,18,0,0,"PCPE",0
47,"47143",127,99,99,0,0,"PCPE",0
47,"47192",105,80,79,1,1,"PCPE",0
47,"47218",995,760,754,6,6,"PCPE",1
47,"47155",3239,2400,2374,27,26,"PCPE",5
47,"47209",42,30,30,1,0,"PCPE",0
47,"47193",1583,1313,1294,12,19,"PCPE",4
47,"47049",100,78,78,1,0,"PCPE",0
47,"47096",135,108,107,2,1,"PCPE",1
47,"47215",54,47,46,1,1,"PCPE",0
47,"47196",35,26,26,1,0,"PCPE",0
47,"47003",228,180,179,3,1,"PCPE",0
47,"47009",106,80,80,1,0,"PCPE",0
47,"47052",6584,5222,5163,41,59,"PCPE",8
47,"47179",398,299,295,3,4,"PCPE",1
47,"47088",110,87,87,0,0,"PCPE",0
47,"47224",91,74,74,1,0,"PCPE",0
47,"47144",78,66,65,2,1,"PCPE",0
47,"47116",413,330,324,1,6,"PCPE",0
47,"47171",418,333,332,9,1,"PCPE",0
47,"47194",301,242,239,1,3,"PCPE",0
47,"47197",888,693,687,10,6,"PCPE",2
47,"47089",153,122,120,2,2,"PCPE",0
47,"47208",59,38,37,3,1,"PCPE",0
47,"47117",297,219,216,4,3,"PCPE",1
47,"47007",3748,2869,2835,24,34,"PCPE",0
47,"47024",262,206,205,2,1,"PCPE",2
47,"47062",163,131,131,0,0,"PCPE",0
47,"47106",50,41,41,0,0,"PCPE",0
47,"47145",611,451,449,4,2,"PCPE",1
47,"47114",4074,2868,2826,20,42,"PCPE",3
47,"47010",13613,10963,10895,108,68,"PCPE",10
47,"47033",199,154,153,3,1,"PCPE",0
47,"47118",161,119,118,0,1,"PCPE",0
47,"47214",1420,1111,1093,9,18,"PCPE",1
47,"47063",101,82,81,2,1,"PCPE",0
47,"47034",76,59,58,1,1,"PCPE",0
47,"47172",148,120,120,1,0,"PCPE",0
47,"47104",2857,2313,2253,19,60,"PCPE",3
47,"47109",171,131,130,1,1,"PCPE",0
47,"47198",66,47,47,0,0,"PCPE",0
47,"47037",174,146,141,2,5,"PCPE",0
47,"47137",29,28,28,1,0,"PCPE",0
47,"47169",68,57,57,0,0,"PCPE",0
47,"47090",2418,1805,1776,17,29,"PCPE",4
47,"47167",242,201,197,3,4,"PCPE",0
47,"47011",568,469,464,1,5,"PCPE",0
47,"47146",260,205,204,1,1,"PCPE",2
47,"47227",64,52,52,0,0,"PCPE",0
47,"47020",278,230,227,1,3,"PCPE",1
47,"47147",119,91,91,0,0,"PCPE",0
47,"47055",202,170,168,1,2,"PCPE",0
47,"47091",89,67,66,0,1,"PCPE",0
47,"47119",90,75,75,1,0,"PCPE",0
47,"47199",80,59,59,2,0,"PCPE",0
47,"47138",237,180,176,1,4,"PCPE",0
47,"47038",108,82,82,0,0,"PCPE",0
47,"47219",42,36,34,2,2,"PCPE",0
47,"47074",150,125,125,1,0,"PCPE",0
47,"47210",372,289,286,1,3,"PCPE",3
47,"47064",31,29,28,2,1,"PCPE",0
47,"47139",1047,790,785,7,5,"PCPE",2
47,"47129",879,700,688,6,12,"PCPE",0
47,"47225",81,61,60,2,1,"PCPE",0
47,"47182",1342,1037,1023,16,14,"PCPE",1
47,"47080",30,22,22,0,0,"PCPE",0
47,"47228",445,359,357,4,2,"PCPE",1
47,"47030",1006,785,770,10,15,"PCPE",2
47,"47083",80,62,61,2,1,"PCPE",0
47,"47111",1009,794,789,4,5,"PCPE",2
47,"47013",99,74,73,0,1,"PCPE",0
47,"47022",57,50,46,0,4,"PCPE",0
47,"47092",110,93,92,0,1,"PCPE",0
47,"47051",338,274,272,0,2,"PCPE",1
47,"47028",33,20,20,0,0,"PCPE",0
47,"47121",553,436,428,5,8,"PCPE",2
47,"47054",638,501,496,6,5,"PCPE",0
47,"47183",130,105,105,0,0,"PCPE",0
47,"47226",161,128,127,1,1,"PCPE",0
47,"47066",1255,1005,996,7,9,"PCPE",0
47,"47031",186,145,144,1,1,"PCPE",0
47,"47140",119,101,100,1,1,"PCPE",0
47,"47220",166,124,124,1,0,"PCPE",0
47,"47181",168,135,134,0,1,"PCPE",0
47,"47076",17375,13778,13684,111,94,"PCPE",20
47,"47079",62,51,51,0,0,"PCPE",0
47,"47175",6575,4991,4937,51,54,"PCPE",13
47,"47203",67,54,54,0,0,"PCPE",0
47,"47229",215,151,150,1,1,"PCPE",0
47,"47040",63,52,51,1,1,"PCPE",0
47,"47230",302,243,241,0,2,"PCPE",0
47,"47184",576,463,462,2,1,"PCPE",0
47,"47212",388,322,322,3,0,"PCPE",0
47,"47102",286,229,224,1,5,"PCPE",0
47,"47023",2999,2457,2445,20,12,"PCPE",5
47,"47113",156,121,121,0,0,"PCPE",0
47,"47094",132,103,101,1,2,"PCPE",1
47,"47132",45,37,35,0,2,"PCPE",0
47,"47141",134,102,101,1,1,"PCPE",0
47,"47176",224,139,135,5,4,"PCPE",0
47,"47150",278,217,214,2,3,"PCPE",4
47,"47123",469,395,386,4,9,"PCPE",0
47,"47015",199,151,151,0,0,"PCPE",0
47,"47148",439,336,335,2,1,"PCPE",1
47,"47067",178,126,126,3,0,"PCPE",0
47,"47065",863,681,671,4,10,"PCPE",0
47,"47177",107,78,76,0,2,"PCPE",1
47,"47059",97,71,71,0,0,"PCPE",1
47,"47086",3926,3065,3028,27,37,"PCPE",2
47,"47068",36,27,27,0,0,"PCPE",0
47,"47095",39,36,35,0,1,"PCPE",0
47,"47016",71,58,57,0,1,"PCPE",0
47,"47231",4384,3457,3432,33,25,"PCPE",3
47,"47042",54,41,41,3,0,"PCPE",0
47,"47124",399,329,328,4,1,"PCPE",0
47,"47223",158,129,125,3,4,"PCPE",0
47,"47039",188,149,148,1,1,"PCPE",0
47,"47151",27,22,21,0,1,"PCPE",0
47,"47112",2592,2063,2043,20,20,"PCPE",0
47,"47115",287,238,237,4,1,"PCPE",1
47,"47069",127,113,111,0,2,"PCPE",0
47,"47206",95,81,81,0,0,"PCPE",0
47,"47017",201,161,158,3,3,"PCPE",0
47,"47149",43,33,32,1,1,"PCPE",0
47,"47152",86,64,64,1,0,"PCPE",0
47,"47046",121,93,93,0,0,"PCPE",0
47,"47125",59,43,43,1,0,"PCPE",0
47,"47232",99,75,74,0,1,"PCPE",0
47,"47161",3903,3200,3183,25,17,"PCPE",1
47,"47134",164,126,119,4,7,"PCPE",0
47,"47043",302,239,239,3,0,"PCPE",1
38,"38031",28697,21546,21202,140,344,"UPYD",67
38,"38052",1281,853,844,2,9,"UPYD",1
38,"38012",2378,1620,1606,6,14,"UPYD",6
38,"38032",13257,8969,8902,72,67,"UPYD",67
38,"38029",1533,776,763,7,13,"UPYD",6
38,"38001",20166,11307,11195,55,112,"UPYD",37
38,"38042",3784,2692,2673,16,19,"UPYD",1
38,"38051",7217,5147,5089,31,58,"UPYD",12
38,"38002",942,701,674,14,27,"UPYD",2
38,"38048",3878,2664,2624,20,40,"UPYD",5
38,"38046",9107,6755,6682,45,73,"UPYD",47
38,"38049",2653,1683,1658,8,25,"UPYD",4
38,"38010",4014,2726,2678,15,48,"UPYD",7
38,"38015",4158,2864,2818,12,46,"UPYD",4
38,"38025",6860,4836,4761,49,75,"UPYD",16
38,"38014",1351,935,929,3,6,"UPYD",4
38,"38003",1440,970,960,2,10,"UPYD",4
38,"38027",5386,3685,3615,29,70,"UPYD",10
38,"38053",3754,2419,2370,15,49,"UPYD",11
38,"38020",15021,9813,9693,51,120,"UPYD",25
38,"38023",121610,81337,80453,527,884,"UPYD",442
38,"38013",2915,1865,1847,12,18,"UPYD",3
38,"38004",4442,2980,2939,20,41,"UPYD",10
38,"38033",3721,2552,2504,15,48,"UPYD",4
38,"38022",18468,12230,12085,86,145,"UPYD",23
38,"38045",3987,2152,2132,23,20,"UPYD",3
38,"38026",32918,24984,24727,174,257,"UPYD",55
38,"38019",13217,8168,8075,54,93,"UPYD",17
38,"38005",5463,3443,3417,24,26,"UPYD",8
38,"38018",4405,3053,3005,21,48,"UPYD",3
38,"38007",1689,1143,1119,3,24,"UPYD",1
38,"38047",1789,1228,1208,5,20,"UPYD",3
38,"38024",15055,9612,9485,77,127,"UPYD",24
38,"38034",4041,2853,2814,17,39,"UPYD",6
38,"38008",5513,3683,3609,17,74,"UPYD",10
38,"38006",39553,21159,20940,124,219,"UPYD",72
38,"38035",9299,5558,5500,35,58,"UPYD",25
38,"38037",12997,8126,7997,46,129,"UPYD",30
38,"38011",20435,13760,13627,82,133,"UPYD",83
38,"38017",28037,16236,16076,100,160,"UPYD",75
38,"38050",2471,1616,1590,8,26,"UPYD",5
38,"38028",22063,15095,14954,89,141,"UPYD",58
38,"38030",1923,1309,1300,5,9,"UPYD",1
38,"38036",6553,4604,4529,45,75,"UPYD",7
38,"38039",10584,7532,7462,77,70,"UPYD",40
38,"38043",18918,12883,12737,109,146,"UPYD",68
38,"38038",162030,105122,104174,667,948,"UPYD",641
38,"38021",1643,1014,1002,5,12,"UPYD",2
38,"38009",4127,2842,2793,15,49,"UPYD",15
38,"38901",1387,883,876,4,7,"UPYD",2
38,"38040",4990,3061,3031,16,30,"UPYD",10
38,"38044",2206,1317,1303,10,14,"UPYD",0
38,"38041",6808,4869,4835,42,34,"UPYD",27
38,"38016",1215,654,641,4,13,"UPYD",0
36,"36022",9056,6635,6514,48,121,"NÓS",430
36,"36014",1980,1464,1442,7,22,"NÓS",36
36,"36019",1625,1127,1119,12,8,"NÓS",44
36,"36047",2492,1719,1704,16,15,"NÓS",162
36,"36034",3477,2499,2470,15,29,"NÓS",257
36,"36028",4139,3094,3045,22,49,"NÓS",162
36,"36006",11537,8885,8740,79,145,"NÓS",686
36,"36060",30350,22032,21753,193,279,"NÓS",928
36,"36046",4055,3189,3139,30,50,"NÓS",136
36,"36017",17866,13133,12910,137,223,"NÓS",666
36,"36009",4908,3167,3114,25,53,"NÓS",59
36,"36055",13643,10361,10145,106,216,"NÓS",529
36,"36008",21736,16270,16094,160,176,"NÓS",1022
36,"36020",2351,1748,1721,20,27,"NÓS",45
36,"36042",17922,12993,12760,116,233,"NÓS",682
36,"36001",2593,1968,1952,6,16,"NÓS",51
36,"36045",24570,18613,18365,184,248,"NÓS",758
36,"36057",236957,177555,175758,1730,1797,"NÓS",5092
36,"36039",15350,11581,11349,119,232,"NÓS",452
36,"36048",5348,3970,3892,44,78,"NÓS",323
36,"36050",7562,5567,5457,44,110,"NÓS",310
36,"36040",2600,1907,1869,13,38,"NÓS",103
36,"36003",9979,7496,7401,81,95,"NÓS",253
36,"36002",3151,2290,2255,19,35,"NÓS",213
36,"36007",1689,1168,1148,12,20,"NÓS",28
36,"36043",4736,3347,3297,22,50,"NÓS",143
36,"36029",16129,12262,12078,101,184,"NÓS",1028
36,"36033",12347,9515,9336,76,179,"NÓS",353
36,"36038",66390,49943,49439,522,504,"NÓS",3203
36,"36901",4095,3344,3293,22,51,"NÓS",134
36,"36053",5693,4321,4265,41,56,"NÓS",501
36,"36037",2607,1862,1838,16,24,"NÓS",65
36,"36013",2412,1602,1586,12,16,"NÓS",49
36,"36035",14430,10832,10680,86,152,"NÓS",285
36,"36051",14272,10230,10072,95,158,"NÓS",461
36,"36059",4937,3379,3318,46,61,"NÓS",153
36,"36036",2511,1923,1892,17,31,"NÓS",72
36,"36015",4205,2941,2885,32,56,"NÓS",149
36,"36026",20203,14399,14189,144,210,"NÓS",706
36,"36027",4452,3328,3274,23,54,"NÓS",91
36,"36032",3655,2745,2699,21,46,"NÓS",207
36,"36012",3735,2818,2777,21,41,"NÓS",82
36,"36058",4992,3495,3441,48,54,"NÓS",255
36,"36010",2862,2195,2177,18,18,"NÓS",152
36,"36004",10178,7351,7224,69,127,"NÓS",614
36,"36018",3272,2288,2262,17,26,"NÓS",91
36,"36052",7298,5298,5175,37,123,"NÓS",268
36,"36041",13428,9842,9710,96,132,"NÓS",494
36,"36005",8120,5839,5747,64,92,"NÓS",275
36,"36031",558,464,454,9,10,"NÓS",50
36,"36030",4220,3041,2994,32,47,"NÓS",217
36,"36011",1842,1185,1169,9,16,"NÓS",22
36,"36023",8420,6287,6180,55,107,"NÓS",485
36,"36025",2292,1396,1389,9,7,"NÓS",27
36,"36016",1173,724,716,7,8,"NÓS",52
36,"36024",16433,12239,12016,115,223,"NÓS",604
36,"36054",10996,8116,7965,84,151,"NÓS",710
36,"36021",12033,9035,8879,99,156,"NÓS",327
36,"36049",6761,5193,5069,54,124,"NÓS",231
36,"36056",5108,3856,3783,34,73,"NÓS",109
36,"36061",8651,6594,6445,58,149,"NÓS",233
36,"36044",2556,1786,1747,13,39,"NÓS",72
41,"41001",1597,1262,1248,5,14,"IULV-CA, UP",67
41,"41092",7749,5715,5647,57,68,"IULV-CA, UP",223
41,"41102",14635,10904,10655,148,249,"IULV-CA, UP",854
41,"41029",13423,9979,9880,84,99,"IULV-CA, UP",421
41,"41010",4394,3203,3160,19,43,"IULV-CA, UP",311
41,"41057",275,193,191,0,2,"IULV-CA, UP",5
41,"41038",99637,71611,71050,727,561,"IULV-CA, UP",3787
41,"41085",4086,3223,3178,31,45,"IULV-CA, UP",126
41,"41039",31674,23240,22982,196,258,"IULV-CA, UP",1014
41,"41067",7115,5248,5178,46,70,"IULV-CA, UP",304
41,"41014",2510,1981,1958,8,23,"IULV-CA, UP",375
41,"41064",5601,3766,3715,42,51,"IULV-CA, UP",140
41,"41082",3432,2809,2781,12,28,"IULV-CA, UP",350
41,"41011",15395,11527,11341,114,186,"IULV-CA, UP",1227
41,"41008",1063,820,805,3,15,"IULV-CA, UP",41
41,"41045",5749,4121,4066,49,55,"IULV-CA, UP",541
41,"41030",516,409,395,2,14,"IULV-CA, UP",28
41,"41089",6504,4759,4691,51,68,"IULV-CA, UP",397
41,"41033",5102,3655,3613,25,42,"IULV-CA, UP",68
41,"41901",2676,2222,2190,31,32,"IULV-CA, UP",76
41,"41040",10411,7959,7892,53,67,"IULV-CA, UP",364
41,"41002",1469,1085,1061,12,24,"IULV-CA, UP",41
41,"41086",16102,10743,10665,93,78,"IULV-CA, UP",478
41,"41094",6288,4726,4653,36,73,"IULV-CA, UP",206
41,"41031",1257,838,836,8,2,"IULV-CA, UP",42
41,"41071",5620,3974,3898,17,76,"IULV-CA, UP",482
41,"41097",3135,2339,2317,19,22,"IULV-CA, UP",51
41,"41077",8728,6423,6308,28,115,"IULV-CA, UP",590
41,"41902",4675,3051,3019,20,32,"IULV-CA, UP",161
41,"41087",10202,7160,7033,51,127,"IULV-CA, UP",351
41,"41022",4300,2918,2891,30,27,"IULV-CA, UP",393
41,"41095",41137,28987,28731,302,256,"IULV-CA, UP",1065
41,"41090",3541,2774,2721,17,53,"IULV-CA, UP",294
41,"41037",3203,2473,2449,18,24,"IULV-CA, UP",323
41,"41006",2740,1909,1897,13,12,"IULV-CA, UP",44
41,"41003",2319,1782,1754,8,28,"IULV-CA, UP",64
41,"41047",10086,7758,7663,80,95,"IULV-CA, UP",357
41,"41072",4052,3115,3041,18,74,"IULV-CA, UP",379
41,"41050",5158,4123,4078,37,45,"IULV-CA, UP",190
41,"41078",2522,1888,1874,5,14,"IULV-CA, UP",184
41,"41060",15279,10611,10447,91,164,"IULV-CA, UP",560
41,"41069",29070,20827,20558,355,269,"IULV-CA, UP",2585
41,"41096",6166,4811,4752,39,59,"IULV-CA, UP",313
41,"41032",4019,2943,2875,17,68,"IULV-CA, UP",156
41,"41004",56552,40018,39623,515,395,"IULV-CA, UP",2226
41,"41903",6747,4926,4854,43,72,"IULV-CA, UP",279
41,"41070",6021,4504,4456,44,48,"IULV-CA, UP",307
41,"41036",3971,2846,2806,14,40,"IULV-CA, UP",77
41,"41079",9343,7111,7029,68,82,"IULV-CA, UP",367
41,"41017",15052,11074,10964,99,110,"IULV-CA, UP",464
41,"41055",15009,10393,10292,82,101,"IULV-CA, UP",484
41,"41091",541928,401177,398212,3487,2965,"IULV-CA, UP",19264
41,"41062",2235,1805,1790,10,15,"IULV-CA, UP",160
41,"41058",17304,12982,12751,133,231,"IULV-CA, UP",728
41,"41081",29164,21631,21410,218,221,"IULV-CA, UP",1369
41,"41015",5310,3799,3710,38,89,"IULV-CA, UP",139
41,"41049",9301,7147,7070,63,77,"IULV-CA, UP",853
41,"41005",9057,6781,6693,58,88,"IULV-CA, UP",644
41,"41034",23033,15936,15711,189,225,"IULV-CA, UP",834
41,"41021",21249,15031,14854,152,177,"IULV-CA, UP",752
41,"41027",3941,2766,2709,28,57,"IULV-CA, UP",279
41,"41025",2041,1456,1430,17,26,"IULV-CA, UP",153
41,"41024",22662,15742,15521,137,221,"IULV-CA, UP",831
41,"41043",636,439,435,3,4,"IULV-CA, UP",39
41,"41016",7310,5473,5410,50,63,"IULV-CA, UP",466
41,"41075",10225,7387,7283,55,104,"IULV-CA, UP",476
41,"41009",1229,811,803,5,8,"IULV-CA, UP",15
41,"41007",12386,8552,8403,90,149,"IULV-CA, UP",737
41,"41054",688,587,570,2,17,"IULV-CA, UP",19
41,"41098",4952,3762,3704,24,58,"IULV-CA, UP",144
41,"41073",1715,1194,1169,9,25,"IULV-CA, UP",45
41,"41019",4654,3267,3224,34,43,"IULV-CA, UP",159
41,"41018",9490,6997,6930,45,67,"IULV-CA, UP",498
41,"41056",3691,3069,3042,21,27,"IULV-CA, UP",149
41,"41044",7392,5562,5526,40,36,"IULV-CA, UP",258
41,"41074",3033,2362,2341,8,21,"IULV-CA, UP",290
41,"41051",2170,1650,1611,8,39,"IULV-CA, UP",40
41,"41063",2683,1942,1922,21,20,"IULV-CA, UP",43
41,"41046",3017,2416,2381,12,35,"IULV-CA, UP",221
41,"41048",2244,1625,1598,22,27,"IULV-CA, UP",39
41,"41100",1025,770,751,5,19,"IULV-CA, UP",35
41,"41083",1154,893,888,3,5,"IULV-CA, UP",15
41,"41099",3998,2597,2577,19,20,"IULV-CA, UP",89
41,"41052",3006,2264,2209,8,55,"IULV-CA, UP",114
41,"41013",4842,3491,3461,22,30,"IULV-CA, UP",478
41,"41023",7919,5852,5788,34,64,"IULV-CA, UP",249
41,"41101",5932,4454,4421,27,33,"IULV-CA, UP",221
41,"41028",1971,1574,1562,11,12,"IULV-CA, UP",102
41,"41076",2184,1442,1432,19,10,"IULV-CA, UP",130
41,"41065",22868,15933,15784,172,149,"IULV-CA, UP",625
41,"41061",2218,1769,1742,5,27,"IULV-CA, UP",568
41,"41088",518,381,377,0,4,"IULV-CA, UP",12
41,"41012",3286,2268,2235,15,33,"IULV-CA, UP",61
41,"41053",21252,16022,15770,121,252,"IULV-CA, UP",1018
41,"41084",2850,2205,2157,15,48,"IULV-CA, UP",104
41,"41059",33977,26158,25965,230,193,"IULV-CA, UP",1366
41,"41020",12872,8820,8723,92,97,"IULV-CA, UP",497
41,"41066",1363,1019,1007,7,12,"IULV-CA, UP",43
41,"41080",1270,954,938,8,16,"IULV-CA, UP",32
41,"41093",18487,14687,14594,117,93,"IULV-CA, UP",600
41,"41068",13948,10269,10150,75,119,"IULV-CA, UP",381
41,"41026",4325,3551,3516,18,35,"IULV-CA, UP",858
41,"41042",5868,4612,4583,37,29,"IULV-CA, UP",412
41,"41041",9743,7620,7482,39,138,"IULV-CA, UP",259
41,"41035",1112,887,876,5,11,"IULV-CA, UP",22
33,"33031",35453,23848,23595,242,253,"PH",18
33,"33015",1561,1042,1031,8,11,"PH",0
33,"33049",6388,4229,4182,48,47,"PH",2
33,"33036",11572,8208,8133,80,75,"PH",3
33,"33012",5230,3595,3568,27,27,"PH",2
33,"33003",665,386,384,7,2,"PH",0
33,"33011",11373,6279,6214,104,65,"PH",8
33,"33052",730,517,512,1,5,"PH",0
33,"33050",603,374,357,0,17,"PH",0
33,"33053",1157,767,762,12,5,"PH",1
33,"33041",7270,5138,5093,53,45,"PH",4
33,"33032",11483,8036,7921,82,115,"PH",8
33,"33072",1601,1012,1002,4,10,"PH",0
33,"33059",4702,3228,3185,42,43,"PH",3
33,"33023",3315,2295,2267,35,28,"PH",1
33,"33025",9261,6116,6062,58,54,"PH",2
33,"33027",849,544,543,8,1,"PH",0
33,"33043",682,465,460,2,5,"PH",0
33,"33035",11299,8048,7981,67,67,"PH",3
33,"33048",156,99,99,2,0,"PH",0
33,"33058",1821,1319,1305,10,14,"PH",1
33,"33067",785,608,598,5,10,"PH",0
33,"33030",899,689,687,10,2,"PH",0
33,"33020",13297,9527,9445,86,82,"PH",11
33,"33060",14750,10307,10206,82,101,"PH",7
33,"33038",2298,1690,1675,12,15,"PH",0
33,"33057",1593,1134,1123,17,11,"PH",0
33,"33006",1556,1043,1036,17,7,"PH",0
33,"33069",3513,2577,2554,15,23,"PH",1
33,"33046",508,375,365,4,10,"PH",1
33,"33042",4316,3143,3105,35,38,"PH",2
33,"33017",3180,2196,2168,30,28,"PH",1
33,"33064",231,181,179,4,2,"PH",0
33,"33018",2896,2068,2041,18,27,"PH",2
33,"33034",10693,6796,6725,72,71,"PH",5
33,"33055",1511,1150,1129,9,21,"PH",3
33,"33026",8621,5600,5555,71,45,"PH",2
33,"33063",419,330,326,1,4,"PH",0
33,"33066",43034,29901,29610,261,291,"PH",26
33,"33054",1688,1159,1146,8,13,"PH",0
33,"33070",3347,2473,2441,31,32,"PH",0
33,"33040",4564,3125,3091,28,34,"PH",2
33,"33065",1109,743,735,16,8,"PH",0
33,"33077",1220,849,840,11,9,"PH",0
33,"33021",4576,3133,3090,33,43,"PH",5
33,"33022",906,604,599,3,5,"PH",0
33,"33056",5015,3435,3405,32,30,"PH",3
33,"33004",67136,48699,48354,389,345,"PH",21
33,"33001",1622,867,852,16,15,"PH",2
33,"33014",9101,6398,6352,46,46,"PH",3
33,"33075",275,161,155,2,6,"PH",0
33,"33029",363,199,198,1,1,"PH",0
33,"33071",617,459,452,8,7,"PH",0
33,"33010",1828,1220,1215,16,5,"PH",2
33,"33028",1289,685,682,9,3,"PH",0
33,"33045",4503,3249,3216,26,33,"PH",1
33,"33039",1672,1261,1257,14,4,"PH",0
33,"33019",3094,2079,2054,15,25,"PH",1
33,"33033",9943,6851,6803,61,48,"PH",8
33,"33037",34841,24271,24054,200,217,"PH",15
33,"33016",19201,14177,14074,115,103,"PH",5
33,"33073",8631,5015,4948,47,67,"PH",2
33,"33005",1479,945,932,12,13,"PH",1
33,"33007",1524,991,980,10,11,"PH",0
33,"33074",3523,2422,2390,36,32,"PH",0
33,"33061",379,194,190,1,4,"PH",1
33,"33076",12270,8265,8203,89,62,"PH",2
33,"33009",899,606,601,4,5,"PH",0
33,"33068",1114,627,623,2,4,"PH",0
33,"33078",147,98,98,0,0,"PH",0
33,"33008",1808,1268,1247,6,21,"PH",3
33,"33047",1126,868,861,12,7,"PH",0
33,"33024",227211,166618,165475,1240,1143,"PH",102
33,"33044",178724,130938,130010,1254,928,"PH",83
33,"33002",10122,7056,6977,55,79,"PH",3
33,"33013",456,336,331,6,5,"PH",0
33,"33062",409,242,239,1,3,"PH",0
33,"33051",7167,4810,4772,57,38,"PH",4
27,"27054",1205,920,906,7,14,"NÓS",63
27,"27003",1913,1372,1351,16,21,"NÓS",30
27,"27029",1475,1142,1116,19,26,"NÓS",52
27,"27012",1366,778,769,5,9,"NÓS",20
27,"27064",1593,1179,1153,14,26,"NÓS",35
27,"27016",7204,5069,4987,65,82,"NÓS",133
27,"27901",2404,1647,1624,25,23,"NÓS",31
27,"27020",3539,2954,2896,38,58,"NÓS",38
27,"27050",2993,2241,2203,16,38,"NÓS",53
27,"27019",8120,6041,5936,82,105,"NÓS",302
27,"27056",1268,899,886,11,13,"NÓS",27
27,"27011",2490,1623,1592,14,31,"NÓS",72
27,"27021",1772,1167,1136,21,31,"NÓS",71
27,"27005",2615,1942,1918,16,24,"NÓS",267
27,"27052",918,659,649,3,10,"NÓS",7
27,"27042",1759,1258,1235,21,23,"NÓS",9
27,"27025",2859,2293,2243,17,50,"NÓS",137
27,"27024",1624,1250,1226,8,24,"NÓS",46
27,"27014",3284,2187,2148,29,39,"NÓS",108
27,"27006",2611,1752,1723,26,29,"NÓS",20
27,"27059",2202,1640,1605,19,35,"NÓS",28
27,"27060",2651,1761,1729,12,32,"NÓS",105
27,"27049",1422,969,958,8,11,"NÓS",26
27,"27040",3225,2454,2415,22,39,"NÓS",64
27,"27055",1320,869,855,3,14,"NÓS",23
27,"27043",1313,875,855,14,20,"NÓS",35
27,"27047",1643,1116,1104,10,12,"NÓS",156
27,"27001",2401,1346,1313,24,33,"NÓS",27
27,"27026",2423,1667,1602,12,65,"NÓS",40
27,"27010",4363,3072,2990,45,82,"NÓS",114
27,"27032",3313,2269,2230,29,39,"NÓS",43
27,"27004",1251,846,828,2,18,"NÓS",12
27,"27045",1049,667,658,9,9,"NÓS",4
27,"27041",2377,1737,1722,16,15,"NÓS",99
27,"27028",79061,57271,56444,702,827,"NÓS",1731
27,"27008",1377,1011,992,11,19,"NÓS",29
27,"27902",7196,5017,4921,55,96,"NÓS",227
27,"27048",2176,1658,1626,19,32,"NÓS",41
27,"27046",1538,1119,1099,10,20,"NÓS",44
27,"27057",11176,7921,7709,99,212,"NÓS",278
27,"27007",2833,2211,2144,34,67,"NÓS",37
27,"27015",4304,3063,2985,41,78,"NÓS",91
27,"27009",2110,1595,1573,11,22,"NÓS",31
27,"27066",12767,9200,9039,102,161,"NÓS",337
27,"27062",619,468,465,6,3,"NÓS",5
27,"27037",1075,736,723,12,13,"NÓS",7
27,"27030",3361,2333,2290,27,43,"NÓS",107
27,"27044",2901,1891,1832,28,59,"NÓS",133
27,"27023",2593,1981,1942,24,39,"NÓS",36
27,"27013",3782,3067,3007,21,60,"NÓS",122
27,"27031",15650,10901,10710,106,191,"NÓS",304
27,"27051",8102,5883,5784,71,99,"NÓS",379
27,"27035",190,121,121,2,0,"NÓS",3
27,"27058",3577,2669,2632,37,37,"NÓS",95
27,"27017",1017,674,666,6,8,"NÓS",14
27,"27022",4859,3324,3251,38,73,"NÓS",110
27,"27027",1937,1458,1425,19,33,"NÓS",57
27,"27034",1154,720,710,6,10,"NÓS",21
27,"27065",12528,8701,8483,150,218,"NÓS",219
27,"27002",1651,1224,1200,8,24,"NÓS",26
27,"27053",546,349,349,1,0,"NÓS",17
27,"27063",1761,1340,1299,12,41,"NÓS",49
27,"27039",4372,3327,3244,56,83,"NÓS",200
27,"27033",631,454,449,8,5,"NÓS",52
27,"27018",3514,2279,2255,17,24,"NÓS",80
27,"27038",945,679,674,9,5,"NÓS",5
27,"27061",1045,821,796,10,25,"NÓS",24
50,"50138",46,41,41,0,0,"VOX",0
50,"50111",186,152,151,1,1,"VOX",1
50,"50291",100,69,69,0,0,"VOX",0
50,"50227",108,79,79,1,0,"VOX",0
50,"50170",378,286,283,2,3,"VOX",0
50,"50017",1772,1301,1293,7,8,"VOX",8
50,"50059",780,572,567,6,5,"VOX",4
50,"50034",838,572,569,5,3,"VOX",0
50,"50182",3352,2437,2409,26,28,"VOX",9
50,"50286",77,54,54,0,0,"VOX",0
50,"50063",61,57,57,0,0,"VOX",0
50,"50115",3248,2277,2262,31,15,"VOX",5
50,"50141",114,85,84,0,1,"VOX",0
50,"50116",190,142,140,1,2,"VOX",0
50,"50065",53,42,42,0,0,"VOX",0
50,"50232",171,120,118,0,2,"VOX",0
50,"50204",2457,1830,1816,14,14,"VOX",7
50,"50214",27,16,16,1,0,"VOX",0
50,"50267",605,424,420,4,4,"VOX",1
50,"50043",257,172,171,1,1,"VOX",0
50,"50195",53,38,38,0,0,"VOX",0
50,"50044",232,156,156,1,0,"VOX",0
50,"50189",712,574,559,4,15,"VOX",1
50,"50186",41,29,29,0,0,"VOX",0
50,"50197",92,71,71,2,0,"VOX",0
50,"50122",68,54,54,2,0,"VOX",0
50,"50010",69,57,57,0,0,"VOX",0
50,"50053",688,535,522,6,13,"VOX",0
50,"50200",509,406,404,6,2,"VOX",1
50,"50221",33,20,20,0,0,"VOX",0
50,"50064",440,350,349,5,1,"VOX",0
50,"50016",52,37,37,0,0,"VOX",0
50,"50238",97,74,73,0,1,"VOX",0
50,"50225",1568,996,985,2,11,"VOX",4
50,"50089",8144,6285,6249,50,36,"VOX",28
50,"50048",35,23,23,0,0,"VOX",0
50,"50079",254,186,184,3,2,"VOX",0
50,"50047",50,32,32,1,0,"VOX",0
50,"50296",398,297,293,2,4,"VOX",1
50,"50259",89,61,61,1,0,"VOX",0
50,"50254",181,130,129,2,1,"VOX",0
50,"50032",273,190,189,0,1,"VOX",0
50,"50022",543,410,398,8,12,"VOX",1
50,"50035",74,53,52,0,1,"VOX",0
50,"50156",214,173,170,2,3,"VOX",0
50,"50293",423,282,280,5,2,"VOX",1
50,"50237",103,73,73,2,0,"VOX",0
50,"50212",41,37,37,0,0,"VOX",1
50,"50104",351,283,282,3,1,"VOX",0
50,"50234",245,198,193,9,5,"VOX",0
50,"50220",46,32,32,0,0,"VOX",0
50,"50251",8300,6228,6167,62,61,"VOX",9
50,"50014",146,99,99,1,0,"VOX",0
50,"50217",455,334,334,1,0,"VOX",0
50,"50128",28,24,24,0,0,"VOX",0
50,"50283",72,55,54,0,1,"VOX",0
50,"50039",507,400,398,3,2,"VOX",0
50,"50006",939,712,701,8,11,"VOX",1
50,"50061",207,174,168,1,6,"VOX",0
50,"50130",395,252,252,1,0,"VOX",0
50,"50190",708,542,539,3,3,"VOX",0
50,"50902",87,78,78,1,0,"VOX",0
50,"50126",2388,1726,1708,22,18,"VOX",2
50,"50136",579,420,413,0,7,"VOX",0
50,"50018",948,717,712,6,5,"VOX",0
50,"50041",12,10,10,0,0,"VOX",0
50,"50203",1043,811,802,15,9,"VOX",7
50,"50278",198,145,144,1,1,"VOX",1
50,"50080",32,25,25,0,0,"VOX",0
50,"50072",174,124,122,2,2,"VOX",3
50,"50295",45,39,39,0,0,"VOX",0
50,"50258",56,34,34,1,0,"VOX",0
50,"50015",98,63,63,0,0,"VOX",0
50,"50012",108,86,83,1,3,"VOX",0
50,"50110",369,258,257,0,1,"VOX",0
50,"50246",41,29,29,0,0,"VOX",0
50,"50160",2245,1661,1648,10,13,"VOX",3
50,"50201",443,335,330,2,5,"VOX",0
50,"50132",755,573,564,7,9,"VOX",2
50,"50275",110,73,72,0,1,"VOX",0
50,"50152",1457,1032,1018,11,14,"VOX",6
50,"50013",224,187,186,3,1,"VOX",1
50,"50028",78,53,53,2,0,"VOX",0
50,"50106",135,105,104,0,1,"VOX",0
50,"50211",252,187,186,0,1,"VOX",1
50,"50003",126,93,92,3,1,"VOX",0
50,"50264",158,111,111,0,0,"VOX",0
50,"50030",225,156,156,2,0,"VOX",0
50,"50901",137,101,101,0,0,"VOX",0
50,"50085",176,131,129,3,2,"VOX",1
50,"50172",196,138,136,0,2,"VOX",0
50,"50024",589,461,459,4,2,"VOX",2
50,"50082",89,58,57,0,1,"VOX",0
50,"50271",256,187,184,4,3,"VOX",0
50,"50162",147,110,110,2,0,"VOX",0
50,"50157",301,211,207,2,4,"VOX",0
50,"50123",465,349,344,2,5,"VOX",0
50,"50228",270,211,210,5,1,"VOX",1
50,"50173",210,141,140,2,1,"VOX",0
50,"50119",930,698,691,7,7,"VOX",1
50,"50255",214,163,163,0,0,"VOX",0
50,"50004",534,406,401,0,5,"VOX",1
50,"50194",84,52,52,0,0,"VOX",0
50,"50224",69,55,55,1,0,"VOX",0
50,"50144",36,28,28,0,0,"VOX",0
50,"50073",2148,1649,1622,9,27,"VOX",2
50,"50176",228,158,157,0,1,"VOX",0
50,"50187",70,38,38,0,0,"VOX",0
50,"50031",161,90,88,1,2,"VOX",1
50,"50229",64,42,42,0,0,"VOX",0
50,"50113",618,506,496,4,10,"VOX",0
50,"50174",92,70,70,0,0,"VOX",0
50,"50084",79,56,56,1,0,"VOX",0
50,"50009",106,78,77,1,1,"VOX",0
50,"50026",442,358,353,6,5,"VOX",1
50,"50087",28,19,19,0,0,"VOX",0
50,"50260",35,32,32,0,0,"VOX",0
50,"50233",114,81,81,1,0,"VOX",0
50,"50067",14055,10236,10109,123,127,"VOX",32
50,"50071",131,90,90,0,0,"VOX",0
50,"50256",84,46,46,0,0,"VOX",0
50,"50129",245,164,164,1,0,"VOX",0
50,"50215",23,15,15,0,0,"VOX",0
50,"50068",1998,1388,1378,17,10,"VOX",0
50,"50294",73,58,58,0,0,"VOX",0
50,"50139",319,239,238,2,1,"VOX",1
50,"50033",75,65,65,0,0,"VOX",0
50,"50257",178,139,137,0,2,"VOX",0
50,"50133",117,88,88,3,0,"VOX",1
50,"50169",362,264,262,0,2,"VOX",2
50,"50075",81,59,59,1,0,"VOX",0
50,"50096",39,17,17,0,0,"VOX",0
50,"50159",670,511,501,5,10,"VOX",0
50,"50288",3371,2566,2547,26,19,"VOX",6
50,"50140",165,106,106,0,0,"VOX",0
50,"50245",90,60,60,1,0,"VOX",0
50,"50223",915,747,741,8,6,"VOX",1
50,"50027",227,177,176,1,1,"VOX",1
50,"50007",46,37,37,1,0,"VOX",0
50,"50268",47,40,39,0,1,"VOX",0
50,"50038",1511,1167,1159,13,8,"VOX",0
50,"50155",102,78,78,0,0,"VOX",0
50,"50248",521,407,406,1,1,"VOX",0
50,"50242",92,81,79,1,2,"VOX",0
50,"50056",406,325,324,2,1,"VOX",0
50,"50181",1003,750,737,9,13,"VOX",4
50,"50008",5085,3617,3574,30,43,"VOX",10
50,"50252",5178,3746,3711,36,35,"VOX",12
50,"50180",120,97,96,0,1,"VOX",0
50,"50090",156,112,111,0,1,"VOX",0
50,"50266",129,85,85,1,0,"VOX",0
50,"50276",129,108,107,0,1,"VOX",0
50,"50098",181,129,127,2,2,"VOX",0
50,"50146",190,137,137,5,0,"VOX",0
50,"50191",476,327,325,3,2,"VOX",0
50,"50208",1802,1349,1332,16,17,"VOX",4
50,"50298",5353,4051,4013,32,38,"VOX",13
50,"50142",30,21,21,0,0,"VOX",0
50,"50151",650,504,503,7,1,"VOX",2
50,"50284",151,115,113,0,2,"VOX",0
50,"50099",3087,2233,2216,15,17,"VOX",6
50,"50230",1176,853,849,11,4,"VOX",2
50,"50199",341,242,241,4,1,"VOX",1
50,"50143",569,414,411,4,3,"VOX",6
50,"50175",1025,745,739,6,6,"VOX",0
50,"50058",72,51,51,0,0,"VOX",0
50,"50147",788,577,576,4,1,"VOX",0
50,"50179",257,207,207,2,0,"VOX",0
50,"50247",827,624,615,10,9,"VOX",1
50,"50231",260,213,210,7,3,"VOX",0
50,"50092",298,256,251,3,5,"VOX",0
50,"50240",1034,749,737,10,12,"VOX",1
50,"50052",90,71,71,0,0,"VOX",0
50,"50249",312,235,233,1,2,"VOX",0
50,"50011",127,96,96,2,0,"VOX",0
50,"50137",1025,793,786,6,7,"VOX",0
50,"50093",94,73,73,1,0,"VOX",0
50,"50021",32,25,25,3,0,"VOX",0
50,"50292",132,103,103,0,0,"VOX",0
50,"50903",2225,1686,1669,21,17,"VOX",5
50,"50235",2323,1687,1675,7,12,"VOX",3
50,"50148",324,240,236,0,4,"VOX",0
50,"50290",387,288,287,4,1,"VOX",0
50,"50081",512,376,372,6,4,"VOX",2
50,"50253",423,328,327,1,1,"VOX",0
50,"50207",109,88,88,1,0,"VOX",1
50,"50114",124,94,94,2,0,"VOX",0
50,"50272",12913,9500,9415,80,85,"VOX",21
50,"50149",36,23,23,0,0,"VOX",0
50,"50184",113,82,82,0,0,"VOX",0
50,"50050",98,59,59,3,0,"VOX",0
50,"50002",148,105,102,0,3,"VOX",0
50,"50005",234,178,178,1,0,"VOX",2
50,"50205",91,69,65,1,4,"VOX",0
50,"50121",276,227,225,4,2,"VOX",0
50,"50178",302,197,196,9,1,"VOX",0
50,"50164",395,263,260,2,3,"VOX",2
50,"50281",80,57,56,0,1,"VOX",0
50,"50171",108,70,69,0,1,"VOX",1
50,"50202",158,96,92,1,4,"VOX",0
50,"50118",2179,1575,1564,7,11,"VOX",1
50,"50243",340,259,254,1,5,"VOX",0
50,"50020",822,560,555,5,5,"VOX",0
50,"50051",828,640,637,8,3,"VOX",1
50,"50274",71,50,49,1,1,"VOX",0
50,"50216",236,189,186,4,3,"VOX",0
50,"50219",4098,3010,2980,27,30,"VOX",7
50,"50192",236,185,183,2,2,"VOX",0
50,"50262",1187,931,930,13,1,"VOX",1
50,"50109",105,78,77,3,1,"VOX",0
50,"50287",274,197,195,4,2,"VOX",0
50,"50168",28,23,23,0,0,"VOX",0
50,"50037",139,92,91,1,1,"VOX",1
50,"50193",647,514,506,1,8,"VOX",0
50,"50076",81,64,64,0,0,"VOX",0
50,"50244",205,157,157,3,0,"VOX",2
50,"50163",3655,2766,2740,34,26,"VOX",12
50,"50045",1255,944,934,6,10,"VOX",3
50,"50108",47,37,37,0,0,"VOX",0
50,"50285",648,473,469,3,4,"VOX",1
50,"50105",304,228,228,3,0,"VOX",0
50,"50150",660,402,402,3,0,"VOX",1
50,"50046",176,123,123,7,0,"VOX",0
50,"50102",863,665,654,6,11,"VOX",0
50,"50078",244,192,189,1,3,"VOX",0
50,"50131",237,168,167,2,1,"VOX",0
50,"50025",4547,3335,3295,45,40,"VOX",9
50,"50054",59,45,45,0,0,"VOX",0
50,"50077",226,175,174,5,1,"VOX",0
50,"50167",232,194,193,0,1,"VOX",0
50,"50265",62,41,41,0,0,"VOX",0
50,"50001",115,81,80,0,1,"VOX",0
50,"50070",60,29,29,1,0,"VOX",0
50,"50060",176,138,136,0,2,"VOX",0
50,"50107",944,772,767,16,5,"VOX",4
50,"50057",1396,980,972,8,8,"VOX",0
50,"50165",1815,1333,1316,27,17,"VOX",3
50,"50036",103,79,79,0,0,"VOX",0
50,"50069",76,53,52,0,1,"VOX",0
50,"50241",593,426,418,1,8,"VOX",0
50,"50185",132,110,110,1,0,"VOX",0
50,"50250",55,44,44,0,0,"VOX",0
50,"50083",90,72,72,1,0,"VOX",0
50,"50029",627,469,468,4,1,"VOX",1
50,"50135",95,63,63,0,0,"VOX",0
50,"50177",315,251,249,3,2,"VOX",0
50,"50154",119,92,91,0,1,"VOX",0
50,"50196",108,83,82,1,1,"VOX",0
50,"50289",52,39,39,1,0,"VOX",0
50,"50239",64,47,47,1,0,"VOX",0
50,"50134",128,88,88,5,0,"VOX",1
50,"50166",260,192,189,2,3,"VOX",1
50,"50282",70,48,48,0,0,"VOX",0
50,"50117",125,91,90,1,1,"VOX",0
50,"50125",371,260,258,3,2,"VOX",1
50,"50088",305,234,229,11,5,"VOX",0
50,"50279",87,62,62,1,0,"VOX",0
50,"50042",16,13,13,0,0,"VOX",0
50,"50209",2560,1787,1774,12,13,"VOX",5
50,"50213",98,77,72,0,5,"VOX",0
50,"50019",54,41,41,0,0,"VOX",0
50,"50218",113,90,89,1,1,"VOX",0
50,"50188",30,23,19,0,4,"VOX",0
50,"50062",1810,1407,1389,12,18,"VOX",0
50,"50263",197,123,121,6,2,"VOX",0
50,"50120",49,36,36,3,0,"VOX",0
50,"50091",48,32,32,1,0,"VOX",0
50,"50261",215,159,159,1,0,"VOX",0
50,"50101",879,615,609,5,6,"VOX",1
50,"50270",38,24,24,2,0,"VOX",0
50,"50094",1626,1197,1178,22,19,"VOX",0
50,"50183",338,255,255,0,0,"VOX",3
50,"50269",288,185,183,0,2,"VOX",0
50,"50297",499531,377882,375565,3049,2317,"VOX",1473
50,"50074",6397,4512,4408,38,104,"VOX",10
50,"50206",466,379,376,2,3,"VOX",1
50,"50040",92,75,75,0,0,"VOX",0
50,"50095",12366,8938,8856,94,82,"VOX",15
50,"50086",184,128,128,1,0,"VOX",0
50,"50210",40,32,31,0,1,"VOX",0
50,"50161",117,76,76,0,0,"VOX",1
50,"50236",104,82,82,2,0,"VOX",0
50,"50277",55,43,43,1,0,"VOX",0
50,"50153",941,737,734,7,3,"VOX",0
50,"50055",3612,2533,2490,34,43,"VOX",4
50,"50066",2613,1956,1951,21,5,"VOX",11
50,"50273",31,18,18,0,0,"VOX",0
50,"50124",417,312,312,9,0,"VOX",0
50,"50100",333,263,261,5,2,"VOX",1
50,"50222",1647,1135,1118,8,17,"VOX",2
50,"50198",56,30,30,0,0,"VOX",0
50,"50280",340,260,258,0,2,"VOX",0
50,"50023",223,175,173,3,2,"VOX",0
46,"46105",16249,11731,11629,59,102,"PODEMOS-COM",2785
46,"46229",972,785,774,2,11,"PODEMOS-COM",191
46,"46022",15481,11422,11347,69,75,"PODEMOS-COM",3065
46,"46221",339,305,303,0,2,"PODEMOS-COM",75
46,"46017",33050,24762,24580,144,182,"PODEMOS-COM",6738
46,"46239",451,353,351,3,2,"PODEMOS-COM",44
46,"46258",2676,2099,2078,9,21,"PODEMOS-COM",420
46,"46210",338,295,283,2,12,"PODEMOS-COM",69
46,"46145",21946,16629,16495,80,134,"PODEMOS-COM",4414
46,"46172",5040,3629,3599,14,30,"PODEMOS-COM",1025
46,"46002",1175,947,935,5,12,"PODEMOS-COM",327
46,"46237",7227,5620,5571,33,49,"PODEMOS-COM",1551
46,"46231",2411,1759,1735,11,24,"PODEMOS-COM",600
46,"46215",1433,1152,1149,4,3,"PODEMOS-COM",449
46,"46220",48393,35859,35571,250,288,"PODEMOS-COM",11338
46,"46089",2141,1649,1625,14,24,"PODEMOS-COM",490
46,"46188",668,548,538,3,10,"PODEMOS-COM",185
46,"46034",1776,1441,1430,4,11,"PODEMOS-COM",476
46,"46178",4643,3465,3434,16,31,"PODEMOS-COM",943
46,"46198",846,702,693,1,9,"PODEMOS-COM",295
46,"46193",8795,7101,7061,40,40,"PODEMOS-COM",2179
46,"46015",7231,5768,5711,33,57,"PODEMOS-COM",1640
46,"46260",2572,2100,2081,10,19,"PODEMOS-COM",607
46,"46194",15552,11606,11505,69,101,"PODEMOS-COM",2976
46,"46055",1273,1031,1021,4,10,"PODEMOS-COM",314
46,"46242",340,291,285,1,6,"PODEMOS-COM",39
46,"46136",2534,2008,1990,13,18,"PODEMOS-COM",511
46,"46255",3145,2494,2470,19,24,"PODEMOS-COM",728
46,"46066",1255,1028,1020,6,8,"PODEMOS-COM",239
46,"46236",975,810,806,4,4,"PODEMOS-COM",241
46,"46132",2148,1850,1830,12,20,"PODEMOS-COM",433
46,"46063",1757,1399,1384,11,15,"PODEMOS-COM",469
46,"46083",15467,11584,11443,79,141,"PODEMOS-COM",3409
46,"46037",1119,952,941,2,11,"PODEMOS-COM",237
46,"46177",4698,3715,3665,16,50,"PODEMOS-COM",1096
46,"46096",279,229,225,2,4,"PODEMOS-COM",74
46,"46058",1779,1430,1409,10,21,"PODEMOS-COM",335
46,"46232",894,715,712,5,3,"PODEMOS-COM",98
46,"46201",67,49,49,0,0,"PODEMOS-COM",13
46,"46126",5555,4619,4574,26,45,"PODEMOS-COM",1428
46,"46068",354,305,297,1,8,"PODEMOS-COM",66
46,"46903",5985,4822,4796,24,26,"PODEMOS-COM",1109
46,"46061",337,281,281,3,0,"PODEMOS-COM",103
46,"46202",16767,13171,13058,59,113,"PODEMOS-COM",3831
46,"46180",682,581,572,1,9,"PODEMOS-COM",170
46,"46028",395,346,339,2,7,"PODEMOS-COM",91
46,"46020",3784,3064,3012,15,52,"PODEMOS-COM",848
46,"46241",400,324,314,1,10,"PODEMOS-COM",84
46,"46074",2690,2158,2145,18,13,"PODEMOS-COM",668
46,"46151",722,589,583,1,6,"PODEMOS-COM",202
46,"46077",7569,6100,6010,41,90,"PODEMOS-COM",2008
46,"46047",525,443,435,2,8,"PODEMOS-COM",119
46,"46158",1024,817,804,5,13,"PODEMOS-COM",223
46,"46041",331,254,253,6,1,"PODEMOS-COM",61
46,"46154",811,644,640,4,4,"PODEMOS-COM",104
46,"46142",797,619,608,2,11,"PODEMOS-COM",88
46,"46249",9362,7163,7072,42,91,"PODEMOS-COM",1204
46,"46197",1956,1556,1543,8,13,"PODEMOS-COM",484
46,"46051",8347,6500,6442,27,58,"PODEMOS-COM",1452
46,"46127",2706,2212,2175,10,37,"PODEMOS-COM",639
46,"46904",802,662,654,7,8,"PODEMOS-COM",171
46,"46045",1261,1066,1041,3,25,"PODEMOS-COM",315
46,"46080",1025,795,784,4,11,"PODEMOS-COM",106
46,"46227",915,771,765,5,6,"PODEMOS-COM",282
46,"46138",345,292,292,0,0,"PODEMOS-COM",61
46,"46137",268,225,220,3,5,"PODEMOS-COM",50
46,"46044",4237,3347,3285,25,62,"PODEMOS-COM",636
46,"46111",10876,8133,8050,35,83,"PODEMOS-COM",2080
46,"46106",1543,1177,1167,5,10,"PODEMOS-COM",199
46,"46099",922,693,685,0,8,"PODEMOS-COM",121
46,"46035",6786,5382,5338,27,44,"PODEMOS-COM",1525
46,"46199",5742,4458,4425,34,33,"PODEMOS-COM",1056
46,"46121",105,92,91,2,1,"PODEMOS-COM",11
46,"46225",346,299,290,0,9,"PODEMOS-COM",79
46,"46139",4495,3629,3577,26,52,"PODEMOS-COM",920
46,"46091",115,101,100,1,1,"PODEMOS-COM",18
46,"46075",149,132,130,2,2,"PODEMOS-COM",31
46,"46234",354,289,287,2,2,"PODEMOS-COM",49
46,"46042",3389,2886,2844,19,42,"PODEMOS-COM",610
46,"46094",20515,15885,15785,125,100,"PODEMOS-COM",4554
46,"46175",459,403,396,1,7,"PODEMOS-COM",124
46,"46013",17366,13952,13862,95,90,"PODEMOS-COM",3949
46,"46195",1967,1612,1602,9,10,"PODEMOS-COM",444
46,"46049",280,242,238,1,4,"PODEMOS-COM",48
46,"46023",328,294,287,2,7,"PODEMOS-COM",93
46,"46104",1956,1567,1543,6,24,"PODEMOS-COM",435
46,"46122",2701,2120,2109,18,11,"PODEMOS-COM",586
46,"46069",161,126,122,0,4,"PODEMOS-COM",19
46,"46183",6009,4624,4563,18,61,"PODEMOS-COM",1165
46,"46112",552,466,464,1,2,"PODEMOS-COM",92
46,"46263",255,204,202,1,2,"PODEMOS-COM",45
46,"46224",170,130,130,0,0,"PODEMOS-COM",32
46,"46214",15730,12427,12334,56,93,"PODEMOS-COM",3286
46,"46252",126,95,93,0,2,"PODEMOS-COM",7
46,"46130",907,722,713,6,9,"PODEMOS-COM",224
46,"46057",495,339,337,6,2,"PODEMOS-COM",73
46,"46147",16843,12206,12099,56,107,"PODEMOS-COM",3331
46,"46247",1024,743,733,2,10,"PODEMOS-COM",119
46,"46128",1601,1316,1281,5,35,"PODEMOS-COM",325
46,"46204",6781,5421,5379,15,42,"PODEMOS-COM",1340
46,"46014",3042,2456,2434,17,22,"PODEMOS-COM",677
46,"46070",16903,13091,12999,64,92,"PODEMOS-COM",3260
46,"46115",403,296,289,1,7,"PODEMOS-COM",31
46,"46084",1576,1314,1298,6,16,"PODEMOS-COM",358
46,"46165",7115,5626,5576,31,50,"PODEMOS-COM",1495
46,"46046",896,697,686,1,11,"PODEMOS-COM",229
46,"46209",1955,1531,1508,7,23,"PODEMOS-COM",389
46,"46228",2363,1854,1839,16,15,"PODEMOS-COM",445
46,"46254",1012,786,775,1,11,"PODEMOS-COM",103
46,"46081",10180,8055,7984,32,71,"PODEMOS-COM",2129
46,"46164",11777,8893,8798,54,95,"PODEMOS-COM",2239
46,"46182",1274,970,966,2,4,"PODEMOS-COM",331
46,"46187",1310,1036,1028,6,8,"PODEMOS-COM",288
46,"46010",914,725,716,4,9,"PODEMOS-COM",217
46,"46086",82,73,73,1,0,"PODEMOS-COM",35
46,"46043",145,131,131,0,0,"PODEMOS-COM",29
46,"46176",2025,1431,1416,10,15,"PODEMOS-COM",346
46,"46181",17066,12779,12636,96,143,"PODEMOS-COM",3659
46,"46100",289,240,237,1,3,"PODEMOS-COM",77
46,"46116",13153,10566,10518,62,48,"PODEMOS-COM",2768
46,"46087",127,99,99,1,0,"PODEMOS-COM",24
46,"46173",1336,1097,1080,9,17,"PODEMOS-COM",309
46,"46006",4529,3803,3748,18,55,"PODEMOS-COM",1075
46,"46155",1035,865,846,2,19,"PODEMOS-COM",278
46,"46117",493,414,411,4,3,"PODEMOS-COM",115
46,"46026",1204,1044,1034,4,10,"PODEMOS-COM",289
46,"46203",3598,2962,2928,17,34,"PODEMOS-COM",943
46,"46250",578668,455375,452638,2701,2737,"PODEMOS-COM",121281
46,"46024",424,348,340,0,8,"PODEMOS-COM",43
46,"46039",2147,1746,1727,9,19,"PODEMOS-COM",375
46,"46018",635,531,522,3,9,"PODEMOS-COM",85
46,"46003",963,841,815,1,26,"PODEMOS-COM",212
46,"46131",49604,37767,37431,266,336,"PODEMOS-COM",9252
46,"46085",11147,8107,8033,57,74,"PODEMOS-COM",2235
46,"46133",563,458,455,2,3,"PODEMOS-COM",63
46,"46123",1838,1466,1447,4,19,"PODEMOS-COM",537
46,"46166",8155,6521,6450,41,71,"PODEMOS-COM",2049
46,"46098",2491,1978,1950,14,28,"PODEMOS-COM",737
46,"46007",11953,9099,9038,65,61,"PODEMOS-COM",2299
46,"46005",22908,17565,17438,126,127,"PODEMOS-COM",5031
46,"46072",3625,2993,2931,37,62,"PODEMOS-COM",810
46,"46088",176,140,138,0,2,"PODEMOS-COM",45
46,"46170",3451,2821,2775,16,46,"PODEMOS-COM",426
46,"46109",6195,4764,4682,23,82,"PODEMOS-COM",1103
46,"46033",197,169,168,1,1,"PODEMOS-COM",33
46,"46073",1097,903,892,6,11,"PODEMOS-COM",199
46,"46114",575,488,484,3,4,"PODEMOS-COM",85
46,"46200",1909,1628,1609,5,19,"PODEMOS-COM",408
46,"46159",22905,17498,17373,102,125,"PODEMOS-COM",4983
46,"46144",665,525,520,2,5,"PODEMOS-COM",76
46,"46101",858,731,723,4,8,"PODEMOS-COM",180
46,"46118",3795,2987,2962,18,25,"PODEMOS-COM",599
46,"46153",441,358,354,0,4,"PODEMOS-COM",128
46,"46093",2117,1721,1710,10,11,"PODEMOS-COM",386
46,"46025",2502,2008,1993,6,15,"PODEMOS-COM",592
46,"46218",1074,930,912,1,18,"PODEMOS-COM",243
46,"46001",802,623,615,4,8,"PODEMOS-COM",108
46,"46008",2673,2201,2189,8,12,"PODEMOS-COM",674
46,"46092",273,183,183,0,0,"PODEMOS-COM",33
46,"46135",9655,7845,7810,32,35,"PODEMOS-COM",2103
46,"46079",326,267,265,2,2,"PODEMOS-COM",39
46,"46036",583,384,381,8,3,"PODEMOS-COM",71
46,"46031",10520,7830,7759,70,71,"PODEMOS-COM",2549
46,"46107",1915,1566,1553,2,13,"PODEMOS-COM",343
46,"46050",200,160,160,0,0,"PODEMOS-COM",39
46,"46246",1066,856,838,7,18,"PODEMOS-COM",135
46,"46244",58586,43371,43098,257,273,"PODEMOS-COM",10399
46,"46143",4215,3219,3171,27,48,"PODEMOS-COM",889
46,"46196",153,131,130,0,1,"PODEMOS-COM",14
46,"46171",16587,12731,12627,79,104,"PODEMOS-COM",3660
46,"46212",1612,1234,1214,5,20,"PODEMOS-COM",385
46,"46156",2087,1712,1702,9,10,"PODEMOS-COM",453
46,"46174",984,808,794,3,14,"PODEMOS-COM",187
46,"46067",1736,1457,1382,2,75,"PODEMOS-COM",306
46,"46090",1640,1440,1424,4,16,"PODEMOS-COM",364
46,"46189",471,412,405,2,7,"PODEMOS-COM",143
46,"46120",1109,919,902,4,17,"PODEMOS-COM",271
46,"46148",1528,1206,1192,15,14,"PODEMOS-COM",220
46,"46185",386,325,321,4,4,"PODEMOS-COM",177
46,"46071",466,383,379,2,4,"PODEMOS-COM",91
46,"46240",209,169,164,1,5,"PODEMOS-COM",33
46,"46030",804,660,635,7,25,"PODEMOS-COM",156
46,"46119",783,672,666,7,6,"PODEMOS-COM",210
46,"46161",1481,1206,1194,6,12,"PODEMOS-COM",327
46,"46097",959,734,728,6,6,"PODEMOS-COM",132
46,"46059",1272,1066,1058,4,8,"PODEMOS-COM",406
46,"46012",888,723,703,3,20,"PODEMOS-COM",157
46,"46032",5635,4529,4493,16,36,"PODEMOS-COM",1416
46,"46054",11251,8795,8731,46,64,"PODEMOS-COM",2408
46,"46160",1912,1523,1514,3,9,"PODEMOS-COM",615
46,"46125",857,709,701,5,8,"PODEMOS-COM",191
46,"46213",15476,11377,11246,110,131,"PODEMOS-COM",2000
46,"46056",184,160,158,1,2,"PODEMOS-COM",43
46,"46038",345,255,255,0,0,"PODEMOS-COM",68
46,"46078",28126,20975,20850,127,125,"PODEMOS-COM",5971
46,"46052",502,432,431,2,1,"PODEMOS-COM",104
46,"46169",32396,25109,24953,169,156,"PODEMOS-COM",6837
46,"46262",232,172,168,0,4,"PODEMOS-COM",44
46,"46179",2182,1823,1788,13,35,"PODEMOS-COM",383
46,"46016",1068,885,874,3,11,"PODEMOS-COM",264
46,"46146",1670,1333,1318,11,15,"PODEMOS-COM",465
46,"46222",383,322,321,2,1,"PODEMOS-COM",120
46,"46060",9361,7285,7229,30,56,"PODEMOS-COM",1832
46,"46062",4652,3650,3583,32,67,"PODEMOS-COM",834
46,"46009",3144,2579,2552,13,27,"PODEMOS-COM",706
46,"46223",7814,6169,6129,33,40,"PODEMOS-COM",1604
46,"46004",1924,1582,1559,11,23,"PODEMOS-COM",513
46,"46219",125,106,105,2,1,"PODEMOS-COM",15
46,"46256",6833,5087,5062,37,25,"PODEMOS-COM",1293
46,"46233",3904,2974,2934,15,40,"PODEMOS-COM",789
46,"46238",13324,10023,9939,50,84,"PODEMOS-COM",3587
46,"46149",362,288,287,2,1,"PODEMOS-COM",50
46,"46027",948,795,781,3,14,"PODEMOS-COM",170
46,"46140",349,288,284,2,4,"PODEMOS-COM",96
46,"46076",587,489,483,2,6,"PODEMOS-COM",113
46,"46230",13944,10746,10646,69,100,"PODEMOS-COM",2797
46,"46190",48824,36748,36542,238,206,"PODEMOS-COM",10414
46,"46216",5039,4207,4188,20,19,"PODEMOS-COM",1018
46,"46134",2357,1811,1797,8,14,"PODEMOS-COM",551
46,"46082",4947,3843,3814,25,29,"PODEMOS-COM",1093
46,"46157",2978,2370,2343,19,27,"PODEMOS-COM",563
46,"46211",1723,1441,1434,13,7,"PODEMOS-COM",316
46,"46208",1114,931,922,3,9,"PODEMOS-COM",284
46,"46163",1847,1508,1489,8,19,"PODEMOS-COM",493
46,"46110",21260,16194,16084,76,110,"PODEMOS-COM",4539
46,"46217",886,724,712,3,12,"PODEMOS-COM",186
46,"46186",19033,15061,14950,70,111,"PODEMOS-COM",4070
46,"46257",5579,4440,4391,26,49,"PODEMOS-COM",1484
46,"46019",8833,7183,7109,47,74,"PODEMOS-COM",1917
46,"46065",1588,1246,1227,5,19,"PODEMOS-COM",444
46,"46141",438,359,348,4,11,"PODEMOS-COM",74
46,"46902",379,314,313,3,1,"PODEMOS-COM",63
46,"46248",4873,3679,3639,18,40,"PODEMOS-COM",774
46,"46095",608,498,493,2,5,"PODEMOS-COM",71
46,"46253",109,93,93,0,0,"PODEMOS-COM",26
46,"46259",503,410,406,2,4,"PODEMOS-COM",75
46,"46191",1970,1557,1533,6,24,"PODEMOS-COM",362
46,"46235",21793,16577,16424,118,153,"PODEMOS-COM",5913
46,"46167",373,286,285,1,1,"PODEMOS-COM",44
46,"46168",1938,1542,1530,11,12,"PODEMOS-COM",450
46,"46129",521,435,434,2,1,"PODEMOS-COM",120
46,"46124",788,680,672,0,8,"PODEMOS-COM",241
46,"46192",767,573,568,1,5,"PODEMOS-COM",151
46,"46029",20649,15241,15110,113,131,"PODEMOS-COM",3607
46,"46011",7627,5496,5407,39,89,"PODEMOS-COM",1474
46,"46150",1839,1377,1362,10,15,"PODEMOS-COM",214
46,"46206",577,475,468,4,7,"PODEMOS-COM",93
46,"46184",26467,20888,20675,138,213,"PODEMOS-COM",6194
46,"46152",97,76,74,0,2,"PODEMOS-COM",9
46,"46226",48,44,44,0,0,"PODEMOS-COM",10
46,"46102",19843,15783,15676,102,107,"PODEMOS-COM",4242
46,"46261",1720,1386,1369,10,17,"PODEMOS-COM",292
46,"46113",2436,1864,1849,11,15,"PODEMOS-COM",502
46,"46048",3448,2817,2790,8,27,"PODEMOS-COM",988
46,"46205",14323,11325,11224,55,101,"PODEMOS-COM",2733
46,"46021",23646,18220,18100,85,120,"PODEMOS-COM",4876
46,"46251",2490,2082,2045,11,37,"PODEMOS-COM",523
46,"46040",1098,914,907,4,7,"PODEMOS-COM",262
46,"46103",1270,1015,998,8,17,"PODEMOS-COM",259
46,"46207",6656,5355,5293,42,62,"PODEMOS-COM",1357
46,"46245",516,427,420,3,7,"PODEMOS-COM",123
46,"46053",560,454,451,2,3,"PODEMOS-COM",135
46,"46243",141,122,120,0,2,"PODEMOS-COM",32
46,"46108",480,375,375,2,0,"PODEMOS-COM",37
46,"46162",1207,962,947,3,15,"PODEMOS-COM",176
46,"46064",527,429,423,0,6,"PODEMOS-COM",115
43,"43907",4382,3174,3147,14,27,"EB",3
43,"43109",2560,1717,1700,13,17,"EB",2
43,"43033",778,576,569,5,7,"EB",2
43,"43135",342,252,251,3,1,"EB",1
43,"43113",408,306,305,2,1,"EB",0
43,"43057",40,25,25,1,0,"EB",0
43,"43046",100,77,72,2,5,"EB",0
43,"43901",8765,5306,5212,81,94,"EB",6
43,"43013",4425,2975,2938,21,37,"EB",6
43,"43053",191,149,147,1,2,"EB",0
43,"43163",25252,17001,16847,74,154,"EB",17
43,"43003",322,234,233,3,1,"EB",1
43,"43161",17217,11541,11478,67,63,"EB",11
43,"43149",699,483,472,7,11,"EB",1
43,"43024",1522,1044,1034,3,10,"EB",0
43,"43083",140,95,94,0,1,"EB",0
43,"43086",5237,3507,3476,27,31,"EB",10
43,"43098",343,249,249,4,0,"EB",0
43,"43008",309,185,181,5,4,"EB",0
43,"43034",480,366,358,4,8,"EB",0
43,"43036",843,545,542,0,3,"EB",1
43,"43066",155,109,107,1,2,"EB",0
43,"43148",90177,64180,63784,349,396,"EB",127
43,"43076",447,318,317,0,1,"EB",2
43,"43035",262,167,164,0,3,"EB",0
43,"43151",109,82,82,1,0,"EB",0
43,"43016",3418,2534,2512,15,22,"EB",2
43,"43112",284,178,178,0,0,"EB",0
43,"43176",799,565,562,5,3,"EB",0
43,"43063",560,363,360,8,3,"EB",1
43,"43095",2493,1723,1703,13,20,"EB",5
43,"43121",604,393,387,4,6,"EB",0
43,"43158",89,55,53,3,2,"EB",0
43,"43060",2887,2019,1990,16,29,"EB",3
43,"43136",10353,6670,6622,50,48,"EB",17
43,"43140",2366,1731,1717,7,14,"EB",0
43,"43009",1431,968,958,5,10,"EB",1
43,"43156",3982,2748,2704,26,44,"EB",2
43,"43169",457,364,356,3,8,"EB",0
43,"43143",56,47,47,1,0,"EB",0
43,"43906",2117,1454,1441,3,13,"EB",4
43,"43064",2017,1384,1367,16,17,"EB",1
43,"43146",38,30,30,1,0,"EB",0
43,"43071",924,650,639,5,11,"EB",0
43,"43027",165,133,133,2,0,"EB",1
43,"43125",942,692,685,4,7,"EB",0
43,"43065",395,266,265,4,1,"EB",1
43,"43903",2383,1420,1407,20,13,"EB",0
43,"43015",112,91,91,1,0,"EB",0
43,"43144",1258,914,911,3,3,"EB",2
43,"43137",1881,1344,1332,9,12,"EB",2
43,"43100",3268,2360,2352,16,8,"EB",8
43,"43096",101,81,81,0,0,"EB",0
43,"43154",132,101,100,1,1,"EB",0
43,"43117",144,110,109,1,1,"EB",0
43,"43164",300,218,217,0,1,"EB",1
43,"43052",954,662,653,9,9,"EB",0
43,"43104",1798,1285,1268,14,17,"EB",0
43,"43004",6326,4274,4227,38,47,"EB",4
43,"43079",364,258,257,1,1,"EB",0
43,"43138",2677,1821,1786,22,35,"EB",1
43,"43042",2148,1585,1573,7,12,"EB",4
43,"43165",578,431,428,2,3,"EB",0
43,"43002",1821,1294,1266,12,28,"EB",2
43,"43115",155,116,116,2,0,"EB",0
43,"43025",604,431,428,5,3,"EB",2
43,"43068",528,346,338,2,8,"EB",0
43,"43020",2202,1631,1614,13,17,"EB",1
43,"43102",485,337,332,2,5,"EB",1
43,"43172",351,243,242,8,1,"EB",0
43,"43088",1966,1382,1372,6,10,"EB",3
43,"43029",323,237,237,4,0,"EB",0
43,"43037",16725,10917,10822,61,95,"EB",23
43,"43040",338,255,247,2,8,"EB",0
43,"43129",4618,3148,3107,24,41,"EB",2
43,"43166",1568,1117,1111,4,6,"EB",3
43,"43054",2836,1873,1852,21,21,"EB",2
43,"43170",857,603,599,8,4,"EB",0
43,"43116",455,326,321,1,5,"EB",1
43,"43007",637,481,479,3,2,"EB",0
43,"43153",10676,7241,7190,29,51,"EB",9
43,"43130",196,128,127,2,1,"EB",1
43,"43078",856,640,632,11,8,"EB",1
43,"43081",597,425,418,4,7,"EB",1
43,"43084",526,404,399,5,5,"EB",3
43,"43028",2717,1727,1715,7,12,"EB",0
43,"43018",410,320,316,1,4,"EB",0
43,"43106",810,544,532,7,12,"EB",0
43,"43051",8545,5813,5735,26,78,"EB",3
43,"43147",521,379,377,1,2,"EB",0
43,"43090",1070,625,620,4,5,"EB",0
43,"43072",105,77,77,1,0,"EB",0
43,"43045",152,121,121,0,0,"EB",0
43,"43005",3615,2376,2354,17,22,"EB",5
43,"43062",274,223,219,7,4,"EB",0
43,"43011",1083,824,819,5,5,"EB",1
43,"43141",111,71,68,0,3,"EB",0
43,"43056",871,532,521,6,11,"EB",2
43,"43168",93,64,64,2,0,"EB",0
43,"43039",102,73,73,0,0,"EB",1
43,"43131",4623,3059,3031,16,28,"EB",1
43,"43097",390,301,300,0,1,"EB",1
43,"43139",2053,1332,1321,16,11,"EB",1
43,"43162",4313,3132,3101,26,31,"EB",7
43,"43091",136,94,94,2,0,"EB",0
43,"43006",683,463,458,10,5,"EB",0
43,"43050",2521,1654,1640,11,14,"EB",3
43,"43159",80,57,57,0,0,"EB",0
43,"43145",4084,2991,2954,36,37,"EB",3
43,"43043",3128,2201,2186,11,15,"EB",2
43,"43026",797,579,574,2,5,"EB",0
43,"43047",4128,2688,2652,19,36,"EB",3
43,"43085",226,178,178,2,0,"EB",0
43,"43105",162,115,115,3,0,"EB",0
43,"43070",236,194,193,0,1,"EB",0
43,"43075",89,62,62,1,0,"EB",0
43,"43014",14293,9441,9319,118,122,"EB",28
43,"43089",281,211,211,1,0,"EB",2
43,"43077",463,307,305,7,2,"EB",1
43,"43126",1177,848,844,8,4,"EB",3
43,"43177",298,236,232,5,4,"EB",0
43,"43044",3975,2793,2758,34,35,"EB",1
43,"43055",1975,1471,1459,16,12,"EB",2
43,"43093",3909,2625,2597,44,28,"EB",4
43,"43120",444,293,288,0,5,"EB",0
43,"43094",2175,1506,1480,11,26,"EB",1
43,"43902",2760,1775,1739,22,36,"EB",4
43,"43114",388,264,262,1,2,"EB",0
43,"43171",14593,10107,10049,46,58,"EB",10
43,"43174",138,99,99,1,0,"EB",0
43,"43082",372,291,285,0,6,"EB",1
43,"43150",1300,940,913,5,27,"EB",0
43,"43110",272,169,167,1,2,"EB",0
43,"43134",283,226,224,2,2,"EB",2
43,"43178",1335,939,933,9,6,"EB",1
43,"43108",1775,1238,1229,8,9,"EB",3
43,"43152",450,338,330,2,8,"EB",2
43,"43049",746,546,543,1,3,"EB",0
43,"43031",1466,1062,1056,8,6,"EB",2
43,"43175",566,390,387,3,3,"EB",1
43,"43160",1273,888,879,7,9,"EB",1
43,"43142",1114,781,771,4,10,"EB",2
43,"43119",793,559,556,7,3,"EB",0
43,"43012",3580,2669,2658,22,11,"EB",3
43,"43124",484,347,343,6,4,"EB",0
43,"43155",22874,15046,14893,137,153,"EB",32
43,"43101",148,107,107,4,0,"EB",0
43,"43132",365,269,264,1,5,"EB",1
43,"43017",126,100,97,1,3,"EB",0
43,"43058",93,68,67,1,1,"EB",0
43,"43023",231,173,171,3,2,"EB",1
43,"43059",253,195,195,2,0,"EB",0
43,"43099",305,234,233,1,1,"EB",0
43,"43061",48,31,29,0,2,"EB",0
43,"43103",892,644,640,6,4,"EB",2
43,"43074",1749,1284,1275,7,9,"EB",2
43,"43067",555,434,430,1,4,"EB",0
43,"43022",1508,1028,1015,20,13,"EB",1
43,"43173",101,63,60,0,3,"EB",0
43,"43118",413,313,308,1,5,"EB",0
43,"43030",430,311,308,1,3,"EB",0
43,"43069",184,144,143,1,1,"EB",0
43,"43019",1371,904,886,4,18,"EB",0
43,"43048",807,569,564,8,5,"EB",6
43,"43001",695,474,472,4,2,"EB",1
43,"43127",765,554,548,2,6,"EB",2
43,"43073",85,60,59,0,1,"EB",0
43,"43107",377,265,260,4,5,"EB",0
43,"43041",226,160,156,0,4,"EB",1
43,"43157",352,273,271,3,2,"EB",0
43,"43092",7059,4603,4563,21,40,"EB",4
43,"43122",106,84,84,0,0,"EB",0
43,"43038",21385,14375,14276,117,99,"EB",26
43,"43080",244,184,184,2,0,"EB",0
43,"43032",523,371,365,7,6,"EB",0
43,"43133",5697,3726,3685,26,41,"EB",10
43,"43904",2908,1799,1760,38,39,"EB",5
43,"43111",2049,1383,1366,9,17,"EB",1
43,"43010",316,253,251,2,2,"EB",1
43,"43021",360,248,247,6,1,"EB",1
43,"43128",908,623,616,4,7,"EB",0
43,"43905",14371,9191,9136,41,55,"EB",16
43,"43167",383,287,286,2,1,"EB",0
43,"43123",70276,47897,47547,302,350,"EB",93
9,"9424",32,26,26,1,0,"PCPE",0
9,"9328",77,55,55,1,0,"PCPE",0
9,"9480",110,89,88,1,1,"PCPE",0
9,"9463",262,206,206,3,0,"PCPE",1
9,"9166",97,79,78,3,1,"PCPE",0
9,"9218",360,272,271,2,1,"PCPE",1
9,"9124",1520,1113,1096,9,17,"PCPE",2
9,"9050",72,54,54,0,0,"PCPE",0
9,"9380",78,59,57,0,2,"PCPE",0
9,"9356",42,31,31,0,0,"PCPE",0
9,"9103",221,185,184,2,1,"PCPE",2
9,"9378",31,21,21,1,0,"PCPE",0
9,"9017",89,67,62,0,5,"PCPE",0
9,"9302",116,87,87,0,0,"PCPE",0
9,"9301",616,513,506,5,7,"PCPE",2
9,"9079",46,40,37,0,3,"PCPE",0
9,"9039",58,38,38,0,0,"PCPE",0
9,"9247",23,19,19,0,0,"PCPE",0
9,"9176",61,45,44,0,1,"PCPE",0
9,"9037",113,96,96,0,0,"PCPE",1
9,"9273",53,41,40,1,1,"PCPE",1
9,"9352",116,97,97,0,0,"PCPE",0
9,"9045",267,186,183,2,3,"PCPE",0
9,"9403",96,78,76,1,2,"PCPE",0
9,"9138",90,73,72,0,1,"PCPE",0
9,"9198",108,86,85,2,1,"PCPE",0
9,"9485",55,43,43,1,0,"PCPE",0
9,"9355",101,75,73,0,2,"PCPE",0
9,"9093",154,133,128,1,5,"PCPE",0
9,"9288",91,70,69,1,1,"PCPE",0
9,"9068",29,23,22,0,1,"PCPE",0
9,"9422",18,10,10,0,0,"PCPE",0
9,"9337",115,84,82,0,2,"PCPE",0
9,"9346",93,71,69,0,2,"PCPE",0
9,"9414",201,148,147,1,1,"PCPE",0
9,"9201",30,17,17,0,0,"PCPE",0
9,"9259",233,184,184,3,0,"PCPE",0
9,"9408",41,34,34,1,0,"PCPE",0
9,"9104",54,43,43,0,0,"PCPE",0
9,"9173",123,93,93,1,0,"PCPE",0
9,"9190",91,56,55,0,1,"PCPE",0
9,"9078",41,35,33,0,2,"PCPE",0
9,"9295",60,37,37,0,0,"PCPE",0
9,"9363",974,730,725,3,5,"PCPE",2
9,"9277",119,101,100,0,1,"PCPE",0
9,"9389",77,56,56,0,0,"PCPE",0
9,"9137",167,128,128,1,0,"PCPE",0
9,"9036",38,31,30,2,1,"PCPE",0
9,"9228",163,138,138,0,0,"PCPE",1
9,"9304",202,166,163,1,3,"PCPE",0
9,"9044",46,38,37,0,1,"PCPE",0
9,"9208",211,139,136,3,3,"PCPE",1
9,"9308",67,43,43,1,0,"PCPE",0
9,"9372",221,190,189,1,1,"PCPE",0
9,"9163",602,479,472,5,7,"PCPE",1
9,"9214",684,452,446,6,6,"PCPE",2
9,"9279",177,130,130,0,0,"PCPE",0
9,"9090",57,51,51,1,0,"PCPE",0
9,"9454",47,34,34,0,0,"PCPE",0
9,"9179",43,35,34,0,1,"PCPE",0
9,"9152",263,193,192,0,1,"PCPE",1
9,"9220",76,62,61,2,1,"PCPE",0
9,"9012",93,68,66,1,2,"PCPE",1
9,"9417",40,30,30,0,0,"PCPE",0
9,"9325",195,125,123,2,2,"PCPE",0
9,"9354",33,30,30,1,0,"PCPE",0
9,"9312",98,83,82,0,1,"PCPE",0
9,"9025",125,86,79,1,7,"PCPE",0
9,"9266",91,72,70,0,2,"PCPE",0
9,"9225",84,57,56,1,1,"PCPE",0
9,"9411",149,111,111,0,0,"PCPE",1
9,"9168",296,233,231,1,2,"PCPE",0
9,"9904",482,389,384,5,5,"PCPE",1
9,"9083",37,33,33,0,0,"PCPE",0
9,"9255",86,66,62,0,4,"PCPE",0
9,"9167",59,42,42,2,0,"PCPE",0
9,"9276",387,280,273,2,7,"PCPE",2
9,"9108",378,290,287,2,3,"PCPE",0
9,"9310",13,9,8,0,1,"PCPE",0
9,"9412",803,552,550,2,2,"PCPE",3
9,"9242",81,65,63,2,2,"PCPE",0
9,"9442",380,287,282,2,5,"PCPE",0
9,"9094",51,42,41,0,1,"PCPE",0
9,"9423",27,25,25,0,0,"PCPE",0
9,"9018",24702,18365,18158,174,207,"PCPE",29
9,"9021",56,33,31,0,2,"PCPE",0
9,"9131",460,381,373,5,8,"PCPE",2
9,"9003",192,148,146,2,2,"PCPE",1
9,"9314",95,80,79,1,1,"PCPE",0
9,"9127",55,40,40,0,0,"PCPE",0
9,"9065",147,124,123,2,1,"PCPE",0
9,"9217",361,265,261,4,4,"PCPE",0
9,"9394",727,558,552,8,6,"PCPE",2
9,"9160",90,71,70,0,1,"PCPE",0
9,"9419",78,45,44,0,1,"PCPE",0
9,"9294",111,88,86,0,2,"PCPE",1
9,"9472",55,40,40,0,0,"PCPE",0
9,"9071",45,34,34,0,0,"PCPE",0
9,"9095",86,62,62,0,0,"PCPE",0
9,"9219",27590,19903,19724,166,179,"PCPE",33
9,"9434",1221,985,970,10,15,"PCPE",0
9,"9063",213,184,182,2,2,"PCPE",2
9,"9172",125,102,102,2,0,"PCPE",1
9,"9327",25,22,22,0,0,"PCPE",0
9,"9067",442,308,303,9,5,"PCPE",0
9,"9027",47,44,41,0,3,"PCPE",0
9,"9249",47,37,37,1,0,"PCPE",0
9,"9189",130,88,86,2,2,"PCPE",0
9,"9257",92,80,78,4,2,"PCPE",0
9,"9274",1098,880,872,9,8,"PCPE",4
9,"9169",99,83,81,0,2,"PCPE",0
9,"9903",3251,2359,2340,24,19,"PCPE",3
9,"9048",1484,1120,1106,4,14,"PCPE",10
9,"9058",393,293,289,2,4,"PCPE",1
9,"9445",44,32,32,1,0,"PCPE",0
9,"9306",113,91,91,1,0,"PCPE",0
9,"9075",111,83,83,1,0,"PCPE",0
9,"9287",208,170,168,2,2,"PCPE",0
9,"9072",307,240,239,1,1,"PCPE",0
9,"9458",466,380,377,3,3,"PCPE",0
9,"9175",129,92,92,0,0,"PCPE",0
9,"9091",732,516,512,7,4,"PCPE",0
9,"9368",22,14,14,1,0,"PCPE",0
9,"9130",79,63,62,1,1,"PCPE",0
9,"9427",1428,1014,1003,12,11,"PCPE",1
9,"9076",23,14,14,0,0,"PCPE",0
9,"9052",31,22,21,1,1,"PCPE",0
9,"9455",44,34,33,0,1,"PCPE",0
9,"9345",124,92,92,0,0,"PCPE",0
9,"9386",58,44,43,2,1,"PCPE",0
9,"9261",463,339,330,8,9,"PCPE",0
9,"9451",238,199,198,1,1,"PCPE",0
9,"9054",100,73,72,3,1,"PCPE",0
9,"9239",53,44,42,1,2,"PCPE",0
9,"9177",1117,830,825,5,5,"PCPE",3
9,"9901",374,268,261,3,7,"PCPE",3
9,"9482",34,29,28,0,1,"PCPE",0
9,"9250",273,218,218,4,0,"PCPE",0
9,"9309",306,216,211,2,5,"PCPE",0
9,"9340",76,49,49,0,0,"PCPE",0
9,"9316",104,83,80,1,3,"PCPE",0
9,"9373",440,285,282,3,3,"PCPE",1
9,"9358",249,191,191,1,0,"PCPE",0
9,"9098",516,396,388,6,8,"PCPE",0
9,"9365",31,20,20,0,0,"PCPE",0
9,"9280",27,17,17,0,0,"PCPE",0
9,"9055",52,39,38,0,1,"PCPE",0
9,"9224",157,122,122,0,0,"PCPE",1
9,"9432",189,143,140,1,3,"PCPE",0
9,"9906",1223,952,947,9,5,"PCPE",4
9,"9202",24,22,22,1,0,"PCPE",0
9,"9229",201,146,145,0,1,"PCPE",0
9,"9283",46,29,28,0,1,"PCPE",0
9,"9425",514,369,366,2,3,"PCPE",1
9,"9466",134,99,99,0,0,"PCPE",0
9,"9418",82,63,62,3,1,"PCPE",0
9,"9256",362,261,255,2,6,"PCPE",1
9,"9265",38,31,31,0,0,"PCPE",1
9,"9375",35,27,27,0,0,"PCPE",1
9,"9122",96,66,66,0,0,"PCPE",0
9,"9268",95,73,72,0,1,"PCPE",0
9,"9361",117,96,96,0,0,"PCPE",0
9,"9184",5,4,4,0,0,"PCPE",0
9,"9019",147,103,102,1,1,"PCPE",0
9,"9140",128,88,87,0,1,"PCPE",0
9,"9074",788,609,598,8,11,"PCPE",1
9,"9343",97,70,69,0,1,"PCPE",0
9,"9289",1466,1027,1013,6,14,"PCPE",0
9,"9409",109,87,87,0,0,"PCPE",0
9,"9416",52,39,39,0,0,"PCPE",0
9,"9119",46,27,27,0,0,"PCPE",0
9,"9253",111,96,94,1,2,"PCPE",0
9,"9460",177,135,135,2,0,"PCPE",1
9,"9347",141,113,109,4,4,"PCPE",0
9,"9339",128,103,103,0,0,"PCPE",0
9,"9026",397,314,311,1,3,"PCPE",0
9,"9029",168,134,132,3,2,"PCPE",0
9,"9109",1068,698,669,10,29,"PCPE",4
9,"9148",86,73,69,5,4,"PCPE",0
9,"9321",1640,1250,1237,5,13,"PCPE",3
9,"9112",113,75,73,2,2,"PCPE",0
9,"9390",611,478,477,3,1,"PCPE",1
9,"9159",56,48,48,1,0,"PCPE",0
9,"9020",262,187,180,2,7,"PCPE",0
9,"9032",108,73,73,0,0,"PCPE",0
9,"9258",173,139,136,4,3,"PCPE",0
9,"9908",469,314,309,2,5,"PCPE",0
9,"9144",52,40,40,0,0,"PCPE",0
9,"9066",65,51,51,0,0,"PCPE",0
9,"9241",201,156,155,3,1,"PCPE",2
9,"9362",204,168,164,0,4,"PCPE",0
9,"9213",320,223,220,4,3,"PCPE",1
9,"9441",74,66,66,0,0,"PCPE",0
9,"9391",361,264,263,2,1,"PCPE",0
9,"9381",32,23,22,0,1,"PCPE",0
9,"9057",144,116,115,0,1,"PCPE",0
9,"9180",136,102,100,2,2,"PCPE",0
9,"9221",445,337,335,1,2,"PCPE",1
9,"9238",932,576,569,6,7,"PCPE",1
9,"9007",59,41,41,0,0,"PCPE",0
9,"9392",53,40,40,0,0,"PCPE",0
9,"9440",96,78,78,0,0,"PCPE",0
9,"9446",12,7,7,0,0,"PCPE",0
9,"9398",75,54,54,1,0,"PCPE",0
9,"9182",78,63,61,2,2,"PCPE",0
9,"9351",60,46,45,1,1,"PCPE",1
9,"9272",294,206,203,1,3,"PCPE",0
9,"9429",56,41,41,0,0,"PCPE",0
9,"9143",27,20,20,0,0,"PCPE",0
9,"9132",173,132,130,0,2,"PCPE",1
9,"9905",391,308,308,5,0,"PCPE",0
9,"9297",323,265,261,5,4,"PCPE",0
9,"9405",128,89,89,0,0,"PCPE",0
9,"9318",61,38,38,0,0,"PCPE",1
9,"9114",87,67,67,0,0,"PCPE",0
9,"9174",809,575,565,10,10,"PCPE",0
9,"9449",87,72,71,1,1,"PCPE",0
9,"9064",332,275,275,3,0,"PCPE",0
9,"9123",40,35,35,0,0,"PCPE",0
9,"9086",687,475,471,0,4,"PCPE",1
9,"9117",77,61,57,0,4,"PCPE",0
9,"9082",40,35,35,0,0,"PCPE",0
9,"9483",212,161,161,1,0,"PCPE",0
9,"9231",70,49,49,3,0,"PCPE",0
9,"9330",1523,1166,1148,15,18,"PCPE",1
9,"9077",36,26,26,1,0,"PCPE",0
9,"9298",82,62,62,0,0,"PCPE",0
9,"9251",371,273,271,3,2,"PCPE",1
9,"9421",237,172,172,2,0,"PCPE",0
9,"9170",203,152,149,1,3,"PCPE",0
9,"9200",48,37,36,0,1,"PCPE",0
9,"9139",101,75,73,2,2,"PCPE",0
9,"9430",24,19,19,0,0,"PCPE",1
9,"9197",148,108,104,1,4,"PCPE",0
9,"9246",622,458,455,5,3,"PCPE",0
9,"9281",147,109,107,0,2,"PCPE",0
9,"9269",39,33,32,0,1,"PCPE",3
9,"9183",51,37,37,0,0,"PCPE",0
9,"9191",39,32,30,0,2,"PCPE",0
9,"9323",64,47,47,0,0,"PCPE",0
9,"9215",377,264,260,0,4,"PCPE",0
9,"9033",89,75,75,0,0,"PCPE",1
9,"9382",33,30,29,1,1,"PCPE",0
9,"9232",151,125,124,2,1,"PCPE",0
9,"9041",28,28,28,1,0,"PCPE",0
9,"9307",113,91,91,0,0,"PCPE",0
9,"9030",109,76,76,3,0,"PCPE",0
9,"9102",37,31,31,0,0,"PCPE",1
9,"9407",27,23,23,1,0,"PCPE",0
9,"9292",92,72,70,0,2,"PCPE",0
9,"9046",30,26,26,0,0,"PCPE",0
9,"9267",115,101,100,3,1,"PCPE",0
9,"9227",119,97,95,0,2,"PCPE",0
9,"9444",72,48,48,2,0,"PCPE",0
9,"9456",129,90,90,2,0,"PCPE",0
9,"9248",78,57,57,0,0,"PCPE",0
9,"9384",293,199,194,0,5,"PCPE",0
9,"9428",107,87,87,0,0,"PCPE",1
9,"9270",163,122,121,1,1,"PCPE",0
9,"9134",228,152,152,2,0,"PCPE",0
9,"9070",34,31,30,3,1,"PCPE",0
9,"9902",461,347,339,1,8,"PCPE",0
9,"9410",3051,2169,2153,18,16,"PCPE",10
9,"9051",168,133,132,1,1,"PCPE",0
9,"9009",163,130,128,2,2,"PCPE",0
9,"9056",4931,3634,3602,35,32,"PCPE",7
9,"9154",142,104,104,2,0,"PCPE",0
9,"9907",1420,1120,1115,13,5,"PCPE",1
9,"9329",123,86,86,1,0,"PCPE",1
9,"9353",73,57,56,0,1,"PCPE",0
9,"9061",166,124,123,1,1,"PCPE",0
9,"9476",63,46,46,0,0,"PCPE",0
9,"9105",107,88,86,0,2,"PCPE",2
9,"9129",105,87,87,0,0,"PCPE",1
9,"9377",625,478,471,5,7,"PCPE",0
9,"9194",2024,1550,1530,17,20,"PCPE",3
9,"9060",148,123,123,0,0,"PCPE",0
9,"9433",60,52,51,0,1,"PCPE",0
9,"9209",4511,3368,3301,37,67,"PCPE",1
9,"9199",91,65,65,2,0,"PCPE",0
9,"9034",280,237,233,5,4,"PCPE",0
9,"9084",189,150,148,7,2,"PCPE",0
9,"9010",32,23,23,2,0,"PCPE",0
9,"9406",252,196,195,1,1,"PCPE",0
9,"9243",75,56,54,1,2,"PCPE",1
9,"9113",464,383,376,6,7,"PCPE",1
9,"9439",1005,823,816,9,7,"PCPE",4
9,"9311",60,52,50,0,2,"PCPE",0
9,"9059",136713,106605,105601,976,1004,"PCPE",284
9,"9178",52,36,36,1,0,"PCPE",0
9,"9334",48,39,38,0,1,"PCPE",0
9,"9022",67,57,57,1,0,"PCPE",0
9,"9088",66,44,42,1,2,"PCPE",0
9,"9100",59,51,50,0,1,"PCPE",0
9,"9128",82,66,66,0,0,"PCPE",0
9,"9085",475,352,350,2,2,"PCPE",1
9,"9374",90,79,77,2,2,"PCPE",0
9,"9149",34,25,24,0,1,"PCPE",0
9,"9181",302,231,225,3,6,"PCPE",1
9,"9196",154,108,107,1,1,"PCPE",1
9,"9332",140,107,107,1,0,"PCPE",0
9,"9478",45,38,38,0,0,"PCPE",0
9,"9115",92,69,68,0,1,"PCPE",0
9,"9151",458,364,363,3,1,"PCPE",2
9,"9350",480,358,347,5,11,"PCPE",1
9,"9235",160,124,123,0,1,"PCPE",0
9,"9226",66,55,53,0,2,"PCPE",0
9,"9396",152,118,118,1,0,"PCPE",1
9,"9141",610,499,493,4,6,"PCPE",1
9,"9366",90,64,63,1,1,"PCPE",2
9,"9244",47,26,26,1,0,"PCPE",0
9,"9195",57,42,42,2,0,"PCPE",0
9,"9164",165,121,121,1,0,"PCPE",0
9,"9230",38,31,31,0,0,"PCPE",0
9,"9326",148,115,113,2,2,"PCPE",2
9,"9125",596,435,433,3,2,"PCPE",1
9,"9471",151,117,117,0,0,"PCPE",0
9,"9360",30,27,27,0,0,"PCPE",0
9,"9110",80,49,49,1,0,"PCPE",0
9,"9369",442,331,328,1,3,"PCPE",1
9,"9120",39,35,35,0,0,"PCPE",0
9,"9006",61,41,41,0,0,"PCPE",0
9,"9013",47,41,41,0,0,"PCPE",0
9,"9024",156,117,114,0,3,"PCPE",0
9,"9262",161,129,129,0,0,"PCPE",0
9,"9014",213,127,126,1,1,"PCPE",0
9,"9317",16,14,14,0,0,"PCPE",0
9,"9335",87,72,71,0,1,"PCPE",0
9,"9101",79,59,59,0,0,"PCPE",0
9,"9303",92,72,71,0,1,"PCPE",1
9,"9338",219,173,171,1,2,"PCPE",0
9,"9438",544,446,444,3,2,"PCPE",1
9,"9431",119,99,98,0,1,"PCPE",0
9,"9415",267,166,165,0,1,"PCPE",0
9,"9388",36,31,30,1,1,"PCPE",1
9,"9135",41,33,33,1,0,"PCPE",0
9,"9016",85,64,64,2,0,"PCPE",0
9,"9062",51,44,44,1,0,"PCPE",0
9,"9348",146,116,114,1,2,"PCPE",0
9,"9467",66,46,46,3,0,"PCPE",0
9,"9236",38,32,32,0,0,"PCPE",0
9,"9450",27,21,20,1,1,"PCPE",0
9,"9155",26,20,20,1,0,"PCPE",0
9,"9395",136,96,95,0,1,"PCPE",1
9,"9437",286,227,226,5,1,"PCPE",1
9,"9133",40,34,34,0,0,"PCPE",0
9,"9473",85,62,61,1,1,"PCPE",0
9,"9043",189,132,132,2,0,"PCPE",0
9,"9223",46,39,39,0,0,"PCPE",0
9,"9413",447,333,333,5,0,"PCPE",1
9,"9443",183,132,129,1,3,"PCPE",0
9,"9162",143,108,108,0,0,"PCPE",0
9,"9448",216,180,178,1,2,"PCPE",1
9,"9136",192,151,147,2,4,"PCPE",0
9,"9001",27,26,26,0,0,"PCPE",0
9,"9038",118,97,94,0,3,"PCPE",0
9,"9192",55,47,46,0,1,"PCPE",0
9,"9023",1096,848,840,9,8,"PCPE",1
9,"9315",379,269,267,2,2,"PCPE",0
9,"9035",313,243,240,0,3,"PCPE",0
9,"9387",118,96,95,0,1,"PCPE",1
9,"9211",1462,1086,1070,11,16,"PCPE",0
9,"9073",926,753,748,10,5,"PCPE",2
9,"9047",56,45,45,2,0,"PCPE",0
9,"9206",61,52,50,3,2,"PCPE",0
9,"9464",36,24,24,0,0,"PCPE",0
9,"9447",42,38,38,0,0,"PCPE",0
9,"9400",317,258,256,3,2,"PCPE",1
9,"9275",192,138,137,1,1,"PCPE",1
9,"9216",385,283,280,8,3,"PCPE",1
9,"9011",69,49,49,0,0,"PCPE",0
47,"47053",116,96,96,1,0,"UPYD",0
47,"47102",286,229,224,1,5,"UPYD",4
47,"47224",91,74,74,1,0,"UPYD",1
47,"47012",118,95,95,0,0,"UPYD",0
47,"47079",62,51,51,0,0,"UPYD",0
47,"47215",54,47,46,1,1,"UPYD",0
47,"47164",377,309,307,2,2,"UPYD",1
47,"47004",1199,946,938,11,8,"UPYD",3
47,"47140",119,101,100,1,1,"UPYD",2
47,"47061",258,216,214,2,2,"UPYD",3
47,"47015",199,151,151,0,0,"UPYD",1
47,"47003",228,180,179,3,1,"UPYD",0
47,"47199",80,59,59,2,0,"UPYD",0
47,"47184",576,463,462,2,1,"UPYD",5
47,"47073",120,98,97,1,1,"UPYD",0
47,"47192",105,80,79,1,1,"UPYD",0
47,"47145",611,451,449,4,2,"UPYD",0
47,"47006",190,145,144,1,1,"UPYD",0
47,"47154",155,128,127,0,1,"UPYD",1
47,"47206",95,81,81,0,0,"UPYD",2
47,"47112",2592,2063,2043,20,20,"UPYD",5
47,"47067",178,126,126,3,0,"UPYD",0
47,"47189",152,128,128,0,0,"UPYD",0
47,"47180",83,64,64,1,0,"UPYD",0
47,"47218",995,760,754,6,6,"UPYD",2
47,"47105",192,164,163,0,1,"UPYD",1
47,"47044",330,291,287,0,4,"UPYD",4
47,"47035",930,745,739,10,6,"UPYD",7
47,"47082",803,641,633,5,8,"UPYD",8
47,"47182",1342,1037,1023,16,14,"UPYD",2
47,"47157",515,442,441,3,1,"UPYD",0
47,"47210",372,289,286,1,3,"UPYD",3
47,"47185",98,79,79,0,0,"UPYD",0
47,"47009",106,80,80,1,0,"UPYD",0
47,"47040",63,52,51,1,1,"UPYD",0
47,"47194",301,242,239,1,3,"UPYD",5
47,"47070",41,32,32,1,0,"UPYD",0
47,"47027",2746,2120,2095,8,25,"UPYD",20
47,"47111",1009,794,789,4,5,"UPYD",3
47,"47212",388,322,322,3,0,"UPYD",0
47,"47174",275,222,218,2,4,"UPYD",3
47,"47228",445,359,357,4,2,"UPYD",2
47,"47187",89,57,56,2,1,"UPYD",0
47,"47055",202,170,168,1,2,"UPYD",2
47,"47118",161,119,118,0,1,"UPYD",0
47,"47014",50,45,45,0,0,"UPYD",0
47,"47054",638,501,496,6,5,"UPYD",2
47,"47144",78,66,65,2,1,"UPYD",0
47,"47188",112,85,85,0,0,"UPYD",0
47,"47091",89,67,66,0,1,"UPYD",1
47,"47123",469,395,386,4,9,"UPYD",6
47,"47029",57,48,47,1,1,"UPYD",0
47,"47126",49,36,36,0,0,"UPYD",0
47,"47017",201,161,158,3,3,"UPYD",0
47,"47232",99,75,74,0,1,"UPYD",0
47,"47128",60,51,49,1,2,"UPYD",1
47,"47036",229,184,179,2,5,"UPYD",1
47,"47170",36,30,29,2,1,"UPYD",0
47,"47138",237,180,176,1,4,"UPYD",2
47,"47038",108,82,82,0,0,"UPYD",0
47,"47066",1255,1005,996,7,9,"UPYD",13
47,"47158",906,686,668,3,18,"UPYD",5
47,"47113",156,121,121,0,0,"UPYD",0
47,"47074",150,125,125,1,0,"UPYD",0
47,"47168",31,28,27,0,1,"UPYD",0
47,"47181",168,135,134,0,1,"UPYD",0
47,"47024",262,206,205,2,1,"UPYD",0
47,"47001",55,51,50,2,1,"UPYD",0
47,"47178",175,146,146,1,0,"UPYD",1
47,"47025",120,97,97,2,0,"UPYD",1
47,"47149",43,33,32,1,1,"UPYD",0
47,"47127",135,98,96,1,2,"UPYD",0
47,"47214",1420,1111,1093,9,18,"UPYD",4
47,"47165",6987,5301,5115,63,186,"UPYD",34
47,"47141",134,102,101,1,1,"UPYD",0
47,"47114",4074,2868,2826,20,42,"UPYD",15
47,"47131",178,132,131,3,1,"UPYD",0
47,"47119",90,75,75,1,0,"UPYD",0
47,"47030",1006,785,770,10,15,"UPYD",8
47,"47023",2999,2457,2445,20,12,"UPYD",31
47,"47134",164,126,119,4,7,"UPYD",1
47,"47080",30,22,22,0,0,"UPYD",1
47,"47196",35,26,26,1,0,"UPYD",1
47,"47088",110,87,87,0,0,"UPYD",0
47,"47155",3239,2400,2374,27,26,"UPYD",17
47,"47020",278,230,227,1,3,"UPYD",4
47,"47143",127,99,99,0,0,"UPYD",0
47,"47186",246602,193774,192412,1384,1362,"UPYD",1954
47,"47125",59,43,43,1,0,"UPYD",0
47,"47097",331,268,263,1,5,"UPYD",0
47,"47021",76,65,65,1,0,"UPYD",2
47,"47227",64,52,52,0,0,"UPYD",4
47,"47132",45,37,35,0,2,"UPYD",0
47,"47103",259,211,211,4,0,"UPYD",0
47,"47087",379,318,314,4,4,"UPYD",1
47,"47225",81,61,60,2,1,"UPYD",0
47,"47200",82,64,64,1,0,"UPYD",0
47,"47109",171,131,130,1,1,"UPYD",4
47,"47059",97,71,71,0,0,"UPYD",1
47,"47167",242,201,197,3,4,"UPYD",1
47,"47060",262,218,214,0,4,"UPYD",2
47,"47106",50,41,41,0,0,"UPYD",1
47,"47219",42,36,34,2,2,"UPYD",0
47,"47176",224,139,135,5,4,"UPYD",1
47,"47204",260,199,193,2,6,"UPYD",0
47,"47078",164,129,124,1,5,"UPYD",0
47,"47217",1896,1436,1420,20,16,"UPYD",17
47,"47171",418,333,332,9,1,"UPYD",2
47,"47090",2418,1805,1776,17,29,"UPYD",6
47,"47071",417,348,344,2,4,"UPYD",5
47,"47110",455,363,357,3,6,"UPYD",2
47,"47133",2665,2140,2118,25,22,"UPYD",24
47,"47081",47,40,40,0,0,"UPYD",0
47,"47050",3757,2829,2812,29,17,"UPYD",18
47,"47216",115,101,99,2,2,"UPYD",0
47,"47011",568,469,464,1,5,"UPYD",0
47,"47146",260,205,204,1,1,"UPYD",5
47,"47151",27,22,21,0,1,"UPYD",0
47,"47147",119,91,91,0,0,"UPYD",0
47,"47096",135,108,107,2,1,"UPYD",1
47,"47207",277,216,212,3,4,"UPYD",0
47,"47115",287,238,237,4,1,"UPYD",1
47,"47043",302,239,239,3,0,"UPYD",1
47,"47094",132,103,101,1,2,"UPYD",0
47,"47179",398,299,295,3,4,"UPYD",2
47,"47058",206,149,149,2,0,"UPYD",2
47,"47209",42,30,30,1,0,"UPYD",0
47,"47226",161,128,127,1,1,"UPYD",0
47,"47156",169,137,135,1,2,"UPYD",0
47,"47191",110,74,74,0,0,"UPYD",2
47,"47069",127,113,111,0,2,"UPYD",0
47,"47162",73,61,61,0,0,"UPYD",0
47,"47139",1047,790,785,7,5,"UPYD",5
47,"47002",25,23,23,0,0,"UPYD",0
47,"47173",883,686,675,4,11,"UPYD",3
47,"47135",84,76,76,2,0,"UPYD",0
47,"47022",57,50,46,0,4,"UPYD",0
47,"47122",2034,1666,1635,21,31,"UPYD",10
47,"47197",888,693,687,10,6,"UPYD",0
47,"47150",278,217,214,2,3,"UPYD",0
47,"47041",149,124,123,2,1,"UPYD",1
47,"47231",4384,3457,3432,33,25,"UPYD",16
47,"47007",3748,2869,2835,24,34,"UPYD",25
47,"47018",35,31,28,0,3,"UPYD",0
47,"47013",99,74,73,0,1,"UPYD",0
47,"47031",186,145,144,1,1,"UPYD",0
47,"47099",152,128,127,1,1,"UPYD",0
47,"47101",1720,1404,1388,10,16,"UPYD",3
47,"47048",190,140,138,0,2,"UPYD",0
47,"47195",461,348,348,3,0,"UPYD",2
47,"47161",3903,3200,3183,25,17,"UPYD",32
47,"47098",583,488,487,6,1,"UPYD",0
47,"47051",338,274,272,0,2,"UPYD",0
47,"47169",68,57,57,0,0,"UPYD",0
47,"47175",6575,4991,4937,51,54,"UPYD",62
47,"47084",1171,911,898,15,13,"UPYD",5
47,"47049",100,78,78,1,0,"UPYD",0
47,"47172",148,120,120,1,0,"UPYD",0
47,"47229",215,151,150,1,1,"UPYD",0
47,"47032",153,120,118,0,2,"UPYD",0
47,"47203",67,54,54,0,0,"UPYD",0
47,"47019",86,67,65,1,2,"UPYD",0
47,"47160",430,334,329,5,5,"UPYD",0
47,"47163",299,236,235,6,1,"UPYD",1
47,"47152",86,64,64,1,0,"UPYD",0
47,"47190",93,80,78,4,2,"UPYD",0
47,"47223",158,129,125,3,4,"UPYD",1
47,"47085",16668,12248,12132,133,116,"UPYD",74
47,"47221",109,91,91,0,0,"UPYD",0
47,"47076",17375,13778,13684,111,94,"UPYD",132
47,"47230",302,243,241,0,2,"UPYD",3
47,"47026",49,40,40,0,0,"UPYD",0
47,"47095",39,36,35,0,1,"UPYD",0
47,"47117",297,219,216,4,3,"UPYD",2
47,"47213",115,83,83,0,0,"UPYD",0
47,"47064",31,29,28,2,1,"UPYD",0
47,"47166",265,203,199,3,4,"UPYD",0
47,"47016",71,58,57,0,1,"UPYD",2
47,"47077",247,190,189,2,1,"UPYD",3
47,"47063",101,82,81,2,1,"UPYD",0
47,"47033",199,154,153,3,1,"UPYD",2
47,"47039",188,149,148,1,1,"UPYD",0
47,"47062",163,131,131,0,0,"UPYD",0
47,"47083",80,62,61,2,1,"UPYD",1
47,"47208",59,38,37,3,1,"UPYD",0
47,"47008",24,18,18,0,0,"UPYD",0
47,"47046",121,93,93,0,0,"UPYD",2
47,"47222",80,68,68,3,0,"UPYD",0
47,"47037",174,146,141,2,5,"UPYD",2
47,"47121",553,436,428,5,8,"UPYD",1
47,"47220",166,124,124,1,0,"UPYD",0
47,"47075",4871,3802,3763,30,39,"UPYD",18
47,"47183",130,105,105,0,0,"UPYD",0
47,"47104",2857,2313,2253,19,60,"UPYD",7
47,"47137",29,28,28,1,0,"UPYD",0
47,"47028",33,20,20,0,0,"UPYD",0
47,"47093",817,654,642,9,12,"UPYD",0
47,"47116",413,330,324,1,6,"UPYD",2
47,"47129",879,700,688,6,12,"UPYD",4
47,"47142",148,114,113,0,1,"UPYD",0
47,"47052",6584,5222,5163,41,59,"UPYD",58
47,"47047",202,157,157,3,0,"UPYD",1
47,"47010",13613,10963,10895,108,68,"UPYD",103
47,"47057",248,194,194,2,0,"UPYD",0
47,"47130",99,78,78,1,0,"UPYD",2
47,"47092",110,93,92,0,1,"UPYD",0
47,"47086",3926,3065,3028,27,37,"UPYD",10
47,"47056",82,58,57,0,1,"UPYD",0
47,"47153",108,74,73,1,1,"UPYD",0
47,"47177",107,78,76,0,2,"UPYD",0
47,"47005",548,426,421,4,5,"UPYD",1
47,"47089",153,122,120,2,2,"UPYD",1
47,"47045",768,586,580,0,6,"UPYD",1
47,"47068",36,27,27,0,0,"UPYD",1
47,"47034",76,59,58,1,1,"UPYD",0
47,"47042",54,41,41,3,0,"UPYD",0
47,"47100",140,119,117,2,2,"UPYD",0
47,"47198",66,47,47,0,0,"UPYD",0
47,"47205",385,281,274,7,7,"UPYD",2
47,"47159",828,654,646,0,8,"UPYD",5
47,"47148",439,336,335,2,1,"UPYD",2
47,"47193",1583,1313,1294,12,19,"UPYD",12
47,"47065",863,681,671,4,10,"UPYD",4
47,"47211",49,39,37,1,2,"UPYD",0
47,"47124",399,329,328,4,1,"UPYD",5
39,"39031",1235,873,863,5,10,"VOX",0
39,"39059",8057,6049,5972,50,77,"VOX",13
39,"39014",898,655,644,8,11,"VOX",0
39,"39090",756,564,550,4,14,"VOX",4
39,"39051",67,62,61,1,1,"VOX",0
39,"39064",1349,1036,1016,6,20,"VOX",4
39,"39026",1751,1303,1295,9,8,"VOX",1
39,"39077",246,186,182,0,4,"VOX",0
39,"39012",6693,5213,5131,44,82,"VOX",11
39,"39054",4472,3478,3441,45,37,"VOX",9
39,"39095",2268,1812,1789,9,23,"VOX",2
39,"39088",71,51,51,0,0,"VOX",0
39,"39004",1539,1177,1160,12,17,"VOX",3
39,"39045",376,284,276,1,8,"VOX",1
39,"39093",307,232,232,1,0,"VOX",2
39,"39084",843,608,604,5,4,"VOX",0
39,"39048",1697,1372,1361,10,11,"VOX",2
39,"39081",435,349,342,3,7,"VOX",0
39,"39083",1139,747,739,6,8,"VOX",0
39,"39055",1118,838,826,6,12,"VOX",7
39,"39027",3139,2493,2439,30,54,"VOX",2
39,"39032",1476,1117,1100,8,17,"VOX",2
39,"39001",2127,1651,1631,17,20,"VOX",0
39,"39002",3313,2430,2391,17,39,"VOX",1
39,"39074",6905,5370,5288,52,82,"VOX",13
39,"39086",357,260,258,1,2,"VOX",1
39,"39022",987,735,730,7,5,"VOX",0
39,"39065",256,202,200,6,2,"VOX",0
39,"39023",6316,4900,4827,37,73,"VOX",15
39,"39020",23612,16515,16334,125,181,"VOX",40
39,"39076",3491,2696,2662,24,34,"VOX",4
39,"39034",286,180,179,4,1,"VOX",1
39,"39066",868,697,688,7,9,"VOX",1
39,"39044",3833,2889,2860,26,29,"VOX",7
39,"39073",9806,7636,7574,42,62,"VOX",24
39,"39060",6705,5437,5339,46,98,"VOX",8
39,"39013",515,378,375,1,3,"VOX",0
39,"39005",1396,1089,1084,4,5,"VOX",3
39,"39016",23860,18608,18405,149,203,"VOX",45
39,"39094",854,644,637,9,7,"VOX",0
39,"39036",983,774,770,8,4,"VOX",2
39,"39057",2321,1773,1746,13,27,"VOX",4
39,"39015",862,650,643,6,7,"VOX",2
39,"39024",1882,1452,1438,14,14,"VOX",2
39,"39046",1402,1015,985,11,30,"VOX",2
39,"39047",1978,1463,1448,15,15,"VOX",4
39,"39098",1422,1078,1074,11,4,"VOX",0
39,"39085",6834,5319,5265,37,54,"VOX",10
39,"39037",2003,1570,1547,8,23,"VOX",3
39,"39007",434,298,297,1,1,"VOX",0
39,"39017",571,385,377,2,8,"VOX",0
39,"39058",831,594,592,6,2,"VOX",1
39,"39028",3733,2918,2877,17,41,"VOX",3
39,"39068",659,486,479,2,7,"VOX",1
39,"39038",1463,1039,1030,6,9,"VOX",4
39,"39006",1728,1353,1337,12,16,"VOX",3
39,"39018",4211,3389,3329,27,60,"VOX",2
39,"39003",299,219,217,0,2,"VOX",0
39,"39075",137597,102862,102053,819,809,"VOX",408
39,"39069",1968,1586,1555,12,31,"VOX",5
39,"39052",18086,14014,13852,124,162,"VOX",44
39,"39035",9587,7315,7214,56,101,"VOX",11
39,"39025",8693,6696,6583,58,113,"VOX",14
39,"39096",702,477,474,3,3,"VOX",0
39,"39099",3117,2446,2406,23,40,"VOX",5
39,"39079",8951,6734,6657,54,77,"VOX",3
39,"39089",149,104,103,1,1,"VOX",0
39,"39019",2098,1669,1646,24,23,"VOX",3
39,"39063",973,725,720,7,5,"VOX",1
39,"39039",572,397,396,1,1,"VOX",1
39,"39070",146,111,109,3,2,"VOX",1
39,"39080",3552,2734,2701,17,33,"VOX",4
39,"39029",624,507,503,4,4,"VOX",0
39,"39100",869,628,617,12,11,"VOX",1
39,"39056",2326,1805,1775,17,30,"VOX",1
39,"39067",813,569,561,5,8,"VOX",0
39,"39009",3223,2395,2370,22,25,"VOX",7
39,"39053",219,135,135,1,0,"VOX",0
39,"39043",1468,1167,1151,10,16,"VOX",1
39,"39087",42262,32560,32124,234,436,"VOX",43
39,"39097",713,409,400,10,9,"VOX",1
39,"39033",578,432,432,5,0,"VOX",0
39,"39030",1894,1314,1290,9,24,"VOX",2
39,"39050",276,173,170,0,3,"VOX",0
39,"39040",4290,3337,3309,22,28,"VOX",8
39,"39010",639,509,505,5,4,"VOX",1
39,"39101",292,206,202,2,4,"VOX",0
39,"39061",3488,2746,2722,29,24,"VOX",13
39,"39091",1947,1572,1552,9,20,"VOX",7
39,"39071",405,277,272,2,5,"VOX",0
39,"39078",1413,1045,1032,10,13,"VOX",1
39,"39011",1602,1211,1202,13,9,"VOX",3
39,"39041",1764,1416,1395,10,21,"VOX",4
39,"39021",495,399,391,4,8,"VOX",0
39,"39072",343,213,213,1,0,"VOX",0
39,"39092",916,668,663,4,5,"VOX",0
39,"39082",1658,1212,1202,15,10,"VOX",0
39,"39102",2281,1647,1631,13,16,"VOX",2
39,"39042",5968,4614,4572,33,42,"VOX",4
39,"39062",1824,1400,1392,14,8,"VOX",5
39,"39008",13932,10600,10506,92,94,"VOX",21
39,"39049",330,251,248,1,3,"VOX",1
35,"35020",6054,4073,4018,26,55,"IU-UPeC",47
35,"35004",38814,20869,20641,192,228,"IU-UPeC",582
35,"35013",6609,4997,4881,51,116,"IU-UPeC",147
35,"35006",30302,21967,21625,243,342,"IU-UPeC",663
35,"35025",1801,1239,1216,9,23,"IU-UPeC",25
35,"35026",80806,53749,52665,450,1084,"IU-UPeC",1699
35,"35018",12463,7628,7546,56,82,"IU-UPeC",299
35,"35014",11169,6234,6107,59,127,"IU-UPeC",182
35,"35029",4125,2545,2514,34,31,"IU-UPeC",66
35,"35007",515,332,330,2,2,"IU-UPeC",12
35,"35005",1071,718,711,6,7,"IU-UPeC",12
35,"35032",3432,2541,2498,19,43,"IU-UPeC",74
35,"35033",6378,4412,4354,24,58,"IU-UPeC",132
35,"35002",23129,15904,15675,74,229,"IU-UPeC",454
35,"35017",25447,15415,15079,127,336,"IU-UPeC",440
35,"35023",11680,8467,8295,75,172,"IU-UPeC",175
35,"35027",10311,7497,7364,58,133,"IU-UPeC",226
35,"35012",10331,5684,5610,32,74,"IU-UPeC",104
35,"35021",14942,10691,10537,80,154,"IU-UPeC",312
35,"35028",9705,5552,5478,64,74,"IU-UPeC",144
35,"35030",9205,5602,5501,58,101,"IU-UPeC",144
35,"35024",13621,8665,8555,76,110,"IU-UPeC",290
35,"35019",32253,19902,19621,126,281,"IU-UPeC",405
35,"35015",9870,5451,5368,29,83,"IU-UPeC",150
35,"35001",4599,3455,3396,27,59,"IU-UPeC",83
35,"35011",23882,16369,16095,107,274,"IU-UPeC",581
35,"35009",19832,14305,14036,97,269,"IU-UPeC",413
35,"35003",5125,2989,2929,21,60,"IU-UPeC",66
35,"35016",297974,198159,195935,1546,2224,"IU-UPeC",5999
35,"35031",7270,5184,5000,36,184,"IU-UPeC",178
35,"35008",6109,4631,4542,37,89,"IU-UPeC",112
35,"35022",48059,30474,30134,219,340,"IU-UPeC",790
35,"35034",7707,3921,3872,30,49,"IU-UPeC",167
35,"35010",3548,2371,2336,20,35,"IU-UPeC",62
30,"30004",1141,938,933,5,5,"PCPE",1
30,"30029",11815,8365,8296,67,69,"PCPE",14
30,"30042",1918,1518,1500,6,18,"PCPE",5
30,"30034",1138,859,846,5,13,"PCPE",2
30,"30030",312625,235232,233576,1438,1656,"PCPE",292
30,"30037",18726,13183,13027,73,156,"PCPE",15
30,"30011",4706,3582,3541,20,41,"PCPE",3
30,"30033",10144,7591,7505,86,86,"PCPE",13
30,"30003",24305,16558,16419,122,139,"PCPE",34
30,"30002",9921,7263,7166,34,97,"PCPE",8
30,"30005",29559,21408,21203,123,205,"PCPE",31
30,"30027",47867,36054,35794,181,260,"PCPE",47
30,"30041",13640,9156,9092,52,64,"PCPE",11
30,"30043",24972,19411,19139,154,272,"PCPE",59
30,"30040",727,627,620,1,7,"PCPE",2
30,"30015",19154,13947,13835,77,112,"PCPE",11
30,"30028",6690,5005,4938,29,67,"PCPE",12
30,"30021",9101,6106,6034,25,72,"PCPE",7
30,"30018",7903,5990,5912,29,78,"PCPE",5
30,"30006",803,683,681,2,2,"PCPE",0
30,"30009",12392,9724,9599,40,125,"PCPE",18
30,"30007",6415,4554,4515,19,39,"PCPE",2
30,"30022",16894,11661,11498,119,163,"PCPE",34
30,"30901",10331,7925,7833,54,92,"PCPE",15
30,"30025",4900,3777,3727,20,50,"PCPE",2
30,"30024",58529,42392,42072,275,320,"PCPE",44
30,"30016",151577,103359,102538,620,821,"PCPE",170
30,"30035",18616,13185,13085,70,100,"PCPE",14
30,"30019",25921,18079,17894,121,185,"PCPE",13
30,"30012",9101,7170,7091,46,79,"PCPE",9
30,"30038",15381,10881,10797,51,84,"PCPE",13
30,"30010",6861,5287,5220,38,67,"PCPE",4
30,"30026",15722,10147,10024,49,123,"PCPE",17
30,"30017",11635,8718,8646,46,72,"PCPE",10
30,"30031",498,424,421,2,3,"PCPE",1
30,"30032",2849,2188,2161,10,27,"PCPE",2
30,"30023",3762,2871,2837,14,34,"PCPE",8
30,"30001",4596,3602,3572,20,30,"PCPE",3
30,"30902",8022,5454,5412,34,42,"PCPE",10
30,"30039",19199,13538,13405,101,133,"PCPE",27
30,"30020",6261,4502,4459,25,43,"PCPE",9
30,"30008",13860,10066,9945,74,121,"PCPE",26
30,"30013",7395,5320,5277,38,43,"PCPE",5
30,"30014",1598,1270,1258,5,12,"PCPE",3
30,"30036",14624,10139,9988,70,151,"PCPE",12
6,"6079",645,502,488,1,14,"IU-UPeC",4
6,"6067",1984,1408,1377,9,31,"IU-UPeC",18
6,"6101",466,386,382,0,4,"IU-UPeC",3
6,"6053",607,459,450,2,9,"IU-UPeC",29
6,"6070",7753,5773,5645,52,128,"IU-UPeC",113
6,"6023",4362,3200,3168,11,32,"IU-UPeC",80
6,"6075",477,401,389,2,12,"IU-UPeC",7
6,"6010",1111,877,863,7,14,"IU-UPeC",109
6,"6065",309,257,247,0,10,"IU-UPeC",0
6,"6089",598,491,488,3,3,"IU-UPeC",8
6,"6005",1717,1271,1258,10,13,"IU-UPeC",13
6,"6085",3427,2563,2524,21,39,"IU-UPeC",93
6,"6071",247,208,203,0,5,"IU-UPeC",3
6,"6017",274,229,228,1,1,"IU-UPeC",4
6,"6008",634,562,558,1,4,"IU-UPeC",7
6,"6016",2978,2258,2235,14,23,"IU-UPeC",37
6,"6001",696,526,521,1,5,"IU-UPeC",20
6,"6036",5085,3797,3739,29,58,"IU-UPeC",144
6,"6140",633,493,482,6,11,"IU-UPeC",1
6,"6111",507,360,359,2,1,"IU-UPeC",18
6,"6056",481,401,399,2,2,"IU-UPeC",8
6,"6131",1074,887,885,2,2,"IU-UPeC",94
6,"6059",1858,1361,1342,12,19,"IU-UPeC",31
6,"6045",499,378,378,4,0,"IU-UPeC",0
6,"6086",1233,884,874,3,10,"IU-UPeC",26
6,"6040",1002,758,754,4,4,"IU-UPeC",4
6,"6154",2798,2001,1975,17,26,"IU-UPeC",28
6,"6134",545,325,323,3,2,"IU-UPeC",3
6,"6118",206,165,164,1,1,"IU-UPeC",4
6,"6104",677,533,529,6,4,"IU-UPeC",12
6,"6046",1248,989,978,4,11,"IU-UPeC",7
6,"6083",46111,32608,32276,235,332,"IU-UPeC",1171
6,"6128",4445,3137,3116,36,21,"IU-UPeC",80
6,"6155",1890,1337,1315,15,22,"IU-UPeC",50
6,"6015",116673,82152,81388,677,764,"IU-UPeC",2166
6,"6074",4814,3717,3659,37,58,"IU-UPeC",167
6,"6052",4051,3071,3009,31,62,"IU-UPeC",59
6,"6018",761,543,539,3,4,"IU-UPeC",32
6,"6095",9493,6973,6839,97,134,"IU-UPeC",510
6,"6088",12639,8992,8885,68,107,"IU-UPeC",321
6,"6137",987,811,805,4,6,"IU-UPeC",12
6,"6069",3079,2164,2137,21,27,"IU-UPeC",46
6,"6105",631,448,443,0,5,"IU-UPeC",10
6,"6043",673,542,535,5,7,"IU-UPeC",9
6,"6026",837,632,623,2,9,"IU-UPeC",6
6,"6035",957,700,690,4,10,"IU-UPeC",10
6,"6031",466,321,316,2,5,"IU-UPeC",3
6,"6143",3338,2548,2508,23,40,"IU-UPeC",227
6,"6147",362,285,281,0,4,"IU-UPeC",5
6,"6080",1931,1498,1480,9,18,"IU-UPeC",45
6,"6098",545,408,402,1,6,"IU-UPeC",13
6,"6034",174,126,125,2,1,"IU-UPeC",4
6,"6161",315,236,231,1,5,"IU-UPeC",7
6,"6055",2058,1557,1527,21,30,"IU-UPeC",29
6,"6030",172,138,138,0,0,"IU-UPeC",0
6,"6117",1417,1044,1031,3,13,"IU-UPeC",19
6,"6130",195,174,170,0,4,"IU-UPeC",8
6,"6099",1148,768,749,5,19,"IU-UPeC",20
6,"6157",453,316,315,0,1,"IU-UPeC",3
6,"6041",460,378,375,3,3,"IU-UPeC",39
6,"6077",347,276,272,3,4,"IU-UPeC",20
6,"6113",2725,2091,2054,9,37,"IU-UPeC",121
6,"6063",3038,2413,2391,15,22,"IU-UPeC",29
6,"6108",2299,1714,1683,13,31,"IU-UPeC",41
6,"6152",1322,964,951,1,13,"IU-UPeC",58
6,"6028",4253,3716,3631,30,85,"IU-UPeC",50
6,"6100",938,776,763,2,13,"IU-UPeC",12
6,"6060",5798,4346,4261,23,85,"IU-UPeC",172
6,"6006",4595,3365,3318,27,47,"IU-UPeC",80
6,"6092",582,402,392,3,10,"IU-UPeC",8
6,"6159",2339,1429,1407,14,22,"IU-UPeC",66
6,"6024",1181,955,942,5,13,"IU-UPeC",46
6,"6145",916,717,711,9,6,"IU-UPeC",10
6,"6146",1094,848,837,5,11,"IU-UPeC",21
6,"6011",24721,17683,17506,172,177,"IU-UPeC",512
6,"6078",510,414,407,1,7,"IU-UPeC",1
6,"6002",4335,3084,3006,33,78,"IU-UPeC",139
6,"6061",1092,899,890,6,9,"IU-UPeC",15
6,"6119",701,519,514,1,5,"IU-UPeC",11
6,"6156",1169,903,898,2,5,"IU-UPeC",21
6,"6151",1094,809,801,8,8,"IU-UPeC",25
6,"6021",928,668,656,9,12,"IU-UPeC",5
6,"6106",428,295,293,2,2,"IU-UPeC",8
6,"6093",4472,3476,3416,22,60,"IU-UPeC",45
6,"6048",848,716,700,0,16,"IU-UPeC",9
6,"6124",1739,1309,1287,15,22,"IU-UPeC",15
6,"6102",1055,843,830,3,13,"IU-UPeC",11
6,"6110",151,107,104,0,3,"IU-UPeC",2
6,"6125",1754,1327,1304,7,23,"IU-UPeC",25
6,"6082",382,312,306,3,6,"IU-UPeC",7
6,"6094",1483,1025,1014,6,11,"IU-UPeC",6
6,"6013",265,230,224,1,6,"IU-UPeC",9
6,"6062",612,450,441,4,9,"IU-UPeC",6
6,"6022",2660,2159,2140,12,19,"IU-UPeC",38
6,"6049",1021,747,733,2,14,"IU-UPeC",21
6,"6009",206,156,156,1,0,"IU-UPeC",3
6,"6162",2938,2278,2239,17,39,"IU-UPeC",30
6,"6144",562,450,447,3,3,"IU-UPeC",17
6,"6054",5442,4185,4098,32,87,"IU-UPeC",85
6,"6072",2334,1813,1792,20,21,"IU-UPeC",30
6,"6120",3393,2635,2600,14,35,"IU-UPeC",74
6,"6050",4124,3178,3110,30,68,"IU-UPeC",118
6,"6096",226,188,182,1,6,"IU-UPeC",4
6,"6141",1741,1246,1223,13,23,"IU-UPeC",11
6,"6073",745,507,497,5,10,"IU-UPeC",71
6,"6122",6651,4654,4553,29,101,"IU-UPeC",99
6,"6064",841,672,671,6,1,"IU-UPeC",87
6,"6091",3782,2728,2690,32,38,"IU-UPeC",47
6,"6032",66,54,54,2,0,"IU-UPeC",0
6,"6019",2090,1519,1488,11,31,"IU-UPeC",87
6,"6109",3957,3258,3177,22,81,"IU-UPeC",91
6,"6136",1578,1182,1168,8,14,"IU-UPeC",52
6,"6115",1260,867,853,7,14,"IU-UPeC",44
6,"6121",3383,2518,2483,21,35,"IU-UPeC",91
6,"6047",855,664,654,2,10,"IU-UPeC",8
6,"6014",6688,4651,4586,22,65,"IU-UPeC",116
6,"6090",877,661,642,7,19,"IU-UPeC",14
6,"6112",393,335,333,0,2,"IU-UPeC",7
6,"6902",1672,1239,1224,6,15,"IU-UPeC",60
6,"6003",830,656,647,6,9,"IU-UPeC",23
6,"6107",1591,1114,1107,4,7,"IU-UPeC",13
6,"6097",2390,1814,1798,7,16,"IU-UPeC",53
6,"6029",1213,892,875,8,17,"IU-UPeC",19
6,"6057",573,471,466,1,5,"IU-UPeC",4
6,"6138",1059,795,773,3,22,"IU-UPeC",16
6,"6148",973,739,730,5,9,"IU-UPeC",66
6,"6012",3280,2358,2343,12,15,"IU-UPeC",164
6,"6037",1768,1176,1160,5,16,"IU-UPeC",13
6,"6038",801,558,551,5,7,"IU-UPeC",3
6,"6150",806,658,650,6,8,"IU-UPeC",29
6,"6042",1012,711,703,3,8,"IU-UPeC",97
6,"6903",2017,1509,1475,11,34,"IU-UPeC",27
6,"6081",1078,850,839,4,11,"IU-UPeC",18
6,"6901",2114,1648,1625,28,23,"IU-UPeC",27
6,"6103",4781,3519,3459,40,60,"IU-UPeC",103
6,"6027",681,586,576,1,10,"IU-UPeC",7
6,"6126",2183,1594,1582,9,12,"IU-UPeC",35
6,"6004",1604,1265,1248,10,17,"IU-UPeC",7
6,"6033",1330,1037,1025,10,12,"IU-UPeC",13
6,"6123",4644,3420,3357,22,63,"IU-UPeC",153
6,"6160",3154,2324,2292,12,32,"IU-UPeC",94
6,"6039",1838,1546,1517,9,29,"IU-UPeC",33
6,"6044",28899,20862,20681,153,181,"IU-UPeC",616
6,"6087",2127,1612,1592,16,20,"IU-UPeC",32
6,"6149",10342,8013,7897,70,116,"IU-UPeC",144
6,"6020",1822,1435,1406,12,29,"IU-UPeC",30
6,"6114",148,116,116,0,0,"IU-UPeC",0
6,"6129",591,466,462,3,4,"IU-UPeC",20
6,"6051",1573,1235,1222,6,13,"IU-UPeC",10
6,"6127",2893,2188,2158,13,30,"IU-UPeC",33
6,"6025",5126,3833,3783,37,50,"IU-UPeC",285
6,"6007",1483,1076,1068,6,8,"IU-UPeC",36
6,"6133",1775,1351,1334,9,17,"IU-UPeC",18
6,"6153",20417,15129,14934,112,195,"IU-UPeC",464
6,"6116",1607,1168,1149,10,19,"IU-UPeC",73
6,"6158",13305,9965,9802,91,163,"IU-UPeC",363
6,"6135",1103,904,888,9,16,"IU-UPeC",8
6,"6066",1776,1260,1245,2,15,"IU-UPeC",7
6,"6058",2055,1512,1494,14,18,"IU-UPeC",45
6,"6084",1100,857,842,4,15,"IU-UPeC",10
6,"6076",837,632,624,2,8,"IU-UPeC",84
6,"6139",553,442,436,1,6,"IU-UPeC",3
6,"6142",276,215,207,0,8,"IU-UPeC",2
6,"6132",855,634,627,4,7,"IU-UPeC",60
6,"6068",453,349,344,3,5,"IU-UPeC",11
47,"47182",1342,1037,1023,16,14,"VOX",4
47,"47006",190,145,144,1,1,"VOX",2
47,"47026",49,40,40,0,0,"VOX",0
47,"47082",803,641,633,5,8,"VOX",0
47,"47117",297,219,216,4,3,"VOX",1
47,"47076",17375,13778,13684,111,94,"VOX",41
47,"47001",55,51,50,2,1,"VOX",0
47,"47208",59,38,37,3,1,"VOX",0
47,"47218",995,760,754,6,6,"VOX",2
47,"47207",277,216,212,3,4,"VOX",2
47,"47019",86,67,65,1,2,"VOX",0
47,"47046",121,93,93,0,0,"VOX",0
47,"47213",115,83,83,0,0,"VOX",0
47,"47209",42,30,30,1,0,"VOX",0
47,"47097",331,268,263,1,5,"VOX",0
47,"47044",330,291,287,0,4,"VOX",1
47,"47184",576,463,462,2,1,"VOX",0
47,"47145",611,451,449,4,2,"VOX",2
47,"47200",82,64,64,1,0,"VOX",0
47,"47118",161,119,118,0,1,"VOX",0
47,"47100",140,119,117,2,2,"VOX",1
47,"47074",150,125,125,1,0,"VOX",2
47,"47165",6987,5301,5115,63,186,"VOX",28
47,"47166",265,203,199,3,4,"VOX",0
47,"47134",164,126,119,4,7,"VOX",0
47,"47181",168,135,134,0,1,"VOX",0
47,"47139",1047,790,785,7,5,"VOX",2
47,"47221",109,91,91,0,0,"VOX",0
47,"47102",286,229,224,1,5,"VOX",3
47,"47063",101,82,81,2,1,"VOX",0
47,"47167",242,201,197,3,4,"VOX",2
47,"47009",106,80,80,1,0,"VOX",0
47,"47050",3757,2829,2812,29,17,"VOX",6
47,"47173",883,686,675,4,11,"VOX",5
47,"47140",119,101,100,1,1,"VOX",0
47,"47170",36,30,29,2,1,"VOX",0
47,"47158",906,686,668,3,18,"VOX",0
47,"47043",302,239,239,3,0,"VOX",1
47,"47028",33,20,20,0,0,"VOX",0
47,"47191",110,74,74,0,0,"VOX",0
47,"47129",879,700,688,6,12,"VOX",4
47,"47198",66,47,47,0,0,"VOX",0
47,"47038",108,82,82,0,0,"VOX",0
47,"47222",80,68,68,3,0,"VOX",1
47,"47111",1009,794,789,4,5,"VOX",2
47,"47179",398,299,295,3,4,"VOX",0
47,"47131",178,132,131,3,1,"VOX",1
47,"47138",237,180,176,1,4,"VOX",0
47,"47073",120,98,97,1,1,"VOX",0
47,"47053",116,96,96,1,0,"VOX",0
47,"47219",42,36,34,2,2,"VOX",0
47,"47115",287,238,237,4,1,"VOX",4
47,"47205",385,281,274,7,7,"VOX",1
47,"47014",50,45,45,0,0,"VOX",1
47,"47016",71,58,57,0,1,"VOX",0
47,"47229",215,151,150,1,1,"VOX",1
47,"47093",817,654,642,9,12,"VOX",0
47,"47052",6584,5222,5163,41,59,"VOX",10
47,"47104",2857,2313,2253,19,60,"VOX",1
47,"47020",278,230,227,1,3,"VOX",1
47,"47212",388,322,322,3,0,"VOX",2
47,"47126",49,36,36,0,0,"VOX",0
47,"47096",135,108,107,2,1,"VOX",0
47,"47169",68,57,57,0,0,"VOX",0
47,"47029",57,48,47,1,1,"VOX",0
47,"47203",67,54,54,0,0,"VOX",0
47,"47188",112,85,85,0,0,"VOX",0
47,"47196",35,26,26,1,0,"VOX",0
47,"47083",80,62,61,2,1,"VOX",3
47,"47230",302,243,241,0,2,"VOX",0
47,"47047",202,157,157,3,0,"VOX",1
47,"47012",118,95,95,0,0,"VOX",0
47,"47228",445,359,357,4,2,"VOX",0
47,"47216",115,101,99,2,2,"VOX",0
47,"47231",4384,3457,3432,33,25,"VOX",11
47,"47156",169,137,135,1,2,"VOX",0
47,"47164",377,309,307,2,2,"VOX",1
47,"47123",469,395,386,4,9,"VOX",0
47,"47024",262,206,205,2,1,"VOX",0
47,"47211",49,39,37,1,2,"VOX",1
47,"47002",25,23,23,0,0,"VOX",0
47,"47109",171,131,130,1,1,"VOX",1
47,"47098",583,488,487,6,1,"VOX",1
47,"47154",155,128,127,0,1,"VOX",0
47,"47077",247,190,189,2,1,"VOX",0
47,"47065",863,681,671,4,10,"VOX",1
47,"47195",461,348,348,3,0,"VOX",1
47,"47075",4871,3802,3763,30,39,"VOX",6
47,"47192",105,80,79,1,1,"VOX",0
47,"47011",568,469,464,1,5,"VOX",0
47,"47187",89,57,56,2,1,"VOX",0
47,"47177",107,78,76,0,2,"VOX",0
47,"47137",29,28,28,1,0,"VOX",0
47,"47060",262,218,214,0,4,"VOX",0
47,"47190",93,80,78,4,2,"VOX",0
47,"47178",175,146,146,1,0,"VOX",1
47,"47226",161,128,127,1,1,"VOX",0
47,"47099",152,128,127,1,1,"VOX",0
47,"47049",100,78,78,1,0,"VOX",0
47,"47017",201,161,158,3,3,"VOX",0
47,"47215",54,47,46,1,1,"VOX",0
47,"47091",89,67,66,0,1,"VOX",0
47,"47119",90,75,75,1,0,"VOX",0
47,"47085",16668,12248,12132,133,116,"VOX",26
47,"47175",6575,4991,4937,51,54,"VOX",19
47,"47035",930,745,739,10,6,"VOX",3
47,"47103",259,211,211,4,0,"VOX",0
47,"47061",258,216,214,2,2,"VOX",0
47,"47174",275,222,218,2,4,"VOX",0
47,"47135",84,76,76,2,0,"VOX",0
47,"47210",372,289,286,1,3,"VOX",1
47,"47089",153,122,120,2,2,"VOX",0
47,"47153",108,74,73,1,1,"VOX",0
47,"47027",2746,2120,2095,8,25,"VOX",4
47,"47106",50,41,41,0,0,"VOX",1
47,"47225",81,61,60,2,1,"VOX",1
47,"47121",553,436,428,5,8,"VOX",0
47,"47147",119,91,91,0,0,"VOX",0
47,"47114",4074,2868,2826,20,42,"VOX",7
47,"47151",27,22,21,0,1,"VOX",0
47,"47186",246602,193774,192412,1384,1362,"VOX",834
47,"47127",135,98,96,1,2,"VOX",0
47,"47095",39,36,35,0,1,"VOX",0
47,"47194",301,242,239,1,3,"VOX",0
47,"47223",158,129,125,3,4,"VOX",1
47,"47133",2665,2140,2118,25,22,"VOX",1
47,"47157",515,442,441,3,1,"VOX",1
47,"47005",548,426,421,4,5,"VOX",2
47,"47146",260,205,204,1,1,"VOX",1
47,"47066",1255,1005,996,7,9,"VOX",3
47,"47081",47,40,40,0,0,"VOX",0
47,"47069",127,113,111,0,2,"VOX",0
47,"47149",43,33,32,1,1,"VOX",0
47,"47037",174,146,141,2,5,"VOX",1
47,"47023",2999,2457,2445,20,12,"VOX",11
47,"47172",148,120,120,1,0,"VOX",2
47,"47031",186,145,144,1,1,"VOX",2
47,"47040",63,52,51,1,1,"VOX",0
47,"47088",110,87,87,0,0,"VOX",0
47,"47206",95,81,81,0,0,"VOX",0
47,"47034",76,59,58,1,1,"VOX",1
47,"47032",153,120,118,0,2,"VOX",0
47,"47113",156,121,121,0,0,"VOX",0
47,"47003",228,180,179,3,1,"VOX",0
47,"47176",224,139,135,5,4,"VOX",0
47,"47110",455,363,357,3,6,"VOX",1
47,"47159",828,654,646,0,8,"VOX",2
47,"47144",78,66,65,2,1,"VOX",0
47,"47105",192,164,163,0,1,"VOX",0
47,"47030",1006,785,770,10,15,"VOX",1
47,"47132",45,37,35,0,2,"VOX",0
47,"47199",80,59,59,2,0,"VOX",0
47,"47220",166,124,124,1,0,"VOX",0
47,"47087",379,318,314,4,4,"VOX",0
47,"47171",418,333,332,9,1,"VOX",2
47,"47010",13613,10963,10895,108,68,"VOX",30
47,"47180",83,64,64,1,0,"VOX",0
47,"47042",54,41,41,3,0,"VOX",0
47,"47197",888,693,687,10,6,"VOX",2
47,"47059",97,71,71,0,0,"VOX",1
47,"47092",110,93,92,0,1,"VOX",1
47,"47056",82,58,57,0,1,"VOX",0
47,"47007",3748,2869,2835,24,34,"VOX",7
47,"47142",148,114,113,0,1,"VOX",2
47,"47148",439,336,335,2,1,"VOX",0
47,"47058",206,149,149,2,0,"VOX",5
47,"47004",1199,946,938,11,8,"VOX",1
47,"47057",248,194,194,2,0,"VOX",0
47,"47130",99,78,78,1,0,"VOX",0
47,"47214",1420,1111,1093,9,18,"VOX",0
47,"47008",24,18,18,0,0,"VOX",0
47,"47189",152,128,128,0,0,"VOX",0
47,"47051",338,274,272,0,2,"VOX",0
47,"47163",299,236,235,6,1,"VOX",0
47,"47155",3239,2400,2374,27,26,"VOX",9
47,"47232",99,75,74,0,1,"VOX",1
47,"47079",62,51,51,0,0,"VOX",0
47,"47125",59,43,43,1,0,"VOX",0
47,"47116",413,330,324,1,6,"VOX",5
47,"47070",41,32,32,1,0,"VOX",0
47,"47161",3903,3200,3183,25,17,"VOX",20
47,"47224",91,74,74,1,0,"VOX",0
47,"47141",134,102,101,1,1,"VOX",0
47,"47064",31,29,28,2,1,"VOX",0
47,"47094",132,103,101,1,2,"VOX",0
47,"47015",199,151,151,0,0,"VOX",1
47,"47227",64,52,52,0,0,"VOX",1
47,"47018",35,31,28,0,3,"VOX",0
47,"47162",73,61,61,0,0,"VOX",0
47,"47041",149,124,123,2,1,"VOX",1
47,"47143",127,99,99,0,0,"VOX",0
47,"47013",99,74,73,0,1,"VOX",0
47,"47054",638,501,496,6,5,"VOX",4
47,"47101",1720,1404,1388,10,16,"VOX",3
47,"47124",399,329,328,4,1,"VOX",0
47,"47045",768,586,580,0,6,"VOX",2
47,"47168",31,28,27,0,1,"VOX",0
47,"47183",130,105,105,0,0,"VOX",0
47,"47071",417,348,344,2,4,"VOX",2
47,"47025",120,97,97,2,0,"VOX",0
47,"47152",86,64,64,1,0,"VOX",1
47,"47036",229,184,179,2,5,"VOX",3
47,"47122",2034,1666,1635,21,31,"VOX",4
47,"47128",60,51,49,1,2,"VOX",0
47,"47217",1896,1436,1420,20,16,"VOX",4
47,"47080",30,22,22,0,0,"VOX",0
47,"47067",178,126,126,3,0,"VOX",1
47,"47039",188,149,148,1,1,"VOX",0
47,"47204",260,199,193,2,6,"VOX",0
47,"47150",278,217,214,2,3,"VOX",0
47,"47048",190,140,138,0,2,"VOX",1
47,"47021",76,65,65,1,0,"VOX",1
47,"47086",3926,3065,3028,27,37,"VOX",3
47,"47084",1171,911,898,15,13,"VOX",1
47,"47185",98,79,79,0,0,"VOX",0
47,"47112",2592,2063,2043,20,20,"VOX",3
47,"47055",202,170,168,1,2,"VOX",0
47,"47193",1583,1313,1294,12,19,"VOX",5
47,"47022",57,50,46,0,4,"VOX",0
47,"47078",164,129,124,1,5,"VOX",0
47,"47033",199,154,153,3,1,"VOX",0
47,"47068",36,27,27,0,0,"VOX",0
47,"47062",163,131,131,0,0,"VOX",0
47,"47160",430,334,329,5,5,"VOX",5
47,"47090",2418,1805,1776,17,29,"VOX",4
9,"9177",1117,830,825,5,5,"IFem",2
9,"9214",684,452,446,6,6,"IFem",0
9,"9135",41,33,33,1,0,"IFem",0
9,"9228",163,138,138,0,0,"IFem",0
9,"9439",1005,823,816,9,7,"IFem",2
9,"9340",76,49,49,0,0,"IFem",0
9,"9079",46,40,37,0,3,"IFem",0
9,"9257",92,80,78,4,2,"IFem",0
9,"9149",34,25,24,0,1,"IFem",0
9,"9430",24,19,19,0,0,"IFem",0
9,"9283",46,29,28,0,1,"IFem",0
9,"9017",89,67,62,0,5,"IFem",0
9,"9166",97,79,78,3,1,"IFem",0
9,"9378",31,21,21,1,0,"IFem",0
9,"9194",2024,1550,1530,17,20,"IFem",2
9,"9024",156,117,114,0,3,"IFem",0
9,"9368",22,14,14,1,0,"IFem",0
9,"9037",113,96,96,0,0,"IFem",0
9,"9423",27,25,25,0,0,"IFem",0
9,"9183",51,37,37,0,0,"IFem",0
9,"9235",160,124,123,0,1,"IFem",0
9,"9445",44,32,32,1,0,"IFem",0
9,"9398",75,54,54,1,0,"IFem",0
9,"9020",262,187,180,2,7,"IFem",2
9,"9266",91,72,70,0,2,"IFem",0
9,"9301",616,513,506,5,7,"IFem",0
9,"9419",78,45,44,0,1,"IFem",0
9,"9438",544,446,444,3,2,"IFem",0
9,"9180",136,102,100,2,2,"IFem",0
9,"9047",56,45,45,2,0,"IFem",0
9,"9032",108,73,73,0,0,"IFem",0
9,"9277",119,101,100,0,1,"IFem",0
9,"9440",96,78,78,0,0,"IFem",0
9,"9130",79,63,62,1,1,"IFem",0
9,"9013",47,41,41,0,0,"IFem",0
9,"9288",91,70,69,1,1,"IFem",0
9,"9302",116,87,87,0,0,"IFem",0
9,"9199",91,65,65,2,0,"IFem",0
9,"9325",195,125,123,2,2,"IFem",0
9,"9346",93,71,69,0,2,"IFem",0
9,"9354",33,30,30,1,0,"IFem",0
9,"9250",273,218,218,4,0,"IFem",0
9,"9380",78,59,57,0,2,"IFem",0
9,"9229",201,146,145,0,1,"IFem",0
9,"9281",147,109,107,0,2,"IFem",0
9,"9052",31,22,21,1,1,"IFem",0
9,"9029",168,134,132,3,2,"IFem",0
9,"9220",76,62,61,2,1,"IFem",0
9,"9168",296,233,231,1,2,"IFem",1
9,"9472",55,40,40,0,0,"IFem",0
9,"9312",98,83,82,0,1,"IFem",0
9,"9086",687,475,471,0,4,"IFem",1
9,"9425",514,369,366,2,3,"IFem",0
9,"9391",361,264,263,2,1,"IFem",0
9,"9308",67,43,43,1,0,"IFem",0
9,"9190",91,56,55,0,1,"IFem",0
9,"9159",56,48,48,1,0,"IFem",0
9,"9217",361,265,261,4,4,"IFem",0
9,"9239",53,44,42,1,2,"IFem",1
9,"9321",1640,1250,1237,5,13,"IFem",0
9,"9327",25,22,22,0,0,"IFem",0
9,"9412",803,552,550,2,2,"IFem",1
9,"9289",1466,1027,1013,6,14,"IFem",0
9,"9361",117,96,96,0,0,"IFem",0
9,"9078",41,35,33,0,2,"IFem",0
9,"9903",3251,2359,2340,24,19,"IFem",3
9,"9904",482,389,384,5,5,"IFem",0
9,"9125",596,435,433,3,2,"IFem",1
9,"9297",323,265,261,5,4,"IFem",1
9,"9396",152,118,118,1,0,"IFem",0
9,"9274",1098,880,872,9,8,"IFem",2
9,"9273",53,41,40,1,1,"IFem",0
9,"9164",165,121,121,1,0,"IFem",0
9,"9343",97,70,69,0,1,"IFem",0
9,"9115",92,69,68,0,1,"IFem",0
9,"9140",128,88,87,0,1,"IFem",0
9,"9454",47,34,34,0,0,"IFem",0
9,"9025",125,86,79,1,7,"IFem",1
9,"9088",66,44,42,1,2,"IFem",0
9,"9303",92,72,71,0,1,"IFem",0
9,"9449",87,72,71,1,1,"IFem",2
9,"9098",516,396,388,6,8,"IFem",0
9,"9414",201,148,147,1,1,"IFem",0
9,"9268",95,73,72,0,1,"IFem",0
9,"9464",36,24,24,0,0,"IFem",1
9,"9428",107,87,87,0,0,"IFem",0
9,"9026",397,314,311,1,3,"IFem",2
9,"9337",115,84,82,0,2,"IFem",0
9,"9100",59,51,50,0,1,"IFem",0
9,"9455",44,34,33,0,1,"IFem",0
9,"9238",932,576,569,6,7,"IFem",1
9,"9372",221,190,189,1,1,"IFem",0
9,"9317",16,14,14,0,0,"IFem",0
9,"9345",124,92,92,0,0,"IFem",0
9,"9075",111,83,83,1,0,"IFem",1
9,"9174",809,575,565,10,10,"IFem",0
9,"9169",99,83,81,0,2,"IFem",0
9,"9209",4511,3368,3301,37,67,"IFem",3
9,"9066",65,51,51,0,0,"IFem",0
9,"9182",78,63,61,2,2,"IFem",0
9,"9014",213,127,126,1,1,"IFem",0
9,"9019",147,103,102,1,1,"IFem",1
9,"9224",157,122,122,0,0,"IFem",0
9,"9386",58,44,43,2,1,"IFem",0
9,"9418",82,63,62,3,1,"IFem",0
9,"9251",371,273,271,3,2,"IFem",1
9,"9407",27,23,23,1,0,"IFem",2
9,"9316",104,83,80,1,3,"IFem",0
9,"9172",125,102,102,2,0,"IFem",0
9,"9363",974,730,725,3,5,"IFem",2
9,"9330",1523,1166,1148,15,18,"IFem",1
9,"9063",213,184,182,2,2,"IFem",0
9,"9901",374,268,261,3,7,"IFem",0
9,"9471",151,117,117,0,0,"IFem",1
9,"9091",732,516,512,7,4,"IFem",1
9,"9176",61,45,44,0,1,"IFem",0
9,"9201",30,17,17,0,0,"IFem",0
9,"9134",228,152,152,2,0,"IFem",0
9,"9012",93,68,66,1,2,"IFem",0
9,"9198",108,86,85,2,1,"IFem",0
9,"9218",360,272,271,2,1,"IFem",0
9,"9384",293,199,194,0,5,"IFem",0
9,"9127",55,40,40,0,0,"IFem",0
9,"9323",64,47,47,0,0,"IFem",0
9,"9117",77,61,57,0,4,"IFem",0
9,"9179",43,35,34,0,1,"IFem",0
9,"9093",154,133,128,1,5,"IFem",0
9,"9389",77,56,56,0,0,"IFem",0
9,"9338",219,173,171,1,2,"IFem",1
9,"9045",267,186,183,2,3,"IFem",0
9,"9039",58,38,38,0,0,"IFem",0
9,"9225",84,57,56,1,1,"IFem",0
9,"9041",28,28,28,1,0,"IFem",0
9,"9476",63,46,46,0,0,"IFem",0
9,"9375",35,27,27,0,0,"IFem",0
9,"9908",469,314,309,2,5,"IFem",0
9,"9409",109,87,87,0,0,"IFem",0
9,"9241",201,156,155,3,1,"IFem",0
9,"9374",90,79,77,2,2,"IFem",0
9,"9131",460,381,373,5,8,"IFem",0
9,"9216",385,283,280,8,3,"IFem",1
9,"9390",611,478,477,3,1,"IFem",0
9,"9377",625,478,471,5,7,"IFem",0
9,"9473",85,62,61,1,1,"IFem",1
9,"9332",140,107,107,1,0,"IFem",1
9,"9246",622,458,455,5,3,"IFem",0
9,"9151",458,364,363,3,1,"IFem",0
9,"9417",40,30,30,0,0,"IFem",0
9,"9112",113,75,73,2,2,"IFem",0
9,"9208",211,139,136,3,3,"IFem",0
9,"9294",111,88,86,0,2,"IFem",0
9,"9242",81,65,63,2,2,"IFem",0
9,"9478",45,38,38,0,0,"IFem",0
9,"9136",192,151,147,2,4,"IFem",1
9,"9027",47,44,41,0,3,"IFem",0
9,"9197",148,108,104,1,4,"IFem",0
9,"9351",60,46,45,1,1,"IFem",1
9,"9265",38,31,31,0,0,"IFem",0
9,"9429",56,41,41,0,0,"IFem",0
9,"9309",306,216,211,2,5,"IFem",0
9,"9048",1484,1120,1106,4,14,"IFem",2
9,"9137",167,128,128,1,0,"IFem",0
9,"9057",144,116,115,0,1,"IFem",0
9,"9010",32,23,23,2,0,"IFem",0
9,"9434",1221,985,970,10,15,"IFem",1
9,"9408",41,34,34,1,0,"IFem",0
9,"9148",86,73,69,5,4,"IFem",0
9,"9021",56,33,31,0,2,"IFem",0
9,"9460",177,135,135,2,0,"IFem",0
9,"9232",151,125,124,2,1,"IFem",0
9,"9058",393,293,289,2,4,"IFem",0
9,"9256",362,261,255,2,6,"IFem",0
9,"9243",75,56,54,1,2,"IFem",0
9,"9295",60,37,37,0,0,"IFem",0
9,"9184",5,4,4,0,0,"IFem",0
9,"9104",54,43,43,0,0,"IFem",0
9,"9124",1520,1113,1096,9,17,"IFem",0
9,"9046",30,26,26,0,0,"IFem",0
9,"9456",129,90,90,2,0,"IFem",0
9,"9189",130,88,86,2,2,"IFem",0
9,"9167",59,42,42,2,0,"IFem",0
9,"9353",73,57,56,0,1,"IFem",0
9,"9170",203,152,149,1,3,"IFem",1
9,"9038",118,97,94,0,3,"IFem",0
9,"9362",204,168,164,0,4,"IFem",1
9,"9200",48,37,36,0,1,"IFem",0
9,"9276",387,280,273,2,7,"IFem",2
9,"9272",294,206,203,1,3,"IFem",0
9,"9231",70,49,49,3,0,"IFem",0
9,"9009",163,130,128,2,2,"IFem",1
9,"9163",602,479,472,5,7,"IFem",0
9,"9304",202,166,163,1,3,"IFem",0
9,"9060",148,123,123,0,0,"IFem",0
9,"9213",320,223,220,4,3,"IFem",0
9,"9432",189,143,140,1,3,"IFem",0
9,"9280",27,17,17,0,0,"IFem",0
9,"9054",100,73,72,3,1,"IFem",1
9,"9248",78,57,57,0,0,"IFem",0
9,"9173",123,93,93,1,0,"IFem",0
9,"9074",788,609,598,8,11,"IFem",0
9,"9442",380,287,282,2,5,"IFem",0
9,"9422",18,10,10,0,0,"IFem",0
9,"9067",442,308,303,9,5,"IFem",0
9,"9247",23,19,19,0,0,"IFem",0
9,"9084",189,150,148,7,2,"IFem",0
9,"9195",57,42,42,2,0,"IFem",0
9,"9061",166,124,123,1,1,"IFem",0
9,"9415",267,166,165,0,1,"IFem",0
9,"9306",113,91,91,1,0,"IFem",0
9,"9105",107,88,86,0,2,"IFem",0
9,"9016",85,64,64,2,0,"IFem",1
9,"9051",168,133,132,1,1,"IFem",0
9,"9129",105,87,87,0,0,"IFem",0
9,"9255",86,66,62,0,4,"IFem",0
9,"9406",252,196,195,1,1,"IFem",0
9,"9310",13,9,8,0,1,"IFem",0
9,"9352",116,97,97,0,0,"IFem",0
9,"9090",57,51,51,1,0,"IFem",0
9,"9215",377,264,260,0,4,"IFem",0
9,"9227",119,97,95,0,2,"IFem",0
9,"9307",113,91,91,0,0,"IFem",0
9,"9451",238,199,198,1,1,"IFem",0
9,"9411",149,111,111,0,0,"IFem",0
9,"9355",101,75,73,0,2,"IFem",0
9,"9160",90,71,70,0,1,"IFem",0
9,"9480",110,89,88,1,1,"IFem",0
9,"9102",37,31,31,0,0,"IFem",0
9,"9003",192,148,146,2,2,"IFem",0
9,"9139",101,75,73,2,2,"IFem",0
9,"9192",55,47,46,0,1,"IFem",2
9,"9358",249,191,191,1,0,"IFem",1
9,"9144",52,40,40,0,0,"IFem",0
9,"9350",480,358,347,5,11,"IFem",1
9,"9298",82,62,62,0,0,"IFem",0
9,"9458",466,380,377,3,3,"IFem",0
9,"9065",147,124,123,2,1,"IFem",0
9,"9223",46,39,39,0,0,"IFem",0
9,"9381",32,23,22,0,1,"IFem",0
9,"9056",4931,3634,3602,35,32,"IFem",4
9,"9120",39,35,35,0,0,"IFem",0
9,"9292",92,72,70,0,2,"IFem",0
9,"9403",96,78,76,1,2,"IFem",0
9,"9485",55,43,43,1,0,"IFem",0
9,"9033",89,75,75,0,0,"IFem",0
9,"9388",36,31,30,1,1,"IFem",0
9,"9123",40,35,35,0,0,"IFem",0
9,"9064",332,275,275,3,0,"IFem",0
9,"9141",610,499,493,4,6,"IFem",1
9,"9253",111,96,94,1,2,"IFem",0
9,"9360",30,27,27,0,0,"IFem",0
9,"9113",464,383,376,6,7,"IFem",0
9,"9328",77,55,55,1,0,"IFem",0
9,"9405",128,89,89,0,0,"IFem",0
9,"9059",136713,106605,105601,976,1004,"IFem",197
9,"9030",109,76,76,3,0,"IFem",0
9,"9421",237,172,172,2,0,"IFem",1
9,"9191",39,32,30,0,2,"IFem",0
9,"9094",51,42,41,0,1,"IFem",1
9,"9482",34,29,28,0,1,"IFem",0
9,"9181",302,231,225,3,6,"IFem",1
9,"9226",66,55,53,0,2,"IFem",0
9,"9202",24,22,22,1,0,"IFem",0
9,"9387",118,96,95,0,1,"IFem",0
9,"9162",143,108,108,0,0,"IFem",0
9,"9114",87,67,67,0,0,"IFem",0
9,"9196",154,108,107,1,1,"IFem",0
9,"9269",39,33,32,0,1,"IFem",0
9,"9132",173,132,130,0,2,"IFem",2
9,"9373",440,285,282,3,3,"IFem",0
9,"9249",47,37,37,1,0,"IFem",0
9,"9044",46,38,37,0,1,"IFem",0
9,"9262",161,129,129,0,0,"IFem",0
9,"9108",378,290,287,2,3,"IFem",0
9,"9122",96,66,66,0,0,"IFem",0
9,"9447",42,38,38,0,0,"IFem",0
9,"9072",307,240,239,1,1,"IFem",0
9,"9392",53,40,40,0,0,"IFem",0
9,"9103",221,185,184,2,1,"IFem",0
9,"9036",38,31,30,2,1,"IFem",0
9,"9043",189,132,132,2,0,"IFem",0
9,"9441",74,66,66,0,0,"IFem",0
9,"9258",173,139,136,4,3,"IFem",0
9,"9287",208,170,168,2,2,"IFem",1
9,"9427",1428,1014,1003,12,11,"IFem",0
9,"9443",183,132,129,1,3,"IFem",0
9,"9347",141,113,109,4,4,"IFem",0
9,"9109",1068,698,669,10,29,"IFem",2
9,"9906",1223,952,947,9,5,"IFem",1
9,"9318",61,38,38,0,0,"IFem",0
9,"9450",27,21,20,1,1,"IFem",0
9,"9073",926,753,748,10,5,"IFem",2
9,"9311",60,52,50,0,2,"IFem",0
9,"9275",192,138,137,1,1,"IFem",0
9,"9466",134,99,99,0,0,"IFem",0
9,"9394",727,558,552,8,6,"IFem",0
9,"9236",38,32,32,0,0,"IFem",0
9,"9006",61,41,41,0,0,"IFem",0
9,"9001",27,26,26,0,0,"IFem",0
9,"9905",391,308,308,5,0,"IFem",0
9,"9267",115,101,100,3,1,"IFem",1
9,"9221",445,337,335,1,2,"IFem",1
9,"9071",45,34,34,0,0,"IFem",0
9,"9365",31,20,20,0,0,"IFem",0
9,"9369",442,331,328,1,3,"IFem",0
9,"9259",233,184,184,3,0,"IFem",0
9,"9467",66,46,46,3,0,"IFem",0
9,"9101",79,59,59,0,0,"IFem",0
9,"9315",379,269,267,2,2,"IFem",0
9,"9416",52,39,39,0,0,"IFem",0
9,"9410",3051,2169,2153,18,16,"IFem",4
9,"9433",60,52,51,0,1,"IFem",0
9,"9133",40,34,34,0,0,"IFem",1
9,"9083",37,33,33,0,0,"IFem",0
9,"9068",29,23,22,0,1,"IFem",0
9,"9055",52,39,38,0,1,"IFem",0
9,"9366",90,64,63,1,1,"IFem",0
9,"9244",47,26,26,1,0,"IFem",0
9,"9034",280,237,233,5,4,"IFem",1
9,"9431",119,99,98,0,1,"IFem",0
9,"9334",48,39,38,0,1,"IFem",0
9,"9155",26,20,20,1,0,"IFem",0
9,"9335",87,72,71,0,1,"IFem",0
9,"9413",447,333,333,5,0,"IFem",1
9,"9424",32,26,26,1,0,"IFem",0
9,"9018",24702,18365,18158,174,207,"IFem",26
9,"9152",263,193,192,0,1,"IFem",0
9,"9007",59,41,41,0,0,"IFem",0
9,"9326",148,115,113,2,2,"IFem",1
9,"9154",142,104,104,2,0,"IFem",0
9,"9446",12,7,7,0,0,"IFem",0
9,"9907",1420,1120,1115,13,5,"IFem",3
9,"9444",72,48,48,2,0,"IFem",0
9,"9270",163,122,121,1,1,"IFem",0
9,"9119",46,27,27,0,0,"IFem",0
9,"9128",82,66,66,0,0,"IFem",0
9,"9076",23,14,14,0,0,"IFem",0
9,"9339",128,103,103,0,0,"IFem",0
9,"9175",129,92,92,0,0,"IFem",0
9,"9261",463,339,330,8,9,"IFem",0
9,"9062",51,44,44,1,0,"IFem",0
9,"9483",212,161,161,1,0,"IFem",0
9,"9395",136,96,95,0,1,"IFem",0
9,"9211",1462,1086,1070,11,16,"IFem",1
9,"9382",33,30,29,1,1,"IFem",0
9,"9077",36,26,26,1,0,"IFem",0
9,"9348",146,116,114,1,2,"IFem",0
9,"9219",27590,19903,19724,166,179,"IFem",25
9,"9050",72,54,54,0,0,"IFem",0
9,"9110",80,49,49,1,0,"IFem",0
9,"9023",1096,848,840,9,8,"IFem",1
9,"9070",34,31,30,3,1,"IFem",0
9,"9437",286,227,226,5,1,"IFem",0
9,"9143",27,20,20,0,0,"IFem",0
9,"9095",86,62,62,0,0,"IFem",0
9,"9178",52,36,36,1,0,"IFem",0
9,"9463",262,206,206,3,0,"IFem",1
9,"9085",475,352,350,2,2,"IFem",0
9,"9314",95,80,79,1,1,"IFem",0
9,"9022",67,57,57,1,0,"IFem",0
9,"9138",90,73,72,0,1,"IFem",1
9,"9902",461,347,339,1,8,"IFem",0
9,"9356",42,31,31,0,0,"IFem",0
9,"9011",69,49,49,0,0,"IFem",0
9,"9035",313,243,240,0,3,"IFem",0
9,"9448",216,180,178,1,2,"IFem",0
9,"9230",38,31,31,0,0,"IFem",0
9,"9206",61,52,50,3,2,"IFem",0
9,"9082",40,35,35,0,0,"IFem",0
9,"9279",177,130,130,0,0,"IFem",0
9,"9329",123,86,86,1,0,"IFem",0
9,"9400",317,258,256,3,2,"IFem",0
30,"30017",11635,8718,8646,46,72,"+MAS+",2
30,"30011",4706,3582,3541,20,41,"+MAS+",1
30,"30042",1918,1518,1500,6,18,"+MAS+",0
30,"30038",15381,10881,10797,51,84,"+MAS+",4
30,"30032",2849,2188,2161,10,27,"+MAS+",0
30,"30033",10144,7591,7505,86,86,"+MAS+",4
30,"30901",10331,7925,7833,54,92,"+MAS+",4
30,"30016",151577,103359,102538,620,821,"+MAS+",58
30,"30036",14624,10139,9988,70,151,"+MAS+",6
30,"30031",498,424,421,2,3,"+MAS+",0
30,"30009",12392,9724,9599,40,125,"+MAS+",4
30,"30037",18726,13183,13027,73,156,"+MAS+",7
30,"30029",11815,8365,8296,67,69,"+MAS+",0
30,"30014",1598,1270,1258,5,12,"+MAS+",0
30,"30012",9101,7170,7091,46,79,"+MAS+",1
30,"30020",6261,4502,4459,25,43,"+MAS+",0
30,"30013",7395,5320,5277,38,43,"+MAS+",1
30,"30030",312625,235232,233576,1438,1656,"+MAS+",102
30,"30004",1141,938,933,5,5,"+MAS+",0
30,"30024",58529,42392,42072,275,320,"+MAS+",9
30,"30034",1138,859,846,5,13,"+MAS+",0
30,"30039",19199,13538,13405,101,133,"+MAS+",8
30,"30043",24972,19411,19139,154,272,"+MAS+",5
30,"30902",8022,5454,5412,34,42,"+MAS+",4
30,"30035",18616,13185,13085,70,100,"+MAS+",7
30,"30025",4900,3777,3727,20,50,"+MAS+",0
30,"30002",9921,7263,7166,34,97,"+MAS+",1
30,"30010",6861,5287,5220,38,67,"+MAS+",4
30,"30021",9101,6106,6034,25,72,"+MAS+",2
30,"30015",19154,13947,13835,77,112,"+MAS+",6
30,"30018",7903,5990,5912,29,78,"+MAS+",2
30,"30008",13860,10066,9945,74,121,"+MAS+",6
30,"30022",16894,11661,11498,119,163,"+MAS+",7
30,"30019",25921,18079,17894,121,185,"+MAS+",4
30,"30041",13640,9156,9092,52,64,"+MAS+",6
30,"30007",6415,4554,4515,19,39,"+MAS+",3
30,"30005",29559,21408,21203,123,205,"+MAS+",8
30,"30001",4596,3602,3572,20,30,"+MAS+",1
30,"30027",47867,36054,35794,181,260,"+MAS+",17
30,"30040",727,627,620,1,7,"+MAS+",2
30,"30006",803,683,681,2,2,"+MAS+",0
30,"30026",15722,10147,10024,49,123,"+MAS+",5
30,"30023",3762,2871,2837,14,34,"+MAS+",0
30,"30003",24305,16558,16419,122,139,"+MAS+",7
30,"30028",6690,5005,4938,29,67,"+MAS+",1
7,"7027",20667,13784,13673,106,111,"PFyV",20
7,"7006",5175,3559,3528,33,31,"PFyV",3
7,"7036",26936,19563,19392,156,171,"PFyV",26
7,"7047",2236,1602,1584,7,18,"PFyV",0
7,"7048",17339,10192,10101,104,91,"PFyV",20
7,"7025",478,377,376,1,1,"PFyV",0
7,"7056",5012,3632,3592,40,40,"PFyV",6
7,"7001",3556,2682,2657,21,25,"PFyV",4
7,"7043",3422,2435,2410,13,25,"PFyV",1
7,"7024",7019,3579,3544,39,35,"PFyV",4
7,"7017",844,625,618,6,7,"PFyV",0
7,"7004",3861,2657,2630,24,27,"PFyV",5
7,"7012",1877,1421,1408,13,13,"PFyV",1
7,"7045",1288,996,992,13,4,"PFyV",1
7,"7014",7277,4301,4261,37,40,"PFyV",4
7,"7010",4858,3518,3463,52,55,"PFyV",8
7,"7033",27017,16370,16205,143,165,"PFyV",22
7,"7009",749,552,550,1,2,"PFyV",1
7,"7031",23747,15538,15401,130,137,"PFyV",15
7,"7062",7539,4371,4312,40,59,"PFyV",4
7,"7032",20039,13156,13033,136,123,"PFyV",15
7,"7019",192,146,146,0,0,"PFyV",1
7,"7057",7170,4736,4668,44,68,"PFyV",3
7,"7039",4880,3473,3412,27,61,"PFyV",3
7,"7005",6659,4400,4357,23,43,"PFyV",3
7,"7063",1420,1084,1072,8,12,"PFyV",0
7,"7013",6832,4879,4775,34,104,"PFyV",10
7,"7011",27781,18282,18180,135,102,"PFyV",13
7,"7055",7474,4796,4740,48,56,"PFyV",7
7,"7030",1573,1151,1129,10,22,"PFyV",2
7,"7041",2039,1566,1540,5,26,"PFyV",0
7,"7003",11742,6924,6837,43,87,"PFyV",6
7,"7054",22371,12930,12779,104,151,"PFyV",16
7,"7050",3321,2161,2134,33,27,"PFyV",0
7,"7007",437,308,304,1,4,"PFyV",1
7,"7026",31158,18670,18537,161,133,"PFyV",44
7,"7046",15649,9532,9443,70,89,"PFyV",16
7,"7020",3597,2652,2622,27,30,"PFyV",6
7,"7038",2032,1515,1503,10,12,"PFyV",0
7,"7053",1171,957,946,8,11,"PFyV",1
7,"7022",11575,7827,7730,85,97,"PFyV",10
7,"7044",8457,6079,5963,59,116,"PFyV",5
7,"7042",10666,7023,6967,59,56,"PFyV",4
7,"7051",5225,3322,3279,38,43,"PFyV",10
7,"7049",1498,1080,1071,12,9,"PFyV",2
7,"7029",4137,3088,3048,34,40,"PFyV",4
7,"7037",3232,1894,1881,16,13,"PFyV",0
7,"7008",5681,4203,4153,22,50,"PFyV",4
7,"7034",991,774,765,2,9,"PFyV",0
7,"7060",2577,1825,1807,20,18,"PFyV",2
7,"7040",279737,181078,179570,1280,1508,"PFyV",328
7,"7065",2079,1462,1451,13,11,"PFyV",3
7,"7018",389,271,265,3,6,"PFyV",0
7,"7002",6367,4466,4401,36,65,"PFyV",4
7,"7021",234,188,188,0,0,"PFyV",0
7,"7058",2804,2138,2118,15,20,"PFyV",3
7,"7064",5361,3588,3546,20,42,"PFyV",2
7,"7035",1517,1188,1181,3,7,"PFyV",2
7,"7902",1072,730,712,18,18,"PFyV",1
7,"7061",9831,6618,6546,54,72,"PFyV",17
7,"7052",4705,2993,2971,34,22,"PFyV",1
7,"7059",2998,2119,2084,11,35,"PFyV",0
7,"7023",3628,2611,2573,45,38,"PFyV",2
7,"7028",892,617,611,2,6,"PFyV",0
7,"7016",2786,1992,1969,30,23,"PFyV",0
7,"7015",21076,13304,13169,162,135,"PFyV",12
7,"7901",611,476,469,6,7,"PFyV",0
48,"48001",5832,4191,4166,37,25,"JS,PC",0
48,"48017",13290,8908,8856,42,52,"JS,PC",1
48,"48909",207,165,165,1,0,"JS,PC",0
48,"48065",3315,2447,2433,19,14,"JS,PC",0
48,"48012",2041,1571,1553,11,18,"JS,PC",1
48,"48060",3645,2277,2274,7,3,"JS,PC",0
48,"48901",4775,3602,3573,35,29,"JS,PC",3
48,"48052",1559,1215,1211,0,4,"JS,PC",1
48,"48004",334,229,227,1,2,"JS,PC",0
48,"48082",37673,27006,26811,201,195,"JS,PC",20
48,"48087",429,346,343,1,3,"JS,PC",0
48,"48074",3333,2467,2428,20,39,"JS,PC",2
48,"48058",972,691,687,4,4,"JS,PC",0
48,"48080",9971,7148,7086,71,62,"JS,PC",3
48,"48026",1134,861,853,7,8,"JS,PC",0
48,"48902",19124,13344,13227,93,117,"JS,PC",7
48,"48083",6950,5128,5097,33,31,"JS,PC",0
48,"48045",5149,3940,3885,35,55,"JS,PC",4
48,"48059",402,317,314,1,3,"JS,PC",0
48,"48066",346,256,256,1,0,"JS,PC",0
48,"48018",875,553,553,3,0,"JS,PC",0
48,"48091",1134,821,812,7,9,"JS,PC",0
48,"48021",1352,952,946,8,6,"JS,PC",0
48,"48075",1975,1440,1421,12,19,"JS,PC",0
48,"48056",978,733,732,7,1,"JS,PC",0
48,"48010",457,311,307,1,4,"JS,PC",0
48,"48913",1251,933,917,13,16,"JS,PC",0
48,"48094",3193,2210,2200,18,10,"JS,PC",5
48,"48019",3594,2569,2544,16,25,"JS,PC",1
48,"48002",7851,5767,5713,41,54,"JS,PC",1
48,"48035",412,313,312,4,1,"JS,PC",0
48,"48057",5749,4093,4081,20,12,"JS,PC",0
48,"48011",9692,6891,6843,56,48,"JS,PC",8
48,"48911",382,291,286,2,5,"JS,PC",0
48,"48067",1161,837,834,2,3,"JS,PC",0
48,"48003",14338,10497,10414,76,83,"JS,PC",9
48,"48068",1551,1178,1163,16,15,"JS,PC",0
48,"48024",1003,775,771,5,4,"JS,PC",0
48,"48027",22033,15929,15825,113,104,"JS,PC",10
48,"48903",1838,1400,1385,4,15,"JS,PC",0
48,"48009",786,614,609,3,5,"JS,PC",0
48,"48063",373,289,288,1,1,"JS,PC",0
48,"48006",289,246,245,3,1,"JS,PC",0
48,"48084",22577,15689,15540,108,149,"JS,PC",6
48,"48072",974,728,723,5,5,"JS,PC",0
48,"48095",2352,1658,1647,6,11,"JS,PC",2
48,"48076",314,237,237,4,0,"JS,PC",0
48,"48071",6118,4467,4412,32,55,"JS,PC",4
48,"48014",1218,870,866,8,4,"JS,PC",0
48,"48093",900,673,664,4,9,"JS,PC",0
48,"48005",117,76,76,0,0,"JS,PC",0
48,"48028",715,553,551,4,2,"JS,PC",0
48,"48904",3504,2671,2650,18,21,"JS,PC",1
48,"48042",1384,1111,1091,7,20,"JS,PC",0
48,"48053",900,676,670,8,6,"JS,PC",1
48,"48015",33690,24299,24160,168,139,"JS,PC",20
48,"48037",678,518,509,2,9,"JS,PC",0
48,"48029",8332,6155,6119,35,36,"JS,PC",9
48,"48905",2565,1882,1847,2,35,"JS,PC",1
48,"48031",340,245,242,0,3,"JS,PC",0
48,"48077",3367,2438,2423,17,15,"JS,PC",0
48,"48061",762,584,581,4,3,"JS,PC",0
48,"48907",355,283,282,2,1,"JS,PC",0
48,"48038",1122,834,824,0,10,"JS,PC",2
48,"48049",548,433,431,0,2,"JS,PC",0
48,"48030",608,454,453,4,1,"JS,PC",0
48,"48064",603,463,459,7,4,"JS,PC",0
48,"48089",3266,2425,2406,23,19,"JS,PC",1
48,"48048",562,399,394,3,5,"JS,PC",0
48,"48046",12617,9037,8967,56,70,"JS,PC",3
48,"48906",775,579,574,0,5,"JS,PC",0
48,"48044",62989,46989,46783,385,206,"JS,PC",18
48,"48008",617,433,424,6,9,"JS,PC",0
48,"48914",330,275,275,1,0,"JS,PC",0
48,"48040",1299,896,884,5,12,"JS,PC",0
48,"48078",38742,28064,27837,231,227,"JS,PC",13
48,"48047",161,112,112,0,0,"JS,PC",0
48,"48007",365,241,239,0,2,"JS,PC",0
48,"48088",135,97,96,0,1,"JS,PC",0
48,"48041",704,558,555,4,3,"JS,PC",0
48,"48097",1303,907,898,10,9,"JS,PC",0
48,"48025",883,642,639,3,3,"JS,PC",0
48,"48910",2948,2126,2115,17,11,"JS,PC",0
48,"48055",2662,1961,1938,16,23,"JS,PC",5
48,"48016",5260,3856,3827,22,29,"JS,PC",1
48,"48020",274076,193807,192607,1471,1200,"JS,PC",172
48,"48079",425,322,321,4,1,"JS,PC",0
48,"48033",215,160,159,0,1,"JS,PC",0
48,"48069",12765,8985,8910,58,75,"JS,PC",2
48,"48081",1883,1412,1398,12,14,"JS,PC",0
48,"48908",245,200,199,1,1,"JS,PC",0
48,"48022",2355,1476,1468,9,8,"JS,PC",0
48,"48915",362,238,238,2,0,"JS,PC",0
48,"48085",10301,7458,7407,50,51,"JS,PC",0
48,"48096",6608,5071,5011,43,60,"JS,PC",4
48,"48039",243,201,201,2,0,"JS,PC",0
48,"48023",594,470,468,4,2,"JS,PC",0
48,"48050",198,153,150,0,3,"JS,PC",0
48,"48073",6952,4476,4435,43,41,"JS,PC",1
48,"48013",79984,56928,56516,383,412,"JS,PC",29
48,"48092",837,619,619,13,0,"JS,PC",1
48,"48070",545,378,374,2,4,"JS,PC",0
48,"48034",12902,9684,9613,79,71,"JS,PC",19
48,"48090",6022,4544,4483,23,61,"JS,PC",2
48,"48043",4403,3214,3186,28,28,"JS,PC",0
48,"48032",5735,4173,4151,32,22,"JS,PC",0
48,"48086",2073,1519,1504,15,15,"JS,PC",0
48,"48051",220,169,168,0,1,"JS,PC",0
48,"48912",2308,1787,1746,27,41,"JS,PC",1
48,"48054",24135,17493,17374,124,119,"JS,PC",9
48,"48036",24144,17085,16954,117,131,"JS,PC",3
48,"48062",300,241,240,1,1,"JS,PC",0
4,"4011",2798,2244,2220,14,24,"VOX",1
4,"4001",1083,812,796,6,16,"VOX",1
4,"4030",1140,828,826,8,2,"VOX",0
4,"4071",398,327,326,2,1,"VOX",1
4,"4092",2852,2192,2168,13,24,"VOX",0
4,"4014",153,118,118,0,0,"VOX",1
4,"4087",189,140,139,1,1,"VOX",1
4,"4031",2359,1791,1786,7,5,"VOX",2
4,"4028",226,198,197,0,1,"VOX",0
4,"4064",2779,2032,2009,8,23,"VOX",5
4,"4078",1095,784,779,7,5,"VOX",0
4,"4089",746,536,528,6,8,"VOX",3
4,"4099",4988,3784,3714,26,70,"VOX",4
4,"4050",830,597,594,3,3,"VOX",1
4,"4046",862,658,656,6,2,"VOX",0
4,"4002",1063,765,760,1,5,"VOX",2
4,"4049",5280,3658,3623,20,35,"VOX",3
4,"4102",13729,8987,8878,114,109,"VOX",20
4,"4088",2475,1717,1703,10,14,"VOX",6
4,"4004",421,314,312,2,2,"VOX",1
4,"4059",1100,752,745,7,7,"VOX",1
4,"4017",1301,881,876,5,5,"VOX",2
4,"4080",226,185,182,2,3,"VOX",0
4,"4096",274,208,206,0,2,"VOX",0
4,"4043",546,466,462,3,4,"VOX",1
4,"4020",292,208,207,1,1,"VOX",0
4,"4033",139,100,97,3,3,"VOX",0
4,"4029",8887,6103,6048,53,55,"VOX",10
4,"4032",5606,3789,3770,19,19,"VOX",4
4,"4034",173,108,108,3,0,"VOX",0
4,"4083",1790,1384,1379,8,5,"VOX",3
4,"4018",274,245,242,0,3,"VOX",1
4,"4094",209,141,141,1,0,"VOX",0
4,"4091",342,280,278,4,2,"VOX",0
4,"4007",736,553,551,0,2,"VOX",0
4,"4066",13573,8651,8570,65,81,"VOX",9
4,"4051",440,373,372,0,1,"VOX",0
4,"4067",584,432,424,0,8,"VOX",0
4,"4081",356,290,290,2,0,"VOX",0
4,"4090",309,242,242,1,0,"VOX",0
4,"4035",8375,6079,6031,28,48,"VOX",12
4,"4006",7016,4823,4786,33,37,"VOX",2
4,"4003",17365,10931,10830,57,101,"VOX",14
4,"4904",1759,1185,1172,15,13,"VOX",3
4,"4082",306,210,209,0,1,"VOX",0
4,"4098",1537,1157,1147,8,10,"VOX",1
4,"4036",228,176,175,2,1,"VOX",0
4,"4063",1099,847,835,2,12,"VOX",1
4,"4005",577,438,432,1,6,"VOX",0
4,"4068",195,158,158,0,0,"VOX",0
4,"4052",12246,8393,8353,84,40,"VOX",21
4,"4055",372,315,315,0,0,"VOX",0
4,"4060",466,361,358,2,3,"VOX",0
4,"4041",318,241,241,6,0,"VOX",2
4,"4008",501,420,415,3,5,"VOX",0
4,"4065",366,290,288,2,2,"VOX",0
4,"4095",726,466,463,2,3,"VOX",2
4,"4062",4528,3610,3579,20,31,"VOX",4
4,"4053",12333,9124,9040,66,84,"VOX",11
4,"4047",2278,1906,1891,13,15,"VOX",2
4,"4079",50800,33862,33629,200,233,"VOX",64
4,"4100",8712,5545,5482,30,63,"VOX",6
4,"4903",4345,2896,2875,35,21,"VOX",1
4,"4097",254,196,194,0,2,"VOX",0
4,"4054",363,297,292,1,5,"VOX",1
4,"4070",1623,1233,1229,7,4,"VOX",1
4,"4023",139,104,102,1,2,"VOX",0
4,"4026",70,60,60,0,0,"VOX",0
4,"4019",251,199,198,0,1,"VOX",0
4,"4048",1503,1104,1096,7,8,"VOX",2
4,"4037",1312,1019,1000,6,19,"VOX",1
4,"4021",187,148,141,1,7,"VOX",0
4,"4061",618,495,491,5,4,"VOX",0
4,"4073",332,231,230,2,1,"VOX",0
4,"4077",303,277,274,2,3,"VOX",0
4,"4069",4692,3641,3607,29,34,"VOX",5
4,"4101",4283,2969,2950,22,19,"VOX",6
4,"4074",2829,1965,1945,24,20,"VOX",5
4,"4072",311,247,244,14,3,"VOX",1
4,"4015",130,98,98,1,0,"VOX",1
4,"4010",579,469,464,2,5,"VOX",0
4,"4093",1872,1265,1252,10,13,"VOX",0
4,"4038",3066,2169,2150,20,19,"VOX",7
4,"4027",249,163,163,1,0,"VOX",0
4,"4022",348,243,242,1,1,"VOX",1
4,"4016",2146,1584,1564,8,20,"VOX",0
4,"4103",1478,1051,1037,6,14,"VOX",5
4,"4045",1777,1402,1392,9,10,"VOX",2
4,"4013",141116,95203,94625,669,578,"VOX",224
4,"4086",1792,1271,1258,8,13,"VOX",1
4,"4902",45373,28425,28220,249,205,"VOX",41
4,"4056",147,123,120,0,3,"VOX",0
4,"4084",337,264,261,1,3,"VOX",0
4,"4044",1555,1253,1243,9,10,"VOX",0
4,"4085",395,302,298,0,4,"VOX",0
4,"4012",191,170,169,1,1,"VOX",0
4,"4024",3036,2325,2308,18,17,"VOX",6
4,"4009",169,127,126,0,1,"VOX",0
4,"4901",539,388,386,0,2,"VOX",0
4,"4057",1337,941,933,2,8,"VOX",2
4,"4075",5152,3772,3715,19,57,"VOX",2
4,"4076",1296,1005,993,7,12,"VOX",0
4,"4058",369,292,291,2,1,"VOX",0
9,"9167",59,42,42,2,0,"IU-UPeC",0
9,"9434",1221,985,970,10,15,"IU-UPeC",46
9,"9124",1520,1113,1096,9,17,"IU-UPeC",32
9,"9408",41,34,34,1,0,"IU-UPeC",1
9,"9236",38,32,32,0,0,"IU-UPeC",0
9,"9330",1523,1166,1148,15,18,"IU-UPeC",38
9,"9009",163,130,128,2,2,"IU-UPeC",7
9,"9257",92,80,78,4,2,"IU-UPeC",4
9,"9024",156,117,114,0,3,"IU-UPeC",2
9,"9906",1223,952,947,9,5,"IU-UPeC",37
9,"9208",211,139,136,3,3,"IU-UPeC",3
9,"9197",148,108,104,1,4,"IU-UPeC",2
9,"9225",84,57,56,1,1,"IU-UPeC",2
9,"9064",332,275,275,3,0,"IU-UPeC",8
9,"9057",144,116,115,0,1,"IU-UPeC",8
9,"9039",58,38,38,0,0,"IU-UPeC",3
9,"9266",91,72,70,0,2,"IU-UPeC",4
9,"9270",163,122,121,1,1,"IU-UPeC",1
9,"9407",27,23,23,1,0,"IU-UPeC",2
9,"9378",31,21,21,1,0,"IU-UPeC",4
9,"9250",273,218,218,4,0,"IU-UPeC",3
9,"9093",154,133,128,1,5,"IU-UPeC",4
9,"9168",296,233,231,1,2,"IU-UPeC",7
9,"9076",23,14,14,0,0,"IU-UPeC",0
9,"9127",55,40,40,0,0,"IU-UPeC",0
9,"9458",466,380,377,3,3,"IU-UPeC",23
9,"9384",293,199,194,0,5,"IU-UPeC",3
9,"9071",45,34,34,0,0,"IU-UPeC",0
9,"9191",39,32,30,0,2,"IU-UPeC",0
9,"9110",80,49,49,1,0,"IU-UPeC",1
9,"9287",208,170,168,2,2,"IU-UPeC",6
9,"9368",22,14,14,1,0,"IU-UPeC",0
9,"9098",516,396,388,6,8,"IU-UPeC",13
9,"9472",55,40,40,0,0,"IU-UPeC",0
9,"9466",134,99,99,0,0,"IU-UPeC",1
9,"9209",4511,3368,3301,37,67,"IU-UPeC",78
9,"9108",378,290,287,2,3,"IU-UPeC",8
9,"9346",93,71,69,0,2,"IU-UPeC",1
9,"9112",113,75,73,2,2,"IU-UPeC",1
9,"9476",63,46,46,0,0,"IU-UPeC",1
9,"9083",37,33,33,0,0,"IU-UPeC",3
9,"9206",61,52,50,3,2,"IU-UPeC",1
9,"9032",108,73,73,0,0,"IU-UPeC",4
9,"9133",40,34,34,0,0,"IU-UPeC",0
9,"9130",79,63,62,1,1,"IU-UPeC",1
9,"9013",47,41,41,0,0,"IU-UPeC",2
9,"9242",81,65,63,2,2,"IU-UPeC",0
9,"9335",87,72,71,0,1,"IU-UPeC",7
9,"9391",361,264,263,2,1,"IU-UPeC",12
9,"9276",387,280,273,2,7,"IU-UPeC",21
9,"9281",147,109,107,0,2,"IU-UPeC",2
9,"9140",128,88,87,0,1,"IU-UPeC",2
9,"9036",38,31,30,2,1,"IU-UPeC",0
9,"9060",148,123,123,0,0,"IU-UPeC",2
9,"9117",77,61,57,0,4,"IU-UPeC",1
9,"9365",31,20,20,0,0,"IU-UPeC",0
9,"9177",1117,830,825,5,5,"IU-UPeC",41
9,"9226",66,55,53,0,2,"IU-UPeC",2
9,"9412",803,552,550,2,2,"IU-UPeC",19
9,"9068",29,23,22,0,1,"IU-UPeC",2
9,"9079",46,40,37,0,3,"IU-UPeC",2
9,"9277",119,101,100,0,1,"IU-UPeC",2
9,"9239",53,44,42,1,2,"IU-UPeC",1
9,"9464",36,24,24,0,0,"IU-UPeC",0
9,"9360",30,27,27,0,0,"IU-UPeC",0
9,"9172",125,102,102,2,0,"IU-UPeC",4
9,"9366",90,64,63,1,1,"IU-UPeC",5
9,"9375",35,27,27,0,0,"IU-UPeC",0
9,"9444",72,48,48,2,0,"IU-UPeC",1
9,"9115",92,69,68,0,1,"IU-UPeC",5
9,"9292",92,72,70,0,2,"IU-UPeC",3
9,"9387",118,96,95,0,1,"IU-UPeC",8
9,"9012",93,68,66,1,2,"IU-UPeC",1
9,"9231",70,49,49,3,0,"IU-UPeC",0
9,"9023",1096,848,840,9,8,"IU-UPeC",50
9,"9363",974,730,725,3,5,"IU-UPeC",10
9,"9372",221,190,189,1,1,"IU-UPeC",11
9,"9279",177,130,130,0,0,"IU-UPeC",0
9,"9217",361,265,261,4,4,"IU-UPeC",7
9,"9422",18,10,10,0,0,"IU-UPeC",0
9,"9429",56,41,41,0,0,"IU-UPeC",0
9,"9190",91,56,55,0,1,"IU-UPeC",0
9,"9438",544,446,444,3,2,"IU-UPeC",22
9,"9152",263,193,192,0,1,"IU-UPeC",6
9,"9159",56,48,48,1,0,"IU-UPeC",2
9,"9027",47,44,41,0,3,"IU-UPeC",0
9,"9183",51,37,37,0,0,"IU-UPeC",0
9,"9148",86,73,69,5,4,"IU-UPeC",4
9,"9048",1484,1120,1106,4,14,"IU-UPeC",68
9,"9316",104,83,80,1,3,"IU-UPeC",1
9,"9213",320,223,220,4,3,"IU-UPeC",1
9,"9180",136,102,100,2,2,"IU-UPeC",4
9,"9433",60,52,51,0,1,"IU-UPeC",4
9,"9448",216,180,178,1,2,"IU-UPeC",5
9,"9094",51,42,41,0,1,"IU-UPeC",5
9,"9423",27,25,25,0,0,"IU-UPeC",0
9,"9154",142,104,104,2,0,"IU-UPeC",2
9,"9355",101,75,73,0,2,"IU-UPeC",0
9,"9343",97,70,69,0,1,"IU-UPeC",2
9,"9050",72,54,54,0,0,"IU-UPeC",3
9,"9215",377,264,260,0,4,"IU-UPeC",5
9,"9253",111,96,94,1,2,"IU-UPeC",1
9,"9369",442,331,328,1,3,"IU-UPeC",15
9,"9232",151,125,124,2,1,"IU-UPeC",2
9,"9149",34,25,24,0,1,"IU-UPeC",1
9,"9390",611,478,477,3,1,"IU-UPeC",15
9,"9416",52,39,39,0,0,"IU-UPeC",1
9,"9019",147,103,102,1,1,"IU-UPeC",9
9,"9129",105,87,87,0,0,"IU-UPeC",2
9,"9377",625,478,471,5,7,"IU-UPeC",9
9,"9044",46,38,37,0,1,"IU-UPeC",5
9,"9001",27,26,26,0,0,"IU-UPeC",0
9,"9056",4931,3634,3602,35,32,"IU-UPeC",158
9,"9249",47,37,37,1,0,"IU-UPeC",0
9,"9358",249,191,191,1,0,"IU-UPeC",4
9,"9194",2024,1550,1530,17,20,"IU-UPeC",57
9,"9043",189,132,132,2,0,"IU-UPeC",5
9,"9200",48,37,36,0,1,"IU-UPeC",4
9,"9189",130,88,86,2,2,"IU-UPeC",2
9,"9304",202,166,163,1,3,"IU-UPeC",5
9,"9224",157,122,122,0,0,"IU-UPeC",2
9,"9445",44,32,32,1,0,"IU-UPeC",0
9,"9074",788,609,598,8,11,"IU-UPeC",25
9,"9238",932,576,569,6,7,"IU-UPeC",20
9,"9075",111,83,83,1,0,"IU-UPeC",3
9,"9485",55,43,43,1,0,"IU-UPeC",2
9,"9259",233,184,184,3,0,"IU-UPeC",9
9,"9160",90,71,70,0,1,"IU-UPeC",2
9,"9017",89,67,62,0,5,"IU-UPeC",0
9,"9052",31,22,21,1,1,"IU-UPeC",0
9,"9347",141,113,109,4,4,"IU-UPeC",6
9,"9443",183,132,129,1,3,"IU-UPeC",3
9,"9113",464,383,376,6,7,"IU-UPeC",16
9,"9037",113,96,96,0,0,"IU-UPeC",3
9,"9467",66,46,46,3,0,"IU-UPeC",2
9,"9072",307,240,239,1,1,"IU-UPeC",10
9,"9394",727,558,552,8,6,"IU-UPeC",14
9,"9415",267,166,165,0,1,"IU-UPeC",4
9,"9141",610,499,493,4,6,"IU-UPeC",22
9,"9908",469,314,309,2,5,"IU-UPeC",7
9,"9029",168,134,132,3,2,"IU-UPeC",10
9,"9131",460,381,373,5,8,"IU-UPeC",17
9,"9084",189,150,148,7,2,"IU-UPeC",2
9,"9025",125,86,79,1,7,"IU-UPeC",0
9,"9055",52,39,38,0,1,"IU-UPeC",0
9,"9030",109,76,76,3,0,"IU-UPeC",2
9,"9026",397,314,311,1,3,"IU-UPeC",18
9,"9073",926,753,748,10,5,"IU-UPeC",34
9,"9395",136,96,95,0,1,"IU-UPeC",6
9,"9421",237,172,172,2,0,"IU-UPeC",3
9,"9196",154,108,107,1,1,"IU-UPeC",5
9,"9143",27,20,20,0,0,"IU-UPeC",0
9,"9272",294,206,203,1,3,"IU-UPeC",3
9,"9020",262,187,180,2,7,"IU-UPeC",3
9,"9091",732,516,512,7,4,"IU-UPeC",14
9,"9007",59,41,41,0,0,"IU-UPeC",0
9,"9122",96,66,66,0,0,"IU-UPeC",0
9,"9179",43,35,34,0,1,"IU-UPeC",2
9,"9095",86,62,62,0,0,"IU-UPeC",0
9,"9454",47,34,34,0,0,"IU-UPeC",3
9,"9288",91,70,69,1,1,"IU-UPeC",5
9,"9321",1640,1250,1237,5,13,"IU-UPeC",23
9,"9163",602,479,472,5,7,"IU-UPeC",5
9,"9340",76,49,49,0,0,"IU-UPeC",0
9,"9176",61,45,44,0,1,"IU-UPeC",0
9,"9103",221,185,184,2,1,"IU-UPeC",3
9,"9442",380,287,282,2,5,"IU-UPeC",9
9,"9323",64,47,47,0,0,"IU-UPeC",6
9,"9010",32,23,23,2,0,"IU-UPeC",0
9,"9309",306,216,211,2,5,"IU-UPeC",5
9,"9251",371,273,271,3,2,"IU-UPeC",12
9,"9078",41,35,33,0,2,"IU-UPeC",3
9,"9256",362,261,255,2,6,"IU-UPeC",12
9,"9088",66,44,42,1,2,"IU-UPeC",1
9,"9054",100,73,72,3,1,"IU-UPeC",4
9,"9314",95,80,79,1,1,"IU-UPeC",6
9,"9460",177,135,135,2,0,"IU-UPeC",4
9,"9455",44,34,33,0,1,"IU-UPeC",0
9,"9302",116,87,87,0,0,"IU-UPeC",1
9,"9389",77,56,56,0,0,"IU-UPeC",0
9,"9061",166,124,123,1,1,"IU-UPeC",1
9,"9352",116,97,97,0,0,"IU-UPeC",1
9,"9325",195,125,123,2,2,"IU-UPeC",2
9,"9419",78,45,44,0,1,"IU-UPeC",0
9,"9447",42,38,38,0,0,"IU-UPeC",0
9,"9104",54,43,43,0,0,"IU-UPeC",0
9,"9016",85,64,64,2,0,"IU-UPeC",1
9,"9184",5,4,4,0,0,"IU-UPeC",0
9,"9406",252,196,195,1,1,"IU-UPeC",10
9,"9102",37,31,31,0,0,"IU-UPeC",2
9,"9162",143,108,108,0,0,"IU-UPeC",2
9,"9303",92,72,71,0,1,"IU-UPeC",4
9,"9902",461,347,339,1,8,"IU-UPeC",28
9,"9151",458,364,363,3,1,"IU-UPeC",16
9,"9425",514,369,366,2,3,"IU-UPeC",26
9,"9220",76,62,61,2,1,"IU-UPeC",5
9,"9308",67,43,43,1,0,"IU-UPeC",1
9,"9471",151,117,117,0,0,"IU-UPeC",4
9,"9063",213,184,182,2,2,"IU-UPeC",2
9,"9478",45,38,38,0,0,"IU-UPeC",3
9,"9258",173,139,136,4,3,"IU-UPeC",1
9,"9354",33,30,30,1,0,"IU-UPeC",0
9,"9214",684,452,446,6,6,"IU-UPeC",13
9,"9182",78,63,61,2,2,"IU-UPeC",1
9,"9351",60,46,45,1,1,"IU-UPeC",0
9,"9228",163,138,138,0,0,"IU-UPeC",11
9,"9414",201,148,147,1,1,"IU-UPeC",0
9,"9439",1005,823,816,9,7,"IU-UPeC",33
9,"9337",115,84,82,0,2,"IU-UPeC",2
9,"9123",40,35,35,0,0,"IU-UPeC",1
9,"9109",1068,698,669,10,29,"IU-UPeC",35
9,"9247",23,19,19,0,0,"IU-UPeC",0
9,"9403",96,78,76,1,2,"IU-UPeC",1
9,"9480",110,89,88,1,1,"IU-UPeC",0
9,"9274",1098,880,872,9,8,"IU-UPeC",42
9,"9332",140,107,107,1,0,"IU-UPeC",2
9,"9289",1466,1027,1013,6,14,"IU-UPeC",31
9,"9328",77,55,55,1,0,"IU-UPeC",2
9,"9418",82,63,62,3,1,"IU-UPeC",1
9,"9229",201,146,145,0,1,"IU-UPeC",5
9,"9243",75,56,54,1,2,"IU-UPeC",6
9,"9441",74,66,66,0,0,"IU-UPeC",0
9,"9119",46,27,27,0,0,"IU-UPeC",0
9,"9014",213,127,126,1,1,"IU-UPeC",4
9,"9085",475,352,350,2,2,"IU-UPeC",11
9,"9046",30,26,26,0,0,"IU-UPeC",5
9,"9905",391,308,308,5,0,"IU-UPeC",10
9,"9038",118,97,94,0,3,"IU-UPeC",3
9,"9326",148,115,113,2,2,"IU-UPeC",6
9,"9410",3051,2169,2153,18,16,"IU-UPeC",57
9,"9318",61,38,38,0,0,"IU-UPeC",0
9,"9456",129,90,90,2,0,"IU-UPeC",1
9,"9132",173,132,130,0,2,"IU-UPeC",2
9,"9432",189,143,140,1,3,"IU-UPeC",5
9,"9903",3251,2359,2340,24,19,"IU-UPeC",85
9,"9417",40,30,30,0,0,"IU-UPeC",0
9,"9382",33,30,29,1,1,"IU-UPeC",2
9,"9120",39,35,35,0,0,"IU-UPeC",1
9,"9268",95,73,72,0,1,"IU-UPeC",1
9,"9327",25,22,22,0,0,"IU-UPeC",0
9,"9311",60,52,50,0,2,"IU-UPeC",3
9,"9430",24,19,19,0,0,"IU-UPeC",2
9,"9086",687,475,471,0,4,"IU-UPeC",15
9,"9265",38,31,31,0,0,"IU-UPeC",1
9,"9173",123,93,93,1,0,"IU-UPeC",2
9,"9312",98,83,82,0,1,"IU-UPeC",4
9,"9003",192,148,146,2,2,"IU-UPeC",5
9,"9221",445,337,335,1,2,"IU-UPeC",22
9,"9021",56,33,31,0,2,"IU-UPeC",3
9,"9301",616,513,506,5,7,"IU-UPeC",30
9,"9427",1428,1014,1003,12,11,"IU-UPeC",42
9,"9198",108,86,85,2,1,"IU-UPeC",6
9,"9041",28,28,28,1,0,"IU-UPeC",1
9,"9100",59,51,50,0,1,"IU-UPeC",0
9,"9090",57,51,51,1,0,"IU-UPeC",2
9,"9392",53,40,40,0,0,"IU-UPeC",1
9,"9338",219,173,171,1,2,"IU-UPeC",11
9,"9381",32,23,22,0,1,"IU-UPeC",0
9,"9262",161,129,129,0,0,"IU-UPeC",0
9,"9431",119,99,98,0,1,"IU-UPeC",0
9,"9136",192,151,147,2,4,"IU-UPeC",3
9,"9339",128,103,103,0,0,"IU-UPeC",3
9,"9006",61,41,41,0,0,"IU-UPeC",0
9,"9297",323,265,261,5,4,"IU-UPeC",8
9,"9065",147,124,123,2,1,"IU-UPeC",3
9,"9310",13,9,8,0,1,"IU-UPeC",2
9,"9082",40,35,35,0,0,"IU-UPeC",0
9,"9066",65,51,51,0,0,"IU-UPeC",1
9,"9170",203,152,149,1,3,"IU-UPeC",7
9,"9051",168,133,132,1,1,"IU-UPeC",3
9,"9350",480,358,347,5,11,"IU-UPeC",6
9,"9134",228,152,152,2,0,"IU-UPeC",10
9,"9413",447,333,333,5,0,"IU-UPeC",10
9,"9047",56,45,45,2,0,"IU-UPeC",0
9,"9077",36,26,26,1,0,"IU-UPeC",0
9,"9144",52,40,40,0,0,"IU-UPeC",4
9,"9451",238,199,198,1,1,"IU-UPeC",14
9,"9280",27,17,17,0,0,"IU-UPeC",0
9,"9294",111,88,86,0,2,"IU-UPeC",7
9,"9175",129,92,92,0,0,"IU-UPeC",2
9,"9411",149,111,111,0,0,"IU-UPeC",2
9,"9907",1420,1120,1115,13,5,"IU-UPeC",72
9,"9166",97,79,78,3,1,"IU-UPeC",1
9,"9283",46,29,28,0,1,"IU-UPeC",1
9,"9483",212,161,161,1,0,"IU-UPeC",3
9,"9353",73,57,56,0,1,"IU-UPeC",2
9,"9373",440,285,282,3,3,"IU-UPeC",5
9,"9178",52,36,36,1,0,"IU-UPeC",0
9,"9125",596,435,433,3,2,"IU-UPeC",8
9,"9388",36,31,30,1,1,"IU-UPeC",0
9,"9904",482,389,384,5,5,"IU-UPeC",12
9,"9201",30,17,17,0,0,"IU-UPeC",0
9,"9269",39,33,32,0,1,"IU-UPeC",1
9,"9398",75,54,54,1,0,"IU-UPeC",0
9,"9386",58,44,43,2,1,"IU-UPeC",2
9,"9216",385,283,280,8,3,"IU-UPeC",16
9,"9267",115,101,100,3,1,"IU-UPeC",7
9,"9195",57,42,42,2,0,"IU-UPeC",3
9,"9405",128,89,89,0,0,"IU-UPeC",2
9,"9022",67,57,57,1,0,"IU-UPeC",0
9,"9361",117,96,96,0,0,"IU-UPeC",1
9,"9329",123,86,86,1,0,"IU-UPeC",10
9,"9230",38,31,31,0,0,"IU-UPeC",0
9,"9138",90,73,72,0,1,"IU-UPeC",0
9,"9128",82,66,66,0,0,"IU-UPeC",5
9,"9400",317,258,256,3,2,"IU-UPeC",12
9,"9139",101,75,73,2,2,"IU-UPeC",3
9,"9380",78,59,57,0,2,"IU-UPeC",5
9,"9348",146,116,114,1,2,"IU-UPeC",0
9,"9473",85,62,61,1,1,"IU-UPeC",0
9,"9362",204,168,164,0,4,"IU-UPeC",12
9,"9155",26,20,20,1,0,"IU-UPeC",0
9,"9202",24,22,22,1,0,"IU-UPeC",0
9,"9218",360,272,271,2,1,"IU-UPeC",15
9,"9482",34,29,28,0,1,"IU-UPeC",1
9,"9241",201,156,155,3,1,"IU-UPeC",7
9,"9246",622,458,455,5,3,"IU-UPeC",17
9,"9035",313,243,240,0,3,"IU-UPeC",12
9,"9255",86,66,62,0,4,"IU-UPeC",3
9,"9137",167,128,128,1,0,"IU-UPeC",6
9,"9428",107,87,87,0,0,"IU-UPeC",0
9,"9045",267,186,183,2,3,"IU-UPeC",5
9,"9440",96,78,78,0,0,"IU-UPeC",0
9,"9446",12,7,7,0,0,"IU-UPeC",0
9,"9295",60,37,37,0,0,"IU-UPeC",0
9,"9334",48,39,38,0,1,"IU-UPeC",2
9,"9223",46,39,39,0,0,"IU-UPeC",1
9,"9114",87,67,67,0,0,"IU-UPeC",2
9,"9192",55,47,46,0,1,"IU-UPeC",4
9,"9227",119,97,95,0,2,"IU-UPeC",5
9,"9396",152,118,118,1,0,"IU-UPeC",0
9,"9317",16,14,14,0,0,"IU-UPeC",0
9,"9275",192,138,137,1,1,"IU-UPeC",0
9,"9298",82,62,62,0,0,"IU-UPeC",2
9,"9101",79,59,59,0,0,"IU-UPeC",4
9,"9062",51,44,44,1,0,"IU-UPeC",1
9,"9211",1462,1086,1070,11,16,"IU-UPeC",35
9,"9058",393,293,289,2,4,"IU-UPeC",17
9,"9261",463,339,330,8,9,"IU-UPeC",8
9,"9018",24702,18365,18158,174,207,"IU-UPeC",978
9,"9409",109,87,87,0,0,"IU-UPeC",2
9,"9307",113,91,91,0,0,"IU-UPeC",0
9,"9356",42,31,31,0,0,"IU-UPeC",0
9,"9374",90,79,77,2,2,"IU-UPeC",1
9,"9449",87,72,71,1,1,"IU-UPeC",1
9,"9105",107,88,86,0,2,"IU-UPeC",4
9,"9067",442,308,303,9,5,"IU-UPeC",13
9,"9437",286,227,226,5,1,"IU-UPeC",2
9,"9463",262,206,206,3,0,"IU-UPeC",11
9,"9901",374,268,261,3,7,"IU-UPeC",7
9,"9235",160,124,123,0,1,"IU-UPeC",4
9,"9199",91,65,65,2,0,"IU-UPeC",2
9,"9181",302,231,225,3,6,"IU-UPeC",8
9,"9059",136713,106605,105601,976,1004,"IU-UPeC",5456
9,"9164",165,121,121,1,0,"IU-UPeC",1
9,"9169",99,83,81,0,2,"IU-UPeC",4
9,"9306",113,91,91,1,0,"IU-UPeC",5
9,"9174",809,575,565,10,10,"IU-UPeC",11
9,"9273",53,41,40,1,1,"IU-UPeC",0
9,"9450",27,21,20,1,1,"IU-UPeC",2
9,"9424",32,26,26,1,0,"IU-UPeC",0
9,"9315",379,269,267,2,2,"IU-UPeC",9
9,"9033",89,75,75,0,0,"IU-UPeC",5
9,"9248",78,57,57,0,0,"IU-UPeC",2
9,"9244",47,26,26,1,0,"IU-UPeC",1
9,"9070",34,31,30,3,1,"IU-UPeC",0
9,"9345",124,92,92,0,0,"IU-UPeC",7
9,"9034",280,237,233,5,4,"IU-UPeC",3
9,"9219",27590,19903,19724,166,179,"IU-UPeC",1135
9,"9011",69,49,49,0,0,"IU-UPeC",3
9,"9135",41,33,33,1,0,"IU-UPeC",1
24,"24134",3465,2628,2583,27,45,"DN",1
24,"24028",386,304,302,3,2,"DN",0
24,"24062",142,105,105,1,0,"DN",0
24,"24146",271,195,194,0,1,"DN",0
24,"24006",488,351,342,4,9,"DN",1
24,"24168",461,383,379,4,4,"DN",2
24,"24016",478,287,285,1,2,"DN",0
24,"24179",299,202,201,8,1,"DN",0
24,"24113",366,282,275,3,7,"DN",0
24,"24059",887,520,512,8,8,"DN",0
24,"24039",2077,1604,1600,39,4,"DN",0
24,"24005",387,267,259,6,8,"DN",0
24,"24121",655,481,477,0,4,"DN",0
24,"24058",205,137,134,0,3,"DN",0
24,"24170",1934,1436,1424,13,12,"DN",0
24,"24019",359,293,291,3,2,"DN",0
24,"24191",111,84,84,1,0,"DN",0
24,"24076",1279,972,953,7,19,"DN",1
24,"24060",615,361,359,0,2,"DN",0
24,"24001",188,108,108,0,0,"DN",0
24,"24115",54290,39886,39486,325,400,"DN",31
24,"24026",1203,908,898,19,10,"DN",1
24,"24185",482,357,349,4,8,"DN",3
24,"24141",98,76,75,0,1,"DN",0
24,"24098",1205,880,874,8,6,"DN",0
24,"24080",218,170,162,3,8,"DN",0
24,"24014",7474,5375,5321,56,54,"DN",1
24,"24065",2106,1573,1545,16,28,"DN",4
24,"24227",1617,1146,1142,14,4,"DN",6
24,"24152",462,302,301,2,1,"DN",3
24,"24053",439,303,298,2,5,"DN",0
24,"24187",876,642,631,6,11,"DN",1
24,"24165",373,254,250,2,4,"DN",0
24,"24201",1086,765,757,5,8,"DN",0
24,"24122",1351,965,948,9,17,"DN",0
24,"24064",1525,1165,1151,10,14,"DN",1
24,"24056",2910,2102,2068,31,34,"DN",1
24,"24153",233,173,172,3,1,"DN",0
24,"24093",380,249,248,3,1,"DN",0
24,"24159",1832,1407,1391,17,16,"DN",2
24,"24199",433,284,281,3,3,"DN",0
24,"24038",3107,2383,2354,30,29,"DN",2
24,"24219",527,390,387,2,3,"DN",2
24,"24003",652,442,435,5,7,"DN",0
24,"24119",702,491,480,6,11,"DN",0
24,"24123",757,499,497,4,2,"DN",0
24,"24104",266,180,179,0,1,"DN",0
24,"24157",2580,2013,1983,25,30,"DN",1
24,"24012",297,212,211,4,1,"DN",0
24,"24007",764,578,576,3,2,"DN",1
24,"24095",314,246,244,1,2,"DN",0
24,"24117",446,333,331,2,2,"DN",0
24,"24176",318,244,243,5,1,"DN",0
24,"24020",463,294,291,5,3,"DN",1
24,"24094",1392,1048,1038,11,10,"DN",3
24,"24068",464,343,339,5,4,"DN",0
24,"24067",645,383,379,2,4,"DN",0
24,"24213",158,117,117,0,0,"DN",0
24,"24214",669,492,490,1,2,"DN",0
24,"24207",296,245,241,3,4,"DN",1
24,"24112",318,207,207,0,0,"DN",0
24,"24030",4297,3226,3180,16,46,"DN",4
24,"24021",1688,1213,1189,6,24,"DN",1
24,"24158",323,210,207,0,3,"DN",0
24,"24203",96,73,72,1,1,"DN",0
24,"24150",243,175,175,3,0,"DN",0
24,"24099",173,133,133,2,0,"DN",0
24,"24116",424,276,273,0,3,"DN",1
24,"24057",1366,1103,1076,11,27,"DN",0
24,"24229",427,330,324,8,6,"DN",0
24,"24217",136,110,109,1,1,"DN",0
24,"24002",236,182,180,3,2,"DN",0
24,"24139",2186,1608,1570,24,38,"DN",1
24,"24041",548,384,381,5,3,"DN",1
24,"24071",1006,747,738,9,9,"DN",0
24,"24103",292,160,160,1,0,"DN",0
24,"24226",204,138,136,0,2,"DN",0
24,"24178",71,58,57,0,1,"DN",0
24,"24193",384,277,276,4,1,"DN",0
24,"24189",6016,4187,4134,58,53,"DN",6
24,"24096",124,74,74,0,0,"DN",0
24,"24044",171,125,118,0,7,"DN",0
24,"24120",345,214,214,1,0,"DN",0
24,"24109",996,667,652,7,15,"DN",0
24,"24148",1684,1268,1256,9,12,"DN",2
24,"24023",268,189,188,2,1,"DN",0
24,"24051",433,308,307,1,1,"DN",0
24,"24063",391,260,259,1,1,"DN",0
24,"24161",291,218,212,2,6,"DN",1
24,"24084",162,119,119,1,0,"DN",0
24,"24088",1037,804,797,8,7,"DN",2
24,"24110",1253,932,926,7,6,"DN",0
24,"24129",122,85,85,1,0,"DN",0
24,"24136",544,391,390,8,1,"DN",0
24,"24182",420,289,287,6,2,"DN",0
24,"24901",908,660,653,4,7,"DN",1
24,"24047",782,533,527,7,6,"DN",2
24,"24086",271,200,198,1,2,"DN",0
24,"24132",628,397,390,6,7,"DN",0
24,"24197",770,545,537,6,8,"DN",0
24,"24018",177,143,141,0,2,"DN",1
24,"24061",1702,1244,1231,13,13,"DN",3
24,"24082",870,692,682,10,10,"DN",0
24,"24049",1493,1152,1138,8,14,"DN",2
24,"24108",377,279,273,3,6,"DN",0
24,"24089",103315,77803,77038,779,765,"DN",103
24,"24130",437,319,315,1,4,"DN",0
24,"24149",155,123,121,0,2,"DN",0
24,"24125",475,285,282,2,3,"DN",0
24,"24137",1114,811,804,9,7,"DN",1
24,"24215",156,119,118,1,1,"DN",0
24,"24034",3419,2596,2556,27,40,"DN",1
24,"24054",433,308,303,4,5,"DN",0
24,"24022",342,227,227,0,0,"DN",0
24,"24031",216,169,167,1,2,"DN",0
24,"24209",2790,1907,1884,15,23,"DN",1
24,"24083",1077,764,755,4,9,"DN",1
24,"24143",514,391,379,4,12,"DN",0
24,"24090",348,226,224,1,2,"DN",0
24,"24050",102,77,77,1,0,"DN",0
24,"24105",1443,1087,1065,10,22,"DN",0
24,"24216",732,533,522,2,11,"DN",0
24,"24091",657,440,437,2,3,"DN",0
24,"24144",704,487,478,5,9,"DN",0
24,"24169",2976,2256,2236,12,20,"DN",2
24,"24194",292,230,229,1,1,"DN",0
24,"24166",1413,1043,1014,7,29,"DN",1
24,"24011",209,113,112,0,1,"DN",0
24,"24151",492,357,357,1,0,"DN",0
24,"24202",8098,5654,5582,51,72,"DN",3
24,"24101",404,264,262,2,2,"DN",0
24,"24224",621,452,445,7,7,"DN",0
24,"24029",754,545,539,2,6,"DN",0
24,"24177",481,328,327,1,1,"DN",0
24,"24081",142,97,97,0,0,"DN",0
24,"24155",478,380,371,0,9,"DN",0
24,"24027",1214,881,860,8,21,"DN",0
24,"24107",244,184,183,2,1,"DN",0
24,"24205",967,714,706,9,8,"DN",0
24,"24162",1671,1314,1303,21,11,"DN",1
24,"24171",364,219,217,1,2,"DN",1
24,"24174",495,362,357,3,5,"DN",0
24,"24211",276,210,206,4,4,"DN",1
24,"24156",243,169,169,1,0,"DN",0
24,"24228",666,455,449,2,6,"DN",1
24,"24218",454,331,329,3,2,"DN",0
24,"24077",227,195,192,1,3,"DN",0
24,"24180",1128,825,814,12,11,"DN",0
24,"24015",2279,1693,1658,22,35,"DN",2
24,"24100",769,569,561,4,8,"DN",2
24,"24102",655,495,492,2,3,"DN",0
24,"24902",354,273,272,2,1,"DN",0
24,"24175",1825,1381,1372,13,9,"DN",0
24,"24225",1020,786,773,6,13,"DN",2
24,"24181",1519,1135,1117,10,18,"DN",1
24,"24198",602,411,402,4,9,"DN",0
24,"24046",953,662,645,6,17,"DN",0
24,"24167",763,509,504,9,5,"DN",0
24,"24188",3843,2962,2899,48,63,"DN",3
24,"24124",374,249,246,4,3,"DN",0
24,"24173",943,678,673,3,5,"DN",3
24,"24106",258,178,173,1,5,"DN",0
24,"24074",99,77,76,1,1,"DN",0
24,"24127",301,239,239,3,0,"DN",0
24,"24092",809,619,609,1,10,"DN",0
24,"24230",423,329,324,2,5,"DN",2
24,"24017",582,434,433,9,1,"DN",0
24,"24070",4159,3206,3162,31,44,"DN",0
24,"24052",171,109,108,0,1,"DN",1
24,"24010",8426,5980,5888,61,92,"DN",13
24,"24145",655,445,443,8,2,"DN",1
24,"24043",135,69,67,0,2,"DN",0
24,"24079",922,654,645,9,9,"DN",1
24,"24142",25160,18503,18262,205,241,"DN",26
24,"24221",790,568,558,6,10,"DN",0
24,"24055",705,510,507,6,3,"DN",0
24,"24190",167,115,115,2,0,"DN",0
24,"24097",225,146,145,1,1,"DN",0
24,"24172",420,218,216,1,2,"DN",0
24,"24073",481,343,340,3,3,"DN",0
24,"24184",206,121,120,0,1,"DN",0
24,"24036",301,181,180,0,1,"DN",0
24,"24183",805,528,522,5,6,"DN",0
24,"24066",504,367,361,3,6,"DN",0
24,"24154",1010,750,729,7,21,"DN",0
24,"24009",322,161,161,1,0,"DN",0
24,"24163",3929,3076,3044,49,32,"DN",2
24,"24033",211,154,151,1,3,"DN",1
24,"24212",1029,784,774,7,10,"DN",0
24,"24206",1732,1303,1288,8,15,"DN",1
24,"24210",510,347,347,0,0,"DN",0
24,"24087",645,469,466,11,3,"DN",1
24,"24008",9319,6964,6852,77,112,"DN",3
24,"24032",111,82,82,1,0,"DN",0
24,"24222",14249,10663,10532,119,131,"DN",17
24,"24078",388,286,284,4,2,"DN",0
24,"24024",695,496,494,4,2,"DN",0
24,"24118",127,84,84,1,0,"DN",0
24,"24069",42,36,36,0,0,"DN",0
24,"24025",300,233,228,0,5,"DN",0
24,"24004",469,349,349,6,0,"DN",0
24,"24040",453,315,309,2,6,"DN",0
24,"24196",2082,1529,1513,15,16,"DN",1
24,"24223",2640,2012,2012,53,0,"DN",2
24,"24037",369,251,251,0,0,"DN",0
24,"24160",692,506,498,2,8,"DN",1
24,"24133",350,259,258,3,1,"DN",0
24,"24042",61,48,48,1,0,"DN",0
24,"24164",373,190,190,1,0,"DN",0
24,"24131",742,499,497,5,2,"DN",0
24,"24114",3107,2174,2155,7,19,"DN",4
3,"3076",8485,6251,6194,37,57,"RECORTES CE",5
3,"3099",42365,31612,31259,220,353,"RECORTES CE",29
3,"3022",142,120,120,2,0,"RECORTES CE",0
3,"3001",337,289,286,3,3,"RECORTES CE",0
3,"3082",12542,8709,8597,48,112,"RECORTES CE",6
3,"3105",5387,4089,4017,21,72,"RECORTES CE",6
3,"3112",653,522,517,2,5,"RECORTES CE",1
3,"3101",4765,3708,3659,13,49,"RECORTES CE",5
3,"3009",46817,36581,36258,240,323,"RECORTES CE",59
3,"3030",513,432,424,0,8,"RECORTES CE",1
3,"3119",16534,12466,12363,69,103,"RECORTES CE",8
3,"3109",2850,2301,2275,11,26,"RECORTES CE",1
3,"3037",352,296,293,3,3,"RECORTES CE",0
3,"3029",242,186,183,1,3,"RECORTES CE",0
3,"3066",42291,31010,30781,190,229,"RECORTES CE",37
3,"3028",1006,833,823,1,10,"RECORTES CE",1
3,"3106",596,503,501,1,2,"RECORTES CE",0
3,"3048",4858,3785,3735,25,50,"RECORTES CE",95
3,"3062",213,176,175,0,1,"RECORTES CE",0
3,"3137",653,516,515,5,1,"RECORTES CE",0
3,"3020",102,79,79,0,0,"RECORTES CE",0
3,"3107",2459,1807,1791,5,16,"RECORTES CE",3
3,"3043",2900,2516,2483,18,33,"RECORTES CE",3
3,"3092",6749,5398,5342,40,56,"RECORTES CE",4
3,"3080",1299,1065,1036,3,29,"RECORTES CE",0
3,"3111",5411,4044,3967,14,77,"RECORTES CE",3
3,"3114",1568,1216,1203,8,13,"RECORTES CE",2
3,"3120",2416,1814,1783,13,31,"RECORTES CE",2
3,"3015",12544,9478,9388,58,90,"RECORTES CE",5
3,"3039",85,61,59,0,2,"RECORTES CE",0
3,"3139",22357,15787,15624,101,163,"RECORTES CE",24
3,"3036",91,80,79,2,1,"RECORTES CE",0
3,"3118",2452,1732,1714,9,18,"RECORTES CE",37
3,"3116",1159,892,886,2,6,"RECORTES CE",2
3,"3138",3154,2406,2378,10,28,"RECORTES CE",2
3,"3130",47,30,30,0,0,"RECORTES CE",0
3,"3007",168,142,138,0,4,"RECORTES CE",0
3,"3016",94,79,79,0,0,"RECORTES CE",0
3,"3086",153,134,134,1,0,"RECORTES CE",0
3,"3053",7196,5800,5736,37,64,"RECORTES CE",5
3,"3102",7271,5762,5687,46,75,"RECORTES CE",6
3,"3012",1072,862,849,3,13,"RECORTES CE",0
3,"3025",1270,1003,996,3,7,"RECORTES CE",0
3,"3046",1594,1185,1178,9,7,"RECORTES CE",1
3,"3103",278,240,237,1,3,"RECORTES CE",0
3,"3136",446,361,361,2,0,"RECORTES CE",1
3,"3131",175,159,153,0,6,"RECORTES CE",0
3,"3072",351,288,287,2,1,"RECORTES CE",0
3,"3021",5627,4691,4613,23,78,"RECORTES CE",3
3,"3003",455,393,388,3,5,"RECORTES CE",0
3,"3005",7753,6158,6118,38,40,"RECORTES CE",3
3,"3100",508,446,442,1,4,"RECORTES CE",0
3,"3115",248,219,219,2,0,"RECORTES CE",0
3,"3074",1706,1400,1382,3,18,"RECORTES CE",1
3,"3045",216,182,179,1,3,"RECORTES CE",0
3,"3091",247,217,215,1,2,"RECORTES CE",0
3,"3088",5498,4078,4030,42,48,"RECORTES CE",2
3,"3054",338,274,268,4,6,"RECORTES CE",0
3,"3129",1187,991,984,8,7,"RECORTES CE",0
3,"3017",376,317,312,3,5,"RECORTES CE",2
3,"3121",21269,14932,14795,78,137,"RECORTES CE",22
3,"3065",166944,126831,126024,773,807,"RECORTES CE",249
3,"3047",9161,6622,6534,35,88,"RECORTES CE",15
3,"3069",3060,2187,2168,9,19,"RECORTES CE",2
3,"3018",12212,9129,9040,64,89,"RECORTES CE",9
3,"3902",10213,7091,6997,52,94,"RECORTES CE",2
3,"3089",9599,7100,6980,39,120,"RECORTES CE",9
3,"3077",1374,1139,1126,11,13,"RECORTES CE",2
3,"3034",1367,1095,1079,4,16,"RECORTES CE",1
3,"3044",4512,3639,3586,16,53,"RECORTES CE",1
3,"3061",1057,828,816,2,12,"RECORTES CE",0
3,"3019",15261,11921,11804,98,117,"RECORTES CE",14
3,"3055",5168,3949,3899,13,50,"RECORTES CE",10
3,"3128",4097,2972,2942,12,30,"RECORTES CE",3
3,"3063",26383,19376,19255,105,121,"RECORTES CE",17
3,"3064",5040,3887,3834,16,53,"RECORTES CE",4
3,"3132",536,426,423,0,3,"RECORTES CE",1
3,"3026",1224,970,949,6,21,"RECORTES CE",2
3,"3125",346,263,262,0,1,"RECORTES CE",0
3,"3042",1367,1045,1033,5,12,"RECORTES CE",0
3,"3050",18601,13710,13610,61,100,"RECORTES CE",20
3,"3134",148,132,132,2,0,"RECORTES CE",0
3,"3085",270,226,225,1,1,"RECORTES CE",0
3,"3127",352,279,277,1,2,"RECORTES CE",0
3,"3071",3980,3134,3106,28,28,"RECORTES CE",2
3,"3027",159,135,132,0,3,"RECORTES CE",0
3,"3051",350,310,305,1,5,"RECORTES CE",0
3,"3067",98,82,81,1,1,"RECORTES CE",0
3,"3038",358,292,285,2,7,"RECORTES CE",1
3,"3073",236,202,202,1,0,"RECORTES CE",0
3,"3083",5607,4160,4106,36,54,"RECORTES CE",6
3,"3104",27134,21080,20902,156,178,"RECORTES CE",30
3,"3097",990,817,811,8,6,"RECORTES CE",0
3,"3122",42227,31379,31186,160,193,"RECORTES CE",72
3,"3058",4947,4015,3978,21,37,"RECORTES CE",1
3,"3049",12082,9341,9236,69,105,"RECORTES CE",0
3,"3124",469,400,394,5,6,"RECORTES CE",0
3,"3110",289,239,239,1,0,"RECORTES CE",0
3,"3090",17087,12723,12602,69,121,"RECORTES CE",10
3,"3024",3904,3109,3060,17,49,"RECORTES CE",0
3,"3008",167,132,131,0,1,"RECORTES CE",0
3,"3070",2038,1526,1499,5,27,"RECORTES CE",2
3,"3002",3610,2714,2682,18,32,"RECORTES CE",2
3,"3004",585,455,454,1,1,"RECORTES CE",2
3,"3056",8737,6809,6731,33,78,"RECORTES CE",8
3,"3123",7472,5748,5680,38,68,"RECORTES CE",8
3,"3014",237548,173040,172027,866,1013,"RECORTES CE",602
3,"3006",497,401,393,4,8,"RECORTES CE",0
3,"3068",46,41,40,0,1,"RECORTES CE",0
3,"3052",969,804,794,6,10,"RECORTES CE",0
3,"3904",1393,1065,1057,8,8,"RECORTES CE",2
3,"3081",1433,1130,1118,5,12,"RECORTES CE",0
3,"3096",5811,4539,4492,19,47,"RECORTES CE",2
3,"3040",257,222,222,0,0,"RECORTES CE",0
3,"3903",2482,1945,1926,16,19,"RECORTES CE",4
3,"3133",41763,26236,26039,134,197,"RECORTES CE",16
3,"3010",325,278,276,0,2,"RECORTES CE",0
3,"3011",7729,5651,5595,29,56,"RECORTES CE",7
3,"3901",1129,855,853,5,2,"RECORTES CE",0
3,"3094",9033,6702,6657,32,45,"RECORTES CE",3
3,"3117",370,325,322,0,3,"RECORTES CE",0
3,"3035",663,543,538,1,5,"RECORTES CE",0
3,"3113",4254,3159,3120,17,39,"RECORTES CE",1
3,"3098",507,403,394,3,9,"RECORTES CE",0
3,"3093",19661,15155,14988,84,167,"RECORTES CE",12
3,"3095",4602,3628,3605,27,23,"RECORTES CE",6
3,"3031",41486,28059,27851,152,208,"RECORTES CE",29
3,"3079",18235,14578,14388,114,190,"RECORTES CE",28
3,"3078",486,398,397,3,1,"RECORTES CE",0
3,"3032",106,90,89,1,1,"RECORTES CE",0
3,"3057",191,148,148,2,0,"RECORTES CE",0
3,"3059",20538,15653,15522,79,131,"RECORTES CE",23
3,"3013",1114,914,906,5,8,"RECORTES CE",0
3,"3075",156,139,139,0,0,"RECORTES CE",0
3,"3084",543,478,476,4,2,"RECORTES CE",1
3,"3023",1410,1221,1201,8,20,"RECORTES CE",1
3,"3060",108,92,90,1,2,"RECORTES CE",0
3,"3041",5945,4393,4344,28,49,"RECORTES CE",87
3,"3135",214,176,174,0,2,"RECORTES CE",0
3,"3033",113,97,97,2,0,"RECORTES CE",0
3,"3140",26176,19795,19509,155,286,"RECORTES CE",35
8,"8266",43128,32806,32660,195,146,"PCPC",74
8,"8122",1683,1117,1106,10,11,"PCPC",1
8,"8225",93,71,71,2,0,"PCPC",0
8,"8106",7216,5220,5176,38,44,"PCPC",16
8,"8297",138,100,99,1,1,"PCPC",0
8,"8209",6773,4845,4822,31,23,"PCPC",15
8,"8293",226,162,162,0,0,"PCPC",0
8,"8287",1044,806,792,7,14,"PCPC",1
8,"8048",583,426,424,5,2,"PCPC",0
8,"8025",1486,1087,1083,13,4,"PCPC",2
8,"8170",447,293,291,11,2,"PCPC",0
8,"8198",4391,3167,3138,17,29,"PCPC",8
8,"8229",535,383,379,3,4,"PCPC",1
8,"8013",1219,873,867,10,6,"PCPC",0
8,"8135",6733,5230,5205,45,25,"PCPC",3
8,"8011",1760,1230,1217,10,13,"PCPC",1
8,"8159",14049,10329,10284,51,45,"PCPC",22
8,"8096",42411,30717,30550,204,167,"PCPC",46
8,"8005",6165,4458,4434,23,24,"PCPC",1
8,"8214",6841,5018,4994,49,24,"PCPC",9
8,"8168",375,235,234,0,1,"PCPC",1
8,"8162",2028,1451,1442,8,9,"PCPC",1
8,"8003",7118,5140,5108,28,32,"PCPC",5
8,"8014",1953,1438,1429,13,9,"PCPC",2
8,"8059",342,224,223,3,1,"PCPC",0
8,"8144",715,493,489,9,4,"PCPC",0
8,"8125",25024,18070,17966,99,104,"PCPC",34
8,"8220",2358,1783,1770,18,13,"PCPC",1
8,"8254",1746,1261,1257,13,4,"PCPC",1
8,"8903",213,167,167,0,0,"PCPC",0
8,"8133",128,76,75,0,1,"PCPC",0
8,"8190",258,179,177,2,2,"PCPC",0
8,"8104",682,445,443,4,2,"PCPC",0
8,"8240",9354,6996,6953,34,43,"PCPC",12
8,"8124",36750,26968,26842,140,126,"PCPC",62
8,"8101",174802,123863,123197,643,666,"PCPC",300
8,"8117",2453,1741,1727,23,14,"PCPC",2
8,"8024",381,270,269,3,1,"PCPC",2
8,"8035",12448,8482,8443,54,39,"PCPC",9
8,"8056",41996,30076,29974,178,102,"PCPC",48
8,"8006",11427,7789,7727,46,62,"PCPC",13
8,"8111",216,185,185,0,0,"PCPC",0
8,"8294",1971,1357,1349,8,8,"PCPC",2
8,"8020",4876,3702,3678,25,24,"PCPC",5
8,"8247",958,716,714,7,2,"PCPC",0
8,"8902",3756,2758,2741,18,17,"PCPC",0
8,"8157",8361,6311,6277,38,34,"PCPC",12
8,"8004",233,181,181,2,0,"PCPC",0
8,"8188",117,81,81,2,0,"PCPC",0
8,"8203",2422,1602,1591,11,11,"PCPC",4
8,"8121",86293,61426,61070,450,356,"PCPC",111
8,"8181",7896,5774,5724,41,50,"PCPC",11
8,"8155",6736,4779,4734,45,45,"PCPC",14
8,"8206",731,568,559,9,9,"PCPC",1
8,"8291",4524,3226,3206,24,20,"PCPC",4
8,"8193",942,637,633,9,4,"PCPC",1
8,"8058",1742,1210,1194,7,16,"PCPC",8
8,"8307",48233,34249,34071,209,178,"PCPC",59
8,"8109",214,174,173,0,1,"PCPC",0
8,"8244",5821,4484,4451,32,33,"PCPC",11
8,"8049",1288,860,841,9,19,"PCPC",0
8,"8304",814,578,573,1,5,"PCPC",0
8,"8140",4769,3344,3335,25,9,"PCPC",2
8,"8184",53690,37794,37636,200,158,"PCPC",118
8,"8288",1632,1061,1053,4,8,"PCPC",2
8,"8197",7605,5331,5317,31,14,"PCPC",3
8,"8182",2803,2039,2034,16,5,"PCPC",2
8,"8249",266,223,220,2,3,"PCPC",0
8,"8082",1150,788,783,6,5,"PCPC",3
8,"8130",96,66,66,0,0,"PCPC",1
8,"8083",1674,1287,1275,8,12,"PCPC",0
8,"8069",3168,2333,2324,17,9,"PCPC",2
8,"8236",1525,1077,1067,3,10,"PCPC",1
8,"8060",143,100,99,0,1,"PCPC",2
8,"8064",1853,1323,1315,9,8,"PCPC",2
8,"8127",2224,1439,1429,8,10,"PCPC",1
8,"8126",8709,6454,6425,34,29,"PCPC",6
8,"8238",14478,11302,11252,85,50,"PCPC",13
8,"8070",267,196,193,2,3,"PCPC",0
8,"8171",2099,1396,1389,20,7,"PCPC",0
8,"8258",835,602,597,5,5,"PCPC",1
8,"8061",1485,1045,1040,5,5,"PCPC",2
8,"8180",26616,19621,19542,90,79,"PCPC",37
8,"8091",5253,3817,3795,23,22,"PCPC",13
8,"8008",187,118,118,1,0,"PCPC",0
8,"8093",26,19,19,0,0,"PCPC",0
8,"8087",159,131,130,2,1,"PCPC",0
8,"8161",11145,7658,7621,45,37,"PCPC",6
8,"8128",564,378,377,1,1,"PCPC",2
8,"8002",202,142,139,0,3,"PCPC",0
8,"8226",879,683,680,3,3,"PCPC",1
8,"8134",803,560,554,5,6,"PCPC",1
8,"8241",76,59,59,0,0,"PCPC",0
8,"8196",19247,14101,14047,75,54,"PCPC",26
8,"8150",258,189,185,0,4,"PCPC",0
8,"8158",3105,2166,2145,18,21,"PCPC",5
8,"8165",1657,1181,1175,8,6,"PCPC",3
8,"8021",69,52,51,3,1,"PCPC",0
8,"8094",1548,1143,1133,12,10,"PCPC",2
8,"8007",6505,4532,4495,28,37,"PCPC",6
8,"8208",5736,4318,4295,23,23,"PCPC",5
8,"8256",644,516,512,1,4,"PCPC",0
8,"8085",985,712,704,1,8,"PCPC",0
8,"8018",2654,1834,1819,16,15,"PCPC",1
8,"8292",1083,796,791,4,5,"PCPC",2
8,"8063",448,363,363,8,0,"PCPC",1
8,"8264",4288,3045,3030,30,15,"PCPC",5
8,"8175",3371,2243,2232,25,11,"PCPC",3
8,"8052",139,94,94,2,0,"PCPC",0
8,"8034",766,542,538,3,4,"PCPC",0
8,"8097",1027,736,731,7,5,"PCPC",0
8,"8147",17001,12422,12333,62,89,"PCPC",21
8,"8108",5014,3757,3740,21,17,"PCPC",6
8,"8141",4590,3173,3150,39,23,"PCPC",4
8,"8156",10923,8013,7964,50,49,"PCPC",16
8,"8086",13550,9448,9395,66,53,"PCPC",15
8,"8901",232,171,171,6,0,"PCPC",0
8,"8275",254,202,202,4,0,"PCPC",0
8,"8261",2319,1638,1632,4,6,"PCPC",3
8,"8298",26426,17862,17784,113,78,"PCPC",17
8,"8053",2805,1789,1775,10,14,"PCPC",4
8,"8192",5696,4093,4069,38,24,"PCPC",6
8,"8221",12391,9503,9456,49,47,"PCPC",10
8,"8273",2309,1706,1689,12,17,"PCPC",2
8,"8202",12615,8911,8831,70,80,"PCPC",20
8,"8009",9136,6613,6578,40,35,"PCPC",10
8,"8280",101,67,67,3,0,"PCPC",0
8,"8098",2387,1668,1662,11,6,"PCPC",1
8,"8306",517,360,354,2,6,"PCPC",0
8,"8065",1179,837,831,8,6,"PCPC",2
8,"8200",61275,45027,44785,276,242,"PCPC",96
8,"8017",2756,1888,1876,7,12,"PCPC",1
8,"8040",10701,7420,7383,43,37,"PCPC",10
8,"8132",379,259,256,3,3,"PCPC",1
8,"8189",126,95,94,2,1,"PCPC",0
8,"8185",194,132,132,0,0,"PCPC",0
8,"8047",3978,2640,2614,21,26,"PCPC",6
8,"8299",395,256,255,3,1,"PCPC",0
8,"8271",69,47,46,0,1,"PCPC",0
8,"8215",2576,1766,1751,30,15,"PCPC",0
8,"8230",7611,5590,5560,40,30,"PCPC",10
8,"8092",3768,2621,2600,31,21,"PCPC",5
8,"8114",18335,13196,13092,66,104,"PCPC",24
8,"8223",1850,1279,1263,10,16,"PCPC",2
8,"8301",48496,35956,35788,200,168,"PCPC",76
8,"8267",6435,4571,4542,24,29,"PCPC",3
8,"8166",1000,680,674,4,6,"PCPC",1
8,"8246",1682,1157,1152,8,5,"PCPC",2
8,"8904",10563,7474,7437,32,37,"PCPC",18
8,"8030",5095,3727,3712,27,15,"PCPC",5
8,"8148",2238,1592,1580,7,12,"PCPC",8
8,"8187",152527,112013,111491,638,522,"PCPC",253
8,"8228",296,207,204,3,3,"PCPC",0
8,"8268",1011,702,699,2,3,"PCPC",2
8,"8038",1488,987,981,10,6,"PCPC",1
8,"8179",579,427,425,6,2,"PCPC",1
8,"8224",816,598,595,7,3,"PCPC",4
8,"8123",19114,14573,14509,81,64,"PCPC",19
8,"8031",2308,1648,1637,10,11,"PCPC",1
8,"8905",2305,1789,1774,17,15,"PCPC",1
8,"8302",9209,6571,6524,65,47,"PCPC",11
8,"8112",12909,8671,8616,50,55,"PCPC",15
8,"8057",59,42,41,2,1,"PCPC",0
8,"8054",9013,6747,6702,38,45,"PCPC",13
8,"8113",52051,34906,34729,229,177,"PCPC",38
8,"8102",28304,19929,19821,170,108,"PCPC",29
8,"8218",8045,5643,5613,54,30,"PCPC",7
8,"8131",699,520,516,4,4,"PCPC",0
8,"8210",4296,2825,2806,22,19,"PCPC",8
8,"8039",354,259,259,0,0,"PCPC",0
8,"8080",38,28,27,0,1,"PCPC",0
8,"8062",951,676,674,5,2,"PCPC",1
8,"8043",3190,2216,2201,12,15,"PCPC",4
8,"8263",20974,15086,15001,93,85,"PCPC",42
8,"8303",278,206,205,2,1,"PCPC",0
8,"8281",4841,3577,3553,18,24,"PCPC",6
8,"8252",24521,18605,18514,110,91,"PCPC",49
8,"8022",12230,7792,7717,60,75,"PCPC",3
8,"8174",394,306,300,3,6,"PCPC",0
8,"8129",456,322,320,3,2,"PCPC",1
8,"8219",15355,11458,11403,86,55,"PCPC",18
8,"8107",11472,8147,8097,45,50,"PCPC",55
8,"8151",463,336,333,11,3,"PCPC",0
8,"8136",11416,8425,8388,63,37,"PCPC",25
8,"8037",1856,1364,1351,20,13,"PCPC",0
8,"8227",2329,1625,1607,13,18,"PCPC",4
8,"8308",131,99,97,0,2,"PCPC",0
8,"8137",265,206,205,1,1,"PCPC",0
8,"8023",6715,4669,4633,25,36,"PCPC",4
8,"8089",33935,24504,24392,150,112,"PCPC",36
8,"8178",430,317,315,4,2,"PCPC",0
8,"8167",5879,4463,4448,42,15,"PCPC",14
8,"8231",20495,13961,13885,91,76,"PCPC",25
8,"8305",27328,19226,19083,116,143,"PCPC",49
8,"8253",133,85,85,1,0,"PCPC",1
8,"8075",3875,2709,2695,12,14,"PCPC",5
8,"8283",5983,4032,4007,31,25,"PCPC",2
8,"8195",82,64,64,0,0,"PCPC",0
8,"8012",1676,1175,1170,24,5,"PCPC",3
8,"8105",9613,7103,7047,46,56,"PCPC",17
8,"8183",4524,3125,3103,21,22,"PCPC",5
8,"8272",157,98,97,0,1,"PCPC",0
8,"8028",1031,724,721,6,3,"PCPC",1
8,"8146",1297,958,954,16,4,"PCPC",3
8,"8076",16173,11553,11473,73,80,"PCPC",20
8,"8139",171,133,132,0,1,"PCPC",0
8,"8153",536,432,431,6,1,"PCPC",0
8,"8160",330,217,217,0,0,"PCPC",0
8,"8154",694,535,529,3,6,"PCPC",3
8,"8296",1787,1358,1351,9,7,"PCPC",4
8,"8177",40,25,25,1,0,"PCPC",0
8,"8251",4970,3505,3480,14,25,"PCPC",7
8,"8233",1876,1247,1237,11,10,"PCPC",0
8,"8073",61659,45611,45356,239,255,"PCPC",93
8,"8274",4702,3349,3323,35,26,"PCPC",11
8,"8036",159,113,112,1,1,"PCPC",0
8,"8055",512,366,364,2,2,"PCPC",0
8,"8026",187,155,155,1,0,"PCPC",0
8,"8234",3187,2331,2322,11,9,"PCPC",6
8,"8201",436,299,298,1,1,"PCPC",0
8,"8077",34550,26102,25983,152,119,"PCPC",47
8,"8300",5682,4328,4312,21,16,"PCPC",8
8,"8041",10314,7291,7238,46,53,"PCPC",8
8,"8044",4150,2957,2932,19,25,"PCPC",6
8,"8286",2904,2009,1997,17,12,"PCPC",1
8,"8278",4764,3372,3358,16,14,"PCPC",2
8,"8245",78581,55798,55530,345,268,"PCPC",173
8,"8100",1992,1496,1485,21,11,"PCPC",0
8,"8078",216,135,135,2,0,"PCPC",0
8,"8116",582,421,418,4,3,"PCPC",0
8,"8045",72,42,39,0,3,"PCPC",0
8,"8290",1490,1163,1155,5,8,"PCPC",1
8,"8119",6182,4517,4492,35,25,"PCPC",14
8,"8235",3683,2612,2595,22,17,"PCPC",5
8,"8279",152985,110533,110039,684,494,"PCPC",259
8,"8265",1548,1115,1108,8,7,"PCPC",0
8,"8243",160,117,117,6,0,"PCPC",0
8,"8015",155841,109156,108536,726,620,"PCPC",245
8,"8164",911,651,644,2,7,"PCPC",1
8,"8042",2233,1668,1653,8,15,"PCPC",2
8,"8120",6815,5071,5045,34,26,"PCPC",4
8,"8068",6729,4765,4739,23,26,"PCPC",4
8,"8145",2585,1927,1915,10,12,"PCPC",4
8,"8149",996,662,660,7,2,"PCPC",2
8,"8142",132,105,104,1,1,"PCPC",0
8,"8016",1822,1229,1214,12,15,"PCPC",1
8,"8176",158,113,113,1,0,"PCPC",0
8,"8032",1973,1410,1403,6,7,"PCPC",0
8,"8072",10240,6957,6935,40,22,"PCPC",10
8,"8143",2686,1892,1881,19,11,"PCPC",3
8,"8051",17873,13126,13048,66,78,"PCPC",34
8,"8095",71,50,50,0,0,"PCPC",0
8,"8207",1840,1418,1410,17,8,"PCPC",4
8,"8211",32990,25446,25282,173,164,"PCPC",42
8,"8110",13392,9211,9142,67,69,"PCPC",15
8,"8248",5402,3848,3815,27,33,"PCPC",5
8,"8046",13243,9747,9693,74,54,"PCPC",14
8,"8237",1642,1165,1160,4,5,"PCPC",2
8,"8204",3058,2282,2262,17,20,"PCPC",2
8,"8270",18399,12948,12869,83,79,"PCPC",20
8,"8099",749,514,513,4,1,"PCPC",0
8,"8019",1141245,824778,820790,5063,3988,"PCPC",1478
8,"8285",10260,6893,6843,56,50,"PCPC",8
8,"8282",6517,5027,5017,40,10,"PCPC",6
8,"8067",5723,3896,3874,39,22,"PCPC",3
8,"8103",631,431,431,3,0,"PCPC",1
8,"8118",17516,12878,12820,79,58,"PCPC",21
8,"8242",216,172,170,0,2,"PCPC",0
8,"8250",7046,4908,4878,33,30,"PCPC",12
8,"8284",12067,7855,7792,66,63,"PCPC",11
8,"8090",129,103,102,2,1,"PCPC",0
8,"8205",59169,45410,45231,357,179,"PCPC",43
8,"8199",665,466,464,6,2,"PCPC",0
8,"8115",3817,2835,2814,18,21,"PCPC",5
8,"8071",241,168,164,3,4,"PCPC",0
8,"8276",233,169,169,3,0,"PCPC",0
8,"8257",110,87,87,0,0,"PCPC",0
8,"8269",2646,1871,1860,17,11,"PCPC",2
8,"8191",5287,3732,3712,31,20,"PCPC",10
8,"8001",8825,6810,6760,24,50,"PCPC",13
8,"8079",339,254,248,2,6,"PCPC",0
8,"8213",6296,4308,4294,47,14,"PCPC",6
8,"8212",495,350,347,3,3,"PCPC",0
8,"8084",1135,795,790,6,5,"PCPC",4
8,"8232",1797,1276,1266,14,10,"PCPC",4
8,"8010",4196,2876,2852,16,24,"PCPC",4
8,"8255",140,90,90,1,0,"PCPC",0
8,"8259",6623,4921,4885,33,36,"PCPC",7
8,"8088",11840,8684,8627,55,57,"PCPC",6
8,"8050",141,107,104,0,3,"PCPC",0
8,"8194",25539,16628,16553,77,75,"PCPC",42
8,"8277",162,132,132,0,0,"PCPC",1
8,"8074",10587,7309,7274,51,35,"PCPC",19
8,"8172",20384,14738,14684,85,54,"PCPC",21
8,"8289",4304,3166,3151,19,15,"PCPC",5
8,"8029",3438,2645,2632,25,13,"PCPC",3
8,"8163",18590,12816,12750,72,66,"PCPC",17
8,"8033",12803,9236,9179,79,57,"PCPC",18
8,"8081",345,255,255,1,0,"PCPC",0
8,"8222",1878,1452,1443,16,9,"PCPC",3
8,"8260",18306,13492,13423,60,69,"PCPC",27
8,"8027",690,527,524,3,3,"PCPC",1
8,"8262",6855,4522,4491,46,31,"PCPC",7
8,"8138",4229,2832,2816,19,16,"PCPC",6
8,"8239",451,324,324,5,0,"PCPC",2
8,"8217",24985,19385,19317,130,68,"PCPC",44
8,"8152",114,84,82,1,2,"PCPC",0
8,"8066",1364,1029,1025,10,4,"PCPC",3
8,"8216",25,17,17,0,0,"PCPC",0
8,"8169",47915,35543,35390,211,153,"PCPC",105
8,"8295",10850,7651,7617,33,34,"PCPC",22
26,"26126",31,29,29,0,0,"PACMA",1
26,"26080",475,392,388,6,4,"PACMA",0
26,"26096",244,199,197,3,2,"PACMA",0
26,"26017",383,302,301,4,1,"PACMA",3
26,"26023",468,358,355,4,3,"PACMA",1
26,"26049",174,127,121,0,6,"PACMA",2
26,"26073",98,83,83,0,0,"PACMA",0
26,"26042",836,645,635,5,10,"PACMA",3
26,"26030",12,12,12,0,0,"PACMA",0
26,"26053",208,161,160,1,1,"PACMA",1
26,"26034",660,522,513,1,9,"PACMA",2
26,"26064",2278,1736,1715,17,21,"PACMA",11
26,"26115",17,14,14,0,0,"PACMA",0
26,"26121",27,21,21,0,0,"PACMA",0
26,"26138",4600,3374,3325,28,49,"PACMA",10
26,"26177",309,266,264,2,2,"PACMA",0
26,"26128",104,80,79,0,1,"PACMA",1
26,"26107",92,75,75,0,0,"PACMA",0
26,"26048",22,22,21,0,1,"PACMA",0
26,"26127",215,182,179,2,3,"PACMA",0
26,"26061",1548,1179,1160,14,19,"PACMA",4
26,"26166",142,131,128,1,3,"PACMA",2
26,"26092",108,83,82,0,1,"PACMA",1
26,"26117",2168,1695,1662,19,33,"PACMA",6
26,"26038",95,66,65,0,1,"PACMA",0
26,"26058",150,114,113,0,1,"PACMA",1
26,"26088",36,32,31,0,1,"PACMA",0
26,"26130",203,167,166,1,1,"PACMA",0
26,"26108",268,207,205,5,2,"PACMA",0
26,"26078",83,68,68,0,0,"PACMA",0
26,"26158",265,220,217,4,3,"PACMA",0
26,"26012",23,23,23,0,0,"PACMA",0
26,"26015",193,151,149,0,2,"PACMA",0
26,"26101",46,34,34,0,0,"PACMA",1
26,"26040",68,62,62,0,0,"PACMA",2
26,"26036",16990,12136,11984,98,152,"PACMA",93
26,"26087",208,157,154,4,3,"PACMA",1
26,"26122",119,104,102,2,2,"PACMA",0
26,"26059",1117,850,840,9,10,"PACMA",6
26,"26179",42,34,33,0,1,"PACMA",0
26,"26035",16,12,12,0,0,"PACMA",0
26,"26031",106,81,81,0,0,"PACMA",0
26,"26150",117,98,98,1,0,"PACMA",0
26,"26019",351,282,281,1,1,"PACMA",2
26,"26039",38,35,35,0,0,"PACMA",0
26,"26009",414,326,319,3,7,"PACMA",2
26,"26131",34,33,33,1,0,"PACMA",0
26,"26014",466,319,319,0,0,"PACMA",0
26,"26022",198,159,158,0,1,"PACMA",0
26,"26094",85,71,68,0,3,"PACMA",1
26,"26147",30,26,26,0,0,"PACMA",0
26,"26155",162,138,137,0,1,"PACMA",0
26,"26164",61,41,41,0,0,"PACMA",0
26,"26010",98,78,78,1,0,"PACMA",1
26,"26077",27,25,25,0,0,"PACMA",0
26,"26086",15,15,15,0,0,"PACMA",0
26,"26143",217,178,177,0,1,"PACMA",2
26,"26100",52,43,43,0,0,"PACMA",0
26,"26051",254,202,201,2,1,"PACMA",0
26,"26120",1457,1144,1133,9,11,"PACMA",6
26,"26160",715,569,567,3,2,"PACMA",6
26,"26118",61,49,49,1,0,"PACMA",0
26,"26144",194,150,148,2,2,"PACMA",3
26,"26057",51,47,45,0,2,"PACMA",0
26,"26140",260,221,218,1,3,"PACMA",1
26,"26082",109,92,89,0,3,"PACMA",0
26,"26037",131,111,111,1,0,"PACMA",0
26,"26072",289,259,258,2,1,"PACMA",0
26,"26066",265,217,209,3,8,"PACMA",1
26,"26145",245,202,201,3,1,"PACMA",0
26,"26149",61,48,48,0,0,"PACMA",1
26,"26095",101,78,77,1,1,"PACMA",0
26,"26178",80,64,63,1,1,"PACMA",0
26,"26016",28,24,24,1,0,"PACMA",0
26,"26075",334,268,264,2,4,"PACMA",1
26,"26026",1323,1070,1060,8,10,"PACMA",5
26,"26106",88,78,78,0,0,"PACMA",1
26,"26067",23,20,20,0,0,"PACMA",0
26,"26018",10469,8216,8110,71,106,"PACMA",42
26,"26146",101,78,77,0,1,"PACMA",0
26,"26119",202,163,162,4,1,"PACMA",1
26,"26093",57,44,44,0,0,"PACMA",0
26,"26027",157,127,127,1,0,"PACMA",0
26,"26007",523,406,401,2,5,"PACMA",2
26,"26132",111,88,88,1,0,"PACMA",0
26,"26052",158,125,125,0,0,"PACMA",0
26,"26123",130,111,108,0,3,"PACMA",1
26,"26103",789,626,616,3,10,"PACMA",5
26,"26032",53,40,40,0,0,"PACMA",1
26,"26165",364,315,311,1,4,"PACMA",1
26,"26089",110513,85146,84302,712,844,"PACMA",613
26,"26020",483,356,344,2,12,"PACMA",2
26,"26091",166,141,138,0,3,"PACMA",0
26,"26168",5318,3853,3802,36,51,"PACMA",41
26,"26139",54,46,46,0,0,"PACMA",0
26,"26170",448,346,344,8,2,"PACMA",0
26,"26183",65,50,50,0,0,"PACMA",1
26,"26005",2343,1607,1590,19,17,"PACMA",5
26,"26024",236,183,183,0,0,"PACMA",0
26,"26004",68,53,53,1,0,"PACMA",0
26,"26069",240,201,199,0,2,"PACMA",0
26,"26172",30,25,25,0,0,"PACMA",0
26,"26152",31,24,23,0,1,"PACMA",0
26,"26148",171,147,145,0,2,"PACMA",0
26,"26105",2187,1722,1696,16,26,"PACMA",9
26,"26163",143,117,117,2,0,"PACMA",0
26,"26109",85,76,74,1,2,"PACMA",0
26,"26062",90,73,71,0,2,"PACMA",0
26,"26054",324,255,254,3,1,"PACMA",0
26,"26070",186,154,153,1,1,"PACMA",0
26,"26047",1969,1614,1596,14,18,"PACMA",2
26,"26171",179,136,126,1,10,"PACMA",0
26,"26142",780,618,613,1,5,"PACMA",12
26,"26046",1594,1221,1209,3,12,"PACMA",2
26,"26099",1259,1038,1024,7,14,"PACMA",2
26,"26050",117,86,86,0,0,"PACMA",0
26,"26002",840,615,608,6,7,"PACMA",5
26,"26154",11,8,8,0,0,"PACMA",0
26,"26124",824,664,659,8,5,"PACMA",2
26,"26098",94,72,71,1,1,"PACMA",1
26,"26110",162,135,134,0,1,"PACMA",0
26,"26180",221,182,179,0,3,"PACMA",3
26,"26043",373,284,282,4,2,"PACMA",6
26,"26134",87,65,65,1,0,"PACMA",0
26,"26153",12,11,10,0,1,"PACMA",0
26,"26065",50,40,40,0,0,"PACMA",0
26,"26174",147,122,112,0,10,"PACMA",0
26,"26006",1809,1420,1410,14,10,"PACMA",12
26,"26161",7,7,7,0,0,"PACMA",0
26,"26169",64,60,60,0,0,"PACMA",0
26,"26060",85,67,67,1,0,"PACMA",0
26,"26003",416,336,330,2,6,"PACMA",0
26,"26076",128,111,110,2,1,"PACMA",0
26,"26104",14,9,9,0,0,"PACMA",0
26,"26044",51,46,45,0,1,"PACMA",0
26,"26008",1862,1442,1425,7,17,"PACMA",9
26,"26141",112,85,83,1,2,"PACMA",0
26,"26033",172,143,142,2,1,"PACMA",1
26,"26175",52,44,44,2,0,"PACMA",0
26,"26074",105,86,85,1,1,"PACMA",0
26,"26041",134,97,94,1,3,"PACMA",0
26,"26079",639,536,527,2,9,"PACMA",2
26,"26129",971,768,757,2,11,"PACMA",1
26,"26029",37,31,31,0,0,"PACMA",0
26,"26114",80,71,71,2,0,"PACMA",0
26,"26157",296,236,232,3,4,"PACMA",1
26,"26021",2819,2113,2077,23,36,"PACMA",15
26,"26135",167,120,119,0,1,"PACMA",0
26,"26112",243,192,191,1,1,"PACMA",0
26,"26176",54,46,43,1,3,"PACMA",0
26,"26081",16,14,14,0,0,"PACMA",0
26,"26167",59,45,45,1,0,"PACMA",0
26,"26173",6,6,6,1,0,"PACMA",0
26,"26181",15,13,13,0,0,"PACMA",0
26,"26102",6128,4673,4585,42,88,"PACMA",29
26,"26068",82,68,66,0,2,"PACMA",1
26,"26071",8477,6115,6029,51,86,"PACMA",67
26,"26083",289,213,213,1,0,"PACMA",2
26,"26063",122,97,96,0,1,"PACMA",0
26,"26113",37,34,32,0,2,"PACMA",0
26,"26055",42,33,33,0,0,"PACMA",0
26,"26056",425,357,353,6,4,"PACMA",1
26,"26125",2708,2013,1988,22,25,"PACMA",5
26,"26136",103,73,72,1,1,"PACMA",0
26,"26025",85,71,71,1,0,"PACMA",1
26,"26028",133,112,111,0,1,"PACMA",0
26,"26011",7336,5309,5255,57,54,"PACMA",20
26,"26111",248,195,192,1,3,"PACMA",1
26,"26045",12,12,12,0,0,"PACMA",0
26,"26151",446,380,375,1,5,"PACMA",1
26,"26001",197,163,155,3,8,"PACMA",2
26,"26162",121,106,106,2,0,"PACMA",0
26,"26013",356,264,262,3,2,"PACMA",2
26,"26084",6630,5015,4952,27,63,"PACMA",49
50,"50035",74,53,52,0,1,"PCPE",0
50,"50254",181,130,129,2,1,"PCPE",0
50,"50128",28,24,24,0,0,"PCPE",1
50,"50268",47,40,39,0,1,"PCPE",0
50,"50179",257,207,207,2,0,"PCPE",1
50,"50162",147,110,110,2,0,"PCPE",0
50,"50272",12913,9500,9415,80,85,"PCPE",17
50,"50131",237,168,167,2,1,"PCPE",0
50,"50083",90,72,72,1,0,"PCPE",0
50,"50011",127,96,96,2,0,"PCPE",0
50,"50063",61,57,57,0,0,"PCPE",0
50,"50003",126,93,92,3,1,"PCPE",0
50,"50194",84,52,52,0,0,"PCPE",0
50,"50020",822,560,555,5,5,"PCPE",0
50,"50204",2457,1830,1816,14,14,"PCPE",1
50,"50021",32,25,25,3,0,"PCPE",0
50,"50056",406,325,324,2,1,"PCPE",1
50,"50288",3371,2566,2547,26,19,"PCPE",0
50,"50076",81,64,64,0,0,"PCPE",0
50,"50053",688,535,522,6,13,"PCPE",0
50,"50100",333,263,261,5,2,"PCPE",1
50,"50072",174,124,122,2,2,"PCPE",1
50,"50133",117,88,88,3,0,"PCPE",1
50,"50227",108,79,79,1,0,"PCPE",0
50,"50282",70,48,48,0,0,"PCPE",0
50,"50903",2225,1686,1669,21,17,"PCPE",2
50,"50152",1457,1032,1018,11,14,"PCPE",0
50,"50068",1998,1388,1378,17,10,"PCPE",0
50,"50278",198,145,144,1,1,"PCPE",0
50,"50263",197,123,121,6,2,"PCPE",0
50,"50283",72,55,54,0,1,"PCPE",0
50,"50160",2245,1661,1648,10,13,"PCPE",0
50,"50066",2613,1956,1951,21,5,"PCPE",1
50,"50032",273,190,189,0,1,"PCPE",1
50,"50079",254,186,184,3,2,"PCPE",0
50,"50073",2148,1649,1622,9,27,"PCPE",2
50,"50124",417,312,312,9,0,"PCPE",0
50,"50213",98,77,72,0,5,"PCPE",0
50,"50129",245,164,164,1,0,"PCPE",0
50,"50042",16,13,13,0,0,"PCPE",0
50,"50174",92,70,70,0,0,"PCPE",0
50,"50203",1043,811,802,15,9,"PCPE",0
50,"50223",915,747,741,8,6,"PCPE",0
50,"50251",8300,6228,6167,62,61,"PCPE",9
50,"50044",232,156,156,1,0,"PCPE",0
50,"50041",12,10,10,0,0,"PCPE",0
50,"50284",151,115,113,0,2,"PCPE",0
50,"50038",1511,1167,1159,13,8,"PCPE",4
50,"50182",3352,2437,2409,26,28,"PCPE",5
50,"50117",125,91,90,1,1,"PCPE",0
50,"50192",236,185,183,2,2,"PCPE",0
50,"50094",1626,1197,1178,22,19,"PCPE",5
50,"50197",92,71,71,2,0,"PCPE",0
50,"50151",650,504,503,7,1,"PCPE",0
50,"50001",115,81,80,0,1,"PCPE",0
50,"50098",181,129,127,2,2,"PCPE",0
50,"50006",939,712,701,8,11,"PCPE",2
50,"50286",77,54,54,0,0,"PCPE",0
50,"50170",378,286,283,2,3,"PCPE",0
50,"50218",113,90,89,1,1,"PCPE",1
50,"50165",1815,1333,1316,27,17,"PCPE",5
50,"50005",234,178,178,1,0,"PCPE",0
50,"50036",103,79,79,0,0,"PCPE",0
50,"50161",117,76,76,0,0,"PCPE",0
50,"50095",12366,8938,8856,94,82,"PCPE",19
50,"50190",708,542,539,3,3,"PCPE",4
50,"50168",28,23,23,0,0,"PCPE",0
50,"50215",23,15,15,0,0,"PCPE",0
50,"50065",53,42,42,0,0,"PCPE",0
50,"50231",260,213,210,7,3,"PCPE",0
50,"50027",227,177,176,1,1,"PCPE",1
50,"50232",171,120,118,0,2,"PCPE",0
50,"50191",476,327,325,3,2,"PCPE",0
50,"50150",660,402,402,3,0,"PCPE",0
50,"50248",521,407,406,1,1,"PCPE",1
50,"50264",158,111,111,0,0,"PCPE",0
50,"50238",97,74,73,0,1,"PCPE",1
50,"50101",879,615,609,5,6,"PCPE",2
50,"50295",45,39,39,0,0,"PCPE",1
50,"50247",827,624,615,10,9,"PCPE",1
50,"50023",223,175,173,3,2,"PCPE",0
50,"50207",109,88,88,1,0,"PCPE",0
50,"50109",105,78,77,3,1,"PCPE",1
50,"50269",288,185,183,0,2,"PCPE",0
50,"50075",81,59,59,1,0,"PCPE",0
50,"50148",324,240,236,0,4,"PCPE",2
50,"50111",186,152,151,1,1,"PCPE",0
50,"50141",114,85,84,0,1,"PCPE",0
50,"50102",863,665,654,6,11,"PCPE",0
50,"50039",507,400,398,3,2,"PCPE",1
50,"50163",3655,2766,2740,34,26,"PCPE",4
50,"50018",948,717,712,6,5,"PCPE",0
50,"50224",69,55,55,1,0,"PCPE",0
50,"50050",98,59,59,3,0,"PCPE",0
50,"50135",95,63,63,0,0,"PCPE",0
50,"50110",369,258,257,0,1,"PCPE",0
50,"50296",398,297,293,2,4,"PCPE",1
50,"50262",1187,931,930,13,1,"PCPE",2
50,"50246",41,29,29,0,0,"PCPE",0
50,"50225",1568,996,985,2,11,"PCPE",1
50,"50030",225,156,156,2,0,"PCPE",1
50,"50016",52,37,37,0,0,"PCPE",0
50,"50237",103,73,73,2,0,"PCPE",0
50,"50136",579,420,413,0,7,"PCPE",0
50,"50047",50,32,32,1,0,"PCPE",0
50,"50293",423,282,280,5,2,"PCPE",1
50,"50281",80,57,56,0,1,"PCPE",2
50,"50172",196,138,136,0,2,"PCPE",0
50,"50013",224,187,186,3,1,"PCPE",0
50,"50214",27,16,16,1,0,"PCPE",0
50,"50169",362,264,262,0,2,"PCPE",0
50,"50082",89,58,57,0,1,"PCPE",0
50,"50014",146,99,99,1,0,"PCPE",0
50,"50048",35,23,23,0,0,"PCPE",0
50,"50292",132,103,103,0,0,"PCPE",0
50,"50155",102,78,78,0,0,"PCPE",0
50,"50069",76,53,52,0,1,"PCPE",0
50,"50187",70,38,38,0,0,"PCPE",0
50,"50265",62,41,41,0,0,"PCPE",1
50,"50113",618,506,496,4,10,"PCPE",0
50,"50275",110,73,72,0,1,"PCPE",0
50,"50285",648,473,469,3,4,"PCPE",0
50,"50008",5085,3617,3574,30,43,"PCPE",4
50,"50123",465,349,344,2,5,"PCPE",2
50,"50266",129,85,85,1,0,"PCPE",0
50,"50249",312,235,233,1,2,"PCPE",0
50,"50242",92,81,79,1,2,"PCPE",0
50,"50273",31,18,18,0,0,"PCPE",0
50,"50084",79,56,56,1,0,"PCPE",0
50,"50259",89,61,61,1,0,"PCPE",0
50,"50074",6397,4512,4408,38,104,"PCPE",10
50,"50164",395,263,260,2,3,"PCPE",0
50,"50201",443,335,330,2,5,"PCPE",0
50,"50147",788,577,576,4,1,"PCPE",1
50,"50120",49,36,36,3,0,"PCPE",0
50,"50243",340,259,254,1,5,"PCPE",0
50,"50267",605,424,420,4,4,"PCPE",3
50,"50125",371,260,258,3,2,"PCPE",2
50,"50118",2179,1575,1564,7,11,"PCPE",0
50,"50171",108,70,69,0,1,"PCPE",0
50,"50212",41,37,37,0,0,"PCPE",0
50,"50185",132,110,110,1,0,"PCPE",0
50,"50244",205,157,157,3,0,"PCPE",0
50,"50291",100,69,69,0,0,"PCPE",0
50,"50260",35,32,32,0,0,"PCPE",0
50,"50250",55,44,44,0,0,"PCPE",0
50,"50104",351,283,282,3,1,"PCPE",1
50,"50092",298,256,251,3,5,"PCPE",1
50,"50143",569,414,411,4,3,"PCPE",1
50,"50130",395,252,252,1,0,"PCPE",0
50,"50234",245,198,193,9,5,"PCPE",1
50,"50902",87,78,78,1,0,"PCPE",0
50,"50245",90,60,60,1,0,"PCPE",0
50,"50140",165,106,106,0,0,"PCPE",0
50,"50193",647,514,506,1,8,"PCPE",0
50,"50119",930,698,691,7,7,"PCPE",0
50,"50108",47,37,37,0,0,"PCPE",0
50,"50200",509,406,404,6,2,"PCPE",2
50,"50180",120,97,96,0,1,"PCPE",0
50,"50255",214,163,163,0,0,"PCPE",0
50,"50297",499531,377882,375565,3049,2317,"PCPE",638
50,"50183",338,255,255,0,0,"PCPE",0
50,"50086",184,128,128,1,0,"PCPE",0
50,"50090",156,112,111,0,1,"PCPE",0
50,"50177",315,251,249,3,2,"PCPE",0
50,"50028",78,53,53,2,0,"PCPE",0
50,"50256",84,46,46,0,0,"PCPE",0
50,"50279",87,62,62,1,0,"PCPE",0
50,"50046",176,123,123,7,0,"PCPE",0
50,"50022",543,410,398,8,12,"PCPE",1
50,"50087",28,19,19,0,0,"PCPE",0
50,"50009",106,78,77,1,1,"PCPE",0
50,"50195",53,38,38,0,0,"PCPE",0
50,"50067",14055,10236,10109,123,127,"PCPE",9
50,"50077",226,175,174,5,1,"PCPE",0
50,"50099",3087,2233,2216,15,17,"PCPE",3
50,"50051",828,640,637,8,3,"PCPE",0
50,"50078",244,192,189,1,3,"PCPE",0
50,"50287",274,197,195,4,2,"PCPE",0
50,"50175",1025,745,739,6,6,"PCPE",0
50,"50154",119,92,91,0,1,"PCPE",0
50,"50010",69,57,57,0,0,"PCPE",0
50,"50257",178,139,137,0,2,"PCPE",0
50,"50058",72,51,51,0,0,"PCPE",0
50,"50089",8144,6285,6249,50,36,"PCPE",6
50,"50096",39,17,17,0,0,"PCPE",0
50,"50274",71,50,49,1,1,"PCPE",0
50,"50107",944,772,767,16,5,"PCPE",0
50,"50126",2388,1726,1708,22,18,"PCPE",2
50,"50206",466,379,376,2,3,"PCPE",0
50,"50216",236,189,186,4,3,"PCPE",0
50,"50196",108,83,82,1,1,"PCPE",0
50,"50017",1772,1301,1293,7,8,"PCPE",1
50,"50186",41,29,29,0,0,"PCPE",0
50,"50007",46,37,37,1,0,"PCPE",0
50,"50228",270,211,210,5,1,"PCPE",0
50,"50166",260,192,189,2,3,"PCPE",1
50,"50114",124,94,94,2,0,"PCPE",0
50,"50031",161,90,88,1,2,"PCPE",0
50,"50210",40,32,31,0,1,"PCPE",0
50,"50290",387,288,287,4,1,"PCPE",0
50,"50004",534,406,401,0,5,"PCPE",0
50,"50045",1255,944,934,6,10,"PCPE",1
50,"50167",232,194,193,0,1,"PCPE",1
50,"50071",131,90,90,0,0,"PCPE",0
50,"50040",92,75,75,0,0,"PCPE",0
50,"50149",36,23,23,0,0,"PCPE",0
50,"50239",64,47,47,1,0,"PCPE",0
50,"50221",33,20,20,0,0,"PCPE",0
50,"50093",94,73,73,1,0,"PCPE",0
50,"50029",627,469,468,4,1,"PCPE",0
50,"50298",5353,4051,4013,32,38,"PCPE",5
50,"50205",91,69,65,1,4,"PCPE",0
50,"50019",54,41,41,0,0,"PCPE",0
50,"50064",440,350,349,5,1,"PCPE",1
50,"50081",512,376,372,6,4,"PCPE",1
50,"50209",2560,1787,1774,12,13,"PCPE",2
50,"50059",780,572,567,6,5,"PCPE",0
50,"50230",1176,853,849,11,4,"PCPE",1
50,"50054",59,45,45,0,0,"PCPE",0
50,"50189",712,574,559,4,15,"PCPE",0
50,"50220",46,32,32,0,0,"PCPE",0
50,"50211",252,187,186,0,1,"PCPE",0
50,"50137",1025,793,786,6,7,"PCPE",0
50,"50121",276,227,225,4,2,"PCPE",0
50,"50080",32,25,25,0,0,"PCPE",0
50,"50241",593,426,418,1,8,"PCPE",0
50,"50261",215,159,159,1,0,"PCPE",0
50,"50115",3248,2277,2262,31,15,"PCPE",2
50,"50233",114,81,81,1,0,"PCPE",0
50,"50202",158,96,92,1,4,"PCPE",0
50,"50105",304,228,228,3,0,"PCPE",0
50,"50116",190,142,140,1,2,"PCPE",0
50,"50052",90,71,71,0,0,"PCPE",0
50,"50015",98,63,63,0,0,"PCPE",0
50,"50061",207,174,168,1,6,"PCPE",0
50,"50156",214,173,170,2,3,"PCPE",0
50,"50106",135,105,104,0,1,"PCPE",0
50,"50043",257,172,171,1,1,"PCPE",1
50,"50139",319,239,238,2,1,"PCPE",0
50,"50235",2323,1687,1675,7,12,"PCPE",4
50,"50037",139,92,91,1,1,"PCPE",0
50,"50142",30,21,21,0,0,"PCPE",0
50,"50294",73,58,58,0,0,"PCPE",0
50,"50188",30,23,19,0,4,"PCPE",0
50,"50219",4098,3010,2980,27,30,"PCPE",3
50,"50199",341,242,241,4,1,"PCPE",1
50,"50034",838,572,569,5,3,"PCPE",1
50,"50144",36,28,28,0,0,"PCPE",0
50,"50252",5178,3746,3711,36,35,"PCPE",4
50,"50289",52,39,39,1,0,"PCPE",0
50,"50070",60,29,29,1,0,"PCPE",0
50,"50270",38,24,24,2,0,"PCPE",0
50,"50012",108,86,83,1,3,"PCPE",0
50,"50002",148,105,102,0,3,"PCPE",0
50,"50271",256,187,184,4,3,"PCPE",0
50,"50153",941,737,734,7,3,"PCPE",0
50,"50134",128,88,88,5,0,"PCPE",0
50,"50055",3612,2533,2490,34,43,"PCPE",1
50,"50173",210,141,140,2,1,"PCPE",0
50,"50025",4547,3335,3295,45,40,"PCPE",3
50,"50276",129,108,107,0,1,"PCPE",1
50,"50060",176,138,136,0,2,"PCPE",0
50,"50176",228,158,157,0,1,"PCPE",0
50,"50026",442,358,353,6,5,"PCPE",1
50,"50198",56,30,30,0,0,"PCPE",0
50,"50146",190,137,137,5,0,"PCPE",0
50,"50122",68,54,54,2,0,"PCPE",0
50,"50240",1034,749,737,10,12,"PCPE",5
50,"50236",104,82,82,2,0,"PCPE",0
50,"50253",423,328,327,1,1,"PCPE",0
50,"50229",64,42,42,0,0,"PCPE",0
50,"50085",176,131,129,3,2,"PCPE",0
50,"50062",1810,1407,1389,12,18,"PCPE",0
50,"50258",56,34,34,1,0,"PCPE",0
50,"50184",113,82,82,0,0,"PCPE",0
50,"50178",302,197,196,9,1,"PCPE",0
50,"50132",755,573,564,7,9,"PCPE",0
50,"50091",48,32,32,1,0,"PCPE",0
50,"50277",55,43,43,1,0,"PCPE",0
50,"50217",455,334,334,1,0,"PCPE",0
50,"50157",301,211,207,2,4,"PCPE",1
50,"50033",75,65,65,0,0,"PCPE",0
50,"50280",340,260,258,0,2,"PCPE",2
50,"50057",1396,980,972,8,8,"PCPE",1
50,"50901",137,101,101,0,0,"PCPE",0
50,"50024",589,461,459,4,2,"PCPE",0
50,"50138",46,41,41,0,0,"PCPE",0
50,"50222",1647,1135,1118,8,17,"PCPE",0
50,"50208",1802,1349,1332,16,17,"PCPE",1
50,"50181",1003,750,737,9,13,"PCPE",2
50,"50159",670,511,501,5,10,"PCPE",1
50,"50088",305,234,229,11,5,"PCPE",0
33,"33047",1126,868,861,12,7,"PCPE",0
33,"33057",1593,1134,1123,17,11,"PCPE",1
33,"33068",1114,627,623,2,4,"PCPE",3
33,"33071",617,459,452,8,7,"PCPE",0
33,"33072",1601,1012,1002,4,10,"PCPE",1
33,"33020",13297,9527,9445,86,82,"PCPE",21
33,"33034",10693,6796,6725,72,71,"PCPE",17
33,"33036",11572,8208,8133,80,75,"PCPE",8
33,"33058",1821,1319,1305,10,14,"PCPE",6
33,"33052",730,517,512,1,5,"PCPE",1
33,"33048",156,99,99,2,0,"PCPE",0
33,"33046",508,375,365,4,10,"PCPE",0
33,"33024",227211,166618,165475,1240,1143,"PCPE",277
33,"33023",3315,2295,2267,35,28,"PCPE",3
33,"33035",11299,8048,7981,67,67,"PCPE",11
33,"33073",8631,5015,4948,47,67,"PCPE",3
33,"33011",11373,6279,6214,104,65,"PCPE",8
33,"33061",379,194,190,1,4,"PCPE",0
33,"33069",3513,2577,2554,15,23,"PCPE",1
33,"33051",7167,4810,4772,57,38,"PCPE",3
33,"33074",3523,2422,2390,36,32,"PCPE",1
33,"33003",665,386,384,7,2,"PCPE",1
33,"33078",147,98,98,0,0,"PCPE",0
33,"33008",1808,1268,1247,6,21,"PCPE",1
33,"33029",363,199,198,1,1,"PCPE",1
33,"33028",1289,685,682,9,3,"PCPE",0
33,"33066",43034,29901,29610,261,291,"PCPE",61
33,"33062",409,242,239,1,3,"PCPE",0
33,"33031",35453,23848,23595,242,253,"PCPE",169
33,"33027",849,544,543,8,1,"PCPE",1
33,"33018",2896,2068,2041,18,27,"PCPE",3
33,"33044",178724,130938,130010,1254,928,"PCPE",135
33,"33041",7270,5138,5093,53,45,"PCPE",5
33,"33033",9943,6851,6803,61,48,"PCPE",14
33,"33076",12270,8265,8203,89,62,"PCPE",10
33,"33022",906,604,599,3,5,"PCPE",19
33,"33053",1157,767,762,12,5,"PCPE",0
33,"33065",1109,743,735,16,8,"PCPE",1
33,"33002",10122,7056,6977,55,79,"PCPE",22
33,"33075",275,161,155,2,6,"PCPE",0
33,"33005",1479,945,932,12,13,"PCPE",6
33,"33042",4316,3143,3105,35,38,"PCPE",5
33,"33055",1511,1150,1129,9,21,"PCPE",4
33,"33025",9261,6116,6062,58,54,"PCPE",7
33,"33045",4503,3249,3216,26,33,"PCPE",2
33,"33070",3347,2473,2441,31,32,"PCPE",5
33,"33039",1672,1261,1257,14,4,"PCPE",1
33,"33016",19201,14177,14074,115,103,"PCPE",20
33,"33009",899,606,601,4,5,"PCPE",1
33,"33059",4702,3228,3185,42,43,"PCPE",8
33,"33017",3180,2196,2168,30,28,"PCPE",1
33,"33019",3094,2079,2054,15,25,"PCPE",5
33,"33015",1561,1042,1031,8,11,"PCPE",2
33,"33063",419,330,326,1,4,"PCPE",0
33,"33001",1622,867,852,16,15,"PCPE",0
33,"33032",11483,8036,7921,82,115,"PCPE",16
33,"33067",785,608,598,5,10,"PCPE",1
33,"33049",6388,4229,4182,48,47,"PCPE",8
33,"33012",5230,3595,3568,27,27,"PCPE",4
33,"33040",4564,3125,3091,28,34,"PCPE",4
33,"33038",2298,1690,1675,12,15,"PCPE",3
33,"33056",5015,3435,3405,32,30,"PCPE",1
33,"33043",682,465,460,2,5,"PCPE",1
33,"33013",456,336,331,6,5,"PCPE",1
33,"33026",8621,5600,5555,71,45,"PCPE",7
33,"33021",4576,3133,3090,33,43,"PCPE",5
33,"33030",899,689,687,10,2,"PCPE",1
33,"33006",1556,1043,1036,17,7,"PCPE",9
33,"33054",1688,1159,1146,8,13,"PCPE",3
33,"33060",14750,10307,10206,82,101,"PCPE",29
33,"33007",1524,991,980,10,11,"PCPE",1
33,"33077",1220,849,840,11,9,"PCPE",1
33,"33064",231,181,179,4,2,"PCPE",1
33,"33010",1828,1220,1215,16,5,"PCPE",2
33,"33037",34841,24271,24054,200,217,"PCPE",112
33,"33050",603,374,357,0,17,"PCPE",1
33,"33014",9101,6398,6352,46,46,"PCPE",24
33,"33004",67136,48699,48354,389,345,"PCPE",119
16,"16040",85,71,71,0,0,"IU-UPeC",0
16,"16901",707,520,513,3,7,"IU-UPeC",14
16,"16100",684,587,580,5,7,"IU-UPeC",5
16,"16050",251,195,194,1,1,"IU-UPeC",3
16,"16259",30,26,26,1,0,"IU-UPeC",0
16,"16242",325,281,278,1,3,"IU-UPeC",5
16,"16012",82,69,69,0,0,"IU-UPeC",2
16,"16088",114,92,92,0,0,"IU-UPeC",5
16,"16154",4904,3776,3730,47,46,"IU-UPeC",100
16,"16239",141,110,107,0,3,"IU-UPeC",2
16,"16204",272,207,207,1,0,"IU-UPeC",4
16,"16111",171,138,137,2,1,"IU-UPeC",12
16,"16001",75,60,60,0,0,"IU-UPeC",1
16,"16212",255,208,206,1,2,"IU-UPeC",2
16,"16006",119,96,94,1,2,"IU-UPeC",4
16,"16280",189,160,157,2,3,"IU-UPeC",1
16,"16266",373,279,273,1,6,"IU-UPeC",2
16,"16017",370,300,296,2,4,"IU-UPeC",11
16,"16231",48,38,38,0,0,"IU-UPeC",1
16,"16243",412,354,348,0,6,"IU-UPeC",18
16,"16121",259,205,205,3,0,"IU-UPeC",9
16,"16139",333,255,251,4,4,"IU-UPeC",5
16,"16197",65,37,37,0,0,"IU-UPeC",0
16,"16129",104,82,79,1,3,"IU-UPeC",0
16,"16279",213,146,143,0,3,"IU-UPeC",5
16,"16085",136,108,108,2,0,"IU-UPeC",1
16,"16192",50,30,29,0,1,"IU-UPeC",1
16,"16126",783,654,648,2,6,"IU-UPeC",26
16,"16234",30,19,19,1,0,"IU-UPeC",2
16,"16148",587,511,511,1,0,"IU-UPeC",1
16,"16024",130,100,98,0,2,"IU-UPeC",3
16,"16029",96,73,71,0,2,"IU-UPeC",3
16,"16218",189,155,154,1,1,"IU-UPeC",1
16,"16110",97,71,70,0,1,"IU-UPeC",0
16,"16248",872,711,696,11,15,"IU-UPeC",20
16,"16238",509,442,434,2,8,"IU-UPeC",3
16,"16176",39,28,28,0,0,"IU-UPeC",0
16,"16042",1192,1021,1005,6,16,"IU-UPeC",27
16,"16271",637,535,533,3,2,"IU-UPeC",15
16,"16003",127,111,109,0,2,"IU-UPeC",1
16,"16011",28,19,19,0,0,"IU-UPeC",0
16,"16045",221,166,164,1,2,"IU-UPeC",3
16,"16116",84,62,62,0,0,"IU-UPeC",0
16,"16198",1365,1067,1052,12,15,"IU-UPeC",19
16,"16170",698,524,517,1,7,"IU-UPeC",13
16,"16060",760,600,593,5,7,"IU-UPeC",17
16,"16909",706,537,534,3,3,"IU-UPeC",11
16,"16276",21,17,17,0,0,"IU-UPeC",0
16,"16052",548,420,420,1,0,"IU-UPeC",22
16,"16063",98,87,87,0,0,"IU-UPeC",0
16,"16133",4391,3539,3509,27,30,"IU-UPeC",371
16,"16253",357,279,279,1,0,"IU-UPeC",4
16,"16215",248,177,172,1,5,"IU-UPeC",2
16,"16202",783,573,566,3,7,"IU-UPeC",17
16,"16904",478,387,381,5,6,"IU-UPeC",7
16,"16065",406,323,319,3,4,"IU-UPeC",7
16,"16070",32,31,31,0,0,"IU-UPeC",1
16,"16199",31,24,24,0,0,"IU-UPeC",0
16,"16055",703,512,509,7,3,"IU-UPeC",20
16,"16056",465,333,322,0,11,"IU-UPeC",3
16,"16086",888,768,762,10,6,"IU-UPeC",9
16,"16190",5127,4088,4025,42,63,"IU-UPeC",59
16,"16224",84,68,67,1,1,"IU-UPeC",10
16,"16167",324,275,271,2,4,"IU-UPeC",6
16,"16132",34,26,26,0,0,"IU-UPeC",3
16,"16158",546,437,431,7,6,"IU-UPeC",18
16,"16185",44,35,33,0,2,"IU-UPeC",2
16,"16047",230,176,176,2,0,"IU-UPeC",4
16,"16143",16,12,12,2,0,"IU-UPeC",0
16,"16274",127,100,100,0,0,"IU-UPeC",0
16,"16078",41427,31365,31095,268,270,"IU-UPeC",1171
16,"16264",433,374,370,2,4,"IU-UPeC",1
16,"16165",63,51,50,1,1,"IU-UPeC",2
16,"16152",40,35,35,0,0,"IU-UPeC",1
16,"16124",1870,1536,1518,7,18,"IU-UPeC",104
16,"16071",20,20,20,0,0,"IU-UPeC",1
16,"16097",162,135,135,1,0,"IU-UPeC",6
16,"16013",31,28,28,0,0,"IU-UPeC",2
16,"16057",78,60,60,0,0,"IU-UPeC",1
16,"16186",465,394,387,2,7,"IU-UPeC",3
16,"16258",198,143,142,0,1,"IU-UPeC",1
16,"16247",71,52,51,0,1,"IU-UPeC",1
16,"16084",49,37,32,0,5,"IU-UPeC",1
16,"16237",113,89,87,0,2,"IU-UPeC",2
16,"16903",1081,824,816,6,8,"IU-UPeC",11
16,"16130",575,451,446,0,5,"IU-UPeC",3
16,"16149",153,130,129,0,1,"IU-UPeC",6
16,"16049",156,121,121,0,0,"IU-UPeC",0
16,"16023",468,344,343,3,1,"IU-UPeC",6
16,"16036",128,104,102,2,2,"IU-UPeC",4
16,"16102",1231,922,911,8,11,"IU-UPeC",17
16,"16172",350,270,270,2,0,"IU-UPeC",1
16,"16125",1676,1338,1326,9,12,"IU-UPeC",15
16,"16225",76,58,57,0,1,"IU-UPeC",2
16,"16073",188,158,158,0,0,"IU-UPeC",0
16,"16195",498,380,376,1,4,"IU-UPeC",1
16,"16082",305,224,224,0,0,"IU-UPeC",3
16,"16177",78,63,63,0,0,"IU-UPeC",0
16,"16081",49,38,37,0,1,"IU-UPeC",3
16,"16033",1729,1385,1365,7,20,"IU-UPeC",86
16,"16217",75,58,58,0,0,"IU-UPeC",0
16,"16254",216,181,179,5,2,"IU-UPeC",1
16,"16008",95,72,72,0,0,"IU-UPeC",5
16,"16277",118,86,84,0,2,"IU-UPeC",0
16,"16092",161,130,129,1,1,"IU-UPeC",1
16,"16150",94,67,67,1,0,"IU-UPeC",3
16,"16118",1405,1147,1136,11,11,"IU-UPeC",32
16,"16128",63,54,54,2,0,"IU-UPeC",0
16,"16188",90,63,62,0,1,"IU-UPeC",2
16,"16062",24,21,21,0,0,"IU-UPeC",0
16,"16240",108,79,79,0,0,"IU-UPeC",3
16,"16196",633,538,527,2,11,"IU-UPeC",14
16,"16016",234,173,172,2,1,"IU-UPeC",1
16,"16004",274,212,206,0,6,"IU-UPeC",3
16,"16083",55,28,28,0,0,"IU-UPeC",0
16,"16160",61,46,45,1,1,"IU-UPeC",0
16,"16278",73,55,55,0,0,"IU-UPeC",0
16,"16058",105,81,80,0,1,"IU-UPeC",1
16,"16175",5113,4203,4124,35,79,"IU-UPeC",43
16,"16156",101,76,75,0,1,"IU-UPeC",0
16,"16251",1858,1450,1420,8,30,"IU-UPeC",15
16,"16067",127,92,91,3,1,"IU-UPeC",1
16,"16171",1818,1514,1498,5,16,"IU-UPeC",15
16,"16908",197,154,154,1,0,"IU-UPeC",7
16,"16275",11,11,11,1,0,"IU-UPeC",0
16,"16153",955,797,780,5,17,"IU-UPeC",19
16,"16157",213,185,182,0,3,"IU-UPeC",2
16,"16032",287,230,230,1,0,"IU-UPeC",6
16,"16145",464,389,387,2,2,"IU-UPeC",10
16,"16265",21,16,16,0,0,"IU-UPeC",0
16,"16010",154,114,110,1,4,"IU-UPeC",0
16,"16211",377,253,250,3,3,"IU-UPeC",8
16,"16068",145,117,114,2,3,"IU-UPeC",1
16,"16038",38,28,28,0,0,"IU-UPeC",1
16,"16122",254,200,198,4,2,"IU-UPeC",4
16,"16064",681,588,581,1,7,"IU-UPeC",5
16,"16002",192,172,172,0,0,"IU-UPeC",1
16,"16015",376,286,285,7,1,"IU-UPeC",2
16,"16112",1505,1088,1072,9,16,"IU-UPeC",29
16,"16902",141,105,105,1,0,"IU-UPeC",2
16,"16191",926,760,752,6,8,"IU-UPeC",12
16,"16051",147,118,118,0,0,"IU-UPeC",0
16,"16019",217,168,166,1,2,"IU-UPeC",0
16,"16103",265,217,217,0,0,"IU-UPeC",4
16,"16236",914,694,689,6,5,"IU-UPeC",14
16,"16174",192,155,155,1,0,"IU-UPeC",4
16,"16104",54,40,40,0,0,"IU-UPeC",0
16,"16147",62,43,43,0,0,"IU-UPeC",2
16,"16245",418,338,333,2,5,"IU-UPeC",13
16,"16255",141,119,119,0,0,"IU-UPeC",0
16,"16246",484,382,375,1,7,"IU-UPeC",4
16,"16096",273,249,244,2,5,"IU-UPeC",3
16,"16219",91,72,72,0,0,"IU-UPeC",3
16,"16109",43,32,32,0,0,"IU-UPeC",1
16,"16101",160,130,129,0,1,"IU-UPeC",1
16,"16250",76,57,57,0,0,"IU-UPeC",1
16,"16203",9960,7515,7418,43,97,"IU-UPeC",217
16,"16022",78,63,61,0,2,"IU-UPeC",0
16,"16005",256,191,187,1,4,"IU-UPeC",8
16,"16193",70,57,57,1,0,"IU-UPeC",1
16,"16270",167,141,141,0,0,"IU-UPeC",2
16,"16072",147,103,102,0,1,"IU-UPeC",2
16,"16031",46,30,30,2,0,"IU-UPeC",0
16,"16117",1057,814,808,2,6,"IU-UPeC",20
16,"16026",85,56,53,0,3,"IU-UPeC",2
16,"16162",43,35,35,0,0,"IU-UPeC",0
16,"16053",429,352,348,5,4,"IU-UPeC",13
16,"16161",58,53,53,0,0,"IU-UPeC",1
16,"16134",4369,3412,3369,23,43,"IU-UPeC",231
16,"16166",247,182,177,0,5,"IU-UPeC",1
16,"16141",145,113,112,1,1,"IU-UPeC",6
16,"16098",571,468,461,5,7,"IU-UPeC",26
16,"16014",613,493,487,1,6,"IU-UPeC",22
16,"16089",379,299,299,4,0,"IU-UPeC",5
16,"16094",132,101,99,1,2,"IU-UPeC",3
16,"16272",228,167,167,1,0,"IU-UPeC",6
16,"16181",64,53,53,0,0,"IU-UPeC",0
16,"16046",250,181,180,1,1,"IU-UPeC",0
16,"16025",25,21,21,1,0,"IU-UPeC",0
16,"16905",1217,965,956,9,9,"IU-UPeC",49
16,"16146",87,62,62,1,0,"IU-UPeC",1
16,"16074",40,31,31,0,0,"IU-UPeC",0
16,"16043",99,73,73,1,0,"IU-UPeC",3
16,"16273",324,252,252,2,0,"IU-UPeC",2
16,"16187",77,52,52,1,0,"IU-UPeC",2
16,"16227",112,84,84,0,0,"IU-UPeC",4
16,"16159",225,170,168,0,2,"IU-UPeC",2
16,"16213",35,28,28,1,0,"IU-UPeC",1
16,"16113",3080,2309,2278,15,31,"IU-UPeC",64
16,"16131",134,97,97,1,0,"IU-UPeC",2
16,"16123",82,54,53,0,1,"IU-UPeC",1
16,"16194",259,208,200,0,8,"IU-UPeC",10
16,"16142",139,110,109,2,1,"IU-UPeC",5
16,"16119",169,121,120,0,1,"IU-UPeC",3
16,"16066",2333,1917,1872,24,45,"IU-UPeC",36
16,"16209",118,100,100,1,0,"IU-UPeC",3
16,"16093",64,52,52,0,0,"IU-UPeC",0
16,"16041",354,284,282,0,2,"IU-UPeC",6
16,"16048",412,312,310,1,2,"IU-UPeC",6
16,"16189",256,192,191,2,1,"IU-UPeC",1
16,"16906",82,67,67,1,0,"IU-UPeC",1
16,"16007",1192,964,959,8,5,"IU-UPeC",5
16,"16020",17,11,11,0,0,"IU-UPeC",0
16,"16108",49,43,42,0,1,"IU-UPeC",4
16,"16206",208,163,162,4,1,"IU-UPeC",1
16,"16034",183,153,153,1,0,"IU-UPeC",3
16,"16027",709,567,562,4,5,"IU-UPeC",20
16,"16018",401,328,328,1,0,"IU-UPeC",1
16,"16140",27,15,15,0,0,"IU-UPeC",0
16,"16107",120,87,87,1,0,"IU-UPeC",5
16,"16163",74,63,63,0,0,"IU-UPeC",2
16,"16216",317,275,267,0,8,"IU-UPeC",0
16,"16910",96,70,70,0,0,"IU-UPeC",4
16,"16173",207,155,154,1,1,"IU-UPeC",1
16,"16091",68,51,49,0,2,"IU-UPeC",1
16,"16030",25,22,22,1,0,"IU-UPeC",0
16,"16087",212,186,186,5,0,"IU-UPeC",2
16,"16115",44,33,33,0,0,"IU-UPeC",1
16,"16228",177,132,131,1,1,"IU-UPeC",0
16,"16263",961,754,745,4,9,"IU-UPeC",17
16,"16205",114,89,88,0,1,"IU-UPeC",1
16,"16135",139,109,108,0,1,"IU-UPeC",7
16,"16269",426,351,349,3,2,"IU-UPeC",2
16,"16044",39,28,27,0,1,"IU-UPeC",0
16,"16151",64,60,60,0,0,"IU-UPeC",0
16,"16009",66,48,48,0,0,"IU-UPeC",0
16,"16079",32,21,20,0,1,"IU-UPeC",0
16,"16035",258,192,192,3,0,"IU-UPeC",4
16,"16169",58,33,32,0,1,"IU-UPeC",1
16,"16106",2729,2130,2095,19,35,"IU-UPeC",17
16,"16099",208,157,152,0,5,"IU-UPeC",5
16,"16061",964,798,790,13,8,"IU-UPeC",18
16,"16244",722,625,617,2,8,"IU-UPeC",1
16,"16137",56,34,33,0,1,"IU-UPeC",0
16,"16155",506,415,414,2,1,"IU-UPeC",4
16,"16249",1986,1593,1570,8,23,"IU-UPeC",15
16,"16039",398,275,271,1,4,"IU-UPeC",3
16,"16095",84,71,68,0,3,"IU-UPeC",5
17,"17006",1131,730,728,9,2,"PCPC",1
17,"17132",1311,923,913,10,10,"PCPC",4
17,"17135",355,263,258,2,5,"PCPC",1
17,"17141",5869,3688,3653,38,35,"PCPC",4
17,"17050",649,499,495,3,4,"PCPC",0
17,"17111",873,643,641,12,2,"PCPC",0
17,"17041",215,146,145,2,1,"PCPC",0
17,"17195",338,256,251,2,5,"PCPC",0
17,"17058",180,132,131,1,1,"PCPC",0
17,"17183",274,186,186,3,0,"PCPC",1
17,"17112",192,141,139,1,2,"PCPC",0
17,"17137",3411,2391,2369,15,22,"PCPC",5
17,"17125",129,88,86,0,2,"PCPC",1
17,"17177",563,359,354,3,5,"PCPC",0
17,"17026",536,381,380,6,1,"PCPC",1
17,"17075",334,234,227,5,7,"PCPC",0
17,"17223",807,528,520,6,8,"PCPC",1
17,"17009",4042,2770,2738,18,32,"PCPC",1
17,"17225",213,142,142,1,0,"PCPC",0
17,"17005",401,263,260,5,3,"PCPC",1
17,"17164",3996,2555,2543,23,12,"PCPC",2
17,"17091",411,282,273,5,9,"PCPC",0
17,"17215",2066,1588,1577,12,11,"PCPC",3
17,"17115",277,195,195,0,0,"PCPC",0
17,"17170",172,118,117,2,1,"PCPC",0
17,"17071",1131,810,803,8,7,"PCPC",3
17,"17116",348,243,240,4,3,"PCPC",0
17,"17121",221,157,156,1,1,"PCPC",0
17,"17090",542,410,408,3,2,"PCPC",3
17,"17151",174,124,123,3,1,"PCPC",0
17,"17128",302,224,223,4,1,"PCPC",1
17,"17028",303,213,213,4,0,"PCPC",0
17,"17146",2979,2030,2009,14,21,"PCPC",4
17,"17191",146,114,113,1,1,"PCPC",0
17,"17114",23020,15151,15024,105,127,"PCPC",41
17,"17226",856,572,557,5,15,"PCPC",2
17,"17145",1488,1003,986,9,17,"PCPC",1
17,"17056",1706,1200,1193,10,7,"PCPC",0
17,"17077",555,386,383,5,3,"PCPC",2
17,"17092",3508,2373,2347,13,26,"PCPC",2
17,"17073",1875,1466,1460,11,6,"PCPC",2
17,"17220",811,563,555,3,8,"PCPC",1
17,"17002",556,429,419,1,10,"PCPC",2
17,"17083",2935,2059,2042,17,17,"PCPC",3
17,"17134",234,163,161,2,2,"PCPC",0
17,"17136",175,133,132,1,1,"PCPC",0
17,"17232",149,98,98,1,0,"PCPC",0
17,"17120",792,530,518,3,12,"PCPC",2
17,"17227",128,95,95,0,0,"PCPC",0
17,"17100",199,142,140,7,2,"PCPC",0
17,"17233",2287,1682,1664,21,18,"PCPC",1
17,"17078",330,225,225,5,0,"PCPC",1
17,"17159",627,439,434,2,5,"PCPC",3
17,"17193",4216,2807,2768,26,39,"PCPC",5
17,"17044",6767,4737,4694,36,43,"PCPC",5
17,"17189",1524,1126,1114,4,12,"PCPC",0
17,"17123",357,275,273,3,2,"PCPC",0
17,"17903",897,647,638,0,9,"PCPC",1
17,"17209",625,480,477,2,3,"PCPC",0
17,"17027",2826,1993,1973,10,20,"PCPC",8
17,"17109",693,443,435,2,8,"PCPC",2
17,"17171",163,123,122,0,1,"PCPC",0
17,"17079",64159,44230,43902,271,328,"PCPC",75
17,"17060",424,277,274,3,3,"PCPC",0
17,"17087",222,169,169,3,0,"PCPC",1
17,"17213",5372,3549,3517,17,32,"PCPC",6
17,"17012",1142,763,757,6,6,"PCPC",0
17,"17016",724,519,515,8,4,"PCPC",1
17,"17144",210,141,141,2,0,"PCPC",0
17,"17129",137,99,99,1,0,"PCPC",0
17,"17032",1713,1036,1020,13,16,"PCPC",2
17,"17015",12525,8550,8470,59,80,"PCPC",10
17,"17234",183,124,124,1,0,"PCPC",1
17,"17187",621,468,464,6,4,"PCPC",0
17,"17138",944,668,663,4,5,"PCPC",4
17,"17052",124,83,83,1,0,"PCPC",0
17,"17157",126,104,102,1,2,"PCPC",0
17,"17061",162,119,119,1,0,"PCPC",0
17,"17158",464,284,281,0,3,"PCPC",0
17,"17025",1124,834,827,3,7,"PCPC",1
17,"17149",363,267,264,0,3,"PCPC",0
17,"17029",203,131,131,2,0,"PCPC",0
17,"17207",2373,1691,1673,18,18,"PCPC",4
17,"17014",61,47,47,1,0,"PCPC",0
17,"17152",10727,6804,6758,46,46,"PCPC",9
17,"17173",180,141,139,2,2,"PCPC",0
17,"17049",3125,2251,2233,7,18,"PCPC",3
17,"17153",186,140,140,0,0,"PCPC",0
17,"17081",244,165,163,0,2,"PCPC",1
17,"17166",516,386,378,2,8,"PCPC",0
17,"17147",8112,5475,5422,43,53,"PCPC",4
17,"17046",719,499,492,2,7,"PCPC",0
17,"17019",1779,1279,1261,13,18,"PCPC",2
17,"17034",6874,4509,4477,32,32,"PCPC",2
17,"17154",92,62,62,0,0,"PCPC",0
17,"17063",166,115,113,0,2,"PCPC",0
17,"17054",375,249,249,2,0,"PCPC",0
17,"17163",2609,1904,1890,18,14,"PCPC",2
17,"17031",172,109,109,3,0,"PCPC",0
17,"17186",3771,2742,2712,18,30,"PCPC",14
17,"17133",1268,887,877,6,10,"PCPC",1
17,"17224",314,214,213,3,1,"PCPC",0
17,"17216",165,112,110,0,2,"PCPC",0
17,"17020",3590,2531,2510,28,21,"PCPC",4
17,"17055",152,125,125,0,0,"PCPC",0
17,"17205",212,166,166,2,0,"PCPC",0
17,"17190",842,592,590,10,2,"PCPC",2
17,"17106",139,108,106,0,2,"PCPC",0
17,"17098",311,224,221,2,3,"PCPC",0
17,"17160",14740,9853,9795,68,58,"PCPC",18
17,"17008",3636,2423,2395,15,28,"PCPC",1
17,"17043",158,119,117,1,2,"PCPC",0
17,"17074",507,345,341,1,4,"PCPC",1
17,"17126",308,252,250,2,2,"PCPC",0
17,"17175",579,366,360,4,6,"PCPC",0
17,"17188",165,126,126,0,0,"PCPC",1
17,"17102",576,397,395,4,2,"PCPC",0
17,"17217",348,268,266,0,2,"PCPC",0
17,"17080",141,98,98,0,0,"PCPC",0
17,"17018",477,347,343,3,4,"PCPC",2
17,"17176",122,91,91,2,0,"PCPC",0
17,"17161",990,737,734,7,3,"PCPC",0
17,"17057",960,708,699,8,9,"PCPC",1
17,"17069",378,270,267,4,3,"PCPC",0
17,"17003",102,71,71,0,0,"PCPC",0
17,"17212",139,108,106,1,2,"PCPC",0
17,"17082",410,273,268,3,5,"PCPC",1
17,"17088",535,372,369,0,3,"PCPC",1
17,"17148",1535,1056,1045,12,11,"PCPC",3
17,"17062",5970,3695,3657,31,38,"PCPC",7
17,"17902",1353,957,947,9,10,"PCPC",1
17,"17030",645,430,428,7,2,"PCPC",0
17,"17150",1407,1074,1060,12,14,"PCPC",3
17,"17182",262,191,191,2,0,"PCPC",0
17,"17070",109,82,82,1,0,"PCPC",0
17,"17093",893,590,585,6,5,"PCPC",0
17,"17197",137,105,105,2,0,"PCPC",0
17,"17143",146,109,107,1,2,"PCPC",1
17,"17064",325,219,214,1,5,"PCPC",0
17,"17218",588,448,445,3,3,"PCPC",0
17,"17194",78,54,52,2,2,"PCPC",0
17,"17095",19593,12648,12554,81,94,"PCPC",30
17,"17011",646,463,462,7,1,"PCPC",0
17,"17001",585,417,413,2,4,"PCPC",3
17,"17035",544,400,399,4,1,"PCPC",0
17,"17198",430,282,281,4,1,"PCPC",0
17,"17155",14500,9167,9080,43,87,"PCPC",17
17,"17119",68,59,59,0,0,"PCPC",0
17,"17221",4182,2882,2859,18,23,"PCPC",3
17,"17076",123,90,88,2,2,"PCPC",0
17,"17051",219,157,155,3,2,"PCPC",0
17,"17085",293,223,221,1,2,"PCPC",0
17,"17110",1325,953,945,5,8,"PCPC",1
17,"17139",1382,972,963,9,9,"PCPC",2
17,"17038",369,255,253,2,2,"PCPC",2
17,"17168",374,273,272,1,1,"PCPC",0
17,"17107",268,189,188,2,1,"PCPC",2
17,"17040",538,392,391,4,1,"PCPC",1
17,"17214",706,471,468,4,3,"PCPC",0
17,"17181",3380,2272,2251,15,21,"PCPC",3
17,"17169",2475,1733,1724,11,9,"PCPC",4
17,"17165",653,445,443,2,2,"PCPC",0
17,"17084",236,160,160,7,0,"PCPC",0
17,"17013",2787,1941,1926,17,15,"PCPC",4
17,"17204",562,385,384,7,1,"PCPC",0
17,"17103",4942,3150,3129,19,21,"PCPC",3
17,"17004",510,371,368,0,3,"PCPC",0
17,"17022",6926,4626,4587,47,39,"PCPC",3
17,"17023",27347,18842,18610,118,232,"PCPC",69
17,"17174",176,102,102,3,0,"PCPC",0
17,"17185",2293,1547,1527,12,20,"PCPC",3
17,"17037",104,65,65,0,0,"PCPC",0
17,"17118",12824,8557,8477,57,80,"PCPC",14
17,"17162",147,91,90,0,1,"PCPC",0
17,"17097",199,149,148,5,1,"PCPC",0
17,"17196",214,151,151,2,0,"PCPC",0
17,"17105",255,170,170,2,0,"PCPC",1
17,"17039",1764,1229,1217,20,12,"PCPC",5
17,"17140",674,498,495,5,3,"PCPC",0
17,"17192",145,108,108,1,0,"PCPC",0
17,"17067",697,500,495,7,5,"PCPC",1
17,"17228",295,211,210,1,1,"PCPC",0
17,"17068",245,173,172,0,1,"PCPC",0
17,"17208",997,679,671,12,8,"PCPC",1
17,"17047",4837,2997,2973,39,24,"PCPC",6
17,"17124",1638,1096,1083,10,13,"PCPC",3
17,"17065",335,250,249,2,1,"PCPC",0
17,"17024",279,176,176,2,0,"PCPC",0
17,"17201",128,93,92,1,1,"PCPC",0
17,"17172",452,308,307,1,1,"PCPC",0
17,"17033",5293,3509,3476,28,33,"PCPC",11
17,"17086",1744,1181,1170,10,11,"PCPC",1
17,"17203",154,110,110,0,0,"PCPC",0
17,"17222",109,85,85,1,0,"PCPC",0
17,"17230",463,343,339,2,4,"PCPC",0
17,"17096",178,115,114,0,1,"PCPC",0
17,"17184",1258,893,887,6,6,"PCPC",0
17,"17199",6845,4527,4483,32,44,"PCPC",6
17,"17178",1063,690,685,5,5,"PCPC",1
17,"17210",551,378,376,2,2,"PCPC",0
17,"17099",80,60,59,0,1,"PCPC",0
17,"17036",2736,1857,1839,16,18,"PCPC",6
17,"17010",330,247,246,5,1,"PCPC",1
17,"17042",414,288,286,2,2,"PCPC",0
17,"17007",1730,1235,1224,4,11,"PCPC",2
17,"17089",5490,3630,3591,20,39,"PCPC",2
17,"17901",989,696,686,7,10,"PCPC",0
17,"17066",26551,16275,16166,140,109,"PCPC",23
17,"17094",1049,646,641,3,5,"PCPC",0
17,"17117",14280,9297,9223,75,74,"PCPC",16
17,"17200",618,425,422,4,3,"PCPC",3
17,"17142",2561,1962,1950,13,12,"PCPC",2
17,"17048",6269,4072,4044,24,28,"PCPC",6
17,"17180",8300,5429,5368,42,61,"PCPC",11
17,"17130",328,246,245,2,1,"PCPC",1
17,"17167",2697,1876,1852,24,24,"PCPC",1
17,"17211",839,646,639,3,7,"PCPC",1
17,"17206",141,89,87,0,2,"PCPC",2
17,"17101",543,364,362,3,2,"PCPC",1
17,"17202",3803,2471,2449,13,22,"PCPC",6
17,"17021",135,86,86,2,0,"PCPC",0
42,"42001",279,219,215,2,4,"PODEMOS",27
42,"42194",176,127,126,2,1,"PODEMOS",7
42,"42083",25,23,21,0,2,"PODEMOS",2
42,"42115",63,46,46,0,0,"PODEMOS",9
42,"42209",146,111,108,3,3,"PODEMOS",16
42,"42129",692,522,516,4,6,"PODEMOS",66
42,"42176",29,23,23,0,0,"PODEMOS",2
42,"42068",85,62,61,2,1,"PODEMOS",2
42,"42219",43,32,32,0,0,"PODEMOS",9
42,"42119",164,97,97,2,0,"PODEMOS",7
42,"42130",60,51,50,3,1,"PODEMOS",4
42,"42041",35,25,25,0,0,"PODEMOS",1
42,"42206",8,5,5,0,0,"PODEMOS",0
42,"42177",71,55,54,1,1,"PODEMOS",1
42,"42084",26,21,21,0,0,"PODEMOS",0
42,"42192",41,31,31,1,0,"PODEMOS",5
42,"42055",165,127,127,3,0,"PODEMOS",15
42,"42003",66,59,57,1,2,"PODEMOS",3
42,"42151",35,31,29,2,2,"PODEMOS",0
42,"42097",21,14,14,0,0,"PODEMOS",5
42,"42042",47,38,38,2,0,"PODEMOS",3
42,"42207",41,33,33,1,0,"PODEMOS",6
42,"42029",143,106,106,0,0,"PODEMOS",7
42,"42139",22,16,16,0,0,"PODEMOS",1
42,"42017",142,115,114,1,1,"PODEMOS",29
42,"42131",50,32,32,0,0,"PODEMOS",1
42,"42056",22,19,19,0,0,"PODEMOS",1
42,"42004",2296,1767,1748,32,19,"PODEMOS",152
42,"42098",11,6,6,0,0,"PODEMOS",0
42,"42043",3796,2833,2792,26,41,"PODEMOS",366
42,"42006",164,121,118,8,3,"PODEMOS",23
42,"42178",117,81,79,2,2,"PODEMOS",7
42,"42018",152,116,114,0,2,"PODEMOS",6
42,"42185",25,21,21,0,0,"PODEMOS",1
42,"42086",38,29,29,1,0,"PODEMOS",1
42,"42152",82,59,59,1,0,"PODEMOS",1
42,"42132",143,118,117,0,1,"PODEMOS",11
42,"42153",14,14,14,1,0,"PODEMOS",0
42,"42053",26,21,21,1,0,"PODEMOS",0
42,"42019",516,367,363,4,4,"PODEMOS",61
42,"42134",2642,1961,1938,24,23,"PODEMOS",319
42,"42157",13,10,10,1,0,"PODEMOS",0
42,"42141",111,79,79,0,0,"PODEMOS",5
42,"42087",45,38,37,0,1,"PODEMOS",6
42,"42200",84,60,60,2,0,"PODEMOS",3
42,"42044",53,49,47,3,2,"PODEMOS",3
42,"42011",17,10,10,0,0,"PODEMOS",0
42,"42195",100,60,60,3,0,"PODEMOS",5
42,"42007",117,86,86,2,0,"PODEMOS",9
42,"42096",281,181,178,8,3,"PODEMOS",26
42,"42135",75,53,53,1,0,"PODEMOS",10
42,"42182",57,45,45,1,0,"PODEMOS",2
42,"42154",97,78,78,1,0,"PODEMOS",8
42,"42088",71,53,53,0,0,"PODEMOS",3
42,"42008",57,38,38,0,0,"PODEMOS",3
42,"42142",52,33,33,0,0,"PODEMOS",2
42,"42046",51,43,43,1,0,"PODEMOS",17
42,"42032",148,117,117,0,0,"PODEMOS",6
42,"42173",29201,21456,21181,272,275,"PODEMOS",4247
42,"42183",111,79,78,2,1,"PODEMOS",7
42,"42125",81,66,66,2,0,"PODEMOS",3
42,"42106",15,9,9,0,0,"PODEMOS",0
42,"42089",55,46,46,1,0,"PODEMOS",6
42,"42188",50,44,43,0,1,"PODEMOS",7
42,"42167",259,195,194,2,1,"PODEMOS",28
42,"42202",24,12,11,0,1,"PODEMOS",1
42,"42025",1216,884,873,11,11,"PODEMOS",113
42,"42076",219,176,173,4,3,"PODEMOS",34
42,"42021",85,53,53,1,0,"PODEMOS",4
42,"42009",80,65,64,2,1,"PODEMOS",6
42,"42048",67,53,51,1,2,"PODEMOS",6
42,"42010",18,14,14,0,0,"PODEMOS",3
42,"42140",16,10,10,1,0,"PODEMOS",0
42,"42085",191,136,136,2,0,"PODEMOS",5
42,"42060",34,23,21,0,2,"PODEMOS",0
42,"42213",29,18,18,1,0,"PODEMOS",1
42,"42061",292,221,219,2,2,"PODEMOS",50
42,"42198",22,17,17,0,0,"PODEMOS",1
42,"42208",21,14,14,2,0,"PODEMOS",0
42,"42107",74,51,48,1,3,"PODEMOS",6
42,"42023",66,53,53,0,0,"PODEMOS",5
42,"42190",94,71,71,1,0,"PODEMOS",9
42,"42039",233,148,146,2,2,"PODEMOS",24
42,"42015",32,25,25,0,0,"PODEMOS",0
42,"42057",175,106,104,1,2,"PODEMOS",12
42,"42049",120,75,73,1,2,"PODEMOS",4
42,"42165",408,289,282,7,7,"PODEMOS",33
42,"42158",110,78,78,1,0,"PODEMOS",16
42,"42172",29,25,25,2,0,"PODEMOS",0
42,"42187",63,55,54,1,1,"PODEMOS",1
42,"42092",65,42,41,1,1,"PODEMOS",1
42,"42058",112,97,92,1,5,"PODEMOS",1
42,"42201",23,23,22,0,1,"PODEMOS",1
42,"42050",31,18,18,0,0,"PODEMOS",0
42,"42054",20,14,14,0,0,"PODEMOS",4
42,"42016",18,13,13,0,0,"PODEMOS",3
42,"42051",21,15,15,0,0,"PODEMOS",0
42,"42110",63,46,46,0,0,"PODEMOS",6
42,"42149",393,300,293,1,7,"PODEMOS",53
42,"42012",37,29,29,0,0,"PODEMOS",8
42,"42155",173,105,104,1,1,"PODEMOS",9
42,"42063",49,37,37,1,0,"PODEMOS",1
42,"42144",442,357,352,5,5,"PODEMOS",67
42,"42121",64,48,48,1,0,"PODEMOS",6
42,"42059",20,14,14,0,0,"PODEMOS",0
42,"42070",35,27,25,0,2,"PODEMOS",4
42,"42193",16,11,11,0,0,"PODEMOS",0
42,"42013",35,28,28,0,0,"PODEMOS",6
42,"42127",40,27,27,1,0,"PODEMOS",1
42,"42094",608,470,463,9,7,"PODEMOS",97
42,"42189",64,50,50,2,0,"PODEMOS",5
42,"42156",30,21,21,0,0,"PODEMOS",0
42,"42145",137,121,121,3,0,"PODEMOS",10
42,"42123",165,119,119,4,0,"PODEMOS",12
42,"42160",261,205,203,1,2,"PODEMOS",47
42,"42052",15,13,13,0,0,"PODEMOS",0
42,"42026",24,20,20,0,0,"PODEMOS",2
42,"42161",140,106,106,2,0,"PODEMOS",12
42,"42218",80,54,54,1,0,"PODEMOS",13
42,"42014",66,43,43,2,0,"PODEMOS",6
42,"42148",10,10,10,0,0,"PODEMOS",0
42,"42027",76,56,56,0,0,"PODEMOS",10
42,"42120",148,98,98,1,0,"PODEMOS",16
42,"42095",1762,1319,1303,15,16,"PODEMOS",271
42,"42028",70,49,49,0,0,"PODEMOS",17
42,"42215",786,555,552,8,3,"PODEMOS",41
42,"42108",12,10,10,0,0,"PODEMOS",0
42,"42191",187,135,132,2,3,"PODEMOS",14
42,"42079",27,17,17,1,0,"PODEMOS",0
42,"42212",69,54,54,3,0,"PODEMOS",8
42,"42045",312,218,214,1,4,"PODEMOS",22
42,"42100",32,31,31,1,0,"PODEMOS",2
42,"42020",4288,3087,3044,42,43,"PODEMOS",457
42,"42211",83,67,67,1,0,"PODEMOS",9
42,"42196",11,10,10,0,0,"PODEMOS",1
42,"42081",143,111,106,2,5,"PODEMOS",7
42,"42163",49,37,37,0,0,"PODEMOS",8
42,"42164",1614,1208,1190,9,18,"PODEMOS",171
42,"42093",40,29,29,3,0,"PODEMOS",2
42,"42116",47,33,33,0,0,"PODEMOS",4
42,"42159",38,33,32,1,1,"PODEMOS",2
42,"42069",1529,1078,1066,10,12,"PODEMOS",269
42,"42030",95,77,76,3,1,"PODEMOS",4
42,"42217",31,25,25,0,0,"PODEMOS",3
42,"42205",93,64,63,0,1,"PODEMOS",4
42,"42075",87,63,63,1,0,"PODEMOS",8
42,"42175",23,18,18,0,0,"PODEMOS",1
42,"42037",34,17,17,1,0,"PODEMOS",0
42,"42105",49,42,42,0,0,"PODEMOS",1
42,"42117",148,113,111,3,2,"PODEMOS",23
42,"42024",87,68,67,0,1,"PODEMOS",6
42,"42174",180,149,148,1,1,"PODEMOS",36
42,"42034",31,22,22,0,0,"PODEMOS",4
42,"42197",76,61,59,1,2,"PODEMOS",4
42,"42022",214,171,171,2,0,"PODEMOS",9
42,"42162",2363,1690,1672,21,18,"PODEMOS",125
42,"42118",23,16,16,0,0,"PODEMOS",1
42,"42128",39,37,37,1,0,"PODEMOS",3
42,"42038",36,27,27,2,0,"PODEMOS",2
42,"42073",72,56,56,0,0,"PODEMOS",5
42,"42071",169,111,109,2,2,"PODEMOS",15
42,"42171",128,78,78,1,0,"PODEMOS",2
42,"42103",583,467,459,5,8,"PODEMOS",34
42,"42064",85,74,74,0,0,"PODEMOS",8
42,"42080",155,113,110,0,3,"PODEMOS",10
42,"42031",26,19,19,0,0,"PODEMOS",2
42,"42168",109,88,88,1,0,"PODEMOS",14
42,"42062",25,16,15,0,1,"PODEMOS",4
42,"42216",25,21,21,0,0,"PODEMOS",3
42,"42078",1031,752,744,6,8,"PODEMOS",104
42,"42184",59,45,44,2,1,"PODEMOS",1
42,"42124",64,44,44,0,0,"PODEMOS",2
42,"42033",50,43,43,0,0,"PODEMOS",3
42,"42036",50,39,38,0,1,"PODEMOS",9
42,"42166",60,40,40,0,0,"PODEMOS",2
42,"42065",22,20,19,0,1,"PODEMOS",4
42,"42082",9,8,8,1,0,"PODEMOS",2
42,"42111",307,221,220,1,1,"PODEMOS",30
42,"42035",782,566,562,4,4,"PODEMOS",63
42,"42204",56,39,38,0,1,"PODEMOS",8
42,"42090",93,70,69,1,1,"PODEMOS",5
42,"42113",512,390,386,3,4,"PODEMOS",37
42,"42181",419,318,312,3,6,"PODEMOS",43
5,"5024",231,169,163,5,6,"FE de las J",0
5,"5208",40,34,34,0,0,"FE de las J",0
5,"5215",169,126,122,2,4,"FE de las J",0
5,"5021",1932,1478,1456,12,22,"FE de las J",6
5,"5084",74,56,56,1,0,"FE de las J",0
5,"5903",157,108,107,0,1,"FE de las J",0
5,"5118",84,57,57,0,0,"FE de las J",0
5,"5142",104,88,82,1,6,"FE de las J",0
5,"5123",96,69,66,2,3,"FE de las J",0
5,"5219",39,28,28,0,0,"FE de las J",0
5,"5105",349,279,270,3,9,"FE de las J",0
5,"5051",181,152,147,3,5,"FE de las J",0
5,"5053",86,58,58,0,0,"FE de las J",0
5,"5044",259,180,180,0,0,"FE de las J",1
5,"5175",159,130,130,0,0,"FE de las J",0
5,"5196",53,39,39,0,0,"FE de las J",0
5,"5144",79,62,60,2,2,"FE de las J",1
5,"5176",234,190,187,2,3,"FE de las J",1
5,"5235",124,111,110,1,1,"FE de las J",0
5,"5046",45,38,38,1,0,"FE de las J",0
5,"5097",474,324,317,3,7,"FE de las J",1
5,"5249",107,82,82,0,0,"FE de las J",0
5,"5232",98,83,81,1,2,"FE de las J",0
5,"5063",34,24,24,0,0,"FE de las J",0
5,"5114",1359,1131,1115,5,16,"FE de las J",2
5,"5093",417,313,311,1,2,"FE de las J",1
5,"5242",681,538,527,10,11,"FE de las J",0
5,"5158",371,289,287,1,2,"FE de las J",3
5,"5148",27,17,17,0,0,"FE de las J",0
5,"5184",250,197,192,0,5,"FE de las J",0
5,"5101",316,240,238,1,2,"FE de las J",1
5,"5135",425,325,322,1,3,"FE de las J",3
5,"5082",528,437,427,5,10,"FE de las J",1
5,"5103",78,56,56,0,0,"FE de las J",0
5,"5055",576,476,467,0,9,"FE de las J",1
5,"5115",532,392,386,2,6,"FE de las J",0
5,"5261",42,26,26,0,0,"FE de las J",0
5,"5107",64,39,39,1,0,"FE de las J",0
5,"5077",161,137,136,2,1,"FE de las J",0
5,"5089",478,377,365,0,12,"FE de las J",1
5,"5170",52,46,46,0,0,"FE de las J",0
5,"5079",70,54,54,0,0,"FE de las J",0
5,"5014",5422,4137,4084,30,53,"FE de las J",9
5,"5160",323,263,260,1,3,"FE de las J",0
5,"5013",876,733,723,2,10,"FE de las J",0
5,"5253",88,70,70,0,0,"FE de las J",1
5,"5076",481,401,387,5,14,"FE de las J",1
5,"5088",33,24,24,0,0,"FE de las J",0
5,"5228",179,126,126,0,0,"FE de las J",0
5,"5147",162,119,116,0,3,"FE de las J",0
5,"5043",84,67,67,0,0,"FE de las J",0
5,"5065",469,388,385,6,3,"FE de las J",2
5,"5087",137,93,93,0,0,"FE de las J",1
5,"5039",56,43,42,0,1,"FE de las J",0
5,"5054",1238,953,933,1,20,"FE de las J",0
5,"5015",87,66,65,1,1,"FE de las J",0
5,"5186",1572,1240,1222,9,18,"FE de las J",0
5,"5040",68,45,45,0,0,"FE de las J",0
5,"5214",38,27,26,0,1,"FE de las J",0
5,"5073",297,243,238,4,5,"FE de las J",0
5,"5164",27,19,19,1,0,"FE de las J",0
5,"5110",721,559,552,3,7,"FE de las J",0
5,"5199",39,32,32,0,0,"FE de las J",0
5,"5140",116,97,96,0,1,"FE de las J",0
5,"5191",126,104,104,1,0,"FE de las J",0
5,"5072",87,70,69,1,1,"FE de las J",0
5,"5195",224,162,161,1,1,"FE de las J",0
5,"5096",79,57,57,0,0,"FE de las J",2
5,"5222",159,126,126,0,0,"FE de las J",0
5,"5132",992,678,672,2,6,"FE de las J",2
5,"5179",215,184,180,0,4,"FE de las J",0
5,"5230",65,56,54,1,2,"FE de las J",0
5,"5056",96,73,73,0,0,"FE de las J",1
5,"5162",87,60,60,2,0,"FE de las J",0
5,"5188",45,38,38,0,0,"FE de las J",0
5,"5007",113,74,74,1,0,"FE de las J",0
5,"5059",109,79,76,1,3,"FE de las J",0
5,"5085",38,29,29,0,0,"FE de las J",0
5,"5026",197,170,169,1,1,"FE de las J",2
5,"5197",98,90,90,0,0,"FE de las J",0
5,"5240",3393,2354,2335,9,19,"FE de las J",4
5,"5207",697,553,548,0,5,"FE de las J",0
5,"5165",380,291,283,5,8,"FE de las J",3
5,"5133",67,55,55,1,0,"FE de las J",0
5,"5145",52,41,41,0,0,"FE de las J",0
5,"5149",105,76,75,0,1,"FE de las J",0
5,"5049",399,301,291,1,10,"FE de las J",1
5,"5134",48,40,40,0,0,"FE de las J",0
5,"5086",82,66,64,1,2,"FE de las J",0
5,"5001",194,153,152,1,1,"FE de las J",0
5,"5143",66,55,55,1,0,"FE de las J",0
5,"5182",801,559,546,9,13,"FE de las J",2
5,"5245",348,293,288,0,5,"FE de las J",5
5,"5212",233,157,155,1,2,"FE de las J",1
5,"5153",108,78,77,3,1,"FE de las J",0
5,"5257",140,98,98,0,0,"FE de las J",0
5,"5166",188,135,134,1,1,"FE de las J",1
5,"5119",33,20,20,0,0,"FE de las J",0
5,"5263",172,137,137,0,0,"FE de las J",3
5,"5241",3081,2143,2115,17,28,"FE de las J",9
5,"5048",120,104,103,0,1,"FE de las J",0
5,"5217",58,45,45,0,0,"FE de las J",0
5,"5102",1807,1431,1412,7,19,"FE de las J",2
5,"5005",187,150,149,0,1,"FE de las J",2
5,"5167",265,209,199,0,10,"FE de las J",0
5,"5127",650,539,535,4,4,"FE de las J",0
5,"5136",97,74,73,5,1,"FE de las J",0
5,"5025",96,73,72,1,1,"FE de las J",0
5,"5227",373,250,248,0,2,"FE de las J",1
5,"5200",49,28,28,0,0,"FE de las J",0
5,"5262",358,278,277,1,1,"FE de las J",0
5,"5209",83,63,63,0,0,"FE de las J",0
5,"5019",44606,34903,34564,285,339,"FE de las J",79
5,"5081",39,33,31,0,2,"FE de las J",0
5,"5254",196,166,166,0,0,"FE de las J",0
5,"5152",690,561,558,3,3,"FE de las J",1
5,"5022",1611,1279,1271,4,8,"FE de las J",4
5,"5037",261,165,163,3,2,"FE de las J",0
5,"5156",249,163,161,0,2,"FE de las J",0
5,"5129",129,78,78,0,0,"FE de las J",0
5,"5216",224,155,155,2,0,"FE de las J",1
5,"5244",51,38,38,0,0,"FE de las J",0
5,"5173",60,45,45,0,0,"FE de las J",0
5,"5027",269,220,218,2,2,"FE de las J",2
5,"5099",497,398,381,3,17,"FE de las J",2
5,"5258",113,98,97,0,1,"FE de las J",1
5,"5229",84,67,67,0,0,"FE de las J",0
5,"5204",611,473,471,1,2,"FE de las J",3
5,"5108",51,30,30,0,0,"FE de las J",0
5,"5181",43,31,31,1,0,"FE de las J",0
5,"5169",226,178,176,1,2,"FE de las J",0
5,"5078",115,100,99,3,1,"FE de las J",0
5,"5178",371,295,289,0,6,"FE de las J",0
5,"5080",59,42,40,0,2,"FE de las J",0
5,"5109",454,378,362,3,16,"FE de las J",1
5,"5233",226,179,177,0,2,"FE de las J",1
5,"5265",82,70,70,0,0,"FE de las J",0
5,"5130",95,82,82,0,0,"FE de las J",0
5,"5131",105,70,69,1,1,"FE de las J",0
5,"5194",138,122,121,5,1,"FE de las J",0
5,"5092",155,120,120,0,0,"FE de las J",0
5,"5246",60,42,42,0,0,"FE de las J",0
5,"5238",787,565,556,4,9,"FE de las J",0
5,"5213",101,83,83,0,0,"FE de las J",0
5,"5066",458,365,364,3,1,"FE de las J",0
5,"5171",73,58,57,2,1,"FE de las J",0
5,"5138",311,241,239,3,2,"FE de las J",0
5,"5187",1755,1409,1395,11,14,"FE de las J",5
5,"5030",46,37,37,0,0,"FE de las J",0
5,"5210",85,72,72,1,0,"FE de las J",0
5,"5128",350,289,284,4,5,"FE de las J",0
5,"5112",97,72,70,1,2,"FE de las J",0
5,"5247",250,147,146,1,1,"FE de las J",0
5,"5267",100,65,64,0,1,"FE de las J",0
5,"5124",107,83,81,1,2,"FE de las J",1
5,"5239",207,163,162,1,1,"FE de las J",7
5,"5041",1001,772,765,10,7,"FE de las J",0
5,"5120",35,26,26,0,0,"FE de las J",0
5,"5067",83,66,59,1,7,"FE de las J",0
5,"5157",240,170,167,1,3,"FE de las J",0
5,"5010",149,119,118,1,1,"FE de las J",0
5,"5113",78,58,58,1,0,"FE de las J",0
5,"5023",173,153,153,5,0,"FE de las J",0
5,"5177",160,128,128,1,0,"FE de las J",0
5,"5069",74,58,58,0,0,"FE de las J",0
5,"5121",241,186,185,3,1,"FE de las J",0
5,"5090",84,69,68,1,1,"FE de las J",0
5,"5225",372,316,315,5,1,"FE de las J",0
5,"5256",116,92,92,1,0,"FE de las J",1
5,"5251",68,40,40,0,0,"FE de las J",0
5,"5104",34,23,22,1,1,"FE de las J",0
5,"5008",227,180,176,2,4,"FE de las J",0
5,"5163",1756,1351,1345,1,6,"FE de las J",2
5,"5016",6335,4873,4775,39,98,"FE de las J",8
5,"5075",107,67,67,0,0,"FE de las J",2
5,"5252",64,45,45,0,0,"FE de las J",0
5,"5139",76,66,66,0,0,"FE de las J",1
5,"5002",1954,1471,1450,9,21,"FE de las J",3
5,"5083",145,108,100,2,8,"FE de las J",1
5,"5226",77,57,57,0,0,"FE de las J",0
5,"5902",288,227,227,0,0,"FE de las J",0
5,"5174",69,55,55,1,0,"FE de las J",1
5,"5221",353,270,264,3,6,"FE de las J",0
5,"5154",36,30,30,0,0,"FE de las J",0
5,"5062",184,155,154,2,1,"FE de las J",3
5,"5116",118,95,93,1,2,"FE de las J",1
5,"5074",693,543,540,1,3,"FE de las J",2
5,"5159",254,175,174,2,1,"FE de las J",0
5,"5183",140,114,113,1,1,"FE de las J",0
5,"5045",95,70,70,0,0,"FE de las J",0
5,"5211",465,375,373,2,2,"FE de las J",0
5,"5155",52,37,37,0,0,"FE de las J",0
5,"5033",174,139,138,0,1,"FE de las J",1
5,"5141",95,86,86,2,0,"FE de las J",0
5,"5243",88,61,61,1,0,"FE de las J",0
5,"5192",100,82,81,1,1,"FE de las J",0
5,"5259",125,107,106,3,1,"FE de las J",0
5,"5168",3565,2740,2711,17,29,"FE de las J",9
5,"5260",104,84,83,1,1,"FE de las J",1
5,"5180",88,68,68,1,0,"FE de las J",0
5,"5070",32,26,26,0,0,"FE de las J",0
5,"5122",144,115,113,1,2,"FE de las J",1
5,"5017",85,75,75,0,0,"FE de las J",1
5,"5029",123,92,89,0,3,"FE de las J",0
5,"5264",62,43,42,1,1,"FE de las J",0
5,"5052",99,89,88,0,1,"FE de las J",0
5,"5117",201,178,174,2,4,"FE de las J",0
5,"5060",120,99,99,1,0,"FE de las J",0
5,"5100",285,229,228,0,1,"FE de las J",0
5,"5064",103,87,87,1,0,"FE de las J",0
5,"5151",93,70,70,1,0,"FE de las J",0
5,"5094",140,110,110,0,0,"FE de las J",0
5,"5106",36,27,27,0,0,"FE de las J",0
5,"5905",214,150,150,1,0,"FE de las J",0
5,"5205",75,58,58,0,0,"FE de las J",0
5,"5126",70,59,59,0,0,"FE de las J",0
5,"5185",94,80,80,1,0,"FE de las J",0
5,"5236",128,85,84,0,1,"FE de las J",0
5,"5061",253,198,196,4,2,"FE de las J",1
5,"5190",55,42,42,2,0,"FE de las J",0
5,"5206",29,22,21,0,1,"FE de las J",0
5,"5036",123,97,97,0,0,"FE de las J",0
5,"5057",2470,1977,1953,14,24,"FE de las J",2
5,"5034",15,12,12,1,0,"FE de las J",0
5,"5266",102,89,89,0,0,"FE de las J",0
5,"5189",443,340,336,3,4,"FE de las J",0
5,"5047",4199,3287,3244,7,43,"FE de las J",2
5,"5035",107,84,84,1,0,"FE de las J",0
5,"5218",121,97,95,0,2,"FE de las J",0
5,"5193",194,163,163,1,0,"FE de las J",1
5,"5172",123,104,102,2,2,"FE de las J",0
5,"5042",155,126,125,0,1,"FE de las J",0
5,"5231",160,126,124,1,2,"FE de las J",0
5,"5198",73,59,59,0,0,"FE de las J",0
5,"5224",106,87,86,0,1,"FE de las J",0
5,"5904",133,92,91,1,1,"FE de las J",0
5,"5220",382,298,294,1,4,"FE de las J",1
5,"5161",586,483,473,2,10,"FE de las J",0
5,"5012",135,110,108,0,2,"FE de las J",0
5,"5201",529,439,431,2,8,"FE de las J",0
5,"5237",164,131,126,1,5,"FE de las J",0
5,"5234",51,46,46,1,0,"FE de las J",0
5,"5018",29,21,21,0,0,"FE de las J",0
5,"5038",116,87,85,0,2,"FE de las J",0
5,"5125",57,45,44,0,1,"FE de las J",1
5,"5058",78,55,55,2,0,"FE de las J",0
5,"5095",266,220,218,0,2,"FE de las J",1
5,"5901",273,187,185,5,2,"FE de las J",1
31,"31155",253,191,189,3,2,"PACMA",3
31,"31206",2095,1529,1513,19,16,"PACMA",17
31,"31017",361,248,246,4,2,"PACMA",0
31,"31085",471,353,351,3,2,"PACMA",0
31,"31041",1583,1125,1110,14,15,"PACMA",10
31,"31109",1562,1184,1177,6,7,"PACMA",5
31,"31048",169,123,123,1,0,"PACMA",0
31,"31031",221,141,140,0,1,"PACMA",0
31,"31237",195,156,156,1,0,"PACMA",1
31,"31244",156,87,84,1,3,"PACMA",0
31,"31101",1390,1031,1028,11,3,"PACMA",10
31,"31152",1347,999,990,16,9,"PACMA",3
31,"31221",1211,844,825,4,19,"PACMA",5
31,"31193",1414,1103,1094,12,9,"PACMA",8
31,"31215",4649,3412,3359,35,53,"PACMA",35
31,"31165",2794,2057,2025,31,32,"PACMA",12
31,"31024",102,52,52,0,0,"PACMA",0
31,"31140",116,82,82,2,0,"PACMA",0
31,"31108",1878,1487,1475,14,12,"PACMA",4
31,"31210",199,146,145,2,1,"PACMA",0
31,"31234",144,107,107,2,0,"PACMA",1
31,"31051",253,176,176,2,0,"PACMA",0
31,"31030",145,107,107,3,0,"PACMA",1
31,"31037",86,64,64,0,0,"PACMA",0
31,"31238",110,96,94,2,2,"PACMA",0
31,"31192",159,132,131,0,1,"PACMA",0
31,"31142",1411,972,964,11,8,"PACMA",4
31,"31122",4719,3671,3654,42,17,"PACMA",30
31,"31254",1920,1473,1458,7,15,"PACMA",5
31,"31095",76,66,64,1,2,"PACMA",0
31,"31191",3018,2324,2297,23,27,"PACMA",20
31,"31012",814,579,570,4,9,"PACMA",4
31,"31135",102,67,62,0,5,"PACMA",0
31,"31200",764,558,546,11,12,"PACMA",4
31,"31010",5721,3986,3946,27,40,"PACMA",24
31,"31182",37,27,27,0,0,"PACMA",0
31,"31004",35,22,22,1,0,"PACMA",0
31,"31188",227,173,173,2,0,"PACMA",5
31,"31021",64,42,42,0,0,"PACMA",0
31,"31189",1170,739,731,10,8,"PACMA",3
31,"31213",105,70,70,0,0,"PACMA",0
31,"31068",2893,2172,2138,27,34,"PACMA",3
31,"31186",302,211,209,2,2,"PACMA",1
31,"31110",90,65,65,2,0,"PACMA",0
31,"31115",166,108,108,2,0,"PACMA",0
31,"31083",56,41,39,0,2,"PACMA",0
31,"31247",152,112,109,0,3,"PACMA",0
31,"31025",768,560,560,5,0,"PACMA",6
31,"31093",293,210,206,2,4,"PACMA",0
31,"31137",208,93,93,3,0,"PACMA",0
31,"31132",146,115,113,1,2,"PACMA",0
31,"31253",129,112,112,0,0,"PACMA",0
31,"31139",159,102,101,3,1,"PACMA",0
31,"31034",40,29,29,1,0,"PACMA",0
31,"31236",1324,943,933,12,10,"PACMA",3
31,"31904",1559,1095,1084,8,11,"PACMA",11
31,"31146",35,30,30,2,0,"PACMA",0
31,"31154",227,127,125,3,2,"PACMA",0
31,"31046",60,38,38,0,0,"PACMA",1
31,"31265",86,61,61,0,0,"PACMA",0
31,"31905",2847,2108,2093,11,15,"PACMA",39
31,"31044",290,223,220,1,3,"PACMA",1
31,"31196",39,34,34,0,0,"PACMA",0
31,"31175",72,50,49,0,1,"PACMA",1
31,"31027",838,595,589,7,6,"PACMA",4
31,"31264",179,117,115,5,2,"PACMA",0
31,"31259",485,325,324,3,1,"PACMA",1
31,"31078",2447,1889,1861,25,28,"PACMA",8
31,"31117",620,390,385,1,5,"PACMA",3
31,"31249",1885,1350,1331,20,19,"PACMA",5
31,"31195",180,129,128,0,1,"PACMA",0
31,"31158",252,181,178,2,3,"PACMA",0
31,"31256",109,70,70,0,0,"PACMA",0
31,"31039",83,58,57,0,1,"PACMA",1
31,"31184",61,43,43,2,0,"PACMA",0
31,"31219",88,63,62,0,1,"PACMA",0
31,"31162",47,29,27,0,2,"PACMA",2
31,"31127",143,97,97,2,0,"PACMA",0
31,"31094",112,82,82,1,0,"PACMA",1
31,"31058",215,153,153,2,0,"PACMA",0
31,"31098",1918,1489,1483,23,6,"PACMA",15
31,"31251",3110,2347,2327,19,20,"PACMA",28
31,"31261",235,187,187,3,0,"PACMA",2
31,"31075",101,68,67,1,1,"PACMA",0
31,"31241",134,94,89,0,5,"PACMA",0
31,"31054",460,308,304,7,4,"PACMA",0
31,"31091",347,217,217,0,0,"PACMA",0
31,"31202",4326,3045,3001,41,44,"PACMA",13
31,"31141",109,70,66,1,4,"PACMA",0
31,"31070",2652,1907,1888,16,19,"PACMA",6
31,"31057",1812,1375,1360,17,15,"PACMA",4
31,"31013",661,439,437,1,2,"PACMA",1
31,"31203",40,29,29,0,0,"PACMA",0
31,"31260",1245,859,857,15,2,"PACMA",2
31,"31166",260,186,186,2,0,"PACMA",1
31,"31076",2407,2005,1986,28,19,"PACMA",9
31,"31229",50,40,40,0,0,"PACMA",1
31,"31049",704,488,486,1,2,"PACMA",0
31,"31201",147803,110800,110079,1040,721,"PACMA",652
31,"31176",2856,2077,2040,33,37,"PACMA",16
31,"31065",1892,1420,1396,14,24,"PACMA",6
31,"31235",166,111,111,0,0,"PACMA",2
31,"31061",56,50,50,1,0,"PACMA",2
31,"31246",140,108,103,2,5,"PACMA",0
31,"31226",585,346,344,1,2,"PACMA",0
31,"31169",2217,1508,1489,15,19,"PACMA",5
31,"31906",2553,1945,1930,21,15,"PACMA",22
31,"31103",46,32,32,1,0,"PACMA",0
31,"31067",1938,1424,1415,15,9,"PACMA",7
31,"31047",261,191,187,6,4,"PACMA",2
31,"31199",150,101,101,3,0,"PACMA",1
31,"31023",6826,5609,5591,77,18,"PACMA",46
31,"31120",394,264,263,5,1,"PACMA",2
31,"31143",98,59,58,1,1,"PACMA",0
31,"31170",49,39,39,1,0,"PACMA",0
31,"31123",654,430,419,7,11,"PACMA",5
31,"31105",1535,1208,1187,18,21,"PACMA",6
31,"31224",914,668,659,6,9,"PACMA",4
31,"31097",10436,7461,7395,96,66,"PACMA",50
31,"31151",67,48,48,1,0,"PACMA",0
31,"31088",5574,4194,4156,46,38,"PACMA",40
31,"31131",871,664,658,13,6,"PACMA",4
31,"31180",216,173,173,5,0,"PACMA",1
31,"31149",2338,1534,1525,16,9,"PACMA",3
31,"31126",357,235,232,0,3,"PACMA",0
31,"31026",147,128,128,1,0,"PACMA",1
31,"31134",178,132,130,1,2,"PACMA",0
31,"31227",8226,6191,6109,53,82,"PACMA",32
31,"31014",274,197,197,4,0,"PACMA",2
31,"31174",110,75,73,0,2,"PACMA",0
31,"31147",98,76,76,2,0,"PACMA",0
31,"31159",1134,867,864,9,3,"PACMA",3
31,"31125",275,194,191,2,3,"PACMA",0
31,"31205",427,330,326,7,4,"PACMA",0
31,"31128",370,265,265,2,0,"PACMA",1
31,"31006",1952,1423,1400,14,23,"PACMA",2
31,"31214",93,70,69,0,1,"PACMA",1
31,"31178",495,364,364,4,0,"PACMA",0
31,"31086",12987,10342,10270,114,72,"PACMA",89
31,"31005",296,205,204,0,1,"PACMA",4
31,"31167",827,624,615,13,9,"PACMA",7
31,"31156",252,193,193,0,0,"PACMA",1
31,"31216",3882,2829,2810,31,19,"PACMA",20
31,"31081",342,239,239,2,0,"PACMA",1
31,"31033",49,29,29,1,0,"PACMA",0
31,"31100",264,186,186,2,0,"PACMA",2
31,"31020",454,235,232,2,3,"PACMA",0
31,"31056",179,137,133,0,4,"PACMA",3
31,"31036",921,664,657,5,7,"PACMA",2
31,"31257",866,657,648,8,9,"PACMA",4
31,"31148",93,70,70,3,0,"PACMA",0
31,"31016",7642,5866,5822,52,44,"PACMA",41
31,"31145",171,133,133,0,0,"PACMA",0
31,"31060",13723,10036,9970,78,66,"PACMA",78
31,"31111",96,75,75,2,0,"PACMA",1
31,"31066",867,647,638,8,9,"PACMA",6
31,"31157",3546,2423,2399,32,24,"PACMA",20
31,"31185",501,345,342,4,3,"PACMA",1
31,"31172",367,293,286,6,7,"PACMA",3
31,"31073",315,214,212,3,2,"PACMA",0
31,"31064",1447,1161,1145,11,16,"PACMA",3
31,"31007",136,94,93,1,1,"PACMA",1
31,"31208",2569,2016,1992,21,24,"PACMA",15
31,"31116",65,51,51,1,0,"PACMA",0
31,"31160",107,81,80,0,1,"PACMA",0
31,"31089",242,188,185,1,3,"PACMA",3
31,"31232",25152,18432,18220,199,212,"PACMA",161
31,"31129",393,265,261,2,4,"PACMA",1
31,"31220",752,607,603,3,4,"PACMA",6
31,"31050",6058,3902,3850,64,52,"PACMA",15
31,"31124",210,162,162,2,0,"PACMA",1
31,"31161",344,273,270,4,3,"PACMA",3
31,"31230",107,86,85,0,1,"PACMA",0
31,"31072",5288,3916,3846,32,70,"PACMA",24
31,"31002",424,312,310,7,2,"PACMA",3
31,"31009",690,508,504,5,4,"PACMA",2
31,"31171",693,510,500,6,10,"PACMA",3
31,"31198",36,29,29,0,0,"PACMA",0
31,"31107",1707,1303,1294,12,9,"PACMA",6
31,"31087",169,131,127,2,4,"PACMA",0
31,"31902",4346,3247,3228,23,19,"PACMA",47
31,"31231",115,81,81,1,0,"PACMA",0
31,"31187",111,70,70,1,0,"PACMA",1
31,"31043",38,30,30,0,0,"PACMA",0
31,"31179",509,361,355,5,6,"PACMA",2
31,"31077",5384,4055,3999,49,56,"PACMA",28
31,"31181",150,116,116,0,0,"PACMA",0
31,"31019",1809,1295,1288,23,7,"PACMA",11
31,"31118",165,122,121,2,1,"PACMA",1
31,"31225",36,29,29,0,0,"PACMA",0
31,"31029",925,662,648,6,14,"PACMA",2
31,"31082",615,398,393,6,5,"PACMA",1
31,"31173",873,704,680,3,24,"PACMA",2
31,"31177",262,171,170,3,1,"PACMA",1
31,"31144",804,482,479,2,3,"PACMA",0
31,"31212",151,118,118,7,0,"PACMA",0
31,"31113",137,86,85,1,1,"PACMA",1
31,"31063",88,72,68,2,4,"PACMA",0
31,"31084",1935,1389,1380,19,9,"PACMA",3
31,"31209",157,108,108,0,0,"PACMA",2
31,"31194",315,218,217,2,1,"PACMA",0
31,"31207",271,194,190,0,4,"PACMA",1
31,"31168",248,192,191,0,1,"PACMA",1
31,"31164",582,464,457,3,7,"PACMA",2
31,"31138",934,649,647,5,2,"PACMA",6
31,"31053",532,395,391,4,4,"PACMA",0
31,"31121",64,45,45,2,0,"PACMA",0
31,"31035",63,45,43,1,2,"PACMA",0
31,"31062",1088,866,853,4,13,"PACMA",4
31,"31074",394,301,298,5,3,"PACMA",4
31,"31071",17,17,17,0,0,"PACMA",0
31,"31204",37,33,33,2,0,"PACMA",1
31,"31042",2744,2081,2053,19,28,"PACMA",11
31,"31228",496,382,381,2,1,"PACMA",4
31,"31211",25,12,12,2,0,"PACMA",0
31,"31059",191,142,141,1,1,"PACMA",0
31,"31197",70,60,59,0,1,"PACMA",0
31,"31901",15475,11855,11771,121,84,"PACMA",82
31,"31252",87,68,68,0,0,"PACMA",0
31,"31907",10677,8568,8523,97,45,"PACMA",70
31,"31243",314,236,234,5,2,"PACMA",0
31,"31233",96,72,71,0,1,"PACMA",0
31,"31153",2172,1463,1448,10,15,"PACMA",2
31,"31092",662,458,455,4,3,"PACMA",0
31,"31040",194,130,128,1,2,"PACMA",0
31,"31262",206,180,180,2,0,"PACMA",2
31,"31099",63,52,52,1,0,"PACMA",0
31,"31258",7841,5961,5927,56,34,"PACMA",56
31,"31008",80,57,54,0,3,"PACMA",0
31,"31255",102,75,74,2,1,"PACMA",2
31,"31250",2832,1921,1899,20,22,"PACMA",6
31,"31104",1876,1355,1338,10,17,"PACMA",8
31,"31240",531,355,351,6,4,"PACMA",1
31,"31190",44,36,36,1,0,"PACMA",0
31,"31130",310,214,213,7,1,"PACMA",0
31,"31080",510,412,411,8,1,"PACMA",1
31,"31263",236,142,142,2,0,"PACMA",0
31,"31248",295,174,168,2,6,"PACMA",0
31,"31018",409,312,311,9,1,"PACMA",3
31,"31011",697,494,491,5,3,"PACMA",2
31,"31038",1348,1017,1005,13,12,"PACMA",2
31,"31112",94,67,66,0,1,"PACMA",1
31,"31245",83,54,54,1,0,"PACMA",0
31,"31133",44,30,30,1,0,"PACMA",0
31,"31022",526,344,341,3,3,"PACMA",2
31,"31052",88,65,64,0,1,"PACMA",0
31,"31114",362,272,269,6,3,"PACMA",1
31,"31003",124,95,95,2,0,"PACMA",0
31,"31090",146,81,80,3,1,"PACMA",0
31,"31903",6593,4699,4660,28,39,"PACMA",45
31,"31102",146,66,66,1,0,"PACMA",0
31,"31096",115,95,92,2,3,"PACMA",0
31,"31032",1733,1295,1285,26,10,"PACMA",7
31,"31242",253,165,164,1,1,"PACMA",0
31,"31908",1008,709,704,11,5,"PACMA",4
31,"31217",337,233,230,1,3,"PACMA",0
31,"31150",213,154,152,1,2,"PACMA",0
31,"31045",504,397,392,9,5,"PACMA",4
31,"31028",211,133,133,0,0,"PACMA",1
31,"31106",689,565,559,1,6,"PACMA",3
31,"31223",995,752,742,6,10,"PACMA",15
31,"31183",681,581,578,10,3,"PACMA",3
31,"31055",259,177,173,2,4,"PACMA",0
31,"31136",444,320,318,6,2,"PACMA",2
31,"31119",40,22,22,0,0,"PACMA",0
31,"31079",76,53,53,0,0,"PACMA",2
31,"31015",2001,1468,1449,18,19,"PACMA",16
31,"31163",2017,1479,1447,15,32,"PACMA",14
31,"31001",90,74,74,5,0,"PACMA",1
31,"31239",310,223,220,5,3,"PACMA",1
31,"31069",847,643,636,4,7,"PACMA",3
31,"31222",63,41,41,5,0,"PACMA",0
27,"27001",2401,1346,1313,24,33,"PCPE",1
27,"27033",631,454,449,8,5,"PCPE",0
27,"27025",2859,2293,2243,17,50,"PCPE",7
27,"27013",3782,3067,3007,21,60,"PCPE",4
27,"27005",2615,1942,1918,16,24,"PCPE",2
27,"27901",2404,1647,1624,25,23,"PCPE",0
27,"27009",2110,1595,1573,11,22,"PCPE",2
27,"27039",4372,3327,3244,56,83,"PCPE",9
27,"27034",1154,720,710,6,10,"PCPE",3
27,"27059",2202,1640,1605,19,35,"PCPE",1
27,"27030",3361,2333,2290,27,43,"PCPE",4
27,"27002",1651,1224,1200,8,24,"PCPE",1
27,"27026",2423,1667,1602,12,65,"PCPE",1
27,"27063",1761,1340,1299,12,41,"PCPE",3
27,"27051",8102,5883,5784,71,99,"PCPE",22
27,"27902",7196,5017,4921,55,96,"PCPE",9
27,"27018",3514,2279,2255,17,24,"PCPE",8
27,"27056",1268,899,886,11,13,"PCPE",1
27,"27006",2611,1752,1723,26,29,"PCPE",3
27,"27022",4859,3324,3251,38,73,"PCPE",12
27,"27035",190,121,121,2,0,"PCPE",0
27,"27024",1624,1250,1226,8,24,"PCPE",0
27,"27052",918,659,649,3,10,"PCPE",1
27,"27040",3225,2454,2415,22,39,"PCPE",5
27,"27064",1593,1179,1153,14,26,"PCPE",0
27,"27027",1937,1458,1425,19,33,"PCPE",2
27,"27041",2377,1737,1722,16,15,"PCPE",3
27,"27003",1913,1372,1351,16,21,"PCPE",0
27,"27045",1049,667,658,9,9,"PCPE",0
27,"27028",79061,57271,56444,702,827,"PCPE",146
27,"27065",12528,8701,8483,150,218,"PCPE",17
27,"27004",1251,846,828,2,18,"PCPE",1
27,"27048",2176,1658,1626,19,32,"PCPE",3
27,"27053",546,349,349,1,0,"PCPE",1
27,"27008",1377,1011,992,11,19,"PCPE",0
27,"27062",619,468,465,6,3,"PCPE",0
27,"27046",1538,1119,1099,10,20,"PCPE",1
27,"27019",8120,6041,5936,82,105,"PCPE",9
27,"27042",1759,1258,1235,21,23,"PCPE",0
27,"27066",12767,9200,9039,102,161,"PCPE",33
27,"27021",1772,1167,1136,21,31,"PCPE",0
27,"27038",945,679,674,9,5,"PCPE",2
27,"27054",1205,920,906,7,14,"PCPE",1
27,"27017",1017,674,666,6,8,"PCPE",1
27,"27029",1475,1142,1116,19,26,"PCPE",1
27,"27023",2593,1981,1942,24,39,"PCPE",4
27,"27050",2993,2241,2203,16,38,"PCPE",2
27,"27055",1320,869,855,3,14,"PCPE",0
27,"27020",3539,2954,2896,38,58,"PCPE",3
27,"27060",2651,1761,1729,12,32,"PCPE",4
27,"27010",4363,3072,2990,45,82,"PCPE",10
27,"27047",1643,1116,1104,10,12,"PCPE",1
27,"27014",3284,2187,2148,29,39,"PCPE",2
27,"27043",1313,875,855,14,20,"PCPE",0
27,"27007",2833,2211,2144,34,67,"PCPE",0
27,"27031",15650,10901,10710,106,191,"PCPE",29
27,"27032",3313,2269,2230,29,39,"PCPE",4
27,"27061",1045,821,796,10,25,"PCPE",0
27,"27058",3577,2669,2632,37,37,"PCPE",7
27,"27016",7204,5069,4987,65,82,"PCPE",8
27,"27037",1075,736,723,12,13,"PCPE",5
27,"27044",2901,1891,1832,28,59,"PCPE",3
27,"27012",1366,778,769,5,9,"PCPE",1
27,"27057",11176,7921,7709,99,212,"PCPE",10
27,"27049",1422,969,958,8,11,"PCPE",0
27,"27015",4304,3063,2985,41,78,"PCPE",2
27,"27011",2490,1623,1592,14,31,"PCPE",2
12,"12075",123,94,92,1,2,"PODEMOS - C",27
12,"12098",588,479,473,4,6,"PODEMOS - C",83
12,"12088",69,58,58,0,0,"PODEMOS - C",10
12,"12076",87,70,70,1,0,"PODEMOS - C",11
12,"12109",647,531,520,1,11,"PODEMOS - C",89
12,"12022",340,273,269,1,4,"PODEMOS - C",61
12,"12016",1582,1311,1295,9,16,"PODEMOS - C",235
12,"12124",1853,1411,1394,20,17,"PODEMOS - C",226
12,"12077",4625,3443,3387,20,56,"PODEMOS - C",846
12,"12100",1345,1115,1098,6,17,"PODEMOS - C",179
12,"12071",1280,1002,988,5,14,"PODEMOS - C",171
12,"12051",477,337,335,2,2,"PODEMOS - C",30
12,"12097",67,55,54,0,1,"PODEMOS - C",11
12,"12123",47,32,32,0,0,"PODEMOS - C",6
12,"12073",156,132,131,0,1,"PODEMOS - C",20
12,"12129",1840,1391,1360,19,31,"PODEMOS - C",394
12,"12099",542,434,405,9,29,"PODEMOS - C",75
12,"12108",463,395,390,0,5,"PODEMOS - C",85
12,"12014",184,140,136,1,4,"PODEMOS - C",25
12,"12055",106,79,79,2,0,"PODEMOS - C",31
12,"12032",23508,17400,17279,89,121,"PODEMOS - C",3841
12,"12074",784,690,678,9,12,"PODEMOS - C",84
12,"12034",1430,1078,1053,4,25,"PODEMOS - C",257
12,"12103",89,69,68,2,1,"PODEMOS - C",3
12,"12006",176,140,140,1,0,"PODEMOS - C",28
12,"12104",6954,5571,5470,26,101,"PODEMOS - C",1163
12,"12105",851,666,659,5,7,"PODEMOS - C",77
12,"12017",164,133,132,1,1,"PODEMOS - C",17
12,"12052",590,464,442,5,22,"PODEMOS - C",57
12,"12080",1955,1647,1624,13,23,"PODEMOS - C",266
12,"12112",99,81,79,1,2,"PODEMOS - C",0
12,"12059",244,190,189,1,1,"PODEMOS - C",49
12,"12015",96,83,81,0,2,"PODEMOS - C",12
12,"12072",1117,962,937,8,25,"PODEMOS - C",128
12,"12111",375,314,310,0,4,"PODEMOS - C",76
12,"12127",77,56,56,0,0,"PODEMOS - C",9
12,"12007",758,672,667,7,5,"PODEMOS - C",193
12,"12025",137,106,106,0,0,"PODEMOS - C",27
12,"12001",1054,798,786,8,12,"PODEMOS - C",162
12,"12138",19064,13610,13456,135,154,"PODEMOS - C",4125
12,"12085",5061,3310,3264,20,46,"PODEMOS - C",743
12,"12130",404,339,332,0,7,"PODEMOS - C",27
12,"12114",200,150,149,1,1,"PODEMOS - C",42
12,"12106",1170,983,967,16,16,"PODEMOS - C",193
12,"12026",894,697,676,14,21,"PODEMOS - C",95
12,"12090",109,94,93,2,1,"PODEMOS - C",9
12,"12008",231,192,190,2,2,"PODEMOS - C",39
12,"12043",581,470,459,4,11,"PODEMOS - C",94
12,"12044",483,438,431,4,7,"PODEMOS - C",76
12,"12121",1127,955,928,6,27,"PODEMOS - C",114
12,"12020",124,104,103,1,1,"PODEMOS - C",7
12,"12122",805,660,647,4,13,"PODEMOS - C",88
12,"12045",354,282,279,2,3,"PODEMOS - C",72
12,"12096",775,587,580,12,7,"PODEMOS - C",132
12,"12037",16,14,14,0,0,"PODEMOS - C",4
12,"12079",405,318,312,4,6,"PODEMOS - C",38
12,"12131",65,53,53,0,0,"PODEMOS - C",1
12,"12115",217,169,167,2,2,"PODEMOS - C",16
12,"12009",17430,12600,12501,77,99,"PODEMOS - C",3008
12,"12061",378,275,275,4,0,"PODEMOS - C",49
12,"12027",17217,12263,12122,77,141,"PODEMOS - C",3167
12,"12021",4442,3486,3432,25,54,"PODEMOS - C",928
12,"12128",1400,1102,1091,11,11,"PODEMOS - C",279
12,"12082",9655,7570,7492,38,78,"PODEMOS - C",1498
12,"12056",285,243,238,3,5,"PODEMOS - C",76
12,"12113",85,69,69,2,0,"PODEMOS - C",10
12,"12140",1140,961,950,5,11,"PODEMOS - C",224
12,"12132",486,407,398,2,9,"PODEMOS - C",134
12,"12038",171,121,120,1,1,"PODEMOS - C",13
12,"12046",193,154,153,3,1,"PODEMOS - C",29
12,"12065",192,166,166,0,0,"PODEMOS - C",16
12,"12089",4331,3103,3050,25,53,"PODEMOS - C",704
12,"12010",259,216,209,6,7,"PODEMOS - C",35
12,"12028",12566,9902,9830,55,72,"PODEMOS - C",2352
12,"12063",42,35,34,2,1,"PODEMOS - C",12
12,"12137",37,26,26,1,0,"PODEMOS - C",4
12,"12083",95,82,80,0,2,"PODEMOS - C",6
12,"12036",593,448,445,2,3,"PODEMOS - C",55
12,"12053",2069,1691,1677,8,14,"PODEMOS - C",326
12,"12117",3576,2786,2747,17,39,"PODEMOS - C",711
12,"12002",116,98,96,0,2,"PODEMOS - C",34
12,"12048",249,196,192,1,4,"PODEMOS - C",25
12,"12141",101,80,80,0,0,"PODEMOS - C",10
12,"12133",60,49,49,0,0,"PODEMOS - C",3
12,"12067",543,442,424,1,18,"PODEMOS - C",63
12,"12057",606,495,487,3,8,"PODEMOS - C",113
12,"12029",717,572,566,6,6,"PODEMOS - C",145
12,"12091",185,145,141,3,4,"PODEMOS - C",15
12,"12092",112,84,84,0,0,"PODEMOS - C",13
12,"12064",97,83,82,0,1,"PODEMOS - C",22
12,"12101",363,282,273,3,9,"PODEMOS - C",81
12,"12093",189,147,145,1,2,"PODEMOS - C",42
12,"12011",4587,3530,3480,30,50,"PODEMOS - C",883
12,"12139",322,239,237,1,2,"PODEMOS - C",86
12,"12058",74,60,59,2,1,"PODEMOS - C",8
12,"12142",161,124,123,0,1,"PODEMOS - C",4
12,"12003",991,762,752,10,10,"PODEMOS - C",164
12,"12134",138,97,96,0,1,"PODEMOS - C",23
12,"12031",3830,3049,2987,20,62,"PODEMOS - C",952
12,"12107",351,313,309,3,4,"PODEMOS - C",52
12,"12068",49,34,34,1,0,"PODEMOS - C",4
12,"12110",244,173,170,1,3,"PODEMOS - C",31
12,"12102",536,452,437,1,15,"PODEMOS - C",58
12,"12094",851,688,674,2,14,"PODEMOS - C",256
12,"12049",455,348,339,5,9,"PODEMOS - C",116
12,"12126",24480,18885,18687,115,198,"PODEMOS - C",4701
12,"12040",117832,89135,88464,525,671,"PODEMOS - C",23084
12,"12118",74,60,59,0,1,"PODEMOS - C",6
12,"12012",2695,2236,2204,6,32,"PODEMOS - C",515
12,"12901",3433,2691,2664,27,27,"PODEMOS - C",569
12,"12004",4204,3174,3130,19,44,"PODEMOS - C",786
12,"12116",67,49,49,0,0,"PODEMOS - C",4
12,"12135",35749,27015,26806,174,209,"PODEMOS - C",6934
12,"12119",147,100,100,1,0,"PODEMOS - C",8
12,"12018",293,244,235,2,9,"PODEMOS - C",51
12,"12005",8090,6113,6027,57,86,"PODEMOS - C",1526
12,"12069",74,50,49,0,1,"PODEMOS - C",6
12,"12039",840,726,719,2,7,"PODEMOS - C",115
12,"12050",1320,1044,1032,8,12,"PODEMOS - C",209
12,"12087",26,18,18,3,0,"PODEMOS - C",0
12,"12041",97,77,77,0,0,"PODEMOS - C",8
12,"12078",339,250,247,1,3,"PODEMOS - C",45
12,"12070",524,418,408,8,10,"PODEMOS - C",76
12,"12024",139,115,113,1,2,"PODEMOS - C",26
12,"12013",148,119,116,4,3,"PODEMOS - C",34
12,"12042",621,520,512,13,8,"PODEMOS - C",37
12,"12095",974,789,784,8,5,"PODEMOS - C",154
12,"12081",611,503,493,3,10,"PODEMOS - C",97
12,"12125",214,185,183,2,2,"PODEMOS - C",30
12,"12084",17599,13146,13022,98,124,"PODEMOS - C",2589
12,"12136",2657,2302,2252,22,50,"PODEMOS - C",258
12,"12120",184,155,154,1,1,"PODEMOS - C",18
12,"12033",1907,1483,1436,11,47,"PODEMOS - C",336
12,"12060",446,367,360,2,7,"PODEMOS - C",92
12,"12902",2148,1562,1536,9,26,"PODEMOS - C",325
31,"31222",63,41,41,5,0,"SAIn",0
31,"31184",61,43,43,2,0,"SAIn",0
31,"31080",510,412,411,8,1,"SAIn",0
31,"31145",171,133,133,0,0,"SAIn",0
31,"31060",13723,10036,9970,78,66,"SAIn",14
31,"31906",2553,1945,1930,21,15,"SAIn",4
31,"31208",2569,2016,1992,21,24,"SAIn",0
31,"31102",146,66,66,1,0,"SAIn",0
31,"31201",147803,110800,110079,1040,721,"SAIn",446
31,"31005",296,205,204,0,1,"SAIn",0
31,"31904",1559,1095,1084,8,11,"SAIn",0
31,"31085",471,353,351,3,2,"SAIn",0
31,"31031",221,141,140,0,1,"SAIn",0
31,"31258",7841,5961,5927,56,34,"SAIn",6
31,"31087",169,131,127,2,4,"SAIn",0
31,"31217",337,233,230,1,3,"SAIn",0
31,"31141",109,70,66,1,4,"SAIn",0
31,"31114",362,272,269,6,3,"SAIn",0
31,"31104",1876,1355,1338,10,17,"SAIn",2
31,"31172",367,293,286,6,7,"SAIn",1
31,"31256",109,70,70,0,0,"SAIn",1
31,"31224",914,668,659,6,9,"SAIn",0
31,"31231",115,81,81,1,0,"SAIn",0
31,"31115",166,108,108,2,0,"SAIn",0
31,"31159",1134,867,864,9,3,"SAIn",1
31,"31186",302,211,209,2,2,"SAIn",0
31,"31065",1892,1420,1396,14,24,"SAIn",0
31,"31014",274,197,197,4,0,"SAIn",1
31,"31209",157,108,108,0,0,"SAIn",1
31,"31095",76,66,64,1,2,"SAIn",0
31,"31108",1878,1487,1475,14,12,"SAIn",1
31,"31026",147,128,128,1,0,"SAIn",0
31,"31068",2893,2172,2138,27,34,"SAIn",1
31,"31203",40,29,29,0,0,"SAIn",1
31,"31035",63,45,43,1,2,"SAIn",0
31,"31009",690,508,504,5,4,"SAIn",0
31,"31212",151,118,118,7,0,"SAIn",0
31,"31092",662,458,455,4,3,"SAIn",0
31,"31039",83,58,57,0,1,"SAIn",0
31,"31246",140,108,103,2,5,"SAIn",0
31,"31106",689,565,559,1,6,"SAIn",0
31,"31211",25,12,12,2,0,"SAIn",0
31,"31179",509,361,355,5,6,"SAIn",1
31,"31188",227,173,173,2,0,"SAIn",0
31,"31265",86,61,61,0,0,"SAIn",0
31,"31004",35,22,22,1,0,"SAIn",0
31,"31090",146,81,80,3,1,"SAIn",0
31,"31033",49,29,29,1,0,"SAIn",0
31,"31064",1447,1161,1145,11,16,"SAIn",0
31,"31176",2856,2077,2040,33,37,"SAIn",4
31,"31118",165,122,121,2,1,"SAIn",0
31,"31155",253,191,189,3,2,"SAIn",0
31,"31086",12987,10342,10270,114,72,"SAIn",42
31,"31047",261,191,187,6,4,"SAIn",0
31,"31241",134,94,89,0,5,"SAIn",0
31,"31168",248,192,191,0,1,"SAIn",0
31,"31183",681,581,578,10,3,"SAIn",0
31,"31223",995,752,742,6,10,"SAIn",0
31,"31052",88,65,64,0,1,"SAIn",0
31,"31048",169,123,123,1,0,"SAIn",0
31,"31112",94,67,66,0,1,"SAIn",0
31,"31199",150,101,101,3,0,"SAIn",1
31,"31137",208,93,93,3,0,"SAIn",0
31,"31232",25152,18432,18220,199,212,"SAIn",20
31,"31041",1583,1125,1110,14,15,"SAIn",0
31,"31139",159,102,101,3,1,"SAIn",0
31,"31117",620,390,385,1,5,"SAIn",0
31,"31119",40,22,22,0,0,"SAIn",0
31,"31132",146,115,113,1,2,"SAIn",1
31,"31058",215,153,153,2,0,"SAIn",0
31,"31228",496,382,381,2,1,"SAIn",0
31,"31260",1245,859,857,15,2,"SAIn",0
31,"31205",427,330,326,7,4,"SAIn",0
31,"31123",654,430,419,7,11,"SAIn",0
31,"31025",768,560,560,5,0,"SAIn",1
31,"31077",5384,4055,3999,49,56,"SAIn",1
31,"31091",347,217,217,0,0,"SAIn",0
31,"31150",213,154,152,1,2,"SAIn",0
31,"31130",310,214,213,7,1,"SAIn",0
31,"31247",152,112,109,0,3,"SAIn",0
31,"31063",88,72,68,2,4,"SAIn",0
31,"31012",814,579,570,4,9,"SAIn",0
31,"31036",921,664,657,5,7,"SAIn",4
31,"31138",934,649,647,5,2,"SAIn",0
31,"31021",64,42,42,0,0,"SAIn",0
31,"31007",136,94,93,1,1,"SAIn",0
31,"31006",1952,1423,1400,14,23,"SAIn",1
31,"31107",1707,1303,1294,12,9,"SAIn",0
31,"31027",838,595,589,7,6,"SAIn",0
31,"31056",179,137,133,0,4,"SAIn",0
31,"31144",804,482,479,2,3,"SAIn",1
31,"31182",37,27,27,0,0,"SAIn",0
31,"31901",15475,11855,11771,121,84,"SAIn",35
31,"31121",64,45,45,2,0,"SAIn",0
31,"31196",39,34,34,0,0,"SAIn",0
31,"31053",532,395,391,4,4,"SAIn",0
31,"31142",1411,972,964,11,8,"SAIn",0
31,"31225",36,29,29,0,0,"SAIn",0
31,"31143",98,59,58,1,1,"SAIn",0
31,"31122",4719,3671,3654,42,17,"SAIn",8
31,"31037",86,64,64,0,0,"SAIn",0
31,"31082",615,398,393,6,5,"SAIn",0
31,"31151",67,48,48,1,0,"SAIn",0
31,"31239",310,223,220,5,3,"SAIn",0
31,"31259",485,325,324,3,1,"SAIn",0
31,"31149",2338,1534,1525,16,9,"SAIn",1
31,"31213",105,70,70,0,0,"SAIn",0
31,"31038",1348,1017,1005,13,12,"SAIn",0
31,"31206",2095,1529,1513,19,16,"SAIn",5
31,"31250",2832,1921,1899,20,22,"SAIn",1
31,"31219",88,63,62,0,1,"SAIn",0
31,"31010",5721,3986,3946,27,40,"SAIn",139
31,"31032",1733,1295,1285,26,10,"SAIn",0
31,"31113",137,86,85,1,1,"SAIn",0
31,"31070",2652,1907,1888,16,19,"SAIn",1
31,"31257",866,657,648,8,9,"SAIn",1
31,"31185",501,345,342,4,3,"SAIn",2
31,"31084",1935,1389,1380,19,9,"SAIn",0
31,"31015",2001,1468,1449,18,19,"SAIn",1
31,"31236",1324,943,933,12,10,"SAIn",2
31,"31226",585,346,344,1,2,"SAIn",0
31,"31157",3546,2423,2399,32,24,"SAIn",3
31,"31154",227,127,125,3,2,"SAIn",0
31,"31020",454,235,232,2,3,"SAIn",0
31,"31216",3882,2829,2810,31,19,"SAIn",2
31,"31164",582,464,457,3,7,"SAIn",2
31,"31195",180,129,128,0,1,"SAIn",0
31,"31017",361,248,246,4,2,"SAIn",0
31,"31116",65,51,51,1,0,"SAIn",0
31,"31126",357,235,232,0,3,"SAIn",0
31,"31110",90,65,65,2,0,"SAIn",0
31,"31013",661,439,437,1,2,"SAIn",0
31,"31162",47,29,27,0,2,"SAIn",0
31,"31003",124,95,95,2,0,"SAIn",0
31,"31192",159,132,131,0,1,"SAIn",0
31,"31071",17,17,17,0,0,"SAIn",0
31,"31083",56,41,39,0,2,"SAIn",0
31,"31022",526,344,341,3,3,"SAIn",0
31,"31101",1390,1031,1028,11,3,"SAIn",1
31,"31251",3110,2347,2327,19,20,"SAIn",1
31,"31079",76,53,53,0,0,"SAIn",0
31,"31165",2794,2057,2025,31,32,"SAIn",0
31,"31134",178,132,130,1,2,"SAIn",0
31,"31175",72,50,49,0,1,"SAIn",0
31,"31019",1809,1295,1288,23,7,"SAIn",0
31,"31049",704,488,486,1,2,"SAIn",0
31,"31147",98,76,76,2,0,"SAIn",1
31,"31153",2172,1463,1448,10,15,"SAIn",1
31,"31248",295,174,168,2,6,"SAIn",0
31,"31244",156,87,84,1,3,"SAIn",0
31,"31215",4649,3412,3359,35,53,"SAIn",2
31,"31214",93,70,69,0,1,"SAIn",0
31,"31160",107,81,80,0,1,"SAIn",0
31,"31127",143,97,97,2,0,"SAIn",1
31,"31903",6593,4699,4660,28,39,"SAIn",7
31,"31078",2447,1889,1861,25,28,"SAIn",0
31,"31238",110,96,94,2,2,"SAIn",0
31,"31096",115,95,92,2,3,"SAIn",0
31,"31240",531,355,351,6,4,"SAIn",0
31,"31074",394,301,298,5,3,"SAIn",0
31,"31103",46,32,32,1,0,"SAIn",0
31,"31204",37,33,33,2,0,"SAIn",0
31,"31066",867,647,638,8,9,"SAIn",3
31,"31061",56,50,50,1,0,"SAIn",0
31,"31046",60,38,38,0,0,"SAIn",0
31,"31229",50,40,40,0,0,"SAIn",0
31,"31234",144,107,107,2,0,"SAIn",0
31,"31235",166,111,111,0,0,"SAIn",0
31,"31170",49,39,39,1,0,"SAIn",0
31,"31198",36,29,29,0,0,"SAIn",0
31,"31181",150,116,116,0,0,"SAIn",0
31,"31197",70,60,59,0,1,"SAIn",0
31,"31059",191,142,141,1,1,"SAIn",0
31,"31230",107,86,85,0,1,"SAIn",0
31,"31125",275,194,191,2,3,"SAIn",0
31,"31034",40,29,29,1,0,"SAIn",0
31,"31233",96,72,71,0,1,"SAIn",0
31,"31227",8226,6191,6109,53,82,"SAIn",3
31,"31128",370,265,265,2,0,"SAIn",0
31,"31163",2017,1479,1447,15,32,"SAIn",0
31,"31171",693,510,500,6,10,"SAIn",1
31,"31220",752,607,603,3,4,"SAIn",0
31,"31072",5288,3916,3846,32,70,"SAIn",2
31,"31202",4326,3045,3001,41,44,"SAIn",7
31,"31099",63,52,52,1,0,"SAIn",0
31,"31008",80,57,54,0,3,"SAIn",0
31,"31069",847,643,636,4,7,"SAIn",0
31,"31187",111,70,70,1,0,"SAIn",0
31,"31028",211,133,133,0,0,"SAIn",0
31,"31105",1535,1208,1187,18,21,"SAIn",0
31,"31002",424,312,310,7,2,"SAIn",0
31,"31242",253,165,164,1,1,"SAIn",0
31,"31174",110,75,73,0,2,"SAIn",0
31,"31135",102,67,62,0,5,"SAIn",0
31,"31189",1170,739,731,10,8,"SAIn",0
31,"31124",210,162,162,2,0,"SAIn",0
31,"31167",827,624,615,13,9,"SAIn",3
31,"31178",495,364,364,4,0,"SAIn",0
31,"31136",444,320,318,6,2,"SAIn",1
31,"31050",6058,3902,3850,64,52,"SAIn",4
31,"31029",925,662,648,6,14,"SAIn",0
31,"31254",1920,1473,1458,7,15,"SAIn",1
31,"31263",236,142,142,2,0,"SAIn",0
31,"31093",293,210,206,2,4,"SAIn",0
31,"31161",344,273,270,4,3,"SAIn",0
31,"31081",342,239,239,2,0,"SAIn",2
31,"31194",315,218,217,2,1,"SAIn",1
31,"31249",1885,1350,1331,20,19,"SAIn",0
31,"31902",4346,3247,3228,23,19,"SAIn",5
31,"31253",129,112,112,0,0,"SAIn",0
31,"31023",6826,5609,5591,77,18,"SAIn",15
31,"31100",264,186,186,2,0,"SAIn",0
31,"31207",271,194,190,0,4,"SAIn",0
31,"31905",2847,2108,2093,11,15,"SAIn",16
31,"31011",697,494,491,5,3,"SAIn",0
31,"31131",871,664,658,13,6,"SAIn",0
31,"31261",235,187,187,3,0,"SAIn",1
31,"31051",253,176,176,2,0,"SAIn",0
31,"31001",90,74,74,5,0,"SAIn",0
31,"31243",314,236,234,5,2,"SAIn",0
31,"31073",315,214,212,3,2,"SAIn",0
31,"31907",10677,8568,8523,97,45,"SAIn",21
31,"31075",101,68,67,1,1,"SAIn",3
31,"31190",44,36,36,1,0,"SAIn",0
31,"31016",7642,5866,5822,52,44,"SAIn",2
31,"31076",2407,2005,1986,28,19,"SAIn",9
31,"31120",394,264,263,5,1,"SAIn",0
31,"31177",262,171,170,3,1,"SAIn",0
31,"31245",83,54,54,1,0,"SAIn",0
31,"31210",199,146,145,2,1,"SAIn",0
31,"31045",504,397,392,9,5,"SAIn",0
31,"31191",3018,2324,2297,23,27,"SAIn",1
31,"31237",195,156,156,1,0,"SAIn",0
31,"31148",93,70,70,3,0,"SAIn",0
31,"31908",1008,709,704,11,5,"SAIn",0
31,"31067",1938,1424,1415,15,9,"SAIn",0
31,"31089",242,188,185,1,3,"SAIn",2
31,"31193",1414,1103,1094,12,9,"SAIn",5
31,"31043",38,30,30,0,0,"SAIn",0
31,"31252",87,68,68,0,0,"SAIn",0
31,"31146",35,30,30,2,0,"SAIn",0
31,"31097",10436,7461,7395,96,66,"SAIn",5
31,"31094",112,82,82,1,0,"SAIn",0
31,"31152",1347,999,990,16,9,"SAIn",5
31,"31024",102,52,52,0,0,"SAIn",0
31,"31166",260,186,186,2,0,"SAIn",0
31,"31055",259,177,173,2,4,"SAIn",0
31,"31044",290,223,220,1,3,"SAIn",0
31,"31133",44,30,30,1,0,"SAIn",0
31,"31169",2217,1508,1489,15,19,"SAIn",1
31,"31255",102,75,74,2,1,"SAIn",1
31,"31140",116,82,82,2,0,"SAIn",0
31,"31262",206,180,180,2,0,"SAIn",0
31,"31129",393,265,261,2,4,"SAIn",0
31,"31098",1918,1489,1483,23,6,"SAIn",2
31,"31111",96,75,75,2,0,"SAIn",0
31,"31018",409,312,311,9,1,"SAIn",0
31,"31030",145,107,107,3,0,"SAIn",0
31,"31042",2744,2081,2053,19,28,"SAIn",0
31,"31173",873,704,680,3,24,"SAIn",0
31,"31200",764,558,546,11,12,"SAIn",0
31,"31158",252,181,178,2,3,"SAIn",0
31,"31054",460,308,304,7,4,"SAIn",0
31,"31180",216,173,173,5,0,"SAIn",2
31,"31057",1812,1375,1360,17,15,"SAIn",1
31,"31088",5574,4194,4156,46,38,"SAIn",5
31,"31109",1562,1184,1177,6,7,"SAIn",4
31,"31156",252,193,193,0,0,"SAIn",0
31,"31264",179,117,115,5,2,"SAIn",0
31,"31221",1211,844,825,4,19,"SAIn",1
31,"31062",1088,866,853,4,13,"SAIn",0
31,"31040",194,130,128,1,2,"SAIn",0
7,"7052",4705,2993,2971,34,22,"MÉS",104
7,"7002",6367,4466,4401,36,65,"MÉS",173
7,"7048",17339,10192,10101,104,91,"MÉS",119
7,"7017",844,625,618,6,7,"MÉS",72
7,"7029",4137,3088,3048,34,40,"MÉS",283
7,"7030",1573,1151,1129,10,22,"MÉS",283
7,"7021",234,188,188,0,0,"MÉS",28
7,"7020",3597,2652,2622,27,30,"MÉS",607
7,"7023",3628,2611,2573,45,38,"MÉS",261
7,"7036",26936,19563,19392,156,171,"MÉS",1331
7,"7027",20667,13784,13673,106,111,"MÉS",981
7,"7041",2039,1566,1540,5,26,"MÉS",442
7,"7038",2032,1515,1503,10,12,"MÉS",382
7,"7042",10666,7023,6967,59,56,"MÉS",726
7,"7007",437,308,304,1,4,"MÉS",56
7,"7004",3861,2657,2630,24,27,"MÉS",362
7,"7001",3556,2682,2657,21,25,"MÉS",230
7,"7057",7170,4736,4668,44,68,"MÉS",333
7,"7003",11742,6924,6837,43,87,"MÉS",335
7,"7012",1877,1421,1408,13,13,"MÉS",372
7,"7035",1517,1188,1181,3,7,"MÉS",184
7,"7032",20039,13156,13033,136,123,"MÉS",536
7,"7059",2998,2119,2084,11,35,"MÉS",183
7,"7022",11575,7827,7730,85,97,"MÉS",1001
7,"7064",5361,3588,3546,20,42,"MÉS",160
7,"7013",6832,4879,4775,34,104,"MÉS",491
7,"7047",2236,1602,1584,7,18,"MÉS",167
7,"7046",15649,9532,9443,70,89,"MÉS",71
7,"7024",7019,3579,3544,39,35,"MÉS",144
7,"7009",749,552,550,1,2,"MÉS",105
7,"7045",1288,996,992,13,4,"MÉS",128
7,"7039",4880,3473,3412,27,61,"MÉS",370
7,"7050",3321,2161,2134,33,27,"MÉS",29
7,"7902",1072,730,712,18,18,"MÉS",42
7,"7028",892,617,611,2,6,"MÉS",91
7,"7034",991,774,765,2,9,"MÉS",159
7,"7031",23747,15538,15401,130,137,"MÉS",882
7,"7058",2804,2138,2118,15,20,"MÉS",279
7,"7005",6659,4400,4357,23,43,"MÉS",239
7,"7053",1171,957,946,8,11,"MÉS",112
7,"7018",389,271,265,3,6,"MÉS",36
7,"7065",2079,1462,1451,13,11,"MÉS",286
7,"7019",192,146,146,0,0,"MÉS",17
7,"7016",2786,1992,1969,30,23,"MÉS",204
7,"7025",478,377,376,1,1,"MÉS",40
7,"7044",8457,6079,5963,59,116,"MÉS",695
7,"7010",4858,3518,3463,52,55,"MÉS",391
7,"7061",9831,6618,6546,54,72,"MÉS",705
7,"7043",3422,2435,2410,13,25,"MÉS",402
7,"7040",279737,181078,179570,1280,1508,"MÉS",10349
7,"7033",27017,16370,16205,143,165,"MÉS",2223
7,"7060",2577,1825,1807,20,18,"MÉS",370
7,"7011",27781,18282,18180,135,102,"MÉS",408
7,"7015",21076,13304,13169,162,135,"MÉS",1088
7,"7056",5012,3632,3592,40,40,"MÉS",516
7,"7051",5225,3322,3279,38,43,"MÉS",292
7,"7055",7474,4796,4740,48,56,"MÉS",387
7,"7026",31158,18670,18537,161,133,"MÉS",247
7,"7063",1420,1084,1072,8,12,"MÉS",125
7,"7062",7539,4371,4312,40,59,"MÉS",200
7,"7037",3232,1894,1881,16,13,"MÉS",149
7,"7901",611,476,469,6,7,"MÉS",30
7,"7008",5681,4203,4153,22,50,"MÉS",553
7,"7049",1498,1080,1071,12,9,"MÉS",193
7,"7054",22371,12930,12779,104,151,"MÉS",111
7,"7006",5175,3559,3528,33,31,"MÉS",649
7,"7014",7277,4301,4261,37,40,"MÉS",320
16,"16067",127,92,91,3,1,"PODEMOS",14
16,"16275",11,11,11,1,0,"PODEMOS",0
16,"16009",66,48,48,0,0,"PODEMOS",8
16,"16153",955,797,780,5,17,"PODEMOS",73
16,"16013",31,28,28,0,0,"PODEMOS",4
16,"16239",141,110,107,0,3,"PODEMOS",19
16,"16901",707,520,513,3,7,"PODEMOS",51
16,"16272",228,167,167,1,0,"PODEMOS",10
16,"16015",376,286,285,7,1,"PODEMOS",24
16,"16026",85,56,53,0,3,"PODEMOS",2
16,"16253",357,279,279,1,0,"PODEMOS",18
16,"16156",101,76,75,0,1,"PODEMOS",5
16,"16215",248,177,172,1,5,"PODEMOS",33
16,"16219",91,72,72,0,0,"PODEMOS",9
16,"16271",637,535,533,3,2,"PODEMOS",61
16,"16042",1192,1021,1005,6,16,"PODEMOS",68
16,"16148",587,511,511,1,0,"PODEMOS",26
16,"16132",34,26,26,0,0,"PODEMOS",2
16,"16177",78,63,63,0,0,"PODEMOS",9
16,"16258",198,143,142,0,1,"PODEMOS",14
16,"16014",613,493,487,1,6,"PODEMOS",52
16,"16089",379,299,299,4,0,"PODEMOS",36
16,"16150",94,67,67,1,0,"PODEMOS",8
16,"16203",9960,7515,7418,43,97,"PODEMOS",924
16,"16019",217,168,166,1,2,"PODEMOS",7
16,"16174",192,155,155,1,0,"PODEMOS",10
16,"16046",250,181,180,1,1,"PODEMOS",6
16,"16050",251,195,194,1,1,"PODEMOS",12
16,"16011",28,19,19,0,0,"PODEMOS",2
16,"16129",104,82,79,1,3,"PODEMOS",1
16,"16155",506,415,414,2,1,"PODEMOS",31
16,"16224",84,68,67,1,1,"PODEMOS",4
16,"16056",465,333,322,0,11,"PODEMOS",28
16,"16910",96,70,70,0,0,"PODEMOS",15
16,"16065",406,323,319,3,4,"PODEMOS",27
16,"16169",58,33,32,0,1,"PODEMOS",2
16,"16141",145,113,112,1,1,"PODEMOS",4
16,"16035",258,192,192,3,0,"PODEMOS",31
16,"16157",213,185,182,0,3,"PODEMOS",11
16,"16012",82,69,69,0,0,"PODEMOS",4
16,"16087",212,186,186,5,0,"PODEMOS",10
16,"16062",24,21,21,0,0,"PODEMOS",8
16,"16024",130,100,98,0,2,"PODEMOS",24
16,"16259",30,26,26,1,0,"PODEMOS",1
16,"16159",225,170,168,0,2,"PODEMOS",5
16,"16270",167,141,141,0,0,"PODEMOS",13
16,"16139",333,255,251,4,4,"PODEMOS",27
16,"16078",41427,31365,31095,268,270,"PODEMOS",4895
16,"16170",698,524,517,1,7,"PODEMOS",67
16,"16175",5113,4203,4124,35,79,"PODEMOS",364
16,"16029",96,73,71,0,2,"PODEMOS",14
16,"16004",274,212,206,0,6,"PODEMOS",19
16,"16166",247,182,177,0,5,"PODEMOS",9
16,"16134",4369,3412,3369,23,43,"PODEMOS",407
16,"16130",575,451,446,0,5,"PODEMOS",26
16,"16243",412,354,348,0,6,"PODEMOS",46
16,"16133",4391,3539,3509,27,30,"PODEMOS",690
16,"16188",90,63,62,0,1,"PODEMOS",9
16,"16176",39,28,28,0,0,"PODEMOS",2
16,"16058",105,81,80,0,1,"PODEMOS",2
16,"16276",21,17,17,0,0,"PODEMOS",0
16,"16018",401,328,328,1,0,"PODEMOS",20
16,"16041",354,284,282,0,2,"PODEMOS",22
16,"16093",64,52,52,0,0,"PODEMOS",8
16,"16098",571,468,461,5,7,"PODEMOS",52
16,"16008",95,72,72,0,0,"PODEMOS",15
16,"16904",478,387,381,5,6,"PODEMOS",68
16,"16234",30,19,19,1,0,"PODEMOS",0
16,"16146",87,62,62,1,0,"PODEMOS",3
16,"16099",208,157,152,0,5,"PODEMOS",17
16,"16038",38,28,28,0,0,"PODEMOS",0
16,"16051",147,118,118,0,0,"PODEMOS",5
16,"16277",118,86,84,0,2,"PODEMOS",4
16,"16082",305,224,224,0,0,"PODEMOS",33
16,"16007",1192,964,959,8,5,"PODEMOS",33
16,"16173",207,155,154,1,1,"PODEMOS",13
16,"16266",373,279,273,1,6,"PODEMOS",7
16,"16031",46,30,30,2,0,"PODEMOS",2
16,"16106",2729,2130,2095,19,35,"PODEMOS",175
16,"16905",1217,965,956,9,9,"PODEMOS",145
16,"16096",273,249,244,2,5,"PODEMOS",19
16,"16165",63,51,50,1,1,"PODEMOS",7
16,"16044",39,28,27,0,1,"PODEMOS",0
16,"16052",548,420,420,1,0,"PODEMOS",48
16,"16264",433,374,370,2,4,"PODEMOS",19
16,"16246",484,382,375,1,7,"PODEMOS",17
16,"16237",113,89,87,0,2,"PODEMOS",11
16,"16250",76,57,57,0,0,"PODEMOS",6
16,"16119",169,121,120,0,1,"PODEMOS",22
16,"16171",1818,1514,1498,5,16,"PODEMOS",113
16,"16085",136,108,108,2,0,"PODEMOS",10
16,"16198",1365,1067,1052,12,15,"PODEMOS",109
16,"16124",1870,1536,1518,7,18,"PODEMOS",183
16,"16101",160,130,129,0,1,"PODEMOS",14
16,"16185",44,35,33,0,2,"PODEMOS",3
16,"16149",153,130,129,0,1,"PODEMOS",31
16,"16204",272,207,207,1,0,"PODEMOS",33
16,"16231",48,38,38,0,0,"PODEMOS",4
16,"16027",709,567,562,4,5,"PODEMOS",77
16,"16194",259,208,200,0,8,"PODEMOS",10
16,"16081",49,38,37,0,1,"PODEMOS",5
16,"16107",120,87,87,1,0,"PODEMOS",4
16,"16909",706,537,534,3,3,"PODEMOS",71
16,"16908",197,154,154,1,0,"PODEMOS",36
16,"16115",44,33,33,0,0,"PODEMOS",2
16,"16135",139,109,108,0,1,"PODEMOS",6
16,"16121",259,205,205,3,0,"PODEMOS",34
16,"16064",681,588,581,1,7,"PODEMOS",44
16,"16280",189,160,157,2,3,"PODEMOS",11
16,"16033",1729,1385,1365,7,20,"PODEMOS",166
16,"16131",134,97,97,1,0,"PODEMOS",8
16,"16158",546,437,431,7,6,"PODEMOS",56
16,"16126",783,654,648,2,6,"PODEMOS",52
16,"16043",99,73,73,1,0,"PODEMOS",6
16,"16212",255,208,206,1,2,"PODEMOS",17
16,"16030",25,22,22,1,0,"PODEMOS",3
16,"16006",119,96,94,1,2,"PODEMOS",5
16,"16162",43,35,35,0,0,"PODEMOS",0
16,"16128",63,54,54,2,0,"PODEMOS",1
16,"16118",1405,1147,1136,11,11,"PODEMOS",107
16,"16142",139,110,109,2,1,"PODEMOS",13
16,"16249",1986,1593,1570,8,23,"PODEMOS",112
16,"16240",108,79,79,0,0,"PODEMOS",10
16,"16906",82,67,67,1,0,"PODEMOS",2
16,"16236",914,694,689,6,5,"PODEMOS",40
16,"16181",64,53,53,0,0,"PODEMOS",2
16,"16057",78,60,60,0,0,"PODEMOS",6
16,"16005",256,191,187,1,4,"PODEMOS",23
16,"16110",97,71,70,0,1,"PODEMOS",1
16,"16071",20,20,20,0,0,"PODEMOS",4
16,"16160",61,46,45,1,1,"PODEMOS",1
16,"16060",760,600,593,5,7,"PODEMOS",57
16,"16274",127,100,100,0,0,"PODEMOS",16
16,"16161",58,53,53,0,0,"PODEMOS",4
16,"16265",21,16,16,0,0,"PODEMOS",0
16,"16167",324,275,271,2,4,"PODEMOS",28
16,"16053",429,352,348,5,4,"PODEMOS",68
16,"16238",509,442,434,2,8,"PODEMOS",31
16,"16145",464,389,387,2,2,"PODEMOS",50
16,"16002",192,172,172,0,0,"PODEMOS",6
16,"16154",4904,3776,3730,47,46,"PODEMOS",432
16,"16251",1858,1450,1420,8,30,"PODEMOS",131
16,"16055",703,512,509,7,3,"PODEMOS",39
16,"16023",468,344,343,3,1,"PODEMOS",81
16,"16218",189,155,154,1,1,"PODEMOS",10
16,"16172",350,270,270,2,0,"PODEMOS",3
16,"16102",1231,922,911,8,11,"PODEMOS",64
16,"16192",50,30,29,0,1,"PODEMOS",3
16,"16206",208,163,162,4,1,"PODEMOS",15
16,"16248",872,711,696,11,15,"PODEMOS",101
16,"16003",127,111,109,0,2,"PODEMOS",12
16,"16095",84,71,68,0,3,"PODEMOS",4
16,"16108",49,43,42,0,1,"PODEMOS",11
16,"16034",183,153,153,1,0,"PODEMOS",14
16,"16112",1505,1088,1072,9,16,"PODEMOS",112
16,"16245",418,338,333,2,5,"PODEMOS",39
16,"16113",3080,2309,2278,15,31,"PODEMOS",198
16,"16017",370,300,296,2,4,"PODEMOS",41
16,"16086",888,768,762,10,6,"PODEMOS",65
16,"16137",56,34,33,0,1,"PODEMOS",4
16,"16152",40,35,35,0,0,"PODEMOS",5
16,"16213",35,28,28,1,0,"PODEMOS",6
16,"16039",398,275,271,1,4,"PODEMOS",22
16,"16269",426,351,349,3,2,"PODEMOS",26
16,"16083",55,28,28,0,0,"PODEMOS",3
16,"16278",73,55,55,0,0,"PODEMOS",2
16,"16100",684,587,580,5,7,"PODEMOS",49
16,"16048",412,312,310,1,2,"PODEMOS",38
16,"16143",16,12,12,2,0,"PODEMOS",1
16,"16092",161,130,129,1,1,"PODEMOS",11
16,"16147",62,43,43,0,0,"PODEMOS",5
16,"16094",132,101,99,1,2,"PODEMOS",8
16,"16088",114,92,92,0,0,"PODEMOS",12
16,"16016",234,173,172,2,1,"PODEMOS",8
16,"16255",141,119,119,0,0,"PODEMOS",4
16,"16122",254,200,198,4,2,"PODEMOS",24
16,"16189",256,192,191,2,1,"PODEMOS",18
16,"16279",213,146,143,0,3,"PODEMOS",9
16,"16036",128,104,102,2,2,"PODEMOS",21
16,"16072",147,103,102,0,1,"PODEMOS",5
16,"16190",5127,4088,4025,42,63,"PODEMOS",310
16,"16068",145,117,114,2,3,"PODEMOS",5
16,"16084",49,37,32,0,5,"PODEMOS",4
16,"16902",141,105,105,1,0,"PODEMOS",8
16,"16091",68,51,49,0,2,"PODEMOS",11
16,"16020",17,11,11,0,0,"PODEMOS",3
16,"16109",43,32,32,0,0,"PODEMOS",5
16,"16061",964,798,790,13,8,"PODEMOS",74
16,"16151",64,60,60,0,0,"PODEMOS",5
16,"16195",498,380,376,1,4,"PODEMOS",12
16,"16073",188,158,158,0,0,"PODEMOS",6
16,"16244",722,625,617,2,8,"PODEMOS",49
16,"16074",40,31,31,0,0,"PODEMOS",2
16,"16228",177,132,131,1,1,"PODEMOS",4
16,"16117",1057,814,808,2,6,"PODEMOS",105
16,"16047",230,176,176,2,0,"PODEMOS",17
16,"16125",1676,1338,1326,9,12,"PODEMOS",115
16,"16242",325,281,278,1,3,"PODEMOS",12
16,"16273",324,252,252,2,0,"PODEMOS",9
16,"16123",82,54,53,0,1,"PODEMOS",9
16,"16187",77,52,52,1,0,"PODEMOS",6
16,"16163",74,63,63,0,0,"PODEMOS",10
16,"16191",926,760,752,6,8,"PODEMOS",41
16,"16001",75,60,60,0,0,"PODEMOS",4
16,"16202",783,573,566,3,7,"PODEMOS",88
16,"16196",633,538,527,2,11,"PODEMOS",48
16,"16211",377,253,250,3,3,"PODEMOS",15
16,"16263",961,754,745,4,9,"PODEMOS",85
16,"16209",118,100,100,1,0,"PODEMOS",13
16,"16032",287,230,230,1,0,"PODEMOS",23
16,"16225",76,58,57,0,1,"PODEMOS",3
16,"16199",31,24,24,0,0,"PODEMOS",1
16,"16010",154,114,110,1,4,"PODEMOS",4
16,"16197",65,37,37,0,0,"PODEMOS",2
16,"16104",54,40,40,0,0,"PODEMOS",3
16,"16066",2333,1917,1872,24,45,"PODEMOS",255
16,"16247",71,52,51,0,1,"PODEMOS",2
16,"16116",84,62,62,0,0,"PODEMOS",8
16,"16193",70,57,57,1,0,"PODEMOS",4
16,"16097",162,135,135,1,0,"PODEMOS",9
16,"16111",171,138,137,2,1,"PODEMOS",23
16,"16254",216,181,179,5,2,"PODEMOS",17
16,"16040",85,71,71,0,0,"PODEMOS",9
16,"16103",265,217,217,0,0,"PODEMOS",8
16,"16070",32,31,31,0,0,"PODEMOS",1
16,"16025",25,21,21,1,0,"PODEMOS",1
16,"16205",114,89,88,0,1,"PODEMOS",21
16,"16217",75,58,58,0,0,"PODEMOS",3
16,"16903",1081,824,816,6,8,"PODEMOS",31
16,"16227",112,84,84,0,0,"PODEMOS",10
16,"16216",317,275,267,0,8,"PODEMOS",38
16,"16140",27,15,15,0,0,"PODEMOS",1
16,"16063",98,87,87,0,0,"PODEMOS",5
16,"16079",32,21,20,0,1,"PODEMOS",2
16,"16022",78,63,61,0,2,"PODEMOS",5
16,"16045",221,166,164,1,2,"PODEMOS",26
16,"16049",156,121,121,0,0,"PODEMOS",5
16,"16186",465,394,387,2,7,"PODEMOS",27
48,"48093",900,673,664,4,9,"IU-UpeC",0
48,"48022",2355,1476,1468,9,8,"IU-UpeC",19
48,"48907",355,283,282,2,1,"IU-UpeC",0
48,"48040",1299,896,884,5,12,"IU-UpeC",7
48,"48020",274076,193807,192607,1471,1200,"IU-UpeC",6011
48,"48061",762,584,581,4,3,"IU-UpeC",10
48,"48069",12765,8985,8910,58,75,"IU-UpeC",122
48,"48089",3266,2425,2406,23,19,"IU-UpeC",61
48,"48032",5735,4173,4151,32,22,"IU-UpeC",60
48,"48041",704,558,555,4,3,"IU-UpeC",8
48,"48049",548,433,431,0,2,"IU-UpeC",3
48,"48092",837,619,619,13,0,"IU-UpeC",0
48,"48901",4775,3602,3573,35,29,"IU-UpeC",105
48,"48009",786,614,609,3,5,"IU-UpeC",2
48,"48044",62989,46989,46783,385,206,"IU-UpeC",947
48,"48048",562,399,394,3,5,"IU-UpeC",12
48,"48042",1384,1111,1091,7,20,"IU-UpeC",31
48,"48007",365,241,239,0,2,"IU-UpeC",3
48,"48030",608,454,453,4,1,"IU-UpeC",0
48,"48033",215,160,159,0,1,"IU-UpeC",1
48,"48909",207,165,165,1,0,"IU-UpeC",0
48,"48097",1303,907,898,10,9,"IU-UpeC",14
48,"48024",1003,775,771,5,4,"IU-UpeC",5
48,"48067",1161,837,834,2,3,"IU-UpeC",5
48,"48090",6022,4544,4483,23,61,"IU-UpeC",90
48,"48088",135,97,96,0,1,"IU-UpeC",3
48,"48018",875,553,553,3,0,"IU-UpeC",2
48,"48021",1352,952,946,8,6,"IU-UpeC",6
48,"48078",38742,28064,27837,231,227,"IU-UpeC",1173
48,"48064",603,463,459,7,4,"IU-UpeC",5
48,"48072",974,728,723,5,5,"IU-UpeC",3
48,"48071",6118,4467,4412,32,55,"IU-UpeC",113
48,"48015",33690,24299,24160,168,139,"IU-UpeC",722
48,"48056",978,733,732,7,1,"IU-UpeC",0
48,"48073",6952,4476,4435,43,41,"IU-UpeC",34
48,"48016",5260,3856,3827,22,29,"IU-UpeC",96
48,"48001",5832,4191,4166,37,25,"IU-UpeC",69
48,"48028",715,553,551,4,2,"IU-UpeC",1
48,"48002",7851,5767,5713,41,54,"IU-UpeC",204
48,"48051",220,169,168,0,1,"IU-UpeC",0
48,"48019",3594,2569,2544,16,25,"IU-UpeC",40
48,"48046",12617,9037,8967,56,70,"IU-UpeC",84
48,"48076",314,237,237,4,0,"IU-UpeC",3
48,"48065",3315,2447,2433,19,14,"IU-UpeC",35
48,"48091",1134,821,812,7,9,"IU-UpeC",4
48,"48043",4403,3214,3186,28,28,"IU-UpeC",63
48,"48003",14338,10497,10414,76,83,"IU-UpeC",248
48,"48082",37673,27006,26811,201,195,"IU-UpeC",962
48,"48052",1559,1215,1211,0,4,"IU-UpeC",16
48,"48008",617,433,424,6,9,"IU-UpeC",6
48,"48081",1883,1412,1398,12,14,"IU-UpeC",9
48,"48017",13290,8908,8856,42,52,"IU-UpeC",77
48,"48903",1838,1400,1385,4,15,"IU-UpeC",21
48,"48084",22577,15689,15540,108,149,"IU-UpeC",553
48,"48036",24144,17085,16954,117,131,"IU-UpeC",537
48,"48060",3645,2277,2274,7,3,"IU-UpeC",8
48,"48068",1551,1178,1163,16,15,"IU-UpeC",8
48,"48057",5749,4093,4081,20,12,"IU-UpeC",29
48,"48074",3333,2467,2428,20,39,"IU-UpeC",46
48,"48004",334,229,227,1,2,"IU-UpeC",2
48,"48011",9692,6891,6843,56,48,"IU-UpeC",175
48,"48045",5149,3940,3885,35,55,"IU-UpeC",62
48,"48066",346,256,256,1,0,"IU-UpeC",0
48,"48027",22033,15929,15825,113,104,"IU-UpeC",312
48,"48058",972,691,687,4,4,"IU-UpeC",4
48,"48910",2948,2126,2115,17,11,"IU-UpeC",38
48,"48904",3504,2671,2650,18,21,"IU-UpeC",39
48,"48075",1975,1440,1421,12,19,"IU-UpeC",18
48,"48050",198,153,150,0,3,"IU-UpeC",0
48,"48010",457,311,307,1,4,"IU-UpeC",7
48,"48026",1134,861,853,7,8,"IU-UpeC",10
48,"48037",678,518,509,2,9,"IU-UpeC",8
48,"48029",8332,6155,6119,35,36,"IU-UpeC",207
48,"48905",2565,1882,1847,2,35,"IU-UpeC",23
48,"48902",19124,13344,13227,93,117,"IU-UpeC",367
48,"48059",402,317,314,1,3,"IU-UpeC",0
48,"48034",12902,9684,9613,79,71,"IU-UpeC",523
48,"48035",412,313,312,4,1,"IU-UpeC",4
48,"48094",3193,2210,2200,18,10,"IU-UpeC",7
48,"48005",117,76,76,0,0,"IU-UpeC",0
48,"48062",300,241,240,1,1,"IU-UpeC",1
48,"48908",245,200,199,1,1,"IU-UpeC",1
48,"48086",2073,1519,1504,15,15,"IU-UpeC",36
48,"48013",79984,56928,56516,383,412,"IU-UpeC",2400
48,"48911",382,291,286,2,5,"IU-UpeC",5
48,"48070",545,378,374,2,4,"IU-UpeC",2
48,"48095",2352,1658,1647,6,11,"IU-UpeC",31
48,"48038",1122,834,824,0,10,"IU-UpeC",7
48,"48079",425,322,321,4,1,"IU-UpeC",0
48,"48083",6950,5128,5097,33,31,"IU-UpeC",197
48,"48054",24135,17493,17374,124,119,"IU-UpeC",515
48,"48063",373,289,288,1,1,"IU-UpeC",5
48,"48087",429,346,343,1,3,"IU-UpeC",2
48,"48914",330,275,275,1,0,"IU-UpeC",1
48,"48006",289,246,245,3,1,"IU-UpeC",1
48,"48014",1218,870,866,8,4,"IU-UpeC",8
48,"48906",775,579,574,0,5,"IU-UpeC",5
48,"48025",883,642,639,3,3,"IU-UpeC",2
48,"48055",2662,1961,1938,16,23,"IU-UpeC",24
48,"48031",340,245,242,0,3,"IU-UpeC",0
48,"48023",594,470,468,4,2,"IU-UpeC",3
48,"48039",243,201,201,2,0,"IU-UpeC",3
48,"48012",2041,1571,1553,11,18,"IU-UpeC",16
48,"48085",10301,7458,7407,50,51,"IU-UpeC",170
48,"48053",900,676,670,8,6,"IU-UpeC",4
48,"48912",2308,1787,1746,27,41,"IU-UpeC",34
48,"48047",161,112,112,0,0,"IU-UpeC",0
48,"48915",362,238,238,2,0,"IU-UpeC",3
48,"48077",3367,2438,2423,17,15,"IU-UpeC",51
48,"48913",1251,933,917,13,16,"IU-UpeC",9
48,"48096",6608,5071,5011,43,60,"IU-UpeC",103
48,"48080",9971,7148,7086,71,62,"IU-UpeC",267
12,"12135",35749,27015,26806,174,209,"SOMVAL",46
12,"12060",446,367,360,2,7,"SOMVAL",0
12,"12090",109,94,93,2,1,"SOMVAL",1
12,"12123",47,32,32,0,0,"SOMVAL",0
12,"12116",67,49,49,0,0,"SOMVAL",0
12,"12115",217,169,167,2,2,"SOMVAL",0
12,"12079",405,318,312,4,6,"SOMVAL",2
12,"12017",164,133,132,1,1,"SOMVAL",0
12,"12075",123,94,92,1,2,"SOMVAL",0
12,"12036",593,448,445,2,3,"SOMVAL",1
12,"12100",1345,1115,1098,6,17,"SOMVAL",1
12,"12138",19064,13610,13456,135,154,"SOMVAL",54
12,"12007",758,672,667,7,5,"SOMVAL",1
12,"12041",97,77,77,0,0,"SOMVAL",0
12,"12126",24480,18885,18687,115,198,"SOMVAL",61
12,"12099",542,434,405,9,29,"SOMVAL",0
12,"12009",17430,12600,12501,77,99,"SOMVAL",15
12,"12033",1907,1483,1436,11,47,"SOMVAL",6
12,"12108",463,395,390,0,5,"SOMVAL",3
12,"12005",8090,6113,6027,57,86,"SOMVAL",7
12,"12902",2148,1562,1536,9,26,"SOMVAL",1
12,"12141",101,80,80,0,0,"SOMVAL",0
12,"12012",2695,2236,2204,6,32,"SOMVAL",2
12,"12111",375,314,310,0,4,"SOMVAL",1
12,"12050",1320,1044,1032,8,12,"SOMVAL",0
12,"12043",581,470,459,4,11,"SOMVAL",0
12,"12042",621,520,512,13,8,"SOMVAL",0
12,"12102",536,452,437,1,15,"SOMVAL",0
12,"12070",524,418,408,8,10,"SOMVAL",0
12,"12133",60,49,49,0,0,"SOMVAL",0
12,"12074",784,690,678,9,12,"SOMVAL",0
12,"12095",974,789,784,8,5,"SOMVAL",1
12,"12034",1430,1078,1053,4,25,"SOMVAL",2
12,"12084",17599,13146,13022,98,124,"SOMVAL",9
12,"12064",97,83,82,0,1,"SOMVAL",1
12,"12027",17217,12263,12122,77,141,"SOMVAL",21
12,"12071",1280,1002,988,5,14,"SOMVAL",0
12,"12052",590,464,442,5,22,"SOMVAL",3
12,"12049",455,348,339,5,9,"SOMVAL",0
12,"12140",1140,961,950,5,11,"SOMVAL",0
12,"12055",106,79,79,2,0,"SOMVAL",0
12,"12015",96,83,81,0,2,"SOMVAL",0
12,"12098",588,479,473,4,6,"SOMVAL",0
12,"12038",171,121,120,1,1,"SOMVAL",1
12,"12097",67,55,54,0,1,"SOMVAL",0
12,"12121",1127,955,928,6,27,"SOMVAL",0
12,"12059",244,190,189,1,1,"SOMVAL",0
12,"12072",1117,962,937,8,25,"SOMVAL",0
12,"12110",244,173,170,1,3,"SOMVAL",0
12,"12129",1840,1391,1360,19,31,"SOMVAL",0
12,"12096",775,587,580,12,7,"SOMVAL",0
12,"12026",894,697,676,14,21,"SOMVAL",0
12,"12087",26,18,18,3,0,"SOMVAL",0
12,"12004",4204,3174,3130,19,44,"SOMVAL",1
12,"12083",95,82,80,0,2,"SOMVAL",0
12,"12016",1582,1311,1295,9,16,"SOMVAL",2
12,"12130",404,339,332,0,7,"SOMVAL",0
12,"12142",161,124,123,0,1,"SOMVAL",0
12,"12106",1170,983,967,16,16,"SOMVAL",3
12,"12127",77,56,56,0,0,"SOMVAL",0
12,"12008",231,192,190,2,2,"SOMVAL",0
12,"12101",363,282,273,3,9,"SOMVAL",0
12,"12125",214,185,183,2,2,"SOMVAL",0
12,"12103",89,69,68,2,1,"SOMVAL",0
12,"12082",9655,7570,7492,38,78,"SOMVAL",39
12,"12113",85,69,69,2,0,"SOMVAL",0
12,"12002",116,98,96,0,2,"SOMVAL",0
12,"12006",176,140,140,1,0,"SOMVAL",1
12,"12024",139,115,113,1,2,"SOMVAL",0
12,"12014",184,140,136,1,4,"SOMVAL",0
12,"12117",3576,2786,2747,17,39,"SOMVAL",4
12,"12134",138,97,96,0,1,"SOMVAL",0
12,"12107",351,313,309,3,4,"SOMVAL",1
12,"12031",3830,3049,2987,20,62,"SOMVAL",0
12,"12061",378,275,275,4,0,"SOMVAL",0
12,"12068",49,34,34,1,0,"SOMVAL",0
12,"12137",37,26,26,1,0,"SOMVAL",0
12,"12091",185,145,141,3,4,"SOMVAL",0
12,"12053",2069,1691,1677,8,14,"SOMVAL",1
12,"12104",6954,5571,5470,26,101,"SOMVAL",5
12,"12056",285,243,238,3,5,"SOMVAL",1
12,"12021",4442,3486,3432,25,54,"SOMVAL",7
12,"12132",486,407,398,2,9,"SOMVAL",0
12,"12058",74,60,59,2,1,"SOMVAL",0
12,"12065",192,166,166,0,0,"SOMVAL",0
12,"12018",293,244,235,2,9,"SOMVAL",0
12,"12094",851,688,674,2,14,"SOMVAL",0
12,"12089",4331,3103,3050,25,53,"SOMVAL",3
12,"12080",1955,1647,1624,13,23,"SOMVAL",0
12,"12040",117832,89135,88464,525,671,"SOMVAL",65
12,"12092",112,84,84,0,0,"SOMVAL",0
12,"12069",74,50,49,0,1,"SOMVAL",0
12,"12046",193,154,153,3,1,"SOMVAL",0
12,"12022",340,273,269,1,4,"SOMVAL",0
12,"12039",840,726,719,2,7,"SOMVAL",1
12,"12057",606,495,487,3,8,"SOMVAL",3
12,"12025",137,106,106,0,0,"SOMVAL",0
12,"12088",69,58,58,0,0,"SOMVAL",0
12,"12901",3433,2691,2664,27,27,"SOMVAL",5
12,"12067",543,442,424,1,18,"SOMVAL",0
12,"12131",65,53,53,0,0,"SOMVAL",0
12,"12128",1400,1102,1091,11,11,"SOMVAL",0
12,"12073",156,132,131,0,1,"SOMVAL",0
12,"12093",189,147,145,1,2,"SOMVAL",1
12,"12109",647,531,520,1,11,"SOMVAL",1
12,"12013",148,119,116,4,3,"SOMVAL",0
12,"12045",354,282,279,2,3,"SOMVAL",0
12,"12076",87,70,70,1,0,"SOMVAL",0
12,"12003",991,762,752,10,10,"SOMVAL",0
12,"12032",23508,17400,17279,89,121,"SOMVAL",50
12,"12118",74,60,59,0,1,"SOMVAL",0
12,"12037",16,14,14,0,0,"SOMVAL",0
12,"12085",5061,3310,3264,20,46,"SOMVAL",5
12,"12051",477,337,335,2,2,"SOMVAL",1
12,"12001",1054,798,786,8,12,"SOMVAL",0
12,"12028",12566,9902,9830,55,72,"SOMVAL",10
12,"12124",1853,1411,1394,20,17,"SOMVAL",0
12,"12011",4587,3530,3480,30,50,"SOMVAL",5
12,"12105",851,666,659,5,7,"SOMVAL",0
12,"12077",4625,3443,3387,20,56,"SOMVAL",2
12,"12010",259,216,209,6,7,"SOMVAL",0
12,"12112",99,81,79,1,2,"SOMVAL",0
12,"12114",200,150,149,1,1,"SOMVAL",2
12,"12048",249,196,192,1,4,"SOMVAL",0
12,"12044",483,438,431,4,7,"SOMVAL",1
12,"12029",717,572,566,6,6,"SOMVAL",1
12,"12063",42,35,34,2,1,"SOMVAL",0
12,"12122",805,660,647,4,13,"SOMVAL",0
12,"12078",339,250,247,1,3,"SOMVAL",2
12,"12139",322,239,237,1,2,"SOMVAL",0
12,"12119",147,100,100,1,0,"SOMVAL",0
12,"12020",124,104,103,1,1,"SOMVAL",0
12,"12081",611,503,493,3,10,"SOMVAL",1
12,"12120",184,155,154,1,1,"SOMVAL",0
12,"12136",2657,2302,2252,22,50,"SOMVAL",2
30,"30025",4900,3777,3727,20,50,"RECORTES CE",2
30,"30040",727,627,620,1,7,"RECORTES CE",0
30,"30041",13640,9156,9092,52,64,"RECORTES CE",13
30,"30030",312625,235232,233576,1438,1656,"RECORTES CE",490
30,"30008",13860,10066,9945,74,121,"RECORTES CE",28
30,"30043",24972,19411,19139,154,272,"RECORTES CE",25
30,"30014",1598,1270,1258,5,12,"RECORTES CE",1
30,"30034",1138,859,846,5,13,"RECORTES CE",1
30,"30007",6415,4554,4515,19,39,"RECORTES CE",7
30,"30036",14624,10139,9988,70,151,"RECORTES CE",16
30,"30038",15381,10881,10797,51,84,"RECORTES CE",17
30,"30031",498,424,421,2,3,"RECORTES CE",0
30,"30011",4706,3582,3541,20,41,"RECORTES CE",2
30,"30028",6690,5005,4938,29,67,"RECORTES CE",3
30,"30027",47867,36054,35794,181,260,"RECORTES CE",60
30,"30021",9101,6106,6034,25,72,"RECORTES CE",15
30,"30022",16894,11661,11498,119,163,"RECORTES CE",9
30,"30005",29559,21408,21203,123,205,"RECORTES CE",40
30,"30017",11635,8718,8646,46,72,"RECORTES CE",5
30,"30033",10144,7591,7505,86,86,"RECORTES CE",6
30,"30010",6861,5287,5220,38,67,"RECORTES CE",9
30,"30039",19199,13538,13405,101,133,"RECORTES CE",16
30,"30037",18726,13183,13027,73,156,"RECORTES CE",30
30,"30035",18616,13185,13085,70,100,"RECORTES CE",25
30,"30029",11815,8365,8296,67,69,"RECORTES CE",10
30,"30019",25921,18079,17894,121,185,"RECORTES CE",19
30,"30001",4596,3602,3572,20,30,"RECORTES CE",3
30,"30012",9101,7170,7091,46,79,"RECORTES CE",4
30,"30032",2849,2188,2161,10,27,"RECORTES CE",3
30,"30018",7903,5990,5912,29,78,"RECORTES CE",7
30,"30004",1141,938,933,5,5,"RECORTES CE",1
30,"30023",3762,2871,2837,14,34,"RECORTES CE",5
30,"30020",6261,4502,4459,25,43,"RECORTES CE",2
30,"30016",151577,103359,102538,620,821,"RECORTES CE",231
30,"30006",803,683,681,2,2,"RECORTES CE",1
30,"30003",24305,16558,16419,122,139,"RECORTES CE",14
30,"30013",7395,5320,5277,38,43,"RECORTES CE",3
30,"30015",19154,13947,13835,77,112,"RECORTES CE",19
30,"30026",15722,10147,10024,49,123,"RECORTES CE",14
30,"30009",12392,9724,9599,40,125,"RECORTES CE",15
30,"30902",8022,5454,5412,34,42,"RECORTES CE",4
30,"30002",9921,7263,7166,34,97,"RECORTES CE",4
30,"30901",10331,7925,7833,54,92,"RECORTES CE",16
30,"30042",1918,1518,1500,6,18,"RECORTES CE",2
30,"30024",58529,42392,42072,275,320,"RECORTES CE",62
31,"31105",1535,1208,1187,18,21,"PODEMOS",166
31,"31213",105,70,70,0,0,"PODEMOS",15
31,"31017",361,248,246,4,2,"PODEMOS",45
31,"31182",37,27,27,0,0,"PODEMOS",9
31,"31051",253,176,176,2,0,"PODEMOS",34
31,"31165",2794,2057,2025,31,32,"PODEMOS",365
31,"31048",169,123,123,1,0,"PODEMOS",12
31,"31044",290,223,220,1,3,"PODEMOS",24
31,"31174",110,75,73,0,2,"PODEMOS",17
31,"31210",199,146,145,2,1,"PODEMOS",12
31,"31903",6593,4699,4660,28,39,"PODEMOS",1380
31,"31119",40,22,22,0,0,"PODEMOS",2
31,"31061",56,50,50,1,0,"PODEMOS",4
31,"31254",1920,1473,1458,7,15,"PODEMOS",296
31,"31142",1411,972,964,11,8,"PODEMOS",157
31,"31081",342,239,239,2,0,"PODEMOS",27
31,"31115",166,108,108,2,0,"PODEMOS",20
31,"31247",152,112,109,0,3,"PODEMOS",8
31,"31258",7841,5961,5927,56,34,"PODEMOS",1662
31,"31231",115,81,81,1,0,"PODEMOS",11
31,"31901",15475,11855,11771,121,84,"PODEMOS",3087
31,"31152",1347,999,990,16,9,"PODEMOS",195
31,"31034",40,29,29,1,0,"PODEMOS",3
31,"31032",1733,1295,1285,26,10,"PODEMOS",267
31,"31024",102,52,52,0,0,"PODEMOS",17
31,"31071",17,17,17,0,0,"PODEMOS",2
31,"31222",63,41,41,5,0,"PODEMOS",5
31,"31212",151,118,118,7,0,"PODEMOS",15
31,"31074",394,301,298,5,3,"PODEMOS",66
31,"31189",1170,739,731,10,8,"PODEMOS",159
31,"31187",111,70,70,1,0,"PODEMOS",12
31,"31149",2338,1534,1525,16,9,"PODEMOS",226
31,"31239",310,223,220,5,3,"PODEMOS",27
31,"31154",227,127,125,3,2,"PODEMOS",37
31,"31030",145,107,107,3,0,"PODEMOS",20
31,"31039",83,58,57,0,1,"PODEMOS",11
31,"31261",235,187,187,3,0,"PODEMOS",40
31,"31234",144,107,107,2,0,"PODEMOS",27
31,"31040",194,130,128,1,2,"PODEMOS",20
31,"31237",195,156,156,1,0,"PODEMOS",35
31,"31257",866,657,648,8,9,"PODEMOS",151
31,"31012",814,579,570,4,9,"PODEMOS",137
31,"31098",1918,1489,1483,23,6,"PODEMOS",385
31,"31176",2856,2077,2040,33,37,"PODEMOS",437
31,"31206",2095,1529,1513,19,16,"PODEMOS",354
31,"31020",454,235,232,2,3,"PODEMOS",51
31,"31064",1447,1161,1145,11,16,"PODEMOS",193
31,"31117",620,390,385,1,5,"PODEMOS",27
31,"31076",2407,2005,1986,28,19,"PODEMOS",295
31,"31132",146,115,113,1,2,"PODEMOS",12
31,"31227",8226,6191,6109,53,82,"PODEMOS",1690
31,"31118",165,122,121,2,1,"PODEMOS",24
31,"31155",253,191,189,3,2,"PODEMOS",39
31,"31241",134,94,89,0,5,"PODEMOS",15
31,"31183",681,581,578,10,3,"PODEMOS",115
31,"31095",76,66,64,1,2,"PODEMOS",5
31,"31199",150,101,101,3,0,"PODEMOS",8
31,"31083",56,41,39,0,2,"PODEMOS",9
31,"31175",72,50,49,0,1,"PODEMOS",6
31,"31244",156,87,84,1,3,"PODEMOS",17
31,"31140",116,82,82,2,0,"PODEMOS",9
31,"31033",49,29,29,1,0,"PODEMOS",9
31,"31201",147803,110800,110079,1040,721,"PODEMOS",24715
31,"31163",2017,1479,1447,15,32,"PODEMOS",237
31,"31014",274,197,197,4,0,"PODEMOS",38
31,"31219",88,63,62,0,1,"PODEMOS",9
31,"31131",871,664,658,13,6,"PODEMOS",123
31,"31007",136,94,93,1,1,"PODEMOS",14
31,"31196",39,34,34,0,0,"PODEMOS",11
31,"31159",1134,867,864,9,3,"PODEMOS",160
31,"31058",215,153,153,2,0,"PODEMOS",28
31,"31021",64,42,42,0,0,"PODEMOS",4
31,"31124",210,162,162,2,0,"PODEMOS",28
31,"31094",112,82,82,1,0,"PODEMOS",6
31,"31078",2447,1889,1861,25,28,"PODEMOS",432
31,"31905",2847,2108,2093,11,15,"PODEMOS",682
31,"31223",995,752,742,6,10,"PODEMOS",126
31,"31091",347,217,217,0,0,"PODEMOS",38
31,"31208",2569,2016,1992,21,24,"PODEMOS",419
31,"31252",87,68,68,0,0,"PODEMOS",15
31,"31209",157,108,108,0,0,"PODEMOS",42
31,"31088",5574,4194,4156,46,38,"PODEMOS",1243
31,"31027",838,595,589,7,6,"PODEMOS",68
31,"31135",102,67,62,0,5,"PODEMOS",4
31,"31047",261,191,187,6,4,"PODEMOS",18
31,"31153",2172,1463,1448,10,15,"PODEMOS",312
31,"31045",504,397,392,9,5,"PODEMOS",125
31,"31052",88,65,64,0,1,"PODEMOS",17
31,"31010",5721,3986,3946,27,40,"PODEMOS",922
31,"31232",25152,18432,18220,199,212,"PODEMOS",3950
31,"31125",275,194,191,2,3,"PODEMOS",44
31,"31085",471,353,351,3,2,"PODEMOS",111
31,"31203",40,29,29,0,0,"PODEMOS",3
31,"31179",509,361,355,5,6,"PODEMOS",62
31,"31122",4719,3671,3654,42,17,"PODEMOS",1082
31,"31084",1935,1389,1380,19,9,"PODEMOS",237
31,"31220",752,607,603,3,4,"PODEMOS",111
31,"31207",271,194,190,0,4,"PODEMOS",34
31,"31145",171,133,133,0,0,"PODEMOS",10
31,"31107",1707,1303,1294,12,9,"PODEMOS",113
31,"31907",10677,8568,8523,97,45,"PODEMOS",2438
31,"31029",925,662,648,6,14,"PODEMOS",112
31,"31185",501,345,342,4,3,"PODEMOS",27
31,"31023",6826,5609,5591,77,18,"PODEMOS",1398
31,"31192",159,132,131,0,1,"PODEMOS",49
31,"31251",3110,2347,2327,19,20,"PODEMOS",542
31,"31138",934,649,647,5,2,"PODEMOS",110
31,"31195",180,129,128,0,1,"PODEMOS",20
31,"31169",2217,1508,1489,15,19,"PODEMOS",221
31,"31229",50,40,40,0,0,"PODEMOS",5
31,"31093",293,210,206,2,4,"PODEMOS",34
31,"31086",12987,10342,10270,114,72,"PODEMOS",3001
31,"31249",1885,1350,1331,20,19,"PODEMOS",235
31,"31151",67,48,48,1,0,"PODEMOS",14
31,"31264",179,117,115,5,2,"PODEMOS",24
31,"31022",526,344,341,3,3,"PODEMOS",46
31,"31116",65,51,51,1,0,"PODEMOS",7
31,"31908",1008,709,704,11,5,"PODEMOS",169
31,"31111",96,75,75,2,0,"PODEMOS",11
31,"31127",143,97,97,2,0,"PODEMOS",15
31,"31037",86,64,64,0,0,"PODEMOS",7
31,"31112",94,67,66,0,1,"PODEMOS",10
31,"31139",159,102,101,3,1,"PODEMOS",24
31,"31097",10436,7461,7395,96,66,"PODEMOS",1498
31,"31009",690,508,504,5,4,"PODEMOS",147
31,"31198",36,29,29,0,0,"PODEMOS",6
31,"31150",213,154,152,1,2,"PODEMOS",45
31,"31177",262,171,170,3,1,"PODEMOS",53
31,"31104",1876,1355,1338,10,17,"PODEMOS",334
31,"31162",47,29,27,0,2,"PODEMOS",3
31,"31148",93,70,70,3,0,"PODEMOS",14
31,"31216",3882,2829,2810,31,19,"PODEMOS",736
31,"31057",1812,1375,1360,17,15,"PODEMOS",220
31,"31003",124,95,95,2,0,"PODEMOS",11
31,"31068",2893,2172,2138,27,34,"PODEMOS",436
31,"31904",1559,1095,1084,8,11,"PODEMOS",296
31,"31172",367,293,286,6,7,"PODEMOS",56
31,"31108",1878,1487,1475,14,12,"PODEMOS",222
31,"31110",90,65,65,2,0,"PODEMOS",17
31,"31053",532,395,391,4,4,"PODEMOS",86
31,"31215",4649,3412,3359,35,53,"PODEMOS",554
31,"31157",3546,2423,2399,32,24,"PODEMOS",488
31,"31066",867,647,638,8,9,"PODEMOS",94
31,"31050",6058,3902,3850,64,52,"PODEMOS",637
31,"31128",370,265,265,2,0,"PODEMOS",45
31,"31026",147,128,128,1,0,"PODEMOS",11
31,"31019",1809,1295,1288,23,7,"PODEMOS",306
31,"31036",921,664,657,5,7,"PODEMOS",126
31,"31226",585,346,344,1,2,"PODEMOS",69
31,"31025",768,560,560,5,0,"PODEMOS",125
31,"31211",25,12,12,2,0,"PODEMOS",0
31,"31013",661,439,437,1,2,"PODEMOS",134
31,"31170",49,39,39,1,0,"PODEMOS",10
31,"31225",36,29,29,0,0,"PODEMOS",3
31,"31043",38,30,30,0,0,"PODEMOS",0
31,"31202",4326,3045,3001,41,44,"PODEMOS",614
31,"31186",302,211,209,2,2,"PODEMOS",46
31,"31101",1390,1031,1028,11,3,"PODEMOS",296
31,"31906",2553,1945,1930,21,15,"PODEMOS",637
31,"31902",4346,3247,3228,23,19,"PODEMOS",890
31,"31256",109,70,70,0,0,"PODEMOS",5
31,"31158",252,181,178,2,3,"PODEMOS",44
31,"31250",2832,1921,1899,20,22,"PODEMOS",527
31,"31087",169,131,127,2,4,"PODEMOS",25
31,"31082",615,398,393,6,5,"PODEMOS",87
31,"31240",531,355,351,6,4,"PODEMOS",63
31,"31006",1952,1423,1400,14,23,"PODEMOS",294
31,"31262",206,180,180,2,0,"PODEMOS",52
31,"31248",295,174,168,2,6,"PODEMOS",16
31,"31049",704,488,486,1,2,"PODEMOS",90
31,"31181",150,116,116,0,0,"PODEMOS",11
31,"31054",460,308,304,7,4,"PODEMOS",54
31,"31002",424,312,310,7,2,"PODEMOS",78
31,"31184",61,43,43,2,0,"PODEMOS",3
31,"31164",582,464,457,3,7,"PODEMOS",65
31,"31067",1938,1424,1415,15,9,"PODEMOS",265
31,"31197",70,60,59,0,1,"PODEMOS",15
31,"31073",315,214,212,3,2,"PODEMOS",32
31,"31126",357,235,232,0,3,"PODEMOS",46
31,"31123",654,430,419,7,11,"PODEMOS",92
31,"31168",248,192,191,0,1,"PODEMOS",33
31,"31038",1348,1017,1005,13,12,"PODEMOS",199
31,"31063",88,72,68,2,4,"PODEMOS",7
31,"31031",221,141,140,0,1,"PODEMOS",18
31,"31265",86,61,61,0,0,"PODEMOS",10
31,"31004",35,22,22,1,0,"PODEMOS",3
31,"31001",90,74,74,5,0,"PODEMOS",20
31,"31046",60,38,38,0,0,"PODEMOS",3
31,"31188",227,173,173,2,0,"PODEMOS",50
31,"31263",236,142,142,2,0,"PODEMOS",21
31,"31245",83,54,54,1,0,"PODEMOS",2
31,"31137",208,93,93,3,0,"PODEMOS",17
31,"31243",314,236,234,5,2,"PODEMOS",66
31,"31217",337,233,230,1,3,"PODEMOS",67
31,"31080",510,412,411,8,1,"PODEMOS",90
31,"31238",110,96,94,2,2,"PODEMOS",31
31,"31167",827,624,615,13,9,"PODEMOS",137
31,"31236",1324,943,933,12,10,"PODEMOS",187
31,"31070",2652,1907,1888,16,19,"PODEMOS",344
31,"31233",96,72,71,0,1,"PODEMOS",8
31,"31204",37,33,33,2,0,"PODEMOS",4
31,"31120",394,264,263,5,1,"PODEMOS",57
31,"31214",93,70,69,0,1,"PODEMOS",10
31,"31246",140,108,103,2,5,"PODEMOS",16
31,"31133",44,30,30,1,0,"PODEMOS",3
31,"31130",310,214,213,7,1,"PODEMOS",39
31,"31100",264,186,186,2,0,"PODEMOS",31
31,"31173",873,704,680,3,24,"PODEMOS",84
31,"31075",101,68,67,1,1,"PODEMOS",28
31,"31121",64,45,45,2,0,"PODEMOS",13
31,"31242",253,165,164,1,1,"PODEMOS",41
31,"31092",662,458,455,4,3,"PODEMOS",78
31,"31260",1245,859,857,15,2,"PODEMOS",180
31,"31147",98,76,76,2,0,"PODEMOS",11
31,"31194",315,218,217,2,1,"PODEMOS",45
31,"31253",129,112,112,0,0,"PODEMOS",28
31,"31255",102,75,74,2,1,"PODEMOS",13
31,"31090",146,81,80,3,1,"PODEMOS",14
31,"31191",3018,2324,2297,23,27,"PODEMOS",637
31,"31055",259,177,173,2,4,"PODEMOS",26
31,"31230",107,86,85,0,1,"PODEMOS",17
31,"31114",362,272,269,6,3,"PODEMOS",89
31,"31160",107,81,80,0,1,"PODEMOS",19
31,"31144",804,482,479,2,3,"PODEMOS",73
31,"31141",109,70,66,1,4,"PODEMOS",15
31,"31065",1892,1420,1396,14,24,"PODEMOS",266
31,"31171",693,510,500,6,10,"PODEMOS",137
31,"31113",137,86,85,1,1,"PODEMOS",13
31,"31136",444,320,318,6,2,"PODEMOS",107
31,"31200",764,558,546,11,12,"PODEMOS",149
31,"31193",1414,1103,1094,12,9,"PODEMOS",292
31,"31015",2001,1468,1449,18,19,"PODEMOS",283
31,"31190",44,36,36,1,0,"PODEMOS",4
31,"31079",76,53,53,0,0,"PODEMOS",15
31,"31035",63,45,43,1,2,"PODEMOS",1
31,"31060",13723,10036,9970,78,66,"PODEMOS",3095
31,"31077",5384,4055,3999,49,56,"PODEMOS",769
31,"31161",344,273,270,4,3,"PODEMOS",77
31,"31134",178,132,130,1,2,"PODEMOS",17
31,"31178",495,364,364,4,0,"PODEMOS",88
31,"31129",393,265,261,2,4,"PODEMOS",26
31,"31224",914,668,659,6,9,"PODEMOS",99
31,"31018",409,312,311,9,1,"PODEMOS",83
31,"31205",427,330,326,7,4,"PODEMOS",77
31,"31056",179,137,133,0,4,"PODEMOS",41
31,"31028",211,133,133,0,0,"PODEMOS",24
31,"31062",1088,866,853,4,13,"PODEMOS",159
31,"31008",80,57,54,0,3,"PODEMOS",6
31,"31143",98,59,58,1,1,"PODEMOS",11
31,"31005",296,205,204,0,1,"PODEMOS",62
31,"31059",191,142,141,1,1,"PODEMOS",25
31,"31259",485,325,324,3,1,"PODEMOS",54
31,"31103",46,32,32,1,0,"PODEMOS",2
31,"31069",847,643,636,4,7,"PODEMOS",110
31,"31102",146,66,66,1,0,"PODEMOS",12
31,"31221",1211,844,825,4,19,"PODEMOS",165
31,"31235",166,111,111,0,0,"PODEMOS",17
31,"31106",689,565,559,1,6,"PODEMOS",85
31,"31156",252,193,193,0,0,"PODEMOS",46
31,"31180",216,173,173,5,0,"PODEMOS",36
31,"31041",1583,1125,1110,14,15,"PODEMOS",311
31,"31016",7642,5866,5822,52,44,"PODEMOS",2018
31,"31099",63,52,52,1,0,"PODEMOS",5
31,"31089",242,188,185,1,3,"PODEMOS",23
31,"31072",5288,3916,3846,32,70,"PODEMOS",658
31,"31011",697,494,491,5,3,"PODEMOS",143
31,"31166",260,186,186,2,0,"PODEMOS",22
31,"31096",115,95,92,2,3,"PODEMOS",11
31,"31042",2744,2081,2053,19,28,"PODEMOS",233
31,"31146",35,30,30,2,0,"PODEMOS",5
31,"31228",496,382,381,2,1,"PODEMOS",111
31,"31109",1562,1184,1177,6,7,"PODEMOS",318
12,"12100",1345,1115,1098,6,17,"IFem",0
12,"12042",621,520,512,13,8,"IFem",0
12,"12052",590,464,442,5,22,"IFem",0
12,"12123",47,32,32,0,0,"IFem",0
12,"12901",3433,2691,2664,27,27,"IFem",0
12,"12016",1582,1311,1295,9,16,"IFem",0
12,"12115",217,169,167,2,2,"IFem",0
12,"12071",1280,1002,988,5,14,"IFem",0
12,"12119",147,100,100,1,0,"IFem",0
12,"12001",1054,798,786,8,12,"IFem",0
12,"12027",17217,12263,12122,77,141,"IFem",10
12,"12105",851,666,659,5,7,"IFem",0
12,"12126",24480,18885,18687,115,198,"IFem",10
12,"12020",124,104,103,1,1,"IFem",1
12,"12131",65,53,53,0,0,"IFem",0
12,"12050",1320,1044,1032,8,12,"IFem",0
12,"12008",231,192,190,2,2,"IFem",0
12,"12129",1840,1391,1360,19,31,"IFem",1
12,"12134",138,97,96,0,1,"IFem",0
12,"12061",378,275,275,4,0,"IFem",0
12,"12104",6954,5571,5470,26,101,"IFem",3
12,"12049",455,348,339,5,9,"IFem",0
12,"12118",74,60,59,0,1,"IFem",0
12,"12099",542,434,405,9,29,"IFem",0
12,"12141",101,80,80,0,0,"IFem",0
12,"12094",851,688,674,2,14,"IFem",1
12,"12097",67,55,54,0,1,"IFem",0
12,"12018",293,244,235,2,9,"IFem",0
12,"12015",96,83,81,0,2,"IFem",1
12,"12017",164,133,132,1,1,"IFem",0
12,"12058",74,60,59,2,1,"IFem",0
12,"12107",351,313,309,3,4,"IFem",0
12,"12033",1907,1483,1436,11,47,"IFem",0
12,"12090",109,94,93,2,1,"IFem",0
12,"12108",463,395,390,0,5,"IFem",0
12,"12065",192,166,166,0,0,"IFem",0
12,"12130",404,339,332,0,7,"IFem",0
12,"12021",4442,3486,3432,25,54,"IFem",0
12,"12041",97,77,77,0,0,"IFem",0
12,"12026",894,697,676,14,21,"IFem",0
12,"12059",244,190,189,1,1,"IFem",0
12,"12103",89,69,68,2,1,"IFem",0
12,"12074",784,690,678,9,12,"IFem",0
12,"12082",9655,7570,7492,38,78,"IFem",9
12,"12064",97,83,82,0,1,"IFem",0
12,"12142",161,124,123,0,1,"IFem",0
12,"12079",405,318,312,4,6,"IFem",0
12,"12051",477,337,335,2,2,"IFem",0
12,"12043",581,470,459,4,11,"IFem",0
12,"12040",117832,89135,88464,525,671,"IFem",80
12,"12125",214,185,183,2,2,"IFem",0
12,"12111",375,314,310,0,4,"IFem",0
12,"12007",758,672,667,7,5,"IFem",2
12,"12022",340,273,269,1,4,"IFem",0
12,"12137",37,26,26,1,0,"IFem",0
12,"12037",16,14,14,0,0,"IFem",0
12,"12014",184,140,136,1,4,"IFem",0
12,"12132",486,407,398,2,9,"IFem",0
12,"12055",106,79,79,2,0,"IFem",0
12,"12028",12566,9902,9830,55,72,"IFem",4
12,"12003",991,762,752,10,10,"IFem",0
12,"12096",775,587,580,12,7,"IFem",0
12,"12078",339,250,247,1,3,"IFem",0
12,"12102",536,452,437,1,15,"IFem",0
12,"12025",137,106,106,0,0,"IFem",0
12,"12095",974,789,784,8,5,"IFem",0
12,"12124",1853,1411,1394,20,17,"IFem",0
12,"12039",840,726,719,2,7,"IFem",1
12,"12084",17599,13146,13022,98,124,"IFem",12
12,"12068",49,34,34,1,0,"IFem",0
12,"12024",139,115,113,1,2,"IFem",0
12,"12139",322,239,237,1,2,"IFem",0
12,"12076",87,70,70,1,0,"IFem",0
12,"12080",1955,1647,1624,13,23,"IFem",0
12,"12127",77,56,56,0,0,"IFem",0
12,"12005",8090,6113,6027,57,86,"IFem",3
12,"12133",60,49,49,0,0,"IFem",0
12,"12114",200,150,149,1,1,"IFem",0
12,"12140",1140,961,950,5,11,"IFem",0
12,"12013",148,119,116,4,3,"IFem",0
12,"12088",69,58,58,0,0,"IFem",0
12,"12034",1430,1078,1053,4,25,"IFem",1
12,"12063",42,35,34,2,1,"IFem",0
12,"12004",4204,3174,3130,19,44,"IFem",1
12,"12045",354,282,279,2,3,"IFem",0
12,"12011",4587,3530,3480,30,50,"IFem",4
12,"12073",156,132,131,0,1,"IFem",0
12,"12902",2148,1562,1536,9,26,"IFem",1
12,"12120",184,155,154,1,1,"IFem",0
12,"12101",363,282,273,3,9,"IFem",0
12,"12069",74,50,49,0,1,"IFem",0
12,"12092",112,84,84,0,0,"IFem",0
12,"12031",3830,3049,2987,20,62,"IFem",2
12,"12113",85,69,69,2,0,"IFem",0
12,"12032",23508,17400,17279,89,121,"IFem",13
12,"12067",543,442,424,1,18,"IFem",0
12,"12006",176,140,140,1,0,"IFem",0
12,"12044",483,438,431,4,7,"IFem",0
12,"12010",259,216,209,6,7,"IFem",0
12,"12110",244,173,170,1,3,"IFem",0
12,"12070",524,418,408,8,10,"IFem",0
12,"12081",611,503,493,3,10,"IFem",0
12,"12098",588,479,473,4,6,"IFem",0
12,"12009",17430,12600,12501,77,99,"IFem",15
12,"12012",2695,2236,2204,6,32,"IFem",1
12,"12087",26,18,18,3,0,"IFem",0
12,"12075",123,94,92,1,2,"IFem",0
12,"12089",4331,3103,3050,25,53,"IFem",3
12,"12121",1127,955,928,6,27,"IFem",0
12,"12002",116,98,96,0,2,"IFem",0
12,"12072",1117,962,937,8,25,"IFem",1
12,"12112",99,81,79,1,2,"IFem",0
12,"12038",171,121,120,1,1,"IFem",0
12,"12046",193,154,153,3,1,"IFem",0
12,"12077",4625,3443,3387,20,56,"IFem",1
12,"12085",5061,3310,3264,20,46,"IFem",7
12,"12057",606,495,487,3,8,"IFem",2
12,"12053",2069,1691,1677,8,14,"IFem",1
12,"12036",593,448,445,2,3,"IFem",0
12,"12135",35749,27015,26806,174,209,"IFem",38
12,"12056",285,243,238,3,5,"IFem",0
12,"12128",1400,1102,1091,11,11,"IFem",1
12,"12116",67,49,49,0,0,"IFem",0
12,"12106",1170,983,967,16,16,"IFem",1
12,"12117",3576,2786,2747,17,39,"IFem",5
12,"12091",185,145,141,3,4,"IFem",0
12,"12109",647,531,520,1,11,"IFem",1
12,"12048",249,196,192,1,4,"IFem",1
12,"12029",717,572,566,6,6,"IFem",0
12,"12138",19064,13610,13456,135,154,"IFem",11
12,"12060",446,367,360,2,7,"IFem",1
12,"12093",189,147,145,1,2,"IFem",3
12,"12136",2657,2302,2252,22,50,"IFem",2
12,"12083",95,82,80,0,2,"IFem",0
12,"12122",805,660,647,4,13,"IFem",0
16,"16001",75,60,60,0,0,"UPYD",0
16,"16026",85,56,53,0,3,"UPYD",0
16,"16270",167,141,141,0,0,"UPYD",1
16,"16124",1870,1536,1518,7,18,"UPYD",1
16,"16013",31,28,28,0,0,"UPYD",0
16,"16143",16,12,12,2,0,"UPYD",0
16,"16084",49,37,32,0,5,"UPYD",0
16,"16215",248,177,172,1,5,"UPYD",1
16,"16171",1818,1514,1498,5,16,"UPYD",5
16,"16238",509,442,434,2,8,"UPYD",0
16,"16185",44,35,33,0,2,"UPYD",0
16,"16271",637,535,533,3,2,"UPYD",3
16,"16002",192,172,172,0,0,"UPYD",0
16,"16041",354,284,282,0,2,"UPYD",1
16,"16085",136,108,108,2,0,"UPYD",0
16,"16167",324,275,271,2,4,"UPYD",1
16,"16125",1676,1338,1326,9,12,"UPYD",4
16,"16014",613,493,487,1,6,"UPYD",2
16,"16126",783,654,648,2,6,"UPYD",1
16,"16029",96,73,71,0,2,"UPYD",0
16,"16055",703,512,509,7,3,"UPYD",5
16,"16007",1192,964,959,8,5,"UPYD",3
16,"16272",228,167,167,1,0,"UPYD",1
16,"16086",888,768,762,10,6,"UPYD",1
16,"16003",127,111,109,0,2,"UPYD",0
16,"16217",75,58,58,0,0,"UPYD",0
16,"16905",1217,965,956,9,9,"UPYD",6
16,"16128",63,54,54,2,0,"UPYD",0
16,"16273",324,252,252,2,0,"UPYD",0
16,"16043",99,73,73,1,0,"UPYD",0
16,"16218",189,155,154,1,1,"UPYD",1
16,"16169",58,33,32,0,1,"UPYD",0
16,"16016",234,173,172,2,1,"UPYD",0
16,"16004",274,212,206,0,6,"UPYD",0
16,"16170",698,524,517,1,7,"UPYD",4
16,"16906",82,67,67,1,0,"UPYD",0
16,"16156",101,76,75,0,1,"UPYD",0
16,"16129",104,82,79,1,3,"UPYD",1
16,"16071",20,20,20,0,0,"UPYD",0
16,"16017",370,300,296,2,4,"UPYD",0
16,"16188",90,63,62,0,1,"UPYD",1
16,"16219",91,72,72,0,0,"UPYD",0
16,"16005",256,191,187,1,4,"UPYD",0
16,"16274",127,100,100,0,0,"UPYD",0
16,"16088",114,92,92,0,0,"UPYD",0
16,"16079",32,21,20,0,1,"UPYD",0
16,"16203",9960,7515,7418,43,97,"UPYD",22
16,"16130",575,451,446,0,5,"UPYD",0
16,"16093",64,52,52,0,0,"UPYD",0
16,"16045",221,166,164,1,2,"UPYD",0
16,"16018",401,328,328,1,0,"UPYD",2
16,"16275",11,11,11,1,0,"UPYD",0
16,"16908",197,154,154,1,0,"UPYD",0
16,"16006",119,96,94,1,2,"UPYD",0
16,"16172",350,270,270,2,0,"UPYD",0
16,"16089",379,299,299,4,0,"UPYD",0
16,"16190",5127,4088,4025,42,63,"UPYD",6
16,"16224",84,68,67,1,1,"UPYD",2
16,"16158",546,437,431,7,6,"UPYD",0
16,"16131",134,97,97,1,0,"UPYD",0
16,"16060",760,600,593,5,7,"UPYD",0
16,"16050",251,195,194,1,1,"UPYD",0
16,"16205",114,89,88,0,1,"UPYD",0
16,"16276",21,17,17,0,0,"UPYD",0
16,"16046",250,181,180,1,1,"UPYD",0
16,"16173",207,155,154,1,1,"UPYD",0
16,"16244",722,625,617,2,8,"UPYD",2
16,"16277",118,86,84,0,2,"UPYD",2
16,"16910",96,70,70,0,0,"UPYD",0
16,"16091",68,51,49,0,2,"UPYD",0
16,"16199",31,24,24,0,0,"UPYD",0
16,"16008",95,72,72,0,0,"UPYD",0
16,"16147",62,43,43,0,0,"UPYD",0
16,"16047",230,176,176,2,0,"UPYD",0
16,"16227",112,84,84,0,0,"UPYD",0
16,"16132",34,26,26,0,0,"UPYD",0
16,"16092",161,130,129,1,1,"UPYD",1
16,"16078",41427,31365,31095,268,270,"UPYD",203
16,"16133",4391,3539,3509,27,30,"UPYD",11
16,"16174",192,155,155,1,0,"UPYD",0
16,"16192",50,30,29,0,1,"UPYD",0
16,"16278",73,55,55,0,0,"UPYD",0
16,"16009",66,48,48,0,0,"UPYD",1
16,"16228",177,132,131,1,1,"UPYD",1
16,"16119",169,121,120,0,1,"UPYD",0
16,"16242",325,281,278,1,3,"UPYD",0
16,"16193",70,57,57,1,0,"UPYD",0
16,"16022",78,63,61,0,2,"UPYD",0
16,"16903",1081,824,816,6,8,"UPYD",0
16,"16049",156,121,121,0,0,"UPYD",0
16,"16175",5113,4203,4124,35,79,"UPYD",11
16,"16134",4369,3412,3369,23,43,"UPYD",16
16,"16107",120,87,87,1,0,"UPYD",0
16,"16279",213,146,143,0,3,"UPYD",1
16,"16194",259,208,200,0,8,"UPYD",1
16,"16036",128,104,102,2,2,"UPYD",0
16,"16231",48,38,38,0,0,"UPYD",1
16,"16010",154,114,110,1,4,"UPYD",0
16,"16280",189,160,157,2,3,"UPYD",0
16,"16094",132,101,99,1,2,"UPYD",1
16,"16135",139,109,108,0,1,"UPYD",1
16,"16154",4904,3776,3730,47,46,"UPYD",19
16,"16176",39,28,28,0,0,"UPYD",0
16,"16095",84,71,68,0,3,"UPYD",1
16,"16108",49,43,42,0,1,"UPYD",1
16,"16195",498,380,376,1,4,"UPYD",1
16,"16011",28,19,19,0,0,"UPYD",0
16,"16234",30,19,19,1,0,"UPYD",0
16,"16137",56,34,33,0,1,"UPYD",0
16,"16051",147,118,118,0,0,"UPYD",1
16,"16191",926,760,752,6,8,"UPYD",1
16,"16142",139,110,109,2,1,"UPYD",0
16,"16177",78,63,63,0,0,"UPYD",0
16,"16901",707,520,513,3,7,"UPYD",1
16,"16012",82,69,69,0,0,"UPYD",0
16,"16025",25,21,21,1,0,"UPYD",0
16,"16066",2333,1917,1872,24,45,"UPYD",6
16,"16039",398,275,271,1,4,"UPYD",1
16,"16902",141,105,105,1,0,"UPYD",0
16,"16250",76,57,57,0,0,"UPYD",0
16,"16139",333,255,251,4,4,"UPYD",1
16,"16052",548,420,420,1,0,"UPYD",2
16,"16083",55,28,28,0,0,"UPYD",0
16,"16255",141,119,119,0,0,"UPYD",0
16,"16101",160,130,129,0,1,"UPYD",1
16,"16111",171,138,137,2,1,"UPYD",0
16,"16031",46,30,30,2,0,"UPYD",1
16,"16209",118,100,100,1,0,"UPYD",0
16,"16189",256,192,191,2,1,"UPYD",2
16,"16243",412,354,348,0,6,"UPYD",2
16,"16197",65,37,37,0,0,"UPYD",1
16,"16153",955,797,780,5,17,"UPYD",1
16,"16027",709,567,562,4,5,"UPYD",3
16,"16067",127,92,91,3,1,"UPYD",0
16,"16098",571,468,461,5,7,"UPYD",1
16,"16140",27,15,15,0,0,"UPYD",0
16,"16904",478,387,381,5,6,"UPYD",3
16,"16186",465,394,387,2,7,"UPYD",0
16,"16245",418,338,333,2,5,"UPYD",0
16,"16141",145,113,112,1,1,"UPYD",0
16,"16146",87,62,62,1,0,"UPYD",2
16,"16024",130,100,98,0,2,"UPYD",2
16,"16150",94,67,67,1,0,"UPYD",0
16,"16038",38,28,28,0,0,"UPYD",0
16,"16015",376,286,285,7,1,"UPYD",2
16,"16239",141,110,107,0,3,"UPYD",1
16,"16159",225,170,168,0,2,"UPYD",0
16,"16117",1057,814,808,2,6,"UPYD",5
16,"16099",208,157,152,0,5,"UPYD",0
16,"16103",265,217,217,0,0,"UPYD",0
16,"16249",1986,1593,1570,8,23,"UPYD",1
16,"16246",484,382,375,1,7,"UPYD",1
16,"16100",684,587,580,5,7,"UPYD",1
16,"16074",40,31,31,0,0,"UPYD",0
16,"16240",108,79,79,0,0,"UPYD",0
16,"16056",465,333,322,0,11,"UPYD",1
16,"16062",24,21,21,0,0,"UPYD",0
16,"16123",82,54,53,0,1,"UPYD",0
16,"16030",25,22,22,1,0,"UPYD",0
16,"16044",39,28,27,0,1,"UPYD",0
16,"16087",212,186,186,5,0,"UPYD",0
16,"16040",85,71,71,0,0,"UPYD",0
16,"16057",78,60,60,0,0,"UPYD",0
16,"16148",587,511,511,1,0,"UPYD",2
16,"16023",468,344,343,3,1,"UPYD",2
16,"16032",287,230,230,1,0,"UPYD",0
16,"16072",147,103,102,0,1,"UPYD",0
16,"16266",373,279,273,1,6,"UPYD",0
16,"16035",258,192,192,3,0,"UPYD",0
16,"16063",98,87,87,0,0,"UPYD",0
16,"16258",198,143,142,0,1,"UPYD",0
16,"16247",71,52,51,0,1,"UPYD",1
16,"16145",464,389,387,2,2,"UPYD",1
16,"16265",21,16,16,0,0,"UPYD",0
16,"16909",706,537,534,3,3,"UPYD",2
16,"16102",1231,922,911,8,11,"UPYD",3
16,"16216",317,275,267,0,8,"UPYD",0
16,"16237",113,89,87,0,2,"UPYD",0
16,"16163",74,63,63,0,0,"UPYD",0
16,"16081",49,38,37,0,1,"UPYD",1
16,"16151",64,60,60,0,0,"UPYD",0
16,"16073",188,158,158,0,0,"UPYD",0
16,"16122",254,200,198,4,2,"UPYD",0
16,"16236",914,694,689,6,5,"UPYD",0
16,"16033",1729,1385,1365,7,20,"UPYD",2
16,"16068",145,117,114,2,3,"UPYD",1
16,"16253",357,279,279,1,0,"UPYD",0
16,"16225",76,58,57,0,1,"UPYD",0
16,"16019",217,168,166,1,2,"UPYD",0
16,"16155",506,415,414,2,1,"UPYD",0
16,"16058",105,81,80,0,1,"UPYD",0
16,"16160",61,46,45,1,1,"UPYD",0
16,"16020",17,11,11,0,0,"UPYD",0
16,"16042",1192,1021,1005,6,16,"UPYD",2
16,"16263",961,754,745,4,9,"UPYD",1
16,"16061",964,798,790,13,8,"UPYD",2
16,"16251",1858,1450,1420,8,30,"UPYD",4
16,"16181",64,53,53,0,0,"UPYD",0
16,"16212",255,208,206,1,2,"UPYD",0
16,"16152",40,35,35,0,0,"UPYD",0
16,"16206",208,163,162,4,1,"UPYD",0
16,"16048",412,312,310,1,2,"UPYD",0
16,"16264",433,374,370,2,4,"UPYD",3
16,"16196",633,538,527,2,11,"UPYD",1
16,"16053",429,352,348,5,4,"UPYD",1
16,"16162",43,35,35,0,0,"UPYD",0
16,"16112",1505,1088,1072,9,16,"UPYD",4
16,"16202",783,573,566,3,7,"UPYD",2
16,"16065",406,323,319,3,4,"UPYD",2
16,"16259",30,26,26,1,0,"UPYD",0
16,"16157",213,185,182,0,3,"UPYD",0
16,"16106",2729,2130,2095,19,35,"UPYD",2
16,"16211",377,253,250,3,3,"UPYD",0
16,"16097",162,135,135,1,0,"UPYD",2
16,"16149",153,130,129,0,1,"UPYD",0
16,"16198",1365,1067,1052,12,15,"UPYD",5
16,"16204",272,207,207,1,0,"UPYD",0
16,"16115",44,33,33,0,0,"UPYD",0
16,"16110",97,71,70,0,1,"UPYD",0
16,"16254",216,181,179,5,2,"UPYD",1
16,"16034",183,153,153,1,0,"UPYD",0
16,"16064",681,588,581,1,7,"UPYD",1
16,"16109",43,32,32,0,0,"UPYD",0
16,"16096",273,249,244,2,5,"UPYD",0
16,"16248",872,711,696,11,15,"UPYD",2
16,"16121",259,205,205,3,0,"UPYD",1
16,"16113",3080,2309,2278,15,31,"UPYD",9
16,"16104",54,40,40,0,0,"UPYD",0
16,"16070",32,31,31,0,0,"UPYD",0
16,"16118",1405,1147,1136,11,11,"UPYD",3
16,"16161",58,53,53,0,0,"UPYD",0
16,"16082",305,224,224,0,0,"UPYD",0
16,"16116",84,62,62,0,0,"UPYD",0
16,"16166",247,182,177,0,5,"UPYD",2
16,"16213",35,28,28,1,0,"UPYD",0
16,"16269",426,351,349,3,2,"UPYD",3
16,"16187",77,52,52,1,0,"UPYD",0
16,"16165",63,51,50,1,1,"UPYD",0
22,"22009",619,463,461,5,2,"PP-PAR",123
22,"22032",107,74,71,0,3,"PP-PAR",16
22,"22149",302,236,236,2,0,"PP-PAR",84
22,"22181",93,62,62,1,0,"PP-PAR",24
22,"22156",264,202,200,3,2,"PP-PAR",63
22,"22187",286,224,221,1,3,"PP-PAR",76
22,"22236",249,198,198,1,0,"PP-PAR",79
22,"22902",219,162,160,1,2,"PP-PAR",65
22,"22242",64,45,44,1,1,"PP-PAR",24
22,"22203",82,68,67,0,1,"PP-PAR",30
22,"22232",96,73,70,2,3,"PP-PAR",36
22,"22165",490,375,372,2,3,"PP-PAR",158
22,"22053",787,541,535,12,6,"PP-PAR",182
22,"22217",395,307,301,3,6,"PP-PAR",124
22,"22076",305,224,223,0,1,"PP-PAR",87
22,"22003",143,119,119,0,0,"PP-PAR",45
22,"22164",35,26,26,1,0,"PP-PAR",12
22,"22015",324,238,236,3,2,"PP-PAR",87
22,"22130",10106,6957,6909,57,48,"PP-PAR",1945
22,"22019",180,156,155,0,1,"PP-PAR",40
22,"22155",77,58,58,2,0,"PP-PAR",31
22,"22029",127,101,100,2,1,"PP-PAR",45
22,"22230",290,224,223,2,1,"PP-PAR",67
22,"22048",12633,9215,9141,90,74,"PP-PAR",3092
22,"22037",116,95,94,1,1,"PP-PAR",35
22,"22235",100,77,77,0,0,"PP-PAR",32
22,"22213",3029,2225,2181,17,44,"PP-PAR",797
22,"22227",211,153,151,3,2,"PP-PAR",45
22,"22253",61,51,50,0,1,"PP-PAR",19
22,"22199",7029,5024,4977,55,47,"PP-PAR",1273
22,"22014",245,184,183,2,1,"PP-PAR",67
22,"22133",117,89,89,4,0,"PP-PAR",24
22,"22184",188,156,156,2,0,"PP-PAR",84
22,"22244",52,38,38,0,0,"PP-PAR",19
22,"22175",197,140,140,0,0,"PP-PAR",50
22,"22117",2497,1788,1770,16,18,"PP-PAR",703
22,"22088",157,116,116,1,0,"PP-PAR",33
22,"22023",430,329,329,2,0,"PP-PAR",136
22,"22020",114,90,90,2,0,"PP-PAR",36
22,"22239",89,78,76,4,2,"PP-PAR",40
22,"22004",136,79,79,0,0,"PP-PAR",25
22,"22028",379,297,293,1,4,"PP-PAR",91
22,"22195",235,190,189,2,1,"PP-PAR",74
22,"22110",751,563,558,3,5,"PP-PAR",187
22,"22017",864,658,651,7,7,"PP-PAR",231
22,"22141",118,90,89,1,1,"PP-PAR",48
22,"22041",163,127,126,4,1,"PP-PAR",70
22,"22903",654,542,536,3,6,"PP-PAR",200
22,"22077",381,295,293,5,2,"PP-PAR",103
22,"22115",364,270,267,4,3,"PP-PAR",122
22,"22160",209,161,161,3,0,"PP-PAR",54
22,"22221",80,60,59,0,1,"PP-PAR",22
22,"22178",104,87,87,1,0,"PP-PAR",33
22,"22024",225,174,173,0,1,"PP-PAR",39
22,"22186",186,139,137,3,2,"PP-PAR",44
22,"22222",527,390,389,5,1,"PP-PAR",124
22,"22142",98,81,79,1,2,"PP-PAR",50
22,"22167",498,397,388,7,9,"PP-PAR",166
22,"22173",234,158,157,0,1,"PP-PAR",47
22,"22116",1443,1048,1038,12,10,"PP-PAR",400
22,"22059",1137,839,828,7,11,"PP-PAR",248
22,"22040",148,123,121,2,2,"PP-PAR",52
22,"22027",325,218,214,0,4,"PP-PAR",78
22,"22062",162,113,113,3,0,"PP-PAR",42
22,"22126",91,65,65,0,0,"PP-PAR",37
22,"22039",869,682,681,5,1,"PP-PAR",219
22,"22150",464,348,348,1,0,"PP-PAR",120
22,"22225",2691,1849,1817,24,32,"PP-PAR",725
22,"22012",111,84,82,0,2,"PP-PAR",31
22,"22063",175,140,140,2,0,"PP-PAR",53
22,"22248",118,92,91,0,1,"PP-PAR",23
22,"22086",215,162,162,4,0,"PP-PAR",45
22,"22201",269,189,189,0,0,"PP-PAR",38
22,"22013",295,235,233,2,2,"PP-PAR",85
22,"22205",434,334,333,2,1,"PP-PAR",82
22,"22245",306,258,257,3,1,"PP-PAR",131
22,"22162",129,101,101,0,0,"PP-PAR",40
22,"22058",190,152,151,2,1,"PP-PAR",45
22,"22249",119,97,97,1,0,"PP-PAR",20
22,"22089",315,227,222,6,5,"PP-PAR",78
22,"22057",364,260,259,1,1,"PP-PAR",46
22,"22190",113,83,83,2,0,"PP-PAR",22
22,"22226",774,591,589,2,2,"PP-PAR",209
22,"22129",183,128,127,2,1,"PP-PAR",60
22,"22021",1970,1485,1469,14,16,"PP-PAR",455
22,"22182",256,177,176,2,1,"PP-PAR",57
22,"22135",192,146,144,0,2,"PP-PAR",61
22,"22072",192,148,147,1,1,"PP-PAR",37
22,"22042",118,102,100,1,2,"PP-PAR",38
22,"22084",534,413,411,3,2,"PP-PAR",143
22,"22157",194,151,151,1,0,"PP-PAR",40
22,"22111",152,114,113,0,1,"PP-PAR",51
22,"22119",1296,950,940,3,10,"PP-PAR",354
22,"22200",251,191,189,0,2,"PP-PAR",70
22,"22193",283,235,234,3,1,"PP-PAR",85
22,"22207",125,89,88,3,1,"PP-PAR",25
22,"22204",1095,816,805,10,11,"PP-PAR",321
22,"22107",123,79,78,2,1,"PP-PAR",26
22,"22177",102,77,77,2,0,"PP-PAR",30
22,"22085",107,92,90,2,2,"PP-PAR",27
22,"22163",426,360,356,3,4,"PP-PAR",114
22,"22043",94,71,70,0,1,"PP-PAR",35
22,"22228",505,409,407,3,2,"PP-PAR",116
22,"22102",184,160,159,1,1,"PP-PAR",57
22,"22047",247,213,212,2,1,"PP-PAR",89
22,"22172",560,399,396,2,3,"PP-PAR",188
22,"22214",128,94,92,0,2,"PP-PAR",49
22,"22078",453,323,319,6,4,"PP-PAR",68
22,"22209",159,127,127,4,0,"PP-PAR",20
22,"22143",213,147,147,3,0,"PP-PAR",78
22,"22128",187,146,142,1,4,"PP-PAR",66
22,"22215",129,91,91,0,0,"PP-PAR",22
22,"22247",30,23,22,0,1,"PP-PAR",1
22,"22151",93,68,68,0,0,"PP-PAR",38
22,"22158",12005,8628,8554,78,74,"PP-PAR",2460
22,"22125",38845,28287,27998,283,289,"PP-PAR",8296
22,"22105",118,87,86,1,1,"PP-PAR",30
22,"22094",101,77,77,1,0,"PP-PAR",27
22,"22045",89,66,66,0,0,"PP-PAR",17
22,"22066",707,512,508,8,4,"PP-PAR",127
22,"22202",136,112,112,0,0,"PP-PAR",41
22,"22064",165,115,115,1,0,"PP-PAR",39
22,"22049",78,61,61,1,0,"PP-PAR",32
22,"22061",6685,4796,4740,38,56,"PP-PAR",1607
22,"22250",347,258,256,5,2,"PP-PAR",83
22,"22096",297,248,248,0,0,"PP-PAR",88
22,"22069",435,340,338,3,2,"PP-PAR",123
22,"22234",802,600,597,7,3,"PP-PAR",230
22,"22106",24,17,17,0,0,"PP-PAR",4
22,"22906",180,146,143,1,3,"PP-PAR",32
22,"22002",109,94,93,0,1,"PP-PAR",46
22,"22022",558,431,427,2,4,"PP-PAR",112
22,"22212",84,70,70,1,0,"PP-PAR",16
22,"22136",815,596,595,6,1,"PP-PAR",241
22,"22067",65,45,45,1,0,"PP-PAR",5
22,"22018",332,243,242,3,1,"PP-PAR",81
22,"22243",45,32,32,0,0,"PP-PAR",12
22,"22901",754,521,513,9,8,"PP-PAR",126
22,"22080",283,217,215,6,2,"PP-PAR",96
22,"22011",89,70,70,1,0,"PP-PAR",38
22,"22050",89,78,78,0,0,"PP-PAR",40
22,"22127",505,387,386,3,1,"PP-PAR",108
22,"22112",9592,6871,6820,76,51,"PP-PAR",2336
22,"22139",83,65,64,0,1,"PP-PAR",36
22,"22103",680,527,522,8,5,"PP-PAR",145
22,"22109",265,207,206,2,1,"PP-PAR",77
22,"22124",204,143,142,1,1,"PP-PAR",50
22,"22007",797,607,603,13,4,"PP-PAR",267
22,"22137",1071,729,719,6,10,"PP-PAR",239
22,"22168",20,15,15,1,0,"PP-PAR",1
22,"22099",490,378,377,4,1,"PP-PAR",137
22,"22254",1129,804,792,9,12,"PP-PAR",255
22,"22223",79,63,62,0,1,"PP-PAR",11
22,"22060",1165,885,879,3,6,"PP-PAR",268
22,"22044",254,191,188,3,3,"PP-PAR",54
22,"22174",485,400,396,6,4,"PP-PAR",191
22,"22144",248,195,195,0,0,"PP-PAR",94
22,"22114",123,80,79,4,1,"PP-PAR",37
22,"22087",72,48,48,1,0,"PP-PAR",35
22,"22052",942,743,741,9,2,"PP-PAR",230
22,"22090",102,75,75,0,0,"PP-PAR",21
22,"22252",122,93,91,1,2,"PP-PAR",33
22,"22170",642,518,509,4,9,"PP-PAR",193
22,"22095",73,48,48,1,0,"PP-PAR",10
22,"22905",294,224,224,2,0,"PP-PAR",100
22,"22188",87,66,66,1,0,"PP-PAR",20
22,"22206",201,141,140,2,1,"PP-PAR",31
22,"22131",83,63,63,3,0,"PP-PAR",16
22,"22025",1071,726,712,13,14,"PP-PAR",273
22,"22001",226,166,166,0,0,"PP-PAR",88
22,"22081",252,179,177,1,2,"PP-PAR",91
22,"22218",43,35,35,0,0,"PP-PAR",14
22,"22246",77,51,50,0,1,"PP-PAR",15
22,"22229",114,81,81,0,0,"PP-PAR",25
22,"22046",740,578,570,6,8,"PP-PAR",213
22,"22907",1459,1112,1104,21,8,"PP-PAR",356
22,"22016",613,447,444,8,3,"PP-PAR",139
22,"22904",835,600,594,6,6,"PP-PAR",244
22,"22251",371,283,281,4,2,"PP-PAR",143
22,"22176",174,140,140,1,0,"PP-PAR",72
22,"22233",82,61,61,0,0,"PP-PAR",22
22,"22074",315,229,226,3,3,"PP-PAR",68
22,"22113",494,362,361,3,1,"PP-PAR",133
22,"22068",82,65,65,3,0,"PP-PAR",16
22,"22208",178,142,140,0,2,"PP-PAR",33
22,"22079",118,86,86,2,0,"PP-PAR",27
22,"22035",244,171,168,3,3,"PP-PAR",35
22,"22908",207,144,140,1,4,"PP-PAR",45
22,"22055",325,252,245,5,7,"PP-PAR",92
22,"22008",173,138,138,3,0,"PP-PAR",68
22,"22909",318,238,234,2,4,"PP-PAR",73
22,"22006",298,217,215,1,2,"PP-PAR",55
22,"22197",479,378,373,6,5,"PP-PAR",138
22,"22122",62,49,49,1,0,"PP-PAR",23
22,"22220",169,123,122,2,1,"PP-PAR",51
22,"22075",126,82,81,2,1,"PP-PAR",16
22,"22083",474,400,396,1,4,"PP-PAR",161
22,"22036",91,82,82,0,0,"PP-PAR",44
22,"22082",298,222,220,2,2,"PP-PAR",90
22,"22189",184,140,137,1,3,"PP-PAR",44
22,"22054",1542,1126,1106,20,20,"PP-PAR",297
22,"22051",101,84,84,1,0,"PP-PAR",35
29,"29038",17555,11638,11562,124,76,"mlgXSÍ",18
29,"29060",706,524,516,0,8,"mlgXSÍ",0
29,"29010",1667,1336,1310,1,26,"mlgXSÍ",0
29,"29096",2806,2065,2034,19,31,"mlgXSÍ",0
29,"29074",785,612,611,4,1,"mlgXSÍ",0
29,"29058",1463,986,975,6,11,"mlgXSÍ",2
29,"29050",425,313,309,1,4,"mlgXSÍ",0
29,"29054",41888,29228,29022,205,206,"mlgXSÍ",38
29,"29005",4342,2946,2908,22,38,"mlgXSÍ",2
29,"29020",3265,2531,2504,17,27,"mlgXSÍ",55
29,"29079",2444,1880,1846,3,34,"mlgXSÍ",1
29,"29084",27393,19096,18886,192,210,"mlgXSÍ",11
29,"29019",888,675,672,0,3,"mlgXSÍ",0
29,"29037",212,166,165,1,1,"mlgXSÍ",0
29,"29095",3350,2523,2467,17,56,"mlgXSÍ",1
29,"29086",795,497,490,3,7,"mlgXSÍ",0
29,"29903",525,394,389,2,5,"mlgXSÍ",1
29,"29097",4117,2996,2947,43,49,"mlgXSÍ",0
29,"29056",1107,815,807,8,8,"mlgXSÍ",0
29,"29065",194,134,134,1,0,"mlgXSÍ",0
29,"29090",1704,1174,1165,10,9,"mlgXSÍ",0
29,"29098",1257,991,977,12,14,"mlgXSÍ",0
29,"29067",424770,295944,294094,2117,1850,"mlgXSÍ",386
29,"29057",376,285,284,2,1,"mlgXSÍ",0
29,"29100",2437,1775,1760,12,15,"mlgXSÍ",0
29,"29032",6708,5341,5265,26,76,"mlgXSÍ",2
29,"29053",1702,1178,1160,17,18,"mlgXSÍ",0
29,"29085",151,99,98,1,1,"mlgXSÍ",1
29,"29066",346,252,251,2,1,"mlgXSÍ",0
29,"29023",2047,1385,1369,2,16,"mlgXSÍ",2
29,"29039",2662,1948,1931,22,17,"mlgXSÍ",2
29,"29901",43601,30325,30130,188,195,"mlgXSÍ",24
29,"29072",3250,2466,2434,11,32,"mlgXSÍ",0
29,"29031",1633,1115,1106,6,9,"mlgXSÍ",1
29,"29904",428,363,360,2,3,"mlgXSÍ",0
29,"29062",658,564,561,0,3,"mlgXSÍ",0
29,"29059",2590,2100,2058,11,42,"mlgXSÍ",2
29,"29014",219,138,138,1,0,"mlgXSÍ",0
29,"29083",2114,1587,1568,10,19,"mlgXSÍ",2
29,"29092",567,423,415,4,8,"mlgXSÍ",1
29,"29068",6885,4580,4511,43,69,"mlgXSÍ",1
29,"29025",39210,26938,26747,160,191,"mlgXSÍ",25
29,"29001",4196,3276,3253,26,23,"mlgXSÍ",3
29,"29088",2720,1930,1883,21,47,"mlgXSÍ",0
29,"29069",85333,56398,55854,443,544,"mlgXSÍ",43
29,"29011",2920,1962,1946,5,16,"mlgXSÍ",1
29,"29048",1428,1168,1155,9,13,"mlgXSÍ",0
29,"29077",208,156,153,0,3,"mlgXSÍ",0
29,"29075",12952,8681,8619,55,62,"mlgXSÍ",3
29,"29042",14078,9890,9776,75,114,"mlgXSÍ",18
29,"29003",1002,777,769,1,8,"mlgXSÍ",1
29,"29087",380,283,276,1,7,"mlgXSÍ",0
29,"29043",2503,1671,1638,17,33,"mlgXSÍ",0
29,"29047",1131,927,914,4,13,"mlgXSÍ",0
29,"29089",3254,2465,2438,10,27,"mlgXSÍ",0
29,"29071",938,640,633,6,7,"mlgXSÍ",0
29,"29029",420,322,315,4,7,"mlgXSÍ",0
29,"29061",1018,833,820,4,13,"mlgXSÍ",2
29,"29093",2235,1689,1667,12,22,"mlgXSÍ",0
29,"29902",2560,1735,1709,13,26,"mlgXSÍ",0
29,"29013",1612,1282,1272,6,10,"mlgXSÍ",0
29,"29044",811,557,556,3,1,"mlgXSÍ",0
29,"29045",1685,1232,1223,4,9,"mlgXSÍ",0
29,"29006",680,482,474,3,8,"mlgXSÍ",0
29,"29080",6704,4812,4766,44,46,"mlgXSÍ",4
29,"29018",2026,1560,1519,15,41,"mlgXSÍ",2
29,"29035",1587,1218,1208,0,10,"mlgXSÍ",0
29,"29015",31884,23160,22943,188,217,"mlgXSÍ",49
29,"29004",328,240,238,2,2,"mlgXSÍ",0
29,"29063",336,255,251,2,4,"mlgXSÍ",0
29,"29051",40201,27168,26842,229,326,"mlgXSÍ",17
29,"29016",253,188,188,1,0,"mlgXSÍ",0
29,"29070",39913,26993,26751,203,242,"mlgXSÍ",62
29,"29082",31505,23154,22990,127,164,"mlgXSÍ",19
29,"29046",2690,1974,1954,17,20,"mlgXSÍ",3
29,"29040",1964,1321,1301,12,20,"mlgXSÍ",0
29,"29052",226,155,152,0,3,"mlgXSÍ",0
29,"29027",2343,1737,1722,6,15,"mlgXSÍ",0
29,"29076",2163,1508,1482,8,26,"mlgXSÍ",2
29,"29012",9765,7029,6944,58,85,"mlgXSÍ",9
29,"29022",185,143,143,1,0,"mlgXSÍ",0
29,"29028",1249,881,881,4,0,"mlgXSÍ",0
29,"29099",960,741,734,3,7,"mlgXSÍ",2
29,"29021",162,114,107,13,7,"mlgXSÍ",0
29,"29064",506,372,365,2,7,"mlgXSÍ",6
29,"29041",3146,2251,2216,26,35,"mlgXSÍ",1
29,"29026",1065,776,766,4,10,"mlgXSÍ",1
29,"29091",8966,6437,6346,57,91,"mlgXSÍ",5
29,"29033",1132,808,804,2,4,"mlgXSÍ",1
29,"29007",27319,19557,19395,179,162,"mlgXSÍ",29
29,"29017",6610,5001,4938,25,63,"mlgXSÍ",2
29,"29034",466,361,359,0,2,"mlgXSÍ",0
29,"29055",1808,1415,1396,13,19,"mlgXSÍ",0
29,"29024",393,271,256,4,15,"mlgXSÍ",1
29,"29049",2987,2204,2185,25,19,"mlgXSÍ",1
29,"29030",809,653,651,2,2,"mlgXSÍ",1
29,"29002",1203,855,842,6,13,"mlgXSÍ",0
29,"29073",1560,1126,1120,5,6,"mlgXSÍ",0
29,"29009",1477,1113,1100,3,13,"mlgXSÍ",0
29,"29081",258,205,200,1,5,"mlgXSÍ",0
29,"29094",57313,39393,39052,280,341,"mlgXSÍ",42
29,"29036",636,481,475,3,6,"mlgXSÍ",0
29,"29008",14541,9954,9820,90,134,"mlgXSÍ",16
12,"12009",17430,12600,12501,77,99,"VOX",16
12,"12118",74,60,59,0,1,"VOX",0
12,"12131",65,53,53,0,0,"VOX",0
12,"12027",17217,12263,12122,77,141,"VOX",22
12,"12016",1582,1311,1295,9,16,"VOX",5
12,"12126",24480,18885,18687,115,198,"VOX",28
12,"12901",3433,2691,2664,27,27,"VOX",5
12,"12017",164,133,132,1,1,"VOX",0
12,"12071",1280,1002,988,5,14,"VOX",0
12,"12041",97,77,77,0,0,"VOX",0
12,"12007",758,672,667,7,5,"VOX",0
12,"12049",455,348,339,5,9,"VOX",0
12,"12040",117832,89135,88464,525,671,"VOX",410
12,"12028",12566,9902,9830,55,72,"VOX",28
12,"12010",259,216,209,6,7,"VOX",0
12,"12123",47,32,32,0,0,"VOX",1
12,"12015",96,83,81,0,2,"VOX",0
12,"12125",214,185,183,2,2,"VOX",1
12,"12057",606,495,487,3,8,"VOX",0
12,"12092",112,84,84,0,0,"VOX",0
12,"12008",231,192,190,2,2,"VOX",0
12,"12045",354,282,279,2,3,"VOX",0
12,"12026",894,697,676,14,21,"VOX",0
12,"12055",106,79,79,2,0,"VOX",0
12,"12038",171,121,120,1,1,"VOX",0
12,"12052",590,464,442,5,22,"VOX",2
12,"12003",991,762,752,10,10,"VOX",0
12,"12088",69,58,58,0,0,"VOX",0
12,"12132",486,407,398,2,9,"VOX",0
12,"12141",101,80,80,0,0,"VOX",1
12,"12094",851,688,674,2,14,"VOX",1
12,"12037",16,14,14,0,0,"VOX",0
12,"12024",139,115,113,1,2,"VOX",1
12,"12004",4204,3174,3130,19,44,"VOX",11
12,"12134",138,97,96,0,1,"VOX",0
12,"12099",542,434,405,9,29,"VOX",2
12,"12050",1320,1044,1032,8,12,"VOX",0
12,"12079",405,318,312,4,6,"VOX",1
12,"12083",95,82,80,0,2,"VOX",0
12,"12102",536,452,437,1,15,"VOX",0
12,"12135",35749,27015,26806,174,209,"VOX",55
12,"12029",717,572,566,6,6,"VOX",2
12,"12022",340,273,269,1,4,"VOX",0
12,"12139",322,239,237,1,2,"VOX",0
12,"12093",189,147,145,1,2,"VOX",0
12,"12137",37,26,26,1,0,"VOX",0
12,"12105",851,666,659,5,7,"VOX",5
12,"12077",4625,3443,3387,20,56,"VOX",9
12,"12001",1054,798,786,8,12,"VOX",1
12,"12117",3576,2786,2747,17,39,"VOX",5
12,"12013",148,119,116,4,3,"VOX",0
12,"12025",137,106,106,0,0,"VOX",0
12,"12078",339,250,247,1,3,"VOX",0
12,"12005",8090,6113,6027,57,86,"VOX",8
12,"12032",23508,17400,17279,89,121,"VOX",91
12,"12076",87,70,70,1,0,"VOX",0
12,"12085",5061,3310,3264,20,46,"VOX",7
12,"12140",1140,961,950,5,11,"VOX",3
12,"12084",17599,13146,13022,98,124,"VOX",37
12,"12113",85,69,69,2,0,"VOX",1
12,"12114",200,150,149,1,1,"VOX",0
12,"12104",6954,5571,5470,26,101,"VOX",7
12,"12058",74,60,59,2,1,"VOX",2
12,"12048",249,196,192,1,4,"VOX",0
12,"12111",375,314,310,0,4,"VOX",0
12,"12110",244,173,170,1,3,"VOX",0
12,"12069",74,50,49,0,1,"VOX",0
12,"12096",775,587,580,12,7,"VOX",1
12,"12006",176,140,140,1,0,"VOX",0
12,"12112",99,81,79,1,2,"VOX",0
12,"12068",49,34,34,1,0,"VOX",0
12,"12120",184,155,154,1,1,"VOX",0
12,"12081",611,503,493,3,10,"VOX",1
12,"12124",1853,1411,1394,20,17,"VOX",1
12,"12097",67,55,54,0,1,"VOX",1
12,"12115",217,169,167,2,2,"VOX",0
12,"12061",378,275,275,4,0,"VOX",1
12,"12059",244,190,189,1,1,"VOX",2
12,"12063",42,35,34,2,1,"VOX",0
12,"12103",89,69,68,2,1,"VOX",0
12,"12034",1430,1078,1053,4,25,"VOX",1
12,"12129",1840,1391,1360,19,31,"VOX",1
12,"12011",4587,3530,3480,30,50,"VOX",2
12,"12020",124,104,103,1,1,"VOX",0
12,"12064",97,83,82,0,1,"VOX",0
12,"12080",1955,1647,1624,13,23,"VOX",1
12,"12056",285,243,238,3,5,"VOX",0
12,"12122",805,660,647,4,13,"VOX",0
12,"12002",116,98,96,0,2,"VOX",0
12,"12100",1345,1115,1098,6,17,"VOX",12
12,"12039",840,726,719,2,7,"VOX",0
12,"12043",581,470,459,4,11,"VOX",0
12,"12091",185,145,141,3,4,"VOX",0
12,"12075",123,94,92,1,2,"VOX",0
12,"12073",156,132,131,0,1,"VOX",0
12,"12036",593,448,445,2,3,"VOX",0
12,"12033",1907,1483,1436,11,47,"VOX",3
12,"12044",483,438,431,4,7,"VOX",0
12,"12046",193,154,153,3,1,"VOX",0
12,"12119",147,100,100,1,0,"VOX",0
12,"12031",3830,3049,2987,20,62,"VOX",7
12,"12130",404,339,332,0,7,"VOX",0
12,"12121",1127,955,928,6,27,"VOX",1
12,"12074",784,690,678,9,12,"VOX",1
12,"12053",2069,1691,1677,8,14,"VOX",1
12,"12067",543,442,424,1,18,"VOX",1
12,"12070",524,418,408,8,10,"VOX",0
12,"12042",621,520,512,13,8,"VOX",0
12,"12090",109,94,93,2,1,"VOX",0
12,"12018",293,244,235,2,9,"VOX",1
12,"12060",446,367,360,2,7,"VOX",2
12,"12095",974,789,784,8,5,"VOX",2
12,"12133",60,49,49,0,0,"VOX",0
12,"12107",351,313,309,3,4,"VOX",2
12,"12065",192,166,166,0,0,"VOX",0
12,"12082",9655,7570,7492,38,78,"VOX",32
12,"12012",2695,2236,2204,6,32,"VOX",5
12,"12014",184,140,136,1,4,"VOX",0
12,"12072",1117,962,937,8,25,"VOX",3
12,"12136",2657,2302,2252,22,50,"VOX",10
12,"12142",161,124,123,0,1,"VOX",0
12,"12098",588,479,473,4,6,"VOX",1
12,"12101",363,282,273,3,9,"VOX",0
12,"12116",67,49,49,0,0,"VOX",0
12,"12902",2148,1562,1536,9,26,"VOX",2
12,"12087",26,18,18,3,0,"VOX",0
12,"12089",4331,3103,3050,25,53,"VOX",5
12,"12109",647,531,520,1,11,"VOX",0
12,"12127",77,56,56,0,0,"VOX",0
12,"12021",4442,3486,3432,25,54,"VOX",11
12,"12138",19064,13610,13456,135,154,"VOX",36
12,"12051",477,337,335,2,2,"VOX",0
12,"12108",463,395,390,0,5,"VOX",0
12,"12128",1400,1102,1091,11,11,"VOX",1
12,"12106",1170,983,967,16,16,"VOX",0
42,"42195",100,60,60,3,0,"PCPE",0
42,"42172",29,25,25,2,0,"PCPE",0
42,"42160",261,205,203,1,2,"PCPE",0
42,"42182",57,45,45,1,0,"PCPE",0
42,"42079",27,17,17,1,0,"PCPE",0
42,"42163",49,37,37,0,0,"PCPE",0
42,"42103",583,467,459,5,8,"PCPE",0
42,"42113",512,390,386,3,4,"PCPE",0
42,"42116",47,33,33,0,0,"PCPE",0
42,"42078",1031,752,744,6,8,"PCPE",0
42,"42176",29,23,23,0,0,"PCPE",0
42,"42057",175,106,104,1,2,"PCPE",0
42,"42037",34,17,17,1,0,"PCPE",0
42,"42153",14,14,14,1,0,"PCPE",0
42,"42149",393,300,293,1,7,"PCPE",0
42,"42046",51,43,43,1,0,"PCPE",0
42,"42197",76,61,59,1,2,"PCPE",0
42,"42154",97,78,78,1,0,"PCPE",0
42,"42042",47,38,38,2,0,"PCPE",0
42,"42108",12,10,10,0,0,"PCPE",0
42,"42011",17,10,10,0,0,"PCPE",0
42,"42001",279,219,215,2,4,"PCPE",0
42,"42164",1614,1208,1190,9,18,"PCPE",2
42,"42089",55,46,46,1,0,"PCPE",0
42,"42207",41,33,33,1,0,"PCPE",0
42,"42015",32,25,25,0,0,"PCPE",0
42,"42178",117,81,79,2,2,"PCPE",0
42,"42064",85,74,74,0,0,"PCPE",0
42,"42189",64,50,50,2,0,"PCPE",0
42,"42059",20,14,14,0,0,"PCPE",0
42,"42055",165,127,127,3,0,"PCPE",0
42,"42016",18,13,13,0,0,"PCPE",0
42,"42140",16,10,10,1,0,"PCPE",0
42,"42017",142,115,114,1,1,"PCPE",0
42,"42009",80,65,64,2,1,"PCPE",0
42,"42029",143,106,106,0,0,"PCPE",0
42,"42162",2363,1690,1672,21,18,"PCPE",5
42,"42141",111,79,79,0,0,"PCPE",0
42,"42105",49,42,42,0,0,"PCPE",0
42,"42044",53,49,47,3,2,"PCPE",0
42,"42087",45,38,37,0,1,"PCPE",0
42,"42119",164,97,97,2,0,"PCPE",0
42,"42095",1762,1319,1303,15,16,"PCPE",0
42,"42039",233,148,146,2,2,"PCPE",0
42,"42033",50,43,43,0,0,"PCPE",0
42,"42215",786,555,552,8,3,"PCPE",1
42,"42092",65,42,41,1,1,"PCPE",1
42,"42202",24,12,11,0,1,"PCPE",0
42,"42205",93,64,63,0,1,"PCPE",0
42,"42060",34,23,21,0,2,"PCPE",0
42,"42032",148,117,117,0,0,"PCPE",0
42,"42070",35,27,25,0,2,"PCPE",0
42,"42012",37,29,29,0,0,"PCPE",1
42,"42003",66,59,57,1,2,"PCPE",0
42,"42167",259,195,194,2,1,"PCPE",0
42,"42183",111,79,78,2,1,"PCPE",0
42,"42051",21,15,15,0,0,"PCPE",0
42,"42191",187,135,132,2,3,"PCPE",0
42,"42188",50,44,43,0,1,"PCPE",0
42,"42054",20,14,14,0,0,"PCPE",0
42,"42028",70,49,49,0,0,"PCPE",0
42,"42085",191,136,136,2,0,"PCPE",0
42,"42200",84,60,60,2,0,"PCPE",0
42,"42217",31,25,25,0,0,"PCPE",0
42,"42096",281,181,178,8,3,"PCPE",0
42,"42081",143,111,106,2,5,"PCPE",0
42,"42056",22,19,19,0,0,"PCPE",0
42,"42030",95,77,76,3,1,"PCPE",0
42,"42174",180,149,148,1,1,"PCPE",1
42,"42198",22,17,17,0,0,"PCPE",0
42,"42021",85,53,53,1,0,"PCPE",0
42,"42100",32,31,31,1,0,"PCPE",0
42,"42053",26,21,21,1,0,"PCPE",0
42,"42043",3796,2833,2792,26,41,"PCPE",6
42,"42049",120,75,73,1,2,"PCPE",0
42,"42212",69,54,54,3,0,"PCPE",0
42,"42166",60,40,40,0,0,"PCPE",0
42,"42036",50,39,38,0,1,"PCPE",0
42,"42181",419,318,312,3,6,"PCPE",0
42,"42031",26,19,19,0,0,"PCPE",0
42,"42065",22,20,19,0,1,"PCPE",0
42,"42129",692,522,516,4,6,"PCPE",0
42,"42159",38,33,32,1,1,"PCPE",0
42,"42177",71,55,54,1,1,"PCPE",0
42,"42019",516,367,363,4,4,"PCPE",0
42,"42130",60,51,50,3,1,"PCPE",0
42,"42007",117,86,86,2,0,"PCPE",0
42,"42124",64,44,44,0,0,"PCPE",0
42,"42062",25,16,15,0,1,"PCPE",0
42,"42139",22,16,16,0,0,"PCPE",0
42,"42117",148,113,111,3,2,"PCPE",0
42,"42196",11,10,10,0,0,"PCPE",0
42,"42206",8,5,5,0,0,"PCPE",0
42,"42041",35,25,25,0,0,"PCPE",0
42,"42024",87,68,67,0,1,"PCPE",0
42,"42192",41,31,31,1,0,"PCPE",0
42,"42123",165,119,119,4,0,"PCPE",0
42,"42084",26,21,21,0,0,"PCPE",0
42,"42069",1529,1078,1066,10,12,"PCPE",0
42,"42155",173,105,104,1,1,"PCPE",0
42,"42004",2296,1767,1748,32,19,"PCPE",2
42,"42094",608,470,463,9,7,"PCPE",0
42,"42187",63,55,54,1,1,"PCPE",0
42,"42013",35,28,28,0,0,"PCPE",0
42,"42086",38,29,29,1,0,"PCPE",0
42,"42106",15,9,9,0,0,"PCPE",0
42,"42218",80,54,54,1,0,"PCPE",0
42,"42127",40,27,27,1,0,"PCPE",0
42,"42161",140,106,106,2,0,"PCPE",0
42,"42151",35,31,29,2,2,"PCPE",0
42,"42052",15,13,13,0,0,"PCPE",0
42,"42190",94,71,71,1,0,"PCPE",0
42,"42006",164,121,118,8,3,"PCPE",0
42,"42171",128,78,78,1,0,"PCPE",0
42,"42213",29,18,18,1,0,"PCPE",0
42,"42131",50,32,32,0,0,"PCPE",0
42,"42165",408,289,282,7,7,"PCPE",0
42,"42134",2642,1961,1938,24,23,"PCPE",0
42,"42194",176,127,126,2,1,"PCPE",0
42,"42209",146,111,108,3,3,"PCPE",2
42,"42118",23,16,16,0,0,"PCPE",0
42,"42082",9,8,8,1,0,"PCPE",0
42,"42097",21,14,14,0,0,"PCPE",0
42,"42020",4288,3087,3044,42,43,"PCPE",3
42,"42120",148,98,98,1,0,"PCPE",0
42,"42058",112,97,92,1,5,"PCPE",0
42,"42158",110,78,78,1,0,"PCPE",0
42,"42115",63,46,46,0,0,"PCPE",0
42,"42193",16,11,11,0,0,"PCPE",0
42,"42083",25,23,21,0,2,"PCPE",0
42,"42045",312,218,214,1,4,"PCPE",0
42,"42008",57,38,38,0,0,"PCPE",0
42,"42173",29201,21456,21181,272,275,"PCPE",28
42,"42201",23,23,22,0,1,"PCPE",0
42,"42088",71,53,53,0,0,"PCPE",0
42,"42090",93,70,69,1,1,"PCPE",0
42,"42050",31,18,18,0,0,"PCPE",0
42,"42076",219,176,173,4,3,"PCPE",0
42,"42121",64,48,48,1,0,"PCPE",0
42,"42110",63,46,46,0,0,"PCPE",0
42,"42144",442,357,352,5,5,"PCPE",0
42,"42156",30,21,21,0,0,"PCPE",0
42,"42128",39,37,37,1,0,"PCPE",0
42,"42063",49,37,37,1,0,"PCPE",1
42,"42035",782,566,562,4,4,"PCPE",0
42,"42023",66,53,53,0,0,"PCPE",0
42,"42125",81,66,66,2,0,"PCPE",0
42,"42152",82,59,59,1,0,"PCPE",0
42,"42204",56,39,38,0,1,"PCPE",0
42,"42216",25,21,21,0,0,"PCPE",0
42,"42073",72,56,56,0,0,"PCPE",0
42,"42075",87,63,63,1,0,"PCPE",0
42,"42022",214,171,171,2,0,"PCPE",0
42,"42145",137,121,121,3,0,"PCPE",0
42,"42148",10,10,10,0,0,"PCPE",0
42,"42027",76,56,56,0,0,"PCPE",0
42,"42026",24,20,20,0,0,"PCPE",0
42,"42071",169,111,109,2,2,"PCPE",1
42,"42068",85,62,61,2,1,"PCPE",0
42,"42048",67,53,51,1,2,"PCPE",0
42,"42018",152,116,114,0,2,"PCPE",0
42,"42219",43,32,32,0,0,"PCPE",0
42,"42098",11,6,6,0,0,"PCPE",0
42,"42107",74,51,48,1,3,"PCPE",0
42,"42135",75,53,53,1,0,"PCPE",0
42,"42025",1216,884,873,11,11,"PCPE",0
42,"42080",155,113,110,0,3,"PCPE",0
42,"42093",40,29,29,3,0,"PCPE",0
42,"42111",307,221,220,1,1,"PCPE",0
42,"42014",66,43,43,2,0,"PCPE",0
42,"42185",25,21,21,0,0,"PCPE",0
42,"42157",13,10,10,1,0,"PCPE",0
42,"42132",143,118,117,0,1,"PCPE",0
42,"42061",292,221,219,2,2,"PCPE",0
42,"42142",52,33,33,0,0,"PCPE",0
42,"42034",31,22,22,0,0,"PCPE",0
42,"42038",36,27,27,2,0,"PCPE",0
42,"42184",59,45,44,2,1,"PCPE",0
42,"42010",18,14,14,0,0,"PCPE",0
42,"42208",21,14,14,2,0,"PCPE",0
42,"42175",23,18,18,0,0,"PCPE",0
42,"42168",109,88,88,1,0,"PCPE",0
42,"42211",83,67,67,1,0,"PCPE",0
50,"50202",158,96,92,1,4,"PODEMOS",6
50,"50268",47,40,39,0,1,"PODEMOS",10
50,"50118",2179,1575,1564,7,11,"PODEMOS",200
50,"50231",260,213,210,7,3,"PODEMOS",25
50,"50222",1647,1135,1118,8,17,"PODEMOS",137
50,"50129",245,164,164,1,0,"PODEMOS",26
50,"50005",234,178,178,1,0,"PODEMOS",12
50,"50040",92,75,75,0,0,"PODEMOS",9
50,"50256",84,46,46,0,0,"PODEMOS",2
50,"50235",2323,1687,1675,7,12,"PODEMOS",339
50,"50011",127,96,96,2,0,"PODEMOS",11
50,"50043",257,172,171,1,1,"PODEMOS",18
50,"50225",1568,996,985,2,11,"PODEMOS",118
50,"50004",534,406,401,0,5,"PODEMOS",50
50,"50033",75,65,65,0,0,"PODEMOS",15
50,"50206",466,379,376,2,3,"PODEMOS",53
50,"50161",117,76,76,0,0,"PODEMOS",12
50,"50133",117,88,88,3,0,"PODEMOS",14
50,"50241",593,426,418,1,8,"PODEMOS",42
50,"50041",12,10,10,0,0,"PODEMOS",2
50,"50200",509,406,404,6,2,"PODEMOS",48
50,"50162",147,110,110,2,0,"PODEMOS",7
50,"50208",1802,1349,1332,16,17,"PODEMOS",165
50,"50036",103,79,79,0,0,"PODEMOS",14
50,"50290",387,288,287,4,1,"PODEMOS",40
50,"50204",2457,1830,1816,14,14,"PODEMOS",305
50,"50009",106,78,77,1,1,"PODEMOS",10
50,"50223",915,747,741,8,6,"PODEMOS",81
50,"50045",1255,944,934,6,10,"PODEMOS",110
50,"50263",197,123,121,6,2,"PODEMOS",22
50,"50026",442,358,353,6,5,"PODEMOS",61
50,"50130",395,252,252,1,0,"PODEMOS",21
50,"50217",455,334,334,1,0,"PODEMOS",25
50,"50218",113,90,89,1,1,"PODEMOS",10
50,"50082",89,58,57,0,1,"PODEMOS",2
50,"50071",131,90,90,0,0,"PODEMOS",5
50,"50081",512,376,372,6,4,"PODEMOS",41
50,"50098",181,129,127,2,2,"PODEMOS",15
50,"50107",944,772,767,16,5,"PODEMOS",86
50,"50012",108,86,83,1,3,"PODEMOS",14
50,"50164",395,263,260,2,3,"PODEMOS",44
50,"50270",38,24,24,2,0,"PODEMOS",6
50,"50198",56,30,30,0,0,"PODEMOS",0
50,"50248",521,407,406,1,1,"PODEMOS",59
50,"50019",54,41,41,0,0,"PODEMOS",3
50,"50003",126,93,92,3,1,"PODEMOS",5
50,"50228",270,211,210,5,1,"PODEMOS",7
50,"50285",648,473,469,3,4,"PODEMOS",68
50,"50272",12913,9500,9415,80,85,"PODEMOS",1934
50,"50108",47,37,37,0,0,"PODEMOS",5
50,"50159",670,511,501,5,10,"PODEMOS",52
50,"50135",95,63,63,0,0,"PODEMOS",10
50,"50132",755,573,564,7,9,"PODEMOS",114
50,"50279",87,62,62,1,0,"PODEMOS",3
50,"50169",362,264,262,0,2,"PODEMOS",37
50,"50255",214,163,163,0,0,"PODEMOS",15
50,"50096",39,17,17,0,0,"PODEMOS",6
50,"50196",108,83,82,1,1,"PODEMOS",9
50,"50278",198,145,144,1,1,"PODEMOS",13
50,"50172",196,138,136,0,2,"PODEMOS",16
50,"50191",476,327,325,3,2,"PODEMOS",43
50,"50074",6397,4512,4408,38,104,"PODEMOS",820
50,"50174",92,70,70,0,0,"PODEMOS",4
50,"50039",507,400,398,3,2,"PODEMOS",96
50,"50050",98,59,59,3,0,"PODEMOS",6
50,"50207",109,88,88,1,0,"PODEMOS",10
50,"50211",252,187,186,0,1,"PODEMOS",13
50,"50061",207,174,168,1,6,"PODEMOS",14
50,"50022",543,410,398,8,12,"PODEMOS",22
50,"50077",226,175,174,5,1,"PODEMOS",17
50,"50072",174,124,122,2,2,"PODEMOS",11
50,"50030",225,156,156,2,0,"PODEMOS",40
50,"50139",319,239,238,2,1,"PODEMOS",26
50,"50054",59,45,45,0,0,"PODEMOS",3
50,"50085",176,131,129,3,2,"PODEMOS",12
50,"50267",605,424,420,4,4,"PODEMOS",52
50,"50080",32,25,25,0,0,"PODEMOS",8
50,"50261",215,159,159,1,0,"PODEMOS",41
50,"50084",79,56,56,1,0,"PODEMOS",6
50,"50192",236,185,183,2,2,"PODEMOS",19
50,"50047",50,32,32,1,0,"PODEMOS",4
50,"50094",1626,1197,1178,22,19,"PODEMOS",144
50,"50013",224,187,186,3,1,"PODEMOS",18
50,"50295",45,39,39,0,0,"PODEMOS",1
50,"50238",97,74,73,0,1,"PODEMOS",15
50,"50183",338,255,255,0,0,"PODEMOS",23
50,"50234",245,198,193,9,5,"PODEMOS",22
50,"50066",2613,1956,1951,21,5,"PODEMOS",393
50,"50230",1176,853,849,11,4,"PODEMOS",110
50,"50028",78,53,53,2,0,"PODEMOS",7
50,"50116",190,142,140,1,2,"PODEMOS",20
50,"50232",171,120,118,0,2,"PODEMOS",31
50,"50141",114,85,84,0,1,"PODEMOS",15
50,"50131",237,168,167,2,1,"PODEMOS",12
50,"50119",930,698,691,7,7,"PODEMOS",59
50,"50246",41,29,29,0,0,"PODEMOS",2
50,"50057",1396,980,972,8,8,"PODEMOS",89
50,"50152",1457,1032,1018,11,14,"PODEMOS",109
50,"50090",156,112,111,0,1,"PODEMOS",7
50,"50215",23,15,15,0,0,"PODEMOS",1
50,"50273",31,18,18,0,0,"PODEMOS",1
50,"50032",273,190,189,0,1,"PODEMOS",29
50,"50287",274,197,195,4,2,"PODEMOS",31
50,"50195",53,38,38,0,0,"PODEMOS",6
50,"50277",55,43,43,1,0,"PODEMOS",9
50,"50236",104,82,82,2,0,"PODEMOS",2
50,"50073",2148,1649,1622,9,27,"PODEMOS",199
50,"50099",3087,2233,2216,15,17,"PODEMOS",264
50,"50002",148,105,102,0,3,"PODEMOS",3
50,"50237",103,73,73,2,0,"PODEMOS",12
50,"50257",178,139,137,0,2,"PODEMOS",18
50,"50205",91,69,65,1,4,"PODEMOS",6
50,"50078",244,192,189,1,3,"PODEMOS",34
50,"50154",119,92,91,0,1,"PODEMOS",6
50,"50068",1998,1388,1378,17,10,"PODEMOS",183
50,"50227",108,79,79,1,0,"PODEMOS",11
50,"50027",227,177,176,1,1,"PODEMOS",22
50,"50247",827,624,615,10,9,"PODEMOS",90
50,"50151",650,504,503,7,1,"PODEMOS",59
50,"50294",73,58,58,0,0,"PODEMOS",5
50,"50203",1043,811,802,15,9,"PODEMOS",203
50,"50069",76,53,52,0,1,"PODEMOS",7
50,"50179",257,207,207,2,0,"PODEMOS",16
50,"50137",1025,793,786,6,7,"PODEMOS",92
50,"50902",87,78,78,1,0,"PODEMOS",3
50,"50113",618,506,496,4,10,"PODEMOS",53
50,"50190",708,542,539,3,3,"PODEMOS",73
50,"50173",210,141,140,2,1,"PODEMOS",26
50,"50109",105,78,77,3,1,"PODEMOS",16
50,"50155",102,78,78,0,0,"PODEMOS",4
50,"50276",129,108,107,0,1,"PODEMOS",7
50,"50079",254,186,184,3,2,"PODEMOS",24
50,"50138",46,41,41,0,0,"PODEMOS",4
50,"50262",1187,931,930,13,1,"PODEMOS",149
50,"50242",92,81,79,1,2,"PODEMOS",15
50,"50214",27,16,16,1,0,"PODEMOS",3
50,"50221",33,20,20,0,0,"PODEMOS",4
50,"50067",14055,10236,10109,123,127,"PODEMOS",1477
50,"50194",84,52,52,0,0,"PODEMOS",2
50,"50184",113,82,82,0,0,"PODEMOS",5
50,"50060",176,138,136,0,2,"PODEMOS",29
50,"50298",5353,4051,4013,32,38,"PODEMOS",551
50,"50229",64,42,42,0,0,"PODEMOS",18
50,"50171",108,70,69,0,1,"PODEMOS",2
50,"50156",214,173,170,2,3,"PODEMOS",33
50,"50124",417,312,312,9,0,"PODEMOS",15
50,"50147",788,577,576,4,1,"PODEMOS",124
50,"50178",302,197,196,9,1,"PODEMOS",34
50,"50136",579,420,413,0,7,"PODEMOS",29
50,"50281",80,57,56,0,1,"PODEMOS",6
50,"50125",371,260,258,3,2,"PODEMOS",28
50,"50055",3612,2533,2490,34,43,"PODEMOS",393
50,"50271",256,187,184,4,3,"PODEMOS",9
50,"50062",1810,1407,1389,12,18,"PODEMOS",305
50,"50010",69,57,57,0,0,"PODEMOS",4
50,"50219",4098,3010,2980,27,30,"PODEMOS",742
50,"50052",90,71,71,0,0,"PODEMOS",4
50,"50148",324,240,236,0,4,"PODEMOS",20
50,"50210",40,32,31,0,1,"PODEMOS",0
50,"50065",53,42,42,0,0,"PODEMOS",9
50,"50140",165,106,106,0,0,"PODEMOS",13
50,"50053",688,535,522,6,13,"PODEMOS",31
50,"50017",1772,1301,1293,7,8,"PODEMOS",277
50,"50166",260,192,189,2,3,"PODEMOS",19
50,"50220",46,32,32,0,0,"PODEMOS",9
50,"50176",228,158,157,0,1,"PODEMOS",11
50,"50059",780,572,567,6,5,"PODEMOS",58
50,"50021",32,25,25,3,0,"PODEMOS",0
50,"50297",499531,377882,375565,3049,2317,"PODEMOS",77728
50,"50286",77,54,54,0,0,"PODEMOS",9
50,"50093",94,73,73,1,0,"PODEMOS",18
50,"50106",135,105,104,0,1,"PODEMOS",13
50,"50177",315,251,249,3,2,"PODEMOS",26
50,"50289",52,39,39,1,0,"PODEMOS",4
50,"50185",132,110,110,1,0,"PODEMOS",47
50,"50070",60,29,29,1,0,"PODEMOS",1
50,"50249",312,235,233,1,2,"PODEMOS",11
50,"50146",190,137,137,5,0,"PODEMOS",16
50,"50253",423,328,327,1,1,"PODEMOS",29
50,"50064",440,350,349,5,1,"PODEMOS",38
50,"50243",340,259,254,1,5,"PODEMOS",10
50,"50142",30,21,21,0,0,"PODEMOS",5
50,"50201",443,335,330,2,5,"PODEMOS",32
50,"50181",1003,750,737,9,13,"PODEMOS",134
50,"50254",181,130,129,2,1,"PODEMOS",13
50,"50114",124,94,94,2,0,"PODEMOS",18
50,"50188",30,23,19,0,4,"PODEMOS",0
50,"50288",3371,2566,2547,26,19,"PODEMOS",425
50,"50046",176,123,123,7,0,"PODEMOS",10
50,"50233",114,81,81,1,0,"PODEMOS",7
50,"50111",186,152,151,1,1,"PODEMOS",43
50,"50016",52,37,37,0,0,"PODEMOS",3
50,"50122",68,54,54,2,0,"PODEMOS",12
50,"50023",223,175,173,3,2,"PODEMOS",11
50,"50104",351,283,282,3,1,"PODEMOS",11
50,"50014",146,99,99,1,0,"PODEMOS",25
50,"50075",81,59,59,1,0,"PODEMOS",0
50,"50056",406,325,324,2,1,"PODEMOS",69
50,"50058",72,51,51,0,0,"PODEMOS",6
50,"50120",49,36,36,3,0,"PODEMOS",7
50,"50224",69,55,55,1,0,"PODEMOS",10
50,"50083",90,72,72,1,0,"PODEMOS",25
50,"50117",125,91,90,1,1,"PODEMOS",14
50,"50076",81,64,64,0,0,"PODEMOS",14
50,"50170",378,286,283,2,3,"PODEMOS",21
50,"50126",2388,1726,1708,22,18,"PODEMOS",160
50,"50163",3655,2766,2740,34,26,"PODEMOS",568
50,"50245",90,60,60,1,0,"PODEMOS",11
50,"50063",61,57,57,0,0,"PODEMOS",2
50,"50293",423,282,280,5,2,"PODEMOS",52
50,"50042",16,13,13,0,0,"PODEMOS",0
50,"50251",8300,6228,6167,62,61,"PODEMOS",1059
50,"50091",48,32,32,1,0,"PODEMOS",1
50,"50157",301,211,207,2,4,"PODEMOS",39
50,"50110",369,258,257,0,1,"PODEMOS",25
50,"50283",72,55,54,0,1,"PODEMOS",4
50,"50149",36,23,23,0,0,"PODEMOS",0
50,"50266",129,85,85,1,0,"PODEMOS",6
50,"50015",98,63,63,0,0,"PODEMOS",5
50,"50153",941,737,734,7,3,"PODEMOS",115
50,"50121",276,227,225,4,2,"PODEMOS",17
50,"50216",236,189,186,4,3,"PODEMOS",19
50,"50143",569,414,411,4,3,"PODEMOS",47
50,"50199",341,242,241,4,1,"PODEMOS",29
50,"50197",92,71,71,2,0,"PODEMOS",7
50,"50115",3248,2277,2262,31,15,"PODEMOS",292
50,"50187",70,38,38,0,0,"PODEMOS",11
50,"50134",128,88,88,5,0,"PODEMOS",5
50,"50006",939,712,701,8,11,"PODEMOS",104
50,"50264",158,111,111,0,0,"PODEMOS",18
50,"50209",2560,1787,1774,12,13,"PODEMOS",363
50,"50037",139,92,91,1,1,"PODEMOS",10
50,"50182",3352,2437,2409,26,28,"PODEMOS",428
50,"50100",333,263,261,5,2,"PODEMOS",23
50,"50193",647,514,506,1,8,"PODEMOS",130
50,"50048",35,23,23,0,0,"PODEMOS",13
50,"50128",28,24,24,0,0,"PODEMOS",5
50,"50051",828,640,637,8,3,"PODEMOS",41
50,"50038",1511,1167,1159,13,8,"PODEMOS",186
50,"50044",232,156,156,1,0,"PODEMOS",28
50,"50020",822,560,555,5,5,"PODEMOS",83
50,"50269",288,185,183,0,2,"PODEMOS",13
50,"50258",56,34,34,1,0,"PODEMOS",4
50,"50186",41,29,29,0,0,"PODEMOS",7
50,"50024",589,461,459,4,2,"PODEMOS",61
50,"50180",120,97,96,0,1,"PODEMOS",22
50,"50160",2245,1661,1648,10,13,"PODEMOS",345
50,"50035",74,53,52,0,1,"PODEMOS",33
50,"50087",28,19,19,0,0,"PODEMOS",1
50,"50092",298,256,251,3,5,"PODEMOS",22
50,"50123",465,349,344,2,5,"PODEMOS",40
50,"50903",2225,1686,1669,21,17,"PODEMOS",369
50,"50001",115,81,80,0,1,"PODEMOS",2
50,"50105",304,228,228,3,0,"PODEMOS",42
50,"50168",28,23,23,0,0,"PODEMOS",5
50,"50296",398,297,293,2,4,"PODEMOS",66
50,"50025",4547,3335,3295,45,40,"PODEMOS",381
50,"50102",863,665,654,6,11,"PODEMOS",97
50,"50008",5085,3617,3574,30,43,"PODEMOS",791
50,"50259",89,61,61,1,0,"PODEMOS",3
50,"50088",305,234,229,11,5,"PODEMOS",14
50,"50189",712,574,559,4,15,"PODEMOS",97
50,"50292",132,103,103,0,0,"PODEMOS",7
50,"50284",151,115,113,0,2,"PODEMOS",15
50,"50252",5178,3746,3711,36,35,"PODEMOS",461
50,"50167",232,194,193,0,1,"PODEMOS",26
50,"50213",98,77,72,0,5,"PODEMOS",2
50,"50291",100,69,69,0,0,"PODEMOS",7
50,"50260",35,32,32,0,0,"PODEMOS",5
50,"50175",1025,745,739,6,6,"PODEMOS",129
50,"50086",184,128,128,1,0,"PODEMOS",23
50,"50095",12366,8938,8856,94,82,"PODEMOS",1374
50,"50901",137,101,101,0,0,"PODEMOS",8
50,"50007",46,37,37,1,0,"PODEMOS",8
50,"50018",948,717,712,6,5,"PODEMOS",46
50,"50282",70,48,48,0,0,"PODEMOS",8
50,"50265",62,41,41,0,0,"PODEMOS",13
50,"50250",55,44,44,0,0,"PODEMOS",7
50,"50239",64,47,47,1,0,"PODEMOS",3
50,"50240",1034,749,737,10,12,"PODEMOS",124
50,"50089",8144,6285,6249,50,36,"PODEMOS",1234
50,"50275",110,73,72,0,1,"PODEMOS",6
50,"50034",838,572,569,5,3,"PODEMOS",79
50,"50029",627,469,468,4,1,"PODEMOS",46
50,"50212",41,37,37,0,0,"PODEMOS",4
50,"50165",1815,1333,1316,27,17,"PODEMOS",312
50,"50101",879,615,609,5,6,"PODEMOS",86
50,"50274",71,50,49,1,1,"PODEMOS",8
50,"50150",660,402,402,3,0,"PODEMOS",46
50,"50244",205,157,157,3,0,"PODEMOS",13
50,"50280",340,260,258,0,2,"PODEMOS",38
50,"50144",36,28,28,0,0,"PODEMOS",2
50,"50031",161,90,88,1,2,"PODEMOS",12
16,"16272",228,167,167,1,0,"C's",10
16,"16007",1192,964,959,8,5,"C's",68
16,"16215",248,177,172,1,5,"C's",9
16,"16197",65,37,37,0,0,"C's",6
16,"16146",87,62,62,1,0,"C's",4
16,"16271",637,535,533,3,2,"C's",26
16,"16050",251,195,194,1,1,"C's",6
16,"16102",1231,922,911,8,11,"C's",81
16,"16203",9960,7515,7418,43,97,"C's",918
16,"16125",1676,1338,1326,9,12,"C's",162
16,"16276",21,17,17,0,0,"C's",3
16,"16040",85,71,71,0,0,"C's",11
16,"16081",49,38,37,0,1,"C's",9
16,"16098",571,468,461,5,7,"C's",56
16,"16238",509,442,434,2,8,"C's",17
16,"16186",465,394,387,2,7,"C's",30
16,"16167",324,275,271,2,4,"C's",21
16,"16116",84,62,62,0,0,"C's",5
16,"16135",139,109,108,0,1,"C's",11
16,"16129",104,82,79,1,3,"C's",11
16,"16253",357,279,279,1,0,"C's",18
16,"16185",44,35,33,0,2,"C's",1
16,"16035",258,192,192,3,0,"C's",19
16,"16068",145,117,114,2,3,"C's",9
16,"16280",189,160,157,2,3,"C's",7
16,"16206",208,163,162,4,1,"C's",9
16,"16227",112,84,84,0,0,"C's",8
16,"16085",136,108,108,2,0,"C's",18
16,"16088",114,92,92,0,0,"C's",10
16,"16255",141,119,119,0,0,"C's",12
16,"16173",207,155,154,1,1,"C's",6
16,"16097",162,135,135,1,0,"C's",3
16,"16086",888,768,762,10,6,"C's",60
16,"16902",141,105,105,1,0,"C's",10
16,"16198",1365,1067,1052,12,15,"C's",110
16,"16038",38,28,28,0,0,"C's",0
16,"16157",213,185,182,0,3,"C's",12
16,"16158",546,437,431,7,6,"C's",51
16,"16190",5127,4088,4025,42,63,"C's",489
16,"16100",684,587,580,5,7,"C's",26
16,"16172",350,270,270,2,0,"C's",18
16,"16032",287,230,230,1,0,"C's",12
16,"16189",256,192,191,2,1,"C's",24
16,"16112",1505,1088,1072,9,16,"C's",71
16,"16089",379,299,299,4,0,"C's",38
16,"16176",39,28,28,0,0,"C's",3
16,"16045",221,166,164,1,2,"C's",4
16,"16132",34,26,26,0,0,"C's",2
16,"16034",183,153,153,1,0,"C's",13
16,"16091",68,51,49,0,2,"C's",2
16,"16277",118,86,84,0,2,"C's",11
16,"16118",1405,1147,1136,11,11,"C's",83
16,"16024",130,100,98,0,2,"C's",9
16,"16057",78,60,60,0,0,"C's",0
16,"16087",212,186,186,5,0,"C's",8
16,"16212",255,208,206,1,2,"C's",21
16,"16160",61,46,45,1,1,"C's",2
16,"16909",706,537,534,3,3,"C's",37
16,"16134",4369,3412,3369,23,43,"C's",516
16,"16031",46,30,30,2,0,"C's",3
16,"16193",70,57,57,1,0,"C's",0
16,"16148",587,511,511,1,0,"C's",33
16,"16101",160,130,129,0,1,"C's",4
16,"16115",44,33,33,0,0,"C's",1
16,"16143",16,12,12,2,0,"C's",0
16,"16084",49,37,32,0,5,"C's",0
16,"16043",99,73,73,1,0,"C's",6
16,"16013",31,28,28,0,0,"C's",3
16,"16044",39,28,27,0,1,"C's",1
16,"16063",98,87,87,0,0,"C's",5
16,"16225",76,58,57,0,1,"C's",1
16,"16224",84,68,67,1,1,"C's",3
16,"16041",354,284,282,0,2,"C's",30
16,"16094",132,101,99,1,2,"C's",15
16,"16204",272,207,207,1,0,"C's",34
16,"16141",145,113,112,1,1,"C's",3
16,"16014",613,493,487,1,6,"C's",22
16,"16046",250,181,180,1,1,"C's",20
16,"16018",401,328,328,1,0,"C's",43
16,"16060",760,600,593,5,7,"C's",54
16,"16122",254,200,198,4,2,"C's",17
16,"16251",1858,1450,1420,8,30,"C's",171
16,"16011",28,19,19,0,0,"C's",1
16,"16248",872,711,696,11,15,"C's",66
16,"16199",31,24,24,0,0,"C's",3
16,"16259",30,26,26,1,0,"C's",0
16,"16003",127,111,109,0,2,"C's",7
16,"16142",139,110,109,2,1,"C's",5
16,"16236",914,694,689,6,5,"C's",106
16,"16016",234,173,172,2,1,"C's",13
16,"16051",147,118,118,0,0,"C's",3
16,"16030",25,22,22,1,0,"C's",1
16,"16202",783,573,566,3,7,"C's",61
16,"16020",17,11,11,0,0,"C's",1
16,"16078",41427,31365,31095,268,270,"C's",4666
16,"16096",273,249,244,2,5,"C's",22
16,"16170",698,524,517,1,7,"C's",31
16,"16219",91,72,72,0,0,"C's",4
16,"16218",189,155,154,1,1,"C's",10
16,"16048",412,312,310,1,2,"C's",32
16,"16124",1870,1536,1518,7,18,"C's",93
16,"16181",64,53,53,0,0,"C's",1
16,"16237",113,89,87,0,2,"C's",11
16,"16175",5113,4203,4124,35,79,"C's",320
16,"16274",127,100,100,0,0,"C's",6
16,"16001",75,60,60,0,0,"C's",4
16,"16903",1081,824,816,6,8,"C's",74
16,"16265",21,16,16,0,0,"C's",1
16,"16130",575,451,446,0,5,"C's",34
16,"16243",412,354,348,0,6,"C's",28
16,"16058",105,81,80,0,1,"C's",5
16,"16211",377,253,250,3,3,"C's",18
16,"16023",468,344,343,3,1,"C's",47
16,"16216",317,275,267,0,8,"C's",19
16,"16064",681,588,581,1,7,"C's",56
16,"16036",128,104,102,2,2,"C's",11
16,"16162",43,35,35,0,0,"C's",0
16,"16055",703,512,509,7,3,"C's",62
16,"16027",709,567,562,4,5,"C's",58
16,"16033",1729,1385,1365,7,20,"C's",114
16,"16217",75,58,58,0,0,"C's",1
16,"16019",217,168,166,1,2,"C's",12
16,"16150",94,67,67,1,0,"C's",4
16,"16029",96,73,71,0,2,"C's",4
16,"16131",134,97,97,1,0,"C's",12
16,"16904",478,387,381,5,6,"C's",45
16,"16108",49,43,42,0,1,"C's",3
16,"16151",64,60,60,0,0,"C's",7
16,"16163",74,63,63,0,0,"C's",4
16,"16901",707,520,513,3,7,"C's",48
16,"16249",1986,1593,1570,8,23,"C's",133
16,"16061",964,798,790,13,8,"C's",61
16,"16104",54,40,40,0,0,"C's",3
16,"16269",426,351,349,3,2,"C's",18
16,"16188",90,63,62,0,1,"C's",3
16,"16004",274,212,206,0,6,"C's",11
16,"16052",548,420,420,1,0,"C's",38
16,"16083",55,28,28,0,0,"C's",7
16,"16026",85,56,53,0,3,"C's",8
16,"16092",161,130,129,1,1,"C's",7
16,"16228",177,132,131,1,1,"C's",10
16,"16209",118,100,100,1,0,"C's",4
16,"16133",4391,3539,3509,27,30,"C's",377
16,"16062",24,21,21,0,0,"C's",1
16,"16106",2729,2130,2095,19,35,"C's",125
16,"16017",370,300,296,2,4,"C's",15
16,"16258",198,143,142,0,1,"C's",5
16,"16071",20,20,20,0,0,"C's",4
16,"16119",169,121,120,0,1,"C's",4
16,"16140",27,15,15,0,0,"C's",2
16,"16161",58,53,53,0,0,"C's",7
16,"16153",955,797,780,5,17,"C's",52
16,"16908",197,154,154,1,0,"C's",6
16,"16231",48,38,38,0,0,"C's",4
16,"16145",464,389,387,2,2,"C's",30
16,"16042",1192,1021,1005,6,16,"C's",106
16,"16111",171,138,137,2,1,"C's",9
16,"16169",58,33,32,0,1,"C's",3
16,"16025",25,21,21,1,0,"C's",3
16,"16273",324,252,252,2,0,"C's",23
16,"16074",40,31,31,0,0,"C's",0
16,"16015",376,286,285,7,1,"C's",24
16,"16126",783,654,648,2,6,"C's",48
16,"16099",208,157,152,0,5,"C's",17
16,"16196",633,538,527,2,11,"C's",27
16,"16039",398,275,271,1,4,"C's",26
16,"16195",498,380,376,1,4,"C's",17
16,"16117",1057,814,808,2,6,"C's",80
16,"16187",77,52,52,1,0,"C's",7
16,"16147",62,43,43,0,0,"C's",7
16,"16156",101,76,75,0,1,"C's",2
16,"16278",73,55,55,0,0,"C's",1
16,"16242",325,281,278,1,3,"C's",17
16,"16008",95,72,72,0,0,"C's",0
16,"16910",96,70,70,0,0,"C's",1
16,"16070",32,31,31,0,0,"C's",1
16,"16066",2333,1917,1872,24,45,"C's",161
16,"16005",256,191,187,1,4,"C's",16
16,"16049",156,121,121,0,0,"C's",7
16,"16213",35,28,28,1,0,"C's",3
16,"16906",82,67,67,1,0,"C's",2
16,"16270",167,141,141,0,0,"C's",8
16,"16174",192,155,155,1,0,"C's",15
16,"16275",11,11,11,1,0,"C's",1
16,"16109",43,32,32,0,0,"C's",4
16,"16123",82,54,53,0,1,"C's",9
16,"16244",722,625,617,2,8,"C's",48
16,"16245",418,338,333,2,5,"C's",36
16,"16149",153,130,129,0,1,"C's",14
16,"16072",147,103,102,0,1,"C's",7
16,"16266",373,279,273,1,6,"C's",21
16,"16110",97,71,70,0,1,"C's",9
16,"16279",213,146,143,0,3,"C's",16
16,"16067",127,92,91,3,1,"C's",4
16,"16010",154,114,110,1,4,"C's",14
16,"16006",119,96,94,1,2,"C's",7
16,"16234",30,19,19,1,0,"C's",0
16,"16192",50,30,29,0,1,"C's",4
16,"16264",433,374,370,2,4,"C's",16
16,"16240",108,79,79,0,0,"C's",7
16,"16065",406,323,319,3,4,"C's",26
16,"16254",216,181,179,5,2,"C's",35
16,"16103",265,217,217,0,0,"C's",26
16,"16205",114,89,88,0,1,"C's",14
16,"16113",3080,2309,2278,15,31,"C's",256
16,"16165",63,51,50,1,1,"C's",5
16,"16137",56,34,33,0,1,"C's",4
16,"16159",225,170,168,0,2,"C's",6
16,"16191",926,760,752,6,8,"C's",77
16,"16139",333,255,251,4,4,"C's",16
16,"16154",4904,3776,3730,47,46,"C's",334
16,"16263",961,754,745,4,9,"C's",85
16,"16247",71,52,51,0,1,"C's",0
16,"16171",1818,1514,1498,5,16,"C's",97
16,"16012",82,69,69,0,0,"C's",6
16,"16002",192,172,172,0,0,"C's",11
16,"16152",40,35,35,0,0,"C's",0
16,"16009",66,48,48,0,0,"C's",2
16,"16022",78,63,61,0,2,"C's",2
16,"16177",78,63,63,0,0,"C's",1
16,"16250",76,57,57,0,0,"C's",7
16,"16239",141,110,107,0,3,"C's",10
16,"16107",120,87,87,1,0,"C's",5
16,"16905",1217,965,956,9,9,"C's",178
16,"16128",63,54,54,2,0,"C's",3
16,"16079",32,21,20,0,1,"C's",1
16,"16053",429,352,348,5,4,"C's",40
16,"16082",305,224,224,0,0,"C's",9
16,"16246",484,382,375,1,7,"C's",15
16,"16121",259,205,205,3,0,"C's",10
16,"16056",465,333,322,0,11,"C's",29
16,"16155",506,415,414,2,1,"C's",46
16,"16194",259,208,200,0,8,"C's",11
16,"16095",84,71,68,0,3,"C's",2
16,"16093",64,52,52,0,0,"C's",2
16,"16166",247,182,177,0,5,"C's",12
16,"16073",188,158,158,0,0,"C's",6
16,"16047",230,176,176,2,0,"C's",24
33,"33002",10122,7056,6977,55,79,"VOX",11
33,"33031",35453,23848,23595,242,253,"VOX",42
33,"33037",34841,24271,24054,200,217,"VOX",28
33,"33063",419,330,326,1,4,"VOX",0
33,"33004",67136,48699,48354,389,345,"VOX",119
33,"33018",2896,2068,2041,18,27,"VOX",0
33,"33009",899,606,601,4,5,"VOX",1
33,"33062",409,242,239,1,3,"VOX",0
33,"33005",1479,945,932,12,13,"VOX",0
33,"33022",906,604,599,3,5,"VOX",0
33,"33076",12270,8265,8203,89,62,"VOX",24
33,"33053",1157,767,762,12,5,"VOX",2
33,"33052",730,517,512,1,5,"VOX",0
33,"33032",11483,8036,7921,82,115,"VOX",21
33,"33050",603,374,357,0,17,"VOX",0
33,"33023",3315,2295,2267,35,28,"VOX",4
33,"33048",156,99,99,2,0,"VOX",0
33,"33058",1821,1319,1305,10,14,"VOX",4
33,"33068",1114,627,623,2,4,"VOX",1
33,"33028",1289,685,682,9,3,"VOX",0
33,"33007",1524,991,980,10,11,"VOX",2
33,"33071",617,459,452,8,7,"VOX",0
33,"33038",2298,1690,1675,12,15,"VOX",2
33,"33025",9261,6116,6062,58,54,"VOX",9
33,"33008",1808,1268,1247,6,21,"VOX",2
33,"33006",1556,1043,1036,17,7,"VOX",0
33,"33044",178724,130938,130010,1254,928,"VOX",617
33,"33065",1109,743,735,16,8,"VOX",2
33,"33017",3180,2196,2168,30,28,"VOX",3
33,"33070",3347,2473,2441,31,32,"VOX",4
33,"33035",11299,8048,7981,67,67,"VOX",26
33,"33043",682,465,460,2,5,"VOX",0
33,"33069",3513,2577,2554,15,23,"VOX",7
33,"33021",4576,3133,3090,33,43,"VOX",3
33,"33012",5230,3595,3568,27,27,"VOX",6
33,"33039",1672,1261,1257,14,4,"VOX",0
33,"33019",3094,2079,2054,15,25,"VOX",4
33,"33042",4316,3143,3105,35,38,"VOX",12
33,"33001",1622,867,852,16,15,"VOX",0
33,"33057",1593,1134,1123,17,11,"VOX",9
33,"33010",1828,1220,1215,16,5,"VOX",1
33,"33075",275,161,155,2,6,"VOX",0
33,"33045",4503,3249,3216,26,33,"VOX",6
33,"33013",456,336,331,6,5,"VOX",0
33,"33016",19201,14177,14074,115,103,"VOX",31
33,"33003",665,386,384,7,2,"VOX",1
33,"33059",4702,3228,3185,42,43,"VOX",3
33,"33040",4564,3125,3091,28,34,"VOX",5
33,"33011",11373,6279,6214,104,65,"VOX",9
33,"33041",7270,5138,5093,53,45,"VOX",8
33,"33020",13297,9527,9445,86,82,"VOX",19
33,"33056",5015,3435,3405,32,30,"VOX",3
33,"33036",11572,8208,8133,80,75,"VOX",15
33,"33024",227211,166618,165475,1240,1143,"VOX",460
33,"33049",6388,4229,4182,48,47,"VOX",6
33,"33067",785,608,598,5,10,"VOX",0
33,"33074",3523,2422,2390,36,32,"VOX",3
33,"33060",14750,10307,10206,82,101,"VOX",13
33,"33064",231,181,179,4,2,"VOX",0
33,"33051",7167,4810,4772,57,38,"VOX",9
33,"33054",1688,1159,1146,8,13,"VOX",1
33,"33014",9101,6398,6352,46,46,"VOX",11
33,"33030",899,689,687,10,2,"VOX",0
33,"33047",1126,868,861,12,7,"VOX",0
33,"33078",147,98,98,0,0,"VOX",0
33,"33015",1561,1042,1031,8,11,"VOX",0
33,"33029",363,199,198,1,1,"VOX",0
33,"33034",10693,6796,6725,72,71,"VOX",19
33,"33046",508,375,365,4,10,"VOX",0
33,"33073",8631,5015,4948,47,67,"VOX",9
33,"33027",849,544,543,8,1,"VOX",0
33,"33055",1511,1150,1129,9,21,"VOX",0
33,"33061",379,194,190,1,4,"VOX",0
33,"33033",9943,6851,6803,61,48,"VOX",15
33,"33072",1601,1012,1002,4,10,"VOX",0
33,"33077",1220,849,840,11,9,"VOX",1
33,"33066",43034,29901,29610,261,291,"VOX",61
33,"33026",8621,5600,5555,71,45,"VOX",10
24,"24053",439,303,298,2,5,"CRA",0
24,"24205",967,714,706,9,8,"CRA",1
24,"24057",1366,1103,1076,11,27,"CRA",1
24,"24170",1934,1436,1424,13,12,"CRA",8
24,"24065",2106,1573,1545,16,28,"CRA",6
24,"24081",142,97,97,0,0,"CRA",0
24,"24101",404,264,262,2,2,"CRA",0
24,"24198",602,411,402,4,9,"CRA",2
24,"24123",757,499,497,4,2,"CRA",1
24,"24188",3843,2962,2899,48,63,"CRA",4
24,"24052",171,109,108,0,1,"CRA",2
24,"24146",271,195,194,0,1,"CRA",0
24,"24077",227,195,192,1,3,"CRA",0
24,"24070",4159,3206,3162,31,44,"CRA",10
24,"24184",206,121,120,0,1,"CRA",0
24,"24190",167,115,115,2,0,"CRA",0
24,"24117",446,333,331,2,2,"CRA",0
24,"24099",173,133,133,2,0,"CRA",0
24,"24059",887,520,512,8,8,"CRA",3
24,"24047",782,533,527,7,6,"CRA",13
24,"24060",615,361,359,0,2,"CRA",2
24,"24214",669,492,490,1,2,"CRA",1
24,"24114",3107,2174,2155,7,19,"CRA",13
24,"24080",218,170,162,3,8,"CRA",0
24,"24090",348,226,224,1,2,"CRA",0
24,"24105",1443,1087,1065,10,22,"CRA",6
24,"24149",155,123,121,0,2,"CRA",1
24,"24173",943,678,673,3,5,"CRA",2
24,"24158",323,210,207,0,3,"CRA",0
24,"24086",271,200,198,1,2,"CRA",0
24,"24020",463,294,291,5,3,"CRA",1
24,"24144",704,487,478,5,9,"CRA",4
24,"24203",96,73,72,1,1,"CRA",0
24,"24082",870,692,682,10,10,"CRA",0
24,"24181",1519,1135,1117,10,18,"CRA",1
24,"24112",318,207,207,0,0,"CRA",0
24,"24087",645,469,466,11,3,"CRA",0
24,"24078",388,286,284,4,2,"CRA",3
24,"24109",996,667,652,7,15,"CRA",4
24,"24153",233,173,172,3,1,"CRA",0
24,"24119",702,491,480,6,11,"CRA",3
24,"24073",481,343,340,3,3,"CRA",0
24,"24175",1825,1381,1372,13,9,"CRA",3
24,"24172",420,218,216,1,2,"CRA",0
24,"24021",1688,1213,1189,6,24,"CRA",3
24,"24019",359,293,291,3,2,"CRA",0
24,"24165",373,254,250,2,4,"CRA",1
24,"24207",296,245,241,3,4,"CRA",5
24,"24215",156,119,118,1,1,"CRA",0
24,"24050",102,77,77,1,0,"CRA",1
24,"24143",514,391,379,4,12,"CRA",0
24,"24182",420,289,287,6,2,"CRA",13
24,"24154",1010,750,729,7,21,"CRA",8
24,"24054",433,308,303,4,5,"CRA",1
24,"24091",657,440,437,2,3,"CRA",3
24,"24216",732,533,522,2,11,"CRA",3
24,"24003",652,442,435,5,7,"CRA",1
24,"24124",374,249,246,4,3,"CRA",0
24,"24064",1525,1165,1151,10,14,"CRA",0
24,"24026",1203,908,898,19,10,"CRA",1
24,"24024",695,496,494,4,2,"CRA",3
24,"24004",469,349,349,6,0,"CRA",0
24,"24107",244,184,183,2,1,"CRA",1
24,"24051",433,308,307,1,1,"CRA",2
24,"24049",1493,1152,1138,8,14,"CRA",3
24,"24108",377,279,273,3,6,"CRA",28
24,"24033",211,154,151,1,3,"CRA",0
24,"24171",364,219,217,1,2,"CRA",0
24,"24001",188,108,108,0,0,"CRA",3
24,"24174",495,362,357,3,5,"CRA",0
24,"24071",1006,747,738,9,9,"CRA",6
24,"24115",54290,39886,39486,325,400,"CRA",104
24,"24150",243,175,175,3,0,"CRA",0
24,"24025",300,233,228,0,5,"CRA",3
24,"24056",2910,2102,2068,31,34,"CRA",17
24,"24095",314,246,244,1,2,"CRA",0
24,"24209",2790,1907,1884,15,23,"CRA",3
24,"24156",243,169,169,1,0,"CRA",0
24,"24222",14249,10663,10532,119,131,"CRA",27
24,"24166",1413,1043,1014,7,29,"CRA",38
24,"24031",216,169,167,1,2,"CRA",1
24,"24178",71,58,57,0,1,"CRA",0
24,"24097",225,146,145,1,1,"CRA",1
24,"24022",342,227,227,0,0,"CRA",2
24,"24189",6016,4187,4134,58,53,"CRA",14
24,"24094",1392,1048,1038,11,10,"CRA",6
24,"24219",527,390,387,2,3,"CRA",2
24,"24210",510,347,347,0,0,"CRA",1
24,"24159",1832,1407,1391,17,16,"CRA",5
24,"24110",1253,932,926,7,6,"CRA",0
24,"24185",482,357,349,4,8,"CRA",1
24,"24141",98,76,75,0,1,"CRA",0
24,"24151",492,357,357,1,0,"CRA",1
24,"24161",291,218,212,2,6,"CRA",0
24,"24036",301,181,180,0,1,"CRA",0
24,"24213",158,117,117,0,0,"CRA",0
24,"24179",299,202,201,8,1,"CRA",1
24,"24067",645,383,379,2,4,"CRA",1
24,"24017",582,434,433,9,1,"CRA",0
24,"24180",1128,825,814,12,11,"CRA",4
24,"24129",122,85,85,1,0,"CRA",2
24,"24152",462,302,301,2,1,"CRA",3
24,"24037",369,251,251,0,0,"CRA",1
24,"24007",764,578,576,3,2,"CRA",6
24,"24098",1205,880,874,8,6,"CRA",3
24,"24118",127,84,84,1,0,"CRA",4
24,"24027",1214,881,860,8,21,"CRA",4
24,"24221",790,568,558,6,10,"CRA",1
24,"24089",103315,77803,77038,779,765,"CRA",213
24,"24079",922,654,645,9,9,"CRA",23
24,"24199",433,284,281,3,3,"CRA",2
24,"24162",1671,1314,1303,21,11,"CRA",5
24,"24142",25160,18503,18262,205,241,"CRA",50
24,"24225",1020,786,773,6,13,"CRA",5
24,"24083",1077,764,755,4,9,"CRA",1
24,"24018",177,143,141,0,2,"CRA",1
24,"24068",464,343,339,5,4,"CRA",2
24,"24191",111,84,84,1,0,"CRA",1
24,"24028",386,304,302,3,2,"CRA",1
24,"24038",3107,2383,2354,30,29,"CRA",6
24,"24130",437,319,315,1,4,"CRA",5
24,"24008",9319,6964,6852,77,112,"CRA",25
24,"24226",204,138,136,0,2,"CRA",2
24,"24100",769,569,561,4,8,"CRA",2
24,"24069",42,36,36,0,0,"CRA",0
24,"24193",384,277,276,4,1,"CRA",0
24,"24039",2077,1604,1600,39,4,"CRA",7
24,"24006",488,351,342,4,9,"CRA",1
24,"24163",3929,3076,3044,49,32,"CRA",9
24,"24202",8098,5654,5582,51,72,"CRA",10
24,"24088",1037,804,797,8,7,"CRA",0
24,"24120",345,214,214,1,0,"CRA",0
24,"24131",742,499,497,5,2,"CRA",2
24,"24009",322,161,161,1,0,"CRA",0
24,"24206",1732,1303,1288,8,15,"CRA",5
24,"24132",628,397,390,6,7,"CRA",1
24,"24040",453,315,309,2,6,"CRA",0
24,"24227",1617,1146,1142,14,4,"CRA",3
24,"24194",292,230,229,1,1,"CRA",0
24,"24224",621,452,445,7,7,"CRA",1
24,"24217",136,110,109,1,1,"CRA",2
24,"24145",655,445,443,8,2,"CRA",7
24,"24164",373,190,190,1,0,"CRA",1
24,"24183",805,528,522,5,6,"CRA",3
24,"24121",655,481,477,0,4,"CRA",1
24,"24010",8426,5980,5888,61,92,"CRA",25
24,"24092",809,619,609,1,10,"CRA",0
24,"24058",205,137,134,0,3,"CRA",0
24,"24061",1702,1244,1231,13,13,"CRA",4
24,"24155",478,380,371,0,9,"CRA",0
24,"24011",209,113,112,0,1,"CRA",0
24,"24030",4297,3226,3180,16,46,"CRA",6
24,"24041",548,384,381,5,3,"CRA",5
24,"24102",655,495,492,2,3,"CRA",0
24,"24133",350,259,258,3,1,"CRA",0
24,"24228",666,455,449,2,6,"CRA",2
24,"24113",366,282,275,3,7,"CRA",1
24,"24196",2082,1529,1513,15,16,"CRA",2
24,"24062",142,105,105,1,0,"CRA",5
24,"24093",380,249,248,3,1,"CRA",3
24,"24122",1351,965,948,9,17,"CRA",3
24,"24134",3465,2628,2583,27,45,"CRA",8
24,"24218",454,331,329,3,2,"CRA",2
24,"24103",292,160,160,1,0,"CRA",0
24,"24002",236,182,180,3,2,"CRA",0
24,"24157",2580,2013,1983,25,30,"CRA",6
24,"24229",427,330,324,8,6,"CRA",2
24,"24012",297,212,211,4,1,"CRA",1
24,"24197",770,545,537,6,8,"CRA",3
24,"24023",268,189,188,2,1,"CRA",2
24,"24029",754,545,539,2,6,"CRA",1
24,"24042",61,48,48,1,0,"CRA",0
24,"24084",162,119,119,1,0,"CRA",0
24,"24063",391,260,259,1,1,"CRA",1
24,"24032",111,82,82,1,0,"CRA",0
24,"24148",1684,1268,1256,9,12,"CRA",5
24,"24176",318,244,243,5,1,"CRA",1
24,"24074",99,77,76,1,1,"CRA",0
24,"24014",7474,5375,5321,56,54,"CRA",14
24,"24230",423,329,324,2,5,"CRA",2
24,"24136",544,391,390,8,1,"CRA",2
24,"24187",876,642,631,6,11,"CRA",9
24,"24167",763,509,504,9,5,"CRA",2
24,"24043",135,69,67,0,2,"CRA",0
24,"24104",266,180,179,0,1,"CRA",1
24,"24055",705,510,507,6,3,"CRA",2
24,"24015",2279,1693,1658,22,35,"CRA",8
24,"24044",171,125,118,0,7,"CRA",1
24,"24901",908,660,653,4,7,"CRA",4
24,"24177",481,328,327,1,1,"CRA",2
24,"24096",124,74,74,0,0,"CRA",0
24,"24211",276,210,206,4,4,"CRA",0
24,"24137",1114,811,804,9,7,"CRA",1
24,"24125",475,285,282,2,3,"CRA",1
24,"24005",387,267,259,6,8,"CRA",1
24,"24212",1029,784,774,7,10,"CRA",4
24,"24076",1279,972,953,7,19,"CRA",3
24,"24168",461,383,379,4,4,"CRA",2
24,"24116",424,276,273,0,3,"CRA",1
24,"24169",2976,2256,2236,12,20,"CRA",7
24,"24034",3419,2596,2556,27,40,"CRA",5
24,"24201",1086,765,757,5,8,"CRA",7
24,"24016",478,287,285,1,2,"CRA",0
24,"24106",258,178,173,1,5,"CRA",0
24,"24223",2640,2012,2012,53,0,"CRA",10
24,"24902",354,273,272,2,1,"CRA",2
24,"24139",2186,1608,1570,24,38,"CRA",3
24,"24066",504,367,361,3,6,"CRA",3
24,"24046",953,662,645,6,17,"CRA",4
24,"24160",692,506,498,2,8,"CRA",4
24,"24127",301,239,239,3,0,"CRA",0
42,"42103",583,467,459,5,8,"UPYD",2
42,"42088",71,53,53,0,0,"UPYD",0
42,"42130",60,51,50,3,1,"UPYD",0
42,"42155",173,105,104,1,1,"UPYD",0
42,"42036",50,39,38,0,1,"UPYD",0
42,"42161",140,106,106,2,0,"UPYD",0
42,"42083",25,23,21,0,2,"UPYD",1
42,"42015",32,25,25,0,0,"UPYD",0
42,"42052",15,13,13,0,0,"UPYD",0
42,"42211",83,67,67,1,0,"UPYD",0
42,"42043",3796,2833,2792,26,41,"UPYD",30
42,"42070",35,27,25,0,2,"UPYD",0
42,"42092",65,42,41,1,1,"UPYD",1
42,"42202",24,12,11,0,1,"UPYD",0
42,"42181",419,318,312,3,6,"UPYD",0
42,"42021",85,53,53,1,0,"UPYD",0
42,"42106",15,9,9,0,0,"UPYD",0
42,"42007",117,86,86,2,0,"UPYD",0
42,"42032",148,117,117,0,0,"UPYD",0
42,"42108",12,10,10,0,0,"UPYD",0
42,"42019",516,367,363,4,4,"UPYD",3
42,"42115",63,46,46,0,0,"UPYD",0
42,"42068",85,62,61,2,1,"UPYD",0
42,"42027",76,56,56,0,0,"UPYD",0
42,"42165",408,289,282,7,7,"UPYD",3
42,"42173",29201,21456,21181,272,275,"UPYD",121
42,"42069",1529,1078,1066,10,12,"UPYD",2
42,"42016",18,13,13,0,0,"UPYD",0
42,"42061",292,221,219,2,2,"UPYD",1
42,"42191",187,135,132,2,3,"UPYD",0
42,"42001",279,219,215,2,4,"UPYD",0
42,"42029",143,106,106,0,0,"UPYD",1
42,"42086",38,29,29,1,0,"UPYD",0
42,"42084",26,21,21,0,0,"UPYD",0
42,"42120",148,98,98,1,0,"UPYD",1
42,"42144",442,357,352,5,5,"UPYD",4
42,"42216",25,21,21,0,0,"UPYD",0
42,"42097",21,14,14,0,0,"UPYD",0
42,"42075",87,63,63,1,0,"UPYD",0
42,"42073",72,56,56,0,0,"UPYD",2
42,"42085",191,136,136,2,0,"UPYD",1
42,"42058",112,97,92,1,5,"UPYD",2
42,"42139",22,16,16,0,0,"UPYD",0
42,"42004",2296,1767,1748,32,19,"UPYD",17
42,"42100",32,31,31,1,0,"UPYD",1
42,"42045",312,218,214,1,4,"UPYD",1
42,"42009",80,65,64,2,1,"UPYD",2
42,"42121",64,48,48,1,0,"UPYD",0
42,"42152",82,59,59,1,0,"UPYD",1
42,"42128",39,37,37,1,0,"UPYD",0
42,"42145",137,121,121,3,0,"UPYD",3
42,"42113",512,390,386,3,4,"UPYD",1
42,"42055",165,127,127,3,0,"UPYD",2
42,"42177",71,55,54,1,1,"UPYD",0
42,"42080",155,113,110,0,3,"UPYD",2
42,"42141",111,79,79,0,0,"UPYD",0
42,"42217",31,25,25,0,0,"UPYD",0
42,"42076",219,176,173,4,3,"UPYD",1
42,"42197",76,61,59,1,2,"UPYD",0
42,"42185",25,21,21,0,0,"UPYD",0
42,"42171",128,78,78,1,0,"UPYD",0
42,"42031",26,19,19,0,0,"UPYD",0
42,"42129",692,522,516,4,6,"UPYD",4
42,"42096",281,181,178,8,3,"UPYD",2
42,"42148",10,10,10,0,0,"UPYD",0
42,"42176",29,23,23,0,0,"UPYD",0
42,"42200",84,60,60,2,0,"UPYD",0
42,"42124",64,44,44,0,0,"UPYD",0
42,"42215",786,555,552,8,3,"UPYD",2
42,"42187",63,55,54,1,1,"UPYD",0
42,"42209",146,111,108,3,3,"UPYD",1
42,"42011",17,10,10,0,0,"UPYD",0
42,"42158",110,78,78,1,0,"UPYD",3
42,"42142",52,33,33,0,0,"UPYD",1
42,"42003",66,59,57,1,2,"UPYD",1
42,"42206",8,5,5,0,0,"UPYD",0
42,"42028",70,49,49,0,0,"UPYD",0
42,"42042",47,38,38,2,0,"UPYD",0
42,"42013",35,28,28,0,0,"UPYD",0
42,"42105",49,42,42,0,0,"UPYD",0
42,"42046",51,43,43,1,0,"UPYD",0
42,"42193",16,11,11,0,0,"UPYD",0
42,"42037",34,17,17,1,0,"UPYD",0
42,"42163",49,37,37,0,0,"UPYD",0
42,"42188",50,44,43,0,1,"UPYD",0
42,"42127",40,27,27,1,0,"UPYD",0
42,"42160",261,205,203,1,2,"UPYD",1
42,"42131",50,32,32,0,0,"UPYD",0
42,"42060",34,23,21,0,2,"UPYD",0
42,"42189",64,50,50,2,0,"UPYD",0
42,"42196",11,10,10,0,0,"UPYD",0
42,"42178",117,81,79,2,2,"UPYD",0
42,"42218",80,54,54,1,0,"UPYD",0
42,"42107",74,51,48,1,3,"UPYD",0
42,"42123",165,119,119,4,0,"UPYD",1
42,"42030",95,77,76,3,1,"UPYD",0
42,"42057",175,106,104,1,2,"UPYD",0
42,"42098",11,6,6,0,0,"UPYD",0
42,"42134",2642,1961,1938,24,23,"UPYD",15
42,"42039",233,148,146,2,2,"UPYD",3
42,"42082",9,8,8,1,0,"UPYD",0
42,"42049",120,75,73,1,2,"UPYD",0
42,"42219",43,32,32,0,0,"UPYD",0
42,"42017",142,115,114,1,1,"UPYD",0
42,"42195",100,60,60,3,0,"UPYD",0
42,"42182",57,45,45,1,0,"UPYD",0
42,"42149",393,300,293,1,7,"UPYD",3
42,"42154",97,78,78,1,0,"UPYD",3
42,"42054",20,14,14,0,0,"UPYD",0
42,"42041",35,25,25,0,0,"UPYD",0
42,"42059",20,14,14,0,0,"UPYD",0
42,"42172",29,25,25,2,0,"UPYD",0
42,"42162",2363,1690,1672,21,18,"UPYD",17
42,"42020",4288,3087,3044,42,43,"UPYD",14
42,"42153",14,14,14,1,0,"UPYD",0
42,"42008",57,38,38,0,0,"UPYD",0
42,"42192",41,31,31,1,0,"UPYD",0
42,"42183",111,79,78,2,1,"UPYD",1
42,"42116",47,33,33,0,0,"UPYD",0
42,"42025",1216,884,873,11,11,"UPYD",3
42,"42051",21,15,15,0,0,"UPYD",0
42,"42167",259,195,194,2,1,"UPYD",0
42,"42207",41,33,33,1,0,"UPYD",0
42,"42078",1031,752,744,6,8,"UPYD",2
42,"42212",69,54,54,3,0,"UPYD",1
42,"42010",18,14,14,0,0,"UPYD",0
42,"42151",35,31,29,2,2,"UPYD",0
42,"42065",22,20,19,0,1,"UPYD",0
42,"42064",85,74,74,0,0,"UPYD",1
42,"42053",26,21,21,1,0,"UPYD",0
42,"42012",37,29,29,0,0,"UPYD",0
42,"42184",59,45,44,2,1,"UPYD",0
42,"42194",176,127,126,2,1,"UPYD",0
42,"42056",22,19,19,0,0,"UPYD",0
42,"42071",169,111,109,2,2,"UPYD",1
42,"42034",31,22,22,0,0,"UPYD",0
42,"42023",66,53,53,0,0,"UPYD",1
42,"42044",53,49,47,3,2,"UPYD",0
42,"42125",81,66,66,2,0,"UPYD",0
42,"42090",93,70,69,1,1,"UPYD",0
42,"42135",75,53,53,1,0,"UPYD",0
42,"42035",782,566,562,4,4,"UPYD",1
42,"42208",21,14,14,2,0,"UPYD",0
42,"42174",180,149,148,1,1,"UPYD",2
42,"42024",87,68,67,0,1,"UPYD",2
42,"42022",214,171,171,2,0,"UPYD",0
42,"42119",164,97,97,2,0,"UPYD",0
42,"42079",27,17,17,1,0,"UPYD",0
42,"42062",25,16,15,0,1,"UPYD",0
42,"42201",23,23,22,0,1,"UPYD",0
42,"42094",608,470,463,9,7,"UPYD",5
42,"42089",55,46,46,1,0,"UPYD",0
42,"42166",60,40,40,0,0,"UPYD",0
42,"42164",1614,1208,1190,9,18,"UPYD",9
42,"42204",56,39,38,0,1,"UPYD",0
42,"42018",152,116,114,0,2,"UPYD",0
42,"42038",36,27,27,2,0,"UPYD",0
42,"42110",63,46,46,0,0,"UPYD",0
42,"42198",22,17,17,0,0,"UPYD",0
42,"42081",143,111,106,2,5,"UPYD",0
42,"42063",49,37,37,1,0,"UPYD",0
42,"42111",307,221,220,1,1,"UPYD",1
42,"42156",30,21,21,0,0,"UPYD",0
42,"42168",109,88,88,1,0,"UPYD",1
42,"42026",24,20,20,0,0,"UPYD",1
42,"42175",23,18,18,0,0,"UPYD",0
42,"42087",45,38,37,0,1,"UPYD",0
42,"42095",1762,1319,1303,15,16,"UPYD",5
42,"42117",148,113,111,3,2,"UPYD",2
42,"42190",94,71,71,1,0,"UPYD",0
42,"42157",13,10,10,1,0,"UPYD",0
42,"42050",31,18,18,0,0,"UPYD",1
42,"42048",67,53,51,1,2,"UPYD",0
42,"42014",66,43,43,2,0,"UPYD",0
42,"42140",16,10,10,1,0,"UPYD",0
42,"42205",93,64,63,0,1,"UPYD",5
42,"42132",143,118,117,0,1,"UPYD",1
42,"42033",50,43,43,0,0,"UPYD",0
42,"42006",164,121,118,8,3,"UPYD",2
42,"42093",40,29,29,3,0,"UPYD",0
42,"42213",29,18,18,1,0,"UPYD",0
42,"42118",23,16,16,0,0,"UPYD",0
42,"42159",38,33,32,1,1,"UPYD",0
14,"14027",7908,6085,6008,57,77,"RECORTES CE",3
14,"14041",3180,2404,2373,26,31,"RECORTES CE",1
14,"14062",1052,813,801,4,12,"RECORTES CE",0
14,"14046",4484,3540,3487,22,53,"RECORTES CE",2
14,"14072",1079,834,830,5,4,"RECORTES CE",1
14,"14043",7574,5571,5510,46,61,"RECORTES CE",7
14,"14016",1364,1047,1045,3,2,"RECORTES CE",0
14,"14005",6358,4379,4272,56,107,"RECORTES CE",3
14,"14013",16845,12599,12414,146,185,"RECORTES CE",19
14,"14051",1401,1095,1077,5,18,"RECORTES CE",0
14,"14035",5992,4475,4437,44,38,"RECORTES CE",1
14,"14015",2149,1637,1616,13,21,"RECORTES CE",0
14,"14006",1331,1166,1137,7,29,"RECORTES CE",0
14,"14014",2570,2104,2075,8,29,"RECORTES CE",5
14,"14052",9447,6250,6201,49,49,"RECORTES CE",5
14,"14024",1920,1522,1488,10,34,"RECORTES CE",4
14,"14053",6050,4498,4427,56,71,"RECORTES CE",5
14,"14045",3055,2486,2451,13,35,"RECORTES CE",1
14,"14056",23613,17016,16804,128,212,"RECORTES CE",60
14,"14037",3344,2476,2442,20,34,"RECORTES CE",4
14,"14054",13665,10923,10678,103,245,"RECORTES CE",4
14,"14060",4854,3695,3633,43,62,"RECORTES CE",7
14,"14044",1624,1285,1267,9,18,"RECORTES CE",0
14,"14065",1861,1461,1446,12,15,"RECORTES CE",0
14,"14073",2900,2068,2041,15,27,"RECORTES CE",3
14,"14025",2950,2460,2425,10,35,"RECORTES CE",3
14,"14007",15200,11064,10926,81,138,"RECORTES CE",13
14,"14028",320,246,244,2,2,"RECORTES CE",0
14,"14055",18572,13587,13410,167,177,"RECORTES CE",18
14,"14021",260189,188939,187558,1934,1381,"RECORTES CE",262
14,"14022",4036,3199,3169,9,30,"RECORTES CE",2
14,"14058",7973,5860,5791,49,69,"RECORTES CE",36
14,"14070",1343,1026,1008,9,18,"RECORTES CE",0
14,"14074",2303,1940,1929,13,11,"RECORTES CE",0
14,"14018",3710,2882,2846,28,36,"RECORTES CE",2
14,"14029",4206,3170,3135,32,35,"RECORTES CE",3
14,"14001",3552,2861,2830,28,31,"RECORTES CE",1
14,"14064",331,252,244,2,8,"RECORTES CE",0
14,"14075",581,463,446,6,17,"RECORTES CE",2
14,"14067",3874,3033,2986,29,47,"RECORTES CE",1
14,"14033",1285,980,963,11,17,"RECORTES CE",3
14,"14042",18921,14842,14653,184,189,"RECORTES CE",23
14,"14047",1654,1221,1211,17,10,"RECORTES CE",1
14,"14009",2779,1941,1934,13,7,"RECORTES CE",3
14,"14049",16357,12206,12029,127,177,"RECORTES CE",10
14,"14061",756,606,592,2,14,"RECORTES CE",0
14,"14038",32236,22982,22773,209,209,"RECORTES CE",25
14,"14031",597,490,484,0,6,"RECORTES CE",0
14,"14030",8580,6619,6542,66,77,"RECORTES CE",5
14,"14011",584,477,476,3,1,"RECORTES CE",0
14,"14066",5890,4366,4322,29,44,"RECORTES CE",2
14,"14008",2871,2053,2034,11,19,"RECORTES CE",1
14,"14036",3767,2911,2857,53,54,"RECORTES CE",3
14,"14003",1265,981,970,6,11,"RECORTES CE",0
14,"14069",7536,5574,5495,48,79,"RECORTES CE",2
14,"14012",6190,4574,4488,27,86,"RECORTES CE",3
14,"14039",2628,2151,2123,11,28,"RECORTES CE",2
14,"14050",2399,1886,1864,11,22,"RECORTES CE",0
14,"14071",937,651,642,2,9,"RECORTES CE",0
14,"14004",2036,1502,1488,6,14,"RECORTES CE",2
14,"14059",699,559,552,5,7,"RECORTES CE",3
14,"14019",6479,5131,5076,46,55,"RECORTES CE",10
14,"14048",1206,967,949,11,18,"RECORTES CE",1
14,"14063",1065,803,797,4,6,"RECORTES CE",0
14,"14040",3792,3036,3010,23,26,"RECORTES CE",0
14,"14020",391,278,274,3,4,"RECORTES CE",0
14,"14017",10869,8130,8029,72,101,"RECORTES CE",9
14,"14010",4051,3003,2968,17,35,"RECORTES CE",3
14,"14032",425,347,335,3,12,"RECORTES CE",0
14,"14023",2041,1742,1717,13,25,"RECORTES CE",0
14,"14057",6152,4973,4903,56,70,"RECORTES CE",2
14,"14034",318,260,252,2,8,"RECORTES CE",0
14,"14068",545,410,407,6,3,"RECORTES CE",0
14,"14002",10951,8231,8150,72,81,"RECORTES CE",10
14,"14026",2073,1437,1421,13,16,"RECORTES CE",0
26,"26160",715,569,567,3,2,"IU-UPeC",18
26,"26067",23,20,20,0,0,"IU-UPeC",0
26,"26065",50,40,40,0,0,"IU-UPeC",0
26,"26017",383,302,301,4,1,"IU-UPeC",9
26,"26013",356,264,262,3,2,"IU-UPeC",10
26,"26171",179,136,126,1,10,"IU-UPeC",7
26,"26146",101,78,77,0,1,"IU-UPeC",4
26,"26148",171,147,145,0,2,"IU-UPeC",3
26,"26170",448,346,344,8,2,"IU-UPeC",4
26,"26064",2278,1736,1715,17,21,"IU-UPeC",166
26,"26022",198,159,158,0,1,"IU-UPeC",0
26,"26029",37,31,31,0,0,"IU-UPeC",0
26,"26011",7336,5309,5255,57,54,"IU-UPeC",169
26,"26168",5318,3853,3802,36,51,"IU-UPeC",195
26,"26036",16990,12136,11984,98,152,"IU-UPeC",414
26,"26084",6630,5015,4952,27,63,"IU-UPeC",170
26,"26071",8477,6115,6029,51,86,"IU-UPeC",268
26,"26079",639,536,527,2,9,"IU-UPeC",11
26,"26016",28,24,24,1,0,"IU-UPeC",1
26,"26018",10469,8216,8110,71,106,"IU-UPeC",390
26,"26008",1862,1442,1425,7,17,"IU-UPeC",30
26,"26009",414,326,319,3,7,"IU-UPeC",6
26,"26103",789,626,616,3,10,"IU-UPeC",22
26,"26004",68,53,53,1,0,"IU-UPeC",0
26,"26147",30,26,26,0,0,"IU-UPeC",2
26,"26122",119,104,102,2,2,"IU-UPeC",2
26,"26061",1548,1179,1160,14,19,"IU-UPeC",38
26,"26113",37,34,32,0,2,"IU-UPeC",0
26,"26066",265,217,209,3,8,"IU-UPeC",9
26,"26086",15,15,15,0,0,"IU-UPeC",0
26,"26046",1594,1221,1209,3,12,"IU-UPeC",138
26,"26140",260,221,218,1,3,"IU-UPeC",14
26,"26038",95,66,65,0,1,"IU-UPeC",1
26,"26030",12,12,12,0,0,"IU-UPeC",0
26,"26119",202,163,162,4,1,"IU-UPeC",2
26,"26088",36,32,31,0,1,"IU-UPeC",2
26,"26114",80,71,71,2,0,"IU-UPeC",2
26,"26025",85,71,71,1,0,"IU-UPeC",1
26,"26078",83,68,68,0,0,"IU-UPeC",4
26,"26178",80,64,63,1,1,"IU-UPeC",2
26,"26014",466,319,319,0,0,"IU-UPeC",16
26,"26120",1457,1144,1133,9,11,"IU-UPeC",27
26,"26165",364,315,311,1,4,"IU-UPeC",5
26,"26169",64,60,60,0,0,"IU-UPeC",1
26,"26111",248,195,192,1,3,"IU-UPeC",5
26,"26094",85,71,68,0,3,"IU-UPeC",2
26,"26040",68,62,62,0,0,"IU-UPeC",1
26,"26104",14,9,9,0,0,"IU-UPeC",2
26,"26027",157,127,127,1,0,"IU-UPeC",9
26,"26117",2168,1695,1662,19,33,"IU-UPeC",43
26,"26129",971,768,757,2,11,"IU-UPeC",5
26,"26080",475,392,388,6,4,"IU-UPeC",4
26,"26158",265,220,217,4,3,"IU-UPeC",4
26,"26049",174,127,121,0,6,"IU-UPeC",1
26,"26091",166,141,138,0,3,"IU-UPeC",1
26,"26057",51,47,45,0,2,"IU-UPeC",6
26,"26135",167,120,119,0,1,"IU-UPeC",5
26,"26087",208,157,154,4,3,"IU-UPeC",5
26,"26105",2187,1722,1696,16,26,"IU-UPeC",84
26,"26092",108,83,82,0,1,"IU-UPeC",0
26,"26183",65,50,50,0,0,"IU-UPeC",0
26,"26052",158,125,125,0,0,"IU-UPeC",12
26,"26141",112,85,83,1,2,"IU-UPeC",5
26,"26074",105,86,85,1,1,"IU-UPeC",2
26,"26109",85,76,74,1,2,"IU-UPeC",1
26,"26005",2343,1607,1590,19,17,"IU-UPeC",45
26,"26149",61,48,48,0,0,"IU-UPeC",1
26,"26110",162,135,134,0,1,"IU-UPeC",5
26,"26062",90,73,71,0,2,"IU-UPeC",5
26,"26098",94,72,71,1,1,"IU-UPeC",5
26,"26034",660,522,513,1,9,"IU-UPeC",19
26,"26145",245,202,201,3,1,"IU-UPeC",4
26,"26032",53,40,40,0,0,"IU-UPeC",4
26,"26001",197,163,155,3,8,"IU-UPeC",4
26,"26127",215,182,179,2,3,"IU-UPeC",2
26,"26039",38,35,35,0,0,"IU-UPeC",0
26,"26180",221,182,179,0,3,"IU-UPeC",1
26,"26176",54,46,43,1,3,"IU-UPeC",1
26,"26031",106,81,81,0,0,"IU-UPeC",2
26,"26047",1969,1614,1596,14,18,"IU-UPeC",24
26,"26023",468,358,355,4,3,"IU-UPeC",13
26,"26015",193,151,149,0,2,"IU-UPeC",5
26,"26115",17,14,14,0,0,"IU-UPeC",0
26,"26056",425,357,353,6,4,"IU-UPeC",7
26,"26076",128,111,110,2,1,"IU-UPeC",0
26,"26082",109,92,89,0,3,"IU-UPeC",1
26,"26007",523,406,401,2,5,"IU-UPeC",14
26,"26020",483,356,344,2,12,"IU-UPeC",2
26,"26024",236,183,183,0,0,"IU-UPeC",5
26,"26121",27,21,21,0,0,"IU-UPeC",0
26,"26134",87,65,65,1,0,"IU-UPeC",1
26,"26174",147,122,112,0,10,"IU-UPeC",3
26,"26126",31,29,29,0,0,"IU-UPeC",0
26,"26081",16,14,14,0,0,"IU-UPeC",0
26,"26166",142,131,128,1,3,"IU-UPeC",4
26,"26073",98,83,83,0,0,"IU-UPeC",1
26,"26053",208,161,160,1,1,"IU-UPeC",7
26,"26157",296,236,232,3,4,"IU-UPeC",3
26,"26010",98,78,78,1,0,"IU-UPeC",1
26,"26037",131,111,111,1,0,"IU-UPeC",16
26,"26060",85,67,67,1,0,"IU-UPeC",1
26,"26163",143,117,117,2,0,"IU-UPeC",2
26,"26042",836,645,635,5,10,"IU-UPeC",13
26,"26101",46,34,34,0,0,"IU-UPeC",0
26,"26179",42,34,33,0,1,"IU-UPeC",0
26,"26172",30,25,25,0,0,"IU-UPeC",0
26,"26131",34,33,33,1,0,"IU-UPeC",1
26,"26041",134,97,94,1,3,"IU-UPeC",2
26,"26058",150,114,113,0,1,"IU-UPeC",10
26,"26026",1323,1070,1060,8,10,"IU-UPeC",24
26,"26054",324,255,254,3,1,"IU-UPeC",7
26,"26099",1259,1038,1024,7,14,"IU-UPeC",19
26,"26181",15,13,13,0,0,"IU-UPeC",0
26,"26077",27,25,25,0,0,"IU-UPeC",0
26,"26093",57,44,44,0,0,"IU-UPeC",2
26,"26075",334,268,264,2,4,"IU-UPeC",7
26,"26132",111,88,88,1,0,"IU-UPeC",3
26,"26102",6128,4673,4585,42,88,"IU-UPeC",203
26,"26048",22,22,21,0,1,"IU-UPeC",0
26,"26138",4600,3374,3325,28,49,"IU-UPeC",153
26,"26124",824,664,659,8,5,"IU-UPeC",14
26,"26161",7,7,7,0,0,"IU-UPeC",0
26,"26107",92,75,75,0,0,"IU-UPeC",1
26,"26002",840,615,608,6,7,"IU-UPeC",11
26,"26069",240,201,199,0,2,"IU-UPeC",8
26,"26144",194,150,148,2,2,"IU-UPeC",5
26,"26044",51,46,45,0,1,"IU-UPeC",1
26,"26072",289,259,258,2,1,"IU-UPeC",7
26,"26028",133,112,111,0,1,"IU-UPeC",8
26,"26143",217,178,177,0,1,"IU-UPeC",5
26,"26068",82,68,66,0,2,"IU-UPeC",3
26,"26136",103,73,72,1,1,"IU-UPeC",1
26,"26162",121,106,106,2,0,"IU-UPeC",3
26,"26095",101,78,77,1,1,"IU-UPeC",6
26,"26012",23,23,23,0,0,"IU-UPeC",1
26,"26112",243,192,191,1,1,"IU-UPeC",3
26,"26173",6,6,6,1,0,"IU-UPeC",0
26,"26123",130,111,108,0,3,"IU-UPeC",3
26,"26006",1809,1420,1410,14,10,"IU-UPeC",66
26,"26096",244,199,197,3,2,"IU-UPeC",7
26,"26055",42,33,33,0,0,"IU-UPeC",1
26,"26045",12,12,12,0,0,"IU-UPeC",0
26,"26021",2819,2113,2077,23,36,"IU-UPeC",31
26,"26035",16,12,12,0,0,"IU-UPeC",0
26,"26063",122,97,96,0,1,"IU-UPeC",3
26,"26108",268,207,205,5,2,"IU-UPeC",9
26,"26019",351,282,281,1,1,"IU-UPeC",14
26,"26003",416,336,330,2,6,"IU-UPeC",3
26,"26100",52,43,43,0,0,"IU-UPeC",2
26,"26118",61,49,49,1,0,"IU-UPeC",3
26,"26050",117,86,86,0,0,"IU-UPeC",2
26,"26083",289,213,213,1,0,"IU-UPeC",5
26,"26070",186,154,153,1,1,"IU-UPeC",0
26,"26125",2708,2013,1988,22,25,"IU-UPeC",30
26,"26154",11,8,8,0,0,"IU-UPeC",1
26,"26139",54,46,46,0,0,"IU-UPeC",5
26,"26152",31,24,23,0,1,"IU-UPeC",0
26,"26130",203,167,166,1,1,"IU-UPeC",6
26,"26167",59,45,45,1,0,"IU-UPeC",1
26,"26155",162,138,137,0,1,"IU-UPeC",0
26,"26151",446,380,375,1,5,"IU-UPeC",14
26,"26043",373,284,282,4,2,"IU-UPeC",13
26,"26089",110513,85146,84302,712,844,"IU-UPeC",4028
26,"26164",61,41,41,0,0,"IU-UPeC",2
26,"26128",104,80,79,0,1,"IU-UPeC",2
26,"26059",1117,850,840,9,10,"IU-UPeC",28
26,"26153",12,11,10,0,1,"IU-UPeC",0
26,"26142",780,618,613,1,5,"IU-UPeC",16
26,"26033",172,143,142,2,1,"IU-UPeC",5
26,"26051",254,202,201,2,1,"IU-UPeC",7
26,"26106",88,78,78,0,0,"IU-UPeC",0
26,"26175",52,44,44,2,0,"IU-UPeC",0
26,"26150",117,98,98,1,0,"IU-UPeC",0
26,"26177",309,266,264,2,2,"IU-UPeC",4
15,"15027",1540,1224,1203,6,21,"RECORTES CE",1
15,"15061",5646,3945,3894,35,51,"RECORTES CE",3
15,"15009",10780,8075,7957,70,118,"RECORTES CE",15
15,"15073",21884,14792,14587,149,205,"RECORTES CE",28
15,"15055",4618,3208,3159,49,49,"RECORTES CE",12
15,"15045",3803,2382,2354,15,28,"RECORTES CE",2
15,"15058",27623,21002,20788,257,214,"RECORTES CE",55
15,"15034",2897,1931,1909,14,22,"RECORTES CE",3
15,"15018",1156,817,806,7,11,"RECORTES CE",2
15,"15001",4805,3466,3419,45,47,"RECORTES CE",4
15,"15015",2840,2126,2100,21,26,"RECORTES CE",2
15,"15010",1913,1355,1338,21,17,"RECORTES CE",1
15,"15038",2236,1556,1530,18,26,"RECORTES CE",2
15,"15037",4087,2775,2733,18,42,"RECORTES CE",4
15,"15080",1760,1215,1197,11,18,"RECORTES CE",0
15,"15051",4651,3343,3297,38,46,"RECORTES CE",3
15,"15022",5817,4026,3981,29,45,"RECORTES CE",7
15,"15007",3352,2469,2453,24,16,"RECORTES CE",2
15,"15016",4806,3291,3222,21,69,"RECORTES CE",6
15,"15071",7965,5559,5483,37,76,"RECORTES CE",21
15,"15064",2207,1680,1650,22,30,"RECORTES CE",6
15,"15031",23321,17319,17152,218,167,"RECORTES CE",38
15,"15008",5650,4239,4175,42,64,"RECORTES CE",7
15,"15074",4061,2983,2947,24,36,"RECORTES CE",5
15,"15086",2918,2109,2077,19,32,"RECORTES CE",4
15,"15035",11517,8305,8192,144,113,"RECORTES CE",27
15,"15093",4265,2856,2814,35,42,"RECORTES CE",4
15,"15028",1415,1085,1070,10,15,"RECORTES CE",1
15,"15089",4317,3238,3188,24,50,"RECORTES CE",8
15,"15052",4351,3122,3063,26,59,"RECORTES CE",7
15,"15084",3312,2361,2326,28,35,"RECORTES CE",3
15,"15062",5936,4047,3993,31,54,"RECORTES CE",15
15,"15075",12279,9076,8952,117,124,"RECORTES CE",17
15,"15057",12169,8853,8729,88,124,"RECORTES CE",15
15,"15085",3346,2365,2311,26,54,"RECORTES CE",2
15,"15023",6481,4658,4595,44,63,"RECORTES CE",11
15,"15039",1271,935,917,8,18,"RECORTES CE",2
15,"15025",1069,662,654,5,8,"RECORTES CE",1
15,"15041",9627,7409,7291,79,118,"RECORTES CE",12
15,"15013",6126,4315,4257,43,58,"RECORTES CE",13
15,"15048",4855,3582,3534,41,48,"RECORTES CE",10
15,"15046",6345,4625,4532,53,93,"RECORTES CE",5
15,"15020",3844,2651,2629,17,22,"RECORTES CE",3
15,"15069",6785,5107,5032,54,75,"RECORTES CE",10
15,"15060",5780,4245,4167,48,78,"RECORTES CE",9
15,"15076",2649,1827,1802,24,25,"RECORTES CE",1
15,"15011",15463,11105,10890,92,215,"RECORTES CE",23
15,"15081",1042,819,814,12,5,"RECORTES CE",1
15,"15068",5096,3518,3476,39,42,"RECORTES CE",12
15,"15032",3455,2438,2391,26,47,"RECORTES CE",3
15,"15083",1100,809,795,5,14,"RECORTES CE",1
15,"15067",8073,6067,6000,45,67,"RECORTES CE",10
15,"15021",5099,3673,3611,43,62,"RECORTES CE",9
15,"15036",58409,40932,40506,484,426,"RECORTES CE",93
15,"15014",4034,2809,2757,34,52,"RECORTES CE",11
15,"15090",1182,868,861,13,7,"RECORTES CE",2
15,"15044",1309,955,941,5,14,"RECORTES CE",2
15,"15003",1818,1326,1302,18,24,"RECORTES CE",1
15,"15033",2489,1953,1931,13,22,"RECORTES CE",3
15,"15049",1099,765,755,12,10,"RECORTES CE",2
15,"15002",22929,16941,16742,205,199,"RECORTES CE",40
15,"15053",7783,5386,5314,47,72,"RECORTES CE",11
15,"15065",7345,5517,5412,46,105,"RECORTES CE",17
15,"15079",1562,1092,1075,16,17,"RECORTES CE",3
15,"15059",10406,7710,7553,91,157,"RECORTES CE",14
15,"15005",24459,16742,16482,215,260,"RECORTES CE",51
15,"15082",15162,11273,11134,135,139,"RECORTES CE",30
15,"15030",200245,148692,147426,1699,1266,"RECORTES CE",357
15,"15901",3595,2401,2374,30,27,"RECORTES CE",4
15,"15006",5353,3534,3469,49,65,"RECORTES CE",6
15,"15092",6523,4518,4449,54,69,"RECORTES CE",6
15,"15902",4660,3352,3296,30,56,"RECORTES CE",4
15,"15029",5761,3994,3928,47,66,"RECORTES CE",6
15,"15091",1119,807,784,12,23,"RECORTES CE",0
15,"15072",9626,7024,6920,52,104,"RECORTES CE",12
15,"15019",25902,18111,17866,232,245,"RECORTES CE",38
15,"15042",3060,2170,2127,21,43,"RECORTES CE",6
15,"15017",19380,14272,14098,156,174,"RECORTES CE",45
15,"15087",5804,3942,3901,49,41,"RECORTES CE",6
15,"15043",5147,3834,3764,36,70,"RECORTES CE",12
15,"15054",32177,22065,21778,349,287,"RECORTES CE",69
15,"15047",2463,1669,1633,21,36,"RECORTES CE",0
15,"15088",3550,2398,2372,18,26,"RECORTES CE",3
15,"15066",4039,2950,2894,34,56,"RECORTES CE",11
15,"15056",5757,4167,4108,43,59,"RECORTES CE",3
15,"15050",1843,1089,1070,19,19,"RECORTES CE",1
15,"15078",78093,58164,57487,673,677,"RECORTES CE",147
15,"15024",4412,3325,3278,35,47,"RECORTES CE",2
15,"15012",3666,2787,2721,40,66,"RECORTES CE",7
15,"15070",9117,6514,6390,98,124,"RECORTES CE",15
15,"15040",2763,2050,2017,10,33,"RECORTES CE",5
15,"15004",4855,3594,3535,28,59,"RECORTES CE",5
15,"15077",8303,5648,5544,57,104,"RECORTES CE",9
8,"8031",2308,1648,1637,10,11,"DL",495
8,"8163",18590,12816,12750,72,66,"DL",1414
8,"8042",2233,1668,1653,8,15,"DL",214
8,"8035",12448,8482,8443,54,39,"DL",1791
8,"8125",25024,18070,17966,99,104,"DL",1096
8,"8183",4524,3125,3103,21,22,"DL",1032
8,"8073",61659,45611,45356,239,255,"DL",1536
8,"8061",1485,1045,1040,5,5,"DL",152
8,"8123",19114,14573,14509,81,64,"DL",2162
8,"8079",339,254,248,2,6,"DL",82
8,"8255",140,90,90,1,0,"DL",39
8,"8147",17001,12422,12333,62,89,"DL",1354
8,"8216",25,17,17,0,0,"DL",2
8,"8062",951,676,674,5,2,"DL",139
8,"8274",4702,3349,3323,35,26,"DL",549
8,"8277",162,132,132,0,0,"DL",54
8,"8151",463,336,333,11,3,"DL",160
8,"8136",11416,8425,8388,63,37,"DL",447
8,"8242",216,172,170,0,2,"DL",71
8,"8185",194,132,132,0,0,"DL",39
8,"8270",18399,12948,12869,83,79,"DL",2098
8,"8250",7046,4908,4878,33,30,"DL",289
8,"8131",699,520,516,4,4,"DL",169
8,"8058",1742,1210,1194,7,16,"DL",168
8,"8122",1683,1117,1106,10,11,"DL",187
8,"8025",1486,1087,1083,13,4,"DL",180
8,"8179",579,427,425,6,2,"DL",89
8,"8182",2803,2039,2034,16,5,"DL",181
8,"8224",816,598,595,7,3,"DL",127
8,"8221",12391,9503,9456,49,47,"DL",1857
8,"8086",13550,9448,9395,66,53,"DL",1125
8,"8083",1674,1287,1275,8,12,"DL",547
8,"8217",24985,19385,19317,130,68,"DL",1487
8,"8225",93,71,71,2,0,"DL",43
8,"8050",141,107,104,0,3,"DL",60
8,"8076",16173,11553,11473,73,80,"DL",1134
8,"8174",394,306,300,3,6,"DL",74
8,"8047",3978,2640,2614,21,26,"DL",503
8,"8052",139,94,94,2,0,"DL",42
8,"8121",86293,61426,61070,450,356,"DL",7823
8,"8239",451,324,324,5,0,"DL",90
8,"8229",535,383,379,3,4,"DL",156
8,"8189",126,95,94,2,1,"DL",55
8,"8218",8045,5643,5613,54,30,"DL",924
8,"8184",53690,37794,37636,200,158,"DL",2386
8,"8227",2329,1625,1607,13,18,"DL",456
8,"8256",644,516,512,1,4,"DL",87
8,"8022",12230,7792,7717,60,75,"DL",2395
8,"8278",4764,3372,3358,16,14,"DL",1590
8,"8048",583,426,424,5,2,"DL",147
8,"8252",24521,18605,18514,110,91,"DL",745
8,"8261",2319,1638,1632,4,6,"DL",262
8,"8069",3168,2333,2324,17,9,"DL",376
8,"8080",38,28,27,0,1,"DL",7
8,"8286",2904,2009,1997,17,12,"DL",257
8,"8190",258,179,177,2,2,"DL",52
8,"8282",6517,5027,5017,40,10,"DL",1090
8,"8178",430,317,315,4,2,"DL",94
8,"8290",1490,1163,1155,5,8,"DL",270
8,"8268",1011,702,699,2,3,"DL",157
8,"8126",8709,6454,6425,34,29,"DL",669
8,"8023",6715,4669,4633,25,36,"DL",725
8,"8116",582,421,418,4,3,"DL",196
8,"8084",1135,795,790,6,5,"DL",204
8,"8019",1141245,824778,820790,5063,3988,"DL",119367
8,"8027",690,527,524,3,3,"DL",150
8,"8053",2805,1789,1775,10,14,"DL",324
8,"8024",381,270,269,3,1,"DL",104
8,"8247",958,716,714,7,2,"DL",297
8,"8291",4524,3226,3206,24,20,"DL",367
8,"8188",117,81,81,2,0,"DL",33
8,"8175",3371,2243,2232,25,11,"DL",714
8,"8149",996,662,660,7,2,"DL",230
8,"8157",8361,6311,6277,38,34,"DL",594
8,"8280",101,67,67,3,0,"DL",24
8,"8054",9013,6747,6702,38,45,"DL",690
8,"8223",1850,1279,1263,10,16,"DL",309
8,"8287",1044,806,792,7,14,"DL",285
8,"8281",4841,3577,3553,18,24,"DL",897
8,"8284",12067,7855,7792,66,63,"DL",1338
8,"8266",43128,32806,32660,195,146,"DL",2793
8,"8002",202,142,139,0,3,"DL",63
8,"8259",6623,4921,4885,33,36,"DL",1112
8,"8124",36750,26968,26842,140,126,"DL",1958
8,"8181",7896,5774,5724,41,50,"DL",904
8,"8051",17873,13126,13048,66,78,"DL",2025
8,"8158",3105,2166,2145,18,21,"DL",270
8,"8215",2576,1766,1751,30,15,"DL",582
8,"8285",10260,6893,6843,56,50,"DL",2158
8,"8222",1878,1452,1443,16,9,"DL",241
8,"8139",171,133,132,0,1,"DL",41
8,"8150",258,189,185,0,4,"DL",77
8,"8275",254,202,202,4,0,"DL",98
8,"8245",78581,55798,55530,345,268,"DL",1730
8,"8148",2238,1592,1580,7,12,"DL",124
8,"8092",3768,2621,2600,31,21,"DL",808
8,"8059",342,224,223,3,1,"DL",78
8,"8293",226,162,162,0,0,"DL",58
8,"8003",7118,5140,5108,28,32,"DL",1195
8,"8082",1150,788,783,6,5,"DL",91
8,"8249",266,223,220,2,3,"DL",72
8,"8246",1682,1157,1152,8,5,"DL",491
8,"8197",7605,5331,5317,31,14,"DL",1150
8,"8260",18306,13492,13423,60,69,"DL",868
8,"8101",174802,123863,123197,643,666,"DL",5598
8,"8004",233,181,181,2,0,"DL",90
8,"8228",296,207,204,3,3,"DL",60
8,"8049",1288,860,841,9,19,"DL",320
8,"8127",2224,1439,1429,8,10,"DL",256
8,"8294",1971,1357,1349,8,8,"DL",324
8,"8160",330,217,217,0,0,"DL",95
8,"8153",536,432,431,6,1,"DL",129
8,"8094",1548,1143,1133,12,10,"DL",326
8,"8195",82,64,64,0,0,"DL",36
8,"8146",1297,958,954,16,4,"DL",101
8,"8091",5253,3817,3795,23,22,"DL",509
8,"8167",5879,4463,4448,42,15,"DL",244
8,"8288",1632,1061,1053,4,8,"DL",149
8,"8292",1083,796,791,4,5,"DL",146
8,"8117",2453,1741,1727,23,14,"DL",590
8,"8005",6165,4458,4434,23,24,"DL",1195
8,"8248",5402,3848,3815,27,33,"DL",648
8,"8193",942,637,633,9,4,"DL",142
8,"8263",20974,15086,15001,93,85,"DL",870
8,"8219",15355,11458,11403,86,55,"DL",2481
8,"8095",71,50,50,0,0,"DL",23
8,"8162",2028,1451,1442,8,9,"DL",193
8,"8251",4970,3505,3480,14,25,"DL",464
8,"8129",456,322,320,3,2,"DL",106
8,"8063",448,363,363,8,0,"DL",138
8,"8006",11427,7789,7727,46,62,"DL",1721
8,"8096",42411,30717,30550,204,167,"DL",4912
8,"8264",4288,3045,3030,30,15,"DL",741
8,"8220",2358,1783,1770,18,13,"DL",839
8,"8074",10587,7309,7274,51,35,"DL",622
8,"8085",985,712,704,1,8,"DL",278
8,"8253",133,85,85,1,0,"DL",49
8,"8297",138,100,99,1,1,"DL",46
8,"8093",26,19,19,0,0,"DL",11
8,"8159",14049,10329,10284,51,45,"DL",829
8,"8118",17516,12878,12820,79,58,"DL",2295
8,"8283",5983,4032,4007,31,25,"DL",1323
8,"8232",1797,1276,1266,14,10,"DL",323
8,"8097",1027,736,731,7,5,"DL",177
8,"8020",4876,3702,3678,25,24,"DL",679
8,"8199",665,466,464,6,2,"DL",177
8,"8008",187,118,118,1,0,"DL",22
8,"8164",911,651,644,2,7,"DL",201
8,"8236",1525,1077,1067,3,10,"DL",257
8,"8098",2387,1668,1662,11,6,"DL",319
8,"8120",6815,5071,5045,34,26,"DL",2247
8,"8254",1746,1261,1257,13,4,"DL",497
8,"8262",6855,4522,4491,46,31,"DL",652
8,"8233",1876,1247,1237,11,10,"DL",454
8,"8128",564,378,377,1,1,"DL",105
8,"8295",10850,7651,7617,33,34,"DL",755
8,"8028",1031,724,721,6,3,"DL",62
8,"8021",69,52,51,3,1,"DL",16
8,"8009",9136,6613,6578,40,35,"DL",1356
8,"8132",379,259,256,3,3,"DL",117
8,"8161",11145,7658,7621,45,37,"DL",903
8,"8143",2686,1892,1881,19,11,"DL",351
8,"8154",694,535,529,3,6,"DL",134
8,"8088",11840,8684,8627,55,57,"DL",2067
8,"8066",1364,1029,1025,10,4,"DL",123
8,"8289",4304,3166,3151,19,15,"DL",506
8,"8099",749,514,513,4,1,"DL",127
8,"8234",3187,2331,2322,11,9,"DL",365
8,"8300",5682,4328,4312,21,16,"DL",572
8,"8045",72,42,39,0,3,"DL",16
8,"8055",512,366,364,2,2,"DL",98
8,"8267",6435,4571,4542,24,29,"DL",617
8,"8155",6736,4779,4734,45,45,"DL",508
8,"8166",1000,680,674,4,6,"DL",224
8,"8010",4196,2876,2852,16,24,"DL",750
8,"8257",110,87,87,0,0,"DL",40
8,"8067",5723,3896,3874,39,22,"DL",1117
8,"8235",3683,2612,2595,22,17,"DL",787
8,"8056",41996,30076,29974,178,102,"DL",2395
8,"8156",10923,8013,7964,50,49,"DL",1168
8,"8231",20495,13961,13885,91,76,"DL",1298
8,"8007",6505,4532,4495,28,37,"DL",1056
8,"8191",5287,3732,3712,31,20,"DL",824
8,"8046",13243,9747,9693,74,54,"DL",1781
8,"8011",1760,1230,1217,10,13,"DL",438
8,"8302",9209,6571,6524,65,47,"DL",306
8,"8012",1676,1175,1170,24,5,"DL",430
8,"8258",835,602,597,5,5,"DL",217
8,"8265",1548,1115,1108,8,7,"DL",379
8,"8057",59,42,41,2,1,"DL",18
8,"8203",2422,1602,1591,11,11,"DL",275
8,"8068",6729,4765,4739,23,26,"DL",586
8,"8032",1973,1410,1403,6,7,"DL",291
8,"8269",2646,1871,1860,17,11,"DL",671
8,"8087",159,131,130,2,1,"DL",55
8,"8200",61275,45027,44785,276,242,"DL",2171
8,"8001",8825,6810,6760,24,50,"DL",338
8,"8013",1219,873,867,10,6,"DL",277
8,"8168",375,235,234,0,1,"DL",59
8,"8204",3058,2282,2262,17,20,"DL",372
8,"8135",6733,5230,5205,45,25,"DL",381
8,"8226",879,683,680,3,3,"DL",246
8,"8036",159,113,112,1,1,"DL",54
8,"8169",47915,35543,35390,211,153,"DL",1670
8,"8237",1642,1165,1160,4,5,"DL",486
8,"8103",631,431,431,3,0,"DL",96
8,"8114",18335,13196,13092,66,104,"DL",1315
8,"8037",1856,1364,1351,20,13,"DL",572
8,"8070",267,196,193,2,3,"DL",83
8,"8304",814,578,573,1,5,"DL",187
8,"8081",345,255,255,1,0,"DL",102
8,"8026",187,155,155,1,0,"DL",75
8,"8205",59169,45410,45231,357,179,"DL",10092
8,"8014",1953,1438,1429,13,9,"DL",419
8,"8271",69,47,46,0,1,"DL",16
8,"8137",265,206,205,1,1,"DL",79
8,"8038",1488,987,981,10,6,"DL",271
8,"8194",25539,16628,16553,77,75,"DL",701
8,"8238",14478,11302,11252,85,50,"DL",2067
8,"8305",27328,19226,19083,116,143,"DL",3907
8,"8170",447,293,291,11,2,"DL",104
8,"8034",766,542,538,3,4,"DL",173
8,"8071",241,168,164,3,4,"DL",52
8,"8272",157,98,97,0,1,"DL",43
8,"8104",682,445,443,4,2,"DL",153
8,"8060",143,100,99,0,1,"DL",50
8,"8138",4229,2832,2816,19,16,"DL",719
8,"8015",155841,109156,108536,726,620,"DL",7518
8,"8206",731,568,559,9,9,"DL",154
8,"8273",2309,1706,1689,12,17,"DL",527
8,"8072",10240,6957,6935,40,22,"DL",966
8,"8171",2099,1396,1389,20,7,"DL",522
8,"8102",28304,19929,19821,170,108,"DL",4972
8,"8207",1840,1418,1410,17,8,"DL",482
8,"8039",354,259,259,0,0,"DL",77
8,"8303",278,206,205,2,1,"DL",69
8,"8172",20384,14738,14684,85,54,"DL",2092
8,"8240",9354,6996,6953,34,43,"DL",1448
8,"8306",517,360,354,2,6,"DL",80
8,"8029",3438,2645,2632,25,13,"DL",786
8,"8016",1822,1229,1214,12,15,"DL",348
8,"8106",7216,5220,5176,38,44,"DL",768
8,"8196",19247,14101,14047,75,54,"DL",587
8,"8307",48233,34249,34071,209,178,"DL",4369
8,"8230",7611,5590,5560,40,30,"DL",1036
8,"8208",5736,4318,4295,23,23,"DL",473
8,"8017",2756,1888,1876,7,12,"DL",448
8,"8107",11472,8147,8097,45,50,"DL",634
8,"8040",10701,7420,7383,43,37,"DL",1306
8,"8296",1787,1358,1351,9,7,"DL",334
8,"8241",76,59,59,0,0,"DL",23
8,"8140",4769,3344,3335,25,9,"DL",800
8,"8308",131,99,97,0,2,"DL",69
8,"8041",10314,7291,7238,46,53,"DL",550
8,"8187",152527,112013,111491,638,522,"DL",13575
8,"8030",5095,3727,3712,27,15,"DL",1117
8,"8209",6773,4845,4822,31,23,"DL",560
8,"8018",2654,1834,1819,16,15,"DL",387
8,"8130",96,66,66,0,0,"DL",25
8,"8152",114,84,82,1,2,"DL",31
8,"8064",1853,1323,1315,9,8,"DL",407
8,"8115",3817,2835,2814,18,21,"DL",338
8,"8075",3875,2709,2695,12,14,"DL",367
8,"8119",6182,4517,4492,35,25,"DL",431
8,"8108",5014,3757,3740,21,17,"DL",439
8,"8298",26426,17862,17784,113,78,"DL",6203
8,"8141",4590,3173,3150,39,23,"DL",884
8,"8901",232,171,171,6,0,"DL",83
8,"8176",158,113,113,1,0,"DL",48
8,"8142",132,105,104,1,1,"DL",48
8,"8210",4296,2825,2806,22,19,"DL",704
8,"8276",233,169,169,3,0,"DL",47
8,"8243",160,117,117,6,0,"DL",65
8,"8109",214,174,173,0,1,"DL",55
8,"8105",9613,7103,7047,46,56,"DL",210
8,"8902",3756,2758,2741,18,17,"DL",498
8,"8165",1657,1181,1175,8,6,"DL",278
8,"8299",395,256,255,3,1,"DL",98
8,"8043",3190,2216,2201,12,15,"DL",236
8,"8244",5821,4484,4451,32,33,"DL",433
8,"8177",40,25,25,1,0,"DL",6
8,"8033",12803,9236,9179,79,57,"DL",1531
8,"8211",32990,25446,25282,173,164,"DL",2113
8,"8110",13392,9211,9142,67,69,"DL",1366
8,"8077",34550,26102,25983,152,119,"DL",1989
8,"8044",4150,2957,2932,19,25,"DL",519
8,"8903",213,167,167,0,0,"DL",83
8,"8089",33935,24504,24392,150,112,"DL",1704
8,"8100",1992,1496,1485,21,11,"DL",706
8,"8078",216,135,135,2,0,"DL",63
8,"8144",715,493,489,9,4,"DL",162
8,"8111",216,185,185,0,0,"DL",100
8,"8212",495,350,347,3,3,"DL",172
8,"8133",128,76,75,0,1,"DL",35
8,"8201",436,299,298,1,1,"DL",101
8,"8904",10563,7474,7437,32,37,"DL",100
8,"8202",12615,8911,8831,70,80,"DL",2025
8,"8279",152985,110533,110039,684,494,"DL",12337
8,"8198",4391,3167,3138,17,29,"DL",678
8,"8145",2585,1927,1915,10,12,"DL",431
8,"8301",48496,35956,35788,200,168,"DL",1368
8,"8090",129,103,102,2,1,"DL",47
8,"8213",6296,4308,4294,47,14,"DL",1062
8,"8112",12909,8671,8616,50,55,"DL",2460
8,"8905",2305,1789,1774,17,15,"DL",330
8,"8192",5696,4093,4069,38,24,"DL",1045
8,"8134",803,560,554,5,6,"DL",129
8,"8214",6841,5018,4994,49,24,"DL",1192
8,"8180",26616,19621,19542,90,79,"DL",945
8,"8113",52051,34906,34729,229,177,"DL",8356
8,"8065",1179,837,831,8,6,"DL",289
22,"22047",247,213,212,2,1,"RECORTES CE",1
22,"22050",89,78,78,0,0,"RECORTES CE",0
22,"22015",324,238,236,3,2,"RECORTES CE",0
22,"22213",3029,2225,2181,17,44,"RECORTES CE",1
22,"22131",83,63,63,3,0,"RECORTES CE",0
22,"22088",157,116,116,1,0,"RECORTES CE",0
22,"22246",77,51,50,0,1,"RECORTES CE",0
22,"22115",364,270,267,4,3,"RECORTES CE",0
22,"22028",379,297,293,1,4,"RECORTES CE",0
22,"22144",248,195,195,0,0,"RECORTES CE",0
22,"22017",864,658,651,7,7,"RECORTES CE",3
22,"22174",485,400,396,6,4,"RECORTES CE",0
22,"22102",184,160,159,1,1,"RECORTES CE",0
22,"22235",100,77,77,0,0,"RECORTES CE",0
22,"22136",815,596,595,6,1,"RECORTES CE",0
22,"22022",558,431,427,2,4,"RECORTES CE",1
22,"22069",435,340,338,3,2,"RECORTES CE",1
22,"22054",1542,1126,1106,20,20,"RECORTES CE",2
22,"22080",283,217,215,6,2,"RECORTES CE",0
22,"22002",109,94,93,0,1,"RECORTES CE",0
22,"22242",64,45,44,1,1,"RECORTES CE",0
22,"22001",226,166,166,0,0,"RECORTES CE",0
22,"22176",174,140,140,1,0,"RECORTES CE",1
22,"22007",797,607,603,13,4,"RECORTES CE",1
22,"22124",204,143,142,1,1,"RECORTES CE",1
22,"22016",613,447,444,8,3,"RECORTES CE",3
22,"22058",190,152,151,2,1,"RECORTES CE",0
22,"22193",283,235,234,3,1,"RECORTES CE",0
22,"22227",211,153,151,3,2,"RECORTES CE",0
22,"22250",347,258,256,5,2,"RECORTES CE",0
22,"22075",126,82,81,2,1,"RECORTES CE",0
22,"22086",215,162,162,4,0,"RECORTES CE",2
22,"22149",302,236,236,2,0,"RECORTES CE",0
22,"22157",194,151,151,1,0,"RECORTES CE",0
22,"22052",942,743,741,9,2,"RECORTES CE",0
22,"22137",1071,729,719,6,10,"RECORTES CE",0
22,"22079",118,86,86,2,0,"RECORTES CE",0
22,"22013",295,235,233,2,2,"RECORTES CE",0
22,"22178",104,87,87,1,0,"RECORTES CE",0
22,"22096",297,248,248,0,0,"RECORTES CE",0
22,"22059",1137,839,828,7,11,"RECORTES CE",4
22,"22199",7029,5024,4977,55,47,"RECORTES CE",7
22,"22225",2691,1849,1817,24,32,"RECORTES CE",3
22,"22066",707,512,508,8,4,"RECORTES CE",0
22,"22249",119,97,97,1,0,"RECORTES CE",0
22,"22141",118,90,89,1,1,"RECORTES CE",0
22,"22139",83,65,64,0,1,"RECORTES CE",0
22,"22230",290,224,223,2,1,"RECORTES CE",0
22,"22130",10106,6957,6909,57,48,"RECORTES CE",13
22,"22107",123,79,78,2,1,"RECORTES CE",0
22,"22222",527,390,389,5,1,"RECORTES CE",3
22,"22122",62,49,49,1,0,"RECORTES CE",0
22,"22099",490,378,377,4,1,"RECORTES CE",0
22,"22172",560,399,396,2,3,"RECORTES CE",0
22,"22084",534,413,411,3,2,"RECORTES CE",2
22,"22087",72,48,48,1,0,"RECORTES CE",0
22,"22011",89,70,70,1,0,"RECORTES CE",0
22,"22254",1129,804,792,9,12,"RECORTES CE",0
22,"22067",65,45,45,1,0,"RECORTES CE",0
22,"22226",774,591,589,2,2,"RECORTES CE",2
22,"22128",187,146,142,1,4,"RECORTES CE",0
22,"22173",234,158,157,0,1,"RECORTES CE",1
22,"22003",143,119,119,0,0,"RECORTES CE",0
22,"22904",835,600,594,6,6,"RECORTES CE",1
22,"22201",269,189,189,0,0,"RECORTES CE",0
22,"22046",740,578,570,6,8,"RECORTES CE",1
22,"22074",315,229,226,3,3,"RECORTES CE",0
22,"22068",82,65,65,3,0,"RECORTES CE",0
22,"22077",381,295,293,5,2,"RECORTES CE",0
22,"22044",254,191,188,3,3,"RECORTES CE",0
22,"22133",117,89,89,4,0,"RECORTES CE",0
22,"22909",318,238,234,2,4,"RECORTES CE",1
22,"22048",12633,9215,9141,90,74,"RECORTES CE",15
22,"22202",136,112,112,0,0,"RECORTES CE",0
22,"22248",118,92,91,0,1,"RECORTES CE",0
22,"22170",642,518,509,4,9,"RECORTES CE",0
22,"22129",183,128,127,2,1,"RECORTES CE",1
22,"22004",136,79,79,0,0,"RECORTES CE",0
22,"22206",201,141,140,2,1,"RECORTES CE",0
22,"22229",114,81,81,0,0,"RECORTES CE",1
22,"22245",306,258,257,3,1,"RECORTES CE",0
22,"22114",123,80,79,4,1,"RECORTES CE",0
22,"22215",129,91,91,0,0,"RECORTES CE",0
22,"22126",91,65,65,0,0,"RECORTES CE",0
22,"22119",1296,950,940,3,10,"RECORTES CE",1
22,"22029",127,101,100,2,1,"RECORTES CE",0
22,"22009",619,463,461,5,2,"RECORTES CE",0
22,"22212",84,70,70,1,0,"RECORTES CE",0
22,"22187",286,224,221,1,3,"RECORTES CE",0
22,"22032",107,74,71,0,3,"RECORTES CE",0
22,"22018",332,243,242,3,1,"RECORTES CE",0
22,"22207",125,89,88,3,1,"RECORTES CE",0
22,"22062",162,113,113,3,0,"RECORTES CE",0
22,"22907",1459,1112,1104,21,8,"RECORTES CE",4
22,"22063",175,140,140,2,0,"RECORTES CE",0
22,"22116",1443,1048,1038,12,10,"RECORTES CE",1
22,"22200",251,191,189,0,2,"RECORTES CE",0
22,"22109",265,207,206,2,1,"RECORTES CE",1
22,"22127",505,387,386,3,1,"RECORTES CE",0
22,"22243",45,32,32,0,0,"RECORTES CE",0
22,"22143",213,147,147,3,0,"RECORTES CE",0
22,"22055",325,252,245,5,7,"RECORTES CE",0
22,"22085",107,92,90,2,2,"RECORTES CE",0
22,"22177",102,77,77,2,0,"RECORTES CE",0
22,"22908",207,144,140,1,4,"RECORTES CE",1
22,"22158",12005,8628,8554,78,74,"RECORTES CE",22
22,"22012",111,84,82,0,2,"RECORTES CE",0
22,"22083",474,400,396,1,4,"RECORTES CE",0
22,"22051",101,84,84,1,0,"RECORTES CE",0
22,"22163",426,360,356,3,4,"RECORTES CE",0
22,"22036",91,82,82,0,0,"RECORTES CE",0
22,"22105",118,87,86,1,1,"RECORTES CE",0
22,"22252",122,93,91,1,2,"RECORTES CE",0
22,"22117",2497,1788,1770,16,18,"RECORTES CE",2
22,"22110",751,563,558,3,5,"RECORTES CE",1
22,"22057",364,260,259,1,1,"RECORTES CE",0
22,"22020",114,90,90,2,0,"RECORTES CE",0
22,"22045",89,66,66,0,0,"RECORTES CE",0
22,"22209",159,127,127,4,0,"RECORTES CE",0
22,"22090",102,75,75,0,0,"RECORTES CE",0
22,"22082",298,222,220,2,2,"RECORTES CE",0
22,"22053",787,541,535,12,6,"RECORTES CE",3
22,"22014",245,184,183,2,1,"RECORTES CE",0
22,"22175",197,140,140,0,0,"RECORTES CE",0
22,"22165",490,375,372,2,3,"RECORTES CE",0
22,"22234",802,600,597,7,3,"RECORTES CE",2
22,"22111",152,114,113,0,1,"RECORTES CE",0
22,"22072",192,148,147,1,1,"RECORTES CE",0
22,"22236",249,198,198,1,0,"RECORTES CE",0
22,"22203",82,68,67,0,1,"RECORTES CE",1
22,"22039",869,682,681,5,1,"RECORTES CE",4
22,"22006",298,217,215,1,2,"RECORTES CE",0
22,"22142",98,81,79,1,2,"RECORTES CE",0
22,"22164",35,26,26,1,0,"RECORTES CE",0
22,"22021",1970,1485,1469,14,16,"RECORTES CE",0
22,"22195",235,190,189,2,1,"RECORTES CE",2
22,"22151",93,68,68,0,0,"RECORTES CE",0
22,"22182",256,177,176,2,1,"RECORTES CE",0
22,"22150",464,348,348,1,0,"RECORTES CE",0
22,"22081",252,179,177,1,2,"RECORTES CE",0
22,"22023",430,329,329,2,0,"RECORTES CE",1
22,"22162",129,101,101,0,0,"RECORTES CE",0
22,"22232",96,73,70,2,3,"RECORTES CE",0
22,"22103",680,527,522,8,5,"RECORTES CE",2
22,"22228",505,409,407,3,2,"RECORTES CE",2
22,"22078",453,323,319,6,4,"RECORTES CE",1
22,"22903",654,542,536,3,6,"RECORTES CE",1
22,"22168",20,15,15,1,0,"RECORTES CE",0
22,"22106",24,17,17,0,0,"RECORTES CE",0
22,"22253",61,51,50,0,1,"RECORTES CE",0
22,"22189",184,140,137,1,3,"RECORTES CE",0
22,"22060",1165,885,879,3,6,"RECORTES CE",0
22,"22113",494,362,361,3,1,"RECORTES CE",0
22,"22901",754,521,513,9,8,"RECORTES CE",1
22,"22244",52,38,38,0,0,"RECORTES CE",0
22,"22233",82,61,61,0,0,"RECORTES CE",1
22,"22024",225,174,173,0,1,"RECORTES CE",3
22,"22076",305,224,223,0,1,"RECORTES CE",0
22,"22135",192,146,144,0,2,"RECORTES CE",1
22,"22214",128,94,92,0,2,"RECORTES CE",0
22,"22008",173,138,138,3,0,"RECORTES CE",0
22,"22041",163,127,126,4,1,"RECORTES CE",0
22,"22155",77,58,58,2,0,"RECORTES CE",0
22,"22025",1071,726,712,13,14,"RECORTES CE",0
22,"22181",93,62,62,1,0,"RECORTES CE",0
22,"22906",180,146,143,1,3,"RECORTES CE",1
22,"22208",178,142,140,0,2,"RECORTES CE",0
22,"22217",395,307,301,3,6,"RECORTES CE",0
22,"22188",87,66,66,1,0,"RECORTES CE",0
22,"22027",325,218,214,0,4,"RECORTES CE",1
22,"22156",264,202,200,3,2,"RECORTES CE",1
22,"22184",188,156,156,2,0,"RECORTES CE",0
22,"22190",113,83,83,2,0,"RECORTES CE",0
22,"22223",79,63,62,0,1,"RECORTES CE",0
22,"22064",165,115,115,1,0,"RECORTES CE",0
22,"22019",180,156,155,0,1,"RECORTES CE",1
22,"22205",434,334,333,2,1,"RECORTES CE",0
22,"22247",30,23,22,0,1,"RECORTES CE",0
22,"22125",38845,28287,27998,283,289,"RECORTES CE",82
22,"22042",118,102,100,1,2,"RECORTES CE",0
22,"22251",371,283,281,4,2,"RECORTES CE",0
22,"22167",498,397,388,7,9,"RECORTES CE",1
22,"22112",9592,6871,6820,76,51,"RECORTES CE",15
22,"22218",43,35,35,0,0,"RECORTES CE",0
22,"22094",101,77,77,1,0,"RECORTES CE",0
22,"22035",244,171,168,3,3,"RECORTES CE",0
22,"22186",186,139,137,3,2,"RECORTES CE",1
22,"22160",209,161,161,3,0,"RECORTES CE",0
22,"22204",1095,816,805,10,11,"RECORTES CE",3
22,"22197",479,378,373,6,5,"RECORTES CE",0
22,"22905",294,224,224,2,0,"RECORTES CE",2
22,"22095",73,48,48,1,0,"RECORTES CE",0
22,"22061",6685,4796,4740,38,56,"RECORTES CE",5
22,"22221",80,60,59,0,1,"RECORTES CE",0
22,"22239",89,78,76,4,2,"RECORTES CE",0
22,"22089",315,227,222,6,5,"RECORTES CE",0
22,"22902",219,162,160,1,2,"RECORTES CE",0
22,"22049",78,61,61,1,0,"RECORTES CE",0
22,"22220",169,123,122,2,1,"RECORTES CE",2
22,"22040",148,123,121,2,2,"RECORTES CE",1
22,"22043",94,71,70,0,1,"RECORTES CE",0
22,"22037",116,95,94,1,1,"RECORTES CE",0
32,"32029",480,349,346,5,3,"PODEMOS-En",31
32,"32041",772,511,505,5,6,"PODEMOS-En",59
32,"32017",1272,862,849,5,13,"PODEMOS-En",75
32,"32005",869,676,671,7,5,"PODEMOS-En",49
32,"32035",1484,944,938,7,6,"PODEMOS-En",95
32,"32020",2625,1997,1974,10,23,"PODEMOS-En",229
32,"32056",1610,1159,1146,9,13,"PODEMOS-En",94
32,"32073",1332,976,965,4,11,"PODEMOS-En",135
32,"32071",1496,1013,1004,1,9,"PODEMOS-En",150
32,"32001",4978,3644,3607,31,37,"PODEMOS-En",820
32,"32087",1798,1421,1397,7,24,"PODEMOS-En",177
32,"32083",860,580,574,4,6,"PODEMOS-En",49
32,"32022",1377,963,951,7,12,"PODEMOS-En",120
32,"32003",886,661,653,6,8,"PODEMOS-En",93
32,"32030",1015,702,689,3,13,"PODEMOS-En",82
32,"32053",1447,1140,1128,12,12,"PODEMOS-En",173
32,"32016",825,559,556,3,3,"PODEMOS-En",40
32,"32015",899,586,581,5,5,"PODEMOS-En",51
32,"32091",1909,1389,1375,8,14,"PODEMOS-En",120
32,"32084",925,657,650,3,7,"PODEMOS-En",67
32,"32014",1170,855,845,7,10,"PODEMOS-En",110
32,"32049",775,502,495,5,7,"PODEMOS-En",67
32,"32045",2484,1820,1795,19,25,"PODEMOS-En",230
32,"32075",4188,3257,3206,43,51,"PODEMOS-En",523
32,"32037",742,544,532,8,12,"PODEMOS-En",59
32,"32006",1571,1140,1127,10,13,"PODEMOS-En",106
32,"32060",845,609,598,6,11,"PODEMOS-En",137
32,"32044",900,658,647,5,11,"PODEMOS-En",133
32,"32061",1093,852,840,3,12,"PODEMOS-En",69
32,"32081",2097,1566,1553,6,13,"PODEMOS-En",253
32,"32039",1275,989,976,5,13,"PODEMOS-En",136
32,"32079",1343,1000,987,9,13,"PODEMOS-En",121
32,"32077",1188,813,796,8,17,"PODEMOS-En",126
32,"32008",8188,5923,5845,44,78,"PODEMOS-En",1299
32,"32054",87290,63653,62823,671,830,"PODEMOS-En",15273
32,"32002",2016,1474,1460,11,14,"PODEMOS-En",206
32,"32048",906,573,564,6,9,"PODEMOS-En",80
32,"32088",1632,1062,1042,8,20,"PODEMOS-En",152
32,"32052",1904,1450,1426,6,24,"PODEMOS-En",190
32,"32010",394,299,298,0,1,"PODEMOS-En",41
32,"32057",575,414,412,5,2,"PODEMOS-En",51
32,"32086",2671,1731,1712,10,19,"PODEMOS-En",225
32,"32082",1259,905,887,6,18,"PODEMOS-En",89
32,"32062",832,646,644,7,2,"PODEMOS-En",60
32,"32058",5209,3808,3750,27,58,"PODEMOS-En",708
32,"32026",2736,2039,1998,25,41,"PODEMOS-En",390
32,"32072",3833,2799,2761,26,38,"PODEMOS-En",657
32,"32080",333,266,265,0,1,"PODEMOS-En",31
32,"32069",4333,3324,3261,25,63,"PODEMOS-En",711
32,"32067",1300,838,824,15,14,"PODEMOS-En",134
32,"32065",669,494,482,3,12,"PODEMOS-En",67
32,"32038",456,299,297,2,2,"PODEMOS-En",35
32,"32092",528,337,334,4,3,"PODEMOS-En",51
32,"32023",1217,884,877,6,7,"PODEMOS-En",124
32,"32018",1261,956,945,3,11,"PODEMOS-En",130
32,"32034",1141,880,873,4,7,"PODEMOS-En",91
32,"32089",1332,917,904,5,13,"PODEMOS-En",66
32,"32046",1179,840,832,5,8,"PODEMOS-En",130
32,"32027",1072,765,747,3,18,"PODEMOS-En",72
32,"32059",1849,1357,1339,16,18,"PODEMOS-En",169
32,"32004",1826,900,897,8,3,"PODEMOS-En",37
32,"32011",934,559,548,5,11,"PODEMOS-En",32
32,"32070",566,335,330,3,5,"PODEMOS-En",40
32,"32042",1585,1120,1104,13,16,"PODEMOS-En",143
32,"32064",526,397,395,1,2,"PODEMOS-En",25
32,"32033",750,504,500,4,4,"PODEMOS-En",42
32,"32024",4839,3424,3368,35,56,"PODEMOS-En",459
32,"32028",1643,1195,1174,18,21,"PODEMOS-En",99
32,"32019",11529,8038,7906,78,132,"PODEMOS-En",1199
32,"32078",1243,876,869,6,7,"PODEMOS-En",84
32,"32007",1527,1078,1070,7,8,"PODEMOS-En",108
32,"32074",1064,731,719,4,12,"PODEMOS-En",66
32,"32085",10709,7489,7403,81,86,"PODEMOS-En",1225
32,"32025",1094,821,809,3,12,"PODEMOS-En",107
32,"32055",1310,952,936,7,16,"PODEMOS-En",134
32,"32090",791,558,556,2,2,"PODEMOS-En",52
32,"32063",1939,1329,1314,16,15,"PODEMOS-En",241
32,"32032",8101,5993,5881,74,112,"PODEMOS-En",1033
32,"32021",956,664,662,2,2,"PODEMOS-En",91
32,"32066",567,435,434,2,1,"PODEMOS-En",20
32,"32068",1424,974,969,8,5,"PODEMOS-En",99
32,"32050",2455,1874,1855,17,19,"PODEMOS-En",215
32,"32051",1458,1141,1137,4,4,"PODEMOS-En",77
32,"32036",1369,1053,1040,5,13,"PODEMOS-En",108
32,"32043",2555,1824,1793,15,31,"PODEMOS-En",310
32,"32076",2121,1509,1489,12,20,"PODEMOS-En",138
32,"32031",1079,826,812,5,14,"PODEMOS-En",96
32,"32013",2213,1447,1431,8,16,"PODEMOS-En",127
32,"32012",811,535,533,3,2,"PODEMOS-En",70
32,"32009",10783,7555,7468,60,87,"PODEMOS-En",1313
32,"32040",1472,1112,1089,9,23,"PODEMOS-En",142
32,"32047",1818,1345,1329,3,16,"PODEMOS-En",146
23,"23006",4636,3761,3714,25,47,"RECORTES CE",0
23,"23086",11537,8362,8242,91,120,"RECORTES CE",26
23,"23004",435,350,346,0,4,"RECORTES CE",1
23,"23082",1924,1420,1413,6,7,"RECORTES CE",0
23,"23070",3931,2549,2533,11,16,"RECORTES CE",0
23,"23042",299,220,220,1,0,"RECORTES CE",0
23,"23056",3108,2365,2343,14,22,"RECORTES CE",1
23,"23075",3319,2640,2618,21,22,"RECORTES CE",0
23,"23030",1232,1020,1007,10,13,"RECORTES CE",0
23,"23074",3030,2368,2353,12,15,"RECORTES CE",1
23,"23061",7520,5481,5405,55,76,"RECORTES CE",1
23,"23049",1834,1384,1378,7,6,"RECORTES CE",0
23,"23018",2326,1678,1668,5,10,"RECORTES CE",1
23,"23094",3852,3097,3061,17,36,"RECORTES CE",1
23,"23087",11313,8540,8454,64,86,"RECORTES CE",6
23,"23098",875,728,722,2,6,"RECORTES CE",0
23,"23001",993,826,820,1,6,"RECORTES CE",0
23,"23009",12866,9787,9667,64,120,"RECORTES CE",5
23,"23069",5385,4406,4318,15,88,"RECORTES CE",5
23,"23057",771,648,648,4,0,"RECORTES CE",0
23,"23032",575,461,457,1,4,"RECORTES CE",0
23,"23005",30539,21840,21629,176,211,"RECORTES CE",18
23,"23037",516,427,423,1,4,"RECORTES CE",0
23,"23058",8665,6651,6585,47,66,"RECORTES CE",73
23,"23059",5856,4498,4450,33,48,"RECORTES CE",5
23,"23046",2405,1963,1934,3,29,"RECORTES CE",2
23,"23048",860,636,630,1,6,"RECORTES CE",2
23,"23028",6203,4645,4585,33,60,"RECORTES CE",3
23,"23095",8737,6303,6268,34,35,"RECORTES CE",1
23,"23027",727,577,576,8,1,"RECORTES CE",0
23,"23026",3636,2724,2685,11,39,"RECORTES CE",0
23,"23904",2852,1784,1764,14,20,"RECORTES CE",0
23,"23045",2139,1560,1551,9,9,"RECORTES CE",0
23,"23014",2561,1982,1959,8,23,"RECORTES CE",1
23,"23008",1518,1185,1173,18,12,"RECORTES CE",0
23,"23060",19157,13567,13438,133,129,"RECORTES CE",9
23,"23090",1316,1077,1071,8,6,"RECORTES CE",0
23,"23002",17450,13199,12986,92,213,"RECORTES CE",11
23,"23021",528,452,448,0,4,"RECORTES CE",0
23,"23073",4558,3427,3402,11,25,"RECORTES CE",1
23,"23071",1728,1337,1328,7,9,"RECORTES CE",3
23,"23903",3550,2742,2721,19,21,"RECORTES CE",1
23,"23019",1562,1249,1227,4,22,"RECORTES CE",0
23,"23040",1489,1226,1211,4,15,"RECORTES CE",2
23,"23093",3257,2534,2506,21,28,"RECORTES CE",3
23,"23092",27765,20688,20560,143,128,"RECORTES CE",12
23,"23024",12512,9391,9182,79,209,"RECORTES CE",5
23,"23091",742,609,607,5,2,"RECORTES CE",0
23,"23054",382,276,275,0,1,"RECORTES CE",0
23,"23015",1393,1061,1052,3,9,"RECORTES CE",0
23,"23003",8709,6520,6440,42,80,"RECORTES CE",4
23,"23043",549,401,400,0,1,"RECORTES CE",2
23,"23034",2558,1987,1977,18,10,"RECORTES CE",0
23,"23063",3845,2934,2898,24,36,"RECORTES CE",2
23,"23080",1786,1347,1329,6,18,"RECORTES CE",0
23,"23041",504,396,392,1,4,"RECORTES CE",0
23,"23076",837,672,658,4,14,"RECORTES CE",0
23,"23096",2643,2174,2140,14,34,"RECORTES CE",1
23,"23033",1356,1080,1065,8,15,"RECORTES CE",1
23,"23007",3102,2381,2369,8,12,"RECORTES CE",9
23,"23047",1638,1311,1306,9,5,"RECORTES CE",1
23,"23016",396,323,318,3,5,"RECORTES CE",0
23,"23017",1584,1265,1253,4,12,"RECORTES CE",0
23,"23055",47421,33170,32908,213,262,"RECORTES CE",36
23,"23101",388,281,279,0,2,"RECORTES CE",0
23,"23097",6445,4313,4290,30,23,"RECORTES CE",3
23,"23088",6124,4764,4703,31,61,"RECORTES CE",0
23,"23029",854,631,623,2,8,"RECORTES CE",1
23,"23025",2813,2186,2163,7,23,"RECORTES CE",1
23,"23039",2220,1658,1626,8,32,"RECORTES CE",0
23,"23085",2273,1833,1814,3,19,"RECORTES CE",1
23,"23053",9526,6783,6736,49,47,"RECORTES CE",2
23,"23067",2489,1869,1847,18,22,"RECORTES CE",2
23,"23012",4177,3016,2988,22,28,"RECORTES CE",0
23,"23050",91221,67753,67164,549,589,"RECORTES CE",71
23,"23072",2002,1593,1582,6,11,"RECORTES CE",0
23,"23038",3557,2851,2831,11,20,"RECORTES CE",5
23,"23077",637,515,514,3,1,"RECORTES CE",0
23,"23902",2327,1877,1857,9,20,"RECORTES CE",0
23,"23065",1601,1222,1207,0,15,"RECORTES CE",0
23,"23066",4376,3530,3508,46,22,"RECORTES CE",7
23,"23079",3733,2994,2981,26,13,"RECORTES CE",1
23,"23052",1138,977,971,6,6,"RECORTES CE",0
23,"23010",14371,10249,10140,65,109,"RECORTES CE",7
23,"23044",4847,3801,3740,26,61,"RECORTES CE",1
23,"23035",1095,871,867,8,4,"RECORTES CE",0
23,"23031",751,662,650,9,12,"RECORTES CE",0
23,"23084",953,711,708,6,3,"RECORTES CE",1
23,"23081",1546,1145,1132,6,13,"RECORTES CE",0
23,"23905",1861,1351,1345,7,6,"RECORTES CE",2
23,"23062",1461,1188,1181,1,7,"RECORTES CE",0
23,"23099",4734,3509,3459,23,50,"RECORTES CE",2
23,"23901",1160,978,972,5,6,"RECORTES CE",0
23,"23020",1584,1376,1366,5,10,"RECORTES CE",0
23,"23011",2193,1616,1600,11,16,"RECORTES CE",0
23,"23051",2762,2258,2231,9,27,"RECORTES CE",6
23,"23064",1659,1368,1364,1,4,"RECORTES CE",0
3,"3037",352,296,293,3,3,"PODEMOS-COM",89
3,"3091",247,217,215,1,2,"PODEMOS-COM",33
3,"3020",102,79,79,0,0,"PODEMOS-COM",17
3,"3045",216,182,179,1,3,"PODEMOS-COM",29
3,"3119",16534,12466,12363,69,103,"PODEMOS-COM",2766
3,"3100",508,446,442,1,4,"PODEMOS-COM",154
3,"3106",596,503,501,1,2,"PODEMOS-COM",116
3,"3022",142,120,120,2,0,"PODEMOS-COM",41
3,"3002",3610,2714,2682,18,32,"PODEMOS-COM",551
3,"3030",513,432,424,0,8,"PODEMOS-COM",113
3,"3029",242,186,183,1,3,"PODEMOS-COM",45
3,"3034",1367,1095,1079,4,16,"PODEMOS-COM",179
3,"3118",2452,1732,1714,9,18,"PODEMOS-COM",279
3,"3135",214,176,174,0,2,"PODEMOS-COM",49
3,"3043",2900,2516,2483,18,33,"PODEMOS-COM",577
3,"3110",289,239,239,1,0,"PODEMOS-COM",98
3,"3039",85,61,59,0,2,"PODEMOS-COM",22
3,"3018",12212,9129,9040,64,89,"PODEMOS-COM",2369
3,"3127",352,279,277,1,2,"PODEMOS-COM",52
3,"3012",1072,862,849,3,13,"PODEMOS-COM",136
3,"3053",7196,5800,5736,37,64,"PODEMOS-COM",1316
3,"3026",1224,970,949,6,21,"PODEMOS-COM",289
3,"3009",46817,36581,36258,240,323,"PODEMOS-COM",10900
3,"3010",325,278,276,0,2,"PODEMOS-COM",84
3,"3072",351,288,287,2,1,"PODEMOS-COM",100
3,"3074",1706,1400,1382,3,18,"PODEMOS-COM",142
3,"3099",42365,31612,31259,220,353,"PODEMOS-COM",4709
3,"3017",376,317,312,3,5,"PODEMOS-COM",118
3,"3129",1187,991,984,8,7,"PODEMOS-COM",232
3,"3032",106,90,89,1,1,"PODEMOS-COM",17
3,"3027",159,135,132,0,3,"PODEMOS-COM",28
3,"3137",653,516,515,5,1,"PODEMOS-COM",171
3,"3097",990,817,811,8,6,"PODEMOS-COM",295
3,"3024",3904,3109,3060,17,49,"PODEMOS-COM",334
3,"3003",455,393,388,3,5,"PODEMOS-COM",119
3,"3051",350,310,305,1,5,"PODEMOS-COM",58
3,"3056",8737,6809,6731,33,78,"PODEMOS-COM",1795
3,"3035",663,543,538,1,5,"PODEMOS-COM",160
3,"3120",2416,1814,1783,13,31,"PODEMOS-COM",301
3,"3028",1006,833,823,1,10,"PODEMOS-COM",209
3,"3101",4765,3708,3659,13,49,"PODEMOS-COM",1447
3,"3093",19661,15155,14988,84,167,"PODEMOS-COM",3382
3,"3066",42291,31010,30781,190,229,"PODEMOS-COM",6691
3,"3004",585,455,454,1,1,"PODEMOS-COM",116
3,"3089",9599,7100,6980,39,120,"PODEMOS-COM",1475
3,"3042",1367,1045,1033,5,12,"PODEMOS-COM",272
3,"3105",5387,4089,4017,21,72,"PODEMOS-COM",646
3,"3015",12544,9478,9388,58,90,"PODEMOS-COM",1370
3,"3025",1270,1003,996,3,7,"PODEMOS-COM",96
3,"3904",1393,1065,1057,8,8,"PODEMOS-COM",187
3,"3136",446,361,361,2,0,"PODEMOS-COM",105
3,"3016",94,79,79,0,0,"PODEMOS-COM",18
3,"3115",248,219,219,2,0,"PODEMOS-COM",56
3,"3111",5411,4044,3967,14,77,"PODEMOS-COM",641
3,"3102",7271,5762,5687,46,75,"PODEMOS-COM",1906
3,"3064",5040,3887,3834,16,53,"PODEMOS-COM",518
3,"3112",653,522,517,2,5,"PODEMOS-COM",101
3,"3086",153,134,134,1,0,"PODEMOS-COM",46
3,"3125",346,263,262,0,1,"PODEMOS-COM",89
3,"3134",148,132,132,2,0,"PODEMOS-COM",37
3,"3069",3060,2187,2168,9,19,"PODEMOS-COM",506
3,"3902",10213,7091,6997,52,94,"PODEMOS-COM",824
3,"3061",1057,828,816,2,12,"PODEMOS-COM",102
3,"3067",98,82,81,1,1,"PODEMOS-COM",18
3,"3036",91,80,79,2,1,"PODEMOS-COM",27
3,"3090",17087,12723,12602,69,121,"PODEMOS-COM",2954
3,"3044",4512,3639,3586,16,53,"PODEMOS-COM",483
3,"3021",5627,4691,4613,23,78,"PODEMOS-COM",1012
3,"3096",5811,4539,4492,19,47,"PODEMOS-COM",1110
3,"3046",1594,1185,1178,9,7,"PODEMOS-COM",294
3,"3130",47,30,30,0,0,"PODEMOS-COM",8
3,"3080",1299,1065,1036,3,29,"PODEMOS-COM",117
3,"3007",168,142,138,0,4,"PODEMOS-COM",45
3,"3050",18601,13710,13610,61,100,"PODEMOS-COM",3224
3,"3107",2459,1807,1791,5,16,"PODEMOS-COM",535
3,"3085",270,226,225,1,1,"PODEMOS-COM",61
3,"3901",1129,855,853,5,2,"PODEMOS-COM",273
3,"3903",2482,1945,1926,16,19,"PODEMOS-COM",287
3,"3128",4097,2972,2942,12,30,"PODEMOS-COM",704
3,"3070",2038,1526,1499,5,27,"PODEMOS-COM",247
3,"3063",26383,19376,19255,105,121,"PODEMOS-COM",5481
3,"3131",175,159,153,0,6,"PODEMOS-COM",51
3,"3133",41763,26236,26039,134,197,"PODEMOS-COM",5767
3,"3047",9161,6622,6534,35,88,"PODEMOS-COM",1578
3,"3055",5168,3949,3899,13,50,"PODEMOS-COM",549
3,"3031",41486,28059,27851,152,208,"PODEMOS-COM",5763
3,"3104",27134,21080,20902,156,178,"PODEMOS-COM",5033
3,"3109",2850,2301,2275,11,26,"PODEMOS-COM",283
3,"3088",5498,4078,4030,42,48,"PODEMOS-COM",749
3,"3114",1568,1216,1203,8,13,"PODEMOS-COM",170
3,"3062",213,176,175,0,1,"PODEMOS-COM",38
3,"3054",338,274,268,4,6,"PODEMOS-COM",55
3,"3060",108,92,90,1,2,"PODEMOS-COM",38
3,"3098",507,403,394,3,9,"PODEMOS-COM",97
3,"3071",3980,3134,3106,28,28,"PODEMOS-COM",995
3,"3001",337,289,286,3,3,"PODEMOS-COM",86
3,"3092",6749,5398,5342,40,56,"PODEMOS-COM",1861
3,"3048",4858,3785,3735,25,50,"PODEMOS-COM",718
3,"3005",7753,6158,6118,38,40,"PODEMOS-COM",907
3,"3122",42227,31379,31186,160,193,"PODEMOS-COM",7983
3,"3113",4254,3159,3120,17,39,"PODEMOS-COM",482
3,"3077",1374,1139,1126,11,13,"PODEMOS-COM",175
3,"3079",18235,14578,14388,114,190,"PODEMOS-COM",3331
3,"3033",113,97,97,2,0,"PODEMOS-COM",25
3,"3052",969,804,794,6,10,"PODEMOS-COM",107
3,"3081",1433,1130,1118,5,12,"PODEMOS-COM",390
3,"3078",486,398,397,3,1,"PODEMOS-COM",50
3,"3121",21269,14932,14795,78,137,"PODEMOS-COM",3446
3,"3123",7472,5748,5680,38,68,"PODEMOS-COM",1158
3,"3038",358,292,285,2,7,"PODEMOS-COM",75
3,"3073",236,202,202,1,0,"PODEMOS-COM",46
3,"3014",237548,173040,172027,866,1013,"PODEMOS-COM",38092
3,"3008",167,132,131,0,1,"PODEMOS-COM",14
3,"3058",4947,4015,3978,21,37,"PODEMOS-COM",511
3,"3057",191,148,148,2,0,"PODEMOS-COM",39
3,"3117",370,325,322,0,3,"PODEMOS-COM",115
3,"3083",5607,4160,4106,36,54,"PODEMOS-COM",912
3,"3075",156,139,139,0,0,"PODEMOS-COM",36
3,"3049",12082,9341,9236,69,105,"PODEMOS-COM",1221
3,"3094",9033,6702,6657,32,45,"PODEMOS-COM",1722
3,"3084",543,478,476,4,2,"PODEMOS-COM",102
3,"3082",12542,8709,8597,48,112,"PODEMOS-COM",2228
3,"3139",22357,15787,15624,101,163,"PODEMOS-COM",3767
3,"3023",1410,1221,1201,8,20,"PODEMOS-COM",274
3,"3076",8485,6251,6194,37,57,"PODEMOS-COM",942
3,"3041",5945,4393,4344,28,49,"PODEMOS-COM",1110
3,"3006",497,401,393,4,8,"PODEMOS-COM",156
3,"3011",7729,5651,5595,29,56,"PODEMOS-COM",1243
3,"3103",278,240,237,1,3,"PODEMOS-COM",59
3,"3019",15261,11921,11804,98,117,"PODEMOS-COM",2222
3,"3013",1114,914,906,5,8,"PODEMOS-COM",134
3,"3040",257,222,222,0,0,"PODEMOS-COM",82
3,"3059",20538,15653,15522,79,131,"PODEMOS-COM",3557
3,"3132",536,426,423,0,3,"PODEMOS-COM",119
3,"3116",1159,892,886,2,6,"PODEMOS-COM",229
3,"3095",4602,3628,3605,27,23,"PODEMOS-COM",1163
3,"3124",469,400,394,5,6,"PODEMOS-COM",141
3,"3140",26176,19795,19509,155,286,"PODEMOS-COM",4565
3,"3068",46,41,40,0,1,"PODEMOS-COM",0
3,"3065",166944,126831,126024,773,807,"PODEMOS-COM",26925
3,"3138",3154,2406,2378,10,28,"PODEMOS-COM",596
33,"33035",11299,8048,7981,67,67,"PODEMOS",1689
33,"33064",231,181,179,4,2,"PODEMOS",26
33,"33021",4576,3133,3090,33,43,"PODEMOS",479
33,"33056",5015,3435,3405,32,30,"PODEMOS",572
33,"33046",508,375,365,4,10,"PODEMOS",25
33,"33055",1511,1150,1129,9,21,"PODEMOS",148
33,"33074",3523,2422,2390,36,32,"PODEMOS",338
33,"33072",1601,1012,1002,4,10,"PODEMOS",151
33,"33025",9261,6116,6062,58,54,"PODEMOS",1199
33,"33013",456,336,331,6,5,"PODEMOS",39
33,"33028",1289,685,682,9,3,"PODEMOS",132
33,"33012",5230,3595,3568,27,27,"PODEMOS",553
33,"33008",1808,1268,1247,6,21,"PODEMOS",156
33,"33009",899,606,601,4,5,"PODEMOS",120
33,"33078",147,98,98,0,0,"PODEMOS",21
33,"33032",11483,8036,7921,82,115,"PODEMOS",1551
33,"33019",3094,2079,2054,15,25,"PODEMOS",305
33,"33029",363,199,198,1,1,"PODEMOS",31
33,"33052",730,517,512,1,5,"PODEMOS",84
33,"33058",1821,1319,1305,10,14,"PODEMOS",289
33,"33044",178724,130938,130010,1254,928,"PODEMOS",25329
33,"33065",1109,743,735,16,8,"PODEMOS",151
33,"33022",906,604,599,3,5,"PODEMOS",116
33,"33066",43034,29901,29610,261,291,"PODEMOS",6632
33,"33016",19201,14177,14074,115,103,"PODEMOS",3066
33,"33048",156,99,99,2,0,"PODEMOS",11
33,"33071",617,459,452,8,7,"PODEMOS",39
33,"33069",3513,2577,2554,15,23,"PODEMOS",497
33,"33049",6388,4229,4182,48,47,"PODEMOS",705
33,"33059",4702,3228,3185,42,43,"PODEMOS",525
33,"33002",10122,7056,6977,55,79,"PODEMOS",1391
33,"33043",682,465,460,2,5,"PODEMOS",70
33,"33018",2896,2068,2041,18,27,"PODEMOS",395
33,"33042",4316,3143,3105,35,38,"PODEMOS",650
33,"33006",1556,1043,1036,17,7,"PODEMOS",217
33,"33004",67136,48699,48354,389,345,"PODEMOS",11455
33,"33045",4503,3249,3216,26,33,"PODEMOS",590
33,"33001",1622,867,852,16,15,"PODEMOS",142
33,"33020",13297,9527,9445,86,82,"PODEMOS",2393
33,"33061",379,194,190,1,4,"PODEMOS",19
33,"33054",1688,1159,1146,8,13,"PODEMOS",192
33,"33050",603,374,357,0,17,"PODEMOS",70
33,"33005",1479,945,932,12,13,"PODEMOS",94
33,"33038",2298,1690,1675,12,15,"PODEMOS",358
33,"33039",1672,1261,1257,14,4,"PODEMOS",232
33,"33023",3315,2295,2267,35,28,"PODEMOS",430
33,"33053",1157,767,762,12,5,"PODEMOS",129
33,"33041",7270,5138,5093,53,45,"PODEMOS",1081
33,"33015",1561,1042,1031,8,11,"PODEMOS",184
33,"33047",1126,868,861,12,7,"PODEMOS",89
33,"33060",14750,10307,10206,82,101,"PODEMOS",2369
33,"33067",785,608,598,5,10,"PODEMOS",88
33,"33040",4564,3125,3091,28,34,"PODEMOS",633
33,"33063",419,330,326,1,4,"PODEMOS",22
33,"33070",3347,2473,2441,31,32,"PODEMOS",534
33,"33076",12270,8265,8203,89,62,"PODEMOS",1471
33,"33010",1828,1220,1215,16,5,"PODEMOS",230
33,"33014",9101,6398,6352,46,46,"PODEMOS",1645
33,"33024",227211,166618,165475,1240,1143,"PODEMOS",39147
33,"33068",1114,627,623,2,4,"PODEMOS",82
33,"33003",665,386,384,7,2,"PODEMOS",56
33,"33030",899,689,687,10,2,"PODEMOS",123
33,"33017",3180,2196,2168,30,28,"PODEMOS",376
33,"33027",849,544,543,8,1,"PODEMOS",96
33,"33037",34841,24271,24054,200,217,"PODEMOS",6246
33,"33007",1524,991,980,10,11,"PODEMOS",108
33,"33062",409,242,239,1,3,"PODEMOS",32
33,"33057",1593,1134,1123,17,11,"PODEMOS",251
33,"33051",7167,4810,4772,57,38,"PODEMOS",798
33,"33031",35453,23848,23595,242,253,"PODEMOS",5999
33,"33075",275,161,155,2,6,"PODEMOS",22
33,"33033",9943,6851,6803,61,48,"PODEMOS",1600
33,"33073",8631,5015,4948,47,67,"PODEMOS",656
33,"33011",11373,6279,6214,104,65,"PODEMOS",905
33,"33026",8621,5600,5555,71,45,"PODEMOS",1060
33,"33077",1220,849,840,11,9,"PODEMOS",69
33,"33036",11572,8208,8133,80,75,"PODEMOS",1166
33,"33034",10693,6796,6725,72,71,"PODEMOS",1064
50,"50001",115,81,80,0,1,"Independien",0
50,"50282",70,48,48,0,0,"Independien",0
50,"50041",12,10,10,0,0,"Independien",0
50,"50252",5178,3746,3711,36,35,"Independien",5
50,"50262",1187,931,930,13,1,"Independien",0
50,"50160",2245,1661,1648,10,13,"Independien",0
50,"50093",94,73,73,1,0,"Independien",0
50,"50131",237,168,167,2,1,"Independien",0
50,"50073",2148,1649,1622,9,27,"Independien",0
50,"50063",61,57,57,0,0,"Independien",0
50,"50076",81,64,64,0,0,"Independien",0
50,"50106",135,105,104,0,1,"Independien",0
50,"50083",90,72,72,1,0,"Independien",0
50,"50098",181,129,127,2,2,"Independien",0
50,"50903",2225,1686,1669,21,17,"Independien",1
50,"50022",543,410,398,8,12,"Independien",2
50,"50032",273,190,189,0,1,"Independien",0
50,"50002",148,105,102,0,3,"Independien",1
50,"50012",108,86,83,1,3,"Independien",0
50,"50283",72,55,54,0,1,"Independien",0
50,"50094",1626,1197,1178,22,19,"Independien",1
50,"50191",476,327,325,3,2,"Independien",0
50,"50284",151,115,113,0,2,"Independien",0
50,"50095",12366,8938,8856,94,82,"Independien",7
50,"50033",75,65,65,0,0,"Independien",0
50,"50129",245,164,164,1,0,"Independien",0
50,"50192",236,185,183,2,2,"Independien",0
50,"50202",158,96,92,1,4,"Independien",0
50,"50003",126,93,92,3,1,"Independien",0
50,"50222",1647,1135,1118,8,17,"Independien",1
50,"50162",147,110,110,2,0,"Independien",0
50,"50294",73,58,58,0,0,"Independien",0
50,"50055",3612,2533,2490,34,43,"Independien",3
50,"50034",838,572,569,5,3,"Independien",1
50,"50140",165,106,106,0,0,"Independien",0
50,"50223",915,747,741,8,6,"Independien",0
50,"50254",181,130,129,2,1,"Independien",0
50,"50203",1043,811,802,15,9,"Independien",0
50,"50096",39,17,17,0,0,"Independien",0
50,"50065",53,42,42,0,0,"Independien",0
50,"50163",3655,2766,2740,34,26,"Independien",3
50,"50285",648,473,469,3,4,"Independien",0
50,"50119",930,698,691,7,7,"Independien",1
50,"50004",534,406,401,0,5,"Independien",0
50,"50193",647,514,506,1,8,"Independien",1
50,"50255",214,163,163,0,0,"Independien",0
50,"50109",105,78,77,3,1,"Independien",0
50,"50144",36,28,28,0,0,"Independien",0
50,"50152",1457,1032,1018,11,14,"Independien",0
50,"50276",129,108,107,0,1,"Independien",0
50,"50289",52,39,39,1,0,"Independien",0
50,"50035",74,53,52,0,1,"Independien",0
50,"50005",234,178,178,1,0,"Independien",0
50,"50113",618,506,496,4,10,"Independien",0
50,"50286",77,54,54,0,0,"Independien",0
50,"50194",84,52,52,0,0,"Independien",0
50,"50036",103,79,79,0,0,"Independien",0
50,"50009",106,78,77,1,1,"Independien",0
50,"50099",3087,2233,2216,15,17,"Independien",2
50,"50225",1568,996,985,2,11,"Independien",0
50,"50287",274,197,195,4,2,"Independien",0
50,"50067",14055,10236,10109,123,127,"Independien",8
50,"50026",442,358,353,6,5,"Independien",0
50,"50257",178,139,137,0,2,"Independien",0
50,"50132",755,573,564,7,9,"Independien",2
50,"50195",53,38,38,0,0,"Independien",0
50,"50237",103,73,73,2,0,"Independien",3
50,"50154",119,92,91,0,1,"Independien",0
50,"50006",939,712,701,8,11,"Independien",0
50,"50227",108,79,79,1,0,"Independien",0
50,"50068",1998,1388,1378,17,10,"Independien",0
50,"50078",244,192,189,1,3,"Independien",0
50,"50100",333,263,261,5,2,"Independien",0
50,"50007",46,37,37,1,0,"Independien",0
50,"50104",351,283,282,3,1,"Independien",0
50,"50288",3371,2566,2547,26,19,"Independien",1
50,"50122",68,54,54,2,0,"Independien",0
50,"50069",76,53,52,0,1,"Independien",0
50,"50196",108,83,82,1,1,"Independien",0
50,"50278",198,145,144,1,1,"Independien",0
50,"50038",1511,1167,1159,13,8,"Independien",0
50,"50272",12913,9500,9415,80,85,"Independien",2
50,"50258",56,34,34,1,0,"Independien",0
50,"50134",128,88,88,5,0,"Independien",0
50,"50079",254,186,184,3,2,"Independien",0
50,"50105",304,228,228,3,0,"Independien",1
50,"50008",5085,3617,3574,30,43,"Independien",3
50,"50018",948,717,712,6,5,"Independien",0
50,"50117",125,91,90,1,1,"Independien",0
50,"50197",92,71,71,2,0,"Independien",0
50,"50180",120,97,96,0,1,"Independien",1
50,"50101",879,615,609,5,6,"Independien",1
50,"50290",387,288,287,4,1,"Independien",0
50,"50167",232,194,193,0,1,"Independien",0
50,"50259",89,61,61,1,0,"Independien",0
50,"50201",443,335,330,2,5,"Independien",1
50,"50229",64,42,42,0,0,"Independien",0
50,"50146",190,137,137,5,0,"Independien",0
50,"50198",56,30,30,0,0,"Independien",0
50,"50102",863,665,654,6,11,"Independien",0
50,"50136",579,420,413,0,7,"Independien",0
50,"50250",55,44,44,0,0,"Independien",0
50,"50040",92,75,75,0,0,"Independien",0
50,"50230",1176,853,849,11,4,"Independien",0
50,"50071",131,90,90,0,0,"Independien",0
50,"50291",100,69,69,0,0,"Independien",0
50,"50010",69,57,57,0,0,"Independien",1
50,"50199",341,242,241,4,1,"Independien",1
50,"50261",215,159,159,1,0,"Independien",0
50,"50051",828,640,637,8,3,"Independien",0
50,"50148",324,240,236,0,4,"Independien",0
50,"50020",822,560,555,5,5,"Independien",0
50,"50085",176,131,129,3,2,"Independien",1
50,"50115",3248,2277,2262,31,15,"Independien",1
50,"50137",1025,793,786,6,7,"Independien",0
50,"50092",298,256,251,3,5,"Independien",1
50,"50292",132,103,103,0,0,"Independien",0
50,"50072",174,124,122,2,2,"Independien",0
50,"50011",127,96,96,2,0,"Independien",0
50,"50130",395,252,252,1,0,"Independien",0
50,"50200",509,406,404,6,2,"Independien",0
50,"50231",260,213,210,7,3,"Independien",0
50,"50170",378,286,283,2,3,"Independien",0
50,"50275",110,73,72,0,1,"Independien",0
50,"50173",210,141,140,2,1,"Independien",1
50,"50242",92,81,79,1,2,"Independien",0
50,"50059",780,572,567,6,5,"Independien",0
50,"50087",28,19,19,0,0,"Independien",0
50,"50211",252,187,186,0,1,"Independien",0
50,"50296",398,297,293,2,4,"Independien",0
50,"50141",114,85,84,0,1,"Independien",0
50,"50138",46,41,41,0,0,"Independien",0
50,"50293",423,282,280,5,2,"Independien",1
50,"50266",129,85,85,1,0,"Independien",0
50,"50221",33,20,20,0,0,"Independien",1
50,"50042",16,13,13,0,0,"Independien",0
50,"50171",108,70,69,0,1,"Independien",0
50,"50263",197,123,121,6,2,"Independien",0
50,"50043",257,172,171,1,1,"Independien",0
50,"50074",6397,4512,4408,38,104,"Independien",8
50,"50150",660,402,402,3,0,"Independien",0
50,"50139",319,239,238,2,1,"Independien",0
50,"50233",114,81,81,1,0,"Independien",0
50,"50172",196,138,136,0,2,"Independien",0
50,"50182",3352,2437,2409,26,28,"Independien",5
50,"50013",224,187,186,3,1,"Independien",0
50,"50244",205,157,157,3,0,"Independien",1
50,"50111",186,152,151,1,1,"Independien",0
50,"50107",944,772,767,16,5,"Independien",0
50,"50044",232,156,156,1,0,"Independien",0
50,"50047",50,32,32,1,0,"Independien",0
50,"50213",98,77,72,0,5,"Independien",0
50,"50108",47,37,37,0,0,"Independien",0
50,"50234",245,198,193,9,5,"Independien",0
50,"50075",81,59,59,1,0,"Independien",0
50,"50295",45,39,39,0,0,"Independien",0
50,"50210",40,32,31,0,1,"Independien",0
50,"50014",146,99,99,1,0,"Independien",0
50,"50265",62,41,41,0,0,"Independien",1
50,"50245",90,60,60,1,0,"Independien",1
50,"50021",32,25,25,3,0,"Independien",0
50,"50279",87,62,62,1,0,"Independien",0
50,"50066",2613,1956,1951,21,5,"Independien",1
50,"50297",499531,377882,375565,3049,2317,"Independien",431
50,"50077",226,175,174,5,1,"Independien",0
50,"50090",156,112,111,0,1,"Independien",0
50,"50028",78,53,53,2,0,"Independien",1
50,"50045",1255,944,934,6,10,"Independien",0
50,"50187",70,38,38,0,0,"Independien",0
50,"50015",98,63,63,0,0,"Independien",0
50,"50019",54,41,41,0,0,"Independien",0
50,"50050",98,59,59,3,0,"Independien",0
50,"50110",369,258,257,0,1,"Independien",1
50,"50174",92,70,70,0,0,"Independien",0
50,"50236",104,82,82,2,0,"Independien",0
50,"50016",52,37,37,0,0,"Independien",0
50,"50142",30,21,21,0,0,"Independien",0
50,"50046",176,123,123,7,0,"Independien",0
50,"50175",1025,745,739,6,6,"Independien",0
50,"50165",1815,1333,1316,27,17,"Independien",0
50,"50267",605,424,420,4,4,"Independien",1
50,"50081",512,376,372,6,4,"Independien",0
50,"50271",256,187,184,4,3,"Independien",0
50,"50143",569,414,411,4,3,"Independien",0
50,"50264",158,111,111,0,0,"Independien",0
50,"50027",227,177,176,1,1,"Independien",0
50,"50062",1810,1407,1389,12,18,"Independien",2
50,"50209",2560,1787,1774,12,13,"Independien",0
50,"50251",8300,6228,6167,62,61,"Independien",5
50,"50166",260,192,189,2,3,"Independien",0
50,"50206",466,379,376,2,3,"Independien",0
50,"50017",1772,1301,1293,7,8,"Independien",3
50,"50228",270,211,210,5,1,"Independien",0
50,"50024",589,461,459,4,2,"Independien",0
50,"50902",87,78,78,1,0,"Independien",0
50,"50268",47,40,39,0,1,"Independien",0
50,"50217",455,334,334,1,0,"Independien",0
50,"50029",627,469,468,4,1,"Independien",0
50,"50060",176,138,136,0,2,"Independien",0
50,"50177",315,251,249,3,2,"Independien",0
50,"50208",1802,1349,1332,16,17,"Independien",3
50,"50114",124,94,94,2,0,"Independien",0
50,"50239",64,47,47,1,0,"Independien",0
50,"50184",113,82,82,0,0,"Independien",0
50,"50025",4547,3335,3295,45,40,"Independien",0
50,"50207",109,88,88,1,0,"Independien",0
50,"50224",69,55,55,1,0,"Independien",0
50,"50269",288,185,183,0,2,"Independien",0
50,"50053",688,535,522,6,13,"Independien",0
50,"50037",139,92,91,1,1,"Independien",0
50,"50189",712,574,559,4,15,"Independien",0
50,"50188",30,23,19,0,4,"Independien",0
50,"50120",49,36,36,3,0,"Independien",0
50,"50058",72,51,51,0,0,"Independien",0
50,"50157",301,211,207,2,4,"Independien",0
50,"50147",788,577,576,4,1,"Independien",0
50,"50240",1034,749,737,10,12,"Independien",0
50,"50061",207,174,168,1,6,"Independien",0
50,"50178",302,197,196,9,1,"Independien",0
50,"50176",228,158,157,0,1,"Independien",0
50,"50030",225,156,156,2,0,"Independien",0
50,"50219",4098,3010,2980,27,30,"Independien",4
50,"50241",593,426,418,1,8,"Independien",0
50,"50273",31,18,18,0,0,"Independien",0
50,"50086",184,128,128,1,0,"Independien",0
50,"50212",41,37,37,0,0,"Independien",0
50,"50118",2179,1575,1564,7,11,"Independien",0
50,"50133",117,88,88,3,0,"Independien",0
50,"50126",2388,1726,1708,22,18,"Independien",1
50,"50169",362,264,262,0,2,"Independien",1
50,"50031",161,90,88,1,2,"Independien",0
50,"50220",46,32,32,0,0,"Independien",0
50,"50161",117,76,76,0,0,"Independien",0
50,"50190",708,542,539,3,3,"Independien",0
50,"50116",190,142,140,1,2,"Independien",0
50,"50164",395,263,260,2,3,"Independien",0
50,"50270",38,24,24,2,0,"Independien",0
50,"50128",28,24,24,0,0,"Independien",0
50,"50039",507,400,398,3,2,"Independien",0
50,"50052",90,71,71,0,0,"Independien",0
50,"50023",223,175,173,3,2,"Independien",0
50,"50123",465,349,344,2,5,"Independien",0
50,"50048",35,23,23,0,0,"Independien",0
50,"50080",32,25,25,0,0,"Independien",0
50,"50214",27,16,16,1,0,"Independien",0
50,"50155",102,78,78,0,0,"Independien",0
50,"50204",2457,1830,1816,14,14,"Independien",4
50,"50057",1396,980,972,8,8,"Independien",6
50,"50168",28,23,23,0,0,"Independien",0
50,"50183",338,255,255,0,0,"Independien",0
50,"50232",171,120,118,0,2,"Independien",0
50,"50156",214,173,170,2,3,"Independien",0
50,"50277",55,43,43,1,0,"Independien",0
50,"50082",89,58,57,0,1,"Independien",0
50,"50243",340,259,254,1,5,"Independien",0
50,"50247",827,624,615,10,9,"Independien",2
50,"50215",23,15,15,0,0,"Independien",0
50,"50274",71,50,49,1,1,"Independien",0
50,"50088",305,234,229,11,5,"Independien",0
50,"50159",670,511,501,5,10,"Independien",0
50,"50089",8144,6285,6249,50,36,"Independien",2
50,"50056",406,325,324,2,1,"Independien",0
50,"50249",312,235,233,1,2,"Independien",1
50,"50135",95,63,63,0,0,"Independien",0
50,"50179",257,207,207,2,0,"Independien",0
50,"50181",1003,750,737,9,13,"Independien",1
50,"50185",132,110,110,1,0,"Independien",0
50,"50246",41,29,29,0,0,"Independien",0
50,"50260",35,32,32,0,0,"Independien",0
50,"50151",650,504,503,7,1,"Independien",0
50,"50216",236,189,186,4,3,"Independien",0
50,"50124",417,312,312,9,0,"Independien",0
50,"50235",2323,1687,1675,7,12,"Independien",4
50,"50298",5353,4051,4013,32,38,"Independien",7
50,"50070",60,29,29,1,0,"Independien",0
50,"50153",941,737,734,7,3,"Independien",0
50,"50901",137,101,101,0,0,"Independien",0
50,"50253",423,328,327,1,1,"Independien",0
50,"50218",113,90,89,1,1,"Independien",0
50,"50149",36,23,23,0,0,"Independien",0
50,"50248",521,407,406,1,1,"Independien",2
50,"50186",41,29,29,0,0,"Independien",0
50,"50091",48,32,32,1,0,"Independien",0
50,"50238",97,74,73,0,1,"Independien",0
50,"50281",80,57,56,0,1,"Independien",0
50,"50280",340,260,258,0,2,"Independien",0
50,"50064",440,350,349,5,1,"Independien",0
50,"50205",91,69,65,1,4,"Independien",0
50,"50084",79,56,56,1,0,"Independien",1
50,"50125",371,260,258,3,2,"Independien",0
50,"50121",276,227,225,4,2,"Independien",0
50,"50256",84,46,46,0,0,"Independien",0
50,"50054",59,45,45,0,0,"Independien",0
46,"46174",984,808,794,3,14,"AVANT",1
46,"46261",1720,1386,1369,10,17,"AVANT",0
46,"46123",1838,1466,1447,4,19,"AVANT",1
46,"46054",11251,8795,8731,46,64,"AVANT",1
46,"46242",340,291,285,1,6,"AVANT",0
46,"46051",8347,6500,6442,27,58,"AVANT",2
46,"46010",914,725,716,4,9,"AVANT",0
46,"46151",722,589,583,1,6,"AVANT",1
46,"46027",948,795,781,3,14,"AVANT",0
46,"46023",328,294,287,2,7,"AVANT",0
46,"46075",149,132,130,2,2,"AVANT",0
46,"46156",2087,1712,1702,9,10,"AVANT",1
46,"46159",22905,17498,17373,102,125,"AVANT",19
46,"46180",682,581,572,1,9,"AVANT",0
46,"46204",6781,5421,5379,15,42,"AVANT",1
46,"46068",354,305,297,1,8,"AVANT",0
46,"46037",1119,952,941,2,11,"AVANT",0
46,"46199",5742,4458,4425,34,33,"AVANT",1
46,"46090",1640,1440,1424,4,16,"AVANT",0
46,"46119",783,672,666,7,6,"AVANT",0
46,"46121",105,92,91,2,1,"AVANT",0
46,"46114",575,488,484,3,4,"AVANT",0
46,"46210",338,295,283,2,12,"AVANT",0
46,"46070",16903,13091,12999,64,92,"AVANT",6
46,"46252",126,95,93,0,2,"AVANT",0
46,"46164",11777,8893,8798,54,95,"AVANT",12
46,"46197",1956,1556,1543,8,13,"AVANT",2
46,"46241",400,324,314,1,10,"AVANT",0
46,"46175",459,403,396,1,7,"AVANT",0
46,"46140",349,288,284,2,4,"AVANT",0
46,"46216",5039,4207,4188,20,19,"AVANT",1
46,"46128",1601,1316,1281,5,35,"AVANT",0
46,"46219",125,106,105,2,1,"AVANT",0
46,"46191",1970,1557,1533,6,24,"AVANT",0
46,"46044",4237,3347,3285,25,62,"AVANT",1
46,"46042",3389,2886,2844,19,42,"AVANT",0
46,"46052",502,432,431,2,1,"AVANT",0
46,"46014",3042,2456,2434,17,22,"AVANT",5
46,"46033",197,169,168,1,1,"AVANT",0
46,"46131",49604,37767,37431,266,336,"AVANT",24
46,"46047",525,443,435,2,8,"AVANT",0
46,"46015",7231,5768,5711,33,57,"AVANT",6
46,"46012",888,723,703,3,20,"AVANT",0
46,"46085",11147,8107,8033,57,74,"AVANT",4
46,"46212",1612,1234,1214,5,20,"AVANT",0
46,"46142",797,619,608,2,11,"AVANT",0
46,"46202",16767,13171,13058,59,113,"AVANT",10
46,"46081",10180,8055,7984,32,71,"AVANT",3
46,"46073",1097,903,892,6,11,"AVANT",0
46,"46059",1272,1066,1058,4,8,"AVANT",1
46,"46256",6833,5087,5062,37,25,"AVANT",5
46,"46097",959,734,728,6,6,"AVANT",0
46,"46060",9361,7285,7229,30,56,"AVANT",1
46,"46028",395,346,339,2,7,"AVANT",0
46,"46228",2363,1854,1839,16,15,"AVANT",2
46,"46185",386,325,321,4,4,"AVANT",0
46,"46006",4529,3803,3748,18,55,"AVANT",3
46,"46133",563,458,455,2,3,"AVANT",0
46,"46100",289,240,237,1,3,"AVANT",0
46,"46239",451,353,351,3,2,"AVANT",0
46,"46143",4215,3219,3171,27,48,"AVANT",2
46,"46249",9362,7163,7072,42,91,"AVANT",3
46,"46247",1024,743,733,2,10,"AVANT",1
46,"46091",115,101,100,1,1,"AVANT",0
46,"46193",8795,7101,7061,40,40,"AVANT",0
46,"46207",6656,5355,5293,42,62,"AVANT",7
46,"46217",886,724,712,3,12,"AVANT",0
46,"46161",1481,1206,1194,6,12,"AVANT",0
46,"46182",1274,970,966,2,4,"AVANT",2
46,"46038",345,255,255,0,0,"AVANT",0
46,"46030",804,660,635,7,25,"AVANT",1
46,"46127",2706,2212,2175,10,37,"AVANT",2
46,"46111",10876,8133,8050,35,83,"AVANT",1
46,"46020",3784,3064,3012,15,52,"AVANT",1
46,"46039",2147,1746,1727,9,19,"AVANT",0
46,"46211",1723,1441,1434,13,7,"AVANT",2
46,"46150",1839,1377,1362,10,15,"AVANT",2
46,"46011",7627,5496,5407,39,89,"AVANT",2
46,"46220",48393,35859,35571,250,288,"AVANT",12
46,"46110",21260,16194,16084,76,110,"AVANT",11
46,"46166",8155,6521,6450,41,71,"AVANT",4
46,"46007",11953,9099,9038,65,61,"AVANT",29
46,"46153",441,358,354,0,4,"AVANT",0
46,"46107",1915,1566,1553,2,13,"AVANT",1
46,"46244",58586,43371,43098,257,273,"AVANT",32
46,"46001",802,623,615,4,8,"AVANT",0
46,"46049",280,242,238,1,4,"AVANT",0
46,"46135",9655,7845,7810,32,35,"AVANT",1
46,"46209",1955,1531,1508,7,23,"AVANT",3
46,"46095",608,498,493,2,5,"AVANT",0
46,"46254",1012,786,775,1,11,"AVANT",0
46,"46124",788,680,672,0,8,"AVANT",0
46,"46043",145,131,131,0,0,"AVANT",0
46,"46076",587,489,483,2,6,"AVANT",1
46,"46149",362,288,287,2,1,"AVANT",0
46,"46050",200,160,160,0,0,"AVANT",0
46,"46098",2491,1978,1950,14,28,"AVANT",0
46,"46231",2411,1759,1735,11,24,"AVANT",1
46,"46106",1543,1177,1167,5,10,"AVANT",0
46,"46169",32396,25109,24953,169,156,"AVANT",26
46,"46154",811,644,640,4,4,"AVANT",3
46,"46233",3904,2974,2934,15,40,"AVANT",6
46,"46218",1074,930,912,1,18,"AVANT",1
46,"46099",922,693,685,0,8,"AVANT",0
46,"46065",1588,1246,1227,5,19,"AVANT",1
46,"46165",7115,5626,5576,31,50,"AVANT",9
46,"46089",2141,1649,1625,14,24,"AVANT",0
46,"46021",23646,18220,18100,85,120,"AVANT",11
46,"46177",4698,3715,3665,16,50,"AVANT",2
46,"46260",2572,2100,2081,10,19,"AVANT",2
46,"46117",493,414,411,4,3,"AVANT",1
46,"46203",3598,2962,2928,17,34,"AVANT",5
46,"46137",268,225,220,3,5,"AVANT",0
46,"46130",907,722,713,6,9,"AVANT",1
46,"46206",577,475,468,4,7,"AVANT",0
46,"46009",3144,2579,2552,13,27,"AVANT",0
46,"46201",67,49,49,0,0,"AVANT",0
46,"46240",209,169,164,1,5,"AVANT",0
46,"46055",1273,1031,1021,4,10,"AVANT",0
46,"46086",82,73,73,1,0,"AVANT",0
46,"46196",153,131,130,0,1,"AVANT",0
46,"46146",1670,1333,1318,11,15,"AVANT",1
46,"46158",1024,817,804,5,13,"AVANT",0
46,"46036",583,384,381,8,3,"AVANT",0
46,"46171",16587,12731,12627,79,104,"AVANT",13
46,"46214",15730,12427,12334,56,93,"AVANT",4
46,"46004",1924,1582,1559,11,23,"AVANT",1
46,"46144",665,525,520,2,5,"AVANT",0
46,"46002",1175,947,935,5,12,"AVANT",1
46,"46223",7814,6169,6129,33,40,"AVANT",7
46,"46083",15467,11584,11443,79,141,"AVANT",10
46,"46200",1909,1628,1609,5,19,"AVANT",2
46,"46134",2357,1811,1797,8,14,"AVANT",1
46,"46080",1025,795,784,4,11,"AVANT",0
46,"46172",5040,3629,3599,14,30,"AVANT",2
46,"46227",915,771,765,5,6,"AVANT",0
46,"46245",516,427,420,3,7,"AVANT",0
46,"46225",346,299,290,0,9,"AVANT",0
46,"46187",1310,1036,1028,6,8,"AVANT",1
46,"46195",1967,1612,1602,9,10,"AVANT",0
46,"46105",16249,11731,11629,59,102,"AVANT",13
46,"46147",16843,12206,12099,56,107,"AVANT",8
46,"46061",337,281,281,3,0,"AVANT",0
46,"46184",26467,20888,20675,138,213,"AVANT",14
46,"46103",1270,1015,998,8,17,"AVANT",0
46,"46255",3145,2494,2470,19,24,"AVANT",4
46,"46236",975,810,806,4,4,"AVANT",0
46,"46198",846,702,693,1,9,"AVANT",1
46,"46122",2701,2120,2109,18,11,"AVANT",2
46,"46094",20515,15885,15785,125,100,"AVANT",9
46,"46181",17066,12779,12636,96,143,"AVANT",7
46,"46088",176,140,138,0,2,"AVANT",0
46,"46057",495,339,337,6,2,"AVANT",0
46,"46179",2182,1823,1788,13,35,"AVANT",1
46,"46205",14323,11325,11224,55,101,"AVANT",5
46,"46183",6009,4624,4563,18,61,"AVANT",2
46,"46077",7569,6100,6010,41,90,"AVANT",1
46,"46222",383,322,321,2,1,"AVANT",0
46,"46176",2025,1431,1416,10,15,"AVANT",0
46,"46224",170,130,130,0,0,"AVANT",0
46,"46186",19033,15061,14950,70,111,"AVANT",20
46,"46040",1098,914,907,4,7,"AVANT",0
46,"46259",503,410,406,2,4,"AVANT",0
46,"46008",2673,2201,2189,8,12,"AVANT",2
46,"46257",5579,4440,4391,26,49,"AVANT",0
46,"46238",13324,10023,9939,50,84,"AVANT",3
46,"46056",184,160,158,1,2,"AVANT",0
46,"46226",48,44,44,0,0,"AVANT",0
46,"46221",339,305,303,0,2,"AVANT",0
46,"46129",521,435,434,2,1,"AVANT",0
46,"46109",6195,4764,4682,23,82,"AVANT",2
46,"46139",4495,3629,3577,26,52,"AVANT",1
46,"46053",560,454,451,2,3,"AVANT",0
46,"46078",28126,20975,20850,127,125,"AVANT",46
46,"46173",1336,1097,1080,9,17,"AVANT",0
46,"46046",896,697,686,1,11,"AVANT",0
46,"46062",4652,3650,3583,32,67,"AVANT",2
46,"46168",1938,1542,1530,11,12,"AVANT",0
46,"46092",273,183,183,0,0,"AVANT",0
46,"46148",1528,1206,1192,15,14,"AVANT",0
46,"46189",471,412,405,2,7,"AVANT",0
46,"46237",7227,5620,5571,33,49,"AVANT",4
46,"46066",1255,1028,1020,6,8,"AVANT",0
46,"46026",1204,1044,1034,4,10,"AVANT",0
46,"46155",1035,865,846,2,19,"AVANT",0
46,"46041",331,254,253,6,1,"AVANT",0
46,"46074",2690,2158,2145,18,13,"AVANT",0
46,"46136",2534,2008,1990,13,18,"AVANT",0
46,"46229",972,785,774,2,11,"AVANT",0
46,"46190",48824,36748,36542,238,206,"AVANT",23
46,"46029",20649,15241,15110,113,131,"AVANT",6
46,"46243",141,122,120,0,2,"AVANT",0
46,"46116",13153,10566,10518,62,48,"AVANT",1
46,"46145",21946,16629,16495,80,134,"AVANT",11
46,"46125",857,709,701,5,8,"AVANT",0
46,"46232",894,715,712,5,3,"AVANT",0
46,"46141",438,359,348,4,11,"AVANT",0
46,"46093",2117,1721,1710,10,11,"AVANT",4
46,"46138",345,292,292,0,0,"AVANT",0
46,"46235",21793,16577,16424,118,153,"AVANT",9
46,"46902",379,314,313,3,1,"AVANT",0
46,"46087",127,99,99,1,0,"AVANT",0
46,"46262",232,172,168,0,4,"AVANT",0
46,"46248",4873,3679,3639,18,40,"AVANT",2
46,"46084",1576,1314,1298,6,16,"AVANT",0
46,"46115",403,296,289,1,7,"AVANT",0
46,"46250",578668,455375,452638,2701,2737,"AVANT",331
46,"46126",5555,4619,4574,26,45,"AVANT",5
46,"46063",1757,1399,1384,11,15,"AVANT",1
46,"46025",2502,2008,1993,6,15,"AVANT",1
46,"46101",858,731,723,4,8,"AVANT",0
46,"46003",963,841,815,1,26,"AVANT",0
46,"46019",8833,7183,7109,47,74,"AVANT",4
46,"46079",326,267,265,2,2,"AVANT",0
46,"46163",1847,1508,1489,8,19,"AVANT",1
46,"46251",2490,2082,2045,11,37,"AVANT",3
46,"46253",109,93,93,0,0,"AVANT",0
46,"46096",279,229,225,2,4,"AVANT",1
46,"46102",19843,15783,15676,102,107,"AVANT",12
46,"46234",354,289,287,2,2,"AVANT",0
46,"46903",5985,4822,4796,24,26,"AVANT",2
46,"46069",161,126,122,0,4,"AVANT",0
46,"46031",10520,7830,7759,70,71,"AVANT",4
46,"46017",33050,24762,24580,144,182,"AVANT",13
46,"46024",424,348,340,0,8,"AVANT",0
46,"46157",2978,2370,2343,19,27,"AVANT",0
46,"46022",15481,11422,11347,69,75,"AVANT",6
46,"46194",15552,11606,11505,69,101,"AVANT",13
46,"46112",552,466,464,1,2,"AVANT",0
46,"46215",1433,1152,1149,4,3,"AVANT",0
46,"46113",2436,1864,1849,11,15,"AVANT",3
46,"46120",1109,919,902,4,17,"AVANT",0
46,"46071",466,383,379,2,4,"AVANT",0
46,"46082",4947,3843,3814,25,29,"AVANT",3
46,"46213",15476,11377,11246,110,131,"AVANT",5
46,"46032",5635,4529,4493,16,36,"AVANT",0
46,"46035",6786,5382,5338,27,44,"AVANT",3
46,"46192",767,573,568,1,5,"AVANT",0
46,"46160",1912,1523,1514,3,9,"AVANT",2
46,"46005",22908,17565,17438,126,127,"AVANT",9
46,"46230",13944,10746,10646,69,100,"AVANT",4
46,"46034",1776,1441,1430,4,11,"AVANT",3
46,"46263",255,204,202,1,2,"AVANT",0
46,"46258",2676,2099,2078,9,21,"AVANT",0
46,"46013",17366,13952,13862,95,90,"AVANT",3
46,"46170",3451,2821,2775,16,46,"AVANT",0
46,"46108",480,375,375,2,0,"AVANT",0
46,"46072",3625,2993,2931,37,62,"AVANT",2
46,"46188",668,548,538,3,10,"AVANT",0
46,"46132",2148,1850,1830,12,20,"AVANT",0
46,"46016",1068,885,874,3,11,"AVANT",2
46,"46162",1207,962,947,3,15,"AVANT",1
46,"46152",97,76,74,0,2,"AVANT",0
46,"46246",1066,856,838,7,18,"AVANT",0
46,"46067",1736,1457,1382,2,75,"AVANT",1
46,"46048",3448,2817,2790,8,27,"AVANT",4
46,"46058",1779,1430,1409,10,21,"AVANT",1
46,"46118",3795,2987,2962,18,25,"AVANT",2
46,"46904",802,662,654,7,8,"AVANT",3
46,"46045",1261,1066,1041,3,25,"AVANT",1
46,"46178",4643,3465,3434,16,31,"AVANT",1
46,"46208",1114,931,922,3,9,"AVANT",2
46,"46018",635,531,522,3,9,"AVANT",0
46,"46167",373,286,285,1,1,"AVANT",0
46,"46104",1956,1567,1543,6,24,"AVANT",0
46,"46064",527,429,423,0,6,"AVANT",0
7,"7044",8457,6079,5963,59,116,"PODEMOS",884
7,"7013",6832,4879,4775,34,104,"PODEMOS",649
7,"7020",3597,2652,2622,27,30,"PODEMOS",602
7,"7057",7170,4736,4668,44,68,"PODEMOS",787
7,"7018",389,271,265,3,6,"PODEMOS",91
7,"7007",437,308,304,1,4,"PODEMOS",62
7,"7025",478,377,376,1,1,"PODEMOS",65
7,"7030",1573,1151,1129,10,22,"PODEMOS",160
7,"7012",1877,1421,1408,13,13,"PODEMOS",250
7,"7055",7474,4796,4740,48,56,"PODEMOS",756
7,"7039",4880,3473,3412,27,61,"PODEMOS",443
7,"7050",3321,2161,2134,33,27,"PODEMOS",389
7,"7015",21076,13304,13169,162,135,"PODEMOS",3464
7,"7048",17339,10192,10101,104,91,"PODEMOS",2913
7,"7036",26936,19563,19392,156,171,"PODEMOS",4344
7,"7063",1420,1084,1072,8,12,"PODEMOS",215
7,"7014",7277,4301,4261,37,40,"PODEMOS",1020
7,"7061",9831,6618,6546,54,72,"PODEMOS",1464
7,"7059",2998,2119,2084,11,35,"PODEMOS",298
7,"7033",27017,16370,16205,143,165,"PODEMOS",3566
7,"7035",1517,1188,1181,3,7,"PODEMOS",168
7,"7001",3556,2682,2657,21,25,"PODEMOS",556
7,"7027",20667,13784,13673,106,111,"PODEMOS",2747
7,"7006",5175,3559,3528,33,31,"PODEMOS",798
7,"7017",844,625,618,6,7,"PODEMOS",119
7,"7901",611,476,469,6,7,"PODEMOS",55
7,"7060",2577,1825,1807,20,18,"PODEMOS",289
7,"7009",749,552,550,1,2,"PODEMOS",67
7,"7024",7019,3579,3544,39,35,"PODEMOS",873
7,"7002",6367,4466,4401,36,65,"PODEMOS",1139
7,"7028",892,617,611,2,6,"PODEMOS",133
7,"7062",7539,4371,4312,40,59,"PODEMOS",995
7,"7032",20039,13156,13033,136,123,"PODEMOS",3282
7,"7046",15649,9532,9443,70,89,"PODEMOS",2265
7,"7034",991,774,765,2,9,"PODEMOS",127
7,"7053",1171,957,946,8,11,"PODEMOS",204
7,"7023",3628,2611,2573,45,38,"PODEMOS",588
7,"7049",1498,1080,1071,12,9,"PODEMOS",171
7,"7011",27781,18282,18180,135,102,"PODEMOS",3904
7,"7037",3232,1894,1881,16,13,"PODEMOS",497
7,"7026",31158,18670,18537,161,133,"PODEMOS",4627
7,"7052",4705,2993,2971,34,22,"PODEMOS",903
7,"7047",2236,1602,1584,7,18,"PODEMOS",342
7,"7051",5225,3322,3279,38,43,"PODEMOS",729
7,"7022",11575,7827,7730,85,97,"PODEMOS",1208
7,"7003",11742,6924,6837,43,87,"PODEMOS",1586
7,"7045",1288,996,992,13,4,"PODEMOS",242
7,"7008",5681,4203,4153,22,50,"PODEMOS",962
7,"7042",10666,7023,6967,59,56,"PODEMOS",1697
7,"7010",4858,3518,3463,52,55,"PODEMOS",797
7,"7021",234,188,188,0,0,"PODEMOS",28
7,"7005",6659,4400,4357,23,43,"PODEMOS",1022
7,"7004",3861,2657,2630,24,27,"PODEMOS",526
7,"7029",4137,3088,3048,34,40,"PODEMOS",586
7,"7902",1072,730,712,18,18,"PODEMOS",143
7,"7040",279737,181078,179570,1280,1508,"PODEMOS",44514
7,"7019",192,146,146,0,0,"PODEMOS",12
7,"7064",5361,3588,3546,20,42,"PODEMOS",1059
7,"7038",2032,1515,1503,10,12,"PODEMOS",211
7,"7058",2804,2138,2118,15,20,"PODEMOS",405
7,"7056",5012,3632,3592,40,40,"PODEMOS",896
7,"7031",23747,15538,15401,130,137,"PODEMOS",3226
7,"7054",22371,12930,12779,104,151,"PODEMOS",3109
7,"7065",2079,1462,1451,13,11,"PODEMOS",325
7,"7016",2786,1992,1969,30,23,"PODEMOS",406
7,"7043",3422,2435,2410,13,25,"PODEMOS",284
7,"7041",2039,1566,1540,5,26,"PODEMOS",207
23,"23032",575,461,457,1,4,"VOX",1
23,"23058",8665,6651,6585,47,66,"VOX",15
23,"23026",3636,2724,2685,11,39,"VOX",3
23,"23035",1095,871,867,8,4,"VOX",2
23,"23043",549,401,400,0,1,"VOX",0
23,"23901",1160,978,972,5,6,"VOX",2
23,"23030",1232,1020,1007,10,13,"VOX",0
23,"23027",727,577,576,8,1,"VOX",0
23,"23065",1601,1222,1207,0,15,"VOX",1
23,"23067",2489,1869,1847,18,22,"VOX",2
23,"23034",2558,1987,1977,18,10,"VOX",1
23,"23082",1924,1420,1413,6,7,"VOX",0
23,"23042",299,220,220,1,0,"VOX",0
23,"23905",1861,1351,1345,7,6,"VOX",1
23,"23052",1138,977,971,6,6,"VOX",2
23,"23094",3852,3097,3061,17,36,"VOX",3
23,"23003",8709,6520,6440,42,80,"VOX",8
23,"23044",4847,3801,3740,26,61,"VOX",2
23,"23097",6445,4313,4290,30,23,"VOX",9
23,"23063",3845,2934,2898,24,36,"VOX",5
23,"23057",771,648,648,4,0,"VOX",0
23,"23029",854,631,623,2,8,"VOX",2
23,"23004",435,350,346,0,4,"VOX",0
23,"23024",12512,9391,9182,79,209,"VOX",22
23,"23016",396,323,318,3,5,"VOX",0
23,"23053",9526,6783,6736,49,47,"VOX",1
23,"23018",2326,1678,1668,5,10,"VOX",0
23,"23076",837,672,658,4,14,"VOX",0
23,"23055",47421,33170,32908,213,262,"VOX",65
23,"23045",2139,1560,1551,9,9,"VOX",5
23,"23059",5856,4498,4450,33,48,"VOX",2
23,"23069",5385,4406,4318,15,88,"VOX",2
23,"23051",2762,2258,2231,9,27,"VOX",0
23,"23062",1461,1188,1181,1,7,"VOX",0
23,"23038",3557,2851,2831,11,20,"VOX",7
23,"23019",1562,1249,1227,4,22,"VOX",0
23,"23014",2561,1982,1959,8,23,"VOX",2
23,"23101",388,281,279,0,2,"VOX",0
23,"23011",2193,1616,1600,11,16,"VOX",0
23,"23086",11537,8362,8242,91,120,"VOX",6
23,"23033",1356,1080,1065,8,15,"VOX",1
23,"23012",4177,3016,2988,22,28,"VOX",3
23,"23085",2273,1833,1814,3,19,"VOX",2
23,"23041",504,396,392,1,4,"VOX",2
23,"23073",4558,3427,3402,11,25,"VOX",4
23,"23088",6124,4764,4703,31,61,"VOX",6
23,"23090",1316,1077,1071,8,6,"VOX",5
23,"23021",528,452,448,0,4,"VOX",0
23,"23008",1518,1185,1173,18,12,"VOX",0
23,"23091",742,609,607,5,2,"VOX",0
23,"23007",3102,2381,2369,8,12,"VOX",2
23,"23001",993,826,820,1,6,"VOX",1
23,"23903",3550,2742,2721,19,21,"VOX",6
23,"23081",1546,1145,1132,6,13,"VOX",0
23,"23074",3030,2368,2353,12,15,"VOX",2
23,"23056",3108,2365,2343,14,22,"VOX",2
23,"23077",637,515,514,3,1,"VOX",0
23,"23095",8737,6303,6268,34,35,"VOX",8
23,"23902",2327,1877,1857,9,20,"VOX",0
23,"23040",1489,1226,1211,4,15,"VOX",2
23,"23037",516,427,423,1,4,"VOX",0
23,"23098",875,728,722,2,6,"VOX",0
23,"23070",3931,2549,2533,11,16,"VOX",1
23,"23005",30539,21840,21629,176,211,"VOX",37
23,"23079",3733,2994,2981,26,13,"VOX",3
23,"23080",1786,1347,1329,6,18,"VOX",0
23,"23075",3319,2640,2618,21,22,"VOX",1
23,"23047",1638,1311,1306,9,5,"VOX",3
23,"23066",4376,3530,3508,46,22,"VOX",6
23,"23009",12866,9787,9667,64,120,"VOX",34
23,"23099",4734,3509,3459,23,50,"VOX",9
23,"23006",4636,3761,3714,25,47,"VOX",1
23,"23015",1393,1061,1052,3,9,"VOX",0
23,"23087",11313,8540,8454,64,86,"VOX",4
23,"23020",1584,1376,1366,5,10,"VOX",0
23,"23093",3257,2534,2506,21,28,"VOX",0
23,"23061",7520,5481,5405,55,76,"VOX",7
23,"23028",6203,4645,4585,33,60,"VOX",3
23,"23017",1584,1265,1253,4,12,"VOX",1
23,"23050",91221,67753,67164,549,589,"VOX",263
23,"23025",2813,2186,2163,7,23,"VOX",5
23,"23096",2643,2174,2140,14,34,"VOX",1
23,"23072",2002,1593,1582,6,11,"VOX",2
23,"23002",17450,13199,12986,92,213,"VOX",31
23,"23904",2852,1784,1764,14,20,"VOX",3
23,"23010",14371,10249,10140,65,109,"VOX",17
23,"23039",2220,1658,1626,8,32,"VOX",5
23,"23049",1834,1384,1378,7,6,"VOX",0
23,"23084",953,711,708,6,3,"VOX",2
23,"23092",27765,20688,20560,143,128,"VOX",36
23,"23031",751,662,650,9,12,"VOX",0
23,"23071",1728,1337,1328,7,9,"VOX",3
23,"23054",382,276,275,0,1,"VOX",2
23,"23046",2405,1963,1934,3,29,"VOX",2
23,"23060",19157,13567,13438,133,129,"VOX",11
23,"23048",860,636,630,1,6,"VOX",0
23,"23064",1659,1368,1364,1,4,"VOX",0
29,"29067",424770,295944,294094,2117,1850,"PODEMOS",57655
29,"29092",567,423,415,4,8,"PODEMOS",47
29,"29018",2026,1560,1519,15,41,"PODEMOS",172
29,"29080",6704,4812,4766,44,46,"PODEMOS",676
29,"29019",888,675,672,0,3,"PODEMOS",41
29,"29062",658,564,561,0,3,"PODEMOS",21
29,"29095",3350,2523,2467,17,56,"PODEMOS",293
29,"29083",2114,1587,1568,10,19,"PODEMOS",95
29,"29097",4117,2996,2947,43,49,"PODEMOS",325
29,"29082",31505,23154,22990,127,164,"PODEMOS",4133
29,"29903",525,394,389,2,5,"PODEMOS",40
29,"29076",2163,1508,1482,8,26,"PODEMOS",211
29,"29085",151,99,98,1,1,"PODEMOS",6
29,"29077",208,156,153,0,3,"PODEMOS",12
29,"29013",1612,1282,1272,6,10,"PODEMOS",160
29,"29044",811,557,556,3,1,"PODEMOS",42
29,"29094",57313,39393,39052,280,341,"PODEMOS",5482
29,"29014",219,138,138,1,0,"PODEMOS",20
29,"29023",2047,1385,1369,2,16,"PODEMOS",170
29,"29033",1132,808,804,2,4,"PODEMOS",71
29,"29048",1428,1168,1155,9,13,"PODEMOS",173
29,"29086",795,497,490,3,7,"PODEMOS",51
29,"29027",2343,1737,1722,6,15,"PODEMOS",143
29,"29060",706,524,516,0,8,"PODEMOS",21
29,"29017",6610,5001,4938,25,63,"PODEMOS",697
29,"29088",2720,1930,1883,21,47,"PODEMOS",260
29,"29063",336,255,251,2,4,"PODEMOS",22
29,"29046",2690,1974,1954,17,20,"PODEMOS",204
29,"29021",162,114,107,13,7,"PODEMOS",10
29,"29050",425,313,309,1,4,"PODEMOS",29
29,"29007",27319,19557,19395,179,162,"PODEMOS",3735
29,"29075",12952,8681,8619,55,62,"PODEMOS",1430
29,"29024",393,271,256,4,15,"PODEMOS",23
29,"29051",40201,27168,26842,229,326,"PODEMOS",4463
29,"29020",3265,2531,2504,17,27,"PODEMOS",335
29,"29090",1704,1174,1165,10,9,"PODEMOS",77
29,"29036",636,481,475,3,6,"PODEMOS",50
29,"29043",2503,1671,1638,17,33,"PODEMOS",208
29,"29099",960,741,734,3,7,"PODEMOS",57
29,"29010",1667,1336,1310,1,26,"PODEMOS",80
29,"29070",39913,26993,26751,203,242,"PODEMOS",5326
29,"29074",785,612,611,4,1,"PODEMOS",57
29,"29096",2806,2065,2034,19,31,"PODEMOS",318
29,"29025",39210,26938,26747,160,191,"PODEMOS",5529
29,"29068",6885,4580,4511,43,69,"PODEMOS",632
29,"29022",185,143,143,1,0,"PODEMOS",28
29,"29052",226,155,152,0,3,"PODEMOS",15
29,"29039",2662,1948,1931,22,17,"PODEMOS",294
29,"29045",1685,1232,1223,4,9,"PODEMOS",132
29,"29008",14541,9954,9820,90,134,"PODEMOS",1047
29,"29072",3250,2466,2434,11,32,"PODEMOS",356
29,"29098",1257,991,977,12,14,"PODEMOS",98
29,"29061",1018,833,820,4,13,"PODEMOS",98
29,"29040",1964,1321,1301,12,20,"PODEMOS",142
29,"29004",328,240,238,2,2,"PODEMOS",13
29,"29904",428,363,360,2,3,"PODEMOS",34
29,"29011",2920,1962,1946,5,16,"PODEMOS",184
29,"29001",4196,3276,3253,26,23,"PODEMOS",576
29,"29054",41888,29228,29022,205,206,"PODEMOS",4885
29,"29003",1002,777,769,1,8,"PODEMOS",64
29,"29035",1587,1218,1208,0,10,"PODEMOS",149
29,"29031",1633,1115,1106,6,9,"PODEMOS",122
29,"29091",8966,6437,6346,57,91,"PODEMOS",871
29,"29073",1560,1126,1120,5,6,"PODEMOS",218
29,"29057",376,285,284,2,1,"PODEMOS",25
29,"29066",346,252,251,2,1,"PODEMOS",30
29,"29006",680,482,474,3,8,"PODEMOS",40
29,"29065",194,134,134,1,0,"PODEMOS",12
29,"29902",2560,1735,1709,13,26,"PODEMOS",216
29,"29049",2987,2204,2185,25,19,"PODEMOS",373
29,"29002",1203,855,842,6,13,"PODEMOS",87
29,"29081",258,205,200,1,5,"PODEMOS",4
29,"29056",1107,815,807,8,8,"PODEMOS",54
29,"29093",2235,1689,1667,12,22,"PODEMOS",164
29,"29028",1249,881,881,4,0,"PODEMOS",110
29,"29071",938,640,633,6,7,"PODEMOS",24
29,"29059",2590,2100,2058,11,42,"PODEMOS",466
29,"29041",3146,2251,2216,26,35,"PODEMOS",333
29,"29064",506,372,365,2,7,"PODEMOS",27
29,"29042",14078,9890,9776,75,114,"PODEMOS",1335
29,"29015",31884,23160,22943,188,217,"PODEMOS",3002
29,"29055",1808,1415,1396,13,19,"PODEMOS",188
29,"29058",1463,986,975,6,11,"PODEMOS",78
29,"29053",1702,1178,1160,17,18,"PODEMOS",177
29,"29079",2444,1880,1846,3,34,"PODEMOS",108
29,"29016",253,188,188,1,0,"PODEMOS",9
29,"29084",27393,19096,18886,192,210,"PODEMOS",2581
29,"29012",9765,7029,6944,58,85,"PODEMOS",933
29,"29030",809,653,651,2,2,"PODEMOS",56
29,"29034",466,361,359,0,2,"PODEMOS",12
29,"29901",43601,30325,30130,188,195,"PODEMOS",5705
29,"29032",6708,5341,5265,26,76,"PODEMOS",839
29,"29047",1131,927,914,4,13,"PODEMOS",163
29,"29100",2437,1775,1760,12,15,"PODEMOS",165
29,"29037",212,166,165,1,1,"PODEMOS",17
29,"29089",3254,2465,2438,10,27,"PODEMOS",354
29,"29026",1065,776,766,4,10,"PODEMOS",82
29,"29029",420,322,315,4,7,"PODEMOS",46
29,"29005",4342,2946,2908,22,38,"PODEMOS",319
29,"29087",380,283,276,1,7,"PODEMOS",16
29,"29009",1477,1113,1100,3,13,"PODEMOS",104
29,"29069",85333,56398,55854,443,544,"PODEMOS",9018
29,"29038",17555,11638,11562,124,76,"PODEMOS",2145
24,"24205",967,714,706,9,8,"IU-UPeC",18
24,"24022",342,227,227,0,0,"IU-UPeC",6
24,"24189",6016,4187,4134,58,53,"IU-UPeC",164
24,"24026",1203,908,898,19,10,"IU-UPeC",32
24,"24053",439,303,298,2,5,"IU-UPeC",4
24,"24902",354,273,272,2,1,"IU-UPeC",7
24,"24002",236,182,180,3,2,"IU-UPeC",5
24,"24088",1037,804,797,8,7,"IU-UPeC",16
24,"24210",510,347,347,0,0,"IU-UPeC",11
24,"24142",25160,18503,18262,205,241,"IU-UPeC",1162
24,"24178",71,58,57,0,1,"IU-UPeC",0
24,"24097",225,146,145,1,1,"IU-UPeC",9
24,"24093",380,249,248,3,1,"IU-UPeC",6
24,"24143",514,391,379,4,12,"IU-UPeC",10
24,"24079",922,654,645,9,9,"IU-UPeC",19
24,"24193",384,277,276,4,1,"IU-UPeC",14
24,"24090",348,226,224,1,2,"IU-UPeC",5
24,"24063",391,260,259,1,1,"IU-UPeC",5
24,"24020",463,294,291,5,3,"IU-UPeC",13
24,"24165",373,254,250,2,4,"IU-UPeC",4
24,"24081",142,97,97,0,0,"IU-UPeC",1
24,"24044",171,125,118,0,7,"IU-UPeC",6
24,"24188",3843,2962,2899,48,63,"IU-UPeC",100
24,"24141",98,76,75,0,1,"IU-UPeC",4
24,"24037",369,251,251,0,0,"IU-UPeC",11
24,"24101",404,264,262,2,2,"IU-UPeC",12
24,"24216",732,533,522,2,11,"IU-UPeC",7
24,"24201",1086,765,757,5,8,"IU-UPeC",29
24,"24127",301,239,239,3,0,"IU-UPeC",5
24,"24099",173,133,133,2,0,"IU-UPeC",4
24,"24001",188,108,108,0,0,"IU-UPeC",1
24,"24009",322,161,161,1,0,"IU-UPeC",2
24,"24161",291,218,212,2,6,"IU-UPeC",7
24,"24150",243,175,175,3,0,"IU-UPeC",6
24,"24181",1519,1135,1117,10,18,"IU-UPeC",21
24,"24191",111,84,84,1,0,"IU-UPeC",1
24,"24145",655,445,443,8,2,"IU-UPeC",0
24,"24196",2082,1529,1513,15,16,"IU-UPeC",76
24,"24182",420,289,287,6,2,"IU-UPeC",8
24,"24148",1684,1268,1256,9,12,"IU-UPeC",57
24,"24023",268,189,188,2,1,"IU-UPeC",7
24,"24124",374,249,246,4,3,"IU-UPeC",2
24,"24025",300,233,228,0,5,"IU-UPeC",5
24,"24184",206,121,120,0,1,"IU-UPeC",3
24,"24211",276,210,206,4,4,"IU-UPeC",2
24,"24151",492,357,357,1,0,"IU-UPeC",13
24,"24008",9319,6964,6852,77,112,"IU-UPeC",306
24,"24074",99,77,76,1,1,"IU-UPeC",4
24,"24047",782,533,527,7,6,"IU-UPeC",9
24,"24107",244,184,183,2,1,"IU-UPeC",2
24,"24169",2976,2256,2236,12,20,"IU-UPeC",163
24,"24149",155,123,121,0,2,"IU-UPeC",0
24,"24014",7474,5375,5321,56,54,"IU-UPeC",208
24,"24129",122,85,85,1,0,"IU-UPeC",2
24,"24218",454,331,329,3,2,"IU-UPeC",6
24,"24065",2106,1573,1545,16,28,"IU-UPeC",68
24,"24092",809,619,609,1,10,"IU-UPeC",15
24,"24016",478,287,285,1,2,"IU-UPeC",2
24,"24109",996,667,652,7,15,"IU-UPeC",28
24,"24173",943,678,673,3,5,"IU-UPeC",11
24,"24052",171,109,108,0,1,"IU-UPeC",3
24,"24156",243,169,169,1,0,"IU-UPeC",3
24,"24199",433,284,281,3,3,"IU-UPeC",15
24,"24087",645,469,466,11,3,"IU-UPeC",9
24,"24901",908,660,653,4,7,"IU-UPeC",31
24,"24226",204,138,136,0,2,"IU-UPeC",3
24,"24160",692,506,498,2,8,"IU-UPeC",15
24,"24006",488,351,342,4,9,"IU-UPeC",10
24,"24110",1253,932,926,7,6,"IU-UPeC",64
24,"24019",359,293,291,3,2,"IU-UPeC",15
24,"24224",621,452,445,7,7,"IU-UPeC",12
24,"24223",2640,2012,2012,53,0,"IU-UPeC",98
24,"24172",420,218,216,1,2,"IU-UPeC",7
24,"24104",266,180,179,0,1,"IU-UPeC",13
24,"24098",1205,880,874,8,6,"IU-UPeC",70
24,"24176",318,244,243,5,1,"IU-UPeC",5
24,"24051",433,308,307,1,1,"IU-UPeC",8
24,"24060",615,361,359,0,2,"IU-UPeC",12
24,"24136",544,391,390,8,1,"IU-UPeC",8
24,"24007",764,578,576,3,2,"IU-UPeC",25
24,"24183",805,528,522,5,6,"IU-UPeC",20
24,"24017",582,434,433,9,1,"IU-UPeC",16
24,"24190",167,115,115,2,0,"IU-UPeC",2
24,"24061",1702,1244,1231,13,13,"IU-UPeC",60
24,"24177",481,328,327,1,1,"IU-UPeC",8
24,"24132",628,397,390,6,7,"IU-UPeC",12
24,"24130",437,319,315,1,4,"IU-UPeC",7
24,"24055",705,510,507,6,3,"IU-UPeC",12
24,"24038",3107,2383,2354,30,29,"IU-UPeC",67
24,"24068",464,343,339,5,4,"IU-UPeC",16
24,"24180",1128,825,814,12,11,"IU-UPeC",14
24,"24209",2790,1907,1884,15,23,"IU-UPeC",56
24,"24125",475,285,282,2,3,"IU-UPeC",4
24,"24162",1671,1314,1303,21,11,"IU-UPeC",69
24,"24059",887,520,512,8,8,"IU-UPeC",11
24,"24102",655,495,492,2,3,"IU-UPeC",9
24,"24122",1351,965,948,9,17,"IU-UPeC",49
24,"24073",481,343,340,3,3,"IU-UPeC",20
24,"24103",292,160,160,1,0,"IU-UPeC",7
24,"24146",271,195,194,0,1,"IU-UPeC",5
24,"24083",1077,764,755,4,9,"IU-UPeC",39
24,"24131",742,499,497,5,2,"IU-UPeC",13
24,"24039",2077,1604,1600,39,4,"IU-UPeC",27
24,"24170",1934,1436,1424,13,12,"IU-UPeC",61
24,"24069",42,36,36,0,0,"IU-UPeC",0
24,"24166",1413,1043,1014,7,29,"IU-UPeC",31
24,"24050",102,77,77,1,0,"IU-UPeC",1
24,"24091",657,440,437,2,3,"IU-UPeC",21
24,"24229",427,330,324,8,6,"IU-UPeC",4
24,"24123",757,499,497,4,2,"IU-UPeC",9
24,"24164",373,190,190,1,0,"IU-UPeC",6
24,"24070",4159,3206,3162,31,44,"IU-UPeC",344
24,"24167",763,509,504,9,5,"IU-UPeC",26
24,"24198",602,411,402,4,9,"IU-UPeC",5
24,"24187",876,642,631,6,11,"IU-UPeC",17
24,"24202",8098,5654,5582,51,72,"IU-UPeC",534
24,"24158",323,210,207,0,3,"IU-UPeC",5
24,"24021",1688,1213,1189,6,24,"IU-UPeC",100
24,"24096",124,74,74,0,0,"IU-UPeC",3
24,"24030",4297,3226,3180,16,46,"IU-UPeC",185
24,"24033",211,154,151,1,3,"IU-UPeC",4
24,"24095",314,246,244,1,2,"IU-UPeC",7
24,"24049",1493,1152,1138,8,14,"IU-UPeC",35
24,"24221",790,568,558,6,10,"IU-UPeC",13
24,"24058",205,137,134,0,3,"IU-UPeC",3
24,"24174",495,362,357,3,5,"IU-UPeC",18
24,"24203",96,73,72,1,1,"IU-UPeC",2
24,"24207",296,245,241,3,4,"IU-UPeC",6
24,"24168",461,383,379,4,4,"IU-UPeC",7
24,"24027",1214,881,860,8,21,"IU-UPeC",35
24,"24077",227,195,192,1,3,"IU-UPeC",5
24,"24066",504,367,361,3,6,"IU-UPeC",1
24,"24113",366,282,275,3,7,"IU-UPeC",7
24,"24116",424,276,273,0,3,"IU-UPeC",9
24,"24212",1029,784,774,7,10,"IU-UPeC",25
24,"24215",156,119,118,1,1,"IU-UPeC",5
24,"24076",1279,972,953,7,19,"IU-UPeC",52
24,"24117",446,333,331,2,2,"IU-UPeC",3
24,"24228",666,455,449,2,6,"IU-UPeC",17
24,"24144",704,487,478,5,9,"IU-UPeC",25
24,"24028",386,304,302,3,2,"IU-UPeC",19
24,"24034",3419,2596,2556,27,40,"IU-UPeC",126
24,"24157",2580,2013,1983,25,30,"IU-UPeC",72
24,"24179",299,202,201,8,1,"IU-UPeC",5
24,"24206",1732,1303,1288,8,15,"IU-UPeC",31
24,"24213",158,117,117,0,0,"IU-UPeC",1
24,"24114",3107,2174,2155,7,19,"IU-UPeC",212
24,"24185",482,357,349,4,8,"IU-UPeC",12
24,"24139",2186,1608,1570,24,38,"IU-UPeC",46
24,"24043",135,69,67,0,2,"IU-UPeC",2
24,"24118",127,84,84,1,0,"IU-UPeC",3
24,"24094",1392,1048,1038,11,10,"IU-UPeC",51
24,"24024",695,496,494,4,2,"IU-UPeC",21
24,"24057",1366,1103,1076,11,27,"IU-UPeC",38
24,"24120",345,214,214,1,0,"IU-UPeC",10
24,"24078",388,286,284,4,2,"IU-UPeC",4
24,"24086",271,200,198,1,2,"IU-UPeC",2
24,"24119",702,491,480,6,11,"IU-UPeC",23
24,"24163",3929,3076,3044,49,32,"IU-UPeC",157
24,"24015",2279,1693,1658,22,35,"IU-UPeC",35
24,"24067",645,383,379,2,4,"IU-UPeC",1
24,"24089",103315,77803,77038,779,765,"IU-UPeC",3849
24,"24062",142,105,105,1,0,"IU-UPeC",5
24,"24222",14249,10663,10532,119,131,"IU-UPeC",630
24,"24217",136,110,109,1,1,"IU-UPeC",3
24,"24112",318,207,207,0,0,"IU-UPeC",6
24,"24018",177,143,141,0,2,"IU-UPeC",6
24,"24152",462,302,301,2,1,"IU-UPeC",10
24,"24133",350,259,258,3,1,"IU-UPeC",5
24,"24036",301,181,180,0,1,"IU-UPeC",7
24,"24071",1006,747,738,9,9,"IU-UPeC",17
24,"24054",433,308,303,4,5,"IU-UPeC",6
24,"24080",218,170,162,3,8,"IU-UPeC",6
24,"24153",233,173,172,3,1,"IU-UPeC",6
24,"24041",548,384,381,5,3,"IU-UPeC",19
24,"24100",769,569,561,4,8,"IU-UPeC",21
24,"24115",54290,39886,39486,325,400,"IU-UPeC",2090
24,"24040",453,315,309,2,6,"IU-UPeC",4
24,"24227",1617,1146,1142,14,4,"IU-UPeC",47
24,"24084",162,119,119,1,0,"IU-UPeC",2
24,"24005",387,267,259,6,8,"IU-UPeC",7
24,"24194",292,230,229,1,1,"IU-UPeC",1
24,"24010",8426,5980,5888,61,92,"IU-UPeC",177
24,"24046",953,662,645,6,17,"IU-UPeC",17
24,"24031",216,169,167,1,2,"IU-UPeC",11
24,"24175",1825,1381,1372,13,9,"IU-UPeC",63
24,"24029",754,545,539,2,6,"IU-UPeC",26
24,"24004",469,349,349,6,0,"IU-UPeC",9
24,"24064",1525,1165,1151,10,14,"IU-UPeC",49
24,"24159",1832,1407,1391,17,16,"IU-UPeC",37
24,"24012",297,212,211,4,1,"IU-UPeC",8
24,"24082",870,692,682,10,10,"IU-UPeC",36
24,"24225",1020,786,773,6,13,"IU-UPeC",28
24,"24154",1010,750,729,7,21,"IU-UPeC",15
24,"24121",655,481,477,0,4,"IU-UPeC",55
24,"24011",209,113,112,0,1,"IU-UPeC",2
24,"24171",364,219,217,1,2,"IU-UPeC",3
24,"24042",61,48,48,1,0,"IU-UPeC",1
24,"24197",770,545,537,6,8,"IU-UPeC",11
24,"24003",652,442,435,5,7,"IU-UPeC",3
24,"24106",258,178,173,1,5,"IU-UPeC",4
24,"24230",423,329,324,2,5,"IU-UPeC",13
24,"24155",478,380,371,0,9,"IU-UPeC",10
24,"24032",111,82,82,1,0,"IU-UPeC",0
24,"24219",527,390,387,2,3,"IU-UPeC",10
24,"24134",3465,2628,2583,27,45,"IU-UPeC",215
24,"24105",1443,1087,1065,10,22,"IU-UPeC",47
24,"24108",377,279,273,3,6,"IU-UPeC",3
24,"24137",1114,811,804,9,7,"IU-UPeC",44
24,"24056",2910,2102,2068,31,34,"IU-UPeC",72
24,"24214",669,492,490,1,2,"IU-UPeC",18
4,"4090",309,242,242,1,0,"PODEMOS",26
4,"4044",1555,1253,1243,9,10,"PODEMOS",162
4,"4001",1083,812,796,6,16,"PODEMOS",76
4,"4014",153,118,118,0,0,"PODEMOS",5
4,"4032",5606,3789,3770,19,19,"PODEMOS",509
4,"4002",1063,765,760,1,5,"PODEMOS",77
4,"4047",2278,1906,1891,13,15,"PODEMOS",124
4,"4034",173,108,108,3,0,"PODEMOS",5
4,"4003",17365,10931,10830,57,101,"PODEMOS",1096
4,"4005",577,438,432,1,6,"PODEMOS",31
4,"4015",130,98,98,1,0,"PODEMOS",12
4,"4091",342,280,278,4,2,"PODEMOS",18
4,"4033",139,100,97,3,3,"PODEMOS",6
4,"4065",366,290,288,2,2,"PODEMOS",16
4,"4046",862,658,656,6,2,"PODEMOS",67
4,"4072",311,247,244,14,3,"PODEMOS",25
4,"4012",191,170,169,1,1,"PODEMOS",9
4,"4093",1872,1265,1252,10,13,"PODEMOS",116
4,"4079",50800,33862,33629,200,233,"PODEMOS",5293
4,"4103",1478,1051,1037,6,14,"PODEMOS",63
4,"4013",141116,95203,94625,669,578,"PODEMOS",15734
4,"4006",7016,4823,4786,33,37,"PODEMOS",356
4,"4097",254,196,194,0,2,"PODEMOS",24
4,"4078",1095,784,779,7,5,"PODEMOS",72
4,"4051",440,373,372,0,1,"PODEMOS",29
4,"4017",1301,881,876,5,5,"PODEMOS",70
4,"4052",12246,8393,8353,84,40,"PODEMOS",1510
4,"4069",4692,3641,3607,29,34,"PODEMOS",433
4,"4088",2475,1717,1703,10,14,"PODEMOS",193
4,"4050",830,597,594,3,3,"PODEMOS",65
4,"4100",8712,5545,5482,30,63,"PODEMOS",747
4,"4083",1790,1384,1379,8,5,"PODEMOS",147
4,"4095",726,466,463,2,3,"PODEMOS",35
4,"4045",1777,1402,1392,9,10,"PODEMOS",121
4,"4081",356,290,290,2,0,"PODEMOS",17
4,"4048",1503,1104,1096,7,8,"PODEMOS",104
4,"4020",292,208,207,1,1,"PODEMOS",9
4,"4903",4345,2896,2875,35,21,"PODEMOS",201
4,"4028",226,198,197,0,1,"PODEMOS",26
4,"4063",1099,847,835,2,12,"PODEMOS",59
4,"4035",8375,6079,6031,28,48,"PODEMOS",559
4,"4049",5280,3658,3623,20,35,"PODEMOS",428
4,"4055",372,315,315,0,0,"PODEMOS",18
4,"4096",274,208,206,0,2,"PODEMOS",22
4,"4023",139,104,102,1,2,"PODEMOS",13
4,"4019",251,199,198,0,1,"PODEMOS",19
4,"4004",421,314,312,2,2,"PODEMOS",30
4,"4904",1759,1185,1172,15,13,"PODEMOS",62
4,"4037",1312,1019,1000,6,19,"PODEMOS",113
4,"4016",2146,1584,1564,8,20,"PODEMOS",155
4,"4067",584,432,424,0,8,"PODEMOS",53
4,"4029",8887,6103,6048,53,55,"PODEMOS",613
4,"4098",1537,1157,1147,8,10,"PODEMOS",73
4,"4022",348,243,242,1,1,"PODEMOS",25
4,"4068",195,158,158,0,0,"PODEMOS",13
4,"4018",274,245,242,0,3,"PODEMOS",29
4,"4080",226,185,182,2,3,"PODEMOS",29
4,"4082",306,210,209,0,1,"PODEMOS",27
4,"4030",1140,828,826,8,2,"PODEMOS",58
4,"4021",187,148,141,1,7,"PODEMOS",3
4,"4086",1792,1271,1258,8,13,"PODEMOS",80
4,"4031",2359,1791,1786,7,5,"PODEMOS",174
4,"4010",579,469,464,2,5,"PODEMOS",35
4,"4008",501,420,415,3,5,"PODEMOS",20
4,"4101",4283,2969,2950,22,19,"PODEMOS",305
4,"4027",249,163,163,1,0,"PODEMOS",14
4,"4041",318,241,241,6,0,"PODEMOS",28
4,"4062",4528,3610,3579,20,31,"PODEMOS",310
4,"4054",363,297,292,1,5,"PODEMOS",17
4,"4053",12333,9124,9040,66,84,"PODEMOS",742
4,"4076",1296,1005,993,7,12,"PODEMOS",119
4,"4075",5152,3772,3715,19,57,"PODEMOS",271
4,"4066",13573,8651,8570,65,81,"PODEMOS",696
4,"4036",228,176,175,2,1,"PODEMOS",7
4,"4011",2798,2244,2220,14,24,"PODEMOS",295
4,"4084",337,264,261,1,3,"PODEMOS",16
4,"4060",466,361,358,2,3,"PODEMOS",35
4,"4058",369,292,291,2,1,"PODEMOS",41
4,"4085",395,302,298,0,4,"PODEMOS",12
4,"4007",736,553,551,0,2,"PODEMOS",46
4,"4073",332,231,230,2,1,"PODEMOS",13
4,"4071",398,327,326,2,1,"PODEMOS",40
4,"4056",147,123,120,0,3,"PODEMOS",9
4,"4026",70,60,60,0,0,"PODEMOS",3
4,"4043",546,466,462,3,4,"PODEMOS",27
4,"4009",169,127,126,0,1,"PODEMOS",13
4,"4057",1337,941,933,2,8,"PODEMOS",76
4,"4102",13729,8987,8878,114,109,"PODEMOS",829
4,"4038",3066,2169,2150,20,19,"PODEMOS",269
4,"4077",303,277,274,2,3,"PODEMOS",10
4,"4092",2852,2192,2168,13,24,"PODEMOS",178
4,"4074",2829,1965,1945,24,20,"PODEMOS",325
4,"4024",3036,2325,2308,18,17,"PODEMOS",294
4,"4061",618,495,491,5,4,"PODEMOS",52
4,"4099",4988,3784,3714,26,70,"PODEMOS",317
4,"4064",2779,2032,2009,8,23,"PODEMOS",318
4,"4087",189,140,139,1,1,"PODEMOS",21
4,"4094",209,141,141,1,0,"PODEMOS",4
4,"4901",539,388,386,0,2,"PODEMOS",41
4,"4902",45373,28425,28220,249,205,"PODEMOS",3169
4,"4059",1100,752,745,7,7,"PODEMOS",49
4,"4070",1623,1233,1229,7,4,"PODEMOS",86
4,"4089",746,536,528,6,8,"PODEMOS",46
21,"21010",14684,8766,8698,92,68,"PCPE",26
21,"21028",381,290,287,0,3,"PCPE",0
21,"21062",1395,936,926,9,10,"PCPE",5
21,"21045",253,192,190,0,2,"PCPE",1
21,"21014",4041,3203,3170,15,33,"PCPE",1
21,"21043",1858,1356,1341,13,15,"PCPE",2
21,"21029",1564,1166,1126,16,40,"PCPE",3
21,"21065",287,202,196,0,6,"PCPE",0
21,"21054",8105,6025,5919,41,106,"PCPE",4
21,"21049",3372,2162,2108,15,54,"PCPE",4
21,"21075",351,270,266,2,4,"PCPE",2
21,"21003",695,533,525,1,8,"PCPE",1
21,"21023",2147,1379,1357,6,22,"PCPE",0
21,"21021",12233,7551,7470,94,81,"PCPE",7
21,"21007",6231,4285,4227,45,58,"PCPE",2
21,"21076",2123,1549,1532,13,17,"PCPE",1
21,"21022",174,115,109,1,6,"PCPE",0
21,"21056",2912,2115,2024,20,91,"PCPE",1
21,"21064",6526,4544,4492,51,52,"PCPE",3
21,"21005",15486,10310,10189,64,121,"PCPE",14
21,"21072",10280,7869,7777,76,92,"PCPE",15
21,"21025",4049,2682,2653,25,29,"PCPE",1
21,"21006",3402,2398,2359,13,39,"PCPE",4
21,"21012",322,234,227,0,7,"PCPE",0
21,"21016",1034,777,764,2,13,"PCPE",0
21,"21040",3158,2386,2345,15,41,"PCPE",3
21,"21071",204,160,158,2,2,"PCPE",1
21,"21027",49,36,36,1,0,"PCPE",0
21,"21069",1715,1186,1175,7,11,"PCPE",1
21,"21038",1082,732,719,8,13,"PCPE",1
21,"21057",1045,641,640,8,1,"PCPE",0
21,"21058",2602,1904,1886,8,18,"PCPE",2
21,"21009",860,571,555,6,16,"PCPE",3
21,"21046",1703,1200,1173,15,27,"PCPE",2
21,"21039",308,223,222,2,1,"PCPE",0
21,"21018",1780,1152,1131,10,21,"PCPE",0
21,"21077",1722,1261,1246,5,15,"PCPE",1
21,"21020",372,241,238,2,3,"PCPE",0
21,"21013",10597,7220,7061,69,159,"PCPE",2
21,"21047",1914,1213,1179,19,34,"PCPE",2
21,"21015",683,425,420,6,5,"PCPE",1
21,"21066",507,408,405,1,3,"PCPE",0
21,"21001",648,479,469,4,10,"PCPE",1
21,"21055",6914,5286,5218,34,68,"PCPE",9
21,"21061",5092,3471,3429,32,42,"PCPE",2
21,"21042",15349,7802,7708,106,94,"PCPE",6
21,"21034",1207,848,838,8,10,"PCPE",4
21,"21059",220,167,165,3,2,"PCPE",0
21,"21031",1209,845,828,3,17,"PCPE",0
21,"21048",305,220,220,3,0,"PCPE",2
21,"21026",270,184,178,1,6,"PCPE",0
21,"21002",15348,10939,10864,80,75,"PCPE",8
21,"21051",245,176,173,1,3,"PCPE",0
21,"21063",2614,2044,2034,12,10,"PCPE",5
21,"21035",9622,6399,6313,69,86,"PCPE",8
21,"21036",192,138,138,1,0,"PCPE",0
21,"21033",536,399,395,0,4,"PCPE",0
21,"21004",1641,1070,1047,10,23,"PCPE",0
21,"21011",3464,2536,2518,19,18,"PCPE",3
21,"21017",3643,2301,2269,17,32,"PCPE",8
21,"21030",1824,1491,1472,11,19,"PCPE",3
21,"21041",113604,74902,74244,718,658,"PCPE",79
21,"21050",12448,8431,8382,86,49,"PCPE",9
21,"21052",4618,2837,2773,20,64,"PCPE",1
21,"21053",3316,2257,2219,25,38,"PCPE",4
21,"21008",2662,1847,1831,14,16,"PCPE",3
21,"21074",2660,1869,1844,18,25,"PCPE",3
21,"21032",1805,1378,1359,15,19,"PCPE",0
21,"21070",6296,4450,4397,38,53,"PCPE",2
21,"21024",495,350,344,5,6,"PCPE",0
21,"21073",1871,1134,1120,12,14,"PCPE",1
21,"21067",415,309,303,0,6,"PCPE",0
21,"21078",2763,1928,1907,12,21,"PCPE",1
21,"21068",998,606,605,14,1,"PCPE",0
21,"21060",11959,7565,7488,103,77,"PCPE",11
21,"21019",590,433,423,4,10,"PCPE",1
21,"21079",731,526,522,3,4,"PCPE",0
21,"21037",472,364,360,2,4,"PCPE",0
21,"21044",17552,10820,10692,106,128,"PCPE",17
41,"41014",2510,1981,1958,8,23,"PCPE",4
41,"41039",31674,23240,22982,196,258,"PCPE",11
41,"41101",5932,4454,4421,27,33,"PCPE",5
41,"41012",3286,2268,2235,15,33,"PCPE",2
41,"41903",6747,4926,4854,43,72,"PCPE",9
41,"41093",18487,14687,14594,117,93,"PCPE",3
41,"41050",5158,4123,4078,37,45,"PCPE",1
41,"41067",7115,5248,5178,46,70,"PCPE",3
41,"41029",13423,9979,9880,84,99,"PCPE",13
41,"41054",688,587,570,2,17,"PCPE",1
41,"41079",9343,7111,7029,68,82,"PCPE",11
41,"41087",10202,7160,7033,51,127,"PCPE",1
41,"41027",3941,2766,2709,28,57,"PCPE",1
41,"41063",2683,1942,1922,21,20,"PCPE",1
41,"41013",4842,3491,3461,22,30,"PCPE",2
41,"41008",1063,820,805,3,15,"PCPE",0
41,"41035",1112,887,876,5,11,"PCPE",2
41,"41062",2235,1805,1790,10,15,"PCPE",0
41,"41051",2170,1650,1611,8,39,"PCPE",0
41,"41077",8728,6423,6308,28,115,"PCPE",8
41,"41018",9490,6997,6930,45,67,"PCPE",7
41,"41007",12386,8552,8403,90,149,"PCPE",7
41,"41011",15395,11527,11341,114,186,"PCPE",9
41,"41089",6504,4759,4691,51,68,"PCPE",4
41,"41090",3541,2774,2721,17,53,"PCPE",4
41,"41021",21249,15031,14854,152,177,"PCPE",9
41,"41024",22662,15742,15521,137,221,"PCPE",6
41,"41080",1270,954,938,8,16,"PCPE",0
41,"41097",3135,2339,2317,19,22,"PCPE",1
41,"41026",4325,3551,3516,18,35,"PCPE",2
41,"41030",516,409,395,2,14,"PCPE",0
41,"41073",1715,1194,1169,9,25,"PCPE",4
41,"41009",1229,811,803,5,8,"PCPE",2
41,"41086",16102,10743,10665,93,78,"PCPE",10
41,"41085",4086,3223,3178,31,45,"PCPE",1
41,"41006",2740,1909,1897,13,12,"PCPE",0
41,"41015",5310,3799,3710,38,89,"PCPE",5
41,"41005",9057,6781,6693,58,88,"PCPE",8
41,"41022",4300,2918,2891,30,27,"PCPE",3
41,"41003",2319,1782,1754,8,28,"PCPE",1
41,"41059",33977,26158,25965,230,193,"PCPE",20
41,"41025",2041,1456,1430,17,26,"PCPE",1
41,"41068",13948,10269,10150,75,119,"PCPE",6
41,"41058",17304,12982,12751,133,231,"PCPE",20
41,"41032",4019,2943,2875,17,68,"PCPE",0
41,"41078",2522,1888,1874,5,14,"PCPE",2
41,"41036",3971,2846,2806,14,40,"PCPE",1
41,"41048",2244,1625,1598,22,27,"PCPE",1
41,"41095",41137,28987,28731,302,256,"PCPE",23
41,"41057",275,193,191,0,2,"PCPE",0
41,"41076",2184,1442,1432,19,10,"PCPE",21
41,"41023",7919,5852,5788,34,64,"PCPE",41
41,"41071",5620,3974,3898,17,76,"PCPE",1
41,"41020",12872,8820,8723,92,97,"PCPE",9
41,"41017",15052,11074,10964,99,110,"PCPE",8
41,"41902",4675,3051,3019,20,32,"PCPE",3
41,"41055",15009,10393,10292,82,101,"PCPE",4
41,"41045",5749,4121,4066,49,55,"PCPE",3
41,"41064",5601,3766,3715,42,51,"PCPE",5
41,"41049",9301,7147,7070,63,77,"PCPE",6
41,"41046",3017,2416,2381,12,35,"PCPE",0
41,"41088",518,381,377,0,4,"PCPE",1
41,"41094",6288,4726,4653,36,73,"PCPE",2
41,"41052",3006,2264,2209,8,55,"PCPE",2
41,"41100",1025,770,751,5,19,"PCPE",2
41,"41033",5102,3655,3613,25,42,"PCPE",3
41,"41091",541928,401177,398212,3487,2965,"PCPE",276
41,"41044",7392,5562,5526,40,36,"PCPE",3
41,"41056",3691,3069,3042,21,27,"PCPE",2
41,"41040",10411,7959,7892,53,67,"PCPE",1
41,"41010",4394,3203,3160,19,43,"PCPE",3
41,"41016",7310,5473,5410,50,63,"PCPE",6
41,"41041",9743,7620,7482,39,138,"PCPE",3
41,"41065",22868,15933,15784,172,149,"PCPE",11
41,"41083",1154,893,888,3,5,"PCPE",0
41,"41031",1257,838,836,8,2,"PCPE",0
41,"41072",4052,3115,3041,18,74,"PCPE",0
41,"41047",10086,7758,7663,80,95,"PCPE",3
41,"41081",29164,21631,21410,218,221,"PCPE",14
41,"41060",15279,10611,10447,91,164,"PCPE",5
41,"41098",4952,3762,3704,24,58,"PCPE",0
41,"41092",7749,5715,5647,57,68,"PCPE",2
41,"41038",99637,71611,71050,727,561,"PCPE",67
41,"41028",1971,1574,1562,11,12,"PCPE",0
41,"41019",4654,3267,3224,34,43,"PCPE",3
41,"41102",14635,10904,10655,148,249,"PCPE",10
41,"41070",6021,4504,4456,44,48,"PCPE",1
41,"41096",6166,4811,4752,39,59,"PCPE",19
41,"41001",1597,1262,1248,5,14,"PCPE",0
41,"41002",1469,1085,1061,12,24,"PCPE",1
41,"41074",3033,2362,2341,8,21,"PCPE",1
41,"41901",2676,2222,2190,31,32,"PCPE",2
41,"41099",3998,2597,2577,19,20,"PCPE",3
41,"41066",1363,1019,1007,7,12,"PCPE",2
41,"41053",21252,16022,15770,121,252,"PCPE",20
41,"41043",636,439,435,3,4,"PCPE",0
41,"41069",29070,20827,20558,355,269,"PCPE",23
41,"41042",5868,4612,4583,37,29,"PCPE",8
41,"41034",23033,15936,15711,189,225,"PCPE",11
41,"41004",56552,40018,39623,515,395,"PCPE",35
41,"41061",2218,1769,1742,5,27,"PCPE",0
41,"41075",10225,7387,7283,55,104,"PCPE",5
41,"41037",3203,2473,2449,18,24,"PCPE",1
41,"41084",2850,2205,2157,15,48,"PCPE",0
41,"41082",3432,2809,2781,12,28,"PCPE",3
15,"15003",1818,1326,1302,18,24,"PCPE",0
15,"15085",3346,2365,2311,26,54,"PCPE",5
15,"15057",12169,8853,8729,88,124,"PCPE",20
15,"15086",2918,2109,2077,19,32,"PCPE",1
15,"15072",9626,7024,6920,52,104,"PCPE",27
15,"15001",4805,3466,3419,45,47,"PCPE",13
15,"15051",4651,3343,3297,38,46,"PCPE",17
15,"15074",4061,2983,2947,24,36,"PCPE",8
15,"15002",22929,16941,16742,205,199,"PCPE",27
15,"15016",4806,3291,3222,21,69,"PCPE",2
15,"15070",9117,6514,6390,98,124,"PCPE",14
15,"15048",4855,3582,3534,41,48,"PCPE",8
15,"15027",1540,1224,1203,6,21,"PCPE",0
15,"15091",1119,807,784,12,23,"PCPE",1
15,"15081",1042,819,814,12,5,"PCPE",3
15,"15010",1913,1355,1338,21,17,"PCPE",1
15,"15055",4618,3208,3159,49,49,"PCPE",15
15,"15019",25902,18111,17866,232,245,"PCPE",44
15,"15038",2236,1556,1530,18,26,"PCPE",1
15,"15066",4039,2950,2894,34,56,"PCPE",1
15,"15029",5761,3994,3928,47,66,"PCPE",9
15,"15045",3803,2382,2354,15,28,"PCPE",0
15,"15075",12279,9076,8952,117,124,"PCPE",21
15,"15047",2463,1669,1633,21,36,"PCPE",7
15,"15079",1562,1092,1075,16,17,"PCPE",4
15,"15071",7965,5559,5483,37,76,"PCPE",13
15,"15013",6126,4315,4257,43,58,"PCPE",8
15,"15083",1100,809,795,5,14,"PCPE",1
15,"15089",4317,3238,3188,24,50,"PCPE",5
15,"15004",4855,3594,3535,28,59,"PCPE",5
15,"15006",5353,3534,3469,49,65,"PCPE",2
15,"15030",200245,148692,147426,1699,1266,"PCPE",299
15,"15902",4660,3352,3296,30,56,"PCPE",8
15,"15031",23321,17319,17152,218,167,"PCPE",34
15,"15087",5804,3942,3901,49,41,"PCPE",20
15,"15032",3455,2438,2391,26,47,"PCPE",3
15,"15037",4087,2775,2733,18,42,"PCPE",4
15,"15021",5099,3673,3611,43,62,"PCPE",4
15,"15041",9627,7409,7291,79,118,"PCPE",9
15,"15076",2649,1827,1802,24,25,"PCPE",0
15,"15017",19380,14272,14098,156,174,"PCPE",47
15,"15025",1069,662,654,5,8,"PCPE",2
15,"15061",5646,3945,3894,35,51,"PCPE",3
15,"15069",6785,5107,5032,54,75,"PCPE",11
15,"15062",5936,4047,3993,31,54,"PCPE",9
15,"15015",2840,2126,2100,21,26,"PCPE",5
15,"15035",11517,8305,8192,144,113,"PCPE",44
15,"15044",1309,955,941,5,14,"PCPE",1
15,"15058",27623,21002,20788,257,214,"PCPE",42
15,"15028",1415,1085,1070,10,15,"PCPE",3
15,"15034",2897,1931,1909,14,22,"PCPE",1
15,"15060",5780,4245,4167,48,78,"PCPE",5
15,"15046",6345,4625,4532,53,93,"PCPE",6
15,"15050",1843,1089,1070,19,19,"PCPE",5
15,"15092",6523,4518,4449,54,69,"PCPE",10
15,"15011",15463,11105,10890,92,215,"PCPE",33
15,"15901",3595,2401,2374,30,27,"PCPE",1
15,"15043",5147,3834,3764,36,70,"PCPE",9
15,"15009",10780,8075,7957,70,118,"PCPE",16
15,"15077",8303,5648,5544,57,104,"PCPE",3
15,"15052",4351,3122,3063,26,59,"PCPE",2
15,"15054",32177,22065,21778,349,287,"PCPE",68
15,"15023",6481,4658,4595,44,63,"PCPE",12
15,"15056",5757,4167,4108,43,59,"PCPE",3
15,"15039",1271,935,917,8,18,"PCPE",2
15,"15053",7783,5386,5314,47,72,"PCPE",9
15,"15020",3844,2651,2629,17,22,"PCPE",3
15,"15064",2207,1680,1650,22,30,"PCPE",1
15,"15065",7345,5517,5412,46,105,"PCPE",7
15,"15068",5096,3518,3476,39,42,"PCPE",11
15,"15007",3352,2469,2453,24,16,"PCPE",4
15,"15036",58409,40932,40506,484,426,"PCPE",135
15,"15082",15162,11273,11134,135,139,"PCPE",17
15,"15078",78093,58164,57487,673,677,"PCPE",100
15,"15008",5650,4239,4175,42,64,"PCPE",5
15,"15067",8073,6067,6000,45,67,"PCPE",14
15,"15088",3550,2398,2372,18,26,"PCPE",2
15,"15049",1099,765,755,12,10,"PCPE",0
15,"15022",5817,4026,3981,29,45,"PCPE",14
15,"15042",3060,2170,2127,21,43,"PCPE",2
15,"15080",1760,1215,1197,11,18,"PCPE",0
15,"15014",4034,2809,2757,34,52,"PCPE",7
15,"15059",10406,7710,7553,91,157,"PCPE",10
15,"15090",1182,868,861,13,7,"PCPE",0
15,"15005",24459,16742,16482,215,260,"PCPE",29
15,"15040",2763,2050,2017,10,33,"PCPE",4
15,"15012",3666,2787,2721,40,66,"PCPE",2
15,"15084",3312,2361,2326,28,35,"PCPE",2
15,"15024",4412,3325,3278,35,47,"PCPE",6
15,"15093",4265,2856,2814,35,42,"PCPE",2
15,"15018",1156,817,806,7,11,"PCPE",3
15,"15033",2489,1953,1931,13,22,"PCPE",1
15,"15073",21884,14792,14587,149,205,"PCPE",41
12,"12123",47,32,32,0,0,"CCD",0
12,"12013",148,119,116,4,3,"CCD",0
12,"12006",176,140,140,1,0,"CCD",1
12,"12131",65,53,53,0,0,"CCD",0
12,"12115",217,169,167,2,2,"CCD",0
12,"12039",840,726,719,2,7,"CCD",3
12,"12132",486,407,398,2,9,"CCD",1
12,"12093",189,147,145,1,2,"CCD",1
12,"12045",354,282,279,2,3,"CCD",1
12,"12061",378,275,275,4,0,"CCD",1
12,"12057",606,495,487,3,8,"CCD",2
12,"12133",60,49,49,0,0,"CCD",3
12,"12040",117832,89135,88464,525,671,"CCD",488
12,"12007",758,672,667,7,5,"CCD",2
12,"12112",99,81,79,1,2,"CCD",0
12,"12055",106,79,79,2,0,"CCD",0
12,"12032",23508,17400,17279,89,121,"CCD",156
12,"12076",87,70,70,1,0,"CCD",2
12,"12088",69,58,58,0,0,"CCD",0
12,"12001",1054,798,786,8,12,"CCD",5
12,"12122",805,660,647,4,13,"CCD",0
12,"12059",244,190,189,1,1,"CCD",0
12,"12026",894,697,676,14,21,"CCD",1
12,"12038",171,121,120,1,1,"CCD",0
12,"12077",4625,3443,3387,20,56,"CCD",16
12,"12058",74,60,59,2,1,"CCD",1
12,"12113",85,69,69,2,0,"CCD",0
12,"12124",1853,1411,1394,20,17,"CCD",5
12,"12134",138,97,96,0,1,"CCD",0
12,"12016",1582,1311,1295,9,16,"CCD",24
12,"12087",26,18,18,3,0,"CCD",1
12,"12096",775,587,580,12,7,"CCD",3
12,"12114",200,150,149,1,1,"CCD",1
12,"12063",42,35,34,2,1,"CCD",1
12,"12105",851,666,659,5,7,"CCD",9
12,"12014",184,140,136,1,4,"CCD",1
12,"12048",249,196,192,1,4,"CCD",0
12,"12901",3433,2691,2664,27,27,"CCD",13
12,"12071",1280,1002,988,5,14,"CCD",7
12,"12138",19064,13610,13456,135,154,"CCD",73
12,"12003",991,762,752,10,10,"CCD",1
12,"12070",524,418,408,8,10,"CCD",3
12,"12121",1127,955,928,6,27,"CCD",4
12,"12092",112,84,84,0,0,"CCD",0
12,"12015",96,83,81,0,2,"CCD",0
12,"12104",6954,5571,5470,26,101,"CCD",43
12,"12136",2657,2302,2252,22,50,"CCD",57
12,"12079",405,318,312,4,6,"CCD",1
12,"12052",590,464,442,5,22,"CCD",4
12,"12046",193,154,153,3,1,"CCD",0
12,"12142",161,124,123,0,1,"CCD",1
12,"12044",483,438,431,4,7,"CCD",3
12,"12034",1430,1078,1053,4,25,"CCD",7
12,"12095",974,789,784,8,5,"CCD",5
12,"12005",8090,6113,6027,57,86,"CCD",52
12,"12137",37,26,26,1,0,"CCD",0
12,"12068",49,34,34,1,0,"CCD",0
12,"12101",363,282,273,3,9,"CCD",1
12,"12004",4204,3174,3130,19,44,"CCD",17
12,"12022",340,273,269,1,4,"CCD",0
12,"12097",67,55,54,0,1,"CCD",0
12,"12140",1140,961,950,5,11,"CCD",1
12,"12037",16,14,14,0,0,"CCD",0
12,"12025",137,106,106,0,0,"CCD",0
12,"12085",5061,3310,3264,20,46,"CCD",23
12,"12036",593,448,445,2,3,"CCD",10
12,"12010",259,216,209,6,7,"CCD",1
12,"12100",1345,1115,1098,6,17,"CCD",4
12,"12120",184,155,154,1,1,"CCD",0
12,"12110",244,173,170,1,3,"CCD",2
12,"12119",147,100,100,1,0,"CCD",2
12,"12011",4587,3530,3480,30,50,"CCD",37
12,"12078",339,250,247,1,3,"CCD",1
12,"12098",588,479,473,4,6,"CCD",1
12,"12089",4331,3103,3050,25,53,"CCD",22
12,"12017",164,133,132,1,1,"CCD",1
12,"12033",1907,1483,1436,11,47,"CCD",10
12,"12082",9655,7570,7492,38,78,"CCD",142
12,"12091",185,145,141,3,4,"CCD",1
12,"12075",123,94,92,1,2,"CCD",0
12,"12008",231,192,190,2,2,"CCD",2
12,"12094",851,688,674,2,14,"CCD",4
12,"12081",611,503,493,3,10,"CCD",1
12,"12084",17599,13146,13022,98,124,"CCD",114
12,"12090",109,94,93,2,1,"CCD",0
12,"12099",542,434,405,9,29,"CCD",0
12,"12027",17217,12263,12122,77,141,"CCD",46
12,"12049",455,348,339,5,9,"CCD",3
12,"12021",4442,3486,3432,25,54,"CCD",32
12,"12074",784,690,678,9,12,"CCD",7
12,"12083",95,82,80,0,2,"CCD",1
12,"12067",543,442,424,1,18,"CCD",1
12,"12073",156,132,131,0,1,"CCD",0
12,"12118",74,60,59,0,1,"CCD",2
12,"12126",24480,18885,18687,115,198,"CCD",102
12,"12043",581,470,459,4,11,"CCD",3
12,"12125",214,185,183,2,2,"CCD",1
12,"12111",375,314,310,0,4,"CCD",0
12,"12103",89,69,68,2,1,"CCD",0
12,"12108",463,395,390,0,5,"CCD",9
12,"12056",285,243,238,3,5,"CCD",1
12,"12064",97,83,82,0,1,"CCD",1
12,"12116",67,49,49,0,0,"CCD",0
12,"12029",717,572,566,6,6,"CCD",0
12,"12069",74,50,49,0,1,"CCD",1
12,"12031",3830,3049,2987,20,62,"CCD",32
12,"12012",2695,2236,2204,6,32,"CCD",14
12,"12902",2148,1562,1536,9,26,"CCD",14
12,"12139",322,239,237,1,2,"CCD",1
12,"12128",1400,1102,1091,11,11,"CCD",4
12,"12028",12566,9902,9830,55,72,"CCD",52
12,"12009",17430,12600,12501,77,99,"CCD",75
12,"12102",536,452,437,1,15,"CCD",0
12,"12141",101,80,80,0,0,"CCD",0
12,"12135",35749,27015,26806,174,209,"CCD",266
12,"12107",351,313,309,3,4,"CCD",1
12,"12130",404,339,332,0,7,"CCD",2
12,"12002",116,98,96,0,2,"CCD",0
12,"12080",1955,1647,1624,13,23,"CCD",2
12,"12109",647,531,520,1,11,"CCD",2
12,"12129",1840,1391,1360,19,31,"CCD",16
12,"12106",1170,983,967,16,16,"CCD",8
12,"12060",446,367,360,2,7,"CCD",4
12,"12020",124,104,103,1,1,"CCD",1
12,"12127",77,56,56,0,0,"CCD",1
12,"12072",1117,962,937,8,25,"CCD",11
12,"12024",139,115,113,1,2,"CCD",0
12,"12117",3576,2786,2747,17,39,"CCD",11
12,"12042",621,520,512,13,8,"CCD",1
12,"12051",477,337,335,2,2,"CCD",1
12,"12065",192,166,166,0,0,"CCD",0
12,"12053",2069,1691,1677,8,14,"CCD",5
12,"12041",97,77,77,0,0,"CCD",0
12,"12050",1320,1044,1032,8,12,"CCD",0
12,"12018",293,244,235,2,9,"CCD",0
5,"5220",382,298,294,1,4,"PODEMOS",33
5,"5018",29,21,21,0,0,"PODEMOS",2
5,"5102",1807,1431,1412,7,19,"PODEMOS",122
5,"5153",108,78,77,3,1,"PODEMOS",8
5,"5126",70,59,59,0,0,"PODEMOS",4
5,"5131",105,70,69,1,1,"PODEMOS",0
5,"5021",1932,1478,1456,12,22,"PODEMOS",201
5,"5086",82,66,64,1,2,"PODEMOS",0
5,"5178",371,295,289,0,6,"PODEMOS",18
5,"5056",96,73,73,0,0,"PODEMOS",4
5,"5216",224,155,155,2,0,"PODEMOS",19
5,"5190",55,42,42,2,0,"PODEMOS",2
5,"5057",2470,1977,1953,14,24,"PODEMOS",125
5,"5243",88,61,61,1,0,"PODEMOS",4
5,"5226",77,57,57,0,0,"PODEMOS",1
5,"5014",5422,4137,4084,30,53,"PODEMOS",671
5,"5072",87,70,69,1,1,"PODEMOS",1
5,"5047",4199,3287,3244,7,43,"PODEMOS",368
5,"5217",58,45,45,0,0,"PODEMOS",2
5,"5142",104,88,82,1,6,"PODEMOS",2
5,"5048",120,104,103,0,1,"PODEMOS",8
5,"5170",52,46,46,0,0,"PODEMOS",7
5,"5238",787,565,556,4,9,"PODEMOS",73
5,"5058",78,55,55,2,0,"PODEMOS",6
5,"5044",259,180,180,0,0,"PODEMOS",3
5,"5037",261,165,163,3,2,"PODEMOS",9
5,"5103",78,56,56,0,0,"PODEMOS",6
5,"5208",40,34,34,0,0,"PODEMOS",3
5,"5019",44606,34903,34564,285,339,"PODEMOS",4558
5,"5002",1954,1471,1450,9,21,"PODEMOS",296
5,"5206",29,22,21,0,1,"PODEMOS",5
5,"5266",102,89,89,0,0,"PODEMOS",4
5,"5060",120,99,99,1,0,"PODEMOS",7
5,"5095",266,220,218,0,2,"PODEMOS",13
5,"5035",107,84,84,1,0,"PODEMOS",9
5,"5078",115,100,99,3,1,"PODEMOS",7
5,"5247",250,147,146,1,1,"PODEMOS",10
5,"5169",226,178,176,1,2,"PODEMOS",10
5,"5264",62,43,42,1,1,"PODEMOS",5
5,"5119",33,20,20,0,0,"PODEMOS",3
5,"5207",697,553,548,0,5,"PODEMOS",59
5,"5158",371,289,287,1,2,"PODEMOS",18
5,"5065",469,388,385,6,3,"PODEMOS",33
5,"5252",64,45,45,0,0,"PODEMOS",1
5,"5005",187,150,149,0,1,"PODEMOS",5
5,"5230",65,56,54,1,2,"PODEMOS",1
5,"5177",160,128,128,1,0,"PODEMOS",15
5,"5075",107,67,67,0,0,"PODEMOS",8
5,"5260",104,84,83,1,1,"PODEMOS",6
5,"5244",51,38,38,0,0,"PODEMOS",3
5,"5073",297,243,238,4,5,"PODEMOS",29
5,"5055",576,476,467,0,9,"PODEMOS",48
5,"5136",97,74,73,5,1,"PODEMOS",7
5,"5053",86,58,58,0,0,"PODEMOS",2
5,"5145",52,41,41,0,0,"PODEMOS",5
5,"5084",74,56,56,1,0,"PODEMOS",4
5,"5141",95,86,86,2,0,"PODEMOS",9
5,"5067",83,66,59,1,7,"PODEMOS",6
5,"5007",113,74,74,1,0,"PODEMOS",2
5,"5063",34,24,24,0,0,"PODEMOS",2
5,"5233",226,179,177,0,2,"PODEMOS",15
5,"5093",417,313,311,1,2,"PODEMOS",40
5,"5054",1238,953,933,1,20,"PODEMOS",214
5,"5187",1755,1409,1395,11,14,"PODEMOS",231
5,"5013",876,733,723,2,10,"PODEMOS",194
5,"5027",269,220,218,2,2,"PODEMOS",32
5,"5903",157,108,107,0,1,"PODEMOS",15
5,"5042",155,126,125,0,1,"PODEMOS",3
5,"5008",227,180,176,2,4,"PODEMOS",11
5,"5165",380,291,283,5,8,"PODEMOS",62
5,"5224",106,87,86,0,1,"PODEMOS",10
5,"5100",285,229,228,0,1,"PODEMOS",37
5,"5043",84,67,67,0,0,"PODEMOS",3
5,"5074",693,543,540,1,3,"PODEMOS",28
5,"5232",98,83,81,1,2,"PODEMOS",11
5,"5134",48,40,40,0,0,"PODEMOS",0
5,"5133",67,55,55,1,0,"PODEMOS",0
5,"5129",129,78,78,0,0,"PODEMOS",4
5,"5251",68,40,40,0,0,"PODEMOS",1
5,"5001",194,153,152,1,1,"PODEMOS",13
5,"5109",454,378,362,3,16,"PODEMOS",24
5,"5174",69,55,55,1,0,"PODEMOS",2
5,"5241",3081,2143,2115,17,28,"PODEMOS",262
5,"5261",42,26,26,0,0,"PODEMOS",0
5,"5257",140,98,98,0,0,"PODEMOS",24
5,"5162",87,60,60,2,0,"PODEMOS",8
5,"5087",137,93,93,0,0,"PODEMOS",6
5,"5122",144,115,113,1,2,"PODEMOS",3
5,"5076",481,401,387,5,14,"PODEMOS",52
5,"5209",83,63,63,0,0,"PODEMOS",2
5,"5097",474,324,317,3,7,"PODEMOS",27
5,"5246",60,42,42,0,0,"PODEMOS",2
5,"5096",79,57,57,0,0,"PODEMOS",8
5,"5210",85,72,72,1,0,"PODEMOS",4
5,"5045",95,70,70,0,0,"PODEMOS",2
5,"5062",184,155,154,2,1,"PODEMOS",5
5,"5176",234,190,187,2,3,"PODEMOS",31
5,"5188",45,38,38,0,0,"PODEMOS",0
5,"5107",64,39,39,1,0,"PODEMOS",3
5,"5112",97,72,70,1,2,"PODEMOS",12
5,"5168",3565,2740,2711,17,29,"PODEMOS",312
5,"5218",121,97,95,0,2,"PODEMOS",0
5,"5089",478,377,365,0,12,"PODEMOS",39
5,"5267",100,65,64,0,1,"PODEMOS",13
5,"5132",992,678,672,2,6,"PODEMOS",102
5,"5164",27,19,19,1,0,"PODEMOS",0
5,"5173",60,45,45,0,0,"PODEMOS",4
5,"5113",78,58,58,1,0,"PODEMOS",6
5,"5038",116,87,85,0,2,"PODEMOS",9
5,"5240",3393,2354,2335,9,19,"PODEMOS",292
5,"5201",529,439,431,2,8,"PODEMOS",36
5,"5185",94,80,80,1,0,"PODEMOS",3
5,"5139",76,66,66,0,0,"PODEMOS",4
5,"5121",241,186,185,3,1,"PODEMOS",20
5,"5901",273,187,185,5,2,"PODEMOS",25
5,"5052",99,89,88,0,1,"PODEMOS",3
5,"5194",138,122,121,5,1,"PODEMOS",13
5,"5249",107,82,82,0,0,"PODEMOS",32
5,"5029",123,92,89,0,3,"PODEMOS",7
5,"5127",650,539,535,4,4,"PODEMOS",56
5,"5902",288,227,227,0,0,"PODEMOS",14
5,"5204",611,473,471,1,2,"PODEMOS",37
5,"5039",56,43,42,0,1,"PODEMOS",5
5,"5182",801,559,546,9,13,"PODEMOS",51
5,"5092",155,120,120,0,0,"PODEMOS",10
5,"5036",123,97,97,0,0,"PODEMOS",3
5,"5166",188,135,134,1,1,"PODEMOS",8
5,"5205",75,58,58,0,0,"PODEMOS",1
5,"5221",353,270,264,3,6,"PODEMOS",41
5,"5163",1756,1351,1345,1,6,"PODEMOS",218
5,"5140",116,97,96,0,1,"PODEMOS",3
5,"5080",59,42,40,0,2,"PODEMOS",7
5,"5171",73,58,57,2,1,"PODEMOS",3
5,"5033",174,139,138,0,1,"PODEMOS",5
5,"5179",215,184,180,0,4,"PODEMOS",2
5,"5199",39,32,32,0,0,"PODEMOS",0
5,"5151",93,70,70,1,0,"PODEMOS",7
5,"5026",197,170,169,1,1,"PODEMOS",10
5,"5214",38,27,26,0,1,"PODEMOS",1
5,"5022",1611,1279,1271,4,8,"PODEMOS",81
5,"5128",350,289,284,4,5,"PODEMOS",47
5,"5099",497,398,381,3,17,"PODEMOS",25
5,"5147",162,119,116,0,3,"PODEMOS",14
5,"5259",125,107,106,3,1,"PODEMOS",5
5,"5172",123,104,102,2,2,"PODEMOS",6
5,"5051",181,152,147,3,5,"PODEMOS",15
5,"5138",311,241,239,3,2,"PODEMOS",11
5,"5263",172,137,137,0,0,"PODEMOS",7
5,"5236",128,85,84,0,1,"PODEMOS",20
5,"5090",84,69,68,1,1,"PODEMOS",1
5,"5069",74,58,58,0,0,"PODEMOS",2
5,"5228",179,126,126,0,0,"PODEMOS",4
5,"5189",443,340,336,3,4,"PODEMOS",52
5,"5034",15,12,12,1,0,"PODEMOS",4
5,"5212",233,157,155,1,2,"PODEMOS",2
5,"5108",51,30,30,0,0,"PODEMOS",5
5,"5024",231,169,163,5,6,"PODEMOS",19
5,"5245",348,293,288,0,5,"PODEMOS",32
5,"5114",1359,1131,1115,5,16,"PODEMOS",71
5,"5144",79,62,60,2,2,"PODEMOS",1
5,"5010",149,119,118,1,1,"PODEMOS",5
5,"5105",349,279,270,3,9,"PODEMOS",43
5,"5159",254,175,174,2,1,"PODEMOS",5
5,"5239",207,163,162,1,1,"PODEMOS",10
5,"5256",116,92,92,1,0,"PODEMOS",3
5,"5234",51,46,46,1,0,"PODEMOS",1
5,"5106",36,27,27,0,0,"PODEMOS",5
5,"5115",532,392,386,2,6,"PODEMOS",29
5,"5061",253,198,196,4,2,"PODEMOS",30
5,"5088",33,24,24,0,0,"PODEMOS",0
5,"5040",68,45,45,0,0,"PODEMOS",3
5,"5175",159,130,130,0,0,"PODEMOS",18
5,"5041",1001,772,765,10,7,"PODEMOS",64
5,"5155",52,37,37,0,0,"PODEMOS",8
5,"5191",126,104,104,1,0,"PODEMOS",16
5,"5197",98,90,90,0,0,"PODEMOS",7
5,"5227",373,250,248,0,2,"PODEMOS",47
5,"5167",265,209,199,0,10,"PODEMOS",28
5,"5066",458,365,364,3,1,"PODEMOS",87
5,"5196",53,39,39,0,0,"PODEMOS",3
5,"5235",124,111,110,1,1,"PODEMOS",7
5,"5180",88,68,68,1,0,"PODEMOS",3
5,"5192",100,82,81,1,1,"PODEMOS",15
5,"5120",35,26,26,0,0,"PODEMOS",2
5,"5152",690,561,558,3,3,"PODEMOS",22
5,"5211",465,375,373,2,2,"PODEMOS",23
5,"5077",161,137,136,2,1,"PODEMOS",12
5,"5046",45,38,38,1,0,"PODEMOS",0
5,"5242",681,538,527,10,11,"PODEMOS",21
5,"5059",109,79,76,1,3,"PODEMOS",21
5,"5265",82,70,70,0,0,"PODEMOS",5
5,"5219",39,28,28,0,0,"PODEMOS",3
5,"5125",57,45,44,0,1,"PODEMOS",4
5,"5229",84,67,67,0,0,"PODEMOS",1
5,"5023",173,153,153,5,0,"PODEMOS",6
5,"5064",103,87,87,1,0,"PODEMOS",0
5,"5148",27,17,17,0,0,"PODEMOS",1
5,"5157",240,170,167,1,3,"PODEMOS",12
5,"5181",43,31,31,1,0,"PODEMOS",2
5,"5225",372,316,315,5,1,"PODEMOS",28
5,"5130",95,82,82,0,0,"PODEMOS",15
5,"5213",101,83,83,0,0,"PODEMOS",6
5,"5237",164,131,126,1,5,"PODEMOS",4
5,"5015",87,66,65,1,1,"PODEMOS",16
5,"5117",201,178,174,2,4,"PODEMOS",12
5,"5118",84,57,57,0,0,"PODEMOS",3
5,"5079",70,54,54,0,0,"PODEMOS",6
5,"5123",96,69,66,2,3,"PODEMOS",6
5,"5262",358,278,277,1,1,"PODEMOS",44
5,"5195",224,162,161,1,1,"PODEMOS",17
5,"5083",145,108,100,2,8,"PODEMOS",10
5,"5016",6335,4873,4775,39,98,"PODEMOS",473
5,"5183",140,114,113,1,1,"PODEMOS",0
5,"5110",721,559,552,3,7,"PODEMOS",43
5,"5186",1572,1240,1222,9,18,"PODEMOS",127
5,"5101",316,240,238,1,2,"PODEMOS",10
5,"5200",49,28,28,0,0,"PODEMOS",2
5,"5254",196,166,166,0,0,"PODEMOS",9
5,"5124",107,83,81,1,2,"PODEMOS",5
5,"5049",399,301,291,1,10,"PODEMOS",37
5,"5904",133,92,91,1,1,"PODEMOS",18
5,"5094",140,110,110,0,0,"PODEMOS",3
5,"5085",38,29,29,0,0,"PODEMOS",0
5,"5156",249,163,161,0,2,"PODEMOS",27
5,"5104",34,23,22,1,1,"PODEMOS",6
5,"5198",73,59,59,0,0,"PODEMOS",3
5,"5215",169,126,122,2,4,"PODEMOS",17
5,"5082",528,437,427,5,10,"PODEMOS",45
5,"5154",36,30,30,0,0,"PODEMOS",4
5,"5135",425,325,322,1,3,"PODEMOS",18
5,"5143",66,55,55,1,0,"PODEMOS",10
5,"5149",105,76,75,0,1,"PODEMOS",7
5,"5030",46,37,37,0,0,"PODEMOS",10
5,"5253",88,70,70,0,0,"PODEMOS",9
5,"5070",32,26,26,0,0,"PODEMOS",3
5,"5116",118,95,93,1,2,"PODEMOS",6
5,"5905",214,150,150,1,0,"PODEMOS",4
5,"5081",39,33,31,0,2,"PODEMOS",0
5,"5231",160,126,124,1,2,"PODEMOS",1
5,"5017",85,75,75,0,0,"PODEMOS",5
5,"5161",586,483,473,2,10,"PODEMOS",45
5,"5012",135,110,108,0,2,"PODEMOS",3
5,"5222",159,126,126,0,0,"PODEMOS",9
5,"5160",323,263,260,1,3,"PODEMOS",13
5,"5025",96,73,72,1,1,"PODEMOS",0
5,"5258",113,98,97,0,1,"PODEMOS",9
5,"5184",250,197,192,0,5,"PODEMOS",20
5,"5193",194,163,163,1,0,"PODEMOS",2
46,"46235",21793,16577,16424,118,153,"VOX",15
46,"46254",1012,786,775,1,11,"VOX",1
46,"46081",10180,8055,7984,32,71,"VOX",18
46,"46094",20515,15885,15785,125,100,"VOX",43
46,"46213",15476,11377,11246,110,131,"VOX",41
46,"46060",9361,7285,7229,30,56,"VOX",18
46,"46114",575,488,484,3,4,"VOX",0
46,"46208",1114,931,922,3,9,"VOX",1
46,"46098",2491,1978,1950,14,28,"VOX",2
46,"46121",105,92,91,2,1,"VOX",0
46,"46230",13944,10746,10646,69,100,"VOX",16
46,"46204",6781,5421,5379,15,42,"VOX",7
46,"46024",424,348,340,0,8,"VOX",1
46,"46184",26467,20888,20675,138,213,"VOX",23
46,"46055",1273,1031,1021,4,10,"VOX",3
46,"46246",1066,856,838,7,18,"VOX",11
46,"46166",8155,6521,6450,41,71,"VOX",5
46,"46054",11251,8795,8731,46,64,"VOX",22
46,"46201",67,49,49,0,0,"VOX",0
46,"46178",4643,3465,3434,16,31,"VOX",24
46,"46091",115,101,100,1,1,"VOX",0
46,"46067",1736,1457,1382,2,75,"VOX",2
46,"46189",471,412,405,2,7,"VOX",0
46,"46147",16843,12206,12099,56,107,"VOX",26
46,"46129",521,435,434,2,1,"VOX",0
46,"46099",922,693,685,0,8,"VOX",2
46,"46902",379,314,313,3,1,"VOX",1
46,"46119",783,672,666,7,6,"VOX",0
46,"46170",3451,2821,2775,16,46,"VOX",5
46,"46215",1433,1152,1149,4,3,"VOX",1
46,"46065",1588,1246,1227,5,19,"VOX",0
46,"46109",6195,4764,4682,23,82,"VOX",9
46,"46019",8833,7183,7109,47,74,"VOX",8
46,"46160",1912,1523,1514,3,9,"VOX",4
46,"46146",1670,1333,1318,11,15,"VOX",16
46,"46224",170,130,130,0,0,"VOX",0
46,"46135",9655,7845,7810,32,35,"VOX",21
46,"46263",255,204,202,1,2,"VOX",1
46,"46150",1839,1377,1362,10,15,"VOX",0
46,"46053",560,454,451,2,3,"VOX",1
46,"46255",3145,2494,2470,19,24,"VOX",7
46,"46123",1838,1466,1447,4,19,"VOX",1
46,"46056",184,160,158,1,2,"VOX",0
46,"46217",886,724,712,3,12,"VOX",0
46,"46004",1924,1582,1559,11,23,"VOX",3
46,"46045",1261,1066,1041,3,25,"VOX",7
46,"46007",11953,9099,9038,65,61,"VOX",13
46,"46153",441,358,354,0,4,"VOX",0
46,"46229",972,785,774,2,11,"VOX",3
46,"46039",2147,1746,1727,9,19,"VOX",1
46,"46258",2676,2099,2078,9,21,"VOX",0
46,"46034",1776,1441,1430,4,11,"VOX",1
46,"46131",49604,37767,37431,266,336,"VOX",120
46,"46136",2534,2008,1990,13,18,"VOX",9
46,"46032",5635,4529,4493,16,36,"VOX",12
46,"46028",395,346,339,2,7,"VOX",0
46,"46016",1068,885,874,3,11,"VOX",0
46,"46023",328,294,287,2,7,"VOX",1
46,"46071",466,383,379,2,4,"VOX",0
46,"46173",1336,1097,1080,9,17,"VOX",1
46,"46251",2490,2082,2045,11,37,"VOX",4
46,"46006",4529,3803,3748,18,55,"VOX",3
46,"46017",33050,24762,24580,144,182,"VOX",66
46,"46216",5039,4207,4188,20,19,"VOX",17
46,"46011",7627,5496,5407,39,89,"VOX",5
46,"46142",797,619,608,2,11,"VOX",1
46,"46205",14323,11325,11224,55,101,"VOX",17
46,"46080",1025,795,784,4,11,"VOX",0
46,"46159",22905,17498,17373,102,125,"VOX",24
46,"46115",403,296,289,1,7,"VOX",0
46,"46179",2182,1823,1788,13,35,"VOX",1
46,"46077",7569,6100,6010,41,90,"VOX",7
46,"46239",451,353,351,3,2,"VOX",0
46,"46044",4237,3347,3285,25,62,"VOX",8
46,"46103",1270,1015,998,8,17,"VOX",1
46,"46069",161,126,122,0,4,"VOX",0
46,"46001",802,623,615,4,8,"VOX",3
46,"46026",1204,1044,1034,4,10,"VOX",6
46,"46070",16903,13091,12999,64,92,"VOX",33
46,"46175",459,403,396,1,7,"VOX",1
46,"46243",141,122,120,0,2,"VOX",0
46,"46038",345,255,255,0,0,"VOX",0
46,"46161",1481,1206,1194,6,12,"VOX",3
46,"46062",4652,3650,3583,32,67,"VOX",2
46,"46079",326,267,265,2,2,"VOX",0
46,"46022",15481,11422,11347,69,75,"VOX",19
46,"46125",857,709,701,5,8,"VOX",1
46,"46244",58586,43371,43098,257,273,"VOX",167
46,"46088",176,140,138,0,2,"VOX",0
46,"46237",7227,5620,5571,33,49,"VOX",7
46,"46188",668,548,538,3,10,"VOX",0
46,"46096",279,229,225,2,4,"VOX",0
46,"46018",635,531,522,3,9,"VOX",2
46,"46064",527,429,423,0,6,"VOX",0
46,"46183",6009,4624,4563,18,61,"VOX",31
46,"46167",373,286,285,1,1,"VOX",0
46,"46220",48393,35859,35571,250,288,"VOX",45
46,"46218",1074,930,912,1,18,"VOX",0
46,"46163",1847,1508,1489,8,19,"VOX",4
46,"46089",2141,1649,1625,14,24,"VOX",3
46,"46110",21260,16194,16084,76,110,"VOX",33
46,"46137",268,225,220,3,5,"VOX",0
46,"46083",15467,11584,11443,79,141,"VOX",20
46,"46193",8795,7101,7061,40,40,"VOX",7
46,"46130",907,722,713,6,9,"VOX",1
46,"46086",82,73,73,1,0,"VOX",0
46,"46194",15552,11606,11505,69,101,"VOX",25
46,"46212",1612,1234,1214,5,20,"VOX",0
46,"46257",5579,4440,4391,26,49,"VOX",5
46,"46084",1576,1314,1298,6,16,"VOX",5
46,"46031",10520,7830,7759,70,71,"VOX",10
46,"46227",915,771,765,5,6,"VOX",3
46,"46029",20649,15241,15110,113,131,"VOX",44
46,"46107",1915,1566,1553,2,13,"VOX",0
46,"46206",577,475,468,4,7,"VOX",8
46,"46049",280,242,238,1,4,"VOX",1
46,"46010",914,725,716,4,9,"VOX",2
46,"46903",5985,4822,4796,24,26,"VOX",15
46,"46185",386,325,321,4,4,"VOX",0
46,"46048",3448,2817,2790,8,27,"VOX",3
46,"46140",349,288,284,2,4,"VOX",0
46,"46247",1024,743,733,2,10,"VOX",1
46,"46072",3625,2993,2931,37,62,"VOX",7
46,"46025",2502,2008,1993,6,15,"VOX",5
46,"46249",9362,7163,7072,42,91,"VOX",15
46,"46222",383,322,321,2,1,"VOX",0
46,"46108",480,375,375,2,0,"VOX",0
46,"46030",804,660,635,7,25,"VOX",0
46,"46256",6833,5087,5062,37,25,"VOX",10
46,"46260",2572,2100,2081,10,19,"VOX",0
46,"46262",232,172,168,0,4,"VOX",0
46,"46002",1175,947,935,5,12,"VOX",4
46,"46228",2363,1854,1839,16,15,"VOX",7
46,"46202",16767,13171,13058,59,113,"VOX",22
46,"46127",2706,2212,2175,10,37,"VOX",0
46,"46041",331,254,253,6,1,"VOX",0
46,"46063",1757,1399,1384,11,15,"VOX",0
46,"46158",1024,817,804,5,13,"VOX",2
46,"46231",2411,1759,1735,11,24,"VOX",1
46,"46250",578668,455375,452638,2701,2737,"VOX",1976
46,"46139",4495,3629,3577,26,52,"VOX",4
46,"46118",3795,2987,2962,18,25,"VOX",3
46,"46066",1255,1028,1020,6,8,"VOX",1
46,"46223",7814,6169,6129,33,40,"VOX",9
46,"46169",32396,25109,24953,169,156,"VOX",46
46,"46021",23646,18220,18100,85,120,"VOX",41
46,"46076",587,489,483,2,6,"VOX",3
46,"46190",48824,36748,36542,238,206,"VOX",95
46,"46155",1035,865,846,2,19,"VOX",0
46,"46013",17366,13952,13862,95,90,"VOX",59
46,"46046",896,697,686,1,11,"VOX",1
46,"46242",340,291,285,1,6,"VOX",2
46,"46074",2690,2158,2145,18,13,"VOX",4
46,"46152",97,76,74,0,2,"VOX",0
46,"46904",802,662,654,7,8,"VOX",0
46,"46199",5742,4458,4425,34,33,"VOX",10
46,"46061",337,281,281,3,0,"VOX",0
46,"46162",1207,962,947,3,15,"VOX",15
46,"46177",4698,3715,3665,16,50,"VOX",2
46,"46014",3042,2456,2434,17,22,"VOX",10
46,"46219",125,106,105,2,1,"VOX",0
46,"46253",109,93,93,0,0,"VOX",0
46,"46120",1109,919,902,4,17,"VOX",2
46,"46211",1723,1441,1434,13,7,"VOX",2
46,"46075",149,132,130,2,2,"VOX",0
46,"46027",948,795,781,3,14,"VOX",3
46,"46221",339,305,303,0,2,"VOX",0
46,"46093",2117,1721,1710,10,11,"VOX",2
46,"46087",127,99,99,1,0,"VOX",0
46,"46149",362,288,287,2,1,"VOX",1
46,"46144",665,525,520,2,5,"VOX",0
46,"46124",788,680,672,0,8,"VOX",1
46,"46209",1955,1531,1508,7,23,"VOX",1
46,"46143",4215,3219,3171,27,48,"VOX",2
46,"46225",346,299,290,0,9,"VOX",1
46,"46180",682,581,572,1,9,"VOX",1
46,"46008",2673,2201,2189,8,12,"VOX",1
46,"46234",354,289,287,2,2,"VOX",1
46,"46195",1967,1612,1602,9,10,"VOX",4
46,"46198",846,702,693,1,9,"VOX",0
46,"46092",273,183,183,0,0,"VOX",0
46,"46040",1098,914,907,4,7,"VOX",0
46,"46102",19843,15783,15676,102,107,"VOX",25
46,"46207",6656,5355,5293,42,62,"VOX",11
46,"46042",3389,2886,2844,19,42,"VOX",1
46,"46058",1779,1430,1409,10,21,"VOX",0
46,"46151",722,589,583,1,6,"VOX",1
46,"46132",2148,1850,1830,12,20,"VOX",2
46,"46261",1720,1386,1369,10,17,"VOX",2
46,"46113",2436,1864,1849,11,15,"VOX",3
46,"46197",1956,1556,1543,8,13,"VOX",1
46,"46232",894,715,712,5,3,"VOX",0
46,"46134",2357,1811,1797,8,14,"VOX",6
46,"46005",22908,17565,17438,126,127,"VOX",33
46,"46145",21946,16629,16495,80,134,"VOX",28
46,"46156",2087,1712,1702,9,10,"VOX",1
46,"46187",1310,1036,1028,6,8,"VOX",2
46,"46012",888,723,703,3,20,"VOX",3
46,"46090",1640,1440,1424,4,16,"VOX",0
46,"46191",1970,1557,1533,6,24,"VOX",2
46,"46068",354,305,297,1,8,"VOX",1
46,"46015",7231,5768,5711,33,57,"VOX",19
46,"46059",1272,1066,1058,4,8,"VOX",1
46,"46200",1909,1628,1609,5,19,"VOX",2
46,"46051",8347,6500,6442,27,58,"VOX",20
46,"46104",1956,1567,1543,6,24,"VOX",1
46,"46050",200,160,160,0,0,"VOX",0
46,"46036",583,384,381,8,3,"VOX",4
46,"46210",338,295,283,2,12,"VOX",0
46,"46073",1097,903,892,6,11,"VOX",2
46,"46214",15730,12427,12334,56,93,"VOX",14
46,"46003",963,841,815,1,26,"VOX",0
46,"46240",209,169,164,1,5,"VOX",0
46,"46122",2701,2120,2109,18,11,"VOX",4
46,"46128",1601,1316,1281,5,35,"VOX",0
46,"46112",552,466,464,1,2,"VOX",3
46,"46203",3598,2962,2928,17,34,"VOX",4
46,"46033",197,169,168,1,1,"VOX",0
46,"46226",48,44,44,0,0,"VOX",0
46,"46248",4873,3679,3639,18,40,"VOX",2
46,"46111",10876,8133,8050,35,83,"VOX",26
46,"46126",5555,4619,4574,26,45,"VOX",6
46,"46138",345,292,292,0,0,"VOX",1
46,"46133",563,458,455,2,3,"VOX",0
46,"46186",19033,15061,14950,70,111,"VOX",23
46,"46181",17066,12779,12636,96,143,"VOX",30
46,"46035",6786,5382,5338,27,44,"VOX",11
46,"46078",28126,20975,20850,127,125,"VOX",40
46,"46117",493,414,411,4,3,"VOX",0
46,"46141",438,359,348,4,11,"VOX",0
46,"46233",3904,2974,2934,15,40,"VOX",5
46,"46082",4947,3843,3814,25,29,"VOX",3
46,"46101",858,731,723,4,8,"VOX",3
46,"46020",3784,3064,3012,15,52,"VOX",5
46,"46148",1528,1206,1192,15,14,"VOX",5
46,"46171",16587,12731,12627,79,104,"VOX",29
46,"46052",502,432,431,2,1,"VOX",1
46,"46168",1938,1542,1530,11,12,"VOX",1
46,"46192",767,573,568,1,5,"VOX",0
46,"46097",959,734,728,6,6,"VOX",5
46,"46157",2978,2370,2343,19,27,"VOX",6
46,"46241",400,324,314,1,10,"VOX",1
46,"46236",975,810,806,4,4,"VOX",1
46,"46043",145,131,131,0,0,"VOX",0
46,"46182",1274,970,966,2,4,"VOX",0
46,"46009",3144,2579,2552,13,27,"VOX",8
46,"46176",2025,1431,1416,10,15,"VOX",1
46,"46196",153,131,130,0,1,"VOX",0
46,"46095",608,498,493,2,5,"VOX",0
46,"46037",1119,952,941,2,11,"VOX",0
46,"46245",516,427,420,3,7,"VOX",2
46,"46106",1543,1177,1167,5,10,"VOX",1
46,"46154",811,644,640,4,4,"VOX",0
46,"46085",11147,8107,8033,57,74,"VOX",12
46,"46238",13324,10023,9939,50,84,"VOX",12
46,"46252",126,95,93,0,2,"VOX",1
46,"46047",525,443,435,2,8,"VOX",0
46,"46164",11777,8893,8798,54,95,"VOX",12
46,"46105",16249,11731,11629,59,102,"VOX",34
46,"46116",13153,10566,10518,62,48,"VOX",26
46,"46165",7115,5626,5576,31,50,"VOX",11
46,"46259",503,410,406,2,4,"VOX",0
46,"46057",495,339,337,6,2,"VOX",0
46,"46100",289,240,237,1,3,"VOX",0
46,"46174",984,808,794,3,14,"VOX",1
46,"46172",5040,3629,3599,14,30,"VOX",10
23,"23001",993,826,820,1,6,"PCPE",1
23,"23061",7520,5481,5405,55,76,"PCPE",4
23,"23032",575,461,457,1,4,"PCPE",1
23,"23042",299,220,220,1,0,"PCPE",0
23,"23074",3030,2368,2353,12,15,"PCPE",1
23,"23086",11537,8362,8242,91,120,"PCPE",14
23,"23905",1861,1351,1345,7,6,"PCPE",3
23,"23029",854,631,623,2,8,"PCPE",0
23,"23052",1138,977,971,6,6,"PCPE",0
23,"23040",1489,1226,1211,4,15,"PCPE",2
23,"23101",388,281,279,0,2,"PCPE",0
23,"23072",2002,1593,1582,6,11,"PCPE",0
23,"23011",2193,1616,1600,11,16,"PCPE",7
23,"23002",17450,13199,12986,92,213,"PCPE",12
23,"23094",3852,3097,3061,17,36,"PCPE",5
23,"23065",1601,1222,1207,0,15,"PCPE",1
23,"23079",3733,2994,2981,26,13,"PCPE",4
23,"23033",1356,1080,1065,8,15,"PCPE",0
23,"23046",2405,1963,1934,3,29,"PCPE",2
23,"23087",11313,8540,8454,64,86,"PCPE",23
23,"23075",3319,2640,2618,21,22,"PCPE",6
23,"23043",549,401,400,0,1,"PCPE",0
23,"23064",1659,1368,1364,1,4,"PCPE",1
23,"23904",2852,1784,1764,14,20,"PCPE",3
23,"23073",4558,3427,3402,11,25,"PCPE",5
23,"23012",4177,3016,2988,22,28,"PCPE",3
23,"23095",8737,6303,6268,34,35,"PCPE",5
23,"23003",8709,6520,6440,42,80,"PCPE",10
23,"23006",4636,3761,3714,25,47,"PCPE",6
23,"23098",875,728,722,2,6,"PCPE",0
23,"23034",2558,1987,1977,18,10,"PCPE",5
23,"23085",2273,1833,1814,3,19,"PCPE",2
23,"23025",2813,2186,2163,7,23,"PCPE",1
23,"23092",27765,20688,20560,143,128,"PCPE",12
23,"23026",3636,2724,2685,11,39,"PCPE",2
23,"23004",435,350,346,0,4,"PCPE",0
23,"23041",504,396,392,1,4,"PCPE",1
23,"23066",4376,3530,3508,46,22,"PCPE",3
23,"23096",2643,2174,2140,14,34,"PCPE",3
23,"23035",1095,871,867,8,4,"PCPE",1
23,"23014",2561,1982,1959,8,23,"PCPE",11
23,"23057",771,648,648,4,0,"PCPE",2
23,"23045",2139,1560,1551,9,9,"PCPE",2
23,"23059",5856,4498,4450,33,48,"PCPE",2
23,"23054",382,276,275,0,1,"PCPE",0
23,"23055",47421,33170,32908,213,262,"PCPE",51
23,"23901",1160,978,972,5,6,"PCPE",0
23,"23090",1316,1077,1071,8,6,"PCPE",2
23,"23005",30539,21840,21629,176,211,"PCPE",23
23,"23084",953,711,708,6,3,"PCPE",0
23,"23056",3108,2365,2343,14,22,"PCPE",7
23,"23049",1834,1384,1378,7,6,"PCPE",3
23,"23058",8665,6651,6585,47,66,"PCPE",5
23,"23015",1393,1061,1052,3,9,"PCPE",2
23,"23097",6445,4313,4290,30,23,"PCPE",2
23,"23088",6124,4764,4703,31,61,"PCPE",0
23,"23050",91221,67753,67164,549,589,"PCPE",65
23,"23037",516,427,423,1,4,"PCPE",1
23,"23076",837,672,658,4,14,"PCPE",0
23,"23047",1638,1311,1306,9,5,"PCPE",0
23,"23024",12512,9391,9182,79,209,"PCPE",11
23,"23030",1232,1020,1007,10,13,"PCPE",0
23,"23009",12866,9787,9667,64,120,"PCPE",9
23,"23093",3257,2534,2506,21,28,"PCPE",3
23,"23019",1562,1249,1227,4,22,"PCPE",1
23,"23070",3931,2549,2533,11,16,"PCPE",1
23,"23016",396,323,318,3,5,"PCPE",0
23,"23007",3102,2381,2369,8,12,"PCPE",9
23,"23099",4734,3509,3459,23,50,"PCPE",1
23,"23902",2327,1877,1857,9,20,"PCPE",3
23,"23071",1728,1337,1328,7,9,"PCPE",2
23,"23039",2220,1658,1626,8,32,"PCPE",0
23,"23008",1518,1185,1173,18,12,"PCPE",1
23,"23051",2762,2258,2231,9,27,"PCPE",3
23,"23067",2489,1869,1847,18,22,"PCPE",4
23,"23031",751,662,650,9,12,"PCPE",1
23,"23091",742,609,607,5,2,"PCPE",0
23,"23048",860,636,630,1,6,"PCPE",0
23,"23069",5385,4406,4318,15,88,"PCPE",4
23,"23062",1461,1188,1181,1,7,"PCPE",2
23,"23063",3845,2934,2898,24,36,"PCPE",6
23,"23021",528,452,448,0,4,"PCPE",1
23,"23053",9526,6783,6736,49,47,"PCPE",30
23,"23044",4847,3801,3740,26,61,"PCPE",10
23,"23027",727,577,576,8,1,"PCPE",0
23,"23038",3557,2851,2831,11,20,"PCPE",1
23,"23081",1546,1145,1132,6,13,"PCPE",0
23,"23010",14371,10249,10140,65,109,"PCPE",10
23,"23017",1584,1265,1253,4,12,"PCPE",1
23,"23077",637,515,514,3,1,"PCPE",1
23,"23018",2326,1678,1668,5,10,"PCPE",2
23,"23082",1924,1420,1413,6,7,"PCPE",0
23,"23060",19157,13567,13438,133,129,"PCPE",15
23,"23028",6203,4645,4585,33,60,"PCPE",4
23,"23903",3550,2742,2721,19,21,"PCPE",0
23,"23080",1786,1347,1329,6,18,"PCPE",1
23,"23020",1584,1376,1366,5,10,"PCPE",3
1,"1043",2318,1644,1624,8,20,"OE",0
1,"1061",153,132,132,2,0,"OE",1
1,"1039",202,161,156,0,5,"OE",0
1,"1034",165,120,119,1,1,"OE",0
1,"1032",522,368,361,0,7,"OE",0
1,"1019",144,112,111,2,1,"OE",0
1,"1062",314,215,215,3,0,"OE",0
1,"1052",244,188,186,1,2,"OE",0
1,"1033",649,512,508,5,4,"OE",0
1,"1018",1370,964,963,4,1,"OE",0
1,"1058",1327,843,833,8,10,"OE",0
1,"1060",199,162,159,0,3,"OE",0
1,"1009",1281,908,898,2,10,"OE",0
1,"1002",8139,5961,5878,32,83,"OE",2
1,"1046",594,445,435,3,10,"OE",0
1,"1027",416,268,268,0,0,"OE",1
1,"1053",587,367,365,3,2,"OE",0
1,"1020",326,232,228,0,4,"OE",0
1,"1901",2344,1688,1669,17,19,"OE",1
1,"1030",159,126,123,1,3,"OE",0
1,"1054",952,694,688,4,6,"OE",0
1,"1063",1799,1320,1309,10,11,"OE",3
1,"1049",140,108,108,0,0,"OE",0
1,"1013",711,486,483,3,3,"OE",1
1,"1044",236,189,187,1,2,"OE",0
1,"1028",1077,759,753,6,6,"OE",0
1,"1902",738,537,528,4,9,"OE",0
1,"1021",460,336,332,1,4,"OE",2
1,"1001",1984,1426,1405,8,21,"OE",3
1,"1004",1405,1026,1010,7,16,"OE",1
1,"1047",964,713,702,13,11,"OE",0
1,"1023",269,197,195,2,2,"OE",0
1,"1057",245,203,202,0,1,"OE",0
1,"1022",805,593,587,3,6,"OE",0
1,"1056",218,141,140,1,1,"OE",0
1,"1031",1183,907,885,6,22,"OE",1
1,"1037",586,425,419,2,6,"OE",1
1,"1059",186354,135873,134633,948,1240,"OE",80
1,"1041",153,105,100,1,5,"OE",1
1,"1014",372,292,284,1,8,"OE",0
1,"1016",439,255,249,3,6,"OE",0
1,"1006",176,142,141,1,1,"OE",0
1,"1036",15034,10733,10619,73,114,"OE",6
1,"1011",237,177,175,7,2,"OE",0
1,"1003",1186,842,833,19,9,"OE",1
1,"1051",3606,2413,2389,21,24,"OE",2
1,"1055",836,564,552,8,12,"OE",0
1,"1017",869,584,577,4,7,"OE",0
1,"1008",790,548,542,13,6,"OE",2
1,"1042",901,653,650,11,3,"OE",0
1,"1010",2275,1729,1717,17,12,"OE",1
38,"38031",28697,21546,21202,140,344,"RECORTES CE",42
38,"38045",3987,2152,2132,23,20,"RECORTES CE",4
38,"38038",162030,105122,104174,667,948,"RECORTES CE",337
38,"38032",13257,8969,8902,72,67,"RECORTES CE",42
38,"38051",7217,5147,5089,31,58,"RECORTES CE",7
38,"38028",22063,15095,14954,89,141,"RECORTES CE",26
38,"38047",1789,1228,1208,5,20,"RECORTES CE",1
38,"38004",4442,2980,2939,20,41,"RECORTES CE",4
38,"38042",3784,2692,2673,16,19,"RECORTES CE",0
38,"38049",2653,1683,1658,8,25,"RECORTES CE",3
38,"38046",9107,6755,6682,45,73,"RECORTES CE",9
38,"38052",1281,853,844,2,9,"RECORTES CE",1
38,"38003",1440,970,960,2,10,"RECORTES CE",2
38,"38001",20166,11307,11195,55,112,"RECORTES CE",31
38,"38034",4041,2853,2814,17,39,"RECORTES CE",5
38,"38044",2206,1317,1303,10,14,"RECORTES CE",2
38,"38020",15021,9813,9693,51,120,"RECORTES CE",28
38,"38014",1351,935,929,3,6,"RECORTES CE",0
38,"38019",13217,8168,8075,54,93,"RECORTES CE",14
38,"38011",20435,13760,13627,82,133,"RECORTES CE",38
38,"38010",4014,2726,2678,15,48,"RECORTES CE",3
38,"38901",1387,883,876,4,7,"RECORTES CE",1
38,"38043",18918,12883,12737,109,146,"RECORTES CE",30
38,"38013",2915,1865,1847,12,18,"RECORTES CE",2
38,"38006",39553,21159,20940,124,219,"RECORTES CE",47
38,"38035",9299,5558,5500,35,58,"RECORTES CE",14
38,"38018",4405,3053,3005,21,48,"RECORTES CE",10
38,"38012",2378,1620,1606,6,14,"RECORTES CE",3
38,"38053",3754,2419,2370,15,49,"RECORTES CE",5
38,"38022",18468,12230,12085,86,145,"RECORTES CE",17
38,"38026",32918,24984,24727,174,257,"RECORTES CE",19
38,"38002",942,701,674,14,27,"RECORTES CE",0
38,"38040",4990,3061,3031,16,30,"RECORTES CE",3
38,"38037",12997,8126,7997,46,129,"RECORTES CE",20
38,"38021",1643,1014,1002,5,12,"RECORTES CE",2
38,"38016",1215,654,641,4,13,"RECORTES CE",3
38,"38009",4127,2842,2793,15,49,"RECORTES CE",6
38,"38027",5386,3685,3615,29,70,"RECORTES CE",4
38,"38036",6553,4604,4529,45,75,"RECORTES CE",17
38,"38041",6808,4869,4835,42,34,"RECORTES CE",8
38,"38024",15055,9612,9485,77,127,"RECORTES CE",17
38,"38030",1923,1309,1300,5,9,"RECORTES CE",2
38,"38005",5463,3443,3417,24,26,"RECORTES CE",7
38,"38017",28037,16236,16076,100,160,"RECORTES CE",28
38,"38050",2471,1616,1590,8,26,"RECORTES CE",3
38,"38007",1689,1143,1119,3,24,"RECORTES CE",1
38,"38025",6860,4836,4761,49,75,"RECORTES CE",13
38,"38015",4158,2864,2818,12,46,"RECORTES CE",4
38,"38039",10584,7532,7462,77,70,"RECORTES CE",14
38,"38008",5513,3683,3609,17,74,"RECORTES CE",10
38,"38029",1533,776,763,7,13,"RECORTES CE",1
38,"38048",3878,2664,2624,20,40,"RECORTES CE",6
38,"38023",121610,81337,80453,527,884,"RECORTES CE",254
38,"38033",3721,2552,2504,15,48,"RECORTES CE",5
15,"15086",2918,2109,2077,19,32,"PT",3
15,"15091",1119,807,784,12,23,"PT",0
15,"15003",1818,1326,1302,18,24,"PT",0
15,"15041",9627,7409,7291,79,118,"PT",8
15,"15078",78093,58164,57487,673,677,"PT",95
15,"15015",2840,2126,2100,21,26,"PT",1
15,"15022",5817,4026,3981,29,45,"PT",7
15,"15033",2489,1953,1931,13,22,"PT",4
15,"15064",2207,1680,1650,22,30,"PT",1
15,"15013",6126,4315,4257,43,58,"PT",6
15,"15079",1562,1092,1075,16,17,"PT",0
15,"15081",1042,819,814,12,5,"PT",1
15,"15043",5147,3834,3764,36,70,"PT",10
15,"15009",10780,8075,7957,70,118,"PT",13
15,"15076",2649,1827,1802,24,25,"PT",1
15,"15017",19380,14272,14098,156,174,"PT",23
15,"15066",4039,2950,2894,34,56,"PT",10
15,"15048",4855,3582,3534,41,48,"PT",5
15,"15029",5761,3994,3928,47,66,"PT",17
15,"15062",5936,4047,3993,31,54,"PT",9
15,"15050",1843,1089,1070,19,19,"PT",2
15,"15024",4412,3325,3278,35,47,"PT",6
15,"15025",1069,662,654,5,8,"PT",1
15,"15082",15162,11273,11134,135,139,"PT",11
15,"15075",12279,9076,8952,117,124,"PT",9
15,"15023",6481,4658,4595,44,63,"PT",8
15,"15008",5650,4239,4175,42,64,"PT",3
15,"15080",1760,1215,1197,11,18,"PT",0
15,"15036",58409,40932,40506,484,426,"PT",45
15,"15034",2897,1931,1909,14,22,"PT",4
15,"15028",1415,1085,1070,10,15,"PT",1
15,"15058",27623,21002,20788,257,214,"PT",34
15,"15090",1182,868,861,13,7,"PT",0
15,"15007",3352,2469,2453,24,16,"PT",0
15,"15053",7783,5386,5314,47,72,"PT",10
15,"15005",24459,16742,16482,215,260,"PT",47
15,"15018",1156,817,806,7,11,"PT",1
15,"15001",4805,3466,3419,45,47,"PT",7
15,"15061",5646,3945,3894,35,51,"PT",5
15,"15016",4806,3291,3222,21,69,"PT",2
15,"15035",11517,8305,8192,144,113,"PT",14
15,"15071",7965,5559,5483,37,76,"PT",10
15,"15901",3595,2401,2374,30,27,"PT",6
15,"15052",4351,3122,3063,26,59,"PT",1
15,"15051",4651,3343,3297,38,46,"PT",2
15,"15027",1540,1224,1203,6,21,"PT",3
15,"15084",3312,2361,2326,28,35,"PT",2
15,"15012",3666,2787,2721,40,66,"PT",5
15,"15092",6523,4518,4449,54,69,"PT",2
15,"15044",1309,955,941,5,14,"PT",1
15,"15089",4317,3238,3188,24,50,"PT",8
15,"15002",22929,16941,16742,205,199,"PT",35
15,"15030",200245,148692,147426,1699,1266,"PT",199
15,"15055",4618,3208,3159,49,49,"PT",7
15,"15006",5353,3534,3469,49,65,"PT",6
15,"15902",4660,3352,3296,30,56,"PT",1
15,"15069",6785,5107,5032,54,75,"PT",10
15,"15077",8303,5648,5544,57,104,"PT",7
15,"15083",1100,809,795,5,14,"PT",1
15,"15019",25902,18111,17866,232,245,"PT",27
15,"15010",1913,1355,1338,21,17,"PT",3
15,"15073",21884,14792,14587,149,205,"PT",27
15,"15011",15463,11105,10890,92,215,"PT",27
15,"15056",5757,4167,4108,43,59,"PT",7
15,"15085",3346,2365,2311,26,54,"PT",0
15,"15093",4265,2856,2814,35,42,"PT",3
15,"15054",32177,22065,21778,349,287,"PT",50
15,"15067",8073,6067,6000,45,67,"PT",1
15,"15074",4061,2983,2947,24,36,"PT",7
15,"15087",5804,3942,3901,49,41,"PT",3
15,"15070",9117,6514,6390,98,124,"PT",13
15,"15047",2463,1669,1633,21,36,"PT",6
15,"15045",3803,2382,2354,15,28,"PT",6
15,"15068",5096,3518,3476,39,42,"PT",9
15,"15049",1099,765,755,12,10,"PT",3
15,"15059",10406,7710,7553,91,157,"PT",12
15,"15057",12169,8853,8729,88,124,"PT",19
15,"15046",6345,4625,4532,53,93,"PT",9
15,"15042",3060,2170,2127,21,43,"PT",20
15,"15004",4855,3594,3535,28,59,"PT",8
15,"15038",2236,1556,1530,18,26,"PT",0
15,"15037",4087,2775,2733,18,42,"PT",1
15,"15040",2763,2050,2017,10,33,"PT",6
15,"15039",1271,935,917,8,18,"PT",3
15,"15032",3455,2438,2391,26,47,"PT",10
15,"15088",3550,2398,2372,18,26,"PT",3
15,"15031",23321,17319,17152,218,167,"PT",36
15,"15072",9626,7024,6920,52,104,"PT",14
15,"15014",4034,2809,2757,34,52,"PT",6
15,"15060",5780,4245,4167,48,78,"PT",9
15,"15021",5099,3673,3611,43,62,"PT",6
15,"15065",7345,5517,5412,46,105,"PT",11
15,"15020",3844,2651,2629,17,22,"PT",1
25,"25101",565,393,388,9,5,"PCPC",0
25,"25197",137,97,97,2,0,"PCPC",1
25,"25124",169,118,116,2,2,"PCPC",0
25,"25102",712,473,467,10,6,"PCPC",1
25,"25205",562,413,402,2,11,"PCPC",2
25,"25179",161,115,114,0,1,"PCPC",0
25,"25038",1564,1075,1062,11,13,"PCPC",1
25,"25051",1522,990,983,10,7,"PCPC",1
25,"25238",217,151,151,6,0,"PCPC",1
25,"25166",177,123,121,1,2,"PCPC",0
25,"25047",1010,730,722,6,8,"PCPC",0
25,"25039",280,182,180,0,2,"PCPC",1
25,"25140",774,468,465,4,3,"PCPC",2
25,"25212",234,173,171,1,2,"PCPC",0
25,"25172",1805,1230,1214,8,16,"PCPC",2
25,"25218",84,66,66,0,0,"PCPC",0
25,"25155",667,463,459,5,4,"PCPC",0
25,"25022",106,76,76,2,0,"PCPC",0
25,"25153",198,141,137,0,4,"PCPC",1
25,"25243",3612,2449,2423,30,26,"PCPC",3
25,"25163",228,143,142,5,1,"PCPC",0
25,"25192",767,510,496,11,14,"PCPC",2
25,"25064",112,85,85,3,0,"PCPC",0
25,"25069",453,289,286,6,3,"PCPC",0
25,"25089",106,58,58,0,0,"PCPC",1
25,"25031",52,31,31,0,0,"PCPC",0
25,"25150",185,127,124,1,3,"PCPC",0
25,"25109",238,168,168,1,0,"PCPC",0
25,"25015",355,258,257,3,1,"PCPC",0
25,"25020",292,203,200,2,3,"PCPC",2
25,"25011",5256,3190,3161,36,29,"PCPC",6
25,"25185",681,421,418,8,3,"PCPC",0
25,"25071",51,31,31,0,0,"PCPC",0
25,"25097",87,62,62,4,0,"PCPC",0
25,"25041",569,380,374,7,6,"PCPC",1
25,"25202",101,72,72,0,0,"PCPC",0
25,"25174",398,299,296,3,3,"PCPC",1
25,"25171",2190,1461,1444,4,17,"PCPC",1
25,"25250",344,236,234,0,2,"PCPC",0
25,"25164",381,264,262,2,2,"PCPC",0
25,"25209",1517,1035,1019,6,16,"PCPC",2
25,"25121",642,415,413,8,2,"PCPC",0
25,"25130",197,117,117,3,0,"PCPC",0
25,"25168",508,392,391,2,1,"PCPC",1
25,"25112",272,189,189,2,0,"PCPC",0
25,"25104",125,86,86,3,0,"PCPC",0
25,"25909",155,89,89,3,0,"PCPC",0
25,"25204",1241,843,827,3,16,"PCPC",0
25,"25906",226,144,143,0,1,"PCPC",1
25,"25105",130,95,93,4,2,"PCPC",0
25,"25180",239,151,151,0,0,"PCPC",1
25,"25072",5858,3878,3835,45,43,"PCPC",5
25,"25225",575,395,393,6,2,"PCPC",2
25,"25017",239,160,159,2,1,"PCPC",0
25,"25055",172,118,116,2,2,"PCPC",0
25,"25053",1059,762,759,10,3,"PCPC",3
25,"25079",305,216,214,5,2,"PCPC",0
25,"25252",548,399,398,6,1,"PCPC",0
25,"25222",67,52,52,1,0,"PCPC",0
25,"25050",3253,2064,2048,27,16,"PCPC",0
25,"25001",139,88,87,1,1,"PCPC",0
25,"25200",336,218,218,0,0,"PCPC",1
25,"25024",356,233,230,1,3,"PCPC",0
25,"25036",184,126,121,0,5,"PCPC",0
25,"25046",421,292,286,1,6,"PCPC",2
25,"25099",1260,804,793,8,11,"PCPC",0
25,"25158",1639,1163,1150,26,13,"PCPC",1
25,"25201",115,70,67,0,3,"PCPC",1
25,"25143",87,58,57,1,1,"PCPC",0
25,"25175",194,132,132,7,0,"PCPC",0
25,"25183",501,332,331,4,1,"PCPC",1
25,"25056",243,151,150,2,1,"PCPC",0
25,"25216",226,150,150,0,0,"PCPC",0
25,"25074",182,145,141,0,4,"PCPC",1
25,"25182",1043,738,727,13,11,"PCPC",1
25,"25242",732,480,477,4,3,"PCPC",0
25,"25007",1410,1005,996,13,9,"PCPC",5
25,"25119",2259,1582,1569,22,13,"PCPC",0
25,"25082",280,169,167,3,2,"PCPC",0
25,"25134",635,418,414,4,4,"PCPC",1
25,"25208",316,191,189,1,2,"PCPC",1
25,"25173",1702,1180,1171,5,9,"PCPC",4
25,"25057",206,152,151,2,1,"PCPC",1
25,"25181",177,138,137,5,1,"PCPC",1
25,"25032",61,44,43,0,1,"PCPC",0
25,"25177",372,258,258,2,0,"PCPC",2
25,"25190",263,195,195,4,0,"PCPC",0
25,"25176",312,239,235,7,4,"PCPC",1
25,"25045",52,36,36,0,0,"PCPC",0
25,"25145",85,64,64,2,0,"PCPC",0
25,"25206",257,164,164,3,0,"PCPC",1
25,"25203",8976,5588,5526,53,62,"PCPC",11
25,"25186",214,141,138,2,3,"PCPC",1
25,"25002",484,323,321,2,2,"PCPC",0
25,"25901",292,186,181,4,5,"PCPC",2
25,"25078",1007,720,717,6,3,"PCPC",0
25,"25251",710,495,494,3,1,"PCPC",0
25,"25189",2106,1392,1381,16,11,"PCPC",3
25,"25221",130,76,76,0,0,"PCPC",0
25,"25194",426,278,273,0,5,"PCPC",1
25,"25110",2796,1828,1807,30,21,"PCPC",5
25,"25049",151,104,104,1,0,"PCPC",0
25,"25006",346,214,212,6,2,"PCPC",0
25,"25115",824,551,549,12,2,"PCPC",1
25,"25016",2114,1417,1411,8,6,"PCPC",1
25,"25912",868,618,617,5,1,"PCPC",0
25,"25911",452,301,299,7,2,"PCPC",1
25,"25094",139,111,109,0,2,"PCPC",0
25,"25244",369,252,248,3,4,"PCPC",0
25,"25910",101,64,62,0,2,"PCPC",0
25,"25233",278,193,191,2,2,"PCPC",0
25,"25029",1662,1156,1147,13,9,"PCPC",1
25,"25122",1916,1274,1264,15,10,"PCPC",0
25,"25023",4527,3111,3073,20,38,"PCPC",3
25,"25253",163,125,124,0,1,"PCPC",0
25,"25126",286,214,210,5,4,"PCPC",0
25,"25151",670,466,459,3,7,"PCPC",1
25,"25902",570,390,379,3,11,"PCPC",0
25,"25111",115,83,83,1,0,"PCPC",0
25,"25035",397,287,286,3,1,"PCPC",1
25,"25220",1028,709,701,9,8,"PCPC",0
25,"25227",641,398,395,3,3,"PCPC",0
25,"25009",631,465,460,3,5,"PCPC",0
25,"25133",713,469,464,1,5,"PCPC",2
25,"25232",1421,961,950,10,11,"PCPC",2
25,"25019",4565,3001,2965,36,36,"PCPC",7
25,"25131",412,271,261,8,10,"PCPC",1
25,"25239",608,320,319,1,1,"PCPC",3
25,"25059",801,590,584,11,6,"PCPC",1
25,"25012",2296,1504,1488,8,16,"PCPC",3
25,"25005",277,183,182,2,1,"PCPC",0
25,"25076",146,84,84,1,0,"PCPC",0
25,"25062",757,521,516,4,5,"PCPC",0
25,"25085",152,106,106,0,0,"PCPC",0
25,"25092",132,93,89,1,4,"PCPC",1
25,"25231",490,382,382,2,0,"PCPC",0
25,"25042",208,143,142,0,1,"PCPC",0
25,"25161",368,234,232,3,2,"PCPC",0
25,"25137",8577,5630,5591,45,39,"PCPC",6
25,"25010",212,131,130,6,1,"PCPC",0
25,"25025",1346,966,956,10,10,"PCPC",2
25,"25043",794,505,501,3,4,"PCPC",0
25,"25156",791,574,571,7,3,"PCPC",1
25,"25191",332,225,222,3,3,"PCPC",0
25,"25040",10532,6837,6762,81,75,"PCPC",10
25,"25230",1573,1100,1081,13,19,"PCPC",0
25,"25077",460,272,269,2,3,"PCPC",0
25,"25149",1382,1010,993,7,17,"PCPC",1
25,"25219",144,106,105,3,1,"PCPC",0
25,"25170",264,182,179,1,3,"PCPC",1
25,"25217",10594,7016,6950,119,66,"PCPC",7
25,"25070",817,584,573,14,11,"PCPC",1
25,"25093",639,451,445,11,6,"PCPC",0
25,"25088",96,76,75,0,1,"PCPC",0
25,"25905",386,260,255,4,5,"PCPC",0
25,"25100",212,134,134,3,0,"PCPC",0
25,"25148",220,155,153,0,2,"PCPC",0
25,"25903",237,154,152,3,2,"PCPC",0
25,"25240",1407,1006,995,10,11,"PCPC",0
25,"25193",765,520,514,3,6,"PCPC",1
25,"25103",131,80,80,3,0,"PCPC",0
25,"25003",3782,2390,2372,24,18,"PCPC",2
25,"25215",334,244,243,2,1,"PCPC",1
25,"25141",156,101,99,1,2,"PCPC",0
25,"25224",126,86,86,1,0,"PCPC",0
25,"25118",350,223,223,8,0,"PCPC",0
25,"25210",1104,779,767,9,12,"PCPC",2
25,"25136",98,71,70,0,1,"PCPC",0
25,"25052",1573,1132,1122,16,10,"PCPC",2
25,"25165",280,194,190,4,4,"PCPC",0
25,"25207",6216,4062,4031,45,31,"PCPC",13
25,"25129",176,113,110,6,3,"PCPC",0
25,"25030",131,86,86,2,0,"PCPC",0
25,"25027",1001,687,681,3,6,"PCPC",1
25,"25063",91,55,55,0,0,"PCPC",0
25,"25033",1106,777,767,7,10,"PCPC",3
25,"25081",318,213,210,2,3,"PCPC",0
25,"25096",912,586,572,9,14,"PCPC",1
25,"25086",533,373,372,5,1,"PCPC",1
25,"25014",254,177,174,4,3,"PCPC",0
25,"25157",181,139,137,1,2,"PCPC",0
25,"25196",119,74,74,0,0,"PCPC",0
25,"25139",479,325,324,3,1,"PCPC",2
25,"25142",368,252,251,3,1,"PCPC",0
25,"25254",738,507,493,6,14,"PCPC",0
25,"25146",224,150,148,2,2,"PCPC",0
25,"25060",70,45,45,2,0,"PCPC",0
25,"25154",120,68,68,1,0,"PCPC",0
25,"25120",92243,61433,61005,533,428,"PCPC",101
25,"25255",426,308,302,4,6,"PCPC",0
25,"25913",87,69,69,1,0,"PCPC",0
25,"25907",498,317,314,3,3,"PCPC",1
25,"25034",2331,1516,1505,20,11,"PCPC",5
25,"25068",558,372,369,9,3,"PCPC",0
25,"25228",3043,2140,2118,21,22,"PCPC",3
25,"25098",253,163,160,2,3,"PCPC",0
25,"25123",193,131,130,0,1,"PCPC",1
25,"25247",123,72,72,0,0,"PCPC",0
25,"25067",730,483,479,4,4,"PCPC",0
25,"25135",1032,707,701,7,6,"PCPC",0
25,"25904",155,118,118,0,0,"PCPC",0
25,"25073",588,374,371,8,3,"PCPC",0
25,"25058",4378,2810,2793,27,17,"PCPC",4
25,"25211",683,427,422,4,5,"PCPC",1
25,"25223",922,614,598,8,16,"PCPC",1
25,"25087",61,46,45,0,1,"PCPC",0
25,"25113",1163,854,845,12,9,"PCPC",2
25,"25075",117,82,82,0,0,"PCPC",0
25,"25127",212,135,134,3,1,"PCPC",0
25,"25004",571,425,423,5,2,"PCPC",0
25,"25048",1644,1151,1138,8,13,"PCPC",2
25,"25249",183,118,118,2,0,"PCPC",0
25,"25152",140,100,98,4,2,"PCPC",0
25,"25008",1135,828,819,11,9,"PCPC",0
25,"25128",142,89,89,0,0,"PCPC",0
25,"25138",576,415,408,6,7,"PCPC",0
25,"25908",228,138,137,3,1,"PCPC",0
25,"25114",97,87,87,0,0,"PCPC",0
25,"25125",424,279,273,4,6,"PCPC",0
25,"25169",188,125,124,3,1,"PCPC",0
25,"25234",4290,2645,2621,25,24,"PCPC",1
25,"25248",891,622,616,3,6,"PCPC",0
25,"25037",385,245,241,2,4,"PCPC",0
25,"25021",2618,1655,1639,32,16,"PCPC",3
25,"25167",236,158,156,3,2,"PCPC",0
25,"25044",189,136,136,3,0,"PCPC",0
25,"25226",251,156,153,3,3,"PCPC",0
25,"25132",130,97,95,1,2,"PCPC",0
25,"25061",82,53,53,0,0,"PCPC",0
25,"25013",2171,1380,1366,10,14,"PCPC",5
25,"25245",441,313,313,0,0,"PCPC",1
42,"42045",312,218,214,1,4,"DN",0
42,"42194",176,127,126,2,1,"DN",1
42,"42023",66,53,53,0,0,"DN",1
42,"42008",57,38,38,0,0,"DN",0
42,"42018",152,116,114,0,2,"DN",0
42,"42116",47,33,33,0,0,"DN",0
42,"42110",63,46,46,0,0,"DN",0
42,"42158",110,78,78,1,0,"DN",0
42,"42022",214,171,171,2,0,"DN",0
42,"42134",2642,1961,1938,24,23,"DN",1
42,"42141",111,79,79,0,0,"DN",2
42,"42160",261,205,203,1,2,"DN",0
42,"42032",148,117,117,0,0,"DN",0
42,"42142",52,33,33,0,0,"DN",0
42,"42088",71,53,53,0,0,"DN",0
42,"42183",111,79,78,2,1,"DN",0
42,"42053",26,21,21,1,0,"DN",0
42,"42070",35,27,25,0,2,"DN",0
42,"42130",60,51,50,3,1,"DN",1
42,"42132",143,118,117,0,1,"DN",0
42,"42172",29,25,25,2,0,"DN",0
42,"42079",27,17,17,1,0,"DN",0
42,"42128",39,37,37,1,0,"DN",0
42,"42171",128,78,78,1,0,"DN",0
42,"42195",100,60,60,3,0,"DN",0
42,"42024",87,68,67,0,1,"DN",0
42,"42148",10,10,10,0,0,"DN",0
42,"42178",117,81,79,2,2,"DN",0
42,"42215",786,555,552,8,3,"DN",1
42,"42196",11,10,10,0,0,"DN",0
42,"42092",65,42,41,1,1,"DN",0
42,"42062",25,16,15,0,1,"DN",0
42,"42030",95,77,76,3,1,"DN",0
42,"42162",2363,1690,1672,21,18,"DN",2
42,"42042",47,38,38,2,0,"DN",0
42,"42001",279,219,215,2,4,"DN",0
42,"42166",60,40,40,0,0,"DN",0
42,"42135",75,53,53,1,0,"DN",0
42,"42004",2296,1767,1748,32,19,"DN",2
42,"42120",148,98,98,1,0,"DN",0
42,"42029",143,106,106,0,0,"DN",0
42,"42089",55,46,46,1,0,"DN",0
42,"42218",80,54,54,1,0,"DN",0
42,"42202",24,12,11,0,1,"DN",0
42,"42093",40,29,29,3,0,"DN",1
42,"42043",3796,2833,2792,26,41,"DN",2
42,"42145",137,121,121,3,0,"DN",0
42,"42208",21,14,14,2,0,"DN",0
42,"42113",512,390,386,3,4,"DN",0
42,"42198",22,17,17,0,0,"DN",0
42,"42175",23,18,18,0,0,"DN",0
42,"42213",29,18,18,1,0,"DN",0
42,"42193",16,11,11,0,0,"DN",0
42,"42103",583,467,459,5,8,"DN",0
42,"42044",53,49,47,3,2,"DN",0
42,"42019",516,367,363,4,4,"DN",0
42,"42061",292,221,219,2,2,"DN",0
42,"42038",36,27,27,2,0,"DN",0
42,"42087",45,38,37,0,1,"DN",1
42,"42152",82,59,59,1,0,"DN",1
42,"42176",29,23,23,0,0,"DN",0
42,"42083",25,23,21,0,2,"DN",0
42,"42200",84,60,60,2,0,"DN",0
42,"42050",31,18,18,0,0,"DN",0
42,"42033",50,43,43,0,0,"DN",0
42,"42054",20,14,14,0,0,"DN",0
42,"42058",112,97,92,1,5,"DN",0
42,"42084",26,21,21,0,0,"DN",0
42,"42041",35,25,25,0,0,"DN",0
42,"42097",21,14,14,0,0,"DN",1
42,"42119",164,97,97,2,0,"DN",0
42,"42131",50,32,32,0,0,"DN",0
42,"42115",63,46,46,0,0,"DN",0
42,"42069",1529,1078,1066,10,12,"DN",2
42,"42009",80,65,64,2,1,"DN",1
42,"42094",608,470,463,9,7,"DN",3
42,"42085",191,136,136,2,0,"DN",0
42,"42153",14,14,14,1,0,"DN",0
42,"42055",165,127,127,3,0,"DN",0
42,"42106",15,9,9,0,0,"DN",0
42,"42017",142,115,114,1,1,"DN",0
42,"42060",34,23,21,0,2,"DN",0
42,"42117",148,113,111,3,2,"DN",0
42,"42098",11,6,6,0,0,"DN",0
42,"42056",22,19,19,0,0,"DN",0
42,"42057",175,106,104,1,2,"DN",3
42,"42168",109,88,88,1,0,"DN",0
42,"42164",1614,1208,1190,9,18,"DN",1
42,"42156",30,21,21,0,0,"DN",0
42,"42034",31,22,22,0,0,"DN",0
42,"42191",187,135,132,2,3,"DN",0
42,"42086",38,29,29,1,0,"DN",0
42,"42124",64,44,44,0,0,"DN",0
42,"42011",17,10,10,0,0,"DN",0
42,"42078",1031,752,744,6,8,"DN",4
42,"42049",120,75,73,1,2,"DN",0
42,"42027",76,56,56,0,0,"DN",0
42,"42205",93,64,63,0,1,"DN",0
42,"42082",9,8,8,1,0,"DN",0
42,"42187",63,55,54,1,1,"DN",0
42,"42096",281,181,178,8,3,"DN",1
42,"42209",146,111,108,3,3,"DN",0
42,"42080",155,113,110,0,3,"DN",0
42,"42046",51,43,43,1,0,"DN",1
42,"42159",38,33,32,1,1,"DN",0
42,"42105",49,42,42,0,0,"DN",0
42,"42073",72,56,56,0,0,"DN",0
42,"42184",59,45,44,2,1,"DN",3
42,"42003",66,59,57,1,2,"DN",0
42,"42188",50,44,43,0,1,"DN",0
42,"42155",173,105,104,1,1,"DN",0
42,"42075",87,63,63,1,0,"DN",0
42,"42206",8,5,5,0,0,"DN",0
42,"42211",83,67,67,1,0,"DN",0
42,"42139",22,16,16,0,0,"DN",0
42,"42052",15,13,13,0,0,"DN",0
42,"42204",56,39,38,0,1,"DN",0
42,"42123",165,119,119,4,0,"DN",0
42,"42163",49,37,37,0,0,"DN",1
42,"42207",41,33,33,1,0,"DN",0
42,"42006",164,121,118,8,3,"DN",1
42,"42111",307,221,220,1,1,"DN",0
42,"42121",64,48,48,1,0,"DN",0
42,"42197",76,61,59,1,2,"DN",0
42,"42107",74,51,48,1,3,"DN",0
42,"42118",23,16,16,0,0,"DN",0
42,"42100",32,31,31,1,0,"DN",0
42,"42048",67,53,51,1,2,"DN",0
42,"42108",12,10,10,0,0,"DN",0
42,"42192",41,31,31,1,0,"DN",0
42,"42051",21,15,15,0,0,"DN",0
42,"42185",25,21,21,0,0,"DN",0
42,"42157",13,10,10,1,0,"DN",0
42,"42039",233,148,146,2,2,"DN",0
42,"42090",93,70,69,1,1,"DN",0
42,"42219",43,32,32,0,0,"DN",0
42,"42015",32,25,25,0,0,"DN",0
42,"42190",94,71,71,1,0,"DN",0
42,"42016",18,13,13,0,0,"DN",0
42,"42063",49,37,37,1,0,"DN",0
42,"42182",57,45,45,1,0,"DN",0
42,"42037",34,17,17,1,0,"DN",0
42,"42068",85,62,61,2,1,"DN",0
42,"42140",16,10,10,1,0,"DN",0
42,"42013",35,28,28,0,0,"DN",0
42,"42154",97,78,78,1,0,"DN",0
42,"42216",25,21,21,0,0,"DN",0
42,"42189",64,50,50,2,0,"DN",0
42,"42149",393,300,293,1,7,"DN",0
42,"42012",37,29,29,0,0,"DN",2
42,"42059",20,14,14,0,0,"DN",0
42,"42181",419,318,312,3,6,"DN",0
42,"42167",259,195,194,2,1,"DN",0
42,"42144",442,357,352,5,5,"DN",0
42,"42036",50,39,38,0,1,"DN",0
42,"42020",4288,3087,3044,42,43,"DN",1
42,"42007",117,86,86,2,0,"DN",0
42,"42065",22,20,19,0,1,"DN",0
42,"42026",24,20,20,0,0,"DN",0
42,"42064",85,74,74,0,0,"DN",0
42,"42010",18,14,14,0,0,"DN",0
42,"42021",85,53,53,1,0,"DN",0
42,"42081",143,111,106,2,5,"DN",0
42,"42127",40,27,27,1,0,"DN",0
42,"42028",70,49,49,0,0,"DN",0
42,"42201",23,23,22,0,1,"DN",0
42,"42095",1762,1319,1303,15,16,"DN",6
42,"42129",692,522,516,4,6,"DN",4
42,"42031",26,19,19,0,0,"DN",0
42,"42173",29201,21456,21181,272,275,"DN",46
42,"42217",31,25,25,0,0,"DN",0
42,"42151",35,31,29,2,2,"DN",0
42,"42174",180,149,148,1,1,"DN",0
42,"42165",408,289,282,7,7,"DN",0
42,"42071",169,111,109,2,2,"DN",0
42,"42177",71,55,54,1,1,"DN",1
42,"42212",69,54,54,3,0,"DN",0
42,"42025",1216,884,873,11,11,"DN",1
42,"42161",140,106,106,2,0,"DN",0
42,"42076",219,176,173,4,3,"DN",0
42,"42125",81,66,66,2,0,"DN",0
42,"42014",66,43,43,2,0,"DN",0
42,"42035",782,566,562,4,4,"DN",1
3,"3028",1006,833,823,1,10,"FDEE",0
3,"3008",167,132,131,0,1,"FDEE",0
3,"3045",216,182,179,1,3,"FDEE",0
3,"3080",1299,1065,1036,3,29,"FDEE",0
3,"3130",47,30,30,0,0,"FDEE",0
3,"3021",5627,4691,4613,23,78,"FDEE",0
3,"3120",2416,1814,1783,13,31,"FDEE",1
3,"3018",12212,9129,9040,64,89,"FDEE",1
3,"3049",12082,9341,9236,69,105,"FDEE",0
3,"3026",1224,970,949,6,21,"FDEE",0
3,"3055",5168,3949,3899,13,50,"FDEE",0
3,"3100",508,446,442,1,4,"FDEE",0
3,"3113",4254,3159,3120,17,39,"FDEE",0
3,"3024",3904,3109,3060,17,49,"FDEE",1
3,"3029",242,186,183,1,3,"FDEE",0
3,"3104",27134,21080,20902,156,178,"FDEE",1
3,"3101",4765,3708,3659,13,49,"FDEE",1
3,"3133",41763,26236,26039,134,197,"FDEE",7
3,"3011",7729,5651,5595,29,56,"FDEE",1
3,"3058",4947,4015,3978,21,37,"FDEE",1
3,"3109",2850,2301,2275,11,26,"FDEE",0
3,"3094",9033,6702,6657,32,45,"FDEE",0
3,"3009",46817,36581,36258,240,323,"FDEE",13
3,"3047",9161,6622,6534,35,88,"FDEE",2
3,"3110",289,239,239,1,0,"FDEE",0
3,"3099",42365,31612,31259,220,353,"FDEE",10
3,"3111",5411,4044,3967,14,77,"FDEE",0
3,"3105",5387,4089,4017,21,72,"FDEE",2
3,"3107",2459,1807,1791,5,16,"FDEE",0
3,"3125",346,263,262,0,1,"FDEE",0
3,"3086",153,134,134,1,0,"FDEE",0
3,"3061",1057,828,816,2,12,"FDEE",0
3,"3137",653,516,515,5,1,"FDEE",0
3,"3098",507,403,394,3,9,"FDEE",0
3,"3010",325,278,276,0,2,"FDEE",0
3,"3129",1187,991,984,8,7,"FDEE",0
3,"3103",278,240,237,1,3,"FDEE",0
3,"3135",214,176,174,0,2,"FDEE",0
3,"3037",352,296,293,3,3,"FDEE",0
3,"3050",18601,13710,13610,61,100,"FDEE",4
3,"3032",106,90,89,1,1,"FDEE",0
3,"3053",7196,5800,5736,37,64,"FDEE",8
3,"3079",18235,14578,14388,114,190,"FDEE",11
3,"3054",338,274,268,4,6,"FDEE",0
3,"3106",596,503,501,1,2,"FDEE",0
3,"3062",213,176,175,0,1,"FDEE",0
3,"3038",358,292,285,2,7,"FDEE",0
3,"3138",3154,2406,2378,10,28,"FDEE",1
3,"3088",5498,4078,4030,42,48,"FDEE",1
3,"3046",1594,1185,1178,9,7,"FDEE",0
3,"3004",585,455,454,1,1,"FDEE",0
3,"3097",990,817,811,8,6,"FDEE",1
3,"3034",1367,1095,1079,4,16,"FDEE",0
3,"3023",1410,1221,1201,8,20,"FDEE",0
3,"3134",148,132,132,2,0,"FDEE",0
3,"3123",7472,5748,5680,38,68,"FDEE",4
3,"3017",376,317,312,3,5,"FDEE",0
3,"3128",4097,2972,2942,12,30,"FDEE",3
3,"3114",1568,1216,1203,8,13,"FDEE",0
3,"3044",4512,3639,3586,16,53,"FDEE",0
3,"3119",16534,12466,12363,69,103,"FDEE",1
3,"3036",91,80,79,2,1,"FDEE",0
3,"3139",22357,15787,15624,101,163,"FDEE",4
3,"3020",102,79,79,0,0,"FDEE",0
3,"3012",1072,862,849,3,13,"FDEE",0
3,"3089",9599,7100,6980,39,120,"FDEE",1
3,"3076",8485,6251,6194,37,57,"FDEE",2
3,"3083",5607,4160,4106,36,54,"FDEE",2
3,"3077",1374,1139,1126,11,13,"FDEE",0
3,"3069",3060,2187,2168,9,19,"FDEE",2
3,"3040",257,222,222,0,0,"FDEE",0
3,"3007",168,142,138,0,4,"FDEE",0
3,"3115",248,219,219,2,0,"FDEE",0
3,"3064",5040,3887,3834,16,53,"FDEE",0
3,"3056",8737,6809,6731,33,78,"FDEE",3
3,"3072",351,288,287,2,1,"FDEE",0
3,"3013",1114,914,906,5,8,"FDEE",0
3,"3102",7271,5762,5687,46,75,"FDEE",1
3,"3124",469,400,394,5,6,"FDEE",0
3,"3031",41486,28059,27851,152,208,"FDEE",7
3,"3071",3980,3134,3106,28,28,"FDEE",0
3,"3095",4602,3628,3605,27,23,"FDEE",4
3,"3082",12542,8709,8597,48,112,"FDEE",5
3,"3014",237548,173040,172027,866,1013,"FDEE",46
3,"3070",2038,1526,1499,5,27,"FDEE",0
3,"3016",94,79,79,0,0,"FDEE",0
3,"3090",17087,12723,12602,69,121,"FDEE",9
3,"3065",166944,126831,126024,773,807,"FDEE",95
3,"3073",236,202,202,1,0,"FDEE",0
3,"3081",1433,1130,1118,5,12,"FDEE",1
3,"3112",653,522,517,2,5,"FDEE",0
3,"3039",85,61,59,0,2,"FDEE",0
3,"3121",21269,14932,14795,78,137,"FDEE",3
3,"3132",536,426,423,0,3,"FDEE",0
3,"3901",1129,855,853,5,2,"FDEE",0
3,"3140",26176,19795,19509,155,286,"FDEE",3
3,"3122",42227,31379,31186,160,193,"FDEE",21
3,"3006",497,401,393,4,8,"FDEE",0
3,"3033",113,97,97,2,0,"FDEE",0
3,"3116",1159,892,886,2,6,"FDEE",0
3,"3091",247,217,215,1,2,"FDEE",0
3,"3063",26383,19376,19255,105,121,"FDEE",6
3,"3042",1367,1045,1033,5,12,"FDEE",0
3,"3001",337,289,286,3,3,"FDEE",0
3,"3131",175,159,153,0,6,"FDEE",0
3,"3074",1706,1400,1382,3,18,"FDEE",0
3,"3022",142,120,120,2,0,"FDEE",0
3,"3066",42291,31010,30781,190,229,"FDEE",115
3,"3096",5811,4539,4492,19,47,"FDEE",3
3,"3117",370,325,322,0,3,"FDEE",0
3,"3067",98,82,81,1,1,"FDEE",0
3,"3059",20538,15653,15522,79,131,"FDEE",7
3,"3051",350,310,305,1,5,"FDEE",0
3,"3092",6749,5398,5342,40,56,"FDEE",2
3,"3903",2482,1945,1926,16,19,"FDEE",1
3,"3043",2900,2516,2483,18,33,"FDEE",0
3,"3002",3610,2714,2682,18,32,"FDEE",1
3,"3075",156,139,139,0,0,"FDEE",0
3,"3048",4858,3785,3735,25,50,"FDEE",2
3,"3902",10213,7091,6997,52,94,"FDEE",3
3,"3005",7753,6158,6118,38,40,"FDEE",6
3,"3015",12544,9478,9388,58,90,"FDEE",1
3,"3078",486,398,397,3,1,"FDEE",0
3,"3127",352,279,277,1,2,"FDEE",0
3,"3084",543,478,476,4,2,"FDEE",0
3,"3118",2452,1732,1714,9,18,"FDEE",2
3,"3035",663,543,538,1,5,"FDEE",2
3,"3027",159,135,132,0,3,"FDEE",0
3,"3019",15261,11921,11804,98,117,"FDEE",7
3,"3060",108,92,90,1,2,"FDEE",0
3,"3093",19661,15155,14988,84,167,"FDEE",4
3,"3030",513,432,424,0,8,"FDEE",0
3,"3003",455,393,388,3,5,"FDEE",0
3,"3057",191,148,148,2,0,"FDEE",0
3,"3068",46,41,40,0,1,"FDEE",0
3,"3904",1393,1065,1057,8,8,"FDEE",1
3,"3025",1270,1003,996,3,7,"FDEE",0
3,"3041",5945,4393,4344,28,49,"FDEE",6
3,"3136",446,361,361,2,0,"FDEE",1
3,"3052",969,804,794,6,10,"FDEE",0
3,"3085",270,226,225,1,1,"FDEE",0
8,"8104",682,445,443,4,2,"UPYD",0
8,"8158",3105,2166,2145,18,21,"UPYD",4
8,"8082",1150,788,783,6,5,"UPYD",3
8,"8181",7896,5774,5724,41,50,"UPYD",10
8,"8285",10260,6893,6843,56,50,"UPYD",13
8,"8303",278,206,205,2,1,"UPYD",0
8,"8108",5014,3757,3740,21,17,"UPYD",10
8,"8152",114,84,82,1,2,"UPYD",0
8,"8060",143,100,99,0,1,"UPYD",0
8,"8204",3058,2282,2262,17,20,"UPYD",5
8,"8025",1486,1087,1083,13,4,"UPYD",0
8,"8219",15355,11458,11403,86,55,"UPYD",17
8,"8029",3438,2645,2632,25,13,"UPYD",3
8,"8231",20495,13961,13885,91,76,"UPYD",37
8,"8129",456,322,320,3,2,"UPYD",0
8,"8092",3768,2621,2600,31,21,"UPYD",2
8,"8023",6715,4669,4633,25,36,"UPYD",10
8,"8179",579,427,425,6,2,"UPYD",0
8,"8201",436,299,298,1,1,"UPYD",0
8,"8163",18590,12816,12750,72,66,"UPYD",26
8,"8307",48233,34249,34071,209,178,"UPYD",61
8,"8033",12803,9236,9179,79,57,"UPYD",9
8,"8261",2319,1638,1632,4,6,"UPYD",1
8,"8011",1760,1230,1217,10,13,"UPYD",0
8,"8003",7118,5140,5108,28,32,"UPYD",6
8,"8217",24985,19385,19317,130,68,"UPYD",43
8,"8236",1525,1077,1067,3,10,"UPYD",1
8,"8093",26,19,19,0,0,"UPYD",0
8,"8210",4296,2825,2806,22,19,"UPYD",5
8,"8094",1548,1143,1133,12,10,"UPYD",0
8,"8015",155841,109156,108536,726,620,"UPYD",246
8,"8296",1787,1358,1351,9,7,"UPYD",3
8,"8240",9354,6996,6953,34,43,"UPYD",11
8,"8227",2329,1625,1607,13,18,"UPYD",2
8,"8069",3168,2333,2324,17,9,"UPYD",3
8,"8132",379,259,256,3,3,"UPYD",1
8,"8156",10923,8013,7964,50,49,"UPYD",12
8,"8259",6623,4921,4885,33,36,"UPYD",5
8,"8222",1878,1452,1443,16,9,"UPYD",0
8,"8041",10314,7291,7238,46,53,"UPYD",19
8,"8042",2233,1668,1653,8,15,"UPYD",2
8,"8174",394,306,300,3,6,"UPYD",0
8,"8150",258,189,185,0,4,"UPYD",1
8,"8220",2358,1783,1770,18,13,"UPYD",1
8,"8238",14478,11302,11252,85,50,"UPYD",26
8,"8137",265,206,205,1,1,"UPYD",0
8,"8007",6505,4532,4495,28,37,"UPYD",3
8,"8209",6773,4845,4822,31,23,"UPYD",13
8,"8281",4841,3577,3553,18,24,"UPYD",1
8,"8213",6296,4308,4294,47,14,"UPYD",4
8,"8047",3978,2640,2614,21,26,"UPYD",0
8,"8053",2805,1789,1775,10,14,"UPYD",4
8,"8230",7611,5590,5560,40,30,"UPYD",11
8,"8116",582,421,418,4,3,"UPYD",0
8,"8249",266,223,220,2,3,"UPYD",0
8,"8039",354,259,259,0,0,"UPYD",0
8,"8098",2387,1668,1662,11,6,"UPYD",4
8,"8206",731,568,559,9,9,"UPYD",0
8,"8061",1485,1045,1040,5,5,"UPYD",1
8,"8072",10240,6957,6935,40,22,"UPYD",7
8,"8280",101,67,67,3,0,"UPYD",0
8,"8246",1682,1157,1152,8,5,"UPYD",1
8,"8038",1488,987,981,10,6,"UPYD",0
8,"8265",1548,1115,1108,8,7,"UPYD",0
8,"8221",12391,9503,9456,49,47,"UPYD",15
8,"8020",4876,3702,3678,25,24,"UPYD",4
8,"8192",5696,4093,4069,38,24,"UPYD",6
8,"8287",1044,806,792,7,14,"UPYD",1
8,"8106",7216,5220,5176,38,44,"UPYD",8
8,"8262",6855,4522,4491,46,31,"UPYD",5
8,"8244",5821,4484,4451,32,33,"UPYD",11
8,"8270",18399,12948,12869,83,79,"UPYD",12
8,"8117",2453,1741,1727,23,14,"UPYD",2
8,"8077",34550,26102,25983,152,119,"UPYD",50
8,"8036",159,113,112,1,1,"UPYD",0
8,"8095",71,50,50,0,0,"UPYD",0
8,"8263",20974,15086,15001,93,85,"UPYD",24
8,"8021",69,52,51,3,1,"UPYD",0
8,"8202",12615,8911,8831,70,80,"UPYD",12
8,"8057",59,42,41,2,1,"UPYD",0
8,"8126",8709,6454,6425,34,29,"UPYD",14
8,"8019",1141245,824778,820790,5063,3988,"UPYD",1749
8,"8223",1850,1279,1263,10,16,"UPYD",2
8,"8293",226,162,162,0,0,"UPYD",0
8,"8140",4769,3344,3335,25,9,"UPYD",2
8,"8264",4288,3045,3030,30,15,"UPYD",1
8,"8234",3187,2331,2322,11,9,"UPYD",8
8,"8067",5723,3896,3874,39,22,"UPYD",5
8,"8283",5983,4032,4007,31,25,"UPYD",5
8,"8175",3371,2243,2232,25,11,"UPYD",2
8,"8257",110,87,87,0,0,"UPYD",0
8,"8203",2422,1602,1591,11,11,"UPYD",3
8,"8237",1642,1165,1160,4,5,"UPYD",0
8,"8130",96,66,66,0,0,"UPYD",0
8,"8101",174802,123863,123197,643,666,"UPYD",303
8,"8035",12448,8482,8443,54,39,"UPYD",18
8,"8083",1674,1287,1275,8,12,"UPYD",1
8,"8276",233,169,169,3,0,"UPYD",0
8,"8164",911,651,644,2,7,"UPYD",1
8,"8008",187,118,118,1,0,"UPYD",0
8,"8306",517,360,354,2,6,"UPYD",1
8,"8004",233,181,181,2,0,"UPYD",0
8,"8065",1179,837,831,8,6,"UPYD",0
8,"8058",1742,1210,1194,7,16,"UPYD",6
8,"8191",5287,3732,3712,31,20,"UPYD",2
8,"8905",2305,1789,1774,17,15,"UPYD",1
8,"8043",3190,2216,2201,12,15,"UPYD",162
8,"8172",20384,14738,14684,85,54,"UPYD",22
8,"8002",202,142,139,0,3,"UPYD",0
8,"8139",171,133,132,0,1,"UPYD",0
8,"8207",1840,1418,1410,17,8,"UPYD",1
8,"8902",3756,2758,2741,18,17,"UPYD",3
8,"8252",24521,18605,18514,110,91,"UPYD",47
8,"8044",4150,2957,2932,19,25,"UPYD",5
8,"8010",4196,2876,2852,16,24,"UPYD",6
8,"8135",6733,5230,5205,45,25,"UPYD",11
8,"8200",61275,45027,44785,276,242,"UPYD",87
8,"8228",296,207,204,3,3,"UPYD",0
8,"8159",14049,10329,10284,51,45,"UPYD",25
8,"8245",78581,55798,55530,345,268,"UPYD",127
8,"8115",3817,2835,2814,18,21,"UPYD",1
8,"8074",10587,7309,7274,51,35,"UPYD",15
8,"8122",1683,1117,1106,10,11,"UPYD",1
8,"8111",216,185,185,0,0,"UPYD",0
8,"8260",18306,13492,13423,60,69,"UPYD",178
8,"8170",447,293,291,11,2,"UPYD",0
8,"8018",2654,1834,1819,16,15,"UPYD",96
8,"8155",6736,4779,4734,45,45,"UPYD",6
8,"8305",27328,19226,19083,116,143,"UPYD",28
8,"8298",26426,17862,17784,113,78,"UPYD",11
8,"8189",126,95,94,2,1,"UPYD",0
8,"8141",4590,3173,3150,39,23,"UPYD",44
8,"8071",241,168,164,3,4,"UPYD",0
8,"8075",3875,2709,2695,12,14,"UPYD",2
8,"8134",803,560,554,5,6,"UPYD",0
8,"8112",12909,8671,8616,50,55,"UPYD",7
8,"8302",9209,6571,6524,65,47,"UPYD",20
8,"8153",536,432,431,6,1,"UPYD",2
8,"8269",2646,1871,1860,17,11,"UPYD",0
8,"8157",8361,6311,6277,38,34,"UPYD",7
8,"8032",1973,1410,1403,6,7,"UPYD",3
8,"8255",140,90,90,1,0,"UPYD",0
8,"8086",13550,9448,9395,66,53,"UPYD",15
8,"8180",26616,19621,19542,90,79,"UPYD",40
8,"8292",1083,796,791,4,5,"UPYD",1
8,"8113",52051,34906,34729,229,177,"UPYD",37
8,"8218",8045,5643,5613,54,30,"UPYD",11
8,"8215",2576,1766,1751,30,15,"UPYD",0
8,"8211",32990,25446,25282,173,164,"UPYD",64
8,"8161",11145,7658,7621,45,37,"UPYD",13
8,"8242",216,172,170,0,2,"UPYD",0
8,"8233",1876,1247,1237,11,10,"UPYD",0
8,"8081",345,255,255,1,0,"UPYD",0
8,"8114",18335,13196,13092,66,104,"UPYD",17
8,"8040",10701,7420,7383,43,37,"UPYD",6
8,"8080",38,28,27,0,1,"UPYD",0
8,"8297",138,100,99,1,1,"UPYD",0
8,"8185",194,132,132,0,0,"UPYD",0
8,"8182",2803,2039,2034,16,5,"UPYD",2
8,"8241",76,59,59,0,0,"UPYD",0
8,"8133",128,76,75,0,1,"UPYD",0
8,"8205",59169,45410,45231,357,179,"UPYD",82
8,"8089",33935,24504,24392,150,112,"UPYD",51
8,"8183",4524,3125,3103,21,22,"UPYD",4
8,"8275",254,202,202,4,0,"UPYD",0
8,"8308",131,99,97,0,2,"UPYD",0
8,"8063",448,363,363,8,0,"UPYD",0
8,"8119",6182,4517,4492,35,25,"UPYD",9
8,"8279",152985,110533,110039,684,494,"UPYD",232
8,"8097",1027,736,731,7,5,"UPYD",1
8,"8187",152527,112013,111491,638,522,"UPYD",474
8,"8901",232,171,171,6,0,"UPYD",0
8,"8294",1971,1357,1349,8,8,"UPYD",1
8,"8239",451,324,324,5,0,"UPYD",0
8,"8272",157,98,97,0,1,"UPYD",1
8,"8266",43128,32806,32660,195,146,"UPYD",92
8,"8160",330,217,217,0,0,"UPYD",0
8,"8250",7046,4908,4878,33,30,"UPYD",12
8,"8091",5253,3817,3795,23,22,"UPYD",3
8,"8225",93,71,71,2,0,"UPYD",0
8,"8102",28304,19929,19821,170,108,"UPYD",39
8,"8005",6165,4458,4434,23,24,"UPYD",5
8,"8295",10850,7651,7617,33,34,"UPYD",14
8,"8128",564,378,377,1,1,"UPYD",1
8,"8012",1676,1175,1170,24,5,"UPYD",0
8,"8251",4970,3505,3480,14,25,"UPYD",6
8,"8165",1657,1181,1175,8,6,"UPYD",2
8,"8184",53690,37794,37636,200,158,"UPYD",206
8,"8052",139,94,94,2,0,"UPYD",0
8,"8190",258,179,177,2,2,"UPYD",0
8,"8288",1632,1061,1053,4,8,"UPYD",2
8,"8051",17873,13126,13048,66,78,"UPYD",15
8,"8099",749,514,513,4,1,"UPYD",0
8,"8268",1011,702,699,2,3,"UPYD",0
8,"8073",61659,45611,45356,239,255,"UPYD",107
8,"8904",10563,7474,7437,32,37,"UPYD",17
8,"8088",11840,8684,8627,55,57,"UPYD",8
8,"8162",2028,1451,1442,8,9,"UPYD",1
8,"8144",715,493,489,9,4,"UPYD",0
8,"8136",11416,8425,8388,63,37,"UPYD",24
8,"8197",7605,5331,5317,31,14,"UPYD",5
8,"8145",2585,1927,1915,10,12,"UPYD",2
8,"8235",3683,2612,2595,22,17,"UPYD",4
8,"8256",644,516,512,1,4,"UPYD",1
8,"8056",41996,30076,29974,178,102,"UPYD",84
8,"8224",816,598,595,7,3,"UPYD",0
8,"8171",2099,1396,1389,20,7,"UPYD",0
8,"8049",1288,860,841,9,19,"UPYD",0
8,"8286",2904,2009,1997,17,12,"UPYD",5
8,"8199",665,466,464,6,2,"UPYD",9
8,"8027",690,527,524,3,3,"UPYD",2
8,"8167",5879,4463,4448,42,15,"UPYD",11
8,"8031",2308,1648,1637,10,11,"UPYD",3
8,"8013",1219,873,867,10,6,"UPYD",5
8,"8196",19247,14101,14047,75,54,"UPYD",30
8,"8254",1746,1261,1257,13,4,"UPYD",0
8,"8138",4229,2832,2816,19,16,"UPYD",1
8,"8062",951,676,674,5,2,"UPYD",2
8,"8105",9613,7103,7047,46,56,"UPYD",12
8,"8277",162,132,132,0,0,"UPYD",1
8,"8267",6435,4571,4542,24,29,"UPYD",10
8,"8299",395,256,255,3,1,"UPYD",0
8,"8066",1364,1029,1025,10,4,"UPYD",2
8,"8142",132,105,104,1,1,"UPYD",0
8,"8016",1822,1229,1214,12,15,"UPYD",3
8,"8022",12230,7792,7717,60,75,"UPYD",8
8,"8289",4304,3166,3151,19,15,"UPYD",7
8,"8166",1000,680,674,4,6,"UPYD",0
8,"8271",69,47,46,0,1,"UPYD",0
8,"8121",86293,61426,61070,450,356,"UPYD",110
8,"8290",1490,1163,1155,5,8,"UPYD",0
8,"8301",48496,35956,35788,200,168,"UPYD",109
8,"8078",216,135,135,2,0,"UPYD",0
8,"8178",430,317,315,4,2,"UPYD",1
8,"8253",133,85,85,1,0,"UPYD",0
8,"8037",1856,1364,1351,20,13,"UPYD",0
8,"8085",985,712,704,1,8,"UPYD",0
8,"8068",6729,4765,4739,23,26,"UPYD",7
8,"8177",40,25,25,1,0,"UPYD",0
8,"8124",36750,26968,26842,140,126,"UPYD",70
8,"8247",958,716,714,7,2,"UPYD",0
8,"8148",2238,1592,1580,7,12,"UPYD",2
8,"8079",339,254,248,2,6,"UPYD",0
8,"8258",835,602,597,5,5,"UPYD",1
8,"8045",72,42,39,0,3,"UPYD",0
8,"8291",4524,3226,3206,24,20,"UPYD",7
8,"8168",375,235,234,0,1,"UPYD",1
8,"8028",1031,724,721,6,3,"UPYD",1
8,"8149",996,662,660,7,2,"UPYD",0
8,"8232",1797,1276,1266,14,10,"UPYD",2
8,"8055",512,366,364,2,2,"UPYD",1
8,"8059",342,224,223,3,1,"UPYD",0
8,"8014",1953,1438,1429,13,9,"UPYD",3
8,"8226",879,683,680,3,3,"UPYD",0
8,"8214",6841,5018,4994,49,24,"UPYD",9
8,"8208",5736,4318,4295,23,23,"UPYD",5
8,"8154",694,535,529,3,6,"UPYD",0
8,"8090",129,103,102,2,1,"UPYD",0
8,"8084",1135,795,790,6,5,"UPYD",1
8,"8048",583,426,424,5,2,"UPYD",0
8,"8216",25,17,17,0,0,"UPYD",0
8,"8110",13392,9211,9142,67,69,"UPYD",16
8,"8017",2756,1888,1876,7,12,"UPYD",2
8,"8212",495,350,347,3,3,"UPYD",0
8,"8194",25539,16628,16553,77,75,"UPYD",46
8,"8146",1297,958,954,16,4,"UPYD",0
8,"8176",158,113,113,1,0,"UPYD",0
8,"8198",4391,3167,3138,17,29,"UPYD",7
8,"8284",12067,7855,7792,66,63,"UPYD",30
8,"8195",82,64,64,0,0,"UPYD",0
8,"8100",1992,1496,1485,21,11,"UPYD",4
8,"8054",9013,6747,6702,38,45,"UPYD",12
8,"8229",535,383,379,3,4,"UPYD",2
8,"8050",141,107,104,0,3,"UPYD",0
8,"8009",9136,6613,6578,40,35,"UPYD",11
8,"8087",159,131,130,2,1,"UPYD",0
8,"8096",42411,30717,30550,204,167,"UPYD",46
8,"8103",631,431,431,3,0,"UPYD",1
8,"8304",814,578,573,1,5,"UPYD",0
8,"8282",6517,5027,5017,40,10,"UPYD",11
8,"8026",187,155,155,1,0,"UPYD",0
8,"8118",17516,12878,12820,79,58,"UPYD",18
8,"8034",766,542,538,3,4,"UPYD",0
8,"8120",6815,5071,5045,34,26,"UPYD",4
8,"8024",381,270,269,3,1,"UPYD",0
8,"8131",699,520,516,4,4,"UPYD",0
8,"8076",16173,11553,11473,73,80,"UPYD",32
8,"8006",11427,7789,7727,46,62,"UPYD",7
8,"8147",17001,12422,12333,62,89,"UPYD",29
8,"8248",5402,3848,3815,27,33,"UPYD",6
8,"8125",25024,18070,17966,99,104,"UPYD",42
8,"8274",4702,3349,3323,35,26,"UPYD",1
8,"8151",463,336,333,11,3,"UPYD",0
8,"8273",2309,1706,1689,12,17,"UPYD",2
8,"8300",5682,4328,4312,21,16,"UPYD",8
8,"8064",1853,1323,1315,9,8,"UPYD",4
8,"8127",2224,1439,1429,8,10,"UPYD",0
8,"8030",5095,3727,3712,27,15,"UPYD",3
8,"8169",47915,35543,35390,211,153,"UPYD",98
8,"8123",19114,14573,14509,81,64,"UPYD",13
8,"8188",117,81,81,2,0,"UPYD",0
8,"8001",8825,6810,6760,24,50,"UPYD",19
8,"8070",267,196,193,2,3,"UPYD",0
8,"8243",160,117,117,6,0,"UPYD",0
8,"8107",11472,8147,8097,45,50,"UPYD",83
8,"8193",942,637,633,9,4,"UPYD",0
8,"8903",213,167,167,0,0,"UPYD",0
8,"8046",13243,9747,9693,74,54,"UPYD",9
8,"8143",2686,1892,1881,19,11,"UPYD",2
8,"8278",4764,3372,3358,16,14,"UPYD",1
8,"8109",214,174,173,0,1,"UPYD",0
45,"45198",1832,1521,1508,6,13,"PODEMOS",99
45,"45100",197,166,164,2,2,"PODEMOS",8
45,"45084",2280,1777,1747,12,30,"PODEMOS",223
45,"45075",146,108,105,0,3,"PODEMOS",19
45,"45130",319,258,252,1,6,"PODEMOS",16
45,"45026",225,171,169,1,2,"PODEMOS",14
45,"45083",465,393,388,5,5,"PODEMOS",36
45,"45156",3441,2863,2825,13,38,"PODEMOS",306
45,"45116",694,531,523,2,8,"PODEMOS",31
45,"45194",67,50,49,0,1,"PODEMOS",3
45,"45064",3839,2915,2884,19,31,"PODEMOS",481
45,"45149",573,486,484,0,2,"PODEMOS",45
45,"45136",5859,4249,4177,24,72,"PODEMOS",422
45,"45021",2459,1862,1833,21,29,"PODEMOS",243
45,"45003",572,431,423,1,8,"PODEMOS",33
45,"45061",2457,1718,1699,7,19,"PODEMOS",216
45,"45030",482,364,361,4,3,"PODEMOS",59
45,"45093",151,117,117,0,0,"PODEMOS",7
45,"45067",2324,1871,1841,13,30,"PODEMOS",153
45,"45001",1852,1395,1355,9,40,"PODEMOS",180
45,"45153",1613,1263,1248,11,15,"PODEMOS",143
45,"45191",549,477,475,0,2,"PODEMOS",42
45,"45110",1799,1394,1380,4,14,"PODEMOS",45
45,"45133",2818,2184,2146,19,38,"PODEMOS",205
45,"45144",794,643,640,2,3,"PODEMOS",88
45,"45112",1939,1302,1268,6,34,"PODEMOS",121
45,"45181",2313,1755,1728,12,27,"PODEMOS",100
45,"45040",1396,871,862,4,9,"PODEMOS",149
45,"45115",2563,2089,2048,5,41,"PODEMOS",130
45,"45065",276,227,223,0,4,"PODEMOS",29
45,"45038",3335,2525,2490,8,35,"PODEMOS",507
45,"45193",626,543,530,2,13,"PODEMOS",64
45,"45111",60,47,47,0,0,"PODEMOS",2
45,"45079",367,285,285,3,0,"PODEMOS",48
45,"45099",3512,2514,2459,9,55,"PODEMOS",470
45,"45199",2963,2055,2027,5,28,"PODEMOS",458
45,"45124",2156,1750,1712,16,38,"PODEMOS",121
45,"45009",545,336,333,1,3,"PODEMOS",29
45,"45077",542,428,423,0,5,"PODEMOS",52
45,"45177",2142,1757,1731,11,26,"PODEMOS",181
45,"45017",262,221,219,0,2,"PODEMOS",22
45,"45104",440,345,341,1,4,"PODEMOS",45
45,"45201",3450,2212,2173,14,39,"PODEMOS",444
45,"45073",307,238,235,0,3,"PODEMOS",45
45,"45186",3083,2369,2341,14,28,"PODEMOS",247
45,"45172",719,559,556,2,3,"PODEMOS",39
45,"45119",3348,2306,2264,14,42,"PODEMOS",443
45,"45137",1623,1106,1093,9,13,"PODEMOS",150
45,"45102",3629,2685,2644,15,41,"PODEMOS",317
45,"45043",793,663,655,1,8,"PODEMOS",47
45,"45019",7356,5539,5484,35,55,"PODEMOS",952
45,"45002",2549,1810,1784,7,26,"PODEMOS",273
45,"45096",1015,832,817,7,15,"PODEMOS",137
45,"45157",2125,1531,1509,14,22,"PODEMOS",246
45,"45123",3075,2261,2222,11,39,"PODEMOS",517
45,"45034",1360,1098,1083,4,15,"PODEMOS",178
45,"45182",1045,854,844,3,10,"PODEMOS",112
45,"45114",595,461,457,1,4,"PODEMOS",31
45,"45015",622,461,455,2,6,"PODEMOS",50
45,"45070",1461,1223,1202,7,21,"PODEMOS",140
45,"45168",62226,48889,48446,327,443,"PODEMOS",8063
45,"45152",597,476,476,2,0,"PODEMOS",30
45,"45122",5164,4112,4067,18,45,"PODEMOS",604
45,"45024",1075,828,824,5,4,"PODEMOS",40
45,"45117",754,610,602,2,8,"PODEMOS",32
45,"45158",2534,1885,1868,8,17,"PODEMOS",229
45,"45014",3984,2824,2802,24,22,"PODEMOS",493
45,"45051",1594,1264,1248,6,16,"PODEMOS",105
45,"45069",1876,1446,1428,8,18,"PODEMOS",144
45,"45187",4078,3405,3353,14,52,"PODEMOS",368
45,"45029",205,169,169,0,0,"PODEMOS",17
45,"45054",3995,2997,2968,8,29,"PODEMOS",259
45,"45197",1921,1500,1480,12,20,"PODEMOS",77
45,"45204",643,519,513,0,6,"PODEMOS",56
45,"45105",405,284,279,3,5,"PODEMOS",8
45,"45176",3665,2747,2712,15,35,"PODEMOS",573
45,"45005",241,207,205,2,2,"PODEMOS",36
45,"45107",3238,2628,2597,15,31,"PODEMOS",449
45,"45042",190,145,145,0,0,"PODEMOS",12
45,"45089",1516,1157,1139,6,18,"PODEMOS",182
45,"45118",2002,1470,1456,3,14,"PODEMOS",156
45,"45164",186,160,160,0,0,"PODEMOS",16
45,"45171",1382,1090,1075,4,15,"PODEMOS",104
45,"45076",574,382,378,1,4,"PODEMOS",54
45,"45165",62857,46607,46141,313,466,"PODEMOS",6501
45,"45068",173,138,135,0,3,"PODEMOS",19
45,"45127",708,524,519,1,5,"PODEMOS",95
45,"45025",1198,921,910,2,11,"PODEMOS",154
45,"45141",897,735,727,4,8,"PODEMOS",58
45,"45125",2329,1920,1898,10,22,"PODEMOS",240
45,"45200",4627,3678,3588,29,90,"PODEMOS",309
45,"45023",2160,1669,1654,9,15,"PODEMOS",331
45,"45173",9477,7145,7061,40,84,"PODEMOS",794
45,"45128",2498,1794,1774,7,20,"PODEMOS",241
45,"45148",307,229,219,1,10,"PODEMOS",8
45,"45063",428,320,310,2,10,"PODEMOS",30
45,"45081",17646,13309,13166,72,143,"PODEMOS",2314
45,"45166",1629,1345,1332,5,13,"PODEMOS",118
45,"45170",235,183,176,4,7,"PODEMOS",15
45,"45020",1313,1062,1046,5,16,"PODEMOS",65
45,"45094",395,312,308,0,4,"PODEMOS",43
45,"45159",86,75,72,1,3,"PODEMOS",1
45,"45180",2725,2060,2028,7,32,"PODEMOS",268
45,"45095",697,529,520,1,9,"PODEMOS",23
45,"45098",2186,1686,1649,10,37,"PODEMOS",157
45,"45060",179,131,129,1,2,"PODEMOS",11
45,"45179",546,406,403,3,3,"PODEMOS",30
45,"45126",260,169,167,1,2,"PODEMOS",31
45,"45109",2913,2295,2218,16,77,"PODEMOS",201
45,"45066",7589,5716,5637,30,79,"PODEMOS",650
45,"45086",503,375,369,3,6,"PODEMOS",41
45,"45135",4302,3509,3453,21,56,"PODEMOS",476
45,"45041",3725,2698,2665,18,33,"PODEMOS",481
45,"45087",8345,6184,6091,34,93,"PODEMOS",703
45,"45033",351,253,247,3,6,"PODEMOS",14
45,"45058",384,304,301,4,3,"PODEMOS",49
45,"45203",2574,1938,1908,10,30,"PODEMOS",299
45,"45188",2783,2161,2127,9,34,"PODEMOS",325
45,"45091",407,301,299,2,2,"PODEMOS",32
45,"45055",1032,857,841,2,16,"PODEMOS",71
45,"45071",1863,1550,1530,8,20,"PODEMOS",130
45,"45013",1786,1428,1412,7,16,"PODEMOS",92
45,"45140",1093,885,876,4,9,"PODEMOS",82
45,"45120",134,105,105,1,0,"PODEMOS",6
45,"45010",436,335,333,2,2,"PODEMOS",21
45,"45145",2539,1830,1811,11,19,"PODEMOS",259
45,"45007",697,566,560,1,6,"PODEMOS",71
45,"45195",2161,1709,1686,12,23,"PODEMOS",182
45,"45011",288,246,241,1,5,"PODEMOS",10
45,"45196",1388,1066,1054,13,12,"PODEMOS",84
45,"45189",597,467,458,2,9,"PODEMOS",84
45,"45036",658,500,496,2,4,"PODEMOS",45
45,"45090",376,299,295,4,4,"PODEMOS",12
45,"45106",7524,5882,5784,55,98,"PODEMOS",739
45,"45202",3905,2962,2920,12,42,"PODEMOS",309
45,"45138",1110,903,887,6,16,"PODEMOS",54
45,"45097",1047,877,869,3,8,"PODEMOS",43
45,"45049",435,330,326,0,4,"PODEMOS",29
45,"45174",309,247,247,1,0,"PODEMOS",12
45,"45012",670,521,506,4,15,"PODEMOS",75
45,"45134",1600,1214,1200,4,14,"PODEMOS",131
45,"45082",1246,1046,1036,9,10,"PODEMOS",108
45,"45143",1180,924,912,3,12,"PODEMOS",137
45,"45035",298,225,221,2,4,"PODEMOS",53
45,"45146",108,85,85,0,0,"PODEMOS",4
45,"45132",2096,1631,1616,7,15,"PODEMOS",171
45,"45184",201,124,123,1,1,"PODEMOS",17
45,"45056",2210,1384,1370,11,14,"PODEMOS",277
45,"45163",8338,6270,6142,57,128,"PODEMOS",875
45,"45074",412,327,322,0,5,"PODEMOS",34
45,"45108",521,415,414,2,1,"PODEMOS",8
45,"45022",392,297,293,8,4,"PODEMOS",31
45,"45131",287,242,242,0,0,"PODEMOS",28
45,"45059",1723,1413,1388,4,25,"PODEMOS",68
45,"45062",1121,910,894,10,16,"PODEMOS",39
45,"45039",226,197,193,1,4,"PODEMOS",14
45,"45175",665,541,532,5,9,"PODEMOS",29
45,"45113",1948,1409,1386,14,23,"PODEMOS",101
45,"45008",142,114,114,2,0,"PODEMOS",3
45,"45027",362,275,270,0,5,"PODEMOS",32
45,"45139",172,135,133,0,2,"PODEMOS",5
45,"45160",1111,908,895,6,13,"PODEMOS",93
45,"45147",581,475,469,4,6,"PODEMOS",65
45,"45031",2723,1935,1896,10,39,"PODEMOS",283
45,"45162",683,515,510,0,5,"PODEMOS",31
45,"45052",2914,2389,2372,23,17,"PODEMOS",403
45,"45101",3761,3090,3048,15,42,"PODEMOS",311
45,"45032",436,317,313,0,4,"PODEMOS",57
45,"45078",1392,1187,1179,8,8,"PODEMOS",69
45,"45129",136,100,97,0,3,"PODEMOS",19
45,"45167",1458,1197,1187,5,10,"PODEMOS",109
45,"45018",495,352,348,0,4,"PODEMOS",99
45,"45151",586,444,437,1,7,"PODEMOS",78
45,"45190",483,397,387,2,10,"PODEMOS",37
45,"45103",397,325,322,0,3,"PODEMOS",10
45,"45183",2253,1581,1569,8,12,"PODEMOS",351
45,"45150",454,366,364,1,2,"PODEMOS",19
45,"45161",13474,9618,9496,63,122,"PODEMOS",2150
45,"45142",7858,6249,6164,57,85,"PODEMOS",756
45,"45048",360,281,277,1,4,"PODEMOS",17
45,"45028",3680,2919,2880,23,39,"PODEMOS",301
45,"45004",568,436,430,1,6,"PODEMOS",52
45,"45085",1501,1086,1067,6,19,"PODEMOS",147
45,"45155",371,297,296,1,1,"PODEMOS",21
45,"45192",2503,2164,2141,7,23,"PODEMOS",151
45,"45050",471,354,351,2,3,"PODEMOS",61
45,"45154",1483,1114,1107,5,7,"PODEMOS",197
45,"45092",233,197,194,0,3,"PODEMOS",8
45,"45185",7734,6057,5973,27,84,"PODEMOS",762
45,"45121",6766,4860,4798,30,62,"PODEMOS",585
45,"45169",193,136,136,1,0,"PODEMOS",6
45,"45006",1425,1022,1013,4,9,"PODEMOS",112
45,"45088",2102,1438,1423,4,15,"PODEMOS",238
45,"45047",2563,1775,1751,13,24,"PODEMOS",319
45,"45080",6,6,6,0,0,"PODEMOS",0
45,"45037",1635,1216,1202,4,14,"PODEMOS",115
45,"45045",1316,945,935,1,10,"PODEMOS",97
45,"45016",4179,3290,3268,30,22,"PODEMOS",556
45,"45057",221,187,182,0,5,"PODEMOS",8
45,"45053",8045,6446,6370,44,76,"PODEMOS",670
45,"45901",769,577,571,1,6,"PODEMOS",65
45,"45046",2421,1815,1796,8,19,"PODEMOS",181
45,"45205",6745,4708,4657,35,51,"PODEMOS",918
45,"45072",670,499,499,2,0,"PODEMOS",58
11,"11902",3619,2431,2410,17,21,"RECORTES CE",0
11,"11005",4560,3203,3143,21,60,"RECORTES CE",3
11,"11011",1688,1239,1205,14,34,"RECORTES CE",2
11,"11002",4287,3245,3238,15,7,"RECORTES CE",3
11,"11022",48778,26546,26333,277,213,"RECORTES CE",64
11,"11017",3207,2389,2362,28,27,"RECORTES CE",1
11,"11033",20773,13487,13333,171,154,"RECORTES CE",23
11,"11042",1189,877,868,5,9,"RECORTES CE",3
11,"11023",9354,6990,6928,86,62,"RECORTES CE",7
11,"11009",602,426,422,5,4,"RECORTES CE",0
11,"11013",2324,1687,1653,16,34,"RECORTES CE",2
11,"11028",32532,23191,22981,274,210,"RECORTES CE",54
11,"11041",9856,7043,6967,85,76,"RECORTES CE",14
11,"11024",6735,5114,5065,33,49,"RECORTES CE",3
11,"11030",22796,15377,15222,145,155,"RECORTES CE",21
11,"11035",13569,9000,8908,93,92,"RECORTES CE",10
11,"11031",76452,51850,51456,568,394,"RECORTES CE",89
11,"11034",2345,1606,1594,10,12,"RECORTES CE",0
11,"11001",4377,2949,2900,17,49,"RECORTES CE",2
11,"11901",5653,4132,4088,84,44,"RECORTES CE",3
11,"11026",4804,3581,3511,31,70,"RECORTES CE",5
11,"11032",53898,32432,32172,371,260,"RECORTES CE",33
11,"11007",18036,10832,10678,181,154,"RECORTES CE",17
11,"11020",165400,113865,113092,1184,773,"RECORTES CE",174
11,"11016",14880,9945,9848,124,97,"RECORTES CE",13
11,"11040",398,326,317,3,9,"RECORTES CE",0
11,"11027",68010,46675,46322,400,353,"RECORTES CE",71
11,"11019",1830,1413,1371,5,42,"RECORTES CE",0
11,"11039",10044,6684,6623,98,61,"RECORTES CE",5
11,"11006",24504,16649,16486,176,163,"RECORTES CE",20
11,"11012",100460,72741,72128,590,613,"RECORTES CE",191
11,"11010",6420,4423,4362,63,61,"RECORTES CE",0
11,"11004",88617,55218,54733,581,485,"RECORTES CE",79
11,"11036",694,439,437,13,2,"RECORTES CE",1
11,"11015",62337,40342,40012,407,330,"RECORTES CE",59
11,"11025",4370,3174,3123,29,51,"RECORTES CE",7
11,"11014",16791,11255,11146,166,109,"RECORTES CE",19
11,"11037",5678,4491,4426,20,65,"RECORTES CE",1
11,"11018",1485,1109,1090,10,19,"RECORTES CE",2
11,"11003",1270,907,899,12,8,"RECORTES CE",0
11,"11021",6777,4826,4779,52,47,"RECORTES CE",3
11,"11008",17460,11800,11615,151,185,"RECORTES CE",15
11,"11038",13803,10593,10441,121,152,"RECORTES CE",20
11,"11029",5433,3112,3067,27,45,"RECORTES CE",2
21,"21040",3158,2386,2345,15,41,"IULV-CA,UPe",81
21,"21017",3643,2301,2269,17,32,"IULV-CA,UPe",87
21,"21014",4041,3203,3170,15,33,"IULV-CA,UPe",130
21,"21038",1082,732,719,8,13,"IULV-CA,UPe",28
21,"21025",4049,2682,2653,25,29,"IULV-CA,UPe",114
21,"21016",1034,777,764,2,13,"IULV-CA,UPe",50
21,"21034",1207,848,838,8,10,"IULV-CA,UPe",31
21,"21054",8105,6025,5919,41,106,"IULV-CA,UPe",79
21,"21036",192,138,138,1,0,"IULV-CA,UPe",5
21,"21005",15486,10310,10189,64,121,"IULV-CA,UPe",427
21,"21022",174,115,109,1,6,"IULV-CA,UPe",3
21,"21076",2123,1549,1532,13,17,"IULV-CA,UPe",109
21,"21027",49,36,36,1,0,"IULV-CA,UPe",1
21,"21069",1715,1186,1175,7,11,"IULV-CA,UPe",13
21,"21003",695,533,525,1,8,"IULV-CA,UPe",47
21,"21043",1858,1356,1341,13,15,"IULV-CA,UPe",30
21,"21032",1805,1378,1359,15,19,"IULV-CA,UPe",93
21,"21055",6914,5286,5218,34,68,"IULV-CA,UPe",113
21,"21006",3402,2398,2359,13,39,"IULV-CA,UPe",76
21,"21031",1209,845,828,3,17,"IULV-CA,UPe",32
21,"21066",507,408,405,1,3,"IULV-CA,UPe",9
21,"21008",2662,1847,1831,14,16,"IULV-CA,UPe",28
21,"21056",2912,2115,2024,20,91,"IULV-CA,UPe",100
21,"21071",204,160,158,2,2,"IULV-CA,UPe",2
21,"21077",1722,1261,1246,5,15,"IULV-CA,UPe",29
21,"21002",15348,10939,10864,80,75,"IULV-CA,UPe",564
21,"21026",270,184,178,1,6,"IULV-CA,UPe",12
21,"21013",10597,7220,7061,69,159,"IULV-CA,UPe",413
21,"21072",10280,7869,7777,76,92,"IULV-CA,UPe",380
21,"21023",2147,1379,1357,6,22,"IULV-CA,UPe",98
21,"21053",3316,2257,2219,25,38,"IULV-CA,UPe",69
21,"21079",731,526,522,3,4,"IULV-CA,UPe",40
21,"21028",381,290,287,0,3,"IULV-CA,UPe",10
21,"21065",287,202,196,0,6,"IULV-CA,UPe",1
21,"21033",536,399,395,0,4,"IULV-CA,UPe",31
21,"21044",17552,10820,10692,106,128,"IULV-CA,UPe",293
21,"21010",14684,8766,8698,92,68,"IULV-CA,UPe",609
21,"21057",1045,641,640,8,1,"IULV-CA,UPe",13
21,"21041",113604,74902,74244,718,658,"IULV-CA,UPe",3819
21,"21058",2602,1904,1886,8,18,"IULV-CA,UPe",81
21,"21045",253,192,190,0,2,"IULV-CA,UPe",8
21,"21012",322,234,227,0,7,"IULV-CA,UPe",13
21,"21018",1780,1152,1131,10,21,"IULV-CA,UPe",34
21,"21052",4618,2837,2773,20,64,"IULV-CA,UPe",288
21,"21020",372,241,238,2,3,"IULV-CA,UPe",7
21,"21011",3464,2536,2518,19,18,"IULV-CA,UPe",111
21,"21049",3372,2162,2108,15,54,"IULV-CA,UPe",145
21,"21068",998,606,605,14,1,"IULV-CA,UPe",8
21,"21039",308,223,222,2,1,"IULV-CA,UPe",8
21,"21019",590,433,423,4,10,"IULV-CA,UPe",17
21,"21073",1871,1134,1120,12,14,"IULV-CA,UPe",19
21,"21067",415,309,303,0,6,"IULV-CA,UPe",22
21,"21070",6296,4450,4397,38,53,"IULV-CA,UPe",404
21,"21047",1914,1213,1179,19,34,"IULV-CA,UPe",157
21,"21061",5092,3471,3429,32,42,"IULV-CA,UPe",75
21,"21051",245,176,173,1,3,"IULV-CA,UPe",2
21,"21075",351,270,266,2,4,"IULV-CA,UPe",6
21,"21059",220,167,165,3,2,"IULV-CA,UPe",6
21,"21046",1703,1200,1173,15,27,"IULV-CA,UPe",22
21,"21009",860,571,555,6,16,"IULV-CA,UPe",46
21,"21030",1824,1491,1472,11,19,"IULV-CA,UPe",16
21,"21035",9622,6399,6313,69,86,"IULV-CA,UPe",151
21,"21042",15349,7802,7708,106,94,"IULV-CA,UPe",201
21,"21001",648,479,469,4,10,"IULV-CA,UPe",10
21,"21021",12233,7551,7470,94,81,"IULV-CA,UPe",291
21,"21007",6231,4285,4227,45,58,"IULV-CA,UPe",330
21,"21064",6526,4544,4492,51,52,"IULV-CA,UPe",187
21,"21024",495,350,344,5,6,"IULV-CA,UPe",33
21,"21078",2763,1928,1907,12,21,"IULV-CA,UPe",296
21,"21074",2660,1869,1844,18,25,"IULV-CA,UPe",66
21,"21029",1564,1166,1126,16,40,"IULV-CA,UPe",46
21,"21050",12448,8431,8382,86,49,"IULV-CA,UPe",195
21,"21037",472,364,360,2,4,"IULV-CA,UPe",16
21,"21004",1641,1070,1047,10,23,"IULV-CA,UPe",25
21,"21048",305,220,220,3,0,"IULV-CA,UPe",4
21,"21063",2614,2044,2034,12,10,"IULV-CA,UPe",49
21,"21060",11959,7565,7488,103,77,"IULV-CA,UPe",260
21,"21062",1395,936,926,9,10,"IULV-CA,UPe",26
21,"21015",683,425,420,6,5,"IULV-CA,UPe",14
1,"1031",1183,907,885,6,22,"PODEMOS-AHA",169
1,"1042",901,653,650,11,3,"PODEMOS-AHA",169
1,"1019",144,112,111,2,1,"PODEMOS-AHA",8
1,"1022",805,593,587,3,6,"PODEMOS-AHA",87
1,"1020",326,232,228,0,4,"PODEMOS-AHA",45
1,"1055",836,564,552,8,12,"PODEMOS-AHA",115
1,"1044",236,189,187,1,2,"PODEMOS-AHA",35
1,"1028",1077,759,753,6,6,"PODEMOS-AHA",166
1,"1009",1281,908,898,2,10,"PODEMOS-AHA",301
1,"1056",218,141,140,1,1,"PODEMOS-AHA",18
1,"1018",1370,964,963,4,1,"PODEMOS-AHA",228
1,"1002",8139,5961,5878,32,83,"PODEMOS-AHA",1685
1,"1021",460,336,332,1,4,"PODEMOS-AHA",61
1,"1004",1405,1026,1010,7,16,"PODEMOS-AHA",264
1,"1054",952,694,688,4,6,"PODEMOS-AHA",178
1,"1046",594,445,435,3,10,"PODEMOS-AHA",105
1,"1057",245,203,202,0,1,"PODEMOS-AHA",22
1,"1016",439,255,249,3,6,"PODEMOS-AHA",55
1,"1059",186354,135873,134633,948,1240,"PODEMOS-AHA",37065
1,"1063",1799,1320,1309,10,11,"PODEMOS-AHA",306
1,"1014",372,292,284,1,8,"PODEMOS-AHA",49
1,"1013",711,486,483,3,3,"PODEMOS-AHA",132
1,"1030",159,126,123,1,3,"PODEMOS-AHA",18
1,"1001",1984,1426,1405,8,21,"PODEMOS-AHA",449
1,"1039",202,161,156,0,5,"PODEMOS-AHA",42
1,"1051",3606,2413,2389,21,24,"PODEMOS-AHA",686
1,"1003",1186,842,833,19,9,"PODEMOS-AHA",122
1,"1017",869,584,577,4,7,"PODEMOS-AHA",101
1,"1058",1327,843,833,8,10,"PODEMOS-AHA",205
1,"1047",964,713,702,13,11,"PODEMOS-AHA",176
1,"1037",586,425,419,2,6,"PODEMOS-AHA",87
1,"1049",140,108,108,0,0,"PODEMOS-AHA",23
1,"1027",416,268,268,0,0,"PODEMOS-AHA",53
1,"1901",2344,1688,1669,17,19,"PODEMOS-AHA",495
1,"1053",587,367,365,3,2,"PODEMOS-AHA",97
1,"1033",649,512,508,5,4,"PODEMOS-AHA",65
1,"1043",2318,1644,1624,8,20,"PODEMOS-AHA",394
1,"1052",244,188,186,1,2,"PODEMOS-AHA",31
1,"1011",237,177,175,7,2,"PODEMOS-AHA",17
1,"1023",269,197,195,2,2,"PODEMOS-AHA",23
1,"1036",15034,10733,10619,73,114,"PODEMOS-AHA",2978
1,"1062",314,215,215,3,0,"PODEMOS-AHA",54
1,"1006",176,142,141,1,1,"PODEMOS-AHA",50
1,"1034",165,120,119,1,1,"PODEMOS-AHA",28
1,"1061",153,132,132,2,0,"PODEMOS-AHA",33
1,"1902",738,537,528,4,9,"PODEMOS-AHA",121
1,"1032",522,368,361,0,7,"PODEMOS-AHA",71
1,"1008",790,548,542,13,6,"PODEMOS-AHA",100
1,"1041",153,105,100,1,5,"PODEMOS-AHA",14
1,"1060",199,162,159,0,3,"PODEMOS-AHA",21
1,"1010",2275,1729,1717,17,12,"PODEMOS-AHA",449
39,"39095",2268,1812,1789,9,23,"IU-UPeC",103
39,"39051",67,62,61,1,1,"IU-UPeC",3
39,"39065",256,202,200,6,2,"IU-UPeC",3
39,"39102",2281,1647,1631,13,16,"IU-UPeC",65
39,"39079",8951,6734,6657,54,77,"IU-UPeC",170
39,"39022",987,735,730,7,5,"IU-UPeC",23
39,"39099",3117,2446,2406,23,40,"IU-UPeC",130
39,"39038",1463,1039,1030,6,9,"IU-UPeC",44
39,"39089",149,104,103,1,1,"IU-UPeC",3
39,"39071",405,277,272,2,5,"IU-UPeC",3
39,"39098",1422,1078,1074,11,4,"IU-UPeC",21
39,"39004",1539,1177,1160,12,17,"IU-UPeC",38
39,"39005",1396,1089,1084,4,5,"IU-UPeC",23
39,"39082",1658,1212,1202,15,10,"IU-UPeC",30
39,"39049",330,251,248,1,3,"IU-UPeC",7
39,"39097",713,409,400,10,9,"IU-UPeC",7
39,"39029",624,507,503,4,4,"IU-UPeC",16
39,"39054",4472,3478,3441,45,37,"IU-UPeC",143
39,"39068",659,486,479,2,7,"IU-UPeC",27
39,"39059",8057,6049,5972,50,77,"IU-UPeC",284
39,"39101",292,206,202,2,4,"IU-UPeC",6
39,"39027",3139,2493,2439,30,54,"IU-UPeC",128
39,"39003",299,219,217,0,2,"IU-UPeC",4
39,"39093",307,232,232,1,0,"IU-UPeC",10
39,"39064",1349,1036,1016,6,20,"IU-UPeC",38
39,"39017",571,385,377,2,8,"IU-UPeC",14
39,"39081",435,349,342,3,7,"IU-UPeC",6
39,"39006",1728,1353,1337,12,16,"IU-UPeC",22
39,"39045",376,284,276,1,8,"IU-UPeC",20
39,"39039",572,397,396,1,1,"IU-UPeC",2
39,"39076",3491,2696,2662,24,34,"IU-UPeC",129
39,"39084",843,608,604,5,4,"IU-UPeC",13
39,"39061",3488,2746,2722,29,24,"IU-UPeC",88
39,"39047",1978,1463,1448,15,15,"IU-UPeC",43
39,"39083",1139,747,739,6,8,"IU-UPeC",16
39,"39021",495,399,391,4,8,"IU-UPeC",16
39,"39031",1235,873,863,5,10,"IU-UPeC",27
39,"39042",5968,4614,4572,33,42,"IU-UPeC",166
39,"39016",23860,18608,18405,149,203,"IU-UPeC",933
39,"39057",2321,1773,1746,13,27,"IU-UPeC",60
39,"39046",1402,1015,985,11,30,"IU-UPeC",43
39,"39088",71,51,51,0,0,"IU-UPeC",4
39,"39014",898,655,644,8,11,"IU-UPeC",25
39,"39024",1882,1452,1438,14,14,"IU-UPeC",57
39,"39034",286,180,179,4,1,"IU-UPeC",2
39,"39019",2098,1669,1646,24,23,"IU-UPeC",60
39,"39094",854,644,637,9,7,"IU-UPeC",27
39,"39040",4290,3337,3309,22,28,"IU-UPeC",115
39,"39002",3313,2430,2391,17,39,"IU-UPeC",81
39,"39060",6705,5437,5339,46,98,"IU-UPeC",264
39,"39063",973,725,720,7,5,"IU-UPeC",16
39,"39072",343,213,213,1,0,"IU-UPeC",6
39,"39048",1697,1372,1361,10,11,"IU-UPeC",70
39,"39050",276,173,170,0,3,"IU-UPeC",3
39,"39007",434,298,297,1,1,"IU-UPeC",5
39,"39043",1468,1167,1151,10,16,"IU-UPeC",28
39,"39091",1947,1572,1552,9,20,"IU-UPeC",48
39,"39041",1764,1416,1395,10,21,"IU-UPeC",58
39,"39074",6905,5370,5288,52,82,"IU-UPeC",218
39,"39018",4211,3389,3329,27,60,"IU-UPeC",173
39,"39028",3733,2918,2877,17,41,"IU-UPeC",122
39,"39030",1894,1314,1290,9,24,"IU-UPeC",44
39,"39032",1476,1117,1100,8,17,"IU-UPeC",37
39,"39015",862,650,643,6,7,"IU-UPeC",10
39,"39092",916,668,663,4,5,"IU-UPeC",32
39,"39096",702,477,474,3,3,"IU-UPeC",14
39,"39025",8693,6696,6583,58,113,"IU-UPeC",362
39,"39053",219,135,135,1,0,"IU-UPeC",4
39,"39078",1413,1045,1032,10,13,"IU-UPeC",46
39,"39066",868,697,688,7,9,"IU-UPeC",25
39,"39067",813,569,561,5,8,"IU-UPeC",5
39,"39011",1602,1211,1202,13,9,"IU-UPeC",28
39,"39086",357,260,258,1,2,"IU-UPeC",5
39,"39090",756,564,550,4,14,"IU-UPeC",19
39,"39070",146,111,109,3,2,"IU-UPeC",11
39,"39069",1968,1586,1555,12,31,"IU-UPeC",96
39,"39012",6693,5213,5131,44,82,"IU-UPeC",350
39,"39058",831,594,592,6,2,"IU-UPeC",20
39,"39033",578,432,432,5,0,"IU-UPeC",10
39,"39077",246,186,182,0,4,"IU-UPeC",6
39,"39073",9806,7636,7574,42,62,"IU-UPeC",359
39,"39035",9587,7315,7214,56,101,"IU-UPeC",305
39,"39013",515,378,375,1,3,"IU-UPeC",7
39,"39052",18086,14014,13852,124,162,"IU-UPeC",635
39,"39044",3833,2889,2860,26,29,"IU-UPeC",121
39,"39023",6316,4900,4827,37,73,"IU-UPeC",163
39,"39026",1751,1303,1295,9,8,"IU-UPeC",35
39,"39075",137597,102862,102053,819,809,"IU-UPeC",4567
39,"39037",2003,1570,1547,8,23,"IU-UPeC",46
39,"39062",1824,1400,1392,14,8,"IU-UPeC",39
39,"39100",869,628,617,12,11,"IU-UPeC",12
39,"39001",2127,1651,1631,17,20,"IU-UPeC",66
39,"39009",3223,2395,2370,22,25,"IU-UPeC",86
39,"39085",6834,5319,5265,37,54,"IU-UPeC",199
39,"39020",23612,16515,16334,125,181,"IU-UPeC",667
39,"39080",3552,2734,2701,17,33,"IU-UPeC",128
39,"39055",1118,838,826,6,12,"IU-UPeC",30
39,"39087",42262,32560,32124,234,436,"IU-UPeC",1765
39,"39036",983,774,770,8,4,"IU-UPeC",30
39,"39008",13932,10600,10506,92,94,"IU-UPeC",634
39,"39010",639,509,505,5,4,"IU-UPeC",24
39,"39056",2326,1805,1775,17,30,"IU-UPeC",77
14,"14072",1079,834,830,5,4,"PODEMOS",67
14,"14045",3055,2486,2451,13,35,"PODEMOS",180
14,"14022",4036,3199,3169,9,30,"PODEMOS",554
14,"14023",2041,1742,1717,13,25,"PODEMOS",60
14,"14053",6050,4498,4427,56,71,"PODEMOS",760
14,"14029",4206,3170,3135,32,35,"PODEMOS",342
14,"14056",23613,17016,16804,128,212,"PODEMOS",2350
14,"14016",1364,1047,1045,3,2,"PODEMOS",65
14,"14075",581,463,446,6,17,"PODEMOS",56
14,"14038",32236,22982,22773,209,209,"PODEMOS",2633
14,"14015",2149,1637,1616,13,21,"PODEMOS",146
14,"14066",5890,4366,4322,29,44,"PODEMOS",646
14,"14032",425,347,335,3,12,"PODEMOS",15
14,"14049",16357,12206,12029,127,177,"PODEMOS",2066
14,"14051",1401,1095,1077,5,18,"PODEMOS",79
14,"14035",5992,4475,4437,44,38,"PODEMOS",198
14,"14026",2073,1437,1421,13,16,"PODEMOS",131
14,"14028",320,246,244,2,2,"PODEMOS",21
14,"14046",4484,3540,3487,22,53,"PODEMOS",532
14,"14063",1065,803,797,4,6,"PODEMOS",54
14,"14064",331,252,244,2,8,"PODEMOS",16
14,"14039",2628,2151,2123,11,28,"PODEMOS",203
14,"14007",15200,11064,10926,81,138,"PODEMOS",1379
14,"14027",7908,6085,6008,57,77,"PODEMOS",1261
14,"14031",597,490,484,0,6,"PODEMOS",41
14,"14021",260189,188939,187558,1934,1381,"PODEMOS",33072
14,"14055",18572,13587,13410,167,177,"PODEMOS",1689
14,"14065",1861,1461,1446,12,15,"PODEMOS",236
14,"14062",1052,813,801,4,12,"PODEMOS",61
14,"14004",2036,1502,1488,6,14,"PODEMOS",104
14,"14058",7973,5860,5791,49,69,"PODEMOS",586
14,"14033",1285,980,963,11,17,"PODEMOS",135
14,"14042",18921,14842,14653,184,189,"PODEMOS",2398
14,"14003",1265,981,970,6,11,"PODEMOS",68
14,"14037",3344,2476,2442,20,34,"PODEMOS",183
14,"14020",391,278,274,3,4,"PODEMOS",27
14,"14013",16845,12599,12414,146,185,"PODEMOS",1575
14,"14052",9447,6250,6201,49,49,"PODEMOS",716
14,"14059",699,559,552,5,7,"PODEMOS",45
14,"14036",3767,2911,2857,53,54,"PODEMOS",511
14,"14074",2303,1940,1929,13,11,"PODEMOS",148
14,"14001",3552,2861,2830,28,31,"PODEMOS",271
14,"14019",6479,5131,5076,46,55,"PODEMOS",722
14,"14041",3180,2404,2373,26,31,"PODEMOS",336
14,"14034",318,260,252,2,8,"PODEMOS",22
14,"14057",6152,4973,4903,56,70,"PODEMOS",796
14,"14011",584,477,476,3,1,"PODEMOS",20
14,"14047",1654,1221,1211,17,10,"PODEMOS",150
14,"14050",2399,1886,1864,11,22,"PODEMOS",269
14,"14054",13665,10923,10678,103,245,"PODEMOS",1156
14,"14073",2900,2068,2041,15,27,"PODEMOS",299
14,"14017",10869,8130,8029,72,101,"PODEMOS",1029
14,"14005",6358,4379,4272,56,107,"PODEMOS",826
14,"14006",1331,1166,1137,7,29,"PODEMOS",48
14,"14008",2871,2053,2034,11,19,"PODEMOS",157
14,"14071",937,651,642,2,9,"PODEMOS",49
14,"14040",3792,3036,3010,23,26,"PODEMOS",396
14,"14014",2570,2104,2075,8,29,"PODEMOS",218
14,"14069",7536,5574,5495,48,79,"PODEMOS",530
14,"14067",3874,3033,2986,29,47,"PODEMOS",361
14,"14018",3710,2882,2846,28,36,"PODEMOS",424
14,"14060",4854,3695,3633,43,62,"PODEMOS",484
14,"14024",1920,1522,1488,10,34,"PODEMOS",236
14,"14043",7574,5571,5510,46,61,"PODEMOS",499
14,"14025",2950,2460,2425,10,35,"PODEMOS",222
14,"14012",6190,4574,4488,27,86,"PODEMOS",699
14,"14044",1624,1285,1267,9,18,"PODEMOS",86
14,"14002",10951,8231,8150,72,81,"PODEMOS",1069
14,"14061",756,606,592,2,14,"PODEMOS",62
14,"14070",1343,1026,1008,9,18,"PODEMOS",48
14,"14010",4051,3003,2968,17,35,"PODEMOS",255
14,"14030",8580,6619,6542,66,77,"PODEMOS",995
14,"14048",1206,967,949,11,18,"PODEMOS",108
14,"14009",2779,1941,1934,13,7,"PODEMOS",149
14,"14068",545,410,407,6,3,"PODEMOS",51
44,"44077",75,58,57,0,1,"PODEMOS",6
44,"44043",108,75,75,1,0,"PODEMOS",10
44,"44099",708,514,510,1,4,"PODEMOS",76
44,"44120",222,140,138,2,2,"PODEMOS",19
44,"44201",497,414,410,2,4,"PODEMOS",73
44,"44258",69,46,46,0,0,"PODEMOS",3
44,"44112",426,293,284,2,9,"PODEMOS",32
44,"44220",121,85,82,2,3,"PODEMOS",8
44,"44206",112,90,88,0,2,"PODEMOS",17
44,"44268",28,24,24,0,0,"PODEMOS",5
44,"44216",26539,19621,19346,248,275,"PODEMOS",3071
44,"44016",486,361,357,7,4,"PODEMOS",34
44,"44034",138,112,110,2,2,"PODEMOS",12
44,"44203",10,8,8,0,0,"PODEMOS",0
44,"44169",351,268,266,3,2,"PODEMOS",28
44,"44247",314,230,228,2,2,"PODEMOS",44
44,"44260",139,100,98,2,2,"PODEMOS",6
44,"44071",599,430,424,8,6,"PODEMOS",87
44,"44209",839,640,623,3,17,"PODEMOS",72
44,"44148",93,76,76,3,0,"PODEMOS",9
44,"44041",54,46,46,2,0,"PODEMOS",8
44,"44161",447,324,320,3,4,"PODEMOS",32
44,"44128",69,50,50,0,0,"PODEMOS",5
44,"44243",23,18,18,0,0,"PODEMOS",2
44,"44003",19,16,16,0,0,"PODEMOS",1
44,"44225",111,76,76,4,0,"PODEMOS",17
44,"44082",91,68,67,0,1,"PODEMOS",9
44,"44210",759,597,596,2,1,"PODEMOS",93
44,"44122",1356,971,969,12,2,"PODEMOS",131
44,"44154",261,194,191,3,3,"PODEMOS",34
44,"44231",38,32,32,0,0,"PODEMOS",6
44,"44189",58,40,40,1,0,"PODEMOS",0
44,"44184",48,30,30,0,0,"PODEMOS",4
44,"44047",221,139,135,0,4,"PODEMOS",14
44,"44097",147,89,87,1,2,"PODEMOS",5
44,"44018",20,20,20,0,0,"PODEMOS",0
44,"44179",345,229,227,2,2,"PODEMOS",45
44,"44084",55,45,45,0,0,"PODEMOS",4
44,"44208",34,22,22,0,0,"PODEMOS",1
44,"44065",55,36,36,1,0,"PODEMOS",2
44,"44176",160,127,127,0,0,"PODEMOS",14
44,"44029",567,475,467,5,8,"PODEMOS",56
44,"44174",430,314,313,2,1,"PODEMOS",22
44,"44152",67,48,48,1,0,"PODEMOS",0
44,"44093",76,60,60,0,0,"PODEMOS",8
44,"44147",419,312,307,5,5,"PODEMOS",48
44,"44062",35,27,26,0,1,"PODEMOS",0
44,"44021",107,83,83,2,0,"PODEMOS",17
44,"44001",68,50,50,0,0,"PODEMOS",6
44,"44194",111,79,75,0,4,"PODEMOS",10
44,"44145",1029,768,763,7,5,"PODEMOS",127
44,"44024",27,23,23,0,0,"PODEMOS",0
44,"44190",72,53,52,0,1,"PODEMOS",4
44,"44262",137,107,107,1,0,"PODEMOS",13
44,"44085",52,40,40,4,0,"PODEMOS",0
44,"44125",65,39,39,0,0,"PODEMOS",3
44,"44221",365,298,296,2,2,"PODEMOS",62
44,"44117",347,278,274,2,4,"PODEMOS",26
44,"44232",391,286,279,4,7,"PODEMOS",27
44,"44116",83,67,65,1,2,"PODEMOS",3
44,"44044",91,70,70,0,0,"PODEMOS",5
44,"44218",37,26,26,0,0,"PODEMOS",3
44,"44150",32,21,20,0,1,"PODEMOS",0
44,"44196",134,102,102,1,0,"PODEMOS",12
44,"44226",141,102,100,2,2,"PODEMOS",16
44,"44185",104,77,77,0,0,"PODEMOS",7
44,"44080",292,221,218,4,3,"PODEMOS",42
44,"44119",135,94,90,2,4,"PODEMOS",22
44,"44027",161,122,121,4,1,"PODEMOS",17
44,"44025",6062,4490,4394,48,96,"PODEMOS",894
44,"44068",664,519,515,4,4,"PODEMOS",72
44,"44012",336,279,276,2,3,"PODEMOS",28
44,"44094",113,102,100,1,2,"PODEMOS",8
44,"44045",355,290,286,2,4,"PODEMOS",35
44,"44236",59,45,45,0,0,"PODEMOS",7
44,"44017",285,221,220,0,1,"PODEMOS",23
44,"44004",415,295,291,3,4,"PODEMOS",59
44,"44088",30,26,26,2,0,"PODEMOS",0
44,"44127",73,51,50,0,1,"PODEMOS",8
44,"44163",128,94,94,0,0,"PODEMOS",14
44,"44207",158,119,115,0,4,"PODEMOS",15
44,"44060",40,35,35,1,0,"PODEMOS",4
44,"44056",513,348,341,4,7,"PODEMOS",21
44,"44105",80,62,62,0,0,"PODEMOS",9
44,"44061",71,57,54,1,3,"PODEMOS",5
44,"44193",82,62,62,1,0,"PODEMOS",16
44,"44137",205,159,159,2,0,"PODEMOS",16
44,"44157",65,41,40,0,1,"PODEMOS",2
44,"44224",22,14,14,0,0,"PODEMOS",2
44,"44212",41,32,32,0,0,"PODEMOS",3
44,"44106",159,127,126,3,1,"PODEMOS",26
44,"44076",2234,1759,1729,16,30,"PODEMOS",251
44,"44126",334,239,235,7,4,"PODEMOS",40
44,"44141",135,105,104,1,1,"PODEMOS",21
44,"44019",68,49,48,1,1,"PODEMOS",4
44,"44199",43,36,36,1,0,"PODEMOS",4
44,"44238",2345,1743,1729,7,14,"PODEMOS",301
44,"44002",54,41,41,0,0,"PODEMOS",12
44,"44109",110,76,74,1,2,"PODEMOS",8
44,"44113",72,50,50,0,0,"PODEMOS",24
44,"44195",92,61,61,2,0,"PODEMOS",0
44,"44033",279,193,191,2,2,"PODEMOS",19
44,"44222",137,96,96,0,0,"PODEMOS",11
44,"44213",63,47,47,0,0,"PODEMOS",1
44,"44261",734,552,542,8,10,"PODEMOS",68
44,"44131",26,20,20,0,0,"PODEMOS",3
44,"44038",107,83,83,2,0,"PODEMOS",13
44,"44020",24,20,19,1,1,"PODEMOS",0
44,"44219",198,141,134,4,7,"PODEMOS",16
44,"44046",48,31,31,2,0,"PODEMOS",2
44,"44159",39,34,34,0,0,"PODEMOS",4
44,"44087",81,70,70,3,0,"PODEMOS",9
44,"44223",75,55,55,2,0,"PODEMOS",13
44,"44054",109,90,90,0,0,"PODEMOS",16
44,"44266",118,95,95,0,0,"PODEMOS",0
44,"44227",75,63,63,0,0,"PODEMOS",3
44,"44215",156,105,103,2,2,"PODEMOS",30
44,"44008",1615,1217,1200,7,17,"PODEMOS",168
44,"44051",2704,2074,2046,32,28,"PODEMOS",262
44,"44039",219,162,160,2,2,"PODEMOS",8
44,"44241",537,408,403,2,5,"PODEMOS",72
44,"44048",65,51,51,0,0,"PODEMOS",4
44,"44246",1554,1091,1079,13,12,"PODEMOS",219
44,"44013",11254,8292,8205,82,87,"PODEMOS",1508
44,"44263",369,265,259,2,6,"PODEMOS",47
44,"44165",184,153,152,1,1,"PODEMOS",17
44,"44035",117,81,81,0,0,"PODEMOS",12
44,"44121",60,43,43,0,0,"PODEMOS",4
44,"44014",2530,2008,1966,17,42,"PODEMOS",354
44,"44180",71,57,56,1,1,"PODEMOS",1
44,"44167",38,31,31,0,0,"PODEMOS",4
44,"44130",34,24,24,0,0,"PODEMOS",1
44,"44090",82,57,57,0,0,"PODEMOS",5
44,"44177",111,77,76,1,1,"PODEMOS",13
44,"44096",161,141,139,0,2,"PODEMOS",30
44,"44217",28,20,20,0,0,"PODEMOS",2
44,"44101",59,44,44,0,0,"PODEMOS",5
44,"44010",178,124,121,2,3,"PODEMOS",14
44,"44064",70,51,51,0,0,"PODEMOS",5
44,"44067",117,80,80,0,0,"PODEMOS",17
44,"44181",78,63,63,1,0,"PODEMOS",5
44,"44228",99,79,79,1,0,"PODEMOS",3
44,"44114",244,186,185,3,1,"PODEMOS",36
44,"44230",155,126,126,2,0,"PODEMOS",22
44,"44028",191,150,142,1,8,"PODEMOS",11
44,"44142",36,27,27,5,0,"PODEMOS",5
44,"44158",1170,898,872,12,26,"PODEMOS",103
44,"44011",57,35,35,0,0,"PODEMOS",0
44,"44075",324,256,250,4,6,"PODEMOS",16
44,"44151",191,147,145,1,2,"PODEMOS",33
44,"44192",364,280,278,0,2,"PODEMOS",15
44,"44144",351,256,252,1,4,"PODEMOS",30
44,"44107",216,162,162,1,0,"PODEMOS",37
44,"44257",167,120,120,1,0,"PODEMOS",16
44,"44244",75,39,39,0,0,"PODEMOS",3
44,"44143",388,310,309,3,1,"PODEMOS",32
44,"44138",140,79,77,0,2,"PODEMOS",11
44,"44124",78,58,58,1,0,"PODEMOS",5
44,"44023",18,15,15,0,0,"PODEMOS",0
44,"44129",41,34,34,0,0,"PODEMOS",7
44,"44055",69,52,51,3,1,"PODEMOS",5
44,"44153",1812,1209,1196,15,13,"PODEMOS",204
44,"44267",71,50,50,0,0,"PODEMOS",5
44,"44237",408,327,321,2,6,"PODEMOS",45
44,"44250",19,12,12,2,0,"PODEMOS",1
44,"44175",121,91,89,2,2,"PODEMOS",8
44,"44026",90,71,71,0,0,"PODEMOS",9
44,"44092",80,53,52,0,1,"PODEMOS",1
44,"44146",173,157,157,1,0,"PODEMOS",13
44,"44211",40,30,30,0,0,"PODEMOS",2
44,"44172",310,216,216,6,0,"PODEMOS",21
44,"44037",453,326,321,5,5,"PODEMOS",77
44,"44036",24,16,16,0,0,"PODEMOS",1
44,"44086",453,355,350,3,5,"PODEMOS",65
44,"44234",62,48,48,1,0,"PODEMOS",10
44,"44059",541,431,423,7,8,"PODEMOS",34
44,"44173",101,85,84,0,1,"PODEMOS",14
44,"44022",490,323,316,9,7,"PODEMOS",57
44,"44007",184,124,120,0,4,"PODEMOS",4
44,"44063",78,61,61,0,0,"PODEMOS",17
44,"44050",3129,2135,2103,30,32,"PODEMOS",263
44,"44110",52,46,44,0,2,"PODEMOS",1
44,"44074",430,338,329,5,9,"PODEMOS",27
44,"44049",850,624,613,8,11,"PODEMOS",76
44,"44197",58,34,34,0,0,"PODEMOS",4
44,"44256",39,34,34,1,0,"PODEMOS",4
44,"44235",91,71,70,2,1,"PODEMOS",8
44,"44006",250,188,186,1,2,"PODEMOS",22
44,"44187",199,148,143,1,5,"PODEMOS",16
44,"44155",1102,831,825,7,6,"PODEMOS",153
44,"44204",25,22,22,0,0,"PODEMOS",2
44,"44066",110,83,83,1,0,"PODEMOS",4
44,"44245",250,189,186,1,3,"PODEMOS",27
44,"44005",54,38,37,2,1,"PODEMOS",1
44,"44123",105,69,69,1,0,"PODEMOS",11
44,"44108",331,238,234,4,4,"PODEMOS",61
44,"44042",127,93,92,1,1,"PODEMOS",14
44,"44089",46,42,42,0,0,"PODEMOS",3
44,"44118",165,127,125,2,2,"PODEMOS",7
44,"44032",16,13,13,0,0,"PODEMOS",2
44,"44239",22,20,20,0,0,"PODEMOS",3
44,"44103",130,106,106,0,0,"PODEMOS",13
44,"44251",254,202,194,2,8,"PODEMOS",3
44,"44240",161,128,125,0,3,"PODEMOS",9
44,"44164",26,22,22,0,0,"PODEMOS",3
44,"44205",712,474,468,6,6,"PODEMOS",49
44,"44171",183,136,135,1,1,"PODEMOS",70
44,"44009",809,586,578,5,8,"PODEMOS",109
44,"44135",115,89,86,0,3,"PODEMOS",4
44,"44198",187,151,148,3,3,"PODEMOS",4
44,"44249",57,47,47,3,0,"PODEMOS",4
44,"44182",194,155,154,3,1,"PODEMOS",10
44,"44053",102,79,73,0,6,"PODEMOS",2
44,"44031",99,64,64,0,0,"PODEMOS",4
44,"44149",99,71,71,3,0,"PODEMOS",12
44,"44191",771,595,586,7,9,"PODEMOS",81
44,"44160",478,329,322,5,7,"PODEMOS",45
44,"44052",80,55,54,0,1,"PODEMOS",5
44,"44133",23,17,17,0,0,"PODEMOS",2
44,"44132",61,50,50,1,0,"PODEMOS",2
44,"44070",55,47,46,1,1,"PODEMOS",1
44,"44040",202,160,158,3,2,"PODEMOS",17
44,"44252",85,67,66,0,1,"PODEMOS",5
44,"44229",151,108,107,1,1,"PODEMOS",24
44,"44136",49,42,42,1,0,"PODEMOS",2
44,"44183",77,45,44,0,1,"PODEMOS",5
44,"44178",56,42,42,0,0,"PODEMOS",2
44,"44102",31,25,25,0,0,"PODEMOS",1
44,"44265",188,144,138,2,6,"PODEMOS",6
44,"44264",253,211,210,2,1,"PODEMOS",25
44,"44168",191,137,131,3,6,"PODEMOS",11
44,"44111",92,69,69,0,0,"PODEMOS",9
44,"44100",187,154,153,0,1,"PODEMOS",37
44,"44115",106,93,92,4,1,"PODEMOS",28
44,"44200",40,22,22,0,0,"PODEMOS",1
44,"44156",46,33,32,1,1,"PODEMOS",2
35,"35026",80806,53749,52665,450,1084,"RECORTES CE",157
35,"35032",3432,2541,2498,19,43,"RECORTES CE",0
35,"35019",32253,19902,19621,126,281,"RECORTES CE",50
35,"35015",9870,5451,5368,29,83,"RECORTES CE",12
35,"35024",13621,8665,8555,76,110,"RECORTES CE",8
35,"35010",3548,2371,2336,20,35,"RECORTES CE",2
35,"35028",9705,5552,5478,64,74,"RECORTES CE",14
35,"35014",11169,6234,6107,59,127,"RECORTES CE",11
35,"35029",4125,2545,2514,34,31,"RECORTES CE",6
35,"35005",1071,718,711,6,7,"RECORTES CE",0
35,"35012",10331,5684,5610,32,74,"RECORTES CE",14
35,"35023",11680,8467,8295,75,172,"RECORTES CE",17
35,"35027",10311,7497,7364,58,133,"RECORTES CE",16
35,"35008",6109,4631,4542,37,89,"RECORTES CE",12
35,"35013",6609,4997,4881,51,116,"RECORTES CE",1
35,"35033",6378,4412,4354,24,58,"RECORTES CE",13
35,"35016",297974,198159,195935,1546,2224,"RECORTES CE",702
35,"35011",23882,16369,16095,107,274,"RECORTES CE",44
35,"35020",6054,4073,4018,26,55,"RECORTES CE",1
35,"35018",12463,7628,7546,56,82,"RECORTES CE",13
35,"35001",4599,3455,3396,27,59,"RECORTES CE",6
35,"35006",30302,21967,21625,243,342,"RECORTES CE",57
35,"35009",19832,14305,14036,97,269,"RECORTES CE",22
35,"35004",38814,20869,20641,192,228,"RECORTES CE",32
35,"35031",7270,5184,5000,36,184,"RECORTES CE",18
35,"35017",25447,15415,15079,127,336,"RECORTES CE",24
35,"35007",515,332,330,2,2,"RECORTES CE",2
35,"35021",14942,10691,10537,80,154,"RECORTES CE",19
35,"35034",7707,3921,3872,30,49,"RECORTES CE",14
35,"35022",48059,30474,30134,219,340,"RECORTES CE",127
35,"35003",5125,2989,2929,21,60,"RECORTES CE",6
35,"35030",9205,5602,5501,58,101,"RECORTES CE",6
35,"35002",23129,15904,15675,74,229,"RECORTES CE",45
35,"35025",1801,1239,1216,9,23,"RECORTES CE",2
32,"32033",750,504,500,4,4,"UPYD",6
32,"32021",956,664,662,2,2,"UPYD",1
32,"32014",1170,855,845,7,10,"UPYD",1
32,"32057",575,414,412,5,2,"UPYD",0
32,"32072",3833,2799,2761,26,38,"UPYD",8
32,"32041",772,511,505,5,6,"UPYD",2
32,"32045",2484,1820,1795,19,25,"UPYD",9
32,"32022",1377,963,951,7,12,"UPYD",2
32,"32060",845,609,598,6,11,"UPYD",3
32,"32082",1259,905,887,6,18,"UPYD",0
32,"32026",2736,2039,1998,25,41,"UPYD",9
32,"32079",1343,1000,987,9,13,"UPYD",1
32,"32044",900,658,647,5,11,"UPYD",2
32,"32077",1188,813,796,8,17,"UPYD",5
32,"32062",832,646,644,7,2,"UPYD",0
32,"32050",2455,1874,1855,17,19,"UPYD",2
32,"32001",4978,3644,3607,31,37,"UPYD",13
32,"32065",669,494,482,3,12,"UPYD",4
32,"32083",860,580,574,4,6,"UPYD",1
32,"32046",1179,840,832,5,8,"UPYD",2
32,"32013",2213,1447,1431,8,16,"UPYD",6
32,"32017",1272,862,849,5,13,"UPYD",1
32,"32054",87290,63653,62823,671,830,"UPYD",370
32,"32019",11529,8038,7906,78,132,"UPYD",25
32,"32080",333,266,265,0,1,"UPYD",0
32,"32090",791,558,556,2,2,"UPYD",1
32,"32005",869,676,671,7,5,"UPYD",0
32,"32084",925,657,650,3,7,"UPYD",0
32,"32037",742,544,532,8,12,"UPYD",2
32,"32006",1571,1140,1127,10,13,"UPYD",1
32,"32085",10709,7489,7403,81,86,"UPYD",26
32,"32069",4333,3324,3261,25,63,"UPYD",14
32,"32091",1909,1389,1375,8,14,"UPYD",2
32,"32086",2671,1731,1712,10,19,"UPYD",5
32,"32040",1472,1112,1089,9,23,"UPYD",3
32,"32009",10783,7555,7468,60,87,"UPYD",38
32,"32002",2016,1474,1460,11,14,"UPYD",7
32,"32010",394,299,298,0,1,"UPYD",1
32,"32087",1798,1421,1397,7,24,"UPYD",0
32,"32038",456,299,297,2,2,"UPYD",2
32,"32081",2097,1566,1553,6,13,"UPYD",1
32,"32028",1643,1195,1174,18,21,"UPYD",0
32,"32036",1369,1053,1040,5,13,"UPYD",7
32,"32068",1424,974,969,8,5,"UPYD",3
32,"32030",1015,702,689,3,13,"UPYD",2
32,"32032",8101,5993,5881,74,112,"UPYD",17
32,"32071",1496,1013,1004,1,9,"UPYD",1
32,"32008",8188,5923,5845,44,78,"UPYD",24
32,"32018",1261,956,945,3,11,"UPYD",2
32,"32016",825,559,556,3,3,"UPYD",1
32,"32076",2121,1509,1489,12,20,"UPYD",7
32,"32055",1310,952,936,7,16,"UPYD",3
32,"32052",1904,1450,1426,6,24,"UPYD",4
32,"32092",528,337,334,4,3,"UPYD",0
32,"32051",1458,1141,1137,4,4,"UPYD",1
32,"32047",1818,1345,1329,3,16,"UPYD",2
32,"32074",1064,731,719,4,12,"UPYD",1
32,"32004",1826,900,897,8,3,"UPYD",0
32,"32029",480,349,346,5,3,"UPYD",0
32,"32073",1332,976,965,4,11,"UPYD",6
32,"32066",567,435,434,2,1,"UPYD",0
32,"32088",1632,1062,1042,8,20,"UPYD",5
32,"32011",934,559,548,5,11,"UPYD",2
32,"32049",775,502,495,5,7,"UPYD",1
32,"32034",1141,880,873,4,7,"UPYD",2
32,"32031",1079,826,812,5,14,"UPYD",0
32,"32024",4839,3424,3368,35,56,"UPYD",15
32,"32035",1484,944,938,7,6,"UPYD",1
32,"32027",1072,765,747,3,18,"UPYD",2
32,"32053",1447,1140,1128,12,12,"UPYD",1
32,"32061",1093,852,840,3,12,"UPYD",2
32,"32003",886,661,653,6,8,"UPYD",0
32,"32089",1332,917,904,5,13,"UPYD",3
32,"32015",899,586,581,5,5,"UPYD",2
32,"32042",1585,1120,1104,13,16,"UPYD",1
32,"32058",5209,3808,3750,27,58,"UPYD",17
32,"32064",526,397,395,1,2,"UPYD",1
32,"32048",906,573,564,6,9,"UPYD",1
32,"32025",1094,821,809,3,12,"UPYD",2
32,"32078",1243,876,869,6,7,"UPYD",1
32,"32007",1527,1078,1070,7,8,"UPYD",1
32,"32039",1275,989,976,5,13,"UPYD",0
32,"32070",566,335,330,3,5,"UPYD",0
32,"32075",4188,3257,3206,43,51,"UPYD",9
32,"32067",1300,838,824,15,14,"UPYD",4
32,"32056",1610,1159,1146,9,13,"UPYD",2
32,"32023",1217,884,877,6,7,"UPYD",0
32,"32020",2625,1997,1974,10,23,"UPYD",2
32,"32063",1939,1329,1314,16,15,"UPYD",7
32,"32043",2555,1824,1793,15,31,"UPYD",2
32,"32012",811,535,533,3,2,"UPYD",3
32,"32059",1849,1357,1339,16,18,"UPYD",2
33,"33023",3315,2295,2267,35,28,"RECORTES CE",3
33,"33013",456,336,331,6,5,"RECORTES CE",0
33,"33028",1289,685,682,9,3,"RECORTES CE",0
33,"33014",9101,6398,6352,46,46,"RECORTES CE",16
33,"33036",11572,8208,8133,80,75,"RECORTES CE",17
33,"33040",4564,3125,3091,28,34,"RECORTES CE",6
33,"33071",617,459,452,8,7,"RECORTES CE",0
33,"33011",11373,6279,6214,104,65,"RECORTES CE",7
33,"33030",899,689,687,10,2,"RECORTES CE",0
33,"33008",1808,1268,1247,6,21,"RECORTES CE",1
33,"33077",1220,849,840,11,9,"RECORTES CE",2
33,"33009",899,606,601,4,5,"RECORTES CE",2
33,"33020",13297,9527,9445,86,82,"RECORTES CE",8
33,"33066",43034,29901,29610,261,291,"RECORTES CE",53
33,"33033",9943,6851,6803,61,48,"RECORTES CE",9
33,"33039",1672,1261,1257,14,4,"RECORTES CE",0
33,"33005",1479,945,932,12,13,"RECORTES CE",0
33,"33054",1688,1159,1146,8,13,"RECORTES CE",3
33,"33025",9261,6116,6062,58,54,"RECORTES CE",6
33,"33064",231,181,179,4,2,"RECORTES CE",0
33,"33055",1511,1150,1129,9,21,"RECORTES CE",1
33,"33021",4576,3133,3090,33,43,"RECORTES CE",1
33,"33027",849,544,543,8,1,"RECORTES CE",1
33,"33074",3523,2422,2390,36,32,"RECORTES CE",1
33,"33035",11299,8048,7981,67,67,"RECORTES CE",6
33,"33041",7270,5138,5093,53,45,"RECORTES CE",7
33,"33044",178724,130938,130010,1254,928,"RECORTES CE",217
33,"33068",1114,627,623,2,4,"RECORTES CE",0
33,"33048",156,99,99,2,0,"RECORTES CE",0
33,"33001",1622,867,852,16,15,"RECORTES CE",0
33,"33017",3180,2196,2168,30,28,"RECORTES CE",2
33,"33067",785,608,598,5,10,"RECORTES CE",0
33,"33042",4316,3143,3105,35,38,"RECORTES CE",2
33,"33065",1109,743,735,16,8,"RECORTES CE",1
33,"33076",12270,8265,8203,89,62,"RECORTES CE",7
33,"33058",1821,1319,1305,10,14,"RECORTES CE",1
33,"33022",906,604,599,3,5,"RECORTES CE",1
33,"33006",1556,1043,1036,17,7,"RECORTES CE",1
33,"33052",730,517,512,1,5,"RECORTES CE",0
33,"33032",11483,8036,7921,82,115,"RECORTES CE",8
33,"33026",8621,5600,5555,71,45,"RECORTES CE",36
33,"33029",363,199,198,1,1,"RECORTES CE",0
33,"33007",1524,991,980,10,11,"RECORTES CE",1
33,"33004",67136,48699,48354,389,345,"RECORTES CE",81
33,"33051",7167,4810,4772,57,38,"RECORTES CE",5
33,"33047",1126,868,861,12,7,"RECORTES CE",0
33,"33016",19201,14177,14074,115,103,"RECORTES CE",18
33,"33031",35453,23848,23595,242,253,"RECORTES CE",26
33,"33049",6388,4229,4182,48,47,"RECORTES CE",6
33,"33053",1157,767,762,12,5,"RECORTES CE",1
33,"33060",14750,10307,10206,82,101,"RECORTES CE",9
33,"33019",3094,2079,2054,15,25,"RECORTES CE",2
33,"33063",419,330,326,1,4,"RECORTES CE",0
33,"33046",508,375,365,4,10,"RECORTES CE",1
33,"33038",2298,1690,1675,12,15,"RECORTES CE",4
33,"33034",10693,6796,6725,72,71,"RECORTES CE",45
33,"33072",1601,1012,1002,4,10,"RECORTES CE",1
33,"33018",2896,2068,2041,18,27,"RECORTES CE",4
33,"33024",227211,166618,165475,1240,1143,"RECORTES CE",312
33,"33062",409,242,239,1,3,"RECORTES CE",0
33,"33012",5230,3595,3568,27,27,"RECORTES CE",5
33,"33075",275,161,155,2,6,"RECORTES CE",0
33,"33043",682,465,460,2,5,"RECORTES CE",0
33,"33010",1828,1220,1215,16,5,"RECORTES CE",2
33,"33070",3347,2473,2441,31,32,"RECORTES CE",2
33,"33045",4503,3249,3216,26,33,"RECORTES CE",6
33,"33078",147,98,98,0,0,"RECORTES CE",0
33,"33059",4702,3228,3185,42,43,"RECORTES CE",0
33,"33002",10122,7056,6977,55,79,"RECORTES CE",4
33,"33050",603,374,357,0,17,"RECORTES CE",0
33,"33056",5015,3435,3405,32,30,"RECORTES CE",3
33,"33057",1593,1134,1123,17,11,"RECORTES CE",2
33,"33061",379,194,190,1,4,"RECORTES CE",1
33,"33069",3513,2577,2554,15,23,"RECORTES CE",1
33,"33073",8631,5015,4948,47,67,"RECORTES CE",2
33,"33037",34841,24271,24054,200,217,"RECORTES CE",37
33,"33015",1561,1042,1031,8,11,"RECORTES CE",1
33,"33003",665,386,384,7,2,"RECORTES CE",0
45,"45182",1045,854,844,3,10,"PCPE",0
45,"45051",1594,1264,1248,6,16,"PCPE",2
45,"45161",13474,9618,9496,63,122,"PCPE",8
45,"45063",428,320,310,2,10,"PCPE",1
45,"45186",3083,2369,2341,14,28,"PCPE",2
45,"45104",440,345,341,1,4,"PCPE",1
45,"45079",367,285,285,3,0,"PCPE",0
45,"45198",1832,1521,1508,6,13,"PCPE",1
45,"45111",60,47,47,0,0,"PCPE",0
45,"45152",597,476,476,2,0,"PCPE",0
45,"45100",197,166,164,2,2,"PCPE",1
45,"45194",67,50,49,0,1,"PCPE",0
45,"45091",407,301,299,2,2,"PCPE",2
45,"45047",2563,1775,1751,13,24,"PCPE",1
45,"45087",8345,6184,6091,34,93,"PCPE",4
45,"45128",2498,1794,1774,7,20,"PCPE",1
45,"45015",622,461,455,2,6,"PCPE",1
45,"45203",2574,1938,1908,10,30,"PCPE",4
45,"45120",134,105,105,1,0,"PCPE",0
45,"45124",2156,1750,1712,16,38,"PCPE",2
45,"45038",3335,2525,2490,8,35,"PCPE",2
45,"45022",392,297,293,8,4,"PCPE",0
45,"45106",7524,5882,5784,55,98,"PCPE",5
45,"45028",3680,2919,2880,23,39,"PCPE",4
45,"45181",2313,1755,1728,12,27,"PCPE",0
45,"45059",1723,1413,1388,4,25,"PCPE",0
45,"45075",146,108,105,0,3,"PCPE",0
45,"45097",1047,877,869,3,8,"PCPE",0
45,"45003",572,431,423,1,8,"PCPE",0
45,"45136",5859,4249,4177,24,72,"PCPE",1
45,"45013",1786,1428,1412,7,16,"PCPE",0
45,"45076",574,382,378,1,4,"PCPE",0
45,"45001",1852,1395,1355,9,40,"PCPE",0
45,"45166",1629,1345,1332,5,13,"PCPE",0
45,"45113",1948,1409,1386,14,23,"PCPE",0
45,"45132",2096,1631,1616,7,15,"PCPE",3
45,"45103",397,325,322,0,3,"PCPE",0
45,"45140",1093,885,876,4,9,"PCPE",1
45,"45123",3075,2261,2222,11,39,"PCPE",1
45,"45056",2210,1384,1370,11,14,"PCPE",1
45,"45126",260,169,167,1,2,"PCPE",0
45,"45114",595,461,457,1,4,"PCPE",0
45,"45183",2253,1581,1569,8,12,"PCPE",0
45,"45067",2324,1871,1841,13,30,"PCPE",1
45,"45049",435,330,326,0,4,"PCPE",0
45,"45080",6,6,6,0,0,"PCPE",0
45,"45034",1360,1098,1083,4,15,"PCPE",2
45,"45037",1635,1216,1202,4,14,"PCPE",0
45,"45189",597,467,458,2,9,"PCPE",0
45,"45121",6766,4860,4798,30,62,"PCPE",3
45,"45027",362,275,270,0,5,"PCPE",1
45,"45009",545,336,333,1,3,"PCPE",0
45,"45109",2913,2295,2218,16,77,"PCPE",0
45,"45026",225,171,169,1,2,"PCPE",0
45,"45014",3984,2824,2802,24,22,"PCPE",2
45,"45023",2160,1669,1654,9,15,"PCPE",1
45,"45045",1316,945,935,1,10,"PCPE",2
45,"45008",142,114,114,2,0,"PCPE",1
45,"45138",1110,903,887,6,16,"PCPE",0
45,"45057",221,187,182,0,5,"PCPE",1
45,"45032",436,317,313,0,4,"PCPE",0
45,"45119",3348,2306,2264,14,42,"PCPE",6
45,"45042",190,145,145,0,0,"PCPE",0
45,"45071",1863,1550,1530,8,20,"PCPE",1
45,"45019",7356,5539,5484,35,55,"PCPE",14
45,"45062",1121,910,894,10,16,"PCPE",0
45,"45187",4078,3405,3353,14,52,"PCPE",6
45,"45145",2539,1830,1811,11,19,"PCPE",0
45,"45116",694,531,523,2,8,"PCPE",1
45,"45190",483,397,387,2,10,"PCPE",0
45,"45112",1939,1302,1268,6,34,"PCPE",4
45,"45115",2563,2089,2048,5,41,"PCPE",3
45,"45176",3665,2747,2712,15,35,"PCPE",1
45,"45083",465,393,388,5,5,"PCPE",0
45,"45033",351,253,247,3,6,"PCPE",0
45,"45197",1921,1500,1480,12,20,"PCPE",7
45,"45089",1516,1157,1139,6,18,"PCPE",0
45,"45017",262,221,219,0,2,"PCPE",0
45,"45005",241,207,205,2,2,"PCPE",0
45,"45055",1032,857,841,2,16,"PCPE",0
45,"45053",8045,6446,6370,44,76,"PCPE",2
45,"45101",3761,3090,3048,15,42,"PCPE",1
45,"45065",276,227,223,0,4,"PCPE",0
45,"45130",319,258,252,1,6,"PCPE",0
45,"45072",670,499,499,2,0,"PCPE",0
45,"45031",2723,1935,1896,10,39,"PCPE",3
45,"45010",436,335,333,2,2,"PCPE",0
45,"45129",136,100,97,0,3,"PCPE",0
45,"45007",697,566,560,1,6,"PCPE",0
45,"45107",3238,2628,2597,15,31,"PCPE",1
45,"45035",298,225,221,2,4,"PCPE",2
45,"45002",2549,1810,1784,7,26,"PCPE",0
45,"45137",1623,1106,1093,9,13,"PCPE",1
45,"45172",719,559,556,2,3,"PCPE",0
45,"45088",2102,1438,1423,4,15,"PCPE",6
45,"45160",1111,908,895,6,13,"PCPE",0
45,"45144",794,643,640,2,3,"PCPE",0
45,"45162",683,515,510,0,5,"PCPE",0
45,"45085",1501,1086,1067,6,19,"PCPE",3
45,"45098",2186,1686,1649,10,37,"PCPE",0
45,"45196",1388,1066,1054,13,12,"PCPE",1
45,"45118",2002,1470,1456,3,14,"PCPE",3
45,"45191",549,477,475,0,2,"PCPE",0
45,"45110",1799,1394,1380,4,14,"PCPE",0
45,"45134",1600,1214,1200,4,14,"PCPE",1
45,"45175",665,541,532,5,9,"PCPE",0
45,"45048",360,281,277,1,4,"PCPE",0
45,"45174",309,247,247,1,0,"PCPE",0
45,"45077",542,428,423,0,5,"PCPE",0
45,"45195",2161,1709,1686,12,23,"PCPE",2
45,"45164",186,160,160,0,0,"PCPE",0
45,"45066",7589,5716,5637,30,79,"PCPE",3
45,"45167",1458,1197,1187,5,10,"PCPE",3
45,"45099",3512,2514,2459,9,55,"PCPE",2
45,"45058",384,304,301,4,3,"PCPE",0
45,"45168",62226,48889,48446,327,443,"PCPE",33
45,"45131",287,242,242,0,0,"PCPE",0
45,"45156",3441,2863,2825,13,38,"PCPE",3
45,"45169",193,136,136,1,0,"PCPE",0
45,"45095",697,529,520,1,9,"PCPE",0
45,"45012",670,521,506,4,15,"PCPE",0
45,"45201",3450,2212,2173,14,39,"PCPE",4
45,"45150",454,366,364,1,2,"PCPE",0
45,"45177",2142,1757,1731,11,26,"PCPE",1
45,"45202",3905,2962,2920,12,42,"PCPE",2
45,"45068",173,138,135,0,3,"PCPE",0
45,"45006",1425,1022,1013,4,9,"PCPE",1
45,"45173",9477,7145,7061,40,84,"PCPE",6
45,"45117",754,610,602,2,8,"PCPE",0
45,"45060",179,131,129,1,2,"PCPE",0
45,"45105",405,284,279,3,5,"PCPE",0
45,"45082",1246,1046,1036,9,10,"PCPE",1
45,"45125",2329,1920,1898,10,22,"PCPE",1
45,"45122",5164,4112,4067,18,45,"PCPE",3
45,"45154",1483,1114,1107,5,7,"PCPE",3
45,"45041",3725,2698,2665,18,33,"PCPE",6
45,"45081",17646,13309,13166,72,143,"PCPE",3
45,"45073",307,238,235,0,3,"PCPE",0
45,"45158",2534,1885,1868,8,17,"PCPE",1
45,"45040",1396,871,862,4,9,"PCPE",1
45,"45193",626,543,530,2,13,"PCPE",1
45,"45050",471,354,351,2,3,"PCPE",1
45,"45180",2725,2060,2028,7,32,"PCPE",3
45,"45086",503,375,369,3,6,"PCPE",1
45,"45084",2280,1777,1747,12,30,"PCPE",0
45,"45155",371,297,296,1,1,"PCPE",0
45,"45133",2818,2184,2146,19,38,"PCPE",2
45,"45090",376,299,295,4,4,"PCPE",0
45,"45004",568,436,430,1,6,"PCPE",0
45,"45029",205,169,169,0,0,"PCPE",0
45,"45135",4302,3509,3453,21,56,"PCPE",2
45,"45185",7734,6057,5973,27,84,"PCPE",4
45,"45070",1461,1223,1202,7,21,"PCPE",1
45,"45108",521,415,414,2,1,"PCPE",0
45,"45153",1613,1263,1248,11,15,"PCPE",1
45,"45143",1180,924,912,3,12,"PCPE",1
45,"45093",151,117,117,0,0,"PCPE",0
45,"45146",108,85,85,0,0,"PCPE",0
45,"45141",897,735,727,4,8,"PCPE",0
45,"45024",1075,828,824,5,4,"PCPE",0
45,"45078",1392,1187,1179,8,8,"PCPE",1
45,"45184",201,124,123,1,1,"PCPE",0
45,"45011",288,246,241,1,5,"PCPE",1
45,"45199",2963,2055,2027,5,28,"PCPE",2
45,"45039",226,197,193,1,4,"PCPE",0
45,"45030",482,364,361,4,3,"PCPE",0
45,"45179",546,406,403,3,3,"PCPE",2
45,"45142",7858,6249,6164,57,85,"PCPE",2
45,"45165",62857,46607,46141,313,466,"PCPE",28
45,"45020",1313,1062,1046,5,16,"PCPE",0
45,"45043",793,663,655,1,8,"PCPE",0
45,"45074",412,327,322,0,5,"PCPE",0
45,"45096",1015,832,817,7,15,"PCPE",1
45,"45064",3839,2915,2884,19,31,"PCPE",2
45,"45901",769,577,571,1,6,"PCPE",0
45,"45016",4179,3290,3268,30,22,"PCPE",4
45,"45054",3995,2997,2968,8,29,"PCPE",3
45,"45163",8338,6270,6142,57,128,"PCPE",6
45,"45069",1876,1446,1428,8,18,"PCPE",1
45,"45170",235,183,176,4,7,"PCPE",0
45,"45151",586,444,437,1,7,"PCPE",0
45,"45021",2459,1862,1833,21,29,"PCPE",2
45,"45205",6745,4708,4657,35,51,"PCPE",8
45,"45139",172,135,133,0,2,"PCPE",0
45,"45092",233,197,194,0,3,"PCPE",1
45,"45052",2914,2389,2372,23,17,"PCPE",1
45,"45149",573,486,484,0,2,"PCPE",0
45,"45018",495,352,348,0,4,"PCPE",0
45,"45171",1382,1090,1075,4,15,"PCPE",2
45,"45036",658,500,496,2,4,"PCPE",0
45,"45147",581,475,469,4,6,"PCPE",0
45,"45046",2421,1815,1796,8,19,"PCPE",1
45,"45159",86,75,72,1,3,"PCPE",0
45,"45200",4627,3678,3588,29,90,"PCPE",1
45,"45094",395,312,308,0,4,"PCPE",0
45,"45061",2457,1718,1699,7,19,"PCPE",0
45,"45127",708,524,519,1,5,"PCPE",0
45,"45102",3629,2685,2644,15,41,"PCPE",5
45,"45148",307,229,219,1,10,"PCPE",0
45,"45025",1198,921,910,2,11,"PCPE",2
45,"45157",2125,1531,1509,14,22,"PCPE",1
45,"45192",2503,2164,2141,7,23,"PCPE",0
45,"45204",643,519,513,0,6,"PCPE",0
45,"45188",2783,2161,2127,9,34,"PCPE",1
19,"19269",100,80,79,0,1,"SAIn",0
19,"19167",132,106,103,0,3,"SAIn",0
19,"19218",52,35,34,0,1,"SAIn",0
19,"19122",93,72,72,3,0,"SAIn",0
19,"19227",74,49,49,0,0,"SAIn",0
19,"19138",272,197,196,0,1,"SAIn",0
19,"19031",15,10,9,0,1,"SAIn",0
19,"19161",218,151,151,1,0,"SAIn",0
19,"19244",81,61,59,2,2,"SAIn",0
19,"19011",254,191,191,2,0,"SAIn",0
19,"19170",193,140,140,0,0,"SAIn",0
19,"19257",3446,2532,2499,36,33,"SAIn",4
19,"19314",52,35,34,1,1,"SAIn",0
19,"19038",28,23,23,0,0,"SAIn",0
19,"19006",768,545,538,0,7,"SAIn",0
19,"19310",11,7,7,0,0,"SAIn",0
19,"19298",64,49,49,0,0,"SAIn",0
19,"19135",105,82,82,0,0,"SAIn",0
19,"19246",46,36,36,0,0,"SAIn",0
19,"19076",31,20,20,0,0,"SAIn",0
19,"19129",29,25,25,0,0,"SAIn",0
19,"19330",71,64,64,0,0,"SAIn",0
19,"19220",2305,1613,1600,9,13,"SAIn",1
19,"19060",150,115,114,1,1,"SAIn",0
19,"19196",106,86,80,0,6,"SAIn",0
19,"19009",261,193,190,5,3,"SAIn",0
19,"19191",13,12,12,0,0,"SAIn",0
19,"19172",55,44,44,0,0,"SAIn",0
19,"19098",21,20,20,0,0,"SAIn",0
19,"19013",128,106,106,0,0,"SAIn",0
19,"19103",255,205,201,0,4,"SAIn",0
19,"19302",58,45,45,1,0,"SAIn",0
19,"19279",57,54,54,0,0,"SAIn",0
19,"19304",220,161,161,1,0,"SAIn",0
19,"19229",69,60,60,1,0,"SAIn",0
19,"19260",41,38,38,1,0,"SAIn",0
19,"19160",899,601,597,2,4,"SAIn",1
19,"19212",727,562,551,8,11,"SAIn",0
19,"19061",56,47,47,0,0,"SAIn",0
19,"19286",725,557,551,1,6,"SAIn",0
19,"19192",1723,1354,1342,9,12,"SAIn",0
19,"19230",504,383,376,4,7,"SAIn",0
19,"19147",46,34,33,0,1,"SAIn",0
19,"19252",67,58,58,0,0,"SAIn",1
19,"19214",74,54,54,0,0,"SAIn",0
19,"19189",120,91,90,2,1,"SAIn",0
19,"19046",21452,16321,16151,91,170,"SAIn",10
19,"19090",97,77,77,1,0,"SAIn",0
19,"19223",110,76,76,3,0,"SAIn",1
19,"19179",72,52,52,1,0,"SAIn",0
19,"19089",28,17,17,0,0,"SAIn",0
19,"19155",66,54,53,0,1,"SAIn",0
19,"19092",417,316,312,4,4,"SAIn",0
19,"19238",42,32,31,2,1,"SAIn",0
19,"19262",139,111,109,0,2,"SAIn",0
19,"19105",2332,1809,1794,11,15,"SAIn",1
19,"19201",59,51,51,1,0,"SAIn",0
19,"19143",1733,1371,1352,9,19,"SAIn",0
19,"19051",70,65,65,0,0,"SAIn",0
19,"19208",43,31,31,0,0,"SAIn",0
19,"19285",25,16,16,2,0,"SAIn",0
19,"19096",93,66,66,0,0,"SAIn",0
19,"19074",73,63,63,0,0,"SAIn",0
19,"19110",57,46,45,2,1,"SAIn",0
19,"19176",237,181,181,0,0,"SAIn",0
19,"19278",29,28,28,2,0,"SAIn",0
19,"19274",895,673,664,8,9,"SAIn",0
19,"19008",37,28,28,0,0,"SAIn",0
19,"19107",302,262,260,0,2,"SAIn",0
19,"19305",162,129,128,1,1,"SAIn",0
19,"19057",72,53,52,0,1,"SAIn",0
19,"19091",29,20,20,0,0,"SAIn",0
19,"19213",72,53,51,0,2,"SAIn",0
19,"19228",29,21,20,0,1,"SAIn",0
19,"19082",85,62,62,0,0,"SAIn",0
19,"19323",42,33,33,0,0,"SAIn",0
19,"19202",13,12,12,0,0,"SAIn",0
19,"19116",13,11,11,0,0,"SAIn",0
19,"19203",31,25,25,0,0,"SAIn",0
19,"19052",27,18,18,1,0,"SAIn",0
19,"19166",158,125,124,0,1,"SAIn",1
19,"19226",48,35,35,0,0,"SAIn",0
19,"19332",93,68,68,0,0,"SAIn",0
19,"19005",95,71,69,1,2,"SAIn",0
19,"19284",10,8,8,0,0,"SAIn",0
19,"19288",23,22,22,0,0,"SAIn",0
19,"19050",15,13,13,0,0,"SAIn",0
19,"19048",17,10,10,1,0,"SAIn",0
19,"19174",111,79,78,0,1,"SAIn",0
19,"19002",73,56,54,0,2,"SAIn",0
19,"19059",79,60,59,0,1,"SAIn",1
19,"19171",4884,3824,3778,24,46,"SAIn",3
19,"19234",46,38,38,0,0,"SAIn",0
19,"19095",12,10,10,0,0,"SAIn",0
19,"19308",65,54,54,0,0,"SAIn",0
19,"19017",69,56,56,0,0,"SAIn",0
19,"19300",762,628,624,3,4,"SAIn",0
19,"19237",47,35,34,1,1,"SAIn",0
19,"19254",49,36,36,1,0,"SAIn",0
19,"19185",31,18,18,0,0,"SAIn",0
19,"19117",1580,1183,1167,11,16,"SAIn",0
19,"19267",19,12,12,0,0,"SAIn",0
19,"19079",8,7,7,0,0,"SAIn",0
19,"19102",101,84,84,0,0,"SAIn",0
19,"19250",21,16,15,0,1,"SAIn",0
19,"19106",92,67,64,0,3,"SAIn",0
19,"19193",23,22,21,0,1,"SAIn",0
19,"19044",309,248,246,3,2,"SAIn",0
19,"19317",141,107,103,0,4,"SAIn",0
19,"19259",28,18,18,0,0,"SAIn",0
19,"19154",66,52,51,0,1,"SAIn",0
19,"19111",158,123,121,0,2,"SAIn",0
19,"19255",78,61,61,0,0,"SAIn",0
19,"19194",98,68,66,0,2,"SAIn",0
19,"19080",73,51,50,0,1,"SAIn",0
19,"19075",63,37,36,0,1,"SAIn",0
19,"19287",144,109,109,0,0,"SAIn",1
19,"19112",57,49,49,0,0,"SAIn",0
19,"19037",146,113,113,1,0,"SAIn",0
19,"19124",382,256,253,0,3,"SAIn",0
19,"19049",12,11,11,0,0,"SAIn",0
19,"19151",1075,779,764,5,15,"SAIn",0
19,"19041",160,133,132,0,1,"SAIn",0
19,"19104",18,13,13,1,0,"SAIn",0
19,"19156",983,743,735,5,8,"SAIn",0
19,"19240",52,38,37,0,1,"SAIn",0
19,"19108",112,90,90,1,0,"SAIn",0
19,"19235",97,63,62,0,1,"SAIn",0
19,"19311",83,58,57,0,1,"SAIn",0
19,"19211",394,297,291,1,6,"SAIn",0
19,"19065",127,103,102,1,1,"SAIn",0
19,"19010",9,9,9,0,0,"SAIn",0
19,"19215",165,142,141,0,1,"SAIn",0
19,"19277",18,12,12,0,0,"SAIn",0
19,"19047",67,60,60,1,0,"SAIn",0
19,"19066",61,49,47,0,2,"SAIn",0
19,"19099",299,206,205,1,1,"SAIn",1
19,"19055",53,34,33,2,1,"SAIn",0
19,"19324",179,136,135,0,1,"SAIn",0
19,"19321",38,26,26,0,0,"SAIn",0
19,"19118",13,10,10,0,0,"SAIn",0
19,"19003",41,37,35,0,2,"SAIn",0
19,"19159",94,77,77,0,0,"SAIn",0
19,"19296",30,21,21,0,0,"SAIn",0
19,"19136",18,15,15,0,0,"SAIn",0
19,"19249",31,27,27,0,0,"SAIn",0
19,"19114",39,26,26,0,0,"SAIn",0
19,"19181",55,37,37,0,0,"SAIn",0
19,"19086",1495,1158,1149,7,9,"SAIn",0
19,"19127",89,56,56,0,0,"SAIn",0
19,"19291",1215,883,868,0,15,"SAIn",0
19,"19322",31,26,26,0,0,"SAIn",0
19,"19301",38,30,30,0,0,"SAIn",0
19,"19198",17,10,10,0,0,"SAIn",0
19,"19225",835,645,638,2,7,"SAIn",0
19,"19139",31,23,23,1,0,"SAIn",0
19,"19173",47,40,37,0,3,"SAIn",0
19,"19186",81,63,63,1,0,"SAIn",0
19,"19001",53,36,36,1,0,"SAIn",0
19,"19087",18,17,17,0,0,"SAIn",0
19,"19146",42,34,34,0,0,"SAIn",0
19,"19243",43,36,36,0,0,"SAIn",0
19,"19134",26,18,18,0,0,"SAIn",0
19,"19251",42,29,28,0,1,"SAIn",0
19,"19306",28,20,20,0,0,"SAIn",0
19,"19222",115,87,86,1,1,"SAIn",0
19,"19280",3451,2620,2581,14,39,"SAIn",2
19,"19195",40,30,26,1,4,"SAIn",0
19,"19289",28,21,21,0,0,"SAIn",0
19,"19071",7746,5748,5678,34,70,"SAIn",1
19,"19109",43,32,32,3,0,"SAIn",0
19,"19078",53,44,44,0,0,"SAIn",0
19,"19219",13,9,9,0,0,"SAIn",0
19,"19148",45,37,37,1,0,"SAIn",0
19,"19039",60,55,54,1,1,"SAIn",0
19,"19325",128,89,88,0,1,"SAIn",0
19,"19266",241,201,199,2,2,"SAIn",0
19,"19270",22,18,18,0,0,"SAIn",0
19,"19329",58,49,49,0,0,"SAIn",0
19,"19190",2405,1852,1833,14,19,"SAIn",1
19,"19027",148,116,115,1,1,"SAIn",0
19,"19241",46,35,35,1,0,"SAIn",0
19,"19216",134,97,97,0,0,"SAIn",0
19,"19263",27,17,15,0,2,"SAIn",0
19,"19197",25,20,20,0,0,"SAIn",0
19,"19007",479,364,360,2,4,"SAIn",0
19,"19133",86,73,73,1,0,"SAIn",0
19,"19022",632,477,468,3,9,"SAIn",0
19,"19150",126,94,93,0,1,"SAIn",0
19,"19309",26,22,22,0,0,"SAIn",0
19,"19145",48,42,42,2,0,"SAIn",0
19,"19242",93,66,62,2,4,"SAIn",1
19,"19162",65,49,49,0,0,"SAIn",0
19,"19070",79,59,59,0,0,"SAIn",0
19,"19058",6786,5451,5415,29,36,"SAIn",2
19,"19264",38,29,29,0,0,"SAIn",0
19,"19032",175,131,124,1,7,"SAIn",0
19,"19045",145,119,117,1,2,"SAIn",0
19,"19097",17,13,13,0,0,"SAIn",0
19,"19272",72,59,59,1,0,"SAIn",0
19,"19177",78,60,57,1,3,"SAIn",0
19,"19019",19,17,16,0,1,"SAIn",0
19,"19293",1868,1379,1364,9,15,"SAIn",3
19,"19901",41,37,36,1,1,"SAIn",0
19,"19318",25,19,19,0,0,"SAIn",0
19,"19004",66,51,50,1,1,"SAIn",0
19,"19142",260,189,186,2,3,"SAIn",0
19,"19261",38,25,25,0,0,"SAIn",0
19,"19152",589,448,439,2,9,"SAIn",0
19,"19178",39,25,25,0,0,"SAIn",0
19,"19042",26,25,25,0,0,"SAIn",0
19,"19248",83,66,66,1,0,"SAIn",0
19,"19020",43,27,26,2,1,"SAIn",0
19,"19024",8143,6017,5944,33,73,"SAIn",2
19,"19043",80,74,72,0,2,"SAIn",0
19,"19034",22,18,18,0,0,"SAIn",0
19,"19204",154,106,106,3,0,"SAIn",0
19,"19319",4425,3336,3304,21,32,"SAIn",0
19,"19073",24,19,19,0,0,"SAIn",0
19,"19221",50,35,35,0,0,"SAIn",0
19,"19224",93,80,80,0,0,"SAIn",0
19,"19232",79,60,59,1,1,"SAIn",0
19,"19126",1620,1242,1216,5,26,"SAIn",0
19,"19184",75,48,46,0,2,"SAIn",0
19,"19132",93,74,74,0,0,"SAIn",0
19,"19120",104,92,92,1,0,"SAIn",0
19,"19283",29,23,23,0,0,"SAIn",0
19,"19018",163,122,119,2,3,"SAIn",0
19,"19271",47,30,30,0,0,"SAIn",0
19,"19123",44,38,38,0,0,"SAIn",0
19,"19233",91,71,71,1,0,"SAIn",0
19,"19294",23,19,19,1,0,"SAIn",0
19,"19115",24,14,14,1,0,"SAIn",0
19,"19217",59,39,37,0,2,"SAIn",0
19,"19036",271,230,229,1,1,"SAIn",0
19,"19209",40,28,27,1,1,"SAIn",0
19,"19331",2611,2010,1982,18,28,"SAIn",3
19,"19064",73,62,62,0,0,"SAIn",0
19,"19121",257,209,208,0,1,"SAIn",1
19,"19130",59955,47034,46504,383,530,"SAIn",23
19,"19247",148,106,102,1,4,"SAIn",0
19,"19239",100,70,69,1,1,"SAIn",0
19,"19327",431,348,342,3,6,"SAIn",0
19,"19015",81,68,68,0,0,"SAIn",0
19,"19282",161,115,112,0,3,"SAIn",0
19,"19113",471,365,365,2,0,"SAIn",4
19,"19199",19,16,16,1,0,"SAIn",0
19,"19023",117,101,99,1,2,"SAIn",0
19,"19183",83,74,73,0,1,"SAIn",0
19,"19200",75,53,53,1,0,"SAIn",0
19,"19231",12,8,8,1,0,"SAIn",0
19,"19290",853,568,560,3,8,"SAIn",2
19,"19182",39,28,27,0,1,"SAIn",0
19,"19125",45,40,40,0,0,"SAIn",0
19,"19307",25,23,23,1,0,"SAIn",0
19,"19303",46,39,38,0,1,"SAIn",0
19,"19334",36,30,29,0,1,"SAIn",0
19,"19153",23,22,22,0,0,"SAIn",0
19,"19016",64,42,42,0,0,"SAIn",0
19,"19163",61,44,43,1,1,"SAIn",0
19,"19081",31,21,21,0,0,"SAIn",0
19,"19021",1051,788,774,7,14,"SAIn",1
19,"19088",84,68,68,0,0,"SAIn",0
19,"19165",48,40,40,0,0,"SAIn",0
19,"19053",2024,1479,1464,13,15,"SAIn",2
19,"19265",136,104,104,0,0,"SAIn",0
19,"19268",36,26,25,0,1,"SAIn",0
19,"19335",54,45,45,0,0,"SAIn",0
19,"19326",1749,1248,1237,5,11,"SAIn",1
19,"19067",70,51,50,2,1,"SAIn",0
19,"19040",51,41,41,0,0,"SAIn",0
19,"19168",297,227,224,2,3,"SAIn",0
19,"19188",50,34,32,1,2,"SAIn",0
19,"19245",1179,913,893,6,20,"SAIn",0
19,"19256",44,35,35,0,0,"SAIn",0
19,"19175",34,26,26,1,0,"SAIn",0
19,"19210",21,19,19,2,0,"SAIn",0
19,"19187",50,46,44,0,2,"SAIn",0
19,"19169",43,36,36,0,0,"SAIn",0
19,"19281",22,18,18,0,0,"SAIn",0
19,"19297",31,21,21,1,0,"SAIn",0
19,"19299",95,74,74,1,0,"SAIn",0
19,"19033",64,49,49,3,0,"SAIn",0
19,"19258",97,73,73,1,0,"SAIn",0
19,"19157",57,45,45,0,0,"SAIn",0
19,"19119",81,71,71,0,0,"SAIn",0
19,"19333",121,86,83,2,3,"SAIn",0
19,"19054",190,165,163,3,2,"SAIn",0
21,"21060",11959,7565,7488,103,77,"PP",2239
21,"21056",2912,2115,2024,20,91,"PP",438
21,"21025",4049,2682,2653,25,29,"PP",776
21,"21018",1780,1152,1131,10,21,"PP",218
21,"21076",2123,1549,1532,13,17,"PP",277
21,"21047",1914,1213,1179,19,34,"PP",318
21,"21014",4041,3203,3170,15,33,"PP",838
21,"21039",308,223,222,2,1,"PP",45
21,"21036",192,138,138,1,0,"PP",46
21,"21005",15486,10310,10189,64,121,"PP",2672
21,"21021",12233,7551,7470,94,81,"PP",2333
21,"21003",695,533,525,1,8,"PP",37
21,"21061",5092,3471,3429,32,42,"PP",1000
21,"21053",3316,2257,2219,25,38,"PP",583
21,"21006",3402,2398,2359,13,39,"PP",325
21,"21077",1722,1261,1246,5,15,"PP",435
21,"21052",4618,2837,2773,20,64,"PP",405
21,"21013",10597,7220,7061,69,159,"PP",2003
21,"21017",3643,2301,2269,17,32,"PP",576
21,"21050",12448,8431,8382,86,49,"PP",2896
21,"21045",253,192,190,0,2,"PP",30
21,"21023",2147,1379,1357,6,22,"PP",295
21,"21008",2662,1847,1831,14,16,"PP",387
21,"21064",6526,4544,4492,51,52,"PP",1139
21,"21031",1209,845,828,3,17,"PP",251
21,"21032",1805,1378,1359,15,19,"PP",373
21,"21007",6231,4285,4227,45,58,"PP",985
21,"21073",1871,1134,1120,12,14,"PP",390
21,"21024",495,350,344,5,6,"PP",64
21,"21002",15348,10939,10864,80,75,"PP",3210
21,"21028",381,290,287,0,3,"PP",48
21,"21011",3464,2536,2518,19,18,"PP",576
21,"21069",1715,1186,1175,7,11,"PP",299
21,"21057",1045,641,640,8,1,"PP",146
21,"21044",17552,10820,10692,106,128,"PP",4713
21,"21030",1824,1491,1472,11,19,"PP",494
21,"21012",322,234,227,0,7,"PP",69
21,"21068",998,606,605,14,1,"PP",174
21,"21026",270,184,178,1,6,"PP",28
21,"21037",472,364,360,2,4,"PP",49
21,"21016",1034,777,764,2,13,"PP",132
21,"21071",204,160,158,2,2,"PP",42
21,"21070",6296,4450,4397,38,53,"PP",969
21,"21040",3158,2386,2345,15,41,"PP",606
21,"21048",305,220,220,3,0,"PP",43
21,"21010",14684,8766,8698,92,68,"PP",2423
21,"21038",1082,732,719,8,13,"PP",217
21,"21022",174,115,109,1,6,"PP",27
21,"21019",590,433,423,4,10,"PP",65
21,"21067",415,309,303,0,6,"PP",37
21,"21054",8105,6025,5919,41,106,"PP",2730
21,"21027",49,36,36,1,0,"PP",12
21,"21033",536,399,395,0,4,"PP",58
21,"21066",507,408,405,1,3,"PP",88
21,"21004",1641,1070,1047,10,23,"PP",192
21,"21001",648,479,469,4,10,"PP",84
21,"21065",287,202,196,0,6,"PP",81
21,"21042",15349,7802,7708,106,94,"PP",2688
21,"21075",351,270,266,2,4,"PP",86
21,"21049",3372,2162,2108,15,54,"PP",438
21,"21041",113604,74902,74244,718,658,"PP",21190
21,"21020",372,241,238,2,3,"PP",62
21,"21074",2660,1869,1844,18,25,"PP",598
21,"21055",6914,5286,5218,34,68,"PP",2497
21,"21059",220,167,165,3,2,"PP",13
21,"21009",860,571,555,6,16,"PP",125
21,"21058",2602,1904,1886,8,18,"PP",315
21,"21062",1395,936,926,9,10,"PP",316
21,"21035",9622,6399,6313,69,86,"PP",1926
21,"21029",1564,1166,1126,16,40,"PP",353
21,"21034",1207,848,838,8,10,"PP",219
21,"21072",10280,7869,7777,76,92,"PP",1883
21,"21078",2763,1928,1907,12,21,"PP",339
21,"21046",1703,1200,1173,15,27,"PP",457
21,"21015",683,425,420,6,5,"PP",47
21,"21063",2614,2044,2034,12,10,"PP",316
21,"21043",1858,1356,1341,13,15,"PP",250
21,"21079",731,526,522,3,4,"PP",136
21,"21051",245,176,173,1,3,"PP",55
34,"34047",1803,1402,1380,15,22,"EB",1
34,"34216",67,52,51,0,1,"EB",2
34,"34134",53,37,37,2,0,"EB",0
34,"34053",209,170,168,4,2,"EB",0
34,"34024",32,19,19,0,0,"EB",0
34,"34046",43,31,29,0,2,"EB",0
34,"34102",205,172,170,1,2,"EB",0
34,"34081",61,50,49,0,1,"EB",0
34,"34055",280,204,202,2,2,"EB",1
34,"34181",453,343,337,3,6,"EB",0
34,"34218",469,353,349,2,4,"EB",1
34,"34079",1601,1285,1269,11,16,"EB",2
34,"34189",57,45,45,1,0,"EB",0
34,"34094",61,42,40,1,2,"EB",0
34,"34227",76,62,62,1,0,"EB",2
34,"34221",179,135,132,3,3,"EB",0
34,"34052",178,148,147,3,1,"EB",0
34,"34133",107,85,82,0,3,"EB",1
34,"34129",179,139,137,2,2,"EB",0
34,"34230",15,12,12,0,0,"EB",0
34,"34175",89,75,74,1,1,"EB",0
34,"34177",179,149,148,1,1,"EB",1
34,"34220",144,129,128,0,1,"EB",0
34,"34050",202,160,160,0,0,"EB",0
34,"34223",219,159,158,1,1,"EB",1
34,"34019",125,103,101,1,2,"EB",0
34,"34140",107,63,62,0,1,"EB",0
34,"34107",81,49,49,3,0,"EB",1
34,"34192",93,76,76,0,0,"EB",0
34,"34132",115,93,92,0,1,"EB",0
34,"34034",126,93,93,1,0,"EB",0
34,"34196",91,70,69,1,1,"EB",0
34,"34131",59,50,48,0,2,"EB",0
34,"34029",727,596,582,4,14,"EB",2
34,"34036",216,167,165,1,2,"EB",1
34,"34136",182,121,120,1,1,"EB",0
34,"34098",780,587,582,2,5,"EB",0
34,"34060",137,113,112,1,1,"EB",0
34,"34160",143,112,110,1,2,"EB",0
34,"34020",53,39,39,0,0,"EB",0
34,"34042",300,247,244,4,3,"EB",0
34,"34202",31,20,19,0,1,"EB",0
34,"34228",81,66,66,0,0,"EB",0
34,"34167",114,89,89,0,0,"EB",0
34,"34082",84,71,71,0,0,"EB",0
34,"34204",47,39,39,2,0,"EB",0
34,"34158",290,190,188,3,2,"EB",0
34,"34011",398,326,326,3,0,"EB",0
34,"34112",47,38,38,0,0,"EB",0
34,"34061",108,80,80,0,0,"EB",2
34,"34179",29,22,20,0,2,"EB",0
34,"34154",76,54,52,0,2,"EB",0
34,"34056",2003,1502,1487,12,15,"EB",1
34,"34035",113,90,89,1,1,"EB",0
34,"34100",142,116,115,5,1,"EB",0
34,"34210",102,90,89,0,1,"EB",0
34,"34233",131,116,116,1,0,"EB",0
34,"34176",134,102,100,2,2,"EB",0
34,"34184",55,46,42,0,4,"EB",0
34,"34157",2460,1872,1836,26,36,"EB",3
34,"34199",1248,955,937,18,18,"EB",0
34,"34074",719,552,545,8,7,"EB",1
34,"34143",172,127,126,3,1,"EB",0
34,"34062",176,111,111,3,0,"EB",0
34,"34018",209,169,166,3,3,"EB",1
34,"34234",72,57,55,0,2,"EB",0
34,"34156",49,42,41,3,1,"EB",0
34,"34127",95,64,64,2,0,"EB",0
34,"34028",144,121,119,1,2,"EB",1
34,"34113",37,36,36,0,0,"EB",0
34,"34038",277,202,202,3,0,"EB",3
34,"34015",39,32,31,1,1,"EB",0
34,"34225",4903,3830,3784,41,46,"EB",2
34,"34063",86,80,79,1,1,"EB",1
34,"34201",193,163,161,2,2,"EB",0
34,"34076",597,494,490,3,4,"EB",0
34,"34039",61,46,45,0,1,"EB",0
34,"34066",58,45,45,0,0,"EB",0
34,"34240",90,71,70,2,1,"EB",0
34,"34178",113,92,91,5,1,"EB",0
34,"34077",349,253,246,0,7,"EB",0
34,"34041",89,71,71,1,0,"EB",1
34,"34147",167,120,120,1,0,"EB",0
34,"34114",212,147,146,2,1,"EB",0
34,"34099",61,51,50,0,1,"EB",0
34,"34170",62,49,49,0,0,"EB",0
34,"34017",920,763,745,2,18,"EB",1
34,"34141",182,148,147,4,1,"EB",0
34,"34116",62,41,41,0,0,"EB",0
34,"34229",67,55,55,1,0,"EB",0
34,"34241",18,13,12,2,1,"EB",0
34,"34067",129,95,95,0,0,"EB",0
34,"34149",20,15,15,0,0,"EB",0
34,"34217",1200,954,934,6,20,"EB",1
34,"34031",29,28,28,1,0,"EB",0
34,"34103",96,78,77,2,1,"EB",0
34,"34001",35,28,28,2,0,"EB",1
34,"34171",982,720,710,7,10,"EB",2
34,"34120",64404,49403,48884,379,519,"EB",101
34,"34205",59,45,45,0,0,"EB",0
34,"34068",25,24,24,1,0,"EB",0
34,"34185",65,46,44,2,2,"EB",0
34,"34242",95,74,73,1,1,"EB",0
34,"34080",5626,3906,3835,39,71,"EB",5
34,"34092",297,236,231,2,5,"EB",1
34,"34045",77,65,65,2,0,"EB",0
34,"34104",247,203,199,0,4,"EB",0
34,"34003",163,127,125,0,2,"EB",0
34,"34231",232,167,167,4,0,"EB",0
34,"34243",326,263,258,2,5,"EB",0
34,"34238",341,279,276,1,3,"EB",0
34,"34093",90,72,70,0,2,"EB",0
34,"34159",363,277,269,4,8,"EB",0
34,"34169",404,302,300,2,2,"EB",3
34,"34069",2285,1711,1692,25,19,"EB",5
34,"34186",51,45,45,0,0,"EB",0
34,"34032",41,32,31,0,1,"EB",0
34,"34121",192,155,154,2,1,"EB",0
34,"34033",18,17,17,0,0,"EB",0
34,"34089",157,124,122,1,2,"EB",0
34,"34004",5626,4226,4178,41,48,"EB",4
34,"34232",748,601,586,11,15,"EB",1
34,"34224",45,31,31,0,0,"EB",0
34,"34245",311,213,209,4,4,"EB",1
34,"34182",792,632,620,3,12,"EB",2
34,"34057",476,339,334,3,5,"EB",0
34,"34091",123,97,95,1,2,"EB",0
34,"34070",160,117,115,2,2,"EB",0
34,"34005",858,670,651,6,19,"EB",1
34,"34122",84,66,65,0,1,"EB",0
34,"34058",184,167,167,0,0,"EB",0
34,"34161",23,14,14,0,0,"EB",0
34,"34246",64,49,47,1,2,"EB",0
34,"34208",53,41,41,1,0,"EB",0
34,"34222",120,82,82,2,0,"EB",0
34,"34022",1095,915,909,8,6,"EB",0
34,"34190",56,40,40,3,0,"EB",0
34,"34096",57,46,46,3,0,"EB",0
34,"34071",172,140,139,4,1,"EB",0
34,"34163",49,40,40,0,0,"EB",0
34,"34123",1668,1346,1319,20,27,"EB",1
34,"34048",76,64,64,1,0,"EB",0
34,"34108",537,453,446,5,7,"EB",3
34,"34083",1773,1259,1244,8,15,"EB",0
34,"34059",422,348,341,6,7,"EB",0
34,"34151",167,111,111,3,0,"EB",0
34,"34174",205,162,162,4,0,"EB",0
34,"34901",1126,881,865,6,16,"EB",1
34,"34072",160,142,140,1,2,"EB",0
34,"34084",140,110,108,1,2,"EB",0
34,"34106",114,94,94,2,0,"EB",0
34,"34023",5265,3948,3918,38,30,"EB",5
34,"34135",391,296,291,4,5,"EB",0
34,"34146",55,42,42,0,0,"EB",0
34,"34124",61,47,46,0,1,"EB",0
34,"34165",66,59,59,0,0,"EB",0
34,"34109",59,48,47,0,1,"EB",1
34,"34902",140,115,114,0,1,"EB",0
34,"34211",180,151,149,3,2,"EB",0
34,"34206",879,688,680,3,8,"EB",1
34,"34152",124,102,99,1,3,"EB",0
34,"34049",369,280,274,1,6,"EB",0
34,"34130",213,175,172,2,3,"EB",3
34,"34236",162,126,126,1,0,"EB",0
34,"34110",91,78,78,2,0,"EB",0
34,"34010",570,437,429,5,8,"EB",0
34,"34125",88,69,68,1,1,"EB",0
34,"34025",61,44,44,1,0,"EB",0
34,"34073",187,150,149,0,1,"EB",0
34,"34213",58,43,42,2,1,"EB",0
34,"34086",105,91,88,1,3,"EB",0
34,"34126",279,218,218,2,0,"EB",1
34,"34903",198,128,127,1,1,"EB",0
34,"34137",28,24,24,1,0,"EB",0
34,"34180",68,56,56,2,0,"EB",0
34,"34037",310,218,217,4,1,"EB",0
34,"34155",135,105,104,1,1,"EB",0
34,"34006",80,69,66,1,3,"EB",0
34,"34027",1096,786,781,11,5,"EB",1
34,"34237",597,472,465,5,7,"EB",0
34,"34087",127,109,108,1,1,"EB",2
34,"34214",186,150,149,1,1,"EB",0
34,"34168",55,51,51,1,0,"EB",0
34,"34051",102,90,88,1,2,"EB",0
34,"34215",163,148,148,2,0,"EB",0
34,"34101",54,42,42,0,0,"EB",0
34,"34009",33,29,26,1,3,"EB",0
34,"34088",231,192,190,2,2,"EB",0
34,"34139",168,126,124,6,2,"EB",0
34,"34904",319,241,240,3,1,"EB",0
34,"34012",362,277,272,4,5,"EB",0
35,"35026",80806,53749,52665,450,1084,"C's",6284
35,"35024",13621,8665,8555,76,110,"C's",1168
35,"35009",19832,14305,14036,97,269,"C's",1154
35,"35023",11680,8467,8295,75,172,"C's",838
35,"35028",9705,5552,5478,64,74,"C's",769
35,"35011",23882,16369,16095,107,274,"C's",1705
35,"35020",6054,4073,4018,26,55,"C's",191
35,"35025",1801,1239,1216,9,23,"C's",101
35,"35004",38814,20869,20641,192,228,"C's",2255
35,"35022",48059,30474,30134,219,340,"C's",3150
35,"35033",6378,4412,4354,24,58,"C's",546
35,"35010",3548,2371,2336,20,35,"C's",182
35,"35031",7270,5184,5000,36,184,"C's",566
35,"35029",4125,2545,2514,34,31,"C's",238
35,"35027",10311,7497,7364,58,133,"C's",778
35,"35007",515,332,330,2,2,"C's",16
35,"35001",4599,3455,3396,27,59,"C's",256
35,"35005",1071,718,711,6,7,"C's",48
35,"35016",297974,198159,195935,1546,2224,"C's",27436
35,"35015",9870,5451,5368,29,83,"C's",488
35,"35019",32253,19902,19621,126,281,"C's",2308
35,"35032",3432,2541,2498,19,43,"C's",207
35,"35008",6109,4631,4542,37,89,"C's",497
35,"35012",10331,5684,5610,32,74,"C's",581
35,"35013",6609,4997,4881,51,116,"C's",477
35,"35006",30302,21967,21625,243,342,"C's",2453
35,"35017",25447,15415,15079,127,336,"C's",1885
35,"35014",11169,6234,6107,59,127,"C's",787
35,"35030",9205,5602,5501,58,101,"C's",553
35,"35003",5125,2989,2929,21,60,"C's",365
35,"35018",12463,7628,7546,56,82,"C's",972
35,"35021",14942,10691,10537,80,154,"C's",1782
35,"35034",7707,3921,3872,30,49,"C's",493
35,"35002",23129,15904,15675,74,229,"C's",1718
48,"48907",355,283,282,2,1,"RECORTES CE",0
48,"48072",974,728,723,5,5,"RECORTES CE",1
48,"48040",1299,896,884,5,12,"RECORTES CE",0
48,"48043",4403,3214,3186,28,28,"RECORTES CE",4
48,"48016",5260,3856,3827,22,29,"RECORTES CE",8
48,"48008",617,433,424,6,9,"RECORTES CE",2
48,"48908",245,200,199,1,1,"RECORTES CE",0
48,"48041",704,558,555,4,3,"RECORTES CE",0
48,"48079",425,322,321,4,1,"RECORTES CE",0
48,"48042",1384,1111,1091,7,20,"RECORTES CE",3
48,"48095",2352,1658,1647,6,11,"RECORTES CE",0
48,"48904",3504,2671,2650,18,21,"RECORTES CE",3
48,"48060",3645,2277,2274,7,3,"RECORTES CE",1
48,"48073",6952,4476,4435,43,41,"RECORTES CE",4
48,"48010",457,311,307,1,4,"RECORTES CE",1
48,"48044",62989,46989,46783,385,206,"RECORTES CE",81
48,"48914",330,275,275,1,0,"RECORTES CE",0
48,"48076",314,237,237,4,0,"RECORTES CE",0
48,"48089",3266,2425,2406,23,19,"RECORTES CE",3
48,"48083",6950,5128,5097,33,31,"RECORTES CE",0
48,"48069",12765,8985,8910,58,75,"RECORTES CE",16
48,"48068",1551,1178,1163,16,15,"RECORTES CE",0
48,"48913",1251,933,917,13,16,"RECORTES CE",1
48,"48096",6608,5071,5011,43,60,"RECORTES CE",17
48,"48902",19124,13344,13227,93,117,"RECORTES CE",29
48,"48077",3367,2438,2423,17,15,"RECORTES CE",2
48,"48018",875,553,553,3,0,"RECORTES CE",1
48,"48002",7851,5767,5713,41,54,"RECORTES CE",7
48,"48065",3315,2447,2433,19,14,"RECORTES CE",2
48,"48905",2565,1882,1847,2,35,"RECORTES CE",2
48,"48086",2073,1519,1504,15,15,"RECORTES CE",1
48,"48063",373,289,288,1,1,"RECORTES CE",0
48,"48067",1161,837,834,2,3,"RECORTES CE",1
48,"48078",38742,28064,27837,231,227,"RECORTES CE",40
48,"48032",5735,4173,4151,32,22,"RECORTES CE",4
48,"48070",545,378,374,2,4,"RECORTES CE",0
48,"48903",1838,1400,1385,4,15,"RECORTES CE",1
48,"48024",1003,775,771,5,4,"RECORTES CE",0
48,"48033",215,160,159,0,1,"RECORTES CE",0
48,"48048",562,399,394,3,5,"RECORTES CE",0
48,"48094",3193,2210,2200,18,10,"RECORTES CE",3
48,"48092",837,619,619,13,0,"RECORTES CE",1
48,"48003",14338,10497,10414,76,83,"RECORTES CE",14
48,"48020",274076,193807,192607,1471,1200,"RECORTES CE",351
48,"48080",9971,7148,7086,71,62,"RECORTES CE",9
48,"48911",382,291,286,2,5,"RECORTES CE",0
48,"48009",786,614,609,3,5,"RECORTES CE",0
48,"48050",198,153,150,0,3,"RECORTES CE",0
48,"48055",2662,1961,1938,16,23,"RECORTES CE",0
48,"48017",13290,8908,8856,42,52,"RECORTES CE",10
48,"48012",2041,1571,1553,11,18,"RECORTES CE",2
48,"48064",603,463,459,7,4,"RECORTES CE",0
48,"48038",1122,834,824,0,10,"RECORTES CE",0
48,"48046",12617,9037,8967,56,70,"RECORTES CE",9
48,"48001",5832,4191,4166,37,25,"RECORTES CE",12
48,"48093",900,673,664,4,9,"RECORTES CE",1
48,"48015",33690,24299,24160,168,139,"RECORTES CE",42
48,"48030",608,454,453,4,1,"RECORTES CE",0
48,"48074",3333,2467,2428,20,39,"RECORTES CE",5
48,"48023",594,470,468,4,2,"RECORTES CE",0
48,"48007",365,241,239,0,2,"RECORTES CE",3
48,"48031",340,245,242,0,3,"RECORTES CE",1
48,"48059",402,317,314,1,3,"RECORTES CE",0
48,"48053",900,676,670,8,6,"RECORTES CE",0
48,"48026",1134,861,853,7,8,"RECORTES CE",0
48,"48051",220,169,168,0,1,"RECORTES CE",0
48,"48090",6022,4544,4483,23,61,"RECORTES CE",6
48,"48035",412,313,312,4,1,"RECORTES CE",0
48,"48019",3594,2569,2544,16,25,"RECORTES CE",6
48,"48062",300,241,240,1,1,"RECORTES CE",0
48,"48056",978,733,732,7,1,"RECORTES CE",1
48,"48011",9692,6891,6843,56,48,"RECORTES CE",13
48,"48005",117,76,76,0,0,"RECORTES CE",0
48,"48075",1975,1440,1421,12,19,"RECORTES CE",0
48,"48014",1218,870,866,8,4,"RECORTES CE",2
48,"48006",289,246,245,3,1,"RECORTES CE",0
48,"48054",24135,17493,17374,124,119,"RECORTES CE",20
48,"48901",4775,3602,3573,35,29,"RECORTES CE",2
48,"48025",883,642,639,3,3,"RECORTES CE",3
48,"48910",2948,2126,2115,17,11,"RECORTES CE",4
48,"48052",1559,1215,1211,0,4,"RECORTES CE",1
48,"48084",22577,15689,15540,108,149,"RECORTES CE",21
48,"48071",6118,4467,4412,32,55,"RECORTES CE",5
48,"48036",24144,17085,16954,117,131,"RECORTES CE",33
48,"48039",243,201,201,2,0,"RECORTES CE",0
48,"48028",715,553,551,4,2,"RECORTES CE",1
48,"48091",1134,821,812,7,9,"RECORTES CE",1
48,"48058",972,691,687,4,4,"RECORTES CE",1
48,"48034",12902,9684,9613,79,71,"RECORTES CE",26
48,"48061",762,584,581,4,3,"RECORTES CE",0
48,"48912",2308,1787,1746,27,41,"RECORTES CE",3
48,"48004",334,229,227,1,2,"RECORTES CE",0
48,"48915",362,238,238,2,0,"RECORTES CE",0
48,"48049",548,433,431,0,2,"RECORTES CE",0
48,"48045",5149,3940,3885,35,55,"RECORTES CE",7
48,"48029",8332,6155,6119,35,36,"RECORTES CE",14
48,"48013",79984,56928,56516,383,412,"RECORTES CE",131
48,"48027",22033,15929,15825,113,104,"RECORTES CE",21
48,"48097",1303,907,898,10,9,"RECORTES CE",1
48,"48022",2355,1476,1468,9,8,"RECORTES CE",3
48,"48081",1883,1412,1398,12,14,"RECORTES CE",0
48,"48909",207,165,165,1,0,"RECORTES CE",1
48,"48088",135,97,96,0,1,"RECORTES CE",0
48,"48021",1352,952,946,8,6,"RECORTES CE",0
48,"48037",678,518,509,2,9,"RECORTES CE",0
48,"48906",775,579,574,0,5,"RECORTES CE",0
48,"48057",5749,4093,4081,20,12,"RECORTES CE",2
48,"48066",346,256,256,1,0,"RECORTES CE",0
48,"48047",161,112,112,0,0,"RECORTES CE",0
48,"48087",429,346,343,1,3,"RECORTES CE",0
48,"48082",37673,27006,26811,201,195,"RECORTES CE",40
48,"48085",10301,7458,7407,50,51,"RECORTES CE",12
18,"18128",344,251,248,0,3,"PODEMOS",49
18,"18111",2743,2046,2033,14,13,"PODEMOS",501
18,"18013",4236,3108,3052,19,56,"PODEMOS",298
18,"18140",43567,29155,28932,194,223,"PODEMOS",5507
18,"18087",184873,138280,137516,836,764,"PODEMOS",24490
18,"18010",563,463,459,4,4,"PODEMOS",89
18,"18016",323,239,237,0,2,"PODEMOS",12
18,"18089",15132,10489,10402,64,87,"PODEMOS",1231
18,"18138",2482,1721,1712,8,9,"PODEMOS",227
18,"18149",5177,3946,3902,29,44,"PODEMOS",544
18,"18012",2330,1670,1660,15,10,"PODEMOS",112
18,"18061",1059,822,816,1,6,"PODEMOS",106
18,"18063",1191,770,767,6,3,"PODEMOS",41
18,"18117",513,402,396,4,6,"PODEMOS",59
18,"18045",1149,803,789,10,14,"PODEMOS",50
18,"18066",2108,1546,1540,4,6,"PODEMOS",229
18,"18099",1581,1271,1249,10,22,"PODEMOS",191
18,"18185",556,461,461,1,0,"PODEMOS",75
18,"18146",970,734,727,6,7,"PODEMOS",59
18,"18121",132,101,100,1,1,"PODEMOS",13
18,"18168",809,589,588,5,1,"PODEMOS",108
18,"18158",8408,5604,5542,38,62,"PODEMOS",984
18,"18147",3734,2416,2386,10,30,"PODEMOS",489
18,"18056",3545,2716,2687,25,29,"PODEMOS",289
18,"18180",631,448,447,2,1,"PODEMOS",64
18,"18179",546,378,377,1,1,"PODEMOS",41
18,"18007",785,527,523,3,4,"PODEMOS",29
18,"18003",14022,10417,10330,82,87,"PODEMOS",1813
18,"18084",4215,3179,3143,24,36,"PODEMOS",574
18,"18134",5811,4002,3946,25,56,"PODEMOS",809
18,"18901",512,359,357,1,2,"PODEMOS",83
18,"18011",4321,3136,3119,10,17,"PODEMOS",564
18,"18036",3768,2904,2882,18,22,"PODEMOS",473
18,"18027",2562,1846,1827,19,19,"PODEMOS",296
18,"18107",971,719,711,6,8,"PODEMOS",62
18,"18123",293,228,227,2,1,"PODEMOS",22
18,"18175",11624,8549,8467,41,82,"PODEMOS",1198
18,"18037",530,411,408,1,3,"PODEMOS",42
18,"18053",1667,1084,1078,9,6,"PODEMOS",87
18,"18132",3312,2582,2556,14,26,"PODEMOS",330
18,"18112",131,88,86,1,2,"PODEMOS",14
18,"18064",379,308,308,1,0,"PODEMOS",24
18,"18094",2389,1853,1832,22,21,"PODEMOS",222
18,"18122",16171,11670,11508,106,162,"PODEMOS",1158
18,"18024",855,660,653,8,7,"PODEMOS",105
18,"18039",3544,2544,2511,34,33,"PODEMOS",184
18,"18082",867,626,621,4,5,"PODEMOS",77
18,"18119",1729,1353,1340,13,13,"PODEMOS",177
18,"18144",782,596,588,3,8,"PODEMOS",129
18,"18083",266,210,207,1,3,"PODEMOS",26
18,"18181",223,159,157,0,2,"PODEMOS",3
18,"18025",294,216,214,0,2,"PODEMOS",24
18,"18136",1875,1477,1470,7,7,"PODEMOS",145
18,"18116",2882,2245,2215,19,30,"PODEMOS",341
18,"18127",16586,11998,11897,97,101,"PODEMOS",2456
18,"18137",1005,758,758,6,0,"PODEMOS",50
18,"18100",7769,5715,5637,57,78,"PODEMOS",746
18,"18161",220,184,184,1,0,"PODEMOS",22
18,"18018",640,490,488,0,2,"PODEMOS",54
18,"18032",239,178,175,0,3,"PODEMOS",40
18,"18188",1642,1249,1234,8,15,"PODEMOS",125
18,"18120",270,218,216,2,2,"PODEMOS",10
18,"18162",951,744,734,0,10,"PODEMOS",55
18,"18059",4153,3074,3039,23,35,"PODEMOS",551
18,"18095",1959,1486,1474,5,12,"PODEMOS",257
18,"18079",3465,2671,2645,16,26,"PODEMOS",471
18,"18187",561,418,417,1,1,"PODEMOS",46
18,"18157",1123,836,823,8,13,"PODEMOS",152
18,"18006",4161,2816,2788,29,28,"PODEMOS",281
18,"18153",8580,6314,6260,39,54,"PODEMOS",1287
18,"18126",1497,1094,1087,7,7,"PODEMOS",210
18,"18905",14500,10137,10058,82,79,"PODEMOS",1972
18,"18159",1009,811,802,3,9,"PODEMOS",90
18,"18912",1488,1021,1007,7,14,"PODEMOS",89
18,"18133",2187,1731,1722,7,9,"PODEMOS",161
18,"18097",956,703,691,1,12,"PODEMOS",87
18,"18141",414,282,277,1,5,"PODEMOS",15
18,"18165",4135,2944,2915,23,29,"PODEMOS",599
18,"18184",2158,1659,1634,4,25,"PODEMOS",223
18,"18173",8978,6319,6251,50,68,"PODEMOS",1197
18,"18071",5583,4221,4176,33,45,"PODEMOS",809
18,"18072",666,481,474,4,7,"PODEMOS",78
18,"18046",1867,1225,1215,8,10,"PODEMOS",147
18,"18038",1066,836,826,2,10,"PODEMOS",65
18,"18022",13306,9165,9091,51,74,"PODEMOS",2208
18,"18154",1016,716,716,2,0,"PODEMOS",42
18,"18017",18172,12077,11954,101,123,"PODEMOS",1712
18,"18069",493,366,363,3,3,"PODEMOS",52
18,"18004",724,511,505,3,6,"PODEMOS",28
18,"18047",5888,4028,4000,32,28,"PODEMOS",973
18,"18020",1469,1046,1032,7,14,"PODEMOS",110
18,"18174",442,354,348,2,6,"PODEMOS",28
18,"18108",858,672,667,0,5,"PODEMOS",94
18,"18085",729,489,484,2,5,"PODEMOS",43
18,"18005",375,266,265,2,1,"PODEMOS",35
18,"18171",2123,1640,1616,14,24,"PODEMOS",133
18,"18148",819,671,666,1,5,"PODEMOS",65
18,"18101",9263,6971,6912,55,59,"PODEMOS",1424
18,"18048",2390,1824,1806,8,18,"PODEMOS",363
18,"18135",4583,3045,2998,14,47,"PODEMOS",303
18,"18124",393,274,271,1,3,"PODEMOS",19
18,"18030",584,428,426,3,2,"PODEMOS",47
18,"18021",17451,12420,12305,101,115,"PODEMOS",2528
18,"18098",6167,4367,4342,22,25,"PODEMOS",448
18,"18074",273,217,213,2,4,"PODEMOS",6
18,"18002",561,446,444,1,2,"PODEMOS",23
18,"18023",15738,11242,11146,92,96,"PODEMOS",1257
18,"18163",324,239,235,1,4,"PODEMOS",28
18,"18054",868,630,627,2,3,"PODEMOS",93
18,"18145",10432,7829,7767,56,62,"PODEMOS",1423
18,"18040",225,142,141,0,1,"PODEMOS",43
18,"18044",179,116,116,0,0,"PODEMOS",10
18,"18177",427,259,258,3,1,"PODEMOS",10
18,"18102",8424,5783,5716,41,67,"PODEMOS",801
18,"18015",443,338,337,0,1,"PODEMOS",19
18,"18096",342,260,259,1,1,"PODEMOS",19
18,"18909",589,462,459,0,3,"PODEMOS",22
18,"18904",779,570,565,1,5,"PODEMOS",55
18,"18029",1833,1252,1243,9,9,"PODEMOS",124
18,"18182",1919,1356,1347,3,9,"PODEMOS",76
18,"18034",510,391,391,1,0,"PODEMOS",79
18,"18913",818,617,603,2,14,"PODEMOS",36
18,"18152",938,687,681,1,6,"PODEMOS",48
18,"18065",625,503,500,1,3,"PODEMOS",97
18,"18911",7392,5359,5301,44,58,"PODEMOS",1053
18,"18170",336,227,225,1,2,"PODEMOS",29
18,"18109",599,421,419,2,2,"PODEMOS",26
18,"18194",2152,1487,1477,6,10,"PODEMOS",166
18,"18062",10298,7584,7512,67,72,"PODEMOS",1366
18,"18903",892,650,645,1,5,"PODEMOS",44
18,"18103",760,596,593,6,3,"PODEMOS",24
18,"18051",1149,825,823,7,2,"PODEMOS",51
18,"18914",1658,1304,1290,8,14,"PODEMOS",190
18,"18001",256,178,177,2,1,"PODEMOS",6
18,"18093",2752,1873,1858,10,15,"PODEMOS",172
18,"18028",945,790,781,2,9,"PODEMOS",37
18,"18183",660,468,465,3,3,"PODEMOS",39
18,"18033",294,220,219,1,1,"PODEMOS",19
18,"18086",355,285,283,0,2,"PODEMOS",43
18,"18105",4548,3169,3139,19,30,"PODEMOS",379
18,"18042",414,342,341,0,1,"PODEMOS",65
18,"18078",739,593,590,4,3,"PODEMOS",68
18,"18076",815,577,576,0,1,"PODEMOS",33
18,"18178",743,571,571,2,0,"PODEMOS",39
18,"18014",6372,4620,4566,44,54,"PODEMOS",856
18,"18193",14194,10280,10196,91,84,"PODEMOS",2127
18,"18067",711,517,516,0,1,"PODEMOS",42
18,"18049",617,456,451,3,5,"PODEMOS",51
18,"18164",1831,1273,1260,11,13,"PODEMOS",126
18,"18167",1897,1321,1313,8,8,"PODEMOS",180
18,"18906",917,681,673,2,8,"PODEMOS",81
18,"18176",258,179,178,3,1,"PODEMOS",32
18,"18057",5263,3968,3937,33,31,"PODEMOS",716
18,"18910",803,573,569,5,4,"PODEMOS",61
18,"18035",1255,964,958,4,6,"PODEMOS",97
18,"18143",979,781,776,2,5,"PODEMOS",191
18,"18043",129,95,95,0,0,"PODEMOS",35
18,"18189",772,599,595,7,4,"PODEMOS",121
18,"18068",1566,1234,1214,5,20,"PODEMOS",259
18,"18902",847,680,674,10,6,"PODEMOS",82
18,"18115",2548,1872,1854,16,18,"PODEMOS",364
18,"18192",1529,1216,1208,3,8,"PODEMOS",122
18,"18151",260,196,196,0,0,"PODEMOS",40
18,"18070",283,223,218,0,5,"PODEMOS",35
18,"18114",634,457,452,2,5,"PODEMOS",82
18,"18050",1711,1271,1256,5,15,"PODEMOS",227
18,"18908",805,633,620,2,13,"PODEMOS",79
18,"18150",6730,4858,4814,28,44,"PODEMOS",814
18,"18907",1859,1482,1475,5,7,"PODEMOS",121
18,"18088",1556,1113,1108,5,5,"PODEMOS",154
38,"38011",20435,13760,13627,82,133,"IUC-UPeC",502
38,"38043",18918,12883,12737,109,146,"IUC-UPeC",440
38,"38026",32918,24984,24727,174,257,"IUC-UPeC",682
38,"38052",1281,853,844,2,9,"IUC-UPeC",21
38,"38009",4127,2842,2793,15,49,"IUC-UPeC",82
38,"38041",6808,4869,4835,42,34,"IUC-UPeC",166
38,"38042",3784,2692,2673,16,19,"IUC-UPeC",42
38,"38021",1643,1014,1002,5,12,"IUC-UPeC",15
38,"38053",3754,2419,2370,15,49,"IUC-UPeC",90
38,"38019",13217,8168,8075,54,93,"IUC-UPeC",100
38,"38008",5513,3683,3609,17,74,"IUC-UPeC",103
38,"38005",5463,3443,3417,24,26,"IUC-UPeC",71
38,"38049",2653,1683,1658,8,25,"IUC-UPeC",46
38,"38015",4158,2864,2818,12,46,"IUC-UPeC",55
38,"38034",4041,2853,2814,17,39,"IUC-UPeC",75
38,"38047",1789,1228,1208,5,20,"IUC-UPeC",27
38,"38035",9299,5558,5500,35,58,"IUC-UPeC",138
38,"38032",13257,8969,8902,72,67,"IUC-UPeC",318
38,"38901",1387,883,876,4,7,"IUC-UPeC",40
38,"38017",28037,16236,16076,100,160,"IUC-UPeC",476
38,"38007",1689,1143,1119,3,24,"IUC-UPeC",29
38,"38044",2206,1317,1303,10,14,"IUC-UPeC",10
38,"38030",1923,1309,1300,5,9,"IUC-UPeC",34
38,"38029",1533,776,763,7,13,"IUC-UPeC",39
38,"38016",1215,654,641,4,13,"IUC-UPeC",30
38,"38036",6553,4604,4529,45,75,"IUC-UPeC",197
38,"38038",162030,105122,104174,667,948,"IUC-UPeC",3910
38,"38001",20166,11307,11195,55,112,"IUC-UPeC",265
38,"38045",3987,2152,2132,23,20,"IUC-UPeC",116
38,"38014",1351,935,929,3,6,"IUC-UPeC",26
38,"38006",39553,21159,20940,124,219,"IUC-UPeC",469
38,"38033",3721,2552,2504,15,48,"IUC-UPeC",60
38,"38022",18468,12230,12085,86,145,"IUC-UPeC",170
38,"38050",2471,1616,1590,8,26,"IUC-UPeC",30
38,"38013",2915,1865,1847,12,18,"IUC-UPeC",35
38,"38003",1440,970,960,2,10,"IUC-UPeC",23
38,"38028",22063,15095,14954,89,141,"IUC-UPeC",428
38,"38023",121610,81337,80453,527,884,"IUC-UPeC",3428
38,"38051",7217,5147,5089,31,58,"IUC-UPeC",88
38,"38040",4990,3061,3031,16,30,"IUC-UPeC",44
38,"38012",2378,1620,1606,6,14,"IUC-UPeC",31
38,"38004",4442,2980,2939,20,41,"IUC-UPeC",182
38,"38010",4014,2726,2678,15,48,"IUC-UPeC",74
38,"38002",942,701,674,14,27,"IUC-UPeC",13
38,"38025",6860,4836,4761,49,75,"IUC-UPeC",82
38,"38027",5386,3685,3615,29,70,"IUC-UPeC",109
38,"38031",28697,21546,21202,140,344,"IUC-UPeC",685
38,"38018",4405,3053,3005,21,48,"IUC-UPeC",55
38,"38048",3878,2664,2624,20,40,"IUC-UPeC",96
38,"38039",10584,7532,7462,77,70,"IUC-UPeC",172
38,"38024",15055,9612,9485,77,127,"IUC-UPeC",343
38,"38037",12997,8126,7997,46,129,"IUC-UPeC",311
38,"38046",9107,6755,6682,45,73,"IUC-UPeC",300
38,"38020",15021,9813,9693,51,120,"IUC-UPeC",325
30,"30001",4596,3602,3572,20,30,"EB",3
30,"30029",11815,8365,8296,67,69,"EB",4
30,"30023",3762,2871,2837,14,34,"EB",1
30,"30019",25921,18079,17894,121,185,"EB",25
30,"30016",151577,103359,102538,620,821,"EB",221
30,"30041",13640,9156,9092,52,64,"EB",16
30,"30020",6261,4502,4459,25,43,"EB",5
30,"30004",1141,938,933,5,5,"EB",0
30,"30010",6861,5287,5220,38,67,"EB",8
30,"30038",15381,10881,10797,51,84,"EB",14
30,"30030",312625,235232,233576,1438,1656,"EB",394
30,"30011",4706,3582,3541,20,41,"EB",5
30,"30002",9921,7263,7166,34,97,"EB",4
30,"30018",7903,5990,5912,29,78,"EB",5
30,"30021",9101,6106,6034,25,72,"EB",4
30,"30901",10331,7925,7833,54,92,"EB",12
30,"30902",8022,5454,5412,34,42,"EB",5
30,"30017",11635,8718,8646,46,72,"EB",9
30,"30024",58529,42392,42072,275,320,"EB",51
30,"30042",1918,1518,1500,6,18,"EB",1
30,"30039",19199,13538,13405,101,133,"EB",38
30,"30033",10144,7591,7505,86,86,"EB",7
30,"30025",4900,3777,3727,20,50,"EB",3
30,"30037",18726,13183,13027,73,156,"EB",15
30,"30031",498,424,421,2,3,"EB",4
30,"30036",14624,10139,9988,70,151,"EB",10
30,"30015",19154,13947,13835,77,112,"EB",12
30,"30022",16894,11661,11498,119,163,"EB",9
30,"30040",727,627,620,1,7,"EB",0
30,"30006",803,683,681,2,2,"EB",2
30,"30012",9101,7170,7091,46,79,"EB",4
30,"30032",2849,2188,2161,10,27,"EB",6
30,"30013",7395,5320,5277,38,43,"EB",5
30,"30003",24305,16558,16419,122,139,"EB",22
30,"30035",18616,13185,13085,70,100,"EB",11
30,"30028",6690,5005,4938,29,67,"EB",8
30,"30009",12392,9724,9599,40,125,"EB",5
30,"30005",29559,21408,21203,123,205,"EB",25
30,"30027",47867,36054,35794,181,260,"EB",50
30,"30014",1598,1270,1258,5,12,"EB",0
30,"30034",1138,859,846,5,13,"EB",1
30,"30007",6415,4554,4515,19,39,"EB",1
30,"30043",24972,19411,19139,154,272,"EB",9
30,"30008",13860,10066,9945,74,121,"EB",18
30,"30026",15722,10147,10024,49,123,"EB",10
34,"34068",25,24,24,1,0,"PCPE",0
34,"34055",280,204,202,2,2,"PCPE",0
34,"34107",81,49,49,3,0,"PCPE",0
34,"34137",28,24,24,1,0,"PCPE",0
34,"34161",23,14,14,0,0,"PCPE",0
34,"34091",123,97,95,1,2,"PCPE",0
34,"34079",1601,1285,1269,11,16,"PCPE",0
34,"34221",179,135,132,3,3,"PCPE",0
34,"34149",20,15,15,0,0,"PCPE",0
34,"34034",126,93,93,1,0,"PCPE",0
34,"34223",219,159,158,1,1,"PCPE",0
34,"34139",168,126,124,6,2,"PCPE",0
34,"34182",792,632,620,3,12,"PCPE",1
34,"34238",341,279,276,1,3,"PCPE",0
34,"34073",187,150,149,0,1,"PCPE",0
34,"34196",91,70,69,1,1,"PCPE",0
34,"34067",129,95,95,0,0,"PCPE",1
34,"34082",84,71,71,0,0,"PCPE",1
34,"34177",179,149,148,1,1,"PCPE",0
34,"34006",80,69,66,1,3,"PCPE",0
34,"34132",115,93,92,0,1,"PCPE",1
34,"34001",35,28,28,2,0,"PCPE",0
34,"34052",178,148,147,3,1,"PCPE",0
34,"34165",66,59,59,0,0,"PCPE",0
34,"34240",90,71,70,2,1,"PCPE",1
34,"34124",61,47,46,0,1,"PCPE",0
34,"34246",64,49,47,1,2,"PCPE",0
34,"34901",1126,881,865,6,16,"PCPE",0
34,"34011",398,326,326,3,0,"PCPE",0
34,"34066",58,45,45,0,0,"PCPE",0
34,"34012",362,277,272,4,5,"PCPE",0
34,"34041",89,71,71,1,0,"PCPE",1
34,"34157",2460,1872,1836,26,36,"PCPE",2
34,"34020",53,39,39,0,0,"PCPE",1
34,"34019",125,103,101,1,2,"PCPE",0
34,"34015",39,32,31,1,1,"PCPE",0
34,"34126",279,218,218,2,0,"PCPE",0
34,"34103",96,78,77,2,1,"PCPE",0
34,"34211",180,151,149,3,2,"PCPE",0
34,"34146",55,42,42,0,0,"PCPE",0
34,"34083",1773,1259,1244,8,15,"PCPE",1
34,"34218",469,353,349,2,4,"PCPE",0
34,"34245",311,213,209,4,4,"PCPE",0
34,"34077",349,253,246,0,7,"PCPE",2
34,"34158",290,190,188,3,2,"PCPE",1
34,"34230",15,12,12,0,0,"PCPE",0
34,"34027",1096,786,781,11,5,"PCPE",4
34,"34225",4903,3830,3784,41,46,"PCPE",8
34,"34184",55,46,42,0,4,"PCPE",0
34,"34003",163,127,125,0,2,"PCPE",1
34,"34023",5265,3948,3918,38,30,"PCPE",4
34,"34229",67,55,55,1,0,"PCPE",0
34,"34038",277,202,202,3,0,"PCPE",0
34,"34076",597,494,490,3,4,"PCPE",0
34,"34205",59,45,45,0,0,"PCPE",0
34,"34154",76,54,52,0,2,"PCPE",0
34,"34210",102,90,89,0,1,"PCPE",0
34,"34093",90,72,70,0,2,"PCPE",0
34,"34069",2285,1711,1692,25,19,"PCPE",3
34,"34081",61,50,49,0,1,"PCPE",0
34,"34904",319,241,240,3,1,"PCPE",0
34,"34088",231,192,190,2,2,"PCPE",0
34,"34036",216,167,165,1,2,"PCPE",0
34,"34216",67,52,51,0,1,"PCPE",0
34,"34228",81,66,66,0,0,"PCPE",0
34,"34127",95,64,64,2,0,"PCPE",0
34,"34213",58,43,42,2,1,"PCPE",1
34,"34227",76,62,62,1,0,"PCPE",0
34,"34134",53,37,37,2,0,"PCPE",0
34,"34102",205,172,170,1,2,"PCPE",0
34,"34046",43,31,29,0,2,"PCPE",0
34,"34176",134,102,100,2,2,"PCPE",0
34,"34094",61,42,40,1,2,"PCPE",0
34,"34037",310,218,217,4,1,"PCPE",0
34,"34141",182,148,147,4,1,"PCPE",0
34,"34061",108,80,80,0,0,"PCPE",0
34,"34100",142,116,115,5,1,"PCPE",0
34,"34017",920,763,745,2,18,"PCPE",1
34,"34029",727,596,582,4,14,"PCPE",1
34,"34123",1668,1346,1319,20,27,"PCPE",0
34,"34120",64404,49403,48884,379,519,"PCPE",48
34,"34233",131,116,116,1,0,"PCPE",0
34,"34232",748,601,586,11,15,"PCPE",3
34,"34190",56,40,40,3,0,"PCPE",0
34,"34018",209,169,166,3,3,"PCPE",0
34,"34215",163,148,148,2,0,"PCPE",0
34,"34143",172,127,126,3,1,"PCPE",0
34,"34131",59,50,48,0,2,"PCPE",0
34,"34080",5626,3906,3835,39,71,"PCPE",8
34,"34092",297,236,231,2,5,"PCPE",0
34,"34159",363,277,269,4,8,"PCPE",1
34,"34098",780,587,582,2,5,"PCPE",0
34,"34101",54,42,42,0,0,"PCPE",1
34,"34151",167,111,111,3,0,"PCPE",0
34,"34045",77,65,65,2,0,"PCPE",0
34,"34171",982,720,710,7,10,"PCPE",2
34,"34181",453,343,337,3,6,"PCPE",5
34,"34201",193,163,161,2,2,"PCPE",0
34,"34084",140,110,108,1,2,"PCPE",1
34,"34140",107,63,62,0,1,"PCPE",0
34,"34220",144,129,128,0,1,"PCPE",0
34,"34231",232,167,167,4,0,"PCPE",0
34,"34004",5626,4226,4178,41,48,"PCPE",4
34,"34099",61,51,50,0,1,"PCPE",0
34,"34236",162,126,126,1,0,"PCPE",0
34,"34039",61,46,45,0,1,"PCPE",0
34,"34086",105,91,88,1,3,"PCPE",0
34,"34005",858,670,651,6,19,"PCPE",2
34,"34129",179,139,137,2,2,"PCPE",1
34,"34089",157,124,122,1,2,"PCPE",0
34,"34167",114,89,89,0,0,"PCPE",0
34,"34208",53,41,41,1,0,"PCPE",0
34,"34241",18,13,12,2,1,"PCPE",0
34,"34189",57,45,45,1,0,"PCPE",0
34,"34122",84,66,65,0,1,"PCPE",0
34,"34204",47,39,39,2,0,"PCPE",0
34,"34130",213,175,172,2,3,"PCPE",0
34,"34185",65,46,44,2,2,"PCPE",0
34,"34222",120,82,82,2,0,"PCPE",0
34,"34903",198,128,127,1,1,"PCPE",0
34,"34112",47,38,38,0,0,"PCPE",0
34,"34071",172,140,139,4,1,"PCPE",0
34,"34022",1095,915,909,8,6,"PCPE",4
34,"34217",1200,954,934,6,20,"PCPE",2
34,"34047",1803,1402,1380,15,22,"PCPE",0
34,"34175",89,75,74,1,1,"PCPE",0
34,"34214",186,150,149,1,1,"PCPE",0
34,"34096",57,46,46,3,0,"PCPE",0
34,"34059",422,348,341,6,7,"PCPE",0
34,"34234",72,57,55,0,2,"PCPE",0
34,"34072",160,142,140,1,2,"PCPE",0
34,"34106",114,94,94,2,0,"PCPE",0
34,"34174",205,162,162,4,0,"PCPE",0
34,"34110",91,78,78,2,0,"PCPE",1
34,"34192",93,76,76,0,0,"PCPE",0
34,"34133",107,85,82,0,3,"PCPE",1
34,"34048",76,64,64,1,0,"PCPE",0
34,"34156",49,42,41,3,1,"PCPE",0
34,"34056",2003,1502,1487,12,15,"PCPE",0
34,"34121",192,155,154,2,1,"PCPE",0
34,"34136",182,121,120,1,1,"PCPE",0
34,"34060",137,113,112,1,1,"PCPE",0
34,"34010",570,437,429,5,8,"PCPE",1
34,"34155",135,105,104,1,1,"PCPE",1
34,"34152",124,102,99,1,3,"PCPE",1
34,"34049",369,280,274,1,6,"PCPE",0
34,"34135",391,296,291,4,5,"PCPE",0
34,"34202",31,20,19,0,1,"PCPE",0
34,"34180",68,56,56,2,0,"PCPE",0
34,"34070",160,117,115,2,2,"PCPE",0
34,"34160",143,112,110,1,2,"PCPE",0
34,"34179",29,22,20,0,2,"PCPE",0
34,"34032",41,32,31,0,1,"PCPE",0
34,"34058",184,167,167,0,0,"PCPE",0
34,"34074",719,552,545,8,7,"PCPE",0
34,"34168",55,51,51,1,0,"PCPE",0
34,"34009",33,29,26,1,3,"PCPE",0
34,"34169",404,302,300,2,2,"PCPE",0
34,"34104",247,203,199,0,4,"PCPE",0
34,"34035",113,90,89,1,1,"PCPE",0
34,"34062",176,111,111,3,0,"PCPE",0
34,"34224",45,31,31,0,0,"PCPE",0
34,"34237",597,472,465,5,7,"PCPE",0
34,"34042",300,247,244,4,3,"PCPE",0
34,"34170",62,49,49,0,0,"PCPE",0
34,"34147",167,120,120,1,0,"PCPE",0
34,"34051",102,90,88,1,2,"PCPE",1
34,"34063",86,80,79,1,1,"PCPE",0
34,"34114",212,147,146,2,1,"PCPE",0
34,"34178",113,92,91,5,1,"PCPE",0
34,"34163",49,40,40,0,0,"PCPE",0
34,"34028",144,121,119,1,2,"PCPE",0
34,"34243",326,263,258,2,5,"PCPE",0
34,"34113",37,36,36,0,0,"PCPE",0
34,"34033",18,17,17,0,0,"PCPE",0
34,"34116",62,41,41,0,0,"PCPE",0
34,"34053",209,170,168,4,2,"PCPE",0
34,"34199",1248,955,937,18,18,"PCPE",2
34,"34087",127,109,108,1,1,"PCPE",0
34,"34109",59,48,47,0,1,"PCPE",0
34,"34050",202,160,160,0,0,"PCPE",0
34,"34242",95,74,73,1,1,"PCPE",0
34,"34108",537,453,446,5,7,"PCPE",0
34,"34902",140,115,114,0,1,"PCPE",0
34,"34125",88,69,68,1,1,"PCPE",0
34,"34025",61,44,44,1,0,"PCPE",0
34,"34206",879,688,680,3,8,"PCPE",0
34,"34057",476,339,334,3,5,"PCPE",0
34,"34186",51,45,45,0,0,"PCPE",0
34,"34031",29,28,28,1,0,"PCPE",0
34,"34024",32,19,19,0,0,"PCPE",0
27,"27064",1593,1179,1153,14,26,"PODEMOS-EN",155
27,"27014",3284,2187,2148,29,39,"PODEMOS-EN",284
27,"27012",1366,778,769,5,9,"PODEMOS-EN",71
27,"27013",3782,3067,3007,21,60,"PODEMOS-EN",932
27,"27063",1761,1340,1299,12,41,"PODEMOS-EN",213
27,"27032",3313,2269,2230,29,39,"PODEMOS-EN",420
27,"27033",631,454,449,8,5,"PODEMOS-EN",35
27,"27039",4372,3327,3244,56,83,"PODEMOS-EN",546
27,"27053",546,349,349,1,0,"PODEMOS-EN",20
27,"27044",2901,1891,1832,28,59,"PODEMOS-EN",242
27,"27051",8102,5883,5784,71,99,"PODEMOS-EN",1294
27,"27027",1937,1458,1425,19,33,"PODEMOS-EN",251
27,"27003",1913,1372,1351,16,21,"PODEMOS-EN",174
27,"27031",15650,10901,10710,106,191,"PODEMOS-EN",2426
27,"27035",190,121,121,2,0,"PODEMOS-EN",27
27,"27002",1651,1224,1200,8,24,"PODEMOS-EN",153
27,"27015",4304,3063,2985,41,78,"PODEMOS-EN",487
27,"27023",2593,1981,1942,24,39,"PODEMOS-EN",180
27,"27022",4859,3324,3251,38,73,"PODEMOS-EN",629
27,"27057",11176,7921,7709,99,212,"PODEMOS-EN",1426
27,"27902",7196,5017,4921,55,96,"PODEMOS-EN",1225
27,"27005",2615,1942,1918,16,24,"PODEMOS-EN",323
27,"27037",1075,736,723,12,13,"PODEMOS-EN",63
27,"27025",2859,2293,2243,17,50,"PODEMOS-EN",449
27,"27048",2176,1658,1626,19,32,"PODEMOS-EN",181
27,"27060",2651,1761,1729,12,32,"PODEMOS-EN",287
27,"27045",1049,667,658,9,9,"PODEMOS-EN",52
27,"27052",918,659,649,3,10,"PODEMOS-EN",77
27,"27043",1313,875,855,14,20,"PODEMOS-EN",104
27,"27028",79061,57271,56444,702,827,"PODEMOS-EN",13963
27,"27018",3514,2279,2255,17,24,"PODEMOS-EN",330
27,"27059",2202,1640,1605,19,35,"PODEMOS-EN",234
27,"27056",1268,899,886,11,13,"PODEMOS-EN",186
27,"27054",1205,920,906,7,14,"PODEMOS-EN",116
27,"27008",1377,1011,992,11,19,"PODEMOS-EN",147
27,"27058",3577,2669,2632,37,37,"PODEMOS-EN",262
27,"27029",1475,1142,1116,19,26,"PODEMOS-EN",164
27,"27020",3539,2954,2896,38,58,"PODEMOS-EN",254
27,"27038",945,679,674,9,5,"PODEMOS-EN",74
27,"27019",8120,6041,5936,82,105,"PODEMOS-EN",1342
27,"27016",7204,5069,4987,65,82,"PODEMOS-EN",994
27,"27030",3361,2333,2290,27,43,"PODEMOS-EN",411
27,"27026",2423,1667,1602,12,65,"PODEMOS-EN",218
27,"27010",4363,3072,2990,45,82,"PODEMOS-EN",553
27,"27040",3225,2454,2415,22,39,"PODEMOS-EN",276
27,"27001",2401,1346,1313,24,33,"PODEMOS-EN",152
27,"27901",2404,1647,1624,25,23,"PODEMOS-EN",202
27,"27049",1422,969,958,8,11,"PODEMOS-EN",87
27,"27065",12528,8701,8483,150,218,"PODEMOS-EN",1339
27,"27050",2993,2241,2203,16,38,"PODEMOS-EN",322
27,"27042",1759,1258,1235,21,23,"PODEMOS-EN",94
27,"27007",2833,2211,2144,34,67,"PODEMOS-EN",248
27,"27047",1643,1116,1104,10,12,"PODEMOS-EN",173
27,"27061",1045,821,796,10,25,"PODEMOS-EN",87
27,"27004",1251,846,828,2,18,"PODEMOS-EN",68
27,"27024",1624,1250,1226,8,24,"PODEMOS-EN",150
27,"27066",12767,9200,9039,102,161,"PODEMOS-EN",2102
27,"27017",1017,674,666,6,8,"PODEMOS-EN",104
27,"27009",2110,1595,1573,11,22,"PODEMOS-EN",193
27,"27034",1154,720,710,6,10,"PODEMOS-EN",89
27,"27046",1538,1119,1099,10,20,"PODEMOS-EN",163
27,"27041",2377,1737,1722,16,15,"PODEMOS-EN",223
27,"27006",2611,1752,1723,26,29,"PODEMOS-EN",268
27,"27055",1320,869,855,3,14,"PODEMOS-EN",101
27,"27021",1772,1167,1136,21,31,"PODEMOS-EN",167
27,"27062",619,468,465,6,3,"PODEMOS-EN",41
27,"27011",2490,1623,1592,14,31,"PODEMOS-EN",250
34,"34091",123,97,95,1,2,"PODEMOS",11
34,"34020",53,39,39,0,0,"PODEMOS",2
34,"34055",280,204,202,2,2,"PODEMOS",14
34,"34134",53,37,37,2,0,"PODEMOS",8
34,"34154",76,54,52,0,2,"PODEMOS",4
34,"34082",84,71,71,0,0,"PODEMOS",4
34,"34137",28,24,24,1,0,"PODEMOS",1
34,"34190",56,40,40,3,0,"PODEMOS",1
34,"34058",184,167,167,0,0,"PODEMOS",11
34,"34192",93,76,76,0,0,"PODEMOS",6
34,"34107",81,49,49,3,0,"PODEMOS",2
34,"34208",53,41,41,1,0,"PODEMOS",1
34,"34158",290,190,188,3,2,"PODEMOS",34
34,"34096",57,46,46,3,0,"PODEMOS",3
34,"34092",297,236,231,2,5,"PODEMOS",10
34,"34161",23,14,14,0,0,"PODEMOS",0
34,"34176",134,102,100,2,2,"PODEMOS",7
34,"34086",105,91,88,1,3,"PODEMOS",7
34,"34114",212,147,146,2,1,"PODEMOS",4
34,"34037",310,218,217,4,1,"PODEMOS",17
34,"34231",232,167,167,4,0,"PODEMOS",14
34,"34236",162,126,126,1,0,"PODEMOS",3
34,"34129",179,139,137,2,2,"PODEMOS",4
34,"34177",179,149,148,1,1,"PODEMOS",18
34,"34059",422,348,341,6,7,"PODEMOS",22
34,"34028",144,121,119,1,2,"PODEMOS",23
34,"34010",570,437,429,5,8,"PODEMOS",31
34,"34046",43,31,29,0,2,"PODEMOS",2
34,"34035",113,90,89,1,1,"PODEMOS",6
34,"34141",182,148,147,4,1,"PODEMOS",16
34,"34112",47,38,38,0,0,"PODEMOS",1
34,"34011",398,326,326,3,0,"PODEMOS",22
34,"34152",124,102,99,1,3,"PODEMOS",6
34,"34224",45,31,31,0,0,"PODEMOS",0
34,"34031",29,28,28,1,0,"PODEMOS",1
34,"34210",102,90,89,0,1,"PODEMOS",7
34,"34169",404,302,300,2,2,"PODEMOS",31
34,"34240",90,71,70,2,1,"PODEMOS",7
34,"34103",96,78,77,2,1,"PODEMOS",3
34,"34140",107,63,62,0,1,"PODEMOS",2
34,"34182",792,632,620,3,12,"PODEMOS",54
34,"34121",192,155,154,2,1,"PODEMOS",6
34,"34133",107,85,82,0,3,"PODEMOS",6
34,"34015",39,32,31,1,1,"PODEMOS",3
34,"34039",61,46,45,0,1,"PODEMOS",1
34,"34042",300,247,244,4,3,"PODEMOS",16
34,"34135",391,296,291,4,5,"PODEMOS",38
34,"34023",5265,3948,3918,38,30,"PODEMOS",769
34,"34074",719,552,545,8,7,"PODEMOS",49
34,"34184",55,46,42,0,4,"PODEMOS",7
34,"34214",186,150,149,1,1,"PODEMOS",17
34,"34071",172,140,139,4,1,"PODEMOS",11
34,"34196",91,70,69,1,1,"PODEMOS",5
34,"34116",62,41,41,0,0,"PODEMOS",3
34,"34029",727,596,582,4,14,"PODEMOS",22
34,"34232",748,601,586,11,15,"PODEMOS",51
34,"34218",469,353,349,2,4,"PODEMOS",15
34,"34242",95,74,73,1,1,"PODEMOS",5
34,"34165",66,59,59,0,0,"PODEMOS",5
34,"34027",1096,786,781,11,5,"PODEMOS",92
34,"34047",1803,1402,1380,15,22,"PODEMOS",87
34,"34072",160,142,140,1,2,"PODEMOS",7
34,"34084",140,110,108,1,2,"PODEMOS",2
34,"34178",113,92,91,5,1,"PODEMOS",5
34,"34243",326,263,258,2,5,"PODEMOS",10
34,"34246",64,49,47,1,2,"PODEMOS",2
34,"34004",5626,4226,4178,41,48,"PODEMOS",604
34,"34143",172,127,126,3,1,"PODEMOS",7
34,"34227",76,62,62,1,0,"PODEMOS",7
34,"34033",18,17,17,0,0,"PODEMOS",1
34,"34060",137,113,112,1,1,"PODEMOS",16
34,"34241",18,13,12,2,1,"PODEMOS",0
34,"34222",120,82,82,2,0,"PODEMOS",4
34,"34146",55,42,42,0,0,"PODEMOS",9
34,"34083",1773,1259,1244,8,15,"PODEMOS",164
34,"34034",126,93,93,1,0,"PODEMOS",12
34,"34051",102,90,88,1,2,"PODEMOS",7
34,"34155",135,105,104,1,1,"PODEMOS",8
34,"34093",90,72,70,0,2,"PODEMOS",2
34,"34149",20,15,15,0,0,"PODEMOS",2
34,"34160",143,112,110,1,2,"PODEMOS",17
34,"34206",879,688,680,3,8,"PODEMOS",43
34,"34077",349,253,246,0,7,"PODEMOS",33
34,"34230",15,12,12,0,0,"PODEMOS",2
34,"34902",140,115,114,0,1,"PODEMOS",7
34,"34032",41,32,31,0,1,"PODEMOS",6
34,"34089",157,124,122,1,2,"PODEMOS",20
34,"34151",167,111,111,3,0,"PODEMOS",10
34,"34098",780,587,582,2,5,"PODEMOS",99
34,"34163",49,40,40,0,0,"PODEMOS",3
34,"34132",115,93,92,0,1,"PODEMOS",15
34,"34126",279,218,218,2,0,"PODEMOS",21
34,"34100",142,116,115,5,1,"PODEMOS",7
34,"34147",167,120,120,1,0,"PODEMOS",9
34,"34070",160,117,115,2,2,"PODEMOS",13
34,"34104",247,203,199,0,4,"PODEMOS",4
34,"34220",144,129,128,0,1,"PODEMOS",10
34,"34088",231,192,190,2,2,"PODEMOS",26
34,"34102",205,172,170,1,2,"PODEMOS",10
34,"34094",61,42,40,1,2,"PODEMOS",2
34,"34067",129,95,95,0,0,"PODEMOS",16
34,"34171",982,720,710,7,10,"PODEMOS",93
34,"34003",163,127,125,0,2,"PODEMOS",16
34,"34006",80,69,66,1,3,"PODEMOS",5
34,"34199",1248,955,937,18,18,"PODEMOS",152
34,"34045",77,65,65,2,0,"PODEMOS",1
34,"34052",178,148,147,3,1,"PODEMOS",26
34,"34205",59,45,45,0,0,"PODEMOS",3
34,"34063",86,80,79,1,1,"PODEMOS",5
34,"34157",2460,1872,1836,26,36,"PODEMOS",223
34,"34139",168,126,124,6,2,"PODEMOS",12
34,"34073",187,150,149,0,1,"PODEMOS",12
34,"34012",362,277,272,4,5,"PODEMOS",28
34,"34120",64404,49403,48884,379,519,"PODEMOS",7298
34,"34156",49,42,41,3,1,"PODEMOS",1
34,"34181",453,343,337,3,6,"PODEMOS",54
34,"34019",125,103,101,1,2,"PODEMOS",7
34,"34068",25,24,24,1,0,"PODEMOS",6
34,"34136",182,121,120,1,1,"PODEMOS",6
34,"34125",88,69,68,1,1,"PODEMOS",7
34,"34076",597,494,490,3,4,"PODEMOS",28
34,"34217",1200,954,934,6,20,"PODEMOS",179
34,"34022",1095,915,909,8,6,"PODEMOS",87
34,"34175",89,75,74,1,1,"PODEMOS",8
34,"34109",59,48,47,0,1,"PODEMOS",8
34,"34215",163,148,148,2,0,"PODEMOS",16
34,"34066",58,45,45,0,0,"PODEMOS",6
34,"34228",81,66,66,0,0,"PODEMOS",5
34,"34041",89,71,71,1,0,"PODEMOS",5
34,"34213",58,43,42,2,1,"PODEMOS",10
34,"34179",29,22,20,0,2,"PODEMOS",0
34,"34180",68,56,56,2,0,"PODEMOS",4
34,"34903",198,128,127,1,1,"PODEMOS",11
34,"34170",62,49,49,0,0,"PODEMOS",0
34,"34174",205,162,162,4,0,"PODEMOS",10
34,"34081",61,50,49,0,1,"PODEMOS",5
34,"34202",31,20,19,0,1,"PODEMOS",2
34,"34087",127,109,108,1,1,"PODEMOS",10
34,"34233",131,116,116,1,0,"PODEMOS",7
34,"34061",108,80,80,0,0,"PODEMOS",14
34,"34108",537,453,446,5,7,"PODEMOS",38
34,"34123",1668,1346,1319,20,27,"PODEMOS",126
34,"34159",363,277,269,4,8,"PODEMOS",43
34,"34225",4903,3830,3784,41,46,"PODEMOS",780
34,"34223",219,159,158,1,1,"PODEMOS",9
34,"34130",213,175,172,2,3,"PODEMOS",11
34,"34009",33,29,26,1,3,"PODEMOS",1
34,"34189",57,45,45,1,0,"PODEMOS",3
34,"34221",179,135,132,3,3,"PODEMOS",18
34,"34127",95,64,64,2,0,"PODEMOS",10
34,"34901",1126,881,865,6,16,"PODEMOS",59
34,"34201",193,163,161,2,2,"PODEMOS",16
34,"34113",37,36,36,0,0,"PODEMOS",5
34,"34238",341,279,276,1,3,"PODEMOS",27
34,"34057",476,339,334,3,5,"PODEMOS",46
34,"34017",920,763,745,2,18,"PODEMOS",69
34,"34048",76,64,64,1,0,"PODEMOS",8
34,"34024",32,19,19,0,0,"PODEMOS",0
34,"34106",114,94,94,2,0,"PODEMOS",4
34,"34005",858,670,651,6,19,"PODEMOS",69
34,"34080",5626,3906,3835,39,71,"PODEMOS",517
34,"34211",180,151,149,3,2,"PODEMOS",5
34,"34001",35,28,28,2,0,"PODEMOS",3
34,"34036",216,167,165,1,2,"PODEMOS",33
34,"34186",51,45,45,0,0,"PODEMOS",0
34,"34185",65,46,44,2,2,"PODEMOS",6
34,"34131",59,50,48,0,2,"PODEMOS",0
34,"34237",597,472,465,5,7,"PODEMOS",28
34,"34122",84,66,65,0,1,"PODEMOS",4
34,"34053",209,170,168,4,2,"PODEMOS",13
34,"34245",311,213,209,4,4,"PODEMOS",6
34,"34018",209,169,166,3,3,"PODEMOS",21
34,"34079",1601,1285,1269,11,16,"PODEMOS",200
34,"34069",2285,1711,1692,25,19,"PODEMOS",225
34,"34062",176,111,111,3,0,"PODEMOS",8
34,"34099",61,51,50,0,1,"PODEMOS",2
34,"34216",67,52,51,0,1,"PODEMOS",0
34,"34229",67,55,55,1,0,"PODEMOS",8
34,"34167",114,89,89,0,0,"PODEMOS",9
34,"34056",2003,1502,1487,12,15,"PODEMOS",186
34,"34101",54,42,42,0,0,"PODEMOS",3
34,"34110",91,78,78,2,0,"PODEMOS",15
34,"34904",319,241,240,3,1,"PODEMOS",30
34,"34124",61,47,46,0,1,"PODEMOS",2
34,"34038",277,202,202,3,0,"PODEMOS",7
34,"34234",72,57,55,0,2,"PODEMOS",8
34,"34025",61,44,44,1,0,"PODEMOS",1
34,"34049",369,280,274,1,6,"PODEMOS",36
34,"34204",47,39,39,2,0,"PODEMOS",0
34,"34050",202,160,160,0,0,"PODEMOS",17
34,"34168",55,51,51,1,0,"PODEMOS",6
4,"4078",1095,784,779,7,5,"RECORTES CE",0
4,"4015",130,98,98,1,0,"RECORTES CE",0
4,"4032",5606,3789,3770,19,19,"RECORTES CE",1
4,"4096",274,208,206,0,2,"RECORTES CE",0
4,"4037",1312,1019,1000,6,19,"RECORTES CE",0
4,"4066",13573,8651,8570,65,81,"RECORTES CE",4
4,"4005",577,438,432,1,6,"RECORTES CE",1
4,"4006",7016,4823,4786,33,37,"RECORTES CE",6
4,"4068",195,158,158,0,0,"RECORTES CE",0
4,"4053",12333,9124,9040,66,84,"RECORTES CE",10
4,"4050",830,597,594,3,3,"RECORTES CE",0
4,"4021",187,148,141,1,7,"RECORTES CE",0
4,"4008",501,420,415,3,5,"RECORTES CE",0
4,"4071",398,327,326,2,1,"RECORTES CE",0
4,"4047",2278,1906,1891,13,15,"RECORTES CE",4
4,"4081",356,290,290,2,0,"RECORTES CE",0
4,"4099",4988,3784,3714,26,70,"RECORTES CE",11
4,"4069",4692,3641,3607,29,34,"RECORTES CE",3
4,"4070",1623,1233,1229,7,4,"RECORTES CE",0
4,"4097",254,196,194,0,2,"RECORTES CE",1
4,"4079",50800,33862,33629,200,233,"RECORTES CE",36
4,"4018",274,245,242,0,3,"RECORTES CE",0
4,"4084",337,264,261,1,3,"RECORTES CE",0
4,"4903",4345,2896,2875,35,21,"RECORTES CE",1
4,"4094",209,141,141,1,0,"RECORTES CE",0
4,"4023",139,104,102,1,2,"RECORTES CE",0
4,"4055",372,315,315,0,0,"RECORTES CE",0
4,"4080",226,185,182,2,3,"RECORTES CE",1
4,"4043",546,466,462,3,4,"RECORTES CE",0
4,"4098",1537,1157,1147,8,10,"RECORTES CE",2
4,"4101",4283,2969,2950,22,19,"RECORTES CE",2
4,"4024",3036,2325,2308,18,17,"RECORTES CE",2
4,"4045",1777,1402,1392,9,10,"RECORTES CE",1
4,"4003",17365,10931,10830,57,101,"RECORTES CE",9
4,"4016",2146,1584,1564,8,20,"RECORTES CE",0
4,"4091",342,280,278,4,2,"RECORTES CE",0
4,"4056",147,123,120,0,3,"RECORTES CE",0
4,"4052",12246,8393,8353,84,40,"RECORTES CE",9
4,"4011",2798,2244,2220,14,24,"RECORTES CE",0
4,"4028",226,198,197,0,1,"RECORTES CE",0
4,"4074",2829,1965,1945,24,20,"RECORTES CE",1
4,"4051",440,373,372,0,1,"RECORTES CE",0
4,"4038",3066,2169,2150,20,19,"RECORTES CE",0
4,"4082",306,210,209,0,1,"RECORTES CE",0
4,"4009",169,127,126,0,1,"RECORTES CE",0
4,"4100",8712,5545,5482,30,63,"RECORTES CE",10
4,"4010",579,469,464,2,5,"RECORTES CE",0
4,"4034",173,108,108,3,0,"RECORTES CE",0
4,"4048",1503,1104,1096,7,8,"RECORTES CE",1
4,"4046",862,658,656,6,2,"RECORTES CE",0
4,"4085",395,302,298,0,4,"RECORTES CE",0
4,"4013",141116,95203,94625,669,578,"RECORTES CE",116
4,"4012",191,170,169,1,1,"RECORTES CE",0
4,"4044",1555,1253,1243,9,10,"RECORTES CE",0
4,"4064",2779,2032,2009,8,23,"RECORTES CE",2
4,"4083",1790,1384,1379,8,5,"RECORTES CE",1
4,"4901",539,388,386,0,2,"RECORTES CE",0
4,"4019",251,199,198,0,1,"RECORTES CE",1
4,"4067",584,432,424,0,8,"RECORTES CE",1
4,"4090",309,242,242,1,0,"RECORTES CE",0
4,"4035",8375,6079,6031,28,48,"RECORTES CE",0
4,"4007",736,553,551,0,2,"RECORTES CE",1
4,"4075",5152,3772,3715,19,57,"RECORTES CE",6
4,"4077",303,277,274,2,3,"RECORTES CE",0
4,"4904",1759,1185,1172,15,13,"RECORTES CE",1
4,"4061",618,495,491,5,4,"RECORTES CE",0
4,"4086",1792,1271,1258,8,13,"RECORTES CE",1
4,"4004",421,314,312,2,2,"RECORTES CE",1
4,"4022",348,243,242,1,1,"RECORTES CE",0
4,"4076",1296,1005,993,7,12,"RECORTES CE",0
4,"4041",318,241,241,6,0,"RECORTES CE",0
4,"4014",153,118,118,0,0,"RECORTES CE",0
4,"4072",311,247,244,14,3,"RECORTES CE",0
4,"4088",2475,1717,1703,10,14,"RECORTES CE",3
4,"4102",13729,8987,8878,114,109,"RECORTES CE",3
4,"4054",363,297,292,1,5,"RECORTES CE",0
4,"4030",1140,828,826,8,2,"RECORTES CE",0
4,"4089",746,536,528,6,8,"RECORTES CE",0
4,"4059",1100,752,745,7,7,"RECORTES CE",0
4,"4103",1478,1051,1037,6,14,"RECORTES CE",0
4,"4002",1063,765,760,1,5,"RECORTES CE",0
4,"4073",332,231,230,2,1,"RECORTES CE",0
4,"4033",139,100,97,3,3,"RECORTES CE",0
4,"4036",228,176,175,2,1,"RECORTES CE",1
4,"4057",1337,941,933,2,8,"RECORTES CE",1
4,"4087",189,140,139,1,1,"RECORTES CE",0
4,"4029",8887,6103,6048,53,55,"RECORTES CE",0
4,"4001",1083,812,796,6,16,"RECORTES CE",0
4,"4092",2852,2192,2168,13,24,"RECORTES CE",0
4,"4902",45373,28425,28220,249,205,"RECORTES CE",29
4,"4063",1099,847,835,2,12,"RECORTES CE",0
4,"4026",70,60,60,0,0,"RECORTES CE",0
4,"4020",292,208,207,1,1,"RECORTES CE",1
4,"4060",466,361,358,2,3,"RECORTES CE",0
4,"4062",4528,3610,3579,20,31,"RECORTES CE",4
4,"4093",1872,1265,1252,10,13,"RECORTES CE",1
4,"4017",1301,881,876,5,5,"RECORTES CE",0
4,"4027",249,163,163,1,0,"RECORTES CE",1
4,"4095",726,466,463,2,3,"RECORTES CE",2
4,"4049",5280,3658,3623,20,35,"RECORTES CE",2
4,"4031",2359,1791,1786,7,5,"RECORTES CE",1
4,"4058",369,292,291,2,1,"RECORTES CE",0
4,"4065",366,290,288,2,2,"RECORTES CE",0
41,"41097",3135,2339,2317,19,22,"RECORTES CE",0
41,"41018",9490,6997,6930,45,67,"RECORTES CE",5
41,"41029",13423,9979,9880,84,99,"RECORTES CE",14
41,"41086",16102,10743,10665,93,78,"RECORTES CE",15
41,"41048",2244,1625,1598,22,27,"RECORTES CE",2
41,"41093",18487,14687,14594,117,93,"RECORTES CE",17
41,"41021",21249,15031,14854,152,177,"RECORTES CE",21
41,"41027",3941,2766,2709,28,57,"RECORTES CE",2
41,"41098",4952,3762,3704,24,58,"RECORTES CE",3
41,"41006",2740,1909,1897,13,12,"RECORTES CE",1
41,"41094",6288,4726,4653,36,73,"RECORTES CE",2
41,"41901",2676,2222,2190,31,32,"RECORTES CE",1
41,"41088",518,381,377,0,4,"RECORTES CE",0
41,"41083",1154,893,888,3,5,"RECORTES CE",1
41,"41046",3017,2416,2381,12,35,"RECORTES CE",2
41,"41036",3971,2846,2806,14,40,"RECORTES CE",2
41,"41043",636,439,435,3,4,"RECORTES CE",1
41,"41095",41137,28987,28731,302,256,"RECORTES CE",33
41,"41008",1063,820,805,3,15,"RECORTES CE",1
41,"41081",29164,21631,21410,218,221,"RECORTES CE",20
41,"41085",4086,3223,3178,31,45,"RECORTES CE",5
41,"41902",4675,3051,3019,20,32,"RECORTES CE",2
41,"41019",4654,3267,3224,34,43,"RECORTES CE",4
41,"41042",5868,4612,4583,37,29,"RECORTES CE",7
41,"41070",6021,4504,4456,44,48,"RECORTES CE",8
41,"41039",31674,23240,22982,196,258,"RECORTES CE",18
41,"41012",3286,2268,2235,15,33,"RECORTES CE",2
41,"41082",3432,2809,2781,12,28,"RECORTES CE",0
41,"41065",22868,15933,15784,172,149,"RECORTES CE",8
41,"41058",17304,12982,12751,133,231,"RECORTES CE",25
41,"41044",7392,5562,5526,40,36,"RECORTES CE",9
41,"41096",6166,4811,4752,39,59,"RECORTES CE",4
41,"41034",23033,15936,15711,189,225,"RECORTES CE",24
41,"41069",29070,20827,20558,355,269,"RECORTES CE",38
41,"41002",1469,1085,1061,12,24,"RECORTES CE",0
41,"41057",275,193,191,0,2,"RECORTES CE",0
41,"41022",4300,2918,2891,30,27,"RECORTES CE",2
41,"41055",15009,10393,10292,82,101,"RECORTES CE",12
41,"41033",5102,3655,3613,25,42,"RECORTES CE",4
41,"41037",3203,2473,2449,18,24,"RECORTES CE",1
41,"41067",7115,5248,5178,46,70,"RECORTES CE",7
41,"41011",15395,11527,11341,114,186,"RECORTES CE",6
41,"41005",9057,6781,6693,58,88,"RECORTES CE",4
41,"41072",4052,3115,3041,18,74,"RECORTES CE",2
41,"41061",2218,1769,1742,5,27,"RECORTES CE",0
41,"41038",99637,71611,71050,727,561,"RECORTES CE",133
41,"41040",10411,7959,7892,53,67,"RECORTES CE",16
41,"41014",2510,1981,1958,8,23,"RECORTES CE",0
41,"41035",1112,887,876,5,11,"RECORTES CE",0
41,"41099",3998,2597,2577,19,20,"RECORTES CE",0
41,"41056",3691,3069,3042,21,27,"RECORTES CE",1
41,"41016",7310,5473,5410,50,63,"RECORTES CE",11
41,"41026",4325,3551,3516,18,35,"RECORTES CE",1
41,"41009",1229,811,803,5,8,"RECORTES CE",2
41,"41031",1257,838,836,8,2,"RECORTES CE",2
41,"41001",1597,1262,1248,5,14,"RECORTES CE",0
41,"41020",12872,8820,8723,92,97,"RECORTES CE",3
41,"41078",2522,1888,1874,5,14,"RECORTES CE",0
41,"41075",10225,7387,7283,55,104,"RECORTES CE",4
41,"41049",9301,7147,7070,63,77,"RECORTES CE",3
41,"41015",5310,3799,3710,38,89,"RECORTES CE",7
41,"41100",1025,770,751,5,19,"RECORTES CE",0
41,"41032",4019,2943,2875,17,68,"RECORTES CE",3
41,"41028",1971,1574,1562,11,12,"RECORTES CE",4
41,"41004",56552,40018,39623,515,395,"RECORTES CE",83
41,"41051",2170,1650,1611,8,39,"RECORTES CE",0
41,"41066",1363,1019,1007,7,12,"RECORTES CE",0
41,"41017",15052,11074,10964,99,110,"RECORTES CE",17
41,"41050",5158,4123,4078,37,45,"RECORTES CE",0
41,"41045",5749,4121,4066,49,55,"RECORTES CE",0
41,"41003",2319,1782,1754,8,28,"RECORTES CE",2
41,"41053",21252,16022,15770,121,252,"RECORTES CE",20
41,"41030",516,409,395,2,14,"RECORTES CE",1
41,"41077",8728,6423,6308,28,115,"RECORTES CE",5
41,"41007",12386,8552,8403,90,149,"RECORTES CE",9
41,"41068",13948,10269,10150,75,119,"RECORTES CE",8
41,"41024",22662,15742,15521,137,221,"RECORTES CE",25
41,"41073",1715,1194,1169,9,25,"RECORTES CE",1
41,"41063",2683,1942,1922,21,20,"RECORTES CE",1
41,"41076",2184,1442,1432,19,10,"RECORTES CE",0
41,"41074",3033,2362,2341,8,21,"RECORTES CE",2
41,"41089",6504,4759,4691,51,68,"RECORTES CE",1
41,"41023",7919,5852,5788,34,64,"RECORTES CE",0
41,"41090",3541,2774,2721,17,53,"RECORTES CE",3
41,"41084",2850,2205,2157,15,48,"RECORTES CE",2
41,"41080",1270,954,938,8,16,"RECORTES CE",0
41,"41047",10086,7758,7663,80,95,"RECORTES CE",16
41,"41062",2235,1805,1790,10,15,"RECORTES CE",2
41,"41013",4842,3491,3461,22,30,"RECORTES CE",1
41,"41101",5932,4454,4421,27,33,"RECORTES CE",1
41,"41079",9343,7111,7029,68,82,"RECORTES CE",7
41,"41102",14635,10904,10655,148,249,"RECORTES CE",15
41,"41903",6747,4926,4854,43,72,"RECORTES CE",6
41,"41041",9743,7620,7482,39,138,"RECORTES CE",5
41,"41052",3006,2264,2209,8,55,"RECORTES CE",4
41,"41054",688,587,570,2,17,"RECORTES CE",0
41,"41060",15279,10611,10447,91,164,"RECORTES CE",17
41,"41091",541928,401177,398212,3487,2965,"RECORTES CE",581
41,"41025",2041,1456,1430,17,26,"RECORTES CE",3
41,"41087",10202,7160,7033,51,127,"RECORTES CE",4
41,"41092",7749,5715,5647,57,68,"RECORTES CE",4
41,"41059",33977,26158,25965,230,193,"RECORTES CE",31
41,"41064",5601,3766,3715,42,51,"RECORTES CE",2
41,"41071",5620,3974,3898,17,76,"RECORTES CE",0
41,"41010",4394,3203,3160,19,43,"RECORTES CE",3
15,"15040",2763,2050,2017,10,33,"NÓS",65
15,"15008",5650,4239,4175,42,64,"NÓS",86
15,"15033",2489,1953,1931,13,22,"NÓS",149
15,"15055",4618,3208,3159,49,49,"NÓS",162
15,"15004",4855,3594,3535,28,59,"NÓS",262
15,"15071",7965,5559,5483,37,76,"NÓS",329
15,"15017",19380,14272,14098,156,174,"NÓS",420
15,"15044",1309,955,941,5,14,"NÓS",18
15,"15086",2918,2109,2077,19,32,"NÓS",60
15,"15045",3803,2382,2354,15,28,"NÓS",206
15,"15036",58409,40932,40506,484,426,"NÓS",1400
15,"15088",3550,2398,2372,18,26,"NÓS",52
15,"15046",6345,4625,4532,53,93,"NÓS",349
15,"15013",6126,4315,4257,43,58,"NÓS",185
15,"15035",11517,8305,8192,144,113,"NÓS",746
15,"15076",2649,1827,1802,24,25,"NÓS",352
15,"15057",12169,8853,8729,88,124,"NÓS",396
15,"15006",5353,3534,3469,49,65,"NÓS",245
15,"15025",1069,662,654,5,8,"NÓS",26
15,"15077",8303,5648,5544,57,104,"NÓS",128
15,"15042",3060,2170,2127,21,43,"NÓS",71
15,"15078",78093,58164,57487,673,677,"NÓS",3017
15,"15038",2236,1556,1530,18,26,"NÓS",158
15,"15047",2463,1669,1633,21,36,"NÓS",70
15,"15069",6785,5107,5032,54,75,"NÓS",323
15,"15075",12279,9076,8952,117,124,"NÓS",328
15,"15034",2897,1931,1909,14,22,"NÓS",51
15,"15054",32177,22065,21778,349,287,"NÓS",870
15,"15037",4087,2775,2733,18,42,"NÓS",198
15,"15066",4039,2950,2894,34,56,"NÓS",103
15,"15014",4034,2809,2757,34,52,"NÓS",101
15,"15028",1415,1085,1070,10,15,"NÓS",152
15,"15024",4412,3325,3278,35,47,"NÓS",185
15,"15007",3352,2469,2453,24,16,"NÓS",92
15,"15058",27623,21002,20788,257,214,"NÓS",559
15,"15043",5147,3834,3764,36,70,"NÓS",182
15,"15090",1182,868,861,13,7,"NÓS",125
15,"15011",15463,11105,10890,92,215,"NÓS",718
15,"15039",1271,935,917,8,18,"NÓS",49
15,"15080",1760,1215,1197,11,18,"NÓS",31
15,"15018",1156,817,806,7,11,"NÓS",43
15,"15051",4651,3343,3297,38,46,"NÓS",207
15,"15005",24459,16742,16482,215,260,"NÓS",597
15,"15030",200245,148692,147426,1699,1266,"NÓS",4190
15,"15067",8073,6067,6000,45,67,"NÓS",570
15,"15060",5780,4245,4167,48,78,"NÓS",181
15,"15056",5757,4167,4108,43,59,"NÓS",120
15,"15068",5096,3518,3476,39,42,"NÓS",126
15,"15050",1843,1089,1070,19,19,"NÓS",81
15,"15059",10406,7710,7553,91,157,"NÓS",514
15,"15072",9626,7024,6920,52,104,"NÓS",664
15,"15003",1818,1326,1302,18,24,"NÓS",52
15,"15081",1042,819,814,12,5,"NÓS",15
15,"15019",25902,18111,17866,232,245,"NÓS",1572
15,"15049",1099,765,755,12,10,"NÓS",184
15,"15023",6481,4658,4595,44,63,"NÓS",217
15,"15031",23321,17319,17152,218,167,"NÓS",581
15,"15010",1913,1355,1338,21,17,"NÓS",191
15,"15041",9627,7409,7291,79,118,"NÓS",360
15,"15048",4855,3582,3534,41,48,"NÓS",101
15,"15061",5646,3945,3894,35,51,"NÓS",100
15,"15079",1562,1092,1075,16,17,"NÓS",69
15,"15073",21884,14792,14587,149,205,"NÓS",953
15,"15020",3844,2651,2629,17,22,"NÓS",221
15,"15070",9117,6514,6390,98,124,"NÓS",480
15,"15027",1540,1224,1203,6,21,"NÓS",58
15,"15083",1100,809,795,5,14,"NÓS",106
15,"15089",4317,3238,3188,24,50,"NÓS",111
15,"15093",4265,2856,2814,35,42,"NÓS",162
15,"15032",3455,2438,2391,26,47,"NÓS",140
15,"15052",4351,3122,3063,26,59,"NÓS",108
15,"15062",5936,4047,3993,31,54,"NÓS",177
15,"15084",3312,2361,2326,28,35,"NÓS",78
15,"15029",5761,3994,3928,47,66,"NÓS",167
15,"15087",5804,3942,3901,49,41,"NÓS",156
15,"15074",4061,2983,2947,24,36,"NÓS",126
15,"15064",2207,1680,1650,22,30,"NÓS",65
15,"15021",5099,3673,3611,43,62,"NÓS",130
15,"15022",5817,4026,3981,29,45,"NÓS",180
15,"15053",7783,5386,5314,47,72,"NÓS",306
15,"15901",3595,2401,2374,30,27,"NÓS",92
15,"15001",4805,3466,3419,45,47,"NÓS",127
15,"15091",1119,807,784,12,23,"NÓS",20
15,"15902",4660,3352,3296,30,56,"NÓS",78
15,"15015",2840,2126,2100,21,26,"NÓS",135
15,"15065",7345,5517,5412,46,105,"NÓS",199
15,"15009",10780,8075,7957,70,118,"NÓS",298
15,"15016",4806,3291,3222,21,69,"NÓS",128
15,"15085",3346,2365,2311,26,54,"NÓS",126
15,"15082",15162,11273,11134,135,139,"NÓS",560
15,"15012",3666,2787,2721,40,66,"NÓS",64
15,"15092",6523,4518,4449,54,69,"NÓS",399
15,"15002",22929,16941,16742,205,199,"NÓS",784
34,"34055",280,204,202,2,2,"PACMA",0
34,"34903",198,128,127,1,1,"PACMA",0
34,"34046",43,31,29,0,2,"PACMA",0
34,"34107",81,49,49,3,0,"PACMA",0
34,"34241",18,13,12,2,1,"PACMA",0
34,"34019",125,103,101,1,2,"PACMA",0
34,"34204",47,39,39,2,0,"PACMA",0
34,"34091",123,97,95,1,2,"PACMA",1
34,"34229",67,55,55,1,0,"PACMA",1
34,"34140",107,63,62,0,1,"PACMA",0
34,"34218",469,353,349,2,4,"PACMA",1
34,"34201",193,163,161,2,2,"PACMA",1
34,"34067",129,95,95,0,0,"PACMA",0
34,"34053",209,170,168,4,2,"PACMA",0
34,"34190",56,40,40,3,0,"PACMA",0
34,"34131",59,50,48,0,2,"PACMA",0
34,"34050",202,160,160,0,0,"PACMA",1
34,"34052",178,148,147,3,1,"PACMA",0
34,"34031",29,28,28,1,0,"PACMA",0
34,"34081",61,50,49,0,1,"PACMA",0
34,"34006",80,69,66,1,3,"PACMA",0
34,"34112",47,38,38,0,0,"PACMA",0
34,"34149",20,15,15,0,0,"PACMA",0
34,"34243",326,263,258,2,5,"PACMA",0
34,"34232",748,601,586,11,15,"PACMA",1
34,"34182",792,632,620,3,12,"PACMA",4
34,"34017",920,763,745,2,18,"PACMA",0
34,"34146",55,42,42,0,0,"PACMA",0
34,"34122",84,66,65,0,1,"PACMA",0
34,"34176",134,102,100,2,2,"PACMA",0
34,"34143",172,127,126,3,1,"PACMA",0
34,"34231",232,167,167,4,0,"PACMA",0
34,"34214",186,150,149,1,1,"PACMA",4
34,"34015",39,32,31,1,1,"PACMA",0
34,"34039",61,46,45,0,1,"PACMA",0
34,"34088",231,192,190,2,2,"PACMA",4
34,"34199",1248,955,937,18,18,"PACMA",8
34,"34022",1095,915,909,8,6,"PACMA",1
34,"34094",61,42,40,1,2,"PACMA",0
34,"34058",184,167,167,0,0,"PACMA",0
34,"34005",858,670,651,6,19,"PACMA",0
34,"34159",363,277,269,4,8,"PACMA",0
34,"34180",68,56,56,2,0,"PACMA",0
34,"34242",95,74,73,1,1,"PACMA",0
34,"34134",53,37,37,2,0,"PACMA",0
34,"34225",4903,3830,3784,41,46,"PACMA",36
34,"34233",131,116,116,1,0,"PACMA",0
34,"34034",126,93,93,1,0,"PACMA",0
34,"34059",422,348,341,6,7,"PACMA",0
34,"34211",180,151,149,3,2,"PACMA",0
34,"34012",362,277,272,4,5,"PACMA",2
34,"34152",124,102,99,1,3,"PACMA",0
34,"34220",144,129,128,0,1,"PACMA",1
34,"34174",205,162,162,4,0,"PACMA",1
34,"34102",205,172,170,1,2,"PACMA",0
34,"34023",5265,3948,3918,38,30,"PACMA",32
34,"34170",62,49,49,0,0,"PACMA",0
34,"34042",300,247,244,4,3,"PACMA",11
34,"34185",65,46,44,2,2,"PACMA",1
34,"34236",162,126,126,1,0,"PACMA",0
34,"34234",72,57,55,0,2,"PACMA",0
34,"34178",113,92,91,5,1,"PACMA",0
34,"34010",570,437,429,5,8,"PACMA",1
34,"34147",167,120,120,1,0,"PACMA",0
34,"34086",105,91,88,1,3,"PACMA",0
34,"34125",88,69,68,1,1,"PACMA",0
34,"34069",2285,1711,1692,25,19,"PACMA",10
34,"34167",114,89,89,0,0,"PACMA",0
34,"34025",61,44,44,1,0,"PACMA",0
34,"34137",28,24,24,1,0,"PACMA",0
34,"34061",108,80,80,0,0,"PACMA",0
34,"34179",29,22,20,0,2,"PACMA",0
34,"34103",96,78,77,2,1,"PACMA",0
34,"34165",66,59,59,0,0,"PACMA",0
34,"34217",1200,954,934,6,20,"PACMA",1
34,"34171",982,720,710,7,10,"PACMA",4
34,"34123",1668,1346,1319,20,27,"PACMA",5
34,"34087",127,109,108,1,1,"PACMA",0
34,"34083",1773,1259,1244,8,15,"PACMA",3
34,"34001",35,28,28,2,0,"PACMA",0
34,"34048",76,64,64,1,0,"PACMA",0
34,"34238",341,279,276,1,3,"PACMA",0
34,"34227",76,62,62,1,0,"PACMA",0
34,"34003",163,127,125,0,2,"PACMA",1
34,"34237",597,472,465,5,7,"PACMA",0
34,"34068",25,24,24,1,0,"PACMA",0
34,"34158",290,190,188,3,2,"PACMA",1
34,"34092",297,236,231,2,5,"PACMA",2
34,"34004",5626,4226,4178,41,48,"PACMA",29
34,"34063",86,80,79,1,1,"PACMA",0
34,"34121",192,155,154,2,1,"PACMA",0
34,"34156",49,42,41,3,1,"PACMA",0
34,"34045",77,65,65,2,0,"PACMA",0
34,"34028",144,121,119,1,2,"PACMA",2
34,"34098",780,587,582,2,5,"PACMA",1
34,"34240",90,71,70,2,1,"PACMA",1
34,"34060",137,113,112,1,1,"PACMA",0
34,"34049",369,280,274,1,6,"PACMA",3
34,"34141",182,148,147,4,1,"PACMA",0
34,"34186",51,45,45,0,0,"PACMA",0
34,"34114",212,147,146,2,1,"PACMA",0
34,"34136",182,121,120,1,1,"PACMA",1
34,"34133",107,85,82,0,3,"PACMA",0
34,"34126",279,218,218,2,0,"PACMA",1
34,"34082",84,71,71,0,0,"PACMA",0
34,"34089",157,124,122,1,2,"PACMA",0
34,"34130",213,175,172,2,3,"PACMA",0
34,"34066",58,45,45,0,0,"PACMA",0
34,"34029",727,596,582,4,14,"PACMA",1
34,"34221",179,135,132,3,3,"PACMA",3
34,"34196",91,70,69,1,1,"PACMA",2
34,"34116",62,41,41,0,0,"PACMA",0
34,"34208",53,41,41,1,0,"PACMA",0
34,"34205",59,45,45,0,0,"PACMA",0
34,"34124",61,47,46,0,1,"PACMA",0
34,"34047",1803,1402,1380,15,22,"PACMA",5
34,"34901",1126,881,865,6,16,"PACMA",6
34,"34161",23,14,14,0,0,"PACMA",0
34,"34108",537,453,446,5,7,"PACMA",3
34,"34904",319,241,240,3,1,"PACMA",0
34,"34155",135,105,104,1,1,"PACMA",2
34,"34120",64404,49403,48884,379,519,"PACMA",331
34,"34027",1096,786,781,11,5,"PACMA",2
34,"34051",102,90,88,1,2,"PACMA",0
34,"34139",168,126,124,6,2,"PACMA",0
34,"34096",57,46,46,3,0,"PACMA",0
34,"34129",179,139,137,2,2,"PACMA",1
34,"34056",2003,1502,1487,12,15,"PACMA",10
34,"34163",49,40,40,0,0,"PACMA",0
34,"34192",93,76,76,0,0,"PACMA",0
34,"34101",54,42,42,0,0,"PACMA",0
34,"34106",114,94,94,2,0,"PACMA",0
34,"34175",89,75,74,1,1,"PACMA",0
34,"34228",81,66,66,0,0,"PACMA",1
34,"34093",90,72,70,0,2,"PACMA",1
34,"34132",115,93,92,0,1,"PACMA",0
34,"34084",140,110,108,1,2,"PACMA",0
34,"34902",140,115,114,0,1,"PACMA",0
34,"34206",879,688,680,3,8,"PACMA",2
34,"34100",142,116,115,5,1,"PACMA",1
34,"34202",31,20,19,0,1,"PACMA",0
34,"34032",41,32,31,0,1,"PACMA",0
34,"34151",167,111,111,3,0,"PACMA",2
34,"34020",53,39,39,0,0,"PACMA",0
34,"34213",58,43,42,2,1,"PACMA",0
34,"34222",120,82,82,2,0,"PACMA",0
34,"34099",61,51,50,0,1,"PACMA",0
34,"34245",311,213,209,4,4,"PACMA",0
34,"34070",160,117,115,2,2,"PACMA",0
34,"34073",187,150,149,0,1,"PACMA",3
34,"34072",160,142,140,1,2,"PACMA",2
34,"34246",64,49,47,1,2,"PACMA",0
34,"34036",216,167,165,1,2,"PACMA",0
34,"34184",55,46,42,0,4,"PACMA",0
34,"34080",5626,3906,3835,39,71,"PACMA",31
34,"34181",453,343,337,3,6,"PACMA",3
34,"34038",277,202,202,3,0,"PACMA",1
34,"34074",719,552,545,8,7,"PACMA",2
34,"34113",37,36,36,0,0,"PACMA",0
34,"34104",247,203,199,0,4,"PACMA",0
34,"34127",95,64,64,2,0,"PACMA",0
34,"34135",391,296,291,4,5,"PACMA",2
34,"34168",55,51,51,1,0,"PACMA",0
34,"34157",2460,1872,1836,26,36,"PACMA",4
34,"34062",176,111,111,3,0,"PACMA",0
34,"34011",398,326,326,3,0,"PACMA",1
34,"34224",45,31,31,0,0,"PACMA",0
34,"34024",32,19,19,0,0,"PACMA",0
34,"34110",91,78,78,2,0,"PACMA",0
34,"34230",15,12,12,0,0,"PACMA",0
34,"34076",597,494,490,3,4,"PACMA",2
34,"34041",89,71,71,1,0,"PACMA",0
34,"34079",1601,1285,1269,11,16,"PACMA",6
34,"34216",67,52,51,0,1,"PACMA",0
34,"34009",33,29,26,1,3,"PACMA",0
34,"34154",76,54,52,0,2,"PACMA",0
34,"34210",102,90,89,0,1,"PACMA",0
34,"34109",59,48,47,0,1,"PACMA",0
34,"34223",219,159,158,1,1,"PACMA",0
34,"34033",18,17,17,0,0,"PACMA",0
34,"34177",179,149,148,1,1,"PACMA",0
34,"34037",310,218,217,4,1,"PACMA",0
34,"34071",172,140,139,4,1,"PACMA",0
34,"34189",57,45,45,1,0,"PACMA",0
34,"34057",476,339,334,3,5,"PACMA",2
34,"34035",113,90,89,1,1,"PACMA",0
34,"34215",163,148,148,2,0,"PACMA",0
34,"34077",349,253,246,0,7,"PACMA",1
34,"34169",404,302,300,2,2,"PACMA",0
34,"34018",209,169,166,3,3,"PACMA",2
34,"34160",143,112,110,1,2,"PACMA",2
34,"34001",35,28,28,2,0,"UPYD",0
34,"34116",62,41,41,0,0,"UPYD",0
34,"34202",31,20,19,0,1,"UPYD",0
34,"34066",58,45,45,0,0,"UPYD",0
34,"34157",2460,1872,1836,26,36,"UPYD",4
34,"34091",123,97,95,1,2,"UPYD",0
34,"34241",18,13,12,2,1,"UPYD",0
34,"34041",89,71,71,1,0,"UPYD",2
34,"34017",920,763,745,2,18,"UPYD",5
34,"34217",1200,954,934,6,20,"UPYD",9
34,"34123",1668,1346,1319,20,27,"UPYD",2
34,"34204",47,39,39,2,0,"UPYD",0
34,"34143",172,127,126,3,1,"UPYD",0
34,"34055",280,204,202,2,2,"UPYD",2
34,"34079",1601,1285,1269,11,16,"UPYD",7
34,"34067",129,95,95,0,0,"UPYD",1
34,"34242",95,74,73,1,1,"UPYD",1
34,"34120",64404,49403,48884,379,519,"UPYD",451
34,"34080",5626,3906,3835,39,71,"UPYD",30
34,"34042",300,247,244,4,3,"UPYD",1
34,"34174",205,162,162,4,0,"UPYD",0
34,"34159",363,277,269,4,8,"UPYD",1
34,"34218",469,353,349,2,4,"UPYD",4
34,"34003",163,127,125,0,2,"UPYD",3
34,"34121",192,155,154,2,1,"UPYD",1
34,"34205",59,45,45,0,0,"UPYD",0
34,"34009",33,29,26,1,3,"UPYD",0
34,"34019",125,103,101,1,2,"UPYD",1
34,"34004",5626,4226,4178,41,48,"UPYD",23
34,"34243",326,263,258,2,5,"UPYD",0
34,"34045",77,65,65,2,0,"UPYD",0
34,"34206",879,688,680,3,8,"UPYD",5
34,"34146",55,42,42,0,0,"UPYD",0
34,"34106",114,94,94,2,0,"UPYD",1
34,"34224",45,31,31,0,0,"UPYD",0
34,"34069",2285,1711,1692,25,19,"UPYD",15
34,"34057",476,339,334,3,5,"UPYD",8
34,"34231",232,167,167,4,0,"UPYD",0
34,"34107",81,49,49,3,0,"UPYD",0
34,"34046",43,31,29,0,2,"UPYD",0
34,"34245",311,213,209,4,4,"UPYD",1
34,"34147",167,120,120,1,0,"UPYD",0
34,"34189",57,45,45,1,0,"UPYD",0
34,"34082",84,71,71,0,0,"UPYD",0
34,"34208",53,41,41,1,0,"UPYD",0
34,"34047",1803,1402,1380,15,22,"UPYD",10
34,"34122",84,66,65,0,1,"UPYD",0
34,"34005",858,670,651,6,19,"UPYD",5
34,"34050",202,160,160,0,0,"UPYD",1
34,"34006",80,69,66,1,3,"UPYD",1
34,"34171",982,720,710,7,10,"UPYD",7
34,"34246",64,49,47,1,2,"UPYD",0
34,"34083",1773,1259,1244,8,15,"UPYD",6
34,"34134",53,37,37,2,0,"UPYD",1
34,"34108",537,453,446,5,7,"UPYD",3
34,"34059",422,348,341,6,7,"UPYD",1
34,"34100",142,116,115,5,1,"UPYD",0
34,"34225",4903,3830,3784,41,46,"UPYD",31
34,"34012",362,277,272,4,5,"UPYD",3
34,"34222",120,82,82,2,0,"UPYD",0
34,"34048",76,64,64,1,0,"UPYD",0
34,"34124",61,47,46,0,1,"UPYD",0
34,"34096",57,46,46,3,0,"UPYD",2
34,"34109",59,48,47,0,1,"UPYD",0
34,"34163",49,40,40,0,0,"UPYD",1
34,"34177",179,149,148,1,1,"UPYD",0
34,"34215",163,148,148,2,0,"UPYD",1
34,"34060",137,113,112,1,1,"UPYD",1
34,"34901",1126,881,865,6,16,"UPYD",14
34,"34049",369,280,274,1,6,"UPYD",0
34,"34211",180,151,149,3,2,"UPYD",0
34,"34136",182,121,120,1,1,"UPYD",0
34,"34178",113,92,91,5,1,"UPYD",1
34,"34902",140,115,114,0,1,"UPYD",0
34,"34140",107,63,62,0,1,"UPYD",0
34,"34072",160,142,140,1,2,"UPYD",0
34,"34216",67,52,51,0,1,"UPYD",0
34,"34165",66,59,59,0,0,"UPYD",0
34,"34179",29,22,20,0,2,"UPYD",0
34,"34010",570,437,429,5,8,"UPYD",3
34,"34125",88,69,68,1,1,"UPYD",0
34,"34024",32,19,19,0,0,"UPYD",0
34,"34053",209,170,168,4,2,"UPYD",0
34,"34099",61,51,50,0,1,"UPYD",0
34,"34154",76,54,52,0,2,"UPYD",2
34,"34137",28,24,24,1,0,"UPYD",0
34,"34103",96,78,77,2,1,"UPYD",0
34,"34011",398,326,326,3,0,"UPYD",3
34,"34070",160,117,115,2,2,"UPYD",2
34,"34167",114,89,89,0,0,"UPYD",0
34,"34022",1095,915,909,8,6,"UPYD",6
34,"34126",279,218,218,2,0,"UPYD",3
34,"34214",186,150,149,1,1,"UPYD",0
34,"34087",127,109,108,1,1,"UPYD",1
34,"34904",319,241,240,3,1,"UPYD",2
34,"34127",95,64,64,2,0,"UPYD",0
34,"34180",68,56,56,2,0,"UPYD",1
34,"34131",59,50,48,0,2,"UPYD",0
34,"34158",290,190,188,3,2,"UPYD",1
34,"34027",1096,786,781,11,5,"UPYD",5
34,"34227",76,62,62,1,0,"UPYD",0
34,"34051",102,90,88,1,2,"UPYD",0
34,"34139",168,126,124,6,2,"UPYD",1
34,"34076",597,494,490,3,4,"UPYD",3
34,"34088",231,192,190,2,2,"UPYD",2
34,"34230",15,12,12,0,0,"UPYD",0
34,"34132",115,93,92,0,1,"UPYD",0
34,"34052",178,148,147,3,1,"UPYD",1
34,"34169",404,302,300,2,2,"UPYD",1
34,"34063",86,80,79,1,1,"UPYD",0
34,"34101",54,42,42,0,0,"UPYD",0
34,"34028",144,121,119,1,2,"UPYD",2
34,"34228",81,66,66,0,0,"UPYD",0
34,"34156",49,42,41,3,1,"UPYD",1
34,"34036",216,167,165,1,2,"UPYD",3
34,"34039",61,46,45,0,1,"UPYD",0
34,"34236",162,126,126,1,0,"UPYD",0
34,"34129",179,139,137,2,2,"UPYD",0
34,"34015",39,32,31,1,1,"UPYD",0
34,"34141",182,148,147,4,1,"UPYD",1
34,"34133",107,85,82,0,3,"UPYD",0
34,"34175",89,75,74,1,1,"UPYD",0
34,"34160",143,112,110,1,2,"UPYD",2
34,"34130",213,175,172,2,3,"UPYD",1
34,"34229",67,55,55,1,0,"UPYD",2
34,"34020",53,39,39,0,0,"UPYD",1
34,"34232",748,601,586,11,15,"UPYD",2
34,"34221",179,135,132,3,3,"UPYD",2
34,"34025",61,44,44,1,0,"UPYD",1
34,"34029",727,596,582,4,14,"UPYD",3
34,"34037",310,218,217,4,1,"UPYD",2
34,"34034",126,93,93,1,0,"UPYD",0
34,"34149",20,15,15,0,0,"UPYD",0
34,"34210",102,90,89,0,1,"UPYD",0
34,"34233",131,116,116,1,0,"UPYD",3
34,"34176",134,102,100,2,2,"UPYD",0
34,"34220",144,129,128,0,1,"UPYD",2
34,"34112",47,38,38,0,0,"UPYD",0
34,"34038",277,202,202,3,0,"UPYD",5
34,"34018",209,169,166,3,3,"UPYD",1
34,"34031",29,28,28,1,0,"UPYD",0
34,"34092",297,236,231,2,5,"UPYD",0
34,"34071",172,140,139,4,1,"UPYD",3
34,"34104",247,203,199,0,4,"UPYD",0
34,"34056",2003,1502,1487,12,15,"UPYD",8
34,"34135",391,296,291,4,5,"UPYD",4
34,"34234",72,57,55,0,2,"UPYD",1
34,"34023",5265,3948,3918,38,30,"UPYD",25
34,"34068",25,24,24,1,0,"UPYD",0
34,"34073",187,150,149,0,1,"UPYD",0
34,"34093",90,72,70,0,2,"UPYD",1
34,"34098",780,587,582,2,5,"UPYD",3
34,"34192",93,76,76,0,0,"UPYD",0
34,"34110",91,78,78,2,0,"UPYD",1
34,"34058",184,167,167,0,0,"UPYD",1
34,"34152",124,102,99,1,3,"UPYD",1
34,"34061",108,80,80,0,0,"UPYD",0
34,"34033",18,17,17,0,0,"UPYD",0
34,"34102",205,172,170,1,2,"UPYD",3
34,"34186",51,45,45,0,0,"UPYD",0
34,"34077",349,253,246,0,7,"UPYD",2
34,"34086",105,91,88,1,3,"UPYD",0
34,"34237",597,472,465,5,7,"UPYD",0
34,"34213",58,43,42,2,1,"UPYD",0
34,"34094",61,42,40,1,2,"UPYD",0
34,"34089",157,124,122,1,2,"UPYD",2
34,"34062",176,111,111,3,0,"UPYD",3
34,"34190",56,40,40,3,0,"UPYD",0
34,"34238",341,279,276,1,3,"UPYD",0
34,"34114",212,147,146,2,1,"UPYD",1
34,"34196",91,70,69,1,1,"UPYD",1
34,"34223",219,159,158,1,1,"UPYD",1
34,"34155",135,105,104,1,1,"UPYD",0
34,"34199",1248,955,937,18,18,"UPYD",6
34,"34074",719,552,545,8,7,"UPYD",2
34,"34084",140,110,108,1,2,"UPYD",0
34,"34151",167,111,111,3,0,"UPYD",2
34,"34168",55,51,51,1,0,"UPYD",0
34,"34184",55,46,42,0,4,"UPYD",1
34,"34035",113,90,89,1,1,"UPYD",0
34,"34081",61,50,49,0,1,"UPYD",0
34,"34903",198,128,127,1,1,"UPYD",2
34,"34170",62,49,49,0,0,"UPYD",0
34,"34181",453,343,337,3,6,"UPYD",2
34,"34161",23,14,14,0,0,"UPYD",0
34,"34185",65,46,44,2,2,"UPYD",3
34,"34113",37,36,36,0,0,"UPYD",0
34,"34240",90,71,70,2,1,"UPYD",0
34,"34182",792,632,620,3,12,"UPYD",3
34,"34032",41,32,31,0,1,"UPYD",1
34,"34201",193,163,161,2,2,"UPYD",0
4,"4071",398,327,326,2,1,"IULV-CA,UPe",18
4,"4037",1312,1019,1000,6,19,"IULV-CA,UPe",25
4,"4099",4988,3784,3714,26,70,"IULV-CA,UPe",75
4,"4043",546,466,462,3,4,"IULV-CA,UPe",8
4,"4008",501,420,415,3,5,"IULV-CA,UPe",4
4,"4100",8712,5545,5482,30,63,"IULV-CA,UPe",156
4,"4901",539,388,386,0,2,"IULV-CA,UPe",8
4,"4087",189,140,139,1,1,"IULV-CA,UPe",3
4,"4018",274,245,242,0,3,"IULV-CA,UPe",7
4,"4059",1100,752,745,7,7,"IULV-CA,UPe",4
4,"4055",372,315,315,0,0,"IULV-CA,UPe",12
4,"4057",1337,941,933,2,8,"IULV-CA,UPe",33
4,"4097",254,196,194,0,2,"IULV-CA,UPe",19
4,"4069",4692,3641,3607,29,34,"IULV-CA,UPe",114
4,"4073",332,231,230,2,1,"IULV-CA,UPe",6
4,"4056",147,123,120,0,3,"IULV-CA,UPe",0
4,"4054",363,297,292,1,5,"IULV-CA,UPe",14
4,"4068",195,158,158,0,0,"IULV-CA,UPe",0
4,"4103",1478,1051,1037,6,14,"IULV-CA,UPe",16
4,"4021",187,148,141,1,7,"IULV-CA,UPe",7
4,"4038",3066,2169,2150,20,19,"IULV-CA,UPe",117
4,"4009",169,127,126,0,1,"IULV-CA,UPe",9
4,"4028",226,198,197,0,1,"IULV-CA,UPe",3
4,"4084",337,264,261,1,3,"IULV-CA,UPe",4
4,"4092",2852,2192,2168,13,24,"IULV-CA,UPe",44
4,"4064",2779,2032,2009,8,23,"IULV-CA,UPe",67
4,"4075",5152,3772,3715,19,57,"IULV-CA,UPe",73
4,"4076",1296,1005,993,7,12,"IULV-CA,UPe",34
4,"4012",191,170,169,1,1,"IULV-CA,UPe",3
4,"4081",356,290,290,2,0,"IULV-CA,UPe",3
4,"4070",1623,1233,1229,7,4,"IULV-CA,UPe",41
4,"4083",1790,1384,1379,8,5,"IULV-CA,UPe",38
4,"4045",1777,1402,1392,9,10,"IULV-CA,UPe",57
4,"4063",1099,847,835,2,12,"IULV-CA,UPe",11
4,"4053",12333,9124,9040,66,84,"IULV-CA,UPe",168
4,"4016",2146,1584,1564,8,20,"IULV-CA,UPe",31
4,"4082",306,210,209,0,1,"IULV-CA,UPe",2
4,"4058",369,292,291,2,1,"IULV-CA,UPe",19
4,"4030",1140,828,826,8,2,"IULV-CA,UPe",22
4,"4029",8887,6103,6048,53,55,"IULV-CA,UPe",150
4,"4079",50800,33862,33629,200,233,"IULV-CA,UPe",1377
4,"4033",139,100,97,3,3,"IULV-CA,UPe",0
4,"4006",7016,4823,4786,33,37,"IULV-CA,UPe",112
4,"4101",4283,2969,2950,22,19,"IULV-CA,UPe",64
4,"4074",2829,1965,1945,24,20,"IULV-CA,UPe",80
4,"4061",618,495,491,5,4,"IULV-CA,UPe",8
4,"4020",292,208,207,1,1,"IULV-CA,UPe",4
4,"4065",366,290,288,2,2,"IULV-CA,UPe",2
4,"4015",130,98,98,1,0,"IULV-CA,UPe",6
4,"4095",726,466,463,2,3,"IULV-CA,UPe",20
4,"4062",4528,3610,3579,20,31,"IULV-CA,UPe",75
4,"4041",318,241,241,6,0,"IULV-CA,UPe",17
4,"4904",1759,1185,1172,15,13,"IULV-CA,UPe",19
4,"4078",1095,784,779,7,5,"IULV-CA,UPe",152
4,"4051",440,373,372,0,1,"IULV-CA,UPe",6
4,"4013",141116,95203,94625,669,578,"IULV-CA,UPe",4102
4,"4046",862,658,656,6,2,"IULV-CA,UPe",25
4,"4072",311,247,244,14,3,"IULV-CA,UPe",4
4,"4024",3036,2325,2308,18,17,"IULV-CA,UPe",92
4,"4047",2278,1906,1891,13,15,"IULV-CA,UPe",37
4,"4027",249,163,163,1,0,"IULV-CA,UPe",7
4,"4001",1083,812,796,6,16,"IULV-CA,UPe",10
4,"4003",17365,10931,10830,57,101,"IULV-CA,UPe",265
4,"4050",830,597,594,3,3,"IULV-CA,UPe",17
4,"4067",584,432,424,0,8,"IULV-CA,UPe",8
4,"4005",577,438,432,1,6,"IULV-CA,UPe",8
4,"4086",1792,1271,1258,8,13,"IULV-CA,UPe",18
4,"4085",395,302,298,0,4,"IULV-CA,UPe",2
4,"4011",2798,2244,2220,14,24,"IULV-CA,UPe",130
4,"4026",70,60,60,0,0,"IULV-CA,UPe",1
4,"4080",226,185,182,2,3,"IULV-CA,UPe",6
4,"4010",579,469,464,2,5,"IULV-CA,UPe",9
4,"4048",1503,1104,1096,7,8,"IULV-CA,UPe",37
4,"4034",173,108,108,3,0,"IULV-CA,UPe",12
4,"4903",4345,2896,2875,35,21,"IULV-CA,UPe",57
4,"4014",153,118,118,0,0,"IULV-CA,UPe",2
4,"4098",1537,1157,1147,8,10,"IULV-CA,UPe",39
4,"4036",228,176,175,2,1,"IULV-CA,UPe",2
4,"4902",45373,28425,28220,249,205,"IULV-CA,UPe",910
4,"4004",421,314,312,2,2,"IULV-CA,UPe",16
4,"4089",746,536,528,6,8,"IULV-CA,UPe",9
4,"4102",13729,8987,8878,114,109,"IULV-CA,UPe",250
4,"4044",1555,1253,1243,9,10,"IULV-CA,UPe",43
4,"4088",2475,1717,1703,10,14,"IULV-CA,UPe",35
4,"4091",342,280,278,4,2,"IULV-CA,UPe",6
4,"4031",2359,1791,1786,7,5,"IULV-CA,UPe",30
4,"4066",13573,8651,8570,65,81,"IULV-CA,UPe",254
4,"4035",8375,6079,6031,28,48,"IULV-CA,UPe",128
4,"4049",5280,3658,3623,20,35,"IULV-CA,UPe",80
4,"4052",12246,8393,8353,84,40,"IULV-CA,UPe",497
4,"4032",5606,3789,3770,19,19,"IULV-CA,UPe",97
4,"4002",1063,765,760,1,5,"IULV-CA,UPe",14
4,"4022",348,243,242,1,1,"IULV-CA,UPe",8
4,"4090",309,242,242,1,0,"IULV-CA,UPe",9
4,"4094",209,141,141,1,0,"IULV-CA,UPe",0
4,"4093",1872,1265,1252,10,13,"IULV-CA,UPe",56
4,"4060",466,361,358,2,3,"IULV-CA,UPe",1
4,"4077",303,277,274,2,3,"IULV-CA,UPe",3
4,"4096",274,208,206,0,2,"IULV-CA,UPe",3
4,"4017",1301,881,876,5,5,"IULV-CA,UPe",16
4,"4007",736,553,551,0,2,"IULV-CA,UPe",51
4,"4023",139,104,102,1,2,"IULV-CA,UPe",1
4,"4019",251,199,198,0,1,"IULV-CA,UPe",2
24,"24062",142,105,105,1,0,"VOX",0
24,"24083",1077,764,755,4,9,"VOX",0
24,"24100",769,569,561,4,8,"VOX",1
24,"24056",2910,2102,2068,31,34,"VOX",1
24,"24151",492,357,357,1,0,"VOX",1
24,"24143",514,391,379,4,12,"VOX",1
24,"24146",271,195,194,0,1,"VOX",0
24,"24218",454,331,329,3,2,"VOX",2
24,"24150",243,175,175,3,0,"VOX",0
24,"24067",645,383,379,2,4,"VOX",2
24,"24141",98,76,75,0,1,"VOX",0
24,"24130",437,319,315,1,4,"VOX",0
24,"24002",236,182,180,3,2,"VOX",0
24,"24008",9319,6964,6852,77,112,"VOX",28
24,"24125",475,285,282,2,3,"VOX",0
24,"24104",266,180,179,0,1,"VOX",1
24,"24053",439,303,298,2,5,"VOX",0
24,"24096",124,74,74,0,0,"VOX",0
24,"24047",782,533,527,7,6,"VOX",4
24,"24016",478,287,285,1,2,"VOX",0
24,"24020",463,294,291,5,3,"VOX",0
24,"24005",387,267,259,6,8,"VOX",0
24,"24167",763,509,504,9,5,"VOX",0
24,"24069",42,36,36,0,0,"VOX",0
24,"24051",433,308,307,1,1,"VOX",1
24,"24028",386,304,302,3,2,"VOX",1
24,"24009",322,161,161,1,0,"VOX",0
24,"24185",482,357,349,4,8,"VOX",4
24,"24039",2077,1604,1600,39,4,"VOX",5
24,"24054",433,308,303,4,5,"VOX",0
24,"24166",1413,1043,1014,7,29,"VOX",0
24,"24001",188,108,108,0,0,"VOX",0
24,"24057",1366,1103,1076,11,27,"VOX",2
24,"24203",96,73,72,1,1,"VOX",0
24,"24199",433,284,281,3,3,"VOX",0
24,"24065",2106,1573,1545,16,28,"VOX",7
24,"24188",3843,2962,2899,48,63,"VOX",4
24,"24097",225,146,145,1,1,"VOX",0
24,"24160",692,506,498,2,8,"VOX",7
24,"24122",1351,965,948,9,17,"VOX",0
24,"24090",348,226,224,1,2,"VOX",0
24,"24228",666,455,449,2,6,"VOX",1
24,"24902",354,273,272,2,1,"VOX",0
24,"24189",6016,4187,4134,58,53,"VOX",14
24,"24161",291,218,212,2,6,"VOX",0
24,"24099",173,133,133,2,0,"VOX",1
24,"24042",61,48,48,1,0,"VOX",0
24,"24137",1114,811,804,9,7,"VOX",2
24,"24187",876,642,631,6,11,"VOX",1
24,"24212",1029,784,774,7,10,"VOX",1
24,"24121",655,481,477,0,4,"VOX",1
24,"24094",1392,1048,1038,11,10,"VOX",2
24,"24170",1934,1436,1424,13,12,"VOX",1
24,"24176",318,244,243,5,1,"VOX",1
24,"24157",2580,2013,1983,25,30,"VOX",2
24,"24219",527,390,387,2,3,"VOX",0
24,"24127",301,239,239,3,0,"VOX",0
24,"24113",366,282,275,3,7,"VOX",0
24,"24046",953,662,645,6,17,"VOX",1
24,"24078",388,286,284,4,2,"VOX",0
24,"24107",244,184,183,2,1,"VOX",0
24,"24044",171,125,118,0,7,"VOX",0
24,"24155",478,380,371,0,9,"VOX",0
24,"24029",754,545,539,2,6,"VOX",2
24,"24023",268,189,188,2,1,"VOX",0
24,"24061",1702,1244,1231,13,13,"VOX",5
24,"24033",211,154,151,1,3,"VOX",0
24,"24010",8426,5980,5888,61,92,"VOX",22
24,"24217",136,110,109,1,1,"VOX",0
24,"24030",4297,3226,3180,16,46,"VOX",5
24,"24148",1684,1268,1256,9,12,"VOX",6
24,"24110",1253,932,926,7,6,"VOX",1
24,"24071",1006,747,738,9,9,"VOX",0
24,"24018",177,143,141,0,2,"VOX",1
24,"24171",364,219,217,1,2,"VOX",0
24,"24105",1443,1087,1065,10,22,"VOX",1
24,"24222",14249,10663,10532,119,131,"VOX",17
24,"24076",1279,972,953,7,19,"VOX",6
24,"24194",292,230,229,1,1,"VOX",0
24,"24119",702,491,480,6,11,"VOX",1
24,"24184",206,121,120,0,1,"VOX",1
24,"24015",2279,1693,1658,22,35,"VOX",8
24,"24059",887,520,512,8,8,"VOX",0
24,"24041",548,384,381,5,3,"VOX",0
24,"24087",645,469,466,11,3,"VOX",3
24,"24025",300,233,228,0,5,"VOX",1
24,"24131",742,499,497,5,2,"VOX",0
24,"24050",102,77,77,1,0,"VOX",0
24,"24172",420,218,216,1,2,"VOX",0
24,"24177",481,328,327,1,1,"VOX",2
24,"24202",8098,5654,5582,51,72,"VOX",8
24,"24004",469,349,349,6,0,"VOX",0
24,"24088",1037,804,797,8,7,"VOX",1
24,"24179",299,202,201,8,1,"VOX",1
24,"24163",3929,3076,3044,49,32,"VOX",15
24,"24003",652,442,435,5,7,"VOX",1
24,"24145",655,445,443,8,2,"VOX",0
24,"24114",3107,2174,2155,7,19,"VOX",3
24,"24043",135,69,67,0,2,"VOX",0
24,"24060",615,361,359,0,2,"VOX",1
24,"24081",142,97,97,0,0,"VOX",0
24,"24206",1732,1303,1288,8,15,"VOX",1
24,"24136",544,391,390,8,1,"VOX",0
24,"24162",1671,1314,1303,21,11,"VOX",5
24,"24038",3107,2383,2354,30,29,"VOX",2
24,"24164",373,190,190,1,0,"VOX",0
24,"24082",870,692,682,10,10,"VOX",2
24,"24124",374,249,246,4,3,"VOX",0
24,"24040",453,315,309,2,6,"VOX",5
24,"24021",1688,1213,1189,6,24,"VOX",0
24,"24058",205,137,134,0,3,"VOX",0
24,"24196",2082,1529,1513,15,16,"VOX",0
24,"24095",314,246,244,1,2,"VOX",1
24,"24165",373,254,250,2,4,"VOX",0
24,"24118",127,84,84,1,0,"VOX",0
24,"24068",464,343,339,5,4,"VOX",0
24,"24183",805,528,522,5,6,"VOX",0
24,"24026",1203,908,898,19,10,"VOX",2
24,"24209",2790,1907,1884,15,23,"VOX",2
24,"24093",380,249,248,3,1,"VOX",1
24,"24153",233,173,172,3,1,"VOX",0
24,"24031",216,169,167,1,2,"VOX",0
24,"24019",359,293,291,3,2,"VOX",1
24,"24178",71,58,57,0,1,"VOX",0
24,"24180",1128,825,814,12,11,"VOX",3
24,"24123",757,499,497,4,2,"VOX",1
24,"24034",3419,2596,2556,27,40,"VOX",1
24,"24201",1086,765,757,5,8,"VOX",5
24,"24134",3465,2628,2583,27,45,"VOX",3
24,"24007",764,578,576,3,2,"VOX",1
24,"24102",655,495,492,2,3,"VOX",1
24,"24106",258,178,173,1,5,"VOX",0
24,"24117",446,333,331,2,2,"VOX",0
24,"24084",162,119,119,1,0,"VOX",0
24,"24012",297,212,211,4,1,"VOX",1
24,"24139",2186,1608,1570,24,38,"VOX",5
24,"24108",377,279,273,3,6,"VOX",0
24,"24092",809,619,609,1,10,"VOX",2
24,"24159",1832,1407,1391,17,16,"VOX",3
24,"24198",602,411,402,4,9,"VOX",0
24,"24120",345,214,214,1,0,"VOX",0
24,"24091",657,440,437,2,3,"VOX",0
24,"24144",704,487,478,5,9,"VOX",1
24,"24230",423,329,324,2,5,"VOX",0
24,"24052",171,109,108,0,1,"VOX",0
24,"24158",323,210,207,0,3,"VOX",0
24,"24221",790,568,558,6,10,"VOX",1
24,"24174",495,362,357,3,5,"VOX",1
24,"24086",271,200,198,1,2,"VOX",0
24,"24190",167,115,115,2,0,"VOX",0
24,"24103",292,160,160,1,0,"VOX",0
24,"24098",1205,880,874,8,6,"VOX",3
24,"24089",103315,77803,77038,779,765,"VOX",282
24,"24079",922,654,645,9,9,"VOX",11
24,"24115",54290,39886,39486,325,400,"VOX",74
24,"24055",705,510,507,6,3,"VOX",2
24,"24226",204,138,136,0,2,"VOX",0
24,"24901",908,660,653,4,7,"VOX",0
24,"24216",732,533,522,2,11,"VOX",4
24,"24080",218,170,162,3,8,"VOX",0
24,"24011",209,113,112,0,1,"VOX",0
24,"24156",243,169,169,1,0,"VOX",0
24,"24142",25160,18503,18262,205,241,"VOX",38
24,"24024",695,496,494,4,2,"VOX",0
24,"24223",2640,2012,2012,53,0,"VOX",3
24,"24101",404,264,262,2,2,"VOX",0
24,"24132",628,397,390,6,7,"VOX",0
24,"24215",156,119,118,1,1,"VOX",2
24,"24032",111,82,82,1,0,"VOX",2
24,"24214",669,492,490,1,2,"VOX",0
24,"24109",996,667,652,7,15,"VOX",1
24,"24211",276,210,206,4,4,"VOX",0
24,"24133",350,259,258,3,1,"VOX",1
24,"24036",301,181,180,0,1,"VOX",0
24,"24213",158,117,117,0,0,"VOX",0
24,"24063",391,260,259,1,1,"VOX",0
24,"24074",99,77,76,1,1,"VOX",0
24,"24181",1519,1135,1117,10,18,"VOX",24
24,"24027",1214,881,860,8,21,"VOX",0
24,"24149",155,123,121,0,2,"VOX",0
24,"24182",420,289,287,6,2,"VOX",0
24,"24207",296,245,241,3,4,"VOX",0
24,"24193",384,277,276,4,1,"VOX",0
24,"24154",1010,750,729,7,21,"VOX",0
24,"24070",4159,3206,3162,31,44,"VOX",4
24,"24225",1020,786,773,6,13,"VOX",1
24,"24129",122,85,85,1,0,"VOX",0
24,"24112",318,207,207,0,0,"VOX",0
24,"24014",7474,5375,5321,56,54,"VOX",2
24,"24116",424,276,273,0,3,"VOX",0
24,"24168",461,383,379,4,4,"VOX",1
24,"24152",462,302,301,2,1,"VOX",0
24,"24006",488,351,342,4,9,"VOX",3
24,"24191",111,84,84,1,0,"VOX",1
24,"24197",770,545,537,6,8,"VOX",0
24,"24073",481,343,340,3,3,"VOX",0
24,"24077",227,195,192,1,3,"VOX",1
24,"24049",1493,1152,1138,8,14,"VOX",0
24,"24210",510,347,347,0,0,"VOX",0
24,"24173",943,678,673,3,5,"VOX",5
24,"24227",1617,1146,1142,14,4,"VOX",3
24,"24017",582,434,433,9,1,"VOX",0
24,"24175",1825,1381,1372,13,9,"VOX",1
24,"24022",342,227,227,0,0,"VOX",0
24,"24229",427,330,324,8,6,"VOX",0
24,"24066",504,367,361,3,6,"VOX",1
24,"24169",2976,2256,2236,12,20,"VOX",3
24,"24224",621,452,445,7,7,"VOX",0
24,"24205",967,714,706,9,8,"VOX",1
24,"24037",369,251,251,0,0,"VOX",0
24,"24064",1525,1165,1151,10,14,"VOX",1
21,"21073",1871,1134,1120,12,14,"PODEMOS",124
21,"21039",308,223,222,2,1,"PODEMOS",37
21,"21036",192,138,138,1,0,"PODEMOS",7
21,"21069",1715,1186,1175,7,11,"PODEMOS",108
21,"21014",4041,3203,3170,15,33,"PODEMOS",311
21,"21061",5092,3471,3429,32,42,"PODEMOS",252
21,"21021",12233,7551,7470,94,81,"PODEMOS",958
21,"21045",253,192,190,0,2,"PODEMOS",40
21,"21019",590,433,423,4,10,"PODEMOS",71
21,"21058",2602,1904,1886,8,18,"PODEMOS",153
21,"21020",372,241,238,2,3,"PODEMOS",31
21,"21067",415,309,303,0,6,"PODEMOS",64
21,"21054",8105,6025,5919,41,106,"PODEMOS",494
21,"21034",1207,848,838,8,10,"PODEMOS",136
21,"21001",648,479,469,4,10,"PODEMOS",108
21,"21003",695,533,525,1,8,"PODEMOS",80
21,"21049",3372,2162,2108,15,54,"PODEMOS",415
21,"21051",245,176,173,1,3,"PODEMOS",20
21,"21015",683,425,420,6,5,"PODEMOS",68
21,"21028",381,290,287,0,3,"PODEMOS",9
21,"21006",3402,2398,2359,13,39,"PODEMOS",392
21,"21078",2763,1928,1907,12,21,"PODEMOS",266
21,"21072",10280,7869,7777,76,92,"PODEMOS",1433
21,"21023",2147,1379,1357,6,22,"PODEMOS",158
21,"21064",6526,4544,4492,51,52,"PODEMOS",677
21,"21005",15486,10310,10189,64,121,"PODEMOS",1355
21,"21027",49,36,36,1,0,"PODEMOS",4
21,"21066",507,408,405,1,3,"PODEMOS",42
21,"21050",12448,8431,8382,86,49,"PODEMOS",806
21,"21035",9622,6399,6313,69,86,"PODEMOS",855
21,"21053",3316,2257,2219,25,38,"PODEMOS",253
21,"21060",11959,7565,7488,103,77,"PODEMOS",1317
21,"21041",113604,74902,74244,718,658,"PODEMOS",13863
21,"21012",322,234,227,0,7,"PODEMOS",42
21,"21026",270,184,178,1,6,"PODEMOS",26
21,"21059",220,167,165,3,2,"PODEMOS",16
21,"21048",305,220,220,3,0,"PODEMOS",32
21,"21071",204,160,158,2,2,"PODEMOS",16
21,"21029",1564,1166,1126,16,40,"PODEMOS",78
21,"21065",287,202,196,0,6,"PODEMOS",17
21,"21032",1805,1378,1359,15,19,"PODEMOS",269
21,"21055",6914,5286,5218,34,68,"PODEMOS",533
21,"21008",2662,1847,1831,14,16,"PODEMOS",184
21,"21063",2614,2044,2034,12,10,"PODEMOS",185
21,"21074",2660,1869,1844,18,25,"PODEMOS",97
21,"21057",1045,641,640,8,1,"PODEMOS",50
21,"21077",1722,1261,1246,5,15,"PODEMOS",87
21,"21062",1395,936,926,9,10,"PODEMOS",44
21,"21025",4049,2682,2653,25,29,"PODEMOS",326
21,"21030",1824,1491,1472,11,19,"PODEMOS",83
21,"21079",731,526,522,3,4,"PODEMOS",62
21,"21052",4618,2837,2773,20,64,"PODEMOS",585
21,"21033",536,399,395,0,4,"PODEMOS",83
21,"21056",2912,2115,2024,20,91,"PODEMOS",411
21,"21002",15348,10939,10864,80,75,"PODEMOS",2209
21,"21011",3464,2536,2518,19,18,"PODEMOS",321
21,"21024",495,350,344,5,6,"PODEMOS",58
21,"21007",6231,4285,4227,45,58,"PODEMOS",804
21,"21046",1703,1200,1173,15,27,"PODEMOS",58
21,"21018",1780,1152,1131,10,21,"PODEMOS",184
21,"21009",860,571,555,6,16,"PODEMOS",92
21,"21017",3643,2301,2269,17,32,"PODEMOS",291
21,"21075",351,270,266,2,4,"PODEMOS",22
21,"21004",1641,1070,1047,10,23,"PODEMOS",188
21,"21010",14684,8766,8698,92,68,"PODEMOS",1345
21,"21040",3158,2386,2345,15,41,"PODEMOS",316
21,"21037",472,364,360,2,4,"PODEMOS",61
21,"21043",1858,1356,1341,13,15,"PODEMOS",152
21,"21068",998,606,605,14,1,"PODEMOS",40
21,"21031",1209,845,828,3,17,"PODEMOS",65
21,"21070",6296,4450,4397,38,53,"PODEMOS",644
21,"21044",17552,10820,10692,106,128,"PODEMOS",1138
21,"21042",15349,7802,7708,106,94,"PODEMOS",1340
21,"21076",2123,1549,1532,13,17,"PODEMOS",269
21,"21013",10597,7220,7061,69,159,"PODEMOS",1203
21,"21047",1914,1213,1179,19,34,"PODEMOS",107
21,"21038",1082,732,719,8,13,"PODEMOS",119
21,"21022",174,115,109,1,6,"PODEMOS",24
21,"21016",1034,777,764,2,13,"PODEMOS",136
6,"6153",20417,15129,14934,112,195,"RECORTES CE",13
6,"6101",466,386,382,0,4,"RECORTES CE",0
6,"6002",4335,3084,3006,33,78,"RECORTES CE",5
6,"6072",2334,1813,1792,20,21,"RECORTES CE",2
6,"6048",848,716,700,0,16,"RECORTES CE",0
6,"6137",987,811,805,4,6,"RECORTES CE",1
6,"6120",3393,2635,2600,14,35,"RECORTES CE",5
6,"6146",1094,848,837,5,11,"RECORTES CE",0
6,"6147",362,285,281,0,4,"RECORTES CE",1
6,"6104",677,533,529,6,4,"RECORTES CE",0
6,"6019",2090,1519,1488,11,31,"RECORTES CE",2
6,"6090",877,661,642,7,19,"RECORTES CE",0
6,"6128",4445,3137,3116,36,21,"RECORTES CE",6
6,"6063",3038,2413,2391,15,22,"RECORTES CE",7
6,"6010",1111,877,863,7,14,"RECORTES CE",0
6,"6903",2017,1509,1475,11,34,"RECORTES CE",0
6,"6059",1858,1361,1342,12,19,"RECORTES CE",2
6,"6062",612,450,441,4,9,"RECORTES CE",0
6,"6099",1148,768,749,5,19,"RECORTES CE",0
6,"6078",510,414,407,1,7,"RECORTES CE",0
6,"6152",1322,964,951,1,13,"RECORTES CE",1
6,"6020",1822,1435,1406,12,29,"RECORTES CE",0
6,"6065",309,257,247,0,10,"RECORTES CE",0
6,"6047",855,664,654,2,10,"RECORTES CE",0
6,"6087",2127,1612,1592,16,20,"RECORTES CE",3
6,"6037",1768,1176,1160,5,16,"RECORTES CE",0
6,"6042",1012,711,703,3,8,"RECORTES CE",0
6,"6064",841,672,671,6,1,"RECORTES CE",0
6,"6036",5085,3797,3739,29,58,"RECORTES CE",4
6,"6055",2058,1557,1527,21,30,"RECORTES CE",0
6,"6031",466,321,316,2,5,"RECORTES CE",1
6,"6053",607,459,450,2,9,"RECORTES CE",0
6,"6135",1103,904,888,9,16,"RECORTES CE",0
6,"6054",5442,4185,4098,32,87,"RECORTES CE",4
6,"6028",4253,3716,3631,30,85,"RECORTES CE",2
6,"6017",274,229,228,1,1,"RECORTES CE",0
6,"6096",226,188,182,1,6,"RECORTES CE",1
6,"6103",4781,3519,3459,40,60,"RECORTES CE",8
6,"6024",1181,955,942,5,13,"RECORTES CE",2
6,"6052",4051,3071,3009,31,62,"RECORTES CE",0
6,"6139",553,442,436,1,6,"RECORTES CE",0
6,"6033",1330,1037,1025,10,12,"RECORTES CE",0
6,"6058",2055,1512,1494,14,18,"RECORTES CE",1
6,"6123",4644,3420,3357,22,63,"RECORTES CE",7
6,"6066",1776,1260,1245,2,15,"RECORTES CE",0
6,"6038",801,558,551,5,7,"RECORTES CE",0
6,"6074",4814,3717,3659,37,58,"RECORTES CE",4
6,"6083",46111,32608,32276,235,332,"RECORTES CE",62
6,"6011",24721,17683,17506,172,177,"RECORTES CE",27
6,"6902",1672,1239,1224,6,15,"RECORTES CE",0
6,"6124",1739,1309,1287,15,22,"RECORTES CE",1
6,"6150",806,658,650,6,8,"RECORTES CE",0
6,"6045",499,378,378,4,0,"RECORTES CE",0
6,"6100",938,776,763,2,13,"RECORTES CE",0
6,"6142",276,215,207,0,8,"RECORTES CE",0
6,"6069",3079,2164,2137,21,27,"RECORTES CE",2
6,"6046",1248,989,978,4,11,"RECORTES CE",0
6,"6145",916,717,711,9,6,"RECORTES CE",0
6,"6003",830,656,647,6,9,"RECORTES CE",0
6,"6030",172,138,138,0,0,"RECORTES CE",0
6,"6116",1607,1168,1149,10,19,"RECORTES CE",0
6,"6085",3427,2563,2524,21,39,"RECORTES CE",6
6,"6079",645,502,488,1,14,"RECORTES CE",0
6,"6098",545,408,402,1,6,"RECORTES CE",0
6,"6157",453,316,315,0,1,"RECORTES CE",0
6,"6109",3957,3258,3177,22,81,"RECORTES CE",1
6,"6073",745,507,497,5,10,"RECORTES CE",1
6,"6130",195,174,170,0,4,"RECORTES CE",0
6,"6005",1717,1271,1258,10,13,"RECORTES CE",1
6,"6057",573,471,466,1,5,"RECORTES CE",0
6,"6134",545,325,323,3,2,"RECORTES CE",0
6,"6126",2183,1594,1582,9,12,"RECORTES CE",0
6,"6077",347,276,272,3,4,"RECORTES CE",0
6,"6086",1233,884,874,3,10,"RECORTES CE",2
6,"6113",2725,2091,2054,9,37,"RECORTES CE",4
6,"6050",4124,3178,3110,30,68,"RECORTES CE",1
6,"6108",2299,1714,1683,13,31,"RECORTES CE",1
6,"6013",265,230,224,1,6,"RECORTES CE",0
6,"6136",1578,1182,1168,8,14,"RECORTES CE",2
6,"6141",1741,1246,1223,13,23,"RECORTES CE",1
6,"6127",2893,2188,2158,13,30,"RECORTES CE",1
6,"6140",633,493,482,6,11,"RECORTES CE",0
6,"6049",1021,747,733,2,14,"RECORTES CE",0
6,"6051",1573,1235,1222,6,13,"RECORTES CE",2
6,"6125",1754,1327,1304,7,23,"RECORTES CE",0
6,"6132",855,634,627,4,7,"RECORTES CE",3
6,"6110",151,107,104,0,3,"RECORTES CE",0
6,"6155",1890,1337,1315,15,22,"RECORTES CE",0
6,"6060",5798,4346,4261,23,85,"RECORTES CE",3
6,"6056",481,401,399,2,2,"RECORTES CE",0
6,"6105",631,448,443,0,5,"RECORTES CE",2
6,"6118",206,165,164,1,1,"RECORTES CE",0
6,"6022",2660,2159,2140,12,19,"RECORTES CE",4
6,"6016",2978,2258,2235,14,23,"RECORTES CE",1
6,"6111",507,360,359,2,1,"RECORTES CE",0
6,"6032",66,54,54,2,0,"RECORTES CE",0
6,"6129",591,466,462,3,4,"RECORTES CE",0
6,"6097",2390,1814,1798,7,16,"RECORTES CE",4
6,"6075",477,401,389,2,12,"RECORTES CE",1
6,"6161",315,236,231,1,5,"RECORTES CE",0
6,"6039",1838,1546,1517,9,29,"RECORTES CE",1
6,"6102",1055,843,830,3,13,"RECORTES CE",0
6,"6084",1100,857,842,4,15,"RECORTES CE",1
6,"6035",957,700,690,4,10,"RECORTES CE",0
6,"6018",761,543,539,3,4,"RECORTES CE",0
6,"6061",1092,899,890,6,9,"RECORTES CE",0
6,"6148",973,739,730,5,9,"RECORTES CE",0
6,"6112",393,335,333,0,2,"RECORTES CE",0
6,"6088",12639,8992,8885,68,107,"RECORTES CE",11
6,"6107",1591,1114,1107,4,7,"RECORTES CE",0
6,"6021",928,668,656,9,12,"RECORTES CE",0
6,"6025",5126,3833,3783,37,50,"RECORTES CE",4
6,"6095",9493,6973,6839,97,134,"RECORTES CE",7
6,"6117",1417,1044,1031,3,13,"RECORTES CE",1
6,"6081",1078,850,839,4,11,"RECORTES CE",0
6,"6131",1074,887,885,2,2,"RECORTES CE",2
6,"6114",148,116,116,0,0,"RECORTES CE",0
6,"6004",1604,1265,1248,10,17,"RECORTES CE",0
6,"6009",206,156,156,1,0,"RECORTES CE",0
6,"6014",6688,4651,4586,22,65,"RECORTES CE",5
6,"6149",10342,8013,7897,70,116,"RECORTES CE",8
6,"6067",1984,1408,1377,9,31,"RECORTES CE",1
6,"6901",2114,1648,1625,28,23,"RECORTES CE",4
6,"6144",562,450,447,3,3,"RECORTES CE",1
6,"6106",428,295,293,2,2,"RECORTES CE",0
6,"6026",837,632,623,2,9,"RECORTES CE",1
6,"6089",598,491,488,3,3,"RECORTES CE",0
6,"6119",701,519,514,1,5,"RECORTES CE",0
6,"6159",2339,1429,1407,14,22,"RECORTES CE",0
6,"6044",28899,20862,20681,153,181,"RECORTES CE",27
6,"6029",1213,892,875,8,17,"RECORTES CE",1
6,"6015",116673,82152,81388,677,764,"RECORTES CE",147
6,"6043",673,542,535,5,7,"RECORTES CE",1
6,"6007",1483,1076,1068,6,8,"RECORTES CE",0
6,"6122",6651,4654,4553,29,101,"RECORTES CE",13
6,"6070",7753,5773,5645,52,128,"RECORTES CE",5
6,"6133",1775,1351,1334,9,17,"RECORTES CE",0
6,"6027",681,586,576,1,10,"RECORTES CE",0
6,"6034",174,126,125,2,1,"RECORTES CE",0
6,"6151",1094,809,801,8,8,"RECORTES CE",1
6,"6115",1260,867,853,7,14,"RECORTES CE",2
6,"6071",247,208,203,0,5,"RECORTES CE",0
6,"6041",460,378,375,3,3,"RECORTES CE",0
6,"6094",1483,1025,1014,6,11,"RECORTES CE",2
6,"6008",634,562,558,1,4,"RECORTES CE",0
6,"6076",837,632,624,2,8,"RECORTES CE",1
6,"6154",2798,2001,1975,17,26,"RECORTES CE",0
6,"6092",582,402,392,3,10,"RECORTES CE",2
6,"6040",1002,758,754,4,4,"RECORTES CE",1
6,"6162",2938,2278,2239,17,39,"RECORTES CE",3
6,"6158",13305,9965,9802,91,163,"RECORTES CE",17
6,"6121",3383,2518,2483,21,35,"RECORTES CE",4
6,"6093",4472,3476,3416,22,60,"RECORTES CE",5
6,"6082",382,312,306,3,6,"RECORTES CE",0
6,"6006",4595,3365,3318,27,47,"RECORTES CE",3
6,"6080",1931,1498,1480,9,18,"RECORTES CE",2
6,"6023",4362,3200,3168,11,32,"RECORTES CE",2
6,"6001",696,526,521,1,5,"RECORTES CE",1
6,"6160",3154,2324,2292,12,32,"RECORTES CE",1
6,"6068",453,349,344,3,5,"RECORTES CE",0
6,"6156",1169,903,898,2,5,"RECORTES CE",0
6,"6012",3280,2358,2343,12,15,"RECORTES CE",2
6,"6143",3338,2548,2508,23,40,"RECORTES CE",0
6,"6091",3782,2728,2690,32,38,"RECORTES CE",0
6,"6138",1059,795,773,3,22,"RECORTES CE",0
48,"48038",1122,834,824,0,10,"EZKERRA",3
48,"48005",117,76,76,0,0,"EZKERRA",0
48,"48073",6952,4476,4435,43,41,"EZKERRA",2
48,"48010",457,311,307,1,4,"EZKERRA",0
48,"48908",245,200,199,1,1,"EZKERRA",0
48,"48017",13290,8908,8856,42,52,"EZKERRA",9
48,"48008",617,433,424,6,9,"EZKERRA",2
48,"48043",4403,3214,3186,28,28,"EZKERRA",6
48,"48909",207,165,165,1,0,"EZKERRA",0
48,"48068",1551,1178,1163,16,15,"EZKERRA",1
48,"48089",3266,2425,2406,23,19,"EZKERRA",2
48,"48003",14338,10497,10414,76,83,"EZKERRA",12
48,"48079",425,322,321,4,1,"EZKERRA",1
48,"48069",12765,8985,8910,58,75,"EZKERRA",11
48,"48024",1003,775,771,5,4,"EZKERRA",0
48,"48905",2565,1882,1847,2,35,"EZKERRA",3
48,"48032",5735,4173,4151,32,22,"EZKERRA",4
48,"48002",7851,5767,5713,41,54,"EZKERRA",8
48,"48911",382,291,286,2,5,"EZKERRA",1
48,"48910",2948,2126,2115,17,11,"EZKERRA",1
48,"48065",3315,2447,2433,19,14,"EZKERRA",7
48,"48030",608,454,453,4,1,"EZKERRA",0
48,"48052",1559,1215,1211,0,4,"EZKERRA",1
48,"48007",365,241,239,0,2,"EZKERRA",0
48,"48093",900,673,664,4,9,"EZKERRA",2
48,"48016",5260,3856,3827,22,29,"EZKERRA",5
48,"48047",161,112,112,0,0,"EZKERRA",0
48,"48044",62989,46989,46783,385,206,"EZKERRA",60
48,"48028",715,553,551,4,2,"EZKERRA",0
48,"48040",1299,896,884,5,12,"EZKERRA",1
48,"48034",12902,9684,9613,79,71,"EZKERRA",43
48,"48078",38742,28064,27837,231,227,"EZKERRA",49
48,"48084",22577,15689,15540,108,149,"EZKERRA",80
48,"48037",678,518,509,2,9,"EZKERRA",2
48,"48021",1352,952,946,8,6,"EZKERRA",0
48,"48018",875,553,553,3,0,"EZKERRA",0
48,"48015",33690,24299,24160,168,139,"EZKERRA",56
48,"48067",1161,837,834,2,3,"EZKERRA",0
48,"48025",883,642,639,3,3,"EZKERRA",0
48,"48006",289,246,245,3,1,"EZKERRA",1
48,"48902",19124,13344,13227,93,117,"EZKERRA",30
48,"48056",978,733,732,7,1,"EZKERRA",6
48,"48045",5149,3940,3885,35,55,"EZKERRA",9
48,"48049",548,433,431,0,2,"EZKERRA",0
48,"48035",412,313,312,4,1,"EZKERRA",0
48,"48020",274076,193807,192607,1471,1200,"EZKERRA",458
48,"48904",3504,2671,2650,18,21,"EZKERRA",0
48,"48014",1218,870,866,8,4,"EZKERRA",1
48,"48913",1251,933,917,13,16,"EZKERRA",2
48,"48051",220,169,168,0,1,"EZKERRA",0
48,"48057",5749,4093,4081,20,12,"EZKERRA",2
48,"48027",22033,15929,15825,113,104,"EZKERRA",47
48,"48083",6950,5128,5097,33,31,"EZKERRA",25
48,"48063",373,289,288,1,1,"EZKERRA",0
48,"48095",2352,1658,1647,6,11,"EZKERRA",2
48,"48071",6118,4467,4412,32,55,"EZKERRA",7
48,"48912",2308,1787,1746,27,41,"EZKERRA",2
48,"48012",2041,1571,1553,11,18,"EZKERRA",1
48,"48026",1134,861,853,7,8,"EZKERRA",0
48,"48081",1883,1412,1398,12,14,"EZKERRA",11
48,"48041",704,558,555,4,3,"EZKERRA",0
48,"48074",3333,2467,2428,20,39,"EZKERRA",1
48,"48914",330,275,275,1,0,"EZKERRA",0
48,"48029",8332,6155,6119,35,36,"EZKERRA",11
48,"48039",243,201,201,2,0,"EZKERRA",0
48,"48092",837,619,619,13,0,"EZKERRA",10
48,"48022",2355,1476,1468,9,8,"EZKERRA",4
48,"48023",594,470,468,4,2,"EZKERRA",0
48,"48064",603,463,459,7,4,"EZKERRA",0
48,"48091",1134,821,812,7,9,"EZKERRA",2
48,"48077",3367,2438,2423,17,15,"EZKERRA",4
48,"48059",402,317,314,1,3,"EZKERRA",0
48,"48087",429,346,343,1,3,"EZKERRA",0
48,"48058",972,691,687,4,4,"EZKERRA",0
48,"48915",362,238,238,2,0,"EZKERRA",0
48,"48009",786,614,609,3,5,"EZKERRA",0
48,"48090",6022,4544,4483,23,61,"EZKERRA",6
48,"48013",79984,56928,56516,383,412,"EZKERRA",145
48,"48004",334,229,227,1,2,"EZKERRA",0
48,"48011",9692,6891,6843,56,48,"EZKERRA",11
48,"48046",12617,9037,8967,56,70,"EZKERRA",19
48,"48901",4775,3602,3573,35,29,"EZKERRA",8
48,"48060",3645,2277,2274,7,3,"EZKERRA",7
48,"48033",215,160,159,0,1,"EZKERRA",0
48,"48050",198,153,150,0,3,"EZKERRA",0
48,"48042",1384,1111,1091,7,20,"EZKERRA",1
48,"48903",1838,1400,1385,4,15,"EZKERRA",1
48,"48019",3594,2569,2544,16,25,"EZKERRA",11
48,"48075",1975,1440,1421,12,19,"EZKERRA",4
48,"48097",1303,907,898,10,9,"EZKERRA",1
48,"48086",2073,1519,1504,15,15,"EZKERRA",2
48,"48062",300,241,240,1,1,"EZKERRA",0
48,"48031",340,245,242,0,3,"EZKERRA",0
48,"48054",24135,17493,17374,124,119,"EZKERRA",49
48,"48096",6608,5071,5011,43,60,"EZKERRA",7
48,"48053",900,676,670,8,6,"EZKERRA",0
48,"48072",974,728,723,5,5,"EZKERRA",0
48,"48055",2662,1961,1938,16,23,"EZKERRA",4
48,"48001",5832,4191,4166,37,25,"EZKERRA",17
48,"48082",37673,27006,26811,201,195,"EZKERRA",90
48,"48076",314,237,237,4,0,"EZKERRA",0
48,"48080",9971,7148,7086,71,62,"EZKERRA",13
48,"48906",775,579,574,0,5,"EZKERRA",0
48,"48070",545,378,374,2,4,"EZKERRA",0
48,"48036",24144,17085,16954,117,131,"EZKERRA",27
48,"48094",3193,2210,2200,18,10,"EZKERRA",7
48,"48907",355,283,282,2,1,"EZKERRA",0
48,"48088",135,97,96,0,1,"EZKERRA",0
48,"48066",346,256,256,1,0,"EZKERRA",0
48,"48048",562,399,394,3,5,"EZKERRA",0
48,"48061",762,584,581,4,3,"EZKERRA",1
48,"48085",10301,7458,7407,50,51,"EZKERRA",8
8,"8197",7605,5331,5317,31,14,"EN COMÚ",933
8,"8175",3371,2243,2232,25,11,"EN COMÚ",240
8,"8085",985,712,704,1,8,"EN COMÚ",82
8,"8122",1683,1117,1106,10,11,"EN COMÚ",266
8,"8303",278,206,205,2,1,"EN COMÚ",30
8,"8051",17873,13126,13048,66,78,"EN COMÚ",3565
8,"8257",110,87,87,0,0,"EN COMÚ",18
8,"8185",194,132,132,0,0,"EN COMÚ",27
8,"8206",731,568,559,9,9,"EN COMÚ",74
8,"8284",12067,7855,7792,66,63,"EN COMÚ",2034
8,"8179",579,427,425,6,2,"EN COMÚ",107
8,"8011",1760,1230,1217,10,13,"EN COMÚ",115
8,"8145",2585,1927,1915,10,12,"EN COMÚ",444
8,"8126",8709,6454,6425,34,29,"EN COMÚ",2038
8,"8040",10701,7420,7383,43,37,"EN COMÚ",1723
8,"8101",174802,123863,123197,643,666,"EN COMÚ",36973
8,"8247",958,716,714,7,2,"EN COMÚ",79
8,"8061",1485,1045,1040,5,5,"EN COMÚ",317
8,"8135",6733,5230,5205,45,25,"EN COMÚ",1642
8,"8281",4841,3577,3553,18,24,"EN COMÚ",676
8,"8030",5095,3727,3712,27,15,"EN COMÚ",580
8,"8305",27328,19226,19083,116,143,"EN COMÚ",3919
8,"8008",187,118,118,1,0,"EN COMÚ",13
8,"8204",3058,2282,2262,17,20,"EN COMÚ",654
8,"8307",48233,34249,34071,209,178,"EN COMÚ",9768
8,"8249",266,223,220,2,3,"EN COMÚ",40
8,"8139",171,133,132,0,1,"EN COMÚ",18
8,"8025",1486,1087,1083,13,4,"EN COMÚ",298
8,"8036",159,113,112,1,1,"EN COMÚ",9
8,"8113",52051,34906,34729,229,177,"EN COMÚ",6586
8,"8094",1548,1143,1133,12,10,"EN COMÚ",208
8,"8208",5736,4318,4295,23,23,"EN COMÚ",1297
8,"8099",749,514,513,4,1,"EN COMÚ",93
8,"8158",3105,2166,2145,18,21,"EN COMÚ",585
8,"8152",114,84,82,1,2,"EN COMÚ",7
8,"8013",1219,873,867,10,6,"EN COMÚ",152
8,"8082",1150,788,783,6,5,"EN COMÚ",220
8,"8004",233,181,181,2,0,"EN COMÚ",21
8,"8264",4288,3045,3030,30,15,"EN COMÚ",472
8,"8163",18590,12816,12750,72,66,"EN COMÚ",2853
8,"8002",202,142,139,0,3,"EN COMÚ",15
8,"8093",26,19,19,0,0,"EN COMÚ",1
8,"8278",4764,3372,3358,16,14,"EN COMÚ",302
8,"8007",6505,4532,4495,28,37,"EN COMÚ",860
8,"8020",4876,3702,3678,25,24,"EN COMÚ",952
8,"8141",4590,3173,3150,39,23,"EN COMÚ",402
8,"8275",254,202,202,4,0,"EN COMÚ",13
8,"8109",214,174,173,0,1,"EN COMÚ",18
8,"8205",59169,45410,45231,357,179,"EN COMÚ",9090
8,"8276",233,169,169,3,0,"EN COMÚ",40
8,"8254",1746,1261,1257,13,4,"EN COMÚ",107
8,"8050",141,107,104,0,3,"EN COMÚ",4
8,"8124",36750,26968,26842,140,126,"EN COMÚ",8892
8,"8071",241,168,164,3,4,"EN COMÚ",25
8,"8098",2387,1668,1662,11,6,"EN COMÚ",420
8,"8224",816,598,595,7,3,"EN COMÚ",132
8,"8131",699,520,516,4,4,"EN COMÚ",71
8,"8226",879,683,680,3,3,"EN COMÚ",72
8,"8102",28304,19929,19821,170,108,"EN COMÚ",3527
8,"8193",942,637,633,9,4,"EN COMÚ",138
8,"8277",162,132,132,0,0,"EN COMÚ",19
8,"8039",354,259,259,0,0,"EN COMÚ",62
8,"8095",71,50,50,0,0,"EN COMÚ",3
8,"8296",1787,1358,1351,9,7,"EN COMÚ",244
8,"8084",1135,795,790,6,5,"EN COMÚ",156
8,"8241",76,59,59,0,0,"EN COMÚ",6
8,"8024",381,270,269,3,1,"EN COMÚ",30
8,"8022",12230,7792,7717,60,75,"EN COMÚ",1067
8,"8070",267,196,193,2,3,"EN COMÚ",17
8,"8174",394,306,300,3,6,"EN COMÚ",34
8,"8289",4304,3166,3151,19,15,"EN COMÚ",856
8,"8137",265,206,205,1,1,"EN COMÚ",36
8,"8194",25539,16628,16553,77,75,"EN COMÚ",5304
8,"8227",2329,1625,1607,13,18,"EN COMÚ",294
8,"8198",4391,3167,3138,17,29,"EN COMÚ",669
8,"8209",6773,4845,4822,31,23,"EN COMÚ",1412
8,"8019",1141245,824778,820790,5063,3988,"EN COMÚ",218053
8,"8190",258,179,177,2,2,"EN COMÚ",24
8,"8191",5287,3732,3712,31,20,"EN COMÚ",789
8,"8034",766,542,538,3,4,"EN COMÚ",59
8,"8119",6182,4517,4492,35,25,"EN COMÚ",1459
8,"8027",690,527,524,3,3,"EN COMÚ",95
8,"8298",26426,17862,17784,113,78,"EN COMÚ",2151
8,"8134",803,560,554,5,6,"EN COMÚ",119
8,"8090",129,103,102,2,1,"EN COMÚ",8
8,"8130",96,66,66,0,0,"EN COMÚ",5
8,"8295",10850,7651,7617,33,34,"EN COMÚ",2359
8,"8265",1548,1115,1108,8,7,"EN COMÚ",129
8,"8203",2422,1602,1591,11,11,"EN COMÚ",423
8,"8225",93,71,71,2,0,"EN COMÚ",9
8,"8076",16173,11553,11473,73,80,"EN COMÚ",3465
8,"8087",159,131,130,2,1,"EN COMÚ",18
8,"8079",339,254,248,2,6,"EN COMÚ",21
8,"8091",5253,3817,3795,23,22,"EN COMÚ",1117
8,"8176",158,113,113,1,0,"EN COMÚ",6
8,"8035",12448,8482,8443,54,39,"EN COMÚ",1649
8,"8168",375,235,234,0,1,"EN COMÚ",36
8,"8248",5402,3848,3815,27,33,"EN COMÚ",959
8,"8128",564,378,377,1,1,"EN COMÚ",71
8,"8180",26616,19621,19542,90,79,"EN COMÚ",7064
8,"8255",140,90,90,1,0,"EN COMÚ",12
8,"8165",1657,1181,1175,8,6,"EN COMÚ",272
8,"8237",1642,1165,1160,4,5,"EN COMÚ",99
8,"8136",11416,8425,8388,63,37,"EN COMÚ",2817
8,"8059",342,224,223,3,1,"EN COMÚ",34
8,"8169",47915,35543,35390,211,153,"EN COMÚ",12761
8,"8201",436,299,298,1,1,"EN COMÚ",46
8,"8144",715,493,489,9,4,"EN COMÚ",62
8,"8055",512,366,364,2,2,"EN COMÚ",57
8,"8125",25024,18070,17966,99,104,"EN COMÚ",6321
8,"8904",10563,7474,7437,32,37,"EN COMÚ",2745
8,"8219",15355,11458,11403,86,55,"EN COMÚ",2493
8,"8129",456,322,320,3,2,"EN COMÚ",58
8,"8159",14049,10329,10284,51,45,"EN COMÚ",3353
8,"8104",682,445,443,4,2,"EN COMÚ",40
8,"8100",1992,1496,1485,21,11,"EN COMÚ",90
8,"8213",6296,4308,4294,47,14,"EN COMÚ",910
8,"8049",1288,860,841,9,19,"EN COMÚ",75
8,"8067",5723,3896,3874,39,22,"EN COMÚ",661
8,"8112",12909,8671,8616,50,55,"EN COMÚ",1255
8,"8202",12615,8911,8831,70,80,"EN COMÚ",1850
8,"8060",143,100,99,0,1,"EN COMÚ",7
8,"8038",1488,987,981,10,6,"EN COMÚ",192
8,"8261",2319,1638,1632,4,6,"EN COMÚ",395
8,"8902",3756,2758,2741,18,17,"EN COMÚ",680
8,"8228",296,207,204,3,3,"EN COMÚ",44
8,"8243",160,117,117,6,0,"EN COMÚ",3
8,"8306",517,360,354,2,6,"EN COMÚ",97
8,"8905",2305,1789,1774,17,15,"EN COMÚ",499
8,"8127",2224,1439,1429,8,10,"EN COMÚ",311
8,"8160",330,217,217,0,0,"EN COMÚ",23
8,"8150",258,189,185,0,4,"EN COMÚ",28
8,"8069",3168,2333,2324,17,9,"EN COMÚ",577
8,"8072",10240,6957,6935,40,22,"EN COMÚ",1879
8,"8270",18399,12948,12869,83,79,"EN COMÚ",2798
8,"8058",1742,1210,1194,7,16,"EN COMÚ",363
8,"8146",1297,958,954,16,4,"EN COMÚ",268
8,"8229",535,383,379,3,4,"EN COMÚ",26
8,"8259",6623,4921,4885,33,36,"EN COMÚ",1056
8,"8029",3438,2645,2632,25,13,"EN COMÚ",374
8,"8062",951,676,674,5,2,"EN COMÚ",109
8,"8230",7611,5590,5560,40,30,"EN COMÚ",1048
8,"8903",213,167,167,0,0,"EN COMÚ",13
8,"8274",4702,3349,3323,35,26,"EN COMÚ",685
8,"8245",78581,55798,55530,345,268,"EN COMÚ",17463
8,"8081",345,255,255,1,0,"EN COMÚ",41
8,"8092",3768,2621,2600,31,21,"EN COMÚ",346
8,"8293",226,162,162,0,0,"EN COMÚ",20
8,"8006",11427,7789,7727,46,62,"EN COMÚ",1488
8,"8263",20974,15086,15001,93,85,"EN COMÚ",4397
8,"8182",2803,2039,2034,16,5,"EN COMÚ",559
8,"8111",216,185,185,0,0,"EN COMÚ",14
8,"8074",10587,7309,7274,51,35,"EN COMÚ",2197
8,"8018",2654,1834,1819,16,15,"EN COMÚ",347
8,"8238",14478,11302,11252,85,50,"EN COMÚ",2623
8,"8045",72,42,39,0,3,"EN COMÚ",7
8,"8268",1011,702,699,2,3,"EN COMÚ",103
8,"8231",20495,13961,13885,91,76,"EN COMÚ",3999
8,"8220",2358,1783,1770,18,13,"EN COMÚ",125
8,"8075",3875,2709,2695,12,14,"EN COMÚ",700
8,"8217",24985,19385,19317,130,68,"EN COMÚ",5785
8,"8097",1027,736,731,7,5,"EN COMÚ",168
8,"8086",13550,9448,9395,66,53,"EN COMÚ",2506
8,"8046",13243,9747,9693,74,54,"EN COMÚ",2389
8,"8042",2233,1668,1653,8,15,"EN COMÚ",444
8,"8031",2308,1648,1637,10,11,"EN COMÚ",220
8,"8239",451,324,324,5,0,"EN COMÚ",62
8,"8199",665,466,464,6,2,"EN COMÚ",45
8,"8153",536,432,431,6,1,"EN COMÚ",67
8,"8188",117,81,81,2,0,"EN COMÚ",2
8,"8221",12391,9503,9456,49,47,"EN COMÚ",2006
8,"8302",9209,6571,6524,65,47,"EN COMÚ",1964
8,"8028",1031,724,721,6,3,"EN COMÚ",251
8,"8116",582,421,418,4,3,"EN COMÚ",35
8,"8120",6815,5071,5045,34,26,"EN COMÚ",374
8,"8043",3190,2216,2201,12,15,"EN COMÚ",517
8,"8218",8045,5643,5613,54,30,"EN COMÚ",1373
8,"8244",5821,4484,4451,32,33,"EN COMÚ",1517
8,"8154",694,535,529,3,6,"EN COMÚ",103
8,"8222",1878,1452,1443,16,9,"EN COMÚ",398
8,"8080",38,28,27,0,1,"EN COMÚ",0
8,"8110",13392,9211,9142,67,69,"EN COMÚ",2337
8,"8047",3978,2640,2614,21,26,"EN COMÚ",420
8,"8121",86293,61426,61070,450,356,"EN COMÚ",14778
8,"8132",379,259,256,3,3,"EN COMÚ",18
8,"8282",6517,5027,5017,40,10,"EN COMÚ",1116
8,"8234",3187,2331,2322,11,9,"EN COMÚ",610
8,"8178",430,317,315,4,2,"EN COMÚ",50
8,"8010",4196,2876,2852,16,24,"EN COMÚ",472
8,"8181",7896,5774,5724,41,50,"EN COMÚ",1358
8,"8017",2756,1888,1876,7,12,"EN COMÚ",323
8,"8216",25,17,17,0,0,"EN COMÚ",9
8,"8256",644,516,512,1,4,"EN COMÚ",180
8,"8166",1000,680,674,4,6,"EN COMÚ",87
8,"8041",10314,7291,7238,46,53,"EN COMÚ",1786
8,"8123",19114,14573,14509,81,64,"EN COMÚ",3907
8,"8279",152985,110533,110039,684,494,"EN COMÚ",31793
8,"8078",216,135,135,2,0,"EN COMÚ",8
8,"8089",33935,24504,24392,150,112,"EN COMÚ",7111
8,"8301",48496,35956,35788,200,168,"EN COMÚ",11580
8,"8286",2904,2009,1997,17,12,"EN COMÚ",503
8,"8187",152527,112013,111491,638,522,"EN COMÚ",31943
8,"8189",126,95,94,2,1,"EN COMÚ",4
8,"8280",101,67,67,3,0,"EN COMÚ",7
8,"8291",4524,3226,3206,24,20,"EN COMÚ",920
8,"8064",1853,1323,1315,9,8,"EN COMÚ",224
8,"8114",18335,13196,13092,66,104,"EN COMÚ",3961
8,"8269",2646,1871,1860,17,11,"EN COMÚ",247
8,"8068",6729,4765,4739,23,26,"EN COMÚ",1298
8,"8258",835,602,597,5,5,"EN COMÚ",59
8,"8032",1973,1410,1403,6,7,"EN COMÚ",298
8,"8266",43128,32806,32660,195,146,"EN COMÚ",10551
8,"8105",9613,7103,7047,46,56,"EN COMÚ",2310
8,"8192",5696,4093,4069,38,24,"EN COMÚ",789
8,"8140",4769,3344,3335,25,9,"EN COMÚ",713
8,"8200",61275,45027,44785,276,242,"EN COMÚ",15236
8,"8157",8361,6311,6277,38,34,"EN COMÚ",1833
8,"8161",11145,7658,7621,45,37,"EN COMÚ",2209
8,"8252",24521,18605,18514,110,91,"EN COMÚ",6564
8,"8107",11472,8147,8097,45,50,"EN COMÚ",2413
8,"8106",7216,5220,5176,38,44,"EN COMÚ",1246
8,"8262",6855,4522,4491,46,31,"EN COMÚ",1110
8,"8009",9136,6613,6578,40,35,"EN COMÚ",1292
8,"8300",5682,4328,4312,21,16,"EN COMÚ",1230
8,"8260",18306,13492,13423,60,69,"EN COMÚ",4415
8,"8103",631,431,431,3,0,"EN COMÚ",80
8,"8271",69,47,46,0,1,"EN COMÚ",7
8,"8184",53690,37794,37636,200,158,"EN COMÚ",12023
8,"8285",10260,6893,6843,56,50,"EN COMÚ",1037
8,"8096",42411,30717,30550,204,167,"EN COMÚ",7025
8,"8308",131,99,97,0,2,"EN COMÚ",5
8,"8253",133,85,85,1,0,"EN COMÚ",14
8,"8149",996,662,660,7,2,"EN COMÚ",71
8,"8294",1971,1357,1349,8,8,"EN COMÚ",338
8,"8155",6736,4779,4734,45,45,"EN COMÚ",1482
8,"8223",1850,1279,1263,10,16,"EN COMÚ",235
8,"8015",155841,109156,108536,726,620,"EN COMÚ",32624
8,"8115",3817,2835,2814,18,21,"EN COMÚ",891
8,"8246",1682,1157,1152,8,5,"EN COMÚ",110
8,"8148",2238,1592,1580,7,12,"EN COMÚ",471
8,"8162",2028,1451,1442,8,9,"EN COMÚ",401
8,"8236",1525,1077,1067,3,10,"EN COMÚ",172
8,"8171",2099,1396,1389,20,7,"EN COMÚ",115
8,"8250",7046,4908,4878,33,30,"EN COMÚ",1292
8,"8083",1674,1287,1275,8,12,"EN COMÚ",85
8,"8177",40,25,25,1,0,"EN COMÚ",3
8,"8292",1083,796,791,4,5,"EN COMÚ",165
8,"8232",1797,1276,1266,14,10,"EN COMÚ",238
8,"8012",1676,1175,1170,24,5,"EN COMÚ",101
8,"8251",4970,3505,3480,14,25,"EN COMÚ",851
8,"8214",6841,5018,4994,49,24,"EN COMÚ",945
8,"8016",1822,1229,1214,12,15,"EN COMÚ",200
8,"8287",1044,806,792,7,14,"EN COMÚ",124
8,"8267",6435,4571,4542,24,29,"EN COMÚ",1379
8,"8117",2453,1741,1727,23,14,"EN COMÚ",218
8,"8172",20384,14738,14684,85,54,"EN COMÚ",3926
8,"8299",395,256,255,3,1,"EN COMÚ",22
8,"8023",6715,4669,4633,25,36,"EN COMÚ",1201
8,"8133",128,76,75,0,1,"EN COMÚ",4
8,"8044",4150,2957,2932,19,25,"EN COMÚ",596
8,"8001",8825,6810,6760,24,50,"EN COMÚ",2321
8,"8142",132,105,104,1,1,"EN COMÚ",13
8,"8066",1364,1029,1025,10,4,"EN COMÚ",250
8,"8052",139,94,94,2,0,"EN COMÚ",8
8,"8033",12803,9236,9179,79,57,"EN COMÚ",2084
8,"8164",911,651,644,2,7,"EN COMÚ",119
8,"8118",17516,12878,12820,79,58,"EN COMÚ",3279
8,"8170",447,293,291,11,2,"EN COMÚ",30
8,"8273",2309,1706,1689,12,17,"EN COMÚ",284
8,"8901",232,171,171,6,0,"EN COMÚ",8
8,"8057",59,42,41,2,1,"EN COMÚ",6
8,"8167",5879,4463,4448,42,15,"EN COMÚ",1609
8,"8065",1179,837,831,8,6,"EN COMÚ",109
8,"8272",157,98,97,0,1,"EN COMÚ",10
8,"8210",4296,2825,2806,22,19,"EN COMÚ",639
8,"8056",41996,30076,29974,178,102,"EN COMÚ",8267
8,"8290",1490,1163,1155,5,8,"EN COMÚ",248
8,"8235",3683,2612,2595,22,17,"EN COMÚ",416
8,"8143",2686,1892,1881,19,11,"EN COMÚ",432
8,"8240",9354,6996,6953,34,43,"EN COMÚ",1565
8,"8005",6165,4458,4434,23,24,"EN COMÚ",867
8,"8183",4524,3125,3103,21,22,"EN COMÚ",419
8,"8233",1876,1247,1237,11,10,"EN COMÚ",135
8,"8196",19247,14101,14047,75,54,"EN COMÚ",4527
8,"8048",583,426,424,5,2,"EN COMÚ",47
8,"8054",9013,6747,6702,38,45,"EN COMÚ",2010
8,"8014",1953,1438,1429,13,9,"EN COMÚ",256
8,"8037",1856,1364,1351,20,13,"EN COMÚ",104
8,"8063",448,363,363,8,0,"EN COMÚ",40
8,"8207",1840,1418,1410,17,8,"EN COMÚ",201
8,"8073",61659,45611,45356,239,255,"EN COMÚ",14949
8,"8151",463,336,333,11,3,"EN COMÚ",18
8,"8242",216,172,170,0,2,"EN COMÚ",24
8,"8283",5983,4032,4007,31,25,"EN COMÚ",563
8,"8288",1632,1061,1053,4,8,"EN COMÚ",296
8,"8088",11840,8684,8627,55,57,"EN COMÚ",1732
8,"8212",495,350,347,3,3,"EN COMÚ",14
8,"8108",5014,3757,3740,21,17,"EN COMÚ",1024
8,"8304",814,578,573,1,5,"EN COMÚ",72
8,"8215",2576,1766,1751,30,15,"EN COMÚ",206
8,"8138",4229,2832,2816,19,16,"EN COMÚ",479
8,"8053",2805,1789,1775,10,14,"EN COMÚ",411
8,"8211",32990,25446,25282,173,164,"EN COMÚ",7421
8,"8195",82,64,64,0,0,"EN COMÚ",5
8,"8003",7118,5140,5108,28,32,"EN COMÚ",914
8,"8021",69,52,51,3,1,"EN COMÚ",13
8,"8077",34550,26102,25983,152,119,"EN COMÚ",7010
8,"8297",138,100,99,1,1,"EN COMÚ",12
8,"8147",17001,12422,12333,62,89,"EN COMÚ",3802
8,"8156",10923,8013,7964,50,49,"EN COMÚ",2217
8,"8026",187,155,155,1,0,"EN COMÚ",20
14,"14070",1343,1026,1008,9,18,"PCOE",0
14,"14066",5890,4366,4322,29,44,"PCOE",11
14,"14040",3792,3036,3010,23,26,"PCOE",3
14,"14064",331,252,244,2,8,"PCOE",0
14,"14050",2399,1886,1864,11,22,"PCOE",5
14,"14024",1920,1522,1488,10,34,"PCOE",3
14,"14054",13665,10923,10678,103,245,"PCOE",9
14,"14012",6190,4574,4488,27,86,"PCOE",9
14,"14045",3055,2486,2451,13,35,"PCOE",3
14,"14021",260189,188939,187558,1934,1381,"PCOE",291
14,"14022",4036,3199,3169,9,30,"PCOE",12
14,"14044",1624,1285,1267,9,18,"PCOE",5
14,"14061",756,606,592,2,14,"PCOE",0
14,"14032",425,347,335,3,12,"PCOE",0
14,"14016",1364,1047,1045,3,2,"PCOE",0
14,"14055",18572,13587,13410,167,177,"PCOE",22
14,"14026",2073,1437,1421,13,16,"PCOE",2
14,"14072",1079,834,830,5,4,"PCOE",0
14,"14030",8580,6619,6542,66,77,"PCOE",4
14,"14027",7908,6085,6008,57,77,"PCOE",17
14,"14046",4484,3540,3487,22,53,"PCOE",9
14,"14060",4854,3695,3633,43,62,"PCOE",8
14,"14005",6358,4379,4272,56,107,"PCOE",12
14,"14015",2149,1637,1616,13,21,"PCOE",4
14,"14062",1052,813,801,4,12,"PCOE",0
14,"14074",2303,1940,1929,13,11,"PCOE",1
14,"14056",23613,17016,16804,128,212,"PCOE",22
14,"14009",2779,1941,1934,13,7,"PCOE",3
14,"14065",1861,1461,1446,12,15,"PCOE",2
14,"14017",10869,8130,8029,72,101,"PCOE",18
14,"14011",584,477,476,3,1,"PCOE",0
14,"14020",391,278,274,3,4,"PCOE",1
14,"14028",320,246,244,2,2,"PCOE",1
14,"14042",18921,14842,14653,184,189,"PCOE",42
14,"14048",1206,967,949,11,18,"PCOE",5
14,"14059",699,559,552,5,7,"PCOE",3
14,"14037",3344,2476,2442,20,34,"PCOE",1
14,"14008",2871,2053,2034,11,19,"PCOE",6
14,"14052",9447,6250,6201,49,49,"PCOE",10
14,"14051",1401,1095,1077,5,18,"PCOE",2
14,"14007",15200,11064,10926,81,138,"PCOE",10
14,"14029",4206,3170,3135,32,35,"PCOE",9
14,"14025",2950,2460,2425,10,35,"PCOE",2
14,"14013",16845,12599,12414,146,185,"PCOE",24
14,"14073",2900,2068,2041,15,27,"PCOE",3
14,"14035",5992,4475,4437,44,38,"PCOE",3
14,"14038",32236,22982,22773,209,209,"PCOE",29
14,"14043",7574,5571,5510,46,61,"PCOE",13
14,"14063",1065,803,797,4,6,"PCOE",1
14,"14041",3180,2404,2373,26,31,"PCOE",18
14,"14049",16357,12206,12029,127,177,"PCOE",27
14,"14036",3767,2911,2857,53,54,"PCOE",14
14,"14014",2570,2104,2075,8,29,"PCOE",1
14,"14003",1265,981,970,6,11,"PCOE",1
14,"14034",318,260,252,2,8,"PCOE",0
14,"14039",2628,2151,2123,11,28,"PCOE",3
14,"14075",581,463,446,6,17,"PCOE",0
14,"14033",1285,980,963,11,17,"PCOE",4
14,"14006",1331,1166,1137,7,29,"PCOE",1
14,"14018",3710,2882,2846,28,36,"PCOE",8
14,"14071",937,651,642,2,9,"PCOE",2
14,"14069",7536,5574,5495,48,79,"PCOE",4
14,"14019",6479,5131,5076,46,55,"PCOE",9
14,"14058",7973,5860,5791,49,69,"PCOE",2
14,"14031",597,490,484,0,6,"PCOE",0
14,"14053",6050,4498,4427,56,71,"PCOE",9
14,"14047",1654,1221,1211,17,10,"PCOE",2
14,"14023",2041,1742,1717,13,25,"PCOE",2
14,"14002",10951,8231,8150,72,81,"PCOE",16
14,"14010",4051,3003,2968,17,35,"PCOE",8
14,"14068",545,410,407,6,3,"PCOE",4
14,"14001",3552,2861,2830,28,31,"PCOE",2
14,"14067",3874,3033,2986,29,47,"PCOE",11
14,"14004",2036,1502,1488,6,14,"PCOE",1
14,"14057",6152,4973,4903,56,70,"PCOE",21
38,"38046",9107,6755,6682,45,73,"VOX",15
38,"38024",15055,9612,9485,77,127,"VOX",19
38,"38004",4442,2980,2939,20,41,"VOX",5
38,"38002",942,701,674,14,27,"VOX",0
38,"38045",3987,2152,2132,23,20,"VOX",1
38,"38008",5513,3683,3609,17,74,"VOX",3
38,"38011",20435,13760,13627,82,133,"VOX",17
38,"38007",1689,1143,1119,3,24,"VOX",1
38,"38028",22063,15095,14954,89,141,"VOX",22
38,"38047",1789,1228,1208,5,20,"VOX",1
38,"38042",3784,2692,2673,16,19,"VOX",1
38,"38015",4158,2864,2818,12,46,"VOX",3
38,"38034",4041,2853,2814,17,39,"VOX",4
38,"38053",3754,2419,2370,15,49,"VOX",2
38,"38049",2653,1683,1658,8,25,"VOX",0
38,"38039",10584,7532,7462,77,70,"VOX",15
38,"38031",28697,21546,21202,140,344,"VOX",33
38,"38036",6553,4604,4529,45,75,"VOX",4
38,"38010",4014,2726,2678,15,48,"VOX",2
38,"38017",28037,16236,16076,100,160,"VOX",11
38,"38019",13217,8168,8075,54,93,"VOX",12
38,"38044",2206,1317,1303,10,14,"VOX",0
38,"38050",2471,1616,1590,8,26,"VOX",5
38,"38018",4405,3053,3005,21,48,"VOX",3
38,"38014",1351,935,929,3,6,"VOX",1
38,"38027",5386,3685,3615,29,70,"VOX",2
38,"38005",5463,3443,3417,24,26,"VOX",2
38,"38012",2378,1620,1606,6,14,"VOX",1
38,"38001",20166,11307,11195,55,112,"VOX",11
38,"38051",7217,5147,5089,31,58,"VOX",4
38,"38037",12997,8126,7997,46,129,"VOX",18
38,"38030",1923,1309,1300,5,9,"VOX",2
38,"38032",13257,8969,8902,72,67,"VOX",13
38,"38026",32918,24984,24727,174,257,"VOX",40
38,"38016",1215,654,641,4,13,"VOX",0
38,"38029",1533,776,763,7,13,"VOX",0
38,"38006",39553,21159,20940,124,219,"VOX",28
38,"38041",6808,4869,4835,42,34,"VOX",8
38,"38035",9299,5558,5500,35,58,"VOX",13
38,"38025",6860,4836,4761,49,75,"VOX",13
38,"38022",18468,12230,12085,86,145,"VOX",10
38,"38043",18918,12883,12737,109,146,"VOX",18
38,"38021",1643,1014,1002,5,12,"VOX",0
38,"38038",162030,105122,104174,667,948,"VOX",251
38,"38020",15021,9813,9693,51,120,"VOX",6
38,"38003",1440,970,960,2,10,"VOX",0
38,"38052",1281,853,844,2,9,"VOX",0
38,"38040",4990,3061,3031,16,30,"VOX",3
38,"38013",2915,1865,1847,12,18,"VOX",2
38,"38901",1387,883,876,4,7,"VOX",0
38,"38033",3721,2552,2504,15,48,"VOX",2
38,"38023",121610,81337,80453,527,884,"VOX",137
38,"38009",4127,2842,2793,15,49,"VOX",5
38,"38048",3878,2664,2624,20,40,"VOX",0
49,"49076",325,253,250,2,3,"RECORTES CE",0
49,"49137",176,140,137,2,3,"RECORTES CE",0
49,"49121",372,269,265,4,4,"RECORTES CE",1
49,"49009",400,290,286,4,4,"RECORTES CE",1
49,"49227",316,259,255,4,4,"RECORTES CE",0
49,"49048",134,84,84,0,0,"RECORTES CE",0
49,"49129",861,626,617,10,9,"RECORTES CE",1
49,"49135",635,450,449,5,1,"RECORTES CE",1
49,"49086",119,98,97,1,1,"RECORTES CE",0
49,"49219",7519,5407,5331,58,76,"RECORTES CE",9
49,"49026",233,182,179,0,3,"RECORTES CE",0
49,"49267",91,75,74,1,1,"RECORTES CE",0
49,"49130",180,137,132,5,5,"RECORTES CE",1
49,"49041",440,315,307,1,8,"RECORTES CE",0
49,"49125",1400,977,957,10,20,"RECORTES CE",2
49,"49193",472,323,316,4,7,"RECORTES CE",0
49,"49165",60,59,58,2,1,"RECORTES CE",0
49,"49245",261,178,174,0,4,"RECORTES CE",0
49,"49020",294,226,223,5,3,"RECORTES CE",0
49,"49119",236,172,172,0,0,"RECORTES CE",0
49,"49188",115,92,91,1,1,"RECORTES CE",0
49,"49084",290,241,238,5,3,"RECORTES CE",0
49,"49206",854,611,595,6,16,"RECORTES CE",0
49,"49127",2369,1752,1731,22,21,"RECORTES CE",2
49,"49038",99,74,74,1,0,"RECORTES CE",0
49,"49003",904,631,624,4,7,"RECORTES CE",3
49,"49053",938,737,729,5,8,"RECORTES CE",1
49,"49168",90,73,73,2,0,"RECORTES CE",0
49,"49139",170,139,136,0,3,"RECORTES CE",0
49,"49120",74,53,51,0,2,"RECORTES CE",0
49,"49047",111,78,77,0,1,"RECORTES CE",1
49,"49151",627,473,467,4,6,"RECORTES CE",1
49,"49269",230,165,163,4,2,"RECORTES CE",0
49,"49064",521,343,339,2,4,"RECORTES CE",0
49,"49128",557,428,424,2,4,"RECORTES CE",0
49,"49258",115,96,95,2,1,"RECORTES CE",0
49,"49275",52483,38405,37981,427,424,"RECORTES CE",70
49,"49186",263,189,187,0,2,"RECORTES CE",0
49,"49133",306,218,217,1,1,"RECORTES CE",0
49,"49187",1251,956,946,8,10,"RECORTES CE",0
49,"49043",300,226,225,2,1,"RECORTES CE",3
49,"49136",324,228,222,4,6,"RECORTES CE",0
49,"49071",770,505,502,6,3,"RECORTES CE",0
49,"49247",454,301,296,3,5,"RECORTES CE",0
49,"49079",105,80,76,2,4,"RECORTES CE",0
49,"49083",52,43,41,1,2,"RECORTES CE",0
49,"49099",132,85,85,1,0,"RECORTES CE",0
49,"49126",236,158,157,4,1,"RECORTES CE",0
49,"49220",146,116,114,1,2,"RECORTES CE",0
49,"49007",371,267,254,6,13,"RECORTES CE",2
49,"49027",150,116,116,5,0,"RECORTES CE",0
49,"49263",54,41,41,0,0,"RECORTES CE",0
49,"49034",446,337,333,3,4,"RECORTES CE",1
49,"49021",14387,10353,10196,117,157,"RECORTES CE",19
49,"49022",287,230,226,3,4,"RECORTES CE",1
49,"49016",256,185,179,2,6,"RECORTES CE",0
49,"49169",35,29,29,0,0,"RECORTES CE",0
49,"49123",547,414,410,0,4,"RECORTES CE",0
49,"49268",416,307,305,5,2,"RECORTES CE",0
49,"49175",234,183,182,2,1,"RECORTES CE",0
49,"49028",122,103,102,1,1,"RECORTES CE",0
49,"49055",104,85,85,2,0,"RECORTES CE",1
49,"49124",254,179,176,2,3,"RECORTES CE",0
49,"49069",384,243,242,6,1,"RECORTES CE",0
49,"49167",205,147,144,0,3,"RECORTES CE",0
49,"49183",101,80,80,4,0,"RECORTES CE",0
49,"49018",331,252,245,1,7,"RECORTES CE",0
49,"49012",72,47,47,1,0,"RECORTES CE",0
49,"49154",131,79,78,0,1,"RECORTES CE",0
49,"49153",172,124,123,1,1,"RECORTES CE",0
49,"49208",395,255,250,1,5,"RECORTES CE",0
49,"49033",728,530,528,4,2,"RECORTES CE",0
49,"49226",253,203,200,1,3,"RECORTES CE",0
49,"49251",166,126,119,0,7,"RECORTES CE",0
49,"49260",774,597,593,12,4,"RECORTES CE",0
49,"49006",154,116,112,0,4,"RECORTES CE",0
49,"49142",247,182,180,5,2,"RECORTES CE",0
49,"49235",450,330,321,5,9,"RECORTES CE",1
49,"49092",132,92,91,1,1,"RECORTES CE",0
49,"49255",426,330,327,4,3,"RECORTES CE",0
49,"49257",279,187,184,1,3,"RECORTES CE",3
49,"49225",153,95,92,2,3,"RECORTES CE",0
49,"49265",128,91,91,1,0,"RECORTES CE",1
49,"49248",188,145,144,0,1,"RECORTES CE",0
49,"49262",392,268,266,1,2,"RECORTES CE",0
49,"49143",225,161,157,2,4,"RECORTES CE",0
49,"49197",180,127,123,2,4,"RECORTES CE",0
49,"49210",478,365,358,4,7,"RECORTES CE",0
49,"49035",236,205,200,0,5,"RECORTES CE",0
49,"49232",97,74,73,0,1,"RECORTES CE",0
49,"49118",206,167,167,0,0,"RECORTES CE",0
49,"49233",95,60,57,0,3,"RECORTES CE",0
49,"49096",175,134,127,1,7,"RECORTES CE",0
49,"49239",673,488,476,6,12,"RECORTES CE",1
49,"49250",1254,974,952,11,22,"RECORTES CE",1
49,"49107",131,98,97,2,1,"RECORTES CE",0
49,"49131",269,186,181,1,5,"RECORTES CE",1
49,"49199",259,203,200,1,3,"RECORTES CE",1
49,"49040",117,99,99,1,0,"RECORTES CE",0
49,"49032",326,251,250,0,1,"RECORTES CE",0
49,"49184",179,117,114,1,3,"RECORTES CE",0
49,"49179",393,265,263,0,2,"RECORTES CE",0
49,"49141",348,251,249,3,2,"RECORTES CE",0
49,"49256",256,207,206,2,1,"RECORTES CE",0
49,"49085",1033,708,701,0,7,"RECORTES CE",1
49,"49097",90,47,47,0,0,"RECORTES CE",0
49,"49259",93,70,63,0,7,"RECORTES CE",0
49,"49095",297,233,231,1,2,"RECORTES CE",0
49,"49082",364,306,304,6,2,"RECORTES CE",0
49,"49172",536,347,341,1,6,"RECORTES CE",0
49,"49013",254,172,168,4,4,"RECORTES CE",0
49,"49261",1546,1171,1154,9,17,"RECORTES CE",1
49,"49243",111,97,95,0,2,"RECORTES CE",0
49,"49164",158,120,118,1,2,"RECORTES CE",0
49,"49108",476,359,352,4,7,"RECORTES CE",3
49,"49104",353,224,223,0,1,"RECORTES CE",0
49,"49100",303,216,215,1,1,"RECORTES CE",0
49,"49117",458,336,328,3,8,"RECORTES CE",1
49,"49066",498,336,328,4,8,"RECORTES CE",0
49,"49132",327,242,236,0,6,"RECORTES CE",0
49,"49241",256,190,186,0,4,"RECORTES CE",0
49,"49105",155,121,121,0,0,"RECORTES CE",0
49,"49149",392,275,271,3,4,"RECORTES CE",0
49,"49244",45,28,28,0,0,"RECORTES CE",0
49,"49011",230,183,180,7,3,"RECORTES CE",0
49,"49015",233,189,188,1,1,"RECORTES CE",0
49,"49148",249,143,141,0,2,"RECORTES CE",0
49,"49067",372,258,256,3,2,"RECORTES CE",0
49,"49122",773,578,569,7,9,"RECORTES CE",0
49,"49019",246,187,181,5,6,"RECORTES CE",0
49,"49110",366,215,215,5,0,"RECORTES CE",0
49,"49101",153,106,101,3,5,"RECORTES CE",0
49,"49087",523,322,319,0,3,"RECORTES CE",0
49,"49037",185,156,156,0,0,"RECORTES CE",0
49,"49185",162,125,121,0,4,"RECORTES CE",0
49,"49176",681,446,444,2,2,"RECORTES CE",0
49,"49111",130,96,96,6,0,"RECORTES CE",0
49,"49221",258,142,135,1,7,"RECORTES CE",1
49,"49004",128,92,88,2,4,"RECORTES CE",0
49,"49036",521,375,371,3,4,"RECORTES CE",0
49,"49008",468,346,342,6,4,"RECORTES CE",0
49,"49024",667,464,457,7,7,"RECORTES CE",1
49,"49044",85,56,55,0,1,"RECORTES CE",0
49,"49090",194,148,147,1,1,"RECORTES CE",1
49,"49207",237,156,155,0,1,"RECORTES CE",0
49,"49050",513,349,348,3,1,"RECORTES CE",1
49,"49109",626,491,490,4,1,"RECORTES CE",1
49,"49080",692,523,518,6,5,"RECORTES CE",0
49,"49170",104,70,68,1,2,"RECORTES CE",0
49,"49150",145,109,104,2,5,"RECORTES CE",0
49,"49242",455,373,365,8,8,"RECORTES CE",2
49,"49091",269,202,202,0,0,"RECORTES CE",0
49,"49042",244,199,195,2,4,"RECORTES CE",0
49,"49078",174,143,143,0,0,"RECORTES CE",0
49,"49222",387,294,289,7,5,"RECORTES CE",0
49,"49231",330,216,212,1,4,"RECORTES CE",0
49,"49113",172,144,142,1,2,"RECORTES CE",0
49,"49014",112,83,82,1,1,"RECORTES CE",0
49,"49002",64,48,48,1,0,"RECORTES CE",0
49,"49178",699,503,487,4,16,"RECORTES CE",2
49,"49171",648,507,500,5,7,"RECORTES CE",0
49,"49230",103,82,81,1,1,"RECORTES CE",0
49,"49229",130,98,97,1,1,"RECORTES CE",0
49,"49205",382,296,294,8,2,"RECORTES CE",0
49,"49270",138,100,99,0,1,"RECORTES CE",0
49,"49075",140,109,106,1,3,"RECORTES CE",0
49,"49152",532,346,344,9,2,"RECORTES CE",0
49,"49236",76,54,53,0,1,"RECORTES CE",0
49,"49031",145,115,113,0,2,"RECORTES CE",0
49,"49023",977,702,697,9,5,"RECORTES CE",1
49,"49138",231,164,163,1,1,"RECORTES CE",0
49,"49114",44,31,30,0,1,"RECORTES CE",0
49,"49029",623,494,482,4,12,"RECORTES CE",3
49,"49192",134,114,114,2,0,"RECORTES CE",0
49,"49163",230,166,160,1,6,"RECORTES CE",0
49,"49061",150,113,113,1,0,"RECORTES CE",1
49,"49115",185,140,139,4,1,"RECORTES CE",0
49,"49249",68,60,59,1,1,"RECORTES CE",0
49,"49166",1225,945,934,11,11,"RECORTES CE",4
49,"49264",592,395,391,4,4,"RECORTES CE",2
49,"49214",707,529,523,7,6,"RECORTES CE",2
49,"49088",92,70,70,0,0,"RECORTES CE",0
49,"49057",106,77,76,0,1,"RECORTES CE",0
49,"49052",191,144,139,1,5,"RECORTES CE",0
49,"49246",233,190,185,1,5,"RECORTES CE",0
49,"49223",766,628,616,5,12,"RECORTES CE",0
49,"49201",306,250,248,4,2,"RECORTES CE",0
49,"49216",162,138,137,0,1,"RECORTES CE",1
49,"49203",319,245,236,1,9,"RECORTES CE",0
49,"49046",272,209,206,3,3,"RECORTES CE",1
49,"49056",295,220,211,4,9,"RECORTES CE",0
49,"49228",56,43,41,0,2,"RECORTES CE",0
49,"49062",121,82,81,1,1,"RECORTES CE",0
49,"49273",189,120,118,0,2,"RECORTES CE",0
49,"49103",412,333,330,4,3,"RECORTES CE",0
49,"49146",296,232,228,2,4,"RECORTES CE",0
49,"49155",83,64,63,1,1,"RECORTES CE",0
49,"49030",84,69,67,1,2,"RECORTES CE",0
49,"49102",198,148,145,1,3,"RECORTES CE",1
49,"49181",369,274,274,2,0,"RECORTES CE",0
49,"49177",284,190,189,1,1,"RECORTES CE",0
49,"49266",75,60,60,0,0,"RECORTES CE",0
49,"49025",174,128,126,0,2,"RECORTES CE",0
49,"49252",326,260,255,7,5,"RECORTES CE",0
49,"49189",202,130,130,5,0,"RECORTES CE",0
49,"49039",333,259,252,1,7,"RECORTES CE",1
49,"49010",346,285,282,3,3,"RECORTES CE",1
49,"49147",267,190,189,2,1,"RECORTES CE",0
49,"49134",187,115,110,0,5,"RECORTES CE",0
49,"49068",472,292,289,2,3,"RECORTES CE",0
49,"49202",190,138,136,2,2,"RECORTES CE",1
49,"49158",215,164,161,3,3,"RECORTES CE",0
49,"49157",214,167,162,1,5,"RECORTES CE",0
49,"49054",908,668,651,13,17,"RECORTES CE",0
49,"49094",243,149,149,1,0,"RECORTES CE",0
49,"49162",192,140,138,1,2,"RECORTES CE",0
49,"49098",222,167,166,2,1,"RECORTES CE",0
49,"49065",1121,850,835,8,15,"RECORTES CE",0
49,"49234",410,336,334,1,2,"RECORTES CE",0
49,"49159",276,220,216,2,4,"RECORTES CE",0
49,"49191",272,215,213,1,2,"RECORTES CE",0
49,"49238",258,202,201,0,1,"RECORTES CE",2
49,"49180",156,101,101,0,0,"RECORTES CE",0
49,"49200",950,737,719,9,18,"RECORTES CE",0
49,"49209",510,347,345,5,2,"RECORTES CE",0
49,"49116",389,272,266,4,6,"RECORTES CE",1
49,"49237",170,120,120,3,0,"RECORTES CE",0
49,"49173",379,229,227,5,2,"RECORTES CE",0
49,"49190",64,49,49,0,0,"RECORTES CE",0
49,"49174",130,95,94,2,1,"RECORTES CE",0
49,"49204",64,45,44,0,1,"RECORTES CE",0
49,"49271",204,154,154,3,0,"RECORTES CE",0
49,"49160",48,36,32,0,4,"RECORTES CE",0
49,"49058",316,252,250,0,2,"RECORTES CE",2
49,"49224",160,109,106,4,3,"RECORTES CE",0
49,"49156",237,185,183,2,2,"RECORTES CE",0
49,"49063",341,274,274,2,0,"RECORTES CE",2
49,"49145",235,145,137,2,8,"RECORTES CE",0
49,"49194",377,229,228,2,1,"RECORTES CE",2
49,"49059",93,61,61,0,0,"RECORTES CE",0
49,"49005",142,93,93,0,0,"RECORTES CE",0
49,"49081",1365,1071,1057,7,14,"RECORTES CE",2
49,"49112",128,85,85,1,0,"RECORTES CE",0
49,"49240",218,168,159,3,9,"RECORTES CE",0
49,"49077",189,115,115,0,0,"RECORTES CE",0
49,"49017",251,169,169,2,0,"RECORTES CE",1
49,"49093",287,233,231,2,2,"RECORTES CE",0
49,"49272",88,73,73,1,0,"RECORTES CE",0
21,"21058",2602,1904,1886,8,18,"DN",1
21,"21021",12233,7551,7470,94,81,"DN",5
21,"21046",1703,1200,1173,15,27,"DN",0
21,"21001",648,479,469,4,10,"DN",0
21,"21025",4049,2682,2653,25,29,"DN",1
21,"21003",695,533,525,1,8,"DN",0
21,"21036",192,138,138,1,0,"DN",0
21,"21050",12448,8431,8382,86,49,"DN",9
21,"21048",305,220,220,3,0,"DN",0
21,"21031",1209,845,828,3,17,"DN",1
21,"21006",3402,2398,2359,13,39,"DN",3
21,"21035",9622,6399,6313,69,86,"DN",4
21,"21016",1034,777,764,2,13,"DN",0
21,"21014",4041,3203,3170,15,33,"DN",1
21,"21047",1914,1213,1179,19,34,"DN",0
21,"21059",220,167,165,3,2,"DN",0
21,"21051",245,176,173,1,3,"DN",0
21,"21069",1715,1186,1175,7,11,"DN",1
21,"21026",270,184,178,1,6,"DN",0
21,"21073",1871,1134,1120,12,14,"DN",0
21,"21060",11959,7565,7488,103,77,"DN",7
21,"21019",590,433,423,4,10,"DN",0
21,"21007",6231,4285,4227,45,58,"DN",1
21,"21034",1207,848,838,8,10,"DN",1
21,"21053",3316,2257,2219,25,38,"DN",3
21,"21040",3158,2386,2345,15,41,"DN",2
21,"21027",49,36,36,1,0,"DN",0
21,"21071",204,160,158,2,2,"DN",0
21,"21028",381,290,287,0,3,"DN",1
21,"21063",2614,2044,2034,12,10,"DN",1
21,"21049",3372,2162,2108,15,54,"DN",2
21,"21038",1082,732,719,8,13,"DN",0
21,"21015",683,425,420,6,5,"DN",0
21,"21013",10597,7220,7061,69,159,"DN",8
21,"21068",998,606,605,14,1,"DN",0
21,"21041",113604,74902,74244,718,658,"DN",94
21,"21061",5092,3471,3429,32,42,"DN",0
21,"21065",287,202,196,0,6,"DN",0
21,"21039",308,223,222,2,1,"DN",0
21,"21032",1805,1378,1359,15,19,"DN",0
21,"21017",3643,2301,2269,17,32,"DN",1
21,"21042",15349,7802,7708,106,94,"DN",3
21,"21010",14684,8766,8698,92,68,"DN",5
21,"21043",1858,1356,1341,13,15,"DN",0
21,"21076",2123,1549,1532,13,17,"DN",0
21,"21029",1564,1166,1126,16,40,"DN",0
21,"21033",536,399,395,0,4,"DN",0
21,"21066",507,408,405,1,3,"DN",0
21,"21018",1780,1152,1131,10,21,"DN",1
21,"21055",6914,5286,5218,34,68,"DN",2
21,"21077",1722,1261,1246,5,15,"DN",0
21,"21062",1395,936,926,9,10,"DN",0
21,"21022",174,115,109,1,6,"DN",0
21,"21011",3464,2536,2518,19,18,"DN",0
21,"21072",10280,7869,7777,76,92,"DN",3
21,"21074",2660,1869,1844,18,25,"DN",0
21,"21044",17552,10820,10692,106,128,"DN",7
21,"21052",4618,2837,2773,20,64,"DN",1
21,"21070",6296,4450,4397,38,53,"DN",3
21,"21037",472,364,360,2,4,"DN",1
21,"21030",1824,1491,1472,11,19,"DN",0
21,"21004",1641,1070,1047,10,23,"DN",0
21,"21056",2912,2115,2024,20,91,"DN",1
21,"21008",2662,1847,1831,14,16,"DN",1
21,"21045",253,192,190,0,2,"DN",0
21,"21064",6526,4544,4492,51,52,"DN",3
21,"21067",415,309,303,0,6,"DN",0
21,"21078",2763,1928,1907,12,21,"DN",0
21,"21023",2147,1379,1357,6,22,"DN",1
21,"21012",322,234,227,0,7,"DN",0
21,"21009",860,571,555,6,16,"DN",0
21,"21075",351,270,266,2,4,"DN",0
21,"21005",15486,10310,10189,64,121,"DN",3
21,"21020",372,241,238,2,3,"DN",0
21,"21024",495,350,344,5,6,"DN",0
21,"21079",731,526,522,3,4,"DN",0
21,"21054",8105,6025,5919,41,106,"DN",5
21,"21057",1045,641,640,8,1,"DN",0
21,"21002",15348,10939,10864,80,75,"DN",5
49,"49173",379,229,227,5,2,"UPYD",0
49,"49167",205,147,144,0,3,"UPYD",1
49,"49104",353,224,223,0,1,"UPYD",0
49,"49266",75,60,60,0,0,"UPYD",1
49,"49097",90,47,47,0,0,"UPYD",0
49,"49247",454,301,296,3,5,"UPYD",3
49,"49077",189,115,115,0,0,"UPYD",0
49,"49107",131,98,97,2,1,"UPYD",0
49,"49197",180,127,123,2,4,"UPYD",0
49,"49055",104,85,85,2,0,"UPYD",1
49,"49046",272,209,206,3,3,"UPYD",1
49,"49094",243,149,149,1,0,"UPYD",1
49,"49172",536,347,341,1,6,"UPYD",1
49,"49061",150,113,113,1,0,"UPYD",1
49,"49149",392,275,271,3,4,"UPYD",2
49,"49205",382,296,294,8,2,"UPYD",1
49,"49113",172,144,142,1,2,"UPYD",0
49,"49257",279,187,184,1,3,"UPYD",0
49,"49246",233,190,185,1,5,"UPYD",1
49,"49275",52483,38405,37981,427,424,"UPYD",337
49,"49029",623,494,482,4,12,"UPYD",5
49,"49109",626,491,490,4,1,"UPYD",0
49,"49016",256,185,179,2,6,"UPYD",2
49,"49154",131,79,78,0,1,"UPYD",0
49,"49098",222,167,166,2,1,"UPYD",0
49,"49262",392,268,266,1,2,"UPYD",2
49,"49030",84,69,67,1,2,"UPYD",0
49,"49250",1254,974,952,11,22,"UPYD",4
49,"49003",904,631,624,4,7,"UPYD",1
49,"49224",160,109,106,4,3,"UPYD",1
49,"49002",64,48,48,1,0,"UPYD",2
49,"49018",331,252,245,1,7,"UPYD",1
49,"49028",122,103,102,1,1,"UPYD",0
49,"49038",99,74,74,1,0,"UPYD",1
49,"49004",128,92,88,2,4,"UPYD",0
49,"49179",393,265,263,0,2,"UPYD",2
49,"49056",295,220,211,4,9,"UPYD",0
49,"49047",111,78,77,0,1,"UPYD",3
49,"49037",185,156,156,0,0,"UPYD",0
49,"49041",440,315,307,1,8,"UPYD",0
49,"49177",284,190,189,1,1,"UPYD",0
49,"49010",346,285,282,3,3,"UPYD",3
49,"49263",54,41,41,0,0,"UPYD",0
49,"49032",326,251,250,0,1,"UPYD",0
49,"49006",154,116,112,0,4,"UPYD",1
49,"49185",162,125,121,0,4,"UPYD",0
49,"49127",2369,1752,1731,22,21,"UPYD",10
49,"49269",230,165,163,4,2,"UPYD",0
49,"49222",387,294,289,7,5,"UPYD",1
49,"49044",85,56,55,0,1,"UPYD",0
49,"49020",294,226,223,5,3,"UPYD",5
49,"49175",234,183,182,2,1,"UPYD",0
49,"49209",510,347,345,5,2,"UPYD",0
49,"49264",592,395,391,4,4,"UPYD",2
49,"49220",146,116,114,1,2,"UPYD",0
49,"49042",244,199,195,2,4,"UPYD",0
49,"49169",35,29,29,0,0,"UPYD",1
49,"49040",117,99,99,1,0,"UPYD",0
49,"49022",287,230,226,3,4,"UPYD",0
49,"49226",253,203,200,1,3,"UPYD",1
49,"49194",377,229,228,2,1,"UPYD",10
49,"49087",523,322,319,0,3,"UPYD",0
49,"49075",140,109,106,1,3,"UPYD",0
49,"49013",254,172,168,4,4,"UPYD",0
49,"49192",134,114,114,2,0,"UPYD",1
49,"49249",68,60,59,1,1,"UPYD",0
49,"49231",330,216,212,1,4,"UPYD",4
49,"49199",259,203,200,1,3,"UPYD",2
49,"49130",180,137,132,5,5,"UPYD",0
49,"49148",249,143,141,0,2,"UPYD",1
49,"49258",115,96,95,2,1,"UPYD",1
49,"49117",458,336,328,3,8,"UPYD",0
49,"49219",7519,5407,5331,58,76,"UPYD",34
49,"49214",707,529,523,7,6,"UPYD",3
49,"49184",179,117,114,1,3,"UPYD",0
49,"49119",236,172,172,0,0,"UPYD",0
49,"49036",521,375,371,3,4,"UPYD",2
49,"49133",306,218,217,1,1,"UPYD",0
49,"49180",156,101,101,0,0,"UPYD",0
49,"49241",256,190,186,0,4,"UPYD",0
49,"49223",766,628,616,5,12,"UPYD",3
49,"49203",319,245,236,1,9,"UPYD",0
49,"49009",400,290,286,4,4,"UPYD",0
49,"49157",214,167,162,1,5,"UPYD",0
49,"49007",371,267,254,6,13,"UPYD",0
49,"49015",233,189,188,1,1,"UPYD",1
49,"49065",1121,850,835,8,15,"UPYD",5
49,"49078",174,143,143,0,0,"UPYD",2
49,"49159",276,220,216,2,4,"UPYD",3
49,"49017",251,169,169,2,0,"UPYD",2
49,"49131",269,186,181,1,5,"UPYD",1
49,"49158",215,164,161,3,3,"UPYD",0
49,"49085",1033,708,701,0,7,"UPYD",2
49,"49268",416,307,305,5,2,"UPYD",0
49,"49014",112,83,82,1,1,"UPYD",0
49,"49236",76,54,53,0,1,"UPYD",0
49,"49096",175,134,127,1,7,"UPYD",0
49,"49033",728,530,528,4,2,"UPYD",1
49,"49201",306,250,248,4,2,"UPYD",2
49,"49142",247,182,180,5,2,"UPYD",1
49,"49186",263,189,187,0,2,"UPYD",0
49,"49233",95,60,57,0,3,"UPYD",0
49,"49063",341,274,274,2,0,"UPYD",3
49,"49234",410,336,334,1,2,"UPYD",2
49,"49120",74,53,51,0,2,"UPYD",0
49,"49066",498,336,328,4,8,"UPYD",0
49,"49151",627,473,467,4,6,"UPYD",3
49,"49064",521,343,339,2,4,"UPYD",2
49,"49139",170,139,136,0,3,"UPYD",0
49,"49206",854,611,595,6,16,"UPYD",4
49,"49156",237,185,183,2,2,"UPYD",2
49,"49162",192,140,138,1,2,"UPYD",0
49,"49174",130,95,94,2,1,"UPYD",0
49,"49271",204,154,154,3,0,"UPYD",1
49,"49112",128,85,85,1,0,"UPYD",0
49,"49221",258,142,135,1,7,"UPYD",1
49,"49111",130,96,96,6,0,"UPYD",0
49,"49166",1225,945,934,11,11,"UPYD",11
49,"49245",261,178,174,0,4,"UPYD",2
49,"49153",172,124,123,1,1,"UPYD",0
49,"49069",384,243,242,6,1,"UPYD",1
49,"49204",64,45,44,0,1,"UPYD",0
49,"49125",1400,977,957,10,20,"UPYD",4
49,"49259",93,70,63,0,7,"UPYD",0
49,"49208",395,255,250,1,5,"UPYD",1
49,"49193",472,323,316,4,7,"UPYD",6
49,"49086",119,98,97,1,1,"UPYD",0
49,"49092",132,92,91,1,1,"UPYD",0
49,"49176",681,446,444,2,2,"UPYD",0
49,"49025",174,128,126,0,2,"UPYD",2
49,"49141",348,251,249,3,2,"UPYD",3
49,"49057",106,77,76,0,1,"UPYD",0
49,"49090",194,148,147,1,1,"UPYD",0
49,"49227",316,259,255,4,4,"UPYD",1
49,"49088",92,70,70,0,0,"UPYD",0
49,"49143",225,161,157,2,4,"UPYD",1
49,"49190",64,49,49,0,0,"UPYD",0
49,"49100",303,216,215,1,1,"UPYD",0
49,"49235",450,330,321,5,9,"UPYD",0
49,"49026",233,182,179,0,3,"UPYD",0
49,"49255",426,330,327,4,3,"UPYD",4
49,"49059",93,61,61,0,0,"UPYD",4
49,"49115",185,140,139,4,1,"UPYD",0
49,"49237",170,120,120,3,0,"UPYD",0
49,"49039",333,259,252,1,7,"UPYD",0
49,"49265",128,91,91,1,0,"UPYD",2
49,"49011",230,183,180,7,3,"UPYD",1
49,"49008",468,346,342,6,4,"UPYD",1
49,"49082",364,306,304,6,2,"UPYD",0
49,"49170",104,70,68,1,2,"UPYD",0
49,"49043",300,226,225,2,1,"UPYD",3
49,"49101",153,106,101,3,5,"UPYD",1
49,"49191",272,215,213,1,2,"UPYD",0
49,"49260",774,597,593,12,4,"UPYD",1
49,"49188",115,92,91,1,1,"UPYD",1
49,"49116",389,272,266,4,6,"UPYD",1
49,"49136",324,228,222,4,6,"UPYD",1
49,"49145",235,145,137,2,8,"UPYD",0
49,"49225",153,95,92,2,3,"UPYD",1
49,"49012",72,47,47,1,0,"UPYD",0
49,"49108",476,359,352,4,7,"UPYD",1
49,"49080",692,523,518,6,5,"UPYD",2
49,"49243",111,97,95,0,2,"UPYD",1
49,"49053",938,737,729,5,8,"UPYD",5
49,"49052",191,144,139,1,5,"UPYD",1
49,"49171",648,507,500,5,7,"UPYD",2
49,"49034",446,337,333,3,4,"UPYD",1
49,"49202",190,138,136,2,2,"UPYD",0
49,"49093",287,233,231,2,2,"UPYD",0
49,"49183",101,80,80,4,0,"UPYD",1
49,"49200",950,737,719,9,18,"UPYD",5
49,"49147",267,190,189,2,1,"UPYD",1
49,"49216",162,138,137,0,1,"UPYD",0
49,"49048",134,84,84,0,0,"UPYD",1
49,"49137",176,140,137,2,3,"UPYD",4
49,"49244",45,28,28,0,0,"UPYD",1
49,"49027",150,116,116,5,0,"UPYD",0
49,"49121",372,269,265,4,4,"UPYD",2
49,"49129",861,626,617,10,9,"UPYD",2
49,"49118",206,167,167,0,0,"UPYD",3
49,"49256",256,207,206,2,1,"UPYD",1
49,"49114",44,31,30,0,1,"UPYD",2
49,"49081",1365,1071,1057,7,14,"UPYD",4
49,"49229",130,98,97,1,1,"UPYD",2
49,"49232",97,74,73,0,1,"UPYD",4
49,"49126",236,158,157,4,1,"UPYD",0
49,"49123",547,414,410,0,4,"UPYD",3
49,"49023",977,702,697,9,5,"UPYD",0
49,"49155",83,64,63,1,1,"UPYD",0
49,"49261",1546,1171,1154,9,17,"UPYD",6
49,"49067",372,258,256,3,2,"UPYD",0
49,"49068",472,292,289,2,3,"UPYD",0
49,"49242",455,373,365,8,8,"UPYD",3
49,"49270",138,100,99,0,1,"UPYD",0
49,"49079",105,80,76,2,4,"UPYD",1
49,"49050",513,349,348,3,1,"UPYD",1
49,"49132",327,242,236,0,6,"UPYD",4
49,"49084",290,241,238,5,3,"UPYD",1
49,"49024",667,464,457,7,7,"UPYD",1
49,"49273",189,120,118,0,2,"UPYD",1
49,"49091",269,202,202,0,0,"UPYD",0
49,"49058",316,252,250,0,2,"UPYD",3
49,"49152",532,346,344,9,2,"UPYD",1
49,"49071",770,505,502,6,3,"UPYD",3
49,"49163",230,166,160,1,6,"UPYD",3
49,"49076",325,253,250,2,3,"UPYD",2
49,"49031",145,115,113,0,2,"UPYD",0
49,"49021",14387,10353,10196,117,157,"UPYD",52
49,"49122",773,578,569,7,9,"UPYD",8
49,"49110",366,215,215,5,0,"UPYD",3
49,"49168",90,73,73,2,0,"UPYD",1
49,"49128",557,428,424,2,4,"UPYD",5
49,"49267",91,75,74,1,1,"UPYD",0
49,"49083",52,43,41,1,2,"UPYD",0
49,"49239",673,488,476,6,12,"UPYD",0
49,"49181",369,274,274,2,0,"UPYD",0
49,"49248",188,145,144,0,1,"UPYD",0
49,"49189",202,130,130,5,0,"UPYD",0
49,"49054",908,668,651,13,17,"UPYD",0
49,"49187",1251,956,946,8,10,"UPYD",4
49,"49210",478,365,358,4,7,"UPYD",2
49,"49178",699,503,487,4,16,"UPYD",3
49,"49124",254,179,176,2,3,"UPYD",1
49,"49240",218,168,159,3,9,"UPYD",2
49,"49228",56,43,41,0,2,"UPYD",0
49,"49099",132,85,85,1,0,"UPYD",0
49,"49135",635,450,449,5,1,"UPYD",3
49,"49160",48,36,32,0,4,"UPYD",1
49,"49164",158,120,118,1,2,"UPYD",0
49,"49207",237,156,155,0,1,"UPYD",2
49,"49165",60,59,58,2,1,"UPYD",0
49,"49272",88,73,73,1,0,"UPYD",2
49,"49095",297,233,231,1,2,"UPYD",1
49,"49062",121,82,81,1,1,"UPYD",0
49,"49150",145,109,104,2,5,"UPYD",0
49,"49103",412,333,330,4,3,"UPYD",2
49,"49138",231,164,163,1,1,"UPYD",0
49,"49102",198,148,145,1,3,"UPYD",5
49,"49105",155,121,121,0,0,"UPYD",2
49,"49005",142,93,93,0,0,"UPYD",1
49,"49252",326,260,255,7,5,"UPYD",3
49,"49251",166,126,119,0,7,"UPYD",0
49,"49146",296,232,228,2,4,"UPYD",0
49,"49035",236,205,200,0,5,"UPYD",1
49,"49230",103,82,81,1,1,"UPYD",2
49,"49134",187,115,110,0,5,"UPYD",0
49,"49019",246,187,181,5,6,"UPYD",0
49,"49238",258,202,201,0,1,"UPYD",0
18,"18028",945,790,781,2,9,"VOX",0
18,"18187",561,418,417,1,1,"VOX",0
18,"18901",512,359,357,1,2,"VOX",0
18,"18103",760,596,593,6,3,"VOX",1
18,"18152",938,687,681,1,6,"VOX",0
18,"18168",809,589,588,5,1,"VOX",1
18,"18033",294,220,219,1,1,"VOX",0
18,"18063",1191,770,767,6,3,"VOX",3
18,"18074",273,217,213,2,4,"VOX",0
18,"18082",867,626,621,4,5,"VOX",3
18,"18064",379,308,308,1,0,"VOX",0
18,"18068",1566,1234,1214,5,20,"VOX",5
18,"18904",779,570,565,1,5,"VOX",0
18,"18046",1867,1225,1215,8,10,"VOX",1
18,"18100",7769,5715,5637,57,78,"VOX",8
18,"18134",5811,4002,3946,25,56,"VOX",11
18,"18164",1831,1273,1260,11,13,"VOX",2
18,"18173",8978,6319,6251,50,68,"VOX",5
18,"18037",530,411,408,1,3,"VOX",1
18,"18906",917,681,673,2,8,"VOX",1
18,"18099",1581,1271,1249,10,22,"VOX",2
18,"18165",4135,2944,2915,23,29,"VOX",2
18,"18183",660,468,465,3,3,"VOX",0
18,"18914",1658,1304,1290,8,14,"VOX",0
18,"18089",15132,10489,10402,64,87,"VOX",18
18,"18128",344,251,248,0,3,"VOX",0
18,"18119",1729,1353,1340,13,13,"VOX",1
18,"18017",18172,12077,11954,101,123,"VOX",18
18,"18102",8424,5783,5716,41,67,"VOX",3
18,"18153",8580,6314,6260,39,54,"VOX",14
18,"18905",14500,10137,10058,82,79,"VOX",18
18,"18154",1016,716,716,2,0,"VOX",0
18,"18059",4153,3074,3039,23,35,"VOX",4
18,"18096",342,260,259,1,1,"VOX",0
18,"18105",4548,3169,3139,19,30,"VOX",4
18,"18101",9263,6971,6912,55,59,"VOX",18
18,"18149",5177,3946,3902,29,44,"VOX",17
18,"18023",15738,11242,11146,92,96,"VOX",14
18,"18011",4321,3136,3119,10,17,"VOX",11
18,"18097",956,703,691,1,12,"VOX",0
18,"18912",1488,1021,1007,7,14,"VOX",1
18,"18083",266,210,207,1,3,"VOX",0
18,"18178",743,571,571,2,0,"VOX",0
18,"18025",294,216,214,0,2,"VOX",0
18,"18018",640,490,488,0,2,"VOX",4
18,"18150",6730,4858,4814,28,44,"VOX",8
18,"18042",414,342,341,0,1,"VOX",0
18,"18910",803,573,569,5,4,"VOX",0
18,"18174",442,354,348,2,6,"VOX",0
18,"18095",1959,1486,1474,5,12,"VOX",3
18,"18185",556,461,461,1,0,"VOX",5
18,"18003",14022,10417,10330,82,87,"VOX",27
18,"18117",513,402,396,4,6,"VOX",1
18,"18177",427,259,258,3,1,"VOX",0
18,"18167",1897,1321,1313,8,8,"VOX",1
18,"18020",1469,1046,1032,7,14,"VOX",3
18,"18094",2389,1853,1832,22,21,"VOX",5
18,"18181",223,159,157,0,2,"VOX",0
18,"18045",1149,803,789,10,14,"VOX",0
18,"18056",3545,2716,2687,25,29,"VOX",3
18,"18054",868,630,627,2,3,"VOX",0
18,"18022",13306,9165,9091,51,74,"VOX",21
18,"18034",510,391,391,1,0,"VOX",4
18,"18062",10298,7584,7512,67,72,"VOX",17
18,"18050",1711,1271,1256,5,15,"VOX",2
18,"18004",724,511,505,3,6,"VOX",2
18,"18030",584,428,426,3,2,"VOX",1
18,"18014",6372,4620,4566,44,54,"VOX",12
18,"18065",625,503,500,1,3,"VOX",0
18,"18114",634,457,452,2,5,"VOX",0
18,"18085",729,489,484,2,5,"VOX",0
18,"18147",3734,2416,2386,10,30,"VOX",3
18,"18107",971,719,711,6,8,"VOX",1
18,"18192",1529,1216,1208,3,8,"VOX",0
18,"18184",2158,1659,1634,4,25,"VOX",3
18,"18087",184873,138280,137516,836,764,"VOX",587
18,"18002",561,446,444,1,2,"VOX",0
18,"18189",772,599,595,7,4,"VOX",0
18,"18124",393,274,271,1,3,"VOX",0
18,"18053",1667,1084,1078,9,6,"VOX",0
18,"18133",2187,1731,1722,7,9,"VOX",0
18,"18086",355,285,283,0,2,"VOX",0
18,"18044",179,116,116,0,0,"VOX",0
18,"18006",4161,2816,2788,29,28,"VOX",5
18,"18051",1149,825,823,7,2,"VOX",0
18,"18902",847,680,674,10,6,"VOX",2
18,"18013",4236,3108,3052,19,56,"VOX",3
18,"18908",805,633,620,2,13,"VOX",2
18,"18121",132,101,100,1,1,"VOX",0
18,"18021",17451,12420,12305,101,115,"VOX",25
18,"18007",785,527,523,3,4,"VOX",1
18,"18012",2330,1670,1660,15,10,"VOX",2
18,"18049",617,456,451,3,5,"VOX",0
18,"18040",225,142,141,0,1,"VOX",0
18,"18158",8408,5604,5542,38,62,"VOX",2
18,"18078",739,593,590,4,3,"VOX",0
18,"18088",1556,1113,1108,5,5,"VOX",0
18,"18132",3312,2582,2556,14,26,"VOX",1
18,"18116",2882,2245,2215,19,30,"VOX",2
18,"18032",239,178,175,0,3,"VOX",0
18,"18005",375,266,265,2,1,"VOX",2
18,"18010",563,463,459,4,4,"VOX",1
18,"18138",2482,1721,1712,8,9,"VOX",1
18,"18143",979,781,776,2,5,"VOX",2
18,"18194",2152,1487,1477,6,10,"VOX",0
18,"18122",16171,11670,11508,106,162,"VOX",6
18,"18098",6167,4367,4342,22,25,"VOX",7
18,"18144",782,596,588,3,8,"VOX",5
18,"18175",11624,8549,8467,41,82,"VOX",11
18,"18057",5263,3968,3937,33,31,"VOX",11
18,"18146",970,734,727,6,7,"VOX",1
18,"18043",129,95,95,0,0,"VOX",0
18,"18039",3544,2544,2511,34,33,"VOX",3
18,"18069",493,366,363,3,3,"VOX",0
18,"18157",1123,836,823,8,13,"VOX",2
18,"18070",283,223,218,0,5,"VOX",0
18,"18162",951,744,734,0,10,"VOX",0
18,"18015",443,338,337,0,1,"VOX",0
18,"18111",2743,2046,2033,14,13,"VOX",5
18,"18061",1059,822,816,1,6,"VOX",1
18,"18024",855,660,653,8,7,"VOX",0
18,"18109",599,421,419,2,2,"VOX",0
18,"18145",10432,7829,7767,56,62,"VOX",20
18,"18048",2390,1824,1806,8,18,"VOX",6
18,"18035",1255,964,958,4,6,"VOX",1
18,"18161",220,184,184,1,0,"VOX",2
18,"18001",256,178,177,2,1,"VOX",0
18,"18135",4583,3045,2998,14,47,"VOX",4
18,"18141",414,282,277,1,5,"VOX",1
18,"18163",324,239,235,1,4,"VOX",1
18,"18903",892,650,645,1,5,"VOX",0
18,"18029",1833,1252,1243,9,9,"VOX",0
18,"18140",43567,29155,28932,194,223,"VOX",42
18,"18067",711,517,516,0,1,"VOX",1
18,"18136",1875,1477,1470,7,7,"VOX",1
18,"18909",589,462,459,0,3,"VOX",0
18,"18079",3465,2671,2645,16,26,"VOX",0
18,"18127",16586,11998,11897,97,101,"VOX",33
18,"18038",1066,836,826,2,10,"VOX",0
18,"18076",815,577,576,0,1,"VOX",1
18,"18072",666,481,474,4,7,"VOX",1
18,"18027",2562,1846,1827,19,19,"VOX",1
18,"18188",1642,1249,1234,8,15,"VOX",0
18,"18148",819,671,666,1,5,"VOX",1
18,"18120",270,218,216,2,2,"VOX",0
18,"18047",5888,4028,4000,32,28,"VOX",8
18,"18170",336,227,225,1,2,"VOX",0
18,"18907",1859,1482,1475,5,7,"VOX",1
18,"18115",2548,1872,1854,16,18,"VOX",2
18,"18093",2752,1873,1858,10,15,"VOX",3
18,"18176",258,179,178,3,1,"VOX",0
18,"18137",1005,758,758,6,0,"VOX",1
18,"18126",1497,1094,1087,7,7,"VOX",4
18,"18036",3768,2904,2882,18,22,"VOX",7
18,"18084",4215,3179,3143,24,36,"VOX",18
18,"18180",631,448,447,2,1,"VOX",0
18,"18123",293,228,227,2,1,"VOX",0
18,"18071",5583,4221,4176,33,45,"VOX",12
18,"18151",260,196,196,0,0,"VOX",0
18,"18913",818,617,603,2,14,"VOX",1
18,"18193",14194,10280,10196,91,84,"VOX",28
18,"18182",1919,1356,1347,3,9,"VOX",13
18,"18016",323,239,237,0,2,"VOX",0
18,"18911",7392,5359,5301,44,58,"VOX",13
18,"18066",2108,1546,1540,4,6,"VOX",2
18,"18179",546,378,377,1,1,"VOX",0
18,"18112",131,88,86,1,2,"VOX",1
18,"18108",858,672,667,0,5,"VOX",1
18,"18159",1009,811,802,3,9,"VOX",0
18,"18171",2123,1640,1616,14,24,"VOX",1
4,"4066",13573,8651,8570,65,81,"PUM+J",5
4,"4043",546,466,462,3,4,"PUM+J",0
4,"4008",501,420,415,3,5,"PUM+J",0
4,"4046",862,658,656,6,2,"PUM+J",0
4,"4055",372,315,315,0,0,"PUM+J",0
4,"4009",169,127,126,0,1,"PUM+J",0
4,"4014",153,118,118,0,0,"PUM+J",0
4,"4065",366,290,288,2,2,"PUM+J",0
4,"4054",363,297,292,1,5,"PUM+J",0
4,"4011",2798,2244,2220,14,24,"PUM+J",0
4,"4080",226,185,182,2,3,"PUM+J",0
4,"4085",395,302,298,0,4,"PUM+J",1
4,"4044",1555,1253,1243,9,10,"PUM+J",0
4,"4094",209,141,141,1,0,"PUM+J",0
4,"4015",130,98,98,1,0,"PUM+J",0
4,"4064",2779,2032,2009,8,23,"PUM+J",1
4,"4057",1337,941,933,2,8,"PUM+J",0
4,"4074",2829,1965,1945,24,20,"PUM+J",1
4,"4027",249,163,163,1,0,"PUM+J",0
4,"4056",147,123,120,0,3,"PUM+J",0
4,"4086",1792,1271,1258,8,13,"PUM+J",0
4,"4089",746,536,528,6,8,"PUM+J",0
4,"4069",4692,3641,3607,29,34,"PUM+J",2
4,"4013",141116,95203,94625,669,578,"PUM+J",66
4,"4038",3066,2169,2150,20,19,"PUM+J",2
4,"4020",292,208,207,1,1,"PUM+J",0
4,"4076",1296,1005,993,7,12,"PUM+J",0
4,"4902",45373,28425,28220,249,205,"PUM+J",24
4,"4031",2359,1791,1786,7,5,"PUM+J",0
4,"4093",1872,1265,1252,10,13,"PUM+J",0
4,"4075",5152,3772,3715,19,57,"PUM+J",3
4,"4052",12246,8393,8353,84,40,"PUM+J",5
4,"4030",1140,828,826,8,2,"PUM+J",0
4,"4010",579,469,464,2,5,"PUM+J",0
4,"4059",1100,752,745,7,7,"PUM+J",0
4,"4033",139,100,97,3,3,"PUM+J",0
4,"4091",342,280,278,4,2,"PUM+J",0
4,"4103",1478,1051,1037,6,14,"PUM+J",1
4,"4023",139,104,102,1,2,"PUM+J",0
4,"4903",4345,2896,2875,35,21,"PUM+J",0
4,"4032",5606,3789,3770,19,19,"PUM+J",2
4,"4060",466,361,358,2,3,"PUM+J",0
4,"4047",2278,1906,1891,13,15,"PUM+J",0
4,"4067",584,432,424,0,8,"PUM+J",1
4,"4073",332,231,230,2,1,"PUM+J",0
4,"4097",254,196,194,0,2,"PUM+J",0
4,"4048",1503,1104,1096,7,8,"PUM+J",1
4,"4016",2146,1584,1564,8,20,"PUM+J",1
4,"4071",398,327,326,2,1,"PUM+J",0
4,"4095",726,466,463,2,3,"PUM+J",0
4,"4087",189,140,139,1,1,"PUM+J",0
4,"4017",1301,881,876,5,5,"PUM+J",0
4,"4002",1063,765,760,1,5,"PUM+J",0
4,"4058",369,292,291,2,1,"PUM+J",0
4,"4001",1083,812,796,6,16,"PUM+J",1
4,"4079",50800,33862,33629,200,233,"PUM+J",19
4,"4045",1777,1402,1392,9,10,"PUM+J",2
4,"4021",187,148,141,1,7,"PUM+J",0
4,"4901",539,388,386,0,2,"PUM+J",0
4,"4018",274,245,242,0,3,"PUM+J",0
4,"4012",191,170,169,1,1,"PUM+J",0
4,"4084",337,264,261,1,3,"PUM+J",0
4,"4102",13729,8987,8878,114,109,"PUM+J",5
4,"4088",2475,1717,1703,10,14,"PUM+J",0
4,"4050",830,597,594,3,3,"PUM+J",2
4,"4003",17365,10931,10830,57,101,"PUM+J",4
4,"4034",173,108,108,3,0,"PUM+J",0
4,"4022",348,243,242,1,1,"PUM+J",0
4,"4081",356,290,290,2,0,"PUM+J",0
4,"4051",440,373,372,0,1,"PUM+J",1
4,"4026",70,60,60,0,0,"PUM+J",0
4,"4019",251,199,198,0,1,"PUM+J",1
4,"4100",8712,5545,5482,30,63,"PUM+J",4
4,"4063",1099,847,835,2,12,"PUM+J",0
4,"4077",303,277,274,2,3,"PUM+J",0
4,"4062",4528,3610,3579,20,31,"PUM+J",0
4,"4049",5280,3658,3623,20,35,"PUM+J",2
4,"4028",226,198,197,0,1,"PUM+J",0
4,"4005",577,438,432,1,6,"PUM+J",0
4,"4035",8375,6079,6031,28,48,"PUM+J",1
4,"4036",228,176,175,2,1,"PUM+J",0
4,"4098",1537,1157,1147,8,10,"PUM+J",1
4,"4007",736,553,551,0,2,"PUM+J",0
4,"4004",421,314,312,2,2,"PUM+J",0
4,"4090",309,242,242,1,0,"PUM+J",0
4,"4061",618,495,491,5,4,"PUM+J",0
4,"4072",311,247,244,14,3,"PUM+J",0
4,"4078",1095,784,779,7,5,"PUM+J",1
4,"4904",1759,1185,1172,15,13,"PUM+J",0
4,"4024",3036,2325,2308,18,17,"PUM+J",0
4,"4101",4283,2969,2950,22,19,"PUM+J",1
4,"4092",2852,2192,2168,13,24,"PUM+J",1
4,"4006",7016,4823,4786,33,37,"PUM+J",2
4,"4029",8887,6103,6048,53,55,"PUM+J",2
4,"4099",4988,3784,3714,26,70,"PUM+J",4
4,"4070",1623,1233,1229,7,4,"PUM+J",1
4,"4053",12333,9124,9040,66,84,"PUM+J",0
4,"4068",195,158,158,0,0,"PUM+J",0
4,"4041",318,241,241,6,0,"PUM+J",0
4,"4037",1312,1019,1000,6,19,"PUM+J",0
4,"4096",274,208,206,0,2,"PUM+J",0
4,"4082",306,210,209,0,1,"PUM+J",0
4,"4083",1790,1384,1379,8,5,"PUM+J",1
8,"8270",18399,12948,12869,83,79,"RECORTES CE",39
8,"8080",38,28,27,0,1,"RECORTES CE",0
8,"8054",9013,6747,6702,38,45,"RECORTES CE",21
8,"8002",202,142,139,0,3,"RECORTES CE",0
8,"8146",1297,958,954,16,4,"RECORTES CE",1
8,"8242",216,172,170,0,2,"RECORTES CE",1
8,"8102",28304,19929,19821,170,108,"RECORTES CE",63
8,"8303",278,206,205,2,1,"RECORTES CE",0
8,"8034",766,542,538,3,4,"RECORTES CE",1
8,"8218",8045,5643,5613,54,30,"RECORTES CE",14
8,"8041",10314,7291,7238,46,53,"RECORTES CE",35
8,"8182",2803,2039,2034,16,5,"RECORTES CE",5
8,"8259",6623,4921,4885,33,36,"RECORTES CE",18
8,"8040",10701,7420,7383,43,37,"RECORTES CE",17
8,"8170",447,293,291,11,2,"RECORTES CE",0
8,"8086",13550,9448,9395,66,53,"RECORTES CE",50
8,"8207",1840,1418,1410,17,8,"RECORTES CE",3
8,"8074",10587,7309,7274,51,35,"RECORTES CE",21
8,"8065",1179,837,831,8,6,"RECORTES CE",1
8,"8068",6729,4765,4739,23,26,"RECORTES CE",19
8,"8069",3168,2333,2324,17,9,"RECORTES CE",16
8,"8091",5253,3817,3795,23,22,"RECORTES CE",8
8,"8071",241,168,164,3,4,"RECORTES CE",0
8,"8191",5287,3732,3712,31,20,"RECORTES CE",10
8,"8027",690,527,524,3,3,"RECORTES CE",0
8,"8220",2358,1783,1770,18,13,"RECORTES CE",0
8,"8104",682,445,443,4,2,"RECORTES CE",0
8,"8029",3438,2645,2632,25,13,"RECORTES CE",9
8,"8115",3817,2835,2814,18,21,"RECORTES CE",10
8,"8082",1150,788,783,6,5,"RECORTES CE",2
8,"8051",17873,13126,13048,66,78,"RECORTES CE",37
8,"8180",26616,19621,19542,90,79,"RECORTES CE",81
8,"8206",731,568,559,9,9,"RECORTES CE",0
8,"8268",1011,702,699,2,3,"RECORTES CE",1
8,"8248",5402,3848,3815,27,33,"RECORTES CE",2
8,"8306",517,360,354,2,6,"RECORTES CE",1
8,"8045",72,42,39,0,3,"RECORTES CE",0
8,"8052",139,94,94,2,0,"RECORTES CE",0
8,"8085",985,712,704,1,8,"RECORTES CE",1
8,"8163",18590,12816,12750,72,66,"RECORTES CE",36
8,"8140",4769,3344,3335,25,9,"RECORTES CE",8
8,"8155",6736,4779,4734,45,45,"RECORTES CE",15
8,"8148",2238,1592,1580,7,12,"RECORTES CE",5
8,"8009",9136,6613,6578,40,35,"RECORTES CE",19
8,"8141",4590,3173,3150,39,23,"RECORTES CE",4
8,"8128",564,378,377,1,1,"RECORTES CE",0
8,"8142",132,105,104,1,1,"RECORTES CE",0
8,"8262",6855,4522,4491,46,31,"RECORTES CE",16
8,"8187",152527,112013,111491,638,522,"RECORTES CE",370
8,"8019",1141245,824778,820790,5063,3988,"RECORTES CE",3018
8,"8015",155841,109156,108536,726,620,"RECORTES CE",463
8,"8107",11472,8147,8097,45,50,"RECORTES CE",30
8,"8118",17516,12878,12820,79,58,"RECORTES CE",33
8,"8175",3371,2243,2232,25,11,"RECORTES CE",3
8,"8263",20974,15086,15001,93,85,"RECORTES CE",49
8,"8105",9613,7103,7047,46,56,"RECORTES CE",36
8,"8011",1760,1230,1217,10,13,"RECORTES CE",2
8,"8292",1083,796,791,4,5,"RECORTES CE",2
8,"8053",2805,1789,1775,10,14,"RECORTES CE",5
8,"8301",48496,35956,35788,200,168,"RECORTES CE",180
8,"8239",451,324,324,5,0,"RECORTES CE",1
8,"8277",162,132,132,0,0,"RECORTES CE",0
8,"8119",6182,4517,4492,35,25,"RECORTES CE",26
8,"8093",26,19,19,0,0,"RECORTES CE",0
8,"8169",47915,35543,35390,211,153,"RECORTES CE",205
8,"8234",3187,2331,2322,11,9,"RECORTES CE",9
8,"8013",1219,873,867,10,6,"RECORTES CE",1
8,"8150",258,189,185,0,4,"RECORTES CE",0
8,"8161",11145,7658,7621,45,37,"RECORTES CE",25
8,"8006",11427,7789,7727,46,62,"RECORTES CE",19
8,"8135",6733,5230,5205,45,25,"RECORTES CE",22
8,"8266",43128,32806,32660,195,146,"RECORTES CE",146
8,"8036",159,113,112,1,1,"RECORTES CE",0
8,"8256",644,516,512,1,4,"RECORTES CE",2
8,"8124",36750,26968,26842,140,126,"RECORTES CE",101
8,"8254",1746,1261,1257,13,4,"RECORTES CE",1
8,"8216",25,17,17,0,0,"RECORTES CE",0
8,"8223",1850,1279,1263,10,16,"RECORTES CE",5
8,"8056",41996,30076,29974,178,102,"RECORTES CE",111
8,"8084",1135,795,790,6,5,"RECORTES CE",0
8,"8137",265,206,205,1,1,"RECORTES CE",0
8,"8279",152985,110533,110039,684,494,"RECORTES CE",519
8,"8304",814,578,573,1,5,"RECORTES CE",0
8,"8231",20495,13961,13885,91,76,"RECORTES CE",37
8,"8089",33935,24504,24392,150,112,"RECORTES CE",109
8,"8060",143,100,99,0,1,"RECORTES CE",0
8,"8112",12909,8671,8616,50,55,"RECORTES CE",18
8,"8049",1288,860,841,9,19,"RECORTES CE",0
8,"8047",3978,2640,2614,21,26,"RECORTES CE",6
8,"8023",6715,4669,4633,25,36,"RECORTES CE",13
8,"8046",13243,9747,9693,74,54,"RECORTES CE",29
8,"8296",1787,1358,1351,9,7,"RECORTES CE",2
8,"8194",25539,16628,16553,77,75,"RECORTES CE",70
8,"8287",1044,806,792,7,14,"RECORTES CE",1
8,"8243",160,117,117,6,0,"RECORTES CE",0
8,"8087",159,131,130,2,1,"RECORTES CE",0
8,"8192",5696,4093,4069,38,24,"RECORTES CE",4
8,"8153",536,432,431,6,1,"RECORTES CE",3
8,"8214",6841,5018,4994,49,24,"RECORTES CE",8
8,"8012",1676,1175,1170,24,5,"RECORTES CE",2
8,"8035",12448,8482,8443,54,39,"RECORTES CE",28
8,"8203",2422,1602,1591,11,11,"RECORTES CE",3
8,"8226",879,683,680,3,3,"RECORTES CE",0
8,"8249",266,223,220,2,3,"RECORTES CE",0
8,"8092",3768,2621,2600,31,21,"RECORTES CE",3
8,"8193",942,637,633,9,4,"RECORTES CE",0
8,"8103",631,431,431,3,0,"RECORTES CE",0
8,"8088",11840,8684,8627,55,57,"RECORTES CE",21
8,"8274",4702,3349,3323,35,26,"RECORTES CE",8
8,"8106",7216,5220,5176,38,44,"RECORTES CE",17
8,"8245",78581,55798,55530,345,268,"RECORTES CE",265
8,"8133",128,76,75,0,1,"RECORTES CE",0
8,"8260",18306,13492,13423,60,69,"RECORTES CE",48
8,"8016",1822,1229,1214,12,15,"RECORTES CE",2
8,"8162",2028,1451,1442,8,9,"RECORTES CE",10
8,"8129",456,322,320,3,2,"RECORTES CE",2
8,"8227",2329,1625,1607,13,18,"RECORTES CE",4
8,"8151",463,336,333,11,3,"RECORTES CE",0
8,"8018",2654,1834,1819,16,15,"RECORTES CE",7
8,"8209",6773,4845,4822,31,23,"RECORTES CE",17
8,"8282",6517,5027,5017,40,10,"RECORTES CE",16
8,"8005",6165,4458,4434,23,24,"RECORTES CE",3
8,"8138",4229,2832,2816,19,16,"RECORTES CE",3
8,"8305",27328,19226,19083,116,143,"RECORTES CE",50
8,"8298",26426,17862,17784,113,78,"RECORTES CE",23
8,"8152",114,84,82,1,2,"RECORTES CE",0
8,"8067",5723,3896,3874,39,22,"RECORTES CE",10
8,"8179",579,427,425,6,2,"RECORTES CE",2
8,"8008",187,118,118,1,0,"RECORTES CE",0
8,"8116",582,421,418,4,3,"RECORTES CE",1
8,"8028",1031,724,721,6,3,"RECORTES CE",4
8,"8109",214,174,173,0,1,"RECORTES CE",0
8,"8284",12067,7855,7792,66,63,"RECORTES CE",17
8,"8157",8361,6311,6277,38,34,"RECORTES CE",25
8,"8066",1364,1029,1025,10,4,"RECORTES CE",3
8,"8113",52051,34906,34729,229,177,"RECORTES CE",61
8,"8210",4296,2825,2806,22,19,"RECORTES CE",8
8,"8902",3756,2758,2741,18,17,"RECORTES CE",5
8,"8244",5821,4484,4451,32,33,"RECORTES CE",30
8,"8265",1548,1115,1108,8,7,"RECORTES CE",1
8,"8139",171,133,132,0,1,"RECORTES CE",0
8,"8251",4970,3505,3480,14,25,"RECORTES CE",11
8,"8281",4841,3577,3553,18,24,"RECORTES CE",8
8,"8095",71,50,50,0,0,"RECORTES CE",0
8,"8307",48233,34249,34071,209,178,"RECORTES CE",113
8,"8204",3058,2282,2262,17,20,"RECORTES CE",14
8,"8075",3875,2709,2695,12,14,"RECORTES CE",6
8,"8903",213,167,167,0,0,"RECORTES CE",0
8,"8077",34550,26102,25983,152,119,"RECORTES CE",121
8,"8205",59169,45410,45231,357,179,"RECORTES CE",146
8,"8111",216,185,185,0,0,"RECORTES CE",1
8,"8212",495,350,347,3,3,"RECORTES CE",0
8,"8293",226,162,162,0,0,"RECORTES CE",2
8,"8048",583,426,424,5,2,"RECORTES CE",0
8,"8275",254,202,202,4,0,"RECORTES CE",0
8,"8122",1683,1117,1106,10,11,"RECORTES CE",3
8,"8070",267,196,193,2,3,"RECORTES CE",0
8,"8904",10563,7474,7437,32,37,"RECORTES CE",39
8,"8221",12391,9503,9456,49,47,"RECORTES CE",34
8,"8255",140,90,90,1,0,"RECORTES CE",0
8,"8276",233,169,169,3,0,"RECORTES CE",0
8,"8078",216,135,135,2,0,"RECORTES CE",0
8,"8257",110,87,87,0,0,"RECORTES CE",0
8,"8167",5879,4463,4448,42,15,"RECORTES CE",11
8,"8250",7046,4908,4878,33,30,"RECORTES CE",13
8,"8261",2319,1638,1632,4,6,"RECORTES CE",5
8,"8064",1853,1323,1315,9,8,"RECORTES CE",1
8,"8130",96,66,66,0,0,"RECORTES CE",0
8,"8156",10923,8013,7964,50,49,"RECORTES CE",33
8,"8108",5014,3757,3740,21,17,"RECORTES CE",7
8,"8127",2224,1439,1429,8,10,"RECORTES CE",6
8,"8252",24521,18605,18514,110,91,"RECORTES CE",95
8,"8195",82,64,64,0,0,"RECORTES CE",0
8,"8076",16173,11553,11473,73,80,"RECORTES CE",66
8,"8057",59,42,41,2,1,"RECORTES CE",0
8,"8024",381,270,269,3,1,"RECORTES CE",0
8,"8291",4524,3226,3206,24,20,"RECORTES CE",11
8,"8302",9209,6571,6524,65,47,"RECORTES CE",19
8,"8196",19247,14101,14047,75,54,"RECORTES CE",49
8,"8273",2309,1706,1689,12,17,"RECORTES CE",3
8,"8258",835,602,597,5,5,"RECORTES CE",0
8,"8237",1642,1165,1160,4,5,"RECORTES CE",0
8,"8143",2686,1892,1881,19,11,"RECORTES CE",6
8,"8032",1973,1410,1403,6,7,"RECORTES CE",7
8,"8294",1971,1357,1349,8,8,"RECORTES CE",4
8,"8211",32990,25446,25282,173,164,"RECORTES CE",111
8,"8039",354,259,259,0,0,"RECORTES CE",0
8,"8181",7896,5774,5724,41,50,"RECORTES CE",18
8,"8055",512,366,364,2,2,"RECORTES CE",0
8,"8190",258,179,177,2,2,"RECORTES CE",0
8,"8147",17001,12422,12333,62,89,"RECORTES CE",50
8,"8037",1856,1364,1351,20,13,"RECORTES CE",6
8,"8267",6435,4571,4542,24,29,"RECORTES CE",16
8,"8253",133,85,85,1,0,"RECORTES CE",0
8,"8081",345,255,255,1,0,"RECORTES CE",2
8,"8264",4288,3045,3030,30,15,"RECORTES CE",12
8,"8042",2233,1668,1653,8,15,"RECORTES CE",2
8,"8014",1953,1438,1429,13,9,"RECORTES CE",2
8,"8222",1878,1452,1443,16,9,"RECORTES CE",3
8,"8228",296,207,204,3,3,"RECORTES CE",0
8,"8120",6815,5071,5045,34,26,"RECORTES CE",8
8,"8272",157,98,97,0,1,"RECORTES CE",0
8,"8217",24985,19385,19317,130,68,"RECORTES CE",73
8,"8134",803,560,554,5,6,"RECORTES CE",0
8,"8020",4876,3702,3678,25,24,"RECORTES CE",12
8,"8246",1682,1157,1152,8,5,"RECORTES CE",0
8,"8126",8709,6454,6425,34,29,"RECORTES CE",26
8,"8283",5983,4032,4007,31,25,"RECORTES CE",3
8,"8295",10850,7651,7617,33,34,"RECORTES CE",24
8,"8177",40,25,25,1,0,"RECORTES CE",0
8,"8097",1027,736,731,7,5,"RECORTES CE",1
8,"8123",19114,14573,14509,81,64,"RECORTES CE",54
8,"8288",1632,1061,1053,4,8,"RECORTES CE",3
8,"8121",86293,61426,61070,450,356,"RECORTES CE",197
8,"8164",911,651,644,2,7,"RECORTES CE",0
8,"8050",141,107,104,0,3,"RECORTES CE",0
8,"8094",1548,1143,1133,12,10,"RECORTES CE",1
8,"8098",2387,1668,1662,11,6,"RECORTES CE",6
8,"8117",2453,1741,1727,23,14,"RECORTES CE",0
8,"8229",535,383,379,3,4,"RECORTES CE",1
8,"8025",1486,1087,1083,13,4,"RECORTES CE",3
8,"8026",187,155,155,1,0,"RECORTES CE",0
8,"8200",61275,45027,44785,276,242,"RECORTES CE",267
8,"8202",12615,8911,8831,70,80,"RECORTES CE",26
8,"8232",1797,1276,1266,14,10,"RECORTES CE",3
8,"8101",174802,123863,123197,643,666,"RECORTES CE",676
8,"8062",951,676,674,5,2,"RECORTES CE",2
8,"8300",5682,4328,4312,21,16,"RECORTES CE",13
8,"8022",12230,7792,7717,60,75,"RECORTES CE",8
8,"8033",12803,9236,9179,79,57,"RECORTES CE",20
8,"8003",7118,5140,5108,28,32,"RECORTES CE",11
8,"8030",5095,3727,3712,27,15,"RECORTES CE",14
8,"8297",138,100,99,1,1,"RECORTES CE",0
8,"8160",330,217,217,0,0,"RECORTES CE",0
8,"8063",448,363,363,8,0,"RECORTES CE",0
8,"8308",131,99,97,0,2,"RECORTES CE",0
8,"8149",996,662,660,7,2,"RECORTES CE",1
8,"8043",3190,2216,2201,12,15,"RECORTES CE",2
8,"8154",694,535,529,3,6,"RECORTES CE",1
8,"8031",2308,1648,1637,10,11,"RECORTES CE",2
8,"8198",4391,3167,3138,17,29,"RECORTES CE",7
8,"8224",816,598,595,7,3,"RECORTES CE",2
8,"8290",1490,1163,1155,5,8,"RECORTES CE",2
8,"8100",1992,1496,1485,21,11,"RECORTES CE",1
8,"8299",395,256,255,3,1,"RECORTES CE",1
8,"8286",2904,2009,1997,17,12,"RECORTES CE",9
8,"8058",1742,1210,1194,7,16,"RECORTES CE",0
8,"8168",375,235,234,0,1,"RECORTES CE",1
8,"8171",2099,1396,1389,20,7,"RECORTES CE",0
8,"8189",126,95,94,2,1,"RECORTES CE",0
8,"8004",233,181,181,2,0,"RECORTES CE",0
8,"8079",339,254,248,2,6,"RECORTES CE",0
8,"8269",2646,1871,1860,17,11,"RECORTES CE",3
8,"8199",665,466,464,6,2,"RECORTES CE",0
8,"8021",69,52,51,3,1,"RECORTES CE",0
8,"8247",958,716,714,7,2,"RECORTES CE",0
8,"8271",69,47,46,0,1,"RECORTES CE",0
8,"8197",7605,5331,5317,31,14,"RECORTES CE",13
8,"8165",1657,1181,1175,8,6,"RECORTES CE",2
8,"8178",430,317,315,4,2,"RECORTES CE",0
8,"8159",14049,10329,10284,51,45,"RECORTES CE",53
8,"8110",13392,9211,9142,67,69,"RECORTES CE",25
8,"8285",10260,6893,6843,56,50,"RECORTES CE",13
8,"8241",76,59,59,0,0,"RECORTES CE",0
8,"8145",2585,1927,1915,10,12,"RECORTES CE",3
8,"8225",93,71,71,2,0,"RECORTES CE",0
8,"8132",379,259,256,3,3,"RECORTES CE",0
8,"8073",61659,45611,45356,239,255,"RECORTES CE",241
8,"8158",3105,2166,2145,18,21,"RECORTES CE",7
8,"8083",1674,1287,1275,8,12,"RECORTES CE",1
8,"8183",4524,3125,3103,21,22,"RECORTES CE",5
8,"8201",436,299,298,1,1,"RECORTES CE",0
8,"8240",9354,6996,6953,34,43,"RECORTES CE",16
8,"8007",6505,4532,4495,28,37,"RECORTES CE",7
8,"8238",14478,11302,11252,85,50,"RECORTES CE",31
8,"8184",53690,37794,37636,200,158,"RECORTES CE",174
8,"8096",42411,30717,30550,204,167,"RECORTES CE",111
8,"8017",2756,1888,1876,7,12,"RECORTES CE",3
8,"8905",2305,1789,1774,17,15,"RECORTES CE",7
8,"8901",232,171,171,6,0,"RECORTES CE",0
8,"8235",3683,2612,2595,22,17,"RECORTES CE",5
8,"8038",1488,987,981,10,6,"RECORTES CE",2
8,"8010",4196,2876,2852,16,24,"RECORTES CE",3
8,"8230",7611,5590,5560,40,30,"RECORTES CE",16
8,"8072",10240,6957,6935,40,22,"RECORTES CE",23
8,"8136",11416,8425,8388,63,37,"RECORTES CE",31
8,"8125",25024,18070,17966,99,104,"RECORTES CE",91
8,"8172",20384,14738,14684,85,54,"RECORTES CE",61
8,"8174",394,306,300,3,6,"RECORTES CE",0
8,"8236",1525,1077,1067,3,10,"RECORTES CE",0
8,"8213",6296,4308,4294,47,14,"RECORTES CE",8
8,"8131",699,520,516,4,4,"RECORTES CE",1
8,"8144",715,493,489,9,4,"RECORTES CE",0
8,"8166",1000,680,674,4,6,"RECORTES CE",0
8,"8208",5736,4318,4295,23,23,"RECORTES CE",34
8,"8233",1876,1247,1237,11,10,"RECORTES CE",1
8,"8001",8825,6810,6760,24,50,"RECORTES CE",31
8,"8278",4764,3372,3358,16,14,"RECORTES CE",4
8,"8061",1485,1045,1040,5,5,"RECORTES CE",4
8,"8044",4150,2957,2932,19,25,"RECORTES CE",14
8,"8215",2576,1766,1751,30,15,"RECORTES CE",0
8,"8185",194,132,132,0,0,"RECORTES CE",0
8,"8188",117,81,81,2,0,"RECORTES CE",0
8,"8289",4304,3166,3151,19,15,"RECORTES CE",13
8,"8219",15355,11458,11403,86,55,"RECORTES CE",24
8,"8099",749,514,513,4,1,"RECORTES CE",1
8,"8090",129,103,102,2,1,"RECORTES CE",0
8,"8114",18335,13196,13092,66,104,"RECORTES CE",72
8,"8176",158,113,113,1,0,"RECORTES CE",0
8,"8059",342,224,223,3,1,"RECORTES CE",0
8,"8280",101,67,67,3,0,"RECORTES CE",0
14,"14046",4484,3540,3487,22,53,"FE de las J",2
14,"14047",1654,1221,1211,17,10,"FE de las J",1
14,"14034",318,260,252,2,8,"FE de las J",1
14,"14030",8580,6619,6542,66,77,"FE de las J",5
14,"14024",1920,1522,1488,10,34,"FE de las J",0
14,"14074",2303,1940,1929,13,11,"FE de las J",0
14,"14037",3344,2476,2442,20,34,"FE de las J",2
14,"14056",23613,17016,16804,128,212,"FE de las J",13
14,"14058",7973,5860,5791,49,69,"FE de las J",4
14,"14073",2900,2068,2041,15,27,"FE de las J",1
14,"14022",4036,3199,3169,9,30,"FE de las J",2
14,"14035",5992,4475,4437,44,38,"FE de las J",8
14,"14066",5890,4366,4322,29,44,"FE de las J",3
14,"14025",2950,2460,2425,10,35,"FE de las J",0
14,"14070",1343,1026,1008,9,18,"FE de las J",1
14,"14067",3874,3033,2986,29,47,"FE de las J",6
14,"14041",3180,2404,2373,26,31,"FE de las J",0
14,"14010",4051,3003,2968,17,35,"FE de las J",1
14,"14065",1861,1461,1446,12,15,"FE de las J",0
14,"14020",391,278,274,3,4,"FE de las J",0
14,"14012",6190,4574,4488,27,86,"FE de las J",2
14,"14021",260189,188939,187558,1934,1381,"FE de las J",228
14,"14031",597,490,484,0,6,"FE de las J",0
14,"14017",10869,8130,8029,72,101,"FE de las J",6
14,"14042",18921,14842,14653,184,189,"FE de las J",7
14,"14068",545,410,407,6,3,"FE de las J",1
14,"14055",18572,13587,13410,167,177,"FE de las J",31
14,"14052",9447,6250,6201,49,49,"FE de las J",4
14,"14007",15200,11064,10926,81,138,"FE de las J",19
14,"14043",7574,5571,5510,46,61,"FE de las J",3
14,"14062",1052,813,801,4,12,"FE de las J",0
14,"14009",2779,1941,1934,13,7,"FE de las J",5
14,"14011",584,477,476,3,1,"FE de las J",0
14,"14014",2570,2104,2075,8,29,"FE de las J",0
14,"14016",1364,1047,1045,3,2,"FE de las J",1
14,"14051",1401,1095,1077,5,18,"FE de las J",0
14,"14018",3710,2882,2846,28,36,"FE de las J",3
14,"14063",1065,803,797,4,6,"FE de las J",3
14,"14036",3767,2911,2857,53,54,"FE de las J",1
14,"14008",2871,2053,2034,11,19,"FE de las J",1
14,"14003",1265,981,970,6,11,"FE de las J",0
14,"14001",3552,2861,2830,28,31,"FE de las J",1
14,"14057",6152,4973,4903,56,70,"FE de las J",3
14,"14026",2073,1437,1421,13,16,"FE de las J",0
14,"14071",937,651,642,2,9,"FE de las J",0
14,"14019",6479,5131,5076,46,55,"FE de las J",2
14,"14005",6358,4379,4272,56,107,"FE de las J",5
14,"14045",3055,2486,2451,13,35,"FE de las J",1
14,"14002",10951,8231,8150,72,81,"FE de las J",3
14,"14004",2036,1502,1488,6,14,"FE de las J",3
14,"14075",581,463,446,6,17,"FE de las J",0
14,"14028",320,246,244,2,2,"FE de las J",0
14,"14015",2149,1637,1616,13,21,"FE de las J",1
14,"14044",1624,1285,1267,9,18,"FE de las J",1
14,"14050",2399,1886,1864,11,22,"FE de las J",0
14,"14049",16357,12206,12029,127,177,"FE de las J",17
14,"14061",756,606,592,2,14,"FE de las J",0
14,"14040",3792,3036,3010,23,26,"FE de las J",3
14,"14013",16845,12599,12414,146,185,"FE de las J",26
14,"14039",2628,2151,2123,11,28,"FE de las J",7
14,"14060",4854,3695,3633,43,62,"FE de las J",3
14,"14072",1079,834,830,5,4,"FE de las J",0
14,"14029",4206,3170,3135,32,35,"FE de las J",4
14,"14053",6050,4498,4427,56,71,"FE de las J",0
14,"14006",1331,1166,1137,7,29,"FE de las J",0
14,"14054",13665,10923,10678,103,245,"FE de las J",5
14,"14032",425,347,335,3,12,"FE de las J",0
14,"14038",32236,22982,22773,209,209,"FE de las J",33
14,"14023",2041,1742,1717,13,25,"FE de las J",0
14,"14069",7536,5574,5495,48,79,"FE de las J",5
14,"14059",699,559,552,5,7,"FE de las J",0
14,"14048",1206,967,949,11,18,"FE de las J",0
14,"14033",1285,980,963,11,17,"FE de las J",0
14,"14027",7908,6085,6008,57,77,"FE de las J",6
14,"14064",331,252,244,2,8,"FE de las J",0
19,"19222",115,87,86,1,1,"RECORTES CE",0
19,"19133",86,73,73,1,0,"RECORTES CE",0
19,"19290",853,568,560,3,8,"RECORTES CE",3
19,"19082",85,62,62,0,0,"RECORTES CE",0
19,"19319",4425,3336,3304,21,32,"RECORTES CE",5
19,"19229",69,60,60,1,0,"RECORTES CE",0
19,"19242",93,66,62,2,4,"RECORTES CE",0
19,"19176",237,181,181,0,0,"RECORTES CE",0
19,"19257",3446,2532,2499,36,33,"RECORTES CE",3
19,"19288",23,22,22,0,0,"RECORTES CE",0
19,"19255",78,61,61,0,0,"RECORTES CE",0
19,"19195",40,30,26,1,4,"RECORTES CE",0
19,"19090",97,77,77,1,0,"RECORTES CE",0
19,"19089",28,17,17,0,0,"RECORTES CE",0
19,"19117",1580,1183,1167,11,16,"RECORTES CE",2
19,"19192",1723,1354,1342,9,12,"RECORTES CE",1
19,"19224",93,80,80,0,0,"RECORTES CE",0
19,"19258",97,73,73,1,0,"RECORTES CE",0
19,"19143",1733,1371,1352,9,19,"RECORTES CE",2
19,"19107",302,262,260,0,2,"RECORTES CE",0
19,"19006",768,545,538,0,7,"RECORTES CE",0
19,"19223",110,76,76,3,0,"RECORTES CE",0
19,"19199",19,16,16,1,0,"RECORTES CE",0
19,"19310",11,7,7,0,0,"RECORTES CE",0
19,"19001",53,36,36,1,0,"RECORTES CE",0
19,"19121",257,209,208,0,1,"RECORTES CE",0
19,"19002",73,56,54,0,2,"RECORTES CE",0
19,"19186",81,63,63,1,0,"RECORTES CE",0
19,"19254",49,36,36,1,0,"RECORTES CE",0
19,"19271",47,30,30,0,0,"RECORTES CE",0
19,"19305",162,129,128,1,1,"RECORTES CE",0
19,"19122",93,72,72,3,0,"RECORTES CE",0
19,"19266",241,201,199,2,2,"RECORTES CE",0
19,"19230",504,383,376,4,7,"RECORTES CE",3
19,"19219",13,9,9,0,0,"RECORTES CE",0
19,"19189",120,91,90,2,1,"RECORTES CE",0
19,"19293",1868,1379,1364,9,15,"RECORTES CE",5
19,"19118",13,10,10,0,0,"RECORTES CE",0
19,"19095",12,10,10,0,0,"RECORTES CE",0
19,"19153",23,22,22,0,0,"RECORTES CE",0
19,"19046",21452,16321,16151,91,170,"RECORTES CE",45
19,"19238",42,32,31,2,1,"RECORTES CE",0
19,"19135",105,82,82,0,0,"RECORTES CE",0
19,"19256",44,35,35,0,0,"RECORTES CE",0
19,"19239",100,70,69,1,1,"RECORTES CE",0
19,"19138",272,197,196,0,1,"RECORTES CE",1
19,"19061",56,47,47,0,0,"RECORTES CE",0
19,"19178",39,25,25,0,0,"RECORTES CE",0
19,"19156",983,743,735,5,8,"RECORTES CE",0
19,"19098",21,20,20,0,0,"RECORTES CE",0
19,"19298",64,49,49,0,0,"RECORTES CE",0
19,"19166",158,125,124,0,1,"RECORTES CE",0
19,"19217",59,39,37,0,2,"RECORTES CE",0
19,"19142",260,189,186,2,3,"RECORTES CE",0
19,"19285",25,16,16,2,0,"RECORTES CE",0
19,"19228",29,21,20,0,1,"RECORTES CE",1
19,"19231",12,8,8,1,0,"RECORTES CE",0
19,"19054",190,165,163,3,2,"RECORTES CE",0
19,"19167",132,106,103,0,3,"RECORTES CE",0
19,"19280",3451,2620,2581,14,39,"RECORTES CE",9
19,"19004",66,51,50,1,1,"RECORTES CE",1
19,"19265",136,104,104,0,0,"RECORTES CE",0
19,"19039",60,55,54,1,1,"RECORTES CE",0
19,"19216",134,97,97,0,0,"RECORTES CE",0
19,"19210",21,19,19,2,0,"RECORTES CE",0
19,"19038",28,23,23,0,0,"RECORTES CE",0
19,"19096",93,66,66,0,0,"RECORTES CE",0
19,"19045",145,119,117,1,2,"RECORTES CE",0
19,"19248",83,66,66,1,0,"RECORTES CE",0
19,"19300",762,628,624,3,4,"RECORTES CE",3
19,"19126",1620,1242,1216,5,26,"RECORTES CE",0
19,"19102",101,84,84,0,0,"RECORTES CE",0
19,"19099",299,206,205,1,1,"RECORTES CE",0
19,"19139",31,23,23,1,0,"RECORTES CE",0
19,"19159",94,77,77,0,0,"RECORTES CE",0
19,"19152",589,448,439,2,9,"RECORTES CE",1
19,"19097",17,13,13,0,0,"RECORTES CE",0
19,"19232",79,60,59,1,1,"RECORTES CE",0
19,"19034",22,18,18,0,0,"RECORTES CE",0
19,"19049",12,11,11,0,0,"RECORTES CE",0
19,"19174",111,79,78,0,1,"RECORTES CE",1
19,"19087",18,17,17,0,0,"RECORTES CE",0
19,"19279",57,54,54,0,0,"RECORTES CE",0
19,"19182",39,28,27,0,1,"RECORTES CE",0
19,"19306",28,20,20,0,0,"RECORTES CE",0
19,"19263",27,17,15,0,2,"RECORTES CE",0
19,"19145",48,42,42,2,0,"RECORTES CE",0
19,"19191",13,12,12,0,0,"RECORTES CE",0
19,"19331",2611,2010,1982,18,28,"RECORTES CE",7
19,"19112",57,49,49,0,0,"RECORTES CE",0
19,"19019",19,17,16,0,1,"RECORTES CE",0
19,"19323",42,33,33,0,0,"RECORTES CE",0
19,"19227",74,49,49,0,0,"RECORTES CE",1
19,"19105",2332,1809,1794,11,15,"RECORTES CE",5
19,"19016",64,42,42,0,0,"RECORTES CE",0
19,"19147",46,34,33,0,1,"RECORTES CE",0
19,"19215",165,142,141,0,1,"RECORTES CE",0
19,"19109",43,32,32,3,0,"RECORTES CE",0
19,"19262",139,111,109,0,2,"RECORTES CE",0
19,"19108",112,90,90,1,0,"RECORTES CE",1
19,"19333",121,86,83,2,3,"RECORTES CE",0
19,"19120",104,92,92,1,0,"RECORTES CE",0
19,"19011",254,191,191,2,0,"RECORTES CE",0
19,"19184",75,48,46,0,2,"RECORTES CE",0
19,"19249",31,27,27,0,0,"RECORTES CE",0
19,"19114",39,26,26,0,0,"RECORTES CE",0
19,"19296",30,21,21,0,0,"RECORTES CE",0
19,"19136",18,15,15,0,0,"RECORTES CE",0
19,"19003",41,37,35,0,2,"RECORTES CE",0
19,"19150",126,94,93,0,1,"RECORTES CE",0
19,"19282",161,115,112,0,3,"RECORTES CE",0
19,"19267",19,12,12,0,0,"RECORTES CE",0
19,"19073",24,19,19,0,0,"RECORTES CE",0
19,"19154",66,52,51,0,1,"RECORTES CE",0
19,"19246",46,36,36,0,0,"RECORTES CE",0
19,"19103",255,205,201,0,4,"RECORTES CE",0
19,"19209",40,28,27,1,1,"RECORTES CE",0
19,"19317",141,107,103,0,4,"RECORTES CE",0
19,"19134",26,18,18,0,0,"RECORTES CE",0
19,"19165",48,40,40,0,0,"RECORTES CE",1
19,"19058",6786,5451,5415,29,36,"RECORTES CE",9
19,"19326",1749,1248,1237,5,11,"RECORTES CE",4
19,"19075",63,37,36,0,1,"RECORTES CE",0
19,"19041",160,133,132,0,1,"RECORTES CE",0
19,"19283",29,23,23,0,0,"RECORTES CE",0
19,"19163",61,44,43,1,1,"RECORTES CE",0
19,"19071",7746,5748,5678,34,70,"RECORTES CE",19
19,"19129",29,25,25,0,0,"RECORTES CE",0
19,"19081",31,21,21,0,0,"RECORTES CE",0
19,"19088",84,68,68,0,0,"RECORTES CE",0
19,"19218",52,35,34,0,1,"RECORTES CE",0
19,"19235",97,63,62,0,1,"RECORTES CE",0
19,"19203",31,25,25,0,0,"RECORTES CE",0
19,"19161",218,151,151,1,0,"RECORTES CE",1
19,"19065",127,103,102,1,1,"RECORTES CE",0
19,"19329",58,49,49,0,0,"RECORTES CE",0
19,"19269",100,80,79,0,1,"RECORTES CE",0
19,"19130",59955,47034,46504,383,530,"RECORTES CE",88
19,"19042",26,25,25,0,0,"RECORTES CE",0
19,"19299",95,74,74,1,0,"RECORTES CE",0
19,"19324",179,136,135,0,1,"RECORTES CE",0
19,"19125",45,40,40,0,0,"RECORTES CE",0
19,"19047",67,60,60,1,0,"RECORTES CE",1
19,"19200",75,53,53,1,0,"RECORTES CE",0
19,"19021",1051,788,774,7,14,"RECORTES CE",1
19,"19017",69,56,56,0,0,"RECORTES CE",0
19,"19334",36,30,29,0,1,"RECORTES CE",0
19,"19043",80,74,72,0,2,"RECORTES CE",0
19,"19106",92,67,64,0,3,"RECORTES CE",0
19,"19208",43,31,31,0,0,"RECORTES CE",0
19,"19220",2305,1613,1600,9,13,"RECORTES CE",3
19,"19233",91,71,71,1,0,"RECORTES CE",0
19,"19067",70,51,50,2,1,"RECORTES CE",0
19,"19225",835,645,638,2,7,"RECORTES CE",1
19,"19040",51,41,41,0,0,"RECORTES CE",1
19,"19074",73,63,63,0,0,"RECORTES CE",0
19,"19036",271,230,229,1,1,"RECORTES CE",0
19,"19127",89,56,56,0,0,"RECORTES CE",0
19,"19194",98,68,66,0,2,"RECORTES CE",0
19,"19052",27,18,18,1,0,"RECORTES CE",0
19,"19202",13,12,12,0,0,"RECORTES CE",0
19,"19169",43,36,36,0,0,"RECORTES CE",0
19,"19124",382,256,253,0,3,"RECORTES CE",0
19,"19309",26,22,22,0,0,"RECORTES CE",0
19,"19064",73,62,62,0,0,"RECORTES CE",0
19,"19226",48,35,35,0,0,"RECORTES CE",0
19,"19318",25,19,19,0,0,"RECORTES CE",0
19,"19284",10,8,8,0,0,"RECORTES CE",0
19,"19092",417,316,312,4,4,"RECORTES CE",1
19,"19015",81,68,68,0,0,"RECORTES CE",0
19,"19183",83,74,73,0,1,"RECORTES CE",0
19,"19214",74,54,54,0,0,"RECORTES CE",0
19,"19234",46,38,38,0,0,"RECORTES CE",0
19,"19314",52,35,34,1,1,"RECORTES CE",0
19,"19286",725,557,551,1,6,"RECORTES CE",4
19,"19113",471,365,365,2,0,"RECORTES CE",0
19,"19274",895,673,664,8,9,"RECORTES CE",1
19,"19204",154,106,106,3,0,"RECORTES CE",0
19,"19244",81,61,59,2,2,"RECORTES CE",0
19,"19303",46,39,38,0,1,"RECORTES CE",0
19,"19277",18,12,12,0,0,"RECORTES CE",0
19,"19078",53,44,44,0,0,"RECORTES CE",0
19,"19270",22,18,18,0,0,"RECORTES CE",0
19,"19289",28,21,21,0,0,"RECORTES CE",0
19,"19010",9,9,9,0,0,"RECORTES CE",0
19,"19321",38,26,26,0,0,"RECORTES CE",0
19,"19031",15,10,9,0,1,"RECORTES CE",0
19,"19260",41,38,38,1,0,"RECORTES CE",0
19,"19278",29,28,28,2,0,"RECORTES CE",0
19,"19185",31,18,18,0,0,"RECORTES CE",0
19,"19022",632,477,468,3,9,"RECORTES CE",2
19,"19007",479,364,360,2,4,"RECORTES CE",0
19,"19201",59,51,51,1,0,"RECORTES CE",0
19,"19212",727,562,551,8,11,"RECORTES CE",1
19,"19168",297,227,224,2,3,"RECORTES CE",1
19,"19335",54,45,45,0,0,"RECORTES CE",0
19,"19198",17,10,10,0,0,"RECORTES CE",0
19,"19048",17,10,10,1,0,"RECORTES CE",0
19,"19123",44,38,38,0,0,"RECORTES CE",0
19,"19009",261,193,190,5,3,"RECORTES CE",0
19,"19057",72,53,52,0,1,"RECORTES CE",1
19,"19264",38,29,29,0,0,"RECORTES CE",0
19,"19008",37,28,28,0,0,"RECORTES CE",0
19,"19251",42,29,28,0,1,"RECORTES CE",0
19,"19173",47,40,37,0,3,"RECORTES CE",0
19,"19901",41,37,36,1,1,"RECORTES CE",0
19,"19104",18,13,13,1,0,"RECORTES CE",0
19,"19151",1075,779,764,5,15,"RECORTES CE",0
19,"19023",117,101,99,1,2,"RECORTES CE",0
19,"19005",95,71,69,1,2,"RECORTES CE",0
19,"19187",50,46,44,0,2,"RECORTES CE",0
19,"19116",13,11,11,0,0,"RECORTES CE",0
19,"19027",148,116,115,1,1,"RECORTES CE",1
19,"19175",34,26,26,1,0,"RECORTES CE",0
19,"19188",50,34,32,1,2,"RECORTES CE",0
19,"19171",4884,3824,3778,24,46,"RECORTES CE",7
19,"19252",67,58,58,0,0,"RECORTES CE",2
19,"19307",25,23,23,1,0,"RECORTES CE",0
19,"19281",22,18,18,0,0,"RECORTES CE",2
19,"19059",79,60,59,0,1,"RECORTES CE",0
19,"19261",38,25,25,0,0,"RECORTES CE",0
19,"19250",21,16,15,0,1,"RECORTES CE",0
19,"19325",128,89,88,0,1,"RECORTES CE",0
19,"19330",71,64,64,0,0,"RECORTES CE",0
19,"19241",46,35,35,1,0,"RECORTES CE",0
19,"19018",163,122,119,2,3,"RECORTES CE",0
19,"19115",24,14,14,1,0,"RECORTES CE",0
19,"19268",36,26,25,0,1,"RECORTES CE",0
19,"19044",309,248,246,3,2,"RECORTES CE",0
19,"19148",45,37,37,1,0,"RECORTES CE",0
19,"19308",65,54,54,0,0,"RECORTES CE",0
19,"19132",93,74,74,0,0,"RECORTES CE",1
19,"19259",28,18,18,0,0,"RECORTES CE",0
19,"19177",78,60,57,1,3,"RECORTES CE",0
19,"19080",73,51,50,0,1,"RECORTES CE",0
19,"19181",55,37,37,0,0,"RECORTES CE",0
19,"19079",8,7,7,0,0,"RECORTES CE",0
19,"19013",128,106,106,0,0,"RECORTES CE",0
19,"19155",66,54,53,0,1,"RECORTES CE",0
19,"19247",148,106,102,1,4,"RECORTES CE",1
19,"19245",1179,913,893,6,20,"RECORTES CE",0
19,"19157",57,45,45,0,0,"RECORTES CE",0
19,"19091",29,20,20,0,0,"RECORTES CE",0
19,"19297",31,21,21,1,0,"RECORTES CE",0
19,"19301",38,30,30,0,0,"RECORTES CE",0
19,"19332",93,68,68,0,0,"RECORTES CE",0
19,"19066",61,49,47,0,2,"RECORTES CE",0
19,"19302",58,45,45,1,0,"RECORTES CE",1
19,"19032",175,131,124,1,7,"RECORTES CE",0
19,"19327",431,348,342,3,6,"RECORTES CE",0
19,"19243",43,36,36,0,0,"RECORTES CE",0
19,"19060",150,115,114,1,1,"RECORTES CE",0
19,"19311",83,58,57,0,1,"RECORTES CE",0
19,"19076",31,20,20,0,0,"RECORTES CE",0
19,"19172",55,44,44,0,0,"RECORTES CE",0
19,"19111",158,123,121,0,2,"RECORTES CE",0
19,"19294",23,19,19,1,0,"RECORTES CE",0
19,"19146",42,34,34,0,0,"RECORTES CE",0
19,"19033",64,49,49,3,0,"RECORTES CE",0
19,"19237",47,35,34,1,1,"RECORTES CE",0
19,"19221",50,35,35,0,0,"RECORTES CE",0
19,"19304",220,161,161,1,0,"RECORTES CE",0
19,"19193",23,22,21,0,1,"RECORTES CE",0
19,"19055",53,34,33,2,1,"RECORTES CE",0
19,"19070",79,59,59,0,0,"RECORTES CE",0
19,"19287",144,109,109,0,0,"RECORTES CE",0
19,"19211",394,297,291,1,6,"RECORTES CE",0
19,"19110",57,46,45,2,1,"RECORTES CE",0
19,"19053",2024,1479,1464,13,15,"RECORTES CE",5
19,"19037",146,113,113,1,0,"RECORTES CE",0
19,"19272",72,59,59,1,0,"RECORTES CE",0
19,"19322",31,26,26,0,0,"RECORTES CE",0
19,"19020",43,27,26,2,1,"RECORTES CE",0
19,"19196",106,86,80,0,6,"RECORTES CE",1
19,"19024",8143,6017,5944,33,73,"RECORTES CE",14
19,"19291",1215,883,868,0,15,"RECORTES CE",3
19,"19050",15,13,13,0,0,"RECORTES CE",0
19,"19170",193,140,140,0,0,"RECORTES CE",0
19,"19179",72,52,52,1,0,"RECORTES CE",0
19,"19190",2405,1852,1833,14,19,"RECORTES CE",2
19,"19240",52,38,37,0,1,"RECORTES CE",0
19,"19160",899,601,597,2,4,"RECORTES CE",0
19,"19086",1495,1158,1149,7,9,"RECORTES CE",2
19,"19119",81,71,71,0,0,"RECORTES CE",0
19,"19197",25,20,20,0,0,"RECORTES CE",0
19,"19051",70,65,65,0,0,"RECORTES CE",0
19,"19162",65,49,49,0,0,"RECORTES CE",0
19,"19213",72,53,51,0,2,"RECORTES CE",0
45,"45182",1045,854,844,3,10,"RECORTES CE",0
45,"45093",151,117,117,0,0,"RECORTES CE",0
45,"45064",3839,2915,2884,19,31,"RECORTES CE",3
45,"45083",465,393,388,5,5,"RECORTES CE",2
45,"45101",3761,3090,3048,15,42,"RECORTES CE",6
45,"45026",225,171,169,1,2,"RECORTES CE",0
45,"45005",241,207,205,2,2,"RECORTES CE",0
45,"45186",3083,2369,2341,14,28,"RECORTES CE",2
45,"45059",1723,1413,1388,4,25,"RECORTES CE",0
45,"45043",793,663,655,1,8,"RECORTES CE",1
45,"45031",2723,1935,1896,10,39,"RECORTES CE",5
45,"45027",362,275,270,0,5,"RECORTES CE",0
45,"45040",1396,871,862,4,9,"RECORTES CE",1
45,"45120",134,105,105,1,0,"RECORTES CE",0
45,"45122",5164,4112,4067,18,45,"RECORTES CE",8
45,"45154",1483,1114,1107,5,7,"RECORTES CE",1
45,"45056",2210,1384,1370,11,14,"RECORTES CE",4
45,"45181",2313,1755,1728,12,27,"RECORTES CE",0
45,"45001",1852,1395,1355,9,40,"RECORTES CE",2
45,"45042",190,145,145,0,0,"RECORTES CE",1
45,"45107",3238,2628,2597,15,31,"RECORTES CE",2
45,"45066",7589,5716,5637,30,79,"RECORTES CE",7
45,"45011",288,246,241,1,5,"RECORTES CE",0
45,"45052",2914,2389,2372,23,17,"RECORTES CE",6
45,"45188",2783,2161,2127,9,34,"RECORTES CE",6
45,"45176",3665,2747,2712,15,35,"RECORTES CE",15
45,"45147",581,475,469,4,6,"RECORTES CE",1
45,"45138",1110,903,887,6,16,"RECORTES CE",3
45,"45199",2963,2055,2027,5,28,"RECORTES CE",6
45,"45008",142,114,114,2,0,"RECORTES CE",0
45,"45169",193,136,136,1,0,"RECORTES CE",1
45,"45113",1948,1409,1386,14,23,"RECORTES CE",2
45,"45148",307,229,219,1,10,"RECORTES CE",0
45,"45172",719,559,556,2,3,"RECORTES CE",0
45,"45124",2156,1750,1712,16,38,"RECORTES CE",4
45,"45901",769,577,571,1,6,"RECORTES CE",0
45,"45140",1093,885,876,4,9,"RECORTES CE",0
45,"45156",3441,2863,2825,13,38,"RECORTES CE",4
45,"45135",4302,3509,3453,21,56,"RECORTES CE",3
45,"45041",3725,2698,2665,18,33,"RECORTES CE",5
45,"45102",3629,2685,2644,15,41,"RECORTES CE",6
45,"45054",3995,2997,2968,8,29,"RECORTES CE",2
45,"45099",3512,2514,2459,9,55,"RECORTES CE",5
45,"45112",1939,1302,1268,6,34,"RECORTES CE",0
45,"45087",8345,6184,6091,34,93,"RECORTES CE",8
45,"45105",405,284,279,3,5,"RECORTES CE",0
45,"45157",2125,1531,1509,14,22,"RECORTES CE",5
45,"45084",2280,1777,1747,12,30,"RECORTES CE",1
45,"45183",2253,1581,1569,8,12,"RECORTES CE",3
45,"45125",2329,1920,1898,10,22,"RECORTES CE",2
45,"45187",4078,3405,3353,14,52,"RECORTES CE",2
45,"45092",233,197,194,0,3,"RECORTES CE",0
45,"45002",2549,1810,1784,7,26,"RECORTES CE",2
45,"45067",2324,1871,1841,13,30,"RECORTES CE",0
45,"45106",7524,5882,5784,55,98,"RECORTES CE",4
45,"45126",260,169,167,1,2,"RECORTES CE",0
45,"45160",1111,908,895,6,13,"RECORTES CE",2
45,"45193",626,543,530,2,13,"RECORTES CE",0
45,"45079",367,285,285,3,0,"RECORTES CE",0
45,"45184",201,124,123,1,1,"RECORTES CE",0
45,"45061",2457,1718,1699,7,19,"RECORTES CE",1
45,"45012",670,521,506,4,15,"RECORTES CE",0
45,"45029",205,169,169,0,0,"RECORTES CE",0
45,"45163",8338,6270,6142,57,128,"RECORTES CE",8
45,"45003",572,431,423,1,8,"RECORTES CE",2
45,"45035",298,225,221,2,4,"RECORTES CE",0
45,"45088",2102,1438,1423,4,15,"RECORTES CE",2
45,"45111",60,47,47,0,0,"RECORTES CE",0
45,"45062",1121,910,894,10,16,"RECORTES CE",0
45,"45024",1075,828,824,5,4,"RECORTES CE",1
45,"45094",395,312,308,0,4,"RECORTES CE",0
45,"45023",2160,1669,1654,9,15,"RECORTES CE",3
45,"45205",6745,4708,4657,35,51,"RECORTES CE",8
45,"45091",407,301,299,2,2,"RECORTES CE",0
45,"45025",1198,921,910,2,11,"RECORTES CE",0
45,"45063",428,320,310,2,10,"RECORTES CE",0
45,"45185",7734,6057,5973,27,84,"RECORTES CE",4
45,"45189",597,467,458,2,9,"RECORTES CE",2
45,"45051",1594,1264,1248,6,16,"RECORTES CE",4
45,"45167",1458,1197,1187,5,10,"RECORTES CE",1
45,"45141",897,735,727,4,8,"RECORTES CE",0
45,"45116",694,531,523,2,8,"RECORTES CE",1
45,"45139",172,135,133,0,2,"RECORTES CE",0
45,"45071",1863,1550,1530,8,20,"RECORTES CE",0
45,"45136",5859,4249,4177,24,72,"RECORTES CE",2
45,"45145",2539,1830,1811,11,19,"RECORTES CE",5
45,"45173",9477,7145,7061,40,84,"RECORTES CE",14
45,"45015",622,461,455,2,6,"RECORTES CE",1
45,"45174",309,247,247,1,0,"RECORTES CE",0
45,"45081",17646,13309,13166,72,143,"RECORTES CE",31
45,"45137",1623,1106,1093,9,13,"RECORTES CE",0
45,"45069",1876,1446,1428,8,18,"RECORTES CE",4
45,"45198",1832,1521,1508,6,13,"RECORTES CE",2
45,"45049",435,330,326,0,4,"RECORTES CE",0
45,"45146",108,85,85,0,0,"RECORTES CE",0
45,"45192",2503,2164,2141,7,23,"RECORTES CE",2
45,"45089",1516,1157,1139,6,18,"RECORTES CE",0
45,"45020",1313,1062,1046,5,16,"RECORTES CE",0
45,"45158",2534,1885,1868,8,17,"RECORTES CE",1
45,"45070",1461,1223,1202,7,21,"RECORTES CE",2
45,"45114",595,461,457,1,4,"RECORTES CE",0
45,"45016",4179,3290,3268,30,22,"RECORTES CE",8
45,"45028",3680,2919,2880,23,39,"RECORTES CE",2
45,"45127",708,524,519,1,5,"RECORTES CE",2
45,"45078",1392,1187,1179,8,8,"RECORTES CE",0
45,"45065",276,227,223,0,4,"RECORTES CE",0
45,"45017",262,221,219,0,2,"RECORTES CE",0
45,"45115",2563,2089,2048,5,41,"RECORTES CE",2
45,"45050",471,354,351,2,3,"RECORTES CE",1
45,"45074",412,327,322,0,5,"RECORTES CE",2
45,"45123",3075,2261,2222,11,39,"RECORTES CE",3
45,"45021",2459,1862,1833,21,29,"RECORTES CE",4
45,"45144",794,643,640,2,3,"RECORTES CE",0
45,"45009",545,336,333,1,3,"RECORTES CE",0
45,"45103",397,325,322,0,3,"RECORTES CE",0
45,"45018",495,352,348,0,4,"RECORTES CE",2
45,"45152",597,476,476,2,0,"RECORTES CE",1
45,"45197",1921,1500,1480,12,20,"RECORTES CE",1
45,"45095",697,529,520,1,9,"RECORTES CE",1
45,"45128",2498,1794,1774,7,20,"RECORTES CE",0
45,"45104",440,345,341,1,4,"RECORTES CE",0
45,"45076",574,382,378,1,4,"RECORTES CE",1
45,"45080",6,6,6,0,0,"RECORTES CE",0
45,"45177",2142,1757,1731,11,26,"RECORTES CE",2
45,"45097",1047,877,869,3,8,"RECORTES CE",1
45,"45133",2818,2184,2146,19,38,"RECORTES CE",4
45,"45019",7356,5539,5484,35,55,"RECORTES CE",13
45,"45060",179,131,129,1,2,"RECORTES CE",0
45,"45068",173,138,135,0,3,"RECORTES CE",0
45,"45149",573,486,484,0,2,"RECORTES CE",2
45,"45022",392,297,293,8,4,"RECORTES CE",0
45,"45162",683,515,510,0,5,"RECORTES CE",2
45,"45007",697,566,560,1,6,"RECORTES CE",1
45,"45150",454,366,364,1,2,"RECORTES CE",0
45,"45118",2002,1470,1456,3,14,"RECORTES CE",1
45,"45085",1501,1086,1067,6,19,"RECORTES CE",1
45,"45179",546,406,403,3,3,"RECORTES CE",0
45,"45110",1799,1394,1380,4,14,"RECORTES CE",0
45,"45180",2725,2060,2028,7,32,"RECORTES CE",2
45,"45004",568,436,430,1,6,"RECORTES CE",1
45,"45134",1600,1214,1200,4,14,"RECORTES CE",0
45,"45151",586,444,437,1,7,"RECORTES CE",0
45,"45159",86,75,72,1,3,"RECORTES CE",0
45,"45086",503,375,369,3,6,"RECORTES CE",0
45,"45046",2421,1815,1796,8,19,"RECORTES CE",0
45,"45143",1180,924,912,3,12,"RECORTES CE",0
45,"45058",384,304,301,4,3,"RECORTES CE",2
45,"45037",1635,1216,1202,4,14,"RECORTES CE",1
45,"45201",3450,2212,2173,14,39,"RECORTES CE",5
45,"45108",521,415,414,2,1,"RECORTES CE",0
45,"45164",186,160,160,0,0,"RECORTES CE",0
45,"45013",1786,1428,1412,7,16,"RECORTES CE",2
45,"45131",287,242,242,0,0,"RECORTES CE",0
45,"45033",351,253,247,3,6,"RECORTES CE",2
45,"45168",62226,48889,48446,327,443,"RECORTES CE",88
45,"45132",2096,1631,1616,7,15,"RECORTES CE",2
45,"45075",146,108,105,0,3,"RECORTES CE",0
45,"45200",4627,3678,3588,29,90,"RECORTES CE",3
45,"45142",7858,6249,6164,57,85,"RECORTES CE",4
45,"45100",197,166,164,2,2,"RECORTES CE",1
45,"45048",360,281,277,1,4,"RECORTES CE",0
45,"45030",482,364,361,4,3,"RECORTES CE",0
45,"45109",2913,2295,2218,16,77,"RECORTES CE",5
45,"45010",436,335,333,2,2,"RECORTES CE",0
45,"45190",483,397,387,2,10,"RECORTES CE",0
45,"45161",13474,9618,9496,63,122,"RECORTES CE",33
45,"45055",1032,857,841,2,16,"RECORTES CE",1
45,"45191",549,477,475,0,2,"RECORTES CE",0
45,"45072",670,499,499,2,0,"RECORTES CE",2
45,"45165",62857,46607,46141,313,466,"RECORTES CE",94
45,"45204",643,519,513,0,6,"RECORTES CE",0
45,"45073",307,238,235,0,3,"RECORTES CE",0
45,"45082",1246,1046,1036,9,10,"RECORTES CE",0
45,"45171",1382,1090,1075,4,15,"RECORTES CE",1
45,"45036",658,500,496,2,4,"RECORTES CE",0
45,"45166",1629,1345,1332,5,13,"RECORTES CE",0
45,"45130",319,258,252,1,6,"RECORTES CE",0
45,"45045",1316,945,935,1,10,"RECORTES CE",2
45,"45096",1015,832,817,7,15,"RECORTES CE",2
45,"45121",6766,4860,4798,30,62,"RECORTES CE",5
45,"45090",376,299,295,4,4,"RECORTES CE",0
45,"45098",2186,1686,1649,10,37,"RECORTES CE",1
45,"45202",3905,2962,2920,12,42,"RECORTES CE",1
45,"45175",665,541,532,5,9,"RECORTES CE",0
45,"45196",1388,1066,1054,13,12,"RECORTES CE",0
45,"45032",436,317,313,0,4,"RECORTES CE",1
45,"45014",3984,2824,2802,24,22,"RECORTES CE",7
45,"45038",3335,2525,2490,8,35,"RECORTES CE",4
45,"45119",3348,2306,2264,14,42,"RECORTES CE",9
45,"45039",226,197,193,1,4,"RECORTES CE",0
45,"45077",542,428,423,0,5,"RECORTES CE",2
45,"45195",2161,1709,1686,12,23,"RECORTES CE",0
45,"45053",8045,6446,6370,44,76,"RECORTES CE",7
45,"45203",2574,1938,1908,10,30,"RECORTES CE",6
45,"45170",235,183,176,4,7,"RECORTES CE",0
45,"45057",221,187,182,0,5,"RECORTES CE",0
45,"45034",1360,1098,1083,4,15,"RECORTES CE",0
45,"45006",1425,1022,1013,4,9,"RECORTES CE",3
45,"45153",1613,1263,1248,11,15,"RECORTES CE",3
45,"45129",136,100,97,0,3,"RECORTES CE",0
45,"45117",754,610,602,2,8,"RECORTES CE",2
45,"45155",371,297,296,1,1,"RECORTES CE",0
45,"45194",67,50,49,0,1,"RECORTES CE",0
45,"45047",2563,1775,1751,13,24,"RECORTES CE",3
18,"18089",15132,10489,10402,64,87,"RECORTES CE",14
18,"18175",11624,8549,8467,41,82,"RECORTES CE",7
18,"18183",660,468,465,3,3,"RECORTES CE",0
18,"18170",336,227,225,1,2,"RECORTES CE",0
18,"18910",803,573,569,5,4,"RECORTES CE",2
18,"18105",4548,3169,3139,19,30,"RECORTES CE",2
18,"18173",8978,6319,6251,50,68,"RECORTES CE",7
18,"18182",1919,1356,1347,3,9,"RECORTES CE",1
18,"18056",3545,2716,2687,25,29,"RECORTES CE",3
18,"18057",5263,3968,3937,33,31,"RECORTES CE",3
18,"18063",1191,770,767,6,3,"RECORTES CE",0
18,"18049",617,456,451,3,5,"RECORTES CE",0
18,"18088",1556,1113,1108,5,5,"RECORTES CE",0
18,"18042",414,342,341,0,1,"RECORTES CE",1
18,"18024",855,660,653,8,7,"RECORTES CE",3
18,"18064",379,308,308,1,0,"RECORTES CE",0
18,"18103",760,596,593,6,3,"RECORTES CE",0
18,"18059",4153,3074,3039,23,35,"RECORTES CE",1
18,"18112",131,88,86,1,2,"RECORTES CE",0
18,"18176",258,179,178,3,1,"RECORTES CE",0
18,"18134",5811,4002,3946,25,56,"RECORTES CE",34
18,"18127",16586,11998,11897,97,101,"RECORTES CE",29
18,"18174",442,354,348,2,6,"RECORTES CE",0
18,"18004",724,511,505,3,6,"RECORTES CE",0
18,"18902",847,680,674,10,6,"RECORTES CE",0
18,"18163",324,239,235,1,4,"RECORTES CE",0
18,"18179",546,378,377,1,1,"RECORTES CE",0
18,"18099",1581,1271,1249,10,22,"RECORTES CE",1
18,"18018",640,490,488,0,2,"RECORTES CE",4
18,"18189",772,599,595,7,4,"RECORTES CE",1
18,"18171",2123,1640,1616,14,24,"RECORTES CE",1
18,"18185",556,461,461,1,0,"RECORTES CE",1
18,"18002",561,446,444,1,2,"RECORTES CE",0
18,"18122",16171,11670,11508,106,162,"RECORTES CE",6
18,"18013",4236,3108,3052,19,56,"RECORTES CE",5
18,"18047",5888,4028,4000,32,28,"RECORTES CE",11
18,"18124",393,274,271,1,3,"RECORTES CE",0
18,"18023",15738,11242,11146,92,96,"RECORTES CE",12
18,"18145",10432,7829,7767,56,62,"RECORTES CE",10
18,"18180",631,448,447,2,1,"RECORTES CE",0
18,"18083",266,210,207,1,3,"RECORTES CE",0
18,"18068",1566,1234,1214,5,20,"RECORTES CE",1
18,"18061",1059,822,816,1,6,"RECORTES CE",0
18,"18913",818,617,603,2,14,"RECORTES CE",0
18,"18908",805,633,620,2,13,"RECORTES CE",2
18,"18111",2743,2046,2033,14,13,"RECORTES CE",1
18,"18015",443,338,337,0,1,"RECORTES CE",0
18,"18904",779,570,565,1,5,"RECORTES CE",1
18,"18007",785,527,523,3,4,"RECORTES CE",1
18,"18193",14194,10280,10196,91,84,"RECORTES CE",10
18,"18178",743,571,571,2,0,"RECORTES CE",0
18,"18097",956,703,691,1,12,"RECORTES CE",1
18,"18137",1005,758,758,6,0,"RECORTES CE",0
18,"18046",1867,1225,1215,8,10,"RECORTES CE",0
18,"18025",294,216,214,0,2,"RECORTES CE",0
18,"18017",18172,12077,11954,101,123,"RECORTES CE",11
18,"18069",493,366,363,3,3,"RECORTES CE",2
18,"18147",3734,2416,2386,10,30,"RECORTES CE",1
18,"18165",4135,2944,2915,23,29,"RECORTES CE",1
18,"18184",2158,1659,1634,4,25,"RECORTES CE",1
18,"18143",979,781,776,2,5,"RECORTES CE",2
18,"18030",584,428,426,3,2,"RECORTES CE",0
18,"18121",132,101,100,1,1,"RECORTES CE",0
18,"18053",1667,1084,1078,9,6,"RECORTES CE",1
18,"18164",1831,1273,1260,11,13,"RECORTES CE",0
18,"18109",599,421,419,2,2,"RECORTES CE",0
18,"18022",13306,9165,9091,51,74,"RECORTES CE",7
18,"18070",283,223,218,0,5,"RECORTES CE",0
18,"18020",1469,1046,1032,7,14,"RECORTES CE",0
18,"18187",561,418,417,1,1,"RECORTES CE",1
18,"18036",3768,2904,2882,18,22,"RECORTES CE",4
18,"18071",5583,4221,4176,33,45,"RECORTES CE",8
18,"18035",1255,964,958,4,6,"RECORTES CE",0
18,"18158",8408,5604,5542,38,62,"RECORTES CE",0
18,"18027",2562,1846,1827,19,19,"RECORTES CE",0
18,"18003",14022,10417,10330,82,87,"RECORTES CE",12
18,"18087",184873,138280,137516,836,764,"RECORTES CE",196
18,"18167",1897,1321,1313,8,8,"RECORTES CE",0
18,"18907",1859,1482,1475,5,7,"RECORTES CE",1
18,"18067",711,517,516,0,1,"RECORTES CE",1
18,"18045",1149,803,789,10,14,"RECORTES CE",1
18,"18085",729,489,484,2,5,"RECORTES CE",0
18,"18126",1497,1094,1087,7,7,"RECORTES CE",1
18,"18102",8424,5783,5716,41,67,"RECORTES CE",5
18,"18181",223,159,157,0,2,"RECORTES CE",0
18,"18006",4161,2816,2788,29,28,"RECORTES CE",1
18,"18136",1875,1477,1470,7,7,"RECORTES CE",1
18,"18153",8580,6314,6260,39,54,"RECORTES CE",9
18,"18005",375,266,265,2,1,"RECORTES CE",0
18,"18133",2187,1731,1722,7,9,"RECORTES CE",0
18,"18117",513,402,396,4,6,"RECORTES CE",0
18,"18062",10298,7584,7512,67,72,"RECORTES CE",10
18,"18029",1833,1252,1243,9,9,"RECORTES CE",0
18,"18050",1711,1271,1256,5,15,"RECORTES CE",3
18,"18028",945,790,781,2,9,"RECORTES CE",0
18,"18010",563,463,459,4,4,"RECORTES CE",0
18,"18119",1729,1353,1340,13,13,"RECORTES CE",3
18,"18093",2752,1873,1858,10,15,"RECORTES CE",1
18,"18048",2390,1824,1806,8,18,"RECORTES CE",1
18,"18001",256,178,177,2,1,"RECORTES CE",0
18,"18906",917,681,673,2,8,"RECORTES CE",0
18,"18037",530,411,408,1,3,"RECORTES CE",1
18,"18044",179,116,116,0,0,"RECORTES CE",0
18,"18051",1149,825,823,7,2,"RECORTES CE",11
18,"18144",782,596,588,3,8,"RECORTES CE",1
18,"18138",2482,1721,1712,8,9,"RECORTES CE",0
18,"18162",951,744,734,0,10,"RECORTES CE",2
18,"18098",6167,4367,4342,22,25,"RECORTES CE",3
18,"18911",7392,5359,5301,44,58,"RECORTES CE",6
18,"18065",625,503,500,1,3,"RECORTES CE",0
18,"18161",220,184,184,1,0,"RECORTES CE",0
18,"18141",414,282,277,1,5,"RECORTES CE",1
18,"18011",4321,3136,3119,10,17,"RECORTES CE",11
18,"18912",1488,1021,1007,7,14,"RECORTES CE",0
18,"18192",1529,1216,1208,3,8,"RECORTES CE",0
18,"18177",427,259,258,3,1,"RECORTES CE",0
18,"18150",6730,4858,4814,28,44,"RECORTES CE",3
18,"18168",809,589,588,5,1,"RECORTES CE",0
18,"18066",2108,1546,1540,4,6,"RECORTES CE",0
18,"18146",970,734,727,6,7,"RECORTES CE",1
18,"18043",129,95,95,0,0,"RECORTES CE",0
18,"18116",2882,2245,2215,19,30,"RECORTES CE",2
18,"18151",260,196,196,0,0,"RECORTES CE",1
18,"18101",9263,6971,6912,55,59,"RECORTES CE",15
18,"18079",3465,2671,2645,16,26,"RECORTES CE",4
18,"18016",323,239,237,0,2,"RECORTES CE",0
18,"18040",225,142,141,0,1,"RECORTES CE",0
18,"18082",867,626,621,4,5,"RECORTES CE",0
18,"18114",634,457,452,2,5,"RECORTES CE",0
18,"18074",273,217,213,2,4,"RECORTES CE",0
18,"18159",1009,811,802,3,9,"RECORTES CE",0
18,"18107",971,719,711,6,8,"RECORTES CE",4
18,"18021",17451,12420,12305,101,115,"RECORTES CE",17
18,"18188",1642,1249,1234,8,15,"RECORTES CE",1
18,"18033",294,220,219,1,1,"RECORTES CE",1
18,"18132",3312,2582,2556,14,26,"RECORTES CE",0
18,"18123",293,228,227,2,1,"RECORTES CE",0
18,"18148",819,671,666,1,5,"RECORTES CE",1
18,"18076",815,577,576,0,1,"RECORTES CE",0
18,"18903",892,650,645,1,5,"RECORTES CE",0
18,"18914",1658,1304,1290,8,14,"RECORTES CE",0
18,"18128",344,251,248,0,3,"RECORTES CE",0
18,"18152",938,687,681,1,6,"RECORTES CE",1
18,"18096",342,260,259,1,1,"RECORTES CE",0
18,"18012",2330,1670,1660,15,10,"RECORTES CE",0
18,"18905",14500,10137,10058,82,79,"RECORTES CE",14
18,"18094",2389,1853,1832,22,21,"RECORTES CE",1
18,"18072",666,481,474,4,7,"RECORTES CE",0
18,"18108",858,672,667,0,5,"RECORTES CE",0
18,"18100",7769,5715,5637,57,78,"RECORTES CE",10
18,"18149",5177,3946,3902,29,44,"RECORTES CE",3
18,"18120",270,218,216,2,2,"RECORTES CE",0
18,"18086",355,285,283,0,2,"RECORTES CE",1
18,"18014",6372,4620,4566,44,54,"RECORTES CE",6
18,"18054",868,630,627,2,3,"RECORTES CE",0
18,"18154",1016,716,716,2,0,"RECORTES CE",0
18,"18901",512,359,357,1,2,"RECORTES CE",0
18,"18095",1959,1486,1474,5,12,"RECORTES CE",1
18,"18084",4215,3179,3143,24,36,"RECORTES CE",1
18,"18039",3544,2544,2511,34,33,"RECORTES CE",6
18,"18115",2548,1872,1854,16,18,"RECORTES CE",1
18,"18032",239,178,175,0,3,"RECORTES CE",0
18,"18140",43567,29155,28932,194,223,"RECORTES CE",36
18,"18038",1066,836,826,2,10,"RECORTES CE",0
18,"18078",739,593,590,4,3,"RECORTES CE",0
18,"18194",2152,1487,1477,6,10,"RECORTES CE",4
18,"18034",510,391,391,1,0,"RECORTES CE",0
18,"18909",589,462,459,0,3,"RECORTES CE",0
18,"18135",4583,3045,2998,14,47,"RECORTES CE",3
18,"18157",1123,836,823,8,13,"RECORTES CE",0
28,"28047",40783,31308,31072,171,236,"VOX",165
28,"28044",5766,4623,4584,22,39,"VOX",36
28,"28156",998,751,743,3,8,"VOX",2
28,"28055",899,682,676,4,6,"VOX",1
28,"28003",181,141,141,3,0,"VOX",3
28,"28087",3176,2545,2528,15,17,"VOX",35
28,"28078",36,34,34,0,0,"VOX",1
28,"28012",883,702,691,4,11,"VOX",2
28,"28064",134,105,105,0,0,"VOX",0
28,"28147",968,751,745,2,6,"VOX",4
28,"28026",6237,4893,4853,32,40,"VOX",39
28,"28036",2514,1974,1949,12,25,"VOX",5
28,"28091",5436,3827,3786,23,41,"VOX",6
28,"28068",10928,8389,8315,43,74,"VOX",80
28,"28021",544,387,387,2,0,"VOX",2
28,"28037",1566,1175,1168,5,7,"VOX",3
28,"28067",4057,3220,3188,12,32,"VOX",12
28,"28013",40409,30141,29905,164,236,"VOX",129
28,"28045",33019,25531,25313,146,218,"VOX",140
28,"28126",39,25,25,0,0,"VOX",0
28,"28166",318,258,255,1,3,"VOX",2
28,"28040",15691,10833,10728,45,105,"VOX",40
28,"28049",58688,48006,47660,286,346,"VOX",107
28,"28082",5664,4526,4492,25,34,"VOX",16
28,"28042",1153,882,874,5,8,"VOX",5
28,"28094",825,636,634,3,2,"VOX",3
28,"28117",95,84,84,0,0,"VOX",0
28,"28019",1237,952,938,2,14,"VOX",7
28,"28148",85022,65597,65111,368,486,"VOX",193
28,"28121",198,166,164,2,2,"VOX",2
28,"28073",12505,9485,9384,64,101,"VOX",34
28,"28053",6458,5299,5263,29,36,"VOX",19
28,"28151",3143,2352,2314,6,38,"VOX",11
28,"28902",468,352,347,2,5,"VOX",0
28,"28075",5581,4380,4350,15,30,"VOX",7
28,"28016",80,57,57,0,0,"VOX",1
28,"28095",1508,1177,1167,6,10,"VOX",5
28,"28080",48226,39753,39570,172,183,"VOX",413
28,"28046",4432,3562,3538,19,24,"VOX",12
28,"28181",20344,16669,16572,95,97,"VOX",138
28,"28031",2055,1538,1519,4,19,"VOX",2
28,"28107",435,326,321,0,5,"VOX",0
28,"28127",64513,53125,52932,300,193,"VOX",551
28,"28179",1441,1082,1071,7,11,"VOX",4
28,"28015",18233,14725,14653,81,72,"VOX",71
28,"28140",2981,2383,2357,14,26,"VOX",8
28,"28158",662,545,543,3,2,"VOX",3
28,"28182",214,174,170,0,4,"VOX",1
28,"28009",14046,11014,10932,51,82,"VOX",64
28,"28056",860,653,647,6,6,"VOX",0
28,"28072",5657,4465,4441,20,24,"VOX",37
28,"28176",12288,9809,9763,50,46,"VOX",98
28,"28028",1730,1347,1326,8,21,"VOX",3
28,"28115",60579,50819,50657,246,162,"VOX",548
28,"28002",2966,2186,2175,9,11,"VOX",20
28,"28128",439,323,320,2,3,"VOX",0
28,"28170",2486,1757,1740,9,17,"VOX",6
28,"28096",18161,13784,13647,57,137,"VOX",40
28,"28130",28243,22649,22458,135,191,"VOX",61
28,"28125",2965,2210,2188,13,22,"VOX",9
28,"28090",8405,6792,6751,34,41,"VOX",30
28,"28086",5055,3627,3600,21,27,"VOX",28
28,"28006",78564,61796,61456,334,340,"VOX",427
28,"28025",427,329,326,1,3,"VOX",1
28,"28131",12971,9828,9755,57,73,"VOX",127
28,"28061",21200,16698,16600,75,98,"VOX",169
28,"28048",499,406,401,2,5,"VOX",2
28,"28108",3330,2536,2528,17,8,"VOX",17
28,"28157",595,448,442,1,6,"VOX",2
28,"28178",1066,850,846,2,4,"VOX",2
28,"28099",1731,1283,1278,8,5,"VOX",3
28,"28034",352,270,269,1,1,"VOX",1
28,"28174",1788,1277,1267,2,10,"VOX",6
28,"28123",56464,47181,46948,257,233,"VOX",141
28,"28146",1773,1274,1262,9,12,"VOX",4
28,"28010",9853,7959,7914,35,45,"VOX",62
28,"28004",6179,4377,4345,15,32,"VOX",23
28,"28168",1226,910,900,1,10,"VOX",3
28,"28017",1210,954,943,6,11,"VOX",8
28,"28171",4238,3002,2962,18,40,"VOX",3
28,"28069",54,43,43,1,0,"VOX",0
28,"28005",134211,104575,103819,667,756,"VOX",598
28,"28024",152,129,128,1,1,"VOX",1
28,"28149",5653,4516,4469,19,47,"VOX",14
28,"28052",3883,2801,2758,18,43,"VOX",9
28,"28089",3703,2961,2933,19,28,"VOX",9
28,"28038",4935,3858,3815,17,43,"VOX",11
28,"28159",588,469,468,6,1,"VOX",1
28,"28033",3824,2854,2832,11,22,"VOX",7
28,"28119",2074,1641,1625,9,16,"VOX",3
28,"28173",520,409,408,3,1,"VOX",1
28,"28100",4169,3076,3048,12,28,"VOX",9
28,"28180",5242,4040,3999,11,41,"VOX",11
28,"28141",5806,4532,4486,24,46,"VOX",23
28,"28160",8227,6295,6251,26,44,"VOX",39
28,"28020",148,99,97,1,2,"VOX",0
28,"28093",2043,1681,1661,9,20,"VOX",19
28,"28074",138742,110456,109579,581,877,"VOX",375
28,"28065",125384,101604,100872,477,732,"VOX",357
28,"28054",11166,8649,8584,36,65,"VOX",113
28,"28183",1050,770,763,2,7,"VOX",5
28,"28008",1768,1293,1282,4,11,"VOX",6
28,"28167",8308,6605,6545,35,60,"VOX",16
28,"28007",124358,99423,98711,554,712,"VOX",554
28,"28092",151511,117869,116968,641,901,"VOX",449
28,"28085",3908,3106,3078,7,28,"VOX",5
28,"28066",7175,5598,5561,28,37,"VOX",31
28,"28113",34305,27077,26881,156,196,"VOX",81
28,"28097",124,85,84,1,1,"VOX",0
28,"28039",130,97,97,0,0,"VOX",0
28,"28106",76612,56555,56006,346,549,"VOX",179
28,"28155",507,420,420,0,0,"VOX",0
28,"28041",4452,3572,3550,24,22,"VOX",16
28,"28043",5922,4063,4008,29,55,"VOX",10
28,"28163",438,357,354,1,3,"VOX",3
28,"28023",4697,3835,3817,20,18,"VOX",23
28,"28135",971,740,735,4,5,"VOX",2
28,"28109",1591,1113,1111,3,2,"VOX",3
28,"28137",1644,1301,1283,7,18,"VOX",3
28,"28175",850,696,692,2,4,"VOX",1
28,"28903",32480,27640,27525,161,115,"VOX",212
28,"28011",445,339,338,0,1,"VOX",3
28,"28076",406,322,319,1,3,"VOX",2
28,"28114",149,103,103,1,0,"VOX",0
28,"28083",8880,6801,6759,47,42,"VOX",25
28,"28058",139289,108214,107323,612,891,"VOX",283
28,"28143",70,59,59,1,0,"VOX",0
28,"28014",32852,24749,24571,120,178,"VOX",60
28,"28060",1509,1194,1183,8,11,"VOX",3
28,"28022",32949,27473,27379,169,94,"VOX",293
28,"28122",518,388,385,2,3,"VOX",3
28,"28154",5420,3966,3899,17,67,"VOX",9
28,"28901",789,590,584,2,6,"VOX",1
28,"28169",1427,1164,1158,1,6,"VOX",17
28,"28101",218,180,180,0,0,"VOX",0
28,"28134",60511,47566,47229,233,337,"VOX",190
28,"28138",69,54,54,0,0,"VOX",0
28,"28071",60,47,46,0,1,"VOX",0
28,"28150",3084,2415,2381,13,34,"VOX",6
28,"28063",252,195,194,2,1,"VOX",2
28,"28030",1716,1342,1316,2,26,"VOX",5
28,"28084",15839,12028,11925,53,103,"VOX",29
28,"28152",16026,13269,13202,46,67,"VOX",139
28,"28070",119,91,91,0,0,"VOX",0
28,"28079",2371327,1817203,1806970,9067,10233,"VOX",13327
28,"28118",58,49,48,1,1,"VOX",1
28,"28027",1199,897,882,5,15,"VOX",1
28,"28059",4312,3256,3237,11,19,"VOX",17
28,"28132",11645,8605,8520,55,85,"VOX",27
28,"28029",530,426,424,3,2,"VOX",1
28,"28164",2986,2281,2263,12,18,"VOX",20
28,"28144",5929,4776,4744,29,32,"VOX",27
28,"28035",1362,1042,1033,3,9,"VOX",4
28,"28133",6002,4259,4204,12,55,"VOX",18
28,"28088",262,180,179,2,1,"VOX",0
28,"28057",1439,1125,1120,5,5,"VOX",3
28,"28177",10192,8271,8234,51,37,"VOX",61
28,"28153",703,510,507,2,3,"VOX",4
28,"28032",4749,3653,3607,19,46,"VOX",21
28,"28102",881,659,650,3,9,"VOX",1
28,"28111",592,489,483,0,6,"VOX",5
28,"28062",308,244,241,3,3,"VOX",1
28,"28120",1217,918,904,4,14,"VOX",6
28,"28136",640,540,532,0,8,"VOX",3
28,"28104",13836,11414,11349,54,65,"VOX",71
28,"28112",167,132,132,0,0,"VOX",0
28,"28124",76,56,54,0,2,"VOX",0
28,"28161",48368,37462,37161,190,301,"VOX",181
28,"28129",7913,6175,6124,30,51,"VOX",30
28,"28162",2549,2039,2025,13,14,"VOX",16
28,"28001",64,48,48,3,0,"VOX",0
28,"28050",4077,3032,3006,15,26,"VOX",20
28,"28145",2370,1824,1809,12,15,"VOX",8
28,"28018",3739,3071,3046,12,25,"VOX",9
28,"28165",1788,1332,1321,5,11,"VOX",2
28,"28051",1542,1240,1232,5,8,"VOX",7
28,"28110",1949,1543,1525,2,18,"VOX",5
28,"28116",700,544,544,3,0,"VOX",2
28,"28172",8965,7255,7219,44,36,"VOX",23
29,"29066",346,252,251,2,1,"RECORTES CE",0
29,"29048",1428,1168,1155,9,13,"RECORTES CE",0
29,"29080",6704,4812,4766,44,46,"RECORTES CE",2
29,"29062",658,564,561,0,3,"RECORTES CE",0
29,"29039",2662,1948,1931,22,17,"RECORTES CE",0
29,"29061",1018,833,820,4,13,"RECORTES CE",0
29,"29038",17555,11638,11562,124,76,"RECORTES CE",25
29,"29034",466,361,359,0,2,"RECORTES CE",0
29,"29089",3254,2465,2438,10,27,"RECORTES CE",3
29,"29040",1964,1321,1301,12,20,"RECORTES CE",3
29,"29087",380,283,276,1,7,"RECORTES CE",0
29,"29082",31505,23154,22990,127,164,"RECORTES CE",30
29,"29050",425,313,309,1,4,"RECORTES CE",0
29,"29067",424770,295944,294094,2117,1850,"RECORTES CE",473
29,"29096",2806,2065,2034,19,31,"RECORTES CE",3
29,"29064",506,372,365,2,7,"RECORTES CE",0
29,"29060",706,524,516,0,8,"RECORTES CE",0
29,"29004",328,240,238,2,2,"RECORTES CE",1
29,"29042",14078,9890,9776,75,114,"RECORTES CE",21
29,"29023",2047,1385,1369,2,16,"RECORTES CE",1
29,"29097",4117,2996,2947,43,49,"RECORTES CE",1
29,"29044",811,557,556,3,1,"RECORTES CE",0
29,"29014",219,138,138,1,0,"RECORTES CE",1
29,"29063",336,255,251,2,4,"RECORTES CE",0
29,"29011",2920,1962,1946,5,16,"RECORTES CE",0
29,"29015",31884,23160,22943,188,217,"RECORTES CE",15
29,"29059",2590,2100,2058,11,42,"RECORTES CE",0
29,"29065",194,134,134,1,0,"RECORTES CE",1
29,"29043",2503,1671,1638,17,33,"RECORTES CE",1
29,"29075",12952,8681,8619,55,62,"RECORTES CE",1
29,"29051",40201,27168,26842,229,326,"RECORTES CE",30
29,"29052",226,155,152,0,3,"RECORTES CE",0
29,"29083",2114,1587,1568,10,19,"RECORTES CE",3
29,"29049",2987,2204,2185,25,19,"RECORTES CE",0
29,"29025",39210,26938,26747,160,191,"RECORTES CE",21
29,"29045",1685,1232,1223,4,9,"RECORTES CE",1
29,"29046",2690,1974,1954,17,20,"RECORTES CE",2
29,"29031",1633,1115,1106,6,9,"RECORTES CE",3
29,"29032",6708,5341,5265,26,76,"RECORTES CE",1
29,"29090",1704,1174,1165,10,9,"RECORTES CE",2
29,"29053",1702,1178,1160,17,18,"RECORTES CE",1
29,"29003",1002,777,769,1,8,"RECORTES CE",0
29,"29012",9765,7029,6944,58,85,"RECORTES CE",3
29,"29013",1612,1282,1272,6,10,"RECORTES CE",2
29,"29070",39913,26993,26751,203,242,"RECORTES CE",68
29,"29016",253,188,188,1,0,"RECORTES CE",0
29,"29022",185,143,143,1,0,"RECORTES CE",0
29,"29099",960,741,734,3,7,"RECORTES CE",0
29,"29035",1587,1218,1208,0,10,"RECORTES CE",0
29,"29100",2437,1775,1760,12,15,"RECORTES CE",4
29,"29007",27319,19557,19395,179,162,"RECORTES CE",18
29,"29017",6610,5001,4938,25,63,"RECORTES CE",1
29,"29081",258,205,200,1,5,"RECORTES CE",0
29,"29088",2720,1930,1883,21,47,"RECORTES CE",0
29,"29054",41888,29228,29022,205,206,"RECORTES CE",44
29,"29071",938,640,633,6,7,"RECORTES CE",1
29,"29091",8966,6437,6346,57,91,"RECORTES CE",4
29,"29036",636,481,475,3,6,"RECORTES CE",2
29,"29068",6885,4580,4511,43,69,"RECORTES CE",1
29,"29008",14541,9954,9820,90,134,"RECORTES CE",4
29,"29033",1132,808,804,2,4,"RECORTES CE",1
29,"29005",4342,2946,2908,22,38,"RECORTES CE",2
29,"29079",2444,1880,1846,3,34,"RECORTES CE",0
29,"29098",1257,991,977,12,14,"RECORTES CE",1
29,"29086",795,497,490,3,7,"RECORTES CE",0
29,"29092",567,423,415,4,8,"RECORTES CE",1
29,"29069",85333,56398,55854,443,544,"RECORTES CE",67
29,"29027",2343,1737,1722,6,15,"RECORTES CE",0
29,"29024",393,271,256,4,15,"RECORTES CE",0
29,"29055",1808,1415,1396,13,19,"RECORTES CE",1
29,"29056",1107,815,807,8,8,"RECORTES CE",0
29,"29018",2026,1560,1519,15,41,"RECORTES CE",1
29,"29026",1065,776,766,4,10,"RECORTES CE",0
29,"29006",680,482,474,3,8,"RECORTES CE",0
29,"29041",3146,2251,2216,26,35,"RECORTES CE",4
29,"29076",2163,1508,1482,8,26,"RECORTES CE",1
29,"29009",1477,1113,1100,3,13,"RECORTES CE",0
29,"29073",1560,1126,1120,5,6,"RECORTES CE",0
29,"29902",2560,1735,1709,13,26,"RECORTES CE",0
29,"29093",2235,1689,1667,12,22,"RECORTES CE",2
29,"29028",1249,881,881,4,0,"RECORTES CE",2
29,"29019",888,675,672,0,3,"RECORTES CE",0
29,"29047",1131,927,914,4,13,"RECORTES CE",2
29,"29037",212,166,165,1,1,"RECORTES CE",0
29,"29010",1667,1336,1310,1,26,"RECORTES CE",1
29,"29084",27393,19096,18886,192,210,"RECORTES CE",14
29,"29903",525,394,389,2,5,"RECORTES CE",1
29,"29085",151,99,98,1,1,"RECORTES CE",0
29,"29077",208,156,153,0,3,"RECORTES CE",0
29,"29074",785,612,611,4,1,"RECORTES CE",0
29,"29029",420,322,315,4,7,"RECORTES CE",0
29,"29057",376,285,284,2,1,"RECORTES CE",0
29,"29001",4196,3276,3253,26,23,"RECORTES CE",1
29,"29020",3265,2531,2504,17,27,"RECORTES CE",2
29,"29094",57313,39393,39052,280,341,"RECORTES CE",28
29,"29904",428,363,360,2,3,"RECORTES CE",1
29,"29072",3250,2466,2434,11,32,"RECORTES CE",0
29,"29002",1203,855,842,6,13,"RECORTES CE",1
29,"29030",809,653,651,2,2,"RECORTES CE",0
29,"29095",3350,2523,2467,17,56,"RECORTES CE",1
29,"29901",43601,30325,30130,188,195,"RECORTES CE",30
29,"29058",1463,986,975,6,11,"RECORTES CE",0
29,"29021",162,114,107,13,7,"RECORTES CE",0
1,"1001",1984,1426,1405,8,21,"PCPE",1
1,"1047",964,713,702,13,11,"PCPE",2
1,"1011",237,177,175,7,2,"PCPE",0
1,"1013",711,486,483,3,3,"PCPE",0
1,"1037",586,425,419,2,6,"PCPE",0
1,"1055",836,564,552,8,12,"PCPE",0
1,"1003",1186,842,833,19,9,"PCPE",0
1,"1022",805,593,587,3,6,"PCPE",0
1,"1058",1327,843,833,8,10,"PCPE",0
1,"1061",153,132,132,2,0,"PCPE",0
1,"1041",153,105,100,1,5,"PCPE",1
1,"1027",416,268,268,0,0,"PCPE",0
1,"1009",1281,908,898,2,10,"PCPE",0
1,"1004",1405,1026,1010,7,16,"PCPE",1
1,"1017",869,584,577,4,7,"PCPE",1
1,"1053",587,367,365,3,2,"PCPE",1
1,"1063",1799,1320,1309,10,11,"PCPE",0
1,"1057",245,203,202,0,1,"PCPE",0
1,"1049",140,108,108,0,0,"PCPE",1
1,"1902",738,537,528,4,9,"PCPE",2
1,"1043",2318,1644,1624,8,20,"PCPE",1
1,"1010",2275,1729,1717,17,12,"PCPE",1
1,"1002",8139,5961,5878,32,83,"PCPE",3
1,"1059",186354,135873,134633,948,1240,"PCPE",138
1,"1062",314,215,215,3,0,"PCPE",0
1,"1030",159,126,123,1,3,"PCPE",0
1,"1014",372,292,284,1,8,"PCPE",1
1,"1018",1370,964,963,4,1,"PCPE",1
1,"1031",1183,907,885,6,22,"PCPE",3
1,"1028",1077,759,753,6,6,"PCPE",0
1,"1901",2344,1688,1669,17,19,"PCPE",1
1,"1051",3606,2413,2389,21,24,"PCPE",0
1,"1034",165,120,119,1,1,"PCPE",1
1,"1020",326,232,228,0,4,"PCPE",1
1,"1016",439,255,249,3,6,"PCPE",1
1,"1060",199,162,159,0,3,"PCPE",0
1,"1039",202,161,156,0,5,"PCPE",0
1,"1052",244,188,186,1,2,"PCPE",0
1,"1046",594,445,435,3,10,"PCPE",1
1,"1021",460,336,332,1,4,"PCPE",1
1,"1023",269,197,195,2,2,"PCPE",0
1,"1006",176,142,141,1,1,"PCPE",0
1,"1008",790,548,542,13,6,"PCPE",0
1,"1054",952,694,688,4,6,"PCPE",1
1,"1044",236,189,187,1,2,"PCPE",0
1,"1032",522,368,361,0,7,"PCPE",0
1,"1042",901,653,650,11,3,"PCPE",2
1,"1019",144,112,111,2,1,"PCPE",0
1,"1056",218,141,140,1,1,"PCPE",1
1,"1036",15034,10733,10619,73,114,"PCPE",7
1,"1033",649,512,508,5,4,"PCPE",0
36,"36014",1980,1464,1442,7,22,"PT",9
36,"36026",20203,14399,14189,144,210,"PT",32
36,"36018",3272,2288,2262,17,26,"PT",4
36,"36016",1173,724,716,7,8,"PT",2
36,"36004",10178,7351,7224,69,127,"PT",12
36,"36059",4937,3379,3318,46,61,"PT",5
36,"36046",4055,3189,3139,30,50,"PT",4
36,"36041",13428,9842,9710,96,132,"PT",23
36,"36019",1625,1127,1119,12,8,"PT",1
36,"36034",3477,2499,2470,15,29,"PT",2
36,"36008",21736,16270,16094,160,176,"PT",47
36,"36043",4736,3347,3297,22,50,"PT",5
36,"36035",14430,10832,10680,86,152,"PT",26
36,"36038",66390,49943,49439,522,504,"PT",77
36,"36030",4220,3041,2994,32,47,"PT",5
36,"36006",11537,8885,8740,79,145,"PT",21
36,"36022",9056,6635,6514,48,121,"PT",4
36,"36057",236957,177555,175758,1730,1797,"PT",340
36,"36005",8120,5839,5747,64,92,"PT",8
36,"36060",30350,22032,21753,193,279,"PT",41
36,"36010",2862,2195,2177,18,18,"PT",5
36,"36024",16433,12239,12016,115,223,"PT",22
36,"36901",4095,3344,3293,22,51,"PT",5
36,"36011",1842,1185,1169,9,16,"PT",0
36,"36028",4139,3094,3045,22,49,"PT",6
36,"36027",4452,3328,3274,23,54,"PT",6
36,"36025",2292,1396,1389,9,7,"PT",3
36,"36031",558,464,454,9,10,"PT",0
36,"36058",4992,3495,3441,48,54,"PT",4
36,"36040",2600,1907,1869,13,38,"PT",3
36,"36023",8420,6287,6180,55,107,"PT",9
36,"36052",7298,5298,5175,37,123,"PT",17
36,"36049",6761,5193,5069,54,124,"PT",16
36,"36051",14272,10230,10072,95,158,"PT",19
36,"36054",10996,8116,7965,84,151,"PT",18
36,"36012",3735,2818,2777,21,41,"PT",6
36,"36013",2412,1602,1586,12,16,"PT",5
36,"36055",13643,10361,10145,106,216,"PT",27
36,"36061",8651,6594,6445,58,149,"PT",9
36,"36053",5693,4321,4265,41,56,"PT",7
36,"36021",12033,9035,8879,99,156,"PT",23
36,"36039",15350,11581,11349,119,232,"PT",27
36,"36056",5108,3856,3783,34,73,"PT",8
36,"36048",5348,3970,3892,44,78,"PT",7
36,"36036",2511,1923,1892,17,31,"PT",6
36,"36017",17866,13133,12910,137,223,"PT",20
36,"36047",2492,1719,1704,16,15,"PT",0
36,"36003",9979,7496,7401,81,95,"PT",15
36,"36042",17922,12993,12760,116,233,"PT",42
36,"36050",7562,5567,5457,44,110,"PT",16
36,"36045",24570,18613,18365,184,248,"PT",39
36,"36033",12347,9515,9336,76,179,"PT",27
36,"36032",3655,2745,2699,21,46,"PT",4
36,"36037",2607,1862,1838,16,24,"PT",6
36,"36015",4205,2941,2885,32,56,"PT",6
36,"36001",2593,1968,1952,6,16,"PT",2
36,"36020",2351,1748,1721,20,27,"PT",2
36,"36009",4908,3167,3114,25,53,"PT",1
36,"36002",3151,2290,2255,19,35,"PT",0
36,"36044",2556,1786,1747,13,39,"PT",6
36,"36007",1689,1168,1148,12,20,"PT",1
36,"36029",16129,12262,12078,101,184,"PT",22
50,"50105",304,228,228,3,0,"RECORTES CE",0
50,"50295",45,39,39,0,0,"RECORTES CE",0
50,"50170",378,286,283,2,3,"RECORTES CE",0
50,"50265",62,41,41,0,0,"RECORTES CE",0
50,"50232",171,120,118,0,2,"RECORTES CE",0
50,"50064",440,350,349,5,1,"RECORTES CE",0
50,"50275",110,73,72,0,1,"RECORTES CE",0
50,"50169",362,264,262,0,2,"RECORTES CE",0
50,"50063",61,57,57,0,0,"RECORTES CE",0
50,"50257",178,139,137,0,2,"RECORTES CE",0
50,"50180",120,97,96,0,1,"RECORTES CE",0
50,"50276",129,108,107,0,1,"RECORTES CE",1
50,"50026",442,358,353,6,5,"RECORTES CE",0
50,"50179",257,207,207,2,0,"RECORTES CE",0
50,"50147",788,577,576,4,1,"RECORTES CE",0
50,"50095",12366,8938,8856,94,82,"RECORTES CE",8
50,"50033",75,65,65,0,0,"RECORTES CE",0
50,"50162",147,110,110,2,0,"RECORTES CE",0
50,"50027",227,177,176,1,1,"RECORTES CE",0
50,"50231",260,213,210,7,3,"RECORTES CE",0
50,"50192",236,185,183,2,2,"RECORTES CE",0
50,"50077",226,175,174,5,1,"RECORTES CE",0
50,"50261",215,159,159,1,0,"RECORTES CE",0
50,"50233",114,81,81,1,0,"RECORTES CE",0
50,"50230",1176,853,849,11,4,"RECORTES CE",3
50,"50212",41,37,37,0,0,"RECORTES CE",0
50,"50150",660,402,402,3,0,"RECORTES CE",0
50,"50074",6397,4512,4408,38,104,"RECORTES CE",8
50,"50122",68,54,54,2,0,"RECORTES CE",0
50,"50010",69,57,57,0,0,"RECORTES CE",0
50,"50255",214,163,163,0,0,"RECORTES CE",0
50,"50024",589,461,459,4,2,"RECORTES CE",0
50,"50258",56,34,34,1,0,"RECORTES CE",0
50,"50178",302,197,196,9,1,"RECORTES CE",1
50,"50273",31,18,18,0,0,"RECORTES CE",0
50,"50290",387,288,287,4,1,"RECORTES CE",2
50,"50283",72,55,54,0,1,"RECORTES CE",0
50,"50002",148,105,102,0,3,"RECORTES CE",0
50,"50296",398,297,293,2,4,"RECORTES CE",0
50,"50004",534,406,401,0,5,"RECORTES CE",0
50,"50183",338,255,255,0,0,"RECORTES CE",0
50,"50032",273,190,189,0,1,"RECORTES CE",1
50,"50084",79,56,56,1,0,"RECORTES CE",0
50,"50174",92,70,70,0,0,"RECORTES CE",0
50,"50012",108,86,83,1,3,"RECORTES CE",1
50,"50141",114,85,84,0,1,"RECORTES CE",0
50,"50243",340,259,254,1,5,"RECORTES CE",0
50,"50234",245,198,193,9,5,"RECORTES CE",1
50,"50061",207,174,168,1,6,"RECORTES CE",0
50,"50142",30,21,21,0,0,"RECORTES CE",0
50,"50195",53,38,38,0,0,"RECORTES CE",0
50,"50225",1568,996,985,2,11,"RECORTES CE",2
50,"50294",73,58,58,0,0,"RECORTES CE",0
50,"50222",1647,1135,1118,8,17,"RECORTES CE",1
50,"50029",627,469,468,4,1,"RECORTES CE",0
50,"50154",119,92,91,0,1,"RECORTES CE",0
50,"50134",128,88,88,5,0,"RECORTES CE",0
50,"50248",521,407,406,1,1,"RECORTES CE",1
50,"50006",939,712,701,8,11,"RECORTES CE",1
50,"50037",139,92,91,1,1,"RECORTES CE",1
50,"50227",108,79,79,1,0,"RECORTES CE",0
50,"50075",81,59,59,1,0,"RECORTES CE",1
50,"50205",91,69,65,1,4,"RECORTES CE",0
50,"50288",3371,2566,2547,26,19,"RECORTES CE",6
50,"50223",915,747,741,8,6,"RECORTES CE",0
50,"50166",260,192,189,2,3,"RECORTES CE",0
50,"50186",41,29,29,0,0,"RECORTES CE",0
50,"50228",270,211,210,5,1,"RECORTES CE",0
50,"50132",755,573,564,7,9,"RECORTES CE",2
50,"50903",2225,1686,1669,21,17,"RECORTES CE",3
50,"50260",35,32,32,0,0,"RECORTES CE",0
50,"50078",244,192,189,1,3,"RECORTES CE",0
50,"50101",879,615,609,5,6,"RECORTES CE",1
50,"50015",98,63,63,0,0,"RECORTES CE",0
50,"50066",2613,1956,1951,21,5,"RECORTES CE",5
50,"50238",97,74,73,0,1,"RECORTES CE",2
50,"50201",443,335,330,2,5,"RECORTES CE",0
50,"50160",2245,1661,1648,10,13,"RECORTES CE",1
50,"50018",948,717,712,6,5,"RECORTES CE",0
50,"50204",2457,1830,1816,14,14,"RECORTES CE",0
50,"50153",941,737,734,7,3,"RECORTES CE",0
50,"50187",70,38,38,0,0,"RECORTES CE",0
50,"50229",64,42,42,0,0,"RECORTES CE",0
50,"50133",117,88,88,3,0,"RECORTES CE",0
50,"50048",35,23,23,0,0,"RECORTES CE",0
50,"50168",28,23,23,0,0,"RECORTES CE",0
50,"50239",64,47,47,1,0,"RECORTES CE",0
50,"50161",117,76,76,0,0,"RECORTES CE",1
50,"50009",106,78,77,1,1,"RECORTES CE",0
50,"50240",1034,749,737,10,12,"RECORTES CE",1
50,"50270",38,24,24,2,0,"RECORTES CE",0
50,"50185",132,110,110,1,0,"RECORTES CE",0
50,"50121",276,227,225,4,2,"RECORTES CE",0
50,"50237",103,73,73,2,0,"RECORTES CE",0
50,"50088",305,234,229,11,5,"RECORTES CE",0
50,"50059",780,572,567,6,5,"RECORTES CE",0
50,"50128",28,24,24,0,0,"RECORTES CE",0
50,"50199",341,242,241,4,1,"RECORTES CE",1
50,"50118",2179,1575,1564,7,11,"RECORTES CE",1
50,"50072",174,124,122,2,2,"RECORTES CE",0
50,"50100",333,263,261,5,2,"RECORTES CE",1
50,"50062",1810,1407,1389,12,18,"RECORTES CE",3
50,"50079",254,186,184,3,2,"RECORTES CE",0
50,"50297",499531,377882,375565,3049,2317,"RECORTES CE",845
50,"50020",822,560,555,5,5,"RECORTES CE",0
50,"50220",46,32,32,0,0,"RECORTES CE",1
50,"50200",509,406,404,6,2,"RECORTES CE",0
50,"50262",1187,931,930,13,1,"RECORTES CE",0
50,"50236",104,82,82,2,0,"RECORTES CE",0
50,"50023",223,175,173,3,2,"RECORTES CE",0
50,"50083",90,72,72,1,0,"RECORTES CE",0
50,"50279",87,62,62,1,0,"RECORTES CE",0
50,"50045",1255,944,934,6,10,"RECORTES CE",4
50,"50235",2323,1687,1675,7,12,"RECORTES CE",4
50,"50094",1626,1197,1178,22,19,"RECORTES CE",3
50,"50286",77,54,54,0,0,"RECORTES CE",0
50,"50021",32,25,25,3,0,"RECORTES CE",0
50,"50106",135,105,104,0,1,"RECORTES CE",0
50,"50177",315,251,249,3,2,"RECORTES CE",0
50,"50253",423,328,327,1,1,"RECORTES CE",1
50,"50171",108,70,69,0,1,"RECORTES CE",0
50,"50251",8300,6228,6167,62,61,"RECORTES CE",9
50,"50211",252,187,186,0,1,"RECORTES CE",0
50,"50138",46,41,41,0,0,"RECORTES CE",0
50,"50263",197,123,121,6,2,"RECORTES CE",0
50,"50099",3087,2233,2216,15,17,"RECORTES CE",4
50,"50277",55,43,43,1,0,"RECORTES CE",0
50,"50129",245,164,164,1,0,"RECORTES CE",0
50,"50191",476,327,325,3,2,"RECORTES CE",1
50,"50246",41,29,29,0,0,"RECORTES CE",0
50,"50165",1815,1333,1316,27,17,"RECORTES CE",5
50,"50136",579,420,413,0,7,"RECORTES CE",0
50,"50284",151,115,113,0,2,"RECORTES CE",0
50,"50107",944,772,767,16,5,"RECORTES CE",0
50,"50080",32,25,25,0,0,"RECORTES CE",0
50,"50111",186,152,151,1,1,"RECORTES CE",0
50,"50264",158,111,111,0,0,"RECORTES CE",2
50,"50110",369,258,257,0,1,"RECORTES CE",0
50,"50085",176,131,129,3,2,"RECORTES CE",1
50,"50172",196,138,136,0,2,"RECORTES CE",0
50,"50254",181,130,129,2,1,"RECORTES CE",1
50,"50003",126,93,92,3,1,"RECORTES CE",1
50,"50244",205,157,157,3,0,"RECORTES CE",0
50,"50173",210,141,140,2,1,"RECORTES CE",0
50,"50193",647,514,506,1,8,"RECORTES CE",1
50,"50285",648,473,469,3,4,"RECORTES CE",0
50,"50278",198,145,144,1,1,"RECORTES CE",0
50,"50137",1025,793,786,6,7,"RECORTES CE",0
50,"50044",232,156,156,1,0,"RECORTES CE",0
50,"50076",81,64,64,0,0,"RECORTES CE",0
50,"50252",5178,3746,3711,36,35,"RECORTES CE",0
50,"50053",688,535,522,6,13,"RECORTES CE",0
50,"50245",90,60,60,1,0,"RECORTES CE",0
50,"50120",49,36,36,3,0,"RECORTES CE",0
50,"50098",181,129,127,2,2,"RECORTES CE",0
50,"50109",105,78,77,3,1,"RECORTES CE",0
50,"50224",69,55,55,1,0,"RECORTES CE",0
50,"50164",395,263,260,2,3,"RECORTES CE",0
50,"50149",36,23,23,0,0,"RECORTES CE",0
50,"50214",27,16,16,1,0,"RECORTES CE",0
50,"50167",232,194,193,0,1,"RECORTES CE",0
50,"50242",92,81,79,1,2,"RECORTES CE",0
50,"50067",14055,10236,10109,123,127,"RECORTES CE",20
50,"50005",234,178,178,1,0,"RECORTES CE",0
50,"50036",103,79,79,0,0,"RECORTES CE",0
50,"50249",312,235,233,1,2,"RECORTES CE",3
50,"50181",1003,750,737,9,13,"RECORTES CE",4
50,"50019",54,41,41,0,0,"RECORTES CE",2
50,"50267",605,424,420,4,4,"RECORTES CE",0
50,"50081",512,376,372,6,4,"RECORTES CE",0
50,"50114",124,94,94,2,0,"RECORTES CE",0
50,"50280",340,260,258,0,2,"RECORTES CE",5
50,"50071",131,90,90,0,0,"RECORTES CE",0
50,"50115",3248,2277,2262,31,15,"RECORTES CE",3
50,"50247",827,624,615,10,9,"RECORTES CE",2
50,"50047",50,32,32,1,0,"RECORTES CE",0
50,"50901",137,101,101,0,0,"RECORTES CE",1
50,"50216",236,189,186,4,3,"RECORTES CE",0
50,"50068",1998,1388,1378,17,10,"RECORTES CE",2
50,"50155",102,78,78,0,0,"RECORTES CE",0
50,"50017",1772,1301,1293,7,8,"RECORTES CE",1
50,"50089",8144,6285,6249,50,36,"RECORTES CE",10
50,"50271",256,187,184,4,3,"RECORTES CE",0
50,"50104",351,283,282,3,1,"RECORTES CE",0
50,"50093",94,73,73,1,0,"RECORTES CE",0
50,"50268",47,40,39,0,1,"RECORTES CE",0
50,"50190",708,542,539,3,3,"RECORTES CE",0
50,"50102",863,665,654,6,11,"RECORTES CE",3
50,"50282",70,48,48,0,0,"RECORTES CE",0
50,"50123",465,349,344,2,5,"RECORTES CE",0
50,"50289",52,39,39,1,0,"RECORTES CE",0
50,"50113",618,506,496,4,10,"RECORTES CE",0
50,"50011",127,96,96,2,0,"RECORTES CE",0
50,"50060",176,138,136,0,2,"RECORTES CE",1
50,"50207",109,88,88,1,0,"RECORTES CE",0
50,"50087",28,19,19,0,0,"RECORTES CE",0
50,"50090",156,112,111,0,1,"RECORTES CE",0
50,"50117",125,91,90,1,1,"RECORTES CE",0
50,"50124",417,312,312,9,0,"RECORTES CE",0
50,"50157",301,211,207,2,4,"RECORTES CE",0
50,"50208",1802,1349,1332,16,17,"RECORTES CE",1
50,"50293",423,282,280,5,2,"RECORTES CE",0
50,"50266",129,85,85,1,0,"RECORTES CE",0
50,"50139",319,239,238,2,1,"RECORTES CE",0
50,"50218",113,90,89,1,1,"RECORTES CE",0
50,"50092",298,256,251,3,5,"RECORTES CE",0
50,"50016",52,37,37,0,0,"RECORTES CE",0
50,"50902",87,78,78,1,0,"RECORTES CE",0
50,"50043",257,172,171,1,1,"RECORTES CE",0
50,"50125",371,260,258,3,2,"RECORTES CE",0
50,"50206",466,379,376,2,3,"RECORTES CE",1
50,"50028",78,53,53,2,0,"RECORTES CE",0
50,"50202",158,96,92,1,4,"RECORTES CE",0
50,"50151",650,504,503,7,1,"RECORTES CE",2
50,"50051",828,640,637,8,3,"RECORTES CE",0
50,"50082",89,58,57,0,1,"RECORTES CE",0
50,"50148",324,240,236,0,4,"RECORTES CE",0
50,"50241",593,426,418,1,8,"RECORTES CE",0
50,"50056",406,325,324,2,1,"RECORTES CE",0
50,"50034",838,572,569,5,3,"RECORTES CE",0
50,"50221",33,20,20,0,0,"RECORTES CE",0
50,"50152",1457,1032,1018,11,14,"RECORTES CE",0
50,"50298",5353,4051,4013,32,38,"RECORTES CE",5
50,"50188",30,23,19,0,4,"RECORTES CE",0
50,"50057",1396,980,972,8,8,"RECORTES CE",2
50,"50203",1043,811,802,15,9,"RECORTES CE",1
50,"50210",40,32,31,0,1,"RECORTES CE",0
50,"50116",190,142,140,1,2,"RECORTES CE",0
50,"50272",12913,9500,9415,80,85,"RECORTES CE",18
50,"50054",59,45,45,0,0,"RECORTES CE",0
50,"50035",74,53,52,0,1,"RECORTES CE",0
50,"50055",3612,2533,2490,34,43,"RECORTES CE",5
50,"50001",115,81,80,0,1,"RECORTES CE",0
50,"50219",4098,3010,2980,27,30,"RECORTES CE",6
50,"50091",48,32,32,1,0,"RECORTES CE",0
50,"50291",100,69,69,0,0,"RECORTES CE",0
50,"50022",543,410,398,8,12,"RECORTES CE",2
50,"50140",165,106,106,0,0,"RECORTES CE",0
50,"50256",84,46,46,0,0,"RECORTES CE",0
50,"50156",214,173,170,2,3,"RECORTES CE",0
50,"50198",56,30,30,0,0,"RECORTES CE",0
50,"50287",274,197,195,4,2,"RECORTES CE",1
50,"50007",46,37,37,1,0,"RECORTES CE",0
50,"50013",224,187,186,3,1,"RECORTES CE",2
50,"50050",98,59,59,3,0,"RECORTES CE",0
50,"50213",98,77,72,0,5,"RECORTES CE",0
50,"50292",132,103,103,0,0,"RECORTES CE",0
50,"50197",92,71,71,2,0,"RECORTES CE",0
50,"50135",95,63,63,0,0,"RECORTES CE",0
50,"50042",16,13,13,0,0,"RECORTES CE",0
50,"50259",89,61,61,1,0,"RECORTES CE",0
50,"50175",1025,745,739,6,6,"RECORTES CE",1
50,"50182",3352,2437,2409,26,28,"RECORTES CE",1
50,"50058",72,51,51,0,0,"RECORTES CE",0
50,"50119",930,698,691,7,7,"RECORTES CE",0
50,"50217",455,334,334,1,0,"RECORTES CE",1
50,"50073",2148,1649,1622,9,27,"RECORTES CE",1
50,"50143",569,414,411,4,3,"RECORTES CE",0
50,"50038",1511,1167,1159,13,8,"RECORTES CE",1
50,"50250",55,44,44,0,0,"RECORTES CE",0
50,"50144",36,28,28,0,0,"RECORTES CE",0
50,"50159",670,511,501,5,10,"RECORTES CE",0
50,"50146",190,137,137,5,0,"RECORTES CE",0
50,"50008",5085,3617,3574,30,43,"RECORTES CE",12
50,"50031",161,90,88,1,2,"RECORTES CE",0
50,"50086",184,128,128,1,0,"RECORTES CE",0
50,"50163",3655,2766,2740,34,26,"RECORTES CE",2
50,"50194",84,52,52,0,0,"RECORTES CE",0
50,"50184",113,82,82,0,0,"RECORTES CE",1
50,"50025",4547,3335,3295,45,40,"RECORTES CE",4
50,"50069",76,53,52,0,1,"RECORTES CE",0
50,"50126",2388,1726,1708,22,18,"RECORTES CE",2
50,"50176",228,158,157,0,1,"RECORTES CE",0
50,"50269",288,185,183,0,2,"RECORTES CE",0
50,"50046",176,123,123,7,0,"RECORTES CE",1
50,"50039",507,400,398,3,2,"RECORTES CE",0
50,"50281",80,57,56,0,1,"RECORTES CE",0
50,"50108",47,37,37,0,0,"RECORTES CE",0
50,"50196",108,83,82,1,1,"RECORTES CE",0
50,"50014",146,99,99,1,0,"RECORTES CE",0
50,"50096",39,17,17,0,0,"RECORTES CE",0
50,"50070",60,29,29,1,0,"RECORTES CE",0
50,"50040",92,75,75,0,0,"RECORTES CE",0
50,"50189",712,574,559,4,15,"RECORTES CE",1
50,"50131",237,168,167,2,1,"RECORTES CE",0
50,"50215",23,15,15,0,0,"RECORTES CE",0
50,"50130",395,252,252,1,0,"RECORTES CE",0
50,"50209",2560,1787,1774,12,13,"RECORTES CE",3
50,"50052",90,71,71,0,0,"RECORTES CE",0
50,"50041",12,10,10,0,0,"RECORTES CE",0
50,"50030",225,156,156,2,0,"RECORTES CE",0
50,"50274",71,50,49,1,1,"RECORTES CE",0
50,"50065",53,42,42,0,0,"RECORTES CE",1
28,"28141",5806,4532,4486,24,46,"RECORTES CE",4
28,"28121",198,166,164,2,2,"RECORTES CE",0
28,"28163",438,357,354,1,3,"RECORTES CE",0
28,"28123",56464,47181,46948,257,233,"RECORTES CE",47
28,"28153",703,510,507,2,3,"RECORTES CE",0
28,"28046",4432,3562,3538,19,24,"RECORTES CE",3
28,"28118",58,49,48,1,1,"RECORTES CE",0
28,"28017",1210,954,943,6,11,"RECORTES CE",0
28,"28064",134,105,105,0,0,"RECORTES CE",0
28,"28066",7175,5598,5561,28,37,"RECORTES CE",3
28,"28169",1427,1164,1158,1,6,"RECORTES CE",1
28,"28075",5581,4380,4350,15,30,"RECORTES CE",10
28,"28072",5657,4465,4441,20,24,"RECORTES CE",4
28,"28136",640,540,532,0,8,"RECORTES CE",0
28,"28088",262,180,179,2,1,"RECORTES CE",0
28,"28159",588,469,468,6,1,"RECORTES CE",0
28,"28130",28243,22649,22458,135,191,"RECORTES CE",23
28,"28007",124358,99423,98711,554,712,"RECORTES CE",121
28,"28005",134211,104575,103819,667,756,"RECORTES CE",147
28,"28146",1773,1274,1262,9,12,"RECORTES CE",1
28,"28076",406,322,319,1,3,"RECORTES CE",0
28,"28094",825,636,634,3,2,"RECORTES CE",0
28,"28124",76,56,54,0,2,"RECORTES CE",0
28,"28022",32949,27473,27379,169,94,"RECORTES CE",19
28,"28120",1217,918,904,4,14,"RECORTES CE",0
28,"28165",1788,1332,1321,5,11,"RECORTES CE",0
28,"28125",2965,2210,2188,13,22,"RECORTES CE",1
28,"28122",518,388,385,2,3,"RECORTES CE",1
28,"28145",2370,1824,1809,12,15,"RECORTES CE",1
28,"28100",4169,3076,3048,12,28,"RECORTES CE",0
28,"28061",21200,16698,16600,75,98,"RECORTES CE",14
28,"28176",12288,9809,9763,50,46,"RECORTES CE",14
28,"28092",151511,117869,116968,641,901,"RECORTES CE",163
28,"28166",318,258,255,1,3,"RECORTES CE",0
28,"28174",1788,1277,1267,2,10,"RECORTES CE",1
28,"28095",1508,1177,1167,6,10,"RECORTES CE",2
28,"28143",70,59,59,1,0,"RECORTES CE",1
28,"28129",7913,6175,6124,30,51,"RECORTES CE",5
28,"28093",2043,1681,1661,9,20,"RECORTES CE",0
28,"28013",40409,30141,29905,164,236,"RECORTES CE",23
28,"28025",427,329,326,1,3,"RECORTES CE",0
28,"28154",5420,3966,3899,17,67,"RECORTES CE",5
28,"28119",2074,1641,1625,9,16,"RECORTES CE",0
28,"28032",4749,3653,3607,19,46,"RECORTES CE",1
28,"28096",18161,13784,13647,57,137,"RECORTES CE",12
28,"28091",5436,3827,3786,23,41,"RECORTES CE",7
28,"28065",125384,101604,100872,477,732,"RECORTES CE",135
28,"28001",64,48,48,3,0,"RECORTES CE",0
28,"28117",95,84,84,0,0,"RECORTES CE",0
28,"28021",544,387,387,2,0,"RECORTES CE",1
28,"28138",69,54,54,0,0,"RECORTES CE",0
28,"28157",595,448,442,1,6,"RECORTES CE",2
28,"28152",16026,13269,13202,46,67,"RECORTES CE",12
28,"28082",5664,4526,4492,25,34,"RECORTES CE",9
28,"28048",499,406,401,2,5,"RECORTES CE",0
28,"28097",124,85,84,1,1,"RECORTES CE",0
28,"28150",3084,2415,2381,13,34,"RECORTES CE",4
28,"28047",40783,31308,31072,171,236,"RECORTES CE",32
28,"28107",435,326,321,0,5,"RECORTES CE",2
28,"28042",1153,882,874,5,8,"RECORTES CE",1
28,"28036",2514,1974,1949,12,25,"RECORTES CE",3
28,"28156",998,751,743,3,8,"RECORTES CE",0
28,"28155",507,420,420,0,0,"RECORTES CE",0
28,"28131",12971,9828,9755,57,73,"RECORTES CE",14
28,"28178",1066,850,846,2,4,"RECORTES CE",1
28,"28168",1226,910,900,1,10,"RECORTES CE",0
28,"28148",85022,65597,65111,368,486,"RECORTES CE",87
28,"28106",76612,56555,56006,346,549,"RECORTES CE",101
28,"28026",6237,4893,4853,32,40,"RECORTES CE",4
28,"28149",5653,4516,4469,19,47,"RECORTES CE",6
28,"28099",1731,1283,1278,8,5,"RECORTES CE",1
28,"28023",4697,3835,3817,20,18,"RECORTES CE",4
28,"28126",39,25,25,0,0,"RECORTES CE",0
28,"28164",2986,2281,2263,12,18,"RECORTES CE",4
28,"28008",1768,1293,1282,4,11,"RECORTES CE",1
28,"28151",3143,2352,2314,6,38,"RECORTES CE",1
28,"28083",8880,6801,6759,47,42,"RECORTES CE",8
28,"28034",352,270,269,1,1,"RECORTES CE",0
28,"28109",1591,1113,1111,3,2,"RECORTES CE",3
28,"28011",445,339,338,0,1,"RECORTES CE",0
28,"28049",58688,48006,47660,286,346,"RECORTES CE",78
28,"28132",11645,8605,8520,55,85,"RECORTES CE",16
28,"28052",3883,2801,2758,18,43,"RECORTES CE",1
28,"28004",6179,4377,4345,15,32,"RECORTES CE",3
28,"28019",1237,952,938,2,14,"RECORTES CE",0
28,"28171",4238,3002,2962,18,40,"RECORTES CE",3
28,"28080",48226,39753,39570,172,183,"RECORTES CE",19
28,"28110",1949,1543,1525,2,18,"RECORTES CE",0
28,"28014",32852,24749,24571,120,178,"RECORTES CE",30
28,"28027",1199,897,882,5,15,"RECORTES CE",0
28,"28057",1439,1125,1120,5,5,"RECORTES CE",3
28,"28012",883,702,691,4,11,"RECORTES CE",0
28,"28133",6002,4259,4204,12,55,"RECORTES CE",4
28,"28035",1362,1042,1033,3,9,"RECORTES CE",1
28,"28084",15839,12028,11925,53,103,"RECORTES CE",17
28,"28128",439,323,320,2,3,"RECORTES CE",1
28,"28050",4077,3032,3006,15,26,"RECORTES CE",4
28,"28090",8405,6792,6751,34,41,"RECORTES CE",5
28,"28073",12505,9485,9384,64,101,"RECORTES CE",15
28,"28043",5922,4063,4008,29,55,"RECORTES CE",2
28,"28003",181,141,141,3,0,"RECORTES CE",1
28,"28111",592,489,483,0,6,"RECORTES CE",2
28,"28020",148,99,97,1,2,"RECORTES CE",0
28,"28071",60,47,46,0,1,"RECORTES CE",0
28,"28134",60511,47566,47229,233,337,"RECORTES CE",55
28,"28059",4312,3256,3237,11,19,"RECORTES CE",1
28,"28158",662,545,543,3,2,"RECORTES CE",0
28,"28101",218,180,180,0,0,"RECORTES CE",0
28,"28181",20344,16669,16572,95,97,"RECORTES CE",12
28,"28006",78564,61796,61456,334,340,"RECORTES CE",63
28,"28144",5929,4776,4744,29,32,"RECORTES CE",2
28,"28056",860,653,647,6,6,"RECORTES CE",0
28,"28074",138742,110456,109579,581,877,"RECORTES CE",166
28,"28086",5055,3627,3600,21,27,"RECORTES CE",4
28,"28067",4057,3220,3188,12,32,"RECORTES CE",2
28,"28102",881,659,650,3,9,"RECORTES CE",2
28,"28167",8308,6605,6545,35,60,"RECORTES CE",8
28,"28180",5242,4040,3999,11,41,"RECORTES CE",2
28,"28037",1566,1175,1168,5,7,"RECORTES CE",0
28,"28044",5766,4623,4584,22,39,"RECORTES CE",4
28,"28182",214,174,170,0,4,"RECORTES CE",0
28,"28172",8965,7255,7219,44,36,"RECORTES CE",8
28,"28029",530,426,424,3,2,"RECORTES CE",0
28,"28127",64513,53125,52932,300,193,"RECORTES CE",51
28,"28060",1509,1194,1183,8,11,"RECORTES CE",1
28,"28175",850,696,692,2,4,"RECORTES CE",0
28,"28112",167,132,132,0,0,"RECORTES CE",0
28,"28160",8227,6295,6251,26,44,"RECORTES CE",6
28,"28030",1716,1342,1316,2,26,"RECORTES CE",2
28,"28104",13836,11414,11349,54,65,"RECORTES CE",10
28,"28135",971,740,735,4,5,"RECORTES CE",1
28,"28028",1730,1347,1326,8,21,"RECORTES CE",0
28,"28173",520,409,408,3,1,"RECORTES CE",0
28,"28053",6458,5299,5263,29,36,"RECORTES CE",0
28,"28058",139289,108214,107323,612,891,"RECORTES CE",179
28,"28087",3176,2545,2528,15,17,"RECORTES CE",0
28,"28183",1050,770,763,2,7,"RECORTES CE",2
28,"28051",1542,1240,1232,5,8,"RECORTES CE",0
28,"28031",2055,1538,1519,4,19,"RECORTES CE",1
28,"28038",4935,3858,3815,17,43,"RECORTES CE",7
28,"28161",48368,37462,37161,190,301,"RECORTES CE",48
28,"28113",34305,27077,26881,156,196,"RECORTES CE",31
28,"28069",54,43,43,1,0,"RECORTES CE",0
28,"28079",2371327,1817203,1806970,9067,10233,"RECORTES CE",1870
28,"28114",149,103,103,1,0,"RECORTES CE",0
28,"28085",3908,3106,3078,7,28,"RECORTES CE",4
28,"28137",1644,1301,1283,7,18,"RECORTES CE",1
28,"28078",36,34,34,0,0,"RECORTES CE",0
28,"28016",80,57,57,0,0,"RECORTES CE",0
28,"28901",789,590,584,2,6,"RECORTES CE",2
28,"28024",152,129,128,1,1,"RECORTES CE",2
28,"28054",11166,8649,8584,36,65,"RECORTES CE",10
28,"28070",119,91,91,0,0,"RECORTES CE",0
28,"28089",3703,2961,2933,19,28,"RECORTES CE",3
28,"28062",308,244,241,3,3,"RECORTES CE",0
28,"28009",14046,11014,10932,51,82,"RECORTES CE",13
28,"28039",130,97,97,0,0,"RECORTES CE",0
28,"28170",2486,1757,1740,9,17,"RECORTES CE",2
28,"28177",10192,8271,8234,51,37,"RECORTES CE",10
28,"28147",968,751,745,2,6,"RECORTES CE",0
28,"28902",468,352,347,2,5,"RECORTES CE",1
28,"28055",899,682,676,4,6,"RECORTES CE",1
28,"28162",2549,2039,2025,13,14,"RECORTES CE",7
28,"28040",15691,10833,10728,45,105,"RECORTES CE",8
28,"28063",252,195,194,2,1,"RECORTES CE",0
28,"28015",18233,14725,14653,81,72,"RECORTES CE",11
28,"28045",33019,25531,25313,146,218,"RECORTES CE",27
28,"28002",2966,2186,2175,9,11,"RECORTES CE",4
28,"28115",60579,50819,50657,246,162,"RECORTES CE",32
28,"28068",10928,8389,8315,43,74,"RECORTES CE",5
28,"28116",700,544,544,3,0,"RECORTES CE",2
28,"28903",32480,27640,27525,161,115,"RECORTES CE",24
28,"28018",3739,3071,3046,12,25,"RECORTES CE",2
28,"28041",4452,3572,3550,24,22,"RECORTES CE",6
28,"28010",9853,7959,7914,35,45,"RECORTES CE",12
28,"28108",3330,2536,2528,17,8,"RECORTES CE",2
28,"28179",1441,1082,1071,7,11,"RECORTES CE",0
28,"28033",3824,2854,2832,11,22,"RECORTES CE",1
28,"28140",2981,2383,2357,14,26,"RECORTES CE",1
9,"9265",38,31,31,0,0,"PACMA",0
9,"9326",148,115,113,2,2,"PACMA",0
9,"9023",1096,848,840,9,8,"PACMA",3
9,"9250",273,218,218,4,0,"PACMA",2
9,"9350",480,358,347,5,11,"PACMA",3
9,"9098",516,396,388,6,8,"PACMA",0
9,"9280",27,17,17,0,0,"PACMA",0
9,"9386",58,44,43,2,1,"PACMA",0
9,"9330",1523,1166,1148,15,18,"PACMA",1
9,"9288",91,70,69,1,1,"PACMA",0
9,"9906",1223,952,947,9,5,"PACMA",6
9,"9327",25,22,22,0,0,"PACMA",2
9,"9172",125,102,102,2,0,"PACMA",0
9,"9112",113,75,73,2,2,"PACMA",1
9,"9321",1640,1250,1237,5,13,"PACMA",6
9,"9120",39,35,35,0,0,"PACMA",0
9,"9228",163,138,138,0,0,"PACMA",0
9,"9247",23,19,19,0,0,"PACMA",0
9,"9197",148,108,104,1,4,"PACMA",1
9,"9418",82,63,62,3,1,"PACMA",0
9,"9395",136,96,95,0,1,"PACMA",1
9,"9456",129,90,90,2,0,"PACMA",0
9,"9024",156,117,114,0,3,"PACMA",1
9,"9244",47,26,26,1,0,"PACMA",0
9,"9218",360,272,271,2,1,"PACMA",4
9,"9036",38,31,30,2,1,"PACMA",0
9,"9451",238,199,198,1,1,"PACMA",0
9,"9162",143,108,108,0,0,"PACMA",1
9,"9316",104,83,80,1,3,"PACMA",0
9,"9266",91,72,70,0,2,"PACMA",0
9,"9279",177,130,130,0,0,"PACMA",0
9,"9246",622,458,455,5,3,"PACMA",1
9,"9115",92,69,68,0,1,"PACMA",0
9,"9012",93,68,66,1,2,"PACMA",1
9,"9303",92,72,71,0,1,"PACMA",0
9,"9378",31,21,21,1,0,"PACMA",0
9,"9382",33,30,29,1,1,"PACMA",0
9,"9366",90,64,63,1,1,"PACMA",0
9,"9091",732,516,512,7,4,"PACMA",1
9,"9044",46,38,37,0,1,"PACMA",0
9,"9122",96,66,66,0,0,"PACMA",0
9,"9086",687,475,471,0,4,"PACMA",4
9,"9074",788,609,598,8,11,"PACMA",4
9,"9163",602,479,472,5,7,"PACMA",0
9,"9243",75,56,54,1,2,"PACMA",0
9,"9016",85,64,64,2,0,"PACMA",2
9,"9236",38,32,32,0,0,"PACMA",0
9,"9424",32,26,26,1,0,"PACMA",0
9,"9902",461,347,339,1,8,"PACMA",3
9,"9301",616,513,506,5,7,"PACMA",2
9,"9392",53,40,40,0,0,"PACMA",0
9,"9323",64,47,47,0,0,"PACMA",0
9,"9430",24,19,19,0,0,"PACMA",0
9,"9238",932,576,569,6,7,"PACMA",3
9,"9088",66,44,42,1,2,"PACMA",0
9,"9152",263,193,192,0,1,"PACMA",1
9,"9224",157,122,122,0,0,"PACMA",1
9,"9194",2024,1550,1530,17,20,"PACMA",11
9,"9052",31,22,21,1,1,"PACMA",0
9,"9117",77,61,57,0,4,"PACMA",0
9,"9011",69,49,49,0,0,"PACMA",0
9,"9343",97,70,69,0,1,"PACMA",0
9,"9104",54,43,43,0,0,"PACMA",0
9,"9428",107,87,87,0,0,"PACMA",0
9,"9394",727,558,552,8,6,"PACMA",4
9,"9434",1221,985,970,10,15,"PACMA",4
9,"9128",82,66,66,0,0,"PACMA",3
9,"9905",391,308,308,5,0,"PACMA",1
9,"9065",147,124,123,2,1,"PACMA",0
9,"9306",113,91,91,1,0,"PACMA",0
9,"9173",123,93,93,1,0,"PACMA",0
9,"9375",35,27,27,0,0,"PACMA",1
9,"9256",362,261,255,2,6,"PACMA",0
9,"9058",393,293,289,2,4,"PACMA",3
9,"9055",52,39,38,0,1,"PACMA",0
9,"9030",109,76,76,3,0,"PACMA",0
9,"9400",317,258,256,3,2,"PACMA",0
9,"9125",596,435,433,3,2,"PACMA",2
9,"9206",61,52,50,3,2,"PACMA",0
9,"9062",51,44,44,1,0,"PACMA",1
9,"9192",55,47,46,0,1,"PACMA",1
9,"9056",4931,3634,3602,35,32,"PACMA",27
9,"9346",93,71,69,0,2,"PACMA",0
9,"9448",216,180,178,1,2,"PACMA",0
9,"9340",76,49,49,0,0,"PACMA",0
9,"9093",154,133,128,1,5,"PACMA",4
9,"9362",204,168,164,0,4,"PACMA",0
9,"9407",27,23,23,1,0,"PACMA",0
9,"9009",163,130,128,2,2,"PACMA",0
9,"9374",90,79,77,2,2,"PACMA",0
9,"9033",89,75,75,0,0,"PACMA",0
9,"9201",30,17,17,0,0,"PACMA",0
9,"9414",201,148,147,1,1,"PACMA",0
9,"9084",189,150,148,7,2,"PACMA",0
9,"9239",53,44,42,1,2,"PACMA",1
9,"9277",119,101,100,0,1,"PACMA",0
9,"9198",108,86,85,2,1,"PACMA",0
9,"9137",167,128,128,1,0,"PACMA",0
9,"9232",151,125,124,2,1,"PACMA",0
9,"9017",89,67,62,0,5,"PACMA",0
9,"9202",24,22,22,1,0,"PACMA",0
9,"9283",46,29,28,0,1,"PACMA",0
9,"9398",75,54,54,1,0,"PACMA",0
9,"9443",183,132,129,1,3,"PACMA",0
9,"9415",267,166,165,0,1,"PACMA",0
9,"9482",34,29,28,0,1,"PACMA",0
9,"9143",27,20,20,0,0,"PACMA",0
9,"9463",262,206,206,3,0,"PACMA",2
9,"9412",803,552,550,2,2,"PACMA",3
9,"9227",119,97,95,0,2,"PACMA",1
9,"9444",72,48,48,2,0,"PACMA",0
9,"9416",52,39,39,0,0,"PACMA",1
9,"9025",125,86,79,1,7,"PACMA",1
9,"9132",173,132,130,0,2,"PACMA",1
9,"9124",1520,1113,1096,9,17,"PACMA",2
9,"9258",173,139,136,4,3,"PACMA",0
9,"9307",113,91,91,0,0,"PACMA",0
9,"9471",151,117,117,0,0,"PACMA",3
9,"9335",87,72,71,0,1,"PACMA",0
9,"9144",52,40,40,0,0,"PACMA",0
9,"9391",361,264,263,2,1,"PACMA",2
9,"9483",212,161,161,1,0,"PACMA",0
9,"9429",56,41,41,0,0,"PACMA",0
9,"9294",111,88,86,0,2,"PACMA",2
9,"9304",202,166,163,1,3,"PACMA",1
9,"9133",40,34,34,0,0,"PACMA",0
9,"9396",152,118,118,1,0,"PACMA",2
9,"9388",36,31,30,1,1,"PACMA",1
9,"9225",84,57,56,1,1,"PACMA",0
9,"9159",56,48,48,1,0,"PACMA",0
9,"9003",192,148,146,2,2,"PACMA",0
9,"9039",58,38,38,0,0,"PACMA",0
9,"9130",79,63,62,1,1,"PACMA",1
9,"9148",86,73,69,5,4,"PACMA",2
9,"9214",684,452,446,6,6,"PACMA",0
9,"9054",100,73,72,3,1,"PACMA",0
9,"9289",1466,1027,1013,6,14,"PACMA",3
9,"9295",60,37,37,0,0,"PACMA",0
9,"9029",168,134,132,3,2,"PACMA",4
9,"9191",39,32,30,0,2,"PACMA",0
9,"9169",99,83,81,0,2,"PACMA",1
9,"9050",72,54,54,0,0,"PACMA",0
9,"9405",128,89,89,0,0,"PACMA",0
9,"9041",28,28,28,1,0,"PACMA",0
9,"9352",116,97,97,0,0,"PACMA",0
9,"9085",475,352,350,2,2,"PACMA",0
9,"9446",12,7,7,0,0,"PACMA",0
9,"9297",323,265,261,5,4,"PACMA",2
9,"9119",46,27,27,0,0,"PACMA",0
9,"9006",61,41,41,0,0,"PACMA",1
9,"9241",201,156,155,3,1,"PACMA",2
9,"9267",115,101,100,3,1,"PACMA",0
9,"9199",91,65,65,2,0,"PACMA",1
9,"9026",397,314,311,1,3,"PACMA",4
9,"9348",146,116,114,1,2,"PACMA",0
9,"9249",47,37,37,1,0,"PACMA",1
9,"9077",36,26,26,1,0,"PACMA",0
9,"9019",147,103,102,1,1,"PACMA",1
9,"9464",36,24,24,0,0,"PACMA",2
9,"9358",249,191,191,1,0,"PACMA",0
9,"9255",86,66,62,0,4,"PACMA",0
9,"9189",130,88,86,2,2,"PACMA",1
9,"9311",60,52,50,0,2,"PACMA",0
9,"9200",48,37,36,0,1,"PACMA",0
9,"9182",78,63,61,2,2,"PACMA",0
9,"9425",514,369,366,2,3,"PACMA",0
9,"9308",67,43,43,1,0,"PACMA",1
9,"9441",74,66,66,0,0,"PACMA",0
9,"9020",262,187,180,2,7,"PACMA",1
9,"9032",108,73,73,0,0,"PACMA",0
9,"9351",60,46,45,1,1,"PACMA",0
9,"9027",47,44,41,0,3,"PACMA",0
9,"9067",442,308,303,9,5,"PACMA",2
9,"9427",1428,1014,1003,12,11,"PACMA",4
9,"9369",442,331,328,1,3,"PACMA",2
9,"9176",61,45,44,0,1,"PACMA",2
9,"9454",47,34,34,0,0,"PACMA",2
9,"9328",77,55,55,1,0,"PACMA",1
9,"9355",101,75,73,0,2,"PACMA",0
9,"9109",1068,698,669,10,29,"PACMA",18
9,"9164",165,121,121,1,0,"PACMA",0
9,"9018",24702,18365,18158,174,207,"PACMA",112
9,"9423",27,25,25,0,0,"PACMA",0
9,"9908",469,314,309,2,5,"PACMA",1
9,"9068",29,23,22,0,1,"PACMA",0
9,"9131",460,381,373,5,8,"PACMA",4
9,"9061",166,124,123,1,1,"PACMA",0
9,"9138",90,73,72,0,1,"PACMA",1
9,"9248",78,57,57,0,0,"PACMA",0
9,"9219",27590,19903,19724,166,179,"PACMA",162
9,"9372",221,190,189,1,1,"PACMA",1
9,"9082",40,35,35,0,0,"PACMA",0
9,"9135",41,33,33,1,0,"PACMA",1
9,"9409",109,87,87,0,0,"PACMA",1
9,"9381",32,23,22,0,1,"PACMA",0
9,"9410",3051,2169,2153,18,16,"PACMA",16
9,"9167",59,42,42,2,0,"PACMA",0
9,"9287",208,170,168,2,2,"PACMA",0
9,"9406",252,196,195,1,1,"PACMA",1
9,"9038",118,97,94,0,3,"PACMA",0
9,"9007",59,41,41,0,0,"PACMA",1
9,"9220",76,62,61,2,1,"PACMA",0
9,"9417",40,30,30,0,0,"PACMA",0
9,"9231",70,49,49,3,0,"PACMA",0
9,"9175",129,92,92,0,0,"PACMA",0
9,"9354",33,30,30,1,0,"PACMA",0
9,"9216",385,283,280,8,3,"PACMA",4
9,"9458",466,380,377,3,3,"PACMA",3
9,"9403",96,78,76,1,2,"PACMA",1
9,"9442",380,287,282,2,5,"PACMA",3
9,"9217",361,265,261,4,4,"PACMA",1
9,"9903",3251,2359,2340,24,19,"PACMA",13
9,"9071",45,34,34,0,0,"PACMA",0
9,"9472",55,40,40,0,0,"PACMA",0
9,"9060",148,123,123,0,0,"PACMA",0
9,"9449",87,72,71,1,1,"PACMA",0
9,"9907",1420,1120,1115,13,5,"PACMA",13
9,"9466",134,99,99,0,0,"PACMA",0
9,"9485",55,43,43,1,0,"PACMA",0
9,"9281",147,109,107,0,2,"PACMA",0
9,"9209",4511,3368,3301,37,67,"PACMA",21
9,"9460",177,135,135,2,0,"PACMA",0
9,"9100",59,51,50,0,1,"PACMA",0
9,"9195",57,42,42,2,0,"PACMA",0
9,"9154",142,104,104,2,0,"PACMA",0
9,"9180",136,102,100,2,2,"PACMA",0
9,"9075",111,83,83,1,0,"PACMA",1
9,"9419",78,45,44,0,1,"PACMA",0
9,"9141",610,499,493,4,6,"PACMA",5
9,"9170",203,152,149,1,3,"PACMA",1
9,"9377",625,478,471,5,7,"PACMA",9
9,"9114",87,67,67,0,0,"PACMA",0
9,"9155",26,20,20,1,0,"PACMA",0
9,"9051",168,133,132,1,1,"PACMA",2
9,"9318",61,38,38,0,0,"PACMA",0
9,"9257",92,80,78,4,2,"PACMA",0
9,"9001",27,26,26,0,0,"PACMA",0
9,"9339",128,103,103,0,0,"PACMA",0
9,"9059",136713,106605,105601,976,1004,"PACMA",732
9,"9110",80,49,49,1,0,"PACMA",0
9,"9178",52,36,36,1,0,"PACMA",0
9,"9268",95,73,72,0,1,"PACMA",0
9,"9368",22,14,14,1,0,"PACMA",0
9,"9276",387,280,273,2,7,"PACMA",9
9,"9262",161,129,129,0,0,"PACMA",0
9,"9213",320,223,220,4,3,"PACMA",1
9,"9478",45,38,38,0,0,"PACMA",0
9,"9298",82,62,62,0,0,"PACMA",1
9,"9140",128,88,87,0,1,"PACMA",1
9,"9208",211,139,136,3,3,"PACMA",0
9,"9179",43,35,34,0,1,"PACMA",0
9,"9431",119,99,98,0,1,"PACMA",0
9,"9363",974,730,725,3,5,"PACMA",1
9,"9312",98,83,82,0,1,"PACMA",1
9,"9190",91,56,55,0,1,"PACMA",0
9,"9422",18,10,10,0,0,"PACMA",0
9,"9337",115,84,82,0,2,"PACMA",0
9,"9904",482,389,384,5,5,"PACMA",1
9,"9408",41,34,34,1,0,"PACMA",0
9,"9048",1484,1120,1106,4,14,"PACMA",1
9,"9309",306,216,211,2,5,"PACMA",3
9,"9360",30,27,27,0,0,"PACMA",0
9,"9183",51,37,37,0,0,"PACMA",0
9,"9160",90,71,70,0,1,"PACMA",0
9,"9315",379,269,267,2,2,"PACMA",3
9,"9365",31,20,20,0,0,"PACMA",0
9,"9314",95,80,79,1,1,"PACMA",0
9,"9166",97,79,78,3,1,"PACMA",0
9,"9072",307,240,239,1,1,"PACMA",0
9,"9325",195,125,123,2,2,"PACMA",0
9,"9223",46,39,39,0,0,"PACMA",0
9,"9253",111,96,94,1,2,"PACMA",0
9,"9034",280,237,233,5,4,"PACMA",0
9,"9310",13,9,8,0,1,"PACMA",0
9,"9174",809,575,565,10,10,"PACMA",3
9,"9292",92,72,70,0,2,"PACMA",1
9,"9421",237,172,172,2,0,"PACMA",0
9,"9229",201,146,145,0,1,"PACMA",0
9,"9373",440,285,282,3,3,"PACMA",3
9,"9447",42,38,38,0,0,"PACMA",0
9,"9387",118,96,95,0,1,"PACMA",0
9,"9035",313,243,240,0,3,"PACMA",0
9,"9356",42,31,31,0,0,"PACMA",0
9,"9242",81,65,63,2,2,"PACMA",0
9,"9411",149,111,111,0,0,"PACMA",0
9,"9105",107,88,86,0,2,"PACMA",0
9,"9136",192,151,147,2,4,"PACMA",1
9,"9010",32,23,23,2,0,"PACMA",0
9,"9045",267,186,183,2,3,"PACMA",0
9,"9168",296,233,231,1,2,"PACMA",0
9,"9151",458,364,363,3,1,"PACMA",1
9,"9079",46,40,37,0,3,"PACMA",1
9,"9046",30,26,26,0,0,"PACMA",0
9,"9261",463,339,330,8,9,"PACMA",0
9,"9439",1005,823,816,9,7,"PACMA",11
9,"9113",464,383,376,6,7,"PACMA",3
9,"9021",56,33,31,0,2,"PACMA",1
9,"9338",219,173,171,1,2,"PACMA",2
9,"9273",53,41,40,1,1,"PACMA",0
9,"9445",44,32,32,1,0,"PACMA",1
9,"9095",86,62,62,0,0,"PACMA",0
9,"9275",192,138,137,1,1,"PACMA",0
9,"9177",1117,830,825,5,5,"PACMA",4
9,"9251",371,273,271,3,2,"PACMA",1
9,"9184",5,4,4,0,0,"PACMA",0
9,"9022",67,57,57,1,0,"PACMA",0
9,"9230",38,31,31,0,0,"PACMA",0
9,"9467",66,46,46,3,0,"PACMA",0
9,"9047",56,45,45,2,0,"PACMA",0
9,"9389",77,56,56,0,0,"PACMA",0
9,"9063",213,184,182,2,2,"PACMA",1
9,"9037",113,96,96,0,0,"PACMA",1
9,"9235",160,124,123,0,1,"PACMA",0
9,"9066",65,51,51,0,0,"PACMA",0
9,"9347",141,113,109,4,4,"PACMA",2
9,"9432",189,143,140,1,3,"PACMA",0
9,"9129",105,87,87,0,0,"PACMA",0
9,"9332",140,107,107,1,0,"PACMA",1
9,"9221",445,337,335,1,2,"PACMA",1
9,"9076",23,14,14,0,0,"PACMA",0
9,"9272",294,206,203,1,3,"PACMA",0
9,"9345",124,92,92,0,0,"PACMA",1
9,"9108",378,290,287,2,3,"PACMA",1
9,"9480",110,89,88,1,1,"PACMA",0
9,"9127",55,40,40,0,0,"PACMA",0
9,"9139",101,75,73,2,2,"PACMA",2
9,"9259",233,184,184,3,0,"PACMA",0
9,"9390",611,478,477,3,1,"PACMA",0
9,"9064",332,275,275,3,0,"PACMA",1
9,"9269",39,33,32,0,1,"PACMA",0
9,"9070",34,31,30,3,1,"PACMA",0
9,"9329",123,86,86,1,0,"PACMA",1
9,"9215",377,264,260,0,4,"PACMA",2
9,"9226",66,55,53,0,2,"PACMA",0
9,"9103",221,185,184,2,1,"PACMA",0
9,"9476",63,46,46,0,0,"PACMA",0
9,"9043",189,132,132,2,0,"PACMA",0
9,"9090",57,51,51,1,0,"PACMA",0
9,"9078",41,35,33,0,2,"PACMA",0
9,"9384",293,199,194,0,5,"PACMA",0
9,"9102",37,31,31,0,0,"PACMA",0
9,"9270",163,122,121,1,1,"PACMA",1
9,"9437",286,227,226,5,1,"PACMA",0
9,"9196",154,108,107,1,1,"PACMA",0
9,"9455",44,34,33,0,1,"PACMA",0
9,"9361",117,96,96,0,0,"PACMA",2
9,"9149",34,25,24,0,1,"PACMA",0
9,"9901",374,268,261,3,7,"PACMA",4
9,"9013",47,41,41,0,0,"PACMA",1
9,"9083",37,33,33,0,0,"PACMA",1
9,"9353",73,57,56,0,1,"PACMA",0
9,"9094",51,42,41,0,1,"PACMA",0
9,"9211",1462,1086,1070,11,16,"PACMA",3
9,"9450",27,21,20,1,1,"PACMA",0
9,"9413",447,333,333,5,0,"PACMA",5
9,"9438",544,446,444,3,2,"PACMA",3
9,"9123",40,35,35,0,0,"PACMA",0
9,"9440",96,78,78,0,0,"PACMA",0
9,"9134",228,152,152,2,0,"PACMA",1
9,"9334",48,39,38,0,1,"PACMA",0
9,"9302",116,87,87,0,0,"PACMA",1
9,"9380",78,59,57,0,2,"PACMA",0
9,"9433",60,52,51,0,1,"PACMA",1
9,"9073",926,753,748,10,5,"PACMA",13
9,"9014",213,127,126,1,1,"PACMA",0
9,"9317",16,14,14,0,0,"PACMA",0
9,"9101",79,59,59,0,0,"PACMA",0
9,"9181",302,231,225,3,6,"PACMA",0
9,"9057",144,116,115,0,1,"PACMA",0
9,"9274",1098,880,872,9,8,"PACMA",6
9,"9473",85,62,61,1,1,"PACMA",0
15,"15029",5761,3994,3928,47,66,"PODEMOS-En",611
15,"15092",6523,4518,4449,54,69,"PODEMOS-En",601
15,"15089",4317,3238,3188,24,50,"PODEMOS-En",684
15,"15051",4651,3343,3297,38,46,"PODEMOS-En",1034
15,"15034",2897,1931,1909,14,22,"PODEMOS-En",276
15,"15093",4265,2856,2814,35,42,"PODEMOS-En",428
15,"15085",3346,2365,2311,26,54,"PODEMOS-En",370
15,"15071",7965,5559,5483,37,76,"PODEMOS-En",1258
15,"15072",9626,7024,6920,52,104,"PODEMOS-En",1875
15,"15030",200245,148692,147426,1699,1266,"PODEMOS-En",45759
15,"15087",5804,3942,3901,49,41,"PODEMOS-En",865
15,"15003",1818,1326,1302,18,24,"PODEMOS-En",154
15,"15044",1309,955,941,5,14,"PODEMOS-En",167
15,"15901",3595,2401,2374,30,27,"PODEMOS-En",571
15,"15048",4855,3582,3534,41,48,"PODEMOS-En",851
15,"15054",32177,22065,21778,349,287,"PODEMOS-En",7059
15,"15083",1100,809,795,5,14,"PODEMOS-En",67
15,"15008",5650,4239,4175,42,64,"PODEMOS-En",967
15,"15064",2207,1680,1650,22,30,"PODEMOS-En",277
15,"15046",6345,4625,4532,53,93,"PODEMOS-En",715
15,"15028",1415,1085,1070,10,15,"PODEMOS-En",287
15,"15078",78093,58164,57487,673,677,"PODEMOS-En",16295
15,"15065",7345,5517,5412,46,105,"PODEMOS-En",1305
15,"15027",1540,1224,1203,6,21,"PODEMOS-En",212
15,"15007",3352,2469,2453,24,16,"PODEMOS-En",325
15,"15011",15463,11105,10890,92,215,"PODEMOS-En",2750
15,"15086",2918,2109,2077,19,32,"PODEMOS-En",293
15,"15047",2463,1669,1633,21,36,"PODEMOS-En",278
15,"15039",1271,935,917,8,18,"PODEMOS-En",149
15,"15070",9117,6514,6390,98,124,"PODEMOS-En",1948
15,"15061",5646,3945,3894,35,51,"PODEMOS-En",627
15,"15084",3312,2361,2326,28,35,"PODEMOS-En",239
15,"15033",2489,1953,1931,13,22,"PODEMOS-En",425
15,"15058",27623,21002,20788,257,214,"PODEMOS-En",6064
15,"15055",4618,3208,3159,49,49,"PODEMOS-En",882
15,"15023",6481,4658,4595,44,63,"PODEMOS-En",1109
15,"15069",6785,5107,5032,54,75,"PODEMOS-En",1545
15,"15001",4805,3466,3419,45,47,"PODEMOS-En",746
15,"15059",10406,7710,7553,91,157,"PODEMOS-En",1304
15,"15013",6126,4315,4257,43,58,"PODEMOS-En",1070
15,"15036",58409,40932,40506,484,426,"PODEMOS-En",12423
15,"15016",4806,3291,3222,21,69,"PODEMOS-En",376
15,"15043",5147,3834,3764,36,70,"PODEMOS-En",899
15,"15010",1913,1355,1338,21,17,"PODEMOS-En",109
15,"15090",1182,868,861,13,7,"PODEMOS-En",64
15,"15042",3060,2170,2127,21,43,"PODEMOS-En",415
15,"15038",2236,1556,1530,18,26,"PODEMOS-En",213
15,"15074",4061,2983,2947,24,36,"PODEMOS-En",500
15,"15035",11517,8305,8192,144,113,"PODEMOS-En",2669
15,"15012",3666,2787,2721,40,66,"PODEMOS-En",479
15,"15037",4087,2775,2733,18,42,"PODEMOS-En",572
15,"15088",3550,2398,2372,18,26,"PODEMOS-En",469
15,"15079",1562,1092,1075,16,17,"PODEMOS-En",132
15,"15020",3844,2651,2629,17,22,"PODEMOS-En",608
15,"15025",1069,662,654,5,8,"PODEMOS-En",61
15,"15075",12279,9076,8952,117,124,"PODEMOS-En",2350
15,"15082",15162,11273,11134,135,139,"PODEMOS-En",3160
15,"15006",5353,3534,3469,49,65,"PODEMOS-En",589
15,"15049",1099,765,755,12,10,"PODEMOS-En",77
15,"15045",3803,2382,2354,15,28,"PODEMOS-En",274
15,"15073",21884,14792,14587,149,205,"PODEMOS-En",3316
15,"15018",1156,817,806,7,11,"PODEMOS-En",181
15,"15041",9627,7409,7291,79,118,"PODEMOS-En",1478
15,"15066",4039,2950,2894,34,56,"PODEMOS-En",448
15,"15031",23321,17319,17152,218,167,"PODEMOS-En",5297
15,"15015",2840,2126,2100,21,26,"PODEMOS-En",558
15,"15052",4351,3122,3063,26,59,"PODEMOS-En",416
15,"15060",5780,4245,4167,48,78,"PODEMOS-En",932
15,"15032",3455,2438,2391,26,47,"PODEMOS-En",368
15,"15068",5096,3518,3476,39,42,"PODEMOS-En",746
15,"15077",8303,5648,5544,57,104,"PODEMOS-En",690
15,"15076",2649,1827,1802,24,25,"PODEMOS-En",276
15,"15056",5757,4167,4108,43,59,"PODEMOS-En",705
15,"15019",25902,18111,17866,232,245,"PODEMOS-En",3935
15,"15009",10780,8075,7957,70,118,"PODEMOS-En",2024
15,"15050",1843,1089,1070,19,19,"PODEMOS-En",151
15,"15062",5936,4047,3993,31,54,"PODEMOS-En",808
15,"15005",24459,16742,16482,215,260,"PODEMOS-En",5135
15,"15002",22929,16941,16742,205,199,"PODEMOS-En",5208
15,"15040",2763,2050,2017,10,33,"PODEMOS-En",423
15,"15024",4412,3325,3278,35,47,"PODEMOS-En",483
15,"15080",1760,1215,1197,11,18,"PODEMOS-En",133
15,"15017",19380,14272,14098,156,174,"PODEMOS-En",4497
15,"15091",1119,807,784,12,23,"PODEMOS-En",173
15,"15053",7783,5386,5314,47,72,"PODEMOS-En",1402
15,"15021",5099,3673,3611,43,62,"PODEMOS-En",880
15,"15902",4660,3352,3296,30,56,"PODEMOS-En",543
15,"15022",5817,4026,3981,29,45,"PODEMOS-En",1067
15,"15067",8073,6067,6000,45,67,"PODEMOS-En",1837
15,"15081",1042,819,814,12,5,"PODEMOS-En",88
15,"15014",4034,2809,2757,34,52,"PODEMOS-En",450
15,"15004",4855,3594,3535,28,59,"PODEMOS-En",925
15,"15057",12169,8853,8729,88,124,"PODEMOS-En",2177
36,"36002",3151,2290,2255,19,35,"PODEMOS-En",349
36,"36042",17922,12993,12760,116,233,"PODEMOS-En",3936
36,"36058",4992,3495,3441,48,54,"PODEMOS-En",855
36,"36014",1980,1464,1442,7,22,"PODEMOS-En",226
36,"36026",20203,14399,14189,144,210,"PODEMOS-En",3595
36,"36053",5693,4321,4265,41,56,"PODEMOS-En",1065
36,"36011",1842,1185,1169,9,16,"PODEMOS-En",162
36,"36057",236957,177555,175758,1730,1797,"PODEMOS-En",59691
36,"36010",2862,2195,2177,18,18,"PODEMOS-En",601
36,"36046",4055,3189,3139,30,50,"PODEMOS-En",625
36,"36040",2600,1907,1869,13,38,"PODEMOS-En",365
36,"36061",8651,6594,6445,58,149,"PODEMOS-En",1057
36,"36027",4452,3328,3274,23,54,"PODEMOS-En",528
36,"36031",558,464,454,9,10,"PODEMOS-En",95
36,"36018",3272,2288,2262,17,26,"PODEMOS-En",274
36,"36012",3735,2818,2777,21,41,"PODEMOS-En",585
36,"36007",1689,1168,1148,12,20,"PODEMOS-En",157
36,"36037",2607,1862,1838,16,24,"PODEMOS-En",451
36,"36013",2412,1602,1586,12,16,"PODEMOS-En",263
36,"36001",2593,1968,1952,6,16,"PODEMOS-En",390
36,"36022",9056,6635,6514,48,121,"PODEMOS-En",2315
36,"36041",13428,9842,9710,96,132,"PODEMOS-En",2192
36,"36038",66390,49943,49439,522,504,"PODEMOS-En",13213
36,"36028",4139,3094,3045,22,49,"PODEMOS-En",486
36,"36039",15350,11581,11349,119,232,"PODEMOS-En",3597
36,"36049",6761,5193,5069,54,124,"PODEMOS-En",1484
36,"36016",1173,724,716,7,8,"PODEMOS-En",46
36,"36047",2492,1719,1704,16,15,"PODEMOS-En",121
36,"36015",4205,2941,2885,32,56,"PODEMOS-En",541
36,"36023",8420,6287,6180,55,107,"PODEMOS-En",1668
36,"36034",3477,2499,2470,15,29,"PODEMOS-En",460
36,"36009",4908,3167,3114,25,53,"PODEMOS-En",566
36,"36044",2556,1786,1747,13,39,"PODEMOS-En",461
36,"36051",14272,10230,10072,95,158,"PODEMOS-En",2223
36,"36036",2511,1923,1892,17,31,"PODEMOS-En",447
36,"36054",10996,8116,7965,84,151,"PODEMOS-En",1912
36,"36006",11537,8885,8740,79,145,"PODEMOS-En",1844
36,"36025",2292,1396,1389,9,7,"PODEMOS-En",211
36,"36019",1625,1127,1119,12,8,"PODEMOS-En",132
36,"36043",4736,3347,3297,22,50,"PODEMOS-En",658
36,"36055",13643,10361,10145,106,216,"PODEMOS-En",2295
36,"36056",5108,3856,3783,34,73,"PODEMOS-En",774
36,"36033",12347,9515,9336,76,179,"PODEMOS-En",2707
36,"36003",9979,7496,7401,81,95,"PODEMOS-En",1936
36,"36052",7298,5298,5175,37,123,"PODEMOS-En",768
36,"36901",4095,3344,3293,22,51,"PODEMOS-En",845
36,"36008",21736,16270,16094,160,176,"PODEMOS-En",6478
36,"36029",16129,12262,12078,101,184,"PODEMOS-En",4097
36,"36020",2351,1748,1721,20,27,"PODEMOS-En",206
36,"36004",10178,7351,7224,69,127,"PODEMOS-En",2041
36,"36005",8120,5839,5747,64,92,"PODEMOS-En",1117
36,"36017",17866,13133,12910,137,223,"PODEMOS-En",2421
36,"36030",4220,3041,2994,32,47,"PODEMOS-En",702
36,"36048",5348,3970,3892,44,78,"PODEMOS-En",1005
36,"36050",7562,5567,5457,44,110,"PODEMOS-En",1400
36,"36032",3655,2745,2699,21,46,"PODEMOS-En",404
36,"36035",14430,10832,10680,86,152,"PODEMOS-En",2807
36,"36021",12033,9035,8879,99,156,"PODEMOS-En",2433
36,"36059",4937,3379,3318,46,61,"PODEMOS-En",539
36,"36045",24570,18613,18365,184,248,"PODEMOS-En",6148
36,"36060",30350,22032,21753,193,279,"PODEMOS-En",6089
36,"36024",16433,12239,12016,115,223,"PODEMOS-En",1765
2,"2016",581,445,441,0,4,"UP-UPeC",2
2,"2026",847,705,697,7,8,"UP-UPeC",59
2,"2071",1056,890,884,7,6,"UP-UPeC",8
2,"2048",1251,1013,1004,9,9,"UP-UPeC",9
2,"2041",350,274,272,1,2,"UP-UPeC",7
2,"2038",284,230,230,1,0,"UP-UPeC",7
2,"2002",494,406,397,0,9,"UP-UPeC",4
2,"2052",473,399,398,3,1,"UP-UPeC",15
2,"2045",3706,3046,3009,17,37,"UP-UPeC",601
2,"2015",1444,1196,1179,7,17,"UP-UPeC",30
2,"2078",922,698,691,6,7,"UP-UPeC",27
2,"2028",132,103,102,0,1,"UP-UPeC",3
2,"2009",19686,14909,14719,148,190,"UP-UPeC",691
2,"2070",411,337,330,1,7,"UP-UPeC",3
2,"2057",2043,1593,1568,24,25,"UP-UPeC",88
2,"2080",532,419,410,0,9,"UP-UPeC",7
2,"2075",1684,1406,1397,10,9,"UP-UPeC",60
2,"2020",451,381,376,3,5,"UP-UPeC",2
2,"2044",1128,806,798,2,8,"UP-UPeC",22
2,"2082",105,88,88,1,0,"UP-UPeC",6
2,"2006",588,482,476,2,6,"UP-UPeC",5
2,"2014",368,300,295,1,5,"UP-UPeC",47
2,"2027",310,251,251,0,0,"UP-UPeC",4
2,"2058",348,244,239,2,5,"UP-UPeC",11
2,"2066",238,206,205,1,1,"UP-UPeC",5
2,"2043",1250,1020,1006,8,14,"UP-UPeC",20
2,"2033",1920,1551,1518,6,33,"UP-UPeC",46
2,"2051",1690,1227,1211,12,16,"UP-UPeC",13
2,"2059",317,242,241,0,1,"UP-UPeC",11
2,"2007",1050,824,811,7,13,"UP-UPeC",16
2,"2017",845,611,607,1,4,"UP-UPeC",12
2,"2054",390,305,302,3,3,"UP-UPeC",2
2,"2025",7502,5918,5785,41,133,"UP-UPeC",225
2,"2049",838,610,607,3,3,"UP-UPeC",9
2,"2074",5998,4415,4363,20,52,"UP-UPeC",94
2,"2031",574,447,440,1,7,"UP-UPeC",19
2,"2019",2412,1991,1959,13,32,"UP-UPeC",48
2,"2081",18334,14121,13932,116,189,"UP-UPeC",436
2,"2085",321,268,266,4,2,"UP-UPeC",2
2,"2063",1471,1161,1156,6,5,"UP-UPeC",21
2,"2030",3059,2405,2377,11,28,"UP-UPeC",84
2,"2079",2887,2312,2285,24,27,"UP-UPeC",327
2,"2083",217,194,194,0,0,"UP-UPeC",0
2,"2032",281,217,216,1,1,"UP-UPeC",14
2,"2029",3306,2563,2533,17,30,"UP-UPeC",139
2,"2005",568,441,434,4,7,"UP-UPeC",4
2,"2901",2202,1571,1563,16,8,"UP-UPeC",22
2,"2021",1037,823,816,3,7,"UP-UPeC",19
2,"2039",1002,824,819,8,5,"UP-UPeC",9
2,"2086",2603,1797,1783,8,14,"UP-UPeC",33
2,"2068",343,265,262,2,3,"UP-UPeC",4
2,"2047",120,91,90,0,1,"UP-UPeC",0
2,"2013",132,105,104,0,1,"UP-UPeC",4
2,"2037",22886,15400,15266,111,134,"UP-UPeC",492
2,"2004",621,504,500,5,4,"UP-UPeC",13
2,"2062",414,324,319,0,5,"UP-UPeC",2
2,"2065",475,403,402,2,1,"UP-UPeC",13
2,"2061",641,534,530,7,4,"UP-UPeC",9
2,"2076",334,269,268,3,1,"UP-UPeC",1
2,"2022",368,279,278,0,1,"UP-UPeC",6
2,"2056",1729,1348,1323,10,25,"UP-UPeC",18
2,"2008",1227,923,909,9,14,"UP-UPeC",15
2,"2069",11544,8969,8824,62,145,"UP-UPeC",251
2,"2036",96,72,72,1,0,"UP-UPeC",2
2,"2010",1798,1491,1463,10,28,"UP-UPeC",53
2,"2003",131959,101091,100433,730,658,"UP-UPeC",4162
2,"2072",1560,1118,1098,4,20,"UP-UPeC",96
2,"2077",55,41,41,0,0,"UP-UPeC",2
2,"2018",832,670,663,5,7,"UP-UPeC",16
2,"2042",850,698,693,2,5,"UP-UPeC",14
2,"2023",576,479,468,2,11,"UP-UPeC",7
2,"2046",1135,936,917,15,19,"UP-UPeC",26
2,"2035",1989,1607,1582,13,25,"UP-UPeC",29
2,"2001",660,521,510,4,11,"UP-UPeC",10
2,"2012",1833,1595,1575,17,20,"UP-UPeC",68
2,"2055",1157,757,753,9,4,"UP-UPeC",7
2,"2011",643,517,515,0,2,"UP-UPeC",2
2,"2064",379,317,316,1,1,"UP-UPeC",5
2,"2084",325,228,221,2,7,"UP-UPeC",5
2,"2040",586,507,505,1,2,"UP-UPeC",6
2,"2067",1189,909,896,4,13,"UP-UPeC",20
2,"2050",103,87,87,0,0,"UP-UPeC",5
2,"2073",4914,3777,3730,42,47,"UP-UPeC",273
2,"2024",3416,2694,2666,33,28,"UP-UPeC",125
2,"2060",1302,1007,1003,8,4,"UP-UPeC",15
2,"2053",2996,2370,2332,15,38,"UP-UPeC",105
2,"2034",1395,1131,1126,10,5,"UP-UPeC",48
46,"46121",105,92,91,2,1,"CCD",1
46,"46157",2978,2370,2343,19,27,"CCD",8
46,"46097",959,734,728,6,6,"CCD",17
46,"46155",1035,865,846,2,19,"CCD",3
46,"46134",2357,1811,1797,8,14,"CCD",19
46,"46160",1912,1523,1514,3,9,"CCD",9
46,"46141",438,359,348,4,11,"CCD",1
46,"46230",13944,10746,10646,69,100,"CCD",34
46,"46195",1967,1612,1602,9,10,"CCD",7
46,"46137",268,225,220,3,5,"CCD",1
46,"46056",184,160,158,1,2,"CCD",0
46,"46131",49604,37767,37431,266,336,"CCD",217
46,"46136",2534,2008,1990,13,18,"CCD",11
46,"46159",22905,17498,17373,102,125,"CCD",84
46,"46258",2676,2099,2078,9,21,"CCD",9
46,"46094",20515,15885,15785,125,100,"CCD",75
46,"46053",560,454,451,2,3,"CCD",2
46,"46050",200,160,160,0,0,"CCD",0
46,"46060",9361,7285,7229,30,56,"CCD",65
46,"46144",665,525,520,2,5,"CCD",4
46,"46224",170,130,130,0,0,"CCD",0
46,"46185",386,325,321,4,4,"CCD",0
46,"46175",459,403,396,1,7,"CCD",0
46,"46029",20649,15241,15110,113,131,"CCD",114
46,"46096",279,229,225,2,4,"CCD",1
46,"46059",1272,1066,1058,4,8,"CCD",2
46,"46016",1068,885,874,3,11,"CCD",4
46,"46035",6786,5382,5338,27,44,"CCD",36
46,"46083",15467,11584,11443,79,141,"CCD",51
46,"46248",4873,3679,3639,18,40,"CCD",16
46,"46240",209,169,164,1,5,"CCD",0
46,"46044",4237,3347,3285,25,62,"CCD",14
46,"46250",578668,455375,452638,2701,2737,"CCD",1874
46,"46114",575,488,484,3,4,"CCD",1
46,"46222",383,322,321,2,1,"CCD",4
46,"46041",331,254,253,6,1,"CCD",1
46,"46249",9362,7163,7072,42,91,"CCD",16
46,"46024",424,348,340,0,8,"CCD",0
46,"46235",21793,16577,16424,118,153,"CCD",98
46,"46099",922,693,685,0,8,"CCD",1
46,"46174",984,808,794,3,14,"CCD",6
46,"46039",2147,1746,1727,9,19,"CCD",8
46,"46263",255,204,202,1,2,"CCD",0
46,"46161",1481,1206,1194,6,12,"CCD",8
46,"46030",804,660,635,7,25,"CCD",4
46,"46227",915,771,765,5,6,"CCD",4
46,"46244",58586,43371,43098,257,273,"CCD",242
46,"46150",1839,1377,1362,10,15,"CCD",6
46,"46196",153,131,130,0,1,"CCD",1
46,"46229",972,785,774,2,11,"CCD",2
46,"46189",471,412,405,2,7,"CCD",1
46,"46147",16843,12206,12099,56,107,"CCD",61
46,"46023",328,294,287,2,7,"CCD",0
46,"46055",1273,1031,1021,4,10,"CCD",8
46,"46129",521,435,434,2,1,"CCD",2
46,"46026",1204,1044,1034,4,10,"CCD",0
46,"46177",4698,3715,3665,16,50,"CCD",21
46,"46213",15476,11377,11246,110,131,"CCD",36
46,"46234",354,289,287,2,2,"CCD",3
46,"46017",33050,24762,24580,144,182,"CCD",122
46,"46022",15481,11422,11347,69,75,"CCD",49
46,"46075",149,132,130,2,2,"CCD",1
46,"46206",577,475,468,4,7,"CCD",0
46,"46255",3145,2494,2470,19,24,"CCD",31
46,"46239",451,353,351,3,2,"CCD",5
46,"46237",7227,5620,5571,33,49,"CCD",21
46,"46071",466,383,379,2,4,"CCD",0
46,"46221",339,305,303,0,2,"CCD",4
46,"46034",1776,1441,1430,4,11,"CCD",8
46,"46251",2490,2082,2045,11,37,"CCD",2
46,"46019",8833,7183,7109,47,74,"CCD",26
46,"46046",896,697,686,1,11,"CCD",4
46,"46158",1024,817,804,5,13,"CCD",2
46,"46256",6833,5087,5062,37,25,"CCD",34
46,"46049",280,242,238,1,4,"CCD",1
46,"46013",17366,13952,13862,95,90,"CCD",53
46,"46087",127,99,99,1,0,"CCD",1
46,"46231",2411,1759,1735,11,24,"CCD",6
46,"46169",32396,25109,24953,169,156,"CCD",119
46,"46172",5040,3629,3599,14,30,"CCD",33
46,"46232",894,715,712,5,3,"CCD",4
46,"46139",4495,3629,3577,26,52,"CCD",5
46,"46091",115,101,100,1,1,"CCD",0
46,"46098",2491,1978,1950,14,28,"CCD",10
46,"46902",379,314,313,3,1,"CCD",1
46,"46219",125,106,105,2,1,"CCD",0
46,"46108",480,375,375,2,0,"CCD",1
46,"46156",2087,1712,1702,9,10,"CCD",4
46,"46070",16903,13091,12999,64,92,"CCD",85
46,"46040",1098,914,907,4,7,"CCD",3
46,"46115",403,296,289,1,7,"CCD",1
46,"46119",783,672,666,7,6,"CCD",0
46,"46054",11251,8795,8731,46,64,"CCD",32
46,"46247",1024,743,733,2,10,"CCD",5
46,"46223",7814,6169,6129,33,40,"CCD",31
46,"46076",587,489,483,2,6,"CCD",0
46,"46033",197,169,168,1,1,"CCD",0
46,"46153",441,358,354,0,4,"CCD",1
46,"46254",1012,786,775,1,11,"CCD",1
46,"46027",948,795,781,3,14,"CCD",2
46,"46204",6781,5421,5379,15,42,"CCD",25
46,"46092",273,183,183,0,0,"CCD",1
46,"46190",48824,36748,36542,238,206,"CCD",234
46,"46202",16767,13171,13058,59,113,"CCD",72
46,"46123",1838,1466,1447,4,19,"CCD",5
46,"46079",326,267,265,2,2,"CCD",2
46,"46183",6009,4624,4563,18,61,"CCD",20
46,"46199",5742,4458,4425,34,33,"CCD",22
46,"46001",802,623,615,4,8,"CCD",3
46,"46065",1588,1246,1227,5,19,"CCD",8
46,"46214",15730,12427,12334,56,93,"CCD",34
46,"46246",1066,856,838,7,18,"CCD",5
46,"46113",2436,1864,1849,11,15,"CCD",15
46,"46904",802,662,654,7,8,"CCD",6
46,"46006",4529,3803,3748,18,55,"CCD",14
46,"46216",5039,4207,4188,20,19,"CCD",16
46,"46109",6195,4764,4682,23,82,"CCD",38
46,"46124",788,680,672,0,8,"CCD",1
46,"46005",22908,17565,17438,126,127,"CCD",106
46,"46146",1670,1333,1318,11,15,"CCD",8
46,"46048",3448,2817,2790,8,27,"CCD",14
46,"46209",1955,1531,1508,7,23,"CCD",11
46,"46010",914,725,716,4,9,"CCD",1
46,"46168",1938,1542,1530,11,12,"CCD",8
46,"46194",15552,11606,11505,69,101,"CCD",71
46,"46084",1576,1314,1298,6,16,"CCD",7
46,"46118",3795,2987,2962,18,25,"CCD",23
46,"46261",1720,1386,1369,10,17,"CCD",7
46,"46140",349,288,284,2,4,"CCD",0
46,"46032",5635,4529,4493,16,36,"CCD",39
46,"46069",161,126,122,0,4,"CCD",1
46,"46117",493,414,411,4,3,"CCD",1
46,"46178",4643,3465,3434,16,31,"CCD",16
46,"46228",2363,1854,1839,16,15,"CCD",5
46,"46262",232,172,168,0,4,"CCD",0
46,"46257",5579,4440,4391,26,49,"CCD",28
46,"46007",11953,9099,9038,65,61,"CCD",46
46,"46116",13153,10566,10518,62,48,"CCD",46
46,"46135",9655,7845,7810,32,35,"CCD",29
46,"46112",552,466,464,1,2,"CCD",4
46,"46203",3598,2962,2928,17,34,"CCD",7
46,"46236",975,810,806,4,4,"CCD",0
46,"46031",10520,7830,7759,70,71,"CCD",36
46,"46212",1612,1234,1214,5,20,"CCD",12
46,"46042",3389,2886,2844,19,42,"CCD",16
46,"46038",345,255,255,0,0,"CCD",0
46,"46215",1433,1152,1149,4,3,"CCD",0
46,"46163",1847,1508,1489,8,19,"CCD",4
46,"46003",963,841,815,1,26,"CCD",0
46,"46132",2148,1850,1830,12,20,"CCD",5
46,"46066",1255,1028,1020,6,8,"CCD",4
46,"46903",5985,4822,4796,24,26,"CCD",33
46,"46107",1915,1566,1553,2,13,"CCD",10
46,"46045",1261,1066,1041,3,25,"CCD",13
46,"46205",14323,11325,11224,55,101,"CCD",56
46,"46260",2572,2100,2081,10,19,"CCD",5
46,"46193",8795,7101,7061,40,40,"CCD",28
46,"46225",346,299,290,0,9,"CCD",3
46,"46133",563,458,455,2,3,"CCD",1
46,"46004",1924,1582,1559,11,23,"CCD",17
46,"46171",16587,12731,12627,79,104,"CCD",50
46,"46110",21260,16194,16084,76,110,"CCD",109
46,"46025",2502,2008,1993,6,15,"CCD",12
46,"46080",1025,795,784,4,11,"CCD",4
46,"46145",21946,16629,16495,80,134,"CCD",62
46,"46128",1601,1316,1281,5,35,"CCD",4
46,"46064",527,429,423,0,6,"CCD",4
46,"46028",395,346,339,2,7,"CCD",3
46,"46093",2117,1721,1710,10,11,"CCD",7
46,"46101",858,731,723,4,8,"CCD",2
46,"46166",8155,6521,6450,41,71,"CCD",43
46,"46243",141,122,120,0,2,"CCD",2
46,"46130",907,722,713,6,9,"CCD",5
46,"46008",2673,2201,2189,8,12,"CCD",12
46,"46242",340,291,285,1,6,"CCD",2
46,"46120",1109,919,902,4,17,"CCD",3
46,"46152",97,76,74,0,2,"CCD",2
46,"46014",3042,2456,2434,17,22,"CCD",6
46,"46011",7627,5496,5407,39,89,"CCD",16
46,"46127",2706,2212,2175,10,37,"CCD",6
46,"46081",10180,8055,7984,32,71,"CCD",42
46,"46088",176,140,138,0,2,"CCD",0
46,"46111",10876,8133,8050,35,83,"CCD",52
46,"46143",4215,3219,3171,27,48,"CCD",28
46,"46167",373,286,285,1,1,"CCD",2
46,"46062",4652,3650,3583,32,67,"CCD",29
46,"46170",3451,2821,2775,16,46,"CCD",9
46,"46061",337,281,281,3,0,"CCD",0
46,"46102",19843,15783,15676,102,107,"CCD",88
46,"46126",5555,4619,4574,26,45,"CCD",16
46,"46200",1909,1628,1609,5,19,"CCD",11
46,"46037",1119,952,941,2,11,"CCD",4
46,"46002",1175,947,935,5,12,"CCD",4
46,"46086",82,73,73,1,0,"CCD",0
46,"46238",13324,10023,9939,50,84,"CCD",46
46,"46012",888,723,703,3,20,"CCD",3
46,"46085",11147,8107,8033,57,74,"CCD",43
46,"46184",26467,20888,20675,138,213,"CCD",104
46,"46208",1114,931,922,3,9,"CCD",5
46,"46082",4947,3843,3814,25,29,"CCD",21
46,"46211",1723,1441,1434,13,7,"CCD",5
46,"46188",668,548,538,3,10,"CCD",12
46,"46226",48,44,44,0,0,"CCD",0
46,"46210",338,295,283,2,12,"CCD",6
46,"46021",23646,18220,18100,85,120,"CCD",115
46,"46104",1956,1567,1543,6,24,"CCD",4
46,"46162",1207,962,947,3,15,"CCD",5
46,"46187",1310,1036,1028,6,8,"CCD",11
46,"46179",2182,1823,1788,13,35,"CCD",20
46,"46217",886,724,712,3,12,"CCD",2
46,"46052",502,432,431,2,1,"CCD",2
46,"46072",3625,2993,2931,37,62,"CCD",8
46,"46015",7231,5768,5711,33,57,"CCD",34
46,"46018",635,531,522,3,9,"CCD",0
46,"46198",846,702,693,1,9,"CCD",3
46,"46122",2701,2120,2109,18,11,"CCD",18
46,"46233",3904,2974,2934,15,40,"CCD",16
46,"46207",6656,5355,5293,42,62,"CCD",27
46,"46103",1270,1015,998,8,17,"CCD",1
46,"46074",2690,2158,2145,18,13,"CCD",16
46,"46149",362,288,287,2,1,"CCD",5
46,"46073",1097,903,892,6,11,"CCD",2
46,"46138",345,292,292,0,0,"CCD",1
46,"46090",1640,1440,1424,4,16,"CCD",0
46,"46125",857,709,701,5,8,"CCD",2
46,"46089",2141,1649,1625,14,24,"CCD",7
46,"46165",7115,5626,5576,31,50,"CCD",26
46,"46252",126,95,93,0,2,"CCD",0
46,"46245",516,427,420,3,7,"CCD",2
46,"46058",1779,1430,1409,10,21,"CCD",6
46,"46180",682,581,572,1,9,"CCD",4
46,"46036",583,384,381,8,3,"CCD",1
46,"46009",3144,2579,2552,13,27,"CCD",11
46,"46182",1274,970,966,2,4,"CCD",6
46,"46105",16249,11731,11629,59,102,"CCD",70
46,"46154",811,644,640,4,4,"CCD",1
46,"46164",11777,8893,8798,54,95,"CCD",38
46,"46241",400,324,314,1,10,"CCD",3
46,"46142",797,619,608,2,11,"CCD",2
46,"46047",525,443,435,2,8,"CCD",4
46,"46051",8347,6500,6442,27,58,"CCD",27
46,"46020",3784,3064,3012,15,52,"CCD",41
46,"46106",1543,1177,1167,5,10,"CCD",1
46,"46067",1736,1457,1382,2,75,"CCD",4
46,"46148",1528,1206,1192,15,14,"CCD",6
46,"46077",7569,6100,6010,41,90,"CCD",15
46,"46151",722,589,583,1,6,"CCD",2
46,"46173",1336,1097,1080,9,17,"CCD",6
46,"46218",1074,930,912,1,18,"CCD",5
46,"46192",767,573,568,1,5,"CCD",2
46,"46220",48393,35859,35571,250,288,"CCD",167
46,"46181",17066,12779,12636,96,143,"CCD",79
46,"46100",289,240,237,1,3,"CCD",2
46,"46043",145,131,131,0,0,"CCD",0
46,"46176",2025,1431,1416,10,15,"CCD",9
46,"46191",1970,1557,1533,6,24,"CCD",1
46,"46063",1757,1399,1384,11,15,"CCD",3
46,"46186",19033,15061,14950,70,111,"CCD",97
46,"46068",354,305,297,1,8,"CCD",1
46,"46095",608,498,493,2,5,"CCD",3
46,"46197",1956,1556,1543,8,13,"CCD",7
46,"46201",67,49,49,0,0,"CCD",0
46,"46078",28126,20975,20850,127,125,"CCD",102
46,"46259",503,410,406,2,4,"CCD",0
46,"46057",495,339,337,6,2,"CCD",1
46,"46253",109,93,93,0,0,"CCD",0
35,"35014",11169,6234,6107,59,127,"PUM+J",2
35,"35013",6609,4997,4881,51,116,"PUM+J",4
35,"35026",80806,53749,52665,450,1084,"PUM+J",60
35,"35012",10331,5684,5610,32,74,"PUM+J",4
35,"35010",3548,2371,2336,20,35,"PUM+J",0
35,"35020",6054,4073,4018,26,55,"PUM+J",3
35,"35017",25447,15415,15079,127,336,"PUM+J",14
35,"35001",4599,3455,3396,27,59,"PUM+J",3
35,"35009",19832,14305,14036,97,269,"PUM+J",15
35,"35004",38814,20869,20641,192,228,"PUM+J",27
35,"35005",1071,718,711,6,7,"PUM+J",0
35,"35018",12463,7628,7546,56,82,"PUM+J",6
35,"35003",5125,2989,2929,21,60,"PUM+J",0
35,"35002",23129,15904,15675,74,229,"PUM+J",11
35,"35032",3432,2541,2498,19,43,"PUM+J",0
35,"35019",32253,19902,19621,126,281,"PUM+J",40
35,"35011",23882,16369,16095,107,274,"PUM+J",19
35,"35028",9705,5552,5478,64,74,"PUM+J",7
35,"35023",11680,8467,8295,75,172,"PUM+J",7
35,"35030",9205,5602,5501,58,101,"PUM+J",3
35,"35008",6109,4631,4542,37,89,"PUM+J",7
35,"35024",13621,8665,8555,76,110,"PUM+J",3
35,"35015",9870,5451,5368,29,83,"PUM+J",1
35,"35021",14942,10691,10537,80,154,"PUM+J",11
35,"35022",48059,30474,30134,219,340,"PUM+J",21
35,"35016",297974,198159,195935,1546,2224,"PUM+J",271
35,"35029",4125,2545,2514,34,31,"PUM+J",5
35,"35007",515,332,330,2,2,"PUM+J",0
35,"35006",30302,21967,21625,243,342,"PUM+J",25
35,"35031",7270,5184,5000,36,184,"PUM+J",8
35,"35025",1801,1239,1216,9,23,"PUM+J",1
35,"35034",7707,3921,3872,30,49,"PUM+J",5
35,"35033",6378,4412,4354,24,58,"PUM+J",3
35,"35027",10311,7497,7364,58,133,"PUM+J",25
4,"4046",862,658,656,6,2,"FE de las J",2
4,"4016",2146,1584,1564,8,20,"FE de las J",4
4,"4024",3036,2325,2308,18,17,"FE de las J",3
4,"4033",139,100,97,3,3,"FE de las J",0
4,"4021",187,148,141,1,7,"FE de las J",0
4,"4047",2278,1906,1891,13,15,"FE de las J",6
4,"4099",4988,3784,3714,26,70,"FE de las J",4
4,"4014",153,118,118,0,0,"FE de las J",0
4,"4060",466,361,358,2,3,"FE de las J",0
4,"4081",356,290,290,2,0,"FE de las J",1
4,"4904",1759,1185,1172,15,13,"FE de las J",0
4,"4088",2475,1717,1703,10,14,"FE de las J",0
4,"4066",13573,8651,8570,65,81,"FE de las J",8
4,"4049",5280,3658,3623,20,35,"FE de las J",3
4,"4017",1301,881,876,5,5,"FE de las J",3
4,"4061",618,495,491,5,4,"FE de las J",0
4,"4095",726,466,463,2,3,"FE de las J",0
4,"4010",579,469,464,2,5,"FE de las J",1
4,"4012",191,170,169,1,1,"FE de las J",0
4,"4035",8375,6079,6031,28,48,"FE de las J",4
4,"4100",8712,5545,5482,30,63,"FE de las J",6
4,"4013",141116,95203,94625,669,578,"FE de las J",113
4,"4041",318,241,241,6,0,"FE de las J",1
4,"4097",254,196,194,0,2,"FE de las J",1
4,"4032",5606,3789,3770,19,19,"FE de las J",4
4,"4011",2798,2244,2220,14,24,"FE de las J",7
4,"4018",274,245,242,0,3,"FE de las J",0
4,"4069",4692,3641,3607,29,34,"FE de las J",3
4,"4101",4283,2969,2950,22,19,"FE de las J",4
4,"4077",303,277,274,2,3,"FE de las J",1
4,"4031",2359,1791,1786,7,5,"FE de las J",0
4,"4070",1623,1233,1229,7,4,"FE de las J",0
4,"4082",306,210,209,0,1,"FE de las J",0
4,"4007",736,553,551,0,2,"FE de las J",2
4,"4030",1140,828,826,8,2,"FE de las J",0
4,"4093",1872,1265,1252,10,13,"FE de las J",1
4,"4079",50800,33862,33629,200,233,"FE de las J",40
4,"4063",1099,847,835,2,12,"FE de las J",1
4,"4094",209,141,141,1,0,"FE de las J",0
4,"4004",421,314,312,2,2,"FE de las J",0
4,"4002",1063,765,760,1,5,"FE de las J",1
4,"4034",173,108,108,3,0,"FE de las J",0
4,"4075",5152,3772,3715,19,57,"FE de las J",2
4,"4072",311,247,244,14,3,"FE de las J",0
4,"4078",1095,784,779,7,5,"FE de las J",0
4,"4059",1100,752,745,7,7,"FE de las J",1
4,"4096",274,208,206,0,2,"FE de las J",0
4,"4015",130,98,98,1,0,"FE de las J",0
4,"4036",228,176,175,2,1,"FE de las J",0
4,"4903",4345,2896,2875,35,21,"FE de las J",3
4,"4067",584,432,424,0,8,"FE de las J",0
4,"4098",1537,1157,1147,8,10,"FE de las J",1
4,"4065",366,290,288,2,2,"FE de las J",0
4,"4103",1478,1051,1037,6,14,"FE de las J",2
4,"4091",342,280,278,4,2,"FE de las J",0
4,"4090",309,242,242,1,0,"FE de las J",0
4,"4087",189,140,139,1,1,"FE de las J",0
4,"4028",226,198,197,0,1,"FE de las J",0
4,"4050",830,597,594,3,3,"FE de las J",0
4,"4003",17365,10931,10830,57,101,"FE de las J",12
4,"4051",440,373,372,0,1,"FE de las J",0
4,"4064",2779,2032,2009,8,23,"FE de las J",4
4,"4019",251,199,198,0,1,"FE de las J",1
4,"4102",13729,8987,8878,114,109,"FE de las J",12
4,"4089",746,536,528,6,8,"FE de las J",0
4,"4092",2852,2192,2168,13,24,"FE de las J",1
4,"4076",1296,1005,993,7,12,"FE de las J",1
4,"4001",1083,812,796,6,16,"FE de las J",1
4,"4037",1312,1019,1000,6,19,"FE de las J",0
4,"4043",546,466,462,3,4,"FE de las J",5
4,"4029",8887,6103,6048,53,55,"FE de las J",6
4,"4005",577,438,432,1,6,"FE de las J",1
4,"4068",195,158,158,0,0,"FE de las J",0
4,"4020",292,208,207,1,1,"FE de las J",0
4,"4073",332,231,230,2,1,"FE de las J",0
4,"4057",1337,941,933,2,8,"FE de las J",1
4,"4062",4528,3610,3579,20,31,"FE de las J",0
4,"4052",12246,8393,8353,84,40,"FE de las J",6
4,"4038",3066,2169,2150,20,19,"FE de las J",1
4,"4044",1555,1253,1243,9,10,"FE de las J",1
4,"4006",7016,4823,4786,33,37,"FE de las J",4
4,"4056",147,123,120,0,3,"FE de las J",0
4,"4054",363,297,292,1,5,"FE de las J",0
4,"4055",372,315,315,0,0,"FE de las J",0
4,"4901",539,388,386,0,2,"FE de las J",0
4,"4045",1777,1402,1392,9,10,"FE de las J",2
4,"4009",169,127,126,0,1,"FE de las J",0
4,"4083",1790,1384,1379,8,5,"FE de las J",0
4,"4048",1503,1104,1096,7,8,"FE de las J",0
4,"4071",398,327,326,2,1,"FE de las J",0
4,"4902",45373,28425,28220,249,205,"FE de las J",37
4,"4074",2829,1965,1945,24,20,"FE de las J",2
4,"4026",70,60,60,0,0,"FE de las J",0
4,"4058",369,292,291,2,1,"FE de las J",0
4,"4027",249,163,163,1,0,"FE de las J",1
4,"4080",226,185,182,2,3,"FE de las J",0
4,"4053",12333,9124,9040,66,84,"FE de las J",5
4,"4022",348,243,242,1,1,"FE de las J",1
4,"4008",501,420,415,3,5,"FE de las J",0
4,"4085",395,302,298,0,4,"FE de las J",0
4,"4086",1792,1271,1258,8,13,"FE de las J",2
4,"4084",337,264,261,1,3,"FE de las J",0
4,"4023",139,104,102,1,2,"FE de las J",0
46,"46235",21793,16577,16424,118,153,"RECORTES CE",31
46,"46205",14323,11325,11224,55,101,"RECORTES CE",12
46,"46145",21946,16629,16495,80,134,"RECORTES CE",14
46,"46169",32396,25109,24953,169,156,"RECORTES CE",87
46,"46134",2357,1811,1797,8,14,"RECORTES CE",1
46,"46112",552,466,464,1,2,"RECORTES CE",1
46,"46126",5555,4619,4574,26,45,"RECORTES CE",5
46,"46046",896,697,686,1,11,"RECORTES CE",2
46,"46002",1175,947,935,5,12,"RECORTES CE",1
46,"46185",386,325,321,4,4,"RECORTES CE",0
46,"46248",4873,3679,3639,18,40,"RECORTES CE",4
46,"46129",521,435,434,2,1,"RECORTES CE",0
46,"46122",2701,2120,2109,18,11,"RECORTES CE",2
46,"46082",4947,3843,3814,25,29,"RECORTES CE",6
46,"46172",5040,3629,3599,14,30,"RECORTES CE",6
46,"46136",2534,2008,1990,13,18,"RECORTES CE",4
46,"46086",82,73,73,1,0,"RECORTES CE",0
46,"46243",141,122,120,0,2,"RECORTES CE",0
46,"46174",984,808,794,3,14,"RECORTES CE",0
46,"46180",682,581,572,1,9,"RECORTES CE",0
46,"46190",48824,36748,36542,238,206,"RECORTES CE",93
46,"46102",19843,15783,15676,102,107,"RECORTES CE",35
46,"46005",22908,17565,17438,126,127,"RECORTES CE",50
46,"46255",3145,2494,2470,19,24,"RECORTES CE",5
46,"46079",326,267,265,2,2,"RECORTES CE",0
46,"46022",15481,11422,11347,69,75,"RECORTES CE",28
46,"46230",13944,10746,10646,69,100,"RECORTES CE",15
46,"46178",4643,3465,3434,16,31,"RECORTES CE",6
46,"46164",11777,8893,8798,54,95,"RECORTES CE",23
46,"46250",578668,455375,452638,2701,2737,"RECORTES CE",949
46,"46026",1204,1044,1034,4,10,"RECORTES CE",0
46,"46249",9362,7163,7072,42,91,"RECORTES CE",7
46,"46153",441,358,354,0,4,"RECORTES CE",0
46,"46224",170,130,130,0,0,"RECORTES CE",1
46,"46097",959,734,728,6,6,"RECORTES CE",3
46,"46054",11251,8795,8731,46,64,"RECORTES CE",27
46,"46189",471,412,405,2,7,"RECORTES CE",0
46,"46099",922,693,685,0,8,"RECORTES CE",0
46,"46234",354,289,287,2,2,"RECORTES CE",0
46,"46074",2690,2158,2145,18,13,"RECORTES CE",6
46,"46039",2147,1746,1727,9,19,"RECORTES CE",2
46,"46229",972,785,774,2,11,"RECORTES CE",1
46,"46043",145,131,131,0,0,"RECORTES CE",0
46,"46101",858,731,723,4,8,"RECORTES CE",0
46,"46060",9361,7285,7229,30,56,"RECORTES CE",6
46,"46096",279,229,225,2,4,"RECORTES CE",0
46,"46133",563,458,455,2,3,"RECORTES CE",1
46,"46052",502,432,431,2,1,"RECORTES CE",1
46,"46042",3389,2886,2844,19,42,"RECORTES CE",3
46,"46037",1119,952,941,2,11,"RECORTES CE",0
46,"46021",23646,18220,18100,85,120,"RECORTES CE",58
46,"46107",1915,1566,1553,2,13,"RECORTES CE",1
46,"46151",722,589,583,1,6,"RECORTES CE",0
46,"46119",783,672,666,7,6,"RECORTES CE",2
46,"46162",1207,962,947,3,15,"RECORTES CE",0
46,"46117",493,414,411,4,3,"RECORTES CE",1
46,"46231",2411,1759,1735,11,24,"RECORTES CE",1
46,"46076",587,489,483,2,6,"RECORTES CE",0
46,"46031",10520,7830,7759,70,71,"RECORTES CE",8
46,"46159",22905,17498,17373,102,125,"RECORTES CE",31
46,"46242",340,291,285,1,6,"RECORTES CE",2
46,"46135",9655,7845,7810,32,35,"RECORTES CE",10
46,"46004",1924,1582,1559,11,23,"RECORTES CE",1
46,"46227",915,771,765,5,6,"RECORTES CE",1
46,"46087",127,99,99,1,0,"RECORTES CE",0
46,"46109",6195,4764,4682,23,82,"RECORTES CE",7
46,"46161",1481,1206,1194,6,12,"RECORTES CE",1
46,"46069",161,126,122,0,4,"RECORTES CE",0
46,"46049",280,242,238,1,4,"RECORTES CE",1
46,"46113",2436,1864,1849,11,15,"RECORTES CE",1
46,"46120",1109,919,902,4,17,"RECORTES CE",0
46,"46029",20649,15241,15110,113,131,"RECORTES CE",36
46,"46094",20515,15885,15785,125,100,"RECORTES CE",34
46,"46213",15476,11377,11246,110,131,"RECORTES CE",25
46,"46128",1601,1316,1281,5,35,"RECORTES CE",0
46,"46143",4215,3219,3171,27,48,"RECORTES CE",1
46,"46183",6009,4624,4563,18,61,"RECORTES CE",8
46,"46028",395,346,339,2,7,"RECORTES CE",0
46,"46158",1024,817,804,5,13,"RECORTES CE",2
46,"46193",8795,7101,7061,40,40,"RECORTES CE",11
46,"46006",4529,3803,3748,18,55,"RECORTES CE",2
46,"46040",1098,914,907,4,7,"RECORTES CE",1
46,"46167",373,286,285,1,1,"RECORTES CE",0
46,"46083",15467,11584,11443,79,141,"RECORTES CE",18
46,"46017",33050,24762,24580,144,182,"RECORTES CE",38
46,"46007",11953,9099,9038,65,61,"RECORTES CE",23
46,"46210",338,295,283,2,12,"RECORTES CE",3
46,"46008",2673,2201,2189,8,12,"RECORTES CE",2
46,"46219",125,106,105,2,1,"RECORTES CE",0
46,"46216",5039,4207,4188,20,19,"RECORTES CE",7
46,"46108",480,375,375,2,0,"RECORTES CE",0
46,"46023",328,294,287,2,7,"RECORTES CE",3
46,"46032",5635,4529,4493,16,36,"RECORTES CE",10
46,"46114",575,488,484,3,4,"RECORTES CE",1
46,"46200",1909,1628,1609,5,19,"RECORTES CE",1
46,"46152",97,76,74,0,2,"RECORTES CE",0
46,"46262",232,172,168,0,4,"RECORTES CE",0
46,"46033",197,169,168,1,1,"RECORTES CE",0
46,"46124",788,680,672,0,8,"RECORTES CE",1
46,"46104",1956,1567,1543,6,24,"RECORTES CE",1
46,"46246",1066,856,838,7,18,"RECORTES CE",0
46,"46132",2148,1850,1830,12,20,"RECORTES CE",2
46,"46059",1272,1066,1058,4,8,"RECORTES CE",0
46,"46156",2087,1712,1702,9,10,"RECORTES CE",1
46,"46245",516,427,420,3,7,"RECORTES CE",1
46,"46232",894,715,712,5,3,"RECORTES CE",0
46,"46092",273,183,183,0,0,"RECORTES CE",0
46,"46070",16903,13091,12999,64,92,"RECORTES CE",26
46,"46206",577,475,468,4,7,"RECORTES CE",0
46,"46239",451,353,351,3,2,"RECORTES CE",1
46,"46115",403,296,289,1,7,"RECORTES CE",0
46,"46110",21260,16194,16084,76,110,"RECORTES CE",47
46,"46041",331,254,253,6,1,"RECORTES CE",1
46,"46166",8155,6521,6450,41,71,"RECORTES CE",8
46,"46125",857,709,701,5,8,"RECORTES CE",1
46,"46226",48,44,44,0,0,"RECORTES CE",0
46,"46221",339,305,303,0,2,"RECORTES CE",0
46,"46252",126,95,93,0,2,"RECORTES CE",0
46,"46207",6656,5355,5293,42,62,"RECORTES CE",5
46,"46045",1261,1066,1041,3,25,"RECORTES CE",0
46,"46146",1670,1333,1318,11,15,"RECORTES CE",1
46,"46131",49604,37767,37431,266,336,"RECORTES CE",60
46,"46236",975,810,806,4,4,"RECORTES CE",1
46,"46044",4237,3347,3285,25,62,"RECORTES CE",1
46,"46091",115,101,100,1,1,"RECORTES CE",0
46,"46154",811,644,640,4,4,"RECORTES CE",1
46,"46090",1640,1440,1424,4,16,"RECORTES CE",0
46,"46140",349,288,284,2,4,"RECORTES CE",0
46,"46027",948,795,781,3,14,"RECORTES CE",0
46,"46194",15552,11606,11505,69,101,"RECORTES CE",21
46,"46228",2363,1854,1839,16,15,"RECORTES CE",3
46,"46064",527,429,423,0,6,"RECORTES CE",0
46,"46238",13324,10023,9939,50,84,"RECORTES CE",11
46,"46211",1723,1441,1434,13,7,"RECORTES CE",1
46,"46903",5985,4822,4796,24,26,"RECORTES CE",8
46,"46261",1720,1386,1369,10,17,"RECORTES CE",0
46,"46175",459,403,396,1,7,"RECORTES CE",0
46,"46089",2141,1649,1625,14,24,"RECORTES CE",2
46,"46254",1012,786,775,1,11,"RECORTES CE",1
46,"46233",3904,2974,2934,15,40,"RECORTES CE",2
46,"46061",337,281,281,3,0,"RECORTES CE",1
46,"46038",345,255,255,0,0,"RECORTES CE",1
46,"46014",3042,2456,2434,17,22,"RECORTES CE",2
46,"46118",3795,2987,2962,18,25,"RECORTES CE",1
46,"46199",5742,4458,4425,34,33,"RECORTES CE",6
46,"46011",7627,5496,5407,39,89,"RECORTES CE",1
46,"46168",1938,1542,1530,11,12,"RECORTES CE",2
46,"46163",1847,1508,1489,8,19,"RECORTES CE",2
46,"46024",424,348,340,0,8,"RECORTES CE",2
46,"46137",268,225,220,3,5,"RECORTES CE",0
46,"46003",963,841,815,1,26,"RECORTES CE",1
46,"46173",1336,1097,1080,9,17,"RECORTES CE",0
46,"46085",11147,8107,8033,57,74,"RECORTES CE",12
46,"46071",466,383,379,2,4,"RECORTES CE",0
46,"46093",2117,1721,1710,10,11,"RECORTES CE",1
46,"46144",665,525,520,2,5,"RECORTES CE",0
46,"46139",4495,3629,3577,26,52,"RECORTES CE",3
46,"46217",886,724,712,3,12,"RECORTES CE",1
46,"46182",1274,970,966,2,4,"RECORTES CE",4
46,"46244",58586,43371,43098,257,273,"RECORTES CE",125
46,"46263",255,204,202,1,2,"RECORTES CE",0
46,"46121",105,92,91,2,1,"RECORTES CE",0
46,"46902",379,314,313,3,1,"RECORTES CE",0
46,"46160",1912,1523,1514,3,9,"RECORTES CE",3
46,"46188",668,548,538,3,10,"RECORTES CE",1
46,"46237",7227,5620,5571,33,49,"RECORTES CE",9
46,"46036",583,384,381,8,3,"RECORTES CE",0
46,"46223",7814,6169,6129,33,40,"RECORTES CE",14
46,"46257",5579,4440,4391,26,49,"RECORTES CE",4
46,"46016",1068,885,874,3,11,"RECORTES CE",0
46,"46184",26467,20888,20675,138,213,"RECORTES CE",26
46,"46204",6781,5421,5379,15,42,"RECORTES CE",7
46,"46056",184,160,158,1,2,"RECORTES CE",0
46,"46208",1114,931,922,3,9,"RECORTES CE",1
46,"46025",2502,2008,1993,6,15,"RECORTES CE",2
46,"46051",8347,6500,6442,27,58,"RECORTES CE",10
46,"46018",635,531,522,3,9,"RECORTES CE",1
46,"46155",1035,865,846,2,19,"RECORTES CE",0
46,"46179",2182,1823,1788,13,35,"RECORTES CE",1
46,"46198",846,702,693,1,9,"RECORTES CE",0
46,"46080",1025,795,784,4,11,"RECORTES CE",1
46,"46220",48393,35859,35571,250,288,"RECORTES CE",67
46,"46098",2491,1978,1950,14,28,"RECORTES CE",1
46,"46010",914,725,716,4,9,"RECORTES CE",0
46,"46247",1024,743,733,2,10,"RECORTES CE",0
46,"46258",2676,2099,2078,9,21,"RECORTES CE",3
46,"46191",1970,1557,1533,6,24,"RECORTES CE",1
46,"46165",7115,5626,5576,31,50,"RECORTES CE",22
46,"46212",1612,1234,1214,5,20,"RECORTES CE",3
46,"46241",400,324,314,1,10,"RECORTES CE",0
46,"46053",560,454,451,2,3,"RECORTES CE",0
46,"46123",1838,1466,1447,4,19,"RECORTES CE",3
46,"46065",1588,1246,1227,5,19,"RECORTES CE",1
46,"46048",3448,2817,2790,8,27,"RECORTES CE",3
46,"46222",383,322,321,2,1,"RECORTES CE",0
46,"46075",149,132,130,2,2,"RECORTES CE",0
46,"46034",1776,1441,1430,4,11,"RECORTES CE",2
46,"46150",1839,1377,1362,10,15,"RECORTES CE",0
46,"46035",6786,5382,5338,27,44,"RECORTES CE",9
46,"46192",767,573,568,1,5,"RECORTES CE",1
46,"46260",2572,2100,2081,10,19,"RECORTES CE",1
46,"46105",16249,11731,11629,59,102,"RECORTES CE",18
46,"46157",2978,2370,2343,19,27,"RECORTES CE",4
46,"46195",1967,1612,1602,9,10,"RECORTES CE",1
46,"46055",1273,1031,1021,4,10,"RECORTES CE",3
46,"46081",10180,8055,7984,32,71,"RECORTES CE",9
46,"46015",7231,5768,5711,33,57,"RECORTES CE",7
46,"46020",3784,3064,3012,15,52,"RECORTES CE",2
46,"46130",907,722,713,6,9,"RECORTES CE",0
46,"46001",802,623,615,4,8,"RECORTES CE",1
46,"46019",8833,7183,7109,47,74,"RECORTES CE",1
46,"46186",19033,15061,14950,70,111,"RECORTES CE",27
46,"46170",3451,2821,2775,16,46,"RECORTES CE",1
46,"46084",1576,1314,1298,6,16,"RECORTES CE",0
46,"46058",1779,1430,1409,10,21,"RECORTES CE",2
46,"46215",1433,1152,1149,4,3,"RECORTES CE",0
46,"46904",802,662,654,7,8,"RECORTES CE",2
46,"46013",17366,13952,13862,95,90,"RECORTES CE",29
46,"46141",438,359,348,4,11,"RECORTES CE",0
46,"46225",346,299,290,0,9,"RECORTES CE",0
46,"46103",1270,1015,998,8,17,"RECORTES CE",0
46,"46050",200,160,160,0,0,"RECORTES CE",1
46,"46256",6833,5087,5062,37,25,"RECORTES CE",16
46,"46147",16843,12206,12099,56,107,"RECORTES CE",31
46,"46176",2025,1431,1416,10,15,"RECORTES CE",4
46,"46068",354,305,297,1,8,"RECORTES CE",0
46,"46127",2706,2212,2175,10,37,"RECORTES CE",1
46,"46149",362,288,287,2,1,"RECORTES CE",1
46,"46177",4698,3715,3665,16,50,"RECORTES CE",7
46,"46063",1757,1399,1384,11,15,"RECORTES CE",4
46,"46073",1097,903,892,6,11,"RECORTES CE",0
46,"46259",503,410,406,2,4,"RECORTES CE",3
46,"46251",2490,2082,2045,11,37,"RECORTES CE",1
46,"46214",15730,12427,12334,56,93,"RECORTES CE",30
46,"46209",1955,1531,1508,7,23,"RECORTES CE",1
46,"46077",7569,6100,6010,41,90,"RECORTES CE",4
46,"46030",804,660,635,7,25,"RECORTES CE",0
46,"46197",1956,1556,1543,8,13,"RECORTES CE",4
46,"46111",10876,8133,8050,35,83,"RECORTES CE",14
46,"46066",1255,1028,1020,6,8,"RECORTES CE",0
46,"46218",1074,930,912,1,18,"RECORTES CE",0
46,"46171",16587,12731,12627,79,104,"RECORTES CE",34
46,"46100",289,240,237,1,3,"RECORTES CE",0
46,"46009",3144,2579,2552,13,27,"RECORTES CE",3
46,"46012",888,723,703,3,20,"RECORTES CE",1
46,"46057",495,339,337,6,2,"RECORTES CE",0
46,"46072",3625,2993,2931,37,62,"RECORTES CE",1
46,"46142",797,619,608,2,11,"RECORTES CE",0
46,"46078",28126,20975,20850,127,125,"RECORTES CE",43
46,"46116",13153,10566,10518,62,48,"RECORTES CE",13
46,"46088",176,140,138,0,2,"RECORTES CE",0
46,"46138",345,292,292,0,0,"RECORTES CE",1
46,"46181",17066,12779,12636,96,143,"RECORTES CE",21
46,"46187",1310,1036,1028,6,8,"RECORTES CE",4
46,"46253",109,93,93,0,0,"RECORTES CE",1
46,"46095",608,498,493,2,5,"RECORTES CE",0
46,"46062",4652,3650,3583,32,67,"RECORTES CE",5
46,"46196",153,131,130,0,1,"RECORTES CE",0
46,"46067",1736,1457,1382,2,75,"RECORTES CE",1
46,"46201",67,49,49,0,0,"RECORTES CE",0
46,"46106",1543,1177,1167,5,10,"RECORTES CE",1
46,"46148",1528,1206,1192,15,14,"RECORTES CE",2
46,"46203",3598,2962,2928,17,34,"RECORTES CE",1
46,"46047",525,443,435,2,8,"RECORTES CE",0
46,"46240",209,169,164,1,5,"RECORTES CE",0
46,"46202",16767,13171,13058,59,113,"RECORTES CE",22
35,"35011",23882,16369,16095,107,274,"UPYD",67
35,"35004",38814,20869,20641,192,228,"UPYD",55
35,"35030",9205,5602,5501,58,101,"UPYD",19
35,"35021",14942,10691,10537,80,154,"UPYD",57
35,"35001",4599,3455,3396,27,59,"UPYD",8
35,"35014",11169,6234,6107,59,127,"UPYD",35
35,"35020",6054,4073,4018,26,55,"UPYD",14
35,"35022",48059,30474,30134,219,340,"UPYD",147
35,"35010",3548,2371,2336,20,35,"UPYD",6
35,"35024",13621,8665,8555,76,110,"UPYD",29
35,"35026",80806,53749,52665,450,1084,"UPYD",236
35,"35033",6378,4412,4354,24,58,"UPYD",23
35,"35005",1071,718,711,6,7,"UPYD",3
35,"35012",10331,5684,5610,32,74,"UPYD",25
35,"35029",4125,2545,2514,34,31,"UPYD",5
35,"35034",7707,3921,3872,30,49,"UPYD",16
35,"35003",5125,2989,2929,21,60,"UPYD",8
35,"35032",3432,2541,2498,19,43,"UPYD",5
35,"35007",515,332,330,2,2,"UPYD",0
35,"35023",11680,8467,8295,75,172,"UPYD",31
35,"35019",32253,19902,19621,126,281,"UPYD",95
35,"35009",19832,14305,14036,97,269,"UPYD",76
35,"35028",9705,5552,5478,64,74,"UPYD",26
35,"35002",23129,15904,15675,74,229,"UPYD",67
35,"35027",10311,7497,7364,58,133,"UPYD",33
35,"35015",9870,5451,5368,29,83,"UPYD",17
35,"35006",30302,21967,21625,243,342,"UPYD",83
35,"35016",297974,198159,195935,1546,2224,"UPYD",1213
35,"35018",12463,7628,7546,56,82,"UPYD",25
35,"35025",1801,1239,1216,9,23,"UPYD",8
35,"35031",7270,5184,5000,36,184,"UPYD",22
35,"35008",6109,4631,4542,37,89,"UPYD",20
35,"35013",6609,4997,4881,51,116,"UPYD",17
35,"35017",25447,15415,15079,127,336,"UPYD",66
10,"10047",972,783,777,1,6,"UPYD",3
10,"10191",532,417,415,12,2,"UPYD",2
10,"10149",435,315,307,1,8,"UPYD",0
10,"10059",369,258,255,0,3,"UPYD",0
10,"10181",694,571,558,7,13,"UPYD",1
10,"10167",306,240,237,0,3,"UPYD",0
10,"10039",427,295,290,0,5,"UPYD",3
10,"10145",126,101,100,1,1,"UPYD",0
10,"10169",544,430,423,0,7,"UPYD",3
10,"10903",819,629,624,7,5,"UPYD",2
10,"10119",630,461,455,2,6,"UPYD",0
10,"10118",289,257,257,1,0,"UPYD",0
10,"10134",565,395,393,1,2,"UPYD",2
10,"10124",862,692,678,7,14,"UPYD",1
10,"10024",687,538,533,6,5,"UPYD",0
10,"10216",1543,1200,1192,9,8,"UPYD",2
10,"10098",385,294,286,0,8,"UPYD",0
10,"10144",996,755,748,3,7,"UPYD",1
10,"10080",368,276,272,1,4,"UPYD",2
10,"10120",176,125,125,2,0,"UPYD",0
10,"10106",134,111,111,1,0,"UPYD",0
10,"10147",1275,985,937,6,48,"UPYD",2
10,"10083",90,69,69,0,0,"UPYD",0
10,"10010",2322,1446,1431,12,15,"UPYD",2
10,"10116",3784,2839,2801,21,38,"UPYD",5
10,"10014",1874,1430,1401,11,29,"UPYD",4
10,"10160",225,172,170,0,2,"UPYD",0
10,"10186",994,830,816,4,14,"UPYD",2
10,"10002",368,278,275,0,3,"UPYD",0
10,"10140",1114,860,848,6,12,"UPYD",2
10,"10092",301,238,236,2,2,"UPYD",0
10,"10088",205,117,117,0,0,"UPYD",0
10,"10097",106,79,79,0,0,"UPYD",0
10,"10161",75,53,53,0,0,"UPYD",0
10,"10067",10486,7796,7692,54,104,"UPYD",24
10,"10203",4600,3268,3215,14,53,"UPYD",13
10,"10034",350,263,262,1,1,"UPYD",0
10,"10132",400,258,256,0,2,"UPYD",0
10,"10052",193,127,126,1,1,"UPYD",2
10,"10112",1583,1203,1176,7,27,"UPYD",2
10,"10901",1184,851,835,2,16,"UPYD",2
10,"10122",231,166,163,0,3,"UPYD",0
10,"10210",551,380,373,1,7,"UPYD",0
10,"10023",846,647,637,1,10,"UPYD",3
10,"10056",591,456,452,5,4,"UPYD",1
10,"10033",430,304,301,1,3,"UPYD",1
10,"10195",7768,5818,5723,58,95,"UPYD",31
10,"10129",363,272,266,4,6,"UPYD",2
10,"10100",795,602,595,4,7,"UPYD",1
10,"10069",831,647,637,2,10,"UPYD",0
10,"10209",296,195,193,1,2,"UPYD",1
10,"10189",2656,2006,1971,10,35,"UPYD",3
10,"10062",413,345,341,3,4,"UPYD",2
10,"10165",259,212,209,0,3,"UPYD",2
10,"10127",4724,3529,3463,15,66,"UPYD",13
10,"10155",1140,856,842,3,14,"UPYD",1
10,"10102",531,413,410,4,3,"UPYD",0
10,"10041",1056,823,811,4,12,"UPYD",3
10,"10141",268,190,189,2,1,"UPYD",0
10,"10007",646,488,478,3,10,"UPYD",1
10,"10044",1451,1100,1087,7,13,"UPYD",7
10,"10082",1893,1528,1484,13,44,"UPYD",1
10,"10197",134,94,93,0,1,"UPYD",0
10,"10148",32985,23666,23394,189,272,"UPYD",162
10,"10096",3443,2503,2464,14,39,"UPYD",8
10,"10001",285,226,225,2,1,"UPYD",0
10,"10208",124,100,98,1,2,"UPYD",0
10,"10006",1275,1024,1004,7,20,"UPYD",0
10,"10070",720,548,540,0,8,"UPYD",1
10,"10177",1703,1331,1296,10,35,"UPYD",3
10,"10104",5169,3766,3703,21,63,"UPYD",11
10,"10142",824,620,616,5,4,"UPYD",1
10,"10204",442,345,342,5,3,"UPYD",1
10,"10081",179,133,129,0,4,"UPYD",0
10,"10904",750,522,520,5,2,"UPYD",2
10,"10068",746,601,586,3,15,"UPYD",8
10,"10183",993,763,761,4,2,"UPYD",7
10,"10058",1025,747,737,5,10,"UPYD",13
10,"10193",1421,1150,1130,10,20,"UPYD",4
10,"10018",1722,1255,1240,6,15,"UPYD",5
10,"10150",354,301,295,4,6,"UPYD",0
10,"10154",184,138,134,1,4,"UPYD",0
10,"10214",208,172,170,0,2,"UPYD",0
10,"10101",185,147,147,1,0,"UPYD",0
10,"10021",5198,3960,3878,40,82,"UPYD",18
10,"10137",399,344,343,4,1,"UPYD",0
10,"10011",570,450,443,2,7,"UPYD",1
10,"10164",742,513,508,1,5,"UPYD",0
10,"10084",1370,934,906,7,28,"UPYD",4
10,"10005",537,411,398,3,13,"UPYD",0
10,"10128",5752,4219,4146,39,73,"UPYD",12
10,"10162",579,483,476,0,7,"UPYD",0
10,"10054",545,427,426,6,1,"UPYD",0
10,"10143",158,121,121,0,0,"UPYD",1
10,"10139",111,84,83,0,1,"UPYD",1
10,"10171",340,262,261,1,1,"UPYD",0
10,"10057",150,112,111,0,1,"UPYD",0
10,"10030",477,316,304,1,12,"UPYD",0
10,"10170",263,204,202,2,2,"UPYD",0
10,"10109",1804,1233,1212,2,21,"UPYD",3
10,"10040",443,344,342,4,2,"UPYD",0
10,"10114",968,721,711,4,10,"UPYD",0
10,"10166",307,220,219,0,1,"UPYD",0
10,"10172",718,501,493,2,8,"UPYD",1
10,"10042",85,70,70,0,0,"UPYD",0
10,"10136",318,234,234,4,0,"UPYD",2
10,"10108",218,122,120,0,2,"UPYD",0
10,"10168",320,240,237,0,3,"UPYD",0
10,"10095",350,269,267,1,2,"UPYD",1
10,"10217",533,431,427,1,4,"UPYD",2
10,"10063",179,145,145,1,0,"UPYD",1
10,"10004",713,551,543,1,8,"UPYD",1
10,"10094",232,203,203,3,0,"UPYD",0
10,"10113",2354,1800,1778,20,22,"UPYD",3
10,"10012",599,494,489,1,5,"UPYD",4
10,"10013",282,228,223,2,5,"UPYD",1
10,"10199",166,120,119,3,1,"UPYD",0
10,"10206",212,161,160,3,1,"UPYD",0
10,"10117",260,127,127,0,0,"UPYD",0
10,"10174",175,141,139,0,2,"UPYD",0
10,"10182",129,95,95,0,0,"UPYD",0
10,"10190",561,401,397,2,4,"UPYD",2
10,"10133",1210,1007,989,2,18,"UPYD",2
10,"10061",1664,1143,1131,8,12,"UPYD",3
10,"10178",781,567,562,1,5,"UPYD",3
10,"10131",12850,9036,8977,44,59,"UPYD",58
10,"10110",2298,1682,1638,10,44,"UPYD",6
10,"10091",378,304,304,0,0,"UPYD",1
10,"10153",318,238,231,3,7,"UPYD",0
10,"10156",96,71,70,1,1,"UPYD",0
10,"10036",327,247,244,2,3,"UPYD",0
10,"10026",646,507,494,5,13,"UPYD",3
10,"10022",435,371,366,1,5,"UPYD",0
10,"10078",414,325,319,3,6,"UPYD",0
10,"10135",1329,981,958,1,23,"UPYD",1
10,"10151",213,163,161,0,2,"UPYD",0
10,"10198",1160,1022,1009,6,13,"UPYD",2
10,"10200",417,308,305,0,3,"UPYD",0
10,"10051",440,318,314,1,4,"UPYD",2
10,"10037",76403,58422,57811,329,611,"UPYD",382
10,"10105",2519,1745,1714,11,31,"UPYD",7
10,"10207",502,352,349,5,3,"UPYD",1
10,"10126",1572,1123,1107,3,16,"UPYD",7
10,"10087",1701,1233,1215,7,18,"UPYD",1
10,"10076",820,608,595,3,13,"UPYD",6
10,"10201",176,146,145,0,1,"UPYD",0
10,"10196",306,234,233,1,1,"UPYD",0
10,"10038",86,70,70,0,0,"UPYD",0
10,"10205",2034,1413,1386,5,27,"UPYD",0
10,"10123",585,480,468,1,12,"UPYD",0
10,"10158",335,252,251,0,1,"UPYD",0
10,"10045",1031,786,781,11,5,"UPYD",5
10,"10093",406,333,324,2,9,"UPYD",0
10,"10202",621,495,478,2,17,"UPYD",5
10,"10130",1761,1322,1308,5,14,"UPYD",2
10,"10213",571,483,478,1,5,"UPYD",2
10,"10185",572,433,427,5,6,"UPYD",0
10,"10079",901,703,695,2,8,"UPYD",1
10,"10071",144,100,100,2,0,"UPYD",0
10,"10089",1376,1004,988,2,16,"UPYD",3
10,"10027",78,66,66,0,0,"UPYD",0
10,"10003",557,401,396,2,5,"UPYD",3
10,"10107",1033,825,815,11,10,"UPYD",1
10,"10016",329,262,259,1,3,"UPYD",0
10,"10064",1490,1142,1119,9,23,"UPYD",1
10,"10211",454,352,339,2,13,"UPYD",0
10,"10086",329,259,256,1,3,"UPYD",3
10,"10115",3578,2857,2811,20,46,"UPYD",9
10,"10077",689,511,504,2,7,"UPYD",0
10,"10085",335,248,244,1,4,"UPYD",0
10,"10048",245,163,161,1,2,"UPYD",2
10,"10103",454,342,338,1,4,"UPYD",0
10,"10163",356,302,299,1,3,"UPYD",0
10,"10008",1331,1052,1047,6,5,"UPYD",3
10,"10065",205,154,154,1,0,"UPYD",1
10,"10043",814,594,590,2,4,"UPYD",1
10,"10157",273,209,205,1,4,"UPYD",0
10,"10073",715,536,530,3,6,"UPYD",2
10,"10138",544,445,437,2,8,"UPYD",2
10,"10090",522,386,382,5,4,"UPYD",1
10,"10219",1290,860,843,1,17,"UPYD",2
10,"10019",1510,1134,1121,8,13,"UPYD",15
10,"10180",4159,2765,2734,12,31,"UPYD",7
10,"10188",500,381,373,2,8,"UPYD",1
10,"10184",778,620,610,6,10,"UPYD",6
10,"10902",730,546,536,2,10,"UPYD",1
10,"10017",841,606,589,4,17,"UPYD",0
10,"10192",841,592,584,0,8,"UPYD",0
10,"10053",289,231,224,1,7,"UPYD",0
10,"10020",1619,1240,1214,9,26,"UPYD",1
10,"10060",973,620,607,5,13,"UPYD",0
10,"10146",1509,1018,1004,4,14,"UPYD",7
10,"10125",903,648,638,2,10,"UPYD",3
10,"10194",536,441,433,5,8,"UPYD",1
10,"10121",7970,5884,5816,33,68,"UPYD",15
10,"10055",719,554,546,3,8,"UPYD",0
10,"10031",167,138,137,1,1,"UPYD",2
10,"10176",374,274,268,1,6,"UPYD",2
10,"10009",270,173,170,1,3,"UPYD",0
10,"10218",1143,828,814,2,14,"UPYD",1
10,"10015",687,500,491,2,9,"UPYD",0
10,"10066",158,128,127,1,1,"UPYD",0
10,"10159",323,235,232,2,3,"UPYD",0
10,"10111",1364,995,978,9,17,"UPYD",5
10,"10212",1691,1303,1280,8,23,"UPYD",11
10,"10215",442,320,320,0,0,"UPYD",0
10,"10175",1434,1054,1028,7,26,"UPYD",3
10,"10029",418,345,341,1,4,"UPYD",0
10,"10028",98,72,71,0,1,"UPYD",1
10,"10152",470,361,357,3,4,"UPYD",0
10,"10187",443,316,311,1,5,"UPYD",1
10,"10050",1062,853,846,5,7,"UPYD",0
10,"10179",301,247,247,0,0,"UPYD",0
10,"10032",1705,1296,1277,10,19,"UPYD",4
10,"10046",201,176,173,2,3,"UPYD",0
10,"10035",1880,1390,1372,6,18,"UPYD",0
10,"10049",3849,3185,3111,27,74,"UPYD",8
10,"10072",862,644,639,2,5,"UPYD",0
10,"10173",581,432,426,4,6,"UPYD",1
10,"10099",592,417,413,7,4,"UPYD",1
10,"10075",256,178,177,1,1,"UPYD",0
10,"10025",402,341,328,2,13,"UPYD",1
10,"10905",651,458,456,0,2,"UPYD",0
2,"2062",414,324,319,0,5,"PODEMOS",23
2,"2028",132,103,102,0,1,"PODEMOS",3
2,"2068",343,265,262,2,3,"PODEMOS",28
2,"2016",581,445,441,0,4,"PODEMOS",40
2,"2055",1157,757,753,9,4,"PODEMOS",88
2,"2045",3706,3046,3009,17,37,"PODEMOS",515
2,"2001",660,521,510,4,11,"PODEMOS",36
2,"2024",3416,2694,2666,33,28,"PODEMOS",383
2,"2051",1690,1227,1211,12,16,"PODEMOS",63
2,"2035",1989,1607,1582,13,25,"PODEMOS",186
2,"2046",1135,936,917,15,19,"PODEMOS",112
2,"2077",55,41,41,0,0,"PODEMOS",6
2,"2061",641,534,530,7,4,"PODEMOS",37
2,"2027",310,251,251,0,0,"PODEMOS",14
2,"2059",317,242,241,0,1,"PODEMOS",14
2,"2047",120,91,90,0,1,"PODEMOS",4
2,"2033",1920,1551,1518,6,33,"PODEMOS",210
2,"2042",850,698,693,2,5,"PODEMOS",81
2,"2010",1798,1491,1463,10,28,"PODEMOS",129
2,"2025",7502,5918,5785,41,133,"PODEMOS",834
2,"2048",1251,1013,1004,9,9,"PODEMOS",95
2,"2037",22886,15400,15266,111,134,"PODEMOS",1937
2,"2009",19686,14909,14719,148,190,"PODEMOS",2483
2,"2012",1833,1595,1575,17,20,"PODEMOS",85
2,"2003",131959,101091,100433,730,658,"PODEMOS",16495
2,"2044",1128,806,798,2,8,"PODEMOS",71
2,"2034",1395,1131,1126,10,5,"PODEMOS",202
2,"2026",847,705,697,7,8,"PODEMOS",70
2,"2023",576,479,468,2,11,"PODEMOS",41
2,"2038",284,230,230,1,0,"PODEMOS",14
2,"2079",2887,2312,2285,24,27,"PODEMOS",511
2,"2011",643,517,515,0,2,"PODEMOS",27
2,"2004",621,504,500,5,4,"PODEMOS",38
2,"2005",568,441,434,4,7,"PODEMOS",39
2,"2072",1560,1118,1098,4,20,"PODEMOS",93
2,"2006",588,482,476,2,6,"PODEMOS",36
2,"2083",217,194,194,0,0,"PODEMOS",13
2,"2039",1002,824,819,8,5,"PODEMOS",71
2,"2070",411,337,330,1,7,"PODEMOS",23
2,"2057",2043,1593,1568,24,25,"PODEMOS",245
2,"2058",348,244,239,2,5,"PODEMOS",22
2,"2036",96,72,72,1,0,"PODEMOS",7
2,"2050",103,87,87,0,0,"PODEMOS",12
2,"2084",325,228,221,2,7,"PODEMOS",12
2,"2013",132,105,104,0,1,"PODEMOS",8
2,"2049",838,610,607,3,3,"PODEMOS",50
2,"2066",238,206,205,1,1,"PODEMOS",13
2,"2080",532,419,410,0,9,"PODEMOS",43
2,"2022",368,279,278,0,1,"PODEMOS",21
2,"2029",3306,2563,2533,17,30,"PODEMOS",356
2,"2014",368,300,295,1,5,"PODEMOS",10
2,"2056",1729,1348,1323,10,25,"PODEMOS",74
2,"2041",350,274,272,1,2,"PODEMOS",21
2,"2073",4914,3777,3730,42,47,"PODEMOS",505
2,"2085",321,268,266,4,2,"PODEMOS",11
2,"2018",832,670,663,5,7,"PODEMOS",39
2,"2081",18334,14121,13932,116,189,"PODEMOS",1775
2,"2015",1444,1196,1179,7,17,"PODEMOS",97
2,"2052",473,399,398,3,1,"PODEMOS",32
2,"2019",2412,1991,1959,13,32,"PODEMOS",189
2,"2008",1227,923,909,9,14,"PODEMOS",97
2,"2074",5998,4415,4363,20,52,"PODEMOS",492
2,"2078",922,698,691,6,7,"PODEMOS",151
2,"2063",1471,1161,1156,6,5,"PODEMOS",58
2,"2007",1050,824,811,7,13,"PODEMOS",110
2,"2040",586,507,505,1,2,"PODEMOS",53
2,"2067",1189,909,896,4,13,"PODEMOS",103
2,"2060",1302,1007,1003,8,4,"PODEMOS",101
2,"2071",1056,890,884,7,6,"PODEMOS",63
2,"2075",1684,1406,1397,10,9,"PODEMOS",97
2,"2031",574,447,440,1,7,"PODEMOS",36
2,"2082",105,88,88,1,0,"PODEMOS",14
2,"2064",379,317,316,1,1,"PODEMOS",23
2,"2053",2996,2370,2332,15,38,"PODEMOS",256
2,"2086",2603,1797,1783,8,14,"PODEMOS",154
2,"2017",845,611,607,1,4,"PODEMOS",36
2,"2020",451,381,376,3,5,"PODEMOS",28
2,"2054",390,305,302,3,3,"PODEMOS",23
2,"2030",3059,2405,2377,11,28,"PODEMOS",243
2,"2901",2202,1571,1563,16,8,"PODEMOS",111
2,"2002",494,406,397,0,9,"PODEMOS",25
2,"2076",334,269,268,3,1,"PODEMOS",12
2,"2021",1037,823,816,3,7,"PODEMOS",103
2,"2065",475,403,402,2,1,"PODEMOS",42
2,"2043",1250,1020,1006,8,14,"PODEMOS",56
2,"2032",281,217,216,1,1,"PODEMOS",37
2,"2069",11544,8969,8824,62,145,"PODEMOS",939
36,"36053",5693,4321,4265,41,56,"RECORTES CE",4
36,"36020",2351,1748,1721,20,27,"RECORTES CE",0
36,"36015",4205,2941,2885,32,56,"RECORTES CE",5
36,"36041",13428,9842,9710,96,132,"RECORTES CE",26
36,"36054",10996,8116,7965,84,151,"RECORTES CE",15
36,"36047",2492,1719,1704,16,15,"RECORTES CE",1
36,"36026",20203,14399,14189,144,210,"RECORTES CE",39
36,"36032",3655,2745,2699,21,46,"RECORTES CE",6
36,"36029",16129,12262,12078,101,184,"RECORTES CE",33
36,"36052",7298,5298,5175,37,123,"RECORTES CE",11
36,"36030",4220,3041,2994,32,47,"RECORTES CE",8
36,"36003",9979,7496,7401,81,95,"RECORTES CE",13
36,"36043",4736,3347,3297,22,50,"RECORTES CE",11
36,"36010",2862,2195,2177,18,18,"RECORTES CE",4
36,"36050",7562,5567,5457,44,110,"RECORTES CE",17
36,"36034",3477,2499,2470,15,29,"RECORTES CE",6
36,"36051",14272,10230,10072,95,158,"RECORTES CE",21
36,"36031",558,464,454,9,10,"RECORTES CE",0
36,"36061",8651,6594,6445,58,149,"RECORTES CE",12
36,"36007",1689,1168,1148,12,20,"RECORTES CE",2
36,"36033",12347,9515,9336,76,179,"RECORTES CE",24
36,"36011",1842,1185,1169,9,16,"RECORTES CE",2
36,"36049",6761,5193,5069,54,124,"RECORTES CE",20
36,"36060",30350,22032,21753,193,279,"RECORTES CE",53
36,"36023",8420,6287,6180,55,107,"RECORTES CE",4
36,"36013",2412,1602,1586,12,16,"RECORTES CE",2
36,"36048",5348,3970,3892,44,78,"RECORTES CE",6
36,"36039",15350,11581,11349,119,232,"RECORTES CE",33
36,"36005",8120,5839,5747,64,92,"RECORTES CE",8
36,"36028",4139,3094,3045,22,49,"RECORTES CE",5
36,"36040",2600,1907,1869,13,38,"RECORTES CE",1
36,"36042",17922,12993,12760,116,233,"RECORTES CE",26
36,"36004",10178,7351,7224,69,127,"RECORTES CE",18
36,"36019",1625,1127,1119,12,8,"RECORTES CE",1
36,"36016",1173,724,716,7,8,"RECORTES CE",0
36,"36018",3272,2288,2262,17,26,"RECORTES CE",4
36,"36022",9056,6635,6514,48,121,"RECORTES CE",11
36,"36014",1980,1464,1442,7,22,"RECORTES CE",4
36,"36006",11537,8885,8740,79,145,"RECORTES CE",26
36,"36037",2607,1862,1838,16,24,"RECORTES CE",6
36,"36046",4055,3189,3139,30,50,"RECORTES CE",13
36,"36035",14430,10832,10680,86,152,"RECORTES CE",30
36,"36009",4908,3167,3114,25,53,"RECORTES CE",8
36,"36027",4452,3328,3274,23,54,"RECORTES CE",6
36,"36059",4937,3379,3318,46,61,"RECORTES CE",13
36,"36038",66390,49943,49439,522,504,"RECORTES CE",129
36,"36058",4992,3495,3441,48,54,"RECORTES CE",3
36,"36901",4095,3344,3293,22,51,"RECORTES CE",6
36,"36045",24570,18613,18365,184,248,"RECORTES CE",55
36,"36002",3151,2290,2255,19,35,"RECORTES CE",13
36,"36057",236957,177555,175758,1730,1797,"RECORTES CE",487
36,"36036",2511,1923,1892,17,31,"RECORTES CE",1
36,"36024",16433,12239,12016,115,223,"RECORTES CE",26
36,"36001",2593,1968,1952,6,16,"RECORTES CE",2
36,"36008",21736,16270,16094,160,176,"RECORTES CE",50
36,"36055",13643,10361,10145,106,216,"RECORTES CE",30
36,"36044",2556,1786,1747,13,39,"RECORTES CE",3
36,"36017",17866,13133,12910,137,223,"RECORTES CE",24
36,"36012",3735,2818,2777,21,41,"RECORTES CE",6
36,"36056",5108,3856,3783,34,73,"RECORTES CE",5
36,"36025",2292,1396,1389,9,7,"RECORTES CE",0
36,"36021",12033,9035,8879,99,156,"RECORTES CE",14
10,"10067",10486,7796,7692,54,104,"VOX",23
10,"10141",268,190,189,2,1,"VOX",0
10,"10181",694,571,558,7,13,"VOX",0
10,"10036",327,247,244,2,3,"VOX",0
10,"10018",1722,1255,1240,6,15,"VOX",5
10,"10153",318,238,231,3,7,"VOX",0
10,"10049",3849,3185,3111,27,74,"VOX",4
10,"10081",179,133,129,0,4,"VOX",0
10,"10162",579,483,476,0,7,"VOX",0
10,"10064",1490,1142,1119,9,23,"VOX",0
10,"10196",306,234,233,1,1,"VOX",0
10,"10112",1583,1203,1176,7,27,"VOX",3
10,"10055",719,554,546,3,8,"VOX",1
10,"10058",1025,747,737,5,10,"VOX",2
10,"10145",126,101,100,1,1,"VOX",0
10,"10014",1874,1430,1401,11,29,"VOX",1
10,"10188",500,381,373,2,8,"VOX",0
10,"10097",106,79,79,0,0,"VOX",0
10,"10126",1572,1123,1107,3,16,"VOX",3
10,"10130",1761,1322,1308,5,14,"VOX",0
10,"10113",2354,1800,1778,20,22,"VOX",2
10,"10119",630,461,455,2,6,"VOX",1
10,"10156",96,71,70,1,1,"VOX",0
10,"10115",3578,2857,2811,20,46,"VOX",7
10,"10116",3784,2839,2801,21,38,"VOX",5
10,"10207",502,352,349,5,3,"VOX",0
10,"10169",544,430,423,0,7,"VOX",1
10,"10095",350,269,267,1,2,"VOX",1
10,"10100",795,602,595,4,7,"VOX",0
10,"10205",2034,1413,1386,5,27,"VOX",2
10,"10193",1421,1150,1130,10,20,"VOX",0
10,"10073",715,536,530,3,6,"VOX",0
10,"10102",531,413,410,4,3,"VOX",0
10,"10122",231,166,163,0,3,"VOX",1
10,"10005",537,411,398,3,13,"VOX",0
10,"10157",273,209,205,1,4,"VOX",0
10,"10088",205,117,117,0,0,"VOX",0
10,"10177",1703,1331,1296,10,35,"VOX",1
10,"10197",134,94,93,0,1,"VOX",0
10,"10092",301,238,236,2,2,"VOX",1
10,"10034",350,263,262,1,1,"VOX",0
10,"10042",85,70,70,0,0,"VOX",0
10,"10083",90,69,69,0,0,"VOX",0
10,"10107",1033,825,815,11,10,"VOX",1
10,"10213",571,483,478,1,5,"VOX",3
10,"10140",1114,860,848,6,12,"VOX",2
10,"10053",289,231,224,1,7,"VOX",0
10,"10144",996,755,748,3,7,"VOX",0
10,"10170",263,204,202,2,2,"VOX",0
10,"10019",1510,1134,1121,8,13,"VOX",4
10,"10082",1893,1528,1484,13,44,"VOX",1
10,"10185",572,433,427,5,6,"VOX",0
10,"10148",32985,23666,23394,189,272,"VOX",83
10,"10006",1275,1024,1004,7,20,"VOX",0
10,"10209",296,195,193,1,2,"VOX",0
10,"10128",5752,4219,4146,39,73,"VOX",4
10,"10009",270,173,170,1,3,"VOX",0
10,"10044",1451,1100,1087,7,13,"VOX",1
10,"10211",454,352,339,2,13,"VOX",0
10,"10904",750,522,520,5,2,"VOX",0
10,"10011",570,450,443,2,7,"VOX",0
10,"10139",111,84,83,0,1,"VOX",0
10,"10075",256,178,177,1,1,"VOX",0
10,"10902",730,546,536,2,10,"VOX",0
10,"10070",720,548,540,0,8,"VOX",1
10,"10096",3443,2503,2464,14,39,"VOX",6
10,"10047",972,783,777,1,6,"VOX",0
10,"10038",86,70,70,0,0,"VOX",1
10,"10104",5169,3766,3703,21,63,"VOX",18
10,"10905",651,458,456,0,2,"VOX",0
10,"10200",417,308,305,0,3,"VOX",0
10,"10045",1031,786,781,11,5,"VOX",2
10,"10008",1331,1052,1047,6,5,"VOX",3
10,"10150",354,301,295,4,6,"VOX",0
10,"10134",565,395,393,1,2,"VOX",0
10,"10903",819,629,624,7,5,"VOX",0
10,"10146",1509,1018,1004,4,14,"VOX",0
10,"10165",259,212,209,0,3,"VOX",0
10,"10136",318,234,234,4,0,"VOX",0
10,"10022",435,371,366,1,5,"VOX",0
10,"10124",862,692,678,7,14,"VOX",3
10,"10189",2656,2006,1971,10,35,"VOX",1
10,"10120",176,125,125,2,0,"VOX",0
10,"10052",193,127,126,1,1,"VOX",0
10,"10215",442,320,320,0,0,"VOX",0
10,"10132",400,258,256,0,2,"VOX",1
10,"10167",306,240,237,0,3,"VOX",0
10,"10179",301,247,247,0,0,"VOX",0
10,"10085",335,248,244,1,4,"VOX",1
10,"10066",158,128,127,1,1,"VOX",0
10,"10032",1705,1296,1277,10,19,"VOX",0
10,"10172",718,501,493,2,8,"VOX",0
10,"10040",443,344,342,4,2,"VOX",0
10,"10076",820,608,595,3,13,"VOX",1
10,"10202",621,495,478,2,17,"VOX",1
10,"10174",175,141,139,0,2,"VOX",0
10,"10098",385,294,286,0,8,"VOX",0
10,"10061",1664,1143,1131,8,12,"VOX",1
10,"10007",646,488,478,3,10,"VOX",0
10,"10190",561,401,397,2,4,"VOX",0
10,"10138",544,445,437,2,8,"VOX",0
10,"10037",76403,58422,57811,329,611,"VOX",164
10,"10106",134,111,111,1,0,"VOX",0
10,"10152",470,361,357,3,4,"VOX",0
10,"10103",454,342,338,1,4,"VOX",0
10,"10054",545,427,426,6,1,"VOX",0
10,"10026",646,507,494,5,13,"VOX",2
10,"10079",901,703,695,2,8,"VOX",1
10,"10135",1329,981,958,1,23,"VOX",0
10,"10176",374,274,268,1,6,"VOX",3
10,"10218",1143,828,814,2,14,"VOX",0
10,"10111",1364,995,978,9,17,"VOX",0
10,"10183",993,763,761,4,2,"VOX",1
10,"10110",2298,1682,1638,10,44,"VOX",2
10,"10219",1290,860,843,1,17,"VOX",1
10,"10105",2519,1745,1714,11,31,"VOX",3
10,"10023",846,647,637,1,10,"VOX",0
10,"10059",369,258,255,0,3,"VOX",1
10,"10201",176,146,145,0,1,"VOX",0
10,"10072",862,644,639,2,5,"VOX",0
10,"10093",406,333,324,2,9,"VOX",0
10,"10062",413,345,341,3,4,"VOX",0
10,"10117",260,127,127,0,0,"VOX",0
10,"10155",1140,856,842,3,14,"VOX",0
10,"10015",687,500,491,2,9,"VOX",3
10,"10027",78,66,66,0,0,"VOX",0
10,"10035",1880,1390,1372,6,18,"VOX",0
10,"10016",329,262,259,1,3,"VOX",0
10,"10204",442,345,342,5,3,"VOX",0
10,"10091",378,304,304,0,0,"VOX",0
10,"10182",129,95,95,0,0,"VOX",0
10,"10056",591,456,452,5,4,"VOX",1
10,"10068",746,601,586,3,15,"VOX",0
10,"10086",329,259,256,1,3,"VOX",0
10,"10154",184,138,134,1,4,"VOX",0
10,"10212",1691,1303,1280,8,23,"VOX",1
10,"10168",320,240,237,0,3,"VOX",0
10,"10021",5198,3960,3878,40,82,"VOX",5
10,"10901",1184,851,835,2,16,"VOX",1
10,"10004",713,551,543,1,8,"VOX",0
10,"10142",824,620,616,5,4,"VOX",0
10,"10077",689,511,504,2,7,"VOX",3
10,"10063",179,145,145,1,0,"VOX",0
10,"10180",4159,2765,2734,12,31,"VOX",4
10,"10013",282,228,223,2,5,"VOX",0
10,"10192",841,592,584,0,8,"VOX",0
10,"10050",1062,853,846,5,7,"VOX",1
10,"10030",477,316,304,1,12,"VOX",0
10,"10017",841,606,589,4,17,"VOX",1
10,"10043",814,594,590,2,4,"VOX",1
10,"10178",781,567,562,1,5,"VOX",0
10,"10118",289,257,257,1,0,"VOX",1
10,"10166",307,220,219,0,1,"VOX",1
10,"10187",443,316,311,1,5,"VOX",0
10,"10216",1543,1200,1192,9,8,"VOX",0
10,"10094",232,203,203,3,0,"VOX",1
10,"10164",742,513,508,1,5,"VOX",0
10,"10137",399,344,343,4,1,"VOX",1
10,"10010",2322,1446,1431,12,15,"VOX",3
10,"10084",1370,934,906,7,28,"VOX",0
10,"10149",435,315,307,1,8,"VOX",2
10,"10198",1160,1022,1009,6,13,"VOX",0
10,"10078",414,325,319,3,6,"VOX",0
10,"10065",205,154,154,1,0,"VOX",1
10,"10127",4724,3529,3463,15,66,"VOX",11
10,"10175",1434,1054,1028,7,26,"VOX",0
10,"10003",557,401,396,2,5,"VOX",0
10,"10060",973,620,607,5,13,"VOX",0
10,"10214",208,172,170,0,2,"VOX",0
10,"10039",427,295,290,0,5,"VOX",0
10,"10160",225,172,170,0,2,"VOX",1
10,"10143",158,121,121,0,0,"VOX",1
10,"10001",285,226,225,2,1,"VOX",1
10,"10090",522,386,382,5,4,"VOX",0
10,"10046",201,176,173,2,3,"VOX",0
10,"10184",778,620,610,6,10,"VOX",1
10,"10217",533,431,427,1,4,"VOX",0
10,"10173",581,432,426,4,6,"VOX",4
10,"10031",167,138,137,1,1,"VOX",1
10,"10020",1619,1240,1214,9,26,"VOX",3
10,"10171",340,262,261,1,1,"VOX",0
10,"10024",687,538,533,6,5,"VOX",0
10,"10041",1056,823,811,4,12,"VOX",4
10,"10194",536,441,433,5,8,"VOX",1
10,"10029",418,345,341,1,4,"VOX",1
10,"10099",592,417,413,7,4,"VOX",1
10,"10208",124,100,98,1,2,"VOX",0
10,"10133",1210,1007,989,2,18,"VOX",1
10,"10108",218,122,120,0,2,"VOX",0
10,"10101",185,147,147,1,0,"VOX",0
10,"10203",4600,3268,3215,14,53,"VOX",5
10,"10131",12850,9036,8977,44,59,"VOX",21
10,"10048",245,163,161,1,2,"VOX",1
10,"10089",1376,1004,988,2,16,"VOX",1
10,"10125",903,648,638,2,10,"VOX",1
10,"10158",335,252,251,0,1,"VOX",0
10,"10069",831,647,637,2,10,"VOX",0
10,"10210",551,380,373,1,7,"VOX",0
10,"10057",150,112,111,0,1,"VOX",0
10,"10121",7970,5884,5816,33,68,"VOX",9
10,"10123",585,480,468,1,12,"VOX",0
10,"10033",430,304,301,1,3,"VOX",0
10,"10028",98,72,71,0,1,"VOX",1
10,"10071",144,100,100,2,0,"VOX",0
10,"10129",363,272,266,4,6,"VOX",0
10,"10051",440,318,314,1,4,"VOX",2
10,"10012",599,494,489,1,5,"VOX",0
10,"10151",213,163,161,0,2,"VOX",0
10,"10191",532,417,415,12,2,"VOX",2
10,"10206",212,161,160,3,1,"VOX",0
10,"10199",166,120,119,3,1,"VOX",0
10,"10186",994,830,816,4,14,"VOX",0
10,"10025",402,341,328,2,13,"VOX",0
10,"10002",368,278,275,0,3,"VOX",0
10,"10109",1804,1233,1212,2,21,"VOX",5
10,"10163",356,302,299,1,3,"VOX",1
10,"10080",368,276,272,1,4,"VOX",0
10,"10087",1701,1233,1215,7,18,"VOX",1
10,"10159",323,235,232,2,3,"VOX",0
10,"10161",75,53,53,0,0,"VOX",0
10,"10114",968,721,711,4,10,"VOX",0
10,"10147",1275,985,937,6,48,"VOX",0
10,"10195",7768,5818,5723,58,95,"VOX",18
37,"37233",65,45,45,0,0,"IU-UPeC",3
37,"37270",190,142,139,1,3,"IU-UPeC",2
37,"37039",304,213,213,4,0,"IU-UPeC",0
37,"37317",306,246,243,1,3,"IU-UPeC",3
37,"37340",150,105,104,1,1,"IU-UPeC",0
37,"37101",163,122,122,2,0,"IU-UPeC",1
37,"37297",420,342,331,4,11,"IU-UPeC",11
37,"37307",160,103,103,0,0,"IU-UPeC",1
37,"37003",119,93,90,0,3,"IU-UPeC",0
37,"37152",424,290,283,2,7,"IU-UPeC",1
37,"37136",667,453,448,2,5,"IU-UPeC",8
37,"37252",116,89,89,0,0,"IU-UPeC",4
37,"37250",358,223,223,1,0,"IU-UPeC",8
37,"37262",78,64,64,1,0,"IU-UPeC",1
37,"37229",143,102,102,1,0,"IU-UPeC",0
37,"37347",477,365,359,3,6,"IU-UPeC",10
37,"37324",371,284,279,4,5,"IU-UPeC",3
37,"37350",421,324,320,4,4,"IU-UPeC",4
37,"37320",93,71,71,1,0,"IU-UPeC",0
37,"37181",291,209,207,1,2,"IU-UPeC",3
37,"37224",210,183,179,2,4,"IU-UPeC",2
37,"37097",36,30,30,0,0,"IU-UPeC",0
37,"37182",77,62,62,0,0,"IU-UPeC",0
37,"37355",189,147,146,1,1,"IU-UPeC",4
37,"37157",77,62,62,0,0,"IU-UPeC",0
37,"37323",521,387,385,8,2,"IU-UPeC",3
37,"37329",36,28,28,0,0,"IU-UPeC",0
37,"37296",338,258,255,4,3,"IU-UPeC",2
37,"37123",182,141,138,0,3,"IU-UPeC",1
37,"37044",470,353,341,1,12,"IU-UPeC",7
37,"37223",109,90,87,0,3,"IU-UPeC",3
37,"37023",1378,1116,1105,9,11,"IU-UPeC",48
37,"37375",705,593,582,11,11,"IU-UPeC",11
37,"37343",62,49,49,0,0,"IU-UPeC",1
37,"37137",105,73,73,0,0,"IU-UPeC",1
37,"37127",221,158,158,4,0,"IU-UPeC",5
37,"37060",245,192,192,0,0,"IU-UPeC",2
37,"37273",108,77,77,0,0,"IU-UPeC",7
37,"37327",185,157,157,5,0,"IU-UPeC",6
37,"37184",345,247,244,1,3,"IU-UPeC",2
37,"37102",411,291,289,3,2,"IU-UPeC",7
37,"37002",144,87,87,0,0,"IU-UPeC",2
37,"37014",1161,850,847,5,3,"IU-UPeC",27
37,"37049",147,98,98,2,0,"IU-UPeC",1
37,"37143",385,301,299,1,2,"IU-UPeC",3
37,"37278",753,573,568,7,5,"IU-UPeC",33
37,"37029",213,155,152,0,3,"IU-UPeC",0
37,"37005",77,58,56,0,2,"IU-UPeC",1
37,"37139",205,163,162,2,1,"IU-UPeC",10
37,"37081",933,720,714,4,6,"IU-UPeC",9
37,"37065",323,237,235,0,2,"IU-UPeC",1
37,"37074",153,109,103,4,6,"IU-UPeC",0
37,"37155",73,54,54,1,0,"IU-UPeC",1
37,"37195",48,35,35,1,0,"IU-UPeC",2
37,"37248",152,127,126,2,1,"IU-UPeC",2
37,"37150",43,35,35,0,0,"IU-UPeC",0
37,"37036",63,46,46,0,0,"IU-UPeC",0
37,"37018",105,80,80,1,0,"IU-UPeC",2
37,"37170",1479,1055,1031,10,24,"IU-UPeC",18
37,"37046",11336,8300,8171,62,129,"IU-UPeC",330
37,"37045",27,20,20,0,0,"IU-UPeC",0
37,"37244",134,91,90,1,1,"IU-UPeC",6
37,"37268",116,71,70,0,1,"IU-UPeC",0
37,"37211",223,163,163,4,0,"IU-UPeC",8
37,"37196",77,54,53,0,1,"IU-UPeC",0
37,"37193",399,279,278,6,1,"IU-UPeC",0
37,"37203",165,118,118,0,0,"IU-UPeC",8
37,"37192",353,245,242,2,3,"IU-UPeC",25
37,"37056",41,30,30,0,0,"IU-UPeC",0
37,"37311",226,182,182,2,0,"IU-UPeC",1
37,"37261",227,165,161,2,4,"IU-UPeC",8
37,"37217",56,46,44,1,2,"IU-UPeC",1
37,"37011",122,91,89,0,2,"IU-UPeC",0
37,"37243",102,76,76,0,0,"IU-UPeC",0
37,"37314",87,74,72,0,2,"IU-UPeC",1
37,"37010",956,716,708,3,8,"IU-UPeC",22
37,"37368",16,15,15,0,0,"IU-UPeC",0
37,"37376",2251,1588,1568,9,20,"IU-UPeC",29
37,"37073",583,449,442,8,7,"IU-UPeC",11
37,"37130",173,155,153,5,2,"IU-UPeC",0
37,"37230",221,167,167,2,0,"IU-UPeC",3
37,"37126",30,24,24,0,0,"IU-UPeC",0
37,"37040",393,320,317,3,3,"IU-UPeC",3
37,"37256",220,158,157,1,1,"IU-UPeC",9
37,"37371",281,183,177,1,6,"IU-UPeC",1
37,"37325",91,68,63,0,5,"IU-UPeC",0
37,"37017",251,186,184,2,2,"IU-UPeC",5
37,"37154",141,116,112,0,4,"IU-UPeC",1
37,"37120",99,77,76,1,1,"IU-UPeC",1
37,"37007",439,321,313,4,8,"IU-UPeC",5
37,"37377",249,199,195,3,4,"IU-UPeC",8
37,"37164",256,200,195,1,5,"IU-UPeC",9
37,"37086",98,80,80,2,0,"IU-UPeC",3
37,"37362",4592,3442,3403,48,39,"IU-UPeC",98
37,"37344",246,184,183,1,1,"IU-UPeC",4
37,"37034",84,66,66,3,0,"IU-UPeC",1
37,"37186",106,78,78,3,0,"IU-UPeC",0
37,"37083",179,159,159,0,0,"IU-UPeC",5
37,"37301",73,62,62,0,0,"IU-UPeC",0
37,"37245",345,252,246,7,6,"IU-UPeC",0
37,"37235",223,168,163,1,5,"IU-UPeC",2
37,"37059",124,100,98,0,2,"IU-UPeC",2
37,"37124",219,149,148,0,1,"IU-UPeC",10
37,"37279",763,572,562,11,10,"IU-UPeC",6
37,"37042",42,29,29,2,0,"IU-UPeC",0
37,"37334",79,42,42,1,0,"IU-UPeC",0
37,"37132",351,272,269,2,3,"IU-UPeC",4
37,"37236",139,94,89,0,5,"IU-UPeC",3
37,"37364",836,598,583,6,15,"IU-UPeC",18
37,"37189",125,97,97,0,0,"IU-UPeC",3
37,"37246",5335,4190,4152,41,38,"IU-UPeC",102
37,"37330",335,262,258,4,4,"IU-UPeC",5
37,"37283",120,88,88,1,0,"IU-UPeC",2
37,"37079",74,64,63,0,1,"IU-UPeC",0
37,"37174",1065,838,826,3,12,"IU-UPeC",13
37,"37129",251,199,194,1,5,"IU-UPeC",12
37,"37361",84,56,55,0,1,"IU-UPeC",0
37,"37335",415,301,293,2,8,"IU-UPeC",2
37,"37144",370,288,284,2,4,"IU-UPeC",7
37,"37122",202,158,156,3,2,"IU-UPeC",1
37,"37052",274,197,197,2,0,"IU-UPeC",3
37,"37092",1731,1264,1250,11,14,"IU-UPeC",50
37,"37328",189,142,140,0,2,"IU-UPeC",10
37,"37281",37,34,33,0,1,"IU-UPeC",3
37,"37332",69,53,52,0,1,"IU-UPeC",0
37,"37216",310,264,257,4,7,"IU-UPeC",5
37,"37304",170,114,109,4,5,"IU-UPeC",0
37,"37021",80,62,62,0,0,"IU-UPeC",0
37,"37358",168,136,135,2,1,"IU-UPeC",0
37,"37293",118,84,84,0,0,"IU-UPeC",1
37,"37222",97,66,66,1,0,"IU-UPeC",1
37,"37218",71,33,33,2,0,"IU-UPeC",1
37,"37366",43,27,27,0,0,"IU-UPeC",0
37,"37004",32,22,22,0,0,"IU-UPeC",1
37,"37242",91,71,71,0,0,"IU-UPeC",1
37,"37117",1458,1075,1068,14,7,"IU-UPeC",57
37,"37231",259,208,207,4,1,"IU-UPeC",9
37,"37294",11680,8850,8760,84,90,"IU-UPeC",372
37,"37309",45,28,28,0,0,"IU-UPeC",0
37,"37337",139,120,120,2,0,"IU-UPeC",2
37,"37228",367,301,299,1,2,"IU-UPeC",8
37,"37063",74,59,59,1,0,"IU-UPeC",1
37,"37104",27,21,21,0,0,"IU-UPeC",0
37,"37173",1526,1138,1125,5,13,"IU-UPeC",22
37,"37009",216,161,160,3,1,"IU-UPeC",1
37,"37199",142,108,108,0,0,"IU-UPeC",1
37,"37272",136,97,96,0,1,"IU-UPeC",0
37,"37125",228,158,156,3,2,"IU-UPeC",3
37,"37254",183,153,149,0,4,"IU-UPeC",2
37,"37349",112,83,82,0,1,"IU-UPeC",2
37,"37251",126,87,87,2,0,"IU-UPeC",1
37,"37008",4298,3312,3272,16,40,"IU-UPeC",82
37,"37265",217,180,178,2,2,"IU-UPeC",3
37,"37185",591,450,443,4,7,"IU-UPeC",12
37,"37300",575,427,423,3,4,"IU-UPeC",7
37,"37032",543,411,410,1,1,"IU-UPeC",14
37,"37365",174,147,144,0,3,"IU-UPeC",4
37,"37284",325,245,244,2,1,"IU-UPeC",4
37,"37319",117,78,77,0,1,"IU-UPeC",6
37,"37115",123,89,87,0,2,"IU-UPeC",0
37,"37379",173,134,134,2,0,"IU-UPeC",1
37,"37171",411,321,317,1,4,"IU-UPeC",3
37,"37274",119148,88959,88152,853,807,"IU-UPeC",3463
37,"37025",258,223,221,2,2,"IU-UPeC",5
37,"37006",135,91,90,1,1,"IU-UPeC",1
37,"37054",261,199,198,1,1,"IU-UPeC",6
37,"37194",252,191,190,2,1,"IU-UPeC",6
37,"37149",70,63,63,0,0,"IU-UPeC",1
37,"37190",219,167,167,0,0,"IU-UPeC",1
37,"37116",69,51,51,0,0,"IU-UPeC",4
37,"37380",55,46,46,2,0,"IU-UPeC",3
37,"37077",260,234,230,0,4,"IU-UPeC",5
37,"37089",67,50,49,0,1,"IU-UPeC",1
37,"37135",1211,932,925,10,7,"IU-UPeC",19
37,"37113",430,340,340,3,0,"IU-UPeC",9
37,"37253",135,110,110,1,0,"IU-UPeC",3
37,"37180",73,52,52,1,0,"IU-UPeC",2
37,"37206",94,71,71,4,0,"IU-UPeC",3
37,"37072",166,133,132,2,1,"IU-UPeC",0
37,"37012",150,117,115,0,2,"IU-UPeC",3
37,"37055",123,105,98,0,7,"IU-UPeC",7
37,"37131",190,140,139,0,1,"IU-UPeC",3
37,"37051",80,54,53,0,1,"IU-UPeC",1
37,"37100",81,68,67,1,1,"IU-UPeC",0
37,"37128",264,211,201,4,10,"IU-UPeC",2
37,"37219",179,110,110,0,0,"IU-UPeC",9
37,"37276",149,100,99,0,1,"IU-UPeC",1
37,"37232",390,349,348,0,1,"IU-UPeC",17
37,"37121",584,434,430,5,4,"IU-UPeC",6
37,"37341",56,43,41,0,2,"IU-UPeC",0
37,"37322",2472,1691,1676,12,15,"IU-UPeC",115
37,"37013",121,87,86,3,1,"IU-UPeC",1
37,"37258",180,117,115,1,2,"IU-UPeC",2
37,"37178",99,84,81,0,3,"IU-UPeC",0
37,"37269",452,328,328,2,0,"IU-UPeC",7
37,"37028",150,111,110,1,1,"IU-UPeC",2
37,"37292",103,72,72,1,0,"IU-UPeC",0
37,"37346",267,222,220,1,2,"IU-UPeC",0
37,"37277",73,55,55,0,0,"IU-UPeC",0
37,"37208",81,49,48,0,1,"IU-UPeC",0
37,"37167",173,150,144,2,6,"IU-UPeC",7
37,"37357",276,216,215,0,1,"IU-UPeC",5
37,"37080",232,176,176,1,0,"IU-UPeC",5
37,"37119",109,86,86,1,0,"IU-UPeC",2
37,"37057",213,168,167,0,1,"IU-UPeC",0
37,"37133",108,82,79,4,3,"IU-UPeC",1
37,"37175",407,316,314,5,2,"IU-UPeC",4
37,"37313",555,415,411,1,4,"IU-UPeC",2
37,"37336",55,47,47,0,0,"IU-UPeC",4
37,"37234",357,224,222,1,2,"IU-UPeC",2
37,"37260",154,126,126,1,0,"IU-UPeC",3
37,"37267",199,151,147,2,4,"IU-UPeC",3
37,"37264",67,43,43,0,0,"IU-UPeC",0
37,"37026",192,158,154,2,4,"IU-UPeC",2
37,"37085",4704,3475,3432,35,43,"IU-UPeC",157
37,"37373",755,548,545,3,3,"IU-UPeC",18
37,"37015",222,145,143,3,2,"IU-UPeC",3
37,"37146",122,100,99,1,1,"IU-UPeC",2
37,"37363",120,98,94,0,4,"IU-UPeC",0
37,"37290",140,116,116,0,0,"IU-UPeC",9
37,"37169",176,139,137,0,2,"IU-UPeC",0
37,"37142",592,453,451,2,2,"IU-UPeC",18
37,"37286",206,156,156,4,0,"IU-UPeC",17
37,"37090",52,38,36,0,2,"IU-UPeC",5
37,"37030",84,68,66,0,2,"IU-UPeC",3
37,"37166",213,142,142,1,0,"IU-UPeC",0
37,"37382",180,133,133,4,0,"IU-UPeC",1
37,"37069",976,713,699,9,14,"IU-UPeC",15
37,"37001",195,147,144,0,3,"IU-UPeC",11
37,"37163",42,33,33,0,0,"IU-UPeC",0
37,"37315",93,69,67,1,2,"IU-UPeC",1
37,"37147",191,141,136,0,5,"IU-UPeC",5
37,"37287",318,237,237,3,0,"IU-UPeC",7
37,"37035",194,161,161,0,0,"IU-UPeC",4
37,"37312",262,211,210,3,1,"IU-UPeC",0
37,"37148",425,304,295,6,9,"IU-UPeC",1
37,"37353",129,92,92,1,0,"IU-UPeC",3
37,"37204",280,214,211,1,3,"IU-UPeC",2
37,"37047",167,83,83,0,0,"IU-UPeC",1
37,"37237",325,250,248,4,2,"IU-UPeC",1
37,"37110",117,92,89,1,3,"IU-UPeC",6
37,"37259",45,30,30,0,0,"IU-UPeC",0
37,"37213",87,73,73,0,0,"IU-UPeC",1
37,"37201",262,179,177,0,2,"IU-UPeC",5
37,"37179",215,173,170,0,3,"IU-UPeC",0
37,"37285",412,311,305,2,6,"IU-UPeC",4
37,"37183",417,305,301,2,4,"IU-UPeC",1
37,"37141",156,127,127,1,0,"IU-UPeC",7
37,"37099",73,45,45,2,0,"IU-UPeC",1
37,"37263",348,252,251,1,1,"IU-UPeC",3
37,"37354",5182,3955,3915,50,40,"IU-UPeC",161
37,"37321",170,131,129,2,2,"IU-UPeC",0
37,"37176",137,100,98,0,2,"IU-UPeC",2
37,"37369",140,96,96,0,0,"IU-UPeC",0
37,"37161",138,109,107,0,2,"IU-UPeC",0
37,"37202",978,773,763,7,10,"IU-UPeC",27
37,"37041",74,48,48,0,0,"IU-UPeC",1
37,"37310",180,129,128,2,1,"IU-UPeC",2
37,"37271",361,283,276,3,7,"IU-UPeC",3
37,"37226",156,121,119,1,2,"IU-UPeC",0
37,"37177",298,223,221,1,2,"IU-UPeC",5
37,"37191",116,78,76,0,2,"IU-UPeC",0
37,"37306",271,171,171,0,0,"IU-UPeC",2
37,"37240",907,646,636,5,10,"IU-UPeC",19
37,"37247",199,162,154,3,8,"IU-UPeC",3
37,"37318",209,156,155,1,1,"IU-UPeC",6
37,"37215",136,102,101,2,1,"IU-UPeC",1
37,"37114",88,67,66,1,1,"IU-UPeC",2
37,"37299",221,170,163,1,7,"IU-UPeC",0
37,"37027",228,187,187,0,0,"IU-UPeC",6
37,"37109",182,119,118,0,1,"IU-UPeC",1
37,"37291",268,206,206,1,0,"IU-UPeC",4
37,"37280",79,50,50,0,0,"IU-UPeC",1
37,"37345",166,135,133,3,2,"IU-UPeC",3
37,"37372",146,117,115,0,2,"IU-UPeC",5
37,"37118",125,96,96,0,0,"IU-UPeC",3
37,"37107",10855,7694,7598,96,96,"IU-UPeC",280
37,"37067",3125,2551,2523,22,28,"IU-UPeC",116
37,"37241",172,128,126,1,2,"IU-UPeC",0
37,"37087",855,681,676,8,5,"IU-UPeC",37
37,"37172",878,580,576,3,4,"IU-UPeC",18
37,"37098",335,237,237,1,0,"IU-UPeC",3
37,"37160",627,450,443,7,7,"IU-UPeC",4
37,"37088",204,152,152,3,0,"IU-UPeC",1
37,"37158",248,183,181,0,2,"IU-UPeC",12
37,"37197",87,55,55,2,0,"IU-UPeC",0
37,"37255",51,38,38,0,0,"IU-UPeC",0
37,"37374",1178,971,943,8,28,"IU-UPeC",18
37,"37061",226,166,164,1,2,"IU-UPeC",2
37,"37070",533,403,396,4,7,"IU-UPeC",13
37,"37360",230,167,166,2,1,"IU-UPeC",4
37,"37342",256,210,208,1,2,"IU-UPeC",5
37,"37022",268,220,219,2,1,"IU-UPeC",5
37,"37162",206,151,149,2,2,"IU-UPeC",1
37,"37033",98,63,63,0,0,"IU-UPeC",3
37,"37134",230,175,173,1,2,"IU-UPeC",3
37,"37058",61,43,42,0,1,"IU-UPeC",1
37,"37378",111,74,70,2,4,"IU-UPeC",2
37,"37275",123,87,86,1,1,"IU-UPeC",2
37,"37381",139,98,92,0,6,"IU-UPeC",1
37,"37200",190,134,133,2,1,"IU-UPeC",2
37,"37348",113,91,91,1,0,"IU-UPeC",1
37,"37221",434,328,323,2,5,"IU-UPeC",9
37,"37024",92,77,77,0,0,"IU-UPeC",1
37,"37138",199,155,154,4,1,"IU-UPeC",3
37,"37038",789,628,616,5,12,"IU-UPeC",14
37,"37351",281,239,238,0,1,"IU-UPeC",4
37,"37367",199,160,158,7,2,"IU-UPeC",1
37,"37159",91,74,74,0,0,"IU-UPeC",2
37,"37225",106,94,92,0,2,"IU-UPeC",3
37,"37266",84,55,55,1,0,"IU-UPeC",1
37,"37106",266,172,166,1,6,"IU-UPeC",3
37,"37078",823,670,657,8,13,"IU-UPeC",31
37,"37289",240,182,182,2,0,"IU-UPeC",1
37,"37331",217,150,148,1,2,"IU-UPeC",4
37,"37019",151,114,111,0,3,"IU-UPeC",4
37,"37031",365,258,257,1,1,"IU-UPeC",1
37,"37091",176,114,113,2,1,"IU-UPeC",2
37,"37212",111,83,83,1,0,"IU-UPeC",8
37,"37370",337,258,255,3,3,"IU-UPeC",5
37,"37145",257,190,187,0,3,"IU-UPeC",1
37,"37333",225,143,142,4,1,"IU-UPeC",2
37,"37205",233,201,197,1,4,"IU-UPeC",5
37,"37249",44,33,33,1,0,"IU-UPeC",0
37,"37062",84,67,66,1,1,"IU-UPeC",3
37,"37316",751,584,577,5,7,"IU-UPeC",15
37,"37214",125,88,88,1,0,"IU-UPeC",0
37,"37108",101,81,79,2,2,"IU-UPeC",3
37,"37020",430,340,334,3,6,"IU-UPeC",5
37,"37359",184,131,129,0,2,"IU-UPeC",2
37,"37288",258,211,210,7,1,"IU-UPeC",5
37,"37338",78,66,66,1,0,"IU-UPeC",5
37,"37207",303,234,233,0,1,"IU-UPeC",8
37,"37068",366,272,271,5,1,"IU-UPeC",10
37,"37188",185,127,125,3,2,"IU-UPeC",1
37,"37352",204,148,147,0,1,"IU-UPeC",7
37,"37071",78,73,72,1,1,"IU-UPeC",0
37,"37156",4310,3173,3126,27,47,"IU-UPeC",55
37,"37037",119,81,81,0,0,"IU-UPeC",1
37,"37016",573,451,447,3,4,"IU-UPeC",11
37,"37140",678,440,435,2,5,"IU-UPeC",3
37,"37282",209,136,136,0,0,"IU-UPeC",0
37,"37103",446,326,325,4,1,"IU-UPeC",8
37,"37356",86,73,71,1,2,"IU-UPeC",3
37,"37303",188,152,151,1,1,"IU-UPeC",4
37,"37305",216,170,169,2,1,"IU-UPeC",7
37,"37112",161,115,114,0,1,"IU-UPeC",3
37,"37050",67,47,46,1,1,"IU-UPeC",0
37,"37298",184,125,125,1,0,"IU-UPeC",1
37,"37339",316,257,257,4,0,"IU-UPeC",4
37,"37187",565,431,426,4,5,"IU-UPeC",0
37,"37151",146,116,115,2,1,"IU-UPeC",2
37,"37168",443,319,311,2,8,"IU-UPeC",8
37,"37209",406,281,280,7,1,"IU-UPeC",12
37,"37082",799,570,560,1,10,"IU-UPeC",13
37,"37165",33,27,27,0,0,"IU-UPeC",0
37,"37257",53,43,43,0,0,"IU-UPeC",0
37,"37239",229,196,194,6,2,"IU-UPeC",11
37,"37096",220,174,174,5,0,"IU-UPeC",1
37,"37198",206,161,160,3,1,"IU-UPeC",7
37,"37302",294,216,214,1,2,"IU-UPeC",1
37,"37238",112,88,85,2,3,"IU-UPeC",4
29,"29038",17555,11638,11562,124,76,"VOX",15
29,"29072",3250,2466,2434,11,32,"VOX",2
29,"29073",1560,1126,1120,5,6,"VOX",1
29,"29046",2690,1974,1954,17,20,"VOX",3
29,"29018",2026,1560,1519,15,41,"VOX",0
29,"29040",1964,1321,1301,12,20,"VOX",1
29,"29014",219,138,138,1,0,"VOX",0
29,"29001",4196,3276,3253,26,23,"VOX",1
29,"29056",1107,815,807,8,8,"VOX",2
29,"29009",1477,1113,1100,3,13,"VOX",0
29,"29066",346,252,251,2,1,"VOX",0
29,"29041",3146,2251,2216,26,35,"VOX",2
29,"29051",40201,27168,26842,229,326,"VOX",42
29,"29071",938,640,633,6,7,"VOX",0
29,"29026",1065,776,766,4,10,"VOX",4
29,"29012",9765,7029,6944,58,85,"VOX",3
29,"29094",57313,39393,39052,280,341,"VOX",84
29,"29090",1704,1174,1165,10,9,"VOX",1
29,"29002",1203,855,842,6,13,"VOX",6
29,"29034",466,361,359,0,2,"VOX",1
29,"29030",809,653,651,2,2,"VOX",0
29,"29057",376,285,284,2,1,"VOX",0
29,"29096",2806,2065,2034,19,31,"VOX",1
29,"29004",328,240,238,2,2,"VOX",0
29,"29074",785,612,611,4,1,"VOX",0
29,"29069",85333,56398,55854,443,544,"VOX",89
29,"29075",12952,8681,8619,55,62,"VOX",15
29,"29052",226,155,152,0,3,"VOX",0
29,"29901",43601,30325,30130,188,195,"VOX",76
29,"29022",185,143,143,1,0,"VOX",0
29,"29048",1428,1168,1155,9,13,"VOX",3
29,"29053",1702,1178,1160,17,18,"VOX",3
29,"29054",41888,29228,29022,205,206,"VOX",62
29,"29097",4117,2996,2947,43,49,"VOX",2
29,"29068",6885,4580,4511,43,69,"VOX",10
29,"29029",420,322,315,4,7,"VOX",0
29,"29091",8966,6437,6346,57,91,"VOX",11
29,"29020",3265,2531,2504,17,27,"VOX",3
29,"29076",2163,1508,1482,8,26,"VOX",4
29,"29005",4342,2946,2908,22,38,"VOX",6
29,"29006",680,482,474,3,8,"VOX",0
29,"29087",380,283,276,1,7,"VOX",0
29,"29019",888,675,672,0,3,"VOX",0
29,"29027",2343,1737,1722,6,15,"VOX",3
29,"29037",212,166,165,1,1,"VOX",0
29,"29064",506,372,365,2,7,"VOX",1
29,"29063",336,255,251,2,4,"VOX",0
29,"29045",1685,1232,1223,4,9,"VOX",2
29,"29060",706,524,516,0,8,"VOX",0
29,"29015",31884,23160,22943,188,217,"VOX",26
29,"29904",428,363,360,2,3,"VOX",0
29,"29089",3254,2465,2438,10,27,"VOX",1
29,"29086",795,497,490,3,7,"VOX",1
29,"29021",162,114,107,13,7,"VOX",0
29,"29043",2503,1671,1638,17,33,"VOX",0
29,"29070",39913,26993,26751,203,242,"VOX",56
29,"29047",1131,927,914,4,13,"VOX",0
29,"29081",258,205,200,1,5,"VOX",0
29,"29092",567,423,415,4,8,"VOX",0
29,"29031",1633,1115,1106,6,9,"VOX",0
29,"29080",6704,4812,4766,44,46,"VOX",10
29,"29099",960,741,734,3,7,"VOX",0
29,"29095",3350,2523,2467,17,56,"VOX",0
29,"29902",2560,1735,1709,13,26,"VOX",1
29,"29058",1463,986,975,6,11,"VOX",3
29,"29083",2114,1587,1568,10,19,"VOX",2
29,"29061",1018,833,820,4,13,"VOX",1
29,"29098",1257,991,977,12,14,"VOX",1
29,"29065",194,134,134,1,0,"VOX",0
29,"29042",14078,9890,9776,75,114,"VOX",16
29,"29077",208,156,153,0,3,"VOX",1
29,"29032",6708,5341,5265,26,76,"VOX",4
29,"29088",2720,1930,1883,21,47,"VOX",0
29,"29044",811,557,556,3,1,"VOX",0
29,"29055",1808,1415,1396,13,19,"VOX",1
29,"29008",14541,9954,9820,90,134,"VOX",15
29,"29067",424770,295944,294094,2117,1850,"VOX",1023
29,"29024",393,271,256,4,15,"VOX",0
29,"29023",2047,1385,1369,2,16,"VOX",3
29,"29049",2987,2204,2185,25,19,"VOX",6
29,"29017",6610,5001,4938,25,63,"VOX",2
29,"29062",658,564,561,0,3,"VOX",0
29,"29082",31505,23154,22990,127,164,"VOX",52
29,"29028",1249,881,881,4,0,"VOX",1
29,"29036",636,481,475,3,6,"VOX",1
29,"29035",1587,1218,1208,0,10,"VOX",2
29,"29085",151,99,98,1,1,"VOX",0
29,"29084",27393,19096,18886,192,210,"VOX",25
29,"29003",1002,777,769,1,8,"VOX",0
29,"29010",1667,1336,1310,1,26,"VOX",0
29,"29013",1612,1282,1272,6,10,"VOX",0
29,"29039",2662,1948,1931,22,17,"VOX",3
29,"29059",2590,2100,2058,11,42,"VOX",0
29,"29079",2444,1880,1846,3,34,"VOX",1
29,"29050",425,313,309,1,4,"VOX",0
29,"29033",1132,808,804,2,4,"VOX",1
29,"29007",27319,19557,19395,179,162,"VOX",44
29,"29025",39210,26938,26747,160,191,"VOX",41
29,"29093",2235,1689,1667,12,22,"VOX",0
29,"29100",2437,1775,1760,12,15,"VOX",1
29,"29903",525,394,389,2,5,"VOX",0
29,"29011",2920,1962,1946,5,16,"VOX",2
29,"29016",253,188,188,1,0,"VOX",0
21,"21065",287,202,196,0,6,"RECORTES CE",0
21,"21026",270,184,178,1,6,"RECORTES CE",1
21,"21053",3316,2257,2219,25,38,"RECORTES CE",3
21,"21047",1914,1213,1179,19,34,"RECORTES CE",1
21,"21036",192,138,138,1,0,"RECORTES CE",0
21,"21005",15486,10310,10189,64,121,"RECORTES CE",5
21,"21079",731,526,522,3,4,"RECORTES CE",0
21,"21038",1082,732,719,8,13,"RECORTES CE",1
21,"21029",1564,1166,1126,16,40,"RECORTES CE",3
21,"21049",3372,2162,2108,15,54,"RECORTES CE",1
21,"21017",3643,2301,2269,17,32,"RECORTES CE",2
21,"21028",381,290,287,0,3,"RECORTES CE",0
21,"21010",14684,8766,8698,92,68,"RECORTES CE",9
21,"21078",2763,1928,1907,12,21,"RECORTES CE",0
21,"21061",5092,3471,3429,32,42,"RECORTES CE",4
21,"21048",305,220,220,3,0,"RECORTES CE",1
21,"21059",220,167,165,3,2,"RECORTES CE",0
21,"21064",6526,4544,4492,51,52,"RECORTES CE",4
21,"21050",12448,8431,8382,86,49,"RECORTES CE",8
21,"21054",8105,6025,5919,41,106,"RECORTES CE",5
21,"21076",2123,1549,1532,13,17,"RECORTES CE",0
21,"21007",6231,4285,4227,45,58,"RECORTES CE",3
21,"21071",204,160,158,2,2,"RECORTES CE",0
21,"21006",3402,2398,2359,13,39,"RECORTES CE",3
21,"21057",1045,641,640,8,1,"RECORTES CE",0
21,"21063",2614,2044,2034,12,10,"RECORTES CE",1
21,"21068",998,606,605,14,1,"RECORTES CE",0
21,"21016",1034,777,764,2,13,"RECORTES CE",0
21,"21012",322,234,227,0,7,"RECORTES CE",0
21,"21003",695,533,525,1,8,"RECORTES CE",1
21,"21043",1858,1356,1341,13,15,"RECORTES CE",1
21,"21019",590,433,423,4,10,"RECORTES CE",1
21,"21070",6296,4450,4397,38,53,"RECORTES CE",3
21,"21051",245,176,173,1,3,"RECORTES CE",0
21,"21011",3464,2536,2518,19,18,"RECORTES CE",3
21,"21034",1207,848,838,8,10,"RECORTES CE",5
21,"21037",472,364,360,2,4,"RECORTES CE",0
21,"21062",1395,936,926,9,10,"RECORTES CE",0
21,"21046",1703,1200,1173,15,27,"RECORTES CE",2
21,"21001",648,479,469,4,10,"RECORTES CE",1
21,"21020",372,241,238,2,3,"RECORTES CE",0
21,"21032",1805,1378,1359,15,19,"RECORTES CE",0
21,"21009",860,571,555,6,16,"RECORTES CE",0
21,"21074",2660,1869,1844,18,25,"RECORTES CE",1
21,"21015",683,425,420,6,5,"RECORTES CE",0
21,"21018",1780,1152,1131,10,21,"RECORTES CE",2
21,"21023",2147,1379,1357,6,22,"RECORTES CE",0
21,"21044",17552,10820,10692,106,128,"RECORTES CE",17
21,"21024",495,350,344,5,6,"RECORTES CE",0
21,"21035",9622,6399,6313,69,86,"RECORTES CE",6
21,"21042",15349,7802,7708,106,94,"RECORTES CE",11
21,"21072",10280,7869,7777,76,92,"RECORTES CE",12
21,"21025",4049,2682,2653,25,29,"RECORTES CE",2
21,"21014",4041,3203,3170,15,33,"RECORTES CE",2
21,"21030",1824,1491,1472,11,19,"RECORTES CE",0
21,"21041",113604,74902,74244,718,658,"RECORTES CE",144
21,"21058",2602,1904,1886,8,18,"RECORTES CE",2
21,"21033",536,399,395,0,4,"RECORTES CE",0
21,"21056",2912,2115,2024,20,91,"RECORTES CE",2
21,"21002",15348,10939,10864,80,75,"RECORTES CE",19
21,"21045",253,192,190,0,2,"RECORTES CE",0
21,"21077",1722,1261,1246,5,15,"RECORTES CE",1
21,"21021",12233,7551,7470,94,81,"RECORTES CE",6
21,"21040",3158,2386,2345,15,41,"RECORTES CE",5
21,"21027",49,36,36,1,0,"RECORTES CE",0
21,"21039",308,223,222,2,1,"RECORTES CE",1
21,"21052",4618,2837,2773,20,64,"RECORTES CE",2
21,"21069",1715,1186,1175,7,11,"RECORTES CE",0
21,"21055",6914,5286,5218,34,68,"RECORTES CE",6
21,"21031",1209,845,828,3,17,"RECORTES CE",1
21,"21022",174,115,109,1,6,"RECORTES CE",0
21,"21008",2662,1847,1831,14,16,"RECORTES CE",2
21,"21066",507,408,405,1,3,"RECORTES CE",3
21,"21013",10597,7220,7061,69,159,"RECORTES CE",4
21,"21067",415,309,303,0,6,"RECORTES CE",0
21,"21004",1641,1070,1047,10,23,"RECORTES CE",1
21,"21075",351,270,266,2,4,"RECORTES CE",0
21,"21060",11959,7565,7488,103,77,"RECORTES CE",11
21,"21073",1871,1134,1120,12,14,"RECORTES CE",0
12,"12118",74,60,59,0,1,"DN",0
12,"12059",244,190,189,1,1,"DN",0
12,"12070",524,418,408,8,10,"DN",0
12,"12084",17599,13146,13022,98,124,"DN",13
12,"12039",840,726,719,2,7,"DN",0
12,"12142",161,124,123,0,1,"DN",0
12,"12087",26,18,18,3,0,"DN",0
12,"12032",23508,17400,17279,89,121,"DN",20
12,"12041",97,77,77,0,0,"DN",0
12,"12089",4331,3103,3050,25,53,"DN",5
12,"12126",24480,18885,18687,115,198,"DN",14
12,"12123",47,32,32,0,0,"DN",0
12,"12063",42,35,34,2,1,"DN",0
12,"12120",184,155,154,1,1,"DN",0
12,"12073",156,132,131,0,1,"DN",0
12,"12021",4442,3486,3432,25,54,"DN",2
12,"12111",375,314,310,0,4,"DN",0
12,"12034",1430,1078,1053,4,25,"DN",2
12,"12085",5061,3310,3264,20,46,"DN",6
12,"12121",1127,955,928,6,27,"DN",0
12,"12132",486,407,398,2,9,"DN",0
12,"12057",606,495,487,3,8,"DN",0
12,"12115",217,169,167,2,2,"DN",0
12,"12038",171,121,120,1,1,"DN",0
12,"12064",97,83,82,0,1,"DN",0
12,"12100",1345,1115,1098,6,17,"DN",0
12,"12108",463,395,390,0,5,"DN",0
12,"12051",477,337,335,2,2,"DN",0
12,"12072",1117,962,937,8,25,"DN",0
12,"12136",2657,2302,2252,22,50,"DN",1
12,"12081",611,503,493,3,10,"DN",0
12,"12119",147,100,100,1,0,"DN",0
12,"12037",16,14,14,0,0,"DN",0
12,"12058",74,60,59,2,1,"DN",0
12,"12117",3576,2786,2747,17,39,"DN",1
12,"12007",758,672,667,7,5,"DN",0
12,"12068",49,34,34,1,0,"DN",0
12,"12114",200,150,149,1,1,"DN",0
12,"12036",593,448,445,2,3,"DN",0
12,"12018",293,244,235,2,9,"DN",1
12,"12003",991,762,752,10,10,"DN",6
12,"12128",1400,1102,1091,11,11,"DN",1
12,"12056",285,243,238,3,5,"DN",1
12,"12074",784,690,678,9,12,"DN",0
12,"12006",176,140,140,1,0,"DN",0
12,"12113",85,69,69,2,0,"DN",0
12,"12140",1140,961,950,5,11,"DN",0
12,"12014",184,140,136,1,4,"DN",0
12,"12013",148,119,116,4,3,"DN",0
12,"12901",3433,2691,2664,27,27,"DN",11
12,"12088",69,58,58,0,0,"DN",0
12,"12079",405,318,312,4,6,"DN",1
12,"12135",35749,27015,26806,174,209,"DN",32
12,"12902",2148,1562,1536,9,26,"DN",4
12,"12002",116,98,96,0,2,"DN",0
12,"12010",259,216,209,6,7,"DN",0
12,"12042",621,520,512,13,8,"DN",0
12,"12109",647,531,520,1,11,"DN",0
12,"12127",77,56,56,0,0,"DN",0
12,"12048",249,196,192,1,4,"DN",0
12,"12005",8090,6113,6027,57,86,"DN",1
12,"12125",214,185,183,2,2,"DN",1
12,"12029",717,572,566,6,6,"DN",1
12,"12050",1320,1044,1032,8,12,"DN",1
12,"12078",339,250,247,1,3,"DN",0
12,"12098",588,479,473,4,6,"DN",6
12,"12033",1907,1483,1436,11,47,"DN",0
12,"12092",112,84,84,0,0,"DN",0
12,"12090",109,94,93,2,1,"DN",0
12,"12065",192,166,166,0,0,"DN",0
12,"12110",244,173,170,1,3,"DN",0
12,"12131",65,53,53,0,0,"DN",0
12,"12024",139,115,113,1,2,"DN",0
12,"12137",37,26,26,1,0,"DN",0
12,"12076",87,70,70,1,0,"DN",0
12,"12040",117832,89135,88464,525,671,"DN",175
12,"12049",455,348,339,5,9,"DN",0
12,"12097",67,55,54,0,1,"DN",0
12,"12134",138,97,96,0,1,"DN",0
12,"12099",542,434,405,9,29,"DN",0
12,"12017",164,133,132,1,1,"DN",0
12,"12009",17430,12600,12501,77,99,"DN",24
12,"12060",446,367,360,2,7,"DN",0
12,"12027",17217,12263,12122,77,141,"DN",56
12,"12004",4204,3174,3130,19,44,"DN",6
12,"12067",543,442,424,1,18,"DN",0
12,"12069",74,50,49,0,1,"DN",0
12,"12015",96,83,81,0,2,"DN",0
12,"12046",193,154,153,3,1,"DN",0
12,"12071",1280,1002,988,5,14,"DN",0
12,"12096",775,587,580,12,7,"DN",0
12,"12106",1170,983,967,16,16,"DN",0
12,"12080",1955,1647,1624,13,23,"DN",0
12,"12095",974,789,784,8,5,"DN",0
12,"12083",95,82,80,0,2,"DN",1
12,"12130",404,339,332,0,7,"DN",0
12,"12061",378,275,275,4,0,"DN",0
12,"12141",101,80,80,0,0,"DN",0
12,"12008",231,192,190,2,2,"DN",0
12,"12055",106,79,79,2,0,"DN",0
12,"12075",123,94,92,1,2,"DN",0
12,"12116",67,49,49,0,0,"DN",0
12,"12016",1582,1311,1295,9,16,"DN",2
12,"12022",340,273,269,1,4,"DN",0
12,"12020",124,104,103,1,1,"DN",0
12,"12139",322,239,237,1,2,"DN",0
12,"12045",354,282,279,2,3,"DN",0
12,"12101",363,282,273,3,9,"DN",0
12,"12122",805,660,647,4,13,"DN",0
12,"12124",1853,1411,1394,20,17,"DN",0
12,"12028",12566,9902,9830,55,72,"DN",7
12,"12104",6954,5571,5470,26,101,"DN",3
12,"12133",60,49,49,0,0,"DN",0
12,"12011",4587,3530,3480,30,50,"DN",0
12,"12043",581,470,459,4,11,"DN",0
12,"12001",1054,798,786,8,12,"DN",1
12,"12082",9655,7570,7492,38,78,"DN",10
12,"12094",851,688,674,2,14,"DN",0
12,"12052",590,464,442,5,22,"DN",1
12,"12053",2069,1691,1677,8,14,"DN",0
12,"12077",4625,3443,3387,20,56,"DN",5
12,"12026",894,697,676,14,21,"DN",5
12,"12025",137,106,106,0,0,"DN",0
12,"12044",483,438,431,4,7,"DN",1
12,"12107",351,313,309,3,4,"DN",0
12,"12103",89,69,68,2,1,"DN",0
12,"12093",189,147,145,1,2,"DN",0
12,"12129",1840,1391,1360,19,31,"DN",1
12,"12031",3830,3049,2987,20,62,"DN",4
12,"12138",19064,13610,13456,135,154,"DN",35
12,"12112",99,81,79,1,2,"DN",0
12,"12012",2695,2236,2204,6,32,"DN",0
12,"12091",185,145,141,3,4,"DN",1
12,"12105",851,666,659,5,7,"DN",0
12,"12102",536,452,437,1,15,"DN",0
2,"2001",660,521,510,4,11,"PLD",0
2,"2012",1833,1595,1575,17,20,"PLD",0
2,"2050",103,87,87,0,0,"PLD",0
2,"2008",1227,923,909,9,14,"PLD",0
2,"2067",1189,909,896,4,13,"PLD",0
2,"2034",1395,1131,1126,10,5,"PLD",0
2,"2030",3059,2405,2377,11,28,"PLD",0
2,"2056",1729,1348,1323,10,25,"PLD",0
2,"2023",576,479,468,2,11,"PLD",1
2,"2005",568,441,434,4,7,"PLD",0
2,"2071",1056,890,884,7,6,"PLD",0
2,"2024",3416,2694,2666,33,28,"PLD",1
2,"2076",334,269,268,3,1,"PLD",0
2,"2035",1989,1607,1582,13,25,"PLD",0
2,"2079",2887,2312,2285,24,27,"PLD",1
2,"2014",368,300,295,1,5,"PLD",0
2,"2002",494,406,397,0,9,"PLD",0
2,"2003",131959,101091,100433,730,658,"PLD",37
2,"2068",343,265,262,2,3,"PLD",0
2,"2013",132,105,104,0,1,"PLD",0
2,"2046",1135,936,917,15,19,"PLD",1
2,"2080",532,419,410,0,9,"PLD",0
2,"2072",1560,1118,1098,4,20,"PLD",0
2,"2065",475,403,402,2,1,"PLD",0
2,"2047",120,91,90,0,1,"PLD",0
2,"2063",1471,1161,1156,6,5,"PLD",0
2,"2036",96,72,72,1,0,"PLD",0
2,"2025",7502,5918,5785,41,133,"PLD",2
2,"2059",317,242,241,0,1,"PLD",0
2,"2018",832,670,663,5,7,"PLD",0
2,"2083",217,194,194,0,0,"PLD",0
2,"2069",11544,8969,8824,62,145,"PLD",42
2,"2048",1251,1013,1004,9,9,"PLD",0
2,"2073",4914,3777,3730,42,47,"PLD",0
2,"2029",3306,2563,2533,17,30,"PLD",1
2,"2077",55,41,41,0,0,"PLD",0
2,"2037",22886,15400,15266,111,134,"PLD",47
2,"2070",411,337,330,1,7,"PLD",0
2,"2060",1302,1007,1003,8,4,"PLD",0
2,"2015",1444,1196,1179,7,17,"PLD",0
2,"2004",621,504,500,5,4,"PLD",0
2,"2039",1002,824,819,8,5,"PLD",0
2,"2057",2043,1593,1568,24,25,"PLD",0
2,"2016",581,445,441,0,4,"PLD",3
2,"2055",1157,757,753,9,4,"PLD",0
2,"2038",284,230,230,1,0,"PLD",0
2,"2054",390,305,302,3,3,"PLD",0
2,"2082",105,88,88,1,0,"PLD",0
2,"2086",2603,1797,1783,8,14,"PLD",1
2,"2031",574,447,440,1,7,"PLD",1
2,"2042",850,698,693,2,5,"PLD",0
2,"2010",1798,1491,1463,10,28,"PLD",0
2,"2011",643,517,515,0,2,"PLD",0
2,"2075",1684,1406,1397,10,9,"PLD",0
2,"2043",1250,1020,1006,8,14,"PLD",0
2,"2040",586,507,505,1,2,"PLD",0
2,"2052",473,399,398,3,1,"PLD",0
2,"2009",19686,14909,14719,148,190,"PLD",3
2,"2006",588,482,476,2,6,"PLD",0
2,"2051",1690,1227,1211,12,16,"PLD",0
2,"2021",1037,823,816,3,7,"PLD",2
2,"2049",838,610,607,3,3,"PLD",0
2,"2901",2202,1571,1563,16,8,"PLD",0
2,"2017",845,611,607,1,4,"PLD",0
2,"2019",2412,1991,1959,13,32,"PLD",0
2,"2053",2996,2370,2332,15,38,"PLD",0
2,"2062",414,324,319,0,5,"PLD",0
2,"2041",350,274,272,1,2,"PLD",0
2,"2026",847,705,697,7,8,"PLD",0
2,"2066",238,206,205,1,1,"PLD",0
2,"2064",379,317,316,1,1,"PLD",0
2,"2084",325,228,221,2,7,"PLD",1
2,"2045",3706,3046,3009,17,37,"PLD",1
2,"2020",451,381,376,3,5,"PLD",0
2,"2028",132,103,102,0,1,"PLD",0
2,"2027",310,251,251,0,0,"PLD",0
2,"2007",1050,824,811,7,13,"PLD",0
2,"2033",1920,1551,1518,6,33,"PLD",0
2,"2044",1128,806,798,2,8,"PLD",0
2,"2074",5998,4415,4363,20,52,"PLD",52
2,"2032",281,217,216,1,1,"PLD",0
2,"2078",922,698,691,6,7,"PLD",1
2,"2058",348,244,239,2,5,"PLD",0
2,"2081",18334,14121,13932,116,189,"PLD",5
2,"2061",641,534,530,7,4,"PLD",1
2,"2022",368,279,278,0,1,"PLD",0
2,"2085",321,268,266,4,2,"PLD",0
16,"16070",32,31,31,0,0,"VOX",1
16,"16195",498,380,376,1,4,"VOX",2
16,"16165",63,51,50,1,1,"VOX",0
16,"16172",350,270,270,2,0,"VOX",0
16,"16063",98,87,87,0,0,"VOX",0
16,"16094",132,101,99,1,2,"VOX",4
16,"16204",272,207,207,1,0,"VOX",2
16,"16151",64,60,60,0,0,"VOX",0
16,"16159",225,170,168,0,2,"VOX",1
16,"16153",955,797,780,5,17,"VOX",0
16,"16045",221,166,164,1,2,"VOX",2
16,"16102",1231,922,911,8,11,"VOX",0
16,"16112",1505,1088,1072,9,16,"VOX",4
16,"16044",39,28,27,0,1,"VOX",0
16,"16194",259,208,200,0,8,"VOX",0
16,"16156",101,76,75,0,1,"VOX",1
16,"16181",64,53,53,0,0,"VOX",0
16,"16089",379,299,299,4,0,"VOX",0
16,"16062",24,21,21,0,0,"VOX",0
16,"16087",212,186,186,5,0,"VOX",0
16,"16162",43,35,35,0,0,"VOX",0
16,"16036",128,104,102,2,2,"VOX",0
16,"16023",468,344,343,3,1,"VOX",2
16,"16067",127,92,91,3,1,"VOX",0
16,"16121",259,205,205,3,0,"VOX",1
16,"16066",2333,1917,1872,24,45,"VOX",7
16,"16231",48,38,38,0,0,"VOX",0
16,"16259",30,26,26,1,0,"VOX",0
16,"16108",49,43,42,0,1,"VOX",1
16,"16247",71,52,51,0,1,"VOX",0
16,"16199",31,24,24,0,0,"VOX",0
16,"16205",114,89,88,0,1,"VOX",0
16,"16185",44,35,33,0,2,"VOX",0
16,"16249",1986,1593,1570,8,23,"VOX",1
16,"16211",377,253,250,3,3,"VOX",0
16,"16148",587,511,511,1,0,"VOX",1
16,"16030",25,22,22,1,0,"VOX",0
16,"16155",506,415,414,2,1,"VOX",2
16,"16157",213,185,182,0,3,"VOX",1
16,"16104",54,40,40,0,0,"VOX",0
16,"16196",633,538,527,2,11,"VOX",0
16,"16035",258,192,192,3,0,"VOX",0
16,"16264",433,374,370,2,4,"VOX",2
16,"16215",248,177,172,1,5,"VOX",0
16,"16209",118,100,100,1,0,"VOX",1
16,"16197",65,37,37,0,0,"VOX",0
16,"16152",40,35,35,0,0,"VOX",0
16,"16203",9960,7515,7418,43,97,"VOX",28
16,"16265",21,16,16,0,0,"VOX",0
16,"16106",2729,2130,2095,19,35,"VOX",1
16,"16034",183,153,153,1,0,"VOX",0
16,"16084",49,37,32,0,5,"VOX",0
16,"16216",317,275,267,0,8,"VOX",0
16,"16125",1676,1338,1326,9,12,"VOX",2
16,"16111",171,138,137,2,1,"VOX",0
16,"16081",49,38,37,0,1,"VOX",0
16,"16251",1858,1450,1420,8,30,"VOX",2
16,"16068",145,117,114,2,3,"VOX",0
16,"16154",4904,3776,3730,47,46,"VOX",3
16,"16237",113,89,87,0,2,"VOX",0
16,"16149",153,130,129,0,1,"VOX",0
16,"16107",120,87,87,1,0,"VOX",0
16,"16078",41427,31365,31095,268,270,"VOX",146
16,"16001",75,60,60,0,0,"VOX",0
16,"16024",130,100,98,0,2,"VOX",0
16,"16056",465,333,322,0,11,"VOX",0
16,"16163",74,63,63,0,0,"VOX",0
16,"16248",872,711,696,11,15,"VOX",6
16,"16126",783,654,648,2,6,"VOX",1
16,"16003",127,111,109,0,2,"VOX",0
16,"16254",216,181,179,5,2,"VOX",1
16,"16039",398,275,271,1,4,"VOX",0
16,"16150",94,67,67,1,0,"VOX",0
16,"16002",192,172,172,0,0,"VOX",1
16,"16065",406,323,319,3,4,"VOX",0
16,"16271",637,535,533,3,2,"VOX",0
16,"16212",255,208,206,1,2,"VOX",0
16,"16113",3080,2309,2278,15,31,"VOX",2
16,"16170",698,524,517,1,7,"VOX",6
16,"16057",78,60,60,0,0,"VOX",0
16,"16246",484,382,375,1,7,"VOX",0
16,"16124",1870,1536,1518,7,18,"VOX",2
16,"16219",91,72,72,0,0,"VOX",0
16,"16188",90,63,62,0,1,"VOX",0
16,"16274",127,100,100,0,0,"VOX",0
16,"16079",32,21,20,0,1,"VOX",0
16,"16040",85,71,71,0,0,"VOX",0
16,"16250",76,57,57,0,0,"VOX",0
16,"16166",247,182,177,0,5,"VOX",0
16,"16004",274,212,206,0,6,"VOX",0
16,"16101",160,130,129,0,1,"VOX",1
16,"16115",44,33,33,0,0,"VOX",0
16,"16116",84,62,62,0,0,"VOX",0
16,"16224",84,68,67,1,1,"VOX",0
16,"16088",114,92,92,0,0,"VOX",0
16,"16006",119,96,94,1,2,"VOX",0
16,"16032",287,230,230,1,0,"VOX",0
16,"16060",760,600,593,5,7,"VOX",0
16,"16158",546,437,431,7,6,"VOX",2
16,"16033",1729,1385,1365,7,20,"VOX",5
16,"16073",188,158,158,0,0,"VOX",0
16,"16055",703,512,509,7,3,"VOX",1
16,"16072",147,103,102,0,1,"VOX",0
16,"16167",324,275,271,2,4,"VOX",0
16,"16217",75,58,58,0,0,"VOX",0
16,"16122",254,200,198,4,2,"VOX",0
16,"16253",357,279,279,1,0,"VOX",2
16,"16086",888,768,762,10,6,"VOX",3
16,"16131",134,97,97,1,0,"VOX",0
16,"16117",1057,814,808,2,6,"VOX",4
16,"16263",961,754,745,4,9,"VOX",0
16,"16169",58,33,32,0,1,"VOX",1
16,"16132",34,26,26,0,0,"VOX",0
16,"16025",25,21,21,1,0,"VOX",0
16,"16206",208,163,162,4,1,"VOX",3
16,"16192",50,30,29,0,1,"VOX",0
16,"16020",17,11,11,0,0,"VOX",0
16,"16277",118,86,84,0,2,"VOX",0
16,"16008",95,72,72,0,0,"VOX",0
16,"16048",412,312,310,1,2,"VOX",0
16,"16255",141,119,119,0,0,"VOX",1
16,"16118",1405,1147,1136,11,11,"VOX",1
16,"16228",177,132,131,1,1,"VOX",0
16,"16092",161,130,129,1,1,"VOX",2
16,"16174",192,155,155,1,0,"VOX",0
16,"16270",167,141,141,0,0,"VOX",1
16,"16278",73,55,55,0,0,"VOX",0
16,"16026",85,56,53,0,3,"VOX",0
16,"16058",105,81,80,0,1,"VOX",1
16,"16119",169,121,120,0,1,"VOX",1
16,"16009",66,48,48,0,0,"VOX",1
16,"16193",70,57,57,1,0,"VOX",0
16,"16175",5113,4203,4124,35,79,"VOX",9
16,"16093",64,52,52,0,0,"VOX",0
16,"16279",213,146,143,0,3,"VOX",0
16,"16010",154,114,110,1,4,"VOX",0
16,"16134",4369,3412,3369,23,43,"VOX",4
16,"16049",156,121,121,0,0,"VOX",0
16,"16280",189,160,157,2,3,"VOX",0
16,"16064",681,588,581,1,7,"VOX",0
16,"16038",38,28,28,0,0,"VOX",0
16,"16176",39,28,28,0,0,"VOX",0
16,"16029",96,73,71,0,2,"VOX",0
16,"16225",76,58,57,0,1,"VOX",0
16,"16244",722,625,617,2,8,"VOX",0
16,"16050",251,195,194,1,1,"VOX",0
16,"16135",139,109,108,0,1,"VOX",0
16,"16074",40,31,31,0,0,"VOX",0
16,"16082",305,224,224,0,0,"VOX",0
16,"16234",30,19,19,1,0,"VOX",0
16,"16137",56,34,33,0,1,"VOX",2
16,"16901",707,520,513,3,7,"VOX",7
16,"16011",28,19,19,0,0,"VOX",0
16,"16047",230,176,176,2,0,"VOX",0
16,"16177",78,63,63,0,0,"VOX",0
16,"16043",99,73,73,1,0,"VOX",0
16,"16236",914,694,689,6,5,"VOX",1
16,"16051",147,118,118,0,0,"VOX",0
16,"16083",55,28,28,0,0,"VOX",0
16,"16213",35,28,28,1,0,"VOX",0
16,"16160",61,46,45,1,1,"VOX",0
16,"16109",43,32,32,0,0,"VOX",0
16,"16012",82,69,69,0,0,"VOX",0
16,"16096",273,249,244,2,5,"VOX",0
16,"16902",141,105,105,1,0,"VOX",0
16,"16133",4391,3539,3509,27,30,"VOX",12
16,"16097",162,135,135,1,0,"VOX",0
16,"16161",58,53,53,0,0,"VOX",0
16,"16022",78,63,61,0,2,"VOX",0
16,"16139",333,255,251,4,4,"VOX",0
16,"16013",31,28,28,0,0,"VOX",0
16,"16110",97,71,70,0,1,"VOX",0
16,"16140",27,15,15,0,0,"VOX",0
16,"16053",429,352,348,5,4,"VOX",3
16,"16014",613,493,487,1,6,"VOX",0
16,"16041",354,284,282,0,2,"VOX",0
16,"16027",709,567,562,4,5,"VOX",1
16,"16085",136,108,108,2,0,"VOX",0
16,"16238",509,442,434,2,8,"VOX",1
16,"16098",571,468,461,5,7,"VOX",0
16,"16198",1365,1067,1052,12,15,"VOX",2
16,"16186",465,394,387,2,7,"VOX",1
16,"16266",373,279,273,1,6,"VOX",1
16,"16904",478,387,381,5,6,"VOX",0
16,"16099",208,157,152,0,5,"VOX",2
16,"16015",376,286,285,7,1,"VOX",0
16,"16042",1192,1021,1005,6,16,"VOX",1
16,"16095",84,71,68,0,3,"VOX",0
16,"16239",141,110,107,0,3,"VOX",0
16,"16905",1217,965,956,9,9,"VOX",7
16,"16187",77,52,52,1,0,"VOX",0
16,"16240",108,79,79,0,0,"VOX",0
16,"16142",139,110,109,2,1,"VOX",0
16,"16269",426,351,349,3,2,"VOX",0
16,"16273",324,252,252,2,0,"VOX",0
16,"16123",82,54,53,0,1,"VOX",0
16,"16218",189,155,154,1,1,"VOX",1
16,"16100",684,587,580,5,7,"VOX",2
16,"16128",63,54,54,2,0,"VOX",0
16,"16906",82,67,67,1,0,"VOX",0
16,"16071",20,20,20,0,0,"VOX",1
16,"16016",234,173,172,2,1,"VOX",0
16,"16005",256,191,187,1,4,"VOX",0
16,"16202",783,573,566,3,7,"VOX",0
16,"16129",104,82,79,1,3,"VOX",0
16,"16143",16,12,12,2,0,"VOX",1
16,"16031",46,30,30,2,0,"VOX",0
16,"16052",548,420,420,1,0,"VOX",0
16,"16903",1081,824,816,6,8,"VOX",2
16,"16171",1818,1514,1498,5,16,"VOX",3
16,"16242",325,281,278,1,3,"VOX",0
16,"16258",198,143,142,0,1,"VOX",0
16,"16017",370,300,296,2,4,"VOX",1
16,"16189",256,192,191,2,1,"VOX",0
16,"16908",197,154,154,1,0,"VOX",0
16,"16145",464,389,387,2,2,"VOX",0
16,"16190",5127,4088,4025,42,63,"VOX",9
16,"16275",11,11,11,1,0,"VOX",0
16,"16243",412,354,348,0,6,"VOX",1
16,"16130",575,451,446,0,5,"VOX",0
16,"16018",401,328,328,1,0,"VOX",0
16,"16276",21,17,17,0,0,"VOX",0
16,"16272",228,167,167,1,0,"VOX",0
16,"16046",250,181,180,1,1,"VOX",0
16,"16019",217,168,166,1,2,"VOX",0
16,"16146",87,62,62,1,0,"VOX",0
16,"16909",706,537,534,3,3,"VOX",1
16,"16141",145,113,112,1,1,"VOX",0
16,"16007",1192,964,959,8,5,"VOX",1
16,"16191",926,760,752,6,8,"VOX",5
16,"16147",62,43,43,0,0,"VOX",0
16,"16910",96,70,70,0,0,"VOX",0
16,"16091",68,51,49,0,2,"VOX",0
16,"16103",265,217,217,0,0,"VOX",1
16,"16061",964,798,790,13,8,"VOX",2
16,"16173",207,155,154,1,1,"VOX",0
16,"16245",418,338,333,2,5,"VOX",0
16,"16227",112,84,84,0,0,"VOX",1
18,"18119",1729,1353,1340,13,13,"UP: IULV-CA",22
18,"18143",979,781,776,2,5,"UP: IULV-CA",89
18,"18157",1123,836,823,8,13,"UP: IULV-CA",34
18,"18089",15132,10489,10402,64,87,"UP: IULV-CA",418
18,"18005",375,266,265,2,1,"UP: IULV-CA",8
18,"18116",2882,2245,2215,19,30,"UP: IULV-CA",90
18,"18153",8580,6314,6260,39,54,"UP: IULV-CA",542
18,"18134",5811,4002,3946,25,56,"UP: IULV-CA",207
18,"18111",2743,2046,2033,14,13,"UP: IULV-CA",96
18,"18068",1566,1234,1214,5,20,"UP: IULV-CA",36
18,"18168",809,589,588,5,1,"UP: IULV-CA",23
18,"18183",660,468,465,3,3,"UP: IULV-CA",6
18,"18083",266,210,207,1,3,"UP: IULV-CA",4
18,"18039",3544,2544,2511,34,33,"UP: IULV-CA",49
18,"18102",8424,5783,5716,41,67,"UP: IULV-CA",383
18,"18179",546,378,377,1,1,"UP: IULV-CA",10
18,"18175",11624,8549,8467,41,82,"UP: IULV-CA",395
18,"18062",10298,7584,7512,67,72,"UP: IULV-CA",312
18,"18105",4548,3169,3139,19,30,"UP: IULV-CA",245
18,"18193",14194,10280,10196,91,84,"UP: IULV-CA",537
18,"18044",179,116,116,0,0,"UP: IULV-CA",4
18,"18064",379,308,308,1,0,"UP: IULV-CA",1
18,"18045",1149,803,789,10,14,"UP: IULV-CA",8
18,"18043",129,95,95,0,0,"UP: IULV-CA",0
18,"18071",5583,4221,4176,33,45,"UP: IULV-CA",229
18,"18093",2752,1873,1858,10,15,"UP: IULV-CA",44
18,"18033",294,220,219,1,1,"UP: IULV-CA",2
18,"18122",16171,11670,11508,106,162,"UP: IULV-CA",366
18,"18015",443,338,337,0,1,"UP: IULV-CA",28
18,"18034",510,391,391,1,0,"UP: IULV-CA",56
18,"18145",10432,7829,7767,56,62,"UP: IULV-CA",345
18,"18024",855,660,653,8,7,"UP: IULV-CA",35
18,"18148",819,671,666,1,5,"UP: IULV-CA",22
18,"18006",4161,2816,2788,29,28,"UP: IULV-CA",94
18,"18088",1556,1113,1108,5,5,"UP: IULV-CA",217
18,"18154",1016,716,716,2,0,"UP: IULV-CA",4
18,"18132",3312,2582,2556,14,26,"UP: IULV-CA",255
18,"18020",1469,1046,1032,7,14,"UP: IULV-CA",13
18,"18136",1875,1477,1470,7,7,"UP: IULV-CA",80
18,"18013",4236,3108,3052,19,56,"UP: IULV-CA",158
18,"18173",8978,6319,6251,50,68,"UP: IULV-CA",405
18,"18004",724,511,505,3,6,"UP: IULV-CA",5
18,"18053",1667,1084,1078,9,6,"UP: IULV-CA",69
18,"18084",4215,3179,3143,24,36,"UP: IULV-CA",165
18,"18066",2108,1546,1540,4,6,"UP: IULV-CA",121
18,"18137",1005,758,758,6,0,"UP: IULV-CA",5
18,"18069",493,366,363,3,3,"UP: IULV-CA",11
18,"18099",1581,1271,1249,10,22,"UP: IULV-CA",117
18,"18017",18172,12077,11954,101,123,"UP: IULV-CA",596
18,"18035",1255,964,958,4,6,"UP: IULV-CA",12
18,"18163",324,239,235,1,4,"UP: IULV-CA",12
18,"18909",589,462,459,0,3,"UP: IULV-CA",6
18,"18059",4153,3074,3039,23,35,"UP: IULV-CA",273
18,"18913",818,617,603,2,14,"UP: IULV-CA",13
18,"18117",513,402,396,4,6,"UP: IULV-CA",20
18,"18007",785,527,523,3,4,"UP: IULV-CA",16
18,"18063",1191,770,767,6,3,"UP: IULV-CA",3
18,"18057",5263,3968,3937,33,31,"UP: IULV-CA",184
18,"18097",956,703,691,1,12,"UP: IULV-CA",19
18,"18040",225,142,141,0,1,"UP: IULV-CA",8
18,"18028",945,790,781,2,9,"UP: IULV-CA",67
18,"18194",2152,1487,1477,6,10,"UP: IULV-CA",85
18,"18177",427,259,258,3,1,"UP: IULV-CA",4
18,"18003",14022,10417,10330,82,87,"UP: IULV-CA",738
18,"18158",8408,5604,5542,38,62,"UP: IULV-CA",409
18,"18192",1529,1216,1208,3,8,"UP: IULV-CA",86
18,"18036",3768,2904,2882,18,22,"UP: IULV-CA",136
18,"18907",1859,1482,1475,5,7,"UP: IULV-CA",24
18,"18152",938,687,681,1,6,"UP: IULV-CA",15
18,"18025",294,216,214,0,2,"UP: IULV-CA",0
18,"18012",2330,1670,1660,15,10,"UP: IULV-CA",22
18,"18908",805,633,620,2,13,"UP: IULV-CA",17
18,"18901",512,359,357,1,2,"UP: IULV-CA",16
18,"18078",739,593,590,4,3,"UP: IULV-CA",64
18,"18094",2389,1853,1832,22,21,"UP: IULV-CA",55
18,"18181",223,159,157,0,2,"UP: IULV-CA",1
18,"18182",1919,1356,1347,3,9,"UP: IULV-CA",27
18,"18001",256,178,177,2,1,"UP: IULV-CA",3
18,"18121",132,101,100,1,1,"UP: IULV-CA",6
18,"18127",16586,11998,11897,97,101,"UP: IULV-CA",779
18,"18184",2158,1659,1634,4,25,"UP: IULV-CA",130
18,"18047",5888,4028,4000,32,28,"UP: IULV-CA",226
18,"18115",2548,1872,1854,16,18,"UP: IULV-CA",150
18,"18114",634,457,452,2,5,"UP: IULV-CA",12
18,"18056",3545,2716,2687,25,29,"UP: IULV-CA",231
18,"18903",892,650,645,1,5,"UP: IULV-CA",14
18,"18151",260,196,196,0,0,"UP: IULV-CA",17
18,"18910",803,573,569,5,4,"UP: IULV-CA",13
18,"18161",220,184,184,1,0,"UP: IULV-CA",6
18,"18048",2390,1824,1806,8,18,"UP: IULV-CA",50
18,"18140",43567,29155,28932,194,223,"UP: IULV-CA",1302
18,"18051",1149,825,823,7,2,"UP: IULV-CA",4
18,"18027",2562,1846,1827,19,19,"UP: IULV-CA",234
18,"18164",1831,1273,1260,11,13,"UP: IULV-CA",35
18,"18902",847,680,674,10,6,"UP: IULV-CA",16
18,"18050",1711,1271,1256,5,15,"UP: IULV-CA",61
18,"18120",270,218,216,2,2,"UP: IULV-CA",8
18,"18011",4321,3136,3119,10,17,"UP: IULV-CA",123
18,"18032",239,178,175,0,3,"UP: IULV-CA",5
18,"18018",640,490,488,0,2,"UP: IULV-CA",27
18,"18180",631,448,447,2,1,"UP: IULV-CA",59
18,"18061",1059,822,816,1,6,"UP: IULV-CA",74
18,"18046",1867,1225,1215,8,10,"UP: IULV-CA",32
18,"18174",442,354,348,2,6,"UP: IULV-CA",8
18,"18002",561,446,444,1,2,"UP: IULV-CA",6
18,"18124",393,274,271,1,3,"UP: IULV-CA",4
18,"18911",7392,5359,5301,44,58,"UP: IULV-CA",206
18,"18128",344,251,248,0,3,"UP: IULV-CA",4
18,"18087",184873,138280,137516,836,764,"UP: IULV-CA",6505
18,"18904",779,570,565,1,5,"UP: IULV-CA",41
18,"18029",1833,1252,1243,9,9,"UP: IULV-CA",20
18,"18141",414,282,277,1,5,"UP: IULV-CA",3
18,"18912",1488,1021,1007,7,14,"UP: IULV-CA",20
18,"18107",971,719,711,6,8,"UP: IULV-CA",6
18,"18914",1658,1304,1290,8,14,"UP: IULV-CA",126
18,"18165",4135,2944,2915,23,29,"UP: IULV-CA",154
18,"18030",584,428,426,3,2,"UP: IULV-CA",13
18,"18112",131,88,86,1,2,"UP: IULV-CA",1
18,"18021",17451,12420,12305,101,115,"UP: IULV-CA",540
18,"18185",556,461,461,1,0,"UP: IULV-CA",22
18,"18054",868,630,627,2,3,"UP: IULV-CA",16
18,"18906",917,681,673,2,8,"UP: IULV-CA",10
18,"18146",970,734,727,6,7,"UP: IULV-CA",45
18,"18103",760,596,593,6,3,"UP: IULV-CA",3
18,"18095",1959,1486,1474,5,12,"UP: IULV-CA",75
18,"18123",293,228,227,2,1,"UP: IULV-CA",3
18,"18109",599,421,419,2,2,"UP: IULV-CA",3
18,"18067",711,517,516,0,1,"UP: IULV-CA",7
18,"18170",336,227,225,1,2,"UP: IULV-CA",6
18,"18187",561,418,417,1,1,"UP: IULV-CA",30
18,"18126",1497,1094,1087,7,7,"UP: IULV-CA",197
18,"18133",2187,1731,1722,7,9,"UP: IULV-CA",33
18,"18074",273,217,213,2,4,"UP: IULV-CA",3
18,"18098",6167,4367,4342,22,25,"UP: IULV-CA",98
18,"18135",4583,3045,2998,14,47,"UP: IULV-CA",87
18,"18022",13306,9165,9091,51,74,"UP: IULV-CA",543
18,"18082",867,626,621,4,5,"UP: IULV-CA",13
18,"18049",617,456,451,3,5,"UP: IULV-CA",27
18,"18023",15738,11242,11146,92,96,"UP: IULV-CA",486
18,"18076",815,577,576,0,1,"UP: IULV-CA",25
18,"18065",625,503,500,1,3,"UP: IULV-CA",190
18,"18070",283,223,218,0,5,"UP: IULV-CA",9
18,"18096",342,260,259,1,1,"UP: IULV-CA",2
18,"18038",1066,836,826,2,10,"UP: IULV-CA",86
18,"18085",729,489,484,2,5,"UP: IULV-CA",12
18,"18167",1897,1321,1313,8,8,"UP: IULV-CA",45
18,"18108",858,672,667,0,5,"UP: IULV-CA",17
18,"18150",6730,4858,4814,28,44,"UP: IULV-CA",363
18,"18101",9263,6971,6912,55,59,"UP: IULV-CA",368
18,"18189",772,599,595,7,4,"UP: IULV-CA",62
18,"18159",1009,811,802,3,9,"UP: IULV-CA",225
18,"18149",5177,3946,3902,29,44,"UP: IULV-CA",174
18,"18037",530,411,408,1,3,"UP: IULV-CA",13
18,"18014",6372,4620,4566,44,54,"UP: IULV-CA",177
18,"18079",3465,2671,2645,16,26,"UP: IULV-CA",257
18,"18176",258,179,178,3,1,"UP: IULV-CA",10
18,"18138",2482,1721,1712,8,9,"UP: IULV-CA",330
18,"18178",743,571,571,2,0,"UP: IULV-CA",8
18,"18188",1642,1249,1234,8,15,"UP: IULV-CA",32
18,"18010",563,463,459,4,4,"UP: IULV-CA",24
18,"18162",951,744,734,0,10,"UP: IULV-CA",16
18,"18171",2123,1640,1616,14,24,"UP: IULV-CA",373
18,"18086",355,285,283,0,2,"UP: IULV-CA",5
18,"18042",414,342,341,0,1,"UP: IULV-CA",18
18,"18072",666,481,474,4,7,"UP: IULV-CA",8
18,"18016",323,239,237,0,2,"UP: IULV-CA",15
18,"18100",7769,5715,5637,57,78,"UP: IULV-CA",174
18,"18144",782,596,588,3,8,"UP: IULV-CA",31
18,"18905",14500,10137,10058,82,79,"UP: IULV-CA",443
18,"18147",3734,2416,2386,10,30,"UP: IULV-CA",119
21,"21054",8105,6025,5919,41,106,"UPYD",5
21,"21014",4041,3203,3170,15,33,"UPYD",18
21,"21076",2123,1549,1532,13,17,"UPYD",0
21,"21040",3158,2386,2345,15,41,"UPYD",4
21,"21024",495,350,344,5,6,"UPYD",1
21,"21039",308,223,222,2,1,"UPYD",0
21,"21021",12233,7551,7470,94,81,"UPYD",23
21,"21071",204,160,158,2,2,"UPYD",0
21,"21010",14684,8766,8698,92,68,"UPYD",36
21,"21065",287,202,196,0,6,"UPYD",1
21,"21005",15486,10310,10189,64,121,"UPYD",30
21,"21049",3372,2162,2108,15,54,"UPYD",3
21,"21017",3643,2301,2269,17,32,"UPYD",3
21,"21026",270,184,178,1,6,"UPYD",3
21,"21006",3402,2398,2359,13,39,"UPYD",1
21,"21070",6296,4450,4397,38,53,"UPYD",14
21,"21020",372,241,238,2,3,"UPYD",0
21,"21073",1871,1134,1120,12,14,"UPYD",2
21,"21077",1722,1261,1246,5,15,"UPYD",3
21,"21043",1858,1356,1341,13,15,"UPYD",4
21,"21055",6914,5286,5218,34,68,"UPYD",13
21,"21004",1641,1070,1047,10,23,"UPYD",5
21,"21013",10597,7220,7061,69,159,"UPYD",18
21,"21003",695,533,525,1,8,"UPYD",2
21,"21050",12448,8431,8382,86,49,"UPYD",26
21,"21016",1034,777,764,2,13,"UPYD",2
21,"21030",1824,1491,1472,11,19,"UPYD",1
21,"21032",1805,1378,1359,15,19,"UPYD",1
21,"21078",2763,1928,1907,12,21,"UPYD",1
21,"21007",6231,4285,4227,45,58,"UPYD",17
21,"21059",220,167,165,3,2,"UPYD",1
21,"21062",1395,936,926,9,10,"UPYD",1
21,"21025",4049,2682,2653,25,29,"UPYD",8
21,"21056",2912,2115,2024,20,91,"UPYD",7
21,"21028",381,290,287,0,3,"UPYD",0
21,"21069",1715,1186,1175,7,11,"UPYD",4
21,"21034",1207,848,838,8,10,"UPYD",0
21,"21060",11959,7565,7488,103,77,"UPYD",52
21,"21038",1082,732,719,8,13,"UPYD",2
21,"21041",113604,74902,74244,718,658,"UPYD",457
21,"21079",731,526,522,3,4,"UPYD",1
21,"21001",648,479,469,4,10,"UPYD",2
21,"21015",683,425,420,6,5,"UPYD",1
21,"21051",245,176,173,1,3,"UPYD",1
21,"21027",49,36,36,1,0,"UPYD",0
21,"21009",860,571,555,6,16,"UPYD",3
21,"21074",2660,1869,1844,18,25,"UPYD",2
21,"21066",507,408,405,1,3,"UPYD",0
21,"21068",998,606,605,14,1,"UPYD",3
21,"21002",15348,10939,10864,80,75,"UPYD",73
21,"21057",1045,641,640,8,1,"UPYD",2
21,"21075",351,270,266,2,4,"UPYD",1
21,"21061",5092,3471,3429,32,42,"UPYD",6
21,"21042",15349,7802,7708,106,94,"UPYD",23
21,"21044",17552,10820,10692,106,128,"UPYD",30
21,"21023",2147,1379,1357,6,22,"UPYD",4
21,"21037",472,364,360,2,4,"UPYD",0
21,"21058",2602,1904,1886,8,18,"UPYD",3
21,"21052",4618,2837,2773,20,64,"UPYD",8
21,"21046",1703,1200,1173,15,27,"UPYD",3
21,"21072",10280,7869,7777,76,92,"UPYD",18
21,"21008",2662,1847,1831,14,16,"UPYD",2
21,"21012",322,234,227,0,7,"UPYD",0
21,"21045",253,192,190,0,2,"UPYD",0
21,"21035",9622,6399,6313,69,86,"UPYD",15
21,"21022",174,115,109,1,6,"UPYD",0
21,"21019",590,433,423,4,10,"UPYD",0
21,"21029",1564,1166,1126,16,40,"UPYD",1
21,"21063",2614,2044,2034,12,10,"UPYD",5
21,"21031",1209,845,828,3,17,"UPYD",2
21,"21048",305,220,220,3,0,"UPYD",1
21,"21064",6526,4544,4492,51,52,"UPYD",22
21,"21047",1914,1213,1179,19,34,"UPYD",1
21,"21033",536,399,395,0,4,"UPYD",1
21,"21036",192,138,138,1,0,"UPYD",0
21,"21018",1780,1152,1131,10,21,"UPYD",3
21,"21067",415,309,303,0,6,"UPYD",0
21,"21011",3464,2536,2518,19,18,"UPYD",4
21,"21053",3316,2257,2219,25,38,"UPYD",3
10,"10185",572,433,427,5,6,"RECORTES CE",1
10,"10150",354,301,295,4,6,"RECORTES CE",0
10,"10169",544,430,423,0,7,"RECORTES CE",0
10,"10014",1874,1430,1401,11,29,"RECORTES CE",0
10,"10115",3578,2857,2811,20,46,"RECORTES CE",3
10,"10174",175,141,139,0,2,"RECORTES CE",0
10,"10076",820,608,595,3,13,"RECORTES CE",1
10,"10207",502,352,349,5,3,"RECORTES CE",0
10,"10055",719,554,546,3,8,"RECORTES CE",0
10,"10138",544,445,437,2,8,"RECORTES CE",0
10,"10082",1893,1528,1484,13,44,"RECORTES CE",0
10,"10122",231,166,163,0,3,"RECORTES CE",0
10,"10177",1703,1331,1296,10,35,"RECORTES CE",1
10,"10051",440,318,314,1,4,"RECORTES CE",0
10,"10212",1691,1303,1280,8,23,"RECORTES CE",5
10,"10042",85,70,70,0,0,"RECORTES CE",1
10,"10004",713,551,543,1,8,"RECORTES CE",1
10,"10081",179,133,129,0,4,"RECORTES CE",0
10,"10002",368,278,275,0,3,"RECORTES CE",0
10,"10139",111,84,83,0,1,"RECORTES CE",0
10,"10133",1210,1007,989,2,18,"RECORTES CE",0
10,"10166",307,220,219,0,1,"RECORTES CE",0
10,"10071",144,100,100,2,0,"RECORTES CE",0
10,"10006",1275,1024,1004,7,20,"RECORTES CE",0
10,"10187",443,316,311,1,5,"RECORTES CE",1
10,"10095",350,269,267,1,2,"RECORTES CE",0
10,"10120",176,125,125,2,0,"RECORTES CE",0
10,"10197",134,94,93,0,1,"RECORTES CE",0
10,"10045",1031,786,781,11,5,"RECORTES CE",1
10,"10173",581,432,426,4,6,"RECORTES CE",0
10,"10902",730,546,536,2,10,"RECORTES CE",1
10,"10017",841,606,589,4,17,"RECORTES CE",0
10,"10165",259,212,209,0,3,"RECORTES CE",0
10,"10093",406,333,324,2,9,"RECORTES CE",0
10,"10100",795,602,595,4,7,"RECORTES CE",0
10,"10090",522,386,382,5,4,"RECORTES CE",0
10,"10193",1421,1150,1130,10,20,"RECORTES CE",1
10,"10192",841,592,584,0,8,"RECORTES CE",0
10,"10027",78,66,66,0,0,"RECORTES CE",0
10,"10007",646,488,478,3,10,"RECORTES CE",0
10,"10015",687,500,491,2,9,"RECORTES CE",0
10,"10176",374,274,268,1,6,"RECORTES CE",0
10,"10119",630,461,455,2,6,"RECORTES CE",0
10,"10189",2656,2006,1971,10,35,"RECORTES CE",2
10,"10066",158,128,127,1,1,"RECORTES CE",0
10,"10178",781,567,562,1,5,"RECORTES CE",2
10,"10010",2322,1446,1431,12,15,"RECORTES CE",0
10,"10158",335,252,251,0,1,"RECORTES CE",0
10,"10146",1509,1018,1004,4,14,"RECORTES CE",1
10,"10219",1290,860,843,1,17,"RECORTES CE",0
10,"10092",301,238,236,2,2,"RECORTES CE",0
10,"10118",289,257,257,1,0,"RECORTES CE",0
10,"10020",1619,1240,1214,9,26,"RECORTES CE",0
10,"10183",993,763,761,4,2,"RECORTES CE",0
10,"10047",972,783,777,1,6,"RECORTES CE",0
10,"10026",646,507,494,5,13,"RECORTES CE",0
10,"10024",687,538,533,6,5,"RECORTES CE",0
10,"10127",4724,3529,3463,15,66,"RECORTES CE",4
10,"10041",1056,823,811,4,12,"RECORTES CE",0
10,"10163",356,302,299,1,3,"RECORTES CE",0
10,"10013",282,228,223,2,5,"RECORTES CE",0
10,"10096",3443,2503,2464,14,39,"RECORTES CE",2
10,"10070",720,548,540,0,8,"RECORTES CE",0
10,"10087",1701,1233,1215,7,18,"RECORTES CE",1
10,"10037",76403,58422,57811,329,611,"RECORTES CE",139
10,"10079",901,703,695,2,8,"RECORTES CE",3
10,"10112",1583,1203,1176,7,27,"RECORTES CE",0
10,"10050",1062,853,846,5,7,"RECORTES CE",0
10,"10053",289,231,224,1,7,"RECORTES CE",0
10,"10152",470,361,357,3,4,"RECORTES CE",0
10,"10018",1722,1255,1240,6,15,"RECORTES CE",3
10,"10144",996,755,748,3,7,"RECORTES CE",2
10,"10205",2034,1413,1386,5,27,"RECORTES CE",0
10,"10213",571,483,478,1,5,"RECORTES CE",0
10,"10028",98,72,71,0,1,"RECORTES CE",0
10,"10114",968,721,711,4,10,"RECORTES CE",0
10,"10036",327,247,244,2,3,"RECORTES CE",0
10,"10064",1490,1142,1119,9,23,"RECORTES CE",0
10,"10104",5169,3766,3703,21,63,"RECORTES CE",5
10,"10157",273,209,205,1,4,"RECORTES CE",1
10,"10141",268,190,189,2,1,"RECORTES CE",0
10,"10124",862,692,678,7,14,"RECORTES CE",0
10,"10170",263,204,202,2,2,"RECORTES CE",0
10,"10043",814,594,590,2,4,"RECORTES CE",0
10,"10904",750,522,520,5,2,"RECORTES CE",0
10,"10052",193,127,126,1,1,"RECORTES CE",0
10,"10040",443,344,342,4,2,"RECORTES CE",0
10,"10069",831,647,637,2,10,"RECORTES CE",1
10,"10075",256,178,177,1,1,"RECORTES CE",1
10,"10033",430,304,301,1,3,"RECORTES CE",0
10,"10164",742,513,508,1,5,"RECORTES CE",1
10,"10048",245,163,161,1,2,"RECORTES CE",1
10,"10044",1451,1100,1087,7,13,"RECORTES CE",1
10,"10151",213,163,161,0,2,"RECORTES CE",0
10,"10080",368,276,272,1,4,"RECORTES CE",0
10,"10008",1331,1052,1047,6,5,"RECORTES CE",0
10,"10905",651,458,456,0,2,"RECORTES CE",0
10,"10167",306,240,237,0,3,"RECORTES CE",0
10,"10191",532,417,415,12,2,"RECORTES CE",0
10,"10143",158,121,121,0,0,"RECORTES CE",0
10,"10132",400,258,256,0,2,"RECORTES CE",1
10,"10217",533,431,427,1,4,"RECORTES CE",0
10,"10215",442,320,320,0,0,"RECORTES CE",0
10,"10194",536,441,433,5,8,"RECORTES CE",0
10,"10029",418,345,341,1,4,"RECORTES CE",0
10,"10021",5198,3960,3878,40,82,"RECORTES CE",1
10,"10188",500,381,373,2,8,"RECORTES CE",1
10,"10180",4159,2765,2734,12,31,"RECORTES CE",2
10,"10022",435,371,366,1,5,"RECORTES CE",0
10,"10108",218,122,120,0,2,"RECORTES CE",0
10,"10168",320,240,237,0,3,"RECORTES CE",0
10,"10107",1033,825,815,11,10,"RECORTES CE",0
10,"10034",350,263,262,1,1,"RECORTES CE",0
10,"10031",167,138,137,1,1,"RECORTES CE",0
10,"10056",591,456,452,5,4,"RECORTES CE",0
10,"10208",124,100,98,1,2,"RECORTES CE",0
10,"10172",718,501,493,2,8,"RECORTES CE",3
10,"10202",621,495,478,2,17,"RECORTES CE",1
10,"10084",1370,934,906,7,28,"RECORTES CE",1
10,"10117",260,127,127,0,0,"RECORTES CE",0
10,"10145",126,101,100,1,1,"RECORTES CE",0
10,"10059",369,258,255,0,3,"RECORTES CE",0
10,"10154",184,138,134,1,4,"RECORTES CE",0
10,"10023",846,647,637,1,10,"RECORTES CE",0
10,"10105",2519,1745,1714,11,31,"RECORTES CE",7
10,"10019",1510,1134,1121,8,13,"RECORTES CE",1
10,"10073",715,536,530,3,6,"RECORTES CE",0
10,"10175",1434,1054,1028,7,26,"RECORTES CE",0
10,"10903",819,629,624,7,5,"RECORTES CE",0
10,"10060",973,620,607,5,13,"RECORTES CE",0
10,"10123",585,480,468,1,12,"RECORTES CE",2
10,"10130",1761,1322,1308,5,14,"RECORTES CE",3
10,"10211",454,352,339,2,13,"RECORTES CE",1
10,"10068",746,601,586,3,15,"RECORTES CE",1
10,"10159",323,235,232,2,3,"RECORTES CE",0
10,"10061",1664,1143,1131,8,12,"RECORTES CE",0
10,"10032",1705,1296,1277,10,19,"RECORTES CE",2
10,"10135",1329,981,958,1,23,"RECORTES CE",1
10,"10901",1184,851,835,2,16,"RECORTES CE",2
10,"10134",565,395,393,1,2,"RECORTES CE",1
10,"10186",994,830,816,4,14,"RECORTES CE",0
10,"10203",4600,3268,3215,14,53,"RECORTES CE",2
10,"10110",2298,1682,1638,10,44,"RECORTES CE",4
10,"10101",185,147,147,1,0,"RECORTES CE",0
10,"10184",778,620,610,6,10,"RECORTES CE",0
10,"10025",402,341,328,2,13,"RECORTES CE",0
10,"10054",545,427,426,6,1,"RECORTES CE",0
10,"10038",86,70,70,0,0,"RECORTES CE",0
10,"10111",1364,995,978,9,17,"RECORTES CE",1
10,"10148",32985,23666,23394,189,272,"RECORTES CE",51
10,"10201",176,146,145,0,1,"RECORTES CE",0
10,"10030",477,316,304,1,12,"RECORTES CE",0
10,"10216",1543,1200,1192,9,8,"RECORTES CE",1
10,"10199",166,120,119,3,1,"RECORTES CE",0
10,"10142",824,620,616,5,4,"RECORTES CE",0
10,"10097",106,79,79,0,0,"RECORTES CE",0
10,"10204",442,345,342,5,3,"RECORTES CE",1
10,"10196",306,234,233,1,1,"RECORTES CE",0
10,"10103",454,342,338,1,4,"RECORTES CE",0
10,"10094",232,203,203,3,0,"RECORTES CE",0
10,"10003",557,401,396,2,5,"RECORTES CE",0
10,"10153",318,238,231,3,7,"RECORTES CE",2
10,"10089",1376,1004,988,2,16,"RECORTES CE",2
10,"10129",363,272,266,4,6,"RECORTES CE",0
10,"10035",1880,1390,1372,6,18,"RECORTES CE",0
10,"10058",1025,747,737,5,10,"RECORTES CE",1
10,"10085",335,248,244,1,4,"RECORTES CE",0
10,"10131",12850,9036,8977,44,59,"RECORTES CE",13
10,"10171",340,262,261,1,1,"RECORTES CE",0
10,"10218",1143,828,814,2,14,"RECORTES CE",0
10,"10012",599,494,489,1,5,"RECORTES CE",1
10,"10121",7970,5884,5816,33,68,"RECORTES CE",4
10,"10005",537,411,398,3,13,"RECORTES CE",1
10,"10179",301,247,247,0,0,"RECORTES CE",0
10,"10126",1572,1123,1107,3,16,"RECORTES CE",0
10,"10078",414,325,319,3,6,"RECORTES CE",0
10,"10102",531,413,410,4,3,"RECORTES CE",0
10,"10065",205,154,154,1,0,"RECORTES CE",1
10,"10190",561,401,397,2,4,"RECORTES CE",1
10,"10147",1275,985,937,6,48,"RECORTES CE",0
10,"10137",399,344,343,4,1,"RECORTES CE",0
10,"10072",862,644,639,2,5,"RECORTES CE",1
10,"10039",427,295,290,0,5,"RECORTES CE",0
10,"10161",75,53,53,0,0,"RECORTES CE",0
10,"10198",1160,1022,1009,6,13,"RECORTES CE",0
10,"10113",2354,1800,1778,20,22,"RECORTES CE",0
10,"10156",96,71,70,1,1,"RECORTES CE",0
10,"10001",285,226,225,2,1,"RECORTES CE",1
10,"10128",5752,4219,4146,39,73,"RECORTES CE",2
10,"10116",3784,2839,2801,21,38,"RECORTES CE",3
10,"10083",90,69,69,0,0,"RECORTES CE",0
10,"10195",7768,5818,5723,58,95,"RECORTES CE",5
10,"10091",378,304,304,0,0,"RECORTES CE",0
10,"10049",3849,3185,3111,27,74,"RECORTES CE",10
10,"10098",385,294,286,0,8,"RECORTES CE",0
10,"10125",903,648,638,2,10,"RECORTES CE",0
10,"10214",208,172,170,0,2,"RECORTES CE",0
10,"10181",694,571,558,7,13,"RECORTES CE",0
10,"10182",129,95,95,0,0,"RECORTES CE",0
10,"10009",270,173,170,1,3,"RECORTES CE",0
10,"10099",592,417,413,7,4,"RECORTES CE",0
10,"10109",1804,1233,1212,2,21,"RECORTES CE",2
10,"10162",579,483,476,0,7,"RECORTES CE",0
10,"10011",570,450,443,2,7,"RECORTES CE",0
10,"10200",417,308,305,0,3,"RECORTES CE",0
10,"10206",212,161,160,3,1,"RECORTES CE",0
10,"10016",329,262,259,1,3,"RECORTES CE",0
10,"10067",10486,7796,7692,54,104,"RECORTES CE",5
10,"10149",435,315,307,1,8,"RECORTES CE",0
10,"10210",551,380,373,1,7,"RECORTES CE",1
10,"10086",329,259,256,1,3,"RECORTES CE",0
10,"10155",1140,856,842,3,14,"RECORTES CE",0
10,"10077",689,511,504,2,7,"RECORTES CE",0
10,"10046",201,176,173,2,3,"RECORTES CE",0
10,"10106",134,111,111,1,0,"RECORTES CE",0
10,"10057",150,112,111,0,1,"RECORTES CE",0
10,"10063",179,145,145,1,0,"RECORTES CE",0
10,"10136",318,234,234,4,0,"RECORTES CE",0
10,"10088",205,117,117,0,0,"RECORTES CE",0
10,"10209",296,195,193,1,2,"RECORTES CE",0
10,"10160",225,172,170,0,2,"RECORTES CE",0
10,"10062",413,345,341,3,4,"RECORTES CE",0
10,"10140",1114,860,848,6,12,"RECORTES CE",0
21,"21065",287,202,196,0,6,"VOX",1
21,"21049",3372,2162,2108,15,54,"VOX",1
21,"21006",3402,2398,2359,13,39,"VOX",2
21,"21048",305,220,220,3,0,"VOX",0
21,"21009",860,571,555,6,16,"VOX",1
21,"21060",11959,7565,7488,103,77,"VOX",16
21,"21054",8105,6025,5919,41,106,"VOX",14
21,"21044",17552,10820,10692,106,128,"VOX",9
21,"21019",590,433,423,4,10,"VOX",0
21,"21072",10280,7869,7777,76,92,"VOX",5
21,"21055",6914,5286,5218,34,68,"VOX",8
21,"21016",1034,777,764,2,13,"VOX",0
21,"21064",6526,4544,4492,51,52,"VOX",5
21,"21028",381,290,287,0,3,"VOX",1
21,"21032",1805,1378,1359,15,19,"VOX",0
21,"21076",2123,1549,1532,13,17,"VOX",0
21,"21005",15486,10310,10189,64,121,"VOX",21
21,"21037",472,364,360,2,4,"VOX",0
21,"21002",15348,10939,10864,80,75,"VOX",31
21,"21066",507,408,405,1,3,"VOX",0
21,"21069",1715,1186,1175,7,11,"VOX",0
21,"21030",1824,1491,1472,11,19,"VOX",7
21,"21003",695,533,525,1,8,"VOX",0
21,"21007",6231,4285,4227,45,58,"VOX",5
21,"21036",192,138,138,1,0,"VOX",0
21,"21035",9622,6399,6313,69,86,"VOX",2
21,"21029",1564,1166,1126,16,40,"VOX",2
21,"21046",1703,1200,1173,15,27,"VOX",0
21,"21038",1082,732,719,8,13,"VOX",3
21,"21077",1722,1261,1246,5,15,"VOX",1
21,"21040",3158,2386,2345,15,41,"VOX",5
21,"21071",204,160,158,2,2,"VOX",0
21,"21033",536,399,395,0,4,"VOX",0
21,"21039",308,223,222,2,1,"VOX",0
21,"21063",2614,2044,2034,12,10,"VOX",0
21,"21075",351,270,266,2,4,"VOX",0
21,"21043",1858,1356,1341,13,15,"VOX",2
21,"21061",5092,3471,3429,32,42,"VOX",1
21,"21073",1871,1134,1120,12,14,"VOX",2
21,"21051",245,176,173,1,3,"VOX",0
21,"21074",2660,1869,1844,18,25,"VOX",8
21,"21057",1045,641,640,8,1,"VOX",0
21,"21018",1780,1152,1131,10,21,"VOX",1
21,"21045",253,192,190,0,2,"VOX",0
21,"21056",2912,2115,2024,20,91,"VOX",1
21,"21078",2763,1928,1907,12,21,"VOX",0
21,"21011",3464,2536,2518,19,18,"VOX",1
21,"21004",1641,1070,1047,10,23,"VOX",1
21,"21050",12448,8431,8382,86,49,"VOX",14
21,"21067",415,309,303,0,6,"VOX",0
21,"21020",372,241,238,2,3,"VOX",1
21,"21027",49,36,36,1,0,"VOX",0
21,"21031",1209,845,828,3,17,"VOX",1
21,"21058",2602,1904,1886,8,18,"VOX",0
21,"21053",3316,2257,2219,25,38,"VOX",3
21,"21025",4049,2682,2653,25,29,"VOX",4
21,"21010",14684,8766,8698,92,68,"VOX",13
21,"21034",1207,848,838,8,10,"VOX",0
21,"21079",731,526,522,3,4,"VOX",1
21,"21023",2147,1379,1357,6,22,"VOX",0
21,"21008",2662,1847,1831,14,16,"VOX",0
21,"21047",1914,1213,1179,19,34,"VOX",0
21,"21024",495,350,344,5,6,"VOX",0
21,"21012",322,234,227,0,7,"VOX",0
21,"21062",1395,936,926,9,10,"VOX",1
21,"21059",220,167,165,3,2,"VOX",0
21,"21068",998,606,605,14,1,"VOX",3
21,"21017",3643,2301,2269,17,32,"VOX",2
21,"21014",4041,3203,3170,15,33,"VOX",0
21,"21022",174,115,109,1,6,"VOX",0
21,"21013",10597,7220,7061,69,159,"VOX",15
21,"21042",15349,7802,7708,106,94,"VOX",17
21,"21001",648,479,469,4,10,"VOX",1
21,"21041",113604,74902,74244,718,658,"VOX",206
21,"21026",270,184,178,1,6,"VOX",0
21,"21021",12233,7551,7470,94,81,"VOX",11
21,"21015",683,425,420,6,5,"VOX",0
21,"21052",4618,2837,2773,20,64,"VOX",2
21,"21070",6296,4450,4397,38,53,"VOX",7
37,"37114",88,67,66,1,1,"RECORTES CE",0
37,"37024",92,77,77,0,0,"RECORTES CE",0
37,"37013",121,87,86,3,1,"RECORTES CE",1
37,"37215",136,102,101,2,1,"RECORTES CE",0
37,"37123",182,141,138,0,3,"RECORTES CE",0
37,"37319",117,78,77,0,1,"RECORTES CE",0
37,"37060",245,192,192,0,0,"RECORTES CE",0
37,"37122",202,158,156,3,2,"RECORTES CE",0
37,"37355",189,147,146,1,1,"RECORTES CE",0
37,"37007",439,321,313,4,8,"RECORTES CE",0
37,"37201",262,179,177,0,2,"RECORTES CE",0
37,"37356",86,73,71,1,2,"RECORTES CE",0
37,"37333",225,143,142,4,1,"RECORTES CE",0
37,"37045",27,20,20,0,0,"RECORTES CE",0
37,"37373",755,548,545,3,3,"RECORTES CE",1
37,"37267",199,151,147,2,4,"RECORTES CE",0
37,"37015",222,145,143,3,2,"RECORTES CE",0
37,"37034",84,66,66,3,0,"RECORTES CE",0
37,"37128",264,211,201,4,10,"RECORTES CE",0
37,"37042",42,29,29,2,0,"RECORTES CE",0
37,"37273",108,77,77,0,0,"RECORTES CE",0
37,"37243",102,76,76,0,0,"RECORTES CE",0
37,"37054",261,199,198,1,1,"RECORTES CE",0
37,"37378",111,74,70,2,4,"RECORTES CE",0
37,"37256",220,158,157,1,1,"RECORTES CE",0
37,"37224",210,183,179,2,4,"RECORTES CE",0
37,"37296",338,258,255,4,3,"RECORTES CE",0
37,"37246",5335,4190,4152,41,38,"RECORTES CE",11
37,"37343",62,49,49,0,0,"RECORTES CE",0
37,"37375",705,593,582,11,11,"RECORTES CE",1
37,"37181",291,209,207,1,2,"RECORTES CE",0
37,"37354",5182,3955,3915,50,40,"RECORTES CE",7
37,"37073",583,449,442,8,7,"RECORTES CE",0
37,"37185",591,450,443,4,7,"RECORTES CE",0
37,"37089",67,50,49,0,1,"RECORTES CE",0
37,"37051",80,54,53,0,1,"RECORTES CE",0
37,"37324",371,284,279,4,5,"RECORTES CE",0
37,"37063",74,59,59,1,0,"RECORTES CE",0
37,"37217",56,46,44,1,2,"RECORTES CE",0
37,"37130",173,155,153,5,2,"RECORTES CE",0
37,"37138",199,155,154,4,1,"RECORTES CE",0
37,"37026",192,158,154,2,4,"RECORTES CE",0
37,"37260",154,126,126,1,0,"RECORTES CE",0
37,"37036",63,46,46,0,0,"RECORTES CE",0
37,"37298",184,125,125,1,0,"RECORTES CE",1
37,"37184",345,247,244,1,3,"RECORTES CE",0
37,"37032",543,411,410,1,1,"RECORTES CE",0
37,"37091",176,114,113,2,1,"RECORTES CE",0
37,"37284",325,245,244,2,1,"RECORTES CE",1
37,"37001",195,147,144,0,3,"RECORTES CE",0
37,"37366",43,27,27,0,0,"RECORTES CE",0
37,"37322",2472,1691,1676,12,15,"RECORTES CE",2
37,"37029",213,155,152,0,3,"RECORTES CE",0
37,"37009",216,161,160,3,1,"RECORTES CE",0
37,"37232",390,349,348,0,1,"RECORTES CE",0
37,"37101",163,122,122,2,0,"RECORTES CE",0
37,"37081",933,720,714,4,6,"RECORTES CE",0
37,"37250",358,223,223,1,0,"RECORTES CE",0
37,"37226",156,121,119,1,2,"RECORTES CE",0
37,"37283",120,88,88,1,0,"RECORTES CE",0
37,"37335",415,301,293,2,8,"RECORTES CE",0
37,"37347",477,365,359,3,6,"RECORTES CE",1
37,"37163",42,33,33,0,0,"RECORTES CE",0
37,"37097",36,30,30,0,0,"RECORTES CE",0
37,"37065",323,237,235,0,2,"RECORTES CE",0
37,"37031",365,258,257,1,1,"RECORTES CE",0
37,"37151",146,116,115,2,1,"RECORTES CE",0
37,"37021",80,62,62,0,0,"RECORTES CE",0
37,"37320",93,71,71,1,0,"RECORTES CE",0
37,"37159",91,74,74,0,0,"RECORTES CE",0
37,"37040",393,320,317,3,3,"RECORTES CE",0
37,"37152",424,290,283,2,7,"RECORTES CE",0
37,"37285",412,311,305,2,6,"RECORTES CE",0
37,"37205",233,201,197,1,4,"RECORTES CE",0
37,"37109",182,119,118,0,1,"RECORTES CE",0
37,"37014",1161,850,847,5,3,"RECORTES CE",0
37,"37376",2251,1588,1568,9,20,"RECORTES CE",2
37,"37018",105,80,80,1,0,"RECORTES CE",0
37,"37289",240,182,182,2,0,"RECORTES CE",0
37,"37183",417,305,301,2,4,"RECORTES CE",0
37,"37325",91,68,63,0,5,"RECORTES CE",0
37,"37198",206,161,160,3,1,"RECORTES CE",1
37,"37202",978,773,763,7,10,"RECORTES CE",4
37,"37169",176,139,137,0,2,"RECORTES CE",0
37,"37234",357,224,222,1,2,"RECORTES CE",0
37,"37321",170,131,129,2,2,"RECORTES CE",0
37,"37218",71,33,33,2,0,"RECORTES CE",0
37,"37115",123,89,87,0,2,"RECORTES CE",0
37,"37345",166,135,133,3,2,"RECORTES CE",0
37,"37055",123,105,98,0,7,"RECORTES CE",0
37,"37348",113,91,91,1,0,"RECORTES CE",0
37,"37132",351,272,269,2,3,"RECORTES CE",0
37,"37136",667,453,448,2,5,"RECORTES CE",0
37,"37166",213,142,142,1,0,"RECORTES CE",0
37,"37069",976,713,699,9,14,"RECORTES CE",0
37,"37223",109,90,87,0,3,"RECORTES CE",0
37,"37121",584,434,430,5,4,"RECORTES CE",2
37,"37353",129,92,92,1,0,"RECORTES CE",0
37,"37261",227,165,161,2,4,"RECORTES CE",0
37,"37039",304,213,213,4,0,"RECORTES CE",0
37,"37056",41,30,30,0,0,"RECORTES CE",0
37,"37247",199,162,154,3,8,"RECORTES CE",0
37,"37303",188,152,151,1,1,"RECORTES CE",0
37,"37192",353,245,242,2,3,"RECORTES CE",0
37,"37035",194,161,161,0,0,"RECORTES CE",0
37,"37129",251,199,194,1,5,"RECORTES CE",0
37,"37070",533,403,396,4,7,"RECORTES CE",0
37,"37288",258,211,210,7,1,"RECORTES CE",0
37,"37277",73,55,55,0,0,"RECORTES CE",0
37,"37251",126,87,87,2,0,"RECORTES CE",0
37,"37083",179,159,159,0,0,"RECORTES CE",0
37,"37372",146,117,115,0,2,"RECORTES CE",0
37,"37339",316,257,257,4,0,"RECORTES CE",0
37,"37157",77,62,62,0,0,"RECORTES CE",0
37,"37190",219,167,167,0,0,"RECORTES CE",0
37,"37186",106,78,78,3,0,"RECORTES CE",0
37,"37233",65,45,45,0,0,"RECORTES CE",0
37,"37271",361,283,276,3,7,"RECORTES CE",0
37,"37329",36,28,28,0,0,"RECORTES CE",0
37,"37369",140,96,96,0,0,"RECORTES CE",0
37,"37176",137,100,98,0,2,"RECORTES CE",0
37,"37085",4704,3475,3432,35,43,"RECORTES CE",8
37,"37145",257,190,187,0,3,"RECORTES CE",0
37,"37112",161,115,114,0,1,"RECORTES CE",1
37,"37362",4592,3442,3403,48,39,"RECORTES CE",5
37,"37305",216,170,169,2,1,"RECORTES CE",1
37,"37033",98,63,63,0,0,"RECORTES CE",0
37,"37242",91,71,71,0,0,"RECORTES CE",0
37,"37377",249,199,195,3,4,"RECORTES CE",0
37,"37113",430,340,340,3,0,"RECORTES CE",0
37,"37158",248,183,181,0,2,"RECORTES CE",0
37,"37146",122,100,99,1,1,"RECORTES CE",0
37,"37286",206,156,156,4,0,"RECORTES CE",1
37,"37363",120,98,94,0,4,"RECORTES CE",0
37,"37306",271,171,171,0,0,"RECORTES CE",0
37,"37023",1378,1116,1105,9,11,"RECORTES CE",1
37,"37228",367,301,299,1,2,"RECORTES CE",0
37,"37082",799,570,560,1,10,"RECORTES CE",1
37,"37315",93,69,67,1,2,"RECORTES CE",0
37,"37212",111,83,83,1,0,"RECORTES CE",0
37,"37016",573,451,447,3,4,"RECORTES CE",2
37,"37338",78,66,66,1,0,"RECORTES CE",0
37,"37299",221,170,163,1,7,"RECORTES CE",0
37,"37379",173,134,134,2,0,"RECORTES CE",0
37,"37140",678,440,435,2,5,"RECORTES CE",0
37,"37164",256,200,195,1,5,"RECORTES CE",0
37,"37160",627,450,443,7,7,"RECORTES CE",0
37,"37236",139,94,89,0,5,"RECORTES CE",0
37,"37248",152,127,126,2,1,"RECORTES CE",0
37,"37102",411,291,289,3,2,"RECORTES CE",0
37,"37204",280,214,211,1,3,"RECORTES CE",1
37,"37240",907,646,636,5,10,"RECORTES CE",1
37,"37061",226,166,164,1,2,"RECORTES CE",0
37,"37148",425,304,295,6,9,"RECORTES CE",0
37,"37252",116,89,89,0,0,"RECORTES CE",0
37,"37126",30,24,24,0,0,"RECORTES CE",0
37,"37332",69,53,52,0,1,"RECORTES CE",0
37,"37297",420,342,331,4,11,"RECORTES CE",0
37,"37116",69,51,51,0,0,"RECORTES CE",0
37,"37103",446,326,325,4,1,"RECORTES CE",1
37,"37274",119148,88959,88152,853,807,"RECORTES CE",159
37,"37172",878,580,576,3,4,"RECORTES CE",0
37,"37344",246,184,183,1,1,"RECORTES CE",0
37,"37264",67,43,43,0,0,"RECORTES CE",0
37,"37275",123,87,86,1,1,"RECORTES CE",0
37,"37231",259,208,207,4,1,"RECORTES CE",0
37,"37253",135,110,110,1,0,"RECORTES CE",0
37,"37072",166,133,132,2,1,"RECORTES CE",0
37,"37249",44,33,33,1,0,"RECORTES CE",0
37,"37310",180,129,128,2,1,"RECORTES CE",0
37,"37037",119,81,81,0,0,"RECORTES CE",1
37,"37367",199,160,158,7,2,"RECORTES CE",0
37,"37195",48,35,35,1,0,"RECORTES CE",0
37,"37199",142,108,108,0,0,"RECORTES CE",0
37,"37117",1458,1075,1068,14,7,"RECORTES CE",0
37,"37005",77,58,56,0,2,"RECORTES CE",0
37,"37090",52,38,36,0,2,"RECORTES CE",0
37,"37239",229,196,194,6,2,"RECORTES CE",2
37,"37125",228,158,156,3,2,"RECORTES CE",0
37,"37020",430,340,334,3,6,"RECORTES CE",1
37,"37177",298,223,221,1,2,"RECORTES CE",0
37,"37254",183,153,149,0,4,"RECORTES CE",0
37,"37189",125,97,97,0,0,"RECORTES CE",0
37,"37173",1526,1138,1125,5,13,"RECORTES CE",1
37,"37147",191,141,136,0,5,"RECORTES CE",0
37,"37307",160,103,103,0,0,"RECORTES CE",0
37,"37106",266,172,166,1,6,"RECORTES CE",1
37,"37368",16,15,15,0,0,"RECORTES CE",0
37,"37346",267,222,220,1,2,"RECORTES CE",0
37,"37017",251,186,184,2,2,"RECORTES CE",0
37,"37312",262,211,210,3,1,"RECORTES CE",0
37,"37300",575,427,423,3,4,"RECORTES CE",0
37,"37052",274,197,197,2,0,"RECORTES CE",0
37,"37255",51,38,38,0,0,"RECORTES CE",0
37,"37080",232,176,176,1,0,"RECORTES CE",0
37,"37358",168,136,135,2,1,"RECORTES CE",0
37,"37197",87,55,55,2,0,"RECORTES CE",0
37,"37380",55,46,46,2,0,"RECORTES CE",1
37,"37245",345,252,246,7,6,"RECORTES CE",0
37,"37092",1731,1264,1250,11,14,"RECORTES CE",3
37,"37222",97,66,66,1,0,"RECORTES CE",0
37,"37282",209,136,136,0,0,"RECORTES CE",0
37,"37107",10855,7694,7598,96,96,"RECORTES CE",7
37,"37187",565,431,426,4,5,"RECORTES CE",0
37,"37293",118,84,84,0,0,"RECORTES CE",0
37,"37340",150,105,104,1,1,"RECORTES CE",0
37,"37370",337,258,255,3,3,"RECORTES CE",0
37,"37150",43,35,35,0,0,"RECORTES CE",0
37,"37004",32,22,22,0,0,"RECORTES CE",0
37,"37290",140,116,116,0,0,"RECORTES CE",0
37,"37381",139,98,92,0,6,"RECORTES CE",0
37,"37165",33,27,27,0,0,"RECORTES CE",0
37,"37268",116,71,70,0,1,"RECORTES CE",0
37,"37100",81,68,67,1,1,"RECORTES CE",0
37,"37382",180,133,133,4,0,"RECORTES CE",0
37,"37360",230,167,166,2,1,"RECORTES CE",2
37,"37019",151,114,111,0,3,"RECORTES CE",0
37,"37327",185,157,157,5,0,"RECORTES CE",1
37,"37188",185,127,125,3,2,"RECORTES CE",1
37,"37143",385,301,299,1,2,"RECORTES CE",1
37,"37265",217,180,178,2,2,"RECORTES CE",1
37,"37219",179,110,110,0,0,"RECORTES CE",0
37,"37334",79,42,42,1,0,"RECORTES CE",0
37,"37349",112,83,82,0,1,"RECORTES CE",0
37,"37342",256,210,208,1,2,"RECORTES CE",1
37,"37276",149,100,99,0,1,"RECORTES CE",0
37,"37110",117,92,89,1,3,"RECORTES CE",0
37,"37328",189,142,140,0,2,"RECORTES CE",1
37,"37350",421,324,320,4,4,"RECORTES CE",0
37,"37167",173,150,144,2,6,"RECORTES CE",0
37,"37225",106,94,92,0,2,"RECORTES CE",0
37,"37044",470,353,341,1,12,"RECORTES CE",0
37,"37168",443,319,311,2,8,"RECORTES CE",0
37,"37213",87,73,73,0,0,"RECORTES CE",0
37,"37259",45,30,30,0,0,"RECORTES CE",0
37,"37237",325,250,248,4,2,"RECORTES CE",0
37,"37179",215,173,170,0,3,"RECORTES CE",2
37,"37099",73,45,45,2,0,"RECORTES CE",0
37,"37317",306,246,243,1,3,"RECORTES CE",0
37,"37304",170,114,109,4,5,"RECORTES CE",0
37,"37134",230,175,173,1,2,"RECORTES CE",0
37,"37149",70,63,63,0,0,"RECORTES CE",0
37,"37022",268,220,219,2,1,"RECORTES CE",2
37,"37351",281,239,238,0,1,"RECORTES CE",1
37,"37309",45,28,28,0,0,"RECORTES CE",0
37,"37161",138,109,107,0,2,"RECORTES CE",0
37,"37071",78,73,72,1,1,"RECORTES CE",0
37,"37108",101,81,79,2,2,"RECORTES CE",0
37,"37191",116,78,76,0,2,"RECORTES CE",0
37,"37330",335,262,258,4,4,"RECORTES CE",0
37,"37012",150,117,115,0,2,"RECORTES CE",1
37,"37046",11336,8300,8171,62,129,"RECORTES CE",11
37,"37059",124,100,98,0,2,"RECORTES CE",0
37,"37078",823,670,657,8,13,"RECORTES CE",0
37,"37374",1178,971,943,8,28,"RECORTES CE",0
37,"37341",56,43,41,0,2,"RECORTES CE",0
37,"37318",209,156,155,1,1,"RECORTES CE",1
37,"37170",1479,1055,1031,10,24,"RECORTES CE",0
37,"37155",73,54,54,1,0,"RECORTES CE",0
37,"37002",144,87,87,0,0,"RECORTES CE",0
37,"37257",53,43,43,0,0,"RECORTES CE",0
37,"37287",318,237,237,3,0,"RECORTES CE",0
37,"37311",226,182,182,2,0,"RECORTES CE",0
37,"37139",205,163,162,2,1,"RECORTES CE",0
37,"37027",228,187,187,0,0,"RECORTES CE",0
37,"37203",165,118,118,0,0,"RECORTES CE",1
37,"37144",370,288,284,2,4,"RECORTES CE",0
37,"37087",855,681,676,8,5,"RECORTES CE",1
37,"37088",204,152,152,3,0,"RECORTES CE",0
37,"37364",836,598,583,6,15,"RECORTES CE",0
37,"37229",143,102,102,1,0,"RECORTES CE",0
37,"37074",153,109,103,4,6,"RECORTES CE",0
37,"37086",98,80,80,2,0,"RECORTES CE",0
37,"37216",310,264,257,4,7,"RECORTES CE",0
37,"37049",147,98,98,2,0,"RECORTES CE",1
37,"37171",411,321,317,1,4,"RECORTES CE",0
37,"37241",172,128,126,1,2,"RECORTES CE",0
37,"37003",119,93,90,0,3,"RECORTES CE",0
37,"37266",84,55,55,1,0,"RECORTES CE",0
37,"37230",221,167,167,2,0,"RECORTES CE",0
37,"37278",753,573,568,7,5,"RECORTES CE",2
37,"37292",103,72,72,1,0,"RECORTES CE",0
37,"37127",221,158,158,4,0,"RECORTES CE",0
37,"37263",348,252,251,1,1,"RECORTES CE",1
37,"37038",789,628,616,5,12,"RECORTES CE",1
37,"37079",74,64,63,0,1,"RECORTES CE",0
37,"37006",135,91,90,1,1,"RECORTES CE",0
37,"37119",109,86,86,1,0,"RECORTES CE",0
37,"37206",94,71,71,4,0,"RECORTES CE",0
37,"37077",260,234,230,0,4,"RECORTES CE",0
37,"37030",84,68,66,0,2,"RECORTES CE",0
37,"37235",223,168,163,1,5,"RECORTES CE",0
37,"37104",27,21,21,0,0,"RECORTES CE",0
37,"37180",73,52,52,1,0,"RECORTES CE",1
37,"37096",220,174,174,5,0,"RECORTES CE",1
37,"37008",4298,3312,3272,16,40,"RECORTES CE",6
37,"37162",206,151,149,2,2,"RECORTES CE",1
37,"37357",276,216,215,0,1,"RECORTES CE",0
37,"37279",763,572,562,11,10,"RECORTES CE",0
37,"37041",74,48,48,0,0,"RECORTES CE",0
37,"37200",190,134,133,2,1,"RECORTES CE",1
37,"37067",3125,2551,2523,22,28,"RECORTES CE",6
37,"37196",77,54,53,0,1,"RECORTES CE",0
37,"37207",303,234,233,0,1,"RECORTES CE",1
37,"37208",81,49,48,0,1,"RECORTES CE",0
37,"37365",174,147,144,0,3,"RECORTES CE",2
37,"37141",156,127,127,1,0,"RECORTES CE",0
37,"37323",521,387,385,8,2,"RECORTES CE",0
37,"37174",1065,838,826,3,12,"RECORTES CE",1
37,"37269",452,328,328,2,0,"RECORTES CE",0
37,"37302",294,216,214,1,2,"RECORTES CE",0
37,"37182",77,62,62,0,0,"RECORTES CE",0
37,"37270",190,142,139,1,3,"RECORTES CE",0
37,"37262",78,64,64,1,0,"RECORTES CE",0
37,"37361",84,56,55,0,1,"RECORTES CE",0
37,"37244",134,91,90,1,1,"RECORTES CE",0
37,"37301",73,62,62,0,0,"RECORTES CE",0
37,"37238",112,88,85,2,3,"RECORTES CE",0
37,"37124",219,149,148,0,1,"RECORTES CE",0
37,"37337",139,120,120,2,0,"RECORTES CE",0
37,"37098",335,237,237,1,0,"RECORTES CE",0
37,"37050",67,47,46,1,1,"RECORTES CE",0
37,"37135",1211,932,925,10,7,"RECORTES CE",0
37,"37193",399,279,278,6,1,"RECORTES CE",0
37,"37156",4310,3173,3126,27,47,"RECORTES CE",4
37,"37272",136,97,96,0,1,"RECORTES CE",0
37,"37211",223,163,163,4,0,"RECORTES CE",0
37,"37137",105,73,73,0,0,"RECORTES CE",0
37,"37142",592,453,451,2,2,"RECORTES CE",0
37,"37359",184,131,129,0,2,"RECORTES CE",0
37,"37316",751,584,577,5,7,"RECORTES CE",0
37,"37131",190,140,139,0,1,"RECORTES CE",0
37,"37336",55,47,47,0,0,"RECORTES CE",0
37,"37120",99,77,76,1,1,"RECORTES CE",0
37,"37258",180,117,115,1,2,"RECORTES CE",0
37,"37178",99,84,81,0,3,"RECORTES CE",0
37,"37062",84,67,66,1,1,"RECORTES CE",0
37,"37371",281,183,177,1,6,"RECORTES CE",0
37,"37280",79,50,50,0,0,"RECORTES CE",0
37,"37221",434,328,323,2,5,"RECORTES CE",0
37,"37025",258,223,221,2,2,"RECORTES CE",0
37,"37133",108,82,79,4,3,"RECORTES CE",0
37,"37057",213,168,167,0,1,"RECORTES CE",0
37,"37314",87,74,72,0,2,"RECORTES CE",0
37,"37011",122,91,89,0,2,"RECORTES CE",0
37,"37068",366,272,271,5,1,"RECORTES CE",0
37,"37058",61,43,42,0,1,"RECORTES CE",0
37,"37118",125,96,96,0,0,"RECORTES CE",0
37,"37331",217,150,148,1,2,"RECORTES CE",0
37,"37028",150,111,110,1,1,"RECORTES CE",0
37,"37175",407,316,314,5,2,"RECORTES CE",0
37,"37294",11680,8850,8760,84,90,"RECORTES CE",18
37,"37313",555,415,411,1,4,"RECORTES CE",0
37,"37281",37,34,33,0,1,"RECORTES CE",0
37,"37209",406,281,280,7,1,"RECORTES CE",1
37,"37047",167,83,83,0,0,"RECORTES CE",0
37,"37010",956,716,708,3,8,"RECORTES CE",2
37,"37291",268,206,206,1,0,"RECORTES CE",0
37,"37194",252,191,190,2,1,"RECORTES CE",0
37,"37352",204,148,147,0,1,"RECORTES CE",0
37,"37214",125,88,88,1,0,"RECORTES CE",0
37,"37154",141,116,112,0,4,"RECORTES CE",0
35,"35015",9870,5451,5368,29,83,"SAIn",1
35,"35003",5125,2989,2929,21,60,"SAIn",4
35,"35027",10311,7497,7364,58,133,"SAIn",4
35,"35031",7270,5184,5000,36,184,"SAIn",2
35,"35008",6109,4631,4542,37,89,"SAIn",0
35,"35011",23882,16369,16095,107,274,"SAIn",6
35,"35005",1071,718,711,6,7,"SAIn",0
35,"35006",30302,21967,21625,243,342,"SAIn",14
35,"35024",13621,8665,8555,76,110,"SAIn",0
35,"35033",6378,4412,4354,24,58,"SAIn",0
35,"35022",48059,30474,30134,219,340,"SAIn",101
35,"35019",32253,19902,19621,126,281,"SAIn",8
35,"35030",9205,5602,5501,58,101,"SAIn",2
35,"35017",25447,15415,15079,127,336,"SAIn",8
35,"35013",6609,4997,4881,51,116,"SAIn",2
35,"35016",297974,198159,195935,1546,2224,"SAIn",93
35,"35004",38814,20869,20641,192,228,"SAIn",13
35,"35020",6054,4073,4018,26,55,"SAIn",0
35,"35028",9705,5552,5478,64,74,"SAIn",1
35,"35032",3432,2541,2498,19,43,"SAIn",0
35,"35023",11680,8467,8295,75,172,"SAIn",5
35,"35012",10331,5684,5610,32,74,"SAIn",4
35,"35007",515,332,330,2,2,"SAIn",0
35,"35001",4599,3455,3396,27,59,"SAIn",2
35,"35002",23129,15904,15675,74,229,"SAIn",4
35,"35025",1801,1239,1216,9,23,"SAIn",0
35,"35021",14942,10691,10537,80,154,"SAIn",1
35,"35009",19832,14305,14036,97,269,"SAIn",5
35,"35014",11169,6234,6107,59,127,"SAIn",1
35,"35029",4125,2545,2514,34,31,"SAIn",1
35,"35010",3548,2371,2336,20,35,"SAIn",0
35,"35018",12463,7628,7546,56,82,"SAIn",0
35,"35034",7707,3921,3872,30,49,"SAIn",0
35,"35026",80806,53749,52665,450,1084,"SAIn",17
29,"29080",6704,4812,4766,44,46,"SOLUCIONA",2
29,"29089",3254,2465,2438,10,27,"SOLUCIONA",1
29,"29090",1704,1174,1165,10,9,"SOLUCIONA",0
29,"29039",2662,1948,1931,22,17,"SOLUCIONA",2
29,"29014",219,138,138,1,0,"SOLUCIONA",0
29,"29067",424770,295944,294094,2117,1850,"SOLUCIONA",214
29,"29042",14078,9890,9776,75,114,"SOLUCIONA",8
29,"29083",2114,1587,1568,10,19,"SOLUCIONA",0
29,"29015",31884,23160,22943,188,217,"SOLUCIONA",11
29,"29002",1203,855,842,6,13,"SOLUCIONA",0
29,"29068",6885,4580,4511,43,69,"SOLUCIONA",1
29,"29901",43601,30325,30130,188,195,"SOLUCIONA",14
29,"29071",938,640,633,6,7,"SOLUCIONA",0
29,"29018",2026,1560,1519,15,41,"SOLUCIONA",1
29,"29020",3265,2531,2504,17,27,"SOLUCIONA",3
29,"29092",567,423,415,4,8,"SOLUCIONA",0
29,"29037",212,166,165,1,1,"SOLUCIONA",0
29,"29034",466,361,359,0,2,"SOLUCIONA",0
29,"29050",425,313,309,1,4,"SOLUCIONA",0
29,"29051",40201,27168,26842,229,326,"SOLUCIONA",13
29,"29006",680,482,474,3,8,"SOLUCIONA",1
29,"29024",393,271,256,4,15,"SOLUCIONA",0
29,"29073",1560,1126,1120,5,6,"SOLUCIONA",0
29,"29010",1667,1336,1310,1,26,"SOLUCIONA",0
29,"29902",2560,1735,1709,13,26,"SOLUCIONA",0
29,"29009",1477,1113,1100,3,13,"SOLUCIONA",0
29,"29065",194,134,134,1,0,"SOLUCIONA",0
29,"29038",17555,11638,11562,124,76,"SOLUCIONA",7
29,"29069",85333,56398,55854,443,544,"SOLUCIONA",29
29,"29094",57313,39393,39052,280,341,"SOLUCIONA",7
29,"29096",2806,2065,2034,19,31,"SOLUCIONA",1
29,"29016",253,188,188,1,0,"SOLUCIONA",0
29,"29052",226,155,152,0,3,"SOLUCIONA",0
29,"29049",2987,2204,2185,25,19,"SOLUCIONA",1
29,"29040",1964,1321,1301,12,20,"SOLUCIONA",2
29,"29053",1702,1178,1160,17,18,"SOLUCIONA",0
29,"29099",960,741,734,3,7,"SOLUCIONA",0
29,"29029",420,322,315,4,7,"SOLUCIONA",0
29,"29095",3350,2523,2467,17,56,"SOLUCIONA",1
29,"29043",2503,1671,1638,17,33,"SOLUCIONA",1
29,"29098",1257,991,977,12,14,"SOLUCIONA",0
29,"29022",185,143,143,1,0,"SOLUCIONA",0
29,"29021",162,114,107,13,7,"SOLUCIONA",0
29,"29028",1249,881,881,4,0,"SOLUCIONA",0
29,"29012",9765,7029,6944,58,85,"SOLUCIONA",3
29,"29086",795,497,490,3,7,"SOLUCIONA",0
29,"29046",2690,1974,1954,17,20,"SOLUCIONA",3
29,"29033",1132,808,804,2,4,"SOLUCIONA",0
29,"29091",8966,6437,6346,57,91,"SOLUCIONA",1
29,"29057",376,285,284,2,1,"SOLUCIONA",0
29,"29048",1428,1168,1155,9,13,"SOLUCIONA",0
29,"29025",39210,26938,26747,160,191,"SOLUCIONA",4
29,"29056",1107,815,807,8,8,"SOLUCIONA",0
29,"29008",14541,9954,9820,90,134,"SOLUCIONA",6
29,"29045",1685,1232,1223,4,9,"SOLUCIONA",0
29,"29044",811,557,556,3,1,"SOLUCIONA",0
29,"29074",785,612,611,4,1,"SOLUCIONA",1
29,"29027",2343,1737,1722,6,15,"SOLUCIONA",0
29,"29075",12952,8681,8619,55,62,"SOLUCIONA",1
29,"29023",2047,1385,1369,2,16,"SOLUCIONA",0
29,"29904",428,363,360,2,3,"SOLUCIONA",0
29,"29017",6610,5001,4938,25,63,"SOLUCIONA",3
29,"29085",151,99,98,1,1,"SOLUCIONA",0
29,"29066",346,252,251,2,1,"SOLUCIONA",0
29,"29062",658,564,561,0,3,"SOLUCIONA",0
29,"29013",1612,1282,1272,6,10,"SOLUCIONA",2
29,"29026",1065,776,766,4,10,"SOLUCIONA",1
29,"29084",27393,19096,18886,192,210,"SOLUCIONA",5
29,"29001",4196,3276,3253,26,23,"SOLUCIONA",0
29,"29031",1633,1115,1106,6,9,"SOLUCIONA",0
29,"29058",1463,986,975,6,11,"SOLUCIONA",1
29,"29064",506,372,365,2,7,"SOLUCIONA",0
29,"29077",208,156,153,0,3,"SOLUCIONA",0
29,"29076",2163,1508,1482,8,26,"SOLUCIONA",4
29,"29060",706,524,516,0,8,"SOLUCIONA",0
29,"29063",336,255,251,2,4,"SOLUCIONA",0
29,"29041",3146,2251,2216,26,35,"SOLUCIONA",2
29,"29036",636,481,475,3,6,"SOLUCIONA",0
29,"29061",1018,833,820,4,13,"SOLUCIONA",0
29,"29072",3250,2466,2434,11,32,"SOLUCIONA",0
29,"29087",380,283,276,1,7,"SOLUCIONA",0
29,"29055",1808,1415,1396,13,19,"SOLUCIONA",0
29,"29047",1131,927,914,4,13,"SOLUCIONA",1
29,"29093",2235,1689,1667,12,22,"SOLUCIONA",1
29,"29054",41888,29228,29022,205,206,"SOLUCIONA",16
29,"29100",2437,1775,1760,12,15,"SOLUCIONA",0
29,"29059",2590,2100,2058,11,42,"SOLUCIONA",0
29,"29032",6708,5341,5265,26,76,"SOLUCIONA",0
29,"29082",31505,23154,22990,127,164,"SOLUCIONA",5
29,"29003",1002,777,769,1,8,"SOLUCIONA",0
29,"29019",888,675,672,0,3,"SOLUCIONA",0
29,"29007",27319,19557,19395,179,162,"SOLUCIONA",5
29,"29088",2720,1930,1883,21,47,"SOLUCIONA",0
29,"29903",525,394,389,2,5,"SOLUCIONA",0
29,"29079",2444,1880,1846,3,34,"SOLUCIONA",0
29,"29005",4342,2946,2908,22,38,"SOLUCIONA",1
29,"29004",328,240,238,2,2,"SOLUCIONA",0
29,"29035",1587,1218,1208,0,10,"SOLUCIONA",0
29,"29081",258,205,200,1,5,"SOLUCIONA",0
29,"29070",39913,26993,26751,203,242,"SOLUCIONA",19
29,"29097",4117,2996,2947,43,49,"SOLUCIONA",1
29,"29011",2920,1962,1946,5,16,"SOLUCIONA",0
29,"29030",809,653,651,2,2,"SOLUCIONA",0
25,"25092",132,93,89,1,4,"VOX",0
25,"25135",1032,707,701,7,6,"VOX",0
25,"25171",2190,1461,1444,4,17,"VOX",1
25,"25240",1407,1006,995,10,11,"VOX",1
25,"25059",801,590,584,11,6,"VOX",0
25,"25061",82,53,53,0,0,"VOX",0
25,"25136",98,71,70,0,1,"VOX",0
25,"25062",757,521,516,4,5,"VOX",0
25,"25243",3612,2449,2423,30,26,"VOX",3
25,"25056",243,151,150,2,1,"VOX",0
25,"25132",130,97,95,1,2,"VOX",0
25,"25067",730,483,479,4,4,"VOX",0
25,"25023",4527,3111,3073,20,38,"VOX",20
25,"25238",217,151,151,6,0,"VOX",0
25,"25123",193,131,130,0,1,"VOX",0
25,"25245",441,313,313,0,0,"VOX",1
25,"25189",2106,1392,1381,16,11,"VOX",0
25,"25096",912,586,572,9,14,"VOX",1
25,"25164",381,264,262,2,2,"VOX",3
25,"25200",336,218,218,0,0,"VOX",1
25,"25101",565,393,388,9,5,"VOX",0
25,"25070",817,584,573,14,11,"VOX",0
25,"25093",639,451,445,11,6,"VOX",0
25,"25079",305,216,214,5,2,"VOX",0
25,"25202",101,72,72,0,0,"VOX",0
25,"25076",146,84,84,1,0,"VOX",0
25,"25139",479,325,324,3,1,"VOX",0
25,"25098",253,163,160,2,3,"VOX",0
25,"25008",1135,828,819,11,9,"VOX",0
25,"25163",228,143,142,5,1,"VOX",1
25,"25127",212,135,134,3,1,"VOX",0
25,"25105",130,95,93,4,2,"VOX",0
25,"25055",172,118,116,2,2,"VOX",0
25,"25134",635,418,414,4,4,"VOX",0
25,"25022",106,76,76,2,0,"VOX",0
25,"25192",767,510,496,11,14,"VOX",0
25,"25201",115,70,67,0,3,"VOX",0
25,"25131",412,271,261,8,10,"VOX",1
25,"25250",344,236,234,0,2,"VOX",0
25,"25036",184,126,121,0,5,"VOX",0
25,"25103",131,80,80,3,0,"VOX",0
25,"25060",70,45,45,2,0,"VOX",0
25,"25100",212,134,134,3,0,"VOX",0
25,"25081",318,213,210,2,3,"VOX",0
25,"25227",641,398,395,3,3,"VOX",0
25,"25173",1702,1180,1171,5,9,"VOX",7
25,"25053",1059,762,759,10,3,"VOX",2
25,"25207",6216,4062,4031,45,31,"VOX",6
25,"25234",4290,2645,2621,25,24,"VOX",0
25,"25071",51,31,31,0,0,"VOX",0
25,"25034",2331,1516,1505,20,11,"VOX",0
25,"25128",142,89,89,0,0,"VOX",1
25,"25143",87,58,57,1,1,"VOX",0
25,"25038",1564,1075,1062,11,13,"VOX",0
25,"25097",87,62,62,4,0,"VOX",0
25,"25183",501,332,331,4,1,"VOX",2
25,"25133",713,469,464,1,5,"VOX",0
25,"25130",197,117,117,3,0,"VOX",0
25,"25058",4378,2810,2793,27,17,"VOX",2
25,"25225",575,395,393,6,2,"VOX",0
25,"25215",334,244,243,2,1,"VOX",0
25,"25110",2796,1828,1807,30,21,"VOX",0
25,"25169",188,125,124,3,1,"VOX",0
25,"25203",8976,5588,5526,53,62,"VOX",3
25,"25104",125,86,86,3,0,"VOX",2
25,"25219",144,106,105,3,1,"VOX",0
25,"25085",152,106,106,0,0,"VOX",0
25,"25137",8577,5630,5591,45,39,"VOX",7
25,"25252",548,399,398,6,1,"VOX",0
25,"25255",426,308,302,4,6,"VOX",0
25,"25064",112,85,85,3,0,"VOX",0
25,"25073",588,374,371,8,3,"VOX",0
25,"25094",139,111,109,0,2,"VOX",0
25,"25191",332,225,222,3,3,"VOX",0
25,"25165",280,194,190,4,4,"VOX",0
25,"25099",1260,804,793,8,11,"VOX",1
25,"25021",2618,1655,1639,32,16,"VOX",2
25,"25249",183,118,118,2,0,"VOX",0
25,"25003",3782,2390,2372,24,18,"VOX",0
25,"25181",177,138,137,5,1,"VOX",0
25,"25030",131,86,86,2,0,"VOX",0
25,"25025",1346,966,956,10,10,"VOX",1
25,"25186",214,141,138,2,3,"VOX",0
25,"25007",1410,1005,996,13,9,"VOX",1
25,"25220",1028,709,701,9,8,"VOX",1
25,"25112",272,189,189,2,0,"VOX",0
25,"25242",732,480,477,4,3,"VOX",0
25,"25204",1241,843,827,3,16,"VOX",0
25,"25113",1163,854,845,12,9,"VOX",0
25,"25902",570,390,379,3,11,"VOX",3
25,"25048",1644,1151,1138,8,13,"VOX",3
25,"25179",161,115,114,0,1,"VOX",0
25,"25209",1517,1035,1019,6,16,"VOX",2
25,"25041",569,380,374,7,6,"VOX",2
25,"25221",130,76,76,0,0,"VOX",0
25,"25224",126,86,86,1,0,"VOX",0
25,"25247",123,72,72,0,0,"VOX",0
25,"25114",97,87,87,0,0,"VOX",1
25,"25208",316,191,189,1,2,"VOX",0
25,"25027",1001,687,681,3,6,"VOX",0
25,"25218",84,66,66,0,0,"VOX",0
25,"25035",397,287,286,3,1,"VOX",3
25,"25251",710,495,494,3,1,"VOX",0
25,"25180",239,151,151,0,0,"VOX",0
25,"25166",177,123,121,1,2,"VOX",0
25,"25244",369,252,248,3,4,"VOX",0
25,"25140",774,468,465,4,3,"VOX",0
25,"25233",278,193,191,2,2,"VOX",0
25,"25145",85,64,64,2,0,"VOX",0
25,"25089",106,58,58,0,0,"VOX",0
25,"25024",356,233,230,1,3,"VOX",0
25,"25222",67,52,52,1,0,"VOX",0
25,"25042",208,143,142,0,1,"VOX",0
25,"25109",238,168,168,1,0,"VOX",0
25,"25039",280,182,180,0,2,"VOX",0
25,"25033",1106,777,767,7,10,"VOX",0
25,"25009",631,465,460,3,5,"VOX",0
25,"25146",224,150,148,2,2,"VOX",0
25,"25170",264,182,179,1,3,"VOX",0
25,"25904",155,118,118,0,0,"VOX",0
25,"25211",683,427,422,4,5,"VOX",0
25,"25142",368,252,251,3,1,"VOX",0
25,"25037",385,245,241,2,4,"VOX",0
25,"25223",922,614,598,8,16,"VOX",0
25,"25118",350,223,223,8,0,"VOX",0
25,"25174",398,299,296,3,3,"VOX",0
25,"25044",189,136,136,3,0,"VOX",0
25,"25167",236,158,156,3,2,"VOX",0
25,"25212",234,173,171,1,2,"VOX",0
25,"25011",5256,3190,3161,36,29,"VOX",1
25,"25077",460,272,269,2,3,"VOX",0
25,"25151",670,466,459,3,7,"VOX",0
25,"25078",1007,720,717,6,3,"VOX",1
25,"25119",2259,1582,1569,22,13,"VOX",1
25,"25905",386,260,255,4,5,"VOX",0
25,"25205",562,413,402,2,11,"VOX",0
25,"25129",176,113,110,6,3,"VOX",0
25,"25045",52,36,36,0,0,"VOX",0
25,"25175",194,132,132,7,0,"VOX",0
25,"25068",558,372,369,9,3,"VOX",0
25,"25031",52,31,31,0,0,"VOX",0
25,"25012",2296,1504,1488,8,16,"VOX",0
25,"25172",1805,1230,1214,8,16,"VOX",0
25,"25906",226,144,143,0,1,"VOX",0
25,"25069",453,289,286,6,3,"VOX",0
25,"25210",1104,779,767,9,12,"VOX",0
25,"25120",92243,61433,61005,533,428,"VOX",340
25,"25190",263,195,195,4,0,"VOX",0
25,"25185",681,421,418,8,3,"VOX",0
25,"25153",198,141,137,0,4,"VOX",0
25,"25006",346,214,212,6,2,"VOX",0
25,"25002",484,323,321,2,2,"VOX",0
25,"25121",642,415,413,8,2,"VOX",0
25,"25115",824,551,549,12,2,"VOX",0
25,"25020",292,203,200,2,3,"VOX",0
25,"25141",156,101,99,1,2,"VOX",0
25,"25907",498,317,314,3,3,"VOX",0
25,"25138",576,415,408,6,7,"VOX",0
25,"25150",185,127,124,1,3,"VOX",0
25,"25226",251,156,153,3,3,"VOX",0
25,"25046",421,292,286,1,6,"VOX",0
25,"25043",794,505,501,3,4,"VOX",1
25,"25216",226,150,150,0,0,"VOX",0
25,"25013",2171,1380,1366,10,14,"VOX",1
25,"25253",163,125,124,0,1,"VOX",0
25,"25908",228,138,137,3,1,"VOX",0
25,"25154",120,68,68,1,0,"VOX",0
25,"25010",212,131,130,6,1,"VOX",1
25,"25004",571,425,423,5,2,"VOX",1
25,"25047",1010,730,722,6,8,"VOX",0
25,"25168",508,392,391,2,1,"VOX",0
25,"25217",10594,7016,6950,119,66,"VOX",9
25,"25014",254,177,174,4,3,"VOX",0
25,"25122",1916,1274,1264,15,10,"VOX",1
25,"25155",667,463,459,5,4,"VOX",0
25,"25254",738,507,493,6,14,"VOX",0
25,"25082",280,169,167,3,2,"VOX",0
25,"25909",155,89,89,3,0,"VOX",0
25,"25005",277,183,182,2,1,"VOX",0
25,"25239",608,320,319,1,1,"VOX",0
25,"25001",139,88,87,1,1,"VOX",0
25,"25193",765,520,514,3,6,"VOX",1
25,"25152",140,100,98,4,2,"VOX",0
25,"25015",355,258,257,3,1,"VOX",1
25,"25910",101,64,62,0,2,"VOX",0
25,"25176",312,239,235,7,4,"VOX",0
25,"25228",3043,2140,2118,21,22,"VOX",4
25,"25072",5858,3878,3835,45,43,"VOX",2
25,"25206",257,164,164,3,0,"VOX",0
25,"25049",151,104,104,1,0,"VOX",0
25,"25230",1573,1100,1081,13,19,"VOX",0
25,"25194",426,278,273,0,5,"VOX",0
25,"25156",791,574,571,7,3,"VOX",0
25,"25124",169,118,116,2,2,"VOX",0
25,"25057",206,152,151,2,1,"VOX",0
25,"25086",533,373,372,5,1,"VOX",0
25,"25901",292,186,181,4,5,"VOX",0
25,"25029",1662,1156,1147,13,9,"VOX",0
25,"25911",452,301,299,7,2,"VOX",0
25,"25050",3253,2064,2048,27,16,"VOX",0
25,"25016",2114,1417,1411,8,6,"VOX",0
25,"25040",10532,6837,6762,81,75,"VOX",5
25,"25196",119,74,74,0,0,"VOX",0
25,"25125",424,279,273,4,6,"VOX",0
25,"25157",181,139,137,1,2,"VOX",0
25,"25017",239,160,159,2,1,"VOX",0
25,"25087",61,46,45,0,1,"VOX",0
25,"25177",372,258,258,2,0,"VOX",0
25,"25182",1043,738,727,13,11,"VOX",0
25,"25231",490,382,382,2,0,"VOX",1
25,"25158",1639,1163,1150,26,13,"VOX",0
25,"25232",1421,961,950,10,11,"VOX",0
25,"25074",182,145,141,0,4,"VOX",0
25,"25051",1522,990,983,10,7,"VOX",1
25,"25912",868,618,617,5,1,"VOX",0
25,"25019",4565,3001,2965,36,36,"VOX",1
25,"25088",96,76,75,0,1,"VOX",0
25,"25148",220,155,153,0,2,"VOX",0
25,"25126",286,214,210,5,4,"VOX",0
25,"25111",115,83,83,1,0,"VOX",0
25,"25063",91,55,55,0,0,"VOX",0
25,"25903",237,154,152,3,2,"VOX",0
25,"25075",117,82,82,0,0,"VOX",0
25,"25149",1382,1010,993,7,17,"VOX",1
25,"25197",137,97,97,2,0,"VOX",0
25,"25052",1573,1132,1122,16,10,"VOX",4
25,"25102",712,473,467,10,6,"VOX",1
25,"25248",891,622,616,3,6,"VOX",0
25,"25032",61,44,43,0,1,"VOX",0
25,"25913",87,69,69,1,0,"VOX",0
25,"25161",368,234,232,3,2,"VOX",0
32,"32028",1643,1195,1174,18,21,"X ESQ",0
32,"32057",575,414,412,5,2,"X ESQ",2
32,"32078",1243,876,869,6,7,"X ESQ",0
32,"32056",1610,1159,1146,9,13,"X ESQ",0
32,"32034",1141,880,873,4,7,"X ESQ",2
32,"32067",1300,838,824,15,14,"X ESQ",3
32,"32033",750,504,500,4,4,"X ESQ",2
32,"32058",5209,3808,3750,27,58,"X ESQ",16
32,"32082",1259,905,887,6,18,"X ESQ",2
32,"32037",742,544,532,8,12,"X ESQ",2
32,"32083",860,580,574,4,6,"X ESQ",3
32,"32021",956,664,662,2,2,"X ESQ",1
32,"32044",900,658,647,5,11,"X ESQ",2
32,"32020",2625,1997,1974,10,23,"X ESQ",5
32,"32059",1849,1357,1339,16,18,"X ESQ",5
32,"32008",8188,5923,5845,44,78,"X ESQ",37
32,"32026",2736,2039,1998,25,41,"X ESQ",8
32,"32066",567,435,434,2,1,"X ESQ",0
32,"32070",566,335,330,3,5,"X ESQ",1
32,"32071",1496,1013,1004,1,9,"X ESQ",0
32,"32025",1094,821,809,3,12,"X ESQ",5
32,"32075",4188,3257,3206,43,51,"X ESQ",12
32,"32039",1275,989,976,5,13,"X ESQ",3
32,"32045",2484,1820,1795,19,25,"X ESQ",3
32,"32013",2213,1447,1431,8,16,"X ESQ",4
32,"32049",775,502,495,5,7,"X ESQ",0
32,"32086",2671,1731,1712,10,19,"X ESQ",6
32,"32029",480,349,346,5,3,"X ESQ",0
32,"32069",4333,3324,3261,25,63,"X ESQ",13
32,"32081",2097,1566,1553,6,13,"X ESQ",7
32,"32060",845,609,598,6,11,"X ESQ",2
32,"32010",394,299,298,0,1,"X ESQ",0
32,"32050",2455,1874,1855,17,19,"X ESQ",0
32,"32063",1939,1329,1314,16,15,"X ESQ",9
32,"32077",1188,813,796,8,17,"X ESQ",3
32,"32064",526,397,395,1,2,"X ESQ",1
32,"32087",1798,1421,1397,7,24,"X ESQ",0
32,"32051",1458,1141,1137,4,4,"X ESQ",0
32,"32047",1818,1345,1329,3,16,"X ESQ",5
32,"32035",1484,944,938,7,6,"X ESQ",4
32,"32011",934,559,548,5,11,"X ESQ",1
32,"32032",8101,5993,5881,74,112,"X ESQ",16
32,"32036",1369,1053,1040,5,13,"X ESQ",8
32,"32085",10709,7489,7403,81,86,"X ESQ",26
32,"32015",899,586,581,5,5,"X ESQ",4
32,"32076",2121,1509,1489,12,20,"X ESQ",2
32,"32038",456,299,297,2,2,"X ESQ",7
32,"32046",1179,840,832,5,8,"X ESQ",2
32,"32073",1332,976,965,4,11,"X ESQ",3
32,"32072",3833,2799,2761,26,38,"X ESQ",12
32,"32088",1632,1062,1042,8,20,"X ESQ",3
32,"32084",925,657,650,3,7,"X ESQ",0
32,"32012",811,535,533,3,2,"X ESQ",3
32,"32040",1472,1112,1089,9,23,"X ESQ",2
32,"32023",1217,884,877,6,7,"X ESQ",0
32,"32022",1377,963,951,7,12,"X ESQ",0
32,"32062",832,646,644,7,2,"X ESQ",3
32,"32089",1332,917,904,5,13,"X ESQ",3
32,"32061",1093,852,840,3,12,"X ESQ",5
32,"32065",669,494,482,3,12,"X ESQ",3
32,"32004",1826,900,897,8,3,"X ESQ",1
32,"32043",2555,1824,1793,15,31,"X ESQ",4
32,"32090",791,558,556,2,2,"X ESQ",0
32,"32009",10783,7555,7468,60,87,"X ESQ",47
32,"32017",1272,862,849,5,13,"X ESQ",1
32,"32041",772,511,505,5,6,"X ESQ",0
32,"32054",87290,63653,62823,671,830,"X ESQ",448
32,"32016",825,559,556,3,3,"X ESQ",1
32,"32048",906,573,564,6,9,"X ESQ",2
32,"32053",1447,1140,1128,12,12,"X ESQ",1
32,"32001",4978,3644,3607,31,37,"X ESQ",13
32,"32014",1170,855,845,7,10,"X ESQ",6
32,"32006",1571,1140,1127,10,13,"X ESQ",3
32,"32091",1909,1389,1375,8,14,"X ESQ",1
32,"32005",869,676,671,7,5,"X ESQ",2
32,"32030",1015,702,689,3,13,"X ESQ",0
32,"32018",1261,956,945,3,11,"X ESQ",1
32,"32079",1343,1000,987,9,13,"X ESQ",3
32,"32002",2016,1474,1460,11,14,"X ESQ",4
32,"32027",1072,765,747,3,18,"X ESQ",2
32,"32031",1079,826,812,5,14,"X ESQ",0
32,"32055",1310,952,936,7,16,"X ESQ",1
32,"32074",1064,731,719,4,12,"X ESQ",2
32,"32003",886,661,653,6,8,"X ESQ",3
32,"32092",528,337,334,4,3,"X ESQ",1
32,"32019",11529,8038,7906,78,132,"X ESQ",26
32,"32007",1527,1078,1070,7,8,"X ESQ",4
32,"32042",1585,1120,1104,13,16,"X ESQ",2
32,"32024",4839,3424,3368,35,56,"X ESQ",7
32,"32068",1424,974,969,8,5,"X ESQ",2
32,"32080",333,266,265,0,1,"X ESQ",1
32,"32052",1904,1450,1426,6,24,"X ESQ",4
48,"48081",1883,1412,1398,12,14,"PUM+J",0
48,"48032",5735,4173,4151,32,22,"PUM+J",1
48,"48075",1975,1440,1421,12,19,"PUM+J",1
48,"48056",978,733,732,7,1,"PUM+J",0
48,"48049",548,433,431,0,2,"PUM+J",0
48,"48059",402,317,314,1,3,"PUM+J",0
48,"48006",289,246,245,3,1,"PUM+J",0
48,"48060",3645,2277,2274,7,3,"PUM+J",1
48,"48911",382,291,286,2,5,"PUM+J",0
48,"48005",117,76,76,0,0,"PUM+J",0
48,"48052",1559,1215,1211,0,4,"PUM+J",1
48,"48037",678,518,509,2,9,"PUM+J",0
48,"48083",6950,5128,5097,33,31,"PUM+J",3
48,"48914",330,275,275,1,0,"PUM+J",0
48,"48018",875,553,553,3,0,"PUM+J",0
48,"48001",5832,4191,4166,37,25,"PUM+J",4
48,"48012",2041,1571,1553,11,18,"PUM+J",1
48,"48092",837,619,619,13,0,"PUM+J",0
48,"48011",9692,6891,6843,56,48,"PUM+J",8
48,"48095",2352,1658,1647,6,11,"PUM+J",1
48,"48068",1551,1178,1163,16,15,"PUM+J",1
48,"48906",775,579,574,0,5,"PUM+J",0
48,"48028",715,553,551,4,2,"PUM+J",1
48,"48046",12617,9037,8967,56,70,"PUM+J",1
48,"48043",4403,3214,3186,28,28,"PUM+J",3
48,"48084",22577,15689,15540,108,149,"PUM+J",4
48,"48910",2948,2126,2115,17,11,"PUM+J",2
48,"48070",545,378,374,2,4,"PUM+J",0
48,"48076",314,237,237,4,0,"PUM+J",0
48,"48057",5749,4093,4081,20,12,"PUM+J",0
48,"48002",7851,5767,5713,41,54,"PUM+J",5
48,"48061",762,584,581,4,3,"PUM+J",2
48,"48038",1122,834,824,0,10,"PUM+J",1
48,"48031",340,245,242,0,3,"PUM+J",0
48,"48020",274076,193807,192607,1471,1200,"PUM+J",172
48,"48014",1218,870,866,8,4,"PUM+J",0
48,"48013",79984,56928,56516,383,412,"PUM+J",54
48,"48045",5149,3940,3885,35,55,"PUM+J",2
48,"48009",786,614,609,3,5,"PUM+J",0
48,"48087",429,346,343,1,3,"PUM+J",0
48,"48033",215,160,159,0,1,"PUM+J",0
48,"48004",334,229,227,1,2,"PUM+J",0
48,"48066",346,256,256,1,0,"PUM+J",0
48,"48055",2662,1961,1938,16,23,"PUM+J",2
48,"48041",704,558,555,4,3,"PUM+J",0
48,"48908",245,200,199,1,1,"PUM+J",0
48,"48022",2355,1476,1468,9,8,"PUM+J",0
48,"48017",13290,8908,8856,42,52,"PUM+J",3
48,"48044",62989,46989,46783,385,206,"PUM+J",34
48,"48016",5260,3856,3827,22,29,"PUM+J",2
48,"48035",412,313,312,4,1,"PUM+J",0
48,"48094",3193,2210,2200,18,10,"PUM+J",1
48,"48902",19124,13344,13227,93,117,"PUM+J",5
48,"48053",900,676,670,8,6,"PUM+J",0
48,"48029",8332,6155,6119,35,36,"PUM+J",3
48,"48048",562,399,394,3,5,"PUM+J",0
48,"48907",355,283,282,2,1,"PUM+J",0
48,"48904",3504,2671,2650,18,21,"PUM+J",3
48,"48080",9971,7148,7086,71,62,"PUM+J",4
48,"48905",2565,1882,1847,2,35,"PUM+J",4
48,"48063",373,289,288,1,1,"PUM+J",2
48,"48036",24144,17085,16954,117,131,"PUM+J",9
48,"48010",457,311,307,1,4,"PUM+J",1
48,"48086",2073,1519,1504,15,15,"PUM+J",1
48,"48096",6608,5071,5011,43,60,"PUM+J",8
48,"48074",3333,2467,2428,20,39,"PUM+J",0
48,"48030",608,454,453,4,1,"PUM+J",0
48,"48008",617,433,424,6,9,"PUM+J",0
48,"48040",1299,896,884,5,12,"PUM+J",0
48,"48901",4775,3602,3573,35,29,"PUM+J",3
48,"48025",883,642,639,3,3,"PUM+J",0
48,"48064",603,463,459,7,4,"PUM+J",0
48,"48073",6952,4476,4435,43,41,"PUM+J",2
48,"48007",365,241,239,0,2,"PUM+J",0
48,"48034",12902,9684,9613,79,71,"PUM+J",13
48,"48047",161,112,112,0,0,"PUM+J",0
48,"48054",24135,17493,17374,124,119,"PUM+J",24
48,"48051",220,169,168,0,1,"PUM+J",0
48,"48085",10301,7458,7407,50,51,"PUM+J",5
48,"48082",37673,27006,26811,201,195,"PUM+J",14
48,"48089",3266,2425,2406,23,19,"PUM+J",1
48,"48912",2308,1787,1746,27,41,"PUM+J",0
48,"48042",1384,1111,1091,7,20,"PUM+J",0
48,"48069",12765,8985,8910,58,75,"PUM+J",6
48,"48039",243,201,201,2,0,"PUM+J",1
48,"48027",22033,15929,15825,113,104,"PUM+J",8
48,"48067",1161,837,834,2,3,"PUM+J",0
48,"48078",38742,28064,27837,231,227,"PUM+J",18
48,"48023",594,470,468,4,2,"PUM+J",0
48,"48071",6118,4467,4412,32,55,"PUM+J",3
48,"48915",362,238,238,2,0,"PUM+J",0
48,"48065",3315,2447,2433,19,14,"PUM+J",1
48,"48072",974,728,723,5,5,"PUM+J",0
48,"48088",135,97,96,0,1,"PUM+J",0
48,"48090",6022,4544,4483,23,61,"PUM+J",1
48,"48079",425,322,321,4,1,"PUM+J",0
48,"48019",3594,2569,2544,16,25,"PUM+J",1
48,"48909",207,165,165,1,0,"PUM+J",0
48,"48077",3367,2438,2423,17,15,"PUM+J",1
48,"48091",1134,821,812,7,9,"PUM+J",0
48,"48913",1251,933,917,13,16,"PUM+J",1
48,"48021",1352,952,946,8,6,"PUM+J",0
48,"48026",1134,861,853,7,8,"PUM+J",0
48,"48097",1303,907,898,10,9,"PUM+J",0
48,"48050",198,153,150,0,3,"PUM+J",0
48,"48015",33690,24299,24160,168,139,"PUM+J",14
48,"48062",300,241,240,1,1,"PUM+J",1
48,"48903",1838,1400,1385,4,15,"PUM+J",0
48,"48024",1003,775,771,5,4,"PUM+J",1
48,"48058",972,691,687,4,4,"PUM+J",0
48,"48003",14338,10497,10414,76,83,"PUM+J",3
48,"48093",900,673,664,4,9,"PUM+J",2
46,"46046",896,697,686,1,11,"EN POSITIU",0
46,"46055",1273,1031,1021,4,10,"EN POSITIU",0
46,"46083",15467,11584,11443,79,141,"EN POSITIU",99
46,"46228",2363,1854,1839,16,15,"EN POSITIU",1
46,"46172",5040,3629,3599,14,30,"EN POSITIU",6
46,"46167",373,286,285,1,1,"EN POSITIU",0
46,"46086",82,73,73,1,0,"EN POSITIU",0
46,"46221",339,305,303,0,2,"EN POSITIU",0
46,"46173",1336,1097,1080,9,17,"EN POSITIU",0
46,"46129",521,435,434,2,1,"EN POSITIU",1
46,"46047",525,443,435,2,8,"EN POSITIU",0
46,"46217",886,724,712,3,12,"EN POSITIU",0
46,"46112",552,466,464,1,2,"EN POSITIU",0
46,"46018",635,531,522,3,9,"EN POSITIU",0
46,"46040",1098,914,907,4,7,"EN POSITIU",1
46,"46226",48,44,44,0,0,"EN POSITIU",0
46,"46174",984,808,794,3,14,"EN POSITIU",0
46,"46051",8347,6500,6442,27,58,"EN POSITIU",1
46,"46223",7814,6169,6129,33,40,"EN POSITIU",14
46,"46246",1066,856,838,7,18,"EN POSITIU",0
46,"46181",17066,12779,12636,96,143,"EN POSITIU",6
46,"46131",49604,37767,37431,266,336,"EN POSITIU",43
46,"46048",3448,2817,2790,8,27,"EN POSITIU",0
46,"46059",1272,1066,1058,4,8,"EN POSITIU",1
46,"46053",560,454,451,2,3,"EN POSITIU",0
46,"46012",888,723,703,3,20,"EN POSITIU",0
46,"46060",9361,7285,7229,30,56,"EN POSITIU",36
46,"46096",279,229,225,2,4,"EN POSITIU",0
46,"46107",1915,1566,1553,2,13,"EN POSITIU",0
46,"46064",527,429,423,0,6,"EN POSITIU",3
46,"46061",337,281,281,3,0,"EN POSITIU",0
46,"46153",441,358,354,0,4,"EN POSITIU",1
46,"46042",3389,2886,2844,19,42,"EN POSITIU",4
46,"46160",1912,1523,1514,3,9,"EN POSITIU",4
46,"46085",11147,8107,8033,57,74,"EN POSITIU",5
46,"46037",1119,952,941,2,11,"EN POSITIU",1
46,"46084",1576,1314,1298,6,16,"EN POSITIU",0
46,"46016",1068,885,874,3,11,"EN POSITIU",0
46,"46023",328,294,287,2,7,"EN POSITIU",0
46,"46238",13324,10023,9939,50,84,"EN POSITIU",7
46,"46152",97,76,74,0,2,"EN POSITIU",0
46,"46158",1024,817,804,5,13,"EN POSITIU",0
46,"46039",2147,1746,1727,9,19,"EN POSITIU",1
46,"46058",1779,1430,1409,10,21,"EN POSITIU",0
46,"46088",176,140,138,0,2,"EN POSITIU",0
46,"46134",2357,1811,1797,8,14,"EN POSITIU",0
46,"46004",1924,1582,1559,11,23,"EN POSITIU",2
46,"46041",331,254,253,6,1,"EN POSITIU",0
46,"46044",4237,3347,3285,25,62,"EN POSITIU",2
46,"46097",959,734,728,6,6,"EN POSITIU",0
46,"46132",2148,1850,1830,12,20,"EN POSITIU",1
46,"46222",383,322,321,2,1,"EN POSITIU",0
46,"46225",346,299,290,0,9,"EN POSITIU",0
46,"46101",858,731,723,4,8,"EN POSITIU",1
46,"46177",4698,3715,3665,16,50,"EN POSITIU",2
46,"46251",2490,2082,2045,11,37,"EN POSITIU",4
46,"46241",400,324,314,1,10,"EN POSITIU",0
46,"46066",1255,1028,1020,6,8,"EN POSITIU",0
46,"46252",126,95,93,0,2,"EN POSITIU",0
46,"46009",3144,2579,2552,13,27,"EN POSITIU",0
46,"46052",502,432,431,2,1,"EN POSITIU",0
46,"46133",563,458,455,2,3,"EN POSITIU",0
46,"46006",4529,3803,3748,18,55,"EN POSITIU",1
46,"46237",7227,5620,5571,33,49,"EN POSITIU",9
46,"46231",2411,1759,1735,11,24,"EN POSITIU",1
46,"46188",668,548,538,3,10,"EN POSITIU",0
46,"46142",797,619,608,2,11,"EN POSITIU",0
46,"46200",1909,1628,1609,5,19,"EN POSITIU",1
46,"46127",2706,2212,2175,10,37,"EN POSITIU",0
46,"46151",722,589,583,1,6,"EN POSITIU",0
46,"46196",153,131,130,0,1,"EN POSITIU",1
46,"46253",109,93,93,0,0,"EN POSITIU",0
46,"46110",21260,16194,16084,76,110,"EN POSITIU",13
46,"46062",4652,3650,3583,32,67,"EN POSITIU",1
46,"46090",1640,1440,1424,4,16,"EN POSITIU",0
46,"46014",3042,2456,2434,17,22,"EN POSITIU",0
46,"46036",583,384,381,8,3,"EN POSITIU",1
46,"46021",23646,18220,18100,85,120,"EN POSITIU",16
46,"46227",915,771,765,5,6,"EN POSITIU",3
46,"46065",1588,1246,1227,5,19,"EN POSITIU",1
46,"46087",127,99,99,1,0,"EN POSITIU",0
46,"46182",1274,970,966,2,4,"EN POSITIU",0
46,"46091",115,101,100,1,1,"EN POSITIU",0
46,"46045",1261,1066,1041,3,25,"EN POSITIU",0
46,"46159",22905,17498,17373,102,125,"EN POSITIU",7
46,"46197",1956,1556,1543,8,13,"EN POSITIU",2
46,"46057",495,339,337,6,2,"EN POSITIU",0
46,"46156",2087,1712,1702,9,10,"EN POSITIU",2
46,"46114",575,488,484,3,4,"EN POSITIU",0
46,"46236",975,810,806,4,4,"EN POSITIU",0
46,"46198",846,702,693,1,9,"EN POSITIU",0
46,"46106",1543,1177,1167,5,10,"EN POSITIU",0
46,"46205",14323,11325,11224,55,101,"EN POSITIU",20
46,"46069",161,126,122,0,4,"EN POSITIU",0
46,"46255",3145,2494,2470,19,24,"EN POSITIU",8
46,"46183",6009,4624,4563,18,61,"EN POSITIU",5
46,"46175",459,403,396,1,7,"EN POSITIU",1
46,"46138",345,292,292,0,0,"EN POSITIU",0
46,"46082",4947,3843,3814,25,29,"EN POSITIU",1
46,"46233",3904,2974,2934,15,40,"EN POSITIU",3
46,"46113",2436,1864,1849,11,15,"EN POSITIU",1
46,"46135",9655,7845,7810,32,35,"EN POSITIU",3
46,"46017",33050,24762,24580,144,182,"EN POSITIU",23
46,"46155",1035,865,846,2,19,"EN POSITIU",1
46,"46092",273,183,183,0,0,"EN POSITIU",0
46,"46130",907,722,713,6,9,"EN POSITIU",2
46,"46001",802,623,615,4,8,"EN POSITIU",0
46,"46244",58586,43371,43098,257,273,"EN POSITIU",19
46,"46115",403,296,289,1,7,"EN POSITIU",0
46,"46024",424,348,340,0,8,"EN POSITIU",0
46,"46229",972,785,774,2,11,"EN POSITIU",0
46,"46219",125,106,105,2,1,"EN POSITIU",0
46,"46089",2141,1649,1625,14,24,"EN POSITIU",0
46,"46116",13153,10566,10518,62,48,"EN POSITIU",2
46,"46033",197,169,168,1,1,"EN POSITIU",0
46,"46178",4643,3465,3434,16,31,"EN POSITIU",3
46,"46063",1757,1399,1384,11,15,"EN POSITIU",0
46,"46184",26467,20888,20675,138,213,"EN POSITIU",17
46,"46139",4495,3629,3577,26,52,"EN POSITIU",1
46,"46002",1175,947,935,5,12,"EN POSITIU",0
46,"46245",516,427,420,3,7,"EN POSITIU",0
46,"46154",811,644,640,4,4,"EN POSITIU",0
46,"46150",1839,1377,1362,10,15,"EN POSITIU",1
46,"46026",1204,1044,1034,4,10,"EN POSITIU",0
46,"46199",5742,4458,4425,34,33,"EN POSITIU",6
46,"46194",15552,11606,11505,69,101,"EN POSITIU",17
46,"46248",4873,3679,3639,18,40,"EN POSITIU",2
46,"46162",1207,962,947,3,15,"EN POSITIU",1
46,"46117",493,414,411,4,3,"EN POSITIU",0
46,"46071",466,383,379,2,4,"EN POSITIU",0
46,"46250",578668,455375,452638,2701,2737,"EN POSITIU",293
46,"46185",386,325,321,4,4,"EN POSITIU",0
46,"46094",20515,15885,15785,125,100,"EN POSITIU",64
46,"46095",608,498,493,2,5,"EN POSITIU",0
46,"46068",354,305,297,1,8,"EN POSITIU",0
46,"46104",1956,1567,1543,6,24,"EN POSITIU",0
46,"46100",289,240,237,1,3,"EN POSITIU",0
46,"46149",362,288,287,2,1,"EN POSITIU",0
46,"46195",1967,1612,1602,9,10,"EN POSITIU",0
46,"46249",9362,7163,7072,42,91,"EN POSITIU",1
46,"46140",349,288,284,2,4,"EN POSITIU",0
46,"46049",280,242,238,1,4,"EN POSITIU",0
46,"46163",1847,1508,1489,8,19,"EN POSITIU",2
46,"46201",67,49,49,0,0,"EN POSITIU",0
46,"46072",3625,2993,2931,37,62,"EN POSITIU",0
46,"46019",8833,7183,7109,47,74,"EN POSITIU",2
46,"46003",963,841,815,1,26,"EN POSITIU",0
46,"46208",1114,931,922,3,9,"EN POSITIU",1
46,"46028",395,346,339,2,7,"EN POSITIU",2
46,"46157",2978,2370,2343,19,27,"EN POSITIU",1
46,"46118",3795,2987,2962,18,25,"EN POSITIU",1
46,"46015",7231,5768,5711,33,57,"EN POSITIU",4
46,"46073",1097,903,892,6,11,"EN POSITIU",2
46,"46259",503,410,406,2,4,"EN POSITIU",0
46,"46187",1310,1036,1028,6,8,"EN POSITIU",0
46,"46179",2182,1823,1788,13,35,"EN POSITIU",0
46,"46050",200,160,160,0,0,"EN POSITIU",0
46,"46164",11777,8893,8798,54,95,"EN POSITIU",1
46,"46202",16767,13171,13058,59,113,"EN POSITIU",8
46,"46025",2502,2008,1993,6,15,"EN POSITIU",4
46,"46247",1024,743,733,2,10,"EN POSITIU",0
46,"46102",19843,15783,15676,102,107,"EN POSITIU",15
46,"46220",48393,35859,35571,250,288,"EN POSITIU",14
46,"46243",141,122,120,0,2,"EN POSITIU",0
46,"46031",10520,7830,7759,70,71,"EN POSITIU",3
46,"46210",338,295,283,2,12,"EN POSITIU",0
46,"46203",3598,2962,2928,17,34,"EN POSITIU",2
46,"46074",2690,2158,2145,18,13,"EN POSITIU",0
46,"46260",2572,2100,2081,10,19,"EN POSITIU",1
46,"46180",682,581,572,1,9,"EN POSITIU",1
46,"46105",16249,11731,11629,59,102,"EN POSITIU",12
46,"46143",4215,3219,3171,27,48,"EN POSITIU",4
46,"46230",13944,10746,10646,69,100,"EN POSITIU",7
46,"46165",7115,5626,5576,31,50,"EN POSITIU",6
46,"46218",1074,930,912,1,18,"EN POSITIU",2
46,"46075",149,132,130,2,2,"EN POSITIU",0
46,"46261",1720,1386,1369,10,17,"EN POSITIU",0
46,"46211",1723,1441,1434,13,7,"EN POSITIU",1
46,"46128",1601,1316,1281,5,35,"EN POSITIU",0
46,"46242",340,291,285,1,6,"EN POSITIU",0
46,"46067",1736,1457,1382,2,75,"EN POSITIU",2
46,"46120",1109,919,902,4,17,"EN POSITIU",1
46,"46029",20649,15241,15110,113,131,"EN POSITIU",24
46,"46234",354,289,287,2,2,"EN POSITIU",0
46,"46224",170,130,130,0,0,"EN POSITIU",0
46,"46166",8155,6521,6450,41,71,"EN POSITIU",1
46,"46204",6781,5421,5379,15,42,"EN POSITIU",3
46,"46232",894,715,712,5,3,"EN POSITIU",0
46,"46108",480,375,375,2,0,"EN POSITIU",2
46,"46022",15481,11422,11347,69,75,"EN POSITIU",14
46,"46136",2534,2008,1990,13,18,"EN POSITIU",3
46,"46189",471,412,405,2,7,"EN POSITIU",1
46,"46144",665,525,520,2,5,"EN POSITIU",0
46,"46007",11953,9099,9038,65,61,"EN POSITIU",13
46,"46212",1612,1234,1214,5,20,"EN POSITIU",0
46,"46121",105,92,91,2,1,"EN POSITIU",0
46,"46030",804,660,635,7,25,"EN POSITIU",2
46,"46235",21793,16577,16424,118,153,"EN POSITIU",10
46,"46098",2491,1978,1950,14,28,"EN POSITIU",1
46,"46119",783,672,666,7,6,"EN POSITIU",0
46,"46043",145,131,131,0,0,"EN POSITIU",0
46,"46124",788,680,672,0,8,"EN POSITIU",0
46,"46038",345,255,255,0,0,"EN POSITIU",0
46,"46122",2701,2120,2109,18,11,"EN POSITIU",3
46,"46076",587,489,483,2,6,"EN POSITIU",1
46,"46262",232,172,168,0,4,"EN POSITIU",0
46,"46190",48824,36748,36542,238,206,"EN POSITIU",38
46,"46099",922,693,685,0,8,"EN POSITIU",0
46,"46137",268,225,220,3,5,"EN POSITIU",0
46,"46008",2673,2201,2189,8,12,"EN POSITIU",0
46,"46213",15476,11377,11246,110,131,"EN POSITIU",9
46,"46254",1012,786,775,1,11,"EN POSITIU",1
46,"46161",1481,1206,1194,6,12,"EN POSITIU",1
46,"46123",1838,1466,1447,4,19,"EN POSITIU",0
46,"46032",5635,4529,4493,16,36,"EN POSITIU",3
46,"46145",21946,16629,16495,80,134,"EN POSITIU",7
46,"46054",11251,8795,8731,46,64,"EN POSITIU",8
46,"46168",1938,1542,1530,11,12,"EN POSITIU",0
46,"46206",577,475,468,4,7,"EN POSITIU",0
46,"46077",7569,6100,6010,41,90,"EN POSITIU",3
46,"46263",255,204,202,1,2,"EN POSITIU",0
46,"46191",1970,1557,1533,6,24,"EN POSITIU",3
46,"46214",15730,12427,12334,56,93,"EN POSITIU",3
46,"46111",10876,8133,8050,35,83,"EN POSITIU",6
46,"46240",209,169,164,1,5,"EN POSITIU",0
46,"46027",948,795,781,3,14,"EN POSITIU",0
46,"46093",2117,1721,1710,10,11,"EN POSITIU",3
46,"46070",16903,13091,12999,64,92,"EN POSITIU",12
46,"46256",6833,5087,5062,37,25,"EN POSITIU",3
46,"46146",1670,1333,1318,11,15,"EN POSITIU",1
46,"46010",914,725,716,4,9,"EN POSITIU",0
46,"46215",1433,1152,1149,4,3,"EN POSITIU",1
46,"46169",32396,25109,24953,169,156,"EN POSITIU",12
46,"46207",6656,5355,5293,42,62,"EN POSITIU",5
46,"46078",28126,20975,20850,127,125,"EN POSITIU",21
46,"46902",379,314,313,3,1,"EN POSITIU",0
46,"46192",767,573,568,1,5,"EN POSITIU",0
46,"46081",10180,8055,7984,32,71,"EN POSITIU",8
46,"46013",17366,13952,13862,95,90,"EN POSITIU",14
46,"46005",22908,17565,17438,126,127,"EN POSITIU",10
46,"46109",6195,4764,4682,23,82,"EN POSITIU",1
46,"46079",326,267,265,2,2,"EN POSITIU",0
46,"46903",5985,4822,4796,24,26,"EN POSITIU",1
46,"46193",8795,7101,7061,40,40,"EN POSITIU",5
46,"46257",5579,4440,4391,26,49,"EN POSITIU",5
46,"46147",16843,12206,12099,56,107,"EN POSITIU",9
46,"46056",184,160,158,1,2,"EN POSITIU",0
46,"46170",3451,2821,2775,16,46,"EN POSITIU",1
46,"46171",16587,12731,12627,79,104,"EN POSITIU",16
46,"46209",1955,1531,1508,7,23,"EN POSITIU",8
46,"46148",1528,1206,1192,15,14,"EN POSITIU",0
46,"46080",1025,795,784,4,11,"EN POSITIU",1
46,"46904",802,662,654,7,8,"EN POSITIU",8
46,"46011",7627,5496,5407,39,89,"EN POSITIU",3
46,"46216",5039,4207,4188,20,19,"EN POSITIU",1
46,"46125",857,709,701,5,8,"EN POSITIU",0
46,"46034",1776,1441,1430,4,11,"EN POSITIU",1
46,"46239",451,353,351,3,2,"EN POSITIU",1
46,"46258",2676,2099,2078,9,21,"EN POSITIU",4
46,"46186",19033,15061,14950,70,111,"EN POSITIU",20
46,"46176",2025,1431,1416,10,15,"EN POSITIU",34
46,"46020",3784,3064,3012,15,52,"EN POSITIU",1
46,"46141",438,359,348,4,11,"EN POSITIU",0
46,"46103",1270,1015,998,8,17,"EN POSITIU",0
46,"46035",6786,5382,5338,27,44,"EN POSITIU",5
46,"46126",5555,4619,4574,26,45,"EN POSITIU",1
15,"15029",5761,3994,3928,47,66,"VOX",5
15,"15078",78093,58164,57487,673,677,"VOX",121
15,"15028",1415,1085,1070,10,15,"VOX",0
15,"15037",4087,2775,2733,18,42,"VOX",2
15,"15035",11517,8305,8192,144,113,"VOX",9
15,"15018",1156,817,806,7,11,"VOX",3
15,"15067",8073,6067,6000,45,67,"VOX",9
15,"15006",5353,3534,3469,49,65,"VOX",9
15,"15004",4855,3594,3535,28,59,"VOX",13
15,"15077",8303,5648,5544,57,104,"VOX",2
15,"15066",4039,2950,2894,34,56,"VOX",3
15,"15015",2840,2126,2100,21,26,"VOX",3
15,"15089",4317,3238,3188,24,50,"VOX",3
15,"15043",5147,3834,3764,36,70,"VOX",4
15,"15070",9117,6514,6390,98,124,"VOX",7
15,"15036",58409,40932,40506,484,426,"VOX",74
15,"15045",3803,2382,2354,15,28,"VOX",1
15,"15060",5780,4245,4167,48,78,"VOX",7
15,"15074",4061,2983,2947,24,36,"VOX",1
15,"15005",24459,16742,16482,215,260,"VOX",34
15,"15014",4034,2809,2757,34,52,"VOX",4
15,"15046",6345,4625,4532,53,93,"VOX",6
15,"15016",4806,3291,3222,21,69,"VOX",1
15,"15034",2897,1931,1909,14,22,"VOX",1
15,"15023",6481,4658,4595,44,63,"VOX",8
15,"15031",23321,17319,17152,218,167,"VOX",16
15,"15041",9627,7409,7291,79,118,"VOX",10
15,"15010",1913,1355,1338,21,17,"VOX",0
15,"15042",3060,2170,2127,21,43,"VOX",1
15,"15061",5646,3945,3894,35,51,"VOX",2
15,"15072",9626,7024,6920,52,104,"VOX",7
15,"15017",19380,14272,14098,156,174,"VOX",47
15,"15901",3595,2401,2374,30,27,"VOX",3
15,"15064",2207,1680,1650,22,30,"VOX",3
15,"15012",3666,2787,2721,40,66,"VOX",7
15,"15081",1042,819,814,12,5,"VOX",0
15,"15021",5099,3673,3611,43,62,"VOX",3
15,"15084",3312,2361,2326,28,35,"VOX",2
15,"15008",5650,4239,4175,42,64,"VOX",7
15,"15039",1271,935,917,8,18,"VOX",2
15,"15025",1069,662,654,5,8,"VOX",0
15,"15062",5936,4047,3993,31,54,"VOX",1
15,"15024",4412,3325,3278,35,47,"VOX",6
15,"15055",4618,3208,3159,49,49,"VOX",4
15,"15068",5096,3518,3476,39,42,"VOX",3
15,"15011",15463,11105,10890,92,215,"VOX",19
15,"15027",1540,1224,1203,6,21,"VOX",2
15,"15059",10406,7710,7553,91,157,"VOX",10
15,"15047",2463,1669,1633,21,36,"VOX",4
15,"15054",32177,22065,21778,349,287,"VOX",22
15,"15009",10780,8075,7957,70,118,"VOX",15
15,"15040",2763,2050,2017,10,33,"VOX",2
15,"15007",3352,2469,2453,24,16,"VOX",2
15,"15048",4855,3582,3534,41,48,"VOX",8
15,"15091",1119,807,784,12,23,"VOX",0
15,"15090",1182,868,861,13,7,"VOX",1
15,"15044",1309,955,941,5,14,"VOX",2
15,"15080",1760,1215,1197,11,18,"VOX",1
15,"15075",12279,9076,8952,117,124,"VOX",10
15,"15003",1818,1326,1302,18,24,"VOX",0
15,"15079",1562,1092,1075,16,17,"VOX",1
15,"15051",4651,3343,3297,38,46,"VOX",1
15,"15073",21884,14792,14587,149,205,"VOX",18
15,"15020",3844,2651,2629,17,22,"VOX",0
15,"15093",4265,2856,2814,35,42,"VOX",3
15,"15902",4660,3352,3296,30,56,"VOX",4
15,"15088",3550,2398,2372,18,26,"VOX",0
15,"15002",22929,16941,16742,205,199,"VOX",30
15,"15087",5804,3942,3901,49,41,"VOX",7
15,"15032",3455,2438,2391,26,47,"VOX",14
15,"15001",4805,3466,3419,45,47,"VOX",11
15,"15030",200245,148692,147426,1699,1266,"VOX",455
15,"15056",5757,4167,4108,43,59,"VOX",4
15,"15049",1099,765,755,12,10,"VOX",0
15,"15052",4351,3122,3063,26,59,"VOX",2
15,"15022",5817,4026,3981,29,45,"VOX",1
15,"15069",6785,5107,5032,54,75,"VOX",8
15,"15019",25902,18111,17866,232,245,"VOX",19
15,"15053",7783,5386,5314,47,72,"VOX",8
15,"15082",15162,11273,11134,135,139,"VOX",13
15,"15083",1100,809,795,5,14,"VOX",0
15,"15057",12169,8853,8729,88,124,"VOX",7
15,"15071",7965,5559,5483,37,76,"VOX",7
15,"15092",6523,4518,4449,54,69,"VOX",6
15,"15058",27623,21002,20788,257,214,"VOX",52
15,"15065",7345,5517,5412,46,105,"VOX",3
15,"15086",2918,2109,2077,19,32,"VOX",2
15,"15033",2489,1953,1931,13,22,"VOX",1
15,"15038",2236,1556,1530,18,26,"VOX",0
15,"15076",2649,1827,1802,24,25,"VOX",1
15,"15050",1843,1089,1070,19,19,"VOX",3
15,"15013",6126,4315,4257,43,58,"VOX",6
15,"15085",3346,2365,2311,26,54,"VOX",0
28,"28019",1237,952,938,2,14,"PCPE",0
28,"28088",262,180,179,2,1,"PCPE",0
28,"28090",8405,6792,6751,34,41,"PCPE",2
28,"28143",70,59,59,1,0,"PCPE",0
28,"28111",592,489,483,0,6,"PCPE",0
28,"28128",439,323,320,2,3,"PCPE",1
28,"28018",3739,3071,3046,12,25,"PCPE",4
28,"28169",1427,1164,1158,1,6,"PCPE",1
28,"28017",1210,954,943,6,11,"PCPE",1
28,"28124",76,56,54,0,2,"PCPE",0
28,"28085",3908,3106,3078,7,28,"PCPE",0
28,"28038",4935,3858,3815,17,43,"PCPE",1
28,"28084",15839,12028,11925,53,103,"PCPE",7
28,"28136",640,540,532,0,8,"PCPE",0
28,"28023",4697,3835,3817,20,18,"PCPE",0
28,"28067",4057,3220,3188,12,32,"PCPE",0
28,"28131",12971,9828,9755,57,73,"PCPE",1
28,"28016",80,57,57,0,0,"PCPE",0
28,"28031",2055,1538,1519,4,19,"PCPE",0
28,"28117",95,84,84,0,0,"PCPE",0
28,"28052",3883,2801,2758,18,43,"PCPE",1
28,"28158",662,545,543,3,2,"PCPE",0
28,"28076",406,322,319,1,3,"PCPE",1
28,"28179",1441,1082,1071,7,11,"PCPE",0
28,"28145",2370,1824,1809,12,15,"PCPE",0
28,"28082",5664,4526,4492,25,34,"PCPE",2
28,"28041",4452,3572,3550,24,22,"PCPE",1
28,"28036",2514,1974,1949,12,25,"PCPE",2
28,"28174",1788,1277,1267,2,10,"PCPE",0
28,"28040",15691,10833,10728,45,105,"PCPE",9
28,"28096",18161,13784,13647,57,137,"PCPE",10
28,"28069",54,43,43,1,0,"PCPE",0
28,"28113",34305,27077,26881,156,196,"PCPE",11
28,"28171",4238,3002,2962,18,40,"PCPE",1
28,"28125",2965,2210,2188,13,22,"PCPE",1
28,"28162",2549,2039,2025,13,14,"PCPE",1
28,"28140",2981,2383,2357,14,26,"PCPE",0
28,"28046",4432,3562,3538,19,24,"PCPE",0
28,"28141",5806,4532,4486,24,46,"PCPE",5
28,"28028",1730,1347,1326,8,21,"PCPE",2
28,"28080",48226,39753,39570,172,183,"PCPE",5
28,"28149",5653,4516,4469,19,47,"PCPE",3
28,"28008",1768,1293,1282,4,11,"PCPE",2
28,"28010",9853,7959,7914,35,45,"PCPE",3
28,"28099",1731,1283,1278,8,5,"PCPE",1
28,"28021",544,387,387,2,0,"PCPE",0
28,"28129",7913,6175,6124,30,51,"PCPE",4
28,"28118",58,49,48,1,1,"PCPE",0
28,"28035",1362,1042,1033,3,9,"PCPE",1
28,"28022",32949,27473,27379,169,94,"PCPE",3
28,"28100",4169,3076,3048,12,28,"PCPE",1
28,"28902",468,352,347,2,5,"PCPE",0
28,"28146",1773,1274,1262,9,12,"PCPE",0
28,"28065",125384,101604,100872,477,732,"PCPE",64
28,"28157",595,448,442,1,6,"PCPE",0
28,"28127",64513,53125,52932,300,193,"PCPE",12
28,"28024",152,129,128,1,1,"PCPE",0
28,"28116",700,544,544,3,0,"PCPE",0
28,"28073",12505,9485,9384,64,101,"PCPE",9
28,"28152",16026,13269,13202,46,67,"PCPE",1
28,"28032",4749,3653,3607,19,46,"PCPE",2
28,"28121",198,166,164,2,2,"PCPE",0
28,"28123",56464,47181,46948,257,233,"PCPE",27
28,"28106",76612,56555,56006,346,549,"PCPE",40
28,"28903",32480,27640,27525,161,115,"PCPE",9
28,"28126",39,25,25,0,0,"PCPE",0
28,"28159",588,469,468,6,1,"PCPE",1
28,"28108",3330,2536,2528,17,8,"PCPE",1
28,"28048",499,406,401,2,5,"PCPE",0
28,"28093",2043,1681,1661,9,20,"PCPE",4
28,"28168",1226,910,900,1,10,"PCPE",0
28,"28025",427,329,326,1,3,"PCPE",0
28,"28034",352,270,269,1,1,"PCPE",0
28,"28004",6179,4377,4345,15,32,"PCPE",2
28,"28059",4312,3256,3237,11,19,"PCPE",0
28,"28072",5657,4465,4441,20,24,"PCPE",3
28,"28177",10192,8271,8234,51,37,"PCPE",3
28,"28001",64,48,48,3,0,"PCPE",0
28,"28144",5929,4776,4744,29,32,"PCPE",0
28,"28043",5922,4063,4008,29,55,"PCPE",3
28,"28178",1066,850,846,2,4,"PCPE",0
28,"28070",119,91,91,0,0,"PCPE",0
28,"28160",8227,6295,6251,26,44,"PCPE",1
28,"28094",825,636,634,3,2,"PCPE",0
28,"28007",124358,99423,98711,554,712,"PCPE",37
28,"28115",60579,50819,50657,246,162,"PCPE",12
28,"28130",28243,22649,22458,135,191,"PCPE",14
28,"28147",968,751,745,2,6,"PCPE",0
28,"28053",6458,5299,5263,29,36,"PCPE",3
28,"28107",435,326,321,0,5,"PCPE",0
28,"28180",5242,4040,3999,11,41,"PCPE",1
28,"28020",148,99,97,1,2,"PCPE",0
28,"28133",6002,4259,4204,12,55,"PCPE",0
28,"28097",124,85,84,1,1,"PCPE",0
28,"28104",13836,11414,11349,54,65,"PCPE",3
28,"28095",1508,1177,1167,6,10,"PCPE",2
28,"28101",218,180,180,0,0,"PCPE",0
28,"28047",40783,31308,31072,171,236,"PCPE",13
28,"28061",21200,16698,16600,75,98,"PCPE",7
28,"28148",85022,65597,65111,368,486,"PCPE",33
28,"28029",530,426,424,3,2,"PCPE",0
28,"28014",32852,24749,24571,120,178,"PCPE",26
28,"28167",8308,6605,6545,35,60,"PCPE",3
28,"28150",3084,2415,2381,13,34,"PCPE",1
28,"28083",8880,6801,6759,47,42,"PCPE",5
28,"28011",445,339,338,0,1,"PCPE",0
28,"28044",5766,4623,4584,22,39,"PCPE",4
28,"28064",134,105,105,0,0,"PCPE",0
28,"28109",1591,1113,1111,3,2,"PCPE",0
28,"28037",1566,1175,1168,5,7,"PCPE",1
28,"28078",36,34,34,0,0,"PCPE",0
28,"28132",11645,8605,8520,55,85,"PCPE",6
28,"28009",14046,11014,10932,51,82,"PCPE",7
28,"28055",899,682,676,4,6,"PCPE",0
28,"28176",12288,9809,9763,50,46,"PCPE",5
28,"28062",308,244,241,3,3,"PCPE",0
28,"28172",8965,7255,7219,44,36,"PCPE",1
28,"28089",3703,2961,2933,19,28,"PCPE",0
28,"28122",518,388,385,2,3,"PCPE",0
28,"28183",1050,770,763,2,7,"PCPE",0
28,"28114",149,103,103,1,0,"PCPE",0
28,"28049",58688,48006,47660,286,346,"PCPE",34
28,"28006",78564,61796,61456,334,340,"PCPE",39
28,"28050",4077,3032,3006,15,26,"PCPE",1
28,"28156",998,751,743,3,8,"PCPE",4
28,"28154",5420,3966,3899,17,67,"PCPE",1
28,"28060",1509,1194,1183,8,11,"PCPE",0
28,"28026",6237,4893,4853,32,40,"PCPE",1
28,"28045",33019,25531,25313,146,218,"PCPE",7
28,"28013",40409,30141,29905,164,236,"PCPE",17
28,"28071",60,47,46,0,1,"PCPE",0
28,"28015",18233,14725,14653,81,72,"PCPE",4
28,"28137",1644,1301,1283,7,18,"PCPE",0
28,"28163",438,357,354,1,3,"PCPE",0
28,"28027",1199,897,882,5,15,"PCPE",0
28,"28042",1153,882,874,5,8,"PCPE",2
28,"28039",130,97,97,0,0,"PCPE",0
28,"28112",167,132,132,0,0,"PCPE",0
28,"28056",860,653,647,6,6,"PCPE",0
28,"28091",5436,3827,3786,23,41,"PCPE",3
28,"28119",2074,1641,1625,9,16,"PCPE",1
28,"28074",138742,110456,109579,581,877,"PCPE",71
28,"28164",2986,2281,2263,12,18,"PCPE",3
28,"28057",1439,1125,1120,5,5,"PCPE",1
28,"28003",181,141,141,3,0,"PCPE",0
28,"28173",520,409,408,3,1,"PCPE",0
28,"28092",151511,117869,116968,641,901,"PCPE",61
28,"28165",1788,1332,1321,5,11,"PCPE",0
28,"28102",881,659,650,3,9,"PCPE",0
28,"28175",850,696,692,2,4,"PCPE",0
28,"28002",2966,2186,2175,9,11,"PCPE",1
28,"28012",883,702,691,4,11,"PCPE",0
28,"28033",3824,2854,2832,11,22,"PCPE",0
28,"28086",5055,3627,3600,21,27,"PCPE",1
28,"28135",971,740,735,4,5,"PCPE",1
28,"28155",507,420,420,0,0,"PCPE",0
28,"28151",3143,2352,2314,6,38,"PCPE",2
28,"28153",703,510,507,2,3,"PCPE",0
28,"28901",789,590,584,2,6,"PCPE",0
28,"28134",60511,47566,47229,233,337,"PCPE",28
28,"28087",3176,2545,2528,15,17,"PCPE",1
28,"28075",5581,4380,4350,15,30,"PCPE",1
28,"28058",139289,108214,107323,612,891,"PCPE",63
28,"28054",11166,8649,8584,36,65,"PCPE",2
28,"28066",7175,5598,5561,28,37,"PCPE",0
28,"28166",318,258,255,1,3,"PCPE",0
28,"28170",2486,1757,1740,9,17,"PCPE",1
28,"28005",134211,104575,103819,667,756,"PCPE",46
28,"28120",1217,918,904,4,14,"PCPE",1
28,"28161",48368,37462,37161,190,301,"PCPE",35
28,"28079",2371327,1817203,1806970,9067,10233,"PCPE",829
28,"28063",252,195,194,2,1,"PCPE",0
28,"28182",214,174,170,0,4,"PCPE",0
28,"28030",1716,1342,1316,2,26,"PCPE",0
28,"28068",10928,8389,8315,43,74,"PCPE",8
28,"28181",20344,16669,16572,95,97,"PCPE",3
28,"28051",1542,1240,1232,5,8,"PCPE",1
28,"28110",1949,1543,1525,2,18,"PCPE",0
28,"28138",69,54,54,0,0,"PCPE",0
43,"43120",444,293,288,0,5,"EN COMÚ",85
43,"43166",1568,1117,1111,4,6,"EN COMÚ",215
43,"43124",484,347,343,6,4,"EN COMÚ",34
43,"43149",699,483,472,7,11,"EN COMÚ",45
43,"43038",21385,14375,14276,117,99,"EN COMÚ",2938
43,"43058",93,68,67,1,1,"EN COMÚ",6
43,"43025",604,431,428,5,3,"EN COMÚ",52
43,"43172",351,243,242,8,1,"EN COMÚ",39
43,"43052",954,662,653,9,9,"EN COMÚ",113
43,"43015",112,91,91,1,0,"EN COMÚ",19
43,"43129",4618,3148,3107,24,41,"EN COMÚ",417
43,"43102",485,337,332,2,5,"EN COMÚ",59
43,"43044",3975,2793,2758,34,35,"EN COMÚ",636
43,"43175",566,390,387,3,3,"EN COMÚ",29
43,"43011",1083,824,819,5,5,"EN COMÚ",95
43,"43901",8765,5306,5212,81,94,"EN COMÚ",1118
43,"43089",281,211,211,1,0,"EN COMÚ",67
43,"43098",343,249,249,4,0,"EN COMÚ",35
43,"43055",1975,1471,1459,16,12,"EN COMÚ",155
43,"43004",6326,4274,4227,38,47,"EN COMÚ",800
43,"43034",480,366,358,4,8,"EN COMÚ",44
43,"43094",2175,1506,1480,11,26,"EN COMÚ",234
43,"43084",526,404,399,5,5,"EN COMÚ",50
43,"43060",2887,2019,1990,16,29,"EN COMÚ",328
43,"43018",410,320,316,1,4,"EN COMÚ",32
43,"43127",765,554,548,2,6,"EN COMÚ",80
43,"43169",457,364,356,3,8,"EN COMÚ",45
43,"43029",323,237,237,4,0,"EN COMÚ",32
43,"43079",364,258,257,1,1,"EN COMÚ",50
43,"43002",1821,1294,1266,12,28,"EN COMÚ",307
43,"43135",342,252,251,3,1,"EN COMÚ",21
43,"43032",523,371,365,7,6,"EN COMÚ",44
43,"43072",105,77,77,1,0,"EN COMÚ",3
43,"43171",14593,10107,10049,46,58,"EN COMÚ",2421
43,"43023",231,173,171,3,2,"EN COMÚ",27
43,"43093",3909,2625,2597,44,28,"EN COMÚ",429
43,"43095",2493,1723,1703,13,20,"EN COMÚ",303
43,"43176",799,565,562,5,3,"EN COMÚ",62
43,"43125",942,692,685,4,7,"EN COMÚ",149
43,"43123",70276,47897,47547,302,350,"EN COMÚ",8729
43,"43109",2560,1717,1700,13,17,"EN COMÚ",411
43,"43008",309,185,181,5,4,"EN COMÚ",29
43,"43070",236,194,193,0,1,"EN COMÚ",27
43,"43150",1300,940,913,5,27,"EN COMÚ",120
43,"43132",365,269,264,1,5,"EN COMÚ",35
43,"43080",244,184,184,2,0,"EN COMÚ",15
43,"43137",1881,1344,1332,9,12,"EN COMÚ",285
43,"43021",360,248,247,6,1,"EN COMÚ",38
43,"43134",283,226,224,2,2,"EN COMÚ",58
43,"43064",2017,1384,1367,16,17,"EN COMÚ",155
43,"43119",793,559,556,7,3,"EN COMÚ",120
43,"43099",305,234,233,1,1,"EN COMÚ",20
43,"43154",132,101,100,1,1,"EN COMÚ",16
43,"43068",528,346,338,2,8,"EN COMÚ",32
43,"43065",395,266,265,4,1,"EN COMÚ",24
43,"43063",560,363,360,8,3,"EN COMÚ",69
43,"43050",2521,1654,1640,11,14,"EN COMÚ",428
43,"43904",2908,1799,1760,38,39,"EN COMÚ",346
43,"43118",413,313,308,1,5,"EN COMÚ",41
43,"43033",778,576,569,5,7,"EN COMÚ",118
43,"43005",3615,2376,2354,17,22,"EN COMÚ",445
43,"43140",2366,1731,1717,7,14,"EN COMÚ",413
43,"43045",152,121,121,0,0,"EN COMÚ",12
43,"43174",138,99,99,1,0,"EN COMÚ",8
43,"43090",1070,625,620,4,5,"EN COMÚ",149
43,"43136",10353,6670,6622,50,48,"EN COMÚ",1539
43,"43022",1508,1028,1015,20,13,"EN COMÚ",136
43,"43128",908,623,616,4,7,"EN COMÚ",109
43,"43039",102,73,73,0,0,"EN COMÚ",3
43,"43138",2677,1821,1786,22,35,"EN COMÚ",352
43,"43097",390,301,300,0,1,"EN COMÚ",45
43,"43103",892,644,640,6,4,"EN COMÚ",162
43,"43041",226,160,156,0,4,"EN COMÚ",19
43,"43077",463,307,305,7,2,"EN COMÚ",27
43,"43059",253,195,195,2,0,"EN COMÚ",17
43,"43051",8545,5813,5735,26,78,"EN COMÚ",1730
43,"43096",101,81,81,0,0,"EN COMÚ",12
43,"43110",272,169,167,1,2,"EN COMÚ",18
43,"43112",284,178,178,0,0,"EN COMÚ",31
43,"43075",89,62,62,1,0,"EN COMÚ",9
43,"43020",2202,1631,1614,13,17,"EN COMÚ",385
43,"43013",4425,2975,2938,21,37,"EN COMÚ",576
43,"43073",85,60,59,0,1,"EN COMÚ",9
43,"43145",4084,2991,2954,36,37,"EN COMÚ",468
43,"43083",140,95,94,0,1,"EN COMÚ",13
43,"43036",843,545,542,0,3,"EN COMÚ",127
43,"43071",924,650,639,5,11,"EN COMÚ",95
43,"43158",89,55,53,3,2,"EN COMÚ",8
43,"43114",388,264,262,1,2,"EN COMÚ",49
43,"43115",155,116,116,2,0,"EN COMÚ",16
43,"43092",7059,4603,4563,21,40,"EN COMÚ",838
43,"43062",274,223,219,7,4,"EN COMÚ",44
43,"43168",93,64,64,2,0,"EN COMÚ",1
43,"43014",14293,9441,9319,118,122,"EN COMÚ",2193
43,"43902",2760,1775,1739,22,36,"EN COMÚ",357
43,"43130",196,128,127,2,1,"EN COMÚ",10
43,"43085",226,178,178,2,0,"EN COMÚ",21
43,"43155",22874,15046,14893,137,153,"EN COMÚ",3280
43,"43143",56,47,47,1,0,"EN COMÚ",7
43,"43142",1114,781,771,4,10,"EN COMÚ",116
43,"43007",637,481,479,3,2,"EN COMÚ",67
43,"43091",136,94,94,2,0,"EN COMÚ",33
43,"43003",322,234,233,3,1,"EN COMÚ",60
43,"43069",184,144,143,1,1,"EN COMÚ",21
43,"43173",101,63,60,0,3,"EN COMÚ",6
43,"43905",14371,9191,9136,41,55,"EN COMÚ",1952
43,"43178",1335,939,933,9,6,"EN COMÚ",146
43,"43107",377,265,260,4,5,"EN COMÚ",60
43,"43046",100,77,72,2,5,"EN COMÚ",13
43,"43148",90177,64180,63784,349,396,"EN COMÚ",14356
43,"43048",807,569,564,8,5,"EN COMÚ",104
43,"43009",1431,968,958,5,10,"EN COMÚ",194
43,"43106",810,544,532,7,12,"EN COMÚ",99
43,"43104",1798,1285,1268,14,17,"EN COMÚ",140
43,"43146",38,30,30,1,0,"EN COMÚ",2
43,"43031",1466,1062,1056,8,6,"EN COMÚ",151
43,"43078",856,640,632,11,8,"EN COMÚ",67
43,"43019",1371,904,886,4,18,"EN COMÚ",151
43,"43162",4313,3132,3101,26,31,"EN COMÚ",601
43,"43017",126,100,97,1,3,"EN COMÚ",15
43,"43027",165,133,133,2,0,"EN COMÚ",5
43,"43067",555,434,430,1,4,"EN COMÚ",39
43,"43122",106,84,84,0,0,"EN COMÚ",32
43,"43903",2383,1420,1407,20,13,"EN COMÚ",194
43,"43012",3580,2669,2658,22,11,"EN COMÚ",674
43,"43043",3128,2201,2186,11,15,"EN COMÚ",555
43,"43170",857,603,599,8,4,"EN COMÚ",97
43,"43907",4382,3174,3147,14,27,"EN COMÚ",730
43,"43053",191,149,147,1,2,"EN COMÚ",31
43,"43108",1775,1238,1229,8,9,"EN COMÚ",187
43,"43010",316,253,251,2,2,"EN COMÚ",34
43,"43030",430,311,308,1,3,"EN COMÚ",81
43,"43113",408,306,305,2,1,"EN COMÚ",53
43,"43100",3268,2360,2352,16,8,"EN COMÚ",677
43,"43061",48,31,29,0,2,"EN COMÚ",2
43,"43116",455,326,321,1,5,"EN COMÚ",36
43,"43111",2049,1383,1366,9,17,"EN COMÚ",399
43,"43024",1522,1044,1034,3,10,"EN COMÚ",260
43,"43054",2836,1873,1852,21,21,"EN COMÚ",199
43,"43164",300,218,217,0,1,"EN COMÚ",48
43,"43042",2148,1585,1573,7,12,"EN COMÚ",208
43,"43074",1749,1284,1275,7,9,"EN COMÚ",241
43,"43088",1966,1382,1372,6,10,"EN COMÚ",238
43,"43016",3418,2534,2512,15,22,"EN COMÚ",670
43,"43066",155,109,107,1,2,"EN COMÚ",28
43,"43141",111,71,68,0,3,"EN COMÚ",9
43,"43161",17217,11541,11478,67,63,"EN COMÚ",1940
43,"43151",109,82,82,1,0,"EN COMÚ",10
43,"43105",162,115,115,3,0,"EN COMÚ",14
43,"43153",10676,7241,7190,29,51,"EN COMÚ",1612
43,"43147",521,379,377,1,2,"EN COMÚ",31
43,"43035",262,167,164,0,3,"EN COMÚ",14
43,"43906",2117,1454,1441,3,13,"EN COMÚ",262
43,"43040",338,255,247,2,8,"EN COMÚ",24
43,"43076",447,318,317,0,1,"EN COMÚ",58
43,"43001",695,474,472,4,2,"EN COMÚ",87
43,"43006",683,463,458,10,5,"EN COMÚ",105
43,"43163",25252,17001,16847,74,154,"EN COMÚ",4286
43,"43086",5237,3507,3476,27,31,"EN COMÚ",551
43,"43037",16725,10917,10822,61,95,"EN COMÚ",2867
43,"43152",450,338,330,2,8,"EN COMÚ",25
43,"43165",578,431,428,2,3,"EN COMÚ",58
43,"43167",383,287,286,2,1,"EN COMÚ",45
43,"43056",871,532,521,6,11,"EN COMÚ",58
43,"43117",144,110,109,1,1,"EN COMÚ",17
43,"43157",352,273,271,3,2,"EN COMÚ",34
43,"43177",298,236,232,5,4,"EN COMÚ",31
43,"43160",1273,888,879,7,9,"EN COMÚ",183
43,"43081",597,425,418,4,7,"EN COMÚ",100
43,"43139",2053,1332,1321,16,11,"EN COMÚ",113
43,"43047",4128,2688,2652,19,36,"EN COMÚ",492
43,"43026",797,579,574,2,5,"EN COMÚ",50
43,"43028",2717,1727,1715,7,12,"EN COMÚ",455
43,"43101",148,107,107,4,0,"EN COMÚ",17
43,"43082",372,291,285,0,6,"EN COMÚ",22
43,"43126",1177,848,844,8,4,"EN COMÚ",156
43,"43156",3982,2748,2704,26,44,"EN COMÚ",595
43,"43159",80,57,57,0,0,"EN COMÚ",5
43,"43049",746,546,543,1,3,"EN COMÚ",57
43,"43131",4623,3059,3031,16,28,"EN COMÚ",728
43,"43133",5697,3726,3685,26,41,"EN COMÚ",873
43,"43144",1258,914,911,3,3,"EN COMÚ",228
43,"43121",604,393,387,4,6,"EN COMÚ",73
43,"43057",40,25,25,1,0,"EN COMÚ",4
13,"13001",1270,985,977,8,8,"IU-UPeC",15
13,"13021",436,376,374,0,2,"IU-UPeC",5
13,"13005",23330,18245,18030,164,215,"IU-UPeC",722
13,"13037",865,678,667,2,11,"IU-UPeC",2
13,"13098",2124,1633,1591,15,42,"IU-UPeC",31
13,"13086",189,146,146,1,0,"IU-UPeC",3
13,"13013",7086,5419,5340,45,79,"IU-UPeC",104
13,"13017",267,205,203,1,2,"IU-UPeC",3
13,"13050",501,403,399,2,4,"IU-UPeC",3
13,"13015",5494,4146,4106,18,40,"IU-UPeC",136
13,"13002",1500,1003,993,9,10,"IU-UPeC",5
13,"13087",23161,16812,16595,145,217,"IU-UPeC",683
13,"13014",496,404,398,2,6,"IU-UPeC",10
13,"13062",575,471,466,4,5,"IU-UPeC",18
13,"13038",1649,1317,1294,15,23,"IU-UPeC",27
13,"13075",213,157,153,1,4,"IU-UPeC",0
13,"13047",5785,4462,4406,23,56,"IU-UPeC",109
13,"13026",452,374,372,1,2,"IU-UPeC",67
13,"13039",14383,10833,10684,100,149,"IU-UPeC",429
13,"13031",2455,1940,1914,9,26,"IU-UPeC",36
13,"13019",5179,3887,3830,35,57,"IU-UPeC",448
13,"13902",479,374,367,0,7,"IU-UPeC",17
13,"13044",2675,1959,1920,12,39,"IU-UPeC",24
13,"13088",610,501,495,5,6,"IU-UPeC",17
13,"13080",350,265,265,1,0,"IU-UPeC",5
13,"13052",6497,4715,4648,71,67,"IU-UPeC",79
13,"13043",231,186,185,5,1,"IU-UPeC",2
13,"13003",487,367,363,2,4,"IU-UPeC",16
13,"13073",542,409,405,0,4,"IU-UPeC",3
13,"13056",11354,8732,8634,48,98,"IU-UPeC",443
13,"13076",488,415,408,1,7,"IU-UPeC",3
13,"13064",1684,1288,1283,13,5,"IU-UPeC",47
13,"13089",1728,1410,1381,6,29,"IU-UPeC",10
13,"13004",1052,827,816,1,11,"IU-UPeC",14
13,"13040",892,720,710,3,10,"IU-UPeC",24
13,"13082",25841,17702,17561,154,141,"IU-UPeC",464
13,"13077",3518,2443,2378,12,65,"IU-UPeC",62
13,"13016",665,537,529,4,8,"IU-UPeC",19
13,"13020",4792,3494,3451,26,43,"IU-UPeC",202
13,"13903",539,437,432,4,5,"IU-UPeC",10
13,"13079",12273,9195,9036,79,159,"IU-UPeC",331
13,"13067",360,298,294,2,4,"IU-UPeC",9
13,"13045",679,532,522,7,10,"IU-UPeC",3
13,"13009",1459,1167,1156,4,11,"IU-UPeC",15
13,"13053",14389,10624,10521,79,103,"IU-UPeC",353
13,"13041",253,182,180,0,2,"IU-UPeC",8
13,"13042",928,696,688,3,8,"IU-UPeC",12
13,"13054",4970,3911,3866,44,45,"IU-UPeC",48
13,"13093",4111,3056,3014,21,42,"IU-UPeC",106
13,"13092",1860,1544,1529,11,15,"IU-UPeC",3
13,"13018",824,667,662,7,5,"IU-UPeC",3
13,"13078",9089,6661,6584,44,77,"IU-UPeC",135
13,"13010",887,673,665,0,8,"IU-UPeC",11
13,"13084",908,725,708,5,17,"IU-UPeC",7
13,"13096",7677,5743,5661,51,82,"IU-UPeC",88
13,"13046",740,575,570,3,5,"IU-UPeC",4
13,"13059",204,156,156,1,0,"IU-UPeC",1
13,"13006",608,487,479,4,8,"IU-UPeC",2
13,"13091",552,466,459,3,7,"IU-UPeC",2
13,"13051",350,281,278,2,3,"IU-UPeC",4
13,"13071",39775,28222,28052,175,170,"IU-UPeC",1432
13,"13063",3728,2708,2685,9,23,"IU-UPeC",59
13,"13085",2365,2011,1983,6,28,"IU-UPeC",40
13,"13023",9003,6578,6517,86,61,"IU-UPeC",47
13,"13061",5723,4210,4149,49,61,"IU-UPeC",131
13,"13007",1273,1056,1028,10,28,"IU-UPeC",34
13,"13057",1172,980,970,1,10,"IU-UPeC",12
13,"13058",4110,3157,3127,28,30,"IU-UPeC",70
13,"13095",83,65,65,1,0,"IU-UPeC",0
13,"13036",800,620,614,3,6,"IU-UPeC",6
13,"13008",441,317,311,2,6,"IU-UPeC",5
13,"13072",775,570,565,5,5,"IU-UPeC",10
13,"13048",515,418,416,3,2,"IU-UPeC",59
13,"13060",269,212,209,1,3,"IU-UPeC",27
13,"13904",527,411,406,8,5,"IU-UPeC",11
13,"13090",1110,872,849,6,23,"IU-UPeC",10
13,"13081",652,525,508,2,17,"IU-UPeC",7
13,"13027",3446,2543,2498,15,45,"IU-UPeC",31
13,"13028",10416,8309,8171,77,138,"IU-UPeC",266
13,"13074",982,843,833,3,10,"IU-UPeC",21
13,"13049",814,585,579,0,6,"IU-UPeC",12
13,"13022",351,280,280,2,0,"IU-UPeC",2
13,"13033",1653,1395,1378,4,17,"IU-UPeC",22
13,"13029",86,69,69,0,0,"IU-UPeC",2
13,"13012",411,294,292,0,2,"IU-UPeC",8
13,"13055",666,495,490,0,5,"IU-UPeC",16
13,"13025",302,250,246,0,4,"IU-UPeC",1
13,"13035",986,791,784,7,7,"IU-UPeC",27
13,"13070",765,612,605,4,7,"IU-UPeC",11
13,"13011",4866,3346,3312,15,34,"IU-UPeC",129
13,"13024",898,643,637,7,6,"IU-UPeC",19
13,"13901",895,676,660,4,16,"IU-UPeC",10
13,"13097",2282,1783,1768,12,15,"IU-UPeC",17
13,"13083",2453,1729,1690,14,39,"IU-UPeC",31
13,"13094",308,253,249,3,4,"IU-UPeC",3
13,"13030",143,110,110,0,0,"IU-UPeC",1
13,"13066",2519,2057,2026,14,31,"IU-UPeC",30
13,"13065",2888,2004,1970,19,34,"IU-UPeC",14
13,"13032",1150,878,870,9,8,"IU-UPeC",20
13,"13068",1058,787,782,5,5,"IU-UPeC",11
13,"13034",58010,44627,44241,332,386,"IU-UPeC",1663
13,"13069",666,518,508,3,10,"IU-UPeC",12
41,"41036",3971,2846,2806,14,40,"FE de las J",0
41,"41046",3017,2416,2381,12,35,"FE de las J",1
41,"41014",2510,1981,1958,8,23,"FE de las J",0
41,"41902",4675,3051,3019,20,32,"FE de las J",5
41,"41089",6504,4759,4691,51,68,"FE de las J",4
41,"41039",31674,23240,22982,196,258,"FE de las J",22
41,"41084",2850,2205,2157,15,48,"FE de las J",3
41,"41002",1469,1085,1061,12,24,"FE de las J",1
41,"41078",2522,1888,1874,5,14,"FE de las J",1
41,"41011",15395,11527,11341,114,186,"FE de las J",11
41,"41029",13423,9979,9880,84,99,"FE de las J",15
41,"41100",1025,770,751,5,19,"FE de las J",1
41,"41075",10225,7387,7283,55,104,"FE de las J",12
41,"41099",3998,2597,2577,19,20,"FE de las J",3
41,"41067",7115,5248,5178,46,70,"FE de las J",2
41,"41061",2218,1769,1742,5,27,"FE de las J",0
41,"41070",6021,4504,4456,44,48,"FE de las J",5
41,"41034",23033,15936,15711,189,225,"FE de las J",21
41,"41050",5158,4123,4078,37,45,"FE de las J",0
41,"41042",5868,4612,4583,37,29,"FE de las J",3
41,"41059",33977,26158,25965,230,193,"FE de las J",14
41,"41093",18487,14687,14594,117,93,"FE de las J",10
41,"41091",541928,401177,398212,3487,2965,"FE de las J",347
41,"41053",21252,16022,15770,121,252,"FE de las J",11
41,"41028",1971,1574,1562,11,12,"FE de las J",0
41,"41088",518,381,377,0,4,"FE de las J",1
41,"41052",3006,2264,2209,8,55,"FE de las J",1
41,"41027",3941,2766,2709,28,57,"FE de las J",0
41,"41094",6288,4726,4653,36,73,"FE de las J",10
41,"41012",3286,2268,2235,15,33,"FE de las J",2
41,"41017",15052,11074,10964,99,110,"FE de las J",10
41,"41019",4654,3267,3224,34,43,"FE de las J",3
41,"41054",688,587,570,2,17,"FE de las J",0
41,"41068",13948,10269,10150,75,119,"FE de las J",3
41,"41903",6747,4926,4854,43,72,"FE de las J",2
41,"41055",15009,10393,10292,82,101,"FE de las J",10
41,"41007",12386,8552,8403,90,149,"FE de las J",13
41,"41010",4394,3203,3160,19,43,"FE de las J",2
41,"41064",5601,3766,3715,42,51,"FE de las J",0
41,"41101",5932,4454,4421,27,33,"FE de las J",1
41,"41005",9057,6781,6693,58,88,"FE de las J",3
41,"41025",2041,1456,1430,17,26,"FE de las J",4
41,"41045",5749,4121,4066,49,55,"FE de las J",1
41,"41097",3135,2339,2317,19,22,"FE de las J",3
41,"41021",21249,15031,14854,152,177,"FE de las J",18
41,"41033",5102,3655,3613,25,42,"FE de las J",1
41,"41057",275,193,191,0,2,"FE de las J",1
41,"41048",2244,1625,1598,22,27,"FE de las J",2
41,"41001",1597,1262,1248,5,14,"FE de las J",0
41,"41901",2676,2222,2190,31,32,"FE de las J",0
41,"41030",516,409,395,2,14,"FE de las J",0
41,"41020",12872,8820,8723,92,97,"FE de las J",5
41,"41085",4086,3223,3178,31,45,"FE de las J",0
41,"41087",10202,7160,7033,51,127,"FE de las J",6
41,"41069",29070,20827,20558,355,269,"FE de las J",33
41,"41037",3203,2473,2449,18,24,"FE de las J",0
41,"41040",10411,7959,7892,53,67,"FE de las J",8
41,"41065",22868,15933,15784,172,149,"FE de las J",10
41,"41058",17304,12982,12751,133,231,"FE de las J",26
41,"41018",9490,6997,6930,45,67,"FE de las J",3
41,"41062",2235,1805,1790,10,15,"FE de las J",2
41,"41047",10086,7758,7663,80,95,"FE de las J",4
41,"41073",1715,1194,1169,9,25,"FE de las J",2
41,"41032",4019,2943,2875,17,68,"FE de las J",5
41,"41022",4300,2918,2891,30,27,"FE de las J",2
41,"41026",4325,3551,3516,18,35,"FE de las J",1
41,"41072",4052,3115,3041,18,74,"FE de las J",3
41,"41096",6166,4811,4752,39,59,"FE de las J",4
41,"41079",9343,7111,7029,68,82,"FE de las J",0
41,"41031",1257,838,836,8,2,"FE de las J",0
41,"41092",7749,5715,5647,57,68,"FE de las J",4
41,"41049",9301,7147,7070,63,77,"FE de las J",2
41,"41082",3432,2809,2781,12,28,"FE de las J",1
41,"41024",22662,15742,15521,137,221,"FE de las J",11
41,"41090",3541,2774,2721,17,53,"FE de las J",2
41,"41081",29164,21631,21410,218,221,"FE de las J",14
41,"41098",4952,3762,3704,24,58,"FE de las J",8
41,"41003",2319,1782,1754,8,28,"FE de las J",2
41,"41015",5310,3799,3710,38,89,"FE de las J",5
41,"41016",7310,5473,5410,50,63,"FE de las J",3
41,"41076",2184,1442,1432,19,10,"FE de las J",0
41,"41051",2170,1650,1611,8,39,"FE de las J",2
41,"41071",5620,3974,3898,17,76,"FE de las J",0
41,"41102",14635,10904,10655,148,249,"FE de las J",13
41,"41080",1270,954,938,8,16,"FE de las J",0
41,"41086",16102,10743,10665,93,78,"FE de las J",10
41,"41006",2740,1909,1897,13,12,"FE de las J",0
41,"41013",4842,3491,3461,22,30,"FE de las J",0
41,"41009",1229,811,803,5,8,"FE de las J",0
41,"41044",7392,5562,5526,40,36,"FE de las J",6
41,"41063",2683,1942,1922,21,20,"FE de las J",2
41,"41083",1154,893,888,3,5,"FE de las J",0
41,"41056",3691,3069,3042,21,27,"FE de las J",0
41,"41008",1063,820,805,3,15,"FE de las J",0
41,"41077",8728,6423,6308,28,115,"FE de las J",5
41,"41038",99637,71611,71050,727,561,"FE de las J",102
41,"41035",1112,887,876,5,11,"FE de las J",0
41,"41043",636,439,435,3,4,"FE de las J",0
41,"41066",1363,1019,1007,7,12,"FE de las J",1
41,"41074",3033,2362,2341,8,21,"FE de las J",0
41,"41041",9743,7620,7482,39,138,"FE de las J",6
41,"41095",41137,28987,28731,302,256,"FE de las J",29
41,"41023",7919,5852,5788,34,64,"FE de las J",1
41,"41004",56552,40018,39623,515,395,"FE de las J",51
41,"41060",15279,10611,10447,91,164,"FE de las J",10
13,"13062",575,471,466,4,5,"PODEMOS",45
13,"13083",2453,1729,1690,14,39,"PODEMOS",168
13,"13038",1649,1317,1294,15,23,"PODEMOS",91
13,"13010",887,673,665,0,8,"PODEMOS",51
13,"13058",4110,3157,3127,28,30,"PODEMOS",199
13,"13033",1653,1395,1378,4,17,"PODEMOS",116
13,"13039",14383,10833,10684,100,149,"PODEMOS",1456
13,"13066",2519,2057,2026,14,31,"PODEMOS",155
13,"13079",12273,9195,9036,79,159,"PODEMOS",901
13,"13040",892,720,710,3,10,"PODEMOS",90
13,"13006",608,487,479,4,8,"PODEMOS",17
13,"13056",11354,8732,8634,48,98,"PODEMOS",1617
13,"13085",2365,2011,1983,6,28,"PODEMOS",168
13,"13014",496,404,398,2,6,"PODEMOS",24
13,"13090",1110,872,849,6,23,"PODEMOS",46
13,"13070",765,612,605,4,7,"PODEMOS",53
13,"13001",1270,985,977,8,8,"PODEMOS",74
13,"13005",23330,18245,18030,164,215,"PODEMOS",3076
13,"13067",360,298,294,2,4,"PODEMOS",44
13,"13009",1459,1167,1156,4,11,"PODEMOS",60
13,"13068",1058,787,782,5,5,"PODEMOS",93
13,"13004",1052,827,816,1,11,"PODEMOS",53
13,"13031",2455,1940,1914,9,26,"PODEMOS",172
13,"13034",58010,44627,44241,332,386,"PODEMOS",6715
13,"13091",552,466,459,3,7,"PODEMOS",23
13,"13015",5494,4146,4106,18,40,"PODEMOS",370
13,"13016",665,537,529,4,8,"PODEMOS",30
13,"13013",7086,5419,5340,45,79,"PODEMOS",522
13,"13042",928,696,688,3,8,"PODEMOS",38
13,"13045",679,532,522,7,10,"PODEMOS",31
13,"13093",4111,3056,3014,21,42,"PODEMOS",343
13,"13049",814,585,579,0,6,"PODEMOS",44
13,"13087",23161,16812,16595,145,217,"PODEMOS",2430
13,"13084",908,725,708,5,17,"PODEMOS",66
13,"13057",1172,980,970,1,10,"PODEMOS",64
13,"13044",2675,1959,1920,12,39,"PODEMOS",204
13,"13018",824,667,662,7,5,"PODEMOS",64
13,"13094",308,253,249,3,4,"PODEMOS",14
13,"13036",800,620,614,3,6,"PODEMOS",47
13,"13078",9089,6661,6584,44,77,"PODEMOS",700
13,"13076",488,415,408,1,7,"PODEMOS",24
13,"13023",9003,6578,6517,86,61,"PODEMOS",420
13,"13059",204,156,156,1,0,"PODEMOS",27
13,"13086",189,146,146,1,0,"PODEMOS",7
13,"13002",1500,1003,993,9,10,"PODEMOS",85
13,"13081",652,525,508,2,17,"PODEMOS",38
13,"13025",302,250,246,0,4,"PODEMOS",12
13,"13095",83,65,65,1,0,"PODEMOS",3
13,"13060",269,212,209,1,3,"PODEMOS",17
13,"13032",1150,878,870,9,8,"PODEMOS",80
13,"13071",39775,28222,28052,175,170,"PODEMOS",4851
13,"13011",4866,3346,3312,15,34,"PODEMOS",339
13,"13055",666,495,490,0,5,"PODEMOS",39
13,"13074",982,843,833,3,10,"PODEMOS",74
13,"13089",1728,1410,1381,6,29,"PODEMOS",117
13,"13020",4792,3494,3451,26,43,"PODEMOS",499
13,"13072",775,570,565,5,5,"PODEMOS",43
13,"13019",5179,3887,3830,35,57,"PODEMOS",500
13,"13022",351,280,280,2,0,"PODEMOS",21
13,"13030",143,110,110,0,0,"PODEMOS",4
13,"13052",6497,4715,4648,71,67,"PODEMOS",501
13,"13069",666,518,508,3,10,"PODEMOS",36
13,"13075",213,157,153,1,4,"PODEMOS",9
13,"13097",2282,1783,1768,12,15,"PODEMOS",175
13,"13080",350,265,265,1,0,"PODEMOS",20
13,"13035",986,791,784,7,7,"PODEMOS",114
13,"13098",2124,1633,1591,15,42,"PODEMOS",117
13,"13021",436,376,374,0,2,"PODEMOS",51
13,"13043",231,186,185,5,1,"PODEMOS",6
13,"13053",14389,10624,10521,79,103,"PODEMOS",1502
13,"13041",253,182,180,0,2,"PODEMOS",22
13,"13024",898,643,637,7,6,"PODEMOS",30
13,"13017",267,205,203,1,2,"PODEMOS",17
13,"13061",5723,4210,4149,49,61,"PODEMOS",520
13,"13037",865,678,667,2,11,"PODEMOS",50
13,"13012",411,294,292,0,2,"PODEMOS",29
13,"13088",610,501,495,5,6,"PODEMOS",23
13,"13904",527,411,406,8,5,"PODEMOS",45
13,"13051",350,281,278,2,3,"PODEMOS",28
13,"13027",3446,2543,2498,15,45,"PODEMOS",161
13,"13047",5785,4462,4406,23,56,"PODEMOS",487
13,"13903",539,437,432,4,5,"PODEMOS",28
13,"13026",452,374,372,1,2,"PODEMOS",35
13,"13092",1860,1544,1529,11,15,"PODEMOS",95
13,"13054",4970,3911,3866,44,45,"PODEMOS",313
13,"13046",740,575,570,3,5,"PODEMOS",36
13,"13901",895,676,660,4,16,"PODEMOS",48
13,"13003",487,367,363,2,4,"PODEMOS",27
13,"13096",7677,5743,5661,51,82,"PODEMOS",591
13,"13029",86,69,69,0,0,"PODEMOS",8
13,"13065",2888,2004,1970,19,34,"PODEMOS",179
13,"13008",441,317,311,2,6,"PODEMOS",24
13,"13063",3728,2708,2685,9,23,"PODEMOS",368
13,"13050",501,403,399,2,4,"PODEMOS",32
13,"13064",1684,1288,1283,13,5,"PODEMOS",193
13,"13007",1273,1056,1028,10,28,"PODEMOS",142
13,"13048",515,418,416,3,2,"PODEMOS",36
13,"13028",10416,8309,8171,77,138,"PODEMOS",799
13,"13902",479,374,367,0,7,"PODEMOS",25
13,"13082",25841,17702,17561,154,141,"PODEMOS",1808
13,"13073",542,409,405,0,4,"PODEMOS",22
13,"13077",3518,2443,2378,12,65,"PODEMOS",298
18,"18051",1149,825,823,7,2,"PUM+J",0
18,"18048",2390,1824,1806,8,18,"PUM+J",1
18,"18145",10432,7829,7767,56,62,"PUM+J",8
18,"18152",938,687,681,1,6,"PUM+J",0
18,"18165",4135,2944,2915,23,29,"PUM+J",1
18,"18148",819,671,666,1,5,"PUM+J",1
18,"18011",4321,3136,3119,10,17,"PUM+J",3
18,"18028",945,790,781,2,9,"PUM+J",0
18,"18187",561,418,417,1,1,"PUM+J",0
18,"18174",442,354,348,2,6,"PUM+J",0
18,"18151",260,196,196,0,0,"PUM+J",0
18,"18193",14194,10280,10196,91,84,"PUM+J",10
18,"18133",2187,1731,1722,7,9,"PUM+J",0
18,"18093",2752,1873,1858,10,15,"PUM+J",0
18,"18181",223,159,157,0,2,"PUM+J",0
18,"18049",617,456,451,3,5,"PUM+J",0
18,"18137",1005,758,758,6,0,"PUM+J",0
18,"18036",3768,2904,2882,18,22,"PUM+J",7
18,"18178",743,571,571,2,0,"PUM+J",0
18,"18018",640,490,488,0,2,"PUM+J",0
18,"18111",2743,2046,2033,14,13,"PUM+J",1
18,"18180",631,448,447,2,1,"PUM+J",0
18,"18023",15738,11242,11146,92,96,"PUM+J",6
18,"18175",11624,8549,8467,41,82,"PUM+J",10
18,"18095",1959,1486,1474,5,12,"PUM+J",1
18,"18094",2389,1853,1832,22,21,"PUM+J",4
18,"18107",971,719,711,6,8,"PUM+J",0
18,"18138",2482,1721,1712,8,9,"PUM+J",0
18,"18153",8580,6314,6260,39,54,"PUM+J",5
18,"18901",512,359,357,1,2,"PUM+J",0
18,"18102",8424,5783,5716,41,67,"PUM+J",2
18,"18902",847,680,674,10,6,"PUM+J",1
18,"18149",5177,3946,3902,29,44,"PUM+J",1
18,"18141",414,282,277,1,5,"PUM+J",0
18,"18119",1729,1353,1340,13,13,"PUM+J",1
18,"18068",1566,1234,1214,5,20,"PUM+J",0
18,"18005",375,266,265,2,1,"PUM+J",0
18,"18123",293,228,227,2,1,"PUM+J",0
18,"18127",16586,11998,11897,97,101,"PUM+J",16
18,"18157",1123,836,823,8,13,"PUM+J",1
18,"18109",599,421,419,2,2,"PUM+J",0
18,"18183",660,468,465,3,3,"PUM+J",0
18,"18045",1149,803,789,10,14,"PUM+J",1
18,"18170",336,227,225,1,2,"PUM+J",0
18,"18122",16171,11670,11508,106,162,"PUM+J",8
18,"18017",18172,12077,11954,101,123,"PUM+J",6
18,"18103",760,596,593,6,3,"PUM+J",0
18,"18112",131,88,86,1,2,"PUM+J",0
18,"18047",5888,4028,4000,32,28,"PUM+J",3
18,"18016",323,239,237,0,2,"PUM+J",0
18,"18087",184873,138280,137516,836,764,"PUM+J",162
18,"18132",3312,2582,2556,14,26,"PUM+J",1
18,"18032",239,178,175,0,3,"PUM+J",0
18,"18116",2882,2245,2215,19,30,"PUM+J",1
18,"18194",2152,1487,1477,6,10,"PUM+J",0
18,"18027",2562,1846,1827,19,19,"PUM+J",0
18,"18101",9263,6971,6912,55,59,"PUM+J",6
18,"18143",979,781,776,2,5,"PUM+J",1
18,"18176",258,179,178,3,1,"PUM+J",0
18,"18059",4153,3074,3039,23,35,"PUM+J",1
18,"18056",3545,2716,2687,25,29,"PUM+J",1
18,"18105",4548,3169,3139,19,30,"PUM+J",1
18,"18020",1469,1046,1032,7,14,"PUM+J",0
18,"18185",556,461,461,1,0,"PUM+J",0
18,"18088",1556,1113,1108,5,5,"PUM+J",0
18,"18034",510,391,391,1,0,"PUM+J",0
18,"18037",530,411,408,1,3,"PUM+J",0
18,"18905",14500,10137,10058,82,79,"PUM+J",15
18,"18140",43567,29155,28932,194,223,"PUM+J",24
18,"18053",1667,1084,1078,9,6,"PUM+J",1
18,"18904",779,570,565,1,5,"PUM+J",0
18,"18136",1875,1477,1470,7,7,"PUM+J",0
18,"18046",1867,1225,1215,8,10,"PUM+J",0
18,"18006",4161,2816,2788,29,28,"PUM+J",3
18,"18146",970,734,727,6,7,"PUM+J",3
18,"18147",3734,2416,2386,10,30,"PUM+J",2
18,"18089",15132,10489,10402,64,87,"PUM+J",6
18,"18022",13306,9165,9091,51,74,"PUM+J",6
18,"18161",220,184,184,1,0,"PUM+J",0
18,"18074",273,217,213,2,4,"PUM+J",0
18,"18906",917,681,673,2,8,"PUM+J",1
18,"18010",563,463,459,4,4,"PUM+J",0
18,"18030",584,428,426,3,2,"PUM+J",0
18,"18144",782,596,588,3,8,"PUM+J",0
18,"18050",1711,1271,1256,5,15,"PUM+J",3
18,"18115",2548,1872,1854,16,18,"PUM+J",0
18,"18182",1919,1356,1347,3,9,"PUM+J",2
18,"18021",17451,12420,12305,101,115,"PUM+J",14
18,"18044",179,116,116,0,0,"PUM+J",0
18,"18184",2158,1659,1634,4,25,"PUM+J",1
18,"18097",956,703,691,1,12,"PUM+J",1
18,"18063",1191,770,767,6,3,"PUM+J",0
18,"18135",4583,3045,2998,14,47,"PUM+J",1
18,"18076",815,577,576,0,1,"PUM+J",0
18,"18908",805,633,620,2,13,"PUM+J",1
18,"18121",132,101,100,1,1,"PUM+J",0
18,"18158",8408,5604,5542,38,62,"PUM+J",1
18,"18188",1642,1249,1234,8,15,"PUM+J",0
18,"18033",294,220,219,1,1,"PUM+J",0
18,"18078",739,593,590,4,3,"PUM+J",0
18,"18071",5583,4221,4176,33,45,"PUM+J",4
18,"18189",772,599,595,7,4,"PUM+J",1
18,"18024",855,660,653,8,7,"PUM+J",0
18,"18064",379,308,308,1,0,"PUM+J",0
18,"18192",1529,1216,1208,3,8,"PUM+J",0
18,"18150",6730,4858,4814,28,44,"PUM+J",1
18,"18072",666,481,474,4,7,"PUM+J",0
18,"18012",2330,1670,1660,15,10,"PUM+J",2
18,"18079",3465,2671,2645,16,26,"PUM+J",0
18,"18117",513,402,396,4,6,"PUM+J",0
18,"18163",324,239,235,1,4,"PUM+J",0
18,"18159",1009,811,802,3,9,"PUM+J",0
18,"18065",625,503,500,1,3,"PUM+J",0
18,"18909",589,462,459,0,3,"PUM+J",0
18,"18164",1831,1273,1260,11,13,"PUM+J",0
18,"18108",858,672,667,0,5,"PUM+J",1
18,"18035",1255,964,958,4,6,"PUM+J",0
18,"18062",10298,7584,7512,67,72,"PUM+J",11
18,"18013",4236,3108,3052,19,56,"PUM+J",3
18,"18038",1066,836,826,2,10,"PUM+J",0
18,"18910",803,573,569,5,4,"PUM+J",0
18,"18082",867,626,621,4,5,"PUM+J",0
18,"18134",5811,4002,3946,25,56,"PUM+J",7
18,"18096",342,260,259,1,1,"PUM+J",0
18,"18066",2108,1546,1540,4,6,"PUM+J",0
18,"18014",6372,4620,4566,44,54,"PUM+J",9
18,"18907",1859,1482,1475,5,7,"PUM+J",1
18,"18057",5263,3968,3937,33,31,"PUM+J",7
18,"18120",270,218,216,2,2,"PUM+J",0
18,"18162",951,744,734,0,10,"PUM+J",0
18,"18173",8978,6319,6251,50,68,"PUM+J",4
18,"18001",256,178,177,2,1,"PUM+J",0
18,"18083",266,210,207,1,3,"PUM+J",0
18,"18002",561,446,444,1,2,"PUM+J",0
18,"18167",1897,1321,1313,8,8,"PUM+J",2
18,"18911",7392,5359,5301,44,58,"PUM+J",4
18,"18124",393,274,271,1,3,"PUM+J",0
18,"18067",711,517,516,0,1,"PUM+J",0
18,"18015",443,338,337,0,1,"PUM+J",0
18,"18040",225,142,141,0,1,"PUM+J",0
18,"18177",427,259,258,3,1,"PUM+J",0
18,"18098",6167,4367,4342,22,25,"PUM+J",2
18,"18054",868,630,627,2,3,"PUM+J",1
18,"18003",14022,10417,10330,82,87,"PUM+J",9
18,"18126",1497,1094,1087,7,7,"PUM+J",0
18,"18168",809,589,588,5,1,"PUM+J",2
18,"18912",1488,1021,1007,7,14,"PUM+J",1
18,"18042",414,342,341,0,1,"PUM+J",0
18,"18084",4215,3179,3143,24,36,"PUM+J",3
18,"18007",785,527,523,3,4,"PUM+J",1
18,"18061",1059,822,816,1,6,"PUM+J",0
18,"18025",294,216,214,0,2,"PUM+J",0
18,"18029",1833,1252,1243,9,9,"PUM+J",0
18,"18114",634,457,452,2,5,"PUM+J",0
18,"18154",1016,716,716,2,0,"PUM+J",0
18,"18913",818,617,603,2,14,"PUM+J",0
18,"18069",493,366,363,3,3,"PUM+J",0
18,"18179",546,378,377,1,1,"PUM+J",0
18,"18099",1581,1271,1249,10,22,"PUM+J",3
18,"18004",724,511,505,3,6,"PUM+J",0
18,"18043",129,95,95,0,0,"PUM+J",0
18,"18085",729,489,484,2,5,"PUM+J",1
18,"18039",3544,2544,2511,34,33,"PUM+J",1
18,"18128",344,251,248,0,3,"PUM+J",0
18,"18903",892,650,645,1,5,"PUM+J",0
18,"18086",355,285,283,0,2,"PUM+J",0
18,"18914",1658,1304,1290,8,14,"PUM+J",0
18,"18171",2123,1640,1616,14,24,"PUM+J",0
18,"18070",283,223,218,0,5,"PUM+J",0
18,"18100",7769,5715,5637,57,78,"PUM+J",3
13,"13008",441,317,311,2,6,"DN",0
13,"13005",23330,18245,18030,164,215,"DN",8
13,"13051",350,281,278,2,3,"DN",0
13,"13085",2365,2011,1983,6,28,"DN",1
13,"13071",39775,28222,28052,175,170,"DN",14
13,"13002",1500,1003,993,9,10,"DN",1
13,"13028",10416,8309,8171,77,138,"DN",5
13,"13006",608,487,479,4,8,"DN",0
13,"13030",143,110,110,0,0,"DN",0
13,"13034",58010,44627,44241,332,386,"DN",24
13,"13001",1270,985,977,8,8,"DN",0
13,"13050",501,403,399,2,4,"DN",4
13,"13042",928,696,688,3,8,"DN",0
13,"13083",2453,1729,1690,14,39,"DN",0
13,"13007",1273,1056,1028,10,28,"DN",1
13,"13033",1653,1395,1378,4,17,"DN",1
13,"13040",892,720,710,3,10,"DN",0
13,"13056",11354,8732,8634,48,98,"DN",7
13,"13066",2519,2057,2026,14,31,"DN",0
13,"13021",436,376,374,0,2,"DN",0
13,"13020",4792,3494,3451,26,43,"DN",3
13,"13055",666,495,490,0,5,"DN",2
13,"13035",986,791,784,7,7,"DN",0
13,"13087",23161,16812,16595,145,217,"DN",13
13,"13088",610,501,495,5,6,"DN",0
13,"13058",4110,3157,3127,28,30,"DN",2
13,"13022",351,280,280,2,0,"DN",0
13,"13032",1150,878,870,9,8,"DN",0
13,"13018",824,667,662,7,5,"DN",0
13,"13082",25841,17702,17561,154,141,"DN",5
13,"13067",360,298,294,2,4,"DN",0
13,"13074",982,843,833,3,10,"DN",0
13,"13031",2455,1940,1914,9,26,"DN",1
13,"13078",9089,6661,6584,44,77,"DN",4
13,"13046",740,575,570,3,5,"DN",0
13,"13011",4866,3346,3312,15,34,"DN",2
13,"13080",350,265,265,1,0,"DN",0
13,"13014",496,404,398,2,6,"DN",0
13,"13036",800,620,614,3,6,"DN",0
13,"13092",1860,1544,1529,11,15,"DN",0
13,"13045",679,532,522,7,10,"DN",0
13,"13096",7677,5743,5661,51,82,"DN",4
13,"13097",2282,1783,1768,12,15,"DN",0
13,"13012",411,294,292,0,2,"DN",0
13,"13048",515,418,416,3,2,"DN",0
13,"13044",2675,1959,1920,12,39,"DN",3
13,"13019",5179,3887,3830,35,57,"DN",1
13,"13049",814,585,579,0,6,"DN",0
13,"13093",4111,3056,3014,21,42,"DN",4
13,"13069",666,518,508,3,10,"DN",0
13,"13081",652,525,508,2,17,"DN",0
13,"13009",1459,1167,1156,4,11,"DN",2
13,"13057",1172,980,970,1,10,"DN",0
13,"13059",204,156,156,1,0,"DN",0
13,"13061",5723,4210,4149,49,61,"DN",2
13,"13041",253,182,180,0,2,"DN",0
13,"13037",865,678,667,2,11,"DN",0
13,"13070",765,612,605,4,7,"DN",1
13,"13090",1110,872,849,6,23,"DN",0
13,"13025",302,250,246,0,4,"DN",0
13,"13010",887,673,665,0,8,"DN",0
13,"13086",189,146,146,1,0,"DN",1
13,"13026",452,374,372,1,2,"DN",0
13,"13079",12273,9195,9036,79,159,"DN",3
13,"13062",575,471,466,4,5,"DN",0
13,"13075",213,157,153,1,4,"DN",0
13,"13901",895,676,660,4,16,"DN",2
13,"13063",3728,2708,2685,9,23,"DN",1
13,"13095",83,65,65,1,0,"DN",0
13,"13043",231,186,185,5,1,"DN",0
13,"13023",9003,6578,6517,86,61,"DN",6
13,"13091",552,466,459,3,7,"DN",0
13,"13015",5494,4146,4106,18,40,"DN",0
13,"13084",908,725,708,5,17,"DN",1
13,"13047",5785,4462,4406,23,56,"DN",3
13,"13039",14383,10833,10684,100,149,"DN",13
13,"13027",3446,2543,2498,15,45,"DN",1
13,"13068",1058,787,782,5,5,"DN",0
13,"13076",488,415,408,1,7,"DN",0
13,"13902",479,374,367,0,7,"DN",0
13,"13072",775,570,565,5,5,"DN",0
13,"13003",487,367,363,2,4,"DN",0
13,"13016",665,537,529,4,8,"DN",1
13,"13052",6497,4715,4648,71,67,"DN",5
13,"13064",1684,1288,1283,13,5,"DN",0
13,"13060",269,212,209,1,3,"DN",0
13,"13004",1052,827,816,1,11,"DN",1
13,"13053",14389,10624,10521,79,103,"DN",14
13,"13024",898,643,637,7,6,"DN",0
13,"13089",1728,1410,1381,6,29,"DN",0
13,"13903",539,437,432,4,5,"DN",0
13,"13077",3518,2443,2378,12,65,"DN",0
13,"13073",542,409,405,0,4,"DN",2
13,"13094",308,253,249,3,4,"DN",0
13,"13065",2888,2004,1970,19,34,"DN",0
13,"13013",7086,5419,5340,45,79,"DN",1
13,"13017",267,205,203,1,2,"DN",0
13,"13029",86,69,69,0,0,"DN",0
13,"13038",1649,1317,1294,15,23,"DN",1
13,"13904",527,411,406,8,5,"DN",0
13,"13098",2124,1633,1591,15,42,"DN",1
13,"13054",4970,3911,3866,44,45,"DN",2
37,"37325",91,68,63,0,5,"PODEMOS",6
37,"37102",411,291,289,3,2,"PODEMOS",33
37,"37284",325,245,244,2,1,"PODEMOS",39
37,"37074",153,109,103,4,6,"PODEMOS",9
37,"37272",136,97,96,0,1,"PODEMOS",5
37,"37205",233,201,197,1,4,"PODEMOS",21
37,"37362",4592,3442,3403,48,39,"PODEMOS",547
37,"37178",99,84,81,0,3,"PODEMOS",0
37,"37274",119148,88959,88152,853,807,"PODEMOS",12489
37,"37363",120,98,94,0,4,"PODEMOS",9
37,"37186",106,78,78,3,0,"PODEMOS",8
37,"37221",434,328,323,2,5,"PODEMOS",23
37,"37288",258,211,210,7,1,"PODEMOS",26
37,"37167",173,150,144,2,6,"PODEMOS",24
37,"37101",163,122,122,2,0,"PODEMOS",12
37,"37312",262,211,210,3,1,"PODEMOS",5
37,"37035",194,161,161,0,0,"PODEMOS",17
37,"37373",755,548,545,3,3,"PODEMOS",65
37,"37100",81,68,67,1,1,"PODEMOS",2
37,"37019",151,114,111,0,3,"PODEMOS",4
37,"37254",183,153,149,0,4,"PODEMOS",13
37,"37209",406,281,280,7,1,"PODEMOS",36
37,"37234",357,224,222,1,2,"PODEMOS",19
37,"37318",209,156,155,1,1,"PODEMOS",16
37,"37124",219,149,148,0,1,"PODEMOS",13
37,"37244",134,91,90,1,1,"PODEMOS",10
37,"37073",583,449,442,8,7,"PODEMOS",30
37,"37327",185,157,157,5,0,"PODEMOS",17
37,"37331",217,150,148,1,2,"PODEMOS",7
37,"37270",190,142,139,1,3,"PODEMOS",3
37,"37014",1161,850,847,5,3,"PODEMOS",84
37,"37222",97,66,66,1,0,"PODEMOS",13
37,"37278",753,573,568,7,5,"PODEMOS",86
37,"37185",591,450,443,4,7,"PODEMOS",44
37,"37109",182,119,118,0,1,"PODEMOS",2
37,"37158",248,183,181,0,2,"PODEMOS",35
37,"37240",907,646,636,5,10,"PODEMOS",89
37,"37281",37,34,33,0,1,"PODEMOS",2
37,"37115",123,89,87,0,2,"PODEMOS",4
37,"37067",3125,2551,2523,22,28,"PODEMOS",470
37,"37343",62,49,49,0,0,"PODEMOS",11
37,"37252",116,89,89,0,0,"PODEMOS",7
37,"37170",1479,1055,1031,10,24,"PODEMOS",90
37,"37181",291,209,207,1,2,"PODEMOS",13
37,"37296",338,258,255,4,3,"PODEMOS",15
37,"37113",430,340,340,3,0,"PODEMOS",27
37,"37282",209,136,136,0,0,"PODEMOS",9
37,"37313",555,415,411,1,4,"PODEMOS",18
37,"37350",421,324,320,4,4,"PODEMOS",24
37,"37317",306,246,243,1,3,"PODEMOS",22
37,"37007",439,321,313,4,8,"PODEMOS",22
37,"37198",206,161,160,3,1,"PODEMOS",24
37,"37192",353,245,242,2,3,"PODEMOS",50
37,"37329",36,28,28,0,0,"PODEMOS",1
37,"37293",118,84,84,0,0,"PODEMOS",3
37,"37320",93,71,71,1,0,"PODEMOS",5
37,"37179",215,173,170,0,3,"PODEMOS",12
37,"37259",45,30,30,0,0,"PODEMOS",0
37,"37190",219,167,167,0,0,"PODEMOS",6
37,"37135",1211,932,925,10,7,"PODEMOS",106
37,"37290",140,116,116,0,0,"PODEMOS",12
37,"37380",55,46,46,2,0,"PODEMOS",6
37,"37184",345,247,244,1,3,"PODEMOS",0
37,"37173",1526,1138,1125,5,13,"PODEMOS",112
37,"37219",179,110,110,0,0,"PODEMOS",8
37,"37251",126,87,87,2,0,"PODEMOS",3
37,"37188",185,127,125,3,2,"PODEMOS",14
37,"37319",117,78,77,0,1,"PODEMOS",11
37,"37159",91,74,74,0,0,"PODEMOS",4
37,"37144",370,288,284,2,4,"PODEMOS",14
37,"37002",144,87,87,0,0,"PODEMOS",4
37,"37375",705,593,582,11,11,"PODEMOS",40
37,"37213",87,73,73,0,0,"PODEMOS",12
37,"37365",174,147,144,0,3,"PODEMOS",5
37,"37034",84,66,66,3,0,"PODEMOS",10
37,"37118",125,96,96,0,0,"PODEMOS",8
37,"37091",176,114,113,2,1,"PODEMOS",9
37,"37357",276,216,215,0,1,"PODEMOS",13
37,"37039",304,213,213,4,0,"PODEMOS",10
37,"37052",274,197,197,2,0,"PODEMOS",26
37,"37175",407,316,314,5,2,"PODEMOS",24
37,"37028",150,111,110,1,1,"PODEMOS",9
37,"37152",424,290,283,2,7,"PODEMOS",25
37,"37182",77,62,62,0,0,"PODEMOS",6
37,"37292",103,72,72,1,0,"PODEMOS",4
37,"37046",11336,8300,8171,62,129,"PODEMOS",1079
37,"37097",36,30,30,0,0,"PODEMOS",1
37,"37277",73,55,55,0,0,"PODEMOS",0
37,"37340",150,105,104,1,1,"PODEMOS",5
37,"37141",156,127,127,1,0,"PODEMOS",15
37,"37369",140,96,96,0,0,"PODEMOS",17
37,"37358",168,136,135,2,1,"PODEMOS",5
37,"37370",337,258,255,3,3,"PODEMOS",21
37,"37321",170,131,129,2,2,"PODEMOS",11
37,"37195",48,35,35,1,0,"PODEMOS",10
37,"37238",112,88,85,2,3,"PODEMOS",17
37,"37286",206,156,156,4,0,"PODEMOS",22
37,"37050",67,47,46,1,1,"PODEMOS",1
37,"37149",70,63,63,0,0,"PODEMOS",4
37,"37003",119,93,90,0,3,"PODEMOS",2
37,"37040",393,320,317,3,3,"PODEMOS",25
37,"37081",933,720,714,4,6,"PODEMOS",32
37,"37177",298,223,221,1,2,"PODEMOS",23
37,"37041",74,48,48,0,0,"PODEMOS",1
37,"37359",184,131,129,0,2,"PODEMOS",13
37,"37367",199,160,158,7,2,"PODEMOS",6
37,"37005",77,58,56,0,2,"PODEMOS",2
37,"37349",112,83,82,0,1,"PODEMOS",1
37,"37199",142,108,108,0,0,"PODEMOS",6
37,"37215",136,102,101,2,1,"PODEMOS",7
37,"37125",228,158,156,3,2,"PODEMOS",20
37,"37280",79,50,50,0,0,"PODEMOS",0
37,"37166",213,142,142,1,0,"PODEMOS",6
37,"37374",1178,971,943,8,28,"PODEMOS",67
37,"37208",81,49,48,0,1,"PODEMOS",10
37,"37262",78,64,64,1,0,"PODEMOS",2
37,"37339",316,257,257,4,0,"PODEMOS",17
37,"37114",88,67,66,1,1,"PODEMOS",3
37,"37044",470,353,341,1,12,"PODEMOS",28
37,"37361",84,56,55,0,1,"PODEMOS",3
37,"37025",258,223,221,2,2,"PODEMOS",12
37,"37225",106,94,92,0,2,"PODEMOS",7
37,"37328",189,142,140,0,2,"PODEMOS",34
37,"37119",109,86,86,1,0,"PODEMOS",15
37,"37241",172,128,126,1,2,"PODEMOS",4
37,"37353",129,92,92,1,0,"PODEMOS",6
37,"37267",199,151,147,2,4,"PODEMOS",16
37,"37010",956,716,708,3,8,"PODEMOS",104
37,"37161",138,109,107,0,2,"PODEMOS",4
37,"37164",256,200,195,1,5,"PODEMOS",44
37,"37085",4704,3475,3432,35,43,"PODEMOS",466
37,"37226",156,121,119,1,2,"PODEMOS",3
37,"37142",592,453,451,2,2,"PODEMOS",67
37,"37176",137,100,98,0,2,"PODEMOS",8
37,"37333",225,143,142,4,1,"PODEMOS",19
37,"37242",91,71,71,0,0,"PODEMOS",4
37,"37271",361,283,276,3,7,"PODEMOS",10
37,"37162",206,151,149,2,2,"PODEMOS",12
37,"37145",257,190,187,0,3,"PODEMOS",10
37,"37355",189,147,146,1,1,"PODEMOS",20
37,"37246",5335,4190,4152,41,38,"PODEMOS",365
37,"37214",125,88,88,1,0,"PODEMOS",14
37,"37202",978,773,763,7,10,"PODEMOS",134
37,"37023",1378,1116,1105,9,11,"PODEMOS",184
37,"37086",98,80,80,2,0,"PODEMOS",0
37,"37306",271,171,171,0,0,"PODEMOS",11
37,"37258",180,117,115,1,2,"PODEMOS",5
37,"37283",120,88,88,1,0,"PODEMOS",6
37,"37250",358,223,223,1,0,"PODEMOS",30
37,"37189",125,97,97,0,0,"PODEMOS",5
37,"37299",221,170,163,1,7,"PODEMOS",10
37,"37063",74,59,59,1,0,"PODEMOS",3
37,"37017",251,186,184,2,2,"PODEMOS",16
37,"37057",213,168,167,0,1,"PODEMOS",7
37,"37056",41,30,30,0,0,"PODEMOS",1
37,"37065",323,237,235,0,2,"PODEMOS",12
37,"37136",667,453,448,2,5,"PODEMOS",42
37,"37006",135,91,90,1,1,"PODEMOS",14
37,"37285",412,311,305,2,6,"PODEMOS",28
37,"37088",204,152,152,3,0,"PODEMOS",11
37,"37248",152,127,126,2,1,"PODEMOS",7
37,"37160",627,450,443,7,7,"PODEMOS",30
37,"37216",310,264,257,4,7,"PODEMOS",15
37,"37379",173,134,134,2,0,"PODEMOS",9
37,"37230",221,167,167,2,0,"PODEMOS",22
37,"37049",147,98,98,2,0,"PODEMOS",8
37,"37134",230,175,173,1,2,"PODEMOS",17
37,"37183",417,305,301,2,4,"PODEMOS",30
37,"37301",73,62,62,0,0,"PODEMOS",3
37,"37354",5182,3955,3915,50,40,"PODEMOS",602
37,"37194",252,191,190,2,1,"PODEMOS",30
37,"37116",69,51,51,0,0,"PODEMOS",7
37,"37004",32,22,22,0,0,"PODEMOS",2
37,"37366",43,27,27,0,0,"PODEMOS",3
37,"37187",565,431,426,4,5,"PODEMOS",13
37,"37071",78,73,72,1,1,"PODEMOS",3
37,"37260",154,126,126,1,0,"PODEMOS",17
37,"37191",116,78,76,0,2,"PODEMOS",1
37,"37117",1458,1075,1068,14,7,"PODEMOS",155
37,"37146",122,100,99,1,1,"PODEMOS",7
37,"37062",84,67,66,1,1,"PODEMOS",1
37,"37264",67,43,43,0,0,"PODEMOS",5
37,"37231",259,208,207,4,1,"PODEMOS",26
37,"37051",80,54,53,0,1,"PODEMOS",0
37,"37232",390,349,348,0,1,"PODEMOS",21
37,"37104",27,21,21,0,0,"PODEMOS",0
37,"37078",823,670,657,8,13,"PODEMOS",57
37,"37027",228,187,187,0,0,"PODEMOS",35
37,"37265",217,180,178,2,2,"PODEMOS",12
37,"37342",256,210,208,1,2,"PODEMOS",19
37,"37291",268,206,206,1,0,"PODEMOS",18
37,"37224",210,183,179,2,4,"PODEMOS",7
37,"37012",150,117,115,0,2,"PODEMOS",6
37,"37307",160,103,103,0,0,"PODEMOS",9
37,"37368",16,15,15,0,0,"PODEMOS",4
37,"37110",117,92,89,1,3,"PODEMOS",9
37,"37151",146,116,115,2,1,"PODEMOS",2
37,"37303",188,152,151,1,1,"PODEMOS",9
37,"37137",105,73,73,0,0,"PODEMOS",2
37,"37156",4310,3173,3126,27,47,"PODEMOS",232
37,"37204",280,214,211,1,3,"PODEMOS",15
37,"37233",65,45,45,0,0,"PODEMOS",5
37,"37197",87,55,55,2,0,"PODEMOS",6
37,"37201",262,179,177,0,2,"PODEMOS",12
37,"37130",173,155,153,5,2,"PODEMOS",3
37,"37266",84,55,55,1,0,"PODEMOS",11
37,"37297",420,342,331,4,11,"PODEMOS",17
37,"37255",51,38,38,0,0,"PODEMOS",2
37,"37309",45,28,28,0,0,"PODEMOS",6
37,"37337",139,120,120,2,0,"PODEMOS",0
37,"37324",371,284,279,4,5,"PODEMOS",12
37,"37045",27,20,20,0,0,"PODEMOS",1
37,"37061",226,166,164,1,2,"PODEMOS",10
37,"37068",366,272,271,5,1,"PODEMOS",17
37,"37015",222,145,143,3,2,"PODEMOS",12
37,"37344",246,184,183,1,1,"PODEMOS",5
37,"37138",199,155,154,4,1,"PODEMOS",11
37,"37298",184,125,125,1,0,"PODEMOS",12
37,"37011",122,91,89,0,2,"PODEMOS",10
37,"37123",182,141,138,0,3,"PODEMOS",3
37,"37008",4298,3312,3272,16,40,"PODEMOS",295
37,"37143",385,301,299,1,2,"PODEMOS",23
37,"37346",267,222,220,1,2,"PODEMOS",20
37,"37120",99,77,76,1,1,"PODEMOS",6
37,"37211",223,163,163,4,0,"PODEMOS",10
37,"37382",180,133,133,4,0,"PODEMOS",5
37,"37314",87,74,72,0,2,"PODEMOS",7
37,"37338",78,66,66,1,0,"PODEMOS",10
37,"37082",799,570,560,1,10,"PODEMOS",49
37,"37268",116,71,70,0,1,"PODEMOS",6
37,"37228",367,301,299,1,2,"PODEMOS",13
37,"37203",165,118,118,0,0,"PODEMOS",11
37,"37121",584,434,430,5,4,"PODEMOS",51
37,"37174",1065,838,826,3,12,"PODEMOS",77
37,"37047",167,83,83,0,0,"PODEMOS",3
37,"37092",1731,1264,1250,11,14,"PODEMOS",205
37,"37122",202,158,156,3,2,"PODEMOS",7
37,"37315",93,69,67,1,2,"PODEMOS",3
37,"37069",976,713,699,9,14,"PODEMOS",89
37,"37229",143,102,102,1,0,"PODEMOS",6
37,"37060",245,192,192,0,0,"PODEMOS",28
37,"37013",121,87,86,3,1,"PODEMOS",7
37,"37098",335,237,237,1,0,"PODEMOS",37
37,"37106",266,172,166,1,6,"PODEMOS",6
37,"37083",179,159,159,0,0,"PODEMOS",14
37,"37112",161,115,114,0,1,"PODEMOS",10
37,"37021",80,62,62,0,0,"PODEMOS",3
37,"37032",543,411,410,1,1,"PODEMOS",51
37,"37154",141,116,112,0,4,"PODEMOS",4
37,"37330",335,262,258,4,4,"PODEMOS",22
37,"37107",10855,7694,7598,96,96,"PODEMOS",686
37,"37172",878,580,576,3,4,"PODEMOS",63
37,"37239",229,196,194,6,2,"PODEMOS",27
37,"37029",213,155,152,0,3,"PODEMOS",7
37,"37289",240,182,182,2,0,"PODEMOS",14
37,"37347",477,365,359,3,6,"PODEMOS",69
37,"37305",216,170,169,2,1,"PODEMOS",17
37,"37249",44,33,33,1,0,"PODEMOS",6
37,"37253",135,110,110,1,0,"PODEMOS",12
37,"37207",303,234,233,0,1,"PODEMOS",35
37,"37022",268,220,219,2,1,"PODEMOS",21
37,"37147",191,141,136,0,5,"PODEMOS",22
37,"37129",251,199,194,1,5,"PODEMOS",33
37,"37352",204,148,147,0,1,"PODEMOS",16
37,"37059",124,100,98,0,2,"PODEMOS",6
37,"37236",139,94,89,0,5,"PODEMOS",4
37,"37169",176,139,137,0,2,"PODEMOS",14
37,"37345",166,135,133,3,2,"PODEMOS",11
37,"37087",855,681,676,8,5,"PODEMOS",115
37,"37294",11680,8850,8760,84,90,"PODEMOS",1446
37,"37223",109,90,87,0,3,"PODEMOS",3
37,"37334",79,42,42,1,0,"PODEMOS",2
37,"37332",69,53,52,0,1,"PODEMOS",3
37,"37009",216,161,160,3,1,"PODEMOS",10
37,"37376",2251,1588,1568,9,20,"PODEMOS",143
37,"37237",325,250,248,4,2,"PODEMOS",32
37,"37200",190,134,133,2,1,"PODEMOS",8
37,"37269",452,328,328,2,0,"PODEMOS",42
37,"37054",261,199,198,1,1,"PODEMOS",20
37,"37356",86,73,71,1,2,"PODEMOS",4
37,"37217",56,46,44,1,2,"PODEMOS",5
37,"37148",425,304,295,6,9,"PODEMOS",13
37,"37273",108,77,77,0,0,"PODEMOS",8
37,"37364",836,598,583,6,15,"PODEMOS",45
37,"37079",74,64,63,0,1,"PODEMOS",9
37,"37180",73,52,52,1,0,"PODEMOS",2
37,"37171",411,321,317,1,4,"PODEMOS",9
37,"37381",139,98,92,0,6,"PODEMOS",11
37,"37287",318,237,237,3,0,"PODEMOS",22
37,"37139",205,163,162,2,1,"PODEMOS",18
37,"37378",111,74,70,2,4,"PODEMOS",1
37,"37037",119,81,81,0,0,"PODEMOS",3
37,"37371",281,183,177,1,6,"PODEMOS",6
37,"37090",52,38,36,0,2,"PODEMOS",2
37,"37275",123,87,86,1,1,"PODEMOS",8
37,"37026",192,158,154,2,4,"PODEMOS",8
37,"37127",221,158,158,4,0,"PODEMOS",28
37,"37089",67,50,49,0,1,"PODEMOS",3
37,"37235",223,168,163,1,5,"PODEMOS",14
37,"37300",575,427,423,3,4,"PODEMOS",62
37,"37020",430,340,334,3,6,"PODEMOS",36
37,"37080",232,176,176,1,0,"PODEMOS",16
37,"37360",230,167,166,2,1,"PODEMOS",10
37,"37243",102,76,76,0,0,"PODEMOS",3
37,"37311",226,182,182,2,0,"PODEMOS",17
37,"37155",73,54,54,1,0,"PODEMOS",9
37,"37302",294,216,214,1,2,"PODEMOS",6
37,"37206",94,71,71,4,0,"PODEMOS",3
37,"37218",71,33,33,2,0,"PODEMOS",1
37,"37322",2472,1691,1676,12,15,"PODEMOS",275
37,"37001",195,147,144,0,3,"PODEMOS",15
37,"37133",108,82,79,4,3,"PODEMOS",6
37,"37196",77,54,53,0,1,"PODEMOS",7
37,"37304",170,114,109,4,5,"PODEMOS",4
37,"37168",443,319,311,2,8,"PODEMOS",35
37,"37193",399,279,278,6,1,"PODEMOS",28
37,"37257",53,43,43,0,0,"PODEMOS",7
37,"37279",763,572,562,11,10,"PODEMOS",44
37,"37108",101,81,79,2,2,"PODEMOS",3
37,"37038",789,628,616,5,12,"PODEMOS",47
37,"37128",264,211,201,4,10,"PODEMOS",37
37,"37256",220,158,157,1,1,"PODEMOS",8
37,"37163",42,33,33,0,0,"PODEMOS",9
37,"37033",98,63,63,0,0,"PODEMOS",5
37,"37351",281,239,238,0,1,"PODEMOS",7
37,"37140",678,440,435,2,5,"PODEMOS",35
37,"37070",533,403,396,4,7,"PODEMOS",50
37,"37323",521,387,385,8,2,"PODEMOS",20
37,"37212",111,83,83,1,0,"PODEMOS",12
37,"37018",105,80,80,1,0,"PODEMOS",3
37,"37247",199,162,154,3,8,"PODEMOS",6
37,"37336",55,47,47,0,0,"PODEMOS",5
37,"37132",351,272,269,2,3,"PODEMOS",27
37,"37096",220,174,174,5,0,"PODEMOS",12
37,"37150",43,35,35,0,0,"PODEMOS",0
37,"37016",573,451,447,3,4,"PODEMOS",62
37,"37335",415,301,293,2,8,"PODEMOS",19
37,"37341",56,43,41,0,2,"PODEMOS",3
37,"37103",446,326,325,4,1,"PODEMOS",31
37,"37165",33,27,27,0,0,"PODEMOS",3
37,"37031",365,258,257,1,1,"PODEMOS",15
37,"37316",751,584,577,5,7,"PODEMOS",35
37,"37263",348,252,251,1,1,"PODEMOS",43
37,"37055",123,105,98,0,7,"PODEMOS",2
37,"37099",73,45,45,2,0,"PODEMOS",1
37,"37024",92,77,77,0,0,"PODEMOS",2
37,"37131",190,140,139,0,1,"PODEMOS",10
37,"37276",149,100,99,0,1,"PODEMOS",5
37,"37348",113,91,91,1,0,"PODEMOS",8
37,"37072",166,133,132,2,1,"PODEMOS",3
37,"37310",180,129,128,2,1,"PODEMOS",14
37,"37261",227,165,161,2,4,"PODEMOS",20
37,"37245",345,252,246,7,6,"PODEMOS",12
37,"37157",77,62,62,0,0,"PODEMOS",3
37,"37372",146,117,115,0,2,"PODEMOS",9
37,"37377",249,199,195,3,4,"PODEMOS",9
37,"37126",30,24,24,0,0,"PODEMOS",0
37,"37042",42,29,29,2,0,"PODEMOS",0
37,"37058",61,43,42,0,1,"PODEMOS",3
37,"37030",84,68,66,0,2,"PODEMOS",5
37,"37036",63,46,46,0,0,"PODEMOS",4
37,"37077",260,234,230,0,4,"PODEMOS",12
1,"1027",416,268,268,0,0,"Ln",0
1,"1062",314,215,215,3,0,"Ln",0
1,"1052",244,188,186,1,2,"Ln",0
1,"1008",790,548,542,13,6,"Ln",0
1,"1059",186354,135873,134633,948,1240,"Ln",62
1,"1039",202,161,156,0,5,"Ln",0
1,"1056",218,141,140,1,1,"Ln",0
1,"1057",245,203,202,0,1,"Ln",0
1,"1060",199,162,159,0,3,"Ln",0
1,"1055",836,564,552,8,12,"Ln",0
1,"1901",2344,1688,1669,17,19,"Ln",0
1,"1041",153,105,100,1,5,"Ln",0
1,"1902",738,537,528,4,9,"Ln",0
1,"1030",159,126,123,1,3,"Ln",2
1,"1044",236,189,187,1,2,"Ln",0
1,"1063",1799,1320,1309,10,11,"Ln",1
1,"1004",1405,1026,1010,7,16,"Ln",1
1,"1021",460,336,332,1,4,"Ln",0
1,"1006",176,142,141,1,1,"Ln",0
1,"1033",649,512,508,5,4,"Ln",0
1,"1001",1984,1426,1405,8,21,"Ln",0
1,"1036",15034,10733,10619,73,114,"Ln",3
1,"1018",1370,964,963,4,1,"Ln",0
1,"1037",586,425,419,2,6,"Ln",0
1,"1058",1327,843,833,8,10,"Ln",1
1,"1010",2275,1729,1717,17,12,"Ln",0
1,"1031",1183,907,885,6,22,"Ln",0
1,"1034",165,120,119,1,1,"Ln",0
1,"1003",1186,842,833,19,9,"Ln",0
1,"1014",372,292,284,1,8,"Ln",0
1,"1051",3606,2413,2389,21,24,"Ln",0
1,"1009",1281,908,898,2,10,"Ln",1
1,"1032",522,368,361,0,7,"Ln",0
1,"1019",144,112,111,2,1,"Ln",0
1,"1017",869,584,577,4,7,"Ln",2
1,"1043",2318,1644,1624,8,20,"Ln",0
1,"1022",805,593,587,3,6,"Ln",0
1,"1049",140,108,108,0,0,"Ln",0
1,"1047",964,713,702,13,11,"Ln",0
1,"1028",1077,759,753,6,6,"Ln",0
1,"1002",8139,5961,5878,32,83,"Ln",5
1,"1046",594,445,435,3,10,"Ln",0
1,"1020",326,232,228,0,4,"Ln",0
1,"1061",153,132,132,2,0,"Ln",0
1,"1013",711,486,483,3,3,"Ln",1
1,"1023",269,197,195,2,2,"Ln",0
1,"1054",952,694,688,4,6,"Ln",0
1,"1053",587,367,365,3,2,"Ln",1
1,"1042",901,653,650,11,3,"Ln",1
1,"1011",237,177,175,7,2,"Ln",0
1,"1016",439,255,249,3,6,"Ln",0
22,"22212",84,70,70,1,0,"Independien",0
22,"22253",61,51,50,0,1,"Independien",0
22,"22182",256,177,176,2,1,"Independien",0
22,"22204",1095,816,805,10,11,"Independien",1
22,"22250",347,258,256,5,2,"Independien",0
22,"22163",426,360,356,3,4,"Independien",0
22,"22067",65,45,45,1,0,"Independien",0
22,"22905",294,224,224,2,0,"Independien",1
22,"22022",558,431,427,2,4,"Independien",1
22,"22119",1296,950,940,3,10,"Independien",0
22,"22032",107,74,71,0,3,"Independien",1
22,"22084",534,413,411,3,2,"Independien",1
22,"22086",215,162,162,4,0,"Independien",1
22,"22106",24,17,17,0,0,"Independien",0
22,"22025",1071,726,712,13,14,"Independien",0
22,"22201",269,189,189,0,0,"Independien",2
22,"22172",560,399,396,2,3,"Independien",1
22,"22076",305,224,223,0,1,"Independien",0
22,"22095",73,48,48,1,0,"Independien",0
22,"22243",45,32,32,0,0,"Independien",0
22,"22049",78,61,61,1,0,"Independien",0
22,"22085",107,92,90,2,2,"Independien",1
22,"22102",184,160,159,1,1,"Independien",0
22,"22035",244,171,168,3,3,"Independien",0
22,"22136",815,596,595,6,1,"Independien",1
22,"22227",211,153,151,3,2,"Independien",0
22,"22181",93,62,62,1,0,"Independien",1
22,"22082",298,222,220,2,2,"Independien",1
22,"22114",123,80,79,4,1,"Independien",0
22,"22027",325,218,214,0,4,"Independien",0
22,"22176",174,140,140,1,0,"Independien",0
22,"22096",297,248,248,0,0,"Independien",0
22,"22105",118,87,86,1,1,"Independien",1
22,"22173",234,158,157,0,1,"Independien",0
22,"22057",364,260,259,1,1,"Independien",0
22,"22017",864,658,651,7,7,"Independien",0
22,"22909",318,238,234,2,4,"Independien",0
22,"22160",209,161,161,3,0,"Independien",0
22,"22023",430,329,329,2,0,"Independien",0
22,"22187",286,224,221,1,3,"Independien",1
22,"22249",119,97,97,1,0,"Independien",0
22,"22226",774,591,589,2,2,"Independien",0
22,"22151",93,68,68,0,0,"Independien",0
22,"22068",82,65,65,3,0,"Independien",0
22,"22221",80,60,59,0,1,"Independien",0
22,"22199",7029,5024,4977,55,47,"Independien",4
22,"22006",298,217,215,1,2,"Independien",0
22,"22242",64,45,44,1,1,"Independien",0
22,"22094",101,77,77,1,0,"Independien",0
22,"22061",6685,4796,4740,38,56,"Independien",5
22,"22246",77,51,50,0,1,"Independien",0
22,"22011",89,70,70,1,0,"Independien",0
22,"22139",83,65,64,0,1,"Independien",1
22,"22064",165,115,115,1,0,"Independien",0
22,"22165",490,375,372,2,3,"Independien",1
22,"22149",302,236,236,2,0,"Independien",0
22,"22099",490,378,377,4,1,"Independien",0
22,"22116",1443,1048,1038,12,10,"Independien",1
22,"22107",123,79,78,2,1,"Independien",0
22,"22904",835,600,594,6,6,"Independien",0
22,"22167",498,397,388,7,9,"Independien",0
22,"22002",109,94,93,0,1,"Independien",0
22,"22200",251,191,189,0,2,"Independien",0
22,"22208",178,142,140,0,2,"Independien",0
22,"22195",235,190,189,2,1,"Independien",0
22,"22203",82,68,67,0,1,"Independien",0
22,"22072",192,148,147,1,1,"Independien",3
22,"22124",204,143,142,1,1,"Independien",0
22,"22008",173,138,138,3,0,"Independien",0
22,"22047",247,213,212,2,1,"Independien",0
22,"22158",12005,8628,8554,78,74,"Independien",7
22,"22075",126,82,81,2,1,"Independien",0
22,"22184",188,156,156,2,0,"Independien",0
22,"22090",102,75,75,0,0,"Independien",1
22,"22110",751,563,558,3,5,"Independien",0
22,"22248",118,92,91,0,1,"Independien",0
22,"22060",1165,885,879,3,6,"Independien",0
22,"22197",479,378,373,6,5,"Independien",0
22,"22113",494,362,361,3,1,"Independien",0
22,"22059",1137,839,828,7,11,"Independien",2
22,"22129",183,128,127,2,1,"Independien",0
22,"22206",201,141,140,2,1,"Independien",0
22,"22051",101,84,84,1,0,"Independien",0
22,"22009",619,463,461,5,2,"Independien",0
22,"22037",116,95,94,1,1,"Independien",0
22,"22230",290,224,223,2,1,"Independien",0
22,"22170",642,518,509,4,9,"Independien",0
22,"22046",740,578,570,6,8,"Independien",0
22,"22903",654,542,536,3,6,"Independien",0
22,"22078",453,323,319,6,4,"Independien",3
22,"22907",1459,1112,1104,21,8,"Independien",0
22,"22115",364,270,267,4,3,"Independien",1
22,"22088",157,116,116,1,0,"Independien",0
22,"22235",100,77,77,0,0,"Independien",0
22,"22217",395,307,301,3,6,"Independien",0
22,"22186",186,139,137,3,2,"Independien",0
22,"22062",162,113,113,3,0,"Independien",0
22,"22188",87,66,66,1,0,"Independien",0
22,"22112",9592,6871,6820,76,51,"Independien",3
22,"22150",464,348,348,1,0,"Independien",0
22,"22077",381,295,293,5,2,"Independien",0
22,"22247",30,23,22,0,1,"Independien",0
22,"22164",35,26,26,1,0,"Independien",0
22,"22157",194,151,151,1,0,"Independien",0
22,"22131",83,63,63,3,0,"Independien",0
22,"22007",797,607,603,13,4,"Independien",2
22,"22109",265,207,206,2,1,"Independien",0
22,"22133",117,89,89,4,0,"Independien",0
22,"22019",180,156,155,0,1,"Independien",1
22,"22228",505,409,407,3,2,"Independien",0
22,"22252",122,93,91,1,2,"Independien",0
22,"22012",111,84,82,0,2,"Independien",0
22,"22048",12633,9215,9141,90,74,"Independien",22
22,"22036",91,82,82,0,0,"Independien",0
22,"22083",474,400,396,1,4,"Independien",0
22,"22053",787,541,535,12,6,"Independien",0
22,"22220",169,123,122,2,1,"Independien",0
22,"22024",225,174,173,0,1,"Independien",0
22,"22141",118,90,89,1,1,"Independien",0
22,"22130",10106,6957,6909,57,48,"Independien",6
22,"22052",942,743,741,9,2,"Independien",0
22,"22190",113,83,83,2,0,"Independien",0
22,"22041",163,127,126,4,1,"Independien",0
22,"22013",295,235,233,2,2,"Independien",0
22,"22069",435,340,338,3,2,"Independien",1
22,"22234",802,600,597,7,3,"Independien",1
22,"22014",245,184,183,2,1,"Independien",1
22,"22906",180,146,143,1,3,"Independien",0
22,"22205",434,334,333,2,1,"Independien",0
22,"22177",102,77,77,2,0,"Independien",1
22,"22251",371,283,281,4,2,"Independien",0
22,"22122",62,49,49,1,0,"Independien",0
22,"22066",707,512,508,8,4,"Independien",1
22,"22175",197,140,140,0,0,"Independien",0
22,"22207",125,89,88,3,1,"Independien",1
22,"22054",1542,1126,1106,20,20,"Independien",2
22,"22162",129,101,101,0,0,"Independien",0
22,"22222",527,390,389,5,1,"Independien",0
22,"22018",332,243,242,3,1,"Independien",0
22,"22127",505,387,386,3,1,"Independien",0
22,"22142",98,81,79,1,2,"Independien",0
22,"22137",1071,729,719,6,10,"Independien",0
22,"22233",82,61,61,0,0,"Independien",0
22,"22045",89,66,66,0,0,"Independien",0
22,"22128",187,146,142,1,4,"Independien",0
22,"22232",96,73,70,2,3,"Independien",0
22,"22156",264,202,200,3,2,"Independien",0
22,"22040",148,123,121,2,2,"Independien",0
22,"22236",249,198,198,1,0,"Independien",0
22,"22089",315,227,222,6,5,"Independien",1
22,"22143",213,147,147,3,0,"Independien",0
22,"22239",89,78,76,4,2,"Independien",0
22,"22244",52,38,38,0,0,"Independien",0
22,"22214",128,94,92,0,2,"Independien",0
22,"22117",2497,1788,1770,16,18,"Independien",0
22,"22080",283,217,215,6,2,"Independien",0
22,"22015",324,238,236,3,2,"Independien",1
22,"22209",159,127,127,4,0,"Independien",0
22,"22135",192,146,144,0,2,"Independien",0
22,"22901",754,521,513,9,8,"Independien",0
22,"22225",2691,1849,1817,24,32,"Independien",5
22,"22229",114,81,81,0,0,"Independien",0
22,"22215",129,91,91,0,0,"Independien",0
22,"22029",127,101,100,2,1,"Independien",0
22,"22111",152,114,113,0,1,"Independien",0
22,"22087",72,48,48,1,0,"Independien",0
22,"22021",1970,1485,1469,14,16,"Independien",1
22,"22126",91,65,65,0,0,"Independien",0
22,"22003",143,119,119,0,0,"Independien",0
22,"22189",184,140,137,1,3,"Independien",0
22,"22254",1129,804,792,9,12,"Independien",0
22,"22020",114,90,90,2,0,"Independien",0
22,"22043",94,71,70,0,1,"Independien",0
22,"22202",136,112,112,0,0,"Independien",0
22,"22168",20,15,15,1,0,"Independien",0
22,"22001",226,166,166,0,0,"Independien",0
22,"22074",315,229,226,3,3,"Independien",0
22,"22213",3029,2225,2181,17,44,"Independien",2
22,"22039",869,682,681,5,1,"Independien",0
22,"22218",43,35,35,0,0,"Independien",0
22,"22223",79,63,62,0,1,"Independien",0
22,"22016",613,447,444,8,3,"Independien",0
22,"22063",175,140,140,2,0,"Independien",0
22,"22055",325,252,245,5,7,"Independien",0
22,"22144",248,195,195,0,0,"Independien",0
22,"22079",118,86,86,2,0,"Independien",0
22,"22902",219,162,160,1,2,"Independien",2
22,"22004",136,79,79,0,0,"Independien",0
22,"22044",254,191,188,3,3,"Independien",0
22,"22908",207,144,140,1,4,"Independien",0
22,"22103",680,527,522,8,5,"Independien",2
22,"22174",485,400,396,6,4,"Independien",0
22,"22125",38845,28287,27998,283,289,"Independien",13
22,"22155",77,58,58,2,0,"Independien",0
22,"22081",252,179,177,1,2,"Independien",0
22,"22058",190,152,151,2,1,"Independien",0
22,"22050",89,78,78,0,0,"Independien",0
22,"22042",118,102,100,1,2,"Independien",0
22,"22178",104,87,87,1,0,"Independien",0
22,"22028",379,297,293,1,4,"Independien",0
22,"22245",306,258,257,3,1,"Independien",0
22,"22193",283,235,234,3,1,"Independien",0
43,"43035",262,167,164,0,3,"ERC-CATSI",37
43,"43161",17217,11541,11478,67,63,"ERC-CATSI",2618
43,"43071",924,650,639,5,11,"ERC-CATSI",118
43,"43026",797,579,574,2,5,"ERC-CATSI",230
43,"43066",155,109,107,1,2,"ERC-CATSI",20
43,"43028",2717,1727,1715,7,12,"ERC-CATSI",210
43,"43040",338,255,247,2,8,"ERC-CATSI",88
43,"43061",48,31,29,0,2,"ERC-CATSI",6
43,"43121",604,393,387,4,6,"ERC-CATSI",170
43,"43154",132,101,100,1,1,"ERC-CATSI",39
43,"43062",274,223,219,7,4,"ERC-CATSI",30
43,"43010",316,253,251,2,2,"ERC-CATSI",66
43,"43077",463,307,305,7,2,"ERC-CATSI",36
43,"43110",272,169,167,1,2,"ERC-CATSI",24
43,"43041",226,160,156,0,4,"ERC-CATSI",32
43,"43101",148,107,107,4,0,"ERC-CATSI",33
43,"43171",14593,10107,10049,46,58,"ERC-CATSI",652
43,"43004",6326,4274,4227,38,47,"ERC-CATSI",1361
43,"43032",523,371,365,7,6,"ERC-CATSI",73
43,"43160",1273,888,879,7,9,"ERC-CATSI",172
43,"43128",908,623,616,4,7,"ERC-CATSI",167
43,"43166",1568,1117,1111,4,6,"ERC-CATSI",267
43,"43078",856,640,632,11,8,"ERC-CATSI",127
43,"43127",765,554,548,2,6,"ERC-CATSI",170
43,"43163",25252,17001,16847,74,154,"ERC-CATSI",2110
43,"43088",1966,1382,1372,6,10,"ERC-CATSI",412
43,"43132",365,269,264,1,5,"ERC-CATSI",88
43,"43095",2493,1723,1703,13,20,"ERC-CATSI",332
43,"43033",778,576,569,5,7,"ERC-CATSI",149
43,"43046",100,77,72,2,5,"ERC-CATSI",32
43,"43098",343,249,249,4,0,"ERC-CATSI",66
43,"43016",3418,2534,2512,15,22,"ERC-CATSI",324
43,"43064",2017,1384,1367,16,17,"ERC-CATSI",339
43,"43096",101,81,81,0,0,"ERC-CATSI",25
43,"43006",683,463,458,10,5,"ERC-CATSI",85
43,"43097",390,301,300,0,1,"ERC-CATSI",71
43,"43125",942,692,685,4,7,"ERC-CATSI",127
43,"43045",152,121,121,0,0,"ERC-CATSI",46
43,"43126",1177,848,844,8,4,"ERC-CATSI",186
43,"43099",305,234,233,1,1,"ERC-CATSI",41
43,"43133",5697,3726,3685,26,41,"ERC-CATSI",824
43,"43051",8545,5813,5735,26,78,"ERC-CATSI",382
43,"43048",807,569,564,8,5,"ERC-CATSI",119
43,"43147",521,379,377,1,2,"ERC-CATSI",118
43,"43038",21385,14375,14276,117,99,"ERC-CATSI",2072
43,"43158",89,55,53,3,2,"ERC-CATSI",14
43,"43157",352,273,271,3,2,"ERC-CATSI",91
43,"43112",284,178,178,0,0,"ERC-CATSI",67
43,"43162",4313,3132,3101,26,31,"ERC-CATSI",486
43,"43113",408,306,305,2,1,"ERC-CATSI",53
43,"43034",480,366,358,4,8,"ERC-CATSI",98
43,"43049",746,546,543,1,3,"ERC-CATSI",206
43,"43114",388,264,262,1,2,"ERC-CATSI",110
43,"43134",283,226,224,2,2,"ERC-CATSI",43
43,"43009",1431,968,958,5,10,"ERC-CATSI",266
43,"43052",954,662,653,9,9,"ERC-CATSI",182
43,"43131",4623,3059,3031,16,28,"ERC-CATSI",296
43,"43135",342,252,251,3,1,"ERC-CATSI",50
43,"43075",89,62,62,1,0,"ERC-CATSI",14
43,"43141",111,71,68,0,3,"ERC-CATSI",20
43,"43039",102,73,73,0,0,"ERC-CATSI",32
43,"43017",126,100,97,1,3,"ERC-CATSI",38
43,"43065",395,266,265,4,1,"ERC-CATSI",86
43,"43042",2148,1585,1573,7,12,"ERC-CATSI",384
43,"43013",4425,2975,2938,21,37,"ERC-CATSI",806
43,"43102",485,337,332,2,5,"ERC-CATSI",67
43,"43105",162,115,115,3,0,"ERC-CATSI",58
43,"43047",4128,2688,2652,19,36,"ERC-CATSI",365
43,"43176",799,565,562,5,3,"ERC-CATSI",175
43,"43156",3982,2748,2704,26,44,"ERC-CATSI",460
43,"43084",526,404,399,5,5,"ERC-CATSI",174
43,"43165",578,431,428,2,3,"ERC-CATSI",126
43,"43067",555,434,430,1,4,"ERC-CATSI",171
43,"43007",637,481,479,3,2,"ERC-CATSI",141
43,"43145",4084,2991,2954,36,37,"ERC-CATSI",654
43,"43023",231,173,171,3,2,"ERC-CATSI",48
43,"43172",351,243,242,8,1,"ERC-CATSI",65
43,"43074",1749,1284,1275,7,9,"ERC-CATSI",335
43,"43081",597,425,418,4,7,"ERC-CATSI",95
43,"43173",101,63,60,0,3,"ERC-CATSI",35
43,"43054",2836,1873,1852,21,21,"ERC-CATSI",599
43,"43024",1522,1044,1034,3,10,"ERC-CATSI",136
43,"43116",455,326,321,1,5,"ERC-CATSI",103
43,"43103",892,644,640,6,4,"ERC-CATSI",99
43,"43167",383,287,286,2,1,"ERC-CATSI",90
43,"43107",377,265,260,4,5,"ERC-CATSI",100
43,"43069",184,144,143,1,1,"ERC-CATSI",39
43,"43044",3975,2793,2758,34,35,"ERC-CATSI",408
43,"43106",810,544,532,7,12,"ERC-CATSI",144
43,"43146",38,30,30,1,0,"ERC-CATSI",15
43,"43076",447,318,317,0,1,"ERC-CATSI",126
43,"43072",105,77,77,1,0,"ERC-CATSI",22
43,"43086",5237,3507,3476,27,31,"ERC-CATSI",1066
43,"43117",144,110,109,1,1,"ERC-CATSI",21
43,"43012",3580,2669,2658,22,11,"ERC-CATSI",521
43,"43148",90177,64180,63784,349,396,"ERC-CATSI",8181
43,"43175",566,390,387,3,3,"ERC-CATSI",102
43,"43178",1335,939,933,9,6,"ERC-CATSI",190
43,"43005",3615,2376,2354,17,22,"ERC-CATSI",499
43,"43108",1775,1238,1229,8,9,"ERC-CATSI",304
43,"43073",85,60,59,0,1,"ERC-CATSI",20
43,"43036",843,545,542,0,3,"ERC-CATSI",106
43,"43015",112,91,91,1,0,"ERC-CATSI",34
43,"43056",871,532,521,6,11,"ERC-CATSI",220
43,"43169",457,364,356,3,8,"ERC-CATSI",148
43,"43115",155,116,116,2,0,"ERC-CATSI",22
43,"43129",4618,3148,3107,24,41,"ERC-CATSI",604
43,"43118",413,313,308,1,5,"ERC-CATSI",105
43,"43149",699,483,472,7,11,"ERC-CATSI",91
43,"43043",3128,2201,2186,11,15,"ERC-CATSI",416
43,"43159",80,57,57,0,0,"ERC-CATSI",14
43,"43037",16725,10917,10822,61,95,"ERC-CATSI",1150
43,"43003",322,234,233,3,1,"ERC-CATSI",37
43,"43014",14293,9441,9319,118,122,"ERC-CATSI",2234
43,"43139",2053,1332,1321,16,11,"ERC-CATSI",406
43,"43138",2677,1821,1786,22,35,"ERC-CATSI",257
43,"43027",165,133,133,2,0,"ERC-CATSI",33
43,"43150",1300,940,913,5,27,"ERC-CATSI",260
43,"43136",10353,6670,6622,50,48,"ERC-CATSI",1751
43,"43177",298,236,232,5,4,"ERC-CATSI",58
43,"43109",2560,1717,1700,13,17,"ERC-CATSI",147
43,"43089",281,211,211,1,0,"ERC-CATSI",30
43,"43140",2366,1731,1717,7,14,"ERC-CATSI",220
43,"43902",2760,1775,1739,22,36,"ERC-CATSI",288
43,"43170",857,603,599,8,4,"ERC-CATSI",172
43,"43120",444,293,288,0,5,"ERC-CATSI",41
43,"43055",1975,1471,1459,16,12,"ERC-CATSI",481
43,"43085",226,178,178,2,0,"ERC-CATSI",53
43,"43068",528,346,338,2,8,"ERC-CATSI",62
43,"43090",1070,625,620,4,5,"ERC-CATSI",58
43,"43008",309,185,181,5,4,"ERC-CATSI",21
43,"43137",1881,1344,1332,9,12,"ERC-CATSI",257
43,"43100",3268,2360,2352,16,8,"ERC-CATSI",313
43,"43903",2383,1420,1407,20,13,"ERC-CATSI",418
43,"43025",604,431,428,5,3,"ERC-CATSI",114
43,"43019",1371,904,886,4,18,"ERC-CATSI",189
43,"43079",364,258,257,1,1,"ERC-CATSI",61
43,"43151",109,82,82,1,0,"ERC-CATSI",38
43,"43059",253,195,195,2,0,"ERC-CATSI",69
43,"43029",323,237,237,4,0,"ERC-CATSI",123
43,"43168",93,64,64,2,0,"ERC-CATSI",23
43,"43142",1114,781,771,4,10,"ERC-CATSI",207
43,"43060",2887,2019,1990,16,29,"ERC-CATSI",601
43,"43111",2049,1383,1366,9,17,"ERC-CATSI",190
43,"43904",2908,1799,1760,38,39,"ERC-CATSI",446
43,"43050",2521,1654,1640,11,14,"ERC-CATSI",195
43,"43080",244,184,184,2,0,"ERC-CATSI",53
43,"43091",136,94,94,2,0,"ERC-CATSI",29
43,"43070",236,194,193,0,1,"ERC-CATSI",75
43,"43901",8765,5306,5212,81,94,"ERC-CATSI",1076
43,"43092",7059,4603,4563,21,40,"ERC-CATSI",633
43,"43030",430,311,308,1,3,"ERC-CATSI",69
43,"43057",40,25,25,1,0,"ERC-CATSI",11
43,"43119",793,559,556,7,3,"ERC-CATSI",107
43,"43143",56,47,47,1,0,"ERC-CATSI",6
43,"43122",106,84,84,0,0,"ERC-CATSI",15
43,"43020",2202,1631,1614,13,17,"ERC-CATSI",189
43,"43123",70276,47897,47547,302,350,"ERC-CATSI",7396
43,"43905",14371,9191,9136,41,55,"ERC-CATSI",861
43,"43153",10676,7241,7190,29,51,"ERC-CATSI",1320
43,"43031",1466,1062,1056,8,6,"ERC-CATSI",280
43,"43093",3909,2625,2597,44,28,"ERC-CATSI",520
43,"43906",2117,1454,1441,3,13,"ERC-CATSI",249
43,"43011",1083,824,819,5,5,"ERC-CATSI",257
43,"43021",360,248,247,6,1,"ERC-CATSI",72
43,"43164",300,218,217,0,1,"ERC-CATSI",21
43,"43130",196,128,127,2,1,"ERC-CATSI",44
43,"43058",93,68,67,1,1,"ERC-CATSI",30
43,"43018",410,320,316,1,4,"ERC-CATSI",83
43,"43144",1258,914,911,3,3,"ERC-CATSI",230
43,"43082",372,291,285,0,6,"ERC-CATSI",76
43,"43174",138,99,99,1,0,"ERC-CATSI",49
43,"43022",1508,1028,1015,20,13,"ERC-CATSI",212
43,"43001",695,474,472,4,2,"ERC-CATSI",112
43,"43124",484,347,343,6,4,"ERC-CATSI",77
43,"43094",2175,1506,1480,11,26,"ERC-CATSI",416
43,"43155",22874,15046,14893,137,153,"ERC-CATSI",2896
43,"43907",4382,3174,3147,14,27,"ERC-CATSI",184
43,"43104",1798,1285,1268,14,17,"ERC-CATSI",500
43,"43053",191,149,147,1,2,"ERC-CATSI",46
43,"43152",450,338,330,2,8,"ERC-CATSI",93
43,"43083",140,95,94,0,1,"ERC-CATSI",11
43,"43063",560,363,360,8,3,"ERC-CATSI",72
43,"43002",1821,1294,1266,12,28,"ERC-CATSI",114
43,"43156",3982,2748,2704,26,44,"RECORTES CE",11
43,"43011",1083,824,819,5,5,"RECORTES CE",0
43,"43043",3128,2201,2186,11,15,"RECORTES CE",6
43,"43006",683,463,458,10,5,"RECORTES CE",0
43,"43053",191,149,147,1,2,"RECORTES CE",0
43,"43170",857,603,599,8,4,"RECORTES CE",1
43,"43098",343,249,249,4,0,"RECORTES CE",0
43,"43126",1177,848,844,8,4,"RECORTES CE",4
43,"43030",430,311,308,1,3,"RECORTES CE",2
43,"43081",597,425,418,4,7,"RECORTES CE",0
43,"43108",1775,1238,1229,8,9,"RECORTES CE",1
43,"43027",165,133,133,2,0,"RECORTES CE",0
43,"43102",485,337,332,2,5,"RECORTES CE",0
43,"43111",2049,1383,1366,9,17,"RECORTES CE",3
43,"43141",111,71,68,0,3,"RECORTES CE",0
43,"43035",262,167,164,0,3,"RECORTES CE",0
43,"43110",272,169,167,1,2,"RECORTES CE",0
43,"43022",1508,1028,1015,20,13,"RECORTES CE",1
43,"43057",40,25,25,1,0,"RECORTES CE",0
43,"43013",4425,2975,2938,21,37,"RECORTES CE",7
43,"43032",523,371,365,7,6,"RECORTES CE",0
43,"43132",365,269,264,1,5,"RECORTES CE",0
43,"43080",244,184,184,2,0,"RECORTES CE",0
43,"43073",85,60,59,0,1,"RECORTES CE",0
43,"43128",908,623,616,4,7,"RECORTES CE",1
43,"43026",797,579,574,2,5,"RECORTES CE",1
43,"43101",148,107,107,4,0,"RECORTES CE",0
43,"43041",226,160,156,0,4,"RECORTES CE",0
43,"43904",2908,1799,1760,38,39,"RECORTES CE",3
43,"43116",455,326,321,1,5,"RECORTES CE",0
43,"43167",383,287,286,2,1,"RECORTES CE",0
43,"43150",1300,940,913,5,27,"RECORTES CE",1
43,"43004",6326,4274,4227,38,47,"RECORTES CE",9
43,"43906",2117,1454,1441,3,13,"RECORTES CE",4
43,"43177",298,236,232,5,4,"RECORTES CE",0
43,"43014",14293,9441,9319,118,122,"RECORTES CE",16
43,"43106",810,544,532,7,12,"RECORTES CE",1
43,"43009",1431,968,958,5,10,"RECORTES CE",1
43,"43131",4623,3059,3031,16,28,"RECORTES CE",9
43,"43039",102,73,73,0,0,"RECORTES CE",0
43,"43018",410,320,316,1,4,"RECORTES CE",0
43,"43072",105,77,77,1,0,"RECORTES CE",0
43,"43138",2677,1821,1786,22,35,"RECORTES CE",3
43,"43145",4084,2991,2954,36,37,"RECORTES CE",10
43,"43019",1371,904,886,4,18,"RECORTES CE",3
43,"43158",89,55,53,3,2,"RECORTES CE",1
43,"43178",1335,939,933,9,6,"RECORTES CE",1
43,"43060",2887,2019,1990,16,29,"RECORTES CE",2
43,"43082",372,291,285,0,6,"RECORTES CE",0
43,"43115",155,116,116,2,0,"RECORTES CE",0
43,"43070",236,194,193,0,1,"RECORTES CE",0
43,"43067",555,434,430,1,4,"RECORTES CE",0
43,"43105",162,115,115,3,0,"RECORTES CE",0
43,"43901",8765,5306,5212,81,94,"RECORTES CE",11
43,"43003",322,234,233,3,1,"RECORTES CE",0
43,"43095",2493,1723,1703,13,20,"RECORTES CE",4
43,"43012",3580,2669,2658,22,11,"RECORTES CE",3
43,"43097",390,301,300,0,1,"RECORTES CE",1
43,"43015",112,91,91,1,0,"RECORTES CE",0
43,"43123",70276,47897,47547,302,350,"RECORTES CE",121
43,"43163",25252,17001,16847,74,154,"RECORTES CE",40
43,"43046",100,77,72,2,5,"RECORTES CE",0
43,"43068",528,346,338,2,8,"RECORTES CE",0
43,"43146",38,30,30,1,0,"RECORTES CE",0
43,"43017",126,100,97,1,3,"RECORTES CE",0
43,"43173",101,63,60,0,3,"RECORTES CE",0
43,"43089",281,211,211,1,0,"RECORTES CE",0
43,"43075",89,62,62,1,0,"RECORTES CE",0
43,"43902",2760,1775,1739,22,36,"RECORTES CE",2
43,"43113",408,306,305,2,1,"RECORTES CE",1
43,"43148",90177,64180,63784,349,396,"RECORTES CE",215
43,"43010",316,253,251,2,2,"RECORTES CE",0
43,"43164",300,218,217,0,1,"RECORTES CE",0
43,"43147",521,379,377,1,2,"RECORTES CE",0
43,"43051",8545,5813,5735,26,78,"RECORTES CE",13
43,"43137",1881,1344,1332,9,12,"RECORTES CE",0
43,"43062",274,223,219,7,4,"RECORTES CE",0
43,"43059",253,195,195,2,0,"RECORTES CE",0
43,"43065",395,266,265,4,1,"RECORTES CE",1
43,"43151",109,82,82,1,0,"RECORTES CE",0
43,"43083",140,95,94,0,1,"RECORTES CE",1
43,"43090",1070,625,620,4,5,"RECORTES CE",2
43,"43175",566,390,387,3,3,"RECORTES CE",2
43,"43161",17217,11541,11478,67,63,"RECORTES CE",33
43,"43120",444,293,288,0,5,"RECORTES CE",0
43,"43086",5237,3507,3476,27,31,"RECORTES CE",11
43,"43040",338,255,247,2,8,"RECORTES CE",0
43,"43125",942,692,685,4,7,"RECORTES CE",1
43,"43142",1114,781,771,4,10,"RECORTES CE",2
43,"43016",3418,2534,2512,15,22,"RECORTES CE",10
43,"43063",560,363,360,8,3,"RECORTES CE",0
43,"43165",578,431,428,2,3,"RECORTES CE",2
43,"43047",4128,2688,2652,19,36,"RECORTES CE",5
43,"43130",196,128,127,2,1,"RECORTES CE",0
43,"43034",480,366,358,4,8,"RECORTES CE",0
43,"43088",1966,1382,1372,6,10,"RECORTES CE",5
43,"43042",2148,1585,1573,7,12,"RECORTES CE",2
43,"43049",746,546,543,1,3,"RECORTES CE",2
43,"43054",2836,1873,1852,21,21,"RECORTES CE",1
43,"43166",1568,1117,1111,4,6,"RECORTES CE",4
43,"43084",526,404,399,5,5,"RECORTES CE",0
43,"43064",2017,1384,1367,16,17,"RECORTES CE",1
43,"43133",5697,3726,3685,26,41,"RECORTES CE",7
43,"43129",4618,3148,3107,24,41,"RECORTES CE",3
43,"43092",7059,4603,4563,21,40,"RECORTES CE",12
43,"43069",184,144,143,1,1,"RECORTES CE",0
43,"43028",2717,1727,1715,7,12,"RECORTES CE",7
43,"43903",2383,1420,1407,20,13,"RECORTES CE",1
43,"43096",101,81,81,0,0,"RECORTES CE",0
43,"43157",352,273,271,3,2,"RECORTES CE",0
43,"43136",10353,6670,6622,50,48,"RECORTES CE",11
43,"43144",1258,914,911,3,3,"RECORTES CE",2
43,"43045",152,121,121,0,0,"RECORTES CE",2
43,"43079",364,258,257,1,1,"RECORTES CE",0
43,"43127",765,554,548,2,6,"RECORTES CE",0
43,"43103",892,644,640,6,4,"RECORTES CE",0
43,"43008",309,185,181,5,4,"RECORTES CE",0
43,"43104",1798,1285,1268,14,17,"RECORTES CE",3
43,"43036",843,545,542,0,3,"RECORTES CE",3
43,"43134",283,226,224,2,2,"RECORTES CE",0
43,"43154",132,101,100,1,1,"RECORTES CE",0
43,"43155",22874,15046,14893,137,153,"RECORTES CE",24
43,"43168",93,64,64,2,0,"RECORTES CE",0
43,"43085",226,178,178,2,0,"RECORTES CE",0
43,"43907",4382,3174,3147,14,27,"RECORTES CE",11
43,"43094",2175,1506,1480,11,26,"RECORTES CE",3
43,"43056",871,532,521,6,11,"RECORTES CE",1
43,"43037",16725,10917,10822,61,95,"RECORTES CE",27
43,"43066",155,109,107,1,2,"RECORTES CE",0
43,"43122",106,84,84,0,0,"RECORTES CE",0
43,"43118",413,313,308,1,5,"RECORTES CE",0
43,"43139",2053,1332,1321,16,11,"RECORTES CE",1
43,"43152",450,338,330,2,8,"RECORTES CE",0
43,"43135",342,252,251,3,1,"RECORTES CE",1
43,"43160",1273,888,879,7,9,"RECORTES CE",0
43,"43091",136,94,94,2,0,"RECORTES CE",0
43,"43076",447,318,317,0,1,"RECORTES CE",0
43,"43007",637,481,479,3,2,"RECORTES CE",1
43,"43149",699,483,472,7,11,"RECORTES CE",1
43,"43119",793,559,556,7,3,"RECORTES CE",4
43,"43117",144,110,109,1,1,"RECORTES CE",0
43,"43143",56,47,47,1,0,"RECORTES CE",0
43,"43099",305,234,233,1,1,"RECORTES CE",0
43,"43905",14371,9191,9136,41,55,"RECORTES CE",23
43,"43124",484,347,343,6,4,"RECORTES CE",0
43,"43171",14593,10107,10049,46,58,"RECORTES CE",27
43,"43174",138,99,99,1,0,"RECORTES CE",0
43,"43055",1975,1471,1459,16,12,"RECORTES CE",2
43,"43078",856,640,632,11,8,"RECORTES CE",0
43,"43058",93,68,67,1,1,"RECORTES CE",0
43,"43107",377,265,260,4,5,"RECORTES CE",0
43,"43162",4313,3132,3101,26,31,"RECORTES CE",5
43,"43093",3909,2625,2597,44,28,"RECORTES CE",4
43,"43029",323,237,237,4,0,"RECORTES CE",0
43,"43021",360,248,247,6,1,"RECORTES CE",2
43,"43169",457,364,356,3,8,"RECORTES CE",0
43,"43001",695,474,472,4,2,"RECORTES CE",0
43,"43050",2521,1654,1640,11,14,"RECORTES CE",5
43,"43033",778,576,569,5,7,"RECORTES CE",4
43,"43140",2366,1731,1717,7,14,"RECORTES CE",7
43,"43114",388,264,262,1,2,"RECORTES CE",0
43,"43005",3615,2376,2354,17,22,"RECORTES CE",6
43,"43052",954,662,653,9,9,"RECORTES CE",2
43,"43031",1466,1062,1056,8,6,"RECORTES CE",1
43,"43112",284,178,178,0,0,"RECORTES CE",0
43,"43024",1522,1044,1034,3,10,"RECORTES CE",1
43,"43176",799,565,562,5,3,"RECORTES CE",0
43,"43153",10676,7241,7190,29,51,"RECORTES CE",27
43,"43002",1821,1294,1266,12,28,"RECORTES CE",0
43,"43077",463,307,305,7,2,"RECORTES CE",0
43,"43109",2560,1717,1700,13,17,"RECORTES CE",4
43,"43044",3975,2793,2758,34,35,"RECORTES CE",3
43,"43172",351,243,242,8,1,"RECORTES CE",0
43,"43074",1749,1284,1275,7,9,"RECORTES CE",3
43,"43038",21385,14375,14276,117,99,"RECORTES CE",25
43,"43025",604,431,428,5,3,"RECORTES CE",0
43,"43121",604,393,387,4,6,"RECORTES CE",0
43,"43100",3268,2360,2352,16,8,"RECORTES CE",5
43,"43061",48,31,29,0,2,"RECORTES CE",0
43,"43023",231,173,171,3,2,"RECORTES CE",1
43,"43020",2202,1631,1614,13,17,"RECORTES CE",3
43,"43048",807,569,564,8,5,"RECORTES CE",2
43,"43071",924,650,639,5,11,"RECORTES CE",1
43,"43159",80,57,57,0,0,"RECORTES CE",0
43,"43032",523,371,365,7,6,"DL",112
43,"43091",136,94,94,2,0,"DL",17
43,"43081",597,425,418,4,7,"DL",110
43,"43903",2383,1420,1407,20,13,"DL",253
43,"43062",274,223,219,7,4,"DL",49
43,"43059",253,195,195,2,0,"DL",79
43,"43022",1508,1028,1015,20,13,"DL",159
43,"43105",162,115,115,3,0,"DL",24
43,"43073",85,60,59,0,1,"DL",20
43,"43084",526,404,399,5,5,"DL",72
43,"43030",430,311,308,1,3,"DL",71
43,"43042",2148,1585,1573,7,12,"DL",388
43,"43157",352,273,271,3,2,"DL",96
43,"43072",105,77,77,1,0,"DL",24
43,"43008",309,185,181,5,4,"DL",18
43,"43061",48,31,29,0,2,"DL",17
43,"43077",463,307,305,7,2,"DL",23
43,"43140",2366,1731,1717,7,14,"DL",140
43,"43021",360,248,247,6,1,"DL",57
43,"43079",364,258,257,1,1,"DL",97
43,"43122",106,84,84,0,0,"DL",21
43,"43039",102,73,73,0,0,"DL",24
43,"43118",413,313,308,1,5,"DL",82
43,"43005",3615,2376,2354,17,22,"DL",437
43,"43131",4623,3059,3031,16,28,"DL",277
43,"43096",101,81,81,0,0,"DL",23
43,"43018",410,320,316,1,4,"DL",159
43,"43112",284,178,178,0,0,"DL",58
43,"43901",8765,5306,5212,81,94,"DL",938
43,"43170",857,603,599,8,4,"DL",184
43,"43095",2493,1723,1703,13,20,"DL",284
43,"43128",908,623,616,4,7,"DL",127
43,"43080",244,184,184,2,0,"DL",64
43,"43033",778,576,569,5,7,"DL",118
43,"43013",4425,2975,2938,21,37,"DL",538
43,"43102",485,337,332,2,5,"DL",69
43,"43121",604,393,387,4,6,"DL",77
43,"43136",10353,6670,6622,50,48,"DL",1016
43,"43067",555,434,430,1,4,"DL",116
43,"43050",2521,1654,1640,11,14,"DL",175
43,"43127",765,554,548,2,6,"DL",168
43,"43006",683,463,458,10,5,"DL",71
43,"43036",843,545,542,0,3,"DL",101
43,"43054",2836,1873,1852,21,21,"DL",531
43,"43058",93,68,67,1,1,"DL",23
43,"43123",70276,47897,47547,302,350,"DL",7222
43,"43133",5697,3726,3685,26,41,"DL",437
43,"43146",38,30,30,1,0,"DL",8
43,"43078",856,640,632,11,8,"DL",176
43,"43023",231,173,171,3,2,"DL",36
43,"43160",1273,888,879,7,9,"DL",125
43,"43165",578,431,428,2,3,"DL",157
43,"43114",388,264,262,1,2,"DL",62
43,"43046",100,77,72,2,5,"DL",18
43,"43124",484,347,343,6,4,"DL",98
43,"43099",305,234,233,1,1,"DL",121
43,"43069",184,144,143,1,1,"DL",34
43,"43002",1821,1294,1266,12,28,"DL",169
43,"43082",372,291,285,0,6,"DL",111
43,"43120",444,293,288,0,5,"DL",47
43,"43117",144,110,109,1,1,"DL",36
43,"43015",112,91,91,1,0,"DL",29
43,"43130",196,128,127,2,1,"DL",39
43,"43043",3128,2201,2186,11,15,"DL",262
43,"43155",22874,15046,14893,137,153,"DL",2753
43,"43141",111,71,68,0,3,"DL",17
43,"43162",4313,3132,3101,26,31,"DL",481
43,"43012",3580,2669,2658,22,11,"DL",409
43,"43137",1881,1344,1332,9,12,"DL",228
43,"43040",338,255,247,2,8,"DL",85
43,"43016",3418,2534,2512,15,22,"DL",333
43,"43108",1775,1238,1229,8,9,"DL",341
43,"43053",191,149,147,1,2,"DL",29
43,"43135",342,252,251,3,1,"DL",125
43,"43149",699,483,472,7,11,"DL",96
43,"43057",40,25,25,1,0,"DL",6
43,"43020",2202,1631,1614,13,17,"DL",230
43,"43156",3982,2748,2704,26,44,"DL",413
43,"43129",4618,3148,3107,24,41,"DL",975
43,"43178",1335,939,933,9,6,"DL",213
43,"43034",480,366,358,4,8,"DL",95
43,"43172",351,243,242,8,1,"DL",66
43,"43092",7059,4603,4563,21,40,"DL",601
43,"43037",16725,10917,10822,61,95,"DL",1125
43,"43153",10676,7241,7190,29,51,"DL",869
43,"43119",793,559,556,7,3,"DL",79
43,"43085",226,178,178,2,0,"DL",41
43,"43027",165,133,133,2,0,"DL",71
43,"43171",14593,10107,10049,46,58,"DL",920
43,"43014",14293,9441,9319,118,122,"DL",1259
43,"43038",21385,14375,14276,117,99,"DL",1833
43,"43167",383,287,286,2,1,"DL",84
43,"43098",343,249,249,4,0,"DL",86
43,"43907",4382,3174,3147,14,27,"DL",252
43,"43010",316,253,251,2,2,"DL",70
43,"43177",298,236,232,5,4,"DL",67
43,"43168",93,64,64,2,0,"DL",24
43,"43154",132,101,100,1,1,"DL",27
43,"43035",262,167,164,0,3,"DL",60
43,"43134",283,226,224,2,2,"DL",40
43,"43049",746,546,543,1,3,"DL",166
43,"43175",566,390,387,3,3,"DL",111
43,"43076",447,318,317,0,1,"DL",69
43,"43158",89,55,53,3,2,"DL",21
43,"43086",5237,3507,3476,27,31,"DL",800
43,"43083",140,95,94,0,1,"DL",30
43,"43055",1975,1471,1459,16,12,"DL",439
43,"43065",395,266,265,4,1,"DL",78
43,"43138",2677,1821,1786,22,35,"DL",327
43,"43094",2175,1506,1480,11,26,"DL",336
43,"43060",2887,2019,1990,16,29,"DL",420
43,"43132",365,269,264,1,5,"DL",72
43,"43026",797,579,574,2,5,"DL",140
43,"43031",1466,1062,1056,8,6,"DL",334
43,"43041",226,160,156,0,4,"DL",26
43,"43025",604,431,428,5,3,"DL",55
43,"43150",1300,940,913,5,27,"DL",257
43,"43044",3975,2793,2758,34,35,"DL",218
43,"43166",1568,1117,1111,4,6,"DL",157
43,"43063",560,363,360,8,3,"DL",74
43,"43056",871,532,521,6,11,"DL",94
43,"43047",4128,2688,2652,19,36,"DL",229
43,"43139",2053,1332,1321,16,11,"DL",496
43,"43017",126,100,97,1,3,"DL",28
43,"43116",455,326,321,1,5,"DL",118
43,"43068",528,346,338,2,8,"DL",32
43,"43151",109,82,82,1,0,"DL",18
43,"43174",138,99,99,1,0,"DL",30
43,"43905",14371,9191,9136,41,55,"DL",801
43,"43045",152,121,121,0,0,"DL",48
43,"43145",4084,2991,2954,36,37,"DL",679
43,"43902",2760,1775,1739,22,36,"DL",198
43,"43075",89,62,62,1,0,"DL",28
43,"43071",924,650,639,5,11,"DL",204
43,"43004",6326,4274,4227,38,47,"DL",469
43,"43164",300,218,217,0,1,"DL",17
43,"43001",695,474,472,4,2,"DL",124
43,"43144",1258,914,911,3,3,"DL",129
43,"43090",1070,625,620,4,5,"DL",26
43,"43904",2908,1799,1760,38,39,"DL",245
43,"43100",3268,2360,2352,16,8,"DL",261
43,"43093",3909,2625,2597,44,28,"DL",612
43,"43028",2717,1727,1715,7,12,"DL",291
43,"43101",148,107,107,4,0,"DL",41
43,"43104",1798,1285,1268,14,17,"DL",280
43,"43111",2049,1383,1366,9,17,"DL",135
43,"43110",272,169,167,1,2,"DL",64
43,"43148",90177,64180,63784,349,396,"DL",6558
43,"43029",323,237,237,4,0,"DL",51
43,"43152",450,338,330,2,8,"DL",117
43,"43115",155,116,116,2,0,"DL",53
43,"43009",1431,968,958,5,10,"DL",192
43,"43051",8545,5813,5735,26,78,"DL",368
43,"43089",281,211,211,1,0,"DL",42
43,"43109",2560,1717,1700,13,17,"DL",128
43,"43143",56,47,47,1,0,"DL",25
43,"43064",2017,1384,1367,16,17,"DL",404
43,"43126",1177,848,844,8,4,"DL",194
43,"43176",799,565,562,5,3,"DL",215
43,"43107",377,265,260,4,5,"DL",45
43,"43048",807,569,564,8,5,"DL",99
43,"43052",954,662,653,9,9,"DL",136
43,"43906",2117,1454,1441,3,13,"DL",451
43,"43147",521,379,377,1,2,"DL",159
43,"43011",1083,824,819,5,5,"DL",230
43,"43097",390,301,300,0,1,"DL",100
43,"43173",101,63,60,0,3,"DL",11
43,"43161",17217,11541,11478,67,63,"DL",2593
43,"43125",942,692,685,4,7,"DL",129
43,"43113",408,306,305,2,1,"DL",104
43,"43088",1966,1382,1372,6,10,"DL",289
43,"43019",1371,904,886,4,18,"DL",193
43,"43024",1522,1044,1034,3,10,"DL",113
43,"43163",25252,17001,16847,74,154,"DL",1922
43,"43066",155,109,107,1,2,"DL",28
43,"43007",637,481,479,3,2,"DL",143
43,"43074",1749,1284,1275,7,9,"DL",327
43,"43106",810,544,532,7,12,"DL",97
43,"43103",892,644,640,6,4,"DL",66
43,"43159",80,57,57,0,0,"DL",28
43,"43070",236,194,193,0,1,"DL",40
43,"43142",1114,781,771,4,10,"DL",237
43,"43003",322,234,233,3,1,"DL",40
43,"43169",457,364,356,3,8,"DL",98
22,"22018",332,243,242,3,1,"PODEMOS-Aho",33
22,"22054",1542,1126,1106,20,20,"PODEMOS-Aho",291
22,"22107",123,79,78,2,1,"PODEMOS-Aho",23
22,"22013",295,235,233,2,2,"PODEMOS-Aho",29
22,"22230",290,224,223,2,1,"PODEMOS-Aho",43
22,"22102",184,160,159,1,1,"PODEMOS-Aho",34
22,"22168",20,15,15,1,0,"PODEMOS-Aho",2
22,"22037",116,95,94,1,1,"PODEMOS-Aho",26
22,"22903",654,542,536,3,6,"PODEMOS-Aho",59
22,"22165",490,375,372,2,3,"PODEMOS-Aho",40
22,"22039",869,682,681,5,1,"PODEMOS-Aho",162
22,"22076",305,224,223,0,1,"PODEMOS-Aho",44
22,"22226",774,591,589,2,2,"PODEMOS-Aho",84
22,"22087",72,48,48,1,0,"PODEMOS-Aho",3
22,"22060",1165,885,879,3,6,"PODEMOS-Aho",155
22,"22106",24,17,17,0,0,"PODEMOS-Aho",6
22,"22103",680,527,522,8,5,"PODEMOS-Aho",79
22,"22908",207,144,140,1,4,"PODEMOS-Aho",27
22,"22188",87,66,66,1,0,"PODEMOS-Aho",11
22,"22021",1970,1485,1469,14,16,"PODEMOS-Aho",229
22,"22047",247,213,212,2,1,"PODEMOS-Aho",31
22,"22223",79,63,62,0,1,"PODEMOS-Aho",24
22,"22149",302,236,236,2,0,"PODEMOS-Aho",39
22,"22167",498,397,388,7,9,"PODEMOS-Aho",45
22,"22212",84,70,70,1,0,"PODEMOS-Aho",14
22,"22046",740,578,570,6,8,"PODEMOS-Aho",48
22,"22084",534,413,411,3,2,"PODEMOS-Aho",101
22,"22061",6685,4796,4740,38,56,"PODEMOS-Aho",841
22,"22019",180,156,155,0,1,"PODEMOS-Aho",31
22,"22214",128,94,92,0,2,"PODEMOS-Aho",7
22,"22115",364,270,267,4,3,"PODEMOS-Aho",39
22,"22008",173,138,138,3,0,"PODEMOS-Aho",19
22,"22059",1137,839,828,7,11,"PODEMOS-Aho",194
22,"22041",163,127,126,4,1,"PODEMOS-Aho",15
22,"22909",318,238,234,2,4,"PODEMOS-Aho",50
22,"22017",864,658,651,7,7,"PODEMOS-Aho",93
22,"22197",479,378,373,6,5,"PODEMOS-Aho",36
22,"22043",94,71,70,0,1,"PODEMOS-Aho",9
22,"22229",114,81,81,0,0,"PODEMOS-Aho",20
22,"22131",83,63,63,3,0,"PODEMOS-Aho",7
22,"22077",381,295,293,5,2,"PODEMOS-Aho",18
22,"22195",235,190,189,2,1,"PODEMOS-Aho",37
22,"22080",283,217,215,6,2,"PODEMOS-Aho",27
22,"22173",234,158,157,0,1,"PODEMOS-Aho",50
22,"22119",1296,950,940,3,10,"PODEMOS-Aho",175
22,"22221",80,60,59,0,1,"PODEMOS-Aho",15
22,"22190",113,83,83,2,0,"PODEMOS-Aho",13
22,"22066",707,512,508,8,4,"PODEMOS-Aho",162
22,"22199",7029,5024,4977,55,47,"PODEMOS-Aho",1098
22,"22025",1071,726,712,13,14,"PODEMOS-Aho",100
22,"22110",751,563,558,3,5,"PODEMOS-Aho",87
22,"22193",283,235,234,3,1,"PODEMOS-Aho",42
22,"22007",797,607,603,13,4,"PODEMOS-Aho",68
22,"22215",129,91,91,0,0,"PODEMOS-Aho",21
22,"22251",371,283,281,4,2,"PODEMOS-Aho",21
22,"22218",43,35,35,0,0,"PODEMOS-Aho",6
22,"22075",126,82,81,2,1,"PODEMOS-Aho",12
22,"22032",107,74,71,0,3,"PODEMOS-Aho",12
22,"22006",298,217,215,1,2,"PODEMOS-Aho",62
22,"22904",835,600,594,6,6,"PODEMOS-Aho",89
22,"22127",505,387,386,3,1,"PODEMOS-Aho",84
22,"22177",102,77,77,2,0,"PODEMOS-Aho",11
22,"22901",754,521,513,9,8,"PODEMOS-Aho",127
22,"22042",118,102,100,1,2,"PODEMOS-Aho",16
22,"22125",38845,28287,27998,283,289,"PODEMOS-Aho",5440
22,"22122",62,49,49,1,0,"PODEMOS-Aho",10
22,"22022",558,431,427,2,4,"PODEMOS-Aho",79
22,"22178",104,87,87,1,0,"PODEMOS-Aho",6
22,"22151",93,68,68,0,0,"PODEMOS-Aho",9
22,"22242",64,45,44,1,1,"PODEMOS-Aho",2
22,"22044",254,191,188,3,3,"PODEMOS-Aho",46
22,"22133",117,89,89,4,0,"PODEMOS-Aho",16
22,"22205",434,334,333,2,1,"PODEMOS-Aho",47
22,"22045",89,66,66,0,0,"PODEMOS-Aho",9
22,"22105",118,87,86,1,1,"PODEMOS-Aho",13
22,"22252",122,93,91,1,2,"PODEMOS-Aho",16
22,"22174",485,400,396,6,4,"PODEMOS-Aho",48
22,"22058",190,152,151,2,1,"PODEMOS-Aho",36
22,"22141",118,90,89,1,1,"PODEMOS-Aho",15
22,"22126",91,65,65,0,0,"PODEMOS-Aho",2
22,"22182",256,177,176,2,1,"PODEMOS-Aho",41
22,"22067",65,45,45,1,0,"PODEMOS-Aho",10
22,"22027",325,218,214,0,4,"PODEMOS-Aho",32
22,"22202",136,112,112,0,0,"PODEMOS-Aho",20
22,"22170",642,518,509,4,9,"PODEMOS-Aho",118
22,"22094",101,77,77,1,0,"PODEMOS-Aho",15
22,"22249",119,97,97,1,0,"PODEMOS-Aho",26
22,"22150",464,348,348,1,0,"PODEMOS-Aho",87
22,"22906",180,146,143,1,3,"PODEMOS-Aho",21
22,"22072",192,148,147,1,1,"PODEMOS-Aho",39
22,"22024",225,174,173,0,1,"PODEMOS-Aho",48
22,"22130",10106,6957,6909,57,48,"PODEMOS-Aho",1405
22,"22250",347,258,256,5,2,"PODEMOS-Aho",68
22,"22209",159,127,127,4,0,"PODEMOS-Aho",39
22,"22143",213,147,147,3,0,"PODEMOS-Aho",19
22,"22220",169,123,122,2,1,"PODEMOS-Aho",10
22,"22050",89,78,78,0,0,"PODEMOS-Aho",7
22,"22088",157,116,116,1,0,"PODEMOS-Aho",24
22,"22112",9592,6871,6820,76,51,"PODEMOS-Aho",1195
22,"22176",174,140,140,1,0,"PODEMOS-Aho",14
22,"22096",297,248,248,0,0,"PODEMOS-Aho",52
22,"22078",453,323,319,6,4,"PODEMOS-Aho",96
22,"22095",73,48,48,1,0,"PODEMOS-Aho",12
22,"22181",93,62,62,1,0,"PODEMOS-Aho",10
22,"22225",2691,1849,1817,24,32,"PODEMOS-Aho",345
22,"22144",248,195,195,0,0,"PODEMOS-Aho",26
22,"22254",1129,804,792,9,12,"PODEMOS-Aho",109
22,"22135",192,146,144,0,2,"PODEMOS-Aho",22
22,"22246",77,51,50,0,1,"PODEMOS-Aho",14
22,"22020",114,90,90,2,0,"PODEMOS-Aho",18
22,"22244",52,38,38,0,0,"PODEMOS-Aho",8
22,"22113",494,362,361,3,1,"PODEMOS-Aho",61
22,"22117",2497,1788,1770,16,18,"PODEMOS-Aho",346
22,"22203",82,68,67,0,1,"PODEMOS-Aho",7
22,"22248",118,92,91,0,1,"PODEMOS-Aho",18
22,"22905",294,224,224,2,0,"PODEMOS-Aho",23
22,"22069",435,340,338,3,2,"PODEMOS-Aho",51
22,"22014",245,184,183,2,1,"PODEMOS-Aho",27
22,"22136",815,596,595,6,1,"PODEMOS-Aho",65
22,"22234",802,600,597,7,3,"PODEMOS-Aho",79
22,"22243",45,32,32,0,0,"PODEMOS-Aho",0
22,"22074",315,229,226,3,3,"PODEMOS-Aho",62
22,"22253",61,51,50,0,1,"PODEMOS-Aho",7
22,"22029",127,101,100,2,1,"PODEMOS-Aho",7
22,"22111",152,114,113,0,1,"PODEMOS-Aho",10
22,"22160",209,161,161,3,0,"PODEMOS-Aho",40
22,"22247",30,23,22,0,1,"PODEMOS-Aho",6
22,"22109",265,207,206,2,1,"PODEMOS-Aho",39
22,"22142",98,81,79,1,2,"PODEMOS-Aho",15
22,"22011",89,70,70,1,0,"PODEMOS-Aho",13
22,"22239",89,78,76,4,2,"PODEMOS-Aho",9
22,"22175",197,140,140,0,0,"PODEMOS-Aho",28
22,"22001",226,166,166,0,0,"PODEMOS-Aho",17
22,"22009",619,463,461,5,2,"PODEMOS-Aho",115
22,"22184",188,156,156,2,0,"PODEMOS-Aho",19
22,"22062",162,113,113,3,0,"PODEMOS-Aho",21
22,"22907",1459,1112,1104,21,8,"PODEMOS-Aho",219
22,"22213",3029,2225,2181,17,44,"PODEMOS-Aho",264
22,"22204",1095,816,805,10,11,"PODEMOS-Aho",159
22,"22015",324,238,236,3,2,"PODEMOS-Aho",42
22,"22189",184,140,137,1,3,"PODEMOS-Aho",14
22,"22057",364,260,259,1,1,"PODEMOS-Aho",42
22,"22068",82,65,65,3,0,"PODEMOS-Aho",15
22,"22083",474,400,396,1,4,"PODEMOS-Aho",37
22,"22156",264,202,200,3,2,"PODEMOS-Aho",34
22,"22051",101,84,84,1,0,"PODEMOS-Aho",13
22,"22053",787,541,535,12,6,"PODEMOS-Aho",88
22,"22004",136,79,79,0,0,"PODEMOS-Aho",19
22,"22003",143,119,119,0,0,"PODEMOS-Aho",18
22,"22208",178,142,140,0,2,"PODEMOS-Aho",38
22,"22036",91,82,82,0,0,"PODEMOS-Aho",13
22,"22232",96,73,70,2,3,"PODEMOS-Aho",7
22,"22228",505,409,407,3,2,"PODEMOS-Aho",73
22,"22222",527,390,389,5,1,"PODEMOS-Aho",75
22,"22099",490,378,377,4,1,"PODEMOS-Aho",52
22,"22124",204,143,142,1,1,"PODEMOS-Aho",29
22,"22028",379,297,293,1,4,"PODEMOS-Aho",74
22,"22052",942,743,741,9,2,"PODEMOS-Aho",108
22,"22186",186,139,137,3,2,"PODEMOS-Aho",22
22,"22129",183,128,127,2,1,"PODEMOS-Aho",12
22,"22235",100,77,77,0,0,"PODEMOS-Aho",4
22,"22049",78,61,61,1,0,"PODEMOS-Aho",8
22,"22158",12005,8628,8554,78,74,"PODEMOS-Aho",1577
22,"22155",77,58,58,2,0,"PODEMOS-Aho",4
22,"22236",249,198,198,1,0,"PODEMOS-Aho",20
22,"22245",306,258,257,3,1,"PODEMOS-Aho",26
22,"22200",251,191,189,0,2,"PODEMOS-Aho",37
22,"22116",1443,1048,1038,12,10,"PODEMOS-Aho",119
22,"22016",613,447,444,8,3,"PODEMOS-Aho",73
22,"22206",201,141,140,2,1,"PODEMOS-Aho",28
22,"22081",252,179,177,1,2,"PODEMOS-Aho",15
22,"22002",109,94,93,0,1,"PODEMOS-Aho",11
22,"22172",560,399,396,2,3,"PODEMOS-Aho",26
22,"22114",123,80,79,4,1,"PODEMOS-Aho",6
22,"22217",395,307,301,3,6,"PODEMOS-Aho",41
22,"22139",83,65,64,0,1,"PODEMOS-Aho",12
22,"22085",107,92,90,2,2,"PODEMOS-Aho",13
22,"22201",269,189,189,0,0,"PODEMOS-Aho",41
22,"22187",286,224,221,1,3,"PODEMOS-Aho",51
22,"22089",315,227,222,6,5,"PODEMOS-Aho",49
22,"22233",82,61,61,0,0,"PODEMOS-Aho",6
22,"22063",175,140,140,2,0,"PODEMOS-Aho",31
22,"22048",12633,9215,9141,90,74,"PODEMOS-Aho",1411
22,"22086",215,162,162,4,0,"PODEMOS-Aho",44
22,"22128",187,146,142,1,4,"PODEMOS-Aho",16
22,"22207",125,89,88,3,1,"PODEMOS-Aho",15
22,"22162",129,101,101,0,0,"PODEMOS-Aho",2
22,"22055",325,252,245,5,7,"PODEMOS-Aho",17
22,"22164",35,26,26,1,0,"PODEMOS-Aho",1
22,"22040",148,123,121,2,2,"PODEMOS-Aho",18
22,"22023",430,329,329,2,0,"PODEMOS-Aho",33
22,"22227",211,153,151,3,2,"PODEMOS-Aho",25
22,"22157",194,151,151,1,0,"PODEMOS-Aho",22
22,"22082",298,222,220,2,2,"PODEMOS-Aho",20
22,"22090",102,75,75,0,0,"PODEMOS-Aho",17
22,"22163",426,360,356,3,4,"PODEMOS-Aho",58
22,"22012",111,84,82,0,2,"PODEMOS-Aho",8
22,"22137",1071,729,719,6,10,"PODEMOS-Aho",95
22,"22079",118,86,86,2,0,"PODEMOS-Aho",9
22,"22902",219,162,160,1,2,"PODEMOS-Aho",22
22,"22035",244,171,168,3,3,"PODEMOS-Aho",31
22,"22064",165,115,115,1,0,"PODEMOS-Aho",25
52,"52001",53255,28182,27819,299,363,"RECORTES CE",46
37,"37005",77,58,56,0,2,"PCPE",0
37,"37347",477,365,359,3,6,"PCPE",0
37,"37027",228,187,187,0,0,"PCPE",0
37,"37267",199,151,147,2,4,"PCPE",1
37,"37192",353,245,242,2,3,"PCPE",1
37,"37319",117,78,77,0,1,"PCPE",0
37,"37198",206,161,160,3,1,"PCPE",0
37,"37354",5182,3955,3915,50,40,"PCPE",1
37,"37317",306,246,243,1,3,"PCPE",0
37,"37322",2472,1691,1676,12,15,"PCPE",3
37,"37029",213,155,152,0,3,"PCPE",0
37,"37145",257,190,187,0,3,"PCPE",0
37,"37035",194,161,161,0,0,"PCPE",0
37,"37038",789,628,616,5,12,"PCPE",1
37,"37128",264,211,201,4,10,"PCPE",0
37,"37241",172,128,126,1,2,"PCPE",0
37,"37327",185,157,157,5,0,"PCPE",0
37,"37017",251,186,184,2,2,"PCPE",0
37,"37132",351,272,269,2,3,"PCPE",0
37,"37356",86,73,71,1,2,"PCPE",0
37,"37203",165,118,118,0,0,"PCPE",0
37,"37296",338,258,255,4,3,"PCPE",0
37,"37010",956,716,708,3,8,"PCPE",1
37,"37016",573,451,447,3,4,"PCPE",0
37,"37249",44,33,33,1,0,"PCPE",0
37,"37376",2251,1588,1568,9,20,"PCPE",1
37,"37365",174,147,144,0,3,"PCPE",0
37,"37037",119,81,81,0,0,"PCPE",0
37,"37350",421,324,320,4,4,"PCPE",0
37,"37263",348,252,251,1,1,"PCPE",0
37,"37269",452,328,328,2,0,"PCPE",0
37,"37115",123,89,87,0,2,"PCPE",0
37,"37074",153,109,103,4,6,"PCPE",0
37,"37222",97,66,66,1,0,"PCPE",0
37,"37377",249,199,195,3,4,"PCPE",0
37,"37020",430,340,334,3,6,"PCPE",1
37,"37216",310,264,257,4,7,"PCPE",0
37,"37209",406,281,280,7,1,"PCPE",0
37,"37244",134,91,90,1,1,"PCPE",0
37,"37036",63,46,46,0,0,"PCPE",0
37,"37003",119,93,90,0,3,"PCPE",0
37,"37271",361,283,276,3,7,"PCPE",0
37,"37337",139,120,120,2,0,"PCPE",0
37,"37259",45,30,30,0,0,"PCPE",0
37,"37190",219,167,167,0,0,"PCPE",0
37,"37129",251,199,194,1,5,"PCPE",0
37,"37019",151,114,111,0,3,"PCPE",0
37,"37279",763,572,562,11,10,"PCPE",1
37,"37177",298,223,221,1,2,"PCPE",2
37,"37121",584,434,430,5,4,"PCPE",0
37,"37109",182,119,118,0,1,"PCPE",0
37,"37334",79,42,42,1,0,"PCPE",0
37,"37294",11680,8850,8760,84,90,"PCPE",11
37,"37260",154,126,126,1,0,"PCPE",1
37,"37012",150,117,115,0,2,"PCPE",0
37,"37013",121,87,86,3,1,"PCPE",0
37,"37184",345,247,244,1,3,"PCPE",1
37,"37148",425,304,295,6,9,"PCPE",1
37,"37077",260,234,230,0,4,"PCPE",0
37,"37183",417,305,301,2,4,"PCPE",0
37,"37114",88,67,66,1,1,"PCPE",0
37,"37057",213,168,167,0,1,"PCPE",0
37,"37028",150,111,110,1,1,"PCPE",0
37,"37151",146,116,115,2,1,"PCPE",0
37,"37368",16,15,15,0,0,"PCPE",0
37,"37102",411,291,289,3,2,"PCPE",1
37,"37261",227,165,161,2,4,"PCPE",0
37,"37182",77,62,62,0,0,"PCPE",0
37,"37006",135,91,90,1,1,"PCPE",0
37,"37107",10855,7694,7598,96,96,"PCPE",11
37,"37004",32,22,22,0,0,"PCPE",0
37,"37338",78,66,66,1,0,"PCPE",0
37,"37349",112,83,82,0,1,"PCPE",0
37,"37119",109,86,86,1,0,"PCPE",0
37,"37018",105,80,80,1,0,"PCPE",0
37,"37336",55,47,47,0,0,"PCPE",0
37,"37289",240,182,182,2,0,"PCPE",0
37,"37234",357,224,222,1,2,"PCPE",0
37,"37256",220,158,157,1,1,"PCPE",1
37,"37284",325,245,244,2,1,"PCPE",4
37,"37146",122,100,99,1,1,"PCPE",0
37,"37286",206,156,156,4,0,"PCPE",0
37,"37363",120,98,94,0,4,"PCPE",0
37,"37026",192,158,154,2,4,"PCPE",1
37,"37374",1178,971,943,8,28,"PCPE",0
37,"37118",125,96,96,0,0,"PCPE",0
37,"37318",209,156,155,1,1,"PCPE",0
37,"37135",1211,932,925,10,7,"PCPE",0
37,"37155",73,54,54,1,0,"PCPE",0
37,"37081",933,720,714,4,6,"PCPE",0
37,"37034",84,66,66,3,0,"PCPE",0
37,"37257",53,43,43,0,0,"PCPE",0
37,"37231",259,208,207,4,1,"PCPE",2
37,"37090",52,38,36,0,2,"PCPE",0
37,"37331",217,150,148,1,2,"PCPE",1
37,"37303",188,152,151,1,1,"PCPE",0
37,"37251",126,87,87,2,0,"PCPE",0
37,"37097",36,30,30,0,0,"PCPE",0
37,"37367",199,160,158,7,2,"PCPE",0
37,"37060",245,192,192,0,0,"PCPE",1
37,"37052",274,197,197,2,0,"PCPE",1
37,"37125",228,158,156,3,2,"PCPE",0
37,"37032",543,411,410,1,1,"PCPE",1
37,"37291",268,206,206,1,0,"PCPE",0
37,"37343",62,49,49,0,0,"PCPE",0
37,"37163",42,33,33,0,0,"PCPE",0
37,"37288",258,211,210,7,1,"PCPE",1
37,"37323",521,387,385,8,2,"PCPE",2
37,"37292",103,72,72,1,0,"PCPE",0
37,"37237",325,250,248,4,2,"PCPE",1
37,"37309",45,28,28,0,0,"PCPE",0
37,"37007",439,321,313,4,8,"PCPE",1
37,"37252",116,89,89,0,0,"PCPE",0
37,"37058",61,43,42,0,1,"PCPE",0
37,"37085",4704,3475,3432,35,43,"PCPE",2
37,"37033",98,63,63,0,0,"PCPE",0
37,"37045",27,20,20,0,0,"PCPE",0
37,"37329",36,28,28,0,0,"PCPE",0
37,"37278",753,573,568,7,5,"PCPE",0
37,"37330",335,262,258,4,4,"PCPE",0
37,"37127",221,158,158,4,0,"PCPE",1
37,"37099",73,45,45,2,0,"PCPE",0
37,"37264",67,43,43,0,0,"PCPE",0
37,"37176",137,100,98,0,2,"PCPE",0
37,"37298",184,125,125,1,0,"PCPE",0
37,"37242",91,71,71,0,0,"PCPE",0
37,"37050",67,47,46,1,1,"PCPE",0
37,"37117",1458,1075,1068,14,7,"PCPE",7
37,"37001",195,147,144,0,3,"PCPE",0
37,"37352",204,148,147,0,1,"PCPE",0
37,"37206",94,71,71,4,0,"PCPE",1
37,"37059",124,100,98,0,2,"PCPE",0
37,"37143",385,301,299,1,2,"PCPE",0
37,"37306",271,171,171,0,0,"PCPE",0
37,"37243",102,76,76,0,0,"PCPE",0
37,"37170",1479,1055,1031,10,24,"PCPE",4
37,"37250",358,223,223,1,0,"PCPE",0
37,"37199",142,108,108,0,0,"PCPE",0
37,"37361",84,56,55,0,1,"PCPE",0
37,"37122",202,158,156,3,2,"PCPE",0
37,"37082",799,570,560,1,10,"PCPE",1
37,"37379",173,134,134,2,0,"PCPE",1
37,"37224",210,183,179,2,4,"PCPE",0
37,"37002",144,87,87,0,0,"PCPE",0
37,"37174",1065,838,826,3,12,"PCPE",2
37,"37320",93,71,71,1,0,"PCPE",0
37,"37098",335,237,237,1,0,"PCPE",0
37,"37083",179,159,159,0,0,"PCPE",1
37,"37014",1161,850,847,5,3,"PCPE",2
37,"37229",143,102,102,1,0,"PCPE",0
37,"37285",412,311,305,2,6,"PCPE",0
37,"37088",204,152,152,3,0,"PCPE",0
37,"37324",371,284,279,4,5,"PCPE",0
37,"37149",70,63,63,0,0,"PCPE",0
37,"37332",69,53,52,0,1,"PCPE",0
37,"37274",119148,88959,88152,853,807,"PCPE",119
37,"37344",246,184,183,1,1,"PCPE",0
37,"37061",226,166,164,1,2,"PCPE",0
37,"37103",446,326,325,4,1,"PCPE",0
37,"37301",73,62,62,0,0,"PCPE",0
37,"37305",216,170,169,2,1,"PCPE",0
37,"37187",565,431,426,4,5,"PCPE",0
37,"37071",78,73,72,1,1,"PCPE",0
37,"37293",118,84,84,0,0,"PCPE",1
37,"37116",69,51,51,0,0,"PCPE",0
37,"37072",166,133,132,2,1,"PCPE",0
37,"37124",219,149,148,0,1,"PCPE",0
37,"37086",98,80,80,2,0,"PCPE",0
37,"37366",43,27,27,0,0,"PCPE",0
37,"37162",206,151,149,2,2,"PCPE",0
37,"37302",294,216,214,1,2,"PCPE",0
37,"37008",4298,3312,3272,16,40,"PCPE",4
37,"37150",43,35,35,0,0,"PCPE",0
37,"37378",111,74,70,2,4,"PCPE",0
37,"37188",185,127,125,3,2,"PCPE",0
37,"37283",120,88,88,1,0,"PCPE",0
37,"37235",223,168,163,1,5,"PCPE",0
37,"37315",93,69,67,1,2,"PCPE",0
37,"37031",365,258,257,1,1,"PCPE",0
37,"37357",276,216,215,0,1,"PCPE",2
37,"37147",191,141,136,0,5,"PCPE",0
37,"37167",173,150,144,2,6,"PCPE",0
37,"37136",667,453,448,2,5,"PCPE",0
37,"37106",266,172,166,1,6,"PCPE",0
37,"37255",51,38,38,0,0,"PCPE",0
37,"37079",74,64,63,0,1,"PCPE",0
37,"37073",583,449,442,8,7,"PCPE",0
37,"37240",907,646,636,5,10,"PCPE",0
37,"37091",176,114,113,2,1,"PCPE",0
37,"37233",65,45,45,0,0,"PCPE",2
37,"37300",575,427,423,3,4,"PCPE",1
37,"37054",261,199,198,1,1,"PCPE",0
37,"37230",221,167,167,2,0,"PCPE",0
37,"37197",87,55,55,2,0,"PCPE",0
37,"37141",156,127,127,1,0,"PCPE",0
37,"37175",407,316,314,5,2,"PCPE",1
37,"37080",232,176,176,1,0,"PCPE",0
37,"37022",268,220,219,2,1,"PCPE",0
37,"37123",182,141,138,0,3,"PCPE",0
37,"37205",233,201,197,1,4,"PCPE",0
37,"37313",555,415,411,1,4,"PCPE",0
37,"37112",161,115,114,0,1,"PCPE",0
37,"37321",170,131,129,2,2,"PCPE",0
37,"37062",84,67,66,1,1,"PCPE",0
37,"37290",140,116,116,0,0,"PCPE",0
37,"37355",189,147,146,1,1,"PCPE",1
37,"37172",878,580,576,3,4,"PCPE",3
37,"37275",123,87,86,1,1,"PCPE",0
37,"37314",87,74,72,0,2,"PCPE",0
37,"37131",190,140,139,0,1,"PCPE",0
37,"37272",136,97,96,0,1,"PCPE",1
37,"37023",1378,1116,1105,9,11,"PCPE",0
37,"37246",5335,4190,4152,41,38,"PCPE",5
37,"37360",230,167,166,2,1,"PCPE",0
37,"37353",129,92,92,1,0,"PCPE",0
37,"37311",226,182,182,2,0,"PCPE",0
37,"37215",136,102,101,2,1,"PCPE",0
37,"37139",205,163,162,2,1,"PCPE",0
37,"37247",199,162,154,3,8,"PCPE",1
37,"37009",216,161,160,3,1,"PCPE",0
37,"37178",99,84,81,0,3,"PCPE",0
37,"37159",91,74,74,0,0,"PCPE",0
37,"37065",323,237,235,0,2,"PCPE",0
37,"37133",108,82,79,4,3,"PCPE",1
37,"37372",146,117,115,0,2,"PCPE",0
37,"37316",751,584,577,5,7,"PCPE",1
37,"37024",92,77,77,0,0,"PCPE",0
37,"37335",415,301,293,2,8,"PCPE",0
37,"37375",705,593,582,11,11,"PCPE",1
37,"37339",316,257,257,4,0,"PCPE",1
37,"37179",215,173,170,0,3,"PCPE",0
37,"37225",106,94,92,0,2,"PCPE",0
37,"37186",106,78,78,3,0,"PCPE",0
37,"37040",393,320,317,3,3,"PCPE",0
37,"37281",37,34,33,0,1,"PCPE",0
37,"37168",443,319,311,2,8,"PCPE",0
37,"37134",230,175,173,1,2,"PCPE",0
37,"37213",87,73,73,0,0,"PCPE",0
37,"37025",258,223,221,2,2,"PCPE",0
37,"37067",3125,2551,2523,22,28,"PCPE",5
37,"37191",116,78,76,0,2,"PCPE",0
37,"37161",138,109,107,0,2,"PCPE",0
37,"37157",77,62,62,0,0,"PCPE",0
37,"37120",99,77,76,1,1,"PCPE",0
37,"37253",135,110,110,1,0,"PCPE",0
37,"37011",122,91,89,0,2,"PCPE",0
37,"37165",33,27,27,0,0,"PCPE",0
37,"37030",84,68,66,0,2,"PCPE",0
37,"37046",11336,8300,8171,62,129,"PCPE",10
37,"37169",176,139,137,0,2,"PCPE",0
37,"37051",80,54,53,0,1,"PCPE",0
37,"37218",71,33,33,2,0,"PCPE",0
37,"37341",56,43,41,0,2,"PCPE",0
37,"37100",81,68,67,1,1,"PCPE",0
37,"37078",823,670,657,8,13,"PCPE",1
37,"37382",180,133,133,4,0,"PCPE",0
37,"37345",166,135,133,3,2,"PCPE",0
37,"37152",424,290,283,2,7,"PCPE",0
37,"37268",116,71,70,0,1,"PCPE",1
37,"37196",77,54,53,0,1,"PCPE",0
37,"37063",74,59,59,1,0,"PCPE",0
37,"37287",318,237,237,3,0,"PCPE",0
37,"37280",79,50,50,0,0,"PCPE",0
37,"37307",160,103,103,0,0,"PCPE",0
37,"37101",163,122,122,2,0,"PCPE",0
37,"37160",627,450,443,7,7,"PCPE",0
37,"37312",262,211,210,3,1,"PCPE",0
37,"37328",189,142,140,0,2,"PCPE",0
37,"37044",470,353,341,1,12,"PCPE",1
37,"37273",108,77,77,0,0,"PCPE",0
37,"37340",150,105,104,1,1,"PCPE",0
37,"37262",78,64,64,1,0,"PCPE",0
37,"37297",420,342,331,4,11,"PCPE",0
37,"37204",280,214,211,1,3,"PCPE",0
37,"37193",399,279,278,6,1,"PCPE",2
37,"37049",147,98,98,2,0,"PCPE",0
37,"37217",56,46,44,1,2,"PCPE",0
37,"37373",755,548,545,3,3,"PCPE",1
37,"37270",190,142,139,1,3,"PCPE",0
37,"37202",978,773,763,7,10,"PCPE",2
37,"37089",67,50,49,0,1,"PCPE",0
37,"37282",209,136,136,0,0,"PCPE",2
37,"37138",199,155,154,4,1,"PCPE",0
37,"37181",291,209,207,1,2,"PCPE",0
37,"37096",220,174,174,5,0,"PCPE",0
37,"37194",252,191,190,2,1,"PCPE",0
37,"37226",156,121,119,1,2,"PCPE",0
37,"37113",430,340,340,3,0,"PCPE",0
37,"37166",213,142,142,1,0,"PCPE",0
37,"37310",180,129,128,2,1,"PCPE",0
37,"37359",184,131,129,0,2,"PCPE",0
37,"37325",91,68,63,0,5,"PCPE",0
37,"37140",678,440,435,2,5,"PCPE",1
37,"37041",74,48,48,0,0,"PCPE",0
37,"37108",101,81,79,2,2,"PCPE",0
37,"37228",367,301,299,1,2,"PCPE",0
37,"37221",434,328,323,2,5,"PCPE",0
37,"37070",533,403,396,4,7,"PCPE",0
37,"37358",168,136,135,2,1,"PCPE",0
37,"37211",223,163,163,4,0,"PCPE",0
37,"37069",976,713,699,9,14,"PCPE",1
37,"37371",281,183,177,1,6,"PCPE",0
37,"37104",27,21,21,0,0,"PCPE",0
37,"37039",304,213,213,4,0,"PCPE",0
37,"37200",190,134,133,2,1,"PCPE",0
37,"37021",80,62,62,0,0,"PCPE",0
37,"37212",111,83,83,1,0,"PCPE",0
37,"37047",167,83,83,0,0,"PCPE",0
37,"37171",411,321,317,1,4,"PCPE",0
37,"37238",112,88,85,2,3,"PCPE",0
37,"37333",225,143,142,4,1,"PCPE",0
37,"37015",222,145,143,3,2,"PCPE",0
37,"37277",73,55,55,0,0,"PCPE",0
37,"37380",55,46,46,2,0,"PCPE",0
37,"37369",140,96,96,0,0,"PCPE",0
37,"37130",173,155,153,5,2,"PCPE",0
37,"37208",81,49,48,0,1,"PCPE",0
37,"37214",125,88,88,1,0,"PCPE",0
37,"37173",1526,1138,1125,5,13,"PCPE",0
37,"37195",48,35,35,1,0,"PCPE",0
37,"37351",281,239,238,0,1,"PCPE",0
37,"37362",4592,3442,3403,48,39,"PCPE",2
37,"37299",221,170,163,1,7,"PCPE",0
37,"37087",855,681,676,8,5,"PCPE",1
37,"37137",105,73,73,0,0,"PCPE",0
37,"37068",366,272,271,5,1,"PCPE",0
37,"37185",591,450,443,4,7,"PCPE",0
37,"37154",141,116,112,0,4,"PCPE",0
37,"37223",109,90,87,0,3,"PCPE",0
37,"37055",123,105,98,0,7,"PCPE",0
37,"37248",152,127,126,2,1,"PCPE",0
37,"37381",139,98,92,0,6,"PCPE",0
37,"37144",370,288,284,2,4,"PCPE",0
37,"37158",248,183,181,0,2,"PCPE",1
37,"37239",229,196,194,6,2,"PCPE",1
37,"37189",125,97,97,0,0,"PCPE",0
37,"37056",41,30,30,0,0,"PCPE",0
37,"37126",30,24,24,0,0,"PCPE",0
37,"37304",170,114,109,4,5,"PCPE",0
37,"37110",117,92,89,1,3,"PCPE",0
37,"37207",303,234,233,0,1,"PCPE",0
37,"37265",217,180,178,2,2,"PCPE",1
37,"37266",84,55,55,1,0,"PCPE",0
37,"37180",73,52,52,1,0,"PCPE",0
37,"37092",1731,1264,1250,11,14,"PCPE",1
37,"37142",592,453,451,2,2,"PCPE",0
37,"37258",180,117,115,1,2,"PCPE",0
37,"37342",256,210,208,1,2,"PCPE",0
37,"37346",267,222,220,1,2,"PCPE",0
37,"37156",4310,3173,3126,27,47,"PCPE",4
37,"37201",262,179,177,0,2,"PCPE",0
37,"37370",337,258,255,3,3,"PCPE",0
37,"37219",179,110,110,0,0,"PCPE",0
37,"37348",113,91,91,1,0,"PCPE",0
37,"37245",345,252,246,7,6,"PCPE",0
37,"37232",390,349,348,0,1,"PCPE",0
37,"37236",139,94,89,0,5,"PCPE",0
37,"37042",42,29,29,2,0,"PCPE",0
37,"37364",836,598,583,6,15,"PCPE",0
37,"37164",256,200,195,1,5,"PCPE",0
37,"37276",149,100,99,0,1,"PCPE",1
37,"37254",183,153,149,0,4,"PCPE",0
28,"28050",4077,3032,3006,15,26,"PUM+J",0
28,"28042",1153,882,874,5,8,"PUM+J",2
28,"28129",7913,6175,6124,30,51,"PUM+J",6
28,"28130",28243,22649,22458,135,191,"PUM+J",18
28,"28092",151511,117869,116968,641,901,"PUM+J",71
28,"28182",214,174,170,0,4,"PUM+J",1
28,"28036",2514,1974,1949,12,25,"PUM+J",0
28,"28047",40783,31308,31072,171,236,"PUM+J",24
28,"28026",6237,4893,4853,32,40,"PUM+J",2
28,"28162",2549,2039,2025,13,14,"PUM+J",1
28,"28166",318,258,255,1,3,"PUM+J",0
28,"28037",1566,1175,1168,5,7,"PUM+J",0
28,"28088",262,180,179,2,1,"PUM+J",0
28,"28181",20344,16669,16572,95,97,"PUM+J",11
28,"28083",8880,6801,6759,47,42,"PUM+J",1
28,"28112",167,132,132,0,0,"PUM+J",0
28,"28903",32480,27640,27525,161,115,"PUM+J",12
28,"28070",119,91,91,0,0,"PUM+J",0
28,"28046",4432,3562,3538,19,24,"PUM+J",2
28,"28134",60511,47566,47229,233,337,"PUM+J",36
28,"28161",48368,37462,37161,190,301,"PUM+J",16
28,"28144",5929,4776,4744,29,32,"PUM+J",0
28,"28137",1644,1301,1283,7,18,"PUM+J",1
28,"28062",308,244,241,3,3,"PUM+J",0
28,"28152",16026,13269,13202,46,67,"PUM+J",9
28,"28115",60579,50819,50657,246,162,"PUM+J",34
28,"28167",8308,6605,6545,35,60,"PUM+J",5
28,"28170",2486,1757,1740,9,17,"PUM+J",1
28,"28094",825,636,634,3,2,"PUM+J",0
28,"28093",2043,1681,1661,9,20,"PUM+J",0
28,"28901",789,590,584,2,6,"PUM+J",0
28,"28069",54,43,43,1,0,"PUM+J",0
28,"28071",60,47,46,0,1,"PUM+J",0
28,"28174",1788,1277,1267,2,10,"PUM+J",2
28,"28090",8405,6792,6751,34,41,"PUM+J",7
28,"28048",499,406,401,2,5,"PUM+J",0
28,"28072",5657,4465,4441,20,24,"PUM+J",2
28,"28010",9853,7959,7914,35,45,"PUM+J",1
28,"28125",2965,2210,2188,13,22,"PUM+J",2
28,"28151",3143,2352,2314,6,38,"PUM+J",0
28,"28041",4452,3572,3550,24,22,"PUM+J",4
28,"28056",860,653,647,6,6,"PUM+J",0
28,"28113",34305,27077,26881,156,196,"PUM+J",16
28,"28179",1441,1082,1071,7,11,"PUM+J",0
28,"28096",18161,13784,13647,57,137,"PUM+J",10
28,"28078",36,34,34,0,0,"PUM+J",0
28,"28141",5806,4532,4486,24,46,"PUM+J",2
28,"28119",2074,1641,1625,9,16,"PUM+J",1
28,"28127",64513,53125,52932,300,193,"PUM+J",26
28,"28004",6179,4377,4345,15,32,"PUM+J",1
28,"28169",1427,1164,1158,1,6,"PUM+J",1
28,"28171",4238,3002,2962,18,40,"PUM+J",7
28,"28033",3824,2854,2832,11,22,"PUM+J",0
28,"28025",427,329,326,1,3,"PUM+J",0
28,"28085",3908,3106,3078,7,28,"PUM+J",1
28,"28108",3330,2536,2528,17,8,"PUM+J",1
28,"28079",2371327,1817203,1806970,9067,10233,"PUM+J",1481
28,"28066",7175,5598,5561,28,37,"PUM+J",2
28,"28131",12971,9828,9755,57,73,"PUM+J",6
28,"28021",544,387,387,2,0,"PUM+J",1
28,"28054",11166,8649,8584,36,65,"PUM+J",2
28,"28073",12505,9485,9384,64,101,"PUM+J",9
28,"28014",32852,24749,24571,120,178,"PUM+J",10
28,"28120",1217,918,904,4,14,"PUM+J",1
28,"28099",1731,1283,1278,8,5,"PUM+J",0
28,"28040",15691,10833,10728,45,105,"PUM+J",7
28,"28118",58,49,48,1,1,"PUM+J",0
28,"28126",39,25,25,0,0,"PUM+J",0
28,"28172",8965,7255,7219,44,36,"PUM+J",3
28,"28164",2986,2281,2263,12,18,"PUM+J",0
28,"28157",595,448,442,1,6,"PUM+J",0
28,"28124",76,56,54,0,2,"PUM+J",0
28,"28001",64,48,48,3,0,"PUM+J",0
28,"28060",1509,1194,1183,8,11,"PUM+J",2
28,"28128",439,323,320,2,3,"PUM+J",0
28,"28003",181,141,141,3,0,"PUM+J",0
28,"28059",4312,3256,3237,11,19,"PUM+J",3
28,"28140",2981,2383,2357,14,26,"PUM+J",0
28,"28002",2966,2186,2175,9,11,"PUM+J",0
28,"28180",5242,4040,3999,11,41,"PUM+J",2
28,"28030",1716,1342,1316,2,26,"PUM+J",1
28,"28038",4935,3858,3815,17,43,"PUM+J",1
28,"28111",592,489,483,0,6,"PUM+J",0
28,"28052",3883,2801,2758,18,43,"PUM+J",1
28,"28175",850,696,692,2,4,"PUM+J",0
28,"28031",2055,1538,1519,4,19,"PUM+J",0
28,"28176",12288,9809,9763,50,46,"PUM+J",6
28,"28902",468,352,347,2,5,"PUM+J",0
28,"28148",85022,65597,65111,368,486,"PUM+J",59
28,"28064",134,105,105,0,0,"PUM+J",0
28,"28106",76612,56555,56006,346,549,"PUM+J",63
28,"28076",406,322,319,1,3,"PUM+J",0
28,"28177",10192,8271,8234,51,37,"PUM+J",9
28,"28107",435,326,321,0,5,"PUM+J",0
28,"28147",968,751,745,2,6,"PUM+J",0
28,"28006",78564,61796,61456,334,340,"PUM+J",64
28,"28155",507,420,420,0,0,"PUM+J",0
28,"28067",4057,3220,3188,12,32,"PUM+J",1
28,"28044",5766,4623,4584,22,39,"PUM+J",1
28,"28143",70,59,59,1,0,"PUM+J",0
28,"28009",14046,11014,10932,51,82,"PUM+J",7
28,"28097",124,85,84,1,1,"PUM+J",0
28,"28183",1050,770,763,2,7,"PUM+J",0
28,"28138",69,54,54,0,0,"PUM+J",0
28,"28091",5436,3827,3786,23,41,"PUM+J",1
28,"28058",139289,108214,107323,612,891,"PUM+J",113
28,"28032",4749,3653,3607,19,46,"PUM+J",1
28,"28053",6458,5299,5263,29,36,"PUM+J",4
28,"28029",530,426,424,3,2,"PUM+J",0
28,"28039",130,97,97,0,0,"PUM+J",0
28,"28153",703,510,507,2,3,"PUM+J",0
28,"28063",252,195,194,2,1,"PUM+J",0
28,"28173",520,409,408,3,1,"PUM+J",0
28,"28068",10928,8389,8315,43,74,"PUM+J",2
28,"28016",80,57,57,0,0,"PUM+J",0
28,"28121",198,166,164,2,2,"PUM+J",0
28,"28156",998,751,743,3,8,"PUM+J",0
28,"28051",1542,1240,1232,5,8,"PUM+J",0
28,"28074",138742,110456,109579,581,877,"PUM+J",121
28,"28135",971,740,735,4,5,"PUM+J",0
28,"28132",11645,8605,8520,55,85,"PUM+J",5
28,"28160",8227,6295,6251,26,44,"PUM+J",3
28,"28018",3739,3071,3046,12,25,"PUM+J",0
28,"28150",3084,2415,2381,13,34,"PUM+J",2
28,"28022",32949,27473,27379,169,94,"PUM+J",15
28,"28086",5055,3627,3600,21,27,"PUM+J",3
28,"28005",134211,104575,103819,667,756,"PUM+J",84
28,"28163",438,357,354,1,3,"PUM+J",0
28,"28122",518,388,385,2,3,"PUM+J",1
28,"28102",881,659,650,3,9,"PUM+J",0
28,"28017",1210,954,943,6,11,"PUM+J",0
28,"28012",883,702,691,4,11,"PUM+J",0
28,"28080",48226,39753,39570,172,183,"PUM+J",14
28,"28007",124358,99423,98711,554,712,"PUM+J",82
28,"28104",13836,11414,11349,54,65,"PUM+J",10
28,"28027",1199,897,882,5,15,"PUM+J",0
28,"28089",3703,2961,2933,19,28,"PUM+J",1
28,"28065",125384,101604,100872,477,732,"PUM+J",90
28,"28011",445,339,338,0,1,"PUM+J",0
28,"28034",352,270,269,1,1,"PUM+J",0
28,"28109",1591,1113,1111,3,2,"PUM+J",1
28,"28023",4697,3835,3817,20,18,"PUM+J",0
28,"28095",1508,1177,1167,6,10,"PUM+J",2
28,"28015",18233,14725,14653,81,72,"PUM+J",5
28,"28117",95,84,84,0,0,"PUM+J",0
28,"28123",56464,47181,46948,257,233,"PUM+J",35
28,"28149",5653,4516,4469,19,47,"PUM+J",3
28,"28154",5420,3966,3899,17,67,"PUM+J",4
28,"28008",1768,1293,1282,4,11,"PUM+J",0
28,"28136",640,540,532,0,8,"PUM+J",0
28,"28028",1730,1347,1326,8,21,"PUM+J",2
28,"28087",3176,2545,2528,15,17,"PUM+J",1
28,"28024",152,129,128,1,1,"PUM+J",0
28,"28146",1773,1274,1262,9,12,"PUM+J",0
28,"28019",1237,952,938,2,14,"PUM+J",1
28,"28049",58688,48006,47660,286,346,"PUM+J",53
28,"28159",588,469,468,6,1,"PUM+J",0
28,"28045",33019,25531,25313,146,218,"PUM+J",19
28,"28114",149,103,103,1,0,"PUM+J",2
28,"28075",5581,4380,4350,15,30,"PUM+J",5
28,"28020",148,99,97,1,2,"PUM+J",0
28,"28061",21200,16698,16600,75,98,"PUM+J",5
28,"28158",662,545,543,3,2,"PUM+J",0
28,"28082",5664,4526,4492,25,34,"PUM+J",5
28,"28013",40409,30141,29905,164,236,"PUM+J",24
28,"28178",1066,850,846,2,4,"PUM+J",1
28,"28100",4169,3076,3048,12,28,"PUM+J",4
28,"28057",1439,1125,1120,5,5,"PUM+J",0
28,"28168",1226,910,900,1,10,"PUM+J",0
28,"28145",2370,1824,1809,12,15,"PUM+J",0
28,"28084",15839,12028,11925,53,103,"PUM+J",13
28,"28133",6002,4259,4204,12,55,"PUM+J",4
28,"28055",899,682,676,4,6,"PUM+J",0
28,"28101",218,180,180,0,0,"PUM+J",0
28,"28116",700,544,544,3,0,"PUM+J",1
28,"28043",5922,4063,4008,29,55,"PUM+J",1
28,"28035",1362,1042,1033,3,9,"PUM+J",2
28,"28110",1949,1543,1525,2,18,"PUM+J",1
28,"28165",1788,1332,1321,5,11,"PUM+J",1
27,"27039",4372,3327,3244,56,83,"RECORTES CE",6
27,"27003",1913,1372,1351,16,21,"RECORTES CE",1
27,"27037",1075,736,723,12,13,"RECORTES CE",0
27,"27044",2901,1891,1832,28,59,"RECORTES CE",6
27,"27004",1251,846,828,2,18,"RECORTES CE",3
27,"27028",79061,57271,56444,702,827,"RECORTES CE",180
27,"27035",190,121,121,2,0,"RECORTES CE",0
27,"27014",3284,2187,2148,29,39,"RECORTES CE",2
27,"27040",3225,2454,2415,22,39,"RECORTES CE",2
27,"27009",2110,1595,1573,11,22,"RECORTES CE",1
27,"27053",546,349,349,1,0,"RECORTES CE",0
27,"27045",1049,667,658,9,9,"RECORTES CE",1
27,"27022",4859,3324,3251,38,73,"RECORTES CE",5
27,"27048",2176,1658,1626,19,32,"RECORTES CE",1
27,"27013",3782,3067,3007,21,60,"RECORTES CE",8
27,"27029",1475,1142,1116,19,26,"RECORTES CE",2
27,"27054",1205,920,906,7,14,"RECORTES CE",1
27,"27047",1643,1116,1104,10,12,"RECORTES CE",0
27,"27031",15650,10901,10710,106,191,"RECORTES CE",16
27,"27066",12767,9200,9039,102,161,"RECORTES CE",30
27,"27060",2651,1761,1729,12,32,"RECORTES CE",3
27,"27064",1593,1179,1153,14,26,"RECORTES CE",0
27,"27034",1154,720,710,6,10,"RECORTES CE",0
27,"27007",2833,2211,2144,34,67,"RECORTES CE",3
27,"27065",12528,8701,8483,150,218,"RECORTES CE",15
27,"27021",1772,1167,1136,21,31,"RECORTES CE",1
27,"27030",3361,2333,2290,27,43,"RECORTES CE",1
27,"27015",4304,3063,2985,41,78,"RECORTES CE",3
27,"27011",2490,1623,1592,14,31,"RECORTES CE",5
27,"27055",1320,869,855,3,14,"RECORTES CE",1
27,"27061",1045,821,796,10,25,"RECORTES CE",2
27,"27012",1366,778,769,5,9,"RECORTES CE",1
27,"27023",2593,1981,1942,24,39,"RECORTES CE",0
27,"27005",2615,1942,1918,16,24,"RECORTES CE",3
27,"27018",3514,2279,2255,17,24,"RECORTES CE",5
27,"27002",1651,1224,1200,8,24,"RECORTES CE",3
27,"27042",1759,1258,1235,21,23,"RECORTES CE",2
27,"27063",1761,1340,1299,12,41,"RECORTES CE",1
27,"27027",1937,1458,1425,19,33,"RECORTES CE",4
27,"27032",3313,2269,2230,29,39,"RECORTES CE",4
27,"27026",2423,1667,1602,12,65,"RECORTES CE",3
27,"27001",2401,1346,1313,24,33,"RECORTES CE",0
27,"27901",2404,1647,1624,25,23,"RECORTES CE",1
27,"27051",8102,5883,5784,71,99,"RECORTES CE",19
27,"27056",1268,899,886,11,13,"RECORTES CE",1
27,"27008",1377,1011,992,11,19,"RECORTES CE",1
27,"27049",1422,969,958,8,11,"RECORTES CE",1
27,"27033",631,454,449,8,5,"RECORTES CE",0
27,"27025",2859,2293,2243,17,50,"RECORTES CE",3
27,"27043",1313,875,855,14,20,"RECORTES CE",0
27,"27057",11176,7921,7709,99,212,"RECORTES CE",18
27,"27050",2993,2241,2203,16,38,"RECORTES CE",2
27,"27006",2611,1752,1723,26,29,"RECORTES CE",4
27,"27059",2202,1640,1605,19,35,"RECORTES CE",3
27,"27016",7204,5069,4987,65,82,"RECORTES CE",16
27,"27038",945,679,674,9,5,"RECORTES CE",1
27,"27010",4363,3072,2990,45,82,"RECORTES CE",8
27,"27019",8120,6041,5936,82,105,"RECORTES CE",9
27,"27052",918,659,649,3,10,"RECORTES CE",0
27,"27020",3539,2954,2896,38,58,"RECORTES CE",4
27,"27041",2377,1737,1722,16,15,"RECORTES CE",0
27,"27058",3577,2669,2632,37,37,"RECORTES CE",4
27,"27017",1017,674,666,6,8,"RECORTES CE",0
27,"27046",1538,1119,1099,10,20,"RECORTES CE",0
27,"27062",619,468,465,6,3,"RECORTES CE",0
27,"27024",1624,1250,1226,8,24,"RECORTES CE",1
27,"27902",7196,5017,4921,55,96,"RECORTES CE",10
